CUSTOMER_ID;ESTADO_CIVIL;SEXO;EDAD;NACIONALIDAD;PROFESION;GENERACION_CLIENTE;COMUNA_CLIENTE;CIUDAD_CLIENTE;SUMA_INGRESOS_12;CANTIDAD_PRODUCTOS_12;SUMA_BOLETAS_12;CANTIDAD_UNIDADES_ECOMMERCE_12;SUMA_BOLETAS_ECOMMERCE_12;SUMA_INGRESOS_ECOMMERCE_12;CANTIDAD_UNIDADES_TIENDA_12;SUMA_BOLETAS_TIENDA_12;SUMA_INGRESOS_TIENDA_12;ULTIMO_PRODUCTO_COMPRADO;LINEA_ULTIMO_PRODUCTO_COMPRDO
15641079;Casado;F;38;CHILENO;;Millenial;PROVIDENCIA                   ;METROPOLITANA;291670;4;2;4;2;291670;0;0;0;CAMA ELASTICA (3,66M) CON MALLA GAMEPOWER AZUL;OUTDOOR
13414723;;M;44;CHILENO;;X;IQUIQUE                       ;TARAPACA;79990;1;1;0;0;0;1;1;79990;GO-KART PEDALES NEGRO;OUTDOOR
19228198;Soltero;F;26;CHILENO;;Silencioso;PROVIDENCIA                   ;METROPOLITANA;123980;2;1;2;1;123980;0;0;0;HOVERBOARD AUTOBALANCE 6.5P, ROJO/BT/BOLSO;OUTDOOR
16238589;;M;37;CHILENO;;Millenial;"";"";683940;6;4;6;4;683940;0;0;0;Scooter con Burbujas KeyRiders;OUTDOOR
16027632;;F;36;CHILENO;;Millenial;RINCONADA;VALPARAISO;44980;2;1;2;1;44980;0;0;0;Piscina Kids 150 X 110 X 42Cm;OUTDOOR
13979105;;F;41;CHILENO;;X;LA LIGUA                      ;VALPARAISO;135940;7;4;0;0;0;7;4;135940;Scooter Peluche Leon y Luces Led KeyRiders;OUTDOOR
12803599;;F;47;CHILENO;;X;PROVIDENCIA                   ;METROPOLITANA;2970;3;2;0;0;0;3;2;2970;Botella Metalica National Geographic 500Ml Color;OUTDOOR
18421775;;M;30;CHILENO;;Millenial;MAIPU                         ;METROPOLITANA;41970;3;1;3;1;41970;0;0;0;COLCHON 2 PZA 203X152X22 CM;OUTDOOR
11347710;;F;54;CHILENO;;X;PROVIDENCIA                   ;METROPOLITANA;82980;2;1;2;1;82980;0;0;0;Mesa Rimax Eterna Familiar Wengue 150X80;OUTDOOR
18231403;;M;29;CHILENO;;Millenial;TOCOPILLA                     ;ANTOFAGASTA;99990;1;1;0;0;0;1;1;99990;CAMA ELASTICA (2,44M) CON MALLA GAMEPOWER AZUL;OUTDOOR
19171894;;F;27;CHILENO;;Z;PROVIDENCIA                   ;METROPOLITANA;16990;1;1;1;1;16990;0;0;0;Juego de Mesa Camcorro 10 en 1;OUTDOOR
7119642;;M;67;CHILENO;;Boomers;NUEVA IMPERIAL                ;ARAUCANIA;129990;1;1;0;0;0;1;1;129990;Auto Electrico 4x4 Descapotable Verde Militar;OUTDOOR
20146759;;F;23;CHILENO;;Silencioso;PROVIDENCIA                   ;METROPOLITANA;153960;4;2;4;2;153960;0;0;0;CAMA ELASTICA (3,05M) CON MALLA GAMEPOWER AZUL;OUTDOOR
15656960;;F;38;CHILENO;;Millenial;TEMUCO                        ;ARAUCANIA;15990;1;1;1;1;15990;0;0;0;COLCHON 2 PZA 203X152X22 CM;OUTDOOR
20107802;;F;23;CHILENO;;Z;N/D;N/D;15980;2;2;3;1;27970;-1;1;-11990;Correpasillos Unicornio Rosado;OUTDOOR
17034834;;F;33;CHILENO;;Millenial;PUERTO MONTT                  ;LOS LAGOS;68980;2;1;2;1;68980;0;0;0;Mesa AirHockey Carromco;OUTDOOR
19718993;;M;25;CHILENO;;Z;CALERA DE TANGO               ;METROPOLITANA;21990;1;1;0;0;0;1;1;21990;COLCHON 2 PZA 203X152X22 CM;OUTDOOR
13250263;;M;45;CHILENO;;X;HUECHURABA                    ;METROPOLITANA;93980;2;1;2;1;93980;0;0;0;V-CARPA 6 PERSONAS TORONTO NAT GEO S17;OUTDOOR
19008581;;F;26;CHILENO;;Z;PROVIDENCIA                   ;METROPOLITANA;19990;1;1;0;0;0;1;1;19990;COLCHON 2 PZA 203X152X22 CM;OUTDOOR
19213264;;F;26;CHILENO;;Z;PROVIDENCIA                   ;METROPOLITANA;63970;3;1;3;1;63970;0;0;0;V-SACO DORMIR TUCSON AZUL NAT GEO S17;OUTDOOR
15722260;;M;38;CHILENO;;X;"";"";220970;3;2;0;0;0;3;2;220970;COLCHON 2 PZA 203X152X22 CM;OUTDOOR
17894890;;F;30;CHILENO;;Millenial;MELIPEUCO                     ;ARAUCANIA;35980;2;1;2;1;35980;0;0;0;V-MESA REDONDA PLEG. 81CM NORTHWEST;OUTDOOR
19317832;Soltero;F;26;CHILENO;;Z;PROVIDENCIA                   ;METROPOLITANA;103980;2;1;2;1;103980;0;0;0;V-PISCINA ESTRUCTURAL BESTWAY STEEL PRO 3.05M X;OUTDOOR
18543408;;F;28;CHILENO;;Millenial;PROVIDENCIA                   ;METROPOLITANA;125840;2;1;2;1;125840;0;0;0;PISCINA CIRCULAR STEEL PRO;OUTDOOR
14469252;;F;48;CHILENO;;X;RENGO                         ;L.G.B.OÂ´HIGGINS;239990;1;1;0;0;0;1;1;239990;PISCINA RECTANGULAR 211CM BESTWAY AZUL;OUTDOOR
20334328;;F;22;CHILENO;;Z;PUDAHUEL;METROPOLITANA;367960;4;2;4;2;367960;0;0;0;PISCINA CIRCULAR STEEL PRO;OUTDOOR
15879071;;F;37;CHILENO;;Millenial;"";"";195840;2;1;2;1;195840;0;0;0;PISCINA RECTANGULAR 211CM BESTWAY AZUL;OUTDOOR
7639344;;M;58;CHILENO;;Boomers;CALBUCO                       ;LOS LAGOS;89990;2;1;0;0;0;2;1;89990;PISCINA STEEL PRO 300X201X66CM;OUTDOOR
13600054;;M;43;CHILENO;;X;PROVIDENCIA                   ;METROPOLITANA;160470;3;2;2;1;145480;1;1;14990;V-PISCINA ESTRUCTURAL BESTWAY STEEL PRO 3.05M X;OUTDOOR
13626792;;F;43;CHILENO;;X;NACIMIENTO                    ;BIO BIO;125840;2;1;2;1;125840;0;0;0;PISCINA CIRCULAR STEEL PRO;OUTDOOR
16505447;;M;35;CHILENO;;Millenial;PENCO                         ;BIO BIO;344950;5;2;0;0;0;5;2;344950;PISCINA CIRCULAR STEEL PRO 6473 L;OUTDOOR
14493246;Divorciado;F;47;CHILENO;;Silencioso;PROVIDENCIA                   ;METROPOLITANA;32483;2;1;2;1;32483;0;0;0;COLCHONETA ULTRALIGHT VERDE MILITAR NATIONAL GEO;OUTDOOR
17803163;Soltero;M;31;CHILENO;PROFESOR;Millenial;PROVIDENCIA                   ;METROPOLITANA;23980;2;1;2;1;23980;0;0;0;Scooter Peluche Dinosaurio y Luces Led KeyRiders;OUTDOOR
16008764;;F;37;CHILENO;;Millenial;PROVIDENCIA                   ;METROPOLITANA;125840;2;1;2;1;125840;0;0;0;PISCINA CIRCULAR STEEL PRO;OUTDOOR
10314793;;F;53;CHILENO;;X;ARAUCO                        ;BIO BIO;85840;2;1;2;1;85840;0;0;0;PISCINA STEEL PRO 300X201X66CM;OUTDOOR
6510200;Casado;M;68;CHILENO;;Silencioso;PROVIDENCIA                   ;METROPOLITANA;309980;2;1;2;1;309980;0;0;0;MESA DE POOL GAMEPOWER 03;OUTDOOR
17641583;;F;31;CHILENO;;Millenial;N/D;N/D;89990;1;1;0;0;0;1;1;89990;CAMA ELASTICA (1,83M) CON MALLA GAMEPOWER AZUL;OUTDOOR
14120853;;F;41;CHILENO;;X;PROVIDENCIA                   ;METROPOLITANA;18980;2;1;2;1;18980;0;0;0;Deslizador Single 5.49 Con Rampa;OUTDOOR
17834881;;F;31;CHILENO;;Millenial;N/D;N/D;85840;2;1;2;1;85840;0;0;0;PISCINA STEEL PRO 300X201X66CM;OUTDOOR
17632865;;F;32;CHILENO;;Millenial;PROVIDENCIA                   ;METROPOLITANA;119990;1;1;1;1;119990;0;0;0;PISCINA CIRCULAR STEEL PRO;OUTDOOR
19127903;Soltero;M;25;CHILENO;;Z;PROVIDENCIA                   ;METROPOLITANA;3990;1;1;0;0;0;1;1;3990;CUERDA SALTARINA LANZA AGUA;OUTDOOR
11568106;;M;52;CHILENO;;X;CHILLAN                       ;BIO BIO;59990;1;1;0;0;0;1;1;59990;TACA TACA MADERA EVER GROUP;OUTDOOR
17517247;;M;34;CHILENO;;Millenial;N/D;N/D;134980;2;2;1;1;89990;1;1;44990;PISCINA STEEL PRO 300X201X66CM;OUTDOOR
16855567;;M;34;CHILENO;;Extranjero;"";"";123980;2;1;2;1;123980;0;0;0;PISCINA CIRCULAR STEEL PRO;OUTDOOR
12747088;;M;47;CHILENO;;Millenial;VALDIVIA                      ;LOS RIOS;78540;2;1;2;1;78540;0;0;0;PISCINA STEEL PRO 300X201X66CM;OUTDOOR
16333111;;F;36;CHILENO;;Millenial;RENCA                         ;METROPOLITANA;129990;1;1;0;0;0;1;1;129990;GO-KART PEDALES NEGRO;OUTDOOR
10051720;;M;57;CHILENO;;Boomers;SAN ANTONIO                   ;VALPARAISO;716510;4;3;0;0;0;4;3;716510;PISCINA CIRCULAR STEEL PRO;OUTDOOR
20025762;;F;23;CHILENO;;Z;"";"";99990;1;1;0;0;0;1;1;99990;PISCINA CIRCULAR STEEL PRO;OUTDOOR
13972647;;F;41;CHILENO;;X;N/D;N/D;119990;1;1;0;0;0;1;1;119990;V-PISCINA ESTRUCTURAL BESTWAY STEEL PRO 3.05M X;OUTDOOR
9939689;;F;58;CHILENO;;Boomers;PUERTO MONTT                  ;LOS LAGOS;179970;3;2;0;0;0;3;2;179970;PISCINA CIRCULAR STEEL PRO 6473 L;OUTDOOR
20565928;;F;21;CHILENO;;Millenial;"";"";99990;1;1;0;0;0;1;1;99990;PISCINA STEEL PRO 300X201X66CM;OUTDOOR
11774113;;M;50;CHILENO;;X;PROVIDENCIA                   ;METROPOLITANA;119990;1;1;1;1;119990;0;0;0;V-PISCINA ESTRUCTURAL BESTWAY STEEL PRO 3.05M X;OUTDOOR
9128434;;F;62;CHILENO;;Boomers;RECOLETA                      ;METROPOLITANA;139990;1;1;0;0;0;1;1;139990;PISCINA CIRCULAR STEEL PRO 6473 L;OUTDOOR
8158505;;F;63;CHILENO;;Boomers;ARICA                         ;ARICA Y PARINACOTA;27980;2;1;0;0;0;2;1;27980;Scooter Peluche Dinosaurio y Luces Led KeyRiders;OUTDOOR
13961751;;M;42;CHILENO;;X;TEMUCO                        ;ARAUCANIA;652980;2;1;0;0;0;2;1;652980;PISCINA POWER STEEL RECTANGULAR;OUTDOOR
20447082;;F;22;CHILENO;;Z;PROVIDENCIA                   ;METROPOLITANA;123980;2;1;2;1;123980;0;0;0;PISCINA CIRCULAR STEEL PRO;OUTDOOR
16214732;;F;36;CHILENO;;Millenial;PROVIDENCIA                   ;METROPOLITANA;256750;4;2;0;0;0;4;2;256750;PISCINA CIRCULAR STEEL PRO 6473 L;OUTDOOR
9966240;;F;56;CHILENO;;Boomers;PROVIDENCIA                   ;METROPOLITANA;123980;2;1;2;1;123980;0;0;0;PISCINA CIRCULAR STEEL PRO;OUTDOOR
13748880;Soltero;F;42;CHILENO;;X;RENCA                         ;METROPOLITANA;97540;2;1;2;1;97540;0;0;0;V-CARRO PLEGABLE NAT GEO S17;OUTDOOR
19650464;;M;25;CHILENO;;Z;N/D;N/D;81980;2;1;2;1;81980;0;0;0;Mesa AirHockey Carromco;OUTDOOR
10496276;;M;52;CHILENO;;X;RENCA                         ;METROPOLITANA;109980;2;2;0;0;0;2;2;109980;TACA TACA MADERA EVER GROUP;OUTDOOR
13487618;;F;44;CHILENO;;X;SANTIAGO;METROPOLITANA;145480;2;1;2;1;145480;0;0;0;PISCINA CIRCULAR STEEL PRO 6473 L;OUTDOOR
11231592;;M;53;CHILENO;;X;RENCA                         ;METROPOLITANA;482840;5;2;0;0;0;5;2;482840;TACA TACA MADERA EVER GROUP;OUTDOOR
16445321;;F;36;CHILENO;;Millenial;PROVIDENCIA                   ;METROPOLITANA;83980;2;1;2;1;83980;0;0;0;TACA TACA MADERA EVER GROUP;OUTDOOR
10982115;;F;50;CHILENO;;X;COIHAIQUE                     ;AYSEN;132980;2;2;0;0;0;2;2;132980;PISCINA RECTANGULAR 150CM BESTWAY AZUL;OUTDOOR
18327771;;F;29;CHILENO;;Millenial;PROVIDENCIA                   ;METROPOLITANA;21570;3;1;3;1;21570;0;0;0;V-TOALLA MICROFIBRA LARGE NAT GEO S17;OUTDOOR
13976381;;F;40;CHILENO;;X;PROVIDENCIA                   ;METROPOLITANA;99990;1;1;1;1;99990;0;0;0;PISCINA STEEL PRO 300X201X66CM;OUTDOOR
16799912;;F;34;CHILENO;;Millenial;PROVIDENCIA                   ;METROPOLITANA;46980;2;1;2;1;46980;0;0;0;V-CARPA 2 PERSONAS TORONTO NAT GEO S17;OUTDOOR
26253072;;M;53;EXTRANJERO - NO INFORMA NACIONALIDAD;;Extranjero;PROVIDENCIA                   ;METROPOLITANA;387970;3;2;0;0;0;3;2;387970;PISCINA RECTANGULAR 150CM BESTWAY AZUL;OUTDOOR
13558762;;M;43;CHILENO;;X;TALAGANTE                     ;METROPOLITANA;23980;2;1;2;1;23980;0;0;0;COLCHON 2 PZA 203X152X22 CM;OUTDOOR
11914615;;F;49;CHILENO;;X;ARAUCO                        ;BIO BIO;376980;2;1;0;0;0;2;1;376980;PISCINA STEEL PRO MAX;OUTDOOR
15165677;;F;38;CHILENO;;Millenial;REQUINOA                      ;L.G.B.OÂ´HIGGINS;278960;4;3;0;0;0;4;3;278960;PISCINA STEEL PRO 300X201X66CM;OUTDOOR
17690865;Soltero;M;34;CHILENO;;Millenial;N/D;N/D;181980;2;1;0;0;0;2;1;181980;PISCINA RECTANGULAR 211CM BESTWAY AZUL;OUTDOOR
18043217;;F;29;CHILENO;;Millenial;TEMUCO                        ;ARAUCANIA;79990;1;1;0;0;0;1;1;79990;TACA TACA MADERA EVER GROUP;OUTDOOR
18430679;;F;29;CHILENO;;Millenial;PROVIDENCIA                   ;METROPOLITANA;105840;2;1;2;1;105840;0;0;0;AUTO ELECTRICO DESCAPOTABLE BLANCO COUP;OUTDOOR
16837088;Soltero;F;34;CHILENO;;Millenial;"";"";245480;2;1;2;1;245480;0;0;0;Scooter Electrico Cero E6 Negro;OUTDOOR
19110820;;F;26;CHILENO;;Z;N/D;N/D;90830;3;2;2;1;70840;1;1;19990;Scooter Peluche Unicornio y Luces Led KeyRiders;OUTDOOR
13439059;;F;44;CHILENO;;X;PROVIDENCIA                   ;METROPOLITANA;483980;2;1;2;1;483980;0;0;0;Piscina Power Steel Swim Vista Series Oval 4.8x3;OUTDOOR
26024641;;F;44;ARGENTINO;;Extranjero;N/D;N/D;359990;1;1;0;0;0;1;1;359990;PISCINA STEEL PRO C/ESCALERA Y COBERTOR;OUTDOOR
13537377;;F;43;CHILENO;;X;SALAMANCA                     ;COQUIMBO;339990;1;1;0;0;0;1;1;339990;PISCINA STEEL PRO C/ESCALERA Y COBERTOR;OUTDOOR
16831823;;F;34;CHILENO;;Millenial;OSORNO                        ;LOS LAGOS;202980;2;1;0;0;0;2;1;202980;PISCINA RECTANGULAR 211CM BESTWAY AZUL;OUTDOOR
10319500;Casado;F;42;CHILENO;PSICOLOGA;X;RENCA                         ;METROPOLITANA;12980;2;1;2;1;12980;0;0;0;V-CARPA PLAYA OUTBACK OUTBACK;OUTDOOR
11314371;;F;54;CHILENO;;X;EL BOSQUE                     ;METROPOLITANA;159980;2;2;0;0;0;2;2;159980;TACA TACA MADERA EVER GROUP;OUTDOOR
16784069;;M;34;CHILENO;;Millenial;N/D;N/D;76980;2;1;2;1;76980;0;0;0;PISCINA RECTANGULAR 150CM BESTWAY AZUL;OUTDOOR
16242682;;F;36;CHILENO;;Millenial;PROVIDENCIA                   ;METROPOLITANA;119990;1;1;1;1;119990;0;0;0;PISCINA CIRCULAR STEEL PRO;OUTDOOR
10376515;;M;54;CHILENO;;Boomers;RENCA                         ;METROPOLITANA;511980;2;1;2;1;511980;0;0;0;PISCINA POWER STEEL OVALADA;OUTDOOR
17521762;;F;31;CHILENO;;Millenial;DONIHUE                       ;L.G.B.OÂ´HIGGINS;99990;1;1;1;1;99990;0;0;0;PISCINA STEEL PRO 300X201X66CM;OUTDOOR
16274488;;M;36;CHILENO;;Millenial;LINARES                       ;MAULE;89990;1;1;0;0;0;1;1;89990;PISCINA RECTANGULAR 150CM BESTWAY AZUL;OUTDOOR
17949670;;M;40;CHILENO;;X;QUILLOTA                      ;VALPARAISO;344960;4;3;3;2;284970;1;1;59990;SCOOTER ELECTRICO CERO EKIDS NEGRO;OUTDOOR
5284254;;F;82;CHILENO;;Silencioso;ILLAPEL                       ;COQUIMBO;199990;1;1;0;0;0;1;1;199990;PISCINA CIRCULAR STEEL PRO 6473 L;OUTDOOR
17953673;;M;30;CHILENO;;Millenial;LA GRANJA                     ;METROPOLITANA;59990;1;1;0;0;0;1;1;59990;PISCINA RECTANGULAR 150CM BESTWAY AZUL;OUTDOOR
8527006;;F;64;CHILENO;;Boomers;MAIPU                         ;METROPOLITANA;168960;4;1;0;0;0;4;1;168960;Triciclo 360 Desmontable Bebesit;OUTDOOR
19362250;;F;25;CHILENO;;Z;"";"";0;0;0;0;0;0;0;0;0;Cesta Ropa Rimax Linum Gris Hielo;OUTDOOR
19739472;;F;25;CHILENO;;Z;PROVIDENCIA                   ;METROPOLITANA;0;0;0;0;0;0;0;0;0;Correpasillos Rojo;OUTDOOR
14163406;;F;41;CHILENO;;X;PROVIDENCIA                   ;METROPOLITANA;0;0;0;0;0;0;0;0;0;V-MOCHILA NATIONAL GEOGRAPHIC BLUELAKE 25L AZUL;OUTDOOR
20187545;;M;23;CHILENO;;Z;PROVIDENCIA                   ;METROPOLITANA;0;0;0;0;0;0;0;0;0;Triciclo 360 Desmontable Bebesit;OUTDOOR
17463454;;M;32;CHILENO;;Silencioso;PROVIDENCIA                   ;METROPOLITANA;0;0;0;0;0;0;0;0;0;Mini Trampolin Kids 3 Pies Con Mango Plegable;OUTDOOR
16511392;;M;35;CHILENO;;Millenial;ANGOL                         ;ARAUCANIA;0;0;0;0;0;0;0;0;0;Triciclo 360 Desmontable Bebesit;OUTDOOR
15894379;;M;37;CHILENO;;Millenial;"";"";0;0;0;0;0;0;0;0;0;Cuatrimoto Electrica Force Rosada;OUTDOOR
18709490;Soltero;M;28;CHILENO;PSICOLOGO;Silencioso;PROVIDENCIA                   ;METROPOLITANA;0;0;0;0;0;0;0;0;0;CENTRO JUEGOS 3EN1 RESBALIN+COLUMPIO+AROBASQ;OUTDOOR
9815326;;F;58;CHILENO;;Silencioso;PROVIDENCIA                   ;METROPOLITANA;0;0;0;0;0;0;0;0;0;V-AUTITO PARA NINOS 80x48x91CM S17;OUTDOOR
19543666;;F;25;CHILENO;;Z;SANTIAGO                      ;METROPOLITANA;0;0;0;0;0;0;0;0;0;COLCHON 2 PZA 203X152X22 CM;OUTDOOR
19483664;Soltero;M;25;CHILENO;;Z;PROVIDENCIA                   ;METROPOLITANA;0;0;0;0;0;0;0;0;0;Set De Ollas - Sarten Outback;OUTDOOR
19032359;Soltero;F;27;CHILENO;PROFESOR;Millenial;PROVIDENCIA                   ;METROPOLITANA;0;0;0;0;0;0;0;0;0;PISCINA RECTANGULAR 150CM BESTWAY AZUL;OUTDOOR
11379801;;F;54;CHILENO;;Boomers;PROVIDENCIA                   ;METROPOLITANA;0;0;0;0;0;0;0;0;0;COLCHON 2 PZA 203X152X22 CM;OUTDOOR
19351236;;F;26;CHILENO;;Z;PROVIDENCIA                   ;METROPOLITANA;0;0;0;0;0;0;0;0;0;TUNEL DE JUEGO 46X180 CM;OUTDOOR
25674273;;F;32;VENEZOLANO;;Extranjero;SANTIAGO                      ;METROPOLITANA;0;0;0;0;0;0;0;0;0;Silla Plegable Outback Con Apoyo De Brazos Gris;OUTDOOR
18482195;;F;29;CHILENO;;Millenial;PROVIDENCIA                   ;METROPOLITANA;0;0;0;0;0;0;0;0;0;Quitasol Outback 160 Cms.;OUTDOOR
18324303;;M;30;CHILENO;;Millenial;N/D;N/D;0;0;0;0;0;0;0;0;0;COLCHON 2 PZA 203X152X22 CM;OUTDOOR
15221637;;M;40;CHILENO;;X;CHIGUAYANTE                   ;BIO BIO;0;0;0;0;0;0;0;0;0;COLCHON 2 PZA 203X152X22 CM;OUTDOOR
16850798;;F;33;CHILENO;;Silencioso;PROVIDENCIA                   ;METROPOLITANA;0;0;0;0;0;0;0;0;0;V-SACO DORMIR STREAM AZUL NAT GEO S17;OUTDOOR
18077917;;F;32;CHILENO;;Millenial;N/D;N/D;0;0;0;0;0;0;0;0;0;COLCHON 2 PZA 203X152X22 CM;OUTDOOR
16544220;Casado;F;35;CHILENO;PROFESOR;Millenial;PROVIDENCIA                   ;METROPOLITANA;0;0;0;0;0;0;0;0;0;COLCHON 2 PZA 203X152X22 CM;OUTDOOR
14092255;;M;40;CHILENO;;X;PROVIDENCIA                   ;METROPOLITANA;0;0;0;0;0;0;0;0;0;COLCHON 2 PZA 203X152X22 CM;OUTDOOR
16166193;;F;36;CHILENO;;Millenial;PROVIDENCIA                   ;METROPOLITANA;0;0;0;0;0;0;0;0;0;CERCA DE COLORES;OUTDOOR
13123205;Soltero;M;45;CHILENO;;X;PROVIDENCIA                   ;METROPOLITANA;0;0;0;0;0;0;0;0;0;JUEGO INFLABL BOUNCEJAM;OUTDOOR
26581594;;F;44;VENEZOLANO;;Extranjero;"";"";0;0;0;0;0;0;0;0;0;V-PISCINA MY FIRST FAST SET SPRAY POOL 1.52M X 3;OUTDOOR
18524867;Soltero;F;28;CHILENO;TECNICO DE NIVEL MEDIO EN ATENCION DE ENFERMERIA;Millenial;PROVIDENCIA                   ;METROPOLITANA;0;0;0;0;0;0;0;0;0;V-PISCINA MY FIRST FAST SET SPRAY POOL 1.52M X 3;OUTDOOR
14324384;;F;45;CHILENO;;X;RENCA                         ;METROPOLITANA;0;0;0;0;0;0;0;0;0;COLCHON 2 PZA 203X152X22 CM;OUTDOOR
9304397;;F;66;CHILENO;;Boomers;PROVIDENCIA                   ;METROPOLITANA;0;0;0;0;0;0;0;0;0;CAMA ELASTICA (1,83M) CON MALLA GAMEPOWER AZUL;OUTDOOR
12254167;;F;49;CHILENO;;X;PROVIDENCIA                   ;METROPOLITANA;0;0;0;0;0;0;0;0;0;Piscina Redonda Fast Set Con Filtro 3.66M X 76 C;OUTDOOR
11975095;;F;50;CHILENO;;X;RENCA                         ;METROPOLITANA;0;0;0;0;0;0;0;0;0;COLCHON 2 PZA 203X152X22 CM;OUTDOOR
13039162;;F;45;CHILENO;;X;PROVIDENCIA                   ;METROPOLITANA;0;0;0;0;0;0;0;0;0;PISCINA RECTANGULAR 211CM BESTWAY AZUL;OUTDOOR
16645351;;F;34;CHILENO;;Millenial;PROVIDENCIA                   ;METROPOLITANA;0;0;0;0;0;0;0;0;0;PISCINA CIRCULAR STEEL PRO 6473 L;OUTDOOR
13759505;;F;41;CHILENO;;X;RENCA                         ;METROPOLITANA;0;0;0;0;0;0;0;0;0;PELOTA DE PLAYA 51CM;OUTDOOR
18058368;;M;38;CHILENO;;Millenial;CANETE                        ;BIO BIO;0;0;0;0;0;0;0;0;0;PISCINA CIRCULAR STEEL PRO 6473 L;OUTDOOR
10271059;;M;55;CHILENO;;Boomers;LA LIGUA                      ;VALPARAISO;0;0;0;0;0;0;0;0;0;CAMIONETA ELECTRICA NINO 905 ZHE;OUTDOOR
9644439;;F;57;CHILENO;;Boomers;QUINTA NORMAL                 ;METROPOLITANA;0;0;0;0;0;0;0;0;0;PISCINA STEEL PRO C/ESCALERA Y COBERTOR;OUTDOOR
6605559;Casado;M;69;CHILENO;;Silencioso;PROVIDENCIA                   ;METROPOLITANA;0;0;0;0;0;0;0;0;0;PISCINA RECTANGULAR 211CM BESTWAY AZUL;OUTDOOR
16185673;;M;37;CHILENO;;Millenial;N/D;N/D;0;0;0;0;0;0;0;0;0;PISCINA CIRCULAR STEEL PRO;OUTDOOR
10225107;;F;58;CHILENO;;Boomers;N/D;N/D;0;0;0;0;0;0;0;0;0;PISCINA CIRCULAR STEEL PRO;OUTDOOR
13572105;;F;43;CHILENO;;X;CHEPICA                       ;L.G.B.OÂ´HIGGINS;0;0;0;0;0;0;0;0;0;PISCINA RECTANGULAR 150CM BESTWAY AZUL;OUTDOOR
8211556;;F;69;CHILENO;;Silencioso;PROVIDENCIA                   ;METROPOLITANA;0;0;0;0;0;0;0;0;0;TACA TACA MADERA EVER GROUP;OUTDOOR
8724022;;M;63;CHILENO;;Boomers;RANCAGUA                      ;L.G.B.OÂ´HIGGINS;0;0;0;0;0;0;0;0;0;PISCINA CIRCULAR STEEL PRO;OUTDOOR
8022447;;M;62;CHILENO;;Boomers;CALERA                        ;VALPARAISO;0;0;0;0;0;0;0;0;0;TACA TACA MADERA EVER GROUP;OUTDOOR
8941495;;F;62;CHILENO;;Boomers;N/D;N/D;0;0;0;0;0;0;0;0;0;PISCINA RECTANGULAR 211CM BESTWAY AZUL;OUTDOOR
15916403;;F;37;CHILENO;;Millenial;PROVIDENCIA                   ;METROPOLITANA;0;0;0;0;0;0;0;0;0;MINI TRAMPOLIN 38 GAMEPOWER AZUL;OUTDOOR
11953242;;M;50;CHILENO;;X;PROVIDENCIA                   ;METROPOLITANA;0;0;0;0;0;0;0;0;0;GO-KART PEDALES NEGRO;OUTDOOR
16251565;;M;36;CHILENO;;Millenial;MACHALI                       ;L.G.B.OÂ´HIGGINS;0;0;0;0;0;0;0;0;0;PISCINA RECTANGULAR 211CM BESTWAY AZUL;OUTDOOR
17069977;;F;33;CHILENO;;Millenial;PROVIDENCIA                   ;METROPOLITANA;0;0;0;0;0;0;0;0;0;PISCINA RECTANGULAR 211CM BESTWAY AZUL;OUTDOOR
15684159;;F;42;CHILENO;;X;N/D;N/D;0;0;0;0;0;0;0;0;0;PISCINA STEEL PRO 300X201X66CM;OUTDOOR
12518880;;M;49;CHILENO;;X;PICHIDEGUA                    ;L.G.B.OÂ´HIGGINS;0;0;0;0;0;0;0;0;0;COLCHON 2 PZA 203X152X22 CM;OUTDOOR
19327694;;F;25;CHILENO;;Z;PROVIDENCIA                   ;METROPOLITANA;0;0;0;0;0;0;0;0;0;CAMA ELASTICA (1,83M) CON MALLA GAMEPOWER AZUL;OUTDOOR
7845570;;M;63;CHILENO;;Boomers;SAN BERNARDO                  ;METROPOLITANA;0;0;0;0;0;0;0;0;0;SET SNORKEL HYDRO-PRO DREAM DIVER;OUTDOOR
6059162;Casado;F;74;CHILENO;;Silencioso;PROVIDENCIA                   ;METROPOLITANA;0;0;0;0;0;0;0;0;0;MOTO ELECTRICA LUCES BLANCA;OUTDOOR
13080981;;F;46;CHILENO;;X;RENCA                         ;METROPOLITANA;0;0;0;0;0;0;0;0;0;PISCINA STEEL PRO 300X201X66CM;OUTDOOR
19357763;;F;24;CHILENO;;Z;LICANTEN                      ;MAULE;0;0;0;0;0;0;0;0;0;PISCINA FORMA DE SANDIA;OUTDOOR
15547402;;F;39;CHILENO;;X;PROVIDENCIA                   ;METROPOLITANA;0;0;0;0;0;0;0;0;0;GO-KART PEDALES ROJO;OUTDOOR
9847514;;F;60;CHILENO;;Boomers;RENCA                         ;METROPOLITANA;0;0;0;0;0;0;0;0;0;PISCINA RECTANGULAR 211CM BESTWAY AZUL;OUTDOOR
13949681;;M;42;CHILENO;;X;PROVIDENCIA                   ;METROPOLITANA;0;0;0;0;0;0;0;0;0;SET DE PLAYA 9 PIEZAS VERDE;OUTDOOR
13245201;;F;44;CHILENO;;X;PROVIDENCIA                   ;METROPOLITANA;0;0;0;0;0;0;0;0;0;SET SKATE C/BOLSO 3SA TRA;OUTDOOR
12801567;Casado;F;47;CHILENO;ENFERMERA;X;RENCA                         ;METROPOLITANA;0;0;0;0;0;0;0;0;0;COHETE C/LANZADOR;OUTDOOR
11596246;Soltero;F;52;CHILENO;;X;RENCA                         ;METROPOLITANA;0;0;0;0;0;0;0;0;0;PISCINA ESTRUCTURAL STEEL PRO 5700LT;OUTDOOR
19569487;;M;25;CHILENO;;Z;N/D;N/D;0;0;0;0;0;0;0;0;0;PISCINA CIRCULAR STEEL PRO;OUTDOOR
12791470;;F;47;CHILENO;;X;LONGAVI                       ;MAULE;0;0;0;0;0;0;0;0;0;COLCHON 2 PZA 203X152X22 CM;OUTDOOR
16718729;;F;34;CHILENO;;Millenial;ANTOFAGASTA                   ;ANTOFAGASTA;0;0;0;0;0;0;0;0;0;GO-KART PEDALES NEGRO;OUTDOOR
15116782;;M;36;CHILENO;;Millenial;PROVIDENCIA                   ;METROPOLITANA;0;0;0;0;0;0;0;0;0;ALFOMBRA DE JUEGO EVA 40CM 4PC;OUTDOOR
16588583;;F;35;CHILENO;;Millenial;PROVIDENCIA                   ;METROPOLITANA;0;0;0;0;0;0;0;0;0;TACA TACA MADERA EVER GROUP;OUTDOOR
16174046;Soltero;F;36;CHILENO;CONSTRUCTOR CIVIL;Millenial;PROVIDENCIA                   ;METROPOLITANA;0;0;0;0;0;0;0;0;0;CASA DE PIEDRA MORADO;OUTDOOR
10524312;;F;58;CHILENO;;Boomers;ANTOFAGASTA                   ;ANTOFAGASTA;820880;11;6;0;0;0;11;6;820880;Asistencia de Mascotas;GARANTIAS
6741732;;M;70;CHILENO;;Silencioso;CONCEPCION                    ;BIO BIO;591411;11;5;0;0;0;11;5;591411;Asistencia Salud Integral Familia;GARANTIAS
9537778;;M;59;CHILENO;;Boomers;TALCAHUANO                    ;BIO BIO;211960;4;1;0;0;0;4;1;211960;Asistencia de Mascotas;GARANTIAS
20387281;;F;22;CHILENO;;Z;"";"";52990;1;1;0;0;0;1;1;52990;Asistencia Salud Integral Familia;GARANTIAS
16039526;;M;37;CHILENO;;Millenial;QUILLON                       ;BIO BIO;52990;1;1;0;0;0;1;1;52990;Asistencia Salud Integral Familia;GARANTIAS
13502817;;F;43;CHILENO;;X;N/D;N/D;864500;8;4;7;3;811510;1;1;52990;ASIST. FULL HOGAR Y AUTO INGRAL;GARANTIAS
7849459;;M;64;CHILENO;;Boomers;SANTIAGO                      ;METROPOLITANA;581000;11;5;0;0;0;11;5;581000;Asistencia de Mascotas;GARANTIAS
19255219;;M;26;CHILENO;;Z;CONSTITUCION                  ;MAULE;12963;2;1;0;0;0;2;1;12963;GM 1A X CTA SBI;GARANTIAS
13791897;;F;41;CHILENO;;X;CAUQUENES                     ;MAULE;853680;10;7;0;0;0;10;7;853680;Asistencia Salud Integral Familia;GARANTIAS
6347077;;F;74;CHILENO;;Silencioso;"";"";586300;7;10;0;0;0;7;10;586300;Asistencia Programa Domiciliario;GARANTIAS
6628954;;F;70;CHILENO;;Silencioso;COQUIMBO                      ;COQUIMBO;836810;8;6;0;0;0;8;6;836810;Asistencia Salud Integral Familia;GARANTIAS
14193510;;F;41;CHILENO;;X;SAN BERNARDO;METROPOLITANA;52990;1;1;0;0;0;1;1;52990;Asistencia Salud Integral Familia;GARANTIAS
8057392;;M;64;CHILENO;;Boomers;COQUIMBO                      ;COQUIMBO;264950;5;3;0;0;0;5;3;264950;Asistencia Salud Integral Familia;GARANTIAS
26296904;Soltero;M;30;CHILENO;;Extranjero;SANTIAGO;METROPOLITANA;272970;3;2;2;1;219980;1;1;52990;Asistencia Salud Integral Familia;GARANTIAS
15583653;;M;39;CHILENO;;X;LA GRANJA;METROPOLITANA;52990;1;1;0;0;0;1;1;52990;Asistencia Salud Integral Familia;GARANTIAS
12183469;;M;49;CHILENO;;X;"";"";257970;3;3;1;1;129990;2;2;127980;Asistencia Salud Integral Familia;GARANTIAS
16090136;;M;37;CHILENO;;Millenial;"";"";67230;3;3;0;0;0;3;3;67230;Asistencia Salud Integral Familia;GARANTIAS
13983564;;F;41;CHILENO;;X;CALERA                        ;VALPARAISO;71980;2;2;0;0;0;2;2;71980;Asistencia Salud Integral Familia;GARANTIAS
4326338;;M;83;CHILENO;;Silencioso;ARICA                         ;ARICA Y PARINACOTA;228950;5;5;0;0;0;5;5;228950;Asistencia Salud Integral Familia;GARANTIAS
11514659;;F;52;CHILENO;;X;SALAMANCA                     ;COQUIMBO;52990;1;1;0;0;0;1;1;52990;Asistencia Salud Integral Familia;GARANTIAS
26118758;;M;25;HAITIANO;;Extranjero;SAN BERNARDO                  ;METROPOLITANA;105980;2;2;0;0;0;2;2;105980;Asistencia Salud Integral Familia;GARANTIAS
26684868;;F;59;VENEZOLANO;;Extranjero;N/D;N/D;910760;4;5;0;0;0;4;5;910760;Asistencia Salud Integral Familia;GARANTIAS
11718748;;M;51;CHILENO;;X;QUELLON                       ;LOS LAGOS;1401840;15;4;0;0;0;15;4;1401840;Asistencia Programa Domiciliario;GARANTIAS
10697568;;F;55;CHILENO;;Boomers;VILLARICA                     ;ARAUCANIA;153860;3;3;0;0;0;3;3;153860;Asistencia Salud Integral Familia;GARANTIAS
12527679;;M;49;CHILENO;;X;PADRE LAS CASAS               ;ARAUCANIA;21062;3;1;0;0;0;3;1;21062;GM 1A X CTA SBI;GARANTIAS
7990905;;F;63;CHILENO;;Boomers;VALPARAISO                    ;VALPARAISO;71980;2;2;0;0;0;2;2;71980;Asistencia Salud Integral Familia;GARANTIAS
24582825;;F;44;PERUANO;;Extranjero;INDEPENDENCIA                 ;METROPOLITANA;411713;5;4;0;0;0;5;4;411713;Asistencia Salud Integral Familia;GARANTIAS
11439488;;M;53;CHILENO;;X;LA SERENA                     ;COQUIMBO;105980;2;1;0;0;0;2;1;105980;Asistencia Salud Integral Familia;GARANTIAS
18193280;;F;29;CHILENO;;Millenial;PROVIDENCIA                   ;METROPOLITANA;342962;4;3;2;1;273980;2;2;68982;Asistencia Salud Integral Familia;GARANTIAS
9278876;;M;59;CHILENO;;Boomers;PUERTO MONTT                  ;LOS LAGOS;52990;1;1;0;0;0;1;1;52990;Asistencia Programa Domiciliario;GARANTIAS
24278044;;F;47;PERUANO;;Extranjero;ALTO HOSPICIO;TARAPACA;790950;5;3;4;2;737960;1;1;52990;Asistencia Salud Integral Familia;GARANTIAS
9441208;;M;59;CHILENO;;Boomers;N/D;N/D;158970;3;2;0;0;0;3;2;158970;Asistencia Salud Integral Familia;GARANTIAS
25304659;;M;50;BOLIVIANO;;Extranjero;IQUIQUE                       ;TARAPACA;472960;4;3;0;0;0;4;3;472960;Asistencia Salud Integral Familia;GARANTIAS
22341992;;M;29;EXTRANJERO - NO INFORMA NACIONALIDAD;;Extranjero;SAN JOAQUIN                   ;METROPOLITANA;52990;1;1;0;0;0;1;1;52990;ASIST. FULL HOGAR Y AUTO INGRAL;GARANTIAS
15537974;;F;39;CHILENO;;X;"";"";52990;1;1;0;0;0;1;1;52990;Asistencia Programa Domiciliario;GARANTIAS
8613851;;F;61;CHILENO;;Boomers;PUTAENDO                      ;VALPARAISO;309970;3;2;0;0;0;3;2;309970;Asistencia Programa Domiciliario;GARANTIAS
9736932;;M;57;CHILENO;;Boomers;SAN FERNANDO                  ;L.G.B.OÂ´HIGGINS;706930;8;5;0;0;0;8;5;706930;Asistencia Salud Integral Familia;GARANTIAS
12799440;;F;47;CHILENO;;X;MELIPILLA                     ;METROPOLITANA;125970;3;3;0;0;0;3;3;125970;ASIST. FULL HOGAR Y AUTO INGRAL;GARANTIAS
7495131;;M;67;CHILENO;;Boomers;PEMUCO                        ;BIO BIO;69980;2;2;0;0;0;2;2;69980;Asistencia Salud Integral Familia;GARANTIAS
8818074;;M;59;CHILENO;;Boomers;VALPARAISO                    ;VALPARAISO;262960;4;4;0;0;0;4;4;262960;Asistencia Salud Integral Familia;GARANTIAS
7890238;;F;67;CHILENO;;Boomers;PROVIDENCIA                   ;METROPOLITANA;460469;8;4;0;0;0;8;4;460469;Asistencia Salud Integral Familia;GARANTIAS
11062711;;F;56;CHILENO;;Boomers;ARAUCO                        ;BIO BIO;105980;2;1;0;0;0;2;1;105980;Asistencia Salud Integral Familia;GARANTIAS
6659269;;M;70;CHILENO;;Silencioso;MULCHEN                       ;BIO BIO;211960;4;1;0;0;0;4;1;211960;Asistencia de Mascotas;GARANTIAS
14664579;;F;52;PERUANO;;Extranjero;N/D;N/D;464860;3;2;0;0;0;3;2;464860;Asistencia Salud Integral Familia;GARANTIAS
7558495;;M;65;CHILENO;;Boomers;GRANEROS                      ;L.G.B.OÂ´HIGGINS;52990;1;1;0;0;0;1;1;52990;Asistencia Programa Domiciliario;GARANTIAS
11339465;;F;54;CHILENO;;X;QUINTA NORMAL                 ;METROPOLITANA;483950;5;3;0;0;0;5;3;483950;Asistencia Salud Integral Familia;GARANTIAS
7302789;;M;63;CHILENO;;Boomers;ANTOFAGASTA                   ;ANTOFAGASTA;593800;8;5;0;0;0;8;5;593800;Asistencia de Mascotas;GARANTIAS
6108346;;M;72;CHILENO;;Silencioso;N/D;N/D;342980;2;2;0;0;0;2;2;342980;Asistencia Salud Integral Familia;GARANTIAS
15053618;;M;39;CHILENO;;X;"";"";52990;1;1;0;0;0;1;1;52990;ASIST. FULL HOGAR Y AUTO INGRAL;GARANTIAS
9632668;;F;62;CHILENO;;Boomers;PUENTE ALTO                   ;METROPOLITANA;52990;1;1;0;0;0;1;1;52990;Asistencia Programa Domiciliario;GARANTIAS
8270365;;M;63;CHILENO;;Boomers;CONSTITUCION                  ;MAULE;355920;8;4;0;0;0;8;4;355920;Asistencia Salud Integral Familia;GARANTIAS
13666984;;F;42;CHILENO;;X;PUDAHUEL                      ;METROPOLITANA;65782;2;2;0;0;0;2;2;65782;Asistencia Programa Domiciliario;GARANTIAS
10381453;;F;56;CHILENO;;Boomers;VINA DEL MAR                  ;VALPARAISO;52990;1;1;0;0;0;1;1;52990;Asistencia Salud Integral Familia;GARANTIAS
10792724;;M;56;CHILENO;;Boomers;SANTA MARIA                   ;VALPARAISO;1636850;15;9;0;0;0;15;9;1636850;Asistencia Salud Integral Familia;GARANTIAS
8444967;;M;63;CHILENO;;Boomers;PEDRO AGUIRRE CERDA           ;METROPOLITANA;53000;2;1;0;0;0;2;1;53000;Asistencia Programa Domiciliario;GARANTIAS
10158590;;F;57;CHILENO;;Boomers;SAN VICENTE                   ;L.G.B.OÂ´HIGGINS;118970;3;3;0;0;0;3;3;118970;Asistencia Salud Integral Familia;GARANTIAS
15680861;;M;44;CHILENO;;X;ANTOFAGASTA                   ;ANTOFAGASTA;52990;1;1;0;0;0;1;1;52990;Asistencia Programa Domiciliario;GARANTIAS
17570446;;M;32;CHILENO;;Millenial;CONCEPCION;BIO-BIO;53000;2;1;0;0;0;2;1;53000;Asistencia Programa Domiciliario;GARANTIAS
13803241;;M;42;CHILENO;;X;N/D;N/D;203750;4;3;0;0;0;4;3;203750;Asistencia Programa Domiciliario;GARANTIAS
27076611;Soltero;M;72;VENEZOLANO;;Extranjero;"";"";0;0;2;0;0;0;0;2;0;Asistencia Programa Domiciliario;GARANTIAS
9193397;;F;60;CHILENO;;Boomers;CORONEL                       ;BIO BIO;1168810;7;5;0;0;0;7;5;1168810;Asistencia Salud Integral Familia;GARANTIAS
8212979;;F;69;CHILENO;;Silencioso;SAN FERNANDO                  ;L.G.B.OÂ´HIGGINS;52990;1;1;0;0;0;1;1;52990;ASIST. FULL HOGAR Y AUTO INGRAL;GARANTIAS
15967062;;M;37;CHILENO;;Millenial;"";"";52990;1;1;0;0;0;1;1;52990;Asistencia Salud Integral Familia;GARANTIAS
8524235;;F;65;CHILENO;;Boomers;CASTRO                        ;LOS LAGOS;403970;3;2;0;0;0;3;2;403970;ASIST. FULL HOGAR Y AUTO INGRAL;GARANTIAS
6308692;;F;76;CHILENO;;Silencioso;LOS ANDES                     ;VALPARAISO;105980;2;2;0;0;0;2;2;105980;Asistencia Programa Domiciliario;GARANTIAS
7218565;;F;69;CHILENO;;Silencioso;MELIPILLA                     ;METROPOLITANA;279980;3;2;0;0;0;3;2;279980;Asistencia Salud Integral Familia;GARANTIAS
24450099;;F;36;COLOMBIANO;;Extranjero;ANTOFAGASTA                   ;ANTOFAGASTA;105980;2;1;0;0;0;2;1;105980;Asistencia Salud Integral Familia;GARANTIAS
5775620;;F;79;CHILENO;;Silencioso;N/D;N/D;1810510;17;14;5;2;693940;12;12;1116570;Asistencia de Mascotas;GARANTIAS
6136679;;M;73;CHILENO;;Silencioso;MELIPILLA                     ;METROPOLITANA;1489870;13;11;0;0;0;13;11;1489870;ASIST. FULL HOGAR Y AUTO INGRAL;GARANTIAS
8017365;;F;66;CHILENO;;Boomers;ANCUD                         ;LOS LAGOS;480950;5;4;0;0;0;5;4;480950;GM 1A X CTA SBI;GARANTIAS
7605834;;M;64;CHILENO;;Boomers;CAUQUENES                     ;MAULE;222980;2;2;0;0;0;2;2;222980;Asistencia Salud Integral Familia;GARANTIAS
6318260;;F;79;CHILENO;;Silencioso;ARAUCO                        ;BIO BIO;477630;6;5;0;0;0;6;5;477630;Asistencia Salud Integral Familia;GARANTIAS
20123820;;M;23;CHILENO;;Z;MELIPILLA                     ;METROPOLITANA;118440;3;2;0;0;0;3;2;118440;Asistencia Programa Domiciliario;GARANTIAS
19723077;;F;24;CHILENO;;Z;"";"";68200;3;1;0;0;0;3;1;68200;GPL 1A X CTA SBI;GARANTIAS
12380632;;M;48;CHILENO;;X;N/D;N/D;407960;5;3;0;0;0;5;3;407960;Asistencia Salud Integral Familia;GARANTIAS
9975516;;F;54;CHILENO;;Boomers;LA CISTERNA                   ;METROPOLITANA;52990;1;1;0;0;0;1;1;52990;Asistencia Salud Integral Familia;GARANTIAS
9421820;;F;60;CHILENO;;Boomers;OVALLE                        ;COQUIMBO;52990;1;1;0;0;0;1;1;52990;Asistencia Salud Integral Familia;GARANTIAS
4067224;;F;83;CHILENO;;Silencioso;SAN JAVIER                    ;MAULE;105980;2;1;0;0;0;2;1;105980;Asistencia Salud Integral Familia;GARANTIAS
7020550;;F;76;CHILENO;;Silencioso;COQUIMBO                      ;COQUIMBO;105980;2;2;0;0;0;2;2;105980;Asistencia Salud Integral Familia;GARANTIAS
10442724;;M;56;CHILENO;;Boomers;TENO                          ;MAULE;183930;7;5;0;0;0;7;5;183930;Asistencia Programa Domiciliario;GARANTIAS
6900941;;M;67;CHILENO;;Boomers;ANTOFAGASTA                   ;ANTOFAGASTA;302540;4;2;0;0;0;4;2;302540;Asistencia Programa Domiciliario;GARANTIAS
11366396;;F;53;CHILENO;;X;RANCAGUA                      ;L.G.B.OÂ´HIGGINS;142960;4;3;0;0;0;4;3;142960;Asistencia Salud Integral Familia;GARANTIAS
5771889;;F;80;CHILENO;;Silencioso;TOME                          ;BIO BIO;105980;2;1;0;0;0;2;1;105980;Asistencia Salud Integral Familia;GARANTIAS
17165765;;M;32;CHILENO;;Millenial;N/D;N/D;244560;3;2;0;0;0;3;2;244560;Asistencia Salud Integral Familia;GARANTIAS
6274008;;F;71;CHILENO;;Silencioso;SANTIAGO                      ;METROPOLITANA;0;0;2;0;0;0;0;2;0;Asistencia Salud Integral Familia;GARANTIAS
11925284;;F;50;CHILENO;;X;TEMUCO                        ;ARAUCANIA;52990;1;1;0;0;0;1;1;52990;Asistencia Salud Integral Familia;GARANTIAS
15742580;;F;38;CHILENO;;X;LOS ANDES                     ;VALPARAISO;259970;3;3;0;0;0;3;3;259970;Asistencia Salud Integral Familia;GARANTIAS
7096824;;M;67;CHILENO;;Boomers;VINA DEL MAR                  ;VALPARAISO;120310;9;2;0;0;0;9;2;120310;GPL 1A X CTA SBI;GARANTIAS
7666172;;M;66;CHILENO;;Boomers;VICTORIA                      ;ARAUCANIA;52990;1;1;0;0;0;1;1;52990;Asistencia Salud Integral Familia;GARANTIAS
9870516;;F;57;CHILENO;;Boomers;NOGALES                       ;VALPARAISO;882890;10;6;0;0;0;10;6;882890;Asistencia Salud Integral Familia;GARANTIAS
7825663;;F;66;CHILENO;;Boomers;BUIN                          ;METROPOLITANA;255730;7;3;0;0;0;7;3;255730;Asistencia Salud Integral Familia;GARANTIAS
12204415;;F;50;CHILENO;;X;SAN CARLOS                    ;BIO BIO;52990;1;1;0;0;0;1;1;52990;Asistencia Salud Integral Familia;GARANTIAS
7919083;;F;64;CHILENO;;Boomers;LA LIGUA                      ;VALPARAISO;347560;3;2;0;0;0;3;2;347560;Asistencia Salud Integral Familia;GARANTIAS
7497598;;F;68;CHILENO;;Silencioso;ARICA                         ;ARICA Y PARINACOTA;1158220;7;5;0;0;0;7;5;1158220;Asistencia Salud Integral Familia;GARANTIAS
22131276;;F;67;PERUANO;;Extranjero;SANTIAGO                      ;METROPOLITANA;405970;3;3;0;0;0;3;3;405970;Asistencia de Mascotas;GARANTIAS
12552356;;F;48;CHILENO;;X;COIHUECO                      ;BIO BIO;1242970;3;2;0;0;0;3;2;1242970;Asistencia Salud Integral Familia;GARANTIAS
11431481;;F;53;CHILENO;;X;RENCA                         ;METROPOLITANA;52990;1;1;0;0;0;1;1;52990;Asistencia Salud Integral Familia;GARANTIAS
19368926;;F;25;CHILENO;;Millenial;N/D;N/D;52990;1;1;0;0;0;1;1;52990;Asistencia Programa Domiciliario;GARANTIAS
11273150;;F;53;CHILENO;;X;SAN PEDRO                     ;METROPOLITANA;1002400;6;5;0;0;0;6;5;1002400;ASIST. FULL HOGAR Y AUTO INGRAL;GARANTIAS
11995615;;F;50;CHILENO;;X;CARTAGENA                     ;VALPARAISO;302970;3;3;0;0;0;3;3;302970;Asistencia Programa Domiciliario;GARANTIAS
20230442;;F;22;CHILENO;;Z;N/D;N/D;52990;1;1;0;0;0;1;1;52990;Asistencia Salud Integral Familia;GARANTIAS
15914523;;F;38;CHILENO;;Millenial;LEBU                          ;BIO BIO;215970;3;2;0;0;0;3;2;215970;Asistencia Salud Integral Familia;GARANTIAS
23928328;;F;45;PERUANO;;Extranjero;SANTIAGO                      ;METROPOLITANA;182960;4;3;0;0;0;4;3;182960;Asistencia Salud Integral Familia;GARANTIAS
8845763;Soltero;M;63;CHILENO;AGROINDUSTRIA;Millenial;N/D;N/D;14240;3;1;0;0;0;3;1;14240;GM 1A X CTA SBI;GARANTIAS
9442196;;M;60;CHILENO;;Boomers;TOME                          ;BIO BIO;52990;1;1;0;0;0;1;1;52990;Asistencia Salud Integral Familia;GARANTIAS
13220049;;F;44;CHILENO;;X;N/D;N/D;133970;3;3;0;0;0;3;3;133970;Asistencia Programa Domiciliario;GARANTIAS
7137522;;M;67;CHILENO;;Boomers;SANTA JUANA                   ;BIO BIO;158970;3;1;0;0;0;3;1;158970;Asistencia Salud Integral Familia;GARANTIAS
19535226;;F;25;CHILENO;;Z;SAN PABLO                     ;LOS LAGOS;140970;3;3;0;0;0;3;3;140970;Asistencia de Mascotas;GARANTIAS
6924593;;F;69;CHILENO;;Silencioso;CURARREHUE                    ;ARAUCANIA;52990;1;1;0;0;0;1;1;52990;Asistencia Salud Integral Familia;GARANTIAS
10236258;;M;58;CHILENO;;Boomers;LOS ANGELES                   ;BIO BIO;158970;3;1;0;0;0;3;1;158970;Asistencia Salud Integral Familia;GARANTIAS
18137699;;M;30;CHILENO;;Millenial;"";"";84980;2;2;0;0;0;2;2;84980;Asistencia Salud Integral Familia;GARANTIAS
16304439;;F;34;CHILENO;;Millenial;SAN CARLOS                    ;BIO BIO;201960;4;3;0;0;0;4;3;201960;Asistencia Salud Integral Familia;GARANTIAS
17994688;;F;39;CHILENO;;X;N/D;N/D;52990;1;1;0;0;0;1;1;52990;Asistencia Salud Integral Familia;GARANTIAS
11743876;;M;51;CHILENO;;X;"";"";52990;1;1;0;0;0;1;1;52990;Asistencia Salud Integral Familia;GARANTIAS
12595655;;M;48;CHILENO;;X;OVALLE                        ;COQUIMBO;52990;1;1;0;0;0;1;1;52990;Asistencia Salud Integral Familia;GARANTIAS
18831134;;M;28;CHILENO;;Millenial;PENALOLEN;METROPOLITANA;52990;1;1;0;0;0;1;1;52990;Asistencia Programa Domiciliario;GARANTIAS
6340604;;F;71;CHILENO;;Silencioso;ALTO HOSPICIO;TARAPACA;689950;5;3;0;0;0;5;3;689950;Asistencia Salud Integral Familia;GARANTIAS
24557854;;M;43;BOLIVIANO;;Extranjero;N/D;N/D;52990;1;1;0;0;0;1;1;52990;Asistencia Salud Integral Familia;GARANTIAS
6467808;Casado;M;71;CHILENO;INGENIERO AGRICOLA;Silencioso;PROVIDENCIA                   ;METROPOLITANA;26990;3;1;0;0;0;3;1;26990;GPL 1A X CTA SBI;GARANTIAS
19966732;;F;24;CHILENO;;Z;LAJA                          ;BIO BIO;970029;6;2;0;0;0;6;2;970029;Asistencia Salud Integral Familia;GARANTIAS
10599789;;F;53;CHILENO;;X;LITUECHE                      ;L.G.B.OÂ´HIGGINS;215450;4;3;0;0;0;4;3;215450;Asistencia Salud Integral Familia;GARANTIAS
8842772;;M;60;CHILENO;;Boomers;PROVIDENCIA                   ;METROPOLITANA;52990;1;1;0;0;0;1;1;52990;Asistencia Salud Integral Familia;GARANTIAS
25938655;Soltero;F;28;EXTRANJERO - NO INFORMA NACIONALIDAD;;Extranjero;"";"";52990;1;1;0;0;0;1;1;52990;Asistencia Programa Domiciliario;GARANTIAS
4920259;;M;78;CHILENO;;Silencioso;N/D;N/D;52990;1;1;0;0;0;1;1;52990;Asistencia Salud Integral Familia;GARANTIAS
7925676;;F;65;CHILENO;;Boomers;CHEPICA                       ;L.G.B.OÂ´HIGGINS;52990;1;1;0;0;0;1;1;52990;Asistencia Salud Integral Familia;GARANTIAS
6788076;;F;72;CHILENO;;Silencioso;ISLA DE MAIPO                 ;METROPOLITANA;92990;1;3;-1;1;-12990;2;2;105980;Asistencia Programa Domiciliario;GARANTIAS
11273025;;M;54;CHILENO;;X;N/D;N/D;52990;1;1;0;0;0;1;1;52990;Asistencia Salud Integral Familia;GARANTIAS
11402894;;F;53;CHILENO;;X;PUENTE ALTO                   ;METROPOLITANA;52990;1;1;0;0;0;1;1;52990;Asistencia Programa Domiciliario;GARANTIAS
4923641;;F;79;CHILENO;;Silencioso;SAN JAVIER                    ;MAULE;158970;3;2;0;0;0;3;2;158970;Asistencia Programa Domiciliario;GARANTIAS
8754154;;M;61;CHILENO;;Boomers;N/D;N/D;252980;2;2;0;0;0;2;2;252980;Asistencia Programa Domiciliario;GARANTIAS
5932182;;M;74;CHILENO;;Silencioso;VICTORIA                      ;ARAUCANIA;100870;2;2;0;0;0;2;2;100870;Asistencia Salud Integral Familia;GARANTIAS
10156795;;F;56;CHILENO;;Boomers;MAIPU                         ;METROPOLITANA;52990;1;1;0;0;0;1;1;52990;Asistencia Programa Domiciliario;GARANTIAS
15258932;;M;40;CHILENO;;Millenial;"";"";52990;1;1;0;0;0;1;1;52990;Asistencia Programa Domiciliario;GARANTIAS
5404690;;M;74;CHILENO;;Silencioso;LOS ANDES                     ;VALPARAISO;103970;3;2;0;0;0;3;2;103970;Asistencia Salud Integral Familia;GARANTIAS
7249529;;F;72;CHILENO;;Silencioso;LINARES                       ;MAULE;1030331;7;4;0;0;0;7;4;1030331;Asistencia Programa Domiciliario;GARANTIAS
12477528;;F;48;CHILENO;;X;RECOLETA;METROPOLITANA;52990;1;1;0;0;0;1;1;52990;Asistencia Programa Domiciliario;GARANTIAS
5737244;;M;73;CHILENO;;Silencioso;VINA DEL MAR                  ;VALPARAISO;293950;5;2;0;0;0;5;2;293950;Asistencia Salud Integral Familia;GARANTIAS
13692053;;M;43;CHILENO;;X;SANTA BARBARA                 ;BIO BIO;407950;5;4;0;0;0;5;4;407950;Asistencia Salud Integral Familia;GARANTIAS
11309387;;F;54;CHILENO;;X;LLANQUIHUE                    ;LOS LAGOS;112980;2;2;0;0;0;2;2;112980;Asistencia Programa Domiciliario;GARANTIAS
10598033;;F;54;CHILENO;;X;MAULLIN                       ;LOS LAGOS;215460;3;2;0;0;0;3;2;215460;Asistencia Programa Domiciliario;GARANTIAS
12397364;;M;49;CHILENO;;X;MONTE PATRIA                  ;COQUIMBO;208960;4;2;0;0;0;4;2;208960;Asistencia Salud Integral Familia;GARANTIAS
9615071;;M;59;CHILENO;;Boomers;PUDAHUEL                      ;METROPOLITANA;52990;1;1;0;0;0;1;1;52990;Asistencia Programa Domiciliario;GARANTIAS
8727630;;F;63;CHILENO;;Boomers;RENCA                         ;METROPOLITANA;52990;1;1;0;0;0;1;1;52990;Asistencia Salud Integral Familia;GARANTIAS
16730365;;F;34;CHILENO;;Millenial;TALCA                         ;MAULE;605960;4;2;0;0;0;4;2;605960;Asistencia Salud Integral Familia;GARANTIAS
8639819;;M;63;CHILENO;;Boomers;TALCA                         ;MAULE;105980;2;1;0;0;0;2;1;105980;Asistencia Salud Integral Familia;GARANTIAS
25453637;;M;32;HAITIANO;;Extranjero;N/D;N/D;52990;1;1;0;0;0;1;1;52990;Asistencia Programa Domiciliario;GARANTIAS
13405381;;M;44;CHILENO;;X;LA SERENA                     ;COQUIMBO;440808;8;3;0;0;0;8;3;440808;Asistencia Salud Integral Familia;GARANTIAS
11385983;;F;53;CHILENO;;X;VINA DEL MAR                  ;VALPARAISO;52990;1;1;0;0;0;1;1;52990;Asistencia Programa Domiciliario;GARANTIAS
26071214;;F;34;VENEZOLANO;;Extranjero;"";"";68670;3;2;2;1;15680;1;1;52990;Asistencia Programa Domiciliario;GARANTIAS
8465152;;F;64;CHILENO;;Boomers;TALCA                         ;MAULE;105980;2;1;0;0;0;2;1;105980;Asistencia Salud Integral Familia;GARANTIAS
12910950;;M;46;CHILENO;;X;PENALOLEN                     ;METROPOLITANA;357950;5;2;0;0;0;5;2;357950;Asistencia Programa Domiciliario;GARANTIAS
11749212;;F;51;CHILENO;;X;CHILLAN                       ;BIO BIO;52990;1;1;0;0;0;1;1;52990;Asistencia Salud Integral Familia;GARANTIAS
6922361;;M;66;CHILENO;;Boomers;PUDAHUEL                      ;METROPOLITANA;180460;3;2;0;0;0;3;2;180460;Asistencia Programa Domiciliario;GARANTIAS
18580143;;F;28;CHILENO;;Millenial;CALAMA                        ;ANTOFAGASTA;452960;4;3;2;1;259980;2;2;192980;Asistencia Salud Integral Familia;GARANTIAS
14405195;;F;43;CHILENO;;X;N/D;N/D;52990;1;1;0;0;0;1;1;52990;Asistencia Salud Integral Familia;GARANTIAS
26559002;;F;28;VENEZOLANO;;Extranjero;N/D;N/D;85980;2;2;0;0;0;2;2;85980;Asistencia Salud Integral Familia;GARANTIAS
14215067;;F;41;CHILENO;;X;TRAIGUEN                      ;ARAUCANIA;52990;1;1;0;0;0;1;1;52990;Asistencia Salud Integral Familia;GARANTIAS
5739340;;F;76;CHILENO;;Silencioso;N/D;N/D;105980;2;1;0;0;0;2;1;105980;Asistencia Programa Domiciliario;GARANTIAS
12304760;;M;50;CHILENO;;X;ALTO HOSPICIO;TARAPACA;52990;1;1;0;0;0;1;1;52990;Asistencia Programa Domiciliario;GARANTIAS
16882588;;F;34;CHILENO;;Millenial;N/D;N/D;100870;2;2;0;0;0;2;2;100870;Asistencia Salud Integral Familia;GARANTIAS
7655803;;M;63;CHILENO;;Boomers;PROVIDENCIA                   ;METROPOLITANA;52990;1;1;0;0;0;1;1;52990;Asistencia Salud Integral Familia;GARANTIAS
24320549;;F;45;BOLIVIANO;;Extranjero;LO BARNECHEA                  ;METROPOLITANA;47880;1;1;0;0;0;1;1;47880;ASIS. SALUD X CTA ASSISTIME;GARANTIAS
6689075;;F;75;CHILENO;;Silencioso;VILLARICA                     ;ARAUCANIA;52990;1;1;0;0;0;1;1;52990;Asistencia Salud Integral Familia;GARANTIAS
8101603;;F;61;CHILENO;;Boomers;MACHALI                       ;L.G.B.OÂ´HIGGINS;52990;1;1;0;0;0;1;1;52990;Asistencia Salud Integral Familia;GARANTIAS
13263093;;F;44;CHILENO;;X;N/D;N/D;323350;4;2;0;0;0;4;2;323350;Asistencia Programa Domiciliario;GARANTIAS
24230741;;M;33;PERUANO;;Extranjero;SANTIAGO                      ;METROPOLITANA;52990;1;1;0;0;0;1;1;52990;Asistencia Salud Integral Familia;GARANTIAS
17012387;;M;33;CHILENO;;Millenial;N/D;N/D;52990;1;1;0;0;0;1;1;52990;Asistencia Programa Domiciliario;GARANTIAS
14117216;;M;41;CHILENO;;X;LA SERENA                     ;COQUIMBO;105980;2;2;0;0;0;2;2;105980;Asistencia Salud Integral Familia;GARANTIAS
9005504;;F;63;CHILENO;;Boomers;N/D;N/D;495350;4;2;0;0;0;4;2;495350;Asistencia Programa Domiciliario;GARANTIAS
11945934;;M;50;CHILENO;;X;N/D;N/D;242382;2;2;0;0;0;2;2;242382;Asistencia Programa Domiciliario;GARANTIAS
19972695;;F;23;CHILENO;;Millenial;"";"";52990;1;1;0;0;0;1;1;52990;Asistencia Salud Integral Familia;GARANTIAS
20017168;;M;23;CHILENO;;Z;VALDIVIA                      ;LOS RIOS;261530;3;2;2;1;208540;1;1;52990;Asistencia Salud Integral Familia;GARANTIAS
13475523;;F;44;CHILENO;;X;N/D;N/D;497950;5;4;2;1;184980;3;3;312970;Asistencia Salud Integral Familia;GARANTIAS
25486855;;M;31;COLOMBIANO;;Extranjero;N/D;N/D;105980;2;1;0;0;0;2;1;105980;Asistencia Programa Domiciliario;GARANTIAS
16001709;;F;37;CHILENO;;Millenial;N/D;N/D;350930;8;5;0;0;0;8;5;350930;Asistencia Salud Integral Familia;GARANTIAS
19451321;;M;25;CHILENO;;Z;N/D;N/D;52990;1;1;0;0;0;1;1;52990;Asistencia Salud Integral Familia;GARANTIAS
18504027;;F;32;CHILENO;;Millenial;FREIRE                        ;ARAUCANIA;92980;3;1;0;0;0;3;1;92980;Asistencia Programa Domiciliario;GARANTIAS
15553651;;M;39;CHILENO;;X;PROVIDENCIA                   ;METROPOLITANA;59990;1;1;0;0;0;1;1;59990;Asistencia Salud Integral Familia;GARANTIAS
14448260;;F;51;CHILENO;;X;LOS ANGELES                   ;BIO BIO;54990;1;1;0;0;0;1;1;54990;Asistencia Salud Integral Familia;GARANTIAS
16988373;;M;33;CHILENO;;Millenial;N/D;N/D;52990;1;1;0;0;0;1;1;52990;Asistencia Salud Integral Familia;GARANTIAS
6794454;;M;63;CHILENO;;Boomers;LOS ALAMOS                    ;BIO BIO;105980;2;1;0;0;0;2;1;105980;Asistencia Salud Integral Familia;GARANTIAS
25505165;;F;49;COLOMBIANO;;Extranjero;CERRO NAVIA                   ;METROPOLITANA;52990;1;1;0;0;0;1;1;52990;Asistencia Salud Integral Familia;GARANTIAS
8766619;;M;61;CHILENO;;Boomers;OSORNO                        ;LOS LAGOS;127970;3;3;0;0;0;3;3;127970;Asistencia Programa Domiciliario;GARANTIAS
26509814;;M;28;VENEZOLANO;;Extranjero;N/D;N/D;52990;1;1;0;0;0;1;1;52990;Asistencia Programa Domiciliario;GARANTIAS
6685791;;M;72;CHILENO;;Silencioso;LEBU                          ;BIO BIO;105980;2;1;0;0;0;2;1;105980;Asistencia Salud Integral Familia;GARANTIAS
19508597;;F;25;CHILENO;;Z;N/D;N/D;52990;1;1;0;0;0;1;1;52990;Asistencia Salud Integral Familia;GARANTIAS
18972632;;F;27;CHILENO;;Millenial;CALLE LARGA;VALPARAISO;52990;1;1;0;0;0;1;1;52990;Asistencia Salud Integral Familia;GARANTIAS
16580056;;F;35;CHILENO;;Millenial;N/D;N/D;308862;3;3;0;0;0;3;3;308862;ASIS. SALUD X CTA ASSISTIME;GARANTIAS
8687679;;M;64;CHILENO;;Boomers;N/D;N/D;55080;1;1;0;0;0;1;1;55080;Asistencia Programa Domiciliario;GARANTIAS
5601582;;F;72;CHILENO;;Silencioso;CASTRO                        ;LOS LAGOS;47973;2;1;0;0;0;2;1;47973;GPL 1A X CTA SBI;GARANTIAS
12880141;;M;47;CHILENO;;X;LAS CONDES                    ;METROPOLITANA;32990;1;1;0;0;0;1;1;32990;ASISTENCIA HOGAR;GARANTIAS
9399142;;M;58;CHILENO;;Boomers;MAULLIN                       ;LOS LAGOS;82870;2;1;0;0;0;2;1;82870;ASIS. SALUD X CTA ASSISTIME;GARANTIAS
18318164;;F;29;CHILENO;;Millenial;N/D;N/D;51760;5;1;0;0;0;5;1;51760;GPL 1A X CTA SBI;GARANTIAS
7656746;;M;64;CHILENO;;Boomers;TEMUCO                        ;ARAUCANIA;47880;1;1;0;0;0;1;1;47880;ASIS. SALUD X CTA ASSISTIME;GARANTIAS
5763314;;F;76;CHILENO;;Silencioso;CHILLAN                       ;BIO BIO;47880;1;1;0;0;0;1;1;47880;ASIS. SALUD X CTA ASSISTIME;GARANTIAS
8598019;;F;66;CHILENO;;Boomers;LONCOCHE                      ;ARAUCANIA;47880;1;1;0;0;0;1;1;47880;ASIS. SALUD X CTA ASSISTIME;GARANTIAS
4775485;;M;73;CHILENO;;Silencioso;BULNES                        ;BIO BIO;47880;1;1;0;0;0;1;1;47880;ASIS. SALUD X CTA ASSISTIME;GARANTIAS
13983099;;M;41;CHILENO;;X;N/D;N/D;47880;1;1;0;0;0;1;1;47880;ASIS. SALUD X CTA ASSISTIME;GARANTIAS
19272768;;M;25;CHILENO;;Z;CONSTITUCION                  ;MAULE;47880;1;1;0;0;0;1;1;47880;ASIS. SALUD X CTA ASSISTIME;GARANTIAS
13538178;;M;43;CHILENO;;X;PETORCA                       ;VALPARAISO;47880;1;1;0;0;0;1;1;47880;ASIS. SALUD X CTA ASSISTIME;GARANTIAS
10193426;;F;56;CHILENO;;Boomers;RIO NEGRO                     ;LOS LAGOS;47880;1;1;0;0;0;1;1;47880;ASIS. SALUD X CTA ASSISTIME;GARANTIAS
20113324;;M;23;CHILENO;;Z;N/D;N/D;47880;1;1;0;0;0;1;1;47880;ASIS. SALUD X CTA ASSISTIME;GARANTIAS
25289159;;F;56;COLOMBIANO;;Extranjero;SANTIAGO                      ;METROPOLITANA;47880;1;1;0;0;0;1;1;47880;ASIS. SALUD X CTA ASSISTIME;GARANTIAS
9605092;;F;58;CHILENO;;Boomers;PUDAHUEL                      ;METROPOLITANA;47880;1;1;0;0;0;1;1;47880;ASIS. SALUD X CTA ASSISTIME;GARANTIAS
8239217;;F;67;CHILENO;;Boomers;N/D;N/D;47880;1;1;0;0;0;1;1;47880;ASIS. SALUD X CTA ASSISTIME;GARANTIAS
10445918;;M;56;CHILENO;;Boomers;N/D;N/D;55080;1;1;0;0;0;1;1;55080;Asistencia Programa Domiciliario;GARANTIAS
26744201;;F;41;VENEZOLANO;;Extranjero;N/D;N/D;0;0;0;0;0;0;0;0;0;ASIS. SALUD X CTA ASSISTIME;GARANTIAS
14673860;;M;52;EXTRANJERO - NO INFORMA NACIONALIDAD;;X;"";"";0;0;0;0;0;0;0;0;0;ASIS. SALUD X CTA ASSISTIME;GARANTIAS
7652336;;M;65;CHILENO;;Millenial;"";"";0;0;0;0;0;0;0;0;0;ASIS. SALUD X CTA ASSISTIME;GARANTIAS
26258813;;M;49;EXTRANJERO - NO INFORMA NACIONALIDAD;;Extranjero;RECOLETA                      ;METROPOLITANA;0;0;0;0;0;0;0;0;0;ASIS. SALUD X CTA ASSISTIME;GARANTIAS
11778678;;F;50;CHILENO;;X;N/D;N/D;0;0;0;0;0;0;0;0;0;ASIS. SALUD X CTA ASSISTIME;GARANTIAS
12582542;;F;47;CHILENO;;X;CALAMA                        ;ANTOFAGASTA;0;0;0;0;0;0;0;0;0;ASIS. SALUD X CTA ASSISTIME;GARANTIAS
26089977;;F;43;VENEZOLANO;;Extranjero;HUALANE                       ;MAULE;0;0;0;0;0;0;0;0;0;ASIS. SALUD X CTA ASSISTIME;GARANTIAS
10886140;;M;55;CHILENO;;Boomers;TOME                          ;BIO BIO;0;0;0;0;0;0;0;0;0;ASIS. SALUD X CTA ASSISTIME;GARANTIAS
10839033;;M;55;CHILENO;;Boomers;RANCAGUA                      ;L.G.B.OÂ´HIGGINS;0;0;0;0;0;0;0;0;0;ASIS. SALUD X CTA ASSISTIME;GARANTIAS
16851179;;M;34;CHILENO;;Z;N/D;N/D;0;0;0;0;0;0;0;0;0;ASIS. SALUD X CTA ASSISTIME;GARANTIAS
10469641;;M;53;CHILENO;;X;RENCA                         ;METROPOLITANA;0;0;0;0;0;0;0;0;0;GM 1A X CTA SBI;GARANTIAS
13462779;;F;49;CHILENO;;X;LA REINA                      ;METROPOLITANA;0;0;0;0;0;0;0;0;0;ASIS. SALUD X CTA ASSISTIME;GARANTIAS
23701441;;F;58;PERUANO;;Extranjero;N/D;N/D;0;0;0;0;0;0;0;0;0;ASIS. SALUD X CTA ASSISTIME;GARANTIAS
24289981;;F;55;BOLIVIANO;;Extranjero;ANTOFAGASTA                   ;ANTOFAGASTA;0;0;0;0;0;0;0;0;0;ASIS. SALUD X CTA ASSISTIME;GARANTIAS
27040081;;F;31;VENEZOLANO;;Extranjero;TOME                          ;BIO BIO;0;0;0;0;0;0;0;0;0;ASIS. SALUD X CTA ASSISTIME;GARANTIAS
13654573;;F;42;CHILENO;;X;QUILPUE                       ;VALPARAISO;0;0;0;0;0;0;0;0;0;GM 1A X CTA SBI;GARANTIAS
16733698;Soltero;M;34;CHILENO;;Millenial;VALLENAR;ATACAMA;0;0;0;0;0;0;0;0;0;GM 3A X CTA SBI;GARANTIAS
9671431;;F;58;CHILENO;;Boomers;SAN BERNARDO                  ;METROPOLITANA;0;0;0;0;0;0;0;0;0;GM ACCES X CTA SBI;GARANTIAS
5334689;;F;80;CHILENO;;Silencioso;MOSTAZAL                      ;L.G.B.OÂ´HIGGINS;0;0;0;0;0;0;0;0;0;ASIS. SALUD X CTA ASSISTIME;GARANTIAS
6680711;;F;76;CHILENO;;Silencioso;CANETE                        ;BIO BIO;0;0;0;0;0;0;0;0;0;ASIS. SALUD X CTA ASSISTIME;GARANTIAS
18491429;;F;29;CHILENO;;Millenial;N/D;N/D;0;0;0;0;0;0;0;0;0;ASIS. SALUD X CTA ASSISTIME;GARANTIAS
15895022;;M;38;CHILENO;;Millenial;OSORNO                        ;LOS LAGOS;0;0;0;0;0;0;0;0;0;ASIS. SALUD X CTA ASSISTIME;GARANTIAS
8872039;;F;61;CHILENO;;Boomers;N/D;N/D;0;0;0;0;0;0;0;0;0;ASIS. SALUD X CTA ASSISTIME;GARANTIAS
19301407;;M;26;CHILENO;;Z;COQUIMBO                      ;COQUIMBO;0;0;0;0;0;0;0;0;0;ASIS. SALUD X CTA ASSISTIME;GARANTIAS
6902395;;F;66;CHILENO;;Boomers;CHILLAN                       ;BIO BIO;0;0;0;0;0;0;0;0;0;ASIS. SALUD X CTA ASSISTIME;GARANTIAS
7498389;;F;65;CHILENO;;Boomers;ARICA                         ;ARICA Y PARINACOTA;0;0;0;0;0;0;0;0;0;ASIS. SALUD X CTA ASSISTIME;GARANTIAS
19266679;;F;27;CHILENO;;Millenial;N/D;N/D;0;0;0;0;0;0;0;0;0;ASIS. SALUD X CTA ASSISTIME;GARANTIAS
6151259;;F;71;CHILENO;;Silencioso;LLAILLAY                      ;VALPARAISO;0;0;0;0;0;0;0;0;0;ASIS. SALUD X CTA ASSISTIME;GARANTIAS
23999940;;M;24;BOLIVIANO;;Extranjero;N/D;N/D;0;0;0;0;0;0;0;0;0;ASIS. SALUD X CTA ASSISTIME;GARANTIAS
7218656;;F;67;CHILENO;;Boomers;PUENTE ALTO                   ;METROPOLITANA;0;0;0;0;0;0;0;0;0;ASIS. SALUD X CTA ASSISTIME;GARANTIAS
10204781;;M;56;CHILENO;;Boomers;LA SERENA                     ;COQUIMBO;0;0;0;0;0;0;0;0;0;ASIS. SALUD X CTA ASSISTIME;GARANTIAS
6576262;;F;68;CHILENO;;Silencioso;MELIPILLA                     ;METROPOLITANA;0;0;0;0;0;0;0;0;0;ASIS. SALUD X CTA ASSISTIME;GARANTIAS
10267586;;F;58;CHILENO;;Boomers;VICTORIA                      ;ARAUCANIA;0;0;0;0;0;0;0;0;0;ASIS. SALUD X CTA ASSISTIME;GARANTIAS
9925893;;F;57;CHILENO;;Boomers;CALAMA                        ;ANTOFAGASTA;0;0;0;0;0;0;0;0;0;TARIFA NORMAL;GARANTIAS
23698106;;F;47;PERUANO;;Extranjero;HUARA                         ;TARAPACA;0;0;0;0;0;0;0;0;0;ASIS. SALUD X CTA ASSISTIME;GARANTIAS
24893901;;M;36;PERUANO;;Extranjero;CONCHALI                      ;METROPOLITANA;0;0;0;0;0;0;0;0;0;ASIS. SALUD X CTA ASSISTIME;GARANTIAS
11883742;;M;51;CHILENO;;X;QUEMCHI                       ;LOS LAGOS;0;0;0;0;0;0;0;0;0;ASIS. SALUD X CTA ASSISTIME;GARANTIAS
16367594;;M;35;CHILENO;;Millenial;"";"";0;0;0;0;0;0;0;0;0;ASIS. SALUD X CTA ASSISTIME;GARANTIAS
10752624;;F;53;CHILENO;;X;MEJILLONES                    ;ANTOFAGASTA;0;0;0;0;0;0;0;0;0;GM 1A X CTA SBI;GARANTIAS
13502041;;F;44;CHILENO;;X;N/D;N/D;0;0;0;0;0;0;0;0;0;ASIS. SALUD X CTA ASSISTIME;GARANTIAS
12768495;;M;47;CHILENO;;X;LAJA                          ;BIO BIO;0;0;0;0;0;0;0;0;0;ASIS. SALUD X CTA ASSISTIME;GARANTIAS
6669888;;F;69;CHILENO;;Silencioso;PALMILLA                      ;L.G.B.OÂ´HIGGINS;0;0;0;0;0;0;0;0;0;GM 1A X CTA SBI;GARANTIAS
24431601;;M;40;COLOMBIANO;;Extranjero;ANTOFAGASTA                   ;ANTOFAGASTA;0;0;0;0;0;0;0;0;0;ASIS. SALUD X CTA ASSISTIME;GARANTIAS
19848301;;M;24;CHILENO;;Z;EL MONTE                      ;METROPOLITANA;0;0;0;0;0;0;0;0;0;ASIS. SALUD X CTA ASSISTIME;GARANTIAS
5457322;;M;77;CHILENO;;Silencioso;MAIPU                         ;METROPOLITANA;0;0;0;0;0;0;0;0;0;ASIS. SALUD X CTA ASSISTIME;GARANTIAS
13754103;;F;42;CHILENO;;X;CABILDO                       ;VALPARAISO;0;0;0;0;0;0;0;0;0;ASIS. SALUD X CTA ASSISTIME;GARANTIAS
8644930;;F;79;CHILENO;;Silencioso;SANTA CRUZ                    ;L.G.B.OÂ´HIGGINS;0;0;0;0;0;0;0;0;0;ASIS. SALUD X CTA ASSISTIME;GARANTIAS
8590457;;M;63;CHILENO;;Boomers;MOLINA                        ;MAULE;0;0;0;0;0;0;0;0;0;GM 1A X CTA SBI;GARANTIAS
9553300;;F;59;CHILENO;;Boomers;N/D;N/D;0;0;0;0;0;0;0;0;0;ASIS. SALUD X CTA ASSISTIME;GARANTIAS
6474112;;M;72;CHILENO;;Silencioso;MAULLIN                       ;LOS LAGOS;0;0;0;0;0;0;0;0;0;ASIS. SALUD X CTA ASSISTIME;GARANTIAS
12197430;;F;50;CHILENO;;X;ALTO HOSPICIO;TARAPACA;0;0;0;0;0;0;0;0;0;GM 1A X CTA SBI;GARANTIAS
11304653;;M;53;CHILENO;;X;PUCON                         ;ARAUCANIA;0;0;0;0;0;0;0;0;0;ASIS. SALUD X CTA ASSISTIME;GARANTIAS
5169053;;F;74;CHILENO;;Silencioso;MAIPU                         ;METROPOLITANA;0;0;0;0;0;0;0;0;0;ASIS. SALUD X CTA ASSISTIME;GARANTIAS
9499916;;M;59;CHILENO;;Boomers;N/D;N/D;0;0;0;0;0;0;0;0;0;ASIS. SALUD X CTA ASSISTIME;GARANTIAS
15354545;;F;39;CHILENO;;X;RENGO                         ;L.G.B.OÂ´HIGGINS;338523;6;2;0;0;0;6;2;338523;CELULAR VIVO Y21S 128GB BLANCO WOM;TELEFONIA
5853051;;M;74;CHILENO;;Silencioso;ARICA                         ;ARICA Y PARINACOTA;214980;2;2;0;0;0;2;2;214980;CELULAR VIVO Y15S BLUE MOVISTAR;TELEFONIA
11154437;;F;55;CHILENO;;Boomers;LOS ANGELES                   ;BIO BIO;219980;2;2;0;0;0;2;2;219980;CELULAR VIVO Y01 AZUL ZAFIRO OPEN;TELEFONIA
15490748;;F;38;CHILENO;;X;"";"";338970;4;3;0;0;0;4;3;338970;CELULAR Moto G20 Rosado WOM;TELEFONIA
11278353;;M;54;CHILENO;;X;SAN VICENTE                   ;L.G.B.OÂ´HIGGINS;339990;1;1;0;0;0;1;1;339990;CELULAR MOTO G100 128GB VERDE BOREAL + HMDI OPEN;TELEFONIA
13152196;Soltero;F;44;CHILENO;;X;PROVIDENCIA                   ;METROPOLITANA;163980;2;1;0;0;0;2;1;163980;CELULAR NOKIA G21 AZUL TRI WOM;TELEFONIA
17536884;;F;32;CHILENO;;Millenial;PROVIDENCIA                   ;METROPOLITANA;69990;2;1;0;0;0;2;1;69990;CELULAR GALAXY A03 4+128GB BLACK OPEN;TELEFONIA
24685102;;F;39;FILIPINO;;Extranjero;SANTIAGO                      ;METROPOLITANA;175010;3;1;0;0;0;3;1;175010;CELULAR GALAXY A33 5G 6+128GB ORANGE OPEN;TELEFONIA
12069450;;F;53;CHILENO;;X;TALTAL                        ;ANTOFAGASTA;239970;3;3;0;0;0;3;3;239970;CELULAR VIVO Y01 AZUL ZAFIRO OPEN;TELEFONIA
13722012;Soltero;M;43;CHILENO;;X;PROVIDENCIA                   ;METROPOLITANA;154980;2;2;0;0;0;2;2;154980;CELULAR VIVO Y15S WAVE GREEN OPEN;TELEFONIA
15646241;;M;34;CHILENO;;Millenial;RENCA                         ;METROPOLITANA;190140;2;1;0;0;0;2;1;190140;CELULAR GALAXY A33 5G 6+128GB ORANGE OPEN;TELEFONIA
13404054;;M;48;CHILENO;;X;RENCA                         ;METROPOLITANA;307103;7;4;0;0;0;7;4;307103;CELULAR VIVO Y21S 128GB BLANCO WOM;TELEFONIA
6758964;;M;69;CHILENO;;Silencioso;LINARES                       ;MAULE;99990;3;1;0;0;0;3;1;99990;CELULAR GALAXY A03 4+64GB BLACK OPEN;TELEFONIA
4504682;;M;75;CHILENO;;Silencioso;QUILLOTA                      ;VALPARAISO;49990;1;3;0;0;0;1;3;49990;Celular SA3 CLARO DIRECTO BLACK;TELEFONIA
17038630;;M;33;CHILENO;;Millenial;VALLENAR;ATACAMA;469960;4;4;0;0;0;4;4;469960;CELULAR GALAXY A53 5G 6+128GB BLACK;TELEFONIA
25543309;;M;51;COLOMBIANO;;Extranjero;CERRILLOS                     ;METROPOLITANA;139990;2;1;0;0;0;2;1;139990;CELULAR GALAXY A23 6+128GB BLACK OPEN;TELEFONIA
18144626;;M;30;CHILENO;;Millenial;PROVIDENCIA                   ;METROPOLITANA;129990;1;1;1;1;129990;0;0;0;CELULAR MOTO G31 4/128 GB GRIS METEORITO OPEN;TELEFONIA
5597454;;F;74;CHILENO;;Silencioso;VINA DEL MAR                  ;VALPARAISO;214630;3;2;0;0;0;3;2;214630;CELULAR GALAXY A13 4+128GB LIGHT BLUE OPEN;TELEFONIA
17074575;;F;33;CHILENO;;Millenial;PROVIDENCIA                   ;METROPOLITANA;149990;1;1;0;0;0;1;1;149990;CELULAR GALAXY A23 6+128GB BLACK OPEN;TELEFONIA
15235587;;F;39;CHILENO;;X;MELIPILLA                     ;METROPOLITANA;1210920;10;5;2;1;263980;8;4;946940;CELULAR GALAXY A53 5G 6+128GB WHITE;TELEFONIA
4285649;;M;85;CHILENO;;Silencioso;LO PRADO                      ;METROPOLITANA;334290;6;3;0;0;0;6;3;334290;CELULAR XIAOMI REDMI 9A 2/32GB GRANITE GRAY;TELEFONIA
19025734;;F;27;CHILENO;;Millenial;N/D;N/D;383970;4;2;4;2;383970;0;0;0;IPHONE XR 64GB LIB OPEN NEGRO;TELEFONIA
10388075;;M;57;CHILENO;;Boomers;PANGUIPULLI                   ;LOS RIOS;869120;6;4;0;0;0;6;4;869120;IPHONE 11 64GB BLACK CLARO;TELEFONIA
10339870;Casado;F;54;CHILENO;;X;PROVIDENCIA                   ;METROPOLITANA;244980;2;1;2;1;244980;0;0;0;CELULAR REDMI NOTE 10 5G 4/128GB GRAPHITE GRAY O;TELEFONIA
26288489;;M;23;VENEZOLANO;;Extranjero;ANTOFAGASTA                   ;ANTOFAGASTA;229970;3;2;2;1;74980;1;1;154990;CELULAR VIVO Y21S 128GB BLANCO WOM;TELEFONIA
7948333;;M;65;CHILENO;;Boomers;PROVIDENCIA                   ;METROPOLITANA;67133;2;1;0;0;0;2;1;67133;CELULAR VIVO Y21S 128GB BLANCO WOM;TELEFONIA
20731405;;F;21;CHILENO;;Z;MELIPILLA;METROPOLITANA;129990;1;1;0;0;0;1;1;129990;CELULAR MOTO G22 64GB AZUL OPEN;TELEFONIA
7270285;;F;67;CHILENO;;Boomers;OVALLE                        ;COQUIMBO;169970;4;3;0;0;0;4;3;169970;CELULAR XIAOMI REDMI 9A 2/32GB GRANITE GRAY;TELEFONIA
16734118;;F;35;CHILENO;;Millenial;CHILLAN                       ;BIO BIO;94990;2;1;0;0;0;2;1;94990;CELULAR MOTOROLA G20 EDICION ESPECIAL VERDE CLAR;TELEFONIA
10169228;;M;58;CHILENO;;Boomers;LONGAVI                       ;MAULE;46993;2;1;0;0;0;2;1;46993;Celular SA3 CLARO DIRECTO BLACK;TELEFONIA
10336700;;F;56;CHILENO;;Boomers;RENCA                         ;METROPOLITANA;204980;5;2;0;0;0;5;2;204980;CELULAR VIVO Y21S 128GB BLANCO WOM;TELEFONIA
9237967;;F;60;CHILENO;;Boomers;RANCAGUA                      ;L.G.B.OÂ´HIGGINS;756960;8;5;0;0;0;8;5;756960;CELULAR GALAXY A03 CORE 2GB 32GB BLUE OPEN;TELEFONIA
26841096;;M;45;VENEZOLANO;;Extranjero;TALAGANTE                     ;METROPOLITANA;339980;2;1;2;1;339980;0;0;0;CELULAR POCO M4 PRO 128GB COOL BLUE OPEN;TELEFONIA
16249962;;F;36;CHILENO;;Millenial;COPIAPO                       ;ATACAMA;89990;1;1;1;1;89990;0;0;0;SMARTPHONE A03S AZUL 32GB;TELEFONIA
13647822;;F;42;CHILENO;;X;N/D;N/D;594970;4;2;2;1;314980;2;1;279990;CELULAR GALAXY A53 5G 6+128GB ORANGE;TELEFONIA
9086036;;F;61;CHILENO;;Boomers;ARAUCO                        ;BIO BIO;350130;3;3;0;0;0;3;3;350130;CELULAR REDMI NOTE 11 4/128GB GRAPHITE GRAY OPEN;TELEFONIA
24862580;;F;33;BOLIVIANO;;Extranjero;N/D;N/D;877930;7;5;4;2;317960;3;3;559970;CELULAR GALAXY A13 4+128GB LIGHT BLUE OPEN;TELEFONIA
12819437;;F;47;CHILENO;;X;CATEMU                        ;VALPARAISO;159990;2;1;0;0;0;2;1;159990;CELULAR GALAXY A13 4+128GB BLACK;TELEFONIA
14307393;;F;47;CHILENO;;X;N/D;N/D;303970;3;2;3;2;303970;0;0;0;SMARTPHONE A22 BLANCO 128GB;TELEFONIA
15149437;Soltero;F;39;CHILENO;;X;SAN JAVIER                    ;MAULE;237103;5;3;0;0;0;5;3;237103;CELULAR VIVO Y21S 128GB BLANCO WOM;TELEFONIA
16167076;Soltero;F;36;CHILENO;;Millenial;RENCA                         ;METROPOLITANA;123970;3;2;2;1;43980;1;1;79990;CELULAR BMOBILE AX1076 PRO BUNDLE;TELEFONIA
25705096;;M;47;COLOMBIANO;;Extranjero;N/D;N/D;373970;3;2;2;1;123980;1;1;249990;CELULAR REDMI 10A US 32GB CHROME SILVER OPEN;TELEFONIA
13396265;;F;44;CHILENO;;X;NUEVA IMPERIAL                ;ARAUCANIA;1178910;9;5;0;0;0;9;5;1178910;CELULAR VIVO Y53S AZUL ENTEL;TELEFONIA
15197381;;M;40;CHILENO;;X;CURANILAHUE                   ;BIO BIO;99990;1;1;0;0;0;1;1;99990;CELULAR GALAXY A03 4+64GB BLACK OPEN;TELEFONIA
25723675;Soltero;M;43;VENEZOLANO;;Extranjero;PROVIDENCIA                   ;METROPOLITANA;747960;4;2;4;2;747960;0;0;0;CELULAR XIAOMI 11T 8/256GB CELESTIAL BLUE OPEN;TELEFONIA
12185206;;F;50;CHILENO;;X;RENCA                         ;METROPOLITANA;307970;5;5;0;0;0;5;5;307970;CELULAR VIVO Y20 BLACK 64GB MOVISTAR;TELEFONIA
15675519;;M;39;CHILENO;;X;PROVIDENCIA                   ;METROPOLITANA;159990;1;1;1;1;159990;0;0;0;CELULAR A32 128 GB BLUE OPEN;TELEFONIA
7136121;;F;67;CHILENO;;Boomers;QUINCHAO                      ;LOS LAGOS;144990;1;1;0;0;0;1;1;144990;CELULAR MOTO G22 128GB NEGRO WOM;TELEFONIA
8927673;;F;60;CHILENO;;Boomers;PROVIDENCIA                   ;METROPOLITANA;432970;3;2;0;0;0;3;2;432970;CELULAR GALAXY A13 4+128GB BLACK;TELEFONIA
5205980;;F;75;CHILENO;;Silencioso;N/D;N/D;1052250;4;6;1;1;199990;3;5;852260;CELULAR VIVO Y01 AZUL ZAFIRO OPEN;TELEFONIA
6410503;;M;71;CHILENO;;Silencioso;ANCUD                         ;LOS LAGOS;977323;11;6;0;0;0;11;6;977323;CELULAR MOTO G22 128GB NEGRO WOM;TELEFONIA
16543929;;F;35;CHILENO;;Millenial;SAN MIGUEL                    ;METROPOLITANA;453980;2;1;2;1;453980;0;0;0;CELULAR XIAOMI 11T PRO 8/256GB CELESTIAL BLUE OP;TELEFONIA
24787275;;M;46;BOLIVIANO;;Extranjero;SANTIAGO                      ;METROPOLITANA;1795910;10;5;0;0;0;10;5;1795910;CELULAR GALAXY A53 5G 6+128GB ORANGE;TELEFONIA
13086482;;F;49;CHILENO;;Millenial;"";"";345910;9;5;9;5;345910;0;0;0;CELULAR VIVO Y11S PHANTON BLACK 32GB MOVISTAR;TELEFONIA
19004639;;F;27;CHILENO;;Millenial;EMPEDRADO                     ;MAULE;1229830;14;6;6;3;822940;8;3;406890;CELULAR GALAXY A23 6+128GB BLACK OPEN;TELEFONIA
15131768;;M;42;CHILENO;;X;TENO                          ;MAULE;626860;9;4;4;1;325960;5;3;300900;CELULAR VIVO Y01 AZUL ZAFIRO OPEN;TELEFONIA
7137714;;M;67;CHILENO;;Boomers;RANCAGUA                      ;L.G.B.OÂ´HIGGINS;997240;10;6;0;0;0;10;6;997240;CELULAR REDMI 10A US 64GB GRAPHITE GRAY OPEN;TELEFONIA
9724415;;M;57;CHILENO;;Boomers;QUILLOTA                      ;VALPARAISO;307341;6;3;0;0;0;6;3;307341;CELULAR XIAOMI REDMI 9A 2/32GB GRANITE GRAY;TELEFONIA
5094434;;M;76;CHILENO;;Silencioso;RENCA                         ;METROPOLITANA;296980;2;1;2;1;296980;0;0;0;CELULAR SMARTPHONE A52S 5G BLACK 128GB;TELEFONIA
19549977;;F;24;CHILENO;;Z;N/D;N/D;4856530;27;14;7;4;1414930;20;10;3441600;CELULAR GALAXY A13 4+128GB LIGHT BLUE OPEN;TELEFONIA
8177644;;F;67;CHILENO;;Boomers;RENCA                         ;METROPOLITANA;552970;4;2;0;0;0;4;2;552970;CELULAR GALAXY A13 4+128GB BLACK;TELEFONIA
19221172;Soltero;F;26;CHILENO;GASTRONOMIA INTERNACIONAL;Extranjero;PROVIDENCIA                   ;N/D;483970;3;1;3;1;483970;0;0;0;CELULAR A52 128 GB LIGHT VIOLET OPEN;TELEFONIA
24667364;;F;44;PERUANO;;Extranjero;RECOLETA                      ;METROPOLITANA;658990;4;2;2;1;413980;2;1;245010;CELULAR SAMSUNG A23 128GB BLACK CLARO;TELEFONIA
10910866;;M;52;CHILENO;;X;COIHAIQUE                     ;AYSEN;534970;5;4;0;0;0;5;4;534970;CELULAR REDMI 10A US 64GB GRAPHITE GRAY OPEN;TELEFONIA
10326751;;M;55;CHILENO;;Boomers;ANGOL                         ;ARAUCANIA;1434700;10;7;0;0;0;10;7;1434700;CELULAR GALAXY A22 5G 4+128GB MINT;TELEFONIA
15147393;;F;37;CHILENO;;Millenial;LOS ANDES                     ;VALPARAISO;885320;9;5;0;0;0;9;5;885320;CELULAR GALAXY A33 5G 6+128GB WHITE OPEN;TELEFONIA
18998367;;F;26;CHILENO;;Z;PROVIDENCIA                   ;METROPOLITANA;980;2;1;0;0;0;2;1;980;CHIP OPEN ENTEL;TELEFONIA
16106961;;F;36;CHILENO;;Millenial;PROVIDENCIA                   ;METROPOLITANA;980;2;1;0;0;0;2;1;980;CHIP OPEN ENTEL;TELEFONIA
24171624;;F;34;COLOMBIANO;;Extranjero;NATALES                       ;MAGALLANES;90980;2;2;0;0;0;2;2;90980;CELULAR SMARTPHONE BMOBIL AX1076 PRO BLACK TRI W;TELEFONIA
11113413;;F;55;CHILENO;;Boomers;TEMUCO                        ;ARAUCANIA;239490;3;2;0;0;0;3;2;239490;CELULAR VIVO Y01 AZUL ZAFIRO OPEN;TELEFONIA
18959721;;F;26;CHILENO;;Z;PROVIDENCIA                   ;METROPOLITANA;179640;2;1;0;0;0;2;1;179640;CELULAR VIVO Y15S WAVE GREEN OPEN;TELEFONIA
19233010;;F;26;CHILENO;;Z;PEDRO AGUIRRE CERDA;METROPOLITANA;327960;4;2;4;2;327960;0;0;0;CELULAR REDMI NOTE 11 4/128GB GRAPHITE GRAY OPEN;TELEFONIA
15267317;;M;48;CHILENO;;X;PAINE                         ;METROPOLITANA;294650;3;2;0;0;0;3;2;294650;CELULAR GALAXY A22 5G 4+128GB MINT;TELEFONIA
17184914;;M;33;CHILENO;;Millenial;SAN CLEMENTE                  ;MAULE;346970;3;2;0;0;0;3;2;346970;CELULAR MOTO G60 4/128 GB NEGRO OPEN;TELEFONIA
13154415;;F;48;CHILENO;;X;NUEVA IMPERIAL                ;ARAUCANIA;690050;7;4;4;2;247080;3;2;442970;CELULAR VIVO Y01 AZUL ZAFIRO OPEN;TELEFONIA
9837155;;M;58;CHILENO;;Boomers;RENCA                         ;METROPOLITANA;272980;2;1;0;0;0;2;1;272980;CELULAR GALAXY A23 6+128GB BLACK OPEN;TELEFONIA
13465738;;F;44;CHILENO;;X;MAIPU;METROPOLITANA;228980;2;1;0;0;0;2;1;228980;IPHONE 8 64 GB LIB OPEN GRAY;TELEFONIA
18045702;;F;30;CHILENO;;Millenial;BUIN                          ;METROPOLITANA;343246;5;3;2;1;93980;3;2;249266;CELULAR VIVO Y53S FANTASTIC RAINBOW 128GB OPEN;TELEFONIA
19436759;;M;25;CHILENO;;Z;N/D;N/D;437103;5;4;0;0;0;5;4;437103;CELULAR VIVO Y21S 128GB BLANCO WOM;TELEFONIA
9205121;;M;60;CHILENO;;Boomers;GRANEROS                      ;L.G.B.OÂ´HIGGINS;425969;7;3;0;0;0;7;3;425969;CELULAR VIVO Y20S NEBULA 128 GB BLUE OPEN;TELEFONIA
15236737;Soltero;F;40;CHILENO;;X;RENCA                         ;METROPOLITANA;54990;2;1;0;0;0;2;1;54990;CELULAR BMOBILE BS30 BLACK OPEN;TELEFONIA
13226289;;M;45;CHILENO;;X;LA CRUZ;VALPARAISO;347980;3;2;1;1;27990;2;1;319990;CELULAR GALAXY A23 6+128GB LIGHT BLUE OPEN;TELEFONIA
6171061;;M;73;CHILENO;;Silencioso;SAN ANTONIO                   ;VALPARAISO;1702559;25;15;0;0;0;25;15;1702559;CELULAR MOTO E32 64GB PLATA OPEN;TELEFONIA
14183837;;F;41;CHILENO;;X;LA PINTANA                    ;METROPOLITANA;133980;2;1;2;1;133980;0;0;0;CELULAR GALAXY A03 128GB BLACK CLARO;TELEFONIA
19874266;;F;23;CHILENO;;Z;PROVIDENCIA                   ;METROPOLITANA;64990;2;2;0;0;0;2;2;64990;PRODUCTO 2 SELECCION BANDA 2;TELEFONIA
12694903;;M;48;CHILENO;;X;SAN VICENTE                   ;L.G.B.OÂ´HIGGINS;294970;3;3;0;0;0;3;3;294970;CELULAR XIAOMI REDMI 9A 2/32GB GRANITE GRAY;TELEFONIA
19719827;;M;24;CHILENO;;Z;PROVIDENCIA                   ;METROPOLITANA;806660;3;2;0;0;0;3;2;806660;IPHONE 11 128GB BLACK CLARO;TELEFONIA
13531691;;M;43;CHILENO;;X;VALLENAR;ATACAMA;690760;3;2;0;0;0;3;2;690760;CELULAR REDMI 10A US 64GB GRAPHITE GRAY OPEN;TELEFONIA
13596579;Soltero;F;43;CHILENO;PROFESOR;X;CURICO;MAULE;169990;1;1;1;1;169990;0;0;0;CELULAR POCO M4 PRO 128GB COOL BLUE OPEN;TELEFONIA
16432818;;F;35;CHILENO;;Millenial;CHEPICA                       ;L.G.B.OÂ´HIGGINS;375010;5;3;0;0;0;5;3;375010;CELULAR REDMI 10C EU 4GB+128GB GRAPHITE GRAY OPE;TELEFONIA
24507517;;M;38;COLOMBIANO;;Extranjero;"";"";365000;3;2;0;0;0;3;2;365000;CELULAR POCO M4 PRO 128GB COOL BLUE OPEN;TELEFONIA
9921471;Soltero;M;59;CHILENO;;Boomers;PROVIDENCIA                   ;METROPOLITANA;132980;2;1;0;0;0;2;1;132980;CELULAR SAMSUNG A03 CORE 32GB BLACK CLARO;TELEFONIA
11449873;;F;53;CHILENO;;X;LOS ANGELES                   ;BIO BIO;183980;3;2;0;0;0;3;2;183980;CELULAR GALAXY A22 5G 4+128GB GRAY;TELEFONIA
16098991;;M;36;CHILENO;;Extranjero;N/D;N/D;990;1;1;0;0;0;1;1;990;CHIP PLAN SIN CONTRATO VIRGIN 3;TELEFONIA
18971484;;F;26;CHILENO;;Z;SALAMANCA                     ;COQUIMBO;225010;2;1;0;0;0;2;1;225010;CELULAR GALAXY A13 4+128GB LIGHT BLUE OPEN;TELEFONIA
8759369;Viudo;F;63;CHILENO;;Boomers;OSORNO                        ;LOS LAGOS;596961;5;4;3;2;564980;2;2;31981;CELULAR IPHONE 12 64GB BLACK CLARO;TELEFONIA
9781039;;F;59;CHILENO;;Boomers;RENCA                         ;METROPOLITANA;119990;1;1;0;0;0;1;1;119990;CELULAR XIAOMI REDMI 9C 64GB GRAY WOM;TELEFONIA
8098175;;F;61;CHILENO;;Boomers;"";"";490770;4;3;1;1;139990;3;2;350780;CELULAR GALAXY A03 4+128GB BLUE OPEN;TELEFONIA
11253426;Soltero;M;54;CHILENO;;Boomers;PROVIDENCIA                   ;METROPOLITANA;229421;9;2;0;0;0;9;2;229421;CELULAR VIVO Y01 AZUL ZAFIRO OPEN;TELEFONIA
11344417;;M;54;CHILENO;;X;ANTOFAGASTA                   ;ANTOFAGASTA;119990;2;1;0;0;0;2;1;119990;CELULAR REDMI 10C EU 4GB+128GB GRAPHITE GRAY OPE;TELEFONIA
18423535;Soltero;M;29;CHILENO;TECNICO EN TELECOMUNICACIONES;Millenial;PROVIDENCIA                   ;METROPOLITANA;25980;2;1;2;1;25980;0;0;0;Mi Router 4A Giga Version Xiaomi;TELEFONIA
17201298;;M;33;CHILENO;;Millenial;PROVIDENCIA                   ;METROPOLITANA;128540;2;3;2;3;128540;0;0;0;CELULAR GALAXY S22 BLACK 128GB;TELEFONIA
10962869;;M;47;CHILENO;;X;NATALES                       ;MAGALLANES;251970;3;3;0;0;0;3;3;251970;CELULAR NOKIA 225 4G BLACK MOVISTAR DIRECTO;TELEFONIA
7506995;;M;67;CHILENO;;Boomers;RENCA                         ;METROPOLITANA;34990;1;1;0;0;0;1;1;34990;Celular SA3 CLARO DIRECTO BLACK;TELEFONIA
10661271;;F;53;CHILENO;;X;OVALLE                        ;COQUIMBO;151240;2;1;0;0;0;2;1;151240;CELULAR VIVO Y01 AZUL ZAFIRO OPEN;TELEFONIA
10123600;;F;58;CHILENO;;Boomers;RENCA                         ;METROPOLITANA;403980;2;1;2;1;403980;0;0;0;CELULAR XIAOMI 11T PRO 8/256GB CELESTIAL BLUE OP;TELEFONIA
7599977;;M;62;CHILENO;;Boomers;RENCA                         ;METROPOLITANA;109990;1;1;0;0;0;1;1;109990;CELULAR REDMI 9C 64GB SUNRISE ORANGE;TELEFONIA
15917014;;F;38;CHILENO;;Millenial;SAN BERNARDO                  ;METROPOLITANA;216616;5;3;0;0;0;5;3;216616;CELULAR VIVO Y15S BLUE MOVISTAR;TELEFONIA
18430907;;M;29;CHILENO;;Millenial;PUNTA ARENAS                  ;MAGALLANES;188970;3;1;0;0;0;3;1;188970;CELULAR REDMI NOTE 10 PRO 128GB AZUL WOM;TELEFONIA
3458708;;F;85;CHILENO;;Silencioso;HIJUELAS                      ;VALPARAISO;853100;5;2;0;0;0;5;2;853100;CELULAR A52 128 GB BLUE OPEN;TELEFONIA
13362065;;M;48;CHILENO;;X;CHIMBARONGO                   ;L.G.B.OÂ´HIGGINS;150480;3;1;0;0;0;3;1;150480;CELULAR VIVO Y15S WAVE GREEN OPEN;TELEFONIA
10829888;;M;54;CHILENO;;X;RENCA                         ;METROPOLITANA;212980;3;1;0;0;0;3;1;212980;CELULAR GALAXY A23 6+128GB BLACK OPEN;TELEFONIA
18830332;;F;28;CHILENO;;Millenial;N/D;N/D;767870;12;9;1;1;199990;11;8;567880;CELULAR VIVO Y21S 128GB BLANCO WOM;TELEFONIA
14287529;;F;48;CHILENO;;X;LEBU                          ;BIO BIO;199980;2;2;0;0;0;2;2;199980;CELULAR SAMSUNG A03 CORE 32GB BLACK CLARO;TELEFONIA
14304413;;M;46;CHILENO;;X;CALAMA                        ;ANTOFAGASTA;539980;2;2;0;0;0;2;2;539980;CELULAR MOTO G50 AZUL 128 GB OPEN;TELEFONIA
17787418;;F;31;CHILENO;;Millenial;LAJA                          ;BIO BIO;119990;1;1;0;0;0;1;1;119990;CELULAR Moto G20 Rosado WOM;TELEFONIA
8068036;;F;63;CHILENO;;Boomers;PROVIDENCIA                   ;METROPOLITANA;46980;2;2;0;0;0;2;2;46980;Celular SA3 CLARO DIRECTO BLACK;TELEFONIA
7449545;;M;66;CHILENO;;Boomers;QUILLOTA                      ;VALPARAISO;199136;5;3;0;0;0;5;3;199136;CELULAR SAMSUNG A03 128GB BLACK CLARO;TELEFONIA
19454836;;M;46;CHILENO;;X;COIHAIQUE                     ;AYSEN;289990;1;1;0;0;0;1;1;289990;CELULAR GALAXY A33 5G 6+128GB LIGHT BLUE OPEN;TELEFONIA
23589289;;M;23;CHILENO;;Extranjero;PROVIDENCIA                   ;METROPOLITANA;239990;1;1;1;1;239990;0;0;0;CELULAR GALAXY A33 5G 6+128GB LIGHT BLUE OPEN;TELEFONIA
15197477;;F;40;CHILENO;;X;LOS ALAMOS                    ;BIO BIO;196962;4;3;0;0;0;4;3;196962;CELULAR MOTOROLA G30 GRIS WOM 128 GB;TELEFONIA
7285066;;F;65;CHILENO;;Boomers;ALTO HOSPICIO;TARAPACA;238380;5;2;0;0;0;5;2;238380;CELULAR MOTO G20 EDICION ESPECIAL 4/128 GB AZUL;TELEFONIA
8007684;;F;65;CHILENO;;Boomers;MAIPU                         ;METROPOLITANA;478512;8;3;0;0;0;8;3;478512;CELULAR VIVO Y21S PEARL WHITE 128 GB OPEN;TELEFONIA
16444432;;F;36;CHILENO;;Millenial;TUCAPEL                       ;BIO BIO;110760;3;1;0;0;0;3;1;110760;CELULAR REDMI 9A 32GB SKY BLUE;TELEFONIA
19211117;;M;25;CHILENO;;Z;RENGO                         ;L.G.B.OÂ´HIGGINS;1396122;34;28;0;0;0;34;28;1396122;CELULAR VIVO Y21S 128GB BLANCO WOM;TELEFONIA
12804318;;M;47;CHILENO;;X;N/D;N/D;1216580;9;5;7;4;996590;2;1;219990;CELULAR REDMI NOTE 11S 128GB GRAPHITE GRAY;TELEFONIA
14307170;Soltero;M;47;CHILENO;;X;RENCA                         ;METROPOLITANA;224560;2;1;0;0;0;2;1;224560;CELULAR GALAXY A23 6+128GB BLACK OPEN;TELEFONIA
8845294;;F;59;CHILENO;;Boomers;SAN VICENTE                   ;L.G.B.OÂ´HIGGINS;791100;5;2;0;0;0;5;2;791100;CELULAR SMARTPHONE A52S 5G BLACK 128GB;TELEFONIA
10752776;Casado;F;59;CHILENO;;Boomers;RENCA                         ;METROPOLITANA;595970;3;2;3;2;595970;0;0;0;IPHONE 11 64GB BLACK CLARO;TELEFONIA
11857306;;F;51;CHILENO;;X;HUECHURABA                    ;METROPOLITANA;239230;4;2;0;0;0;4;2;239230;CELULAR VIVO Y21S 128GB BLANCO WOM;TELEFONIA
13868534;;F;42;CHILENO;;X;ANTOFAGASTA                   ;ANTOFAGASTA;219970;3;2;0;0;0;3;2;219970;CELULAR REDMI NOTE 10 5G 4/128GB GRAPHITE GRAY O;TELEFONIA
10398901;;F;51;CHILENO;;X;RENCA                         ;METROPOLITANA;359980;2;2;1;1;109990;1;1;249990;CELULAR GALAXY A33 5G 6+128GB BLACK OPEN;TELEFONIA
17987830;;F;30;CHILENO;;Millenial;PROVIDENCIA                   ;METROPOLITANA;364980;2;2;0;0;0;2;2;364980;CELULAR POCO M4 PRO 128GB COOL BLUE OPEN;TELEFONIA
15963523;Divorciado;M;37;CHILENO;;Millenial;LO BARNECHEA;METROPOLITANA;239990;1;1;1;1;239990;0;0;0;CELULAR GALAXY A33 5G 6+128GB LIGHT BLUE OPEN;TELEFONIA
20171410;;M;22;CHILENO;;Millenial;"";"";129990;2;1;0;0;0;2;1;129990;CELULAR REDMI NOTE 11 4/128GB TWILIGHT BLUE OPEN;TELEFONIA
10451395;;M;57;CHILENO;;Boomers;ARICA                         ;ARICA Y PARINACOTA;65090;2;1;0;0;0;2;1;65090;CELULAR REDMI 9C 64GB MIDNIGHT GRAY MOVISTAR;TELEFONIA
14552930;;M;47;CHILENO;;X;N/D;N/D;382150;3;2;0;0;0;3;2;382150;CELULAR GALAXY A53 5G 6+128GB WHITE;TELEFONIA
19838334;;F;24;CHILENO;;Z;"";"";980;2;1;0;0;0;2;1;980;CHIP PREPAGO OPEN WOM;TELEFONIA
19215082;;F;26;CHILENO;;Z;ILLAPEL;COQUIMBO;538790;4;3;1;1;279990;3;2;258800;SMARTPHONE A03S NEGRO 32GB;TELEFONIA
25466639;;M;33;HAITIANO;;Extranjero;"";"";468310;6;3;2;1;303980;4;2;164330;CELULAR GALAXY A13 4+128GB LIGHT BLUE OPEN;TELEFONIA
17460800;;F;32;CHILENO;;Millenial;ANGOL                         ;ARAUCANIA;129990;2;1;0;0;0;2;1;129990;CELULAR REDMI NOTE 11 4/128GB TWILIGHT BLUE OPEN;TELEFONIA
25385677;;M;35;HAITIANO;;Extranjero;LA GRANJA                     ;METROPOLITANA;207230;5;2;0;0;0;5;2;207230;CELULAR MOTO G22 128GB NEGRO WOM;TELEFONIA
17971960;;M;30;CHILENO;;Millenial;PROVIDENCIA                   ;METROPOLITANA;226980;2;1;2;1;226980;0;0;0;CELULAR SAMSUNG A52s 128GB BLACK CLARO;TELEFONIA
11032971;;F;57;CHILENO;;Boomers;SAN CARLOS                    ;BIO BIO;99990;1;1;0;0;0;1;1;99990;CELULAR REDMI 9C 64GB MIDNIGHT GRAY MOVISTAR;TELEFONIA
27163218;;M;30;"";;Extranjero;"";"";129990;1;1;1;1;129990;0;0;0;CELULAR GALAXY A13 4+128GB LIGHT BLUE OPEN;TELEFONIA
13361789;;F;43;CHILENO;;Extranjero;LA LIGUA                      ;VALPARAISO;119990;1;1;1;1;119990;0;0;0;CELULAR REDMI 10A US 64GB GRAPHITE GRAY OPEN;TELEFONIA
10260515;;M;54;CHILENO;;X;CERRO NAVIA;METROPOLITANA;254960;5;2;0;0;0;5;2;254960;CELULAR REDMI 10A US 64GB GRAPHITE GRAY OPEN;TELEFONIA
16823825;;M;34;CHILENO;;Millenial;NUEVA IMPERIAL                ;ARAUCANIA;637980;2;1;2;1;637980;0;0;0;CELULAR IPHONE 12 64GB BLACK CLARO;TELEFONIA
15874899;;F;37;CHILENO;;Millenial;N/D;N/D;268970;4;3;0;0;0;4;3;268970;CELULAR POCO M4 PRO 128GB COOL BLUE OPEN;TELEFONIA
18433906;;M;28;CHILENO;;Millenial;SANTIAGO;METROPOLITANA;103980;2;1;2;1;103980;0;0;0;CELULAR REDMI 10A US 32GB CHROME SILVER OPEN;TELEFONIA
17585443;Soltero;M;31;CHILENO;INGENIERO INFORMATICO;Millenial;TEMUCO                        ;ARAUCANIA;364460;4;2;4;2;364460;0;0;0;CELULAR POCO M4 PRO 128GB COOL BLUE OPEN;TELEFONIA
12724304;;M;47;CHILENO;;X;PROVIDENCIA                   ;METROPOLITANA;77123;3;2;0;0;0;3;2;77123;CELULAR VIVO Y21S 128GB BLANCO WOM;TELEFONIA
10497418;;F;58;CHILENO;;Boomers;"";"";214560;2;1;0;0;0;2;1;214560;CELULAR GALAXY A13 4+128GB BLACK;TELEFONIA
8782157;;F;62;CHILENO;;Boomers;NEGRETE                       ;BIO BIO;326460;4;3;0;0;0;4;3;326460;CELULAR SAMSUNG A03 CORE 32GB BLACK CLARO;TELEFONIA
9055073;;M;59;CHILENO;;Boomers;"";"";267980;3;1;0;0;0;3;1;267980;CELULAR SAMSUNG A52s 128GB BLACK CLARO;TELEFONIA
4995578;;M;80;CHILENO;;Silencioso;CANETE                        ;BIO BIO;156240;3;1;0;0;0;3;1;156240;CELULAR VIVO Y01 AZUL ZAFIRO OPEN;TELEFONIA
18728414;;F;28;CHILENO;;Millenial;ANTOFAGASTA                   ;ANTOFAGASTA;159990;1;1;0;0;0;1;1;159990;CELULAR REDMI 10C 128GB GRAPHITE GRAY CLARO;TELEFONIA
13939214;;F;42;CHILENO;;X;PROVIDENCIA                   ;METROPOLITANA;197960;4;2;4;2;197960;0;0;0;CELULAR A32 128 GB LIGHT VIOLET OPEN;TELEFONIA
18952309;;M;27;CHILENO;;Millenial;N/D;N/D;672960;4;2;2;1;609980;2;1;62980;Galaxy Z Flip3 128GB LAVENDER;TELEFONIA
15497840;Soltero;F;36;CHILENO;PROFESOR;Millenial;RENCA                         ;METROPOLITANA;51840;2;1;0;0;0;2;1;51840;CELULAR BMOBILE C40 CRIS OPEN;TELEFONIA
13000967;;F;46;CHILENO;;X;N/D;N/D;148970;4;2;2;1;18980;2;1;129990;CELULAR GALAXY A22 5G 4+128GB MINT;TELEFONIA
20250164;;F;22;CHILENO;;Z;PROVIDENCIA                   ;METROPOLITANA;219990;1;1;1;1;219990;0;0;0;CELULAR SAMSUNG A52s 128GB BLACK CLARO;TELEFONIA
9351308;;M;61;CHILENO;;Boomers;LA PINTANA                    ;METROPOLITANA;1079310;9;5;0;0;0;9;5;1079310;CELULAR A52 128 GB WHITE OPEN;TELEFONIA
15600990;;M;49;CHILENO;;X;PANGUIPULLI                   ;LOS RIOS;139990;1;1;0;0;0;1;1;139990;CELULAR REDMI 9C 64GB SUNRISE ORANGE;TELEFONIA
19603211;;M;25;CHILENO;;Z;SAN FERNANDO                  ;L.G.B.OÂ´HIGGINS;369970;3;3;0;0;0;3;3;369970;CELULAR REDMI NOTE 10 5G US 128G NIGHTTIME BLUE;TELEFONIA
13098201;;M;45;CHILENO;;X;N/D;N/D;259980;3;2;0;0;0;3;2;259980;CELULAR Moto G20 Blue WOM;TELEFONIA
17112095;;F;33;CHILENO;;Millenial;N/D;N/D;211562;5;3;0;0;0;5;3;211562;CELULAR VIVO Y01 AZUL ZAFIRO OPEN;TELEFONIA
12199141;;F;50;CHILENO;;X;ARAUCO                        ;BIO BIO;199990;1;1;0;0;0;1;1;199990;CELULAR A32 128 GB BLACK OPEN;TELEFONIA
18257613;;F;30;CHILENO;;Millenial;PROVIDENCIA                   ;METROPOLITANA;192980;3;2;0;0;0;3;2;192980;CELULAR POCO M4 PRO 128GB COOL BLUE OPEN;TELEFONIA
15879825;Soltero;M;37;CHILENO;;Millenial;CHILLAN;BIO-BIO;246980;2;1;2;1;246980;0;0;0;CELULAR A52 128 GB BLACK OPEN;TELEFONIA
11822790;;M;51;CHILENO;;X;LA SERENA                     ;COQUIMBO;1128920;9;6;0;0;0;9;6;1128920;CELULAR REDMI 9C 64GB SUNRISE ORANGE;TELEFONIA
15201203;;M;40;CHILENO;;X;N/D;N/D;924940;7;4;0;0;0;7;4;924940;CELULAR VIVO Y53S FANTASTIC RAINBOW 128GB OPEN;TELEFONIA
15503002;;F;39;CHILENO;;X;PUREN                         ;ARAUCANIA;509240;4;2;0;0;0;4;2;509240;CELULAR GALAXY A03 4+64GB BLACK OPEN;TELEFONIA
20123592;;M;23;CHILENO;;Z;N/D;N/D;268970;2;1;0;0;0;2;1;268970;CELULAR MOTO G60 4/128 GB NEGRO OPEN;TELEFONIA
5116247;;M;73;CHILENO;;Silencioso;CHIGUAYANTE                   ;BIO BIO;218630;4;2;0;0;0;4;2;218630;CELULAR GALAXY A03 CORE 2GB 32GB BLUE OPEN;TELEFONIA
26485705;;M;26;NO INFORMA NACIONALIDAD;;Extranjero;PROVIDENCIA                   ;METROPOLITANA;201970;3;2;3;2;201970;0;0;0;CELULAR A52 128 GB BLACK OPEN;TELEFONIA
16454781;;F;35;CHILENO;;Millenial;N/D;N/D;723910;8;5;0;0;0;8;5;723910;CELULAR VIVO Y21S PEARL WHITE 128 GB OPEN;TELEFONIA
16460690;;M;35;CHILENO;;Millenial;N/D;N/D;831930;9;6;0;0;0;9;6;831930;CELULAR GALAXY A13 4+128GB LIGHT BLUE OPEN;TELEFONIA
26207720;Soltero;M;33;VENEZOLANO;;Extranjero;"";"";163980;2;1;2;1;163980;0;0;0;CELULAR A32 128 GB BLUE OPEN;TELEFONIA
6316349;;M;72;CHILENO;;Silencioso;CURANILAHUE                   ;BIO BIO;89990;1;1;0;0;0;1;1;89990;CELULAR Moto E7 Rosado WOM;TELEFONIA
16993654;;M;31;CHILENO;;Millenial;N/D;N/D;444970;3;2;0;0;0;3;2;444970;CELULAR GALAXY A03 4+128GB BLUE OPEN;TELEFONIA
26388205;;F;26;VENEZOLANO;;Extranjero;CONCEPCION                    ;BIO BIO;439990;1;1;0;0;0;1;1;439990;CELULAR SAMSUNG S21 FE 128GB LIGHT GREEN OPEN;TELEFONIA
6146292;;M;74;CHILENO;;Silencioso;PUERTO MONTT                  ;LOS LAGOS;369120;6;1;0;0;0;6;1;369120;CELULAR GALAXY A22 5G 4+128GB WHITE;TELEFONIA
7638620;;F;67;CHILENO;;Boomers;LOS SAUCES                    ;ARAUCANIA;255960;4;2;0;0;0;4;2;255960;CELULAR GALAXY A22 5G 4+128GB GRAY;TELEFONIA
19821813;;F;22;CHILENO;;Z;PROVIDENCIA                   ;METROPOLITANA;179990;2;1;0;0;0;2;1;179990;CELULAR REDMI NOTE 11S 6GB+128GB TWILIGHT BLUE O;TELEFONIA
13038073;;F;45;CHILENO;;X;PROVIDENCIA                   ;METROPOLITANA;1009190;8;8;0;0;0;8;8;1009190;CELULAR GALAXY A13 4+128GB WHITE OPEN;TELEFONIA
20595716;;M;21;CHILENO;;Z;QUILLON                       ;BIO BIO;64990;1;1;1;1;64990;0;0;0;CELULAR XIAOMI REDMI 9A 32GB VERDE CLARO;TELEFONIA
17536291;;F;38;CHILENO;;Millenial;RECOLETA                      ;METROPOLITANA;319980;2;1;2;1;319980;0;0;0;CELULAR GALAXY A22 5G 4+128GB MINT;TELEFONIA
20092767;;M;23;CHILENO;;Z;MONTE PATRIA                  ;COQUIMBO;248120;3;1;0;0;0;3;1;248120;CELULAR VIVO Y21S MIDNIGHT BLUE 128 GB OPEN;TELEFONIA
14321966;;F;45;CHILENO;;X;TALAGANTE                     ;METROPOLITANA;189990;2;1;0;0;0;2;1;189990;CELULAR VIVO Y53S FANTASTIC RAINBOW 128GB OPEN;TELEFONIA
10375808;Soltero;F;54;CHILENO;;Boomers;LA REINA                      ;METROPOLITANA;200000;2;1;0;0;0;2;1;200000;CELULAR REDMI NOTE 11 PRO 128GB WHITE;TELEFONIA
10054013;;F;54;CHILENO;;Boomers;CURACO DE VELEZ               ;LOS LAGOS;217981;2;2;0;0;0;2;2;217981;CELULAR Moto E7 Rosado WOM;TELEFONIA
13776902;;M;42;CHILENO;;X;N/D;N/D;149990;1;1;0;0;0;1;1;149990;CELULAR A54 OPPO AZUL 128GB;TELEFONIA
11264635;;F;54;CHILENO;;X;PADRE LAS CASAS               ;ARAUCANIA;1713480;11;6;0;0;0;11;6;1713480;CELULAR GALAXY A03 CORE 2GB 32GB BLUE OPEN;TELEFONIA
14280990;;F;52;CHILENO;;X;VALDIVIA                      ;LOS RIOS;163130;4;1;0;0;0;4;1;163130;CELULAR REDMI 9 64GB CARBON GREY;TELEFONIA
15031114;;M;39;CHILENO;;X;PUERTO MONTT                  ;LOS LAGOS;344970;3;3;1;1;149990;2;2;194980;CELULAR GALAXY A22 5G 4+128GB GRAY;TELEFONIA
7186895;;F;65;CHILENO;;Boomers;N/D;N/D;310500;5;3;0;0;0;5;3;310500;Celular SA3 CLARO DIRECTO BLACK;TELEFONIA
26338468;;M;76;VENEZOLANO;;Extranjero;LOS ANGELES                   ;BIO BIO;240830;3;2;3;2;240830;0;0;0;CELULAR REDMI NOTE 11 PRO 128GB GRAPHITE;TELEFONIA
9268979;;M;59;CHILENO;;Boomers;VILLA ALEMANA                 ;VALPARAISO;69990;1;1;0;0;0;1;1;69990;CELULAR Moto E7 Rosado WOM;TELEFONIA
8249696;Casado;M;62;CHILENO;;Boomers;CONSTITUCION                  ;MAULE;139990;1;1;1;1;139990;0;0;0;CELULAR A32 128 GB BLUE OPEN;TELEFONIA
19463164;Soltero;M;25;CHILENO;;Z;N/D;N/D;990;3;1;0;0;0;3;1;990;CHIP OPEN ENTEL;TELEFONIA
17454000;;M;31;CHILENO;;Millenial;ARAUCO                        ;BIO BIO;97620;2;1;0;0;0;2;1;97620;CELULAR MOTOROLA E6 PLAY AZUL TRI WOM;TELEFONIA
6465542;;M;65;CHILENO;;Boomers;CAUQUENES                     ;MAULE;535960;4;4;0;0;0;4;4;535960;CELULAR REDMI NOTE 11 PRO 128GB GRAPHITE;TELEFONIA
20303579;;M;21;CHILENO;;Z;"";"";375230;5;2;0;0;0;5;2;375230;CELULAR REDMI NOTE 11 PRO 128GB WHITE;TELEFONIA
11961815;;F;50;CHILENO;;X;LOS ANGELES                   ;BIO BIO;0;0;2;0;0;0;0;2;0;CELULAR REDMI 9A 32GB SKY BLUE;TELEFONIA
10089571;;F;58;CHILENO;;Boomers;RENCA                         ;METROPOLITANA;42990;2;1;0;0;0;2;1;42990;CELULAR BMOBILE C40 CRIS OPEN;TELEFONIA
15373782;;F;39;CHILENO;;X;N/D;N/D;169990;1;1;0;0;0;1;1;169990;CELULAR VIVO Y21S 128GB BLANCO WOM;TELEFONIA
12173583;;F;49;CHILENO;;X;VINA DEL MAR                  ;VALPARAISO;175980;2;1;2;1;175980;0;0;0;CELULAR A52 128 GB LIGHT VIOLET OPEN;TELEFONIA
7387889;;M;66;CHILENO;;Boomers;LA SERENA                     ;COQUIMBO;94286;3;1;0;0;0;3;1;94286;CELULAR VIVO Y21S 128GB BLANCO WOM;TELEFONIA
11413527;;F;52;CHILENO;;X;ANCUD                         ;LOS LAGOS;391110;9;5;0;0;0;9;5;391110;CELULAR A52 128 GB LIGHT VIOLET OPEN;TELEFONIA
26538977;;F;32;CHILENO;;Extranjero;PROVIDENCIA                   ;METROPOLITANA;0;0;2;0;2;0;0;0;0;CELULAR GALAXY S22 BLACK 128GB;TELEFONIA
10530029;;F;53;CHILENO;;X;"";"";0;0;2;0;2;0;0;0;0;CELULAR REDMI NOTE 11 4/128GB TWILIGHT BLUE OPEN;TELEFONIA
18008078;Soltero;M;30;CHILENO;;Millenial;LOS SAUCES                    ;ARAUCANIA;150970;3;2;0;0;0;3;2;150970;CELULAR A32 128 GB BLACK OPEN;TELEFONIA
18183786;;M;29;CHILENO;;Millenial;PROVIDENCIA                   ;METROPOLITANA;319980;2;2;2;2;319980;0;0;0;CELULAR A52 128 GB BLACK OPEN;TELEFONIA
13853115;;F;42;CHILENO;;X;NACIMIENTO                    ;BIO BIO;591420;7;3;0;0;0;7;3;591420;CELULAR REDMI NOTE 11 4/128GB TWILIGHT BLUE OPEN;TELEFONIA
6137681;;F;73;CHILENO;;Silencioso;TIERRA AMARILLA               ;ATACAMA;267831;3;2;0;0;0;3;2;267831;CELULAR REDMI NOTE 11 PRO 128GB WHITE;TELEFONIA
23143563;;F;36;COLOMBIANO;;Extranjero;PROVIDENCIA                   ;METROPOLITANA;199990;1;1;1;1;199990;0;0;0;CELULAR REDMI NOTE 11 PRO 128GB GRAPHITE;TELEFONIA
14302563;;F;46;CHILENO;;X;PENAFLOR                      ;METROPOLITANA;408940;7;5;0;0;0;7;5;408940;CELULAR A12 128GB ROJO OPEN;TELEFONIA
18290611;;F;29;CHILENO;;Millenial;CANETE                        ;BIO BIO;1015900;10;8;6;5;709940;4;3;305960;CELULAR REDMI NOTE 11 PRO 128GB GRAPHITE;TELEFONIA
20021156;;F;23;CHILENO;;Z;PROVIDENCIA                   ;METROPOLITANA;315970;4;2;4;2;315970;0;0;0;CELULAR REDMI NOTE 10 PRO 6+128GB GRADIENT BRONZ;TELEFONIA
15233646;;F;39;CHILENO;;X;PAINE                         ;METROPOLITANA;489950;6;4;0;0;0;6;4;489950;SMARTPHONE A03S NEGRO 32GB;TELEFONIA
12751025;;F;47;CHILENO;;X;N/D;N/D;693940;6;4;3;1;432970;3;3;260970;CELULAR GALAXY A53 5G 6+128GB BLUE;TELEFONIA
24813623;;F;36;ECUATORIANO;;Extranjero;SAN RAMON                     ;METROPOLITANA;333960;4;3;2;1;103980;2;2;229980;CELULAR REDMI 10A US 32GB CHROME SILVER OPEN;TELEFONIA
14300740;;M;46;CHILENO;;X;"";"";149990;2;1;0;0;0;2;1;149990;CELULAR REDMI NOTE 10 5G 4/128GB GRAPHITE GRAY O;TELEFONIA
13093481;;M;46;CHILENO;;X;QUILICURA;METROPOLITANA;103980;2;1;2;1;103980;0;0;0;CELULAR GALAXY A03 4+64GB BLUE OPEN;TELEFONIA
19723511;;M;25;CHILENO;;Z;RETIRO                        ;MAULE;369970;3;3;0;0;0;3;3;369970;CELULAR REDMI 9C 64GB SUNRISE ORANGE;TELEFONIA
24207618;;F;45;PERUANO;;Extranjero;ARICA                         ;ARICA Y PARINACOTA;714960;4;4;0;0;0;4;4;714960;CELULAR GALAXY A22 5G 4+128GB GRAY;TELEFONIA
16706961;;F;35;CHILENO;;Millenial;PROVIDENCIA                   ;METROPOLITANA;199990;1;1;0;0;0;1;1;199990;CELULAR A32 128 GB LIGHT VIOLET OPEN;TELEFONIA
19380618;Soltero;M;25;CHILENO;;Z;RENAICO                       ;ARAUCANIA;399990;1;1;1;1;399990;0;0;0;CELULAR XIAOMI 11T PRO 8/256GB CELESTIAL BLUE OP;TELEFONIA
9626806;;M;62;CHILENO;;Boomers;CHILLAN                       ;BIO BIO;1128480;10;6;0;0;0;10;6;1128480;CELULAR AZUMI L4G BLACK CLARO;TELEFONIA
6566311;Casado;M;71;CHILENO;;Silencioso;RENCA                         ;METROPOLITANA;25140;2;1;0;0;0;2;1;25140;CELULAR ALCATEL P1 DIRECTO CLARO BLACK;TELEFONIA
18384586;;F;29;CHILENO;;Millenial;LOS ANDES                     ;VALPARAISO;574870;6;3;4;2;353960;2;1;220910;CELULAR GALAXY A23 6+128GB BLACK OPEN;TELEFONIA
17320495;;M;32;CHILENO;;Millenial;LOTA                          ;BIO BIO;174980;4;2;0;0;0;4;2;174980;CELULAR GALAXY A13 4+128GB BLACK;TELEFONIA
4719076;;F;79;CHILENO;;Silencioso;CONCEPCION                    ;BIO BIO;139990;1;1;0;0;0;1;1;139990;CELULAR GALAXY A13 4+128GB BLACK;TELEFONIA
5982866;;M;70;CHILENO;;Silencioso;PROVIDENCIA                   ;METROPOLITANA;216980;2;2;1;1;179990;1;1;36990;CELULAR REDMI NOTE 11 4/128GB GRAPHITE GRAY OPEN;TELEFONIA
6010017;;M;71;CHILENO;;Silencioso;RENCA                         ;METROPOLITANA;364990;2;1;0;0;0;2;1;364990;CELULAR SAMSUNG S21 FE 128GB LIGHT GREEN OPEN;TELEFONIA
13671309;;M;43;CHILENO;;X;PROVIDENCIA                   ;METROPOLITANA;259990;1;1;1;1;259990;0;0;0;CELULAR GALAXY A53 5G 6+128GB BLUE;TELEFONIA
11268301;;F;53;CHILENO;;X;RENCA                         ;METROPOLITANA;170409;3;1;0;0;0;3;1;170409;CELULAR VIVO Y53S FANTASTIC RAINBOW 128GB OPEN;TELEFONIA
7818382;;M;62;CHILENO;;Silencioso;PROVIDENCIA                   ;METROPOLITANA;441980;2;1;2;1;441980;0;0;0;CELULAR GALAXY A73 5G 256GB GRAY OPEN;TELEFONIA
18691774;;M;28;CHILENO;;Millenial;AISEN                         ;AYSEN;548970;3;2;2;1;248980;1;1;299990;CELULAR POCO X4 PRO 5G EU 6+128GB LASER BLACK O;TELEFONIA
17679808;Soltero;M;30;CHILENO;INGENIERO CIVIL INFORMATICO;Silencioso;PROVIDENCIA                   ;METROPOLITANA;143980;2;1;2;1;143980;0;0;0;CELULAR REDMI NOTE 10 5G 4/128GB GRAPHITE GRAY O;TELEFONIA
7239795;Casado;F;67;CHILENO;;Boomers;MAIPU                         ;METROPOLITANA;414710;4;2;0;0;0;4;2;414710;CELULAR VIVO V21 5G DUSK BLUE 128GB OPEN;TELEFONIA
16896486;;F;36;CHILENO;;Millenial;TALCAHUANO                    ;BIO BIO;453950;5;3;0;0;0;5;3;453950;SMARTPHONE A03S NEGRO 32GB;TELEFONIA
17467064;;F;32;CHILENO;;Millenial;PROVIDENCIA                   ;METROPOLITANA;159990;1;1;1;1;159990;0;0;0;CELULAR GALAXY A22 5G 4+128GB MINT;TELEFONIA
12608440;;F;48;CHILENO;;X;ARICA                         ;TARAPACA;339990;1;1;0;0;0;1;1;339990;CELULAR GALAXY A53 5G 6+128GB ORANGE;TELEFONIA
16726093;Soltero;F;34;CHILENO;KINESIOLOGO;Millenial;PROVIDENCIA                   ;METROPOLITANA;179990;1;1;1;1;179990;0;0;0;CELULAR REDMI NOTE 10 PRO 6+128GB GRADIENT BRONZ;TELEFONIA
15121704;Soltero;M;40;CHILENO;PREPARADOR FISICO;X;PROVIDENCIA                   ;METROPOLITANA;169990;1;1;1;1;169990;0;0;0;CELULAR A52 128 GB BLUE OPEN;TELEFONIA
15114620;;F;45;CHILENO;;X;PERALILLO                     ;L.G.B.OÂ´HIGGINS;149990;1;1;0;0;0;1;1;149990;CELULAR A32 128 GB BLUE OPEN;TELEFONIA
8030453;;M;63;CHILENO;;Boomers;PALMILLA                      ;L.G.B.OÂ´HIGGINS;946840;5;3;0;0;0;5;3;946840;CELULAR VIVO Y15S WAVE GREEN OPEN;TELEFONIA
10601223;;F;52;CHILENO;;X;ANTOFAGASTA                   ;ANTOFAGASTA;469040;6;4;0;0;0;6;4;469040;CELULAR OPPO A15 BLACK 32GB CLARO;TELEFONIA
12868774;;F;47;CHILENO;;X;RENCA                         ;METROPOLITANA;133980;2;1;2;1;133980;0;0;0;CELULAR A54 OPPO NEGRO 128GB;TELEFONIA
18506240;;F;29;CHILENO;;Millenial;"";"";189980;4;2;0;0;0;4;2;189980;CELULAR VIVO Y21S 128GB BLANCO WOM;TELEFONIA
10539380;;M;56;CHILENO;;Boomers;"";"";364970;5;2;0;0;0;5;2;364970;CELULAR VIVO Y01 AZUL ZAFIRO OPEN;TELEFONIA
16155934;;M;36;CHILENO;;Millenial;CURANILAHUE                   ;BIO BIO;180820;4;3;2;1;45840;2;2;134980;CELULAR SAMSUNG A03 128GB BLACK CLARO;TELEFONIA
19663110;;F;25;CHILENO;;Millenial;CONCEPCION;BIO-BIO;245980;2;1;2;1;245980;0;0;0;CELUALAR REDMI NOTE 11 PRO US 6GB+128GB STAR BLU;TELEFONIA
8146275;;M;62;CHILENO;;Boomers;CALERA                        ;VALPARAISO;189690;5;3;0;0;0;5;3;189690;CELULAR AZUMI V60 DUAL OPEN;TELEFONIA
14226259;;M;41;CHILENO;;X;CASTRO                        ;LOS LAGOS;3646580;14;10;1;1;539990;13;9;3106590;CELULAR GALAXY S21 FE 8GB 256GB GRAY;TELEFONIA
8102168;;F;63;CHILENO;;Boomers;ANCUD                         ;LOS LAGOS;119990;2;1;0;0;0;2;1;119990;CELULAR A52 128 GB LIGHT VIOLET OPEN;TELEFONIA
6090141;;F;81;CHILENO;;Silencioso;ERCILLA                       ;ARAUCANIA;761339;5;2;0;0;0;5;2;761339;CELULAR GALAXY A73 5G 256GB GRAY OPEN;TELEFONIA
9448629;;F;62;CHILENO;;Boomers;TRAIGUEN                      ;ARAUCANIA;248530;3;2;0;0;0;3;2;248530;CELULAR VIVO Y15S WAVE GREEN OPEN;TELEFONIA
16457184;;F;35;CHILENO;;Millenial;MAULE                         ;MAULE;359980;2;2;2;2;359980;0;0;0;Celular P40 LITE LIB OPEN GREEN;TELEFONIA
13143202;;F;45;CHILENO;;X;LOS ANGELES                   ;BIO BIO;169990;2;1;0;0;0;2;1;169990;CELULAR GALAXY A22 5G 4+128GB MINT;TELEFONIA
19853026;;F;24;CHILENO;;Z;PROVIDENCIA                   ;METROPOLITANA;386970;3;2;3;2;386970;0;0;0;CELULAR POCO X3 PRO 128G PHANTOM BLACK OPEN;TELEFONIA
17253219;;F;32;CHILENO;;Millenial;PROVIDENCIA                   ;METROPOLITANA;93980;2;1;2;1;93980;0;0;0;CELULAR XIAOMI REDMI 9C 64GB GRAY WOM;TELEFONIA
9988397;;M;56;CHILENO;;Boomers;CAUQUENES                     ;MAULE;189990;1;1;0;0;0;1;1;189990;CELULAR GALAXY A22 5G 4+128GB GRAY;TELEFONIA
18328272;;M;29;CHILENO;;Millenial;PUDAHUEL                      ;METROPOLITANA;1065920;8;4;8;4;1065920;0;0;0;CELULAR IPHONE 12 64GB BLACK CLARO;TELEFONIA
10396712;;F;54;CHILENO;;X;PUERTO MONTT                  ;LOS LAGOS;850950;5;5;0;0;0;5;5;850950;CELULAR REDMI 10A US 32GB CHROME SILVER OPEN;TELEFONIA
23590473;;M;47;CHILENO;;X;ANTOFAGASTA                   ;ANTOFAGASTA;249040;4;1;0;0;0;4;1;249040;CELULAR REDMI NOTE 11 PRO 128GB GRAPHITE;TELEFONIA
16170071;;F;37;CHILENO;;Millenial;CORRAL                        ;LOS LAGOS;154980;2;2;0;0;0;2;2;154980;CELULAR BMOBILE C40 CRIS OPEN;TELEFONIA
9130380;;F;60;CHILENO;;Boomers;TALAGANTE                     ;METROPOLITANA;670790;12;7;0;0;0;12;7;670790;CELULAR MOTO G60S 6/128 GB AZUL;TELEFONIA
18671025;;F;29;CHILENO;;Millenial;CANETE                        ;BIO BIO;289980;3;2;0;0;0;3;2;289980;CELULAR A52 128 GB BLUE OPEN;TELEFONIA
17744299;;F;31;CHILENO;;Millenial;LOS ANGELES                   ;BIO BIO;169990;1;1;1;1;169990;0;0;0;CELULAR A52 128 GB BLUE OPEN;TELEFONIA
14379486;Casado;F;45;CHILENO;;X;RENCA                         ;METROPOLITANA;395980;3;2;0;0;0;3;2;395980;CELULAR BMOBILE BS30 BLACK OPEN;TELEFONIA
10188014;;M;58;CHILENO;;Boomers;ILLAPEL                       ;COQUIMBO;195540;2;1;0;0;0;2;1;195540;CELULAR GALAXY A13 4+128GB BLACK;TELEFONIA
8939306;;F;60;CHILENO;;Boomers;ARICA                         ;ARICA Y PARINACOTA;154990;1;1;0;0;0;1;1;154990;CELULAR VIVO Y21S 128GB BLANCO WOM;TELEFONIA
18012501;;F;30;CHILENO;;Millenial;OVALLE                        ;COQUIMBO;499990;2;1;0;0;0;2;1;499990;CELULAR GALAXY A73 5G 256GB GRAY OPEN;TELEFONIA
6143275;;F;74;CHILENO;;Silencioso;CALERA                        ;VALPARAISO;579950;5;2;0;0;0;5;2;579950;Celular SA3 CLARO DIRECTO BLACK;TELEFONIA
17745641;;F;31;CHILENO;;Millenial;LA SERENA                     ;COQUIMBO;1470;3;4;0;0;0;3;4;1470;CHIP OPEN ENTEL;TELEFONIA
13970089;;F;42;CHILENO;;X;COIHAIQUE                     ;AYSEN;442983;2;2;0;0;0;2;2;442983;CELULAR SAMSUNG S21 FE 128GB GRAY OPEN;TELEFONIA
10749771;;M;56;CHILENO;;Boomers;VILLARICA                     ;ARAUCANIA;99990;1;1;0;0;0;1;1;99990;CELULAR OPPO A15 BLACK 32GB CLARO;TELEFONIA
12604063;;M;48;CHILENO;;Silencioso;PROVIDENCIA                   ;METROPOLITANA;339980;2;2;2;2;339980;0;0;0;CELULAR A52 128 GB BLACK OPEN;TELEFONIA
14703906;Casado;F;39;PERUANO;INGENIERO INDUSTRIAL;X;PROVIDENCIA                   ;METROPOLITANA;143980;2;1;2;1;143980;0;0;0;CELULAR REDMI NOTE 10 5G 4/128GB GRAPHITE GRAY O;TELEFONIA
14110226;;F;41;CHILENO;;X;ANTOFAGASTA                   ;ANTOFAGASTA;139990;1;1;1;1;139990;0;0;0;CELULAR A32 128 GB BLUE OPEN;TELEFONIA
12762392;Casado;F;46;CHILENO;;X;CHANCO                        ;MAULE;790940;6;4;4;2;513960;2;2;276980;CELULAR GALAXY A22 5G 4+128GB GRAY;TELEFONIA
18027070;Soltero;F;30;CHILENO;;Millenial;PROVIDENCIA                   ;METROPOLITANA;387950;6;3;6;3;387950;0;0;0;CELULAR REDMI NOTE 10S 128GB OCEAN BLUE;TELEFONIA
6909254;;M;70;CHILENO;;Silencioso;RENCA                         ;METROPOLITANA;146980;2;1;2;1;146980;0;0;0;CELULAR REDMI NOTE 10 5G US 128G NIGHTTIME BLUE;TELEFONIA
15431941;;M;40;CHILENO;;X;N/D;N/D;299990;1;1;0;0;0;1;1;299990;CELULAR MOTO G100 128GB VERDE BOREAL + HMDI OPEN;TELEFONIA
16091571;;M;37;CHILENO;;Millenial;PROVIDENCIA                   ;METROPOLITANA;283980;2;1;2;1;283980;0;0;0;CELULAR GALAXY A53 5G 6+128GB BLACK;TELEFONIA
19383779;;M;26;CHILENO;;Z;VILLARICA                     ;ARAUCANIA;149990;1;1;0;0;0;1;1;149990;CELULAR REDMI NOTE 10 5G 4/128GB GRAPHITE GRAY O;TELEFONIA
24448675;Soltero;M;34;COLOMBIANO;;Extranjero;PROVIDENCIA                   ;METROPOLITANA;429990;1;1;1;1;429990;0;0;0;CELULAR GALAXY A73 5G 256GB GRAY OPEN;TELEFONIA
14041261;;F;41;CHILENO;;X;ANCUD                         ;LOS LAGOS;138980;3;2;0;0;0;3;2;138980;CELULAR REDMI NOTE 10S 128GB PEBBLE WHITE;TELEFONIA
9776821;;M;52;CHILENO;;X;COIHAIQUE                     ;AYSEN;248120;2;1;0;0;0;2;1;248120;CELULAR REDMI NOTE 10S 128GB ONIX BLACK;TELEFONIA
7764282;;F;66;CHILENO;;Boomers;QUILLECO                      ;BIO BIO;718760;3;2;0;0;0;3;2;718760;IPHONE 11 64GB BLACK CLARO;TELEFONIA
19607590;;M;24;CHILENO;;Z;"";"";84970;5;3;0;0;0;5;3;84970;CELULAR XIAOMI REDMI 9A 2/32GB GRANITE GRAY;TELEFONIA
19767924;;M;23;CHILENO;;Z;ARAUCO;BIO-BIO;89990;1;1;1;1;89990;0;0;0;CELULAR Moto E7 Rosado WOM;TELEFONIA
17929282;Soltero;M;30;CHILENO;;Millenial;PROVIDENCIA                   ;METROPOLITANA;354820;2;1;0;0;0;2;1;354820;CELULAR REDMI NOTE 11S 6GB+128GB TWILIGHT BLUE O;TELEFONIA
6301116;;F;68;CHILENO;;Boomers;OLIVAR                        ;L.G.B.OÂ´HIGGINS;44990;2;1;0;0;0;2;1;44990;CELULAR BMOBILE C40 CRIS OPEN;TELEFONIA
9463575;;M;60;CHILENO;;Boomers;ISLA DE MAIPO                 ;METROPOLITANA;419980;2;2;0;0;0;2;2;419980;CELULAR VIVO Y01 AZUL ZAFIRO OPEN;TELEFONIA
13047505;;M;46;CHILENO;;X;N/D;N/D;399980;2;2;1;1;199990;1;1;199990;CELUALAR REDMI NOTE 11 PRO US 6GB+128GB STAR BLU;TELEFONIA
8740364;;M;62;CHILENO;;Boomers;PROVIDENCIA                   ;METROPOLITANA;990;3;1;0;0;0;3;1;990;CHIP OPEN ENTEL;TELEFONIA
26851524;;F;45;NO INFORMA NACIONALIDAD;;Extranjero;"";"";174980;2;1;2;1;174980;0;0;0;CELULAR A52 128 GB BLACK OPEN;TELEFONIA
19822832;;M;24;CHILENO;;Z;PEMUCO                        ;BIO BIO;421970;5;2;0;0;0;5;2;421970;CELULAR VIVO Y53S FANTASTIC RAINBOW 128GB OPEN;TELEFONIA
8980446;;F;60;CHILENO;;Boomers;CURICO                        ;MAULE;364980;2;2;0;0;0;2;2;364980;CELULAR REDMI 10C EU 4GB+128GB GRAPHITE GRAY OPE;TELEFONIA
12794348;;F;47;CHILENO;;X;N/D;N/D;1296930;8;6;0;0;0;8;6;1296930;CELULAR GALAXY A22 5G 4+128GB MINT;TELEFONIA
19494760;;F;24;CHILENO;;Z;ARICA                         ;TARAPACA;835170;4;3;0;0;0;4;3;835170;CELULAR REDMI NOTE 11S 6GB+128GB TWILIGHT BLUE O;TELEFONIA
9037069;;M;62;CHILENO;;Boomers;ISLA DE MAIPO                 ;METROPOLITANA;188100;5;3;0;0;0;5;3;188100;CELULAR GALAXY A03 4+128GB BLACK OPEN;TELEFONIA
13374356;Casado;M;44;CHILENO;;X;PROVIDENCIA                   ;METROPOLITANA;180390;3;2;0;0;0;3;2;180390;CELULAR XIAOMI REDMI 9C 64GB GRAY WOM;TELEFONIA
16885284;;F;33;CHILENO;;Millenial;N/D;N/D;580950;5;4;1;1;149990;4;3;430960;CELULAR GALAXY A22 5G 4+128GB GRAY;TELEFONIA
8888406;;M;57;CHILENO;;Boomers;RENCA                         ;METROPOLITANA;119990;1;1;0;0;0;1;1;119990;CELULAR GALAXY A03 4+128GB BLACK OPEN;TELEFONIA
12789235;;M;47;CHILENO;;X;PELLUHUE                      ;MAULE;1022520;7;6;0;0;0;7;6;1022520;CELULAR MOTO G60S 6/128 GB AZUL;TELEFONIA
8795538;;F;59;CHILENO;;Boomers;LEBU                          ;BIO BIO;24990;1;1;0;0;0;1;1;24990;CELULAR ALCATEL P1 DIRECTO CLARO BLACK;TELEFONIA
13224794;;F;46;CHILENO;;X;N/D;N/D;990;3;1;0;0;0;3;1;990;CHIP OPEN ENTEL;TELEFONIA
15516811;;F;38;CHILENO;;X;N/D;N/D;589960;5;2;0;0;0;5;2;589960;CELULAR A54 OPPO AZUL 128GB;TELEFONIA
7532170;;M;64;CHILENO;;Boomers;PENAFLOR                      ;METROPOLITANA;361100;6;3;0;0;0;6;3;361100;CELULAR VIVO Y20S NEBULA 128 GB BLUE OPEN;TELEFONIA
6985171;;M;67;CHILENO;;Boomers;VILLARICA                     ;ARAUCANIA;499990;1;1;0;0;0;1;1;499990;CELULAR SAMSUNG S21 FE 128GB LIGHT VIOLET OPEN;TELEFONIA
19086078;;M;26;CHILENO;;Z;N/D;N/D;1291910;10;7;7;4;531940;3;3;759970;CELULAR A52 128 GB BLUE OPEN;TELEFONIA
13608333;;F;43;CHILENO;;X;VILLARICA                     ;ARAUCANIA;219990;1;1;0;0;0;1;1;219990;CELULAR RENO5 LITE NEGRO 128GB;TELEFONIA
14347762;;F;42;CHILENO;;X;ILLAPEL                       ;COQUIMBO;259990;2;1;0;0;0;2;1;259990;CELULAR SMARTPHONE A52S 5G BLACK 128GB;TELEFONIA
16029675;;F;37;CHILENO;;Millenial;ALTO HOSPICIO;TARAPACA;317960;4;3;4;3;317960;0;0;0;CELULAR GALAXY A03 CORE 2GB 32GB BLACK OPEN;TELEFONIA
15705514;;F;39;CHILENO;;X;PROVIDENCIA                   ;METROPOLITANA;1131930;9;5;0;0;0;9;5;1131930;CELULAR A32 128 GB BLUE OPEN;TELEFONIA
13764198;;M;42;CHILENO;;X;QUILLOTA                      ;VALPARAISO;299960;4;3;0;0;0;4;3;299960;CELULAR VIVO Y01 AZUL ZAFIRO OPEN;TELEFONIA
11957081;;F;51;CHILENO;;X;CHILLAN                       ;BIO BIO;119990;3;1;0;0;0;3;1;119990;CELULAR VIVO Y15S WAVE GREEN OPEN;TELEFONIA
5106283;;F;75;CHILENO;;Silencioso;VILLA ALEMANA                 ;VALPARAISO;575980;2;1;2;1;575980;0;0;0;CELULAR IPHONE 12 MINI 64GB BLACK CLARO;TELEFONIA
19714213;;M;24;CHILENO;;Z;N/D;N/D;899990;3;1;3;1;899990;0;0;0;CELULAR GALAXY S22 ULTRA BLACK 128GB;TELEFONIA
10634620;;F;54;CHILENO;;Boomers;COLINA                        ;METROPOLITANA;751240;6;4;0;0;0;6;4;751240;CELULAR MOTO G60S 6/128 GB AZUL;TELEFONIA
9460265;;M;60;CHILENO;;Boomers;CURICO                        ;MAULE;320359;6;4;0;0;0;6;4;320359;CELULAR GALAXY A03 CORE 2GB 32GB BLACK OPEN;TELEFONIA
13528045;;M;43;CHILENO;;X;N/D;N/D;236980;2;1;2;1;236980;0;0;0;CELULAR REDMI NOTE 10 PRO 6+128GB ONYX GRAY;TELEFONIA
7428624;;F;70;CHILENO;;Silencioso;VINA DEL MAR                  ;VALPARAISO;94990;1;1;0;0;0;1;1;94990;CELULAR MOTO E7 32GB GRIS OPEN;TELEFONIA
17198054;;M;33;CHILENO;;Millenial;OSORNO                        ;LOS LAGOS;395970;3;2;3;2;395970;0;0;0;CELULAR A52 128 GB WHITE OPEN;TELEFONIA
18663409;;F;28;CHILENO;;Millenial;LAMPA                         ;METROPOLITANA;139980;2;1;2;1;139980;0;0;0;CELULAR XIAOMI REDMI 9A 2/32GB GRANITE GRAY;TELEFONIA
26675388;;M;37;HAITIANO;;Extranjero;PROVIDENCIA                   ;METROPOLITANA;159990;2;1;2;1;159990;0;0;0;CELULAR A32 128 GB BLACK OPEN;TELEFONIA
19392925;;F;25;CHILENO;;Z;MOLINA                        ;MAULE;102500;3;1;0;0;0;3;1;102500;CELULAR REDMI 9C 64GB MIDNIGHT GRAY MOVISTAR;TELEFONIA
18033230;;F;30;CHILENO;;Millenial;N/D;N/D;19980;4;2;0;0;0;4;2;19980;CHIP OPEN ENTEL;TELEFONIA
13120945;;F;46;CHILENO;;Boomers;QUILPUE                       ;VALPARAISO;414690;4;2;0;0;0;4;2;414690;CELULAR A52 128 GB BLACK OPEN;TELEFONIA
10473904;;M;56;CHILENO;;Boomers;VILLA ALEMANA                 ;VALPARAISO;123970;3;2;0;0;0;3;2;123970;Celular SA3 CLARO DIRECTO BLACK;TELEFONIA
11512211;;M;51;CHILENO;;X;OVALLE                        ;COQUIMBO;225970;3;2;0;0;0;3;2;225970;CELULAR VIVO Y01 AZUL ZAFIRO OPEN;TELEFONIA
14471543;;F;43;CHILENO;;X;PROVIDENCIA                   ;METROPOLITANA;252980;3;1;0;0;0;3;1;252980;CELULAR VIVO V21 5G 128GB SUNSET DAZZLE OPEN;TELEFONIA
11011558;;F;57;CHILENO;;Boomers;RENCA                         ;METROPOLITANA;149990;1;1;0;0;0;1;1;149990;CELULAR VIVO Y15S WAVE GREEN OPEN;TELEFONIA
16695739;Soltero;M;34;CHILENO;;Millenial;RENCA                         ;METROPOLITANA;429990;1;1;1;1;429990;0;0;0;CELULAR GALAXY A73 5G 256GB GRAY OPEN;TELEFONIA
12999668;Soltero;M;47;CHILENO;;X;PROVIDENCIA                   ;METROPOLITANA;169990;1;1;1;1;169990;0;0;0;CELULAR A52 128 GB LIGHT VIOLET OPEN;TELEFONIA
11111507;Casado;F;55;CHILENO;;Boomers;SAN CARLOS                    ;BIO BIO;139990;1;1;0;0;0;1;1;139990;CELULAR REDMI 10A US 64GB GRAPHITE GRAY OPEN;TELEFONIA
5923593;;M;74;CHILENO;;Silencioso;ARICA                         ;ARICA Y PARINACOTA;35990;1;1;0;0;0;1;1;35990;CELULAR BMOBILE BS30 BLACK OPEN;TELEFONIA
20007641;;F;24;CHILENO;;Z;TALCA;MAULE;614980;2;2;1;1;569990;1;1;44990;CELULAR IPHONE 12 64GB BLACK CLARO;TELEFONIA
15809614;;M;38;CHILENO;;Millenial;CHILLAN                       ;BIO BIO;219990;2;1;0;0;0;2;1;219990;CELULAR REDMI NOTE 11 PRO 128GB GRAPHITE;TELEFONIA
4856576;;F;74;CHILENO;;Silencioso;RECOLETA                      ;METROPOLITANA;219990;1;1;0;0;0;1;1;219990;CELULAR POCO X3 PRO 128G PHANTOM BLACK OPEN;TELEFONIA
13296446;;M;44;CHILENO;;X;RENCA                         ;METROPOLITANA;79990;2;1;0;0;0;2;1;79990;CELULAR REDMI 9A 32GB SKY BLUE;TELEFONIA
10554461;;F;58;CHILENO;;Boomers;N/D;N/D;184620;2;1;0;0;0;2;1;184620;CELULAR VIVO Y20S NEBULA 128 GB BLUE OPEN;TELEFONIA
12769732;;F;47;CHILENO;;X;LOS ALAMOS                    ;BIO BIO;169980;2;2;0;0;0;2;2;169980;CELULAR GALAXY A03 4+128GB BLACK OPEN;TELEFONIA
24815079;;M;42;VENEZOLANO;;Extranjero;QUINTA NORMAL                 ;METROPOLITANA;149990;2;1;2;1;149990;0;0;0;CELULAR GALAXY A22 5G 4+128GB GRAY;TELEFONIA
15074968;;F;41;CHILENO;;X;RENCA                         ;METROPOLITANA;99980;2;2;0;0;0;2;2;99980;CELULAR GALAXY A03 CORE 2GB 32GB BLACK OPEN;TELEFONIA
20231587;;M;23;CHILENO;;Z;PROVIDENCIA                   ;METROPOLITANA;169990;1;1;1;1;169990;0;0;0;CELULAR REDMI NOTE 11 4/128GB TWILIGHT BLUE OPEN;TELEFONIA
14490604;;F;52;CHILENO;;X;CAUQUENES                     ;MAULE;995450;5;4;0;0;0;5;4;995450;CELULAR A52 128 GB WHITE OPEN;TELEFONIA
20126217;;M;23;CHILENO;;Z;TOCOPILLA                     ;ANTOFAGASTA;139990;1;1;1;1;139990;0;0;0;CELULAR REDMI NOTE 11 4/128GB GRAPHITE GRAY OPEN;TELEFONIA
26828422;;F;23;NO INFORMA NACIONALIDAD;;Extranjero;PROVIDENCIA                   ;METROPOLITANA;169990;1;1;1;1;169990;0;0;0;CELULAR A52 128 GB BLUE OPEN;TELEFONIA
18230393;;F;32;CHILENO;;Millenial;ARAUCO                        ;BIO BIO;147400;2;1;0;0;0;2;1;147400;CELULAR GALAXY A03 CORE 2GB 32GB BLACK OPEN;TELEFONIA
13834560;;F;42;CHILENO;;X;PROVIDENCIA                   ;METROPOLITANA;303070;2;1;0;0;0;2;1;303070;CELULAR A52 128 GB LIGHT VIOLET OPEN;TELEFONIA
15118061;Casado;M;40;CHILENO;;X;PROVIDENCIA                   ;METROPOLITANA;213280;3;1;0;0;0;3;1;213280;CELULAR GALAXY A22 5G 4+128GB GRAY;TELEFONIA
14195815;Divorciado;F;41;CHILENO;CONTADOR AUDITOR;X;EL BOSQUE;METROPOLITANA;119990;1;1;1;1;119990;0;0;0;CELULAR GALAXY A22 5G 4+128GB GRAY;TELEFONIA
13115302;Casado;F;47;CHILENO;TECNICO EN ADMINISTRACION DE EMPRESAS;X;VILLARICA                     ;ARAUCANIA;199990;1;1;0;0;0;1;1;199990;CELULAR GALAXY A22 5G 4+128GB GRAY;TELEFONIA
11111881;;F;54;CHILENO;;Boomers;RENCA                         ;METROPOLITANA;149990;1;1;0;0;0;1;1;149990;CELULAR MOTOROLA G30 GRIS WOM 128 GB;TELEFONIA
27007845;Soltero;M;45;EXTRANJERO - NO INFORMA NACIONALIDAD;;Extranjero;N/D;N/D;149990;1;1;1;1;149990;0;0;0;CELULAR REDMI NOTE 10 5G 4/128GB GRAPHITE GRAY O;TELEFONIA
5367343;;M;76;CHILENO;;Silencioso;PAINE                         ;METROPOLITANA;400960;4;2;0;0;0;4;2;400960;CELULAR A32 128 GB LIGHT VIOLET OPEN;TELEFONIA
19221710;Soltero;F;26;CHILENO;TECNICO DE NIVEL MEDIO EN ALIMENTACION;Z;PROVIDENCIA                   ;METROPOLITANA;346960;6;2;0;0;0;6;2;346960;CELULAR GALAXY A03 CORE 2GB 32GB BLACK OPEN;TELEFONIA
10445345;;F;55;CHILENO;;Boomers;N/D;N/D;751780;7;3;0;0;0;7;3;751780;CELULAR GALAXY A53 5G 6+128GB WHITE;TELEFONIA
16685330;Casado;F;34;CHILENO;;Millenial;PROVIDENCIA                   ;METROPOLITANA;149990;2;1;2;1;149990;0;0;0;CELULAR GALAXY A22 5G 4+128GB MINT;TELEFONIA
8082721;Divorciado;M;65;CHILENO;;Boomers;RENCA                         ;METROPOLITANA;359060;2;1;0;0;0;2;1;359060;CELULAR SMARTPHONE A52S 5G BLACK 128GB;TELEFONIA
9203330;;F;59;CHILENO;;Boomers;NUEVA IMPERIAL                ;ARAUCANIA;563110;6;3;0;0;0;6;3;563110;CELULAR VIVO V21 5G 128GB SUNSET DAZZLE OPEN;TELEFONIA
17885824;;F;30;CHILENO;;Millenial;N/D;N/D;817670;8;5;0;0;0;8;5;817670;CELULAR VIVO Y20 BLACK 64GB MOVISTAR;TELEFONIA
15219794;;F;40;CHILENO;;X;PROVIDENCIA                   ;METROPOLITANA;149990;1;1;1;1;149990;0;0;0;CELULAR GALAXY A22 5G 4+128GB WHITE;TELEFONIA
11822881;;M;51;CHILENO;;X;COQUIMBO                      ;COQUIMBO;99980;2;2;0;0;0;2;2;99980;CELULAR REDMI 9A 32GB SKY BLUE;TELEFONIA
15475860;;F;39;CHILENO;;X;N/D;N/D;168980;2;2;0;0;0;2;2;168980;CELULAR REDMI NOTE 10 5G 4/128GB GRAPHITE GRAY O;TELEFONIA
19266595;;F;26;CHILENO;;Extranjero;CASTRO                        ;LOS LAGOS;30000;1;1;0;0;0;1;1;30000;PRODUCTO 2 SELECCION BANDA 2;TELEFONIA
13837023;;F;42;CHILENO;;X;"";"";143980;2;1;2;1;143980;0;0;0;CELULAR REDMI NOTE 10 5G 4/128GB GRAPHITE GRAY O;TELEFONIA
19727102;;F;25;CHILENO;;Z;PROVIDENCIA                   ;METROPOLITANA;186670;4;4;4;4;186670;0;0;0;CELULAR A52 128 GB BLACK OPEN;TELEFONIA
6258762;Casado;M;73;CHILENO;;Silencioso;RENCA                         ;METROPOLITANA;219990;1;1;0;0;0;1;1;219990;CELULAR SAMSUNG A23 128GB BLACK CLARO;TELEFONIA
5755211;;F;75;CHILENO;;Silencioso;ALTO HOSPICIO;TARAPACA;150140;3;1;0;0;0;3;1;150140;SMARTPHONE A22 VERDE 128GB;TELEFONIA
12014744;;F;54;CHILENO;;X;PADRE LAS CASAS               ;ARAUCANIA;176990;3;1;0;0;0;3;1;176990;CELULAR A54 OPPO AZUL 128GB;TELEFONIA
10534940;Casado;F;56;CHILENO;;Boomers;RENCA                         ;METROPOLITANA;159990;1;1;1;1;159990;0;0;0;CELULAR A32 128 GB LIGHT VIOLET OPEN;TELEFONIA
18658844;;M;28;CHILENO;;Silencioso;PROVIDENCIA                   ;METROPOLITANA;313970;3;2;3;2;313970;0;0;0;CELULAR XIAOMI REDMI 9A 32GB BLACK DIRECTO CLARO;TELEFONIA
16669433;;F;35;CHILENO;;Millenial;PROVIDENCIA                   ;METROPOLITANA;339980;2;1;2;1;339980;0;0;0;CELULAR A52 128 GB LIGHT VIOLET OPEN;TELEFONIA
26106081;;M;29;PERUANO;;Extranjero;N/D;N/D;602940;7;6;0;0;0;7;6;602940;CELULAR SMARTPHONE A52S 5G BLACK 128GB;TELEFONIA
14544835;;F;46;CHILENO;;X;N/D;N/D;401940;6;3;6;3;401940;0;0;0;CELULAR REDMI NOTE 10 5G 4/128GB GRAPHITE GRAY O;TELEFONIA
13162560;;F;45;CHILENO;;X;LA GRANJA                     ;METROPOLITANA;1192240;15;7;0;0;0;15;7;1192240;CELULAR VIVO Y21S 128GB BLANCO WOM;TELEFONIA
11846165;;M;50;CHILENO;;X;PROVIDENCIA                   ;METROPOLITANA;403980;2;1;2;1;403980;0;0;0;IPHONE 11 64GB BLACK CLARO;TELEFONIA
18661162;Soltero;M;28;CHILENO;ENFERMERO;Millenial;PROVIDENCIA                   ;METROPOLITANA;869990;2;1;2;1;869990;0;0;0;CELULAR GALAXY S22 ULTRA BLACK 128GB;TELEFONIA
18623595;;F;28;CHILENO;;Millenial;N/D;N/D;69880;3;1;0;0;0;3;1;69880;CELULAR XIAOMI REDMI 9C 64GB GRAY WOM;TELEFONIA
16323760;;F;35;CHILENO;;Millenial;PARRAL                        ;MAULE;259970;3;2;0;0;0;3;2;259970;CELULAR REDMI NOTE 10 PRO 6+128GB ONYX GRAY;TELEFONIA
12725866;;F;46;CHILENO;;X;RENGO                         ;L.G.B.OÂ´HIGGINS;186580;6;4;0;0;0;6;4;186580;CELULAR ZTE A3 2020 GRIS DIRECTO CLARO;TELEFONIA
11516127;;F;52;CHILENO;;X;LA LIGUA                      ;VALPARAISO;427111;6;2;0;0;0;6;2;427111;CELULAR REDMI NOTE 10S 128GB ONIX BLACK;TELEFONIA
17901479;;F;30;CHILENO;;Millenial;CONSTITUCION                  ;MAULE;50485;3;2;0;0;0;3;2;50485;CELULAR BMOBILE C40 CRIS OPEN;TELEFONIA
9410714;;F;58;CHILENO;;Boomers;QUINTERO                      ;VALPARAISO;166980;2;1;2;1;166980;0;0;0;CELULAR REDMI NOTE 11 4/128GB TWILIGHT BLUE OPEN;TELEFONIA
13172570;;M;44;CHILENO;;X;CALAMA                        ;ANTOFAGASTA;252970;3;2;0;0;0;3;2;252970;CELULAR VIVO Y11S PHANTOM BLACK OPEN;TELEFONIA
10397241;;F;56;CHILENO;;Boomers;NUEVA IMPERIAL                ;ARAUCANIA;149991;2;1;0;0;0;2;1;149991;CELULAR A12 128GB Negro OPEN;TELEFONIA
6694054;;M;53;CHILENO;;X;MELIPILLA                     ;METROPOLITANA;669980;2;2;0;0;0;2;2;669980;CELULAR REDMI NOTE 11 GRAPHITE GRAY + REDMI BUDS;TELEFONIA
12717320;;F;48;CHILENO;;X;ARICA                         ;ARICA Y PARINACOTA;449980;2;2;1;1;229990;1;1;219990;CELULAR A52 128 GB BLACK OPEN;TELEFONIA
14315229;;F;46;CHILENO;;X;CHONCHI                       ;LOS LAGOS;237630;3;2;0;0;0;3;2;237630;CELULAR VIVO Y11S PHANTON BLACK 32GB MOVISTAR;TELEFONIA
8083228;Casado;F;68;CHILENO;;Boomers;RENCA                         ;METROPOLITANA;288180;2;1;0;0;0;2;1;288180;CELULAR A52 128 GB BLACK OPEN;TELEFONIA
6351716;;M;73;CHILENO;;Silencioso;SAN VICENTE                   ;L.G.B.OÂ´HIGGINS;638960;4;3;0;0;0;4;3;638960;CELULAR SMARTPHONE A52S 5G BLACK 128GB;TELEFONIA
17481073;;M;31;CHILENO;;Millenial;QUILPUE                       ;VALPARAISO;334970;3;1;0;0;0;3;1;334970;VIVO Y53S DEEP SEA BLUE 128GB OPEN;TELEFONIA
25773578;;F;58;EXTRANJERO - NO INFORMA NACIONALIDAD;;Extranjero;RENGO                         ;L.G.B.OÂ´HIGGINS;94990;1;1;0;0;0;1;1;94990;CELULAR OPPO A15 BLACK 32GB CLARO;TELEFONIA
19062303;;F;27;CHILENO;;Z;CURACAVI;METROPOLITANA;112990;3;2;0;0;0;3;2;112990;CELULAR VIVO Y20 NEBULA BLUE OPEN;TELEFONIA
11181081;Soltero;M;55;CHILENO;;Boomers;PROVIDENCIA                   ;METROPOLITANA;146800;2;1;0;0;0;2;1;146800;CELULAR VIVO Y11S PHANTOM BLACK OPEN;TELEFONIA
11136888;;M;55;CHILENO;;Boomers;RENCA                         ;METROPOLITANA;114990;2;1;0;0;0;2;1;114990;CELULAR GALAXY A22 5G 4+128GB MINT;TELEFONIA
16748848;;F;34;CHILENO;;Millenial;PROVIDENCIA                   ;METROPOLITANA;199990;1;1;0;0;0;1;1;199990;CELULAR REDMI NOTE 11 4/128GB TWILIGHT BLUE OPEN;TELEFONIA
23463259;;F;37;BOLIVIANO;;Extranjero;CALAMA                        ;ANTOFAGASTA;289970;4;3;0;0;0;4;3;289970;CELULAR A32 128 GB BLUE OPEN;TELEFONIA
19896976;;M;23;CHILENO;;Z;SAN JAVIER                    ;MAULE;1311920;10;5;0;0;0;10;5;1311920;CELULAR GALAXY A53 5G 6+128GB BLUE;TELEFONIA
18620178;;F;29;CHILENO;;Millenial;PROVIDENCIA                   ;METROPOLITANA;509340;5;3;0;0;0;5;3;509340;CELULAR VIVO Y20S NEBULA 128 GB BLUE OPEN;TELEFONIA
16957120;;M;33;CHILENO;;Millenial;QUELLON                       ;LOS LAGOS;880520;4;2;4;2;880520;0;0;0;IPHONE 12 128GB BLACK CLARO;TELEFONIA
12162713;;M;48;CHILENO;;X;OSORNO                        ;LOS LAGOS;434970;4;2;0;0;0;4;2;434970;CELULAR REDMI NOTE 11 4/128GB TWILIGHT BLUE OPEN;TELEFONIA
18448309;Soltero;M;28;CHILENO;;Millenial;PROVIDENCIA                   ;METROPOLITANA;529980;2;2;0;0;0;2;2;529980;CELULAR GALAXY A53 5G 6+128GB BLACK;TELEFONIA
9113885;;M;61;CHILENO;;Boomers;CALERA                        ;VALPARAISO;239982;4;2;0;0;0;4;2;239982;CELULAR VIVO Y20S NEBULA 128 GB BLUE OPEN;TELEFONIA
25899415;;M;34;VENEZOLANO;;Extranjero;QUINTA NORMAL                 ;METROPOLITANA;299980;2;2;0;0;0;2;2;299980;CELULAR VIVO V21 5G DUSK BLUE 128GB OPEN;TELEFONIA
13050270;Soltero;M;46;CHILENO;;X;PROVIDENCIA                   ;METROPOLITANA;853980;2;1;2;1;853980;0;0;0;CELULAR IPHONE 13 256GB MIDNIGHT CLARO;TELEFONIA
26060445;;M;32;VENEZOLANO;;Extranjero;"";"";517940;7;4;4;2;282960;3;2;234980;CELULAR Moto G20 Blue WOM;TELEFONIA
17269486;Soltero;F;33;CHILENO;CIRUJANO DENTISTA;Millenial;PROVIDENCIA                   ;METROPOLITANA;555980;2;1;2;1;555980;0;0;0;Galaxy Z Flip3 128GB LAVENDER;TELEFONIA
19279648;Soltero;F;26;CHILENO;TECNICO DE NIVEL SUPERIOR EN IMAGENOLOGIA Y RADIOTERAPIA;Z;PROVIDENCIA                   ;METROPOLITANA;204980;2;2;1;1;179990;1;1;24990;CELULAR REDMI NOTE 11S 6GB+128GB TWILIGHT BLUE O;TELEFONIA
16379697;;M;36;CHILENO;;Millenial;PROVIDENCIA                   ;METROPOLITANA;193930;2;1;0;0;0;2;1;193930;CELULAR MOTOROLA G20 EDICION ESPECIAL VERDE CLAR;TELEFONIA
19190989;Soltero;M;26;CHILENO;TECNICO ELECTRICO;Z;PROVIDENCIA                   ;METROPOLITANA;173980;2;1;2;1;173980;0;0;0;CELULAR XIAOMI REDMI NOTE 10S BLANCO WOM;TELEFONIA
9984652;;F;60;CHILENO;;Boomers;CAUQUENES                     ;MAULE;213980;2;1;0;0;0;2;1;213980;CELULAR A52 128 GB BLACK OPEN;TELEFONIA
9444532;;M;57;CHILENO;;Millenial;"";"";236140;2;1;0;0;0;2;1;236140;CELULAR GALAXY A22 5G 4+128GB GRAY;TELEFONIA
11566702;;M;53;CHILENO;;X;EL BOSQUE                     ;METROPOLITANA;142640;2;1;0;0;0;2;1;142640;SMARTPHONE A03s 64 GB Red DS;TELEFONIA
19340453;;F;26;CHILENO;;Z;"";"";219990;2;1;0;0;0;2;1;219990;CELULAR VIVO V21 5G 128GB SUNSET DAZZLE OPEN;TELEFONIA
6299049;;M;72;CHILENO;;Silencioso;SAN VICENTE                   ;L.G.B.OÂ´HIGGINS;149991;3;1;0;0;0;3;1;149991;CELULAR GALAXY A22 5G 4+128GB GRAY;TELEFONIA
19000074;;F;27;CHILENO;;Z;COLLIPULLI                    ;ARAUCANIA;169991;2;1;0;0;0;2;1;169991;CELULAR REDMI NOTE 11 4/128GB GRAPHITE GRAY OPEN;TELEFONIA
11280503;;F;54;CHILENO;;X;PERALILLO                     ;L.G.B.OÂ´HIGGINS;153640;2;1;0;0;0;2;1;153640;Celular Y8P ENTEL TRIANGULADO NEGRO;TELEFONIA
14041568;;M;40;CHILENO;;X;CHILE CHICO                   ;AYSEN;389980;2;2;0;0;0;2;2;389980;CELULAR A52 128 GB BLACK OPEN;TELEFONIA
24486583;;F;30;BOLIVIANO;;Extranjero;N/D;N/D;162980;2;1;0;0;0;2;1;162980;CELULAR LG K61 Gris OPEN;TELEFONIA
15839405;;M;37;CHILENO;;Millenial;PROVIDENCIA                   ;METROPOLITANA;303980;2;1;2;1;303980;0;0;0;CELULAR IPHONE SE 64GB DIRECTO CLARO;TELEFONIA
13486268;;M;44;CHILENO;;X;PROVIDENCIA                   ;METROPOLITANA;143980;2;1;2;1;143980;0;0;0;CELULAR MOTO G30 128GB LILA PASTEL OPEN;TELEFONIA
5066531;;F;76;CHILENO;;Silencioso;RENCA                         ;METROPOLITANA;179980;2;2;0;0;0;2;2;179980;CELULAR GALAXY A03 CORE 2GB 32GB BLACK OPEN;TELEFONIA
22455719;Soltero;M;26;CHILENO;;Extranjero;PROVIDENCIA                   ;METROPOLITANA;465980;2;1;2;1;465980;0;0;0;CELULAR XIAOMI 11T PRO 8/256GB CELESTIAL BLUE KI;TELEFONIA
13579615;;F;43;CHILENO;;X;SANTA BARBARA                 ;BIO BIO;351761;3;1;0;0;0;3;1;351761;CELULAR SMARTPHONE A52S 5G LIGHT VIOLET 128GB;TELEFONIA
12584498;;M;48;CHILENO;;X;LAS CONDES;METROPOLITANA;651980;3;1;3;1;651980;0;0;0;Galaxy Z Flip3 128GB LAVENDER;TELEFONIA
8990245;;M;62;CHILENO;;Boomers;SANTIAGO                      ;METROPOLITANA;89990;1;1;0;0;0;1;1;89990;CELULAR MOTO E7 32GB GRIS OPEN;TELEFONIA
9561195;;M;58;CHILENO;;Boomers;CHIMBARONGO                   ;L.G.B.OÂ´HIGGINS;157980;3;1;0;0;0;3;1;157980;CELULAR GALAXY A22 5G 4+128GB GRAY;TELEFONIA
6949139;Casado;M;68;CHILENO;;Boomers;PROVIDENCIA                   ;METROPOLITANA;39990;1;1;0;0;0;1;1;39990;CELULAR BMOBILE C40 CRIS OPEN;TELEFONIA
10513296;;M;56;CHILENO;;Boomers;N/D;N/D;109990;1;1;0;0;0;1;1;109990;SMARTPHONE A03S 32 GB ROJO;TELEFONIA
7418271;;M;67;CHILENO;;Millenial;PROVIDENCIA                   ;METROPOLITANA;96780;2;1;0;0;0;2;1;96780;CELULAR GALAXY A03 CORE 2GB 32GB BLACK OPEN;TELEFONIA
12810563;;F;47;CHILENO;;X;LOS ANGELES                   ;BIO BIO;133930;3;1;0;0;0;3;1;133930;CELULAR MOTOROLA G30 GRIS WOM 128 GB;TELEFONIA
16048485;;F;40;CHILENO;;X;MARIQUINA                     ;LOS LAGOS;195960;4;2;0;0;0;4;2;195960;CELULAR VIVO Y20S NEBULA 128 GB BLUE OPEN;TELEFONIA
15884173;;F;37;CHILENO;;Millenial;"";"";530990;1;1;1;1;530990;0;0;0;CELULAR SAMSUNG S21 FE 128GB LIGHT VIOLET OPEN;TELEFONIA
19210092;;M;26;CHILENO;;Z;RENGO                         ;L.G.B.OÂ´HIGGINS;309970;3;3;0;0;0;3;3;309970;CELULAR MOTOROLA G20 EDICION ESPECIAL VERDE CLAR;TELEFONIA
18342095;;M;29;CHILENO;;Millenial;LINARES                       ;MAULE;342910;4;3;0;0;0;4;3;342910;CELULAR MOTOROLA G30 GRIS WOM 128 GB;TELEFONIA
19012065;;M;27;CHILENO;;Z;RANCAGUA                      ;L.G.B.OÂ´HIGGINS;179990;2;1;0;0;0;2;1;179990;CELULAR MOTO G50 AZUL 128 GB OPEN;TELEFONIA
22999026;;M;32;PERUANO;;Extranjero;PROVIDENCIA                   ;METROPOLITANA;99990;1;1;1;1;99990;0;0;0;NOKIA G10 3/64 GB BLUE TRI WOM;TELEFONIA
20389861;;F;22;CHILENO;;Z;NUNOA;METROPOLITANA;505580;5;1;0;0;0;5;1;505580;CELULAR GALAXY S20FE 128GB CLOUD LAVENDER OPEN;TELEFONIA
7827464;;M;66;CHILENO;;Boomers;LOS SAUCES                    ;ARAUCANIA;432861;4;3;0;0;0;4;3;432861;CELULAR XIAOMI REDMI 9A 32GB VERDE CLARO;TELEFONIA
12184803;;M;49;CHILENO;;X;PROVIDENCIA                   ;METROPOLITANA;169990;1;1;0;0;0;1;1;169990;CELULAR GALAXY A22 5G 4+128GB MINT;TELEFONIA
18099987;;M;30;CHILENO;;Millenial;PROVIDENCIA                   ;METROPOLITANA;483980;2;1;2;1;483980;0;0;0;CELULAR XIAOMI 11T PRO 8/256GB MOON WHITE;TELEFONIA
8931235;Soltero;M;61;CHILENO;;Boomers;RENCA                         ;METROPOLITANA;147640;2;1;0;0;0;2;1;147640;SMARTPHONE A03S 32 GB ROJO;TELEFONIA
26860901;;M;26;VENEZOLANO;;Extranjero;N/D;N/D;185980;2;1;2;1;185980;0;0;0;CELULAR A32 128 GB BLUE OPEN;TELEFONIA
13374708;;F;43;CHILENO;;X;RETIRO                        ;MAULE;199990;1;1;0;0;0;1;1;199990;CELULAR A52 128 GB BLACK OPEN;TELEFONIA
5840683;;M;72;CHILENO;;Silencioso;VALLENAR;ATACAMA;109990;1;1;0;0;0;1;1;109990;SMARTPHONE A03S 32 GB ROJO;TELEFONIA
20426017;;F;21;CHILENO;;Z;COIHAIQUE                     ;AYSEN;19990;2;1;0;0;0;2;1;19990;CELULAR XIAOMI REDMI 9A 32GB GRANITE GRAY TRI WO;TELEFONIA
19748811;;F;24;CHILENO;;Silencioso;PROVIDENCIA                   ;METROPOLITANA;215990;1;1;1;1;215990;0;0;0;CELULAR SMARTPHONE A52S 5G LIGHT GREEN 128GB;TELEFONIA
14622680;;F;41;CHILENO;;X;RENCA                         ;METROPOLITANA;219990;1;1;0;0;0;1;1;219990;CELULAR A52 128 GB BLACK OPEN;TELEFONIA
18806146;;M;27;CHILENO;;Z;LOS ANGELES                   ;BIO BIO;159990;1;1;1;1;159990;0;0;0;CELULAR GALAXY A22 5G 4+128GB GRAY;TELEFONIA
15830284;;M;47;CHILENO;;X;TALCAHUANO                    ;BIO BIO;332990;4;2;0;0;0;4;2;332990;CELULAR GALAXY A03 4+64GB BLUE OPEN;TELEFONIA
8257119;Casado;M;62;CHILENO;;Boomers;PROVIDENCIA                   ;METROPOLITANA;42350;2;1;0;0;0;2;1;42350;CELULAR BMOBILE BS30 BLACK OPEN;TELEFONIA
13762700;;M;42;CHILENO;;X;LA LIGUA                      ;VALPARAISO;282981;3;1;0;0;0;3;1;282981;CELULAR A52 128 GB BLACK OPEN;TELEFONIA
9216545;Casado;F;61;CHILENO;;Boomers;RENCA                         ;METROPOLITANA;169990;1;1;0;0;0;1;1;169990;CELULAR GALAXY A22 5G 4+128GB MINT;TELEFONIA
18489789;;F;28;CHILENO;;Millenial;SAN CARLOS                    ;BIO BIO;234970;3;2;2;1;199980;1;1;34990;CELULAR NOKIA 225 4G BLACK MOVISTAR DIRECTO;TELEFONIA
10081618;;F;59;CHILENO;;Boomers;AISEN                         ;AYSEN;189990;1;1;0;0;0;1;1;189990;CELULAR MOTO G60 4/128 GB SILVER OPEN;TELEFONIA
14304436;;F;46;CHILENO;;X;SAN CARLOS                    ;BIO BIO;129500;2;1;0;0;0;2;1;129500;CELULAR VIVO Y11S NEGRO WOM;TELEFONIA
9011616;;M;61;CHILENO;;Boomers;TALCA                         ;MAULE;99990;1;1;0;0;0;1;1;99990;CELULAR VIVO Y20 NEBULA BLUE OPEN;TELEFONIA
10958968;;F;50;CHILENO;;X;COIHAIQUE                     ;AYSEN;129990;2;1;0;0;0;2;1;129990;CELULAR REDMI NOTE 11 GRAPHITE GRAY + REDMI BUDS;TELEFONIA
25450998;;F;38;HAITIANO;;Extranjero;PROVIDENCIA                   ;METROPOLITANA;809960;9;3;0;0;0;9;3;809960;CELULAR VIVO Y20S NEBULA 128 GB BLUE OPEN;TELEFONIA
17217703;;M;32;CHILENO;;Millenial;LOS ANGELES                   ;BIO BIO;97640;3;1;0;0;0;3;1;97640;CELULAR VIVO Y20S NEBULA 128 GB BLUE OPEN;TELEFONIA
18680538;Casado;M;28;CHILENO;;Millenial;PROVIDENCIA                   ;METROPOLITANA;99991;2;1;0;0;0;2;1;99991;CELULAR VIVO Y20 NEBULA BLUE OPEN;TELEFONIA
26228931;Soltero;M;43;NO INFORMA NACIONALIDAD;;Extranjero;ALTO HOSPICIO;TARAPACA;187640;3;1;0;0;0;3;1;187640;CELULAR A12 128GB Negro OPEN;TELEFONIA
6994670;Casado;M;65;CHILENO;ENFERMERO;Boomers;CHILLAN                       ;BIO BIO;219990;1;1;0;0;0;1;1;219990;CELULAR A52 128 GB BLACK OPEN;TELEFONIA
8196569;Casado;M;63;CHILENO;BIOLOGO MARINO;Boomers;RENCA                         ;METROPOLITANA;159990;1;1;1;1;159990;0;0;0;CELULAR GALAXY A22 5G 4+128GB MINT;TELEFONIA
15733726;;M;38;CHILENO;;X;PROVIDENCIA                   ;METROPOLITANA;114980;2;2;2;2;114980;0;0;0;CELULAR XIAOMI REDMI 9A 2/32GB GRANITE GRAY;TELEFONIA
14046126;Casado;M;40;CHILENO;CONTADOR AUDITOR;X;PROVIDENCIA                   ;METROPOLITANA;189990;1;1;0;0;0;1;1;189990;CELULAR GALAXY A22 5G 4+128GB GRAY;TELEFONIA
10875009;;M;56;CHILENO;;Boomers;INDEPENDENCIA                 ;METROPOLITANA;114990;2;1;0;0;0;2;1;114990;CELULAR GALAXY A22 5G 4+128GB GRAY;TELEFONIA
3781950;;M;85;CHILENO;;Silencioso;TOCOPILLA                     ;ANTOFAGASTA;159990;1;1;0;0;0;1;1;159990;CELULAR MOTOROLA G9 PLAY 64GB SPRING PINK OPEN;TELEFONIA
20486470;;F;21;CHILENO;;Z;PROVIDENCIA                   ;METROPOLITANA;131980;2;1;2;1;131980;0;0;0;CELULAR XIAOMI REDMI 9C 64GB GRAY WOM;TELEFONIA
8846037;;M;63;CHILENO;;Boomers;ANTOFAGASTA                   ;ANTOFAGASTA;38991;2;1;0;0;0;2;1;38991;CELULAR BMOBILE C40 CRIS OPEN;TELEFONIA
13006521;;F;46;CHILENO;;X;COLINA                        ;METROPOLITANA;418940;6;3;0;0;0;6;3;418940;CELULAR A52 128 GB LIGHT VIOLET OPEN;TELEFONIA
16941071;Soltero;F;33;CHILENO;INGENIERO EN PREVENCION DE RIESGOS;Millenial;PROVIDENCIA                   ;METROPOLITANA;119500;2;1;0;0;0;2;1;119500;CELULAR GALAXY A03 CORE 2GB 32GB BLUE OPEN;TELEFONIA
19705370;;F;24;CHILENO;;Z;PROVIDENCIA                   ;METROPOLITANA;329970;3;3;2;2;189980;1;1;139990;SMARTPHONE A03s 64 GB Red DS;TELEFONIA
10835520;;F;50;CHILENO;;X;PROVIDENCIA                   ;METROPOLITANA;89991;2;1;0;0;0;2;1;89991;CELULAR XIAOMI REDMI 9A SE 2/32GB GB PEACOCK GRE;TELEFONIA
25844026;;M;27;HAITIANO;;Extranjero;LITUECHE                      ;L.G.B.OÂ´HIGGINS;333971;4;2;0;0;0;4;2;333971;CELULAR VIVO Y20S NEBULA 128 GB BLUE OPEN;TELEFONIA
15450151;;M;40;CHILENO;;X;SAN CARLOS                    ;BIO BIO;364980;2;2;0;0;0;2;2;364980;VIVO Y53S DEEP SEA BLUE 128GB OPEN;TELEFONIA
15369473;;M;39;CHILENO;;X;PUENTE ALTO;METROPOLITANA;0;0;2;0;0;0;0;2;0;CELULAR GALAXY A22 5G 4+128GB GRAY;TELEFONIA
16726453;;F;34;CHILENO;;Millenial;PROVIDENCIA                   ;METROPOLITANA;291980;2;2;0;0;0;2;2;291980;CELULAR SMARTPHONE A52S 5G LIGHT VIOLET 128GB;TELEFONIA
19478851;;F;25;CHILENO;;Z;TEMUCO                        ;ARAUCANIA;460970;3;2;0;0;0;3;2;460970;CELULAR POCO F3 128 GB DEEP OCEAN BLUE;TELEFONIA
26451554;;M;27;VENEZOLANO;;Extranjero;LOS ANDES                     ;VALPARAISO;389980;2;2;2;2;389980;0;0;0;CELULAR REDMI NOTE 10 PRO 6+128GB GRADIENT BRONZ;TELEFONIA
13535542;;F;42;CHILENO;;X;LA SERENA                     ;COQUIMBO;422620;6;3;5;2;342630;1;1;79990;CELULAR XIAOMI REDMI 9A 32GB VERDE CLARO;TELEFONIA
19045163;;F;26;CHILENO;;Z;PROVIDENCIA                   ;METROPOLITANA;109991;2;1;0;0;0;2;1;109991;CELULAR VIVO Y11S 32GB NEBULA BLUE OPEN;TELEFONIA
9072102;Casado;F;60;CHILENO;;Boomers;RENCA                         ;METROPOLITANA;209990;1;1;1;1;209990;0;0;0;CELULAR A52 128 GB BLUE OPEN;TELEFONIA
15915497;;F;37;CHILENO;;Millenial;RENCA                         ;METROPOLITANA;179991;2;1;0;0;0;2;1;179991;CELULAR MOTO G31 4/128 GB GRIS METEORITO OPEN;TELEFONIA
8275818;;F;64;CHILENO;;Boomers;PANGUIPULLI                   ;LOS RIOS;821130;7;4;0;0;0;7;4;821130;CELULAR A52 128 GB LIGHT VIOLET OPEN;TELEFONIA
13280512;;F;44;CHILENO;;X;CONCHALI;METROPOLITANA;213980;2;1;2;1;213980;0;0;0;CELULAR A52 128 GB BLACK OPEN;TELEFONIA
7552490;;F;66;CHILENO;;Boomers;VILLARICA                     ;ARAUCANIA;187640;2;1;0;0;0;2;1;187640;CELULAR MOTOROLA G20 EDICION ESPECIAL VERDE CLAR;TELEFONIA
17909743;;M;29;CHILENO;;Millenial;PROVIDENCIA                   ;METROPOLITANA;189630;3;2;0;0;0;3;2;189630;SMARTPHONE A03S 64 GB NEGRO;TELEFONIA
16439327;Casado;F;35;CHILENO;ENFERMERA;Millenial;SALAMANCA                     ;COQUIMBO;457110;5;2;2;1;229980;3;1;227130;CELULAR A52 128 GB LIGHT VIOLET OPEN;TELEFONIA
19467381;;F;25;CHILENO;;Z;VALLENAR;ATACAMA;964940;6;2;0;0;0;6;2;964940;CELULAR SAMSUNG S21 FE 128GB LIGHT VIOLET OPEN;TELEFONIA
7619509;;F;68;CHILENO;;Boomers;TALCA                         ;MAULE;24990;1;1;0;0;0;1;1;24990;CELULAR AZUMI L4G BLACK CLARO;TELEFONIA
17519432;;M;32;CHILENO;;Millenial;N/D;N/D;509980;2;2;0;0;0;2;2;509980;CELULAR SMARTPHONE A52S 5G BLACK 128GB;TELEFONIA
5459826;;M;75;CHILENO;;Silencioso;LOTA                          ;BIO BIO;299981;3;2;0;0;0;3;2;299981;CELULAR A12 128GB Azul OPEN;TELEFONIA
8156156;;M;65;CHILENO;;Boomers;LAS CABRAS                    ;L.G.B.OÂ´HIGGINS;538930;8;4;0;0;0;8;4;538930;CELULAR Moto One Fusion 128GB Blue WOM;TELEFONIA
16155294;;F;36;CHILENO;;Millenial;PROVIDENCIA                   ;METROPOLITANA;179990;1;1;0;0;0;1;1;179990;CELULAR REDMI NOTE 10S 128GB ONIX BLACK;TELEFONIA
10466013;;F;58;CHILENO;;Boomers;NUEVA IMPERIAL                ;ARAUCANIA;235980;3;1;0;0;0;3;1;235980;CELULAR MOTO G60S 6/128 GB AZUL;TELEFONIA
16690168;;F;34;CHILENO;;Millenial;PROVIDENCIA                   ;METROPOLITANA;195980;2;1;2;1;195980;0;0;0;CELULAR POCO X3 PRO 128 GB FROST BLUE;TELEFONIA
15711053;;F;38;CHILENO;;Millenial;N/D;N/D;153970;3;1;0;0;0;3;1;153970;SMARTPHONE A03s 64 GB Red DS;TELEFONIA
18321981;Soltero;F;29;CHILENO;TECNOLOGO MEDICO;Millenial;PROVIDENCIA                   ;METROPOLITANA;199990;1;1;0;0;0;1;1;199990;CELULAR POCO X3 PRO 128G PHANTOM BLACK OPEN;TELEFONIA
6820263;;F;70;CHILENO;;Silencioso;CERRO NAVIA                   ;METROPOLITANA;166980;2;1;0;0;0;2;1;166980;CELULAR A12 128GB Rojo OPEN;TELEFONIA
16323710;Soltero;M;35;CHILENO;INGENIERO EN BIOTECNOLOGIA MOLECULAR;Millenial;PROVIDENCIA                   ;METROPOLITANA;223980;2;1;2;1;223980;0;0;0;CELULAR MOTO G60S 6/128 GB AZUL;TELEFONIA
7919162;;M;63;CHILENO;;Boomers;MELIPILLA                     ;METROPOLITANA;613900;10;5;0;0;0;10;5;613900;SMARTPHONE A22 BLANCO 128GB;TELEFONIA
8291216;;F;60;CHILENO;;Boomers;CABILDO                       ;VALPARAISO;928252;10;5;2;1;574980;8;4;353272;CELULAR XIAOMI REDMI 9A 32GB GRANITE GRAY TRI WO;TELEFONIA
14097951;;M;41;CHILENO;;X;AISEN                         ;AYSEN;552970;3;1;0;0;0;3;1;552970;CELULAR A52 128 GB LIGHT VIOLET OPEN;TELEFONIA
6687045;;M;70;CHILENO;;Silencioso;TEODORO SCHMIDT               ;ARAUCANIA;50980;2;1;0;0;0;2;1;50980;CELULAR BMOBILE C40 CRIS OPEN;TELEFONIA
12661581;;F;47;CHILENO;;X;PUTAENDO                      ;VALPARAISO;1200810;8;6;0;0;0;8;6;1200810;CELULAR MOTO G60 4/128 GB SILVER OPEN;TELEFONIA
13811999;;F;41;CHILENO;;X;NUEVA IMPERIAL                ;ARAUCANIA;89990;1;1;0;0;0;1;1;89990;CELULAR XIAOMI REDMI 9A 32GB GRANITE GRAY TRI WO;TELEFONIA
13758836;;M;42;CHILENO;;X;TALAGANTE                     ;METROPOLITANA;278970;5;2;3;1;133980;2;1;144990;CELULAR A32 128 GB BLACK OPEN;TELEFONIA
18996531;;F;27;CHILENO;;Z;QUILPUE                       ;VALPARAISO;514920;8;4;6;3;274940;2;1;239980;CELULAR A52 128 GB LIGHT VIOLET OPEN;TELEFONIA
17197277;;F;33;CHILENO;;Millenial;OSORNO                        ;LOS LAGOS;24990;1;1;0;0;0;1;1;24990;CELULAR AZUMI L4G BLACK CLARO;TELEFONIA
8817676;;M;60;CHILENO;;Boomers;COIHAIQUE                     ;AYSEN;777940;6;4;0;0;0;6;4;777940;CELULAR A12 128GB Azul OPEN;TELEFONIA
11221009;;M;54;CHILENO;;X;SALAMANCA                     ;COQUIMBO;412960;4;2;0;0;0;4;2;412960;SMARTPHONE A22 BLANCO 128GB;TELEFONIA
16839236;;M;34;CHILENO;;Millenial;COQUIMBO                      ;COQUIMBO;603980;2;1;2;1;603980;0;0;0;Celular Galaxy S21 Plus Phantom Black 128GB;TELEFONIA
25955417;;F;41;EXTRANJERO - NO INFORMA NACIONALIDAD;;Extranjero;TILTIL                        ;METROPOLITANA;305980;2;1;0;0;0;2;1;305980;CELULAR A52 128 GB BLUE OPEN;TELEFONIA
13179867;Soltero;F;48;CHILENO;;X;OVALLE                        ;COQUIMBO;99990;1;1;0;0;0;1;1;99990;CELULAR GALAXY A03 CORE 2GB 32GB BLACK OPEN;TELEFONIA
23169453;;M;61;ECUATORIANO;;Extranjero;VALLENAR;ATACAMA;599991;2;1;0;0;0;2;1;599991;CELULAR SAMSUNG S21 FE 128GB LIGHT GREEN OPEN;TELEFONIA
12155951;;F;50;CHILENO;;X;NACIMIENTO                    ;BIO BIO;473790;8;4;0;0;0;8;4;473790;CELULAR MOTOROLA G20 64GB BLUE CLARO;TELEFONIA
14628566;;M;41;PERUANO;;Extranjero;ALTO HOSPICIO;TARAPACA;176980;2;1;0;0;0;2;1;176980;CELULAR A12 128GB Rojo OPEN;TELEFONIA
19795028;;F;24;CHILENO;;Z;N/D;N/D;766430;6;4;2;1;198980;4;3;567450;CELULAR POCO X3 PRO 128 GB FROST BLUE;TELEFONIA
19792357;;F;24;CHILENO;;Z;NUNOA;METROPOLITANA;79990;2;1;0;0;0;2;1;79990;VIVO Y20 OBSIDIAN BLACK OPEN;TELEFONIA
11940843;;F;50;CHILENO;;X;CANELA                        ;COQUIMBO;199990;1;1;0;0;0;1;1;199990;CELULAR MOTO G50 AZUL 128 GB OPEN;TELEFONIA
9091072;;F;61;CHILENO;;Boomers;RENCA                         ;METROPOLITANA;429980;2;2;0;0;0;2;2;429980;CELULAR A52 128 GB BLACK OPEN;TELEFONIA
17968048;Soltero;F;30;CHILENO;;Millenial;PROVIDENCIA                   ;METROPOLITANA;230981;3;1;0;0;0;3;1;230981;CELULAR VIVO Y53S FANTASTIC RAINBOW 128GB OPEN;TELEFONIA
12033182;Casado;F;58;CHILENO;PREVENCION DE RIESGOS;Boomers;RIO CLARO                     ;MAULE;219990;1;1;0;0;0;1;1;219990;CELULAR A52 128 GB LIGHT VIOLET OPEN;TELEFONIA
13379214;;F;45;CHILENO;;X;N/D;N/D;367840;5;3;4;2;319960;1;1;47880;CELULAR A12 128GB Negro OPEN;TELEFONIA
12574651;;F;51;CHILENO;;X;POZO ALMONTE                  ;TARAPACA;139970;3;2;0;0;0;3;2;139970;Celular NOKIA 1.3 NEGRO WOM;TELEFONIA
19805309;;M;23;CHILENO;;Z;PROVIDENCIA                   ;METROPOLITANA;47980;2;1;2;1;47980;0;0;0;CELULAR BMOBILE C40 CRIS OPEN;TELEFONIA
7606566;;F;67;CHILENO;;Boomers;LO PRADO                      ;METROPOLITANA;1299990;2;1;0;0;0;2;1;1299990;CELULAR GALAXY S22 ULTRA BURGUNDY 128GB;TELEFONIA
10107992;;F;58;CHILENO;;Boomers;RENCA                         ;METROPOLITANA;18990;1;1;0;0;0;1;1;18990;CELULAR NOKIA 110 BLACK OPEN;TELEFONIA
8562105;;M;63;CHILENO;;Boomers;LA SERENA                     ;COQUIMBO;49990;2;1;0;0;0;2;1;49990;CELULAR VIVO Y11S 32GB NEBULA BLUE OPEN;TELEFONIA
11517697;Viudo;F;52;CHILENO;;X;RENCA                         ;METROPOLITANA;39990;2;1;0;0;0;2;1;39990;CELULAR VIVO Y11S NEGRO WOM;TELEFONIA
19127799;Soltero;F;26;CHILENO;NUTRICIONISTA;Z;PROVIDENCIA                   ;METROPOLITANA;18990;1;1;0;0;0;1;1;18990;CELULAR NOKIA 110 BLACK OPEN;TELEFONIA
10595276;;M;51;CHILENO;;X;FREIRINA                      ;ATACAMA;199980;2;2;0;0;0;2;2;199980;CELULAR VIVO Y21S MIDNIGHT BLUE 128 GB OPEN;TELEFONIA
17747580;;F;31;CHILENO;;Millenial;PROVIDENCIA                   ;METROPOLITANA;189990;1;1;1;1;189990;0;0;0;CELULAR POCO X3 PRO 128G PHANTOM BLACK OPEN;TELEFONIA
14570066;;F;41;CHILENO;;X;LINARES                       ;MAULE;156980;2;1;0;0;0;2;1;156980;CELULAR GALAXY A03 4+128GB BLACK OPEN;TELEFONIA
19275700;Soltero;M;25;CHILENO;;Z;PROVIDENCIA                   ;METROPOLITANA;309990;1;1;1;1;309990;0;0;0;CELULAR XIAOMI 11 LITE 5G NE 8/128GB TRUFFLE BLA;TELEFONIA
6689857;;F;69;CHILENO;;Silencioso;"";"";324950;5;3;2;1;64980;3;2;259970;CELULAR VIVO Y11S NEGRO WOM;TELEFONIA
19571598;;M;25;CHILENO;;Z;NATALES                       ;MAGALLANES;190960;4;4;0;0;0;4;4;190960;CELULAR XIAOMI REDMI 9A 2/32GB GRANITE GRAY;TELEFONIA
16405242;;M;36;CHILENO;;Millenial;N/D;N/D;189980;2;4;0;0;0;2;4;189980;CELULAR VIVO Y11S PHANTOM BLACK OPEN;TELEFONIA
10695778;;M;55;CHILENO;;Boomers;LAS CONDES                    ;METROPOLITANA;535970;3;2;0;0;0;3;2;535970;CELULAR SMARTPHONE A52S 5G BLACK 128GB;TELEFONIA
9047284;;M;61;CHILENO;;Boomers;COQUIMBO                      ;COQUIMBO;452980;2;1;0;0;0;2;1;452980;CELULAR SMARTPHONE A52S 5G LIGHT GREEN 128GB;TELEFONIA
8134364;;F;64;CHILENO;;Boomers;TALCAHUANO                    ;BIO BIO;310960;4;3;0;0;0;4;3;310960;VIVO Y53S DEEP SEA BLUE 128GB OPEN;TELEFONIA
16756558;;F;34;CHILENO;;Millenial;RENGO;O HIGGINS;89980;4;2;0;0;0;4;2;89980;SMARTPHONE A03S 32 GB ROJO;TELEFONIA
15286421;;F;40;CHILENO;;X;N/D;N/D;639950;5;4;0;0;0;5;4;639950;POCO X3 PRO 256 GB METAL BRONCE;TELEFONIA
7953378;;M;65;CHILENO;;Boomers;PUENTE ALTO                   ;METROPOLITANA;30000;3;2;0;0;0;3;2;30000;CELULAR BMOBILE BS30 BLACK OPEN;TELEFONIA
8642201;;M;63;CHILENO;;Boomers;LOS ALAMOS                    ;BIO BIO;272970;3;2;0;0;0;3;2;272970;CELULAR MOTOROLA MOTO G20 64GB ROSA FLAMINGO;TELEFONIA
8947754;Soltero;M;60;CHILENO;;Boomers;RENCA                         ;METROPOLITANA;139990;1;1;1;1;139990;0;0;0;CELULAR A12 128GB Azul OPEN;TELEFONIA
19860016;;M;24;CHILENO;;Silencioso;PROVIDENCIA                   ;METROPOLITANA;649990;1;1;1;1;649990;0;0;0;CELULAR IPHONE 12 64GB WHITE CLARO;TELEFONIA
7932125;;F;61;CHILENO;;Boomers;N/D;N/D;79990;2;1;0;0;0;2;1;79990;CELULAR VIVO Y20 NEBULA BLUE OPEN;TELEFONIA
8979624;Soltero;M;61;CHILENO;INGENIERO AGRICOLA;Boomers;PROVIDENCIA                   ;METROPOLITANA;46980;2;1;0;0;0;2;1;46980;CELULAR BMOBILE BS30 BLACK OPEN;TELEFONIA
10356776;Soltero;M;57;CHILENO;;Boomers;RENCA                         ;METROPOLITANA;61990;2;1;0;0;0;2;1;61990;CELULAR VIVO Y11S PHANTON BLACK 32GB MOVISTAR;TELEFONIA
18007126;;M;29;CHILENO;;Millenial;ALTO HOSPICIO;TARAPACA;186980;3;1;0;0;0;3;1;186980;CELULAR XIAOMI REDMI 9T TWILIGHT BLUE MOVISTAR;TELEFONIA
5358622;;F;73;CHILENO;;Silencioso;CALAMA                        ;ANTOFAGASTA;99990;1;1;0;0;0;1;1;99990;CELULAR VIVO Y20 NEBULA BLUE OPEN;TELEFONIA
19193928;Soltero;F;29;CHILENO;INGENIERO EN PREVENCION DE RIESGOS;Millenial;"";"";715970;4;1;4;1;715970;0;0;0;CELULAR SAMSUNG S21 FE 128GB LIGHT GREEN OPEN;TELEFONIA
10558850;;M;57;CHILENO;;Boomers;CALLE LARGA                   ;VALPARAISO;459950;7;3;0;0;0;7;3;459950;CELULAR A12 128GB Azul OPEN;TELEFONIA
10983444;;M;51;CHILENO;;X;PROVIDENCIA                   ;METROPOLITANA;129990;2;1;2;1;129990;0;0;0;CELULAR A12 128GB Azul OPEN;TELEFONIA
12408370;;F;49;CHILENO;;X;PUDAHUEL                      ;METROPOLITANA;337960;4;2;4;2;337960;0;0;0;CELULAR A32 128 GB BLACK OPEN;TELEFONIA
7649139;;F;67;CHILENO;;Boomers;SALAMANCA                     ;COQUIMBO;344980;2;2;0;0;0;2;2;344980;CELULAR SMARTPHONE A52S 5G BLACK 128GB;TELEFONIA
9893674;;M;51;CHILENO;;X;N/D;N/D;219990;1;1;0;0;0;1;1;219990;CELULAR A52 128 GB BLACK OPEN;TELEFONIA
10562754;;F;57;CHILENO;;Boomers;SALAMANCA                     ;COQUIMBO;712940;6;3;0;0;0;6;3;712940;CELULAR GALAXY A03 CORE 2GB 32GB BLUE OPEN;TELEFONIA
7792788;;M;64;CHILENO;;Boomers;CURICO                        ;MAULE;339971;4;2;0;0;0;4;2;339971;CELULAR A12 128GB Azul OPEN;TELEFONIA
8967158;;M;62;CHILENO;;Silencioso;PROVIDENCIA                   ;METROPOLITANA;465970;3;2;1;1;189990;2;1;275980;CELULAR MOTO G60 4/128 GB SILVER OPEN;TELEFONIA
10798541;;M;55;CHILENO;;Boomers;PROVIDENCIA                   ;METROPOLITANA;119990;1;1;1;1;119990;0;0;0;CELULAR A12 128GB Azul OPEN;TELEFONIA
16216022;;F;36;CHILENO;;Millenial;CANETE                        ;BIO BIO;281960;4;2;0;0;0;4;2;281960;CELULAR MOTO E7 32GB GRIS OPEN;TELEFONIA
14568261;;F;46;CHILENO;;X;TALCA                         ;MAULE;539960;4;3;0;0;0;4;3;539960;CELULAR REDMI 9A 32GB SKY BLUE;TELEFONIA
9774437;;F;57;CHILENO;;Boomers;VILLA ALEMANA                 ;VALPARAISO;119573;3;3;0;0;0;3;3;119573;CELULAR BMOBILE C40 CRIS OPEN;TELEFONIA
17066261;;F;33;CHILENO;;Millenial;CANELA                        ;COQUIMBO;119990;1;1;0;0;0;1;1;119990;CELULAR GALAXY A03 4+128GB BLUE OPEN;TELEFONIA
26519218;;F;55;CHILENO;;Extranjero;ANGOL                         ;ARAUCANIA;402960;5;2;0;0;0;5;2;402960;SMARTPHONE A03S AZUL 32GB;TELEFONIA
18472341;;F;32;CHILENO;;Millenial;PROVIDENCIA                   ;METROPOLITANA;169990;1;1;0;0;0;1;1;169990;CELULAR VIVO Y21S PEARL WHITE 128 GB OPEN;TELEFONIA
20234216;;F;22;CHILENO;;Millenial;PROVIDENCIA                   ;METROPOLITANA;2;0;1;0;0;0;0;1;2;CELULAR A12 128GB Azul OPEN;TELEFONIA
17345747;Soltero;F;32;CHILENO;ABOGADO;Millenial;PROVIDENCIA                   ;METROPOLITANA;223980;2;1;2;1;223980;0;0;0;CELULAR A52 128 GB LIGHT VIOLET OPEN;TELEFONIA
15700209;;F;38;CHILENO;;X;MAIPU                         ;METROPOLITANA;133970;3;2;0;0;0;3;2;133970;CELULAR REDMI 9A 32GB SKY BLUE;TELEFONIA
10362420;;M;56;CHILENO;;Boomers;PENAFLOR                      ;METROPOLITANA;183980;2;1;2;1;183980;0;0;0;CELULAR REDMI NOTE 10S 128GB PEBBLE WHITE;TELEFONIA
18089470;;F;30;CHILENO;;Millenial;N/D;N/D;17990;1;1;0;0;0;1;1;17990;CELULAR NOKIA 110 BLACK OPEN;TELEFONIA
7856651;Soltero;M;64;CHILENO;INGENIERO AGRICOLA;Boomers;PROVIDENCIA                   ;METROPOLITANA;24990;1;1;0;0;0;1;1;24990;CELULAR AZUMI L4G BLACK CLARO;TELEFONIA
12892278;;F;47;CHILENO;;X;PENALOLEN                     ;METROPOLITANA;99990;1;3;0;2;0;1;1;99990;CELULAR VIVO Y11S PHANTOM BLACK OPEN;TELEFONIA
15403283;;F;39;CHILENO;;X;SANTIAGO                      ;METROPOLITANA;109980;2;1;2;1;109980;0;0;0;CELULAR NOKIA C1 PLUS BLUE;TELEFONIA
15877975;;M;38;CHILENO;;Millenial;RENCA                         ;METROPOLITANA;149991;2;1;0;0;0;2;1;149991;CELULAR A54 OPPO AZUL 128GB;TELEFONIA
7026419;;M;60;CHILENO;;Boomers;PROVIDENCIA                   ;METROPOLITANA;166980;2;1;0;0;0;2;1;166980;CELULAR A12 128GB Azul OPEN;TELEFONIA
15229586;;F;41;CHILENO;;X;PROVIDENCIA                   ;METROPOLITANA;139980;3;2;0;0;0;3;2;139980;CELULAR A12 128GB Rojo OPEN;TELEFONIA
4861211;;M;78;CHILENO;;Silencioso;SAN BERNARDO                  ;METROPOLITANA;34990;1;1;0;0;0;1;1;34990;CELULAR NOKIA 225 4G BLACK MOVISTAR DIRECTO;TELEFONIA
13749781;;F;42;CHILENO;;X;SALAMANCA                     ;COQUIMBO;669980;2;2;0;0;0;2;2;669980;POCO X3 PRO 256 GB PHANTOM BLACK;TELEFONIA
16313484;;F;36;CHILENO;;Millenial;ILLAPEL                       ;COQUIMBO;457520;4;3;2;1;227540;2;2;229980;CELULAR MOTO G20 EDICION ESPECIAL 4/128 GB AZUL;TELEFONIA
9622548;Casado;M;61;CHILENO;AGROINDUSTRIA;Silencioso;PROVIDENCIA                   ;METROPOLITANA;89990;1;1;0;0;0;1;1;89990;CELULAR XIAOMI REDMI 9A 2/32GB GRANITE GRAY;TELEFONIA
18531311;;F;28;CHILENO;;Millenial;PROVIDENCIA                   ;METROPOLITANA;299990;1;1;1;1;299990;0;0;0;CELULAR IPHONE SE 64GB DIRECTO CLARO;TELEFONIA
18718760;Soltero;F;28;CHILENO;;Millenial;PROVIDENCIA                   ;METROPOLITANA;299991;2;1;0;0;0;2;1;299991;CELULAR 11 LITE 5G NE 8/128GB PEACH PINK OPEN;TELEFONIA
15901723;;M;37;CHILENO;;Millenial;LA SERENA                     ;COQUIMBO;190970;4;2;0;0;0;4;2;190970;CELULAR VIVO Y21S PEARL WHITE 128 GB OPEN;TELEFONIA
7889669;;M;66;CHILENO;;Boomers;RENCA                         ;METROPOLITANA;209980;2;2;0;0;0;2;2;209980;SMARTPHONE A03S NEGRO 32GB;TELEFONIA
14358063;;M;43;CHILENO;;X;SANTA MARIA                   ;VALPARAISO;181980;3;1;0;0;0;3;1;181980;CELULAR A12 128GB Negro OPEN;TELEFONIA
19822683;;F;23;CHILENO;;Z;"";"";10990;1;3;0;2;0;1;1;10990;CELULAR HUAWEI NOVA 8i BLUE;TELEFONIA
12982592;;F;46;CHILENO;;X;CURANILAHUE                   ;BIO BIO;221980;2;2;0;0;0;2;2;221980;CELULAR MOTO G60S 6/128 GB AZUL;TELEFONIA
20389023;;M;22;CHILENO;;Z;PADRE HURTADO;METROPOLITANA;279990;1;1;0;0;0;1;1;279990;CELULAR IPHONE SE 64GB DIRECTO CLARO;TELEFONIA
9546280;;M;55;CHILENO;;Boomers;COMBARBALA                    ;COQUIMBO;90980;2;2;0;0;0;2;2;90980;CELULAR REDMI 9A 32GB PEACOCK GREEN;TELEFONIA
13176288;;F;45;CHILENO;;X;VICUNA                        ;COQUIMBO;89990;2;1;0;0;0;2;1;89990;CELULAR A12 128GB Negro OPEN;TELEFONIA
6107618;;F;74;CHILENO;;Silencioso;QUILLOTA                      ;VALPARAISO;136980;2;1;0;0;0;2;1;136980;SMARTPHONE A03S 32 GB ROJO;TELEFONIA
16339484;;F;36;CHILENO;;Millenial;N/D;N/D;119990;1;1;0;0;0;1;1;119990;CELULAR MOTO G20 64GB ROSA FLAMINGO OPEN;TELEFONIA
9351946;;F;60;CHILENO;;Boomers;CARTAGENA                     ;VALPARAISO;897940;6;3;0;0;0;6;3;897940;POCO X3 PRO 256 GB PHANTOM BLACK;TELEFONIA
26682861;;M;27;HAITIANO;;Extranjero;LA LIGUA                      ;VALPARAISO;111980;3;1;0;0;0;3;1;111980;CELULAR A12 128GB Rojo OPEN;TELEFONIA
11521370;Soltero;F;52;CHILENO;;X;RENCA                         ;METROPOLITANA;148980;2;2;0;0;0;2;2;148980;CELULAR A12 128GB Negro OPEN;TELEFONIA
17882168;Soltero;F;29;CHILENO;;Millenial;PROVIDENCIA                   ;METROPOLITANA;89990;1;1;0;0;0;1;1;89990;CELULAR MOTO E7 32GB GRIS OPEN;TELEFONIA
18749520;Soltero;F;28;CHILENO;ENFERMERA;Millenial;PROVIDENCIA                   ;METROPOLITANA;403980;2;1;2;1;403980;0;0;0;CELULAR XIAOMI 11T 8/256GB CELESTIAL BLUE OPEN;TELEFONIA
8585739;;M;63;CHILENO;;Boomers;MOSTAZAL                      ;L.G.B.OÂ´HIGGINS;1244080;10;3;0;0;0;10;3;1244080;SMARTPHONE A03S AZUL 32GB;TELEFONIA
7600634;;F;66;CHILENO;;Boomers;MELIPILLA                     ;METROPOLITANA;565940;6;2;0;0;0;6;2;565940;CELULAR A32 128 GB BLACK OPEN;TELEFONIA
16737348;;F;34;CHILENO;;Millenial;SAN FERNANDO                  ;L.G.B.OÂ´HIGGINS;149990;1;1;0;0;0;1;1;149990;CELULAR MOTOROLA G30 GRIS WOM 128 GB;TELEFONIA
17187858;;F;33;CHILENO;;Millenial;PROVIDENCIA                   ;METROPOLITANA;309991;2;1;0;0;0;2;1;309991;CELULAR SMARTPHONE A52S 5G LIGHT VIOLET 128GB;TELEFONIA
12816889;;F;46;CHILENO;;X;ZAPALLAR                      ;VALPARAISO;117981;3;1;0;0;0;3;1;117981;CELULAR XIAOMI REDMI 9A 2/32GB GRANITE GRAY;TELEFONIA
10435636;;M;56;CHILENO;;Boomers;RINCONADA                     ;VALPARAISO;15990;3;2;0;0;0;3;2;15990;CHIP OPEN ENTEL;TELEFONIA
10919143;;F;52;CHILENO;;X;COLINA                        ;METROPOLITANA;179120;4;3;2;1;78980;2;2;100140;CELULAR VIVO Y11S PHANTOM BLACK OPEN;TELEFONIA
13366124;;M;44;CHILENO;;X;LLAILLAY                      ;VALPARAISO;199990;1;1;0;0;0;1;1;199990;CELULAR POCO X3 PRO 128G PHANTOM BLACK OPEN;TELEFONIA
18229814;;F;30;CHILENO;;Millenial;LEBU                          ;BIO BIO;199990;1;1;0;0;0;1;1;199990;SMARTPHONE A22 BLANCO 128GB;TELEFONIA
8274182;;M;67;CHILENO;;Boomers;OVALLE                        ;COQUIMBO;79990;1;1;0;0;0;1;1;79990;CELULAR XIAOMI REDMI 9A 32GB GRANITE GRAY TRI WO;TELEFONIA
15646666;;M;38;CHILENO;;X;VICTORIA                      ;ARAUCANIA;109990;1;1;0;0;0;1;1;109990;CELULAR VIVO Y11S 32GB NEBULA BLUE OPEN;TELEFONIA
8630385;;F;66;CHILENO;;Boomers;OSORNO                        ;LOS LAGOS;487850;4;2;0;0;0;4;2;487850;CELULAR A12 128GB Azul OPEN;TELEFONIA
10283254;;F;56;CHILENO;;Boomers;LOS ANGELES                   ;BIO BIO;119990;1;1;0;0;0;1;1;119990;CELULAR A12 128GB Rojo OPEN;TELEFONIA
7820252;;F;67;CHILENO;;Boomers;LA CISTERNA                   ;METROPOLITANA;119990;1;1;0;0;0;1;1;119990;CELULAR A12 128GB Negro OPEN;TELEFONIA
9398964;;M;60;CHILENO;;Boomers;EL MONTE                      ;METROPOLITANA;148970;4;3;0;0;0;4;3;148970;CELULAR MOTO G20 EDICION ESPECIAL 4/128 GB AZUL;TELEFONIA
12335871;Casado;M;49;CHILENO;;X;RENCA                         ;METROPOLITANA;179990;1;1;0;0;0;1;1;179990;CELULAR A54 OPPO NEGRO 128GB;TELEFONIA
9343643;;F;61;CHILENO;;Boomers;VALLENAR;ATACAMA;957960;6;3;0;0;0;6;3;957960;CELULAR GALAXY S22 GREEN 128GB;TELEFONIA
25432454;;M;27;HAITIANO;;Extranjero;EL BOSQUE                     ;METROPOLITANA;119990;1;1;0;0;0;1;1;119990;CELULAR A12 128GB Azul OPEN;TELEFONIA
17547650;;M;31;CHILENO;;Millenial;N/D;N/D;917940;6;3;0;0;0;6;3;917940;IPHONE 12 128GB BLACK CLARO;TELEFONIA
19075188;;F;27;CHILENO;;Silencioso;PROVIDENCIA                   ;METROPOLITANA;389980;2;2;2;2;389980;0;0;0;CELULAR A32 128 GB BLACK OPEN;TELEFONIA
17392153;;F;32;CHILENO;;Millenial;CALAMA                        ;ANTOFAGASTA;527940;6;2;0;0;0;6;2;527940;CELULAR VIVO V21 5G 128GB SUNSET DAZZLE OPEN;TELEFONIA
13721070;;F;43;CHILENO;;X;PICHIDEGUA                    ;L.G.B.OÂ´HIGGINS;119990;1;1;0;0;0;1;1;119990;CELULAR A12 128GB Negro OPEN;TELEFONIA
18576426;;M;28;CHILENO;;Millenial;N/D;N/D;599980;2;2;1;1;399990;1;1;199990;CELULAR XIAOMI 11T 8/256GB METEORITE GRAY OPEN;TELEFONIA
15659627;;F;38;CHILENO;;Millenial;ARAUCO                        ;BIO BIO;349980;2;2;1;1;149990;1;1;199990;CELULAR A32 128 GB BLACK OPEN;TELEFONIA
7969053;;M;62;CHILENO;;Boomers;LA SERENA                     ;COQUIMBO;49990;2;1;0;0;0;2;1;49990;CELULAR VIVO Y11S PHANTOM BLACK OPEN;TELEFONIA
14141095;;F;40;CHILENO;;X;MAIPU                         ;METROPOLITANA;139990;3;1;0;0;0;3;1;139990;CELULAR XIAOMI REDMI 9A 2/32GB GRANITE GRAY;TELEFONIA
8564621;;F;50;CHILENO;;X;N/D;N/D;549971;4;3;0;0;0;4;3;549971;CELULAR REDMI NOTE 10S 128GB ONIX BLACK;TELEFONIA
18718210;;M;27;CHILENO;;Silencioso;PROVIDENCIA                   ;METROPOLITANA;89990;1;1;0;0;0;1;1;89990;CELULAR XIAOMI REDMI 9A 2/32GB GRANITE GRAY;TELEFONIA
26615805;;M;32;VENEZOLANO;;Extranjero;PUERTO MONTT                  ;LOS LAGOS;269990;1;1;1;1;269990;0;0;0;CELULAR REDMI NOTE 10 PRO 128GB AZUL WOM;TELEFONIA
7931223;;F;63;CHILENO;;Boomers;VICUNA                        ;COQUIMBO;49990;2;1;0;0;0;2;1;49990;CELULAR VIVO Y11S 32 GB NEBULA BLUE WOM;TELEFONIA
10762069;;M;55;CHILENO;;Boomers;TALCA                         ;MAULE;271450;5;3;2;1;85480;3;2;185970;CELULAR XIAOMI REDMI 9A 32GB BLACK DIRECTO CLARO;TELEFONIA
17499151;;M;32;CHILENO;;Millenial;N/D;N/D;370980;2;2;0;0;0;2;2;370980;CELULAR A72 128 GB BLACK OPEN;TELEFONIA
8127923;;M;65;CHILENO;;Boomers;PROVIDENCIA                   ;METROPOLITANA;93980;2;1;0;0;0;2;1;93980;CELULAR NOKIA C1 PLUS BLUE;TELEFONIA
10614455;;F;52;CHILENO;;X;"";"";455929;6;3;3;1;250960;3;2;204969;CELULAR A12 128GB Azul OPEN;TELEFONIA
14451612;;M;48;CHILENO;;X;TIRUA                         ;BIO BIO;159990;1;1;0;0;0;1;1;159990;CELULAR VIVO Y20S NEBULA 128 GB BLUE OPEN;TELEFONIA
26024718;;M;32;EXTRANJERO - NO INFORMA NACIONALIDAD;;Extranjero;NOGALES                       ;VALPARAISO;866910;10;6;0;0;0;10;6;866910;CELULAR A12 128GB Rojo OPEN;TELEFONIA
6830588;;F;69;CHILENO;;Silencioso;CERRO NAVIA                   ;METROPOLITANA;119990;1;1;0;0;0;1;1;119990;CELULAR A12 128GB Rojo OPEN;TELEFONIA
8108369;;F;64;CHILENO;;Boomers;PENAFLOR                      ;METROPOLITANA;130130;3;1;0;0;0;3;1;130130;CELULAR POCO M3 64GB COOL BLUE;TELEFONIA
15130835;;M;39;CHILENO;;X;CURICO                        ;MAULE;490872;1;1;1;1;490872;0;0;0;CELULAR XIAOMI 11T PRO 8/256GB METEORITE GRAY;TELEFONIA
4564375;;M;79;CHILENO;;Silencioso;QUILPUE                       ;VALPARAISO;990;1;1;0;0;0;1;1;990;CHIP OPEN ENTEL;TELEFONIA
15958744;;M;36;CHILENO;;Millenial;PROVIDENCIA                   ;METROPOLITANA;99991;2;1;0;0;0;2;1;99991;SMARTPHONE A03S 32 GB ROJO;TELEFONIA
19048965;;F;26;CHILENO;;Z;N/D;N/D;356960;4;3;1;1;139990;3;2;216970;CELULAR A12 128GB Rojo OPEN;TELEFONIA
11892090;;F;50;CHILENO;;X;SAN VICENTE                   ;L.G.B.OÂ´HIGGINS;257970;3;2;0;0;0;3;2;257970;CELULAR VIVO Y11S 32GB NEBULA BLUE OPEN;TELEFONIA
16801725;;F;34;CHILENO;;Millenial;N/D;N/D;0;0;2;0;0;0;0;2;0;CELULAR SMARTPHONE A52S 5G BLACK 128GB;TELEFONIA
19487442;;F;25;CHILENO;;Z;PROVIDENCIA                   ;METROPOLITANA;249990;1;1;0;0;0;1;1;249990;CELULAR REDMI NOTE 11 4/128GB TWILIGHT BLUE OPEN;TELEFONIA
18218843;;M;29;CHILENO;;Millenial;PROVIDENCIA                   ;METROPOLITANA;315970;3;2;0;0;0;3;2;315970;CELULAR VIVO Y11S 32GB NEBULA BLUE OPEN;TELEFONIA
8792077;;F;62;CHILENO;;Boomers;LA SERENA                     ;COQUIMBO;216980;2;2;0;0;0;2;2;216980;CELULAR MOTO G60S 6/128 GB AZUL;TELEFONIA
18198255;Soltero;M;29;CHILENO;;Millenial;ANGOL                         ;ARAUCANIA;194980;2;3;0;0;0;2;3;194980;CELULAR MOTO G20 64GB ROSA FLAMINGO OPEN;TELEFONIA
9971443;;M;57;CHILENO;;Boomers;PROVIDENCIA                   ;METROPOLITANA;34990;1;1;0;0;0;1;1;34990;CELULAR NOKIA 225 4G BLACK MOVISTAR DIRECTO;TELEFONIA
12774446;;M;47;CHILENO;;X;SAN FELIPE                    ;VALPARAISO;99990;1;1;1;1;99990;0;0;0;CELULAR HUAWEI Y7P NEGRO ENTEL;TELEFONIA
19623813;;F;25;CHILENO;;Z;N/D;N/D;132980;2;2;0;0;0;2;2;132980;CELULAR REDMI 9C 64 GB BLUE DIRECTO CLARO;TELEFONIA
9167280;;M;60;CHILENO;;Boomers;BUIN                          ;METROPOLITANA;635960;4;2;0;0;0;4;2;635960;CELULAR VIVO Y53S FANTASTIC RAINBOW 128GB OPEN;TELEFONIA
15909538;;F;37;CHILENO;;Millenial;LA SERENA                     ;COQUIMBO;174960;8;3;0;0;0;8;3;174960;CELULAR REDMI 9A 32GB PEACOCK GREEN;TELEFONIA
17884497;;F;30;CHILENO;;Millenial;LINARES                       ;MAULE;538860;3;2;0;0;0;3;2;538860;CELULAR GALAXY S20FE 128GB ClOUD NAVY OPEN;TELEFONIA
15649854;;M;38;CHILENO;;Millenial;N/D;N/D;17990;1;1;0;0;0;1;1;17990;CELULAR NOKIA 110 BLACK OPEN;TELEFONIA
6626407;;M;70;CHILENO;;Silencioso;SAN ANTONIO                   ;VALPARAISO;17990;1;1;0;0;0;1;1;17990;CELULAR NOKIA 110 BLACK OPEN;TELEFONIA
23744274;;M;34;BOLIVIANO;;Extranjero;TOCOPILLA                     ;ANTOFAGASTA;199990;1;1;0;0;0;1;1;199990;CELULAR XIAOMI POCO X3 PRO 128GB PANTHOM BLACK;TELEFONIA
25920633;;M;40;VENEZOLANO;;Extranjero;"";"";259990;1;1;0;0;0;1;1;259990;CELULAR REDMI NOTE 10 PRO 128GB AZUL WOM;TELEFONIA
12567715;;F;48;CHILENO;;X;RIO CLARO                     ;MAULE;352980;2;1;0;0;0;2;1;352980;CELULAR REDMI NOTE 10 PRO 6+128GB GRADIENT BRONZ;TELEFONIA
5723321;;F;71;CHILENO;;Silencioso;RENCA                         ;METROPOLITANA;107980;2;1;0;0;0;2;1;107980;CELULAR XIAOMI REDMI 9A 32GB GRANITE GRAY TRI WO;TELEFONIA
16183947;;M;36;CHILENO;;Millenial;VALLENAR;ATACAMA;319990;1;1;0;0;0;1;1;319990;CELULAR 11 LITE 5G NE 8/128GB PEACH PINK OPEN;TELEFONIA
7143492;;M;66;CHILENO;;Boomers;PROVIDENCIA                   ;METROPOLITANA;51990;2;1;0;0;0;2;1;51990;CELULAR VIVO Y11S PHANTON BLACK 32GB MOVISTAR;TELEFONIA
19551761;;F;25;CHILENO;;Extranjero;SANTIAGO                      ;METROPOLITANA;149990;1;1;0;0;0;1;1;149990;CELULAR XIAOMI REDMI 10 4G 4/64Gb CARBON GRAY;TELEFONIA
25230597;;F;32;COLOMBIANO;;Extranjero;CALERA                        ;VALPARAISO;84980;2;1;0;0;0;2;1;84980;CELULAR NOKIA C1 PLUS BLUE;TELEFONIA
10001451;;F;55;CHILENO;;Boomers;RENCA                         ;METROPOLITANA;31980;2;3;0;0;0;2;3;31980;CELULAR AZUMI L4G BLACK CLARO;TELEFONIA
26238967;;F;36;VENEZOLANO;;Extranjero;N/D;N/D;390970;4;2;0;0;0;4;2;390970;CELULAR POCO X3 PRO 128G PHANTOM BLACK OPEN;TELEFONIA
6335433;;F;73;CHILENO;;Silencioso;PETORCA                       ;VALPARAISO;186981;3;1;0;0;0;3;1;186981;CELULAR MOTO G20 EDICION ESPECIAL 4/128 GB VERDE;TELEFONIA
16632257;;M;36;CHILENO;;Millenial;LOS ANGELES                   ;BIO BIO;1580800;7;6;2;3;355840;5;3;1224960;CELULAR SAMSUNG S21 FE 128GB LIGHT GREEN OPEN;TELEFONIA
9407577;;F;61;CHILENO;;Boomers;RENCA                         ;METROPOLITANA;113980;2;1;2;1;113980;0;0;0;Celular XIAOMI REDMI 9 64 GB DIRECTO CLARO NEGRO;TELEFONIA
17446532;;F;32;CHILENO;;Millenial;N/D;N/D;179990;1;1;0;0;0;1;1;179990;CELULAR POCO X3 PRO 128G PHANTOM BLACK OPEN;TELEFONIA
23484571;;M;29;CHILENO;;Extranjero;PROVIDENCIA                   ;METROPOLITANA;533980;2;1;2;1;533980;0;0;0;CELULAR GALAXY S20FE 128GB CLOUD GREEN OPEN;TELEFONIA
18079096;;F;30;CHILENO;;Millenial;PROVIDENCIA                   ;METROPOLITANA;193980;2;1;2;1;193980;0;0;0;CELULAR MOTO G50 AZUL 128 GB OPEN;TELEFONIA
10882485;;F;55;CHILENO;;Boomers;COLLIPULLI                    ;ARAUCANIA;384990;1;1;0;0;0;1;1;384990;CELULAR GALAXY S20FE 128GB ClOUD NAVY OPEN;TELEFONIA
5671406;;F;79;CHILENO;;Silencioso;LA UNION                      ;LOS RIOS;64990;1;1;0;0;0;1;1;64990;CELULAR SMARTPHONE BMOBIL AX1076 PRO BLACK TRI W;TELEFONIA
18651785;;M;24;CHILENO;;Z;TEMUCO                        ;ARAUCANIA;165960;5;2;0;0;0;5;2;165960;CELULAR A12 128GB Negro OPEN;TELEFONIA
10043953;Soltero;F;47;CHILENO;TECNICO EN ADMINISTRACION DE EMPRESAS;Silencioso;PROVIDENCIA                   ;METROPOLITANA;299990;1;1;1;1;299990;0;0;0;CELULAR IPHONE SE 64GB DIRECTO CLARO;TELEFONIA
20253445;;F;22;CHILENO;;Z;PROVIDENCIA                   ;METROPOLITANA;129990;2;1;0;0;0;2;1;129990;CELULAR A12 128GB Azul OPEN;TELEFONIA
8798219;;F;60;CHILENO;;Boomers;MELIPILLA                     ;METROPOLITANA;264960;4;2;0;0;0;4;2;264960;SMARTPHONE A03S 64 GB NEGRO;TELEFONIA
14234389;;M;53;CHILENO;;X;SALAMANCA                     ;COQUIMBO;201980;2;1;0;0;0;2;1;201980;CELULAR A12 128GB Rojo OPEN;TELEFONIA
19769496;;M;24;CHILENO;;Z;PROVIDENCIA                   ;METROPOLITANA;276980;2;1;2;1;276980;0;0;0;CELULAR SMARTPHONE A52S 5G BLACK 128GB;TELEFONIA
16991792;;M;33;CHILENO;;Silencioso;SANTA MARIA                   ;VALPARAISO;129990;1;1;0;0;0;1;1;129990;CELULAR A12 128GB Rojo OPEN;TELEFONIA
24654921;Soltero;M;29;CHILENO;;Extranjero;"";"";209990;2;1;0;0;0;2;1;209990;POCO X3 PRO 256 GB PHANTOM BLACK;TELEFONIA
19206920;;M;30;CHILENO;;Millenial;AISEN                         ;AYSEN;269990;1;1;0;0;0;1;1;269990;CELULAR SMARTPHONE A52S 5G BLACK 128GB;TELEFONIA
19942926;;F;23;CHILENO;;Z;N/D;N/D;189990;1;1;0;0;0;1;1;189990;CELULAR REDMI NOTE 10S 128GB ONIX BLACK;TELEFONIA
16050515;;M;36;CHILENO;;Millenial;PROVIDENCIA                   ;METROPOLITANA;399990;2;1;0;0;0;2;1;399990;CELULAR MOTO G100 128GB VERDE BOREAL + HMDI OPEN;TELEFONIA
9173624;;F;62;CHILENO;;Boomers;RENCA                         ;METROPOLITANA;89980;3;1;0;0;0;3;1;89980;CELULAR MOTO E7 GRIS MINERAL MOVISTAR;TELEFONIA
15662315;;M;38;CHILENO;;X;RECOLETA                      ;METROPOLITANA;81990;1;1;0;0;0;1;1;81990;Celular Y6P WOM TRIANGULADO VERDE;TELEFONIA
16712655;;F;29;CHILENO;;Millenial;PUTRE                         ;ARICA Y PARINACOTA;442859;3;2;0;0;0;3;2;442859;CELULAR IPHONE SE 64GB DIRECTO CLARO;TELEFONIA
19142695;;M;26;CHILENO;;Z;SAN ANTONIO                   ;VALPARAISO;141990;2;1;0;0;0;2;1;141990;CELULAR MOTO G30 GRIS TORNASOL 128GB MOVISTAR;TELEFONIA
12161763;;M;51;CHILENO;;X;ANGOL                         ;ARAUCANIA;428850;4;2;0;0;0;4;2;428850;CELULAR POCO X3 PRO 128G PHANTOM BLACK OPEN;TELEFONIA
19604274;;F;24;CHILENO;;Z;"";"";252981;3;1;0;0;0;3;1;252981;CELULAR A22 128GB NEGRO;TELEFONIA
13618080;;F;43;CHILENO;;X;SAN CARLOS                    ;BIO BIO;179990;1;1;0;0;0;1;1;179990;CELULAR A22 128GB NEGRO;TELEFONIA
19784666;;M;24;CHILENO;;Z;LA PINTANA;METROPOLITANA;239990;1;1;0;0;0;1;1;239990;CELULAR VIVO Y53S FANTASTIC RAINBOW 128GB OPEN;TELEFONIA
17687866;;F;31;CHILENO;;Millenial;N/D;N/D;59540;2;1;2;1;59540;0;0;0;CELULAR NOKIA C1 PLUS BLUE;TELEFONIA
8198183;;F;60;CHILENO;;X;PUENTE ALTO                   ;METROPOLITANA;368980;2;1;0;0;0;2;1;368980;CELULAR SMARTPHONE A52S 5G LIGHT GREEN 128GB;TELEFONIA
7142228;;F;68;CHILENO;;Boomers;VALDIVIA                      ;LOS RIOS;328950;5;4;0;0;0;5;4;328950;CELULAR REDMI NOTE 10S 128GB ONIX BLACK;TELEFONIA
15673888;Soltero;F;38;CHILENO;;X;PROVIDENCIA                   ;METROPOLITANA;170970;3;2;0;0;0;3;2;170970;CELULAR NOKIA QUEEN VALUE BLACK CLARO;TELEFONIA
7390277;;F;65;CHILENO;;Boomers;PENCO                         ;BIO BIO;179990;1;1;0;0;0;1;1;179990;CELULAR A22 128GB NEGRO;TELEFONIA
17471584;;M;31;CHILENO;;Millenial;CHIMBARONGO                   ;L.G.B.OÂ´HIGGINS;294980;2;2;0;0;0;2;2;294980;CELULAR MOTOROLA G20 64GB BLUE CLARO;TELEFONIA
15159601;;M;38;CHILENO;;Millenial;ALHUE                         ;METROPOLITANA;139990;1;1;0;0;0;1;1;139990;CELULAR A12 128GB Negro OPEN;TELEFONIA
17304774;;F;32;CHILENO;;Millenial;SANTIAGO                      ;METROPOLITANA;144980;2;2;1;1;54990;1;1;89990;CELULAR NOKIA C1 PLUS BLUE;TELEFONIA
25667178;Soltero;M;34;HAITIANO;;Extranjero;PROVIDENCIA                   ;METROPOLITANA;159990;1;1;0;0;0;1;1;159990;CELULAR MOTO G20 EDICION ESPECIAL 4/128 GB AZUL;TELEFONIA
8599022;;M;63;CHILENO;;Boomers;CURANILAHUE                   ;BIO BIO;39990;1;1;0;0;0;1;1;39990;CELULAR BMOBILE C40 CRIS OPEN;TELEFONIA
16290886;;F;36;CHILENO;;Millenial;PROVIDENCIA                   ;METROPOLITANA;199990;1;1;0;0;0;1;1;199990;REDMI 10 US 128GB Carbon Gray;TELEFONIA
26706408;;M;23;HAITIANO;;Extranjero;RENGO;O HIGGINS;449970;3;3;1;1;129990;2;2;319980;CELULAR VIVO Y11S PHANTON BLACK 32GB MOVISTAR;TELEFONIA
6487811;;F;75;CHILENO;;Silencioso;CHONCHI                       ;LOS LAGOS;107980;2;1;0;0;0;2;1;107980;CELULAR XIAOMI REDMI 9A 32GB GRANITE GRAY TRI WO;TELEFONIA
8688778;;M;64;CHILENO;;Boomers;PROVIDENCIA                   ;METROPOLITANA;89990;1;1;0;0;0;1;1;89990;CELULAR VIVO Y11S PHANTON BLACK 32GB MOVISTAR;TELEFONIA
8667724;;F;49;CHILENO;;X;COLINA                        ;METROPOLITANA;119990;1;1;0;0;0;1;1;119990;SMARTPHONE A03S AZUL 32GB;TELEFONIA
9427233;;M;60;CHILENO;;Boomers;PROVIDENCIA                   ;METROPOLITANA;119990;1;1;0;0;0;1;1;119990;CELULAR VIVO Y11S 32GB NEBULA BLUE OPEN;TELEFONIA
17167911;Soltero;M;33;CHILENO;;Millenial;PROVIDENCIA                   ;METROPOLITANA;123980;2;1;2;1;123980;0;0;0;NOKIA G10 3/64 GB BLUE TRI WOM;TELEFONIA
17822125;Casado;F;31;CHILENO;PROFESOR;Millenial;PROVIDENCIA                   ;METROPOLITANA;239990;2;1;0;0;0;2;1;239990;CELULAR REDMI NOTE 10 PRO 128GB AZUL WOM;TELEFONIA
13787455;;M;42;CHILENO;;X;ARAUCO                        ;BIO BIO;408960;4;3;2;1;293980;2;2;114980;CELULAR VIVO Y11S PHANTON BLACK 32GB MOVISTAR;TELEFONIA
12722990;;F;46;CHILENO;;X;PROVIDENCIA                   ;METROPOLITANA;1403970;5;2;5;2;1403970;0;0;0;CELULAR SAMSUNG S21 FE 128GB LIGHT VIOLET OPEN;TELEFONIA
8955988;;M;61;CHILENO;;Boomers;SAN BERNARDO                  ;METROPOLITANA;299990;1;1;0;0;0;1;1;299990;CELULAR SMARTPHONE A52S 5G LIGHT VIOLET 128GB;TELEFONIA
13208006;;F;45;CHILENO;;X;PROVIDENCIA                   ;METROPOLITANA;305960;4;1;0;0;0;4;1;305960;CELULAR VIVO Y11S 32GB NEBULA BLUE OPEN;TELEFONIA
15495086;;M;38;CHILENO;;X;"";"";312151;5;3;0;0;0;5;3;312151;CELULAR A22 128GB NEGRO;TELEFONIA
8090863;;M;62;CHILENO;;Boomers;BUIN                          ;METROPOLITANA;51990;2;1;0;0;0;2;1;51990;CELULAR VIVO Y11S PHANTON BLACK 32GB MOVISTAR;TELEFONIA
15088624;;M;39;CHILENO;;X;SANTO DOMINGO                 ;VALPARAISO;277630;7;4;0;0;0;7;4;277630;CELULAR VIVO Y11S 32GB NEBULA BLUE OPEN;TELEFONIA
19882311;;F;24;CHILENO;;Z;EL BOSQUE                     ;METROPOLITANA;843970;5;2;5;2;843970;0;0;0;CELULAR SAMSUNG S21 FE 128GB LIGHT VIOLET OPEN;TELEFONIA
10993826;;F;45;CHILENO;;Millenial;HUECHURABA                    ;METROPOLITANA;39970;3;1;3;1;39970;0;0;0;CELULAR NOKIA 110 BLACK OPEN;TELEFONIA
10328688;;F;57;CHILENO;;Boomers;VINA DEL MAR                  ;VALPARAISO;439980;2;2;0;0;0;2;2;439980;CELULAR VIVO Y11S 32GB NEBULA BLUE OPEN;TELEFONIA
18900406;;M;27;CHILENO;;Millenial;PROVIDENCIA                   ;METROPOLITANA;189990;1;1;1;1;189990;0;0;0;CELULAR A32 128 GB BLACK OPEN;TELEFONIA
7486979;;M;67;CHILENO;;Boomers;RENCA                         ;METROPOLITANA;269980;2;2;0;0;0;2;2;269980;Celular XIAOMI REDMI 9 64 GB DIRECTO CLARO NEGRO;TELEFONIA
7498785;;M;66;CHILENO;;Boomers;CALBUCO                       ;LOS LAGOS;99991;2;1;0;0;0;2;1;99991;SMARTPHONE A03S 32 GB ROJO;TELEFONIA
7626350;Casado;F;65;CHILENO;;Boomers;PROVIDENCIA                   ;METROPOLITANA;164980;2;2;0;0;0;2;2;164980;CELULAR VIVO Y11S 32GB NEBULA BLUE OPEN;TELEFONIA
15632322;;M;38;CHILENO;;Millenial;RENCA                         ;METROPOLITANA;899990;2;1;2;1;899990;0;0;0;CELULAR IPHONE 12 PRO MAX 128GB AZUL CLARO;TELEFONIA
10439572;;F;58;CHILENO;;Boomers;PROVIDENCIA                   ;METROPOLITANA;99990;1;1;0;0;0;1;1;99990;CELULAR VIVO Y11S 32GB NEBULA BLUE OPEN;TELEFONIA
6749518;;F;74;CHILENO;;Silencioso;N/D;N/D;335970;3;2;0;0;0;3;2;335970;CELULAR VIVO Y53S FANTASTIC RAINBOW 128GB OPEN;TELEFONIA
19453424;;M;26;CHILENO;;Silencioso;PROVIDENCIA                   ;METROPOLITANA;1558460;4;2;2;1;805480;2;1;752980;CELULAR IPHONE 12 128GB WHITE CLARO;TELEFONIA
13072458;;F;46;CHILENO;;X;TALAGANTE                     ;METROPOLITANA;377950;7;2;0;0;0;7;2;377950;CELULAR POCO X3 PRO 128G PHANTOM BLACK OPEN;TELEFONIA
14311544;;F;45;CHILENO;;X;N/D;N/D;464960;4;4;0;0;0;4;4;464960;CELULAR Moto G20 Blue WOM;TELEFONIA
8595214;;M;69;CHILENO;;Silencioso;EMPEDRADO                     ;MAULE;191980;2;1;0;0;0;2;1;191980;SMARTPHONE A03S 64 GB S/SIM NEGRO;TELEFONIA
16022034;;M;39;CHILENO;;X;PROVIDENCIA                   ;METROPOLITANA;149990;1;1;0;0;0;1;1;149990;CELULAR REDMI 9T 128GB SUNRISE ORANGE MOVISTAR;TELEFONIA
20150777;;F;22;CHILENO;;Z;LICANTEN                      ;MAULE;289990;1;1;1;1;289990;0;0;0;CELULAR SMARTPHONE A52S 5G LIGHT GREEN 128GB;TELEFONIA
10036651;;F;58;CHILENO;;Boomers;ARICA                         ;ARICA Y PARINACOTA;325970;3;2;0;0;0;3;2;325970;CELULAR MOTO G30 128GB GRIS TORNASOL OPEN;TELEFONIA
4526450;;F;42;CHILENO;;X;ZAPALLAR                      ;VALPARAISO;74990;2;1;0;0;0;2;1;74990;CELULAR XIAOMI REDMI 9 64GB DIRECTO CLARO MORADO;TELEFONIA
12928440;;M;47;CHILENO;;X;NUEVA IMPERIAL                ;ARAUCANIA;297969;3;2;0;0;0;3;2;297969;SMARTPHONE A03S NEGRO 32GB;TELEFONIA
15163011;;F;39;CHILENO;;X;PROVIDENCIA                   ;METROPOLITANA;179980;2;1;0;0;0;2;1;179980;CELULAR CLARO MOTOROLA E7 32GB GRIS;TELEFONIA
20076648;;M;23;CHILENO;;Z;SAN CARLOS                    ;BIO BIO;149980;3;2;0;0;0;3;2;149980;CELULAR MOTOROLA E6 PLAY AZUL TRI WOM;TELEFONIA
5767288;;F;75;CHILENO;;Silencioso;CATEMU                        ;VALPARAISO;253980;2;1;0;0;0;2;1;253980;CELULAR A32 128 GB LIGHT VIOLET OPEN;TELEFONIA
14310083;;M;46;CHILENO;;X;DALCAHUE                      ;LOS LAGOS;139990;1;1;0;0;0;1;1;139990;CELULAR MOTO G30 128GB GRIS TORNASOL OPEN;TELEFONIA
7505221;;F;70;CHILENO;;Silencioso;BUIN                          ;METROPOLITANA;116980;3;2;0;0;0;3;2;116980;CELULAR VIVO Y11S PHANTON BLACK 32GB MOVISTAR;TELEFONIA
10218247;;M;58;CHILENO;;Boomers;"";"";243980;2;1;0;0;0;2;1;243980;CELULAR A32 128 GB LIGHT VIOLET OPEN;TELEFONIA
26316571;;M;30;HAITIANO;;Extranjero;LA LIGUA                      ;VALPARAISO;119990;1;1;0;0;0;1;1;119990;CELULAR MOTOROLA G9 PLAY 64GB BLUE DIRECTO CLAR;TELEFONIA
13140467;;F;45;CHILENO;;X;REQUINOA                      ;L.G.B.OÂ´HIGGINS;299980;2;2;0;0;0;2;2;299980;CELULAR SAMSUNG A12 128GB BLACK CLARO;TELEFONIA
11627464;;F;52;CHILENO;;X;SANTIAGO                      ;METROPOLITANA;288950;5;4;0;0;0;5;4;288950;CELULAR A32 128 GB BLUE OPEN;TELEFONIA
15505033;;F;39;CHILENO;;X;LANCO                         ;METROPOLITANA;1054970;3;2;2;1;454980;1;1;599990;Celular Galaxy S21 Phantom Grey 128GB;TELEFONIA
7138052;;M;69;CHILENO;;Silencioso;RENGO                         ;L.G.B.OÂ´HIGGINS;109480;2;1;0;0;0;2;1;109480;CELULAR CLARO MOTOROLA E7 32GB GRIS;TELEFONIA
14694164;;M;62;ECUATORIANO;;Extranjero;MOSTAZAL                      ;L.G.B.OÂ´HIGGINS;174990;2;1;0;0;0;2;1;174990;CELULAR REDMI NOTE 10S 128GB PEBBLE WHITE;TELEFONIA
16585369;;F;36;CHILENO;;Millenial;TRAIGUEN                      ;ARAUCANIA;699990;1;1;0;0;0;1;1;699990;Celular Galaxy S21 Plus Phantom Violet 128GB;TELEFONIA
16252031;;F;36;CHILENO;;Millenial;RENCA                         ;METROPOLITANA;239990;1;1;0;0;0;1;1;239990;POCO X3 PRO 256 GB PHANTOM BLACK;TELEFONIA
18812294;;M;27;CHILENO;;Millenial;NATALES                       ;MAGALLANES;129990;1;1;0;0;0;1;1;129990;CELULAR REDMI NOTE 8 2021 64GB NEPTUNE BLUE;TELEFONIA
17980355;;F;30;CHILENO;;Millenial;N/D;N/D;89990;2;1;0;0;0;2;1;89990;CELULAR A12 128GB Negro OPEN;TELEFONIA
9418454;;M;59;CHILENO;;Boomers;VALPARAISO                    ;VALPARAISO;275980;3;1;0;0;0;3;1;275980;CELULAR POCO X3 PRO 128 GB FROST BLUE;TELEFONIA
14181000;;F;42;CHILENO;;X;PROVIDENCIA                   ;METROPOLITANA;199990;1;1;0;0;0;1;1;199990;CELULAR A32 128 GB LIGHT VIOLET OPEN;TELEFONIA
11033813;;F;57;CHILENO;;Boomers;CHIGUAYANTE                   ;BIO BIO;159991;2;1;0;0;0;2;1;159991;CELULAR XIAOMI REDMI 9T TWILIGHT BLUE MOVISTAR;TELEFONIA
19324670;;F;24;CHILENO;;Z;PITRUFQUEN                    ;ARAUCANIA;127980;2;1;0;0;0;2;1;127980;CELULAR VIVO Y11S 32GB NEBULA BLUE OPEN;TELEFONIA
17472564;;M;32;CHILENO;;Millenial;PROVIDENCIA                   ;METROPOLITANA;279990;1;1;1;1;279990;0;0;0;CELULAR SMARTPHONE A52S 5G BLACK 128GB;TELEFONIA
25189579;;F;26;BOLIVIANO;;Extranjero;PROVIDENCIA                   ;METROPOLITANA;99990;2;1;0;0;0;2;1;99990;CELULAR VIVO Y20S NEBULA 128 GB BLUE OPEN;TELEFONIA
14101392;;M;40;CHILENO;;X;PUREN                         ;ARAUCANIA;146980;2;1;2;1;146980;0;0;0;CELULAR XIAOMI REDMI 9 64GB DIRECTO CLARO MORADO;TELEFONIA
7526555;;F;67;CHILENO;;Boomers;ANTOFAGASTA                   ;ANTOFAGASTA;181980;2;1;0;0;0;2;1;181980;VIVO Y20 OBSIDIAN BLACK OPEN;TELEFONIA
9567582;;F;74;CHILENO;;Silencioso;VALDIVIA                      ;LOS LAGOS;449139;5;3;0;0;0;5;3;449139;SMARTPHONE A52S 5G WHITE 128GB;TELEFONIA
17717279;;F;31;CHILENO;;Millenial;N/D;N/D;117980;2;1;0;0;0;2;1;117980;CELULAR MOTO E7 GRIS MINERAL MOVISTAR;TELEFONIA
13234117;;M;44;CHILENO;;X;PUDAHUEL                      ;METROPOLITANA;251960;4;2;0;0;0;4;2;251960;CELULAR MOTOROLA G20 64GB BLUE CLARO;TELEFONIA
8011874;;F;63;CHILENO;;Boomers;SANTIAGO                      ;METROPOLITANA;139990;1;2;0;0;0;1;2;139990;SMARTPHONE A03S 64 GB NEGRO;TELEFONIA
20452443;;F;22;CHILENO;;Millenial;PUENTE ALTO;METROPOLITANA;215980;2;1;0;0;0;2;1;215980;CELULAR A32 128 GB LIGHT VIOLET OPEN;TELEFONIA
14155187;;M;40;CHILENO;;X;N/D;N/D;183980;2;1;2;1;183980;0;0;0;REDMI 10 US 128GB Carbon Gray;TELEFONIA
15910500;;M;38;CHILENO;;X;NEGRETE                       ;BIO BIO;243980;2;1;0;0;0;2;1;243980;CELULAR A32 128 GB LIGHT VIOLET OPEN;TELEFONIA
26973196;;F;44;EXTRANJERO - NO INFORMA NACIONALIDAD;;Extranjero;"";"";94990;2;2;0;0;0;2;2;94990;CELULAR VIVO Y20S OBSIDIAN BLACK 128GB OPEN;TELEFONIA
17930857;;F;31;CHILENO;;Millenial;PROVIDENCIA                   ;METROPOLITANA;65990;2;1;0;0;0;2;1;65990;CELULAR MOTO E7 32GB ROSA CORAL OPEN;TELEFONIA
9123207;;F;61;CHILENO;;Boomers;PROVIDENCIA                   ;METROPOLITANA;117980;2;1;0;0;0;2;1;117980;CELULAR VIVO Y11S PHANTON BLACK 32GB MOVISTAR;TELEFONIA
7208640;;M;59;CHILENO;;Boomers;N/D;N/D;265950;4;2;4;2;265950;0;0;0;SMARTHPHONE SAMSUNG GALAXY A03S 64GB NEGRO;TELEFONIA
12205288;;M;49;CHILENO;;X;SAN CARLOS                    ;BIO BIO;149990;1;1;0;0;0;1;1;149990;CELULAR A12 128GB Rojo OPEN;TELEFONIA
8326929;;F;65;CHILENO;;Boomers;N/D;N/D;504630;2;1;0;0;0;2;1;504630;CELULAR IPHONE SE 64GB DIRECTO CLARO;TELEFONIA
19464761;;F;25;CHILENO;;Z;PROVIDENCIA                   ;METROPOLITANA;139990;1;1;1;1;139990;0;0;0;CELULAR MOTO G20 EDICION ESPECIAL 4/128 GB AZUL;TELEFONIA
9192125;;M;60;CHILENO;;Boomers;RENCA                         ;METROPOLITANA;139990;1;1;0;0;0;1;1;139990;CELULAR A12 128GB Azul OPEN;TELEFONIA
25508637;;M;46;PERUANO;;Extranjero;SAN BERNARDO                  ;METROPOLITANA;119990;1;1;0;0;0;1;1;119990;Celular Y8P ENTEL TRIANGULADO NEGRO;TELEFONIA
22635219;;M;44;PERUANO;;Extranjero;IQUIQUE                       ;TARAPACA;129991;2;1;0;0;0;2;1;129991;VIVO Y20 OBSIDIAN BLACK OPEN;TELEFONIA
16139499;;F;36;CHILENO;;Millenial;PROVIDENCIA                   ;METROPOLITANA;120140;3;2;0;0;0;3;2;120140;CELULAR MOTO G30 128GB LILA PASTEL OPEN;TELEFONIA
10871167;Casado;M;55;CHILENO;;Boomers;RENCA                         ;METROPOLITANA;46970;4;2;0;0;0;4;2;46970;CELULAR VIVO Y11S 32GB NEBULA BLUE OPEN;TELEFONIA
20525127;;F;21;CHILENO;;Z;LLAILLAY                      ;VALPARAISO;129990;1;1;0;0;0;1;1;129990;CELULAR Moto G20 Rosado WOM;TELEFONIA
13344620;Casado;F;45;CHILENO;;X;RENGO                         ;L.G.B.OÂ´HIGGINS;79980;4;2;0;0;0;4;2;79980;CELULAR VIVO Y11S 32 GB NEBULA BLUE WOM;TELEFONIA
7574679;;M;64;CHILENO;;Boomers;VALPARAISO                    ;VALPARAISO;127980;2;1;0;0;0;2;1;127980;CELULAR VIVO Y11S 32GB NEBULA BLUE OPEN;TELEFONIA
18523076;;F;29;CHILENO;;Millenial;LOS ANGELES                   ;BIO BIO;222980;2;3;0;2;0;2;1;222980;CELULAR XIAOMI REDMI 9T TWILIGHT BLUE MOVISTAR;TELEFONIA
15248886;;M;39;CHILENO;;X;PUENTE ALTO                   ;METROPOLITANA;599990;1;1;0;0;0;1;1;599990;IPHONE 11 64GB BLACK CLARO;TELEFONIA
5763654;;M;72;CHILENO;;Silencioso;BULNES                        ;BIO BIO;119990;1;1;0;0;0;1;1;119990;CELULAR MOTOROLA G9 PLAY 64GB SPRING PINK OPEN;TELEFONIA
17855951;;F;31;CHILENO;;Millenial;N/D;N/D;672950;5;3;0;0;0;5;3;672950;CELULAR XIAOMI 11 LITE 5G NE 8/128GB BUBBLEGUM K;TELEFONIA
11766252;;M;50;CHILENO;;X;SAN CLEMENTE                  ;MAULE;550650;4;2;0;0;0;4;2;550650;CELULAR SMARTPHONE A52S 5G LIGHT GREEN 128GB;TELEFONIA
15608474;;M;38;CHILENO;;Millenial;PROVIDENCIA                   ;METROPOLITANA;351970;3;1;0;0;0;3;1;351970;POCO X3 PRO 256 GB PHANTOM BLACK;TELEFONIA
11062849;;F;55;CHILENO;;Boomers;LEBU                          ;BIO BIO;152660;3;2;0;0;0;3;2;152660;SMARTPHONE A03S 32 GB ROJO;TELEFONIA
16433289;;F;35;CHILENO;;Millenial;RENCA                         ;METROPOLITANA;229990;1;1;0;0;0;1;1;229990;POCO X3 PRO 256 GB PHANTOM BLACK;TELEFONIA
10849341;;F;57;CHILENO;;Boomers;PEDRO AGUIRRE CERDA           ;METROPOLITANA;279980;2;1;0;0;0;2;1;279980;CELULAR MOTOROLA G30 GRIS WOM 128 GB;TELEFONIA
17972780;;F;30;CHILENO;;Millenial;N/D;N/D;74990;2;1;0;0;0;2;1;74990;CELULAR Moto G20 Rosado WOM;TELEFONIA
15732913;;M;38;CHILENO;;Millenial;"";"";199990;1;1;1;1;199990;0;0;0;POCO X3 PRO US 128G METAL BRONZE;TELEFONIA
13969956;;M;42;CHILENO;;X;N/D;N/D;603970;3;2;0;0;0;3;2;603970;CELULAR SMARTPHONE A52S 5G BLACK 128GB;TELEFONIA
12594049;;F;47;CHILENO;;X;OSORNO                        ;LOS LAGOS;119990;1;1;0;0;0;1;1;119990;Celular XIAOMI REDMI 9 64 GB DIRECTO CLARO NEGRO;TELEFONIA
19584252;;F;25;CHILENO;;Z;PROVIDENCIA                   ;METROPOLITANA;59990;1;1;0;0;0;1;1;59990;CELULAR NOKIA C1 PLUS BLUE;TELEFONIA
24972636;;M;33;ARGENTINO;;Extranjero;SAN ANTONIO                   ;VALPARAISO;223980;2;1;0;0;0;2;1;223980;CELULAR MOTO G30 128GB GRIS TORNASOL OPEN;TELEFONIA
17491523;;F;32;CHILENO;;Millenial;COQUIMBO                      ;COQUIMBO;99990;1;1;0;0;0;1;1;99990;CELULAR MOTOROLA G20 64GB BLUE CLARO;TELEFONIA
15528236;;M;43;CHILENO;;X;LONGAVI                       ;MAULE;237607;6;2;0;0;0;6;2;237607;CELULAR VIVO Y11S 32GB NEBULA BLUE OPEN;TELEFONIA
26227962;;M;53;EXTRANJERO - NO INFORMA NACIONALIDAD;;Extranjero;N/D;N/D;230980;2;1;0;0;0;2;1;230980;SMARTHPHONE REDMI 10 US 64GB SEA BLUE;TELEFONIA
27157787;;F;34;EXTRANJERO - NO INFORMA NACIONALIDAD;;Extranjero;SAN MIGUEL;METROPOLITANA;316130;3;1;0;0;0;3;1;316130;CELULAR MI 11 LITE 128GB BOBA BLACK OPEN;TELEFONIA
18952380;;M;27;CHILENO;;Millenial;ILLAPEL                       ;COQUIMBO;129990;1;1;0;0;0;1;1;129990;CELULAR XIAOMI REDMI 9 64GB DIRECTO CLARO MORADO;TELEFONIA
14065679;;F;40;CHILENO;;X;LO PRADO;METROPOLITANA;199990;1;1;1;1;199990;0;0;0;CELULAR XIAOMI POCO X3 PRO 128GB PANTHOM BLACK;TELEFONIA
10993355;;M;50;CHILENO;;X;COPIAPO                       ;ATACAMA;423970;3;1;0;0;0;3;1;423970;CELULAR A32 128 GB WHITE OPEN;TELEFONIA
24568419;Soltero;F;38;COLOMBIANO;;Extranjero;LA REINA                      ;METROPOLITANA;289990;1;1;0;0;0;1;1;289990;CELULAR SMARTPHONE A52S 5G BLACK 128GB;TELEFONIA
10424133;;M;56;CHILENO;;Boomers;N/D;N/D;202980;2;1;0;0;0;2;1;202980;CELULAR A12 128GB Negro OPEN;TELEFONIA
9331362;;M;61;CHILENO;;Boomers;TENO                          ;MAULE;139990;1;3;0;0;0;1;3;139990;CELULAR A12 128GB NEGRO OPEN;TELEFONIA
26537978;;F;49;EXTRANJERO - NO INFORMA NACIONALIDAD;;Extranjero;N/D;N/D;689980;2;1;0;0;0;2;1;689980;CELULAR MOTO G100 128GB VERDE BOREAL + HMDI OPEN;TELEFONIA
19556729;;F;25;CHILENO;;Z;OSORNO                        ;LOS LAGOS;627950;6;2;0;0;0;6;2;627950;SMARTHPHONE REDMI 10 US 64GB SEA BLUE;TELEFONIA
10281426;Casado;M;53;CHILENO;;X;RENCA                         ;METROPOLITANA;94990;2;1;0;0;0;2;1;94990;CELULAR MOTO G30 128GB LILA PASTEL OPEN;TELEFONIA
10161486;Soltero;M;57;CHILENO;;Boomers;RENCA                         ;METROPOLITANA;156980;2;1;0;0;0;2;1;156980;SMARTPHONE A03S 32 GB ROJO;TELEFONIA
7296411;;F;70;CHILENO;;Silencioso;VINA DEL MAR                  ;VALPARAISO;179990;1;1;0;0;0;1;1;179990;CELULAR A32 128 GB LIGHT VIOLET OPEN;TELEFONIA
17660865;;M;32;CHILENO;;Millenial;PENAFLOR                      ;METROPOLITANA;99990;1;1;0;0;0;1;1;99990;CELULAR MOTOROLA G20 64GB BLUE CLARO;TELEFONIA
8638191;;F;59;CHILENO;;Boomers;RENGO                         ;L.G.B.OÂ´HIGGINS;44990;2;1;0;0;0;2;1;44990;CELULAR VIVO Y11S 32GB NEBULA BLUE OPEN;TELEFONIA
9036182;;M;57;CHILENO;;Boomers;PROVIDENCIA                   ;METROPOLITANA;693980;2;1;2;1;693980;0;0;0;CELULAR IPHONE 12 64GB BLACK CLARO;TELEFONIA
15303714;;F;45;CHILENO;;X;AISEN                         ;AYSEN;399990;1;1;0;0;0;1;1;399990;CELULAR A72 128 GB LIGHT VIOLET OPEN;TELEFONIA
15355102;;F;39;CHILENO;;X;PENALOLEN                     ;METROPOLITANA;199990;1;1;1;1;199990;0;0;0;POCO X3 PRO 256 GB PHANTOM BLACK;TELEFONIA
9367948;;M;60;CHILENO;;Boomers;NANCAGUA                      ;L.G.B.OÂ´HIGGINS;768050;4;2;0;0;0;4;2;768050;CELULAR POCO X3 PRO 128G PHANTOM BLACK OPEN;TELEFONIA
18950750;;M;27;CHILENO;;Millenial;CASTRO                        ;LOS LAGOS;129990;1;1;0;0;0;1;1;129990;CELULAR MOTOROLA MOTO G20 64GB ROSA FLAMINGO;TELEFONIA
14348284;Casado;M;43;CHILENO;AGRONOMO;X;RENCA                         ;METROPOLITANA;819980;2;1;0;0;0;2;1;819980;CELULAR XIAOMI 11T 8/256GB CELESTIAL BLUE KIT;TELEFONIA
26170096;;F;39;EXTRANJERO - NO INFORMA NACIONALIDAD;;Extranjero;PICA                          ;TARAPACA;359991;2;1;0;0;0;2;1;359991;CELULAR XIAOMI 11 LITE 5G NE 8/128GB BUBBLEGUM K;TELEFONIA
16906794;Soltero;M;32;CHILENO;;Millenial;RENCA                         ;METROPOLITANA;149991;2;1;0;0;0;2;1;149991;SMARTHPHONE SAMSUNG GALAXY A03S 64GB NEGRO;TELEFONIA
15538750;;M;38;CHILENO;;X;RECOLETA;METROPOLITANA;294990;1;1;0;0;0;1;1;294990;CELULAR SMARTPHONE A52S 5G LIGHT VIOLET 128GB;TELEFONIA
17828551;Soltero;F;30;CHILENO;TECNICO EN ENFERMERIA DE NIVEL SUPERIOR;Millenial;PICHILEMU                     ;L.G.B.OÂ´HIGGINS;873970;3;2;0;0;0;3;2;873970;POCO F3 EU Night Black 256GB;TELEFONIA
4671721;;M;78;CHILENO;;Silencioso;PROVIDENCIA                   ;METROPOLITANA;192971;4;1;0;0;0;4;1;192971;CELULAR A12 128GB Azul OPEN;TELEFONIA
14207827;;F;40;CHILENO;;X;RENCA                         ;METROPOLITANA;214960;4;4;2;2;156980;2;2;57980;CELULAR REDMI 9T 128GB SUNRISE ORANGE MOVISTAR;TELEFONIA
13711421;;M;43;CHILENO;;X;PROVIDENCIA                   ;METROPOLITANA;119990;1;1;1;1;119990;0;0;0;CELULAR MOTOROLA G20 64GB BLUE CLARO;TELEFONIA
13327903;;M;44;CHILENO;;X;N/D;N/D;899990;2;1;2;1;899990;0;0;0;CELULAR IPHONE 12 PRO MAX 128GB AZUL CLARO;TELEFONIA
12507646;;F;49;CHILENO;;X;N/D;N/D;189990;1;1;0;0;0;1;1;189990;CELULAR A32 128 GB WHITE OPEN;TELEFONIA
17630194;;F;32;CHILENO;;Millenial;N/D;N/D;149990;1;1;1;1;149990;0;0;0;CELULAR MOTO G30 GRIS TORNASOL 128GB MOVISTAR;TELEFONIA
10443162;;F;54;CHILENO;;Boomers;PROVIDENCIA                   ;METROPOLITANA;153980;2;1;2;1;153980;0;0;0;CELULAR MOTO G20 EDICION ESPECIAL 4/128 GB AZUL;TELEFONIA
16889741;;F;32;CHILENO;;Millenial;N/D;N/D;299990;1;1;1;1;299990;0;0;0;CELULAR IPHONE SE 64GB DIRECTO CLARO;TELEFONIA
17687980;;M;31;CHILENO;;Millenial;PROVIDENCIA                   ;METROPOLITANA;149990;1;1;0;0;0;1;1;149990;CELULAR MOTOROLA G30 GRIS WOM 128 GB;TELEFONIA
18671317;;M;28;CHILENO;;Millenial;LOS ALAMOS                    ;BIO BIO;94990;1;1;0;0;0;1;1;94990;CELULAR CLARO MOTOROLA E7 32GB GRIS;TELEFONIA
10117940;;M;57;CHILENO;;Boomers;NEGRETE                       ;BIO BIO;91990;2;1;0;0;0;2;1;91990;MOTO G20 AZUL CIELO 64GB MOVISTAR;TELEFONIA
8914341;;M;60;CHILENO;;Boomers;CHANCO;MAULE;149990;1;1;0;0;0;1;1;149990;SMARTHPHONE SAMSUNG GALAXY A03S 64GB NEGRO;TELEFONIA
17448576;;F;32;CHILENO;;Millenial;N/D;N/D;217980;3;1;0;0;0;3;1;217980;CELULAR REDMI NOTE 10S 128GB PEBBLE WHITE;TELEFONIA
13446501;;F;43;CHILENO;;X;SAN BERNARDO                  ;METROPOLITANA;199980;2;2;2;2;199980;0;0;0;CELULAR MOTOROLA G20 64GB BLUE CLARO;TELEFONIA
18977626;;F;27;CHILENO;;Z;CURICO;MAULE;229990;1;1;1;1;229990;0;0;0;POCO X3 PRO 256 GB PHANTOM BLACK;TELEFONIA
10526422;;F;53;CHILENO;;X;ANCUD                         ;LOS LAGOS;189990;1;1;1;1;189990;0;0;0;POCO X3 PRO US 128G METAL BRONZE;TELEFONIA
6644850;Casado;M;69;CHILENO;AGRONOMO;Silencioso;RETIRO                        ;MAULE;119990;2;1;0;0;0;2;1;119990;VIVO Y20 OBSIDIAN BLACK OPEN;TELEFONIA
11099467;;F;56;CHILENO;;Boomers;LA SERENA                     ;COQUIMBO;169990;1;1;0;0;0;1;1;169990;CELULAR REDMI 9T 128 GB OCEAN GREEN;TELEFONIA
12201891;;M;50;CHILENO;;X;LEBU                          ;BIO BIO;192970;3;2;0;0;0;3;2;192970;CELULAR Moto G20 Rosado WOM;TELEFONIA
6798682;;F;74;CHILENO;;Silencioso;MARIQUINA                     ;LOS LAGOS;369990;1;1;0;0;0;1;1;369990;CELULAR SMARTPHONE A52S 5G BLACK 128GB;TELEFONIA
13400757;;F;44;CHILENO;;X;PANGUIPULLI                   ;LOS LAGOS;129991;2;1;0;0;0;2;1;129991;CELULAR MOTO ONE FUSION 64GB VERDE 64GB OPEN;TELEFONIA
25963785;;M;44;VENEZOLANO;;Extranjero;N/D;N/D;149990;1;1;0;0;0;1;1;149990;Celular Y8P ENTEL TRIANGULADO NEGRO;TELEFONIA
8625908;;M;62;CHILENO;;Boomers;PROVIDENCIA                   ;METROPOLITANA;399980;2;1;0;0;0;2;1;399980;CELULAR A32 128 GB BLUE OPEN;TELEFONIA
14679007;;M;50;PERUANO;;Extranjero;SANTIAGO                      ;METROPOLITANA;377060;3;1;0;0;0;3;1;377060;CELULAR SMARTPHONE A52S 5G BLACK 128GB;TELEFONIA
11126174;;M;55;CHILENO;;Boomers;EL BOSQUE                     ;METROPOLITANA;31990;2;1;0;0;0;2;1;31990;CELULAR MOTO E7I POWER 32GB BLUE MOVISTAR;TELEFONIA
8498121;;M;63;CHILENO;;Boomers;LOS ANGELES                   ;BIO BIO;209991;2;1;0;0;0;2;1;209991;CELULAR A32 128 GB BLUE OPEN;TELEFONIA
7133488;;M;64;CHILENO;;Boomers;N/D;N/D;141980;2;2;0;0;0;2;2;141980;CELULAR VIVO Y20S OBSIDIAN BLACK 128GB OPEN;TELEFONIA
13837331;;F;42;CHILENO;;X;LA PINTANA                    ;METROPOLITANA;261460;5;2;0;0;0;5;2;261460;VIVO Y20 OBSIDIAN BLACK OPEN;TELEFONIA
4915602;;F;84;CHILENO;;Silencioso;LLAILLAY                      ;VALPARAISO;91990;2;1;0;0;0;2;1;91990;MOTO G20 AZUL CIELO 64GB MOVISTAR;TELEFONIA
7718526;;F;62;CHILENO;;Boomers;LOS ALAMOS                    ;BIO BIO;185980;2;4;0;0;0;2;4;185980;MOTO G30 LILA PASTEL 128GB MOVISTAR;TELEFONIA
9418910;;M;59;CHILENO;;Boomers;NATALES                       ;MAGALLANES;94982;2;1;0;0;0;2;1;94982;CELULAR MOTOROLA E7 IPOWER 32GB BLUE CLARO;TELEFONIA
19548882;;M;25;CHILENO;;Z;PAPUDO                        ;VALPARAISO;238980;2;1;0;0;0;2;1;238980;CELULAR A22 128GB NEGRO;TELEFONIA
6895272;;F;63;CHILENO;;Boomers;RENCA                         ;METROPOLITANA;123980;2;1;2;1;123980;0;0;0;CELULAR A12 128GB Azul OPEN;TELEFONIA
20294245;;F;22;CHILENO;;Z;PROVIDENCIA                   ;METROPOLITANA;499960;4;2;0;0;0;4;2;499960;CELULAR POCO X3 PRO 256 GB FROST BLUE;TELEFONIA
18763331;Soltero;M;27;CHILENO;TECNICO EN ELECTRONICA;Millenial;PROVIDENCIA                   ;METROPOLITANA;503980;3;1;3;1;503980;0;0;0;CELULAR GALAXY S20FE 128GB CLOUD GREEN OPEN;TELEFONIA
5380993;;M;76;CHILENO;;Silencioso;RENCA                         ;METROPOLITANA;148980;2;1;0;0;0;2;1;148980;CELULAR VIVO Y11S PHANTOM BLACK OPEN;TELEFONIA
7213553;Casado;F;70;CHILENO;;Silencioso;PROVIDENCIA                   ;METROPOLITANA;124990;2;1;0;0;0;2;1;124990;CELULAR A12 128GB Negro OPEN;TELEFONIA
18270028;;M;29;CHILENO;;Millenial;QUILLOTA                      ;VALPARAISO;309990;2;1;0;0;0;2;1;309990;CELULAR SMARTPHONE A52S 5G BLACK 128GB;TELEFONIA
10498024;;F;56;CHILENO;;Boomers;LINARES                       ;MAULE;978200;11;5;0;0;0;11;5;978200;CELULAR REDMI 9T 128 GB OCEAN GREEN;TELEFONIA
19348053;;F;26;CHILENO;;Z;LA SERENA                     ;COQUIMBO;99990;2;1;0;0;0;2;1;99990;CELULAR A12 128GB Negro OPEN;TELEFONIA
6000950;;M;70;CHILENO;;Silencioso;SAN ANTONIO                   ;VALPARAISO;89990;2;1;0;0;0;2;1;89990;CELULAR A12 128GB Azul OPEN;TELEFONIA
7471600;;F;68;CHILENO;;Boomers;SAN JOAQUIN                   ;METROPOLITANA;109980;2;1;2;1;109980;0;0;0;Celular A10S LIB OPEN RED;TELEFONIA
9940132;;F;55;CHILENO;;Boomers;MELIPILLA                     ;METROPOLITANA;264980;2;2;0;0;0;2;2;264980;CELULAR VIVO Y20S NEBULA 128 GB BLUE OPEN;TELEFONIA
15772782;;M;38;CHILENO;;Millenial;MAULE                         ;MAULE;399990;1;1;0;0;0;1;1;399990;CELULAR A72 128 GB BLUE OPEN;TELEFONIA
6767449;;F;65;CHILENO;;Boomers;SAN FERNANDO                  ;L.G.B.OÂ´HIGGINS;84990;1;1;0;0;0;1;1;84990;CELULAR MOTO E7 32GB ROSA CORAL OPEN;TELEFONIA
9475720;;F;61;CHILENO;;Boomers;RECOLETA                      ;METROPOLITANA;89990;2;1;0;0;0;2;1;89990;CELULAR VIVO Y11S NEBULA BLUE 32GB OPEN;TELEFONIA
8185569;;M;64;CHILENO;;Boomers;SAN FELIPE                    ;VALPARAISO;564970;3;2;0;0;0;3;2;564970;CELULAR LG K61 Gris OPEN;TELEFONIA
26795321;;M;47;VENEZOLANO;;Extranjero;TEMUCO                        ;ARAUCANIA;436980;2;1;2;1;436980;0;0;0;CELULAR XIAOMI 11T 8/256GB CELESTIAL BLUE KIT;TELEFONIA
20132698;;F;23;CHILENO;;Z;LA LIGUA;VALPARAISO;164990;2;1;0;0;0;2;1;164990;CELULAR POCO X3 PRO 128G PHANTOM BLACK OPEN;TELEFONIA
16442890;;M;35;CHILENO;;Millenial;OVALLE;COQUIMBO;169990;1;1;1;1;169990;0;0;0;REDMI 10 US 128GB Carbon Gray;TELEFONIA
11622714;;F;52;CHILENO;;X;QUILPUE                       ;VALPARAISO;84990;1;1;0;0;0;1;1;84990;CELULAR VIVO Y11S NEBULA BLUE 32GB OPEN;TELEFONIA
12751244;Casado;M;46;CHILENO;;X;RENCA                         ;METROPOLITANA;109990;1;1;0;0;0;1;1;109990;Celular Y7P LIB OPEN NEGRO;TELEFONIA
12361313;;F;49;CHILENO;;X;FLORIDA                       ;BIO BIO;259990;1;1;0;0;0;1;1;259990;POCO X3 PRO 256 GB PHANTOM BLACK;TELEFONIA
9697892;;M;56;CHILENO;;Boomers;RENCA                         ;METROPOLITANA;109990;1;1;0;0;0;1;1;109990;CELULAR REDMI NOTE 8 2021 64GB MOONLIGHT WHITE;TELEFONIA
11310873;;F;54;CHILENO;;X;LIMACHE                       ;VALPARAISO;96980;2;2;0;0;0;2;2;96980;CELULAR A02 NEGRO 32GB OPEN;TELEFONIA
16229272;;F;39;CHILENO;;X;N/D;N/D;376680;4;2;4;2;376680;0;0;0;CELULAR SMARTPHONE A52S 5G BLACK 128GB;TELEFONIA
10201601;;M;55;CHILENO;;Boomers;PROVIDENCIA                   ;METROPOLITANA;149990;1;1;0;0;0;1;1;149990;CELULAR A12 128GB Azul OPEN;TELEFONIA
5867164;;F;68;CHILENO;;Boomers;RENCA                         ;METROPOLITANA;149990;1;1;0;0;0;1;1;149990;CELULAR A12 128GB Azul OPEN;TELEFONIA
10198802;;F;59;CHILENO;;Boomers;RENCA                         ;METROPOLITANA;79980;4;2;0;0;0;4;2;79980;CELULAR REDMI 9 32GB CARBON GREY OPEN;TELEFONIA
18581844;;F;28;CHILENO;;Millenial;PROVIDENCIA                   ;METROPOLITANA;169990;1;1;0;0;0;1;1;169990;CELULAR REDMI 9T 128 GB OCEAN GREEN;TELEFONIA
14356972;;F;42;CHILENO;;X;RENGO                         ;L.G.B.OÂ´HIGGINS;519980;2;1;0;0;0;2;1;519980;CELULAR SMARTPHONE A52S 5G LIGHT GREEN 128GB;TELEFONIA
19393792;;M;26;CHILENO;;Millenial;PROVIDENCIA                   ;METROPOLITANA;1179960;4;2;4;2;1179960;0;0;0;IPHONE 11 128GB BLACK CLARO;TELEFONIA
10958174;;F;49;CHILENO;;X;ARICA                         ;ARICA Y PARINACOTA;79990;1;1;0;0;0;1;1;79990;Celular NOKIA 4.2 ENTEL DIRECTO NEGRO;TELEFONIA
19481211;;F;26;CHILENO;;Millenial;PROVIDENCIA                   ;METROPOLITANA;183980;2;1;2;1;183980;0;0;0;CELULAR A32 128 GB LIGHT VIOLET OPEN;TELEFONIA
22318538;;M;40;PERUANO;;Extranjero;INDEPENDENCIA                 ;METROPOLITANA;249990;1;1;0;0;0;1;1;249990;CELULAR HUAWEI Y9A BLACK OPEN;TELEFONIA
15387245;;M;39;CHILENO;;X;RENGO;O HIGGINS;156120;4;2;0;0;0;4;2;156120;CELULAR MOTO G20 64GB ROSA FLAMINGO OPEN;TELEFONIA
26662668;;F;42;VENEZOLANO;;Extranjero;"";"";990;1;1;0;0;0;1;1;990;CHIP PREPAGO 2000 WOM;TELEFONIA
19851978;;M;24;CHILENO;;Z;RANCAGUA                      ;L.G.B.OÂ´HIGGINS;1604530;3;1;3;1;1604530;0;0;0;IPHONE 12 128GB BLACK CLARO;TELEFONIA
11275336;;F;53;CHILENO;;Silencioso;PROVIDENCIA                   ;METROPOLITANA;884530;3;1;3;1;884530;0;0;0;IPHONE XS 64GB GRIS REAC;TELEFONIA
14358685;;M;44;CHILENO;;X;PROVIDENCIA                   ;METROPOLITANA;139990;1;1;0;0;0;1;1;139990;CELULAR VIVO Y20S OBSIDIAN BLACK 128GB OPEN;TELEFONIA
4565022;;F;80;CHILENO;;Silencioso;QUILPUE                       ;VALPARAISO;69990;1;1;0;0;0;1;1;69990;Celular LG K22 MOVISTAR DIRECTO TITAN;TELEFONIA
13157425;;F;46;CHILENO;;X;TEMUCO                        ;ARAUCANIA;99990;1;1;0;0;0;1;1;99990;CELULAR XIAOMI REDMI 9 64GB DIRECTO CLARO MORADO;TELEFONIA
5351414;;F;79;CHILENO;;Silencioso;RENCA                         ;METROPOLITANA;183980;2;1;2;1;183980;0;0;0;CELULAR A32 128 GB LIGHT VIOLET OPEN;TELEFONIA
13588742;;F;48;CHILENO;;X;VALDIVIA                      ;LOS RIOS;74990;1;1;0;0;0;1;1;74990;CELULAR MOTO E6I 32GB GRIS OPEN;TELEFONIA
7186804;;F;70;CHILENO;;Silencioso;VALLENAR;ATACAMA;645980;2;1;0;0;0;2;1;645980;CELULAR NOTE 20 ULTRA MYSTIC BRONZE 256 GB OPE;TELEFONIA
5735226;;F;77;CHILENO;;Silencioso;CALBUCO                       ;LOS LAGOS;34990;1;1;0;0;0;1;1;34990;CELULAR NOKIA 225 4G BLACK MOVISTAR DIRECTO;TELEFONIA
11188507;Soltero;M;55;CHILENO;AGRONOMO;Boomers;CALAMA                        ;ANTOFAGASTA;185130;3;1;0;0;0;3;1;185130;SMARTHPHONE SAMSUNG GALAXY A03S 64GB NEGRO;TELEFONIA
13802999;;M;41;CHILENO;;X;CANETE                        ;BIO BIO;391941;7;3;0;0;0;7;3;391941;CELULAR A12 128GB Negro OPEN;TELEFONIA
16632994;;F;35;CHILENO;;Millenial;LA FLORIDA                    ;METROPOLITANA;249990;1;1;0;0;0;1;1;249990;POCO X3 PRO 256 GB METAL BRONCE;TELEFONIA
8239175;;F;64;CHILENO;;Boomers;OSORNO                        ;LOS LAGOS;131990;3;1;0;0;0;3;1;131990;MOTO G30 LILA PASTEL 128GB MOVISTAR;TELEFONIA
19478099;Soltero;M;26;CHILENO;;Z;PROVIDENCIA                   ;METROPOLITANA;96980;2;1;2;1;96980;0;0;0;CELULAR REDMI 9C 32GB MIDNIGHT GRAY;TELEFONIA
11373649;;M;52;CHILENO;;X;N/D;N/D;339990;2;1;0;0;0;2;1;339990;CELULAR SMARTPHONE A52S 5G LIGHT VIOLET 128GB;TELEFONIA
19390764;;M;25;CHILENO;;Silencioso;PROVIDENCIA                   ;METROPOLITANA;480970;3;1;3;1;480970;0;0;0;CELULAR GALAXY S20FE 128GB CLOUD GREEN OPEN;TELEFONIA
13308852;Soltero;M;45;CHILENO;;X;ANCUD                         ;LOS LAGOS;149990;2;1;0;0;0;2;1;149990;REDMI 10 US 128GB Carbon Gray;TELEFONIA
15976496;Soltero;M;34;CHILENO;;Millenial;PROVIDENCIA                   ;METROPOLITANA;159980;2;1;0;0;0;2;1;159980;CELULAR CLARO LG K42 GRIS;TELEFONIA
16649251;;F;35;CHILENO;;Millenial;RENCA                         ;METROPOLITANA;309980;2;1;2;1;309980;0;0;0;POCO X3 PRO 256 GB PHANTOM BLACK;TELEFONIA
19611921;;M;24;CHILENO;;Z;N/D;N/D;79990;2;1;0;0;0;2;1;79990;CELULAR POCO M3 128GB POWER BLACK;TELEFONIA
5958221;;F;76;CHILENO;;Silencioso;RENCA                         ;METROPOLITANA;89990;1;1;0;0;0;1;1;89990;CELULAR VIVO Y11S NEBULA BLUE 32GB OPEN;TELEFONIA
15677216;;M;44;CHILENO;;X;CHILLAN VIEJO                 ;BIO BIO;560830;3;1;0;0;0;3;1;560830;CELULAR GALAXY S20FE 128GB ClOUD NAVY OPEN;TELEFONIA
16046879;;F;36;CHILENO;;Millenial;RENCA                         ;METROPOLITANA;189990;1;1;0;0;0;1;1;189990;SMARTPHONE A22 BLANCO 128GB;TELEFONIA
16582516;;M;35;CHILENO;;Millenial;PUDAHUEL                      ;METROPOLITANA;189990;1;1;1;1;189990;0;0;0;CELULAR REDMI NOTE 10S 128GB PEBBLE WHITE;TELEFONIA
8241505;;F;66;CHILENO;;Boomers;CORONEL                       ;BIO BIO;119990;1;1;0;0;0;1;1;119990;SMARTPHONE A03S NEGRO 32GB;TELEFONIA
12377442;Casado;F;49;CHILENO;;X;RENCA                         ;METROPOLITANA;130980;2;1;0;0;0;2;1;130980;SMARTPHONE A03S NEGRO 32GB;TELEFONIA
17939175;;F;30;CHILENO;;Silencioso;PROVIDENCIA                   ;METROPOLITANA;149990;1;1;1;1;149990;0;0;0;Celular Y8P ENTEL TRIANGULADO NEGRO;TELEFONIA
17968635;Soltero;F;31;CHILENO;;Millenial;RENCA                         ;METROPOLITANA;154980;2;1;2;1;154980;0;0;0;CELULAR Galaxy A21s (128GB) Black WOM;TELEFONIA
6471578;;F;71;CHILENO;;Silencioso;LA PINTANA                    ;METROPOLITANA;179980;2;1;0;0;0;2;1;179980;CELULAR MOTO E7 32GB ROSA CORAL OPEN;TELEFONIA
8590743;;M;62;CHILENO;;Boomers;PLACILLA                      ;L.G.B.OÂ´HIGGINS;115469;3;1;0;0;0;3;1;115469;Celular XIAOMI REDMI 9C 64 GB DIRECTO CLARO;TELEFONIA
6610124;Casado;M;66;CHILENO;;Boomers;RENCA                         ;METROPOLITANA;32990;1;1;0;0;0;1;1;32990;CELULAR OWN 1026 AZUL ENTEL;TELEFONIA
19393029;;M;25;CHILENO;;Z;N/D;N/D;69480;3;1;0;0;0;3;1;69480;CELULAR REDMI 9C 32GB MIDNIGHT GRAY;TELEFONIA
20058294;;M;23;CHILENO;;Z;PROVIDENCIA                   ;METROPOLITANA;377960;4;2;4;2;377960;0;0;0;CELULAR XIAOMI REDMI 9T TWILIGHT BLUE MOVISTAR;TELEFONIA
5816469;;M;69;CHILENO;;Silencioso;N/D;N/D;619970;3;3;1;1;329990;2;2;289980;CELULAR IPHONE SE 64GB DIRECTO CLARO;TELEFONIA
18009016;;F;30;CHILENO;;Millenial;ANGOL;ARAUCANIA;134980;2;2;1;1;79990;1;1;54990;CELULAR XIAOMI REDMI 9C 32GB AZUL WOM;TELEFONIA
11628054;;M;52;CHILENO;;X;QUINTA NORMAL                 ;METROPOLITANA;483980;2;1;2;1;483980;0;0;0;IPHONE 11 64GB BLACK CLARO;TELEFONIA
16397750;;F;35;CHILENO;;Millenial;VALPARAISO                    ;VALPARAISO;109990;1;1;1;1;109990;0;0;0;CELULAR XIAOMI REDMI 9 64GB DIRECTO CLARO MORADO;TELEFONIA
13332345;;F;43;CHILENO;;X;RENCA                         ;METROPOLITANA;18990;1;1;0;0;0;1;1;18990;CELULAR NOKIA 110 BLACK OPEN;TELEFONIA
15867302;;F;37;CHILENO;;Millenial;MARIA PINTO                   ;METROPOLITANA;282960;4;2;0;0;0;4;2;282960;CELULAR VIVO Y11S NEBULA BLUE 32GB OPEN;TELEFONIA
13413658;;F;45;CHILENO;;X;TEMUCO                        ;ARAUCANIA;179980;2;1;0;0;0;2;1;179980;CELULAR A12 128GB Rojo OPEN;TELEFONIA
19706945;;M;24;CHILENO;;Z;PUENTE ALTO                   ;METROPOLITANA;79990;1;1;0;0;0;1;1;79990;CELULAR MOTO E7i 32GB AZUL OPEN;TELEFONIA
15571769;;F;39;CHILENO;;X;PROVIDENCIA                   ;METROPOLITANA;469990;2;1;0;0;0;2;1;469990;CELULAR GALAXY S20FE 128GB CLOUD LAVENDER OPEN;TELEFONIA
26828008;;M;35;EXTRANJERO - NO INFORMA NACIONALIDAD;;Extranjero;INDEPENDENCIA                 ;METROPOLITANA;173980;2;1;2;1;173980;0;0;0;CELULAR A22 128GB NEGRO;TELEFONIA
14102671;;M;41;CHILENO;;X;ARICA                         ;ARICA Y PARINACOTA;2990;1;1;0;0;0;1;1;2990;BAM HUAWEI E8372H 4G LTE ENT;TELEFONIA
18419929;;F;28;CHILENO;;Millenial;N/D;N/D;99990;1;1;0;0;0;1;1;99990;CELULAR MOTOROLA G20 64GB BLUE CLARO;TELEFONIA
13024473;;M;45;CHILENO;;Silencioso;PROVIDENCIA                   ;METROPOLITANA;228540;2;1;2;1;228540;0;0;0;CELULAR MI 11 LITE US 128GB PEACH PINK OPEN;TELEFONIA
10271967;;M;63;CHILENO;;Boomers;CARTAGENA                     ;VALPARAISO;79990;1;1;0;0;0;1;1;79990;CELULAR MOTOROLA E7 IPOWER 32GB BLUE CLARO;TELEFONIA
5762986;;M;75;CHILENO;;Silencioso;PROVIDENCIA                   ;METROPOLITANA;98760;3;1;0;0;0;3;1;98760;CELULAR MOTOROLA E6 PLAY AZUL TRI WOM;TELEFONIA
17699067;;F;31;CHILENO;;Silencioso;PROVIDENCIA                   ;METROPOLITANA;455910;9;5;9;5;455910;0;0;0;CELULAR Redmi 9C 32GB Gray WOM;TELEFONIA
15344113;;M;40;CHILENO;;Millenial;"";"";1014980;3;1;0;0;0;3;1;1014980;SMARTPHONE Z FLIP3 GREEN 128GB;TELEFONIA
8720649;;F;56;CHILENO;;Boomers;LA LIGUA                      ;VALPARAISO;264980;2;1;0;0;0;2;1;264980;POCO X3 PRO 256 GB PHANTOM BLACK;TELEFONIA
20399913;;F;22;CHILENO;;Z;TOCOPILLA                     ;ANTOFAGASTA;587980;2;2;0;0;0;2;2;587980;IPHONE 11 64GB BLACK CLARO;TELEFONIA
13629413;;F;45;CHILENO;;X;TIRUA                         ;BIO BIO;89991;2;1;0;0;0;2;1;89991;CELULAR VIVO Y11S PHANTOM BLACK OPEN;TELEFONIA
15176411;;M;40;CHILENO;;Silencioso;PROVIDENCIA                   ;METROPOLITANA;169990;1;1;1;1;169990;0;0;0;CELULAR MOTOROLA G9 PLUS 128GB AZUL CLARO;TELEFONIA
18195834;;F;30;CHILENO;;Millenial;N/D;N/D;1099971;6;1;0;0;0;6;1;1099971;Celular Galaxy S21 Phantom Grey 128GB;TELEFONIA
22858504;;F;57;PERUANO;;Extranjero;LO PRADO                      ;METROPOLITANA;224990;2;1;0;0;0;2;1;224990;CELULAR RENO5 LITE NEGRO 128GB;TELEFONIA
24840538;;F;47;PERUANO;;Extranjero;CERRILLOS                     ;METROPOLITANA;139990;1;1;0;0;0;1;1;139990;CELULAR A12 128GB Negro OPEN;TELEFONIA
19576412;;M;24;CHILENO;;Z;COLBUN                        ;MAULE;349980;4;2;0;0;0;4;2;349980;CELULAR VIVO Y20S OBSIDIAN BLACK 128GB OPEN;TELEFONIA
15962326;Casado;F;37;CHILENO;TECNICO DE NIVEL SUPERIOR LABORATORISTA DENTAL;Millenial;PROVIDENCIA                   ;METROPOLITANA;109990;1;1;0;0;0;1;1;109990;CELULAR POCO M3 64GB COOL BLUE;TELEFONIA
17066007;;M;34;CHILENO;;Millenial;SAN FABIAN                    ;BIO BIO;199990;1;1;0;0;0;1;1;199990;POCO X3 PRO 256 GB PHANTOM BLACK;TELEFONIA
16423061;;F;35;CHILENO;;Silencioso;PROVIDENCIA                   ;METROPOLITANA;303980;2;1;2;1;303980;0;0;0;CELULAR IPHONE SE 64GB DIRECTO CLARO;TELEFONIA
7461452;;M;61;CHILENO;;Boomers;PROVIDENCIA                   ;METROPOLITANA;105840;2;1;2;1;105840;0;0;0;CELULAR MOTO ONE FUSION 64GB VERDE 64GB OPEN;TELEFONIA
17528219;;M;32;CHILENO;;Millenial;ZAPALLAR                      ;VALPARAISO;204980;2;1;2;1;204980;0;0;0;CELULAR POCO X3 PRO 256 GB FROST BLUE;TELEFONIA
20322874;;F;22;CHILENO;;Silencioso;PROVIDENCIA                   ;METROPOLITANA;159990;1;1;1;1;159990;0;0;0;CELULAR MOTO G30 128GB LILA PASTEL OPEN;TELEFONIA
6913646;;F;67;CHILENO;;Boomers;LA LIGUA                      ;VALPARAISO;338971;4;2;0;0;0;4;2;338971;CELULAR MOTOROLA G9 PLAY 64GB ELECTRIC BLUE OPEN;TELEFONIA
15529153;;M;38;CHILENO;;X;PROVIDENCIA                   ;METROPOLITANA;353980;2;1;2;1;353980;0;0;0;CELULAR IPHONE SE 64GB DIRECTO CLARO;TELEFONIA
15234174;;M;38;CHILENO;;Millenial;CUNCO                         ;ARAUCANIA;74990;2;1;0;0;0;2;1;74990;CELULAR MOTOROLA G20 64GB BLUE CLARO;TELEFONIA
17763082;;M;31;CHILENO;;Millenial;EL BOSQUE                     ;METROPOLITANA;109990;1;1;1;1;109990;0;0;0;CELULAR MOTOROLA MOTO G20 64GB ROSA FLAMINGO;TELEFONIA
18271641;;M;29;CHILENO;;Silencioso;PROVIDENCIA                   ;METROPOLITANA;969970;3;1;3;1;969970;0;0;0;Celular Galaxy S21 Ultra Phantom Black 128GB;TELEFONIA
10192843;;M;57;CHILENO;;Boomers;CHIMBARONGO                   ;L.G.B.OÂ´HIGGINS;174980;2;1;0;0;0;2;1;174980;CELULAR XIAOMI REDMI 9T TWILIGHT BLUE MOVISTAR;TELEFONIA
26100066;;M;26;ECUATORIANO;;Extranjero;CALDERA                       ;ATACAMA;538640;2;1;2;1;538640;0;0;0;IPHONE 11 64GB BLACK CLARO;TELEFONIA
17694161;Soltero;M;31;CHILENO;INGENIERO NAVAL;Millenial;PROVIDENCIA                   ;METROPOLITANA;778540;2;1;2;1;778540;0;0;0;IPHONE 12 128GB BLACK CLARO;TELEFONIA
15511655;Soltero;F;39;CHILENO;INGENIERO COMERCIAL;X;PROVIDENCIA                   ;METROPOLITANA;667960;4;2;4;2;667960;0;0;0;CELULAR SMARTPHONE A52S 5G BLACK 128GB;TELEFONIA
19297543;;M;26;CHILENO;;Silencioso;PROVIDENCIA                   ;METROPOLITANA;819990;2;1;2;1;819990;0;0;0;IPHONE 12 128GB BLACK CLARO;TELEFONIA
20369074;;F;26;CHILENO;;Z;PROVIDENCIA;METROPOLITANA;189990;1;1;0;0;0;1;1;189990;CELULAR A22 128GB NEGRO;TELEFONIA
12964440;;F;46;CHILENO;;X;RENCA                         ;METROPOLITANA;905480;2;1;2;1;905480;0;0;0;CELULAR IPHONE 12 PRO 128GB GRAFITO CLARO;TELEFONIA
16157049;;M;36;CHILENO;;Millenial;LOTA;BIO-BIO;69990;2;1;0;0;0;2;1;69990;CELULAR MOTO E7i 32GB AZUL OPEN;TELEFONIA
17228102;Casado;F;33;CHILENO;;Millenial;PROVIDENCIA                   ;METROPOLITANA;133980;2;1;2;1;133980;0;0;0;CELULAR XIAOMI REDMI 9T TWILIGHT BLUE MOVISTAR;TELEFONIA
11113526;;F;55;CHILENO;;Boomers;PROVIDENCIA                   ;METROPOLITANA;154980;2;2;0;0;0;2;2;154980;CELULAR CLARO MOTOROLA E7 32GB GRIS;TELEFONIA
6042407;;M;75;CHILENO;;Silencioso;VICTORIA                      ;ARAUCANIA;-29990;-1;1;0;0;0;-1;1;-29990;CELULAR OWN 1026 AZUL ENTEL;TELEFONIA
18838395;;M;27;CHILENO;;Millenial;PROVIDENCIA                   ;METROPOLITANA;499990;2;1;2;1;499990;0;0;0;IPHONE 11 64GB BLACK CLARO;TELEFONIA
14237325;;F;49;CHILENO;;X;PROVIDENCIA                   ;METROPOLITANA;33460;4;2;0;0;0;4;2;33460;Celular SA3 CLARO DIRECTO BLACK;TELEFONIA
11724718;;M;51;CHILENO;;X;LO ESPEJO                     ;METROPOLITANA;169990;1;1;1;1;169990;0;0;0;CELULAR MOTOROLA G9 PLUS 128GB AZUL CLARO;TELEFONIA
23142507;;M;59;PERUANO;;Extranjero;SANTIAGO                      ;METROPOLITANA;1064980;2;1;0;0;0;2;1;1064980;Celular Galaxy S21 Ultra Phantom Black 128GB;TELEFONIA
17007240;;F;33;CHILENO;;Millenial;MAIPU;METROPOLITANA;827970;3;1;3;1;827970;0;0;0;Celular Galaxy S21 Plus Phantom Black 128GB;TELEFONIA
16195950;;M;36;CHILENO;;Millenial;GORBEA                        ;ARAUCANIA;79990;1;1;0;0;0;1;1;79990;CELULAR XIAOMI REDMI 9A 32GB BLACK DIRECTO CLARO;TELEFONIA
19883264;;M;24;CHILENO;;Z;PROVIDENCIA                   ;METROPOLITANA;303980;2;1;2;1;303980;0;0;0;CELULAR IPHONE SE 64GB DIRECTO CLARO;TELEFONIA
14163362;;M;40;CHILENO;;X;LONGAVI                       ;MAULE;359990;1;1;0;0;0;1;1;359990;CELULAR SMARTPHONE A52S 5G LIGHT GREEN 128GB;TELEFONIA
20182961;;F;23;CHILENO;;Z;PROVIDENCIA                   ;METROPOLITANA;251960;3;1;3;1;251960;0;0;0;CELULAR MI 11 LITE US 128GB PEACH PINK OPEN;TELEFONIA
24302414;;F;39;COLOMBIANO;;Extranjero;N/D;N/D;693960;4;2;2;1;464980;2;1;228980;SMARTPHONE A22 VERDE 128GB;TELEFONIA
10913688;;F;51;CHILENO;;X;RENCA                         ;METROPOLITANA;110980;2;1;0;0;0;2;1;110980;CELULAR VIVO Y11S NEBULA BLUE 32GB OPEN;TELEFONIA
17153361;;F;33;CHILENO;;Millenial;N/D;N/D;370980;2;1;0;0;0;2;1;370980;CELULAR SMARTPHONE A52S 5G BLACK 128GB;TELEFONIA
13708338;;F;43;CHILENO;;X;N/D;N/D;119990;1;1;0;0;0;1;1;119990;CELULAR MOTOROLA G9 PLAY 64GB SPRING PINK OPEN;TELEFONIA
26482216;;F;26;VENEZOLANO;;Extranjero;N/D;N/D;473980;2;1;2;1;473980;0;0;0;IPHONE 11 64GB BLACK CLARO;TELEFONIA
6954968;;F;70;CHILENO;;Silencioso;ARICA                         ;ARICA Y PARINACOTA;129480;2;1;0;0;0;2;1;129480;CELULAR REDMI 9C 64GB SUNRISE ORANGE;TELEFONIA
8785238;;F;54;CHILENO;;X;RENCA                         ;METROPOLITANA;229990;2;1;0;0;0;2;1;229990;CELULAR VIVO V20 SUNSET MELODY OPEN;TELEFONIA
10085379;;F;59;CHILENO;;Boomers;N/D;N/D;144980;2;1;2;1;144980;0;0;0;SMARTPHONE A03S 64 GB NEGRO;TELEFONIA
12174681;;F;52;CHILENO;;X;RENCA                         ;METROPOLITANA;243980;2;1;2;1;243980;0;0;0;IPHONE 8 64 GB LIB OPEN GRAY;TELEFONIA
8935026;;M;61;CHILENO;;Boomers;LEBU                          ;BIO BIO;597080;2;1;0;0;0;2;1;597080;CELULAR A72 128 GB BLACK OPEN;TELEFONIA
13955348;;F;42;CHILENO;;X;TALCAHUANO                    ;BIO BIO;79990;1;1;1;1;79990;0;0;0;Celular NOKIA 4.2 ENTEL DIRECTO NEGRO;TELEFONIA
16294238;;F;36;CHILENO;;Millenial;PROVIDENCIA                   ;METROPOLITANA;144990;2;1;0;0;0;2;1;144990;CELULAR A32 128 GB WHITE OPEN;TELEFONIA
20621693;;F;21;CHILENO;;Millenial;"";"";229990;1;1;1;1;229990;0;0;0;CELULAR POCO X3 PRO 256 GB FROST BLUE;TELEFONIA
16717122;;F;34;CHILENO;;Millenial;PUENTE ALTO                   ;METROPOLITANA;109470;5;1;0;0;0;5;1;109470;CELULAR MOTO E7 32GB ROSA CORAL OPEN;TELEFONIA
10891730;;M;53;CHILENO;;X;LA SERENA                     ;COQUIMBO;895970;5;3;0;0;0;5;3;895970;CELULAR A72 128 GB BLACK OPEN;TELEFONIA
13904557;;M;42;CHILENO;;Silencioso;PROVIDENCIA                   ;METROPOLITANA;99990;1;1;0;0;0;1;1;99990;CELULAR VIVO Y11S PHANTOM BLACK OPEN;TELEFONIA
9484911;;F;62;CHILENO;;Silencioso;PROVIDENCIA                   ;METROPOLITANA;189980;2;1;0;0;0;2;1;189980;CELULAR A21s 128 GB AZUL;TELEFONIA
15994029;;M;37;CHILENO;;Millenial;DONIHUE                       ;L.G.B.OÂ´HIGGINS;149990;1;1;0;0;0;1;1;149990;CELULAR A21s 128 GB AZUL;TELEFONIA
15891823;;F;38;CHILENO;;Millenial;LO ESPEJO                     ;METROPOLITANA;142980;2;2;0;0;0;2;2;142980;CELULAR XIAOMI REDMI 9 64GB DIRECTO CLARO MORADO;TELEFONIA
5407428;Casado;F;75;CHILENO;;Silencioso;RENCA                         ;METROPOLITANA;354571;2;2;0;0;0;2;2;354571;CELULAR MOTOROLA G9 PLAY 64GB ELECTRIC BLUE OPEN;TELEFONIA
19410888;;M;25;CHILENO;;Z;NIQUEN                        ;BIO BIO;189990;1;1;0;0;0;1;1;189990;CELULAR MOTO G30 128GB GRIS TORNASOL OPEN;TELEFONIA
9681219;;M;61;CHILENO;;Boomers;LA PINTANA                    ;METROPOLITANA;215980;3;1;0;0;0;3;1;215980;CELULAR A32 128 GB BLUE OPEN;TELEFONIA
9357909;;F;58;CHILENO;;Boomers;ESTACION CENTRAL              ;METROPOLITANA;364980;2;1;0;0;0;2;1;364980;CELULAR REDMI NOTE 10 PRO 6+128GB GRADIENT BRONZ;TELEFONIA
18626764;;F;28;CHILENO;;Silencioso;PROVIDENCIA                   ;METROPOLITANA;139990;1;1;0;0;0;1;1;139990;CELULAR A21s 128 GB Rojo;TELEFONIA
11273224;;M;54;CHILENO;;X;SAN ANTONIO                   ;VALPARAISO;184990;2;1;0;0;0;2;1;184990;CELULAR POCO X3 PRO 128G PHANTOM BLACK OPEN;TELEFONIA
18213723;;M;29;CHILENO;;Millenial;MELIPILLA                     ;METROPOLITANA;631980;2;2;0;0;0;2;2;631980;IPHONE 11 64GB BLACK CLARO;TELEFONIA
9838249;;M;59;CHILENO;;Boomers;PROVIDENCIA                   ;METROPOLITANA;109990;1;1;0;0;0;1;1;109990;CELULAR CLARO LG K42 GRIS;TELEFONIA
5956620;Casado;M;72;CHILENO;;Silencioso;PROVIDENCIA                   ;METROPOLITANA;19990;1;1;0;0;0;1;1;19990;Celular AL3 CLARO DIRECTO NEGRO;TELEFONIA
17862949;;F;30;CHILENO;;Millenial;PROVIDENCIA                   ;METROPOLITANA;134980;2;1;2;1;134980;0;0;0;CELULAR A12 128GB Negro OPEN;TELEFONIA
13874215;;M;42;CHILENO;;X;N/D;N/D;189990;1;1;1;1;189990;0;0;0;CELULAR A32 128 GB BLACK OPEN;TELEFONIA
18224883;;M;29;CHILENO;;Millenial;LA LIGUA                      ;VALPARAISO;289970;3;2;0;0;0;3;2;289970;CELULAR REDMI 9T 128 GB OCEAN GREEN;TELEFONIA
15231202;;F;40;CHILENO;;X;N/D;N/D;34990;1;1;0;0;0;1;1;34990;CELULAR ALCATEL P1 DIRECTO CLARO BLACK;TELEFONIA
18971148;;F;27;CHILENO;;Millenial;SALAMANCA                     ;COQUIMBO;139990;1;1;0;0;0;1;1;139990;CELULAR A21s 128 GB Rojo;TELEFONIA
7262798;;M;64;CHILENO;;Boomers;GORBEA                        ;ARAUCANIA;219982;4;1;0;0;0;4;1;219982;CELULAR VIVO Y11S NEBULA BLUE 32GB OPEN;TELEFONIA
18814870;;F;27;CHILENO;;Millenial;CANETE                        ;BIO BIO;189990;2;1;0;0;0;2;1;189990;POCO X3 PRO 256 GB PHANTOM BLACK;TELEFONIA
20301897;;F;22;CHILENO;;Z;PROVIDENCIA                   ;METROPOLITANA;61990;2;1;0;0;0;2;1;61990;CELULAR VIVO Y11S PHANTON BLACK 32GB MOVISTAR;TELEFONIA
17423497;;F;32;CHILENO;;Millenial;PROVIDENCIA                   ;METROPOLITANA;245840;2;1;2;1;245840;0;0;0;POCO X3 PRO 256 GB PHANTOM BLACK;TELEFONIA
14192875;;M;42;CHILENO;;X;LA REINA                      ;METROPOLITANA;69990;1;1;0;0;0;1;1;69990;CELULAR MOTOROLA E6 PLAY AZUL TRI WOM;TELEFONIA
6466807;;F;72;CHILENO;;Silencioso;TOCOPILLA                     ;ANTOFAGASTA;129990;1;1;0;0;0;1;1;129990;CELULAR A12 128GB NEGRO OPEN;TELEFONIA
17359070;;F;32;CHILENO;;Millenial;VALDIVIA                      ;LOS LAGOS;34990;1;1;0;0;0;1;1;34990;CELULAR ALCATEL P1 DIRECTO CLARO BLACK;TELEFONIA
8509248;;M;63;CHILENO;;Boomers;CAUQUENES                     ;MAULE;69990;1;1;0;0;0;1;1;69990;CELULAR MOTOROLA E6 PLAY AZUL TRI WOM;TELEFONIA
16632162;;M;35;CHILENO;;Millenial;PENAFLOR                      ;METROPOLITANA;239990;1;1;0;0;0;1;1;239990;CELULAR POCO X3 PRO 256 GB FROST BLUE;TELEFONIA
13985870;;F;41;CHILENO;;X;QUILLOTA                      ;VALPARAISO;140980;2;1;0;0;0;2;1;140980;CELULAR REDMI 9T 128 GB OCEAN GREEN;TELEFONIA
13113637;;M;46;CHILENO;;X;VILCUN                        ;ARAUCANIA;245460;4;3;0;0;0;4;3;245460;CELULAR VIVO Y11S NEBULA BLUE 32GB OPEN;TELEFONIA
8599950;;M;58;CHILENO;;Boomers;EL BOSQUE                     ;METROPOLITANA;106870;2;1;0;0;0;2;1;106870;CELULAR MOTO E7i 32GB AZUL OPEN;TELEFONIA
13372278;;F;44;CHILENO;;X;SAN JAVIER                    ;MAULE;84990;1;1;0;0;0;1;1;84990;CELULAR MOTO E7i 32GB AZUL OPEN;TELEFONIA
17933263;;F;31;CHILENO;;Millenial;PROVIDENCIA                   ;METROPOLITANA;109990;1;1;0;0;0;1;1;109990;CELULAR REDMI NOTE 8 2021 64 GB SPACE BLACK;TELEFONIA
12373363;Casado;M;49;CHILENO;AGRONOMO;X;RENCA                         ;METROPOLITANA;449990;1;3;0;0;0;1;3;449990;CELULAR GALAXY S20FE 128GB CLOUD LAVENDER OPEN;TELEFONIA
18211781;;F;29;CHILENO;;Millenial;INDEPENDENCIA;METROPOLITANA;123980;2;1;2;1;123980;0;0;0;CELULAR A12 128GB Negro OPEN;TELEFONIA
14361380;;F;46;CHILENO;;X;VILLA ALEMANA;VALPARAISO;229990;1;1;0;0;0;1;1;229990;CELULAR MI 11 LITE 128GB BOBA BLACK OPEN;TELEFONIA
13601445;;M;43;CHILENO;;X;SAN JOSE DE MAIPO             ;METROPOLITANA;229990;1;1;0;0;0;1;1;229990;POCO X3 PRO 256 GB PHANTOM BLACK;TELEFONIA
17696854;;F;31;CHILENO;;Millenial;SAN CARLOS                    ;BIO BIO;79990;2;1;0;0;0;2;1;79990;CELULAR CLARO MOTOROLA E7 32GB GRIS;TELEFONIA
16840299;;F;34;CHILENO;;Millenial;SAN FERNANDO                  ;L.G.B.OÂ´HIGGINS;189990;1;1;0;0;0;1;1;189990;CELULAR MOTO G30 128GB LILA PASTEL OPEN;TELEFONIA
18710020;;F;28;CHILENO;;Millenial;PROVIDENCIA                   ;METROPOLITANA;238980;2;1;0;0;0;2;1;238980;CELULAR A32 128 GB WHITE OPEN;TELEFONIA
18030919;Soltero;M;30;CHILENO;;Millenial;PROVIDENCIA                   ;METROPOLITANA;219990;1;1;0;0;0;1;1;219990;CELULAR A22 128GB NEGRO;TELEFONIA
9117098;Casado;M;58;CHILENO;;Boomers;RENCA                         ;METROPOLITANA;84990;2;1;0;0;0;2;1;84990;Celular G8 POWER LITE WOM DIRECTO TURQUESA;TELEFONIA
15603813;;M;40;CHILENO;;Silencioso;PROVIDENCIA                   ;METROPOLITANA;78770;2;1;0;0;0;2;1;78770;CELULAR ZTE A3 2020 GRIS DIRECTO CLARO;TELEFONIA
10277820;;M;56;CHILENO;;Boomers;ANTOFAGASTA                   ;ANTOFAGASTA;245980;2;1;0;0;0;2;1;245980;CELULAR A32 128 GB LIGHT VIOLET OPEN;TELEFONIA
20346205;;M;22;CHILENO;;Z;PROVIDENCIA                   ;METROPOLITANA;139990;1;1;0;0;0;1;1;139990;CELULAR MOTO ONE FUSION 128GB AZUL OPEN;TELEFONIA
16857001;;F;33;CHILENO;;Millenial;CONSTITUCION                  ;MAULE;184980;2;1;0;0;0;2;1;184980;CELULAR A21s 128 GB AZUL;TELEFONIA
13703873;;F;43;CHILENO;;X;"";"";399990;1;1;0;0;0;1;1;399990;CELULAR GALAXY S20FE 128GB CLOUD LAVENDER OPEN;TELEFONIA
13908210;;F;42;CHILENO;;Silencioso;PROVIDENCIA                   ;METROPOLITANA;149990;1;1;0;0;0;1;1;149990;CELULAR A21s 128 GB AZUL;TELEFONIA
5855630;;M;75;CHILENO;;Silencioso;ARICA                         ;ARICA Y PARINACOTA;199980;2;1;0;0;0;2;1;199980;CELULAR A21s 128 GB Negro;TELEFONIA
13361719;;M;44;CHILENO;;X;N/D;N/D;-34990;-1;3;0;0;0;-1;3;-34990;CELULAR A21s 128 GB Negro;TELEFONIA
18150807;;F;30;CHILENO;;Millenial;PROVIDENCIA                   ;METROPOLITANA;229990;1;1;0;0;0;1;1;229990;POCO X3 PRO 256 GB PHANTOM BLACK;TELEFONIA
5213039;;F;75;CHILENO;;Silencioso;CHILLAN                       ;BIO BIO;34990;1;1;0;0;0;1;1;34990;CELULAR ALCATEL P1 DIRECTO CLARO BLACK;TELEFONIA
10756077;;M;54;CHILENO;;X;ILLAPEL                       ;COQUIMBO;359980;2;1;0;0;0;2;1;359980;CELULAR REDMI NOTE 10 PRO 6+128GB ONYX GRAY;TELEFONIA
7493202;Casado;M;67;CHILENO;;Boomers;VILLARICA                     ;ARAUCANIA;74990;1;1;0;0;0;1;1;74990;CELULAR MOTOROLA E6S GRIS 32GB DIRECTO WOM;TELEFONIA
16587361;;M;30;CHILENO;;Millenial;LAS CABRAS                    ;L.G.B.OÂ´HIGGINS;139990;1;1;1;1;139990;0;0;0;CELULAR Galaxy A21s (128GB) Black WOM;TELEFONIA
8589367;;M;64;CHILENO;;Boomers;RENCA                         ;METROPOLITANA;547870;3;1;0;0;0;3;1;547870;CELULAR GALAXY S20FE 128GB ClOUD NAVY OPEN;TELEFONIA
18937935;;F;27;CHILENO;;Millenial;LAS CONDES                    ;METROPOLITANA;433980;2;1;2;1;433980;0;0;0;CELULAR MI 10T PRO 256GB AURORA BLUE OPEN;TELEFONIA
14623960;;F;42;CHILENO;;X;CURICO                        ;MAULE;343970;3;1;0;0;0;3;1;343970;POCO X3 PRO 256 GB PHANTOM BLACK;TELEFONIA
17842537;;M;31;CHILENO;;Millenial;N/D;N/D;189990;1;1;0;0;0;1;1;189990;CELULAR MOTO G30 128GB GRIS TORNASOL OPEN;TELEFONIA
19869966;;F;23;CHILENO;;Silencioso;PROVIDENCIA                   ;METROPOLITANA;801540;2;1;2;1;801540;0;0;0;CELULAR IPHONE 12 128GB WHITE CLARO;TELEFONIA
5841327;;M;75;CHILENO;;Silencioso;SAN CARLOS                    ;BIO BIO;64990;1;1;0;0;0;1;1;64990;Celular NOKIA 4.2 ENTEL DIRECTO NEGRO;TELEFONIA
19476703;Soltero;M;25;CHILENO;;Z;ANGOL                         ;ARAUCANIA;129990;1;1;0;0;0;1;1;129990;CELULAR A12 128GB Rojo OPEN;TELEFONIA
9854720;;M;53;CHILENO;;X;N/D;N/D;2171940;4;1;4;1;2171940;0;0;0;CELULAR IPHONE 12 PRO 128GB GRAFITO CLARO;TELEFONIA
10119824;;F;55;CHILENO;;Boomers;PROVIDENCIA                   ;METROPOLITANA;147970;5;1;0;0;0;5;1;147970;CELULAR VIVO Y11S PHANTON BLACK 32GB MOVISTAR;TELEFONIA
8472272;;F;54;CHILENO;;Boomers;HUALQUI                       ;BIO BIO;122970;4;2;0;0;0;4;2;122970;CELULAR MOTOROLA G9 PLAY 64GB SPRING PINK OPEN;TELEFONIA
9104013;;F;62;CHILENO;;Boomers;VALDIVIA                      ;LOS LAGOS;-565310;-4;2;0;0;0;-4;2;-565310;CELULAR MOTOROLA E7 IPOWER 32GB BLUE CLARO;TELEFONIA
26317647;;M;25;HAITIANO;;Extranjero;TALCA                         ;MAULE;382950;3;2;0;0;0;3;2;382950;CELULAR HUAWEI Y9A BLACK OPEN;TELEFONIA
12182835;;F;51;CHILENO;;X;SAN PEDRO DE LA PAZ           ;BIO BIO;129480;2;1;0;0;0;2;1;129480;CELULAR VIVO Y11S PHANTON BLACK 32GB MOVISTAR;TELEFONIA
20129599;;M;23;CHILENO;;Silencioso;PROVIDENCIA                   ;METROPOLITANA;189990;1;1;1;1;189990;0;0;0;CELULAR A32 128 GB LIGHT VIOLET OPEN;TELEFONIA
19402739;;F;26;CHILENO;;Z;CHILLAN;BIO-BIO;139990;1;1;0;0;0;1;1;139990;CELULAR POCO M3 128GB COOL BLUE;TELEFONIA
8271745;;F;52;CHILENO;;X;PROVIDENCIA                   ;METROPOLITANA;269990;1;1;0;0;0;1;1;269990;CELULAR REDMI NOTE 10 PRO 6+128GB GRADIENT BRONZ;TELEFONIA
9724826;;F;58;CHILENO;;Boomers;PARRAL                        ;MAULE;149990;1;1;0;0;0;1;1;149990;CELULAR A21s 128 GB AZUL;TELEFONIA
19588284;;M;25;CHILENO;;Z;PROVIDENCIA                   ;METROPOLITANA;234540;2;1;2;1;234540;0;0;0;CELULAR POCO X3 PRO 256 GB FROST BLUE;TELEFONIA
17743642;;F;32;CHILENO;;Millenial;PROVIDENCIA                   ;METROPOLITANA;101990;2;1;0;0;0;2;1;101990;CELULAR REDMI 9T 128 GB OCEAN GREEN;TELEFONIA
13787113;;F;41;CHILENO;;X;CONSTITUCION                  ;MAULE;49990;2;1;0;0;0;2;1;49990;CELULAR Redmi 9C 32GB Gray WOM;TELEFONIA
9433198;;M;60;CHILENO;;Boomers;OVALLE                        ;COQUIMBO;399990;1;1;0;0;0;1;1;399990;CELULAR GALAXY S20FE 128GB ClOUD NAVY OPEN;TELEFONIA
19324381;;F;26;CHILENO;;Z;N/D;N/D;0;0;0;0;0;0;0;0;0;CELULAR REDMI NOTE 10S 128GB ONIX BLACK;TELEFONIA
12878596;;M;46;CHILENO;;X;MOSTAZAL                      ;L.G.B.OÂ´HIGGINS;0;0;0;0;0;0;0;0;0;CELULAR A21s 128 GB Negro;TELEFONIA
18341207;;F;29;CHILENO;;Silencioso;PROVIDENCIA                   ;METROPOLITANA;0;0;0;0;0;0;0;0;0;CELULAR REDMI 9T 128GB SUNRISE ORANGE MOVISTAR;TELEFONIA
19934449;;M;24;CHILENO;;Z;PROVIDENCIA                   ;METROPOLITANA;0;0;0;0;0;0;0;0;0;POCO X3 PRO 256 GB PHANTOM BLACK;TELEFONIA
11524624;;F;52;CHILENO;;X;PROVIDENCIA                   ;METROPOLITANA;0;0;0;0;0;0;0;0;0;CELULAR REDMI NOTE 10 EU 64GB ONIX GRAY OPEN;TELEFONIA
17748225;Soltero;M;31;CHILENO;INGENIERO CIVIL EN MINAS;Millenial;PROVIDENCIA                   ;METROPOLITANA;0;0;0;0;0;0;0;0;0;CELULAR MI 11 LITE 128GB BOBA BLACK OPEN;TELEFONIA
20141232;;M;23;CHILENO;;Z;PROVIDENCIA                   ;METROPOLITANA;0;0;0;0;0;0;0;0;0;CELULAR A21s 128 GB Negro;TELEFONIA
13833475;;M;42;CHILENO;;X;N/D;N/D;0;0;0;0;0;0;0;0;0;CELULAR G8 POWER MOTO TRI ENTEL;TELEFONIA
12409833;;M;48;CHILENO;;X;LO PRADO                      ;METROPOLITANA;0;0;0;0;0;0;0;0;0;CELULAR MOTO G9 POWER 128GB MORADO SONICO OPEN;TELEFONIA
20353072;;F;22;CHILENO;;Z;PROVIDENCIA                   ;METROPOLITANA;0;0;0;0;0;0;0;0;0;CELULAR A21s 128 GB Negro;TELEFONIA
16449206;;M;34;CHILENO;;Millenial;COIHAIQUE                     ;AYSEN;0;0;0;0;0;0;0;0;0;CELULAR A21s 128 GB Negro;TELEFONIA
16189823;;M;37;CHILENO;;Millenial;PROVIDENCIA                   ;METROPOLITANA;0;0;0;0;0;0;0;0;0;CELULAR VIVO Y11S PHANTON BLACK 32GB MOVISTAR;TELEFONIA
8602479;Casado;M;63;CHILENO;INGENIERO AGRICOLA;Boomers;CONTULMO                      ;BIO BIO;0;0;0;0;0;0;0;0;0;Celular AL3 CLARO DIRECTO NEGRO;TELEFONIA
11442765;Casado;F;53;CHILENO;;X;PROVIDENCIA                   ;METROPOLITANA;0;0;0;0;0;0;0;0;0;CELULAR A21s 128 GB Rojo;TELEFONIA
11532580;;F;52;CHILENO;;X;CAUQUENES                     ;MAULE;0;0;0;0;0;0;0;0;0;CELULAR A21s 128 GB Rojo;TELEFONIA
5376881;;M;77;CHILENO;;Silencioso;PROVIDENCIA                   ;METROPOLITANA;0;0;0;0;0;0;0;0;0;CELULAR REDMI 9C 64GB SUNRISE ORANGE;TELEFONIA
12039774;;M;46;CHILENO;;X;PROVIDENCIA                   ;METROPOLITANA;0;0;0;0;0;0;0;0;0;CELULAR A21s 128 GB Negro;TELEFONIA
17807144;;F;31;CHILENO;;Millenial;VILLARICA                     ;ARAUCANIA;0;0;0;0;0;0;0;0;0;CELULAR REDMI 9T 128 GB OCEAN GREEN;TELEFONIA
17550207;;M;30;CHILENO;;Millenial;PROVIDENCIA                   ;METROPOLITANA;0;0;0;0;0;0;0;0;0;Celular LG K22 ENTEL DIRECTO TITAN;TELEFONIA
12764523;;F;48;CHILENO;;X;CHILLAN VIEJO                 ;BIO BIO;0;0;0;0;0;0;0;0;0;CELULAR A12 128GB ROJO OPEN;TELEFONIA
15849336;;M;38;CHILENO;;X;PANGUIPULLI                   ;LOS RIOS;0;0;0;0;0;0;0;0;0;CELULAR A21s 128 GB AZUL;TELEFONIA
12619971;;M;48;CHILENO;;X;ANTOFAGASTA                   ;ANTOFAGASTA;0;0;0;0;0;0;0;0;0;MOTO G20 AZUL CIELO 64GB MOVISTAR;TELEFONIA
17222189;;M;33;CHILENO;;Millenial;N/D;N/D;0;0;0;0;0;0;0;0;0;CELULAR REDMI 9C 64GB SUNRISE ORANGE;TELEFONIA
7057035;;M;69;CHILENO;;Silencioso;PROVIDENCIA                   ;METROPOLITANA;0;0;0;0;0;0;0;0;0;CELULAR POCO X3 PRO 128G PHANTOM BLACK OPEN;TELEFONIA
20414647;Soltero;F;29;CHILENO;;Millenial;PROVIDENCIA                   ;METROPOLITANA;0;0;0;0;0;0;0;0;0;CELULAR A02 ROJO 32GB OPEN;TELEFONIA
11692325;Casado;F;52;CHILENO;;X;RENCA                         ;METROPOLITANA;0;0;0;0;0;0;0;0;0;CELULAR GALAXY A01 32GB AZUL ENTEL;TELEFONIA
10983119;;M;55;CHILENO;;Boomers;PROVIDENCIA                   ;METROPOLITANA;0;0;0;0;0;0;0;0;0;CELULAR OWN 1026 AZUL ENTEL;TELEFONIA
14464146;;F;53;CHILENO;;X;PROVIDENCIA                   ;METROPOLITANA;0;0;0;0;0;0;0;0;0;Celular A11 LIB OPEN WHITE;TELEFONIA
20477472;;F;21;CHILENO;;Z;SAN FERNANDO                  ;L.G.B.OÂ´HIGGINS;0;0;0;0;0;0;0;0;0;CELULAR GALAXY S20FE 128GB ClOUD NAVY OPEN;TELEFONIA
14470392;;F;48;CHILENO;;X;LOS ALAMOS                    ;BIO BIO;0;0;0;0;0;0;0;0;0;Celular VIVO Y11S ENTEL DIRECTO AZUL;TELEFONIA
19409237;;M;26;CHILENO;;Z;PROVIDENCIA                   ;METROPOLITANA;0;0;0;0;0;0;0;0;0;CELULAR A32 128 GB LIGHT VIOLET OPEN;TELEFONIA
5394126;;M;76;CHILENO;;Silencioso;RECOLETA                      ;METROPOLITANA;0;0;0;0;0;0;0;0;0;CELULAR NOKIA 5.3 CHARCOAL TRI ENTEL;TELEFONIA
10955037;;F;54;CHILENO;;X;EL BOSQUE                     ;METROPOLITANA;0;0;0;0;0;0;0;0;0;CELULAR REDMI NOTE 9 128 GB MIDNIGHT GREY OPEN;TELEFONIA
6586690;;F;72;CHILENO;;Silencioso;QUILPUE                       ;VALPARAISO;0;0;0;0;0;0;0;0;0;Celular G8 POWER LITE WOM DIRECTO TURQUESA;TELEFONIA
8626542;;M;63;CHILENO;;Boomers;CAUQUENES                     ;MAULE;0;0;0;0;0;0;0;0;0;CELULAR MOTOROLA E6 PLAY AZUL TRI WOM;TELEFONIA
19563693;;F;25;CHILENO;;Z;N/D;N/D;0;0;0;0;0;0;0;0;0;CELULAR VIVO Y11s PHANTOM BLACK ENTEL DIRECTO;TELEFONIA
18575551;;F;28;CHILENO;;Millenial;PROVIDENCIA                   ;METROPOLITANA;0;0;0;0;0;0;0;0;0;CELULAR VIVO Y11S NEBULA BLUE 32GB OPEN;TELEFONIA
19703559;;F;25;CHILENO;;Z;PROVIDENCIA                   ;METROPOLITANA;0;0;0;0;0;0;0;0;0;CELULAR MOTO G9 POWER 128GB MORADO SONICO OPEN;TELEFONIA
10339718;;F;59;CHILENO;;Boomers;N/D;N/D;0;0;0;0;0;0;0;0;0;CELULAR A12 128GB NEGRO OPEN;TELEFONIA
6489341;;M;70;CHILENO;;Silencioso;RENCA                         ;METROPOLITANA;0;0;0;0;0;0;0;0;0;CELULAR NOKIA 225 4G BLACK MOVISTAR DIRECTO;TELEFONIA
19042186;;M;26;CHILENO;;Z;N/D;N/D;0;0;0;0;0;0;0;0;0;CELULAR A21s 128 GB AZUL;TELEFONIA
8954667;Casado;M;54;CHILENO;INGENIERO COMERCIAL;Boomers;PROVIDENCIA                   ;METROPOLITANA;0;0;0;0;0;0;0;0;0;CELULAR IPHONE SE 64GB DIRECTO CLARO;TELEFONIA
18976874;Soltero;F;27;CHILENO;;Millenial;PROVIDENCIA                   ;METROPOLITANA;0;0;0;0;0;0;0;0;0;Celular Y8P ENTEL TRIANGULADO PIEDRA DE LUNA;TELEFONIA
10441889;;F;57;CHILENO;;Boomers;OVALLE                        ;COQUIMBO;0;0;0;0;0;0;0;0;0;IPHONE 11 64GB BLACK CLARO;TELEFONIA
19774460;;F;24;CHILENO;;Z;"";"";0;0;0;0;0;0;0;0;0;CELULAR A32 128 GB BLUE OPEN;TELEFONIA
15583226;;F;37;CHILENO;;Millenial;N/D;N/D;0;0;0;0;0;0;0;0;0;CELULAR REDMI NOTE 9 128G FOREST GREEN OPEN;TELEFONIA
13159478;;M;46;CHILENO;;X;PANGUIPULLI                   ;LOS RIOS;0;0;0;0;0;0;0;0;0;CELULAR A02 AZUL 32GB OPEN;TELEFONIA
20149758;;F;22;CHILENO;;Millenial;N/D;N/D;0;0;0;0;0;0;0;0;0;CELULAR MOTOROLA E6 PLAY AZUL TRI WOM;TELEFONIA
13629571;;M;42;CHILENO;;X;CURANILAHUE                   ;BIO BIO;0;0;0;0;0;0;0;0;0;CELULAR A32 128 GB BLUE OPEN;TELEFONIA
19236855;;M;25;CHILENO;;Z;LA FLORIDA;METROPOLITANA;0;0;0;0;0;0;0;0;0;POCO X3 PRO 256 GB PHANTOM BLACK;TELEFONIA
12213738;;F;50;CHILENO;;X;N/D;N/D;0;0;0;0;0;0;0;0;0;CELULAR A12 128GB ROJO OPEN;TELEFONIA
15013485;;M;41;CHILENO;;X;CALAMA                        ;ANTOFAGASTA;0;0;0;0;0;0;0;0;0;CELULAR GALAXY S20FE 128GB CLOUD LAVENDER OPEN;TELEFONIA
5032917;;M;77;CHILENO;;Silencioso;RENCA                         ;METROPOLITANA;0;0;0;0;0;0;0;0;0;CELULAR A02s NEGRO 32GB OPEN;TELEFONIA
11134064;;F;55;CHILENO;;Boomers;RENCA                         ;METROPOLITANA;0;0;0;0;0;0;0;0;0;Celular AL3 CLARO DIRECTO NEGRO;TELEFONIA
26083206;Soltero;M;40;VENEZOLANO;;Extranjero;N/D;N/D;0;0;0;0;0;0;0;0;0;CELULAR NOTE 20 ULTRA MYSTIC BLACK 256GB OPEN;TELEFONIA
9300207;;F;62;CHILENO;;Boomers;RENCA                         ;METROPOLITANA;0;0;0;0;0;0;0;0;0;CELULAR REDMI NOTE 9 128 GB MIDNIGHT GREY OPEN;TELEFONIA
8912535;;M;61;CHILENO;;Boomers;SAN FERNANDO                  ;L.G.B.OÂ´HIGGINS;0;0;0;0;0;0;0;0;0;CELULAR ZTE A3 2020 GRIS DIRECTO CLARO;TELEFONIA
16271375;;M;36;CHILENO;;Millenial;RENCA                         ;METROPOLITANA;0;0;0;0;0;0;0;0;0;CELULAR MOTOROLA E6 PLAY AZUL TRI WOM;TELEFONIA
9642760;;M;59;CHILENO;;Boomers;RENCA                         ;METROPOLITANA;0;0;0;0;0;0;0;0;0;CELULAR XIAOMI REDMI 9A 32GB BLACK DIRECTO CLARO;TELEFONIA
15436600;;F;40;CHILENO;;X;N/D;N/D;0;0;0;0;0;0;0;0;0;CELULAR REDMI NOTE 10S 128GB OCEAN BLUE;TELEFONIA
19354503;;F;26;CHILENO;;Z;N/D;N/D;0;0;0;0;0;0;0;0;0;CELULAR A21s 128 GB Negro;TELEFONIA
17286027;;M;35;CHILENO;;Millenial;PROVIDENCIA                   ;METROPOLITANA;0;0;0;0;0;0;0;0;0;CELULAR REDMI NOTE 10S 128GB ONIX BLACK;TELEFONIA
15218076;;M;39;CHILENO;;Silencioso;PROVIDENCIA                   ;METROPOLITANA;0;0;0;0;0;0;0;0;0;CELULAR HUAWEI Y5 NEO NEGRO WOM;TELEFONIA
9286338;Soltero;F;61;CHILENO;;Boomers;RENCA                         ;METROPOLITANA;0;0;0;0;0;0;0;0;0;CELULAR REDMI 9T 128 GB OCEAN GREEN;TELEFONIA
15504344;;F;39;CHILENO;;X;PUENTE ALTO                   ;METROPOLITANA;0;0;0;0;0;0;0;0;0;CELULAR A12 128GB NEGRO TRIANGULADO CLARO;TELEFONIA
26212008;;M;36;HAITIANO;;Extranjero;"";"";0;0;0;0;0;0;0;0;0;CELULAR A12 128GB NEGRO TRIANGULADO CLARO;TELEFONIA
13544138;;F;43;CHILENO;;X;N/D;N/D;0;0;0;0;0;0;0;0;0;POCO X3 PRO 256 GB PHANTOM BLACK;TELEFONIA
26466412;;M;31;VENEZOLANO;;Extranjero;SAN RAMON                     ;METROPOLITANA;0;0;0;0;0;0;0;0;0;CELULAR MI 11 LITE 128GB BUBBLEGUM BLUE;TELEFONIA
11769602;;M;50;CHILENO;;X;N/D;N/D;0;0;0;0;0;0;0;0;0;CELULAR A21s 128 GB Negro;TELEFONIA
6518313;;M;71;CHILENO;;Silencioso;OSORNO                        ;LOS LAGOS;0;0;0;0;0;0;0;0;0;CELULAR MOTOROLA E6 PLAY AZUL TRI WOM;TELEFONIA
14194245;Soltero;F;41;CHILENO;;X;PROVIDENCIA                   ;METROPOLITANA;0;0;0;0;0;0;0;0;0;CELULAR REDMI NOTE 10S 128GB ONIX BLACK;TELEFONIA
14358160;;M;42;CHILENO;;X;SAN FELIPE                    ;VALPARAISO;0;0;0;0;0;0;0;0;0;Celular ZTE A3 2020 ENTEL DIRECTO GRIS;TELEFONIA
19194714;;M;27;CHILENO;;Z;TEMUCO                        ;ARAUCANIA;0;0;0;0;0;0;0;0;0;CELULAR MOTO E7i 32GB AZUL OPEN;TELEFONIA
13674137;;M;43;CHILENO;;X;HUECHURABA                    ;METROPOLITANA;0;0;0;0;0;0;0;0;0;CELULAR A21s 128 GB Negro;TELEFONIA
22792001;;M;40;PERUANO;;Extranjero;N/D;N/D;0;0;0;0;0;0;0;0;0;CELULAR GALAXY S20FE 128GB CLOUD LAVENDER OPEN;TELEFONIA
24636616;;F;53;BOLIVIANO;;Extranjero;SANTIAGO                      ;METROPOLITANA;0;0;0;0;0;0;0;0;0;POCO X3 PRO 256 GB METAL BRONCE;TELEFONIA
12600322;Soltero;M;47;CHILENO;;X;PROVIDENCIA                   ;METROPOLITANA;0;0;0;0;0;0;0;0;0;CELULAR A32 128 GB WHITE OPEN;TELEFONIA
10551802;;M;55;CHILENO;;Boomers;CURICO                        ;MAULE;0;0;0;0;0;0;0;0;0;CELULAR A12 128GB AZUL OPEN;TELEFONIA
7451256;;M;70;CHILENO;;Silencioso;PROVIDENCIA                   ;METROPOLITANA;0;0;0;0;0;0;0;0;0;CELULAR CLARO MOTOROLA E7 32GB GRIS;TELEFONIA
10725948;;M;55;CHILENO;;Silencioso;PROVIDENCIA                   ;METROPOLITANA;0;0;0;0;0;0;0;0;0;CELULAR SAMSUNG NOTE 20 MYSTIC GRAY OPEN;TELEFONIA
10999926;;F;50;CHILENO;;X;CONCEPCION                    ;BIO BIO;0;0;0;0;0;0;0;0;0;CELULAR A32 128 GB WHITE OPEN;TELEFONIA
16780133;Soltero;F;35;CHILENO;;Silencioso;PROVIDENCIA                   ;METROPOLITANA;0;0;0;0;0;0;0;0;0;CELULAR GALAXY S20FE 128GB CLOUD LAVENDER OPEN;TELEFONIA
19235894;;F;26;CHILENO;;Z;N/D;N/D;0;0;0;0;0;0;0;0;0;CELULAR POCO X3 PRO 128G PHANTOM BLACK OPEN;TELEFONIA
14350105;;M;43;CHILENO;;X;N/D;N/D;0;0;0;0;0;0;0;0;0;CELULAR A12 128GB AZUL OPEN;TELEFONIA
11304856;;M;54;CHILENO;;X;LONCOCHE                      ;ARAUCANIA;0;0;0;0;0;0;0;0;0;CELULAR A32 128 GB BLUE OPEN;TELEFONIA
24346128;;F;31;BOLIVIANO;;Extranjero;CERRO NAVIA                   ;METROPOLITANA;0;0;0;0;0;0;0;0;0;CELULAR A12 128GB AZUL OPEN;TELEFONIA
14023073;;F;41;CHILENO;;X;RETIRO                        ;MAULE;0;0;0;0;0;0;0;0;0;CELULAR A12 128GB AZUL OPEN;TELEFONIA
7416417;;F;63;CHILENO;;Boomers;EL BOSQUE                     ;METROPOLITANA;0;0;0;0;0;0;0;0;0;CELULAR REDMI NOTE 9 128 GB MIDNIGHT GREY OPEN;TELEFONIA
9835229;;M;56;CHILENO;;Boomers;HUALQUI                       ;BIO BIO;0;0;0;0;0;0;0;0;0;CELULAR A72 128 GB BLACK OPEN;TELEFONIA
10475433;;F;56;CHILENO;;Boomers;PROVIDENCIA                   ;METROPOLITANA;0;0;0;0;0;0;0;0;0;CELULAR MOTOROLA E6 PLAY AZUL TRI WOM;TELEFONIA
9075169;;F;68;CHILENO;;Silencioso;VILLARICA                     ;ARAUCANIA;0;0;0;0;0;0;0;0;0;CELULAR VIVO Y11S PHANTON BLACK 32GB MOVISTAR;TELEFONIA
16605324;;M;35;CHILENO;;Millenial;CABRERO                       ;BIO BIO;0;0;0;0;0;0;0;0;0;Celular A10S LIB OPEN RED;TELEFONIA
12958554;Casado;F;45;CHILENO;;X;RENCA                         ;METROPOLITANA;0;0;0;0;0;0;0;0;0;CELULAR REDMI 9C 32GB TWILIGHT BLUE MOVISTAR;TELEFONIA
19833738;;F;24;CHILENO;;Silencioso;PROVIDENCIA                   ;METROPOLITANA;0;0;0;0;0;0;0;0;0;CELULAR A21s 128 GB Negro;TELEFONIA
18175541;;F;30;CHILENO;;Millenial;SAN CLEMENTE                  ;MAULE;0;0;0;0;0;0;0;0;0;CELULAR A32 128 GB LIGHT VIOLET OPEN;TELEFONIA
18850443;;M;27;CHILENO;;Silencioso;PROVIDENCIA                   ;METROPOLITANA;0;0;0;0;0;0;0;0;0;Celular Galaxy S21 Plus Phantom Silver 128GB;TELEFONIA
20188519;;M;23;CHILENO;;Silencioso;PROVIDENCIA                   ;METROPOLITANA;0;0;0;0;0;0;0;0;0;CELULAR REDMI NOTE 9 PRO 128GB GLACIER WHITE;TELEFONIA
16291781;;M;36;CHILENO;;Millenial;MARIA PINTO                   ;METROPOLITANA;0;0;0;0;0;0;0;0;0;CELULAR A32 128 GB BLACK OPEN;TELEFONIA
10854186;;F;54;CHILENO;;Boomers;VILLA ALEMANA                 ;VALPARAISO;0;0;0;0;0;0;0;0;0;CELULAR A21s 128 GB Rojo;TELEFONIA
17814507;;F;31;CHILENO;;Millenial;"";"";0;0;0;0;0;0;0;0;0;CELULAR MOTO ONE FUSION 64GB VERDE 64GB OPEN;TELEFONIA
12815193;;M;46;CHILENO;;X;OVALLE                        ;COQUIMBO;0;0;0;0;0;0;0;0;0;CELULAR A21s 128 GB Rojo;TELEFONIA
15519670;;F;34;CHILENO;;Silencioso;PROVIDENCIA                   ;METROPOLITANA;0;0;0;0;0;0;0;0;0;CELULAR MOTO E6I 32GB GRIS OPEN;TELEFONIA
10419970;Soltero;M;55;CHILENO;;Boomers;PROVIDENCIA                   ;METROPOLITANA;0;0;0;0;0;0;0;0;0;CELULAR OWN 1026 AZUL ENTEL;TELEFONIA
20094693;;F;23;CHILENO;;Z;PROVIDENCIA                   ;METROPOLITANA;0;0;0;0;0;0;0;0;0;CELULAR POCO X3 PRO 128 GB FROST BLUE;TELEFONIA
26285776;;F;36;VENEZOLANO;;Extranjero;ESTACION CENTRAL              ;METROPOLITANA;0;0;0;0;0;0;0;0;0;CELULAR MOTO E6I 32GB GRIS OPEN;TELEFONIA
18316961;Soltero;M;29;CHILENO;;Millenial;PROVIDENCIA                   ;METROPOLITANA;0;0;0;0;0;0;0;0;0;CELULAR A21s 128 GB Negro;TELEFONIA
15146540;;F;40;CHILENO;;X;RETIRO                        ;MAULE;0;0;0;0;0;0;0;0;0;CELULAR MOTO G9 POWER 128GB VERDE GRANITO OPEN;TELEFONIA
6160933;;F;70;CHILENO;;Silencioso;ARAUCO                        ;BIO BIO;0;0;0;0;0;0;0;0;0;CELULAR A02 NEGRO 32GB OPEN;TELEFONIA
15864610;;M;37;CHILENO;;Millenial;PANGUIPULLI                   ;LOS RIOS;0;0;0;0;0;0;0;0;0;Celular A71 LIB OPEN PLATEADO;TELEFONIA
18685806;;F;27;CHILENO;;Millenial;PROVIDENCIA                   ;METROPOLITANA;0;0;0;0;0;0;0;0;0;CELULAR REDMI 9 64GB SUNSET PURPLE TRI WOM;TELEFONIA
18141791;Soltero;F;29;CHILENO;;Millenial;PROVIDENCIA                   ;METROPOLITANA;0;0;0;0;0;0;0;0;0;Celular A31 LIB OPEN BLACK;TELEFONIA
17658606;;F;31;CHILENO;;Millenial;PROVIDENCIA                   ;METROPOLITANA;0;0;0;0;0;0;0;0;0;CELULAR REDMI NOTE 10 128GB PEBBLE WHITE;TELEFONIA
11649965;;F;52;CHILENO;;X;QUILICURA                     ;METROPOLITANA;0;0;0;0;0;0;0;0;0;CELULAR A32 128 GB LIGHT VIOLET OPEN;TELEFONIA
18644267;Soltero;F;28;CHILENO;;Millenial;PROVIDENCIA                   ;METROPOLITANA;0;0;0;0;0;0;0;0;0;CELULAR A32 128 GB BLUE OPEN;TELEFONIA
16376790;;F;35;CHILENO;;Millenial;PUTAENDO                      ;VALPARAISO;0;0;0;0;0;0;0;0;0;Celular A01 CLARO DIRECTO BLACK;TELEFONIA
16306073;;M;36;CHILENO;;Millenial;SAN ESTEBAN                   ;VALPARAISO;0;0;0;0;0;0;0;0;0;CELULAR VIVO Y11S PHANTON BLACK 32GB MOVISTAR;TELEFONIA
5156793;;M;76;CHILENO;;Silencioso;RENCA                         ;METROPOLITANA;0;0;0;0;0;0;0;0;0;CELULAR Xiaomi Redmi 9 64 GB Morado WOM;TELEFONIA
10100555;;M;56;CHILENO;;Boomers;RENCA                         ;METROPOLITANA;0;0;0;0;0;0;0;0;0;CELULAR GALAXY S20FE 128GB ClOUD NAVY OPEN;TELEFONIA
8159415;;M;65;CHILENO;;Boomers;DALCAHUE                      ;LOS LAGOS;0;0;0;0;0;0;0;0;0;CELULAR GALAXY A01 32GB AZUL ENTEL;TELEFONIA
17186014;;F;33;CHILENO;;Millenial;PROVIDENCIA                   ;METROPOLITANA;0;0;0;0;0;0;0;0;0;CELULAR POCO X3 PRO 256 GB FROST BLUE;TELEFONIA
16845033;;F;34;CHILENO;;Millenial;SAN CARLOS                    ;BIO BIO;0;0;0;0;0;0;0;0;0;CELULAR Xiaomi Redmi 9 64 GB Morado WOM;TELEFONIA
17971060;;F;31;CHILENO;;Millenial;ANGOL                         ;ARAUCANIA;0;0;0;0;0;0;0;0;0;Celular A11 LIB OPEN WHITE;TELEFONIA
18528269;;F;29;CHILENO;;Millenial;CORRAL                        ;LOS LAGOS;0;0;0;0;0;0;0;0;0;CELULAR REDMI NOTE 10 128GB ONIX GRAY OPEN;TELEFONIA
18893211;Soltero;M;27;CHILENO;;Z;PROVIDENCIA                   ;METROPOLITANA;0;0;0;0;0;0;0;0;0;Celular Y8P ENTEL TRIANGULADO NEGRO;TELEFONIA
10883502;;M;56;CHILENO;;Boomers;RANCAGUA                      ;L.G.B.OÂ´HIGGINS;0;0;0;0;0;0;0;0;0;CELULAR MOTOROLA E6 PLAY AZUL TRI WOM;TELEFONIA
20565204;;M;21;CHILENO;;Z;N/D;N/D;0;0;0;0;0;0;0;0;0;CELULAR A12 128GB NEGRO OPEN;TELEFONIA
16748592;;F;34;CHILENO;;Millenial;PROVIDENCIA                   ;METROPOLITANA;0;0;0;0;0;0;0;0;0;POCO X3 PRO 256 GB PHANTOM BLACK;TELEFONIA
18612732;Soltero;F;28;CHILENO;ENFERMERA;Silencioso;PROVIDENCIA                   ;METROPOLITANA;0;0;0;0;0;0;0;0;0;CELULAR NOKIA 225 4G BLACK TRI ENTEL;TELEFONIA
18553052;Soltero;F;28;CHILENO;;Millenial;PROVIDENCIA                   ;METROPOLITANA;0;0;0;0;0;0;0;0;0;IPHONE XS 64GB GRIS REAC;TELEFONIA
16321977;;F;36;CHILENO;;Millenial;N/D;N/D;0;0;0;0;0;0;0;0;0;CELULAR MOTO E7I POWER 32GB BLUE MOVISTAR;TELEFONIA
12398460;;M;49;CHILENO;;X;ILLAPEL                       ;COQUIMBO;0;0;0;0;0;0;0;0;0;CELULAR A21s 128 GB Rojo;TELEFONIA
13610787;;M;43;CHILENO;;X;SAN JAVIER                    ;MAULE;0;0;0;0;0;0;0;0;0;CELULAR CLARO MOTOROLA E7 32GB GRIS;TELEFONIA
8886978;;F;64;CHILENO;;Silencioso;PROVIDENCIA                   ;METROPOLITANA;0;0;0;0;0;0;0;0;0;CELULAR MOTOROLA E7 IPOWER 32GB BLUE CLARO;TELEFONIA
14016398;;F;41;CHILENO;;Millenial;N/D;N/D;0;0;0;0;0;0;0;0;0;CELULAR MOTO E6I 32GB GRIS OPEN;TELEFONIA
27150657;;M;32;EXTRANJERO - NO INFORMA NACIONALIDAD;;Extranjero;N/D;N/D;0;0;0;0;0;0;0;0;0;POCO X3 PRO 256 GB PHANTOM BLACK;TELEFONIA
8115157;;M;61;CHILENO;;Boomers;COQUIMBO                      ;COQUIMBO;0;0;0;0;0;0;0;0;0;POCO X3 PRO 256 GB PHANTOM BLACK;TELEFONIA
19401663;;F;26;CHILENO;;Silencioso;PROVIDENCIA                   ;METROPOLITANA;0;0;0;0;0;0;0;0;0;Celular A31 LIB OPEN AZUL;TELEFONIA
14388123;;F;44;CHILENO;;Silencioso;PROVIDENCIA                   ;METROPOLITANA;0;0;0;0;0;0;0;0;0;CELULAR A21s 128 GB Rojo;TELEFONIA
14494490;;F;47;CHILENO;;X;RENCA                         ;METROPOLITANA;0;0;0;0;0;0;0;0;0;Celular A01 LIB OPEN ROJO;TELEFONIA
11773692;;F;51;CHILENO;;X;ANTOFAGASTA                   ;ANTOFAGASTA;0;0;0;0;0;0;0;0;0;CELULAR REDMI NOTE 10 EU 64GB ONIX GRAY OPEN;TELEFONIA
18292120;Soltero;M;29;CHILENO;;Silencioso;PROVIDENCIA                   ;METROPOLITANA;0;0;0;0;0;0;0;0;0;CELULAR A32 128 GB BLACK OPEN;TELEFONIA
16599885;;F;35;CHILENO;;Millenial;PROVIDENCIA                   ;METROPOLITANA;0;0;0;0;0;0;0;0;0;Celular A10S LIB OPEN BLUE;TELEFONIA
18550788;;M;29;CHILENO;;Millenial;PUNTA ARENAS                  ;MAGALLANES;0;0;0;0;0;0;0;0;0;CELULAR POCO M3 64GB POWER BLACK;TELEFONIA
12306323;;F;53;CHILENO;;X;VICTORIA                      ;ARAUCANIA;0;0;0;0;0;0;0;0;0;CELULAR VIVO Y11S PHANTON BLACK 32GB MOVISTAR;TELEFONIA
13958010;Casado;M;42;CHILENO;INGENIERO INFORMATICO;X;PROVIDENCIA                   ;METROPOLITANA;0;0;0;0;0;0;0;0;0;CELULAR MI 11 LITE 128GB BUBBLEGUM BLUE;TELEFONIA
17999763;Soltero;F;31;CHILENO;;Silencioso;PROVIDENCIA                   ;METROPOLITANA;0;0;0;0;0;0;0;0;0;CELULAR Xiaomi Redmi 9 64 GB Morado WOM;TELEFONIA
16147595;;M;36;CHILENO;;Silencioso;PROVIDENCIA                   ;METROPOLITANA;0;0;0;0;0;0;0;0;0;CELULAR A02 ROJO 32GB OPEN;TELEFONIA
19299844;;F;25;CHILENO;;Z;N/D;N/D;0;0;0;0;0;0;0;0;0;CELULAR A21s 128 GB AZUL;TELEFONIA
18151577;Soltero;M;30;CHILENO;;Millenial;PROVIDENCIA                   ;METROPOLITANA;0;0;0;0;0;0;0;0;0;CELULAR A12 128GB AZUL OPEN;TELEFONIA
8980672;;F;58;CHILENO;;Boomers;N/D;N/D;0;0;0;0;0;0;0;0;0;CELULAR A32 128 GB LIGHT VIOLET OPEN;TELEFONIA
19882142;;M;24;CHILENO;;Silencioso;PROVIDENCIA                   ;METROPOLITANA;0;0;0;0;0;0;0;0;0;CELULAR A21s 128 GB AZUL;TELEFONIA
19584539;;F;25;CHILENO;;Z;CERRO NAVIA                   ;METROPOLITANA;0;0;0;0;0;0;0;0;0;CELULAR A32 128 GB BLUE OPEN;TELEFONIA
16750182;Soltero;F;34;CHILENO;AGRONOMO;Millenial;PROVIDENCIA                   ;METROPOLITANA;0;0;0;0;0;0;0;0;0;CELULAR MI 10T PRO 256GB AURORA BLUE OPEN;TELEFONIA
15119931;;F;39;CHILENO;;X;CHEPICA                       ;L.G.B.OÂ´HIGGINS;0;0;0;0;0;0;0;0;0;CELULAR Xiaomi Redmi 9 64 GB Morado WOM;TELEFONIA
20041544;;F;23;CHILENO;;Z;SAN BERNARDO                  ;METROPOLITANA;0;0;0;0;0;0;0;0;0;CELULAR VIVO Y11S PHANTOM BLACK OPEN;TELEFONIA
19800692;;F;24;CHILENO;;Silencioso;PROVIDENCIA                   ;METROPOLITANA;0;0;0;0;0;0;0;0;0;CELULAR POCO X3 PRO 128 GB FROST BLUE;TELEFONIA
6673256;;F;69;CHILENO;;Silencioso;N/D;N/D;0;0;0;0;0;0;0;0;0;CELULAR ZTE A3 2020 GRIS DIRECTO CLARO;TELEFONIA
9865178;;M;58;CHILENO;;Boomers;SAN BERNARDO                  ;METROPOLITANA;0;0;0;0;0;0;0;0;0;CELULAR HUAWEI Y8S CLARO DIRECTO BLACK;TELEFONIA
17374053;;F;32;CHILENO;;Millenial;N/D;N/D;0;0;0;0;0;0;0;0;0;CELULAR VIVO Y11S PHANTOM BLACK OPEN;TELEFONIA
14108498;;F;41;CHILENO;;Silencioso;PROVIDENCIA                   ;METROPOLITANA;0;0;0;0;0;0;0;0;0;CELULAR SAMSUNG NOTE 20 MYSTIC GRAY OPEN;TELEFONIA
18097371;;F;30;CHILENO;;Millenial;PUYEHUE                       ;LOS LAGOS;0;0;0;0;0;0;0;0;0;CELULAR XIAOMI REDMI 9C 64GB TIWLIGHT BLUE TRI W;TELEFONIA
18996780;;F;27;CHILENO;;Z;VINA DEL MAR                  ;VALPARAISO;0;0;0;0;0;0;0;0;0;CELULAR XIAOMI REDMI 9A 32 GB BLUE DIRECTO CLARO;TELEFONIA
13091361;;F;46;CHILENO;;X;EL BOSQUE                     ;METROPOLITANA;0;0;0;0;0;0;0;0;0;CELULAR ZTE A5 2020 DIRECTO CLARO VERDE;TELEFONIA
18084676;;M;30;CHILENO;;Millenial;PADRE HURTADO                 ;METROPOLITANA;0;0;0;0;0;0;0;0;0;Celular A01 Core Azul Tri Entel;TELEFONIA
14165405;;M;40;CHILENO;;X;PROVIDENCIA                   ;METROPOLITANA;0;0;0;0;0;0;0;0;0;CELULAR POCO X3 PRO 128G PHANTOM BLACK OPEN;TELEFONIA
15124343;;M;39;CHILENO;;X;CHILLAN                       ;BIO BIO;0;0;0;0;0;0;0;0;0;CELULAR A02 ROJO 32GB OPEN;TELEFONIA
20324673;;F;22;CHILENO;;Silencioso;PROVIDENCIA                   ;METROPOLITANA;0;0;0;0;0;0;0;0;0;CELULAR MOTO ONE FUSION 64GB VERDE 64GB OPEN;TELEFONIA
13608117;;F;43;CHILENO;;X;RENCA                         ;METROPOLITANA;0;0;0;0;0;0;0;0;0;CELULAR MOTOROLA G9 PLAY 64GB ELECTRIC BLUE OPEN;TELEFONIA
19718565;;F;24;CHILENO;;Z;PROVIDENCIA                   ;METROPOLITANA;0;0;0;0;0;0;0;0;0;CELULAR REDMI NOTE 10 128GB PEBBLE WHITE;TELEFONIA
19019884;Soltero;F;27;CHILENO;;Z;PROVIDENCIA                   ;METROPOLITANA;0;0;0;0;0;0;0;0;0;CELULAR VIVO Y20 NEGRO DIRECTO ENTEL;TELEFONIA
14072581;;F;40;CHILENO;;X;LOS ALAMOS                    ;BIO BIO;0;0;0;0;0;0;0;0;0;CELULAR A12 128GB ROJO OPEN;TELEFONIA
9030390;Divorciado;M;61;CHILENO;;Silencioso;PROVIDENCIA                   ;METROPOLITANA;0;0;0;0;0;0;0;0;0;CELULAR REDMI 9 64GB SUNSET PURPLE TRI WOM;TELEFONIA
15404682;;F;40;CHILENO;;X;"";"";0;0;0;0;0;0;0;0;0;CELULAR A21s 128 GB Rojo;TELEFONIA
13431774;;F;43;CHILENO;;X;CASABLANCA                    ;VALPARAISO;0;0;0;0;0;0;0;0;0;CELULAR A02s ROJO 32GB OPEN;TELEFONIA
17871621;;F;31;CHILENO;;Millenial;N/D;N/D;0;0;0;0;0;0;0;0;0;CELULAR REDMI NOTE 10 EU 128G Onyx Gray BUNDLE;TELEFONIA
16304568;;F;37;CHILENO;;Millenial;PROVIDENCIA                   ;METROPOLITANA;0;0;0;0;0;0;0;0;0;Celular AL3 CLARO DIRECTO NEGRO;TELEFONIA
11433223;Soltero;F;52;CHILENO;;X;RENCA                         ;METROPOLITANA;0;0;0;0;0;0;0;0;0;Celular G8 POWER LITE MOVISTAR DIRECTO AZUL;TELEFONIA
15703297;;M;38;CHILENO;;X;PROVIDENCIA                   ;METROPOLITANA;0;0;0;0;0;0;0;0;0;Celular A11 LIB OPEN WHITE;TELEFONIA
15818167;;F;37;CHILENO;;Millenial;LA CRUZ                       ;VALPARAISO;0;0;0;0;0;0;0;0;0;Celular LG K22 MOVISTAR DIRECTO TITAN;TELEFONIA
14167426;;F;47;CHILENO;;X;PUENTE ALTO                   ;METROPOLITANA;0;0;0;0;0;0;0;0;0;CELULAR REDMI NOTE 10 128GB PEBBLE WHITE;TELEFONIA
7760347;;M;64;CHILENO;;Boomers;LINARES                       ;MAULE;0;0;0;0;0;0;0;0;0;Celular A11 LIB OPEN WHITE;TELEFONIA
18232431;;F;30;CHILENO;;Millenial;"";"";0;0;0;0;0;0;0;0;0;CELULAR XIAOMI REDMI 9C 64GB TIWLIGHT BLUE TRI M;TELEFONIA
19213437;Soltero;M;25;CHILENO;;Z;PROVIDENCIA                   ;METROPOLITANA;0;0;0;0;0;0;0;0;0;CELULAR MOTO G9 PLAY ROSA SPRING MOVISTAR;TELEFONIA
9727009;;M;57;CHILENO;;Boomers;ARICA                         ;ARICA Y PARINACOTA;0;0;0;0;0;0;0;0;0;Celular SA3 CLARO DIRECTO BLACK;TELEFONIA
18509445;Soltero;F;28;CHILENO;;Millenial;PROVIDENCIA                   ;METROPOLITANA;0;0;0;0;0;0;0;0;0;Celular A11 LIB OPEN BLUE;TELEFONIA
13788746;;F;42;CHILENO;;X;RENCA                         ;METROPOLITANA;0;0;0;0;0;0;0;0;0;CELULAR MOTOROLA G9 PLAY 64GB BLUE DIRECTO CLAR;TELEFONIA
12210630;;F;50;CHILENO;;X;ARICA                         ;ARICA Y PARINACOTA;0;0;0;0;0;0;0;0;0;CELULAR A02 ROJO 32GB OPEN;TELEFONIA
14210373;;M;41;CHILENO;;X;PROVIDENCIA                   ;METROPOLITANA;0;0;0;0;0;0;0;0;0;Celular NOKIA 1.3 NEGRO WOM;TELEFONIA
7500980;;F;70;CHILENO;;Silencioso;N/D;N/D;0;0;0;0;0;0;0;0;0;CELULAR A72 128 GB BLACK OPEN;TELEFONIA
18344689;;M;30;CHILENO;;Millenial;PROVIDENCIA                   ;METROPOLITANA;0;0;0;0;0;0;0;0;0;CELULAR REDMI 9 64GB SUNSET PURPLE TRI WOM;TELEFONIA
16576841;;F;33;CHILENO;;Millenial;RENCA                         ;METROPOLITANA;0;0;0;0;0;0;0;0;0;CELULAR A32 128 GB LIGHT VIOLET OPEN;TELEFONIA
19905209;;F;23;CHILENO;;Silencioso;PROVIDENCIA                   ;METROPOLITANA;0;0;0;0;0;0;0;0;0;Celular NOKIA 4.2 ENTEL DIRECTO NEGRO;TELEFONIA
7532868;;M;68;CHILENO;;Boomers;TALCA                         ;MAULE;0;0;0;0;0;0;0;0;0;Celular G8 POWER LITE WOM DIRECTO TURQUESA;TELEFONIA
18159717;Soltero;F;31;CHILENO;TECNICO SUPERIOR DE ENFERMERIA;Millenial;PROVIDENCIA                   ;METROPOLITANA;0;0;0;0;0;0;0;0;0;CELULAR POCO M3 64GB COOL BLUE;TELEFONIA
12207473;;F;50;CHILENO;;X;CAUQUENES                     ;MAULE;0;0;0;0;0;0;0;0;0;Celular A51 128GB LIB OPEN BLACK;TELEFONIA
11489202;;F;53;CHILENO;;X;PROVIDENCIA                   ;METROPOLITANA;0;0;0;0;0;0;0;0;0;CELULAR A32 128 GB LIGHT VIOLET OPEN;TELEFONIA
16830735;;M;34;CHILENO;;Millenial;OSORNO                        ;LOS LAGOS;0;0;0;0;0;0;0;0;0;CELULAR A21s 128 GB Negro;TELEFONIA
18644932;Soltero;F;27;CHILENO;;Millenial;PROVIDENCIA                   ;METROPOLITANA;0;0;0;0;0;0;0;0;0;CELULAR A32 128 GB LIGHT VIOLET OPEN;TELEFONIA
14590386;;M;46;CHILENO;;X;PROVIDENCIA                   ;METROPOLITANA;0;0;0;0;0;0;0;0;0;Celular A11 LIB OPEN WHITE;TELEFONIA
15042770;Soltero;M;40;CHILENO;;X;PROVIDENCIA                   ;METROPOLITANA;0;0;0;0;0;0;0;0;0;CELULAR A02s AZUL 32GB OPEN;TELEFONIA
15533633;;M;40;CHILENO;;Silencioso;PROVIDENCIA                   ;METROPOLITANA;0;0;0;0;0;0;0;0;0;CELULAR MOTOROLA G9 PLAY 64GB ELECTRIC BLUE OPEN;TELEFONIA
8501710;;F;48;CHILENO;;X;N/D;N/D;0;0;0;0;0;0;0;0;0;CELULAR A52 128 GB BLACK OPEN;TELEFONIA
8346591;;M;64;CHILENO;;Boomers;ANCUD                         ;LOS LAGOS;0;0;0;0;0;0;0;0;0;CELULAR VIVO V20 MIDNIGHT JAZZ OPEN;TELEFONIA
20901129;Soltero;M;31;CHILENO;;Millenial;PROVIDENCIA                   ;METROPOLITANA;0;0;0;0;0;0;0;0;0;CELULAR A32 128 GB BLACK OPEN;TELEFONIA
19138424;;F;26;CHILENO;;Z;CASTRO                        ;LOS LAGOS;0;0;0;0;0;0;0;0;0;CELULAR A02s NEGRO 32GB OPEN;TELEFONIA
17128920;;M;33;CHILENO;;Millenial;PROVIDENCIA                   ;METROPOLITANA;0;0;0;0;0;0;0;0;0;CELULAR REDMI NOTE 10 128GB PEBBLE WHITE;TELEFONIA
17523680;Soltero;M;30;CHILENO;KINESIOLOGO;Silencioso;PROVIDENCIA                   ;METROPOLITANA;0;0;0;0;0;0;0;0;0;Celular P40 LITE LIB OPEN GREEN;TELEFONIA
19225110;;M;26;CHILENO;;Z;EL BOSQUE                     ;METROPOLITANA;0;0;0;0;0;0;0;0;0;CELULAR REDMI NOTE 10 EU 64GB ONIX GRAY OPEN;TELEFONIA
22588168;;M;46;PERUANO;;Extranjero;PUDAHUEL                      ;METROPOLITANA;0;0;0;0;0;0;0;0;0;CELULAR Samsung Galaxy A02s 32GB Azul WOM;TELEFONIA
15226562;;F;38;CHILENO;;Millenial;LUMACO                        ;ARAUCANIA;0;0;0;0;0;0;0;0;0;CELULAR MOTO ONE FUSION 64GB VERDE 64GB OPEN;TELEFONIA
19912338;;F;24;CHILENO;;Z;PROVIDENCIA                   ;METROPOLITANA;0;0;0;0;0;0;0;0;0;CELULAR REDMI NOTE 9 128 GB MIDNIGHT GREY OPEN;TELEFONIA
20466456;;F;22;CHILENO;;Silencioso;PROVIDENCIA                   ;METROPOLITANA;0;0;0;0;0;0;0;0;0;CELULAR GALAXY S20FE 128GB CLOUD LAVENDER OPEN;TELEFONIA
11894220;;M;50;CHILENO;;X;RENCA                         ;METROPOLITANA;0;0;0;0;0;0;0;0;0;IPHONE XR 64GB AZUL REAC;TELEFONIA
10001057;;M;65;CHILENO;;Boomers;RENCA                         ;METROPOLITANA;0;0;0;0;0;0;0;0;0;Celular LG K22 MOVISTAR DIRECTO TITAN;TELEFONIA
17836991;;F;31;CHILENO;;Silencioso;PROVIDENCIA                   ;METROPOLITANA;0;0;0;0;0;0;0;0;0;CELULAR XIAOMI REDMI 9C 32GB AZUL WOM;TELEFONIA
10943274;;F;53;CHILENO;;X;MAIPU                         ;METROPOLITANA;0;0;0;0;0;0;0;0;0;CELULAR A21s 128 GB Negro;TELEFONIA
17745176;Soltero;F;31;CHILENO;;Millenial;PROVIDENCIA                   ;METROPOLITANA;0;0;0;0;0;0;0;0;0;CELULAR SAMSUNG A02S DIRECTO CLARO BLACK;TELEFONIA
14107836;;M;40;CHILENO;;X;CHILLAN                       ;NUBLE;0;0;0;0;0;0;0;0;0;CELULAR A02 ROJO 32GB OPEN;TELEFONIA
19865208;;F;24;CHILENO;;Z;PROVIDENCIA                   ;METROPOLITANA;0;0;0;0;0;0;0;0;0;CELULAR REDMI NOTE 10 128GB ONIX GRAY OPEN;TELEFONIA
18234800;Casado;M;29;CHILENO;;Millenial;N/D;N/D;0;0;0;0;0;0;0;0;0;IPHONE 12 128GB BLACK CLARO;TELEFONIA
7113619;;M;62;CHILENO;;Boomers;N/D;N/D;0;0;0;0;0;0;0;0;0;CELULAR MI 10T PRO 256GB COSMIC BLACK OPEN;TELEFONIA
19945225;;F;24;CHILENO;;Z;LA SERENA;COQUIMBO;0;0;0;0;0;0;0;0;0;CELULAR MOTOROLA G9 PLAY 64GB BLUE DIRECTO CLAR;TELEFONIA
15041233;;M;39;CHILENO;;X;OVALLE                        ;COQUIMBO;0;0;0;0;0;0;0;0;0;CELULAR A02 AZUL 32GB OPEN;TELEFONIA
15845548;;M;37;CHILENO;;Millenial;PADRE LAS CASAS               ;ARAUCANIA;0;0;0;0;0;0;0;0;0;CELULAR SAMSUNG A02S DIRECTO CLARO BLACK;TELEFONIA
18029569;;F;30;CHILENO;;Millenial;PROVIDENCIA                   ;METROPOLITANA;0;0;0;0;0;0;0;0;0;CELULAR A02s ROJO 32GB OPEN;TELEFONIA
19512917;Soltero;M;25;CHILENO;;Silencioso;PROVIDENCIA                   ;METROPOLITANA;0;0;0;0;0;0;0;0;0;CELULAR REDMI NOTE 9 128G FOREST GREEN OPEN;TELEFONIA
7629521;;F;65;CHILENO;;Boomers;RANCAGUA                      ;L.G.B.OÂ´HIGGINS;0;0;0;0;0;0;0;0;0;CELULAR MOTOROLA G9 PLAY ROSADO DIRECTO WOM;TELEFONIA
17720343;;F;28;CHILENO;;Millenial;N/D;N/D;0;0;0;0;0;0;0;0;0;CELULAR A32 128 GB BLACK OPEN;TELEFONIA
18501165;Soltero;F;28;CHILENO;;Millenial;PROVIDENCIA                   ;METROPOLITANA;0;0;0;0;0;0;0;0;0;CELULAR A72 128 GB LIGHT VIOLET OPEN;TELEFONIA
12102960;;F;56;CHILENO;;Boomers;QUILLECO                      ;BIO BIO;0;0;0;0;0;0;0;0;0;CELULAR MOTOROLA E6S GRIS 32GB DIRECTO WOM;TELEFONIA
5950033;;F;74;CHILENO;;Silencioso;PROVIDENCIA                   ;METROPOLITANA;0;0;0;0;0;0;0;0;0;CELULAR A52 128 GB BLACK OPEN;TELEFONIA
11563713;Soltero;M;52;CHILENO;AGROINDUSTRIA;X;RENCA                         ;METROPOLITANA;0;0;0;0;0;0;0;0;0;Celular LG K22 DIRECTO CLARO;TELEFONIA
16119687;;M;37;CHILENO;;Millenial;PROVIDENCIA                   ;METROPOLITANA;0;0;0;0;0;0;0;0;0;POCO X3 PRO 256 GB PHANTOM BLACK;TELEFONIA
14300921;Casado;F;54;CHILENO;;X;RENCA                         ;METROPOLITANA;0;0;0;0;0;0;0;0;0;CELULAR OWN 1026 AZUL ENTEL;TELEFONIA
20032585;;F;22;CHILENO;;Z;PROVIDENCIA                   ;METROPOLITANA;0;0;0;0;0;0;0;0;0;CELULAR A32 128 GB WHITE OPEN;TELEFONIA
14291224;Casado;M;48;CHILENO;;Silencioso;PROVIDENCIA                   ;METROPOLITANA;0;0;0;0;0;0;0;0;0;CELULAR A02s AZUL 32GB OPEN;TELEFONIA
20326359;;M;22;CHILENO;;Silencioso;PROVIDENCIA                   ;METROPOLITANA;0;0;0;0;0;0;0;0;0;CELULAR REDMI NOTE 10 128GB PEBBLE WHITE;TELEFONIA
17528410;;M;31;CHILENO;;Millenial;N/D;N/D;0;0;0;0;0;0;0;0;0;CELULAR REDMI NOTE 10 EU 128G Onyx Gray BUNDLE;TELEFONIA
19455966;Soltero;F;29;CHILENO;FOTOGRAFO;Millenial;PROVIDENCIA                   ;METROPOLITANA;0;0;0;0;0;0;0;0;0;CELULAR MOTO ONE FUSION 64GB VERDE 64GB OPEN;TELEFONIA
17682616;Soltero;F;31;CHILENO;;Millenial;MELIPILLA                     ;METROPOLITANA;0;0;0;0;0;0;0;0;0;CELULAR MOTO E6S 32GB GRIS DIRECTO ENTEL;TELEFONIA
18281387;;M;30;CHILENO;;Millenial;CHONCHI                       ;LOS LAGOS;0;0;0;0;0;0;0;0;0;CELULAR MOTOROLA G9 PLAY 64GB BLUE DIRECTO CLAR;TELEFONIA
11328802;;F;54;CHILENO;;X;ILLAPEL                       ;COQUIMBO;0;0;0;0;0;0;0;0;0;Celular A11 LIB OPEN WHITE;TELEFONIA
16625684;;M;34;CHILENO;;Silencioso;PROVIDENCIA                   ;METROPOLITANA;0;0;0;0;0;0;0;0;0;CELULAR GALAXY S20FE 128GB CLOUD LAVENDER OPEN;TELEFONIA
13048009;;M;46;CHILENO;;X;PROVIDENCIA                   ;METROPOLITANA;0;0;0;0;0;0;0;0;0;CELULAR MOTO E6S 32GB ROSA OPEN;TELEFONIA
13349157;;M;43;CHILENO;;X;PROVIDENCIA                   ;METROPOLITANA;0;0;0;0;0;0;0;0;0;CELULAR A12 128GB AZUL OPEN;TELEFONIA
15472797;;M;40;CHILENO;;X;PROVIDENCIA                   ;METROPOLITANA;0;0;0;0;0;0;0;0;0;CELULAR REDMI NOTE 10 128GB ONIX GRAY OPEN;TELEFONIA
12099092;Casado;F;56;CHILENO;;Boomers;RENCA                         ;METROPOLITANA;0;0;0;0;0;0;0;0;0;Celular A11 LIB OPEN WHITE;TELEFONIA
17711721;;F;31;CHILENO;;Millenial;N/D;N/D;0;0;0;0;0;0;0;0;0;CELULAR A02s ROJO 32GB OPEN;TELEFONIA
9526966;;F;60;CHILENO;;Boomers;PROVIDENCIA                   ;METROPOLITANA;0;0;0;0;0;0;0;0;0;CELULAR A32 128 GB BLUE OPEN;TELEFONIA
13105583;;M;46;CHILENO;;X;PROVIDENCIA                   ;METROPOLITANA;0;0;0;0;0;0;0;0;0;Celular P40 LITE LIB OPEN GREEN;TELEFONIA
14135943;;F;40;CHILENO;;X;N/D;N/D;0;0;0;0;0;0;0;0;0;CELULAR MI 11 LITE 128GB BUBBLEGUM BLUE;TELEFONIA
19555079;;M;25;CHILENO;;Silencioso;PROVIDENCIA                   ;METROPOLITANA;0;0;0;0;0;0;0;0;0;CELULAR MOTOROLA G9 PLAY 64GB ELECTRIC BLUE OPEN;TELEFONIA
18730398;;M;28;CHILENO;;Extranjero;N/D;N/D;0;0;0;0;0;0;0;0;0;CELULAR POCO X3 PRO 128G PHANTOM BLACK OPEN;TELEFONIA
15809983;;M;37;CHILENO;;Millenial;N/D;N/D;0;0;0;0;0;0;0;0;0;CELULAR GALAXY A01 32GB AZUL ENTEL;TELEFONIA
12548595;;M;47;CHILENO;;X;CONSTITUCION                  ;MAULE;0;0;0;0;0;0;0;0;0;CELULAR A32 128 GB BLUE OPEN;TELEFONIA
12333602;;F;51;CHILENO;;X;TALCAHUANO                    ;BIO BIO;0;0;0;0;0;0;0;0;0;CELULAR VIVO Y20S NEBULA 128 GB BLUE OPEN;TELEFONIA
19125075;;F;40;CHILENO;;Silencioso;PROVIDENCIA                   ;METROPOLITANA;0;0;0;0;0;0;0;0;0;CELULAR VIVO Y51 CRYSTAL SYMPHONY OPEN;TELEFONIA
16740251;;M;34;CHILENO;;Silencioso;PROVIDENCIA                   ;METROPOLITANA;0;0;0;0;0;0;0;0;0;CELULAR XIAOMI REDMI 9C 32GB AZUL WOM;TELEFONIA
11580230;;F;51;CHILENO;;X;N/D;N/D;0;0;0;0;0;0;0;0;0;IPHONE XR 64GB LIB OPEN NEGRO;TELEFONIA
18846718;;M;28;CHILENO;;Millenial;PROVIDENCIA                   ;METROPOLITANA;0;0;0;0;0;0;0;0;0;CELULAR GALAXY S20FE 128GB ClOUD NAVY OPEN;TELEFONIA
13528944;;F;43;CHILENO;;X;CALAMA                        ;ANTOFAGASTA;0;0;0;0;0;0;0;0;0;Celular SAMSUNG A01 CORE BLACK CLARO;TELEFONIA
8756152;Divorciado;M;62;CHILENO;INGENIERO AGRICOLA;Boomers;SAN CARLOS                    ;BIO BIO;0;0;0;0;0;0;0;0;0;CELULAR A12 128GB AZUL OPEN;TELEFONIA
13360591;;M;44;CHILENO;;X;N/D;N/D;0;0;0;0;0;0;0;0;0;CELULAR A32 128 GB WHITE OPEN;TELEFONIA
18567668;;F;28;CHILENO;;Millenial;SALAMANCA                     ;COQUIMBO;0;0;0;0;0;0;0;0;0;CELULAR MOTO G9 POWER 128GB MORADO SONICO OPEN;TELEFONIA
19660479;;F;25;CHILENO;;Z;PROVIDENCIA                   ;METROPOLITANA;0;0;0;0;0;0;0;0;0;Celular LG K22 MOVISTAR DIRECTO TITAN;TELEFONIA
17764957;;F;31;CHILENO;;Silencioso;PROVIDENCIA                   ;METROPOLITANA;0;0;0;0;0;0;0;0;0;CELULAR XIAOMI MI 10T 128GB LUNAR SILVER OPEN;TELEFONIA
20279117;;F;22;CHILENO;;Z;PROVIDENCIA                   ;METROPOLITANA;0;0;0;0;0;0;0;0;0;CELULAR A21s 128 GB Negro;TELEFONIA
10980915;;M;53;CHILENO;;X;RENCA                         ;METROPOLITANA;0;0;0;0;0;0;0;0;0;CELULAR POCO M3 64GB POWER BLACK;TELEFONIA
17174270;Soltero;M;33;CHILENO;;Millenial;PROVIDENCIA                   ;METROPOLITANA;0;0;0;0;0;0;0;0;0;CELULAR MOTOROLA G9 PLAY 64GB SPRING PINK OPEN;TELEFONIA
17068674;;F;33;CHILENO;;Millenial;VALDIVIA                      ;LOS RIOS;0;0;0;0;0;0;0;0;0;CELULAR A12 128GB NEGRO OPEN;TELEFONIA
17644521;;F;31;CHILENO;;Millenial;VALLENAR;ATACAMA;0;0;0;0;0;0;0;0;0;CELULAR REDMI NOTE 10 128GB ONIX GRAY OPEN;TELEFONIA
9686104;;F;58;CHILENO;;Boomers;PROVIDENCIA                   ;METROPOLITANA;0;0;0;0;0;0;0;0;0;Celular SAMSUNG A01 CORE BLACK CLARO;TELEFONIA
23686389;;F;31;BOLIVIANO;;Extranjero;CALAMA                        ;ANTOFAGASTA;0;0;0;0;0;0;0;0;0;CELULAR VIVO Y11s PHANTOM BLACK ENTEL DIRECTO;TELEFONIA
11526360;;M;52;CHILENO;;X;MARIA PINTO                   ;METROPOLITANA;0;0;0;0;0;0;0;0;0;CELULAR A21s 128 GB Rojo;TELEFONIA
17410006;;F;32;CHILENO;;Millenial;VICUNA                        ;COQUIMBO;0;0;0;0;0;0;0;0;0;CELULAR POCO X3 PRO 256 GB FROST BLUE;TELEFONIA
19047009;;M;27;CHILENO;;Z;QUILLOTA                      ;VALPARAISO;0;0;0;0;0;0;0;0;0;Celular Y8P ENTEL TRIANGULADO NEGRO;TELEFONIA
17784130;Soltero;M;31;CHILENO;;Silencioso;PROVIDENCIA                   ;METROPOLITANA;0;0;0;0;0;0;0;0;0;CELULAR POCO M3 64GB POWER BLACK;TELEFONIA
8842803;;M;63;CHILENO;;Boomers;VALDIVIA                      ;LOS RIOS;0;0;0;0;0;0;0;0;0;CELULAR MOTOROLA E6S GRIS 32GB DIRECTO WOM;TELEFONIA
8734901;Casado;M;62;CHILENO;;Boomers;RENCA                         ;METROPOLITANA;0;0;0;0;0;0;0;0;0;CELULAR A21s 128 GB AZUL;TELEFONIA
10190717;Casado;M;56;CHILENO;;Silencioso;PROVIDENCIA                   ;METROPOLITANA;0;0;0;0;0;0;0;0;0;CELULAR MOTO G9 POWER 128GB MORADO SONICO OPEN;TELEFONIA
12079041;Soltero;M;54;CHILENO;;X;MAIPU                         ;METROPOLITANA;0;0;0;0;0;0;0;0;0;CELULAR A21s 128 GB Rojo;TELEFONIA
18895791;;F;27;CHILENO;;Z;PROVIDENCIA                   ;METROPOLITANA;0;0;0;0;0;0;0;0;0;Celular A11 LIB OPEN BLUE;TELEFONIA
15046629;Soltero;M;40;CHILENO;;X;RENCA                         ;METROPOLITANA;0;0;0;0;0;0;0;0;0;CELULAR A12 128GB NEGRO OPEN;TELEFONIA
17406857;Soltero;M;32;CHILENO;MEDICO CIRUJANO;Silencioso;PROVIDENCIA                   ;METROPOLITANA;0;0;0;0;0;0;0;0;0;Celular P40 LITE LIB OPEN GREEN;TELEFONIA
11536119;;M;51;CHILENO;;X;ANTOFAGASTA                   ;ANTOFAGASTA;0;0;0;0;0;0;0;0;0;CELULAR REDMI NOTE 10 EU 128G Lake Green BUNDLE;TELEFONIA
9283346;;M;60;CHILENO;;Boomers;PROVIDENCIA                   ;METROPOLITANA;0;0;0;0;0;0;0;0;0;Celular A01 CLARO DIRECTO BLACK;TELEFONIA
15660801;Soltero;M;39;CHILENO;;X;PROVIDENCIA                   ;METROPOLITANA;0;0;0;0;0;0;0;0;0;Celular A51 128GB LIB OPEN AZUL;TELEFONIA
12173617;Casado;F;49;CHILENO;;X;PROVIDENCIA                   ;METROPOLITANA;0;0;0;0;0;0;0;0;0;Celular LG K22 MOVISTAR DIRECTO TITAN;TELEFONIA
18646374;;M;28;CHILENO;;Millenial;RANCAGUA                      ;L.G.B.OÂ´HIGGINS;0;0;0;0;0;0;0;0;0;CELULAR REDMI NOTE 10 128GB ONIX GRAY OPEN;TELEFONIA
18454625;;M;29;CHILENO;;Millenial;PROVIDENCIA                   ;METROPOLITANA;0;0;0;0;0;0;0;0;0;CELULAR XIAOMI POCO X3 64G SHADOW GRAY;TELEFONIA
13279265;;M;44;CHILENO;;X;PROVIDENCIA                   ;METROPOLITANA;0;0;0;0;0;0;0;0;0;CELULAR NOTE 20 ULTRA MYSTIC BLACK 256GB OPEN;TELEFONIA
19320986;;M;26;CHILENO;;Silencioso;PROVIDENCIA                   ;METROPOLITANA;0;0;0;0;0;0;0;0;0;CELULAR MOTO G9 POWER 128GB MORADO SONICO OPEN;TELEFONIA
13887173;;M;42;CHILENO;;X;PROVIDENCIA                   ;METROPOLITANA;0;0;0;0;0;0;0;0;0;CELULAR A12 128GB AZUL OPEN;TELEFONIA
7997455;;M;66;CHILENO;;Boomers;VALLENAR;ATACAMA;0;0;0;0;0;0;0;0;0;CELULAR ZTE A5 2020 DIRECTO CLARO VERDE;TELEFONIA
6417087;;F;74;CHILENO;;Silencioso;RENCA                         ;METROPOLITANA;0;0;0;0;0;0;0;0;0;CELULAR A21s 128 GB AZUL;TELEFONIA
9948488;Casado;M;50;CHILENO;;X;RENCA                         ;METROPOLITANA;0;0;0;0;0;0;0;0;0;CELULAR A21s 128 GB Negro;TELEFONIA
16388348;;M;35;CHILENO;;Millenial;LEBU                          ;BIO BIO;0;0;0;0;0;0;0;0;0;CELULAR A02s AZUL 32GB OPEN;TELEFONIA
8657289;;M;62;CHILENO;;Boomers;PROVIDENCIA                   ;METROPOLITANA;0;0;0;0;0;0;0;0;0;CELULAR A02s AZUL 32GB OPEN;TELEFONIA
9387226;Casado;F;61;CHILENO;;Boomers;COCHRANE                      ;AYSEN;0;0;0;0;0;0;0;0;0;CELULAR A02 ROJO 32GB OPEN;TELEFONIA
16215440;;F;37;CHILENO;;Millenial;LAMPA;METROPOLITANA;0;0;0;0;0;0;0;0;0;CELULAR A21s 128 GB AZUL;TELEFONIA
19003045;Soltero;M;27;CHILENO;;Z;PROVIDENCIA                   ;METROPOLITANA;0;0;0;0;0;0;0;0;0;CELULAR A12 128GB NEGRO OPEN;TELEFONIA
13372990;;M;43;CHILENO;;X;LA FLORIDA;METROPOLITANA;0;0;0;0;0;0;0;0;0;CELULAR XIAOMI POCO X3 64G SHADOW GRAY;TELEFONIA
12753509;Casado;M;47;CHILENO;;X;PROVIDENCIA                   ;METROPOLITANA;0;0;0;0;0;0;0;0;0;CELULAR VIVO Y11s PHANTOM BLACK ENTEL DIRECTO;TELEFONIA
7822099;;M;62;CHILENO;;Boomers;RAUCO                         ;MAULE;0;0;0;0;0;0;0;0;0;CELULAR A02 ROJO 32GB OPEN;TELEFONIA
19118254;;F;26;CHILENO;;Z;N/D;N/D;0;0;0;0;0;0;0;0;0;CELULAR A12 128GB ROJO OPEN;TELEFONIA
13920330;Divorciado;F;41;CHILENO;INGENIERO EN RECURSOS NATURALES RENOVABLES;X;PROVIDENCIA                   ;METROPOLITANA;0;0;0;0;0;0;0;0;0;Celular A51 128GB LIB OPEN AZUL;TELEFONIA
6868208;Casado;M;66;CHILENO;;Silencioso;PROVIDENCIA                   ;METROPOLITANA;0;0;0;0;0;0;0;0;0;CELULAR A21s 128 GB AZUL;TELEFONIA
18233877;Soltero;F;29;CHILENO;;Millenial;PROVIDENCIA                   ;METROPOLITANA;0;0;0;0;0;0;0;0;0;CELULAR MOTO E6S 32GB GRIS DIRECTO ENTEL;TELEFONIA
17314287;;M;32;CHILENO;;Millenial;RENCA                         ;METROPOLITANA;0;0;0;0;0;0;0;0;0;Celular SAMSUNG A01 CORE BLACK CLARO;TELEFONIA
19425482;Soltero;F;26;CHILENO;;Silencioso;PROVIDENCIA                   ;METROPOLITANA;0;0;0;0;0;0;0;0;0;CELULAR A02 ROJO 32GB OPEN;TELEFONIA
19242019;;M;27;CHILENO;;Z;N/D;N/D;0;0;0;0;0;0;0;0;0;CELULAR A12 128GB ROJO OPEN;TELEFONIA
16346195;;F;38;CHILENO;;X;N/D;N/D;0;0;0;0;0;0;0;0;0;CELULAR A02s AZUL 32GB OPEN;TELEFONIA
19381978;Soltero;F;26;CHILENO;INGENIERIA EN PRODUCCION GANADERA;Z;PROVIDENCIA                   ;METROPOLITANA;0;0;0;0;0;0;0;0;0;CELULAR A12 128GB AZUL OPEN;TELEFONIA
15342176;Soltero;F;38;CHILENO;ADMINISTRADOR PUBLICO;X;PROVIDENCIA                   ;METROPOLITANA;0;0;0;0;0;0;0;0;0;CELULAR A21s 128 GB Negro;TELEFONIA
15754955;Soltero;F;40;CHILENO;;X;PROVIDENCIA                   ;METROPOLITANA;0;0;0;0;0;0;0;0;0;CELULAR MOTO E6I 32GB GRIS OPEN;TELEFONIA
15383358;;F;39;CHILENO;;Silencioso;PROVIDENCIA                   ;METROPOLITANA;0;0;0;0;0;0;0;0;0;CELULAR A12 128GB NEGRO OPEN;TELEFONIA
18688643;;F;28;CHILENO;;Millenial;CHILLAN VIEJO                 ;BIO BIO;0;0;0;0;0;0;0;0;0;CELULAR REDMI NOTE 10 PRO 8+128GB GRADIENT BRONZ;TELEFONIA
6919354;Casado;M;69;CHILENO;AGROINDUSTRIA;Silencioso;CALERA                        ;VALPARAISO;0;0;0;0;0;0;0;0;0;CELULAR NOKIA 110 BLACK OPEN;TELEFONIA
18447533;;F;29;CHILENO;;Millenial;N/D;N/D;0;0;0;0;0;0;0;0;0;CELULAR Xiaomi Redmi 9 64 GB Morado WOM;TELEFONIA
20338947;;F;22;CHILENO;;Silencioso;PROVIDENCIA                   ;METROPOLITANA;0;0;0;0;0;0;0;0;0;Celular G8 POWER LITE WOM DIRECTO TURQUESA;TELEFONIA
15164702;;M;39;CHILENO;;X;RENCA                         ;METROPOLITANA;0;0;0;0;0;0;0;0;0;CELULAR G8 POWER MOTO TRI ENTEL;TELEFONIA
8213739;;M;65;CHILENO;;Boomers;COLINA                        ;METROPOLITANA;0;0;0;0;0;0;0;0;0;Celular A11 LIB OPEN WHITE;TELEFONIA
19417972;Soltero;M;25;CHILENO;;Silencioso;PROVIDENCIA                   ;METROPOLITANA;0;0;0;0;0;0;0;0;0;CELULAR MOTO G9 POWER 128GB VERDE GRANITO OPEN;TELEFONIA
19010947;;M;27;CHILENO;;Z;PROVIDENCIA                   ;METROPOLITANA;0;0;0;0;0;0;0;0;0;CELULAR A21s 128 GB Negro;TELEFONIA
15521187;;M;39;CHILENO;;X;CALERA                        ;VALPARAISO;0;0;0;0;0;0;0;0;0;Celular A11 LIB OPEN WHITE;TELEFONIA
13746122;;M;43;CHILENO;;X;OVALLE                        ;COQUIMBO;0;0;0;0;0;0;0;0;0;CELULAR A02s NEGRO 32GB OPEN;TELEFONIA
13633547;;M;42;CHILENO;;X;ARICA                         ;ARICA Y PARINACOTA;0;0;0;0;0;0;0;0;0;CELULAR A02s AZUL 32GB OPEN;TELEFONIA
13616194;;F;42;CHILENO;;X;PARRAL                        ;MAULE;0;0;0;0;0;0;0;0;0;Celular A51 128GB LIB OPEN BLACK;TELEFONIA
10127629;;F;56;CHILENO;;Boomers;MAIPU                         ;METROPOLITANA;0;0;0;0;0;0;0;0;0;Celular A51 128GB LIB OPEN BLACK;TELEFONIA
14246826;;F;48;CHILENO;;X;MELIPILLA;METROPOLITANA;0;0;0;0;0;0;0;0;0;CELULAR A21s 128 GB Rojo;TELEFONIA
12735403;Casado;F;46;CHILENO;;X;RENCA                         ;METROPOLITANA;0;0;0;0;0;0;0;0;0;CELULAR REDMI 9 32GB CARBON GREY OPEN;TELEFONIA
14099912;;F;40;CHILENO;;X;PROVIDENCIA                   ;METROPOLITANA;0;0;0;0;0;0;0;0;0;CELULAR A02s NEGRO 32GB OPEN;TELEFONIA
10048584;;M;69;CHILENO;;Silencioso;PANGUIPULLI                   ;LOS RIOS;0;0;0;0;0;0;0;0;0;CELULAR A02 ROJO 32GB OPEN;TELEFONIA
13623145;;F;43;CHILENO;;X;N/D;N/D;0;0;0;0;0;0;0;0;0;CELULAR A21s 128 GB Negro;TELEFONIA
13435123;;M;43;CHILENO;;X;PROVIDENCIA                   ;METROPOLITANA;0;0;0;0;0;0;0;0;0;CELULAR ZTE A3 2020 GRIS DIRECTO CLARO;TELEFONIA
19857790;;F;24;CHILENO;;Z;PROVIDENCIA                   ;METROPOLITANA;0;0;0;0;0;0;0;0;0;CELULAR A21s 128 GB Rojo;TELEFONIA
12314705;Soltero;M;48;CHILENO;;X;PROVIDENCIA                   ;METROPOLITANA;0;0;0;0;0;0;0;0;0;Celular AL3 CLARO DIRECTO NEGRO;TELEFONIA
15513396;;M;38;CHILENO;;Millenial;RENCA                         ;METROPOLITANA;0;0;0;0;0;0;0;0;0;Celular AL3 CLARO DIRECTO NEGRO;TELEFONIA
18333982;;M;30;CHILENO;;Millenial;SAN PEDRO DE LA PAZ           ;BIO BIO;0;0;0;0;0;0;0;0;0;Celular NOKIA 2.3 WOM DIRECTO CHARCOAL;TELEFONIA
17917705;;M;30;CHILENO;;Millenial;PADRE LAS CASAS               ;ARAUCANIA;0;0;0;0;0;0;0;0;0;CELULAR A02s AZUL 32GB OPEN;TELEFONIA
10304054;;F;54;CHILENO;;X;PUERTO MONTT                  ;LOS LAGOS;0;0;0;0;0;0;0;0;0;Celular XIAOMI REDMI 9C 64 GB DIRECTO CLARO;TELEFONIA
15244608;;M;46;CHILENO;;X;RENCA                         ;METROPOLITANA;0;0;0;0;0;0;0;0;0;Celular A01 LIB OPEN NEGRO;TELEFONIA
15049633;;M;36;CHILENO;;Millenial;PROVIDENCIA                   ;METROPOLITANA;0;0;0;0;0;0;0;0;0;CELULAR A12 128GB NEGRO OPEN;TELEFONIA
14081842;;F;41;CHILENO;;X;COLBUN                        ;MAULE;0;0;0;0;0;0;0;0;0;CELULAR A21s 128 GB Rojo;TELEFONIA
18927562;Soltero;M;27;CHILENO;;Silencioso;PROVIDENCIA                   ;METROPOLITANA;0;0;0;0;0;0;0;0;0;CELULAR MOTOROLA E6 PLAY AZUL TRI WOM;TELEFONIA
10620544;;M;55;CHILENO;;Boomers;PROVIDENCIA                   ;METROPOLITANA;0;0;0;0;0;0;0;0;0;Celular A51 128GB LIB OPEN AZUL;TELEFONIA
16109732;;M;37;CHILENO;;Millenial;OVALLE                        ;COQUIMBO;0;0;0;0;0;0;0;0;0;CELULAR MOTOROLA G9 PLAY 64GB SPRING PINK OPEN;TELEFONIA
18739040;;M;28;CHILENO;;Millenial;N/D;N/D;0;0;0;0;0;0;0;0;0;Celular A11 LIB OPEN BLACK;TELEFONIA
11754865;;M;51;CHILENO;;X;PROVIDENCIA                   ;METROPOLITANA;0;0;0;0;0;0;0;0;0;Celular XIAOMI REDMI 9C 64 GB DIRECTO CLARO;TELEFONIA
18179260;;M;29;CHILENO;;Millenial;PROVIDENCIA                   ;METROPOLITANA;0;0;0;0;0;0;0;0;0;CELULAR MOTOROLA E6 PLAY AZUL TRI WOM;TELEFONIA
20432741;;F;22;CHILENO;;Z;PROVIDENCIA                   ;METROPOLITANA;0;0;0;0;0;0;0;0;0;Celular A11 LIB OPEN BLUE;TELEFONIA
15915466;Casado;M;37;CHILENO;INGENIERO CIVIL;Millenial;PROVIDENCIA                   ;METROPOLITANA;0;0;0;0;0;0;0;0;0;Celular Galaxy S21 Phantom Grey 128GB;TELEFONIA
11517457;;M;52;CHILENO;;X;LOS ANDES                     ;VALPARAISO;0;0;0;0;0;0;0;0;0;CELULAR A12 128GB AZUL OPEN;TELEFONIA
16315796;;F;36;CHILENO;;Millenial;PROVIDENCIA                   ;METROPOLITANA;0;0;0;0;0;0;0;0;0;CELULAR MOTOROLA G9 PLAY 64GB ELECTRIC BLUE OPEN;TELEFONIA
10535571;;F;54;CHILENO;;Boomers;LINARES                       ;MAULE;0;0;0;0;0;0;0;0;0;CELULAR XIAOMI MI 10T 128GB LUNAR SILVER OPEN;TELEFONIA
11374130;;M;53;CHILENO;;X;PROVIDENCIA                   ;METROPOLITANA;0;0;0;0;0;0;0;0;0;Celular G8 POWER LITE MOVISTAR DIRECTO AZUL;TELEFONIA
7592107;;F;66;CHILENO;;Boomers;HIJUELAS                      ;VALPARAISO;0;0;0;0;0;0;0;0;0;CELULAR MOTOROLA E6 PLAY AZUL TRI WOM;TELEFONIA
14057854;;F;41;CHILENO;;Silencioso;PROVIDENCIA                   ;METROPOLITANA;0;0;0;0;0;0;0;0;0;CELULAR REDMI NOTE 10 128GB ONIX GRAY OPEN;TELEFONIA
17526212;Soltero;M;30;CHILENO;;Silencioso;PROVIDENCIA                   ;METROPOLITANA;0;0;0;0;0;0;0;0;0;CELULAR A32 128 GB WHITE OPEN;TELEFONIA
17620557;;F;31;CHILENO;;Millenial;PROVIDENCIA                   ;METROPOLITANA;0;0;0;0;0;0;0;0;0;CELULAR A12 128GB AZUL OPEN;TELEFONIA
16697177;;M;34;CHILENO;;Millenial;N/D;N/D;0;0;0;0;0;0;0;0;0;CELULAR A21s 128 GB Negro;TELEFONIA
17453732;;M;33;CHILENO;;Millenial;ARAUCO;BIO-BIO;0;0;0;0;0;0;0;0;0;Celular Galaxy S21 Phantom White 128GB;TELEFONIA
10869724;;F;55;CHILENO;;Boomers;LA SERENA                     ;COQUIMBO;0;0;0;0;0;0;0;0;0;Celular A71 LIB OPEN NEGRO;TELEFONIA
19783761;;M;25;CHILENO;;Silencioso;PROVIDENCIA                   ;METROPOLITANA;0;0;0;0;0;0;0;0;0;CELULAR MOTO G9 POWER 128GB VERDE GRANITO OPEN;TELEFONIA
16462628;;F;35;CHILENO;;Millenial;PUENTE ALTO                   ;METROPOLITANA;0;0;0;0;0;0;0;0;0;Celular A51 128GB LIB OPEN BLACK;TELEFONIA
20682179;;M;32;CHILENO;;Millenial;PROVIDENCIA                   ;METROPOLITANA;0;0;0;0;0;0;0;0;0;Celular G8 POWER LITE MOVISTAR DIRECTO AZUL;TELEFONIA
14127858;;F;41;CHILENO;;X;CONCHALI                      ;METROPOLITANA;0;0;0;0;0;0;0;0;0;CELULAR ZTE A5 2020 DIRECTO CLARO VERDE;TELEFONIA
19491239;;F;24;CHILENO;;Z;PROVIDENCIA                   ;METROPOLITANA;0;0;0;0;0;0;0;0;0;CELULAR VIVO Y11S PHANTOM BLACK OPEN;TELEFONIA
10196052;;F;50;CHILENO;;X;LOS ANDES                     ;VALPARAISO;0;0;0;0;0;0;0;0;0;CELULAR A02s ROJO 32GB OPEN;TELEFONIA
15382797;Casado;F;39;CHILENO;;X;PROVIDENCIA                   ;METROPOLITANA;0;0;0;0;0;0;0;0;0;KIT PACK OPEN RETAIL 4G TELEFONICA;TELEFONIA
17525825;Soltero;M;30;CHILENO;INGENIERO CIVIL INDUSTRIAL;Millenial;RANCAGUA;O HIGGINS;0;0;0;0;0;0;0;0;0;CELULAR REDMI NOTE 9 PRO 128GB GLACIER WHITE;TELEFONIA
19343410;;F;26;CHILENO;;Z;PUENTE ALTO                   ;METROPOLITANA;0;0;0;0;0;0;0;0;0;CELULAR REDMI NOTE 9 PRO 128GB INTERSTELLAR GREY;TELEFONIA
18884660;;F;27;CHILENO;;Z;TENO                          ;MAULE;0;0;0;0;0;0;0;0;0;Celular A71 LIB OPEN PLATEADO;TELEFONIA
14207231;Casado;F;41;CHILENO;;Silencioso;PROVIDENCIA                   ;METROPOLITANA;0;0;0;0;0;0;0;0;0;CELULAR XIAOMI POCO M3 128GB YELLOW OPEN;TELEFONIA
12866472;;F;47;CHILENO;;X;SANTIAGO                      ;METROPOLITANA;0;0;0;0;0;0;0;0;0;IPHONE 8 64 GB LIB OPEN PLATEADO;TELEFONIA
18876925;;M;27;CHILENO;;Z;TEMUCO                        ;ARAUCANIA;0;0;0;0;0;0;0;0;0;CELULAR SAMSUNG A21S AZUL OPEN;TELEFONIA
15170845;;M;39;CHILENO;;X;TOME                          ;BIO BIO;0;0;0;0;0;0;0;0;0;CELULAR A12 128GB AZUL OPEN;TELEFONIA
7464006;;F;66;CHILENO;;Boomers;COIHAIQUE                     ;AYSEN;0;0;0;0;0;0;0;0;0;CELULAR Samsung Galaxy A02s 32GB Azul WOM;TELEFONIA
4691692;;M;82;CHILENO;;Silencioso;CHILE CHICO                   ;AYSEN;0;0;0;0;0;0;0;0;0;CELULAR A21s 128 GB Negro;TELEFONIA
11665003;;M;52;CHILENO;;X;PROVIDENCIA                   ;METROPOLITANA;0;0;0;0;0;0;0;0;0;CELULAR MOTO G9 POWER 128GB MORADO SONICO OPEN;TELEFONIA
10238099;;F;56;CHILENO;;Boomers;PROVIDENCIA                   ;METROPOLITANA;0;0;0;0;0;0;0;0;0;Celular A11 LIB OPEN BLACK;TELEFONIA
15721785;;F;38;CHILENO;;Silencioso;PROVIDENCIA                   ;METROPOLITANA;0;0;0;0;0;0;0;0;0;Celular A11 LIB OPEN BLUE;TELEFONIA
17642244;;M;31;CHILENO;;Millenial;SAN BERNARDO                  ;METROPOLITANA;0;0;0;0;0;0;0;0;0;Celular A51 128GB LIB OPEN AZUL;TELEFONIA
19781479;;M;26;CHILENO;;Z;N/D;N/D;0;0;0;0;0;0;0;0;0;Celular S20 FE LIB OPEN Cloud Green;TELEFONIA
17018821;;F;33;CHILENO;;Silencioso;PROVIDENCIA                   ;METROPOLITANA;0;0;0;0;0;0;0;0;0;Celular A51 128GB LIB OPEN BLACK;TELEFONIA
14072544;;F;42;CHILENO;;X;PUENTE ALTO                   ;METROPOLITANA;0;0;0;0;0;0;0;0;0;Celular A51 128GB CLARO TRIANGULADO BLACK;TELEFONIA
16320442;Casado;F;36;CHILENO;;Silencioso;PROVIDENCIA                   ;METROPOLITANA;0;0;0;0;0;0;0;0;0;Celular Galaxy S21 Ultra Phantom Black 128GB;TELEFONIA
12992042;;M;46;CHILENO;;X;PROVIDENCIA                   ;METROPOLITANA;0;0;0;0;0;0;0;0;0;CELULAR REDMI NOTE 9 128GB ONYX BLACK OPEN;TELEFONIA
16315669;;M;36;CHILENO;;Silencioso;PROVIDENCIA                   ;METROPOLITANA;0;0;0;0;0;0;0;0;0;Celular G8 POWER LITE WOM DIRECTO TURQUESA;TELEFONIA
17195511;;F;34;CHILENO;;Silencioso;PROVIDENCIA                   ;METROPOLITANA;0;0;0;0;0;0;0;0;0;Celular P30 LITE LIB OPEN NEGRO;TELEFONIA
11877043;;M;50;CHILENO;;Extranjero;SAN MIGUEL                    ;METROPOLITANA;0;0;0;0;0;0;0;0;0;CELULAR A12 128GB NEGRO OPEN;TELEFONIA
18919473;;F;27;CHILENO;;Z;N/D;N/D;0;0;0;0;0;0;0;0;0;CELULAR A02 NEGRO 32GB OPEN;TELEFONIA
5589679;;M;71;CHILENO;;Silencioso;ARICA                         ;TARAPACA;0;0;0;0;0;0;0;0;0;Celular A51 128GB LIB OPEN BLANCO;TELEFONIA
11918882;;F;55;CHILENO;;Boomers;RENCA                         ;METROPOLITANA;0;0;0;0;0;0;0;0;0;Celular A01 Core Azul Tri Entel;TELEFONIA
19275763;Soltero;F;25;CHILENO;;Z;PLACILLA                      ;L.G.B.OÂ´HIGGINS;0;0;0;0;0;0;0;0;0;Celular A31 LIB OPEN AZUL;TELEFONIA
13540327;;M;46;CHILENO;;X;RENCA                         ;METROPOLITANA;0;0;0;0;0;0;0;0;0;IPHONE 8 64 GB LIB OPEN DORADO;TELEFONIA
14361886;;M;41;CHILENO;;X;PROVIDENCIA                   ;METROPOLITANA;0;0;0;0;0;0;0;0;0;Celular AL3 CLARO DIRECTO NEGRO;TELEFONIA
16620404;;M;35;CHILENO;;Millenial;SAN BERNARDO                  ;METROPOLITANA;0;0;0;0;0;0;0;0;0;CELULAR A21s 128 GB Rojo;TELEFONIA
15956062;;F;37;CHILENO;;Millenial;PROVIDENCIA                   ;METROPOLITANA;0;0;0;0;0;0;0;0;0;CELULAR REDMI 9 64GB CARBON GREY;TELEFONIA
16779526;;M;34;CHILENO;;Millenial;N/D;N/D;0;0;0;0;0;0;0;0;0;Celular A11 LIB OPEN WHITE;TELEFONIA
18569628;Soltero;F;28;CHILENO;;Silencioso;PROVIDENCIA                   ;METROPOLITANA;0;0;0;0;0;0;0;0;0;CELULAR G8 POWER MOTO TRI ENTEL;TELEFONIA
11136022;;M;55;CHILENO;;Boomers;RENCA                         ;METROPOLITANA;0;0;0;0;0;0;0;0;0;CELULAR POCO M3 64GB COOL BLUE;TELEFONIA
16712065;;M;34;CHILENO;;Millenial;PROVIDENCIA                   ;METROPOLITANA;0;0;0;0;0;0;0;0;0;CELULAR LG K61 Gris OPEN;TELEFONIA
14070645;;M;40;CHILENO;;X;OSORNO                        ;LOS LAGOS;0;0;0;0;0;0;0;0;0;CELULAR MOTO G8 POWER LITE AZUL TRI ENTEL;TELEFONIA
17174573;;M;33;CHILENO;;Millenial;COQUIMBO                      ;COQUIMBO;0;0;0;0;0;0;0;0;0;CELULAR A02s ROJO 32GB OPEN;TELEFONIA
18377222;Soltero;M;28;CHILENO;;Silencioso;PROVIDENCIA                   ;METROPOLITANA;0;0;0;0;0;0;0;0;0;CELULAR REDMI 9 32GB CARBON GREY OPEN;TELEFONIA
9199455;;F;59;CHILENO;;Boomers;SAN CARLOS                    ;BIO BIO;0;0;0;0;0;0;0;0;0;CELULAR A21s 128 GB Negro;TELEFONIA
18820152;;M;32;CHILENO;;Millenial;N/D;N/D;0;0;0;0;0;0;0;0;0;CELULAR A02 ROJO 32GB OPEN;TELEFONIA
20390497;;M;22;CHILENO;;Silencioso;PROVIDENCIA                   ;METROPOLITANA;0;0;0;0;0;0;0;0;0;CELULAR POCO M3 64GB POWER BLACK;TELEFONIA
20195557;;M;22;CHILENO;;Silencioso;PROVIDENCIA                   ;METROPOLITANA;0;0;0;0;0;0;0;0;0;CELULAR REDMI NOTE 9 PRO 128GB GLACIER WHITE;TELEFONIA
19789496;;F;24;CHILENO;;Z;N/D;N/D;0;0;0;0;0;0;0;0;0;Celular LG K22 ENTEL DIRECTO TITAN;TELEFONIA
12037325;;F;41;CHILENO;;Silencioso;PROVIDENCIA                   ;METROPOLITANA;0;0;0;0;0;0;0;0;0;Celular A31 LIB OPEN BLACK;TELEFONIA
8478634;;F;61;CHILENO;;Boomers;CALAMA                        ;ANTOFAGASTA;0;0;0;0;0;0;0;0;0;CELULAR A21s 128 GB Rojo;TELEFONIA
8785399;Casado;M;59;CHILENO;;Boomers;RENCA                         ;METROPOLITANA;0;0;0;0;0;0;0;0;0;CELULAR MOTO G9 POWER 128GB MORADO SONICO OPEN;TELEFONIA
18400115;Soltero;M;29;CHILENO;INGENIERIA EN ADMINISTRACION DE EMPRESAS MENCION FINANZAS;Millenial;PROVIDENCIA                   ;METROPOLITANA;0;0;0;0;0;0;0;0;0;Celular A01 Core Azul Tri Entel;TELEFONIA
9414815;;M;59;CHILENO;;Boomers;RENCA                         ;METROPOLITANA;0;0;0;0;0;0;0;0;0;CELULAR REDMI 9 32GB CARBON GREY OPEN;TELEFONIA
12894932;;F;46;CHILENO;;X;PUENTE ALTO                   ;METROPOLITANA;0;0;0;0;0;0;0;0;0;Celular A31 LIB OPEN BLACK;TELEFONIA
16342576;Soltero;F;35;CHILENO;TECNICO AGROPECUARIO;Millenial;PROVIDENCIA                   ;METROPOLITANA;0;0;0;0;0;0;0;0;0;Celular A11 LIB OPEN BLUE;TELEFONIA
19972103;;F;23;CHILENO;;Z;PROVIDENCIA                   ;METROPOLITANA;0;0;0;0;0;0;0;0;0;CELULAR A21s 128 GB Rojo;TELEFONIA
11907148;Casado;F;50;CHILENO;;Silencioso;PROVIDENCIA                   ;METROPOLITANA;0;0;0;0;0;0;0;0;0;CELULAR MOTO E6S 32GB GRIS DIRECTO ENTEL;TELEFONIA
13349986;Casado;F;43;CHILENO;;X;RENCA                         ;METROPOLITANA;0;0;0;0;0;0;0;0;0;Celular A10S LIB OPEN RED;TELEFONIA
17460789;;F;37;CHILENO;;Millenial;SANTIAGO                      ;METROPOLITANA;0;0;0;0;0;0;0;0;0;Celular LG K22 MOVISTAR DIRECTO TITAN;TELEFONIA
10659039;;M;56;CHILENO;;Boomers;PUTAENDO                      ;VALPARAISO;0;0;0;0;0;0;0;0;0;CELULAR A12 128GB AZUL OPEN;TELEFONIA
12006870;;M;55;CHILENO;;Boomers;PROVIDENCIA                   ;METROPOLITANA;0;0;0;0;0;0;0;0;0;CELULAR VIVO Y11s PHANTOM BLACK ENTEL DIRECTO;TELEFONIA
15136953;Soltero;F;39;CHILENO;PROFESOR;X;RENCA                         ;METROPOLITANA;0;0;0;0;0;0;0;0;0;CELULAR MOTO G8 POWER LITE AZUL TRI ENTEL;TELEFONIA
5057598;Casado;F;75;CHILENO;PROFESOR;Silencioso;RENCA                         ;METROPOLITANA;0;0;0;0;0;0;0;0;0;CELULAR A12 128GB AZUL OPEN;TELEFONIA
16464896;;F;35;CHILENO;;Extranjero;N/D;N/D;0;0;0;0;0;0;0;0;0;REPETIDOR MI WIFI RANGE EXTENDER PRO XIAOMI;TELEFONIA
26376232;;M;47;VENEZOLANO;;Extranjero;MULCHEN                       ;BIO BIO;0;0;0;0;0;0;0;0;0;CELULAR A21s 128 GB Negro;TELEFONIA
19534394;;F;24;CHILENO;;Z;PROVIDENCIA                   ;METROPOLITANA;0;0;0;0;0;0;0;0;0;CELULAR REDMI 9 64GB SUNSET PURPLE TRI WOM;TELEFONIA
12867137;Casado;M;46;CHILENO;;X;SAN BERNARDO                  ;METROPOLITANA;0;0;0;0;0;0;0;0;0;CELULAR XIAOMI POCO X3 64G COBALT BLUE;TELEFONIA
16419450;Casado;M;36;CHILENO;;Silencioso;PROVIDENCIA                   ;METROPOLITANA;0;0;0;0;0;0;0;0;0;CELULAR XIAOMI REDMI 9A 32GB BLACK DIRECTO CLARO;TELEFONIA
11364219;;F;52;CHILENO;;X;MELIPILLA                     ;METROPOLITANA;0;0;0;0;0;0;0;0;0;CELULAR OWN 1026 AZUL ENTEL;TELEFONIA
8888882;;M;62;CHILENO;;Boomers;RETIRO                        ;MAULE;0;0;0;0;0;0;0;0;0;CELULAR Y8S MOVISTAR DIRECTO BLACK;TELEFONIA
17989522;;M;30;CHILENO;;Millenial;CHILLAN                       ;BIO BIO;0;0;0;0;0;0;0;0;0;CELULAR REDMI NOTE 9 PRO 128GB TROPICAL GREEN;TELEFONIA
7880172;;M;65;CHILENO;;Boomers;CURARREHUE                    ;ARAUCANIA;0;0;0;0;0;0;0;0;0;CELULAR MOTO G9 POWER 128GB MORADO SONICO OPEN;TELEFONIA
20274445;;F;23;CHILENO;;Z;PROVIDENCIA                   ;METROPOLITANA;0;0;0;0;0;0;0;0;0;CELULAR REDMI NOTE 9 PRO 128GB TROPICAL GREEN;TELEFONIA
19429172;Soltero;F;25;CHILENO;;Z;PROVIDENCIA                   ;METROPOLITANA;0;0;0;0;0;0;0;0;0;Celular TIGER V MOVISTAR DIRECTO GRIS;TELEFONIA
25685475;;F;42;COLOMBIANO;;Extranjero;CALAMA                        ;ANTOFAGASTA;0;0;0;0;0;0;0;0;0;Celular A51 128GB LIB OPEN BLANCO;TELEFONIA
20224447;;F;23;CHILENO;;Z;CURICO                        ;MAULE;0;0;0;0;0;0;0;0;0;CELULAR OWN 1026 AZUL ENTEL;TELEFONIA
15730978;;M;38;CHILENO;;Silencioso;PROVIDENCIA                   ;METROPOLITANA;0;0;0;0;0;0;0;0;0;CELULAR HUAWEI Y9 PRIME BLUE OPEN;TELEFONIA
12963880;;F;45;CHILENO;;X;RENCA                         ;METROPOLITANA;0;0;0;0;0;0;0;0;0;CELULAR HUAWEI Y5P BLUE TRIANGULADO WOM;TELEFONIA
13375551;;M;44;CHILENO;;X;SAN CARLOS                    ;BIO BIO;0;0;0;0;0;0;0;0;0;Celular A51 128GB LIB OPEN AZUL;TELEFONIA
16860467;;M;34;CHILENO;;Millenial;RENCA                         ;METROPOLITANA;0;0;0;0;0;0;0;0;0;CELULAR A12 128GB ROJO OPEN;TELEFONIA
18661037;Soltero;F;28;CHILENO;;Millenial;PROVIDENCIA                   ;METROPOLITANA;0;0;0;0;0;0;0;0;0;IPHONE 11 64GB BLACK CLARO;TELEFONIA
6154528;;F;72;CHILENO;;Silencioso;VINA DEL MAR                  ;VALPARAISO;0;0;0;0;0;0;0;0;0;CELULAR VIVO Y11S PHANTOM BLACK OPEN;TELEFONIA
17334256;;M;33;CHILENO;;Millenial;MELIPILLA                     ;METROPOLITANA;0;0;0;0;0;0;0;0;0;CELULAR A02s ROJO 32GB OPEN;TELEFONIA
9326611;;F;60;CHILENO;;Boomers;ALTO HOSPICIO;TARAPACA;0;0;0;0;0;0;0;0;0;CELULAR SAMSUNG A21S AZUL OPEN;TELEFONIA
7302559;;M;69;CHILENO;;Silencioso;TALCA                         ;MAULE;0;0;0;0;0;0;0;0;0;CELULAR VIVO Y11S PHANTOM BLACK OPEN;TELEFONIA
19713275;;F;24;CHILENO;;Millenial;PROVIDENCIA                   ;METROPOLITANA;0;0;0;0;0;0;0;0;0;Celular R340 CLARO DIRECTO NEGRO;TELEFONIA
18286104;Soltero;M;30;CHILENO;;Millenial;PROVIDENCIA                   ;METROPOLITANA;0;0;0;0;0;0;0;0;0;CELULAR MOTO G8 POWER LITE TURQUESA TRI ENTEL;TELEFONIA
10317527;Casado;F;56;CHILENO;;Boomers;RENCA                         ;METROPOLITANA;0;0;0;0;0;0;0;0;0;Celular J2 CORE CLARO DIRECTO NEGRO;TELEFONIA
14096408;;M;41;CHILENO;;X;OSORNO                        ;LOS LAGOS;0;0;0;0;0;0;0;0;0;CELULAR MOTOROLA G9 PLUS DEEP DIVE OPEN;TELEFONIA
13116638;;M;48;CHILENO;;X;RENCA                         ;METROPOLITANA;0;0;0;0;0;0;0;0;0;Celular VIVO Y11S ENTEL DIRECTO AZUL;TELEFONIA
24419819;;M;34;PERUANO;;Extranjero;PROVIDENCIA                   ;METROPOLITANA;0;0;0;0;0;0;0;0;0;Celular A10S LIB OPEN RED;TELEFONIA
15821494;Soltero;M;37;CHILENO;;Silencioso;PROVIDENCIA                   ;METROPOLITANA;0;0;0;0;0;0;0;0;0;CELULAR XIAOMI POCO X3 64G SHADOW GRAY;TELEFONIA
7299324;;F;68;CHILENO;;Silencioso;PROVIDENCIA                   ;METROPOLITANA;0;0;0;0;0;0;0;0;0;CELULAR A21s 128 GB Negro;TELEFONIA
19181560;;M;26;CHILENO;;Z;CHONCHI                       ;LOS LAGOS;0;0;0;0;0;0;0;0;0;CELULAR A21s 128 GB Negro;TELEFONIA
14283019;;M;49;CHILENO;;X;PROVIDENCIA                   ;METROPOLITANA;0;0;0;0;0;0;0;0;0;CELULAR MOTOROLA G9 PLAY ROSADO DIRECTO WOM;TELEFONIA
17870160;;F;31;CHILENO;;Millenial;PROVIDENCIA                   ;METROPOLITANA;0;0;0;0;0;0;0;0;0;Celular S20 FE LIB OPEN Cloud Lavender;TELEFONIA
16102131;;F;37;CHILENO;;Millenial;RENCA                         ;METROPOLITANA;0;0;0;0;0;0;0;0;0;CELULAR REDMI NOTE 8 64GB SPACE BLACK OPEN;TELEFONIA
5858408;Casado;M;72;CHILENO;AGRONOMO;Silencioso;PROVIDENCIA                   ;METROPOLITANA;0;0;0;0;0;0;0;0;0;Celular R340 CLARO DIRECTO NEGRO;TELEFONIA
15451425;;F;40;CHILENO;;X;N/D;N/D;0;0;0;0;0;0;0;0;0;CELULAR A02s NEGRO 32GB OPEN;TELEFONIA
15679552;;M;38;CHILENO;;Millenial;N/D;N/D;0;0;0;0;0;0;0;0;0;CELULAR SAMSUNG A71 AZUL OPEN;TELEFONIA
18557502;;M;30;CHILENO;;Millenial;TEMUCO                        ;ARAUCANIA;0;0;0;0;0;0;0;0;0;Celular A71 LIB OPEN NEGRO;TELEFONIA
15233393;;M;45;CHILENO;;X;RENCA                         ;METROPOLITANA;0;0;0;0;0;0;0;0;0;CELULAR A21s 128 GB AZUL;TELEFONIA
11465454;;F;53;CHILENO;;X;ARICA                         ;TARAPACA;0;0;0;0;0;0;0;0;0;CELULAR MOTO G9 POWER 128GB MORADO SONICO OPEN;TELEFONIA
11955912;;F;49;CHILENO;;X;SAN JAVIER                    ;MAULE;0;0;0;0;0;0;0;0;0;CELULAR NOKIA 5.3 CHARCOAL TRI ENTEL;TELEFONIA
20178375;;F;23;CHILENO;;Z;PROVIDENCIA                   ;METROPOLITANA;0;0;0;0;0;0;0;0;0;CELULAR REDMI NOTE 9 128GB ONYX BLACK OPEN;TELEFONIA
17928245;Soltero;M;30;CHILENO;INGENIERO EN MINAS;Silencioso;PROVIDENCIA                   ;METROPOLITANA;0;0;0;0;0;0;0;0;0;Celular A51 128GB LIB OPEN BLACK;TELEFONIA
25568298;;M;38;HAITIANO;;Extranjero;MELIPILLA                     ;METROPOLITANA;0;0;0;0;0;0;0;0;0;CELULAR VIVO Y11S PHANTOM BLACK OPEN;TELEFONIA
10334332;Casado;M;56;CHILENO;;Boomers;RENCA                         ;METROPOLITANA;0;0;0;0;0;0;0;0;0;CELULAR NOKIA 110 BLACK OPEN;TELEFONIA
14236491;;M;50;CHILENO;;X;LIMACHE                       ;VALPARAISO;0;0;0;0;0;0;0;0;0;Celular A51 128GB LIB OPEN AZUL;TELEFONIA
17912535;;F;31;CHILENO;;Millenial;"";"";0;0;0;0;0;0;0;0;0;CELULAR OWN 1026 AZUL ENTEL;TELEFONIA
17015543;;F;33;CHILENO;;Millenial;PROVIDENCIA                   ;METROPOLITANA;0;0;0;0;0;0;0;0;0;Celular VIVO Y11S ENTEL DIRECTO AZUL;TELEFONIA
11311723;;F;53;CHILENO;;X;RANCAGUA                      ;L.G.B.OÂ´HIGGINS;0;0;0;0;0;0;0;0;0;CELULAR REDMI NOTE 9 128GB ONYX BLACK OPEN;TELEFONIA
7444654;;M;65;CHILENO;;Boomers;CABILDO                       ;VALPARAISO;0;0;0;0;0;0;0;0;0;CELULAR POCO M3 64GB COOL BLUE;TELEFONIA
10528627;;F;53;CHILENO;;X;RENCA                         ;METROPOLITANA;0;0;0;0;0;0;0;0;0;Celular A51 128GB LIB OPEN BLACK;TELEFONIA
18547272;Soltero;M;28;CHILENO;;Millenial;PROVIDENCIA                   ;METROPOLITANA;0;0;0;0;0;0;0;0;0;CELULAR MOTO G8 POWER LITE BUNDLE AUDIFONOS TRI;TELEFONIA
20004114;;M;23;CHILENO;;Z;PROVIDENCIA                   ;METROPOLITANA;0;0;0;0;0;0;0;0;0;Celular AL3 CLARO DIRECTO NEGRO;TELEFONIA
24945577;;F;48;COLOMBIANO;;Extranjero;LA REINA                      ;METROPOLITANA;0;0;0;0;0;0;0;0;0;Celular A71 LIB OPEN PLATEADO;TELEFONIA
11588311;;F;52;CHILENO;;X;LONCOCHE                      ;ARAUCANIA;0;0;0;0;0;0;0;0;0;Celular P40 LITE LIB OPEN BLACK;TELEFONIA
19222051;Soltero;F;26;CHILENO;;Z;PROVIDENCIA                   ;METROPOLITANA;0;0;0;0;0;0;0;0;0;CELULAR A12 128GB AZUL OPEN;TELEFONIA
15209526;;F;40;CHILENO;;X;SANTA BARBARA                 ;BIO BIO;0;0;0;0;0;0;0;0;0;CELULAR HUAWEI Y8S NEGRO WOM;TELEFONIA
9431713;Casado;F;60;CHILENO;;Boomers;RENCA                         ;METROPOLITANA;0;0;0;0;0;0;0;0;0;CELULAR NOKIA 225 4G BLACK TRI ENTEL;TELEFONIA
13558075;;F;43;CHILENO;;X;TALAGANTE                     ;METROPOLITANA;0;0;0;0;0;0;0;0;0;Celular XIAOMI REDMI 9A 32 GB DIRECTO CLARO;TELEFONIA
18865347;;F;26;CHILENO;;Z;N/D;N/D;0;0;0;0;0;0;0;0;0;CELULAR REDMI NOTE 9 128GB ONYX BLACK OPEN;TELEFONIA
13289087;Casado;M;44;CHILENO;;X;PROVIDENCIA                   ;METROPOLITANA;0;0;0;0;0;0;0;0;0;Celular NOKIA 4.2 ENTEL DIRECTO NEGRO;TELEFONIA
8886454;;M;60;CHILENO;;Boomers;SAN CLEMENTE                  ;MAULE;0;0;0;0;0;0;0;0;0;CELULAR MOTO ONE FUSION 64GB VERDE 64GB OPEN;TELEFONIA
11853631;;F;51;CHILENO;;X;PROVIDENCIA                   ;METROPOLITANA;0;0;0;0;0;0;0;0;0;CELULAR MOTO G8 POWER LITE BUNDLE AUDIFONOS TRI;TELEFONIA
13356680;;F;44;CHILENO;;X;CALAMA                        ;ANTOFAGASTA;0;0;0;0;0;0;0;0;0;Celular A51 128GB LIB OPEN AZUL;TELEFONIA
7096399;;M;67;CHILENO;;Boomers;PROVIDENCIA                   ;METROPOLITANA;0;0;0;0;0;0;0;0;0;Celular XIAOMI REDMI 9A 32 GB DIRECTO CLARO;TELEFONIA
8655581;;F;46;CHILENO;;X;RENCA                         ;METROPOLITANA;0;0;0;0;0;0;0;0;0;Celular A31 LIB OPEN BLACK;TELEFONIA
18617931;;M;27;CHILENO;;Millenial;PROVIDENCIA                   ;METROPOLITANA;0;0;0;0;0;0;0;0;0;CELULAR XIAOMI MI 10T 128GB COSMIC BLACK OPEN;TELEFONIA
17984218;;M;31;CHILENO;;Millenial;LOS VILOS                     ;COQUIMBO;0;0;0;0;0;0;0;0;0;Celular A10S MOVISTAR DIRECTO BLACK;TELEFONIA
17542198;;M;31;CHILENO;;Millenial;RENCA                         ;METROPOLITANA;0;0;0;0;0;0;0;0;0;Celular NOKIA 4.2 ENTEL DIRECTO NEGRO;TELEFONIA
18748220;;F;28;CHILENO;;Millenial;SAN BERNARDO                  ;METROPOLITANA;0;0;0;0;0;0;0;0;0;CELULAR MOTOROLA G9 PLUS CHAMPAGNE ROSE OPEN;TELEFONIA
14186656;;M;40;CHILENO;;X;PROVIDENCIA                   ;METROPOLITANA;0;0;0;0;0;0;0;0;0;CELULAR XIAOMI MI 10T 128GB COSMIC BLACK OPEN;TELEFONIA
18786101;Soltero;M;27;CHILENO;;Silencioso;PROVIDENCIA                   ;METROPOLITANA;0;0;0;0;0;0;0;0;0;CELULAR REDMI NOTE 8 64GB NEPTUNE BLUE OPEN;TELEFONIA
6758656;Soltero;F;73;CHILENO;;Silencioso;NANCAGUA                      ;L.G.B.OÂ´HIGGINS;0;0;0;0;0;0;0;0;0;CELULAR MOTO G8 POWER LITE TURQUESA TRI ENTEL;TELEFONIA
12060727;;F;55;CHILENO;;Boomers;PROVIDENCIA                   ;METROPOLITANA;0;0;0;0;0;0;0;0;0;Celular A51 128GB LIB OPEN AZUL;TELEFONIA
10755269;;F;59;CHILENO;;Boomers;CANETE                        ;BIO BIO;0;0;0;0;0;0;0;0;0;CELULAR SAMSUNG A21S AZUL OPEN;TELEFONIA
18630795;;M;27;CHILENO;;Millenial;HUECHURABA                    ;METROPOLITANA;0;0;0;0;0;0;0;0;0;CELULAR A21s 128 GB AZUL;TELEFONIA
9842405;;F;58;CHILENO;;Boomers;OSORNO                        ;LOS LAGOS;0;0;0;0;0;0;0;0;0;Celular A10S LIB OPEN NEGRO;TELEFONIA
5952132;Soltero;M;75;CHILENO;;Silencioso;RENCA                         ;METROPOLITANA;0;0;0;0;0;0;0;0;0;CELULAR NOKIA 225 4G BLACK TRI ENTEL;TELEFONIA
15244810;;F;40;CHILENO;;X;PROVIDENCIA                   ;METROPOLITANA;0;0;0;0;0;0;0;0;0;Celular G8 POWER LITE WOM DIRECTO TURQUESA;TELEFONIA
8595462;;M;62;CHILENO;;Boomers;RENCA                         ;METROPOLITANA;0;0;0;0;0;0;0;0;0;Celular a11 azul samsung WOM;TELEFONIA
11505636;;F;52;CHILENO;;X;ILLAPEL                       ;COQUIMBO;0;0;0;0;0;0;0;0;0;Celular A10S LIB OPEN NEGRO;TELEFONIA
27019975;;M;31;VENEZOLANO;;Extranjero;TALCAHUANO                    ;BIO BIO;0;0;0;0;0;0;0;0;0;CELULAR SAMSUNG A71 AZUL OPEN;TELEFONIA
7924153;Casado;M;63;CHILENO;;Boomers;RENCA                         ;METROPOLITANA;0;0;0;0;0;0;0;0;0;CELULAR SAMSUNG A01 NEGRO DIRECTO WOM;TELEFONIA
19661192;;M;24;CHILENO;;Silencioso;PROVIDENCIA                   ;METROPOLITANA;0;0;0;0;0;0;0;0;0;CELULAR REDMI NOTE 8 64GB NEPTUNE BLUE OPEN;TELEFONIA
11660257;;F;52;CHILENO;;X;PUENTE ALTO                   ;METROPOLITANA;0;0;0;0;0;0;0;0;0;CELULAR REDMI NOTE 9 128GB ONYX BLACK OPEN;TELEFONIA
8911954;;M;65;CHILENO;;Boomers;LOS VILOS                     ;COQUIMBO;0;0;0;0;0;0;0;0;0;CELULAR A02s NEGRO 32GB OPEN;TELEFONIA
14526768;;F;48;CHILENO;;X;VILLARICA                     ;ARAUCANIA;0;0;0;0;0;0;0;0;0;CELULAR MOTO ONE FUSION 64GB VERDE 64GB OPEN;TELEFONIA
16306411;;F;36;CHILENO;;Millenial;CALERA                        ;VALPARAISO;0;0;0;0;0;0;0;0;0;Celular LG K22 ENTEL DIRECTO TITAN;TELEFONIA
19226649;;F;26;CHILENO;;Z;PROVIDENCIA                   ;METROPOLITANA;0;0;0;0;0;0;0;0;0;CELULAR XIAOMI POCO X3 64G COBALT BLUE;TELEFONIA
6575830;;M;65;CHILENO;;Boomers;RENCA                         ;METROPOLITANA;0;0;0;0;0;0;0;0;0;Celular Y9S LIB OPEN BLACK;TELEFONIA
16702589;;M;34;CHILENO;;Millenial;PUTAENDO                      ;VALPARAISO;0;0;0;0;0;0;0;0;0;CELULAR MOTO G8 POWER LITE AZUL TRI ENTEL;TELEFONIA
6944420;;F;70;CHILENO;;Silencioso;PUNTA ARENAS                  ;MAGALLANES;0;0;0;0;0;0;0;0;0;CELULAR NOKIA 110 BLACK OPEN;TELEFONIA
9928187;;M;55;CHILENO;;Boomers;CAUQUENES                     ;MAULE;0;0;0;0;0;0;0;0;0;CELULAR MOTO ONE FUSION 64GB VERDE 64GB OPEN;TELEFONIA
13365420;Soltero;M;44;CHILENO;;X;RENCA                         ;METROPOLITANA;0;0;0;0;0;0;0;0;0;CELULAR MOTO ONE FUSION 64GB VERDE 64GB OPEN;TELEFONIA
6889573;;M;68;CHILENO;;Boomers;PROVIDENCIA                   ;METROPOLITANA;0;0;0;0;0;0;0;0;0;CELULAR A21s 128 GB AZUL;TELEFONIA
19056021;Soltero;F;27;CHILENO;;Silencioso;PROVIDENCIA                   ;METROPOLITANA;0;0;0;0;0;0;0;0;0;Celular A01 Core Azul Tri Entel;TELEFONIA
14581061;;F;43;CHILENO;;X;PROVIDENCIA                   ;METROPOLITANA;0;0;0;0;0;0;0;0;0;CELULAR REDMI NOTE 8 64GB SPACE BLACK OPEN;TELEFONIA
19991282;;F;24;CHILENO;;Z;MAIPU                         ;METROPOLITANA;0;0;0;0;0;0;0;0;0;CELULAR REDMI NOTE 8 64GB NEPTUNE BLUE OPEN;TELEFONIA
9733042;;M;58;CHILENO;;Boomers;PROVIDENCIA                   ;METROPOLITANA;0;0;0;0;0;0;0;0;0;Celular SA3 CLARO DIRECTO BLACK;TELEFONIA
12473426;;M;48;CHILENO;;X;SAN BERNARDO                  ;METROPOLITANA;0;0;0;0;0;0;0;0;0;CELULAR SAMSUNG A71 AZUL OPEN;TELEFONIA
12717935;;M;47;CHILENO;;X;ILLAPEL                       ;COQUIMBO;0;0;0;0;0;0;0;0;0;Celular A10S LIB OPEN RED;TELEFONIA
18629250;;F;28;CHILENO;;Millenial;"";"";0;0;0;0;0;0;0;0;0;CELULAR A02s NEGRO 32GB OPEN;TELEFONIA
13111713;;F;45;CHILENO;;X;MOSTAZAL                      ;L.G.B.OÂ´HIGGINS;0;0;0;0;0;0;0;0;0;Celular A10S MOVISTAR DIRECTO BLACK;TELEFONIA
15740158;;F;38;CHILENO;;X;LA SERENA                     ;COQUIMBO;0;0;0;0;0;0;0;0;0;CELULAR SAMSUNG A02S 32GB NEGRO DIRECTO ENTEL;TELEFONIA
6522332;;F;71;CHILENO;;Silencioso;TEMUCO                        ;ARAUCANIA;0;0;0;0;0;0;0;0;0;Celular A01 LIB OPEN AZUL;TELEFONIA
16880259;;F;34;CHILENO;;Millenial;PROVIDENCIA                   ;METROPOLITANA;0;0;0;0;0;0;0;0;0;CELULAR NOKIA 225 4G BLACK TRI ENTEL;TELEFONIA
15107014;;M;39;CHILENO;;X;PROVIDENCIA                   ;METROPOLITANA;0;0;0;0;0;0;0;0;0;CELULAR REDMI 9 64GB SUNSET PURPLE TRI WOM;TELEFONIA
25958898;;F;30;VENEZOLANO;;Extranjero;RANCAGUA                      ;L.G.B.OÂ´HIGGINS;0;0;0;0;0;0;0;0;0;Celular Y9 PRIME LIB OPEN VERDE;TELEFONIA
16040432;;M;37;CHILENO;;Millenial;SANTIAGO                      ;METROPOLITANA;0;0;0;0;0;0;0;0;0;IPHONE 8 64 GB LIB OPEN DORADO;TELEFONIA
11999171;;M;50;CHILENO;;X;LINARES                       ;MAULE;0;0;0;0;0;0;0;0;0;CELULAR REDMI NOTE 9 PRO 128GB GLACIER WHITE;TELEFONIA
18243792;;F;30;CHILENO;;Millenial;QUILICURA                     ;METROPOLITANA;0;0;0;0;0;0;0;0;0;CELULAR LG K22 TRIANGULADO WOM;TELEFONIA
14311814;;F;46;CHILENO;;X;RENCA                         ;METROPOLITANA;0;0;0;0;0;0;0;0;0;CELULAR REDMI 9A GRANITE GREY DIRECTO MOVISTAR;TELEFONIA
12864420;;F;47;CHILENO;;X;LA FLORIDA                    ;METROPOLITANA;0;0;0;0;0;0;0;0;0;IPHONE 7 32GB LIB OPEN NEGRO;TELEFONIA
17800440;;F;31;CHILENO;;Millenial;YERBAS BUENAS                 ;MAULE;0;0;0;0;0;0;0;0;0;Celular A71 LIB OPEN PLATEADO;TELEFONIA
8828573;;F;46;CHILENO;;X;RENCA                         ;METROPOLITANA;0;0;0;0;0;0;0;0;0;CELULAR REDMI NOTE 9 PRO 128GB TROPICAL GREEN;TELEFONIA
7500309;;M;69;CHILENO;;Silencioso;PUDAHUEL                      ;METROPOLITANA;0;0;0;0;0;0;0;0;0;Celular a11 azul samsung WOM;TELEFONIA
5838951;;M;70;CHILENO;;Silencioso;RENCA                         ;METROPOLITANA;0;0;0;0;0;0;0;0;0;CELULAR REDMI NOTE 9 128GB ONYX BLACK OPEN;TELEFONIA
20037117;;M;23;CHILENO;;Silencioso;PROVIDENCIA                   ;METROPOLITANA;0;0;0;0;0;0;0;0;0;CELULAR REDMI NOTE 8 64GB SPACE BLACK OPEN;TELEFONIA
8429592;;F;66;CHILENO;;Boomers;TOLTEN                        ;ARAUCANIA;0;0;0;0;0;0;0;0;0;Celular A10S MOVISTAR DIRECTO BLACK;TELEFONIA
19516823;;F;25;CHILENO;;Silencioso;PROVIDENCIA                   ;METROPOLITANA;0;0;0;0;0;0;0;0;0;Celular A51 128GB LIB OPEN BLANCO;TELEFONIA
18816134;;F;27;CHILENO;;Millenial;CHIGUAYANTE                   ;BIO BIO;0;0;0;0;0;0;0;0;0;CELULAR NOKIA 5.3 CHARCOAL TRI ENTEL;TELEFONIA
18447183;;F;29;CHILENO;;Silencioso;PROVIDENCIA                   ;METROPOLITANA;0;0;0;0;0;0;0;0;0;Celular S20 FE LIB OPEN Cloud Lavender;TELEFONIA
7921405;;F;61;CHILENO;;Boomers;RENCA                         ;METROPOLITANA;0;0;0;0;0;0;0;0;0;Celular SAMSUNG A01 CORE BLACK CLARO;TELEFONIA
17511776;;F;32;CHILENO;;Millenial;LOS LAGOS                     ;LOS RIOS;0;0;0;0;0;0;0;0;0;Celular a11 azul samsung WOM;TELEFONIA
5960723;;F;74;CHILENO;;Silencioso;CATEMU                        ;VALPARAISO;0;0;0;0;0;0;0;0;0;Celular A71 LIB OPEN NEGRO;TELEFONIA
20179434;;F;22;CHILENO;;Z;PROVIDENCIA                   ;METROPOLITANA;0;0;0;0;0;0;0;0;0;CELULAR MOTOROLA G8 POWER LITE AZUL WOM;TELEFONIA
17653950;;F;31;CHILENO;;Millenial;VALDIVIA                      ;LOS LAGOS;0;0;0;0;0;0;0;0;0;CELULAR SAMSUNG A21S AZUL OPEN;TELEFONIA
17791711;;F;31;CHILENO;;Millenial;VINA DEL MAR                  ;VALPARAISO;0;0;0;0;0;0;0;0;0;CELULAR LG K41S TITAN DIRECTO MOVISTAR;TELEFONIA
25602699;;M;30;HAITIANO;;Extranjero;MACUL                         ;METROPOLITANA;0;0;0;0;0;0;0;0;0;Celular S10 LITE LIB OPEN AZUL;TELEFONIA
18768760;;M;28;CHILENO;;Millenial;PROVIDENCIA                   ;METROPOLITANA;0;0;0;0;0;0;0;0;0;Celular LG K22 MOVISTAR DIRECTO TITAN;TELEFONIA
12021707;;M;53;CHILENO;;X;"";"";0;0;0;0;0;0;0;0;0;CELULAR MOTO G8 POWER LITE TURQUESA TRI ENTEL;TELEFONIA
13814325;Soltero;M;41;CHILENO;;X;RENCA                         ;METROPOLITANA;0;0;0;0;0;0;0;0;0;Celular A10S LIB OPEN NEGRO;TELEFONIA
18132820;Soltero;F;30;CHILENO;PSICOLOGO;Millenial;PROVIDENCIA                   ;METROPOLITANA;0;0;0;0;0;0;0;0;0;CELULAR MOTO G9 POWER 128GB MORADO SONICO OPEN;TELEFONIA
12248434;Casado;M;50;CHILENO;;X;RENCA                         ;METROPOLITANA;0;0;0;0;0;0;0;0;0;Celular SAMSUNG A21s CLARO DIRECTO BLACK;TELEFONIA
19844525;;M;24;CHILENO;;Z;PROVIDENCIA                   ;METROPOLITANA;0;0;0;0;0;0;0;0;0;CELULAR SAMSUNG A21S AZUL OPEN;TELEFONIA
11509416;;F;52;CHILENO;;X;COQUIMBO                      ;COQUIMBO;0;0;0;0;0;0;0;0;0;CELULAR VIVO Y11s PHANTOM BLACK ENTEL DIRECTO;TELEFONIA
11422341;;M;53;CHILENO;;X;PROVIDENCIA                   ;METROPOLITANA;0;0;0;0;0;0;0;0;0;CELULAR HUAWEI Y8S NEGRO WOM;TELEFONIA
17847432;;M;31;CHILENO;;Millenial;PROVIDENCIA                   ;METROPOLITANA;0;0;0;0;0;0;0;0;0;CELULAR REDMI NOTE 8 64GB NEPTUNE BLUE OPEN;TELEFONIA
10466562;Casado;M;54;CHILENO;;X;RENCA                         ;METROPOLITANA;0;0;0;0;0;0;0;0;0;Celular XIAOMI REDMI 9A 32 GB DIRECTO CLARO;TELEFONIA
19600749;;F;25;CHILENO;;Z;N/D;N/D;0;0;0;0;0;0;0;0;0;Celular A51 128GB LIB OPEN BLACK;TELEFONIA
12541287;;F;49;CHILENO;;X;CASTRO                        ;LOS LAGOS;0;0;0;0;0;0;0;0;0;Celular A11 LIB OPEN BLUE;TELEFONIA
12722315;;M;46;CHILENO;;X;PROVIDENCIA                   ;METROPOLITANA;0;0;0;0;0;0;0;0;0;Celular VIVO Y11S ENTEL DIRECTO AZUL;TELEFONIA
8365140;;M;51;CHILENO;;Extranjero;PANGUIPULLI                   ;LOS RIOS;0;0;0;0;0;0;0;0;0;Celular Y9 PRIME LIB OPEN VERDE;TELEFONIA
5828792;;M;73;CHILENO;;Silencioso;PROVIDENCIA                   ;METROPOLITANA;0;0;0;0;0;0;0;0;0;CELULAR OWN 1026 AZUL ENTEL;TELEFONIA
15345684;;M;39;CHILENO;;X;PROVIDENCIA                   ;METROPOLITANA;0;0;0;0;0;0;0;0;0;Celular AL3 CLARO DIRECTO NEGRO;TELEFONIA
15503587;;M;39;CHILENO;;X;N/D;N/D;0;0;0;0;0;0;0;0;0;Celular P40 LITE LIB OPEN GREEN;TELEFONIA
15755253;;M;38;CHILENO;;Millenial;VILLA ALEGRE                  ;MAULE;0;0;0;0;0;0;0;0;0;Celular A31 LIB OPEN ROJO;TELEFONIA
10824775;;M;55;CHILENO;;Boomers;RENCA                         ;METROPOLITANA;0;0;0;0;0;0;0;0;0;CELULAR MOTOROLA G7 PLAY DEEP INDIGO TEL;TELEFONIA
13760909;;M;43;CHILENO;;X;RENCA                         ;METROPOLITANA;0;0;0;0;0;0;0;0;0;Celular G8 POWER LITE MOVISTAR DIRECTO AZUL;TELEFONIA
11734712;;F;50;CHILENO;;X;PROVIDENCIA                   ;METROPOLITANA;0;0;0;0;0;0;0;0;0;CELULAR REDMI 9 64GB SUNSET PURPLE TRI WOM;TELEFONIA
15179061;;M;39;CHILENO;;Silencioso;PROVIDENCIA                   ;METROPOLITANA;0;0;0;0;0;0;0;0;0;Celular NOTE 10 LITE LIB OPEN NEGRO;TELEFONIA
8541843;;M;62;CHILENO;;Boomers;LA CISTERNA                   ;METROPOLITANA;0;0;0;0;0;0;0;0;0;CELULAR A12 128GB NEGRO OPEN;TELEFONIA
12206902;;M;50;CHILENO;;X;CHANCO                        ;MAULE;0;0;0;0;0;0;0;0;0;Celular A31 LIB OPEN AZUL;TELEFONIA
15434800;;M;40;CHILENO;;X;PROVIDENCIA                   ;METROPOLITANA;0;0;0;0;0;0;0;0;0;CELULAR LG K41S TITAN DIRECTO MOVISTAR;TELEFONIA
5347145;;M;76;CHILENO;;Silencioso;RENCA                         ;METROPOLITANA;0;0;0;0;0;0;0;0;0;Celular R340 CLARO DIRECTO NEGRO;TELEFONIA
6738358;Casado;M;70;CHILENO;;Silencioso;RENCA                         ;METROPOLITANA;0;0;0;0;0;0;0;0;0;CELULAR MOTO G8 POWER LITE TURQUESA TRI ENTEL;TELEFONIA
19899898;;M;24;CHILENO;;Z;"";"";0;0;0;0;0;0;0;0;0;Celular A51 128GB LIB OPEN BLANCO;TELEFONIA
7992713;;M;63;CHILENO;;Boomers;PROVIDENCIA                   ;METROPOLITANA;0;0;0;0;0;0;0;0;0;CELULAR OWN 1026 AZUL ENTEL;TELEFONIA
10304506;;F;57;CHILENO;;Boomers;CALERA DE TANGO               ;METROPOLITANA;0;0;0;0;0;0;0;0;0;Celular A31 LIB OPEN AZUL;TELEFONIA
8889264;;M;61;CHILENO;;Boomers;PROVIDENCIA                   ;METROPOLITANA;0;0;0;0;0;0;0;0;0;Celular TIGER V SENIOR CLARO DIRECTO NEGRO;TELEFONIA
19295833;Soltero;M;26;CHILENO;;Z;PROVIDENCIA                   ;METROPOLITANA;0;0;0;0;0;0;0;0;0;CELULAR LG K22 TRIANGULADO WOM;TELEFONIA
6662467;Casado;F;66;CHILENO;;Boomers;RENCA                         ;METROPOLITANA;0;0;0;0;0;0;0;0;0;Celular A11 LIB OPEN BLACK;TELEFONIA
15898404;Casado;F;38;CHILENO;;Millenial;PROVIDENCIA                   ;METROPOLITANA;0;0;0;0;0;0;0;0;0;IPHONE 7 32GB LIB OPEN SILVER;TELEFONIA
10182745;;M;57;CHILENO;;Boomers;OVALLE                        ;COQUIMBO;0;0;0;0;0;0;0;0;0;Celular A11 LIB OPEN BLACK;TELEFONIA
15527972;;F;35;CHILENO;;Millenial;N/D;N/D;0;0;0;0;0;0;0;0;0;CELULAR SAMSUNG A21S NEGRO OPEN;TELEFONIA
11152141;;F;55;CHILENO;;Boomers;MAIPU                         ;METROPOLITANA;0;0;0;0;0;0;0;0;0;CELULAR MOTO G8 POWER LITE TURQUESA TRI ENTEL;TELEFONIA
27119770;;F;37;VENEZOLANO;;Extranjero;PROVIDENCIA                   ;METROPOLITANA;0;0;0;0;0;0;0;0;0;CELULAR SAMSUNG A71 AZUL OPEN;TELEFONIA
9180697;;M;55;CHILENO;;Boomers;LOS ANDES                     ;VALPARAISO;0;0;0;0;0;0;0;0;0;Celular LG K22 ENTEL DIRECTO TITAN;TELEFONIA
15871697;;M;38;CHILENO;;Millenial;PROVIDENCIA                   ;METROPOLITANA;0;0;0;0;0;0;0;0;0;Celular P40 LITE LIB OPEN BLACK;TELEFONIA
11365048;;F;53;CHILENO;;X;PUNITAQUI                     ;COQUIMBO;0;0;0;0;0;0;0;0;0;Celular A11 LIB OPEN WHITE;TELEFONIA
25769985;;M;28;BOLIVIANO;;Extranjero;N/D;N/D;0;0;0;0;0;0;0;0;0;Celular G8 POWER LITE MOVISTAR DIRECTO AZUL;TELEFONIA
12692823;;M;48;CHILENO;;X;RENCA                         ;METROPOLITANA;0;0;0;0;0;0;0;0;0;CELULAR XIAOMI REDMI 9C AZUL DIRECTO ENTEL;TELEFONIA
8738326;Casado;M;62;CHILENO;;Boomers;PROVIDENCIA                   ;METROPOLITANA;0;0;0;0;0;0;0;0;0;Celular SAMSUNG A01 CORE BLACK CLARO;TELEFONIA
13529959;Casado;M;43;CHILENO;;X;RENCA                         ;METROPOLITANA;0;0;0;0;0;0;0;0;0;CELULAR NOKIA 225 4G BLACK TRI ENTEL;TELEFONIA
17664213;;M;31;CHILENO;;Extranjero;SALAMANCA;COQUIMBO;0;0;0;0;0;0;0;0;0;IPHONE 7 LIB OPEN NEGRO;TELEFONIA
7790247;;M;65;CHILENO;;Boomers;VICUNA                        ;COQUIMBO;0;0;0;0;0;0;0;0;0;Celular NOKIA 1.3 NEGRO WOM;TELEFONIA
7213920;;M;69;CHILENO;;Silencioso;VALPARAISO                    ;VALPARAISO;0;0;0;0;0;0;0;0;0;Celular ZTE A3 2020 WOM DIRECTO NEGRO;TELEFONIA
17578776;Casado;F;31;CHILENO;;Z;PROVIDENCIA                   ;METROPOLITANA;0;0;0;0;0;0;0;0;0;Celular A31 LIB OPEN AZUL;TELEFONIA
11543069;;F;52;CHILENO;;X;RIO NEGRO                     ;LOS LAGOS;0;0;0;0;0;0;0;0;0;CELULAR REDMI NOTE 8 64GB SPACE BLACK OPEN;TELEFONIA
7139241;;F;65;CHILENO;;Extranjero;VALDIVIA                      ;LOS RIOS;0;0;0;0;0;0;0;0;0;Celular A3 LITE ENTEL TRIANGULADO NEGRO;TELEFONIA
16616788;;M;35;CHILENO;;Millenial;RENCA                         ;METROPOLITANA;0;0;0;0;0;0;0;0;0;CELULAR LG K22 TRIANGULADO WOM;TELEFONIA
9649746;;M;58;CHILENO;;Boomers;PROVIDENCIA                   ;METROPOLITANA;0;0;0;0;0;0;0;0;0;Celular a11 azul samsung WOM;TELEFONIA
6763706;;F;71;CHILENO;;Silencioso;AISEN                         ;AYSEN;0;0;0;0;0;0;0;0;0;Celular A01 Core Azul Tri Entel;TELEFONIA
6365158;;F;76;CHILENO;;Silencioso;RANCAGUA                      ;L.G.B.OÂ´HIGGINS;0;0;0;0;0;0;0;0;0;Celular A10S LIB OPEN BLUE;TELEFONIA
27146475;;F;28;NO INFORMA NACIONALIDAD;;Extranjero;PROVIDENCIA                   ;METROPOLITANA;0;0;0;0;0;0;0;0;0;Celular A51 128GB LIB OPEN BLACK;TELEFONIA
13003270;;F;46;CHILENO;;X;PROVIDENCIA                   ;METROPOLITANA;0;0;0;0;0;0;0;0;0;CELULAR REDMI NOTE 8 64GB SPACE BLACK OPEN;TELEFONIA
10294343;;M;52;CHILENO;;X;PROVIDENCIA                   ;METROPOLITANA;0;0;0;0;0;0;0;0;0;Celular NOKIA 2.3 ENTEL DIRECTO CARBON;TELEFONIA
15016791;Soltero;F;39;CHILENO;ANALISTA DE SISTEMAS;X;CALAMA                        ;ANTOFAGASTA;0;0;0;0;0;0;0;0;0;Celular XIAOMI REDMI 9A 32 GB DIRECTO CLARO;TELEFONIA
8763027;;M;62;CHILENO;;Boomers;PROVIDENCIA                   ;METROPOLITANA;0;0;0;0;0;0;0;0;0;Celular R340 CLARO DIRECTO NEGRO;TELEFONIA
17855935;;M;31;CHILENO;;Millenial;COIHAIQUE                     ;AYSEN;0;0;0;0;0;0;0;0;0;Celular a11 azul samsung WOM;TELEFONIA
16784767;Soltero;M;34;CHILENO;INGENIERO EN PREVENCION DE RIESGOS;Millenial;PROVIDENCIA                   ;METROPOLITANA;0;0;0;0;0;0;0;0;0;CELULAR MOTO G9 POWER 128GB VERDE GRANITO OPEN;TELEFONIA
18190909;;M;29;CHILENO;;Millenial;PUENTE ALTO                   ;METROPOLITANA;0;0;0;0;0;0;0;0;0;Celular A51 128GB LIB OPEN BLACK;TELEFONIA
9006834;;F;62;CHILENO;;Boomers;PUENTE ALTO                   ;METROPOLITANA;0;0;0;0;0;0;0;0;0;CELULAR LG K22 TRIANGULADO WOM;TELEFONIA
16234567;Casado;M;36;CHILENO;TECNICO EN ADMINISTRACION DE EMPRESAS;Millenial;PROVIDENCIA                   ;METROPOLITANA;0;0;0;0;0;0;0;0;0;Celular A51 128GB LIB OPEN BLACK;TELEFONIA
20312193;;F;26;CHILENO;;Millenial;PROVIDENCIA                   ;METROPOLITANA;0;0;0;0;0;0;0;0;0;CELULAR MOTOROLA G8 POWER LITE AZUL WOM;TELEFONIA
20239991;;F;23;CHILENO;;Z;RENCA                         ;METROPOLITANA;0;0;0;0;0;0;0;0;0;CELULAR REDMI NOTE 9S 64 GB GLACIER WHITE;TELEFONIA
17549699;Soltero;M;30;CHILENO;;Millenial;PROVIDENCIA                   ;METROPOLITANA;0;0;0;0;0;0;0;0;0;CELULAR HUAWEI Y7A GOLD OPEN;TELEFONIA
19773818;;M;24;CHILENO;;Z;PROVIDENCIA                   ;METROPOLITANA;0;0;0;0;0;0;0;0;0;CELULAR REDMI NOTE 8 64GB NEPTUNE BLUE OPEN;TELEFONIA
12420445;;F;49;CHILENO;;X;OVALLE                        ;COQUIMBO;0;0;0;0;0;0;0;0;0;Celular A31 LIB OPEN AZUL;TELEFONIA
9486291;;F;59;CHILENO;;Boomers;PUENTE ALTO                   ;METROPOLITANA;0;0;0;0;0;0;0;0;0;Celular ZTE A3 2020 ENTEL DIRECTO GRIS;TELEFONIA
18558982;;M;28;CHILENO;;Millenial;LAMPA                         ;METROPOLITANA;0;0;0;0;0;0;0;0;0;CELULAR XIAOMI REDMI 9C 64GB MIDNIGHT GRAY;TELEFONIA
17508605;;F;32;CHILENO;;Millenial;LA FLORIDA                    ;METROPOLITANA;0;0;0;0;0;0;0;0;0;Celular SAMSUNG A11 32GB ENTEL DIRECTO NEGRO;TELEFONIA
8904123;;M;61;CHILENO;;Boomers;PUENTE ALTO                   ;METROPOLITANA;0;0;0;0;0;0;0;0;0;Celular NOKIA 1.3 NEGRO WOM;TELEFONIA
9185036;Viudo;M;60;CHILENO;AGROINDUSTRIA;Boomers;LA FLORIDA                    ;METROPOLITANA;0;0;0;0;0;0;0;0;0;Celular A3 LITE ENTEL TRIANGULADO NEGRO;TELEFONIA
10955551;;F;49;CHILENO;;X;PUCON                         ;ARAUCANIA;0;0;0;0;0;0;0;0;0;Celular SAMSUNG A01 CORE BLACK CLARO;TELEFONIA
13954763;;F;42;CHILENO;;X;N/D;N/D;0;0;0;0;0;0;0;0;0;Celular XIAOMI REDMI 9C 64 GB DIRECTO CLARO;TELEFONIA
11026056;;F;56;CHILENO;;Boomers;RENCA                         ;METROPOLITANA;0;0;0;0;0;0;0;0;0;CELULAR SAMSUNG A01 CORE BLACK WOM;TELEFONIA
16128754;;F;36;CHILENO;;Millenial;MACUL                         ;METROPOLITANA;0;0;0;0;0;0;0;0;0;Celular A51 128GB LIB OPEN BLACK;TELEFONIA
11929601;Casado;M;50;CHILENO;;X;RENCA                         ;METROPOLITANA;0;0;0;0;0;0;0;0;0;Celular LG K22 ENTEL DIRECTO TITAN;TELEFONIA
11593266;;M;54;CHILENO;;X;PROVIDENCIA                   ;METROPOLITANA;0;0;0;0;0;0;0;0;0;CELULAR SAMSUNG A21S AZUL OPEN;TELEFONIA
19728663;;M;24;CHILENO;;Z;PETORCA                       ;VALPARAISO;0;0;0;0;0;0;0;0;0;CELULAR REDMI NOTE 8 64GB SPACE BLACK OPEN;TELEFONIA
13809823;;F;42;CHILENO;;X;PERQUENCO                     ;ARAUCANIA;0;0;0;0;0;0;0;0;0;Celular A01 LIB OPEN ROJO;TELEFONIA
19046012;Soltero;F;27;CHILENO;;Z;PROVIDENCIA                   ;METROPOLITANA;0;0;0;0;0;0;0;0;0;Celular A10S LIB OPEN BLUE;TELEFONIA
15061259;;F;40;CHILENO;;X;PROVIDENCIA                   ;METROPOLITANA;0;0;0;0;0;0;0;0;0;Celular LG K22 ENTEL DIRECTO TITAN;TELEFONIA
16943446;Soltero;M;34;CHILENO;TECNICO EN ELECTRONICA;Millenial;RENCA                         ;METROPOLITANA;0;0;0;0;0;0;0;0;0;CELULAR XIAOMI REDMI 9A 32GB SKY BLUE TRI WOM;TELEFONIA
16320992;;M;35;CHILENO;;Millenial;RENCA                         ;METROPOLITANA;0;0;0;0;0;0;0;0;0;CELULAR NOKIA 7.2 GREEN TRI WOM;TELEFONIA
7938352;Casado;M;65;CHILENO;;Boomers;RENCA                         ;METROPOLITANA;0;0;0;0;0;0;0;0;0;CELULAR MOTOROLA G9 PLAY 64GB SPRING PINK OPEN;TELEFONIA
9816036;;F;58;CHILENO;;Boomers;CONCEPCION                    ;BIO BIO;0;0;0;0;0;0;0;0;0;CELULAR MOTO ONE FUSION 64GB VERDE 64GB OPEN;TELEFONIA
9694676;;F;58;CHILENO;;Boomers;CHIGUAYANTE                   ;BIO BIO;0;0;0;0;0;0;0;0;0;Celular G8 POWER LITE MOVISTAR DIRECTO AZUL;TELEFONIA
15222140;;M;39;CHILENO;;X;PROVIDENCIA                   ;METROPOLITANA;0;0;0;0;0;0;0;0;0;Celular A11 LIB OPEN BLUE;TELEFONIA
16552467;Soltero;M;35;CHILENO;;Millenial;PROVIDENCIA                   ;METROPOLITANA;0;0;0;0;0;0;0;0;0;Celular A11 LIB OPEN BLUE;TELEFONIA
24075603;;F;44;PERUANO;;Extranjero;LA REINA                      ;METROPOLITANA;0;0;0;0;0;0;0;0;0;Celular A51 128GB LIB OPEN BLACK;TELEFONIA
8622902;;M;60;CHILENO;;Boomers;QUILLOTA                      ;VALPARAISO;0;0;0;0;0;0;0;0;0;CELULAR HUAWEI Y9S BLACK DIRECTO CLARO;TELEFONIA
9591536;;M;60;CHILENO;;Boomers;CALAMA                        ;ANTOFAGASTA;0;0;0;0;0;0;0;0;0;Celular A11 LIB OPEN BLUE;TELEFONIA
13561302;;M;43;CHILENO;;X;PROVIDENCIA                   ;METROPOLITANA;0;0;0;0;0;0;0;0;0;Celular A01 Core Azul Tri Entel;TELEFONIA
17462458;;M;32;CHILENO;;Millenial;PROVIDENCIA                   ;METROPOLITANA;0;0;0;0;0;0;0;0;0;Celular A3 LITE ENTEL TRIANGULADO NEGRO;TELEFONIA
19975721;;F;22;CHILENO;;Millenial;N/D;N/D;0;0;0;0;0;0;0;0;0;CELULAR XIAOMI REDMI 9C 64GB MIDNIGHT GRAY;TELEFONIA
6718529;Viudo;F;72;CHILENO;SECRETARIA;Silencioso;PUDAHUEL                      ;METROPOLITANA;0;0;0;0;0;0;0;0;0;Celular A51 128GB LIB OPEN AZUL;TELEFONIA
8079274;;M;62;CHILENO;;Boomers;PROVIDENCIA                   ;METROPOLITANA;0;0;0;0;0;0;0;0;0;Celular SA3 CLARO DIRECTO BLACK;TELEFONIA
19817321;;M;25;CHILENO;;Z;PROVIDENCIA                   ;METROPOLITANA;0;0;0;0;0;0;0;0;0;Celular S20 ULTRA LIB OPEN NEGRO;TELEFONIA
10805868;;F;54;CHILENO;;Boomers;PROVIDENCIA                   ;METROPOLITANA;0;0;0;0;0;0;0;0;0;CELULAR XIAOMI MI 10T 128GB COSMIC BLACK OPEN;TELEFONIA
6368864;;F;74;CHILENO;;Silencioso;LOS VILOS                     ;COQUIMBO;0;0;0;0;0;0;0;0;0;Celular A01 LIB OPEN AZUL;TELEFONIA
8646532;;M;69;CHILENO;;Silencioso;OSORNO                        ;LOS LAGOS;0;0;0;0;0;0;0;0;0;IPHONE 8 64 GB LIB OPEN GRAY;TELEFONIA
10724988;;F;51;CHILENO;;X;LA CISTERNA                   ;METROPOLITANA;0;0;0;0;0;0;0;0;0;Celular NOKIA 2.3 WOM DIRECTO CHARCOAL;TELEFONIA
6674643;;M;70;CHILENO;;Silencioso;RENCA                         ;METROPOLITANA;0;0;0;0;0;0;0;0;0;Celular A01 CLARO DIRECTO BLACK;TELEFONIA
17133418;;F;33;CHILENO;;Millenial;IQUIQUE                       ;TARAPACA;0;0;0;0;0;0;0;0;0;Celular P40 LITE LIB OPEN GREEN;TELEFONIA
5080282;;M;75;CHILENO;;Silencioso;RENCA                         ;METROPOLITANA;0;0;0;0;0;0;0;0;0;Celular SA3 CLARO DIRECTO BLACK;TELEFONIA
16261037;Soltero;M;36;CHILENO;;Millenial;PROVIDENCIA                   ;METROPOLITANA;0;0;0;0;0;0;0;0;0;Celular SAMSUNG A11 32GB ENTEL DIRECTO NEGRO;TELEFONIA
12085277;Soltero;M;51;CHILENO;;X;RENCA                         ;METROPOLITANA;0;0;0;0;0;0;0;0;0;Celular SA3 CLARO DIRECTO BLACK;TELEFONIA
17187804;;F;33;CHILENO;;Millenial;CURACAUTIN;ARAUCANIA;0;0;0;0;0;0;0;0;0;Celular Y9S LIB OPEN BREATHING CRYSTAL;TELEFONIA
14708403;;F;61;DOMINICANO;;Extranjero;COLINA                        ;METROPOLITANA;0;0;0;0;0;0;0;0;0;Celular XIAOMI REDMI 9 64 GB DIRECTO CLARO NEGRO;TELEFONIA
7189334;;M;69;CHILENO;;Silencioso;PROVIDENCIA                   ;METROPOLITANA;0;0;0;0;0;0;0;0;0;Celular NOKIA 4.2 ENTEL DIRECTO NEGRO;TELEFONIA
19150347;;M;26;CHILENO;;Millenial;"";"";0;0;0;0;0;0;0;0;0;CELULAR REDMI 9 64GB SUNSET PURPLE TRI WOM;TELEFONIA
10457525;;F;57;CHILENO;;Boomers;CALERA                        ;VALPARAISO;0;0;0;0;0;0;0;0;0;CELULAR MOTO ONE FUSION 64GB VERDE 64GB OPEN;TELEFONIA
15587961;;F;38;CHILENO;;X;RENCA                         ;METROPOLITANA;0;0;0;0;0;0;0;0;0;Celular P30 LITE PLUS LIB OPEN BLACK;TELEFONIA
9017901;;F;61;CHILENO;;Boomers;PROVIDENCIA                   ;METROPOLITANA;0;0;0;0;0;0;0;0;0;Celular SA3 CLARO DIRECTO BLACK;TELEFONIA
11566717;;M;52;CHILENO;;X;RANCAGUA                      ;L.G.B.OÂ´HIGGINS;0;0;0;0;0;0;0;0;0;Celular A31 LIB OPEN ROJO;TELEFONIA
7342019;;F;68;CHILENO;;Silencioso;LA LIGUA                      ;VALPARAISO;0;0;0;0;0;0;0;0;0;Celular SAMSUNG A01 CORE AZUL ENTEL;TELEFONIA
5961670;;M;75;CHILENO;;Silencioso;SAN VICENTE                   ;L.G.B.OÂ´HIGGINS;0;0;0;0;0;0;0;0;0;Celular A10S MOVISTAR DIRECTO BLACK;TELEFONIA
25416332;;M;64;COLOMBIANO;;Extranjero;LO PRADO                      ;METROPOLITANA;0;0;0;0;0;0;0;0;0;Celular P40 LITE LIB OPEN GREEN;TELEFONIA
17997900;Soltero;F;30;CHILENO;;Millenial;PROVIDENCIA                   ;METROPOLITANA;0;0;0;0;0;0;0;0;0;Celular SA3 CLARO DIRECTO BLACK;TELEFONIA
17321016;;F;32;CHILENO;;Millenial;N/D;N/D;0;0;0;0;0;0;0;0;0;Celular A20S WOM TRIANGULADO AZUL;TELEFONIA
15398374;;F;40;CHILENO;;X;PENAFLOR                      ;METROPOLITANA;0;0;0;0;0;0;0;0;0;Celular A10S LIB OPEN RED;TELEFONIA
14427056;;M;48;CHILENO;;X;ALHUE                         ;METROPOLITANA;0;0;0;0;0;0;0;0;0;Celular A11 LIB OPEN WHITE;TELEFONIA
17662234;;M;31;CHILENO;;Millenial;QUILICURA                     ;METROPOLITANA;0;0;0;0;0;0;0;0;0;CELULAR MOTO ONE FUSION 64GB VERDE 64GB OPEN;TELEFONIA
15939880;;F;38;CHILENO;;Millenial;PROVIDENCIA                   ;METROPOLITANA;0;0;0;0;0;0;0;0;0;Celular Y9S LIB OPEN BREATHING CRYSTAL;TELEFONIA
17731014;;M;31;CHILENO;;Millenial;CONCHALI                      ;METROPOLITANA;0;0;0;0;0;0;0;0;0;Celular Y9 PRIME LIB OPEN VERDE;TELEFONIA
9509702;;F;59;CHILENO;;Boomers;ILLAPEL                       ;COQUIMBO;0;0;0;0;0;0;0;0;0;CELULAR MOTO ONE FUSION 64GB VERDE 64GB OPEN;TELEFONIA
16654630;;F;35;CHILENO;;Millenial;PROVIDENCIA                   ;METROPOLITANA;0;0;0;0;0;0;0;0;0;CELULAR NOKIA 1.3 CYAN BLUE TRI ENTEL;TELEFONIA
13105747;;M;46;CHILENO;;X;RENCA                         ;METROPOLITANA;0;0;0;0;0;0;0;0;0;Celular A11 LIB OPEN BLACK;TELEFONIA
10132224;;F;68;CHILENO;;Boomers;LONCOCHE                      ;ARAUCANIA;0;0;0;0;0;0;0;0;0;Celular A20S LIB OPEN ROJO;TELEFONIA
10780526;;F;53;CHILENO;;X;OVALLE                        ;COQUIMBO;0;0;0;0;0;0;0;0;0;Celular A51 128GB LIB OPEN AZUL;TELEFONIA
11217568;;M;55;CHILENO;;Boomers;RENCA                         ;METROPOLITANA;0;0;0;0;0;0;0;0;0;Celular Y5 NEO CLARO DIRECTO BLACK;TELEFONIA
17275217;Soltero;M;32;CHILENO;;Millenial;PROVIDENCIA                   ;METROPOLITANA;0;0;0;0;0;0;0;0;0;Celular A31 LIB OPEN ROJO;TELEFONIA
11224035;;M;54;CHILENO;;X;ALGARROBO                     ;VALPARAISO;0;0;0;0;0;0;0;0;0;Celular A71 LIB OPEN PLATEADO;TELEFONIA
11504924;;M;53;CHILENO;;X;LA FLORIDA                    ;METROPOLITANA;0;0;0;0;0;0;0;0;0;CELULAR HUAWEI Y8S NEGRO WOM;TELEFONIA
26253150;;M;49;VENEZOLANO;;Extranjero;ESTACION CENTRAL              ;METROPOLITANA;0;0;0;0;0;0;0;0;0;Celular A71 LIB OPEN PLATEADO;TELEFONIA
19425521;;F;26;CHILENO;;Z;TALCAHUANO;BIO-BIO;0;0;0;0;0;0;0;0;0;Celular A11 LIB OPEN BLUE;TELEFONIA
18119574;;F;30;CHILENO;;Millenial;PROVIDENCIA                   ;METROPOLITANA;0;0;0;0;0;0;0;0;0;CELULAR SAMSUNG A71 AZUL OPEN;TELEFONIA
16526527;;F;35;CHILENO;;Millenial;CHANARAL                      ;ATACAMA;0;0;0;0;0;0;0;0;0;Celular a11 azul samsung WOM;TELEFONIA
15732856;;F;38;CHILENO;;X;PAINE                         ;METROPOLITANA;0;0;0;0;0;0;0;0;0;Celular A10S LIB OPEN NEGRO;TELEFONIA
9776537;Divorciado;M;55;CHILENO;;Boomers;PROVIDENCIA                   ;METROPOLITANA;0;0;0;0;0;0;0;0;0;Celular A01 LIB OPEN NEGRO;TELEFONIA
14097737;;F;41;CHILENO;;X;QUEMCHI                       ;LOS LAGOS;0;0;0;0;0;0;0;0;0;Celular A11 LIB OPEN BLUE;TELEFONIA
11492686;;F;54;CHILENO;;Boomers;LO BARNECHEA                  ;METROPOLITANA;0;0;0;0;0;0;0;0;0;Celular SAMSUNG A01 CORE BLACK CLARO;TELEFONIA
12460519;;M;49;CHILENO;;X;PROVIDENCIA                   ;METROPOLITANA;0;0;0;0;0;0;0;0;0;CELULAR MOTOROLA G9 PLUS CHAMPAGNE ROSE OPEN;TELEFONIA
17210576;Soltero;F;32;CHILENO;;Millenial;QUILLOTA                      ;VALPARAISO;0;0;0;0;0;0;0;0;0;Celular SAMSUNG A11 32GB ENTEL DIRECTO NEGRO;TELEFONIA
15060581;;M;40;CHILENO;;X;RENCA                         ;METROPOLITANA;0;0;0;0;0;0;0;0;0;CELULAR LG K22 TRIANGULADO WOM;TELEFONIA
6700207;;M;71;CHILENO;;Silencioso;N/D;N/D;0;0;0;0;0;0;0;0;0;Celular VIVO Y11S ENTEL DIRECTO AZUL;TELEFONIA
18079711;;F;30;CHILENO;;Millenial;SAN VICENTE;O HIGGINS;0;0;0;0;0;0;0;0;0;Celular LG K22 DIRECTO CLARO;TELEFONIA
13506708;;M;44;CHILENO;;X;RENCA                         ;METROPOLITANA;0;0;0;0;0;0;0;0;0;Celular A01 LIB OPEN ROJO;TELEFONIA
14348833;;M;43;CHILENO;;X;OVALLE                        ;COQUIMBO;0;0;0;0;0;0;0;0;0;Celular A20S LIB OPEN ROJO;TELEFONIA
16695201;;M;35;CHILENO;;Millenial;LAS CONDES;METROPOLITANA;0;0;0;0;0;0;0;0;0;Celular LG K22 DIRECTO CLARO;TELEFONIA
10952144;;F;49;CHILENO;;X;VALLENAR;ATACAMA;0;0;0;0;0;0;0;0;0;Celular A20S WOM TRIANGULADO AZUL;TELEFONIA
12932325;;M;47;CHILENO;;X;FREIRE                        ;ARAUCANIA;0;0;0;0;0;0;0;0;0;CELULAR XIAOMI REDMI 9A 32GB SKY BLUE TRI WOM;TELEFONIA
11316037;;M;54;CHILENO;;Boomers;SAN BERNARDO                  ;METROPOLITANA;0;0;0;0;0;0;0;0;0;CELULAR XIAOMI REDMI 9C 64GB TIWLIGHT BLUE TRI M;TELEFONIA
15513996;Soltero;F;39;CHILENO;;X;PROVIDENCIA                   ;METROPOLITANA;0;0;0;0;0;0;0;0;0;Celular A11 LIB OPEN BLUE;TELEFONIA
4306499;;M;83;CHILENO;;Silencioso;MACUL                         ;METROPOLITANA;0;0;0;0;0;0;0;0;0;Celular A11 LIB OPEN BLACK;TELEFONIA
19347726;;F;26;CHILENO;;Z;ANTUCO                        ;BIO BIO;0;0;0;0;0;0;0;0;0;Celular SA3 CLARO DIRECTO BLACK;TELEFONIA
10600950;;F;42;CHILENO;;X;N/D;N/D;0;0;0;0;0;0;0;0;0;Celular A11 LIB OPEN BLUE;TELEFONIA
13968746;;F;41;CHILENO;;X;PROVIDENCIA                   ;METROPOLITANA;0;0;0;0;0;0;0;0;0;Celular Y6 2019 WOM DIRECTO AZUL;TELEFONIA
16412755;;M;35;CHILENO;;Millenial;N/D;N/D;0;0;0;0;0;0;0;0;0;Celular G8 POWER LITE MOVISTAR DIRECTO AZUL;TELEFONIA
14505553;;M;45;CHILENO;;X;MACHALI                       ;L.G.B.OÂ´HIGGINS;0;0;0;0;0;0;0;0;0;IPHONE 7 32GB LIB OPEN DORADO;TELEFONIA
5499485;;F;76;CHILENO;;Silencioso;TEMUCO                        ;ARAUCANIA;0;0;0;0;0;0;0;0;0;Celular A10S LIB OPEN RED;TELEFONIA
18983754;;F;26;CHILENO;;Z;"";"";0;0;0;0;0;0;0;0;0;Celular A10S LIB OPEN BLUE;TELEFONIA
10961584;;M;53;CHILENO;;X;PROVIDENCIA                   ;METROPOLITANA;0;0;0;0;0;0;0;0;0;CELULAR LG K22 TRIANGULADO WOM;TELEFONIA
17634043;;M;32;CHILENO;;Millenial;PROVIDENCIA                   ;METROPOLITANA;0;0;0;0;0;0;0;0;0;Celular XIAOMI REDMI 9C 64 GB DIRECTO CLARO;TELEFONIA
20369590;;F;22;CHILENO;;Z;MOSTAZAL                      ;L.G.B.OÂ´HIGGINS;0;0;0;0;0;0;0;0;0;Celular A10S LIB OPEN RED;TELEFONIA
8425450;;M;65;CHILENO;;Boomers;PROVIDENCIA                   ;METROPOLITANA;0;0;0;0;0;0;0;0;0;Celular A11 LIB OPEN BLUE;TELEFONIA
15481210;;F;40;CHILENO;;X;MAIPU                         ;METROPOLITANA;0;0;0;0;0;0;0;0;0;CELULAR REDMI NOTE 8 64GB SPACE BLACK OPEN;TELEFONIA
25571296;;M;32;PERUANO;;Extranjero;RECOLETA                      ;METROPOLITANA;0;0;0;0;0;0;0;0;0;Celular A11 LIB OPEN BLUE;TELEFONIA
17508238;Soltero;M;31;CHILENO;;Millenial;PROVIDENCIA                   ;METROPOLITANA;0;0;0;0;0;0;0;0;0;Celular A20S LIB OPEN NEGRO;TELEFONIA
8691840;Casado;M;62;CHILENO;;Boomers;PROVIDENCIA                   ;METROPOLITANA;0;0;0;0;0;0;0;0;0;Celular SA3 CLARO DIRECTO BLACK;TELEFONIA
13576805;;M;43;CHILENO;;X;RENCA                         ;METROPOLITANA;0;0;0;0;0;0;0;0;0;Celular A31 LIB OPEN AZUL;TELEFONIA
13058815;;M;46;CHILENO;;X;PROVIDENCIA                   ;METROPOLITANA;0;0;0;0;0;0;0;0;0;Celular A3 LITE ENTEL TRIANGULADO NEGRO;TELEFONIA
17793862;Soltero;M;31;CHILENO;;Millenial;N/D;N/D;0;0;0;0;0;0;0;0;0;Celular A01 MOVISTAR DIRECTO BLACK;TELEFONIA
15914036;;F;36;CHILENO;;Millenial;LA LIGUA                      ;VALPARAISO;0;0;0;0;0;0;0;0;0;CELULAR SAMSUNG A21S ROJO OPEN;TELEFONIA
17696336;;M;31;CHILENO;;Millenial;PROVIDENCIA                   ;METROPOLITANA;0;0;0;0;0;0;0;0;0;CELULAR REDMI NOTE 8 64GB SPACE BLACK OPEN;TELEFONIA
18251919;Soltero;F;29;CHILENO;;Millenial;PROVIDENCIA                   ;METROPOLITANA;0;0;0;0;0;0;0;0;0;Celular A10S MOVISTAR DIRECTO NEGRO;TELEFONIA
18647827;Casado;F;27;CHILENO;;Silencioso;PROVIDENCIA                   ;METROPOLITANA;0;0;0;0;0;0;0;0;0;Celular NOKIA 4.2 ENTEL DIRECTO NEGRO;TELEFONIA
12829303;;F;47;CHILENO;;X;PROVIDENCIA                   ;METROPOLITANA;0;0;0;0;0;0;0;0;0;Celular Y6 2019 WOM DIRECTO BLACK;TELEFONIA
26450236;;F;36;VENEZOLANO;;Extranjero;QUILLOTA                      ;VALPARAISO;0;0;0;0;0;0;0;0;0;CELULAR SAMSUNG A21S AZUL OPEN;TELEFONIA
13062872;;M;45;CHILENO;;X;N/D;N/D;0;0;0;0;0;0;0;0;0;Celular A20S LIB OPEN ROJO;TELEFONIA
11213836;;F;54;CHILENO;;Boomers;PENCO                         ;BIO BIO;0;0;0;0;0;0;0;0;0;Celular A01 CLARO DIRECTO BLACK;TELEFONIA
11776049;;F;51;CHILENO;;X;RENCA                         ;METROPOLITANA;0;0;0;0;0;0;0;0;0;Celular A01 LIB OPEN ROJO;TELEFONIA
8646489;;M;63;CHILENO;;Boomers;RENCA                         ;METROPOLITANA;0;0;0;0;0;0;0;0;0;Celular A20S LIB OPEN AZUL;TELEFONIA
9935938;Casado;F;58;CHILENO;;Boomers;RENCA                         ;METROPOLITANA;0;0;0;0;0;0;0;0;0;Celular A10S LIB OPEN BLUE;TELEFONIA
13371746;;M;44;CHILENO;;X;SAN JAVIER                    ;MAULE;0;0;0;0;0;0;0;0;0;Celular A11 LIB OPEN WHITE;TELEFONIA
13426712;;F;44;CHILENO;;X;N/D;N/D;0;0;0;0;0;0;0;0;0;Celular A71 LIB OPEN PLATEADO;TELEFONIA
17252928;Casado;M;32;CHILENO;;Millenial;PROVIDENCIA                   ;METROPOLITANA;0;0;0;0;0;0;0;0;0;Celular A51 128GB LIB OPEN AZUL;TELEFONIA
11905505;;F;52;CHILENO;;X;RENAICO                       ;ARAUCANIA;0;0;0;0;0;0;0;0;0;Celular A11 LIB OPEN BLACK;TELEFONIA
12675595;;M;48;CHILENO;;X;PROVIDENCIA                   ;METROPOLITANA;0;0;0;0;0;0;0;0;0;CELULAR HUAWEI Y6P NEGRO ENTEL;TELEFONIA
9066593;Soltero;M;64;CHILENO;INGENIERO AGRICOLA;Boomers;PROVIDENCIA                   ;METROPOLITANA;0;0;0;0;0;0;0;0;0;CELULAR OWN 1026 AZUL ENTEL;TELEFONIA
10250830;;M;53;CHILENO;;X;PROVIDENCIA                   ;METROPOLITANA;0;0;0;0;0;0;0;0;0;Celular A20S LIB OPEN NEGRO;TELEFONIA
20254491;;M;23;CHILENO;;Z;PROVIDENCIA                   ;METROPOLITANA;0;0;0;0;0;0;0;0;0;Celular P30 LITE CLARO DIRECTO AZUL;TELEFONIA
15871658;;M;38;CHILENO;;Millenial;PROVIDENCIA                   ;METROPOLITANA;0;0;0;0;0;0;0;0;0;Celular SAMSUNG A01 CORE AZUL ENTEL;TELEFONIA
18520935;Soltero;M;28;CHILENO;;Millenial;PROVIDENCIA                   ;METROPOLITANA;0;0;0;0;0;0;0;0;0;Celular NOVA 5T LIB OPEN AZUL;TELEFONIA
5910810;;F;75;CHILENO;;Silencioso;SAN BERNARDO                  ;METROPOLITANA;0;0;0;0;0;0;0;0;0;Celular A01 LIB OPEN ROJO;TELEFONIA
25897420;;M;33;VENEZOLANO;;Extranjero;PUENTE ALTO                   ;METROPOLITANA;0;0;0;0;0;0;0;0;0;Celular A10S LIB OPEN BLUE;TELEFONIA
13594751;;M;42;CHILENO;;X;RENCA                         ;METROPOLITANA;0;0;0;0;0;0;0;0;0;Celular A20S LIB OPEN NEGRO;TELEFONIA
6957192;;F;71;CHILENO;;Silencioso;SAN FELIPE                    ;VALPARAISO;0;0;0;0;0;0;0;0;0;Celular Y5 NEO CLARO DIRECTO BLACK;TELEFONIA
15196769;;M;40;CHILENO;;X;PROVIDENCIA                   ;METROPOLITANA;0;0;0;0;0;0;0;0;0;Celular A11 LIB OPEN BLUE;TELEFONIA
7166755;;F;70;CHILENO;;Silencioso;TALCAHUANO                    ;BIO BIO;0;0;0;0;0;0;0;0;0;Celular SA3 CLARO DIRECTO BLACK;TELEFONIA
18873995;;F;27;CHILENO;;Millenial;CARAHUE                       ;ARAUCANIA;0;0;0;0;0;0;0;0;0;CELULAR SAMSUNG A21S ROJO OPEN;TELEFONIA
5678853;;F;74;CHILENO;;Silencioso;RENCA                         ;METROPOLITANA;0;0;0;0;0;0;0;0;0;CELULAR HUAWEI Y5 NEO NEGRO WOM;TELEFONIA
5860730;;M;74;CHILENO;;Silencioso;PROVIDENCIA                   ;METROPOLITANA;0;0;0;0;0;0;0;0;0;Celular A01 LIB OPEN AZUL;TELEFONIA
11418863;;M;53;CHILENO;;X;ANGOL                         ;ARAUCANIA;0;0;0;0;0;0;0;0;0;Celular A20S LIB OPEN AZUL;TELEFONIA
12397452;;M;49;CHILENO;;X;MONTE PATRIA                  ;COQUIMBO;0;0;0;0;0;0;0;0;0;Celular SAMSUNG A11 32GB ENTEL DIRECTO NEGRO;TELEFONIA
16205507;Soltero;M;36;CHILENO;;Millenial;VILLARICA                     ;ARAUCANIA;0;0;0;0;0;0;0;0;0;CELULAR SAMSUNG A21S AZUL OPEN;TELEFONIA
10590208;Soltero;M;55;CHILENO;;Boomers;RENCA                         ;METROPOLITANA;0;0;0;0;0;0;0;0;0;Celular A20S LIB OPEN NEGRO;TELEFONIA
8787139;;M;62;CHILENO;;Boomers;RENCA                         ;METROPOLITANA;0;0;0;0;0;0;0;0;0;CELULAR MOTOROLA G9 PLUS DEEP DIVE OPEN;TELEFONIA
18061054;Soltero;F;30;CHILENO;;Millenial;PROVIDENCIA                   ;METROPOLITANA;0;0;0;0;0;0;0;0;0;Celular Y6 2019 WOM DIRECTO AZUL;TELEFONIA
7228455;;M;69;CHILENO;;Silencioso;PROVIDENCIA                   ;METROPOLITANA;0;0;0;0;0;0;0;0;0;Celular P SMART 2019 WOM DIRECTO NEGRO;TELEFONIA
14238290;Soltero;F;48;CHILENO;PROFESOR;X;PROVIDENCIA                   ;METROPOLITANA;0;0;0;0;0;0;0;0;0;CELULAR HUAWEI Y5 NEO NEGRO WOM;TELEFONIA
9686871;;M;57;CHILENO;;Boomers;RENCA                         ;METROPOLITANA;0;0;0;0;0;0;0;0;0;Celular A11 LIB OPEN BLACK;TELEFONIA
12462662;;F;49;CHILENO;;X;BUIN                          ;METROPOLITANA;0;0;0;0;0;0;0;0;0;Celular A11 LIB OPEN WHITE;TELEFONIA
7927925;;F;74;CHILENO;;Silencioso;N/D;N/D;0;0;0;0;0;0;0;0;0;Celular A20S LIB OPEN ROJO;TELEFONIA
6701495;;M;67;CHILENO;;Boomers;PROVIDENCIA                   ;METROPOLITANA;0;0;0;0;0;0;0;0;0;Celular A20S LIB OPEN NEGRO;TELEFONIA
18325584;;M;29;CHILENO;;Millenial;PUDAHUEL                      ;METROPOLITANA;0;0;0;0;0;0;0;0;0;Celular A11 LIB OPEN BLACK;TELEFONIA
10928479;;F;54;CHILENO;;Boomers;SAAVEDRA                      ;ARAUCANIA;0;0;0;0;0;0;0;0;0;CELULAR Y8S MOVISTAR DIRECTO BLACK;TELEFONIA
16296385;;F;37;CHILENO;;Millenial;N/D;N/D;0;0;0;0;0;0;0;0;0;Celular A11 LIB OPEN BLACK;TELEFONIA
20311632;;F;26;CHILENO;;Z;MELIPILLA                     ;METROPOLITANA;0;0;0;0;0;0;0;0;0;Celular NOKIA 4.2 ENTEL DIRECTO NEGRO;TELEFONIA
12577331;;F;47;CHILENO;;X;RENCA                         ;METROPOLITANA;0;0;0;0;0;0;0;0;0;Celular SAMSUNG A01 CORE AZUL ENTEL;TELEFONIA
9339704;;M;56;CHILENO;;Boomers;ARICA                         ;ARICA Y PARINACOTA;0;0;0;0;0;0;0;0;0;CELULAR SAMSUNG A21S NEGRO OPEN;TELEFONIA
10937283;;M;41;CHILENO;;Boomers;LA CISTERNA                   ;METROPOLITANA;0;0;0;0;0;0;0;0;0;Celular A20S LIB OPEN ROJO;TELEFONIA
9622354;;F;62;CHILENO;;Boomers;PROVIDENCIA                   ;METROPOLITANA;0;0;0;0;0;0;0;0;0;Celular A3 LITE ENTEL TRIANGULADO NEGRO;TELEFONIA
16873457;Soltero;F;31;CHILENO;;Millenial;PROVIDENCIA                   ;METROPOLITANA;0;0;0;0;0;0;0;0;0;Celular A10S LIB OPEN NEGRO;TELEFONIA
18259995;;F;29;CHILENO;;Millenial;SAN NICOLAS                   ;BIO BIO;0;0;0;0;0;0;0;0;0;Celular A10S LIB OPEN RED;TELEFONIA
5219093;Casado;M;75;CHILENO;;Silencioso;CARAHUE                       ;ARAUCANIA;0;0;0;0;0;0;0;0;0;Celular A01 CLARO DIRECTO BLACK;TELEFONIA
13678562;;F;43;CHILENO;;X;PROVIDENCIA                   ;METROPOLITANA;0;0;0;0;0;0;0;0;0;CELULAR HUAWEI Y5P CLARO DIRECTO BLUE;TELEFONIA
12073531;;M;54;CHILENO;;X;RENCA                         ;METROPOLITANA;0;0;0;0;0;0;0;0;0;Celular A10S LIB OPEN RED;TELEFONIA
18011700;;M;30;CHILENO;;Millenial;RENCA                         ;METROPOLITANA;0;0;0;0;0;0;0;0;0;Celular A51 128GB LIB OPEN BLACK;TELEFONIA
18944480;;M;26;CHILENO;;Z;PROVIDENCIA                   ;METROPOLITANA;0;0;0;0;0;0;0;0;0;Celular a11 azul samsung WOM;TELEFONIA
11920877;;M;50;CHILENO;;X;RENCA                         ;METROPOLITANA;0;0;0;0;0;0;0;0;0;Celular A20S LIB OPEN NEGRO;TELEFONIA
14033372;;F;41;CHILENO;;X;ERCILLA                       ;ARAUCANIA;0;0;0;0;0;0;0;0;0;CELULAR HUAWEI Y5P BLUE TRIANGULADO WOM;TELEFONIA
8930665;Casado;M;59;CHILENO;;Boomers;RENCA                         ;METROPOLITANA;0;0;0;0;0;0;0;0;0;Celular A51 128GB LIB OPEN BLANCO;TELEFONIA
5644410;;F;74;CHILENO;;Silencioso;VINA DEL MAR                  ;VALPARAISO;0;0;0;0;0;0;0;0;0;Celular J2 CORE CLARO DIRECTO NEGRO;TELEFONIA
17963227;;F;31;CHILENO;;Millenial;PROVIDENCIA                   ;METROPOLITANA;0;0;0;0;0;0;0;0;0;CELULAR HUAWEI Y5P BLUE TRIANGULADO WOM;TELEFONIA
14497803;Casado;F;47;CHILENO;;X;RENCA                         ;METROPOLITANA;0;0;0;0;0;0;0;0;0;Celular S20 LIB OPEN GRIS;TELEFONIA
9715690;;M;59;CHILENO;;Boomers;SAN ESTEBAN                   ;VALPARAISO;0;0;0;0;0;0;0;0;0;Celular SAMSUNG A01 CORE AZUL ENTEL;TELEFONIA
16828867;;F;33;CHILENO;;Millenial;SANTA CRUZ                    ;L.G.B.OÂ´HIGGINS;0;0;0;0;0;0;0;0;0;CELULAR SAMSUNG A21S AZUL OPEN;TELEFONIA
14541384;Soltero;M;47;CHILENO;;X;PROVIDENCIA                   ;METROPOLITANA;0;0;0;0;0;0;0;0;0;CELULAR MOTOROLA G9 PLAY 64GB SPRING PINK OPEN;TELEFONIA
8922913;;M;60;CHILENO;;Boomers;SAN CARLOS                    ;BIO BIO;0;0;0;0;0;0;0;0;0;CELULAR ZTE A5 2020 NEGRO WOM;TELEFONIA
7966494;;F;66;CHILENO;;Boomers;SAN FELIPE                    ;VALPARAISO;0;0;0;0;0;0;0;0;0;Celular A20S LIB OPEN AZUL;TELEFONIA
9780365;Casado;M;59;CHILENO;;Boomers;RENCA                         ;METROPOLITANA;0;0;0;0;0;0;0;0;0;Celular A31 LIB OPEN AZUL;TELEFONIA
7227840;Divorciado;M;67;CHILENO;;Boomers;RENCA                         ;METROPOLITANA;0;0;0;0;0;0;0;0;0;Celular A10S LIB OPEN BLUE;TELEFONIA
11769015;;F;51;CHILENO;;X;RENCA                         ;METROPOLITANA;0;0;0;0;0;0;0;0;0;CELULAR SAMSUNG A10S NEGRO WOM;TELEFONIA
15793927;;M;37;CHILENO;;Millenial;MARIQUINA                     ;LOS LAGOS;0;0;0;0;0;0;0;0;0;CHIP RECARGA CLARO;TELEFONIA
16794452;;M;35;CHILENO;;Millenial;TEMUCO                        ;ARAUCANIA;0;0;0;0;0;0;0;0;0;CELULAR Y7 PLUS CLARO DIRECTO BLACK;TELEFONIA
12471250;;F;49;CHILENO;;X;PROVIDENCIA                   ;METROPOLITANA;0;0;0;0;0;0;0;0;0;Celular A51 128GB LIB OPEN BLANCO;TELEFONIA
17971524;;F;30;CHILENO;;Millenial;PROVIDENCIA                   ;METROPOLITANA;0;0;0;0;0;0;0;0;0;CELULAR HUAWEI Y5P CLARO DIRECTO BLUE;TELEFONIA
12868419;Soltero;M;47;CHILENO;MANTENIMIENTO INDUSTRIAL;X;PROVIDENCIA                   ;METROPOLITANA;0;0;0;0;0;0;0;0;0;Celular A10S LIB OPEN BLUE;TELEFONIA
10219741;;F;57;CHILENO;;Boomers;SAN ANTONIO                   ;VALPARAISO;0;0;0;0;0;0;0;0;0;Celular SAMSUNG A31 BLACK CLARO;TELEFONIA
9817761;;F;58;CHILENO;;Boomers;TEMUCO                        ;ARAUCANIA;0;0;0;0;0;0;0;0;0;Celular A3 LITE ENTEL TRIANGULADO NEGRO;TELEFONIA
16758784;;F;34;CHILENO;;Millenial;SAN ANTONIO                   ;VALPARAISO;0;0;0;0;0;0;0;0;0;Celular A10S LIB OPEN RED;TELEFONIA
10384159;;M;53;CHILENO;;X;QUILPUE                       ;VALPARAISO;0;0;0;0;0;0;0;0;0;Celular A20S LIB OPEN AZUL;TELEFONIA
12388329;;F;49;CHILENO;;X;NUEVA IMPERIAL;ARAUCANIA;0;0;0;0;0;0;0;0;0;CELULAR SAMSUNG A21S AZUL OPEN;TELEFONIA
7480636;;M;68;CHILENO;;Boomers;MALLOA                        ;L.G.B.OÂ´HIGGINS;0;0;0;0;0;0;0;0;0;Celular SA3 CLARO DIRECTO BLACK;TELEFONIA
5720302;Viudo;M;73;CHILENO;AGROINDUSTRIA;Silencioso;PROVIDENCIA                   ;METROPOLITANA;0;0;0;0;0;0;0;0;0;Celular SA3 CLARO DIRECTO BLACK;TELEFONIA
17037499;;F;34;CHILENO;;Millenial;CALBUCO                       ;LOS LAGOS;0;0;0;0;0;0;0;0;0;Celular A31 LIB OPEN AZUL;TELEFONIA
16311077;Soltero;F;34;CHILENO;;Millenial;PROVIDENCIA                   ;METROPOLITANA;0;0;0;0;0;0;0;0;0;CELULAR Y8S MOVISTAR DIRECTO BLACK;TELEFONIA
10218311;Casado;F;60;CHILENO;;Boomers;PROVIDENCIA                   ;METROPOLITANA;0;0;0;0;0;0;0;0;0;Celular A10S LIB OPEN RED;TELEFONIA
6814122;;F;70;CHILENO;;Silencioso;RENCA                         ;METROPOLITANA;0;0;0;0;0;0;0;0;0;CELULAR SAMSUNG A21S AZUL OPEN;TELEFONIA
8945243;Soltero;M;61;CHILENO;AGROINDUSTRIA;Boomers;PROVIDENCIA                   ;METROPOLITANA;0;0;0;0;0;0;0;0;0;Celular SA3 CLARO DIRECTO BLACK;TELEFONIA
6367490;;F;71;CHILENO;;Silencioso;CORONEL                       ;BIO BIO;0;0;0;0;0;0;0;0;0;Celular Y7P LIB OPEN NEGRO;TELEFONIA
17962692;Soltero;M;31;CHILENO;PROFESOR;Millenial;PROVIDENCIA                   ;METROPOLITANA;0;0;0;0;0;0;0;0;0;Celular A01 LIB OPEN AZUL;TELEFONIA
17903991;;M;31;CHILENO;;Millenial;PROVIDENCIA                   ;METROPOLITANA;0;0;0;0;0;0;0;0;0;Celular P30 LITE LIB OPEN NEGRO;TELEFONIA
10553704;;M;56;CHILENO;;Boomers;PINTO                         ;BIO BIO;0;0;0;0;0;0;0;0;0;Celular A10S LIB OPEN BLUE;TELEFONIA
11920626;;F;50;CHILENO;;X;VALDIVIA                      ;LOS RIOS;0;0;0;0;0;0;0;0;0;Celular NOKIA 2.3 ENTEL DIRECTO CARBON;TELEFONIA
15628725;Soltero;M;38;CHILENO;KINESIOLOGO;X;PROVIDENCIA                   ;METROPOLITANA;0;0;0;0;0;0;0;0;0;Celular S20+ LIB OPEN NEGRO;TELEFONIA
5465139;Soltero;F;75;CHILENO;;Silencioso;CHIMBARONGO                   ;L.G.B.OÂ´HIGGINS;0;0;0;0;0;0;0;0;0;Celular A31 LIB OPEN ROJO;TELEFONIA
6503502;;M;70;CHILENO;;Silencioso;PAPUDO                        ;VALPARAISO;0;0;0;0;0;0;0;0;0;Celular A20S LIB OPEN AZUL;TELEFONIA
17764624;Soltero;M;31;CHILENO;;Millenial;PROVIDENCIA                   ;METROPOLITANA;0;0;0;0;0;0;0;0;0;Celular Y7P LIB OPEN NEGRO;TELEFONIA
26314882;;M;36;HAITIANO;;Extranjero;SAN FELIPE                    ;VALPARAISO;0;0;0;0;0;0;0;0;0;Celular A20S LIB OPEN AZUL;TELEFONIA
16846044;;M;34;CHILENO;;Millenial;PROVIDENCIA                   ;METROPOLITANA;0;0;0;0;0;0;0;0;0;Celular A01 LIB OPEN ROJO;TELEFONIA
12816022;;F;46;CHILENO;;X;SALAMANCA                     ;COQUIMBO;0;0;0;0;0;0;0;0;0;Celular A51 128GB LIB OPEN BLANCO;TELEFONIA
8891539;;M;60;CHILENO;;Boomers;PROVIDENCIA                   ;METROPOLITANA;0;0;0;0;0;0;0;0;0;Celular A51 128GB LIB OPEN BLANCO;TELEFONIA
18066344;;F;29;CHILENO;;Millenial;N/D;N/D;0;0;0;0;0;0;0;0;0;Celular A20S LIB OPEN ROJO;TELEFONIA
10348428;;F;55;CHILENO;;Boomers;PUNTA ARENAS                  ;MAGALLANES;0;0;0;0;0;0;0;0;0;Celular J2 CORE CLARO DIRECTO NEGRO;TELEFONIA
19607148;;F;25;CHILENO;;Z;TEMUCO                        ;ARAUCANIA;0;0;0;0;0;0;0;0;0;Celular P30 LITE LIB OPEN AZUL;TELEFONIA
10917946;;M;55;CHILENO;;Boomers;SAN FELIPE                    ;VALPARAISO;0;0;0;0;0;0;0;0;0;Celular Y6P WOM TRIANGULADO VERDE;TELEFONIA
10896985;;F;53;CHILENO;;X;N/D;N/D;0;0;0;0;0;0;0;0;0;Celular A01 LIB OPEN ROJO;TELEFONIA
9971687;;F;59;CHILENO;;Boomers;SAN JUAN DE LA COSTA          ;LOS LAGOS;0;0;0;0;0;0;0;0;0;Celular Y6 2019 CLARO DIRECTO BLACK;TELEFONIA
11096810;;F;56;CHILENO;;Boomers;LOS ANDES                     ;VALPARAISO;0;0;0;0;0;0;0;0;0;Celular A20S LIB OPEN NEGRO;TELEFONIA
9951782;;F;54;CHILENO;;X;SAN FERNANDO                  ;L.G.B.OÂ´HIGGINS;0;0;0;0;0;0;0;0;0;Celular Y7P LIB OPEN NEGRO;TELEFONIA
7425198;;F;67;CHILENO;;Boomers;VILLARICA                     ;ARAUCANIA;0;0;0;0;0;0;0;0;0;Celular TIGER V SENIOR CLARO DIRECTO NEGRO;TELEFONIA
14410054;;F;52;CHILENO;;X;PARRAL                        ;MAULE;0;0;0;0;0;0;0;0;0;Celular A01 LIB OPEN ROJO;TELEFONIA
17660822;Soltero;M;32;CHILENO;;Millenial;PROVIDENCIA                   ;METROPOLITANA;0;0;0;0;0;0;0;0;0;Celular A10S LIB OPEN RED;TELEFONIA
16550172;;F;35;CHILENO;;Millenial;"";"";0;0;0;0;0;0;0;0;0;Celular A5 CLARO DIRECTO BLACK;TELEFONIA
11942784;;M;50;CHILENO;;X;RENCA                         ;METROPOLITANA;0;0;0;0;0;0;0;0;0;Celular E6S ENTEL DIRECTO BLUE;TELEFONIA
14612612;;M;41;CHILENO;;X;TUCAPEL                       ;BIO BIO;0;0;0;0;0;0;0;0;0;Celular A01 LIB OPEN NEGRO;TELEFONIA
19568366;;F;32;CHILENO;;Millenial;LOS ANGELES                   ;BIO BIO;0;0;0;0;0;0;0;0;0;Celular A11 LIB OPEN BLUE;TELEFONIA
18155656;;M;29;CHILENO;;Millenial;AYSEN;AYSEN;0;0;0;0;0;0;0;0;0;Celular A01 LIB OPEN NEGRO;TELEFONIA
5153535;;M;78;CHILENO;;Silencioso;QUILLOTA                      ;VALPARAISO;0;0;0;0;0;0;0;0;0;Celular A10S LIB OPEN RED;TELEFONIA
15600903;;M;38;CHILENO;;Millenial;PROVIDENCIA                   ;METROPOLITANA;0;0;0;0;0;0;0;0;0;IPHONE 7 32GB LIB OPEN NEGRO;TELEFONIA
8780917;Casado;M;63;CHILENO;INGENIERO AGRICOLA;Boomers;RENCA                         ;METROPOLITANA;0;0;0;0;0;0;0;0;0;Celular A10S LIB OPEN BLUE;TELEFONIA
18224822;Soltero;F;29;CHILENO;PROFESOR;Millenial;PROVIDENCIA                   ;METROPOLITANA;0;0;0;0;0;0;0;0;0;Celular NOKIA 1.3 NEGRO WOM;TELEFONIA
9843516;;F;58;CHILENO;;Boomers;PROVIDENCIA                   ;METROPOLITANA;0;0;0;0;0;0;0;0;0;Celular TIGER V SENIOR CLARO DIRECTO NEGRO;TELEFONIA
12496045;;M;48;CHILENO;;X;PROVIDENCIA                   ;METROPOLITANA;0;0;0;0;0;0;0;0;0;CELULAR MOTO ONE FUSION 64GB VERDE 64GB OPEN;TELEFONIA
18135207;;F;31;CHILENO;;Millenial;PROVIDENCIA                   ;METROPOLITANA;0;0;0;0;0;0;0;0;0;Celular Y5 NEO MOVISTAR DIRECTO BLACK;TELEFONIA
7825307;;M;60;CHILENO;;Boomers;RENCA                         ;METROPOLITANA;0;0;0;0;0;0;0;0;0;Celular Y6 2019 MOVISTAR DIRECTO BLUE;TELEFONIA
15487973;Casado;M;50;CHILENO;AGROINDUSTRIA;X;CARAHUE                       ;ARAUCANIA;0;0;0;0;0;0;0;0;0;CELULAR Y8S MOVISTAR DIRECTO BLACK;TELEFONIA
15996910;Soltero;M;37;CHILENO;;Millenial;PROVIDENCIA                   ;METROPOLITANA;0;0;0;0;0;0;0;0;0;Celular G8 POWER LITE WOM DIRECTO TURQUESA;TELEFONIA
16926533;Soltero;M;34;CHILENO;;Millenial;PROVIDENCIA                   ;METROPOLITANA;0;0;0;0;0;0;0;0;0;IPHONE X 64GB NEGRO;TELEFONIA
8187578;Soltero;M;62;CHILENO;;Boomers;PROVIDENCIA                   ;METROPOLITANA;0;0;0;0;0;0;0;0;0;Celular SA3 CLARO DIRECTO BLACK;TELEFONIA
9214258;Casado;M;59;CHILENO;CONTADOR AUDITOR;Boomers;RENCA                         ;METROPOLITANA;0;0;0;0;0;0;0;0;0;Celular A51 128GB LIB OPEN BLACK;TELEFONIA
17011269;;M;34;CHILENO;;Millenial;RENCA                         ;METROPOLITANA;0;0;0;0;0;0;0;0;0;Celular A3 LITE ENTEL TRIANGULADO NEGRO;TELEFONIA
19749782;;F;24;CHILENO;;Z;MELIPILLA                     ;METROPOLITANA;0;0;0;0;0;0;0;0;0;CELULAR MOTO ONE FUSION 64GB VERDE 64GB OPEN;TELEFONIA
9166995;Soltero;F;62;CHILENO;;Boomers;RENCA                         ;METROPOLITANA;0;0;0;0;0;0;0;0;0;Celular AL3 CLARO DIRECTO NEGRO;TELEFONIA
18990129;Soltero;F;27;CHILENO;;Millenial;N/D;N/D;0;0;0;0;0;0;0;0;0;CELULAR HUAWEI Y5P CLARO DIRECTO BLUE;TELEFONIA
5413038;;M;76;CHILENO;;Silencioso;RENCA                         ;METROPOLITANA;0;0;0;0;0;0;0;0;0;Celular SA3 CLARO DIRECTO BLACK;TELEFONIA
18718327;Soltero;F;27;CHILENO;TECNICO DE NIVEL SUPERIOR EN ENFERMERIA;Millenial;PROVIDENCIA                   ;METROPOLITANA;0;0;0;0;0;0;0;0;0;Celular A20S LIB OPEN ROJO;TELEFONIA
5277167;;F;78;CHILENO;;Silencioso;SAN ANTONIO                   ;VALPARAISO;0;0;0;0;0;0;0;0;0;Celular A51 128GB CLARO TRIANGULADO BLACK;TELEFONIA
13843189;;F;42;CHILENO;;X;LOS ANGELES                   ;BIO BIO;0;0;0;0;0;0;0;0;0;Celular G8 POWER LITE WOM DIRECTO TURQUESA;TELEFONIA
17897072;;F;31;CHILENO;;Millenial;PROVIDENCIA                   ;METROPOLITANA;0;0;0;0;0;0;0;0;0;Celular A10S LIB OPEN RED;TELEFONIA
17488066;;F;31;CHILENO;;Millenial;MAIPU                         ;METROPOLITANA;0;0;0;0;0;0;0;0;0;IPHONE 7 32GB LIB OPEN DORADO;TELEFONIA
6607527;;M;71;CHILENO;;Silencioso;RENCA                         ;METROPOLITANA;0;0;0;0;0;0;0;0;0;Celular SA3 CLARO DIRECTO BLACK;TELEFONIA
8970715;;F;62;CHILENO;;Boomers;RANCAGUA                      ;L.G.B.OÂ´HIGGINS;0;0;0;0;0;0;0;0;0;Celular A10S LIB OPEN BLUE;TELEFONIA
7255567;;M;68;CHILENO;;Boomers;RENCA                         ;METROPOLITANA;0;0;0;0;0;0;0;0;0;Celular A10S LIB OPEN BLUE;TELEFONIA
16448785;;F;35;CHILENO;;Millenial;DALCAHUE                      ;LOS LAGOS;0;0;0;0;0;0;0;0;0;CELULAR HUAWEI Y6P NEGRO ENTEL;TELEFONIA
18533946;;F;28;CHILENO;;Millenial;PROVIDENCIA                   ;METROPOLITANA;0;0;0;0;0;0;0;0;0;Celular A10S LIB OPEN BLUE;TELEFONIA
12772136;;M;47;CHILENO;;X;PROVIDENCIA                   ;METROPOLITANA;0;0;0;0;0;0;0;0;0;Celular A01 LIB OPEN AZUL;TELEFONIA
18516444;;M;28;CHILENO;;Millenial;SAN FERNANDO                  ;L.G.B.OÂ´HIGGINS;0;0;0;0;0;0;0;0;0;CELULAR HUAWEI Y8S NEGRO WOM;TELEFONIA
19654664;;M;43;CHILENO;;X;ALTO HOSPICIO;TARAPACA;0;0;0;0;0;0;0;0;0;CELULAR SAMSUNG A21S NEGRO OPEN;TELEFONIA
11224716;;F;54;CHILENO;;X;RENCA                         ;METROPOLITANA;0;0;0;0;0;0;0;0;0;Celular Y7P LIB OPEN NEGRO;TELEFONIA
17521899;Soltero;M;31;CHILENO;;Millenial;PROVIDENCIA                   ;METROPOLITANA;0;0;0;0;0;0;0;0;0;Celular A51 128GB LIB OPEN AZUL;TELEFONIA
17078557;;M;33;CHILENO;;Millenial;PROVIDENCIA                   ;METROPOLITANA;0;0;0;0;0;0;0;0;0;Celular Y7P LIB OPEN NEGRO;TELEFONIA
9092619;;F;61;CHILENO;;Boomers;PROVIDENCIA                   ;METROPOLITANA;0;0;0;0;0;0;0;0;0;Celular Y5 NEO CLARO DIRECTO BLACK;TELEFONIA
7464755;;F;68;CHILENO;;Boomers;TOCOPILLA                     ;ANTOFAGASTA;1761770;14;9;0;0;0;14;9;1761770;Mouse Gamer Pro M885;ACCESORIOS
18085546;;F;30;CHILENO;;Millenial;PROVIDENCIA                   ;METROPOLITANA;114980;2;1;2;1;114980;0;0;0;GALAXY WATCH ACTIVE4 40 MM GOLD;ACCESORIOS
17887185;Soltero;M;30;CHILENO;;Millenial;MOSTAZAL                      ;L.G.B.OÂ´HIGGINS;116980;2;1;2;1;116980;0;0;0;Galaxy Watch Active4 40 mm Black;ACCESORIOS
16683836;;M;35;CHILENO;;Millenial;OSORNO                        ;LOS LAGOS;56980;2;2;0;0;0;2;2;56980;KARAOKE MLAB TOWER OUTDOOR MIC BT BK 8568;ACCESORIOS
22855193;Casado;M;48;AFRICANO;;Extranjero;RENCA                         ;METROPOLITANA;93980;2;1;2;1;93980;0;0;0;AUDIFONO GALAXY BUDS2 BLACK;ACCESORIOS
14001743;;F;40;CHILENO;;X;VALPARAISO                    ;VALPARAISO;490165;19;13;0;0;0;19;13;490165;Mouse Bluetooth Hdwr Mint;ACCESORIOS
17311382;Soltero;M;32;CHILENO;PROFESIONALES;Millenial;RENCA                         ;METROPOLITANA;39470;3;2;2;1;12480;1;1;26990;Redmi Buds 3 Lite White;ACCESORIOS
13581623;;F;43;CHILENO;;X;CURACAUTIN                    ;ARAUCANIA;372920;8;4;0;0;0;8;4;372920;GALAXY WATCH ACTIVE4 40 MM LTE GOLD;ACCESORIOS
11433245;;M;53;CHILENO;;X;N/D;N/D;36980;2;1;0;0;0;2;1;36980;Teclado Gamer GT M867;ACCESORIOS
11629582;;M;51;CHILENO;;X;CERRO NAVIA                   ;METROPOLITANA;9990;1;3;0;0;0;1;3;9990;AUDIFONO GAMER 1 PLUG STEREO CON MICROFONO H220S;ACCESORIOS
18611520;;F;28;CHILENO;;Millenial;PUDAHUEL;METROPOLITANA;69980;2;1;0;0;0;2;1;69980;MI Smart Band 6 Negra XIAOMI;ACCESORIOS
10903142;;F;51;CHILENO;;X;SAN VICENTE                   ;L.G.B.OÂ´HIGGINS;653660;7;5;0;0;0;7;5;653660;SAMSUNG TYPE-C EARPHONES BLACK;ACCESORIOS
18522342;;F;28;CHILENO;;Millenial;MARIQUINA                     ;LOS LAGOS;545950;6;4;0;0;0;6;4;545950;Kit 4 en 1 Gamer M501;ACCESORIOS
19799949;;F;24;CHILENO;;Z;LOS ALAMOS                    ;BIO BIO;56980;2;2;1;1;34990;1;1;21990;ALTEC LANSING AUDIFONO Nano Pods TWS ICE BLUE 89;ACCESORIOS
16511802;;M;35;CHILENO;;Millenial;CANETE;BIO-BIO;318950;5;5;0;0;0;5;5;318950;REDMI BUDS 3 PRO (GRAPHITE BLACK);ACCESORIOS
20513580;;M;21;CHILENO;;Z;CORONEL;BIO-BIO;193950;5;3;4;2;172960;1;1;20990;Teclado Gamer Pro M858;ACCESORIOS
11316887;;M;54;CHILENO;;Boomers;N/D;N/D;1039920;7;3;0;0;0;7;3;1039920;SOPORTE TV 32-65 KTA03 KIOTO FIJO;ACCESORIOS
17609761;Soltero;M;31;CHILENO;;Millenial;PROVIDENCIA                   ;METROPOLITANA;29990;1;1;0;0;0;1;1;29990;Audifonos Gamer Ultimate M2026;ACCESORIOS
15151630;;M;40;CHILENO;;X;HUECHURABA                    ;METROPOLITANA;129990;1;1;0;0;0;1;1;129990;AUDIFONOS GALAXY BUDS PRO BLACK;ACCESORIOS
26182130;;M;33;VENEZOLANO;;Extranjero;"";"";99990;1;1;0;0;0;1;1;99990;Silla Gamer Python Roja;ACCESORIOS
14472112;;M;47;CHILENO;;X;PROVIDENCIA                   ;METROPOLITANA;1310970;4;5;4;5;1310970;0;0;0;Galaxy Watch Active4 40 mm Black;ACCESORIOS
13394303;;F;43;CHILENO;;X;ANGOL                         ;ARAUCANIA;552341;8;7;0;0;0;8;7;552341;Redmi Buds 3;ACCESORIOS
20119075;;M;23;CHILENO;;Z;PROVIDENCIA                   ;METROPOLITANA;917960;4;2;4;2;917960;0;0;0;TRAVEL ADAPTER 15W - FAST CHARGER (TYPE-C CABLE);ACCESORIOS
25763521;;F;58;EXTRANJERO - NO INFORMA NACIONALIDAD;;Extranjero;PUENTE ALTO                   ;METROPOLITANA;101990;2;3;0;0;0;2;3;101990;AUDIFONO MOTO BUDBS 100 TRUE WIRELESS WHITE;ACCESORIOS
19215314;;M;26;CHILENO;;Z;CALAMA                        ;ANTOFAGASTA;129980;2;2;0;0;0;2;2;129980;GALAXY WATCH ACTIVE4 40 MM SILVER;ACCESORIOS
10750900;;M;54;CHILENO;;Boomers;PROVIDENCIA                   ;METROPOLITANA;65980;2;1;0;0;0;2;1;65980;SOPORTE TV KT- AC01;ACCESORIOS
18416338;Soltero;M;29;CHILENO;;Millenial;LA GRANJA                     ;METROPOLITANA;93060;16;3;0;0;0;16;3;93060;Mi Smart Band 6 Negra Xiaomi;ACCESORIOS
16226944;;M;36;CHILENO;;Millenial;N/D;N/D;39990;1;1;0;0;0;1;1;39990;Redmi Buds 3;ACCESORIOS
19552223;;F;24;CHILENO;;Z;N/D;N/D;3990;1;1;0;0;0;1;1;3990;AUDIFONO MLAB ON HEADBAND P800 BLACK 7403;ACCESORIOS
19740528;;F;25;CHILENO;;Z;PROVIDENCIA                   ;METROPOLITANA;9990;1;1;0;0;0;1;1;9990;TRAVEL ADAPTER 15W - FAST CHARGER (TYPE-C CABLE);ACCESORIOS
20294421;;M;22;CHILENO;;Z;TEMUCO;ARAUCANIA;177950;5;4;2;1;124980;3;3;52970;SAMSUNG TYPE-C EARPHONES BLACK;ACCESORIOS
20399923;;F;22;CHILENO;;Z;QUILLOTA;VALPARAISO;25970;3;2;2;1;18980;1;1;6990;AUDIFONO IN PANASONIC RP-TCM130PPW BLANCO;ACCESORIOS
10888769;;M;54;CHILENO;;Boomers;YERBAS BUENAS                 ;MAULE;684030;6;3;0;0;0;6;3;684030;AUDIFONOS HUAWEI FREEBUDS PRO SILVER;ACCESORIOS
13791192;;F;41;CHILENO;;X;N/D;N/D;845960;4;3;1;1;119990;3;2;725970;Silla Gamer Balderi Negra;ACCESORIOS
19052319;;F;26;CHILENO;;Z;LOS ANGELES                   ;BIO BIO;269820;4;2;2;1;255840;2;1;13980;SOPORTE TV 26-56 KTA02 KIOTO FIJO;ACCESORIOS
11769297;;F;50;CHILENO;;X;RETIRO                        ;MAULE;246051;6;5;0;0;0;6;5;246051;SOPORTE TV 26-56 KTAT02 KIOTO MOVIL;ACCESORIOS
17625814;;F;31;CHILENO;;Millenial;LA SERENA                     ;COQUIMBO;42970;3;2;3;2;42970;0;0;0;SOPORTE TV 26-56 KTA02 KIOTO FIJO;ACCESORIOS
17969299;;M;30;CHILENO;;Millenial;N/D;N/D;17832;2;1;0;0;0;2;1;17832;AUDIFONO TEEN FROZEN 2 ELSA+ANNA ALAMBRICO;ACCESORIOS
5432735;;M;72;CHILENO;;Silencioso;ILLAPEL                       ;COQUIMBO;6990;1;1;0;0;0;1;1;6990;SOPORTE TV 26-56 KTA02 KIOTO FIJO;ACCESORIOS
13034979;;M;46;CHILENO;;X;"";"";12980;2;2;0;0;0;2;2;12980;MOUSE 100 WIRED;ACCESORIOS
20097570;;F;23;CHILENO;;Z;REQUINOA                      ;L.G.B.OÂ´HIGGINS;5990;1;1;1;1;5990;0;0;0;TYPE C TO TYPE C CABLE 3A (MAX 60W);ACCESORIOS
10671426;;M;47;CHILENO;;X;PROVIDENCIA                   ;METROPOLITANA;69970;3;2;3;2;69970;0;0;0;Teclado Gamer Pro M858;ACCESORIOS
19470070;;F;27;CHILENO;;Z;QUILPUE;VALPARAISO;39950;5;2;0;0;0;5;2;39950;SAMSUNG TYPE-C EARPHONES BLACK;ACCESORIOS
13102843;;M;45;CHILENO;;X;CABRERO                       ;BIO BIO;134990;3;2;1;1;14990;2;1;120000;Multiconector M350;ACCESORIOS
18366167;;M;29;CHILENO;;Millenial;PROVIDENCIA                   ;METROPOLITANA;14990;1;1;0;0;0;1;1;14990;SAMSUNG TYPE-C EARPHONES BLACK;ACCESORIOS
20198334;;M;23;CHILENO;;Extranjero;PROVIDENCIA                   ;N/D;153980;2;1;2;1;153980;0;0;0;SILLA GAMER ARMOR S / 3MGC2NXB.0001;ACCESORIOS
14264386;;F;52;CHILENO;;X;PROVIDENCIA                   ;METROPOLITANA;241711;4;3;0;0;0;4;3;241711;SOPORTE TV 26-56 KTA02 KIOTO FIJO;ACCESORIOS
19846490;;F;23;CHILENO;;Z;PROVIDENCIA                   ;METROPOLITANA;34980;2;2;2;2;34980;0;0;0;Microfono Gamer M59;ACCESORIOS
16583390;;M;34;CHILENO;;Millenial;LINARES                       ;MAULE;52970;3;2;0;0;0;3;2;52970;SOPORTE TV 26-56 KTA02 KIOTO FIJO;ACCESORIOS
11434810;Divorciado;M;53;CHILENO;INTERPRETE DE IDIOMAS;X;MACUL;METROPOLITANA;27970;3;1;3;1;27970;0;0;0;3-PACK TOMACORRIENTE SMART NEXXT;ACCESORIOS
25458439;;M;23;EXTRANJERO - NO INFORMA NACIONALIDAD;;Extranjero;PROVIDENCIA                   ;METROPOLITANA;57990;1;1;1;1;57990;0;0;0;PARLANTES SRS-XB23/LC LA;ACCESORIOS
15332745;;F;39;CHILENO;;X;"";"";7990;1;3;0;0;0;1;3;7990;JBL AUDIFONOS ON-EAR BLUETOOTH TUNE 510BT AZUL;ACCESORIOS
9955277;;M;58;CHILENO;;Boomers;PROVIDENCIA                   ;METROPOLITANA;21990;1;1;0;0;0;1;1;21990;Audifonos Gamer Pro M2022;ACCESORIOS
25343512;Casado;M;40;CUBANO;;Extranjero;PROVIDENCIA                   ;METROPOLITANA;545970;3;2;3;2;545970;0;0;0;AUDIFONO GALAXY BUDS2 VIOLET;ACCESORIOS
17714705;;F;31;CHILENO;;Millenial;PROVIDENCIA                   ;METROPOLITANA;9990;1;1;0;0;0;1;1;9990;Funda Con Cierre 14;ACCESORIOS
12812611;;F;46;CHILENO;;X;PROVIDENCIA                   ;METROPOLITANA;34990;1;3;3;2;188970;-2;1;-153980;365 Personal Suscripcion Anual QQ2-0008TP;ACCESORIOS
8918887;;M;61;CHILENO;;Boomers;CALAMA                        ;ANTOFAGASTA;11990;1;1;0;0;0;1;1;11990;SOPORTE TV 32-65 KTA03 KIOTO FIJO;ACCESORIOS
10043300;;M;52;CHILENO;;X;N/D;N/D;67950;5;4;0;0;0;5;4;67950;SOPORTE TV 32-65 KTA03 KIOTO FIJO;ACCESORIOS
20500568;;M;21;CHILENO;;Z;BULNES;BIO-BIO;45980;2;1;0;0;0;2;1;45980;Redmi Buds 3 Lite White;ACCESORIOS
15999367;;M;37;CHILENO;;Millenial;RENCA                         ;METROPOLITANA;159980;2;2;0;0;0;2;2;159980;AUDIFONOS GALAXY BUDS PRO BLACK;ACCESORIOS
13702842;;M;43;CHILENO;;X;PIRQUE;METROPOLITANA;365932;7;3;4;2;64960;3;1;300972;PARLANTE KARAOKE FD-PKBT82 8 LUCES MIC/FM/BT/USB;ACCESORIOS
12727905;;F;46;CHILENO;;Silencioso;PROVIDENCIA                   ;METROPOLITANA;39990;1;1;1;1;39990;0;0;0;365 Familia 6 usuarios Anual;ACCESORIOS
26103399;;F;35;COLOMBIANO;;Extranjero;N/D;N/D;188620;7;6;0;0;0;7;6;188620;TRAVEL ADAPTER 15W - FAST CHARGER (TYPE-C CABLE);ACCESORIOS
14398147;;F;44;CHILENO;;X;"";"";22990;1;1;0;0;0;1;1;22990;Redmi Buds 3 Lite Black;ACCESORIOS
8602338;;F;61;CHILENO;;Boomers;ANCUD                         ;LOS LAGOS;36990;1;1;0;0;0;1;1;36990;AUDIFONO XIAOMI EARPHONES MI TRUE WIRELESS 2 BAS;ACCESORIOS
20718141;;F;21;CHILENO;;Z;COQUIMBO;COQUIMBO;13980;4;2;1;1;12990;3;1;990;SOPORTE TV 14-42 KTAM02 KIOTO C/ BRAZO MOVIL;ACCESORIOS
9185493;;F;60;CHILENO;;Boomers;RENCA                         ;METROPOLITANA;13980;2;1;2;1;13980;0;0;0;TECLADO GAMER LUMINOSO MARVO;ACCESORIOS
19869944;;M;23;CHILENO;;Z;PROVIDENCIA                   ;METROPOLITANA;281960;4;2;4;2;281960;0;0;0;AUDIFONOS HUAWEI FREEBUDS PRO SILVER;ACCESORIOS
18324199;;F;29;CHILENO;;Millenial;N/D;N/D;1105890;11;10;5;4;157950;6;6;947940;SOPORTE TV 14-63 CON BRAZO KT-FM 3L;ACCESORIOS
19548498;;M;25;CHILENO;;Z;VINA DEL MAR                  ;VALPARAISO;343940;7;6;0;0;0;7;6;343940;ALTEC LANSING AUDIFONO HEADBAND BLUETOOTH COMFOR;ACCESORIOS
10158819;;F;56;CHILENO;;Boomers;VICTORIA                      ;ARAUCANIA;77220;4;2;0;0;0;4;2;77220;Redmi Buds 3 Lite White;ACCESORIOS
19352836;;M;26;CHILENO;;Z;PROVIDENCIA                   ;METROPOLITANA;0;0;2;0;2;0;0;0;0;GALAXY WATCH4 42 MM BLACK;ACCESORIOS
16568639;;F;34;CHILENO;;Millenial;BUIN                          ;METROPOLITANA;22990;1;1;0;0;0;1;1;22990;Redmi Buds 3 Lite White;ACCESORIOS
17604028;Soltero;F;31;CHILENO;;Silencioso;PROVIDENCIA                   ;METROPOLITANA;348970;3;3;3;3;348970;0;0;0;DISCO DURO CANVIO 1TB BASICS BLACK TOSHIBA;ACCESORIOS
11471035;;F;53;CHILENO;;X;N/D;N/D;14990;1;1;0;0;0;1;1;14990;AUDIFONO ON ZX310AP ROJO;ACCESORIOS
12947415;;M;47;CHILENO;;X;RENCA                         ;METROPOLITANA;24990;1;1;0;0;0;1;1;24990;SOPORTE TV 14-63 CON BRAZO KT-FM 3L;ACCESORIOS
20129899;;M;23;CHILENO;;Z;RECOLETA;METROPOLITANA;8000;2;1;0;0;0;2;1;8000;Parlante Karaoke Blik Screamer 1;ACCESORIOS
20049508;;M;23;CHILENO;;Z;"";"";6000;2;1;0;0;0;2;1;6000;PAD MOUSE GAMER EXTRA LARGE MP9040;ACCESORIOS
15713361;;M;38;CHILENO;;Millenial;RENCA                         ;METROPOLITANA;12990;1;1;0;0;0;1;1;12990;SAMSUNG TYPE-C EARPHONES BLACK;ACCESORIOS
19825443;;M;24;CHILENO;;Z;N/D;N/D;198030;6;4;0;0;0;6;4;198030;ALTEC LANSING AUDIFONO Nano Pods TWS PURPLE 8996;ACCESORIOS
20373410;;F;22;CHILENO;;Z;PROVIDENCIA                   ;METROPOLITANA;79990;1;1;1;1;79990;0;0;0;AUDIFONO GALAXY BUDS2 VIOLET;ACCESORIOS
25600140;Casado;M;33;ECUATORIANO;MEDICO CIRUJANO;Extranjero;PROVIDENCIA                   ;METROPOLITANA;113980;2;1;2;1;113980;0;0;0;AUDIFONOS GALAXY BUDS PRO BLACK;ACCESORIOS
16046579;;M;37;CHILENO;;Millenial;TEMUCO;ARAUCANIA;76980;2;1;2;1;76980;0;0;0;Reloj Smartwatch Lhotse RD9 Dark Silver Naranjo;ACCESORIOS
19634128;;F;25;CHILENO;;Silencioso;PROVIDENCIA                   ;METROPOLITANA;39990;1;1;1;1;39990;0;0;0;HUAWEI FREEBUDS 4i SILVER FROST;ACCESORIOS
19232297;Soltero;M;26;CHILENO;;Z;PROVIDENCIA                   ;METROPOLITANA;16980;2;1;2;1;16980;0;0;0;PARLANTES GAMER DHS-2101;ACCESORIOS
18570620;;M;28;CHILENO;;Millenial;PROVIDENCIA                   ;METROPOLITANA;8990;1;1;0;0;0;1;1;8990;SOPORTE TV 32-65 KTA03 KIOTO FIJO;ACCESORIOS
19531784;;F;25;CHILENO;;Z;PENCO;BIO-BIO;18990;2;1;0;0;0;2;1;18990;AUDIFONO INALAMBRICO N68 FIDDLER;ACCESORIOS
10800463;;M;44;CHILENO;;X;CALBUCO                       ;LOS LAGOS;11990;1;1;0;0;0;1;1;11990;SAMSUNG TYPE-C EARPHONES BLACK;ACCESORIOS
27087524;;M;27;VENEZOLANO;;Extranjero;TALCAHUANO;BIO-BIO;39990;1;1;1;1;39990;0;0;0;HUAWEI FREEBUDS 4i SILVER FROST;ACCESORIOS
16882851;;F;34;CHILENO;;Millenial;RANCAGUA                      ;L.G.B.OÂ´HIGGINS;87980;2;1;2;1;87980;0;0;0;Silla Gamer Tyrus Blanco rosadosa;ACCESORIOS
7463061;Casado;M;65;CHILENO;INGENIERO;Boomers;LOS ANDES                     ;VALPARAISO;43980;2;1;2;1;43980;0;0;0;HUAWEI FREEBUDS 4i SILVER FROST;ACCESORIOS
11584469;;M;52;CHILENO;;X;TIRUA                         ;BIO BIO;534970;5;3;0;0;0;5;3;534970;SOPORTE TV 14-63 CON BRAZO KT-FM 3L;ACCESORIOS
17367545;;F;32;CHILENO;;Millenial;N/D;N/D;195951;6;3;0;0;0;6;3;195951;Mi In-Ear Headphones Basic (Black) XIAOMI;ACCESORIOS
8213943;;F;63;CHILENO;;Boomers;PUNTA ARENAS                  ;MAGALLANES;91980;2;2;0;0;0;2;2;91980;KARAOKE MLAB TOWER OUTDOOR MIC BT BK 8568;ACCESORIOS
26000074;;F;48;COLOMBIANO;;Extranjero;SANTIAGO                      ;METROPOLITANA;59990;1;1;0;0;0;1;1;59990;FREEBUDS 4i BLACK HUAWEI;ACCESORIOS
15835193;;F;37;CHILENO;;Millenial;CONCHALI                      ;METROPOLITANA;16980;2;1;2;1;16980;0;0;0;SAMSUNG TYPE-C EARPHONES BLACK;ACCESORIOS
8513407;;M;57;CHILENO;;Boomers;COIHAIQUE                     ;AYSEN;1294950;5;4;0;0;0;5;4;1294950;ALTEC LANSING AUDIFONO Nanobuds TWS 2.0 GRAY BLA;ACCESORIOS
12690749;;M;48;CHILENO;;X;"";"";180000;2;1;0;0;0;2;1;180000;Galaxy Watch Active4 40 mm Black;ACCESORIOS
20230274;;F;22;CHILENO;;Z;PROVIDENCIA                   ;METROPOLITANA;6990;1;1;0;0;0;1;1;6990;SOPORTE TV 26-56 KTA02 KIOTO FIJO;ACCESORIOS
15442494;;M;39;CHILENO;;X;MAIPU;METROPOLITANA;100960;4;2;4;2;100960;0;0;0;10000mAh Mi 18W Fast Charge Power Bank 3 (Black);ACCESORIOS
18722609;;M;28;CHILENO;;Millenial;SAN FERNANDO                  ;L.G.B.OÂ´HIGGINS;64980;2;2;0;0;0;2;2;64980;20000mAh REDMI 18W FAST CHARGE POWER BANK BLACK;ACCESORIOS
25519617;Soltero;M;44;SUECO;;Extranjero;PROVIDENCIA                   ;METROPOLITANA;252960;4;2;4;2;252960;0;0;0;AUDIFONO WH-CH510/BZ UC;ACCESORIOS
20128360;;F;23;CHILENO;;Z;PROVIDENCIA                   ;METROPOLITANA;90980;2;2;0;0;0;2;2;90980;New GAMEPAD - GLAP;ACCESORIOS
14381248;;F;42;CHILENO;;X;PROVIDENCIA                   ;METROPOLITANA;43980;2;1;2;1;43980;0;0;0;HUAWEI FREEBUDS 4i SILVER FROST;ACCESORIOS
15951380;;F;37;CHILENO;;Millenial;QUILLOTA                      ;VALPARAISO;139980;2;1;0;0;0;2;1;139980;Silla Gamer Tyrus Negra;ACCESORIOS
18460466;;M;28;CHILENO;;Millenial;LLANQUIHUE;LOS LAGOS;81970;3;3;0;0;0;3;3;81970;Redmi Buds 3 Lite White;ACCESORIOS
9650320;;F;61;CHILENO;;Boomers;SAN FERNANDO                  ;L.G.B.OÂ´HIGGINS;54173;3;3;0;0;0;3;3;54173;SOPORTE TV 32-65 KTA03 KIOTO FIJO;ACCESORIOS
14549550;;F;47;CHILENO;;X;N/D;N/D;472960;4;2;0;0;0;4;2;472960;Silla Gamer Tyrus Blanco rosadosa;ACCESORIOS
10786999;;F;57;CHILENO;;Boomers;N/D;N/D;6990;1;1;0;0;0;1;1;6990;SOPORTE TV 26-56 KTA02 KIOTO FIJO;ACCESORIOS
19684060;;M;24;CHILENO;;Z;MACUL;METROPOLITANA;357960;4;2;4;2;357960;0;0;0;AUDIFONOS GALAXY BUDS PRO SILVER;ACCESORIOS
13022992;;M;46;CHILENO;;X;IQUIQUE                       ;TARAPACA;8000;2;1;0;0;0;2;1;8000;Mouse Gamer Ultimate M1019;ACCESORIOS
5171947;;M;77;CHILENO;;Silencioso;LOS ANGELES                   ;BIO BIO;22990;1;1;0;0;0;1;1;22990;AUDIFONO XIAOMI EARPHONES MI TRUE WIRELESS 2 BAS;ACCESORIOS
18890499;Soltero;F;27;CHILENO;;Z;PROVIDENCIA                   ;METROPOLITANA;22990;1;1;0;0;0;1;1;22990;Redmi Buds 3 Lite Black;ACCESORIOS
11968582;;M;50;CHILENO;;X;RENCA                         ;METROPOLITANA;14990;1;1;0;0;0;1;1;14990;SOPORTE TV 14-63 CON BRAZO KT-FM 3L;ACCESORIOS
19988404;;F;23;CHILENO;;Z;PROVIDENCIA                   ;METROPOLITANA;232980;2;1;0;0;0;2;1;232980;GALAXY WATCH4 42 MM BLACK;ACCESORIOS
19544846;Soltero;M;25;CHILENO;;Z;SANTIAGO;METROPOLITANA;69990;1;1;0;0;0;1;1;69990;REDMI BUDS 3 PRO (GRAPHITE BLACK);ACCESORIOS
19523213;;M;25;CHILENO;;Z;"";"";0;0;2;0;0;0;0;2;0;AUDIFONO KIDS SPIDERMAN ALAMBRICO;ACCESORIOS
13824377;;M;42;CHILENO;;X;PUERTO MONTT                  ;LOS LAGOS;295950;5;4;0;0;0;5;4;295950;PARLANTES GAMER DHS-2101;ACCESORIOS
19799354;;M;24;CHILENO;;Z;CORONEL                       ;BIO BIO;7990;1;1;0;0;0;1;1;7990;SOPORTE TV 26-56 KTA02 KIOTO FIJO;ACCESORIOS
20288119;;M;23;CHILENO;;Z;"";"";193820;6;4;4;2;120950;2;2;72870;MI SMART SPEAKER;ACCESORIOS
17996567;;M;30;CHILENO;;Millenial;ILLAPEL                       ;COQUIMBO;91980;2;2;0;0;0;2;2;91980;PARLANTE KARAOKE MGPANTERA NEGRO;ACCESORIOS
15405079;;M;39;CHILENO;;X;MELIPILLA                     ;METROPOLITANA;24990;1;1;0;0;0;1;1;24990;Parlante Bluetooth Blik Booster 1;ACCESORIOS
13767680;;M;42;CHILENO;;X;PROVIDENCIA                   ;METROPOLITANA;202970;3;3;0;0;0;3;3;202970;SOPORTE TV 14-63 CON BRAZO KT-FM 3L;ACCESORIOS
8860023;;M;61;CHILENO;;Boomers;RECOLETA                      ;METROPOLITANA;23000;2;1;0;0;0;2;1;23000;Redmi Buds 3 Lite Black;ACCESORIOS
12719566;;M;46;CHILENO;;X;N/D;N/D;44960;4;2;0;0;0;4;2;44960;AUDIFONO SAMSUNG WIRELESS A08C;ACCESORIOS
11392766;;M;52;CHILENO;;X;N/D;N/D;783960;4;2;2;1;753980;2;1;29980;SOPORTE TV 14-63 CON BRAZO KT-FM 3L;ACCESORIOS
17518469;;M;32;CHILENO;;Millenial;EL MONTE                      ;METROPOLITANA;434940;6;3;2;1;203980;4;2;230960;GALAXY WATCH ACTIVE4 40 MM GOLD;ACCESORIOS
15340406;;M;39;CHILENO;;X;"";"";638509;9;8;0;0;0;9;8;638509;ALTEC LANSING AUDIFONO Nanobuds TWS 2.0 GRAY BLA;ACCESORIOS
17423478;;F;33;CHILENO;;Millenial;SANTA BARBARA                 ;BIO BIO;9990;1;1;0;0;0;1;1;9990;TRAVEL ADAPTER 15W - FAST CHARGER (TYPE-C CABLE);ACCESORIOS
15066844;Soltero;M;38;CHILENO;;X;CATEMU                        ;VALPARAISO;645940;6;2;0;0;0;6;2;645940;SAMSUNG TYPE-C EARPHONES BLACK;ACCESORIOS
20437384;;F;22;CHILENO;;Z;N/D;N/D;15990;1;1;0;0;0;1;1;15990;AUDIFONO BLUETOOTH SPIDERMAN;ACCESORIOS
19800651;;F;25;CHILENO;;Z;PENAFLOR;METROPOLITANA;29980;2;2;0;0;0;2;2;29980;SOPORTE TV 14-42 KTAM02 KIOTO C/ BRAZO MOVIL;ACCESORIOS
13353136;;F;44;CHILENO;;X;LICANTEN                      ;MAULE;33980;2;1;0;0;0;2;1;33980;KARAOKE MLAB TOWER OUTDOOR MIC BT BK 8568;ACCESORIOS
11334530;;F;55;CHILENO;;Boomers;PROVIDENCIA                   ;METROPOLITANA;21990;1;1;0;0;0;1;1;21990;KARAOKE MLAB TOWER OUTDOOR MIC BT BK 8568;ACCESORIOS
12166138;;M;44;CHILENO;;X;N/D;N/D;49960;4;2;4;2;49960;0;0;0;Teclado + Mouse 510 Wireless Combo - LA Spanish;ACCESORIOS
7599864;;M;65;CHILENO;;Boomers;TIRUA                         ;BIO BIO;1309431;7;2;0;0;0;7;2;1309431;Escritorio Gamer Pro RGB;ACCESORIOS
7484998;;F;68;CHILENO;;Silencioso;BUIN                          ;METROPOLITANA;41970;3;3;0;0;0;3;3;41970;SOPORTE TV 26-56 KTA02 KIOTO FIJO;ACCESORIOS
14025621;;M;41;CHILENO;;X;CHILLAN                       ;BIO BIO;11980;2;1;0;0;0;2;1;11980;SOPORTE TV 32-65 KTA03 KIOTO FIJO;ACCESORIOS
9935930;;F;58;CHILENO;;Boomers;VINA DEL MAR                  ;VALPARAISO;23990;1;1;0;0;0;1;1;23990;KARAOKE MLAB TOWER OUTDOOR MIC BT BK 8568;ACCESORIOS
18706339;;F;27;CHILENO;;Millenial;VALPARAISO                    ;VALPARAISO;9990;1;1;0;0;0;1;1;9990;MOUSE 200 RED WIRELESS;ACCESORIOS
19092989;;F;27;CHILENO;;Z;"";"";100000;2;1;0;0;0;2;1;100000;AUDIFONO GALAXY BUDS LIVE NEGRO;ACCESORIOS
19592648;;M;24;CHILENO;;Z;N/D;N/D;52970;3;3;0;0;0;3;3;52970;SAMSUNG TYPE-C EARPHONES BLACK;ACCESORIOS
14485787;;M;48;CHILENO;;X;CONSTITUCION                  ;MAULE;29990;1;1;0;0;0;1;1;29990;AUDIFONO MOTOROLA BLUETOOTH ESCAPE 220 NEGRO;ACCESORIOS
5321634;;F;77;CHILENO;;Silencioso;PROVIDENCIA                   ;METROPOLITANA;10140;2;1;0;0;0;2;1;10140;TRAVEL ADAPTER 15W - FAST CHARGER (TYPE-C CABLE);ACCESORIOS
11851207;Casado;F;50;CHILENO;ANALISTA DE SISTEMAS;X;RENCA                         ;METROPOLITANA;109990;2;1;2;1;109990;0;0;0;AUDIFONOS GALAXY BUDS PRO SILVER;ACCESORIOS
4265653;;M;81;CHILENO;;Silencioso;SAN FELIPE                    ;VALPARAISO;14990;1;1;0;0;0;1;1;14990;SOPORTE TV 14-63 CON BRAZO KT-FM 3L;ACCESORIOS
15895097;;M;38;CHILENO;;Millenial;PROVIDENCIA;METROPOLITANA;13990;1;1;0;0;0;1;1;13990;PARLANTE 6985 MLAB VERTICAL BRITPOP BT;ACCESORIOS
18142155;Soltero;M;29;CHILENO;;Millenial;PROVIDENCIA                   ;METROPOLITANA;12990;1;1;0;0;0;1;1;12990;10000mAh Redmi Power Bank Black XIAOMI;ACCESORIOS
15003237;;M;40;CHILENO;;X;VILLARICA                     ;ARAUCANIA;225980;2;2;1;1;199990;1;1;25990;SOPORTE TV 14-63 CON BRAZO KT-FM 3L;ACCESORIOS
13736909;;F;43;CHILENO;;X;TEMUCO                        ;ARAUCANIA;45940;6;5;0;0;0;6;5;45940;Mi In-Ear Headphones Basic (Black) XIAOMI;ACCESORIOS
26092398;Soltero;F;50;NO INFORMA NACIONALIDAD;;Extranjero;CONSTITUCION                  ;MAULE;59990;1;1;0;0;0;1;1;59990;DISCO DURO CANVIO 1TB BASICS BLACK TOSHIBA;ACCESORIOS
15953479;Casado;M;37;CHILENO;INGENIERO EN ADMINISTRACION DE EMPRESAS;Millenial;PENALOLEN                     ;METROPOLITANA;45980;2;1;0;0;0;2;1;45980;SMARTBAND SAMSUNG GALAXY FIT 2 ROJO;ACCESORIOS
18894391;;F;27;CHILENO;;Millenial;N/D;N/D;2000;2;1;0;0;0;2;1;2000;AUDIFONO PANASONIC IN RP-HV096E-K NEGRO;ACCESORIOS
11077749;Soltero;F;56;CHILENO;;Silencioso;PROVIDENCIA                   ;METROPOLITANA;7990;1;1;0;0;0;1;1;7990;SOPORTE TV 26-56 KTA02 KIOTO FIJO;ACCESORIOS
15346440;;M;40;CHILENO;;Silencioso;PROVIDENCIA                   ;METROPOLITANA;42990;1;1;1;1;42990;0;0;0;365 Personal Suscripcion Anual QQ2-0008TP;ACCESORIOS
16711244;;F;34;CHILENO;;Millenial;SANTIAGO                      ;METROPOLITANA;25990;1;1;0;0;0;1;1;25990;PARLANTE KARAOKE MGGLADIATOR NEGRO;ACCESORIOS
13174897;;M;45;CHILENO;;X;N/D;N/D;96970;3;2;0;0;0;3;2;96970;PARLANTE KARAOKE FD-PKBT82 8 LUCES MIC/FM/BT/USB;ACCESORIOS
10136588;;M;56;CHILENO;;Boomers;CASTRO                        ;LOS LAGOS;109990;1;1;0;0;0;1;1;109990;Silla Gamer Python Roja;ACCESORIOS
15024513;;F;40;CHILENO;;Z;PROVIDENCIA                   ;METROPOLITANA;169990;1;1;1;1;169990;0;0;0;GALAXY WATCH ACTIVE4 40 MM SILVER;ACCESORIOS
15695095;;M;38;CHILENO;;Millenial;ARICA                         ;TARAPACA;19990;1;1;0;0;0;1;1;19990;Travel Adapter SFC 25W Type C (w/o Cable);ACCESORIOS
18136800;;M;29;CHILENO;;Millenial;PROVIDENCIA                   ;METROPOLITANA;14990;1;1;1;1;14990;0;0;0;Travel Adapter SFC 25W Type C (w/o Cable);ACCESORIOS
11938984;;M;50;CHILENO;;X;RENCA                         ;METROPOLITANA;6990;1;1;0;0;0;1;1;6990;SOPORTE TV 26-56 KTA02 KIOTO FIJO;ACCESORIOS
12715680;;M;48;CHILENO;;X;COIHAIQUE                     ;AYSEN;20990;1;1;0;0;0;1;1;20990;AUDIFONO XIAOMI EARBUDS MI TRUE WIRELESS BASIC 2;ACCESORIOS
11443654;Casado;F;53;CHILENO;;X;RENCA                         ;METROPOLITANA;6990;1;1;1;1;6990;0;0;0;SOPORTE TV 26-56 KTAT02 KIOTO MOVIL;ACCESORIOS
17986506;;F;30;CHILENO;;Millenial;MELIPILLA                     ;METROPOLITANA;37980;2;1;0;0;0;2;1;37980;KARAOKE MLAB TOWER OUTDOOR MIC BT BK 8568;ACCESORIOS
19132251;Soltero;M;26;CHILENO;;Z;COIHAIQUE                     ;AYSEN;806314;16;13;1;1;14990;15;12;791324;Mousepad Gamer M905;ACCESORIOS
19828266;;M;24;CHILENO;;Z;MAIPU;METROPOLITANA;169990;2;1;2;1;169990;0;0;0;GALAXY WATCH4 42 MM SILVER;ACCESORIOS
10802067;;F;51;CHILENO;;X;LA SERENA;COQUIMBO;124990;1;1;1;1;124990;0;0;0;AUDIFONOS GALAXY BUDS PRO BLACK;ACCESORIOS
11892874;;F;51;CHILENO;;X;PROVIDENCIA                   ;METROPOLITANA;284980;2;4;0;0;0;2;4;284980;SOPORTE TV 14-63 CON BRAZO KT-FM 3L;ACCESORIOS
16437657;;F;35;CHILENO;;Millenial;N/D;N/D;139990;1;1;1;1;139990;0;0;0;AUDIFONOS GALAXY BUDS PRO BLACK;ACCESORIOS
16037933;;M;36;CHILENO;;Millenial;N/D;N/D;890830;5;3;3;2;690830;2;1;200000;Travel Adapter SFC 25W Type C (w/o Cable);ACCESORIOS
18051504;;F;30;CHILENO;;Millenial;BUIN                          ;METROPOLITANA;130000;2;1;0;0;0;2;1;130000;AUDIFONOS GALAXY BUDS PRO BLACK;ACCESORIOS
23937010;Soltero;F;34;COLOMBIANO;;Extranjero;PROVIDENCIA                   ;METROPOLITANA;179990;1;1;0;0;0;1;1;179990;GALAXY WATCH ACTIVE4 40 MM GOLD;ACCESORIOS
14028123;;F;40;CHILENO;;X;PROVIDENCIA                   ;METROPOLITANA;10990;1;1;0;0;0;1;1;10990;TRAVEL ADAPTER 15W - FAST CHARGER (TYPE-C CABLE);ACCESORIOS
18314384;;M;29;CHILENO;;Millenial;PROVIDENCIA                   ;METROPOLITANA;9990;1;1;1;1;9990;0;0;0;TRAVEL ADAPTER 15W - FAST CHARGER (TYPE-C CABLE);ACCESORIOS
17058723;;F;33;CHILENO;;Millenial;N/D;N/D;674720;7;6;0;0;0;7;6;674720;Escritorio Gamer RGB;ACCESORIOS
17596036;;F;31;CHILENO;;Millenial;PROVIDENCIA                   ;METROPOLITANA;16950;5;1;5;1;16950;0;0;0;MOUSE M170 LOGITECH NEGRO;ACCESORIOS
17363464;;M;32;CHILENO;;Millenial;PROVIDENCIA                   ;METROPOLITANA;0;0;2;0;2;0;0;0;0;HUAWEI FREEBUDS 4i SILVER FROST;ACCESORIOS
9021580;;M;60;CHILENO;;Boomers;RENCA                         ;METROPOLITANA;33960;4;1;0;0;0;4;1;33960;MLAB AUDIFONO AIR-ACCES POP-UP CASE HANG UP WHIT;ACCESORIOS
18120066;;M;30;CHILENO;;Millenial;CONCHALI                      ;METROPOLITANA;79990;1;1;0;0;0;1;1;79990;PARLANTE PL5 XBOOM GO BLUETHOOH 2020;ACCESORIOS
16242603;;F;36;CHILENO;;Millenial;BUIN                          ;METROPOLITANA;16990;1;1;0;0;0;1;1;16990;PARLANTE KARAOKE MGPANTERA NEGRO;ACCESORIOS
16784014;Soltero;F;34;CHILENO;;Millenial;TALAGANTE                     ;METROPOLITANA;6990;1;1;0;0;0;1;1;6990;Audifonos Orejas De Gato Rosado;ACCESORIOS
26848226;;M;33;EXTRANJERO - NO INFORMA NACIONALIDAD;;Extranjero;"";"";79980;2;1;0;0;0;2;1;79980;MI WATCH LITE NEGRO XIAOMI;ACCESORIOS
16925579;;F;33;CHILENO;;Millenial;LO BARNECHEA                  ;METROPOLITANA;48980;2;1;2;1;48980;0;0;0;HONOR BAND 6 PINK;ACCESORIOS
11379557;;F;53;CHILENO;;X;"";"";10990;1;1;0;0;0;1;1;10990;SOPORTE TV 32-65 KTA03 KIOTO FIJO;ACCESORIOS
8769015;;F;62;CHILENO;;Boomers;VINA DEL MAR                  ;VALPARAISO;41980;2;1;0;0;0;2;1;41980;AUDIFONO BLUETOOTH RP-HF410BPUA BT 24HRS AZUL;ACCESORIOS
17683290;;F;31;CHILENO;;Millenial;SANTIAGO                      ;METROPOLITANA;423960;4;2;4;2;423960;0;0;0;AUDIFONO PANASONIC Bluetooth RB-M300BE-K Negro;ACCESORIOS
8094295;;F;61;CHILENO;;Boomers;LA GRANJA                     ;METROPOLITANA;17000;2;1;0;0;0;2;1;17000;PARLANTE 8531 MLAB MAX BASS BT;ACCESORIOS
10936135;;M;51;CHILENO;;X;CHILE CHICO                   ;AYSEN;244950;5;3;0;0;0;5;3;244950;SOPORTE TV 14-63 CON BRAZO KT-FM 3L;ACCESORIOS
13615340;;M;49;CHILENO;;Extranjero;PELLUHUE                      ;MAULE;345970;3;2;0;0;0;3;2;345970;SOPORTE TV 26-56 KTAT02 KIOTO MOVIL;ACCESORIOS
17441785;;F;32;CHILENO;;Millenial;CURICO                        ;MAULE;25990;1;1;0;0;0;1;1;25990;PARLANTE KARAOKE MGROCKET NEGRO;ACCESORIOS
19571733;;M;25;CHILENO;;Z;PUENTE ALTO                   ;METROPOLITANA;12990;1;1;0;0;0;1;1;12990;AUDIFONO MLAN AIR-WIRELESS CHARGE TOUCH RED;ACCESORIOS
26956836;;F;50;EXTRANJERO - NO INFORMA NACIONALIDAD;;Extranjero;"";"";7990;1;1;0;0;0;1;1;7990;AUDIFONO IN PANASONIC RP-TCM130PPW BLANCO;ACCESORIOS
15196671;;M;39;CHILENO;;X;PROVIDENCIA                   ;METROPOLITANA;295830;3;2;2;1;95840;1;1;199990;WATCH GT2 PRO BLACK HUAWEI;ACCESORIOS
15910889;;F;38;CHILENO;;Millenial;SAN RAMON;METROPOLITANA;26980;2;1;2;1;26980;0;0;0;AUDIFONO XIAOMI EARPHONES MI TRUE WIRELESS 2 BAS;ACCESORIOS
15827816;;F;34;CHILENO;;Millenial;PADRE LAS CASAS               ;ARAUCANIA;8990;1;1;0;0;0;1;1;8990;HUAWEI AUDIFONOS MANOS LIBRES AM116;ACCESORIOS
14096980;;M;40;CHILENO;;X;OSORNO                        ;LOS LAGOS;374960;4;4;0;0;0;4;4;374960;HUAWEI FREEBUDS 4i SILVER FROST;ACCESORIOS
11241018;;M;54;CHILENO;;X;LAJA                          ;BIO BIO;19990;1;1;0;0;0;1;1;19990;Audifonos Gamer Expert MF6;ACCESORIOS
17827505;;F;32;CHILENO;;Millenial;"";"";19990;1;1;0;0;0;1;1;19990;KARAOKE MLAB TOWER OUTDOOR MIC BT BK 8568;ACCESORIOS
17607353;Soltero;M;32;CHILENO;TECNICO EN ADMINISTRACION DE EMPRESAS;Millenial;PROVIDENCIA                   ;METROPOLITANA;19990;1;3;0;0;0;1;3;19990;AUDIFONO XIAOMI EARBUDS MI TRUE WIRELESS BASIC 2;ACCESORIOS
5591000;;F;78;CHILENO;;Silencioso;RENCA                         ;METROPOLITANA;276970;3;2;0;0;0;3;2;276970;GALAXY WATCH4 42 MM BLACK;ACCESORIOS
16346906;;M;35;CHILENO;;Silencioso;PROVIDENCIA                   ;METROPOLITANA;15980;3;1;3;1;15980;0;0;0;PARLANTE BLUETOOTH BABYBOOM XL;ACCESORIOS
15423969;;M;40;CHILENO;;X;CERRILLOS                     ;METROPOLITANA;16990;1;1;0;0;0;1;1;16990;PARLANTE KARAOKE MGPANTERA NEGRO;ACCESORIOS
13933457;;F;41;CHILENO;;X;PROVIDENCIA                   ;METROPOLITANA;5990;1;1;0;0;0;1;1;5990;AUDIFONO IN SAM HS1303C/ MIC ROSADO;ACCESORIOS
19492602;;F;24;CHILENO;;Z;PROVIDENCIA                   ;METROPOLITANA;189990;1;1;1;1;189990;0;0;0;GALAXY WATCH ACTIVE4 40 MM GOLD;ACCESORIOS
25859315;;M;42;HAITIANO;;Extranjero;N/D;N/D;6990;1;1;0;0;0;1;1;6990;SOPORTE TV 26-56 KTAT02 KIOTO MOVIL;ACCESORIOS
9131240;;F;62;CHILENO;;Boomers;VINA DEL MAR                  ;VALPARAISO;8990;1;1;0;0;0;1;1;8990;PARLANTE 7284 MLAB ZUKABASS NARAN/VERDE BT;ACCESORIOS
9880390;;M;56;CHILENO;;Boomers;PUENTE ALTO                   ;METROPOLITANA;33980;2;1;0;0;0;2;1;33980;AUDIFONO INALAMBRICO N68 FIDDLER;ACCESORIOS
12028708;;F;53;CHILENO;;X;RENCA                         ;METROPOLITANA;329980;2;2;0;0;0;2;2;329980;Smartwatch GT 2 BLACK;ACCESORIOS
19540656;;M;39;CHILENO;;X;N/D;N/D;50740;5;3;0;0;0;5;3;50740;AUDIFONO GAMER ON EAR DHE-8010;ACCESORIOS
18171709;;F;29;CHILENO;;Millenial;QUILPUE                       ;VALPARAISO;16990;1;1;0;0;0;1;1;16990;PARLANTE KARAOKE MGPANTERA NEGRO;ACCESORIOS
18505669;;F;29;CHILENO;;Millenial;ARAUCO                        ;BIO BIO;8990;1;1;0;0;0;1;1;8990;PARLANTE GBASS MICRO;ACCESORIOS
18965257;Soltero;F;27;CHILENO;;Z;PROVIDENCIA                   ;METROPOLITANA;89990;1;1;0;0;0;1;1;89990;AUDIFONO GALAXY BUDS2 BLACK;ACCESORIOS
26172923;;F;28;EXTRANJERO - NO INFORMA NACIONALIDAD;;Extranjero;N/D;N/D;11990;1;1;0;0;0;1;1;11990;ARO DE LUZ LED 10 PULGADAS + TRIPODE PEQUENO;ACCESORIOS
14521209;;M;42;CHILENO;;X;CURICO                        ;MAULE;114980;2;1;0;0;0;2;1;114980;Silla Gamer Python Roja;ACCESORIOS
25923216;;F;39;BOLIVIANO;;Extranjero;IQUIQUE                       ;TARAPACA;28970;3;3;0;0;0;3;3;28970;Funda Con Cierre 15;ACCESORIOS
13179804;;M;49;CHILENO;;X;OVALLE                        ;COQUIMBO;189990;1;1;0;0;0;1;1;189990;GALAXY WATCH ACTIVE4 40 MM GOLD;ACCESORIOS
20269515;;F;22;CHILENO;;Z;"";"";22980;2;1;0;0;0;2;1;22980;AUDIFONO AIR-VICTORY BLACK 8724;ACCESORIOS
16401481;;F;36;CHILENO;;Millenial;CABILDO                       ;VALPARAISO;189990;1;1;0;0;0;1;1;189990;Galaxy Watch Active4 40 mm Black;ACCESORIOS
13796274;;M;41;CHILENO;;X;PROVIDENCIA                   ;METROPOLITANA;17990;1;1;0;0;0;1;1;17990;AUDIFONO XIAOMI EARBUDS MI TRUE WIRELESS BASIC 2;ACCESORIOS
18751967;;F;27;CHILENO;;Millenial;PROVIDENCIA                   ;METROPOLITANA;26990;1;1;0;0;0;1;1;26990;AUDIFONO MOTOROLA BLUETOOTH ESCAPE 220 NEGRO;ACCESORIOS
26855920;;M;38;EXTRANJERO - NO INFORMA NACIONALIDAD;;Extranjero;N/D;N/D;153980;2;1;2;1;153980;0;0;0;AUDIFONOS Airpods (MV7N2BE/A);ACCESORIOS
11764125;;M;50;CHILENO;;X;RENCA                         ;METROPOLITANA;189990;1;1;0;0;0;1;1;189990;GALAXY WATCH ACTIVE4 40 MM GOLD;ACCESORIOS
17539940;;F;32;CHILENO;;Millenial;TALCAHUANO                    ;BIO BIO;37230;3;2;0;0;0;3;2;37230;AUDIFONO INALAMBRICO N68 FIDDLER;ACCESORIOS
18920547;Soltero;F;27;CHILENO;;Z;PROVIDENCIA                   ;METROPOLITANA;7990;1;1;0;0;0;1;1;7990;SOPORTE TV 26-56 KTAT02 KIOTO MOVIL;ACCESORIOS
13770575;;F;42;CHILENO;;X;MAIPU                         ;METROPOLITANA;61270;5;2;0;0;0;5;2;61270;ALTEC LANSING AUDIFONO Nano Pods TWS ICE BLUE 89;ACCESORIOS
20044206;;F;23;CHILENO;;Z;PROVIDENCIA                   ;METROPOLITANA;8990;1;1;0;0;0;1;1;8990;AUDIFONO ON ZX110 SONY NEGRO;ACCESORIOS
12365377;;M;48;CHILENO;;X;RANCAGUA                      ;L.G.B.OÂ´HIGGINS;21980;2;1;0;0;0;2;1;21980;AUDIFONO TEEN SPIDERMAN ALAMBRICO;ACCESORIOS
15056426;;F;40;CHILENO;;X;CABILDO                       ;VALPARAISO;9990;1;1;0;0;0;1;1;9990;TRAVEL ADAPTER 15W - FAST CHARGER (TYPE-C CABLE);ACCESORIOS
20433940;;F;22;CHILENO;;Z;PROVIDENCIA                   ;METROPOLITANA;209990;2;1;2;1;209990;0;0;0;GALAXY WATCH ACTIVE4 40 MM LTE GOLD;ACCESORIOS
18680776;;F;27;CHILENO;;Millenial;PROVIDENCIA                   ;METROPOLITANA;43980;2;1;2;1;43980;0;0;0;BAND 6 PINK HUAWEI;ACCESORIOS
17037830;;F;34;CHILENO;;Millenial;RENCA                         ;METROPOLITANA;9990;1;1;0;0;0;1;1;9990;AUDIFONO MLAB TWS FULLY WIRELESSÂ  WHITE 8721;ACCESORIOS
16645323;;F;34;CHILENO;;Millenial;PROVIDENCIA                   ;METROPOLITANA;27990;1;1;0;0;0;1;1;27990;Desktop 850 with AES Spanish;ACCESORIOS
18281786;;M;29;CHILENO;;Millenial;N/D;N/D;39990;1;1;1;1;39990;0;0;0;BAND 6 PINK HUAWEI;ACCESORIOS
13387546;;F;43;CHILENO;;X;N/D;N/D;26980;4;1;0;0;0;4;1;26980;SMARTWATCH HUAWEI BAND 4E ACTIVE MINERAL RED;ACCESORIOS
11659663;;F;52;CHILENO;;X;FREIRE                        ;ARAUCANIA;337950;5;3;0;0;0;5;3;337950;AUDIFONO SAMSUNG WIRELESS 103B;ACCESORIOS
10111121;;M;53;CHILENO;;X;N/D;N/D;536960;4;2;4;2;536960;0;0;0;PARLANTES GAMER RGB DHE-6001;ACCESORIOS
19773608;;M;24;CHILENO;;Z;"";"";54970;3;2;1;1;29990;2;1;24980;SAMSUNG TYPE-C EARPHONES BLACK;ACCESORIOS
17655889;;F;31;CHILENO;;Millenial;CALAMA                        ;ANTOFAGASTA;382960;4;1;0;0;0;4;1;382960;GALAXY WATCH4 42 MM SILVER;ACCESORIOS
17207701;;F;33;CHILENO;;Millenial;SAN PEDRO DE LA PAZ           ;BIO BIO;120980;2;1;0;0;0;2;1;120980;Smartwatch GT 2 BLACK;ACCESORIOS
17158696;;M;33;CHILENO;;Millenial;TEMUCO                        ;ARAUCANIA;14990;1;1;0;0;0;1;1;14990;Travel Adapter SFC 25W Type C (w/o Cable);ACCESORIOS
17452348;;F;32;CHILENO;;Millenial;COQUIMBO;COQUIMBO;5990;1;1;1;1;5990;0;0;0;Mi In-Ear Headphones Basic (Black) XIAOMI;ACCESORIOS
15556824;;M;39;CHILENO;;X;RENCA                         ;METROPOLITANA;99990;1;1;0;0;0;1;1;99990;HUAWEI WATCH FIT NEW BLUE;ACCESORIOS
19571943;;M;25;CHILENO;;Millenial;N/D;N/D;431940;6;3;6;3;431940;0;0;0;AUDIFONOS GALAXY BUDS PRO VIOLET;ACCESORIOS
16152457;;F;36;CHILENO;;Millenial;TALCAHUANO                    ;BIO BIO;7990;1;1;0;0;0;1;1;7990;Audifonos Orejas De Gato Azul;ACCESORIOS
12318086;;F;48;CHILENO;;X;CAUQUENES                     ;MAULE;10000;2;1;0;0;0;2;1;10000;WIRELESS MINI MOUSE M187 REFRESH CORAL;ACCESORIOS
15041283;;F;39;CHILENO;;X;PUNTA ARENAS                  ;MAGALLANES;19990;1;1;0;0;0;1;1;19990;Mouse G203 LIGHTSYNC Gaming - BLACK;ACCESORIOS
26115432;;M;28;BOLIVIANO;;Extranjero;N/D;N/D;269970;3;4;0;0;0;3;4;269970;Galaxy Watch Active4 40 mm Black;ACCESORIOS
12165879;;M;44;CHILENO;;X;DONIHUE                       ;L.G.B.OÂ´HIGGINS;99990;1;1;0;0;0;1;1;99990;Disco Portatil Toshiba Canvio Gaming, Negro 4T;ACCESORIOS
13434922;;F;43;CHILENO;;X;BUIN                          ;METROPOLITANA;11990;1;1;0;0;0;1;1;11990;10000mAh Redmi Power Bank Black XIAOMI;ACCESORIOS
18454031;;F;29;CHILENO;;Millenial;CONCEPCION                    ;BIO BIO;18990;1;1;0;0;0;1;1;18990;PARLANTE KARAOKE MGPANTERA NEGRO;ACCESORIOS
16280748;;M;36;CHILENO;;Millenial;SAN JOAQUIN                   ;METROPOLITANA;8990;1;1;0;0;0;1;1;8990;Funda Con Cierre 15;ACCESORIOS
11895957;Soltero;M;51;CHILENO;;X;PROVIDENCIA                   ;METROPOLITANA;139990;1;1;0;0;0;1;1;139990;Smartwatch GT 2 BLACK;ACCESORIOS
25812927;;F;45;COLOMBIANO;;Extranjero;"";"";14990;1;1;0;0;0;1;1;14990;Travel Adapter SFC 25W Type C (w/o Cable);ACCESORIOS
15572342;;M;38;CHILENO;;X;RENCA                         ;METROPOLITANA;11990;1;1;1;1;11990;0;0;0;PARLANTE ZUKABASS + MICROFONO MLAB BT ROJO;ACCESORIOS
7284018;;M;57;CHILENO;;Boomers;CASTRO                        ;LOS LAGOS;85940;6;4;0;0;0;6;4;85940;20000mAh Redmi 18W Fast Charge Power Bank Black;ACCESORIOS
18561588;Soltero;F;28;CHILENO;;Millenial;PROVIDENCIA                   ;METROPOLITANA;8990;1;1;0;0;0;1;1;8990;Funda Con Cierre 15;ACCESORIOS
9754577;Casado;F;56;CHILENO;;Boomers;RENCA                         ;METROPOLITANA;4990;1;1;0;0;0;1;1;4990;MEMORIA MICROSD CLASE 10 32GB SANDISK;ACCESORIOS
19645804;;M;25;CHILENO;;Z;N/D;N/D;0;0;18;0;18;0;0;0;0;Mouse Alambrico Rosado;ACCESORIOS
15472957;;F;39;CHILENO;;X;PROVIDENCIA                   ;METROPOLITANA;7990;1;1;0;0;0;1;1;7990;Audifonos Orejas De Gato Rosado;ACCESORIOS
6514733;;M;68;CHILENO;;Boomers;PARRAL                        ;MAULE;7990;1;1;0;0;0;1;1;7990;SOPORTE TV 26-56 KTA02 KIOTO FIJO;ACCESORIOS
14072222;;F;40;CHILENO;;X;LOTA                          ;BIO BIO;5990;1;1;0;0;0;1;1;5990;AUDIFONO IN SAM HS1303C/ MIC NEGRO;ACCESORIOS
15526225;;F;39;CHILENO;;X;RENGO                         ;L.G.B.OÂ´HIGGINS;11980;2;2;0;0;0;2;2;11980;AUDIFONO IN SAM HS1303C/ MIC ROSADO;ACCESORIOS
13598351;;M;42;CHILENO;;X;RENCA                         ;METROPOLITANA;19990;1;1;0;0;0;1;1;19990;AUDIFONO XIAOMI EARBUDS MI TRUE WIRELESS BASIC 2;ACCESORIOS
19398997;;F;25;CHILENO;;Z;ANTOFAGASTA                   ;ANTOFAGASTA;189640;2;1;2;1;189640;0;0;0;SMARTWATCH GALAXY WATCH 3 41MM MYSTIC BRONCE;ACCESORIOS
12854579;;F;47;CHILENO;;X;EL QUISCO                     ;VALPARAISO;39990;1;1;0;0;0;1;1;39990;Headset Pav Gam 400 Grn CAN/ENG;ACCESORIOS
10083737;;M;44;CHILENO;;X;PUNTA ARENAS                  ;MAGALLANES;6000;2;1;0;0;0;2;1;6000;AUDIFONO IN SAM HS1303C/ MIC NEGRO;ACCESORIOS
18716690;Soltero;M;28;CHILENO;;Millenial;PROVIDENCIA                   ;METROPOLITANA;8990;1;1;0;0;0;1;1;8990;AUDIFONO ON ZX110 SONY NEGRO;ACCESORIOS
19218485;;F;26;CHILENO;;Z;PROVIDENCIA                   ;METROPOLITANA;129980;2;2;1;1;119990;1;1;9990;AUDIFONO ON ZX110 SONY NEGRO;ACCESORIOS
13771831;;F;42;CHILENO;;X;RENCA                         ;METROPOLITANA;44990;1;1;0;0;0;1;1;44990;MI Smart Band 6 Negra XIAOMI;ACCESORIOS
10401028;;F;44;CHILENO;;X;SANTIAGO                      ;METROPOLITANA;18980;2;1;2;1;18980;0;0;0;AUDIFONO GAMER ON EAR H200S PLUG STEREO;ACCESORIOS
8636086;;M;63;CHILENO;;Boomers;VINA DEL MAR                  ;VALPARAISO;410970;3;2;0;0;0;3;2;410970;BATERY PACK TIPO C 10.000 MAH SAMSUNG;ACCESORIOS
18533092;;F;28;CHILENO;;Silencioso;PROVIDENCIA                   ;METROPOLITANA;27980;2;1;2;1;27980;0;0;0;AUDIFONO TAT1235 PHILIPS NEGRO;ACCESORIOS
15561449;;F;39;CHILENO;;X;QUILPUE                       ;VALPARAISO;324980;2;2;1;1;289990;1;1;34990;SMARTBAND SAMSUNG GALAXY FIT 2 ROJO;ACCESORIOS
19065236;;M;26;CHILENO;;Z;COIHAIQUE                     ;AYSEN;21990;1;1;0;0;0;1;1;21990;SOPORTE ARTICULADO FULL MOTION 32-55 PULGADAS;ACCESORIOS
19981000;;F;23;CHILENO;;Z;PROVIDENCIA                   ;METROPOLITANA;164980;2;1;2;1;164980;0;0;0;AUDIFONOS GALAXY BUDS PRO VIOLET;ACCESORIOS
17327211;;M;37;CHILENO;;Millenial;N/D;N/D;29840;2;1;2;1;29840;0;0;0;AUDIFONO TAT1235 PHILIPS BLANCO;ACCESORIOS
19968044;;M;23;CHILENO;;Silencioso;PROVIDENCIA                   ;METROPOLITANA;149640;2;1;2;1;149640;0;0;0;ESCRITORIO GAMER LOAD;ACCESORIOS
24824213;;M;43;PERUANO;;Extranjero;"";"";41980;2;1;2;1;41980;0;0;0;BAND 6 PINK HUAWEI;ACCESORIOS
13272663;Casado;M;44;CHILENO;;X;PROVIDENCIA                   ;METROPOLITANA;34990;1;1;0;0;0;1;1;34990;SMARTBAND SAMSUNG GALAXY FIT 2 ROJO;ACCESORIOS
19925395;;M;23;CHILENO;;Silencioso;PROVIDENCIA                   ;METROPOLITANA;84980;2;1;2;1;84980;0;0;0;AUDIFONO GALAXY BUDS PLUS NEGRO;ACCESORIOS
10270577;;F;51;CHILENO;;X;CHIMBARONGO                   ;L.G.B.OÂ´HIGGINS;9990;1;1;0;0;0;1;1;9990;PARLANTE ZUKABASS 4 BT USB/SD/FM CALACAS;ACCESORIOS
11668770;;M;51;CHILENO;;X;PUENTE ALTO                   ;METROPOLITANA;10990;1;1;0;0;0;1;1;10990;PARLANTE ZUKABASS + MICROFONO MLAB BT ROJO;ACCESORIOS
11536172;;M;51;CHILENO;;X;CHILLAN                       ;BIO BIO;6990;1;1;1;1;6990;0;0;0;SOPORTE TV 26-56 KTAT02 KIOTO MOVIL;ACCESORIOS
19817132;;F;24;CHILENO;;Z;N/D;N/D;6990;1;1;0;0;0;1;1;6990;AUDIFONO IN SAM HS1303C/ MIC ROSADO;ACCESORIOS
11611287;;F;52;CHILENO;;X;N/D;N/D;146980;2;1;0;0;0;2;1;146980;Silla Gamer Python Roja;ACCESORIOS
19448150;;M;26;CHILENO;;Z;N/D;N/D;8990;1;1;0;0;0;1;1;8990;PARLANTE 7284 MLAB ZUKABASS NARAN/VERDE BT;ACCESORIOS
17000461;;M;33;CHILENO;;Millenial;PROVIDENCIA                   ;METROPOLITANA;85840;2;1;2;1;85840;0;0;0;AUDIFONO GALAXY BUDS PLUS NEGRO;ACCESORIOS
16787016;;F;34;CHILENO;;Millenial;PROVIDENCIA                   ;METROPOLITANA;327960;4;2;4;2;327960;0;0;0;SMARTWATCH GALAXY WATCH 3 41MM MYSTIC BRONCE;ACCESORIOS
8290616;;F;70;CHILENO;;Silencioso;RENCA                         ;METROPOLITANA;9990;1;1;0;0;0;1;1;9990;PARLANTE GBASS MICRO;ACCESORIOS
8354869;;M;63;CHILENO;;Boomers;OVALLE                        ;COQUIMBO;14990;1;1;0;0;0;1;1;14990;Kit 2-1 Rojo;ACCESORIOS
16294753;;M;35;CHILENO;;Millenial;PROVIDENCIA                   ;METROPOLITANA;189640;2;1;2;1;189640;0;0;0;SMARTWATCH GALAXY WATCH 3 41MM MYSTIC BRONCE;ACCESORIOS
19180412;Soltero;F;26;CHILENO;;Z;PROVIDENCIA                   ;METROPOLITANA;191540;2;1;2;1;191540;0;0;0;SMARTWATCH GALAXY WATCH 3 41MM MYSTIC BRONCE;ACCESORIOS
9333573;;F;60;CHILENO;;Silencioso;PROVIDENCIA                   ;METROPOLITANA;17990;1;1;0;0;0;1;1;17990;AUDIFONO XIAOMI EARBUDS MI TRUE WIRELESS BASIC 2;ACCESORIOS
16456195;;M;35;CHILENO;;Millenial;TALCA                         ;MAULE;35980;2;1;0;0;0;2;1;35980;SOPORTE TV 14-63 CON BRAZO KT-FM 3L;ACCESORIOS
18880658;;F;27;CHILENO;;Millenial;N/D;N/D;19980;2;1;0;0;0;2;1;19980;10000mAh Redmi Power Bank Black XIAOMI;ACCESORIOS
15347848;;M;40;CHILENO;;X;PROVIDENCIA                   ;METROPOLITANA;11990;1;1;0;0;0;1;1;11990;10000mAh Redmi Power Bank Black XIAOMI;ACCESORIOS
13339820;;F;45;CHILENO;;X;RENCA                         ;METROPOLITANA;17990;1;1;0;0;0;1;1;17990;SOPORTE TV 14-63 CON BRAZO KT-FM 3L;ACCESORIOS
19111311;;F;26;CHILENO;;Z;PROVIDENCIA                   ;METROPOLITANA;16990;1;1;0;0;0;1;1;16990;KARAOKE MLAB SUITCASE OUTDOOR MIC BT BK 8566;ACCESORIOS
20300895;;F;22;CHILENO;;Z;PROVIDENCIA                   ;METROPOLITANA;34980;2;1;2;1;34980;0;0;0;AUDIFONO WH-CH510/BZ UC;ACCESORIOS
18367102;;F;28;CHILENO;;Millenial;N/D;N/D;10990;1;1;0;0;0;1;1;10990;PARLANTE ZUKABASS + MICROFONO MLAB BT;ACCESORIOS
16815142;;M;34;CHILENO;;Millenial;VILLARICA                     ;ARAUCANIA;13990;1;1;0;0;0;1;1;13990;AUDIFONO SAMSUNG WIRELESS 103B;ACCESORIOS
17671207;Soltero;M;31;CHILENO;INGENIERO CIVIL INDUSTRIAL;Millenial;PROVIDENCIA                   ;METROPOLITANA;277970;3;1;3;1;277970;0;0;0;Galaxy Watch Active4 44 mm Black;ACCESORIOS
11037642;Casado;F;57;CHILENO;;Boomers;RENCA                         ;METROPOLITANA;25570;2;1;0;0;0;2;1;25570;RADIO RETRO MINI WOOGIE 8751;ACCESORIOS
18170950;;M;29;CHILENO;;Millenial;PROVIDENCIA                   ;METROPOLITANA;54990;1;1;0;0;0;1;1;54990;DISCO DURO CANVIO 1TB BASICS BLACK TOSHIBA;ACCESORIOS
11808505;;M;51;CHILENO;;X;PROVIDENCIA                   ;METROPOLITANA;15570;2;1;0;0;0;2;1;15570;PARLANTE ZUKABASS 4 BT USB/SD/FM CALACAS;ACCESORIOS
10928036;;F;55;CHILENO;;Boomers;CHILLAN                       ;BIO BIO;14990;1;1;0;0;0;1;1;14990;SOPORTE TV 14-42 KTAM02 KIOTO C/ BRAZO MOVIL;ACCESORIOS
15991876;;F;37;CHILENO;;Silencioso;PROVIDENCIA                   ;METROPOLITANA;42170;2;1;0;0;0;2;1;42170;MI Bluetooth Speaker (16W) BLUE;ACCESORIOS
19647872;;M;25;CHILENO;;Extranjero;MAIPU                         ;METROPOLITANA;79990;1;1;1;1;79990;0;0;0;AUDIFONO GALAXY BUDS PLUS NEGRO;ACCESORIOS
9278794;;M;56;CHILENO;;Boomers;PROVIDENCIA                   ;METROPOLITANA;9990;1;1;0;0;0;1;1;9990;TRAVEL ADAPTER 15W - FAST CHARGER (TYPE-C CABLE);ACCESORIOS
16311071;;M;34;CHILENO;;Millenial;PROVIDENCIA                   ;METROPOLITANA;14990;1;1;0;0;0;1;1;14990;SOPORTE TV 14-42 KTAM02 KIOTO C/ BRAZO MOVIL;ACCESORIOS
19662974;;M;23;CHILENO;;Z;N/D;N/D;19990;1;1;0;0;0;1;1;19990;TWS EARPHONE WITH CHARGING CASE BLANCO FIDDLER;ACCESORIOS
16929909;;M;34;CHILENO;;Millenial;N/D;N/D;16980;2;2;0;0;0;2;2;16980;PARLANTE ZUKABASS + MICROFONO MLAB BT;ACCESORIOS
12517546;;F;48;CHILENO;;X;RANCAGUA                      ;L.G.B.OÂ´HIGGINS;18990;1;2;0;0;0;1;2;18990;PARLANTE KARAOKE MGGLADIATOR NEGRO;ACCESORIOS
17233013;Soltero;M;37;CHILENO;;Millenial;PROVIDENCIA                   ;METROPOLITANA;0;0;0;0;0;0;0;0;0;TRAVEL ADAPTER 15W - FAST CHARGER (TYPE-C CABLE);ACCESORIOS
16390013;;F;36;CHILENO;;Millenial;N/D;N/D;0;0;0;0;0;0;0;0;0;SMARTBAND XIAOMI MI BAND 5 NEGRO;ACCESORIOS
15200131;;M;38;CHILENO;;X;PROVIDENCIA                   ;METROPOLITANA;0;0;0;0;0;0;0;0;0;SOPORTE TV 26-56 KTA02 KIOTO FIJO;ACCESORIOS
20320528;;F;22;CHILENO;;Z;PROVIDENCIA                   ;METROPOLITANA;0;0;0;0;0;0;0;0;0;DISCO DURO CANVIO 4TB BASICS BLACK;ACCESORIOS
15427257;;M;39;CHILENO;;Silencioso;PROVIDENCIA                   ;METROPOLITANA;0;0;0;0;0;0;0;0;0;PARLANTE 8531 MLAB MAX BASS BT;ACCESORIOS
8077892;;M;62;CHILENO;;Boomers;RENCA                         ;METROPOLITANA;0;0;0;0;0;0;0;0;0;TRAVEL ADAPTER 15W - FAST CHARGER (TYPE-C CABLE);ACCESORIOS
16756386;;M;34;CHILENO;;Millenial;PROVIDENCIA                   ;METROPOLITANA;0;0;0;0;0;0;0;0;0;DISCO DURO CANVIO 1TB BASICS BLACK TOSHIBA;ACCESORIOS
8101518;;M;63;CHILENO;;Boomers;RENCA                         ;METROPOLITANA;0;0;0;0;0;0;0;0;0;KIT PREPAGO HD DIRECTV;ACCESORIOS
15658185;Casado;F;39;CHILENO;;X;TIRUA                         ;BIO BIO;0;0;0;0;0;0;0;0;0;PARLANTE ZUKABASS + MICROFONO MLAB BT;ACCESORIOS
13101503;;M;46;CHILENO;;Silencioso;PROVIDENCIA                   ;METROPOLITANA;0;0;0;0;0;0;0;0;0;AUDIFONO XIAOMI EARBUDS MI TRUE WIRELESS BASIC 2;ACCESORIOS
20306914;;F;22;CHILENO;;Silencioso;PROVIDENCIA                   ;METROPOLITANA;0;0;0;0;0;0;0;0;0;AUDIFONO IN SONY BT WI-310 BLACK;ACCESORIOS
12127765;Soltero;M;41;CHILENO;PROFESOR;X;PROVIDENCIA                   ;METROPOLITANA;0;0;0;0;0;0;0;0;0;AUDIFONO ON ZX110 SONY NEGRO;ACCESORIOS
16068674;;F;37;CHILENO;;Millenial;PROVIDENCIA                   ;METROPOLITANA;0;0;0;0;0;0;0;0;0;SMARTBAND SAMSUNG GALAXY FIT 2 ROJO;ACCESORIOS
9697729;;F;57;CHILENO;;Boomers;RENCA                         ;METROPOLITANA;0;0;0;0;0;0;0;0;0;Audifonos Orejas De Gato Azul;ACCESORIOS
13782711;;F;42;CHILENO;;X;SANTA CRUZ                    ;L.G.B.OÂ´HIGGINS;0;0;0;0;0;0;0;0;0;PARLANTE KARAOKE MGPANTERA NEGRO;ACCESORIOS
25940413;;F;33;VENEZOLANO;;Extranjero;CONCEPCION                    ;BIO BIO;0;0;0;0;0;0;0;0;0;HUAWEI Sport Bluetooth Headphones Lite Black AM6;ACCESORIOS
7267555;Casado;F;68;CHILENO;PROFESOR;Silencioso;AISEN                         ;AYSEN;0;0;0;0;0;0;0;0;0;SOPORTE TV 14-42 KTAM02 KIOTO C/ BRAZO MOVIL;ACCESORIOS
11208998;Casado;F;55;CHILENO;AUTOMATIZACION Y CONTROL INDUSTRIAL;Boomers;RENCA                         ;METROPOLITANA;0;0;0;0;0;0;0;0;0;PARLANTE KARAOKE MGGLADIATOR NEGRO;ACCESORIOS
9232833;;F;63;CHILENO;;Boomers;SAN FERNANDO                  ;L.G.B.OÂ´HIGGINS;0;0;0;0;0;0;0;0;0;AUDIFONO IN SAM HS1303C/ MIC AZUL;ACCESORIOS
16136770;;F;36;CHILENO;;Millenial;N/D;N/D;0;0;0;0;0;0;0;0;0;KARAOKE MLAB SUITCASE OUTDOOR MIC BT BK 8566;ACCESORIOS
13570018;;M;43;CHILENO;;X;PROVIDENCIA                   ;METROPOLITANA;0;0;0;0;0;0;0;0;0;SOPORTE TV 32-65 KTA03 KIOTO FIJO;ACCESORIOS
18415151;;F;29;CHILENO;;Millenial;TALCAHUANO                    ;BIO BIO;0;0;0;0;0;0;0;0;0;BATERY PACK TIPO C 10.000 MAH SAMSUNG;ACCESORIOS
15678587;;M;38;CHILENO;;X;N/D;N/D;0;0;0;0;0;0;0;0;0;PARLANTE PL7 XBOOM GO BLUETHOOH 2020;ACCESORIOS
17142176;Soltero;M;33;CHILENO;INGENIERO CIVIL MECANICO;Millenial;PROVIDENCIA                   ;METROPOLITANA;0;0;0;0;0;0;0;0;0;EXPRESS MOD 3930 PURPLE;ACCESORIOS
12581720;;F;48;CHILENO;;X;N/D;N/D;0;0;0;0;0;0;0;0;0;MINI PARLANTE BT GO2;ACCESORIOS
10249032;;M;51;CHILENO;;X;"";"";0;0;0;0;0;0;0;0;0;PARLANTE GBASS MICRO;ACCESORIOS
19775626;;M;23;CHILENO;;Silencioso;PROVIDENCIA                   ;METROPOLITANA;0;0;0;0;0;0;0;0;0;AUDIFONO XIAOMI EARBUDS MI TRUE WIRELESS BASIC 2;ACCESORIOS
13217138;;F;44;CHILENO;;X;IQUIQUE                       ;TARAPACA;0;0;0;0;0;0;0;0;0;SILLA GAMER RACING PRO - NEGRO;ACCESORIOS
13376269;;M;44;CHILENO;;X;RENCA                         ;METROPOLITANA;0;0;0;0;0;0;0;0;0;PARLANTE KARAOKE MGROCKET NEGRO;ACCESORIOS
26714998;;M;30;EXTRANJERO - NO INFORMA NACIONALIDAD;;Extranjero;CHILLAN                       ;BIO BIO;0;0;0;0;0;0;0;0;0;MI Smart Band 6 Negra XIAOMI;ACCESORIOS
17071648;;F;33;CHILENO;;Silencioso;PROVIDENCIA                   ;METROPOLITANA;0;0;0;0;0;0;0;0;0;MOUSE 200 RED WIRELESS;ACCESORIOS
15148773;;F;39;CHILENO;;X;CAUQUENES                     ;MAULE;0;0;0;0;0;0;0;0;0;AUDIFONO ON ZX310AP ROJO;ACCESORIOS
18392919;Soltero;M;29;CHILENO;INGENIERO EN MAQUINARIA;Extranjero;PROVIDENCIA                   ;METROPOLITANA;0;0;0;0;0;0;0;0;0;AUDIFONO TAT1235 PHILIPS NEGRO;ACCESORIOS
8476145;Casado;F;62;CHILENO;;Boomers;RENCA                         ;METROPOLITANA;0;0;0;0;0;0;0;0;0;AUDIFONO PANASONIC IN RP-HV096E-K NEGRO;ACCESORIOS
18861081;;F;27;CHILENO;;Millenial;OVALLE                        ;COQUIMBO;0;0;0;0;0;0;0;0;0;SOPORTE TV 26-56 KTAT02 KIOTO MOVIL;ACCESORIOS
13840697;Casado;F;41;CHILENO;EDUCADOR DE PARVULO;X;RENCA                         ;METROPOLITANA;0;0;0;0;0;0;0;0;0;Smartwatch ACTIVE 2 GOLD;ACCESORIOS
13710568;;F;43;CHILENO;;X;SAN PEDRO DE LA PAZ           ;BIO BIO;0;0;0;0;0;0;0;0;0;AUDIFONO IN SONY BT WI-C200 WHITE;ACCESORIOS
20899212;;M;23;CHILENO;;Silencioso;PROVIDENCIA                   ;METROPOLITANA;0;0;0;0;0;0;0;0;0;HUAWEI Sport Bluetooth Headphones Lite Black AM6;ACCESORIOS
19304908;;M;26;CHILENO;;Z;N/D;N/D;0;0;0;0;0;0;0;0;0;PARLANTE KARAOKE MGGLADIATOR NEGRO;ACCESORIOS
11271212;Soltero;M;53;CHILENO;;X;EL BOSQUE                     ;METROPOLITANA;0;0;0;0;0;0;0;0;0;KARAOKE MLAB SUITCASE OUTDOOR MIC BT BK 8566;ACCESORIOS
17323800;Casado;F;32;CHILENO;INGENIERO EN ADMINISTRACION DE EMPRESAS;Millenial;RENCA                         ;METROPOLITANA;0;0;0;0;0;0;0;0;0;KIT PREPAGO HD DIRECTV;ACCESORIOS
18532375;;M;28;CHILENO;;Millenial;PROVIDENCIA                   ;METROPOLITANA;0;0;0;0;0;0;0;0;0;MOUSE 200 Inalambrico NEGRO;ACCESORIOS
16512211;;M;36;CHILENO;;Millenial;RENCA                         ;METROPOLITANA;0;0;0;0;0;0;0;0;0;PARLANTE ZUKABASS + MICROFONO MLAB BT;ACCESORIOS
16651558;;M;35;CHILENO;;Millenial;PROVIDENCIA                   ;METROPOLITANA;0;0;0;0;0;0;0;0;0;AUDIFONO IN EX15LP SONY NEG;ACCESORIOS
16240119;;F;36;CHILENO;;Millenial;PROVIDENCIA                   ;METROPOLITANA;0;0;0;0;0;0;0;0;0;BATERY PACK TIPO C 10.000 MAH SAMSUNG;ACCESORIOS
20391737;;M;21;CHILENO;;Silencioso;PROVIDENCIA                   ;METROPOLITANA;0;0;0;0;0;0;0;0;0;AUDIFONO MLAB TWS FULLY WIRELESSÂ  WHITE 8721;ACCESORIOS
18586638;;M;29;CHILENO;;Millenial;PROVIDENCIA                   ;METROPOLITANA;0;0;0;0;0;0;0;0;0;SOPORTE TV 14-63 CON BRAZO KT-FM 3L;ACCESORIOS
25507214;;M;32;HAITIANO;;Extranjero;SAN FERNANDO                  ;L.G.B.OÂ´HIGGINS;0;0;0;0;0;0;0;0;0;10000mAh Redmi Power Bank Black XIAOMI;ACCESORIOS
14185051;;F;41;CHILENO;;X;N/D;N/D;0;0;0;0;0;0;0;0;0;BAND 4 BLACK;ACCESORIOS
19707783;Soltero;M;28;CHILENO;;Millenial;PROVIDENCIA                   ;METROPOLITANA;0;0;0;0;0;0;0;0;0;PARLANTE PL2 XBOOM GO BLUETHOOH 2020;ACCESORIOS
12397889;;F;49;CHILENO;;Silencioso;PROVIDENCIA                   ;METROPOLITANA;0;0;0;0;0;0;0;0;0;True Wireless Philips SHB2505 5+15 Hrs Negro;ACCESORIOS
17255645;;F;32;CHILENO;;Millenial;PADRE HURTADO;METROPOLITANA;0;0;0;0;0;0;0;0;0;AUDIFONO XIAOMI EARBUDS MI TRUE WIRELESS BASIC 2;ACCESORIOS
9743607;;F;58;CHILENO;;Boomers;MAIPU                         ;METROPOLITANA;0;0;0;0;0;0;0;0;0;AUDIFONO PANASONIC IN RP-HV096E-K NEGRO;ACCESORIOS
17097614;;M;33;CHILENO;;Silencioso;PROVIDENCIA                   ;METROPOLITANA;0;0;0;0;0;0;0;0;0;SOPORTE SOUNDBAR XTA-310 NEGRO;ACCESORIOS
18526463;;F;27;CHILENO;;Millenial;PROVIDENCIA                   ;METROPOLITANA;0;0;0;0;0;0;0;0;0;KIT PREPAGO HD DIRECTV;ACCESORIOS
16483039;;M;35;CHILENO;;Silencioso;PROVIDENCIA                   ;METROPOLITANA;0;0;0;0;0;0;0;0;0;BAND 4 BLACK;ACCESORIOS
14367598;;M;48;CHILENO;;X;PAINE                         ;METROPOLITANA;0;0;0;0;0;0;0;0;0;SOPORTE TV 26-56 KTA02 KIOTO FIJO;ACCESORIOS
26534070;;M;34;CHILENO;;Extranjero;N/D;N/D;0;0;0;0;0;0;0;0;0;AUDIFONO Bluetooth BE7 Azul;ACCESORIOS
19791805;;M;25;CHILENO;;Z;PROVIDENCIA                   ;METROPOLITANA;0;0;0;0;0;0;0;0;0;BATERY PACK TIPO C 10.000 MAH SAMSUNG;ACCESORIOS
13735406;;F;43;CHILENO;;Silencioso;PROVIDENCIA                   ;METROPOLITANA;0;0;0;0;0;0;0;0;0;SOPORTE TV 26-56 KTAT02 KIOTO MOVIL;ACCESORIOS
17160298;;F;33;CHILENO;;Millenial;CONCON                        ;VALPARAISO;0;0;0;0;0;0;0;0;0;MI WATCH LITE NEGRO XIAOMI;ACCESORIOS
9326212;;M;61;CHILENO;;Boomers;TALAGANTE                     ;METROPOLITANA;0;0;0;0;0;0;0;0;0;AUDIFONO IN SAM C/ MIC EG920 BLACK;ACCESORIOS
18028802;;F;29;CHILENO;;Millenial;CONSTITUCION                  ;MAULE;0;0;0;0;0;0;0;0;0;SOPORTE TV 14-42 KTAM02 KIOTO C/ BRAZO MOVIL;ACCESORIOS
20038764;;M;23;CHILENO;;Silencioso;PROVIDENCIA                   ;METROPOLITANA;0;0;0;0;0;0;0;0;0;Teclado Gamer Mecanico Plateado Retroiluminado;ACCESORIOS
7484053;Casado;F;71;CHILENO;;Silencioso;CORONEL                       ;BIO BIO;0;0;0;0;0;0;0;0;0;PARLANTE BT MICRO PINEAPPLE 8647;ACCESORIOS
19650470;;M;25;CHILENO;;Z;CONSTITUCION                  ;MAULE;0;0;0;0;0;0;0;0;0;AUDIFONO XIAOMI EARBUDS MI TRUE WIRELESS BASIC 2;ACCESORIOS
19714719;;M;25;CHILENO;;Z;PROVIDENCIA                   ;METROPOLITANA;0;0;0;0;0;0;0;0;0;Smartwatch ACTIVE 2 BLACK;ACCESORIOS
17488355;;M;31;CHILENO;;Millenial;MAIPU                         ;METROPOLITANA;0;0;0;0;0;0;0;0;0;DISCO DURO CANVIO 1TB BASICS BLACK TOSHIBA;ACCESORIOS
20463381;;F;21;CHILENO;;Z;SANTA CRUZ;O HIGGINS;0;0;0;0;0;0;0;0;0;SOPORTE TV 26-56 KTAT02 KIOTO MOVIL;ACCESORIOS
17983453;Soltero;M;28;CHILENO;;Silencioso;PROVIDENCIA                   ;METROPOLITANA;0;0;0;0;0;0;0;0;0;MI WATCH LITE NEGRO XIAOMI;ACCESORIOS
10178259;;M;54;CHILENO;;X;RENCA                         ;METROPOLITANA;0;0;0;0;0;0;0;0;0;Smartwatch ACTIVE 2 GOLD;ACCESORIOS
16997126;;M;33;CHILENO;;Millenial;PROVIDENCIA                   ;METROPOLITANA;0;0;0;0;0;0;0;0;0;MI WATCH NEGRO XIAOMI;ACCESORIOS
16311327;;M;34;CHILENO;;Millenial;VILLA ALEMANA                 ;VALPARAISO;0;0;0;0;0;0;0;0;0;BATERY PACK TIPO C 10.000 MAH SAMSUNG;ACCESORIOS
16849077;;M;34;CHILENO;;Millenial;SANTIAGO                      ;METROPOLITANA;0;0;0;0;0;0;0;0;0;PARLANTE 8531 MLAB MAX BASS BT;ACCESORIOS
15639619;;M;38;CHILENO;;X;COIHAIQUE                     ;AYSEN;0;0;0;0;0;0;0;0;0;DISCO DURO CANVIO 1TB BASICS BLACK TOSHIBA;ACCESORIOS
16961083;;F;35;CHILENO;;Millenial;PROVIDENCIA                   ;METROPOLITANA;0;0;0;0;0;0;0;0;0;AUDIFONO IN SONY BT WI-C200 BLACK;ACCESORIOS
17915569;;F;31;CHILENO;;Millenial;N/D;N/D;0;0;0;0;0;0;0;0;0;PARLANTE 7284 MLAB ZUKABASS NARAN/VERDE BT;ACCESORIOS
18021078;Soltero;M;30;CHILENO;;Millenial;PROVIDENCIA                   ;METROPOLITANA;0;0;0;0;0;0;0;0;0;AUDIFONO GALAXY BUDS LIVE NEGRO;ACCESORIOS
9363274;;F;57;CHILENO;;Boomers;CALLE LARGA                   ;VALPARAISO;0;0;0;0;0;0;0;0;0;PARLANTE 8531 MLAB MAX BASS BT;ACCESORIOS
18087844;;F;29;CHILENO;;Millenial;N/D;N/D;0;0;0;0;0;0;0;0;0;EXPRESS MOD 3930 PURPLE;ACCESORIOS
27117741;;M;26;EXTRANJERO - NO INFORMA NACIONALIDAD;;Extranjero;N/D;N/D;0;0;0;0;0;0;0;0;0;AUDIFONO PANASONIC IN RP-HV096E-K NEGRO;ACCESORIOS
20274007;;M;22;CHILENO;;Z;PROVIDENCIA                   ;METROPOLITANA;0;0;0;0;0;0;0;0;0;PARLANTE PL2 XBOOM GO BLUETHOOH 2020;ACCESORIOS
15919468;;M;37;CHILENO;;Millenial;SAN BERNARDO                  ;METROPOLITANA;0;0;0;0;0;0;0;0;0;AUDIFONO XIAOMI EARBUDS MI TRUE WIRELESS BASIC 2;ACCESORIOS
19152020;Soltero;M;26;CHILENO;;Silencioso;PROVIDENCIA                   ;METROPOLITANA;0;0;0;0;0;0;0;0;0;AUDIFONO XIAOMI EARBUDS MI TRUE WIRELESS BASIC 2;ACCESORIOS
17736183;;F;31;CHILENO;;Millenial;ANTOFAGASTA;ANTOFAGASTA;0;0;0;0;0;0;0;0;0;Smartwatch GT 2 BLACK;ACCESORIOS
16198949;Soltero;M;36;CHILENO;;Silencioso;PROVIDENCIA                   ;METROPOLITANA;0;0;0;0;0;0;0;0;0;MOUSE GLORIOUS MODEL D GLOSSY BLACK;ACCESORIOS
26591764;;F;40;EXTRANJERO - NO INFORMA NACIONALIDAD;;Extranjero;NUNOA                         ;METROPOLITANA;0;0;0;0;0;0;0;0;0;PARLANTE GBASS MICRO;ACCESORIOS
19082512;;M;26;CHILENO;;Z;LA LIGUA                      ;VALPARAISO;0;0;0;0;0;0;0;0;0;True Wireless Philips TAT2205 4+8 Hrs Rojo;ACCESORIOS
25742248;;M;37;VENEZOLANO;;Extranjero;SANTIAGO                      ;METROPOLITANA;0;0;0;0;0;0;0;0;0;BAND 4 BLACK;ACCESORIOS
18830421;;F;28;CHILENO;;Millenial;PROVIDENCIA                   ;METROPOLITANA;0;0;0;0;0;0;0;0;0;AUDIFONOS GALAXY BUDS PRO BLACK;ACCESORIOS
16686617;;F;34;CHILENO;;Millenial;RENCA                         ;METROPOLITANA;0;0;0;0;0;0;0;0;0;AUDIFONO IN SAM HS1303C/ MIC BLANCO;ACCESORIOS
15370328;Soltero;F;39;CHILENO;;Silencioso;PROVIDENCIA                   ;METROPOLITANA;0;0;0;0;0;0;0;0;0;PARLANTE 8531 MLAB MAX BASS BT;ACCESORIOS
19659389;;F;24;CHILENO;;Z;PROVIDENCIA                   ;METROPOLITANA;0;0;0;0;0;0;0;0;0;AUDIFONO MLAB TWS IN-AIR WHITE 8533;ACCESORIOS
7751545;;M;67;CHILENO;;Boomers;RENCA                         ;METROPOLITANA;0;0;0;0;0;0;0;0;0;AUDIFONO IN E9LP SONY BZ NEGRO;ACCESORIOS
17128872;Soltero;F;34;CHILENO;RELACIONADOR PUBLICO;Millenial;PROVIDENCIA                   ;METROPOLITANA;0;0;0;0;0;0;0;0;0;Audifonos Huawei Headphones Lite Silver;ACCESORIOS
13258074;;M;44;CHILENO;;X;PROVIDENCIA                   ;METROPOLITANA;0;0;0;0;0;0;0;0;0;ITFIT Tripode Selfie Stick;ACCESORIOS
26071537;;M;41;VENEZOLANO;;Extranjero;N/D;N/D;0;0;0;0;0;0;0;0;0;SOPORTE TV 26-56 KTA02 KIOTO FIJO;ACCESORIOS
17229196;;M;32;CHILENO;;Millenial;COQUIMBO                      ;COQUIMBO;0;0;0;0;0;0;0;0;0;TRAVEL ADAPTER 15W - FAST CHARGER (TYPE-C CABLE);ACCESORIOS
13000512;;F;47;CHILENO;;X;CALBUCO                       ;LOS LAGOS;0;0;0;0;0;0;0;0;0;AUDIFONO IN EX15AP SONY NEGRO;ACCESORIOS
15752267;;M;38;CHILENO;;Silencioso;PROVIDENCIA                   ;METROPOLITANA;0;0;0;0;0;0;0;0;0;Smartwatch ACTIVE 1 DORADO;ACCESORIOS
19543154;;F;24;CHILENO;;Silencioso;PROVIDENCIA                   ;METROPOLITANA;0;0;0;0;0;0;0;0;0;AUDIFONO MLAB TWS FULLY WIRELESSÂ  WHITE 8721;ACCESORIOS
19492692;;M;25;CHILENO;;Z;PROVIDENCIA                   ;METROPOLITANA;0;0;0;0;0;0;0;0;0;HUAWEI AUDIFONOS MANOS LIBRES AM116;ACCESORIOS
18050479;;M;30;CHILENO;;Millenial;N/D;N/D;0;0;0;0;0;0;0;0;0;SMARTWATCH GALAXY WATCH 3 45MM MYSTIC BLACK;ACCESORIOS
16616616;;F;35;CHILENO;;Millenial;PROVIDENCIA                   ;METROPOLITANA;0;0;0;0;0;0;0;0;0;AUDIFONO SAMSUNG WIRELESS A08C;ACCESORIOS
19514426;Soltero;M;25;CHILENO;;Silencioso;PROVIDENCIA                   ;METROPOLITANA;0;0;0;0;0;0;0;0;0;Smartwatch ACTIVE 1 NEGRO;ACCESORIOS
19823393;;M;24;CHILENO;;Z;SAN FABIAN                    ;BIO BIO;0;0;0;0;0;0;0;0;0;AUDIFONO MLAB TWS FULLY WIRELESSÂ  WHITE 8721;ACCESORIOS
20462823;;F;22;CHILENO;;Z;PROVIDENCIA                   ;METROPOLITANA;0;0;0;0;0;0;0;0;0;PARLANTE FLIP 5 BLUETOOTH ROJO;ACCESORIOS
19296267;;F;25;CHILENO;;Z;LA SERENA                     ;COQUIMBO;0;0;0;0;0;0;0;0;0;AUDIFONO BLUETOOTH RP-HF410BPUA BT 24HRS AZUL;ACCESORIOS
12607280;;F;47;CHILENO;;X;SAN JAVIER                    ;MAULE;0;0;0;0;0;0;0;0;0;AUDIFONO AIR-VICTORY BLACK 8724;ACCESORIOS
19322238;;M;25;CHILENO;;Z;"";"";0;0;0;0;0;0;0;0;0;PARLANTE FLIP 5 BLUETOOTH ROJO;ACCESORIOS
17312560;;M;32;CHILENO;;Millenial;N/D;N/D;0;0;0;0;0;0;0;0;0;APPLE WATCH S5 40MM BLACK;ACCESORIOS
13881520;;F;41;CHILENO;;X;PROVIDENCIA                   ;METROPOLITANA;0;0;0;0;0;0;0;0;0;DISCO DURO CANVIO 1TB BASICS BLACK TOSHIBA;ACCESORIOS
18512165;Soltero;F;28;CHILENO;INGENIERIA EN PREVENCION DE RIESGOS CALIDAD Y AMBIENTE;Millenial;PROVIDENCIA                   ;METROPOLITANA;0;0;0;0;0;0;0;0;0;AUDIFONO MLAB TWS IN-AIR WHITE 8533;ACCESORIOS
18469644;;F;29;CHILENO;;Silencioso;PROVIDENCIA                   ;METROPOLITANA;0;0;0;0;0;0;0;0;0;MOUSE HP Z3700 SILVER WIRELESS;ACCESORIOS
8070869;;F;62;CHILENO;;Boomers;ANTOFAGASTA                   ;ANTOFAGASTA;0;0;0;0;0;0;0;0;0;AUDIFONO IN HUAWEI BLANCO;ACCESORIOS
12496057;;M;48;CHILENO;;X;TIRUA                         ;BIO BIO;0;0;0;0;0;0;0;0;0;AUDIFONO XIAOMI EARBUDS MI TRUE WIRELESS BASIC 2;ACCESORIOS
20014887;;M;23;CHILENO;;Silencioso;PROVIDENCIA                   ;METROPOLITANA;0;0;0;0;0;0;0;0;0;KIT DIRECTV GO BOX;ACCESORIOS
18560093;Soltero;F;28;CHILENO;;Millenial;PROVIDENCIA                   ;METROPOLITANA;0;0;0;0;0;0;0;0;0;SOPORTE TV 14-42 KTAM02 KIOTO C/ BRAZO MOVIL;ACCESORIOS
14494634;;F;50;CHILENO;;X;N/D;N/D;0;0;0;0;0;0;0;0;0;AUDIFONO ON ZX110 SONY NEGRO;ACCESORIOS
26072855;;M;55;EXTRANJERO - NO INFORMA NACIONALIDAD;;Extranjero;N/D;N/D;0;0;0;0;0;0;0;0;0;AUDIFONO PANASONIC IN RP-HV096E-K NEGRO;ACCESORIOS
11703452;;F;51;CHILENO;;X;EL MONTE                      ;METROPOLITANA;0;0;0;0;0;0;0;0;0;SOPORTE TV EE-F01 14-42 ENCORE;ACCESORIOS
16907721;;F;34;CHILENO;;Millenial;PADRE HURTADO                 ;METROPOLITANA;0;0;0;0;0;0;0;0;0;MOCHILA Mix 1 2021 PRIUS;ACCESORIOS
15369518;;M;39;CHILENO;;X;N/D;N/D;0;0;0;0;0;0;0;0;0;PARLANTE 6985 MLAB VERTICAL BRITPOP BT;ACCESORIOS
12306007;;F;51;CHILENO;;X;RENCA                         ;METROPOLITANA;0;0;0;0;0;0;0;0;0;MEMORIA MICROSD CLASE 10 128GB SANDISK;ACCESORIOS
17439547;;F;32;CHILENO;;Millenial;N/D;N/D;0;0;0;0;0;0;0;0;0;MOCHILA Mix 2 2021 PACK TEEN ( SUP);ACCESORIOS
19806568;;M;24;CHILENO;;Silencioso;PROVIDENCIA                   ;METROPOLITANA;0;0;0;0;0;0;0;0;0;AUDIFONOS Airpods Pro (MWP22AM/A);ACCESORIOS
17788496;;F;31;CHILENO;;Millenial;PROVIDENCIA                   ;METROPOLITANA;0;0;0;0;0;0;0;0;0;APPLE WATCH S5 44MM BLACK;ACCESORIOS
18632746;;F;28;CHILENO;;Millenial;VALLENAR;ATACAMA;0;0;0;0;0;0;0;0;0;MOCHILA Mix 2 2021 PACK TEEN ( SUP);ACCESORIOS
19067856;;F;27;CHILENO;;Z;N/D;N/D;0;0;0;0;0;0;0;0;0;AUDIFONO SLEVE INT WS BLACK;ACCESORIOS
10153202;;F;57;CHILENO;;Boomers;CALERA                        ;VALPARAISO;0;0;0;0;0;0;0;0;0;AUDIFONO PANASONIC IN RP-HV096E-K NEGRO;ACCESORIOS
13614600;;M;43;CHILENO;;X;RENCA                         ;METROPOLITANA;0;0;0;0;0;0;0;0;0;HUAWEI Sport Bluetooth Headphones Lite Black AM6;ACCESORIOS
13445573;;M;44;CHILENO;;X;RECOLETA                      ;METROPOLITANA;0;0;0;0;0;0;0;0;0;AUDIFONO ON ZX310AP NEGRO;ACCESORIOS
14443386;Soltero;F;47;CHILENO;AUXILIAR DE FARMACIA PRIVADA;X;RENCA                         ;METROPOLITANA;0;0;0;0;0;0;0;0;0;SOPORTE TV 14-63 CON BRAZO KT-FM 3L;ACCESORIOS
15148159;;F;59;CHILENO;;Boomers;CAUQUENES                     ;MAULE;0;0;0;0;0;0;0;0;0;SOPORTE TV 26-56 KTA02 KIOTO FIJO;ACCESORIOS
19331454;Soltero;F;26;CHILENO;;Silencioso;PROVIDENCIA                   ;METROPOLITANA;0;0;0;0;0;0;0;0;0;SMARTWATCH GALAXY WATCH ACTIVE II DORADO 44;ACCESORIOS
20179502;;F;33;CHILENO;;Millenial;SAN FERNANDO                  ;L.G.B.OÂ´HIGGINS;0;0;0;0;0;0;0;0;0;PARLANTE ZUKABASS 4 BT USB/SD/FM CALACAS;ACCESORIOS
8469786;;M;55;CHILENO;;Boomers;COIHAIQUE                     ;AYSEN;0;0;0;0;0;0;0;0;0;AUDIFONO PANASONIC BT ON RP-HF410BPUK NEGRO;ACCESORIOS
15939110;;M;37;CHILENO;;Millenial;PROVIDENCIA                   ;METROPOLITANA;0;0;0;0;0;0;0;0;0;MOUSE MICROSOFT Bluetooth Mobile 3600 Dark Red;ACCESORIOS
16318831;Casado;F;35;CHILENO;INGENIERIA EN PREVENCION DE RIESGOS CALIDAD Y AMBIENTE;Millenial;PROVIDENCIA                   ;METROPOLITANA;0;0;0;0;0;0;0;0;0;Audifonos Huawei Headphones Lite Silver;ACCESORIOS
14288053;;F;47;CHILENO;;X;LEBU                          ;BIO BIO;0;0;0;0;0;0;0;0;0;AUDIFONO MLAB TWS IN-AIR WHITE 8533;ACCESORIOS
16400698;;M;35;CHILENO;;Millenial;CALERA                        ;VALPARAISO;0;0;0;0;0;0;0;0;0;AUDIFONO PANASONIC BT ON RP-HF410BPUK NEGRO;ACCESORIOS
18999678;;F;26;CHILENO;;Z;"";"";0;0;0;0;0;0;0;0;0;AUDIFONO IN SAM HS1303C/ MIC AZUL;ACCESORIOS
19216108;;F;26;CHILENO;;Z;CHEPICA                       ;L.G.B.OÂ´HIGGINS;0;0;0;0;0;0;0;0;0;PARLANTE KARAOKE FD-PKBT82 8 LUCES MIC/FM/BT/USB;ACCESORIOS
15622936;;F;39;CHILENO;;X;PROVIDENCIA                   ;METROPOLITANA;0;0;0;0;0;0;0;0;0;RADIO RETRO MINI WOOGIE 8751;ACCESORIOS
14574986;;F;43;CHILENO;;X;VILLARICA                     ;ARAUCANIA;0;0;0;0;0;0;0;0;0;MEMORIA MICROSD CLASE 10 128GB SANDISK;ACCESORIOS
13980292;;M;41;CHILENO;;X;COLINA;METROPOLITANA;0;0;0;0;0;0;0;0;0;Funda 15.6 Chroma Sleeve EURO;ACCESORIOS
19120964;;F;26;CHILENO;;Z;PROVIDENCIA                   ;METROPOLITANA;0;0;0;0;0;0;0;0;0;AUDIFONOS HUAWEI MANOS LIBRES TIPO C CM33;ACCESORIOS
17697583;;F;31;CHILENO;;Millenial;ARICA                         ;ARICA Y PARINACOTA;0;0;0;0;0;0;0;0;0;PARLANTE GO 2 BLUETOOTH AZUL;ACCESORIOS
17645310;Soltero;F;29;CHILENO;TECNICO DE NIVEL SUPERIOR EN ENFERMERIA;Millenial;PROVIDENCIA                   ;METROPOLITANA;0;0;0;0;0;0;0;0;0;PARLANTE 8531 MLAB MAX BASS BT;ACCESORIOS
6956477;Viudo;F;67;CHILENO;;Boomers;RANCAGUA                      ;L.G.B.OÂ´HIGGINS;0;0;0;0;0;0;0;0;0;PARLANTE ZUKABASS 4 BT USB/SD/FM CALACAS;ACCESORIOS
8496243;;F;67;CHILENO;;Boomers;VINA DEL MAR                  ;VALPARAISO;0;0;0;0;0;0;0;0;0;PARLANTE 8531 MLAB MAX BASS BT;ACCESORIOS
18453464;Soltero;F;28;CHILENO;TECNICO DE NIVEL SUPERIOR EN ENFERMERIA;Millenial;PROVIDENCIA                   ;METROPOLITANA;0;0;0;0;0;0;0;0;0;PARLANTE ZUKABASS 4 BT USB/SD/FM CALACAS;ACCESORIOS
11933705;;M;50;CHILENO;;X;RENCA                         ;METROPOLITANA;0;0;0;0;0;0;0;0;0;SOPORTE TV 14-42 KTAM02 KIOTO C/ BRAZO MOVIL;ACCESORIOS
26748181;Soltero;M;48;VENEZOLANO;;Extranjero;"";"";0;0;0;0;0;0;0;0;0;SMARTWATCH HUAWEI WATCH FIT BLACK;ACCESORIOS
18720041;;M;28;CHILENO;;Millenial;VILCUN                        ;ARAUCANIA;0;0;0;0;0;0;0;0;0;CABLE DE DATOS USB TIPO C HUAWEI SUPER CHARGER A;ACCESORIOS
18046048;Soltero;M;30;CHILENO;;Millenial;PROVIDENCIA                   ;METROPOLITANA;0;0;0;0;0;0;0;0;0;AUDIFONO ON ZX310AP ROJO;ACCESORIOS
19668006;;F;24;CHILENO;;Z;PROVIDENCIA                   ;METROPOLITANA;0;0;0;0;0;0;0;0;0;AUDIFONO ON ZX310AP ROJO;ACCESORIOS
13781363;Casado;F;41;CHILENO;;X;CHEPICA                       ;L.G.B.OÂ´HIGGINS;0;0;0;0;0;0;0;0;0;AUDIFONO MLAB ON STYLE BLACK BT 8240;ACCESORIOS
16268319;;M;36;CHILENO;;Millenial;N/D;N/D;0;0;0;0;0;0;0;0;0;AUDIFONO ON SONY WH-CH400 AZUL;ACCESORIOS
12266660;;F;50;CHILENO;;X;QUILICURA                     ;METROPOLITANA;0;0;0;0;0;0;0;0;0;PARLANTE GO 2 BLUETOOTH AZUL;ACCESORIOS
13824721;;F;42;CHILENO;;X;LOS MUERMOS                   ;LOS LAGOS;0;0;0;0;0;0;0;0;0;DISCO DURO CANVIO 2TB BASICS BLACK TOSHIBA;ACCESORIOS
12500891;;F;49;CHILENO;;X;PROVIDENCIA                   ;METROPOLITANA;0;0;0;0;0;0;0;0;0;MEMORIA MICROSD CLASE 10 128GB SANDISK;ACCESORIOS
14042914;;M;43;CHILENO;;X;N/D;N/D;0;0;0;0;0;0;0;0;0;AUDIFONO MLAB ON STYLE BLACK BT 8240;ACCESORIOS
13006861;;F;45;CHILENO;;X;N/D;N/D;0;0;0;0;0;0;0;0;0;AUDIFONO IN SAM HS1303C/ MIC BLANCO;ACCESORIOS
7342240;;M;65;CHILENO;;Boomers;OVALLE                        ;COQUIMBO;0;0;0;0;0;0;0;0;0;PARLANTE 6985 MLAB VERTICAL BRITPOP BT;ACCESORIOS
14587437;;F;40;CHILENO;;X;COPIAPO                       ;ATACAMA;0;0;0;0;0;0;0;0;0;RADIO AUTO SONY DSX-A410BT;ACCESORIOS
13416536;;F;44;CHILENO;;X;RENCA                         ;METROPOLITANA;0;0;0;0;0;0;0;0;0;HUAWEI Sport Bluetooth Headphones Lite Black AM6;ACCESORIOS
10370749;;M;49;CHILENO;;X;VALPARAISO                    ;VALPARAISO;0;0;0;0;0;0;0;0;0;AUDIFONO MLAB TWS FULLY WIRELESSÂ  WHITE 8721;ACCESORIOS
15117604;;M;40;CHILENO;;X;PROVIDENCIA                   ;METROPOLITANA;0;0;0;0;0;0;0;0;0;PARLANTE BT MICRO PINEAPPLE 8647;ACCESORIOS
11779624;Casado;F;51;CHILENO;PROFESOR;X;RENCA                         ;METROPOLITANA;0;0;0;0;0;0;0;0;0;DISCO DURO CANVIO 2TB BASICS BLACK TOSHIBA;ACCESORIOS
13794699;;M;42;CHILENO;;X;PROVIDENCIA                   ;METROPOLITANA;0;0;0;0;0;0;0;0;0;HUAWEI FREEBUDS 3I BLANCOS;ACCESORIOS
15630496;;M;38;CHILENO;;X;PROVIDENCIA                   ;METROPOLITANA;0;0;0;0;0;0;0;0;0;KIT DIRECTV GO BOX;ACCESORIOS
19168722;;M;26;CHILENO;;Z;SAN CARLOS                    ;BIO BIO;0;0;0;0;0;0;0;0;0;AUDIFONO IN PANASONIC RP-TCM130PPA AZUL;ACCESORIOS
19046909;Soltero;M;27;CHILENO;PROFESOR;Z;PROVIDENCIA                   ;METROPOLITANA;0;0;0;0;0;0;0;0;0;Smartwatch ACTIVE 1 NEGRO;ACCESORIOS
16957483;Soltero;F;33;CHILENO;TECNICO DE NIVEL MEDIO EN ATENCION DE ENFERMERIA;Millenial;PROVIDENCIA                   ;METROPOLITANA;0;0;0;0;0;0;0;0;0;MOUSE HP Z3700 GOLD WIRELESS;ACCESORIOS
10768380;;F;56;CHILENO;;Boomers;RENCA                         ;METROPOLITANA;0;0;0;0;0;0;0;0;0;AUDIFONO MLAB TWS FULLY WIRELESSÂ  WHITE 8721;ACCESORIOS
12944142;Casado;F;45;CHILENO;;X;RENCA                         ;METROPOLITANA;0;0;0;0;0;0;0;0;0;PARLANTE 7279 MLAB ZUKABASS NEGRO BT;ACCESORIOS
9851325;Soltero;M;58;CHILENO;;Boomers;RENCA                         ;METROPOLITANA;0;0;0;0;0;0;0;0;0;PARLANTE 8531 MLAB MAX BASS BT;ACCESORIOS
17568539;;M;31;CHILENO;;Millenial;PROVIDENCIA                   ;METROPOLITANA;0;0;0;0;0;0;0;0;0;AUDIFONO IN EX15AP SONY NEGRO;ACCESORIOS
15934001;;M;36;CHILENO;;Millenial;PROVIDENCIA                   ;METROPOLITANA;0;0;0;0;0;0;0;0;0;AUDIFONO IN SAM FIT EG920 BLANCO;ACCESORIOS
17256874;;M;32;CHILENO;;Millenial;PROVIDENCIA                   ;METROPOLITANA;0;0;0;0;0;0;0;0;0;AUDIFONO GALAXY BUDS LIVE COBRE;ACCESORIOS
15193438;;M;39;CHILENO;;X;N/D;N/D;0;0;0;0;0;0;0;0;0;AUDIFONO ON ZX110AP SONY BLANCO;ACCESORIOS
18621431;Soltero;M;28;CHILENO;;Millenial;"";"";0;0;0;0;0;0;0;0;0;Smartwatch GT 2E BLACK;ACCESORIOS
19390496;;F;25;CHILENO;;Z;PROVIDENCIA                   ;METROPOLITANA;0;0;0;0;0;0;0;0;0;PARLANTE 8531 MLAB MAX BASS BT;ACCESORIOS
17855424;Soltero;M;31;CHILENO;PROFESOR;Millenial;PROVIDENCIA                   ;METROPOLITANA;0;0;0;0;0;0;0;0;0;MEMORIA MICROSD CLASE 10 200GB SANDISK;ACCESORIOS
15562609;;F;38;CHILENO;;X;DONIHUE                       ;L.G.B.OÂ´HIGGINS;0;0;0;0;0;0;0;0;0;DISCO DURO CANVIO 4TB BASICS BLACK;ACCESORIOS
5995000;;M;74;CHILENO;;Silencioso;CONCEPCION                    ;BIO BIO;0;0;0;0;0;0;0;0;0;RADIO RETRO ANTIQUE 8732;ACCESORIOS
18161936;;F;30;CHILENO;;Millenial;SAN ANTONIO                   ;VALPARAISO;0;0;0;0;0;0;0;0;0;AUDIFONO IN EX15LP SONY AZL;ACCESORIOS
9310739;Soltero;M;59;CHILENO;INGENIERO AGRICOLA;Boomers;PROVIDENCIA                   ;METROPOLITANA;0;0;0;0;0;0;0;0;0;RADIO RETRO ANTIQUE 8732;ACCESORIOS
18967349;Soltero;F;26;CHILENO;;Z;PROVIDENCIA                   ;METROPOLITANA;0;0;0;0;0;0;0;0;0;AUDIFONO IN EX15AP SONY NEGRO;ACCESORIOS
16486753;;F;35;CHILENO;;Millenial;PROVIDENCIA                   ;METROPOLITANA;0;0;0;0;0;0;0;0;0;Smartwatch GT 2E BLACK;ACCESORIOS
10711684;Soltero;F;43;CHILENO;CIRUJANO DENTISTA;X;RENCA                         ;METROPOLITANA;0;0;0;0;0;0;0;0;0;SOPORTE TV 32-65 KTA03 KIOTO FIJO;ACCESORIOS
20502974;;M;21;CHILENO;;Z;PROVIDENCIA                   ;METROPOLITANA;0;0;0;0;0;0;0;0;0;PENDRIVE KINGSTON DT100G3/64GB DATATRAVELER 100;ACCESORIOS
9864390;;F;58;CHILENO;;Boomers;SAN FELIPE                    ;VALPARAISO;0;0;0;0;0;0;0;0;0;AUDIFONO ON ZX110AP SONY BLANCO;ACCESORIOS
17388796;Soltero;M;32;CHILENO;ENFERMERO;Millenial;PROVIDENCIA                   ;METROPOLITANA;0;0;0;0;0;0;0;0;0;MEMORIA MICROSD CLASE 10 128GB SANDISK;ACCESORIOS
19271559;;F;26;CHILENO;;Millenial;N/D;N/D;0;0;0;0;0;0;0;0;0;TRAVEL ADAPTER 15W - FAST CHARGER (TYPE-C CABLE);ACCESORIOS
17276026;;F;32;CHILENO;;Millenial;PROVIDENCIA                   ;METROPOLITANA;0;0;0;0;0;0;0;0;0;AUDIFONO MLAB TWS IN-AIR WHITE 8533;ACCESORIOS
17006749;;F;33;CHILENO;;Millenial;RENGO                         ;L.G.B.OÂ´HIGGINS;0;0;0;0;0;0;0;0;0;AUDIFONO ON ZX110AP SONY NEGRO;ACCESORIOS
13898576;;M;42;CHILENO;;X;SAN RAMON                     ;METROPOLITANA;0;0;0;0;0;0;0;0;0;365 Familia 6 usuarios Anual;ACCESORIOS
5322323;;F;75;CHILENO;;Silencioso;PROVIDENCIA                   ;METROPOLITANA;0;0;0;0;0;0;0;0;0;PARLANTE 8531 MLAB MAX BASS BT;ACCESORIOS
17814535;;M;31;CHILENO;;Millenial;N/D;N/D;0;0;0;0;0;0;0;0;0;MOUSE HP Z3700 SILVER WIRELESS;ACCESORIOS
14125774;;M;41;CHILENO;;X;DONIHUE                       ;L.G.B.OÂ´HIGGINS;0;0;0;0;0;0;0;0;0;CARGADOR HUAWEI MICROUSB-USB AP32 USB TIPO C;ACCESORIOS
16194980;;M;35;CHILENO;;Millenial;N/D;N/D;0;0;0;0;0;0;0;0;0;SOPORTE TV 14-63 CON BRAZO KT-FM 3L;ACCESORIOS
5090082;;F;82;CHILENO;;Silencioso;HUALPEN;BIO BIO;0;0;0;0;0;0;0;0;0;PARLANTE 8531 MLAB MAX BASS BT;ACCESORIOS
20307944;;F;22;CHILENO;;Z;PROVIDENCIA                   ;METROPOLITANA;0;0;0;0;0;0;0;0;0;SOPORTE TV 14-42 KTAM02 KIOTO C/ BRAZO MOVIL;ACCESORIOS
14399508;Divorciado;M;43;CHILENO;;X;RENCA                         ;METROPOLITANA;0;0;0;0;0;0;0;0;0;Smartwatch GT 2 BLACK;ACCESORIOS
7016056;Casado;M;52;CHILENO;;X;PROVIDENCIA                   ;METROPOLITANA;0;0;0;0;0;0;0;0;0;TECLADO + MOUSE MICROSOFT Wireless Desktop 850;ACCESORIOS
17794682;;M;31;CHILENO;;Extranjero;CURICO                        ;MAULE;0;0;0;0;0;0;0;0;0;Smartwatch GT 2 ORANGE;ACCESORIOS
13044637;;M;46;CHILENO;;X;PROVIDENCIA                   ;METROPOLITANA;0;0;0;0;0;0;0;0;0;PARLANTE 8247 MLAB SOUNDLAB BLACK;ACCESORIOS
20323852;;M;22;CHILENO;;Z;N/D;N/D;0;0;0;0;0;0;0;0;0;DISCO DURO CANVIO 1TB BASICS BLACK TOSHIBA;ACCESORIOS
16200143;;F;36;CHILENO;;Millenial;PROVIDENCIA                   ;METROPOLITANA;0;0;0;0;0;0;0;0;0;APPLE WATCH S5 40MM GOLD;ACCESORIOS
13678690;;M;43;CHILENO;;X;"";"";0;0;0;0;0;0;0;0;0;DISCO DURO CANVIO 2TB BASICS BLACK TOSHIBA;ACCESORIOS
19534526;;M;25;CHILENO;;Z;N/D;N/D;0;0;0;0;0;0;0;0;0;DISCO DURO CANVIO 1TB BASICS BLACK TOSHIBA;ACCESORIOS
6711982;;M;71;CHILENO;;Silencioso;PROVIDENCIA                   ;METROPOLITANA;0;0;0;0;0;0;0;0;0;PARLANTE 6985 MLAB VERTICAL BRITPOP BT;ACCESORIOS
17833548;;F;31;CHILENO;;Millenial;RENCA                         ;METROPOLITANA;0;0;0;0;0;0;0;0;0;Smartwatch ACTIVE 2 BLACK;ACCESORIOS
15644866;Soltero;M;39;CHILENO;;X;RENCA                         ;METROPOLITANA;0;0;0;0;0;0;0;0;0;SOPORTE TV 32-65 KTA03 KIOTO FIJO;ACCESORIOS
7546199;Casado;M;63;CHILENO;;Boomers;PROVIDENCIA                   ;METROPOLITANA;0;0;0;0;0;0;0;0;0;RADIO RETRO ANTIQUE 8732;ACCESORIOS
11795168;;F;50;CHILENO;;X;PROVIDENCIA                   ;METROPOLITANA;0;0;0;0;0;0;0;0;0;SOPORTE TV 26-56 KTAT02 KIOTO MOVIL;ACCESORIOS
19352797;;F;26;CHILENO;;Silencioso;PROVIDENCIA                   ;METROPOLITANA;348960;4;2;4;2;348960;0;0;0;BIANCHI WOLF 20 SX PLATA;BICICLETAS
17526771;Soltero;M;30;CHILENO;;Millenial;PROVIDENCIA                   ;METROPOLITANA;411980;2;1;2;1;411980;0;0;0;SUNPEED RULE 27.5 NARANJA S;BICICLETAS
9135971;Casado;F;60;CHILENO;;Boomers;RENCA                         ;METROPOLITANA;68980;2;1;0;0;0;2;1;68980;BICICLETA INFANTIL ARO 12 ROSADA;BICICLETAS
18970597;;F;26;CHILENO;;Z;COPIAPO                       ;ATACAMA;135980;2;1;2;1;135980;0;0;0;BICI RETROPLUS CELESTE ARO 26;BICICLETAS
19199280;;M;26;CHILENO;;Z;PROVIDENCIA                   ;METROPOLITANA;149980;2;1;2;1;149980;0;0;0;BICI ALLEYCAT NEGRA/TURQUESA 28 FITZER;BICICLETAS
25417870;;M;55;COLOMBIANO;;Extranjero;ANTOFAGASTA                   ;ANTOFAGASTA;254990;1;1;0;0;0;1;1;254990;MODELO SUNPEED ZERO ARO 29 ROJA M;BICICLETAS
19982635;;M;23;CHILENO;;Z;"";"";69990;1;1;0;0;0;1;1;69990;MOTOBIKE INFANTIL ROJA ARO 12;BICICLETAS
15491457;;M;39;CHILENO;;X;CHILLAN                       ;BIO BIO;559980;2;2;0;0;0;2;2;559980;BICI STRIKER AMARILLA 29 V-BRAKE;BICICLETAS
16159091;;F;36;CHILENO;;Millenial;N/D;N/D;349980;2;1;0;0;0;2;1;349980;BICI SHINEPLUS GRIS 27,5 FRENO DISCO;BICICLETAS
16556706;;F;35;CHILENO;;Millenial;PROVIDENCIA                   ;METROPOLITANA;63980;2;1;2;1;63980;0;0;0;BICICLETA INFANTIL ARO 16 NEGRA;BICICLETAS
9721778;;F;60;CHILENO;;Boomers;LA REINA                      ;METROPOLITANA;333970;3;1;0;0;0;3;1;333970;V-BICICLETA MTB XT-9003 ARO 27.5;BICICLETAS
17300476;Soltero;F;32;CHILENO;;Millenial;RENCA                         ;METROPOLITANA;169980;2;1;2;1;169980;0;0;0;BICI RETROPLUS VERDE 26 V-BRAKE;BICICLETAS
19045277;;F;26;CHILENO;;Z;"";"";269990;1;1;0;0;0;1;1;269990;MODELO SUNPEED STELLA ARO 27.5 ROSADA S;BICICLETAS
15996436;;M;37;CHILENO;;Millenial;PUCON                         ;ARAUCANIA;352950;5;2;0;0;0;5;2;352950;BICICLETA INFANTIL ARO 20 AMARILLA;BICICLETAS
15906287;;F;38;CHILENO;;Millenial;TALCA                         ;MAULE;332980;2;1;0;0;0;2;1;332980;BC XTS MTB ALU STRIKER 29 21VEL DISCO NEGRO;BICICLETAS
7729415;;M;62;CHILENO;;Boomers;VINA DEL MAR                  ;VALPARAISO;649960;4;2;2;1;539980;2;1;109980;MOTOBIKE NARANJA ARO 16;BICICLETAS
14002613;;F;40;CHILENO;;X;EL TABO                       ;VALPARAISO;579960;4;3;2;1;309980;2;2;269980;V-BICICLETA MTB XT-9001 ARO 26;BICICLETAS
7584532;;F;67;CHILENO;;Boomers;CONSTITUCION                  ;MAULE;229990;1;1;0;0;0;1;1;229990;BICI STRIKER AMARILLA 29 V-BRAKE;BICICLETAS
20381416;;F;22;CHILENO;;Z;ROMERAL                       ;MAULE;69990;1;1;0;0;0;1;1;69990;BICICLETA INFANTIL ARO 12 AMARILLA;BICICLETAS
9698349;;M;57;CHILENO;;Boomers;LA PINTANA                    ;METROPOLITANA;159980;2;1;2;1;159980;0;0;0;BICI RETROPLUS VERDE 26 V-BRAKE;BICICLETAS
15534413;;F;40;CHILENO;;X;EL BOSQUE                     ;METROPOLITANA;104990;1;1;0;0;0;1;1;104990;MOTOBIKE NARANJA ARO 16;BICICLETAS
17331193;;M;32;CHILENO;;Millenial;VALLENAR;ATACAMA;89990;1;1;0;0;0;1;1;89990;MOTOBIKE NARANJA ARO 16;BICICLETAS
10860619;;F;51;CHILENO;;X;LAMPA                         ;METROPOLITANA;569980;2;1;0;0;0;2;1;569980;BICICLETA MTB ELBRUS ARO 26 AZUL;BICICLETAS
15987975;;F;37;CHILENO;;Millenial;"";"";383950;5;2;5;2;383950;0;0;0;BIANCHI MTB PRO 26 ST LADY CON CANASTO BLANCO/CE;BICICLETAS
17005087;;F;33;CHILENO;;Millenial;PROVIDENCIA                   ;METROPOLITANA;103980;2;1;2;1;103980;0;0;0;BICICLETA INFANTIL ARO 16 ROSADA;BICICLETAS
15293057;;M;40;CHILENO;;X;N/D;N/D;109990;1;1;0;0;0;1;1;109990;BICICLETA INFANTIL ARO 16 CELESTE;BICICLETAS
15410581;Soltero;M;40;CHILENO;DISENADOR GRAFICO;X;PROVIDENCIA                   ;METROPOLITANA;93980;2;1;2;1;93980;0;0;0;V-MTB ARO 16 MINNIE ROSADO;BICICLETAS
9945700;;F;56;CHILENO;;Boomers;ANGOL                         ;ARAUCANIA;182970;3;2;0;0;0;3;2;182970;BICICLETA INFANTIL ARO 20 AMARILLA;BICICLETAS
19719548;;F;24;CHILENO;;Z;BUIN                          ;METROPOLITANA;757850;4;2;0;0;0;4;2;757850;BICICLETA INFANTIL ARO 12 AMARILLA;BICICLETAS
18822239;;F;26;CHILENO;;Z;CORONEL                       ;BIO BIO;85840;2;1;2;1;85840;0;0;0;BICICLETA INFANTIL ARO 16 ROSADA;BICICLETAS
17911003;;M;31;CHILENO;;Millenial;PROVIDENCIA                   ;METROPOLITANA;95840;2;1;2;1;95840;0;0;0;BICICLETA INFANTIL ARO 20 AMARILLA;BICICLETAS
15546681;;M;38;CHILENO;;Millenial;PROVIDENCIA                   ;METROPOLITANA;2870910;21;2;0;0;0;21;2;2870910;BICICLETA INFANTIL ARO 16 CELESTE;BICICLETAS
19746054;;F;24;CHILENO;;Z;PROVIDENCIA                   ;METROPOLITANA;169980;2;1;2;1;169980;0;0;0;BICI RETROPLUS ROSADA 26 V-BRAKE;BICICLETAS
16221852;;F;36;CHILENO;;Millenial;CHILLAN                       ;NUBLE;347970;3;3;0;0;0;3;3;347970;BICI STRIKER AMARILLA 29 V-BRAKE;BICICLETAS
15308364;;M;39;CHILENO;;X;RENCA                         ;METROPOLITANA;352960;4;1;0;0;0;4;1;352960;BICICLETA MTB ELBRUS ARO 26 AZUL;BICICLETAS
7074561;;M;61;CHILENO;;Boomers;"";"";249990;1;1;0;0;0;1;1;249990;BICICLETA MONKEL 29 ALUMINIO AZUL;BICICLETAS
10910870;Casado;F;40;CHILENO;EDUCADOR DE PARVULO;X;RENCA                         ;METROPOLITANA;64980;2;1;0;0;0;2;1;64980;V-BICICLETA BIANCHI CORSA CELESTE;BICICLETAS
18819753;;F;26;CHILENO;;Z;N/D;N/D;0;0;0;0;0;0;0;0;0;BIANCHI ADVANTAGE 27,5 SX NEGRO SEMI MATTE/BLANC;BICICLETAS
16635307;Soltero;M;34;CHILENO;PROFESOR;Millenial;RENCA                         ;METROPOLITANA;0;0;0;0;0;0;0;0;0;BIANCHI STREET 20 LADY BLANCO / ORANGE;BICICLETAS
17455571;;F;32;CHILENO;;Millenial;PROVIDENCIA                   ;METROPOLITANA;0;0;0;0;0;0;0;0;0;HOTWHEELS 20 ROJO;BICICLETAS
17983103;Soltero;M;30;CHILENO;CONSTRUCTOR CIVIL;Millenial;PROVIDENCIA                   ;METROPOLITANA;0;0;0;0;0;0;0;0;0;BICICLETA VISION KRYPTON ALUMINIO (NEGRO / NARAN;BICICLETAS
15161535;;M;38;CHILENO;;Millenial;"";"";0;0;0;0;0;0;0;0;0;HOTWHEELS 12 BLANCO;BICICLETAS
11929682;;M;49;CHILENO;;X;CASTRO                        ;LOS LAGOS;0;0;0;0;0;0;0;0;0;BIANCHI STONE MOUNT 29 L NEG;BICICLETAS
18147721;Soltero;M;30;CHILENO;;Millenial;PROVIDENCIA                   ;METROPOLITANA;0;0;0;0;0;0;0;0;0;MTB EXPLORER BICYSTAR ARO 29 VERDE-PLOMO;BICICLETAS
7733595;Soltero;M;65;CHILENO;;Boomers;PROVIDENCIA                   ;METROPOLITANA;0;0;0;0;0;0;0;0;0;V-BICICLETA URBANA HOMBRE BOLLEN 700;BICICLETAS
20265558;;F;22;CHILENO;;Z;PROVIDENCIA                   ;METROPOLITANA;0;0;0;0;0;0;0;0;0;BICI VIGOR GRIS 24 V-BRAKE;BICICLETAS
16403603;;M;36;CHILENO;;Millenial;PROVIDENCIA                   ;METROPOLITANA;0;0;0;0;0;0;0;0;0;BICI STRIKER AMARILLA 29 V-BRAKE;BICICLETAS
14052831;;F;40;CHILENO;;X;RENCA                         ;METROPOLITANA;0;0;0;0;0;0;0;0;0;BICI VIGOR NEGRA 24 V-BRAKE;BICICLETAS
15763333;;F;37;CHILENO;;Millenial;PROVIDENCIA                   ;METROPOLITANA;0;0;0;0;0;0;0;0;0;BICI VIGORPLUS NEGRA 27,5 V-BRAKE;BICICLETAS
16086055;;M;36;CHILENO;;Millenial;N/D;N/D;0;0;0;0;0;0;0;0;0;BICICLETA INFANTIL ARO 20 BLANCA;BICICLETAS
16690643;;M;34;CHILENO;;Millenial;PROVIDENCIA                   ;METROPOLITANA;0;0;0;0;0;0;0;0;0;BICICLETA INFANTIL ARO 12 CELESTE;BICICLETAS
18794156;;F;28;CHILENO;;Millenial;PUENTE ALTO                   ;METROPOLITANA;0;0;0;0;0;0;0;0;0;BICICLETA INFANTIL ARO 16 ROSADA;BICICLETAS
17735195;;F;31;CHILENO;;Millenial;PROVIDENCIA                   ;METROPOLITANA;0;0;0;0;0;0;0;0;0;BICI RETROPLUS BEIGE 26 V-BRAKE;BICICLETAS
19307095;Soltero;F;26;CHILENO;MATRONA;Z;PROVIDENCIA                   ;METROPOLITANA;0;0;0;0;0;0;0;0;0;BC XTS MTB ACE MUJ SHINE 27 18VEL DISCO TURQ;BICICLETAS
10434516;;F;58;CHILENO;;Boomers;MAIPU                         ;METROPOLITANA;0;0;0;0;0;0;0;0;0;BIANCHI STREET 20 LADY AMARILLO CLARO VERDE;BICICLETAS
15644882;;M;39;CHILENO;;X;CHONCHI                       ;LOS LAGOS;0;0;0;0;0;0;0;0;0;V-MTB ARO 12 SPIDERMAN ROJO;BICICLETAS
17545592;;F;33;CHILENO;;Millenial;PROVIDENCIA                   ;METROPOLITANA;0;0;0;0;0;0;0;0;0;BICICLETA INFANTIL ARO 20 AMARILLA;BICICLETAS
19895575;;M;24;CHILENO;;Z;PROVIDENCIA                   ;METROPOLITANA;0;0;0;0;0;0;0;0;0;BICI VIGORPLUS NEGRA 27,5 V-BRAKE;BICICLETAS
15418769;;M;40;CHILENO;;X;PROVIDENCIA                   ;METROPOLITANA;0;0;0;0;0;0;0;0;0;BICI VIGORPLUS NEGRA 27,5 V-BRAKE;BICICLETAS
14003951;;F;40;CHILENO;;X;SAN ANTONIO                   ;VALPARAISO;0;0;0;0;0;0;0;0;0;BICI RETROPLUS BEIGE 26 V-BRAKE;BICICLETAS
13502847;Casado;M;44;CHILENO;;X;RENCA                         ;METROPOLITANA;0;0;0;0;0;0;0;0;0;BICICLETA INFANTIL ARO 16 CELESTE;BICICLETAS
19643077;;M;25;CHILENO;;Z;OSORNO                        ;LOS LAGOS;0;0;0;0;0;0;0;0;0;BICICLETA INFANTIL ARO 20 BLANCA;BICICLETAS
8757376;;M;62;CHILENO;;Boomers;PROVIDENCIA                   ;METROPOLITANA;0;0;0;0;0;0;0;0;0;BICI SHINEPLUS BLANCA 27,5 FRENO DISCO;BICICLETAS
12470154;;F;48;CHILENO;;X;PROVIDENCIA                   ;METROPOLITANA;0;0;0;0;0;0;0;0;0;CASCO COMIC;BICICLETAS
12643410;;M;48;CHILENO;;X;RENCA                         ;METROPOLITANA;0;0;0;0;0;0;0;0;0;BICICLETA INFANTIL ARO 16 NEGRA;BICICLETAS
10655158;;M;55;CHILENO;;Boomers;CASABLANCA                    ;VALPARAISO;0;0;0;0;0;0;0;0;0;BICICLETA INFANTIL ARO 20 AMARILLA;BICICLETAS
18413266;;M;28;CHILENO;;Millenial;PROVIDENCIA                   ;METROPOLITANA;0;0;0;0;0;0;0;0;0;BICI RETROPLUS BEIGE 26 V-BRAKE;BICICLETAS
16638591;;M;35;CHILENO;;Millenial;PROVIDENCIA                   ;METROPOLITANA;0;0;0;0;0;0;0;0;0;BICICLETA INFANTIL ARO 20 BLANCA;BICICLETAS
10116241;Casado;F;57;CHILENO;PROFESOR;Boomers;RENCA                         ;METROPOLITANA;0;0;0;0;0;0;0;0;0;BICICLETA INFANTIL ARO 12 CELESTE;BICICLETAS
11232703;;M;56;CHILENO;;Boomers;SAN MIGUEL                    ;METROPOLITANA;0;0;0;0;0;0;0;0;0;BICI OX 20 SPINE 1V AZUL A20;BICICLETAS
13530528;;F;43;CHILENO;;X;COQUIMBO                      ;COQUIMBO;0;0;0;0;0;0;0;0;0;BICICLETA INFANTIL ARO 16 ROSADA;BICICLETAS
17847724;;F;31;CHILENO;;Millenial;RENCA                         ;METROPOLITANA;0;0;0;0;0;0;0;0;0;HOTWHEELS ARO 16 PLATA;BICICLETAS
13306976;;M;44;CHILENO;;X;PROVIDENCIA                   ;METROPOLITANA;0;0;0;0;0;0;0;0;0;BICICLETA APRENDIZAJE CON CASCO RED;BICICLETAS
15983059;;F;37;CHILENO;;Millenial;SAN FERNANDO                  ;L.G.B.OÂ´HIGGINS;0;0;0;0;0;0;0;0;0;CASCO COMIC;BICICLETAS
18014352;Soltero;F;30;CHILENO;CIRUJANO DENTISTA;Millenial;PROVIDENCIA                   ;METROPOLITANA;0;0;0;0;0;0;0;0;0;BICICLETA ELECTRICA QICYCLE XIAOMI;BICICLETAS
7619683;;M;65;CHILENO;;Boomers;N/D;N/D;0;0;0;0;0;0;0;0;0;CASCO COMIC;BICICLETAS
13727317;;M;43;CHILENO;;X;"";"";223970;3;2;0;0;0;3;2;223970;PACK 2 ALMOHADAS C+L;DORMITORIO
6203406;;F;73;CHILENO;;Silencioso;MELIPILLA                     ;METROPOLITANA;485751;11;5;0;0;0;11;5;485751;COLCHON NEW ENTREE 2P;DORMITORIO
16850398;;F;34;CHILENO;;Millenial;LOS SAUCES                    ;ARAUCANIA;3872570;39;18;36;16;3774600;3;2;97970;COLCHON ERGO T 1.50X2.00;DORMITORIO
19466163;;F;25;CHILENO;;Millenial;"";"";10990;1;1;0;0;0;1;1;10990;PACK 2 ALMOHADAS C+L;DORMITORIO
10164881;Soltero;F;58;CHILENO;;Boomers;RENCA                         ;METROPOLITANA;332960;4;2;0;0;0;4;2;332960;COLCHON CASALINDA CDM 2PL X200;DORMITORIO
26829732;;M;33;HAITIANO;;Extranjero;N/D;N/D;1074910;10;6;9;5;1044920;1;1;29990;CE EVOLUTION BLACK 2P BD+RESP+2 VEL;DORMITORIO
18363080;;M;29;CHILENO;;Millenial;N/D;N/D;41980;2;1;0;0;0;2;1;41980;Almohada Cooling 65x48 cm;DORMITORIO
16470432;;M;35;CHILENO;;Millenial;QUINTA NORMAL                 ;METROPOLITANA;181980;2;1;2;1;181980;0;0;0;CE EVOLUTION BLACK 1,5P BN DUAL SIDE;DORMITORIO
9370085;;F;60;CHILENO;;Boomers;TALCA                         ;MAULE;33940;6;5;0;0;0;6;5;33940;PACK 2 ALMOHADAS C+L;DORMITORIO
7064570;;F;69;CHILENO;;Silencioso;CALBUCO                       ;LOS LAGOS;378910;4;2;0;0;0;4;2;378910;COLCHON WAVE 1.05X1.90;DORMITORIO
13328540;;F;43;CHILENO;;X;N/D;N/D;1129940;6;5;1;1;49990;5;4;1079950;Cama Europea Terapeutic 2PBN + Resp + 2 Vel Vill;DORMITORIO
9505822;;M;56;CHILENO;;Boomers;VILLA ALEMANA                 ;VALPARAISO;730940;8;3;0;0;0;8;3;730940;COLCHON NEW ORTOPEDIC 2P;DORMITORIO
17716375;;F;31;CHILENO;;Millenial;CHEPICA                       ;L.G.B.OÂ´HIGGINS;10990;1;1;0;0;0;1;1;10990;PACK 2 ALMOHADAS C+L;DORMITORIO
17757936;Soltero;F;31;CHILENO;ENFERMERA;Millenial;PROVIDENCIA                   ;METROPOLITANA;168980;2;1;2;1;168980;0;0;0;CAMA NIDO HOUSTON;DORMITORIO
15126863;;M;40;CHILENO;;X;CURICO                        ;MAULE;282980;2;1;0;0;0;2;1;282980;CE EVOLUTION BLACK 1,5P BN RESP+VEL;DORMITORIO
18258289;;F;30;CHILENO;;Millenial;VILLA ALEMANA                 ;VALPARAISO;206980;2;1;2;1;206980;0;0;0;COLCHON ERGO T 1.50X2.00;DORMITORIO
17471365;;F;31;CHILENO;;Millenial;N/D;N/D;534959;6;2;0;0;0;6;2;534959;COLCHON BAMBOO 1,5P FIBRAS BAMBOO;DORMITORIO
17901815;;M;29;CHILENO;;Millenial;CONSTITUCION                  ;MAULE;9990;1;1;0;0;0;1;1;9990;Almohada Imperial Soft 50x70 cm;DORMITORIO
18307772;;F;29;CHILENO;;Millenial;"";"";110990;1;1;0;0;0;1;1;110990;CLOSET CAJONERA NEW BELGICA M-398-NW;DORMITORIO
9021239;;M;59;CHILENO;;Boomers;N/D;N/D;200970;3;2;2;1;188980;1;1;11990;CE EVOLUTION BLACK 1,5P BN DUAL SIDE;DORMITORIO
18772217;;F;27;CHILENO;;Millenial;CHILLAN                       ;BIO BIO;35980;2;1;0;0;0;2;1;35980;ALMOHADA COOL GEL TECH SERIES 60X40 CM;DORMITORIO
7307781;;M;69;CHILENO;;Silencioso;MELIPILLA                     ;METROPOLITANA;212970;3;1;0;0;0;3;1;212970;CLOSET 2 PUERTAS BALI BICOLOR;DORMITORIO
26857732;;M;25;HAITIANO;;Extranjero;SAN FELIPE                    ;VALPARAISO;238810;2;1;0;0;0;2;1;238810;CE EVOLUTION BLACK 1,5P + RESPALDO CASTILLA;DORMITORIO
5477113;;F;75;CHILENO;;Silencioso;PROVIDENCIA                   ;METROPOLITANA;9990;1;1;0;0;0;1;1;9990;PACK 2 ALMOHADAS C+L;DORMITORIO
8842984;Soltero;F;62;CHILENO;;Boomers;RENCA                         ;METROPOLITANA;176980;2;1;2;1;176980;0;0;0;CE EVOLUTION BLACK 1,5P BN DUAL SIDE;DORMITORIO
17193795;;F;33;CHILENO;;Millenial;COPIAPO                       ;ATACAMA;486010;6;2;0;0;0;6;2;486010;BOX AMERICANO MIRAGE 2PBN;DORMITORIO
12447895;;F;49;CHILENO;;X;"";"";27990;1;1;0;0;0;1;1;27990;Almohada Cooling 65x48 cm;DORMITORIO
20236233;;F;22;CHILENO;;Z;CANELA                        ;COQUIMBO;128968;3;1;0;0;0;3;1;128968;COLCHON ERGO T 1P;DORMITORIO
11673394;;F;52;CHILENO;;X;RENCA                         ;METROPOLITANA;1538282;13;6;0;0;0;13;6;1538282;CE Everest 2P x 2 mt. + Set Paris;DORMITORIO
9826773;;M;56;CHILENO;;Boomers;PUNTA ARENAS                  ;MAGALLANES;342960;3;1;0;0;0;3;1;342960;CE EVOLUTION BLACK 1,5P BN RESP+VEL;DORMITORIO
6992095;;M;69;CHILENO;;Silencioso;PUNTA ARENAS                  ;MAGALLANES;299990;1;1;0;0;0;1;1;299990;CE ERGO T 2P 2MT BD;DORMITORIO
9625962;;M;60;CHILENO;;Boomers;OVALLE                        ;COQUIMBO;824340;5;4;0;0;0;5;4;824340;CE EVOLUTION BLACK 1,5P BN RESP+VEL;DORMITORIO
19667702;;M;24;CHILENO;;Z;PROVIDENCIA                   ;METROPOLITANA;249520;4;2;4;2;249520;0;0;0;RESPALDO TABOR GRAFITO 2PL;DORMITORIO
16846774;;F;34;CHILENO;;Millenial;CHANCO                        ;MAULE;448970;3;3;3;3;448970;0;0;0;SET RESPALDO BENITO 1,5 PLAZAS + 1 VELADOR;DORMITORIO
10013634;;F;59;CHILENO;;Boomers;INDEPENDENCIA                 ;METROPOLITANA;465960;4;2;0;0;0;4;2;465960;CE EVOLUTION BLACK 2P BD+RESP+2 VEL;DORMITORIO
20612315;;F;21;CHILENO;;Z;"";"";4990;1;1;0;0;0;1;1;4990;PACK 2 ALMOHADAS C+L;DORMITORIO
11455300;Casado;F;53;CHILENO;;X;RENCA                         ;METROPOLITANA;209990;1;1;1;1;209990;0;0;0;CE EVOLUTION BLACK 1,5P BN RESP+VEL;DORMITORIO
9854404;;M;59;CHILENO;;Boomers;LLANQUIHUE                    ;LOS LAGOS;22980;2;2;0;0;0;2;2;22980;Almohadas Isidora Soft 50x90 cm;DORMITORIO
19281714;;F;26;CHILENO;;Z;RENCA;METROPOLITANA;393980;2;1;2;1;393980;0;0;0;CE CAMA ERGO T 1.50X2.00 BD + RESP FERRARA;DORMITORIO
14619192;;F;40;CHILENO;;X;LOTA                          ;BIO BIO;309970;4;3;1;1;129990;3;2;179980;CLOSET ESPANA 6P+4C;DORMITORIO
21152326;;F;42;PERUANO;;Extranjero;SANTIAGO                      ;METROPOLITANA;748910;9;5;2;1;199980;7;4;548930;PACK 2 ALMOHADAS C+L;DORMITORIO
9298503;;F;56;CHILENO;;Boomers;VALLENAR;ATACAMA;291850;6;3;0;0;0;6;3;291850;PACK 2 ALMOHADAS C+L;DORMITORIO
13746839;;M;42;CHILENO;;Millenial;"";"";26980;2;2;0;0;0;2;2;26980;PACK 2 ALMOHADAS C+L;DORMITORIO
13815448;;F;42;CHILENO;;X;N/D;N/D;415127;7;3;7;3;415127;0;0;0;CAMA EUROPEA WAVE1.05X1.90 TABOR GRAF;DORMITORIO
19027916;Soltero;M;27;CHILENO;;Millenial;"";"";4990;1;1;0;0;0;1;1;4990;PACK 2 ALMOHADAS C+L;DORMITORIO
19577900;;M;25;CHILENO;;Extranjero;PROVIDENCIA                   ;METROPOLITANA;4990;1;1;1;1;4990;0;0;0;PACK 2 ALMOHADAS C+L;DORMITORIO
20188484;;F;23;CHILENO;;Millenial;"";"";19960;4;1;4;1;19960;0;0;0;PACK 2 ALMOHADAS C+L;DORMITORIO
16326742;;F;35;CHILENO;;Millenial;TOCOPILLA                     ;ANTOFAGASTA;1053950;5;3;2;1;203980;3;2;849970;COLCHON CASALINDA CDM 2PL X200;DORMITORIO
10429162;;M;56;CHILENO;;Boomers;RENCA                         ;METROPOLITANA;229980;2;1;2;1;229980;0;0;0;CE EVOLUTION BLACK 1,5P BN RESP+VEL;DORMITORIO
10908618;;F;54;CHILENO;;Boomers;SAN ANTONIO                   ;VALPARAISO;996100;9;3;0;0;0;9;3;996100;COLCHON IBIZA 2P;DORMITORIO
8310606;;F;61;CHILENO;;Boomers;LA GRANJA                     ;METROPOLITANA;171980;2;1;2;1;171980;0;0;0;BOX AMERICANO BEAT 1,5 PLAZAS 105 X 190 CM;DORMITORIO
24879703;;M;39;PERUANO;;Extranjero;N/D;N/D;243960;4;2;0;0;0;4;2;243960;CE EVOLUTION BLACK 1,5P BN RESP+VEL;DORMITORIO
6777424;Divorciado;F;63;CHILENO;;Boomers;RENCA                         ;METROPOLITANA;253980;2;1;2;1;253980;0;0;0;SET MUEBLES SICILIA 2PL;DORMITORIO
17399951;;M;32;CHILENO;;Millenial;N/D;N/D;2410460;27;4;0;0;0;27;4;2410460;COLCHON BAMBOO 2P FIBRAS BAMBOO;DORMITORIO
11138182;;F;55;CHILENO;;Boomers;PANGUIPULLI                   ;LOS LAGOS;271980;2;1;0;0;0;2;1;271980;BOX AMERICANO EXCELLENCE PLUS 2P BN+2ALM;DORMITORIO
9322424;;M;57;CHILENO;;Boomers;ALTO HOSPICIO;TARAPACA;519990;1;1;0;0;0;1;1;519990;CE EVEREST 2P 2MTS BD DUAL SIDE;DORMITORIO
16077013;;F;37;CHILENO;;Millenial;PUTAENDO                      ;VALPARAISO;299990;1;1;0;0;0;1;1;299990;CE ERGO T 2P 2MT BD;DORMITORIO
18668240;;F;28;CHILENO;;Millenial;BUIN                          ;METROPOLITANA;99980;2;1;2;1;99980;0;0;0;COMODA POLUX 8CJNS WENGUE;DORMITORIO
9398682;Soltero;M;59;CHILENO;;Boomers;PROVIDENCIA                   ;METROPOLITANA;360970;3;2;0;0;0;3;2;360970;COLCHON THERAPEDIC 1,5P;DORMITORIO
18136659;;F;29;CHILENO;;Millenial;OVALLE                        ;COQUIMBO;383970;3;1;3;1;383970;0;0;0;CLOSET 3P 0C MOD H563 - JACARANDA;DORMITORIO
6775204;Casado;M;70;CHILENO;AGRONOMO;Silencioso;RENCA                         ;METROPOLITANA;322980;2;1;0;0;0;2;1;322980;COLCHON TERAPEUTIC 2P PILLOW TOP;DORMITORIO
7442720;;M;67;CHILENO;;Boomers;CHIMBARONGO                   ;L.G.B.OÂ´HIGGINS;605891;11;5;0;0;0;11;5;605891;SET 2 ALMOHADAS VISCO MEDIUM 60X40 CM;DORMITORIO
19145907;;F;27;CHILENO;;Z;N/D;N/D;1060930;7;4;1;1;279990;6;3;780940;CE ERGO T 2P 2MT BD;DORMITORIO
19200726;Casado;F;36;CHILENO;PROFESOR;Millenial;ARICA                         ;TARAPACA;530980;2;1;0;0;0;2;1;530980;CE NEW STYLE 6 2P 2MT BD;DORMITORIO
19286676;;F;26;CHILENO;;Z;PROVIDENCIA                   ;METROPOLITANA;301980;2;1;2;1;301980;0;0;0;CE ERGO T 2P 2MT BD;DORMITORIO
10723164;;F;57;CHILENO;;Boomers;RENCA                         ;METROPOLITANA;307970;3;1;0;0;0;3;1;307970;CE EVOLUTION BLACK 1,5P BN RESP+VEL;DORMITORIO
16829680;;F;34;CHILENO;;Millenial;PROVIDENCIA                   ;METROPOLITANA;253980;2;1;2;1;253980;0;0;0;CAMA AMERICANA BEAT 2 PLAZAS 150 X 190 CM;DORMITORIO
15787789;;M;38;CHILENO;;Millenial;PROVIDENCIA                   ;METROPOLITANA;363960;4;2;4;2;363960;0;0;0;BOX AMERICANO EXCELLENCE 2P BASE NORMAL+2ALM;DORMITORIO
12311127;;M;50;CHILENO;;X;CASTRO                        ;LOS LAGOS;886020;7;3;0;0;0;7;3;886020;COLCHON BAMBOO 2P FIBRAS BAMBOO;DORMITORIO
20378615;;F;22;CHILENO;;Z;PROVIDENCIA                   ;METROPOLITANA;143980;2;1;2;1;143980;0;0;0;COLCHON BEAT 1,5P 1.05X2.00;DORMITORIO
19970922;;F;23;CHILENO;;Z;"";"";224980;2;1;2;1;224980;0;0;0;CE EVOLUTION BLACK 2P BD DUAL SIDE;DORMITORIO
18257566;;F;30;CHILENO;;Millenial;VINA DEL MAR;VALPARAISO;271960;4;2;4;2;271960;0;0;0;CAMA EUROPEA WAVE 1.50X1.90;DORMITORIO
6144218;;F;75;CHILENO;;Silencioso;NUEVA IMPERIAL                ;ARAUCANIA;577720;7;2;0;0;0;7;2;577720;BOX AMERICANO MIRAGE 2PBN;DORMITORIO
8949449;Casado;F;61;CHILENO;;Boomers;RENCA                         ;METROPOLITANA;326960;4;2;0;0;0;4;2;326960;CAMA EUROPEA CASALINDA CDM 1.5PL;DORMITORIO
12988277;;F;55;CHILENO;;Boomers;CHILLAN                       ;BIO BIO;408950;5;3;0;0;0;5;3;408950;ALMOHADA ROSEN SOFT PLUS AMERICANA;DORMITORIO
7766452;;F;66;CHILENO;;Boomers;N/D;N/D;126980;2;1;2;1;126980;0;0;0;CLOSET CABURGUA 2 PT CORREDERA CEREZO;DORMITORIO
19978427;;F;23;CHILENO;;Z;IQUIQUE;TARAPACA;241980;2;1;0;0;0;2;1;241980;CAMA EUROPEA WAVE 1.50X1.90;DORMITORIO
11240411;;F;54;CHILENO;;X;N/D;N/D;320980;2;1;2;1;320980;0;0;0;CAMA EUROPEA IBIZA 2 PL BD;DORMITORIO
12363676;;F;49;CHILENO;;X;N/D;N/D;237400;2;1;0;0;0;2;1;237400;COLCHON NEW ORTOPEDIC 2P;DORMITORIO
6078537;;M;73;CHILENO;;Silencioso;LA CRUZ                       ;VALPARAISO;241970;3;2;3;2;241970;0;0;0;BOX AMERICANO EXCELLENCE 2P BASE NORMAL+2ALM;DORMITORIO
5230764;;F;77;CHILENO;;Silencioso;SAN FERNANDO                  ;L.G.B.OÂ´HIGGINS;1216970;11;5;0;0;0;11;5;1216970;CAMA EUROPEA EXCELLENCE 2 PLAZAS BASE NORMAL;DORMITORIO
12269693;;M;50;CHILENO;;X;RENCA                         ;METROPOLITANA;288980;2;1;2;1;288980;0;0;0;DUPLEX BOX AMERICANO EXCELLENCE 1 PLAZA;DORMITORIO
17011226;;M;33;CHILENO;;Millenial;ARICA                         ;ARICA Y PARINACOTA;228980;2;1;2;1;228980;0;0;0;CE EVOLUTION BLACK 1,5P BN RESP+VEL;DORMITORIO
5508377;;F;81;CHILENO;;Silencioso;TOCOPILLA                     ;ANTOFAGASTA;312840;5;2;0;0;0;5;2;312840;CE EVOLUTION BLACK 1,5P BN RESP+VEL;DORMITORIO
13080124;;F;50;CHILENO;;X;TOLTEN                        ;ARAUCANIA;320952;5;3;0;0;0;5;3;320952;CLOSET 6 PUERTAS 2 CAJONES 1 ZAPATERA BALI CAOB;DORMITORIO
16108406;;F;37;CHILENO;;Millenial;"";"";126950;5;3;0;0;0;5;3;126950;ALMOHADA MEMORY MAX BASIC AMERICANA;DORMITORIO
18399338;;F;28;CHILENO;;Millenial;N/D;N/D;219940;6;2;0;0;0;6;2;219940;PACK 2 ALMOHADAS C+L;DORMITORIO
15041255;;M;39;CHILENO;;X;PROVIDENCIA                   ;METROPOLITANA;395960;2;1;0;0;0;2;1;395960;CE EVOLUTION BLACK 2P BN+RESP+2 VEL;DORMITORIO
11378366;;F;53;CHILENO;;X;PROVIDENCIA                   ;METROPOLITANA;141980;2;1;2;1;141980;0;0;0;CLOSET M-802 4P+2 C ALTO 1,82 BLANCO NATURAL;DORMITORIO
20249300;;F;22;CHILENO;;Z;PROVIDENCIA                   ;METROPOLITANA;431980;2;1;2;1;431980;0;0;0;C.EUROPEA NEW ORTOPEDIC KING +RESP+2VEL LEGNO;DORMITORIO
15787432;;F;38;CHILENO;;Millenial;PROVIDENCIA                   ;METROPOLITANA;49990;2;1;2;1;49990;0;0;0;RESPALDO 2 PL + 2 VELADORES FIORENZZA;DORMITORIO
18973711;;F;27;CHILENO;;Z;SAN FELIPE                    ;VALPARAISO;212790;3;1;0;0;0;3;1;212790;CE EVOLUTION BLACK 1,5P + RESPALDO CASTILLA;DORMITORIO
14360802;;F;40;CHILENO;;X;LOS SAUCES                    ;ARAUCANIA;915950;5;3;0;0;0;5;3;915950;Cama Tempo 2PBD;DORMITORIO
15374133;;M;39;CHILENO;;X;INDEPENDENCIA;METROPOLITANA;229980;2;1;2;1;229980;0;0;0;BOX AM NEW ENTREE 1,5P + Respaldo + 1Vel ASTURIA;DORMITORIO
26061551;Soltero;M;27;EXTRANJERO - NO INFORMA NACIONALIDAD;;Extranjero;PROVIDENCIA                   ;METROPOLITANA;138980;2;1;2;1;138980;0;0;0;RESPALDO ISSEY 2 PL GRAFITO;DORMITORIO
12991721;;F;46;CHILENO;;X;MARIQUINA;LOS LAGOS;181980;2;1;2;1;181980;0;0;0;COLCHON EXCELLENCE PLUS 2P + CUBRECOLCHON;DORMITORIO
20069066;;F;23;CHILENO;;Z;"";"";114990;2;1;0;0;0;2;1;114990;COLCHON 1PZA NEW VERSATILE BY ABCDIN;DORMITORIO
18122924;;M;29;CHILENO;;Millenial;PROVIDENCIA                   ;METROPOLITANA;144980;2;1;2;1;144980;0;0;0;COLCHON NEW ORTOPEDIC 1,5P;DORMITORIO
7858297;;F;63;CHILENO;;Boomers;LEBU                          ;BIO BIO;191980;2;1;0;0;0;2;1;191980;COLCHON BEAT 2P 150X200;DORMITORIO
26247380;;M;43;COLOMBIANO;;Extranjero;RANCAGUA                      ;L.G.B.OÂ´HIGGINS;361960;4;3;0;0;0;4;3;361960;PACK 2 ALMOHADAS C+L;DORMITORIO
7246746;;F;71;CHILENO;;Silencioso;PROVIDENCIA                   ;METROPOLITANA;189980;2;1;0;0;0;2;1;189980;COLCHON NEW STYLE 2 1,5P;DORMITORIO
13038121;;M;45;CHILENO;;X;N/D;N/D;189980;2;1;2;1;189980;0;0;0;COLCHON NEW ORTOPEDIC 1,5P;DORMITORIO
12099724;;F;53;CHILENO;;X;PROVIDENCIA                   ;METROPOLITANA;120980;2;1;2;1;120980;0;0;0;CLOSET NIZA 6P+2C;DORMITORIO
18657950;Soltero;F;28;CHILENO;;Millenial;MELIPEUCO                     ;ARAUCANIA;485740;4;1;0;0;0;4;1;485740;COLCHON ERGO T 2P 150X200;DORMITORIO
12337302;;F;49;CHILENO;;X;N/D;N/D;308070;5;2;4;1;288080;1;1;19990;BOX AMERICANO MIRAGE 2PBN;DORMITORIO
15576811;;F;39;CHILENO;;X;PROVIDENCIA                   ;METROPOLITANA;397960;3;1;3;1;397960;0;0;0;CAMA EUROPEA EXCELLENCE 1.5 PLAZA;DORMITORIO
10765300;;M;46;CHILENO;;X;N/D;N/D;1946860;15;12;13;7;3507870;2;5;-1561010;BA BEAT 2P 2MTS BN;DORMITORIO
11587860;;F;53;CHILENO;;X;VILLARICA                     ;ARAUCANIA;490382;2;2;0;0;0;2;2;490382;BOX BAMBOO + Respaldo + 2 Veladores ALICANTE;DORMITORIO
15682810;Casado;M;39;CHILENO;INGENIERO INFORMATICO;X;PROVIDENCIA                   ;METROPOLITANA;311980;2;1;2;1;311980;0;0;0;CAMAROTE NIRVANA 1 1/2P;DORMITORIO
5128773;;F;75;CHILENO;;Silencioso;PROVIDENCIA                   ;METROPOLITANA;17980;2;1;0;0;0;2;1;17980;ALMOHADA SOFT MICROGEL;DORMITORIO
18565796;;F;28;CHILENO;;Millenial;SALAMANCA                     ;COQUIMBO;576960;4;2;2;1;289980;2;1;286980;COLCHON TERAPEUTIC 2P PILLOW TOP;DORMITORIO
20437443;;F;22;CHILENO;;Z;TALCAHUANO                    ;BIO BIO;34970;3;2;0;0;0;3;2;34970;ALMOHADA ROSEN SOFT PLUS AMERICANA;DORMITORIO
8807089;;F;60;CHILENO;;Boomers;CORONEL                       ;BIO BIO;194970;6;3;0;0;0;6;3;194970;PACK 2 ALMOHADAS C+L;DORMITORIO
9648007;;M;59;CHILENO;;Boomers;PEUMO                         ;L.G.B.OÂ´HIGGINS;280980;2;1;0;0;0;2;1;280980;COLCHON TERAPEUTIC 2P PILLOW TOP;DORMITORIO
15404026;;F;40;CHILENO;;X;NIQUEN                        ;BIO BIO;517990;3;1;0;0;0;3;1;517990;Cama Europea Terapeutic King;DORMITORIO
18419261;;M;28;CHILENO;;Millenial;SAN PEDRO DE LA PAZ;BIO-BIO;123980;2;1;2;1;123980;0;0;0;COLCHON EXCELLENCE FULL;DORMITORIO
14720374;;F;33;CHILENO;;Extranjero;PROVIDENCIA                   ;METROPOLITANA;129990;1;1;0;0;0;1;1;129990;COLCHON BAMBOO 1,5P FIBRAS BAMBOO;DORMITORIO
26094322;Soltero;F;49;EXTRANJERO - NO INFORMA NACIONALIDAD;;Extranjero;N/D;N/D;103980;2;1;2;1;103980;0;0;0;COMODA 5C MOD S265 - CAOBA;DORMITORIO
5503548;;F;76;CHILENO;;Silencioso;PROVIDENCIA                   ;METROPOLITANA;252980;2;1;0;0;0;2;1;252980;CE EVOLUTION BLACK 1,5P + RESPALDO CASTILLA;DORMITORIO
15087400;;M;42;CHILENO;;X;SAN ANTONIO                   ;VALPARAISO;154980;2;2;0;0;0;2;2;154980;COLCHON EVOLUTION BLACK 1,5P DUAL SIDE;DORMITORIO
13814016;;M;43;CHILENO;;X;VILLARICA                     ;ARAUCANIA;409980;2;1;0;0;0;2;1;409980;COLCHON TERAPEUTIC 2P PILLOW TOP;DORMITORIO
9936189;;F;61;CHILENO;;Boomers;PUERTO MONTT                  ;LOS LAGOS;215980;2;1;0;0;0;2;1;215980;CAMA AMERICANA BEAT 1 PLAZA 90 X 190 CM;DORMITORIO
18230737;;M;29;CHILENO;;Millenial;PROVIDENCIA                   ;METROPOLITANA;211980;2;1;2;1;211980;0;0;0;CE EVOLUTION BLACK 1,5P BN RESP+VEL;DORMITORIO
8151474;;F;63;CHILENO;;Boomers;PENAFLOR                      ;METROPOLITANA;750950;4;1;0;0;0;4;1;750950;CE EVEREST 2P 2MTS BD DUAL SIDE;DORMITORIO
8755784;;F;63;CHILENO;;Boomers;QUINTA NORMAL                 ;METROPOLITANA;330950;6;2;0;0;0;6;2;330950;COLCHON NEW ORTOPEDIC 1,5 105X200;DORMITORIO
17329997;;M;32;CHILENO;;Millenial;COLBUN                        ;MAULE;4990;1;1;0;0;0;1;1;4990;PACK 2 ALMOHADAS C+L;DORMITORIO
11008974;;F;57;CHILENO;;Boomers;CALERA                        ;VALPARAISO;586650;4;2;0;0;0;4;2;586650;DIVAN CAMA ERGO T 1,5P 2 MTS;DORMITORIO
8538984;;F;50;CHILENO;;X;PUENTE ALTO                   ;METROPOLITANA;478960;4;2;0;0;0;4;2;478960;COLCHON BAMBOO 1P FIBRAS BAMBOO;DORMITORIO
23102952;Soltero;M;46;URUGUAYO;;Extranjero;N/D;N/D;832110;8;4;2;1;129980;6;3;702130;CLOSET ESPANA 6P+4C;DORMITORIO
19878343;;M;24;CHILENO;;Z;N/D;N/D;376960;4;2;4;2;376960;0;0;0;CE EVOLUTION BLACK 1,5P + RESPALDO CASTILLA;DORMITORIO
7290143;;F;67;CHILENO;;Boomers;PROVIDENCIA                   ;METROPOLITANA;59980;2;1;0;0;0;2;1;59980;Almohada Visco Bamboo Classic Pack 60x40 cm;DORMITORIO
16090081;;F;37;CHILENO;;Millenial;CONSTITUCION                  ;MAULE;276980;2;1;0;0;0;2;1;276980;DUPLEX BOX AMERICANO EXCELLENCE 1 PLAZA;DORMITORIO
7331636;;F;68;CHILENO;;Silencioso;RANCAGUA                      ;L.G.B.OÂ´HIGGINS;15980;2;1;0;0;0;2;1;15980;ALMOHADA SOFT MICROGEL;DORMITORIO
9686862;Casado;M;56;CHILENO;;Boomers;N/D;N/D;278980;2;1;0;0;0;2;1;278980;COLCHON TERAPEUTIC 2P PILLOW TOP;DORMITORIO
8024122;Divorciado;M;66;CHILENO;;Boomers;PARRAL                        ;MAULE;225990;3;1;0;0;0;3;1;225990;COLCHON BAMBOO 2P FIBRAS BAMBOO;DORMITORIO
26090839;;M;24;EXTRANJERO - NO INFORMA NACIONALIDAD;;Extranjero;VALDIVIA                      ;LOS LAGOS;398960;4;2;0;0;0;4;2;398960;CE EVOLUTION BLACK 2P BN+RESP+2 VEL;DORMITORIO
19947698;;F;24;CHILENO;;Z;PROVIDENCIA                   ;METROPOLITANA;225980;2;1;2;1;225980;0;0;0;BOX AMERICANO EXCELLENCE 2P BASE NORMAL+2ALM;DORMITORIO
14446851;Soltero;F;48;CHILENO;;X;PROVIDENCIA                   ;METROPOLITANA;359980;2;1;2;1;359980;0;0;0;COMODA MANCHESTER;DORMITORIO
9105092;;F;63;CHILENO;;Boomers;SAN FELIPE                    ;VALPARAISO;33980;2;1;0;0;0;2;1;33980;Almohada Bamboo Classic 70x40;DORMITORIO
10260055;Casado;M;55;CHILENO;;Boomers;RENCA                         ;METROPOLITANA;642980;2;1;2;1;642980;0;0;0;CE COTTON ORGANIC KING 2MTS BD DUAL SIDE;DORMITORIO
16677718;;M;34;CHILENO;;Millenial;QUILPUE                       ;VALPARAISO;176980;2;1;2;1;176980;0;0;0;CE EVOLUTION BLACK 1,5P BN RESP+VEL;DORMITORIO
8854386;;F;62;CHILENO;;Boomers;NUEVA IMPERIAL                ;ARAUCANIA;617550;4;2;0;0;0;4;2;617550;BA BEAT 2P 2MTS BN;DORMITORIO
15124487;;M;39;CHILENO;;X;RANCAGUA                      ;L.G.B.OÂ´HIGGINS;288980;2;1;2;1;288980;0;0;0;COLCHON NEW STYLE 6 2P;DORMITORIO
11820341;;F;50;CHILENO;;X;N/D;N/D;310480;2;1;0;0;0;2;1;310480;DIVAN CAMA ERGO T 1,5P 2 MTS;DORMITORIO
12094629;Soltero;M;48;CHILENO;PROFESOR;X;PROVIDENCIA                   ;METROPOLITANA;103980;2;1;2;1;103980;0;0;0;COLCHON THERAPEDIC 1P;DORMITORIO
15302921;Soltero;F;39;CHILENO;;X;RENCA                         ;METROPOLITANA;705960;4;2;4;2;705960;0;0;0;DIVAN CAMA ERGO T 1,5P 2 MTS;DORMITORIO
14116341;;F;41;CHILENO;;Millenial;VICUNA                        ;COQUIMBO;107540;2;1;2;1;107540;0;0;0;COMODA Z-91 TV40 4 CAJONES 1 PUERTA - ROVERE / B;DORMITORIO
16706845;;F;35;CHILENO;;Millenial;"";"";213980;2;1;0;0;0;2;1;213980;CE EVOLUTION BLACK 1,5P + RESPALDO CASTILLA;DORMITORIO
16038151;;F;36;CHILENO;;Millenial;N/D;N/D;457940;6;2;0;0;0;6;2;457940;CLOSET ESPANA 6P+4C;DORMITORIO
10067812;;F;58;CHILENO;;Boomers;SAN RAMON                     ;METROPOLITANA;1029630;6;3;0;0;0;6;3;1029630;BOX BAMBOO + Respaldo + 2 Veladores ALICANTE;DORMITORIO
18705680;Soltero;M;27;CHILENO;;Millenial;LA SERENA;COQUIMBO;149520;4;2;4;2;149520;0;0;0;COLCHON EXCELLENCE 1P;DORMITORIO
13344480;;F;46;CHILENO;;X;COINCO                        ;L.G.B.OÂ´HIGGINS;231980;2;1;0;0;0;2;1;231980;CE EVOLUTION BLACK 1,5P BN RESP+VEL;DORMITORIO
26673257;Soltero;F;34;NO INFORMA NACIONALIDAD;;Extranjero;PROVIDENCIA                   ;METROPOLITANA;129980;2;1;2;1;129980;0;0;0;COLCHON CASALINDA CDM 1PL X190;DORMITORIO
16598086;;F;34;CHILENO;;Millenial;"";"";144540;2;1;2;1;144540;0;0;0;CLOSET ESPANA 6P+4C;DORMITORIO
10843267;Casado;F;57;CHILENO;;Boomers;RENCA                         ;METROPOLITANA;199980;2;2;0;0;0;2;2;199980;COLCHON SPRING III 1P;DORMITORIO
13793355;;F;42;CHILENO;;X;SAN JAVIER                    ;MAULE;7990;1;1;0;0;0;1;1;7990;ALMOHADA SOFT MICROGEL;DORMITORIO
19501571;;M;24;CHILENO;;Z;"";"";281970;3;2;3;2;281970;0;0;0;CE EVOLUTION BLACK 1,5P + RESPALDO CASTILLA;DORMITORIO
13883989;;M;43;CHILENO;;X;N/D;N/D;209990;1;3;0;0;0;1;3;209990;COLCHON BAMBOO 2P FIBRAS BAMBOO;DORMITORIO
19365557;;F;25;CHILENO;;Z;PROVIDENCIA                   ;METROPOLITANA;185840;2;1;2;1;185840;0;0;0;BOX AMERICANO EXCELLENCE 1.5 PLAZA + ALM;DORMITORIO
13656708;;M;43;CHILENO;;X;RENCA                         ;METROPOLITANA;34990;1;1;0;0;0;1;1;34990;ALMOHADA COOL GEL TECH SERIES 60X40 CM;DORMITORIO
27239842;;M;37;EXTRANJERO - NO INFORMA NACIONALIDAD ;;Extranjero;PAINE                         ;METROPOLITANA;13980;2;1;0;0;0;2;1;13980;Almohadas Isidora Soft 50x70 cm;DORMITORIO
15124083;;M;40;CHILENO;;X;CHILLAN                       ;BIO BIO;364980;2;1;2;1;364980;0;0;0;CE EXCEL PLUS 2P BD +RESP+2VEL NEW VILLARRICA;DORMITORIO
7662866;;F;65;CHILENO;;Boomers;TALAGANTE                     ;METROPOLITANA;16990;1;1;0;0;0;1;1;16990;Almohada Bamboo Classic 70x40;DORMITORIO
9700723;;F;60;CHILENO;;Boomers;CANETE                        ;BIO BIO;417960;4;3;0;0;0;4;3;417960;COLCHON IBIZA 2P;DORMITORIO
18860915;;F;28;CHILENO;;Millenial;"";"";129640;2;1;2;1;129640;0;0;0;CLOSET 4P 2C MOD Y444 - BLANCO 4x1 APLICACIONES;DORMITORIO
13952584;;F;42;CHILENO;;X;TALCAHUANO                    ;BIO BIO;86990;1;1;0;0;0;1;1;86990;COLCHON BALANCE 1 1P;DORMITORIO
6382837;Soltero;F;72;CHILENO;;Silencioso;PROVIDENCIA                   ;METROPOLITANA;10980;2;1;0;0;0;2;1;10980;Almohada Imperial Soft 50x70 cm;DORMITORIO
12587516;;F;48;CHILENO;;X;TALCA                         ;MAULE;8990;1;1;0;0;0;1;1;8990;ALMOHADA SOFT MICROGEL;DORMITORIO
10297828;;F;57;CHILENO;;Boomers;RENCA                         ;METROPOLITANA;203980;2;1;2;1;203980;0;0;0;BOX AMERICANO EXCELLENCE 2P BASE NORMAL+2ALM;DORMITORIO
16183169;;F;37;CHILENO;;Millenial;PROVIDENCIA                   ;METROPOLITANA;371980;2;1;2;1;371980;0;0;0;BS NEW ORTOPEDIC B5BLACK 2PBN+RESP+2VEL LEGNO;DORMITORIO
15423678;;F;39;CHILENO;;X;N/D;N/D;-321480;-2;2;-1;1;-299990;-1;1;-21490;CE NEW ORTOPEDIC 2PBD;DORMITORIO
6057525;;F;70;CHILENO;;Silencioso;PROVIDENCIA                   ;METROPOLITANA;199980;2;1;2;1;199980;0;0;0;CE EVOLUTION BLACK 1,5P + RESPALDO ASTURIAS;DORMITORIO
7157963;;F;65;CHILENO;;Boomers;SAN MIGUEL                    ;METROPOLITANA;229980;2;1;0;0;0;2;1;229980;COLCHON BAMBOO 2P FIBRAS BAMBOO;DORMITORIO
24366057;;M;29;PERUANO;;Extranjero;N/D;N/D;73980;2;1;2;1;73980;0;0;0;CLOSET CROACIA BLANCO 4P;DORMITORIO
15109667;;F;39;CHILENO;;X;PEDRO AGUIRRE CERDA           ;METROPOLITANA;293970;3;1;3;1;293970;0;0;0;BOX AMERICANO EXCELLENCE 1.5 PLAZA + ALM;DORMITORIO
17816570;;F;30;CHILENO;;Millenial;SAN ANTONIO                   ;VALPARAISO;14990;1;1;0;0;0;1;1;14990;Almohada Bamboo Classic 70x40;DORMITORIO
7618661;Casado;M;62;CHILENO;;Boomers;SAN VICENTE                   ;L.G.B.OÂ´HIGGINS;13980;2;1;0;0;0;2;1;13980;ALMOHADA ROSEN SOFT PLUS AMERICANA;DORMITORIO
15466514;;F;40;CHILENO;;X;SAN FERNANDO                  ;L.G.B.OÂ´HIGGINS;316970;3;2;0;0;0;3;2;316970;PACK 2 ALMOHADAS C+L;DORMITORIO
13456258;;M;46;CHILENO;;X;RENCA                         ;METROPOLITANA;209980;2;1;2;1;209980;0;0;0;CAMA EUROPEA CASALINDA CDM 1.5PL;DORMITORIO
15753378;;F;38;CHILENO;;Millenial;RENCA                         ;METROPOLITANA;364980;2;1;2;1;364980;0;0;0;CE BAMBOO 2P BN FIBRAS BAMBOO DUAL SIDE;DORMITORIO
11597689;;M;52;CHILENO;;X;N/D;N/D;60980;2;2;0;0;0;2;2;60980;Almohadas Isidora Soft 50x90 cm;DORMITORIO
15741224;;F;38;CHILENO;;X;N/D;N/D;620860;3;2;0;0;0;3;2;620860;BOX BAMBOO + Respaldo + 2 Veladores ALICANTE;DORMITORIO
16881076;;F;34;CHILENO;;Millenial;COLTAUCO                      ;L.G.B.OÂ´HIGGINS;254540;2;1;2;1;254540;0;0;0;DUPLEX BOX AMERICANO EXCELLENCE 1 PLAZA;DORMITORIO
14506642;;F;47;CHILENO;;X;TALCA                         ;MAULE;135480;2;1;2;1;135480;0;0;0;CLOSET M-701 6 PUERTAS 2 CAJONES ALTO 1,82 COLOR;DORMITORIO
16670716;;F;35;CHILENO;;Millenial;"";"";195980;2;1;2;1;195980;0;0;0;CE EVOLUTION BLACK 1,5P + RESPALDO CASTILLA;DORMITORIO
18754270;;M;27;CHILENO;;Z;N/D;N/D;-659990;-1;1;-1;1;-659990;0;0;0;CE TEMPO 1.50X2.00 2P BD RESP ISSEY GRAF ];DORMITORIO
11318924;Casado;M;53;CHILENO;INGENIERO AGRICOLA;X;RENCA                         ;METROPOLITANA;292980;2;1;0;0;0;2;1;292980;COLCHON BAMBOO 2P FIBRAS BAMBOO;DORMITORIO
19096523;;F;26;CHILENO;;Z;N/D;N/D;239980;2;1;2;1;239980;0;0;0;COLCHON TERAPEUTIC 2P PILLOW TOP;DORMITORIO
17744839;Soltero;M;31;CHILENO;INGENIERIA EN MAQUINARIA VEHICULOS AUTOMOTRICES Y SISTEMAS ELECTRONICOS;Millenial;PROVIDENCIA                   ;METROPOLITANA;9980;2;1;0;0;0;2;1;9980;PACK 2 ALMOHADAS C+L;DORMITORIO
14334214;;M;44;CHILENO;;X;LITUECHE                      ;L.G.B.OÂ´HIGGINS;233980;2;1;0;0;0;2;1;233980;COLCHON NEW STYLE 4 2P;DORMITORIO
15220010;;F;40;CHILENO;;X;CORONEL                       ;BIO BIO;670530;5;2;0;0;0;5;2;670530;COLCHON NEW ORTOPEDIC 1P;DORMITORIO
10746755;Casado;F;56;CHILENO;MECANICO AUTOMOTRIZ EN SISTEMAS ELECTRONICOS;Boomers;RENCA                         ;METROPOLITANA;202980;2;1;0;0;0;2;1;202980;COLCHON NEW ORTOPEDIC 1P;DORMITORIO
5338662;;M;78;CHILENO;;Silencioso;CONSTITUCION                  ;MAULE;459860;3;1;0;0;0;3;1;459860;CE NEW ORTOPEDIC 2PBD;DORMITORIO
19088980;;M;27;CHILENO;;Extranjero;PROVIDENCIA                   ;METROPOLITANA;641980;2;1;2;1;641980;0;0;0;CAMA ART 4 1.80X2.00;DORMITORIO
18735273;;M;28;CHILENO;;Millenial;PROVIDENCIA                   ;METROPOLITANA;195980;2;1;2;1;195980;0;0;0;BOX AMERICANO MIRAGE 2PBN;DORMITORIO
13178150;;M;44;CHILENO;;X;PROVIDENCIA                   ;METROPOLITANA;199990;1;1;0;0;0;1;1;199990;COLCHON BAMBOO 2P FIBRAS BAMBOO;DORMITORIO
19316517;;M;25;CHILENO;;Z;LOS ANDES                     ;VALPARAISO;290670;2;1;0;0;0;2;1;290670;CE EVOLUTION BLACK 1,5P BN RESP+VEL;DORMITORIO
14478670;;F;47;CHILENO;;X;CURACO DE VELEZ               ;LOS LAGOS;225980;2;1;2;1;225980;0;0;0;BOX AMERICANO EXCELLENCE 1.5P +RESP+VEL OLMO;DORMITORIO
8365057;;M;64;CHILENO;;Boomers;LOS ANGELES                   ;BIO BIO;187470;2;1;0;0;0;2;1;187470;COLCHON BAMBOO 1,5P FIBRAS BAMBOO;DORMITORIO
13227956;;M;45;CHILENO;;X;PUENTE ALTO                   ;METROPOLITANA;229980;2;1;2;1;229980;0;0;0;COLCHON TERAPEUTIC 2P PILLOW TOP;DORMITORIO
13056114;;F;46;CHILENO;;X;PROVIDENCIA                   ;METROPOLITANA;309980;2;1;2;1;309980;0;0;0;DIVAN CAMA ERGO T 1,5P 2 MTS;DORMITORIO
11928553;;M;53;CHILENO;;X;PROVIDENCIA                   ;METROPOLITANA;199980;2;1;0;0;0;2;1;199980;COLCHON BAMBOO 1,5P FIBRAS BAMBOO;DORMITORIO
10202920;;F;55;CHILENO;;Boomers;PROVIDENCIA                   ;METROPOLITANA;192870;2;1;0;0;0;2;1;192870;COLCHON BAMBOO 1,5P FIBRAS BAMBOO;DORMITORIO
11627903;;M;52;CHILENO;;X;EL BOSQUE                     ;METROPOLITANA;3990;1;1;0;0;0;1;1;3990;PACK 2 ALMOHADAS C+L;DORMITORIO
16993028;;F;32;CHILENO;;Extranjero;CHILLAN                       ;BIO BIO;273980;2;1;2;1;273980;0;0;0;DIVAN CAMA ERGO T 1,5P 2 MTS;DORMITORIO
18102807;;M;30;CHILENO;;Extranjero;COIHAIQUE                     ;AYSEN;8490;1;1;0;0;0;1;1;8490;ALMOHADA ROSEN SOFT PLUS AMERICANA;DORMITORIO
19317026;;F;26;CHILENO;;Z;PENALOLEN                     ;METROPOLITANA;249980;2;1;2;1;249980;0;0;0;COLCHON BALANCE 2P;DORMITORIO
9737552;;F;56;CHILENO;;Boomers;ANCUD                         ;LOS LAGOS;301980;2;1;0;0;0;2;1;301980;CAMA NIDO EVOLUTION BLACK 1,5P;DORMITORIO
9080248;Soltero;M;62;CHILENO;;Boomers;PROVIDENCIA                   ;METROPOLITANA;10980;2;1;0;0;0;2;1;10980;Almohadas Isidora Soft 50x90 cm;DORMITORIO
15742227;;M;38;CHILENO;;Millenial;N/D;N/D;1071390;8;2;0;0;0;8;2;1071390;C.EURO NEW ORTOPEDIC KING +RESP+2VEL ESPRESSO;DORMITORIO
9067741;;M;61;CHILENO;;Boomers;YERBAS BUENAS                 ;MAULE;187980;2;2;0;0;0;2;2;187980;COLCHON NEW ORTOPEDIC 1,5P;DORMITORIO
11164338;;M;55;CHILENO;;Boomers;PARRAL                        ;MAULE;303970;3;2;0;0;0;3;2;303970;COLCHON TERAPEUTIC 2P PILLOW TOP;DORMITORIO
15179584;;M;39;CHILENO;;X;RANCAGUA;O HIGGINS;13980;2;1;0;0;0;2;1;13980;ALMOHADA SOFT MICROGEL;DORMITORIO
16729112;;F;34;CHILENO;;Millenial;SAN CLEMENTE                  ;MAULE;193980;2;1;0;0;0;2;1;193980;CLOSET ARICA TV 32 M302 TEXTURADO CASTANO;DORMITORIO
18616218;Soltero;F;28;CHILENO;;Millenial;COIHAIQUE                     ;AYSEN;333780;22;3;0;0;0;22;3;333780;SET 2 ALMOHADAS VISCO MEDIUM 60X40 CM;DORMITORIO
16737856;;M;34;CHILENO;;Millenial;RENGO                         ;L.G.B.OÂ´HIGGINS;511630;6;2;0;0;0;6;2;511630;BA EXCELLENCE PLUS 2P BN +RESP+VEL OLMO;DORMITORIO
20043371;;F;23;CHILENO;;Z;PROVIDENCIA                   ;METROPOLITANA;173980;2;1;0;0;0;2;1;173980;COLCHON NEW ORTOPEDIC 1,5P;DORMITORIO
12923193;;M;47;CHILENO;;X;CORONEL                       ;BIO BIO;619950;5;3;0;0;0;5;3;619950;COLCHON NEW ORTOPEDIC 2P;DORMITORIO
17079378;;F;33;CHILENO;;Millenial;PROVIDENCIA                   ;METROPOLITANA;149980;2;1;2;1;149980;0;0;0;COLCHON NEW ORTOPEDIC 1,5P;DORMITORIO
7633189;Soltero;F;72;CHILENO;;Silencioso;PROVIDENCIA                   ;METROPOLITANA;8990;1;1;0;0;0;1;1;8990;ALMOHADA SOFT MICROGEL;DORMITORIO
19506121;;F;25;CHILENO;;Z;OVALLE                        ;COQUIMBO;275970;3;1;3;1;275970;0;0;0;CE EVOLUTION BLACK 1,5P + RESPALDO CASTILLA;DORMITORIO
14526510;;F;40;CHILENO;;X;TEMUCO                        ;ARAUCANIA;144980;2;1;2;1;144980;0;0;0;CE EVOLUTION BLACK 1,5P + RESPALDO CASTILLA;DORMITORIO
19911906;;F;23;CHILENO;;Z;PROVIDENCIA                   ;METROPOLITANA;281970;3;1;3;1;281970;0;0;0;CE EVOLUTION BLACK 1,5P + RESPALDO CASTILLA;DORMITORIO
17245976;;F;33;CHILENO;;Millenial;N/D;N/D;74980;2;1;2;1;74980;0;0;0;CLOSET CROACIA BLANCO 4P;DORMITORIO
5722046;;F;84;CHILENO;;Silencioso;NATALES                       ;MAGALLANES;159990;1;1;0;0;0;1;1;159990;COLCHON BAMBOO 1,5P FIBRAS BAMBOO;DORMITORIO
18297253;;F;29;CHILENO;;Millenial;PROVIDENCIA                   ;METROPOLITANA;330670;2;1;0;0;0;2;1;330670;CE EVOLUTION BLACK 2P BN+RESP+2 VEL;DORMITORIO
17009827;;M;33;CHILENO;;Millenial;PROVIDENCIA                   ;METROPOLITANA;49990;1;1;0;0;0;1;1;49990;SET 2 ALMOHADAS VISCO MEDIUM 60X40 CM;DORMITORIO
11440255;;F;53;CHILENO;;X;LEBU                          ;BIO BIO;13980;2;2;0;0;0;2;2;13980;PACK 2 ALMOHADAS C+L;DORMITORIO
10374716;;M;54;CHILENO;;Boomers;PUENTE ALTO                   ;METROPOLITANA;349980;2;1;0;0;0;2;1;349980;CE BAMBOO 2P BD FIBRAS BAMBOO DUAL SIDE;DORMITORIO
16755839;;M;34;CHILENO;;Millenial;PROVIDENCIA                   ;METROPOLITANA;129980;2;1;2;1;129980;0;0;0;CE EVOLUTION BLACK 1,5P + RESPALDO CASTILLA;DORMITORIO
16759862;;F;30;CHILENO;;Millenial;CHILLAN VIEJO                 ;BIO BIO;555660;5;2;5;2;555660;0;0;0;CE EVOLUTION BLACK 2P BD DUAL SIDE;DORMITORIO
17937252;;M;30;CHILENO;;Millenial;N/D;N/D;245980;2;1;2;1;245980;0;0;0;CE ERGO T 2P 2MT BD;DORMITORIO
6840489;;F;71;CHILENO;;Silencioso;LO ESPEJO                     ;METROPOLITANA;122330;5;1;0;0;0;5;1;122330;SET 2 ALMOHADAS VISCO MEDIUM 60X40 CM;DORMITORIO
19313490;;F;28;CHILENO;;Millenial;N/D;N/D;319830;3;1;3;1;319830;0;0;0;BOX AMERICANO EXCELLENCE 2P BASE NORMAL;DORMITORIO
17358166;;F;32;CHILENO;;Millenial;OSORNO                        ;LOS LAGOS;98540;2;1;2;1;98540;0;0;0;COLCHON SPRING III 1P;DORMITORIO
17304603;;F;32;CHILENO;;Millenial;N/D;N/D;218960;4;2;4;2;218960;0;0;0;COLCHON NEW ORTOPEDIC 1,5P;DORMITORIO
15616500;;F;38;CHILENO;;Millenial;"";"";336959;4;1;0;0;0;4;1;336959;DUPLEX BOX AMERICANO EXCELLENCE 1 PLAZA +2ALM;DORMITORIO
18775648;;M;27;CHILENO;;Z;N/D;N/D;3990;2;1;0;0;0;2;1;3990;PACK 2 ALMOHADAS C+L;DORMITORIO
16705212;;M;34;CHILENO;;Millenial;N/D;N/D;179640;2;1;2;1;179640;0;0;0;CE EVOLUTION BLACK 1P + RESPALDO ASTURIAS;DORMITORIO
13422840;;M;44;CHILENO;;Silencioso;PROVIDENCIA                   ;METROPOLITANA;351980;2;1;2;1;351980;0;0;0;CE NEW ORTOPEDIC 2PBN +RESP+2VEL NEW VILLARRI;DORMITORIO
17099773;;F;33;CHILENO;;Silencioso;PROVIDENCIA                   ;METROPOLITANA;471980;2;1;2;1;471980;0;0;0;C.EUROPEA NEW ORTOPEDIC KING +RESP+2VEL LEGNO;DORMITORIO
14377802;;F;45;CHILENO;;X;RENGO                         ;L.G.B.OÂ´HIGGINS;149970;3;2;0;0;0;3;2;149970;COLCHON NEW ENTREE 1,5P;DORMITORIO
7739619;;F;66;CHILENO;;Boomers;ILLAPEL                       ;COQUIMBO;107540;2;1;2;1;107540;0;0;0;COLCHON EXCELLENCE FULL;DORMITORIO
26012476;;F;25;EXTRANJERO - NO INFORMA NACIONALIDAD;;Extranjero;PROVIDENCIA                   ;METROPOLITANA;29980;2;1;2;1;29980;0;0;0;Colchon Cuna Extendible 100x60;DORMITORIO
26562807;;F;28;VENEZOLANO;;Extranjero;SAN MIGUEL                    ;METROPOLITANA;169980;2;1;2;1;169980;0;0;0;CE EVOLUTION BLACK 1,5P BN DUAL SIDE;DORMITORIO
17880776;Soltero;F;30;CHILENO;PROFESOR;Silencioso;PROVIDENCIA                   ;METROPOLITANA;49990;1;1;0;0;0;1;1;49990;SET 2 ALMOHADAS VISCO MEDIUM 60X40 CM;DORMITORIO
19569165;;F;24;CHILENO;;Z;PROVIDENCIA                   ;METROPOLITANA;305980;2;1;2;1;305980;0;0;0;BS NEW ORTOPEDIC B5BLACK 2PBN+RESP+2VEL LEGNO;DORMITORIO
13375526;;M;44;CHILENO;;Silencioso;PROVIDENCIA                   ;METROPOLITANA;253980;2;1;2;1;253980;0;0;0;COLCHON ROSEN SWAG 1,5P 1.05X1.90;DORMITORIO
16712159;;M;34;CHILENO;;Millenial;PROVIDENCIA                   ;METROPOLITANA;209980;2;1;2;1;209980;0;0;0;COLCHON BAMBOO 2P FIBRAS BAMBOO;DORMITORIO
13068880;Soltero;F;46;CHILENO;;X;CASTRO                        ;LOS LAGOS;209990;1;1;0;0;0;1;1;209990;COLCHON BAMBOO 2P FIBRAS BAMBOO;DORMITORIO
16503254;;M;35;CHILENO;;Silencioso;PROVIDENCIA                   ;METROPOLITANA;111980;2;1;0;0;0;2;1;111980;COLCHON EVOLUTION BLACK 1P DUAL SIDE;DORMITORIO
7733283;Casado;F;68;CHILENO;;Boomers;RENCA                         ;METROPOLITANA;7980;2;1;0;0;0;2;1;7980;PACK 2 ALMOHADAS C+L;DORMITORIO
16035104;;F;36;CHILENO;;Millenial;N/D;N/D;33980;2;1;0;0;0;2;1;33980;ALMOHADA BAMBOO TECH SERIES 65X45 CM;DORMITORIO
13771167;;M;42;CHILENO;;X;PROVIDENCIA                   ;METROPOLITANA;113980;2;1;2;1;113980;0;0;0;COLCHON EXCELLENCE FULL;DORMITORIO
9084467;;F;62;CHILENO;;Boomers;RENCA                         ;METROPOLITANA;347870;2;1;0;0;0;2;1;347870;CE EVOLUTION BLACK 2P BN+RESP+2 VEL;DORMITORIO
9055111;;F;62;CHILENO;;Boomers;PUERTO VARAS                  ;LOS LAGOS;0;0;0;0;0;0;0;0;0;PACK 2 ALMOHADAS C+L;DORMITORIO
14033297;Soltero;F;44;CHILENO;CONTADOR;X;RENCA                         ;METROPOLITANA;0;0;0;0;0;0;0;0;0;RACK CLASICO NOGAL AMAZONICO;DORMITORIO
12600179;;F;48;CHILENO;;X;SANTA MARIA                   ;VALPARAISO;0;0;0;0;0;0;0;0;0;Almohada Bamboo Classic 70x40;DORMITORIO
13953397;;F;42;CHILENO;;X;LOS ANGELES                   ;BIO BIO;0;0;0;0;0;0;0;0;0;CLOSET ESPANA 6P+4C;DORMITORIO
12553662;;F;48;CHILENO;;X;TALCAHUANO                    ;BIO BIO;0;0;0;0;0;0;0;0;0;BOX AMERICANO EXCELLENCE 1.5 PLAZA + ALM;DORMITORIO
9466161;Casado;F;60;CHILENO;;Boomers;RENCA                         ;METROPOLITANA;0;0;0;0;0;0;0;0;0;CAMA EUROPEA GRIS NEW ENTREE 1,5P;DORMITORIO
14330934;;F;44;CHILENO;;Silencioso;PROVIDENCIA                   ;METROPOLITANA;0;0;0;0;0;0;0;0;0;PLUMON 2PZA ANDES;DORMITORIO
17695469;;F;27;CHILENO;;Millenial;N/D;N/D;0;0;0;0;0;0;0;0;0;BS ORTOPEDIC ADVANCE B5 BLACK 2PBN;DORMITORIO
15497704;;F;36;CHILENO;;Millenial;PROVIDENCIA                   ;METROPOLITANA;0;0;0;0;0;0;0;0;0;Almohada ViscoGel Cobre 70x40x13 cm;DORMITORIO
5847693;;F;72;CHILENO;;Silencioso;ANTOFAGASTA                   ;ANTOFAGASTA;0;0;0;0;0;0;0;0;0;COLCHON BALANCE 2P;DORMITORIO
14101012;;F;40;CHILENO;;X;PROVIDENCIA                   ;METROPOLITANA;0;0;0;0;0;0;0;0;0;SET 2 ALMOHADAS VISCO MEDIUM 60X40 CM;DORMITORIO
16605336;;F;34;CHILENO;;Millenial;LA PINTANA                    ;METROPOLITANA;0;0;0;0;0;0;0;0;0;COLCHON EXCELLENCE 1.5 PLAZA + CUBRECOLCHON;DORMITORIO
19370460;Soltero;F;26;CHILENO;ENFERMERA;Z;PROVIDENCIA                   ;METROPOLITANA;0;0;0;0;0;0;0;0;0;SET SABANA MICROFIBRA MUSTARD 2P;DORMITORIO
5560867;;F;77;CHILENO;;Silencioso;N/D;N/D;0;0;0;0;0;0;0;0;0;CE EVEREST 2P 2MTS BD DUAL SIDE;DORMITORIO
5622418;;F;73;CHILENO;;Silencioso;ARAUCO                        ;BIO BIO;0;0;0;0;0;0;0;0;0;CAMA NIDO EVOLUTION BLACK 1,5P;DORMITORIO
18790347;;F;28;CHILENO;;Millenial;ANTOFAGASTA                   ;ANTOFAGASTA;0;0;0;0;0;0;0;0;0;CAMAROTE TRIPLE CORINA CAFE OSCURO;DORMITORIO
9132488;;M;58;CHILENO;;Boomers;RENCA                         ;METROPOLITANA;0;0;0;0;0;0;0;0;0;ALMOHADA ROSEN SOFT PLUS KING;DORMITORIO
16845895;Casado;M;34;CHILENO;PSICOLOGO;Millenial;PROVIDENCIA                   ;METROPOLITANA;0;0;0;0;0;0;0;0;0;COLCHON NEW STYLE 2 2P 150X200;DORMITORIO
20022107;;F;23;CHILENO;;Silencioso;PROVIDENCIA                   ;METROPOLITANA;0;0;0;0;0;0;0;0;0;Almohada Bamboo Classic 70x40;DORMITORIO
4551452;;M;79;CHILENO;;Silencioso;SAN BERNARDO                  ;METROPOLITANA;0;0;0;0;0;0;0;0;0;COLCHON BALANCE 2P;DORMITORIO
17694693;;M;31;CHILENO;;Millenial;PROVIDENCIA                   ;METROPOLITANA;0;0;0;0;0;0;0;0;0;COLCHON EXCELLENCE PLUS 2P + CUBRECOLCHON;DORMITORIO
15576312;;M;39;CHILENO;;Silencioso;PROVIDENCIA                   ;METROPOLITANA;0;0;0;0;0;0;0;0;0;BOX AMERICANO EXCELLENCE PLUS 1.5 PLAZA+ ALM;DORMITORIO
15436551;;F;40;CHILENO;;Silencioso;PROVIDENCIA                   ;METROPOLITANA;0;0;0;0;0;0;0;0;0;CLOSET CROACIA BLANCO 4P;DORMITORIO
23900799;;F;40;COLOMBIANO;;Extranjero;N/D;N/D;0;0;0;0;0;0;0;0;0;COLCHON SPRING III 1P;DORMITORIO
17270007;;M;32;CHILENO;;Millenial;PROVIDENCIA                   ;METROPOLITANA;0;0;0;0;0;0;0;0;0;TOCADOR FAVATEX EIBAR 5C 2P;DORMITORIO
16975502;;F;33;CHILENO;;Millenial;COIHAIQUE                     ;AYSEN;0;0;0;0;0;0;0;0;0;ALMOHADA ROSEN SOFT PLUS AMERICANA;DORMITORIO
7652805;;F;63;CHILENO;;Boomers;LOS ANDES                     ;VALPARAISO;0;0;0;0;0;0;0;0;0;Almohada Bamboo Classic 70x40;DORMITORIO
11810729;;F;50;CHILENO;;X;RENCA                         ;METROPOLITANA;0;0;0;0;0;0;0;0;0;CAMA EUROPEA IBIZA 2 PL BD;DORMITORIO
16291618;Soltero;F;36;CHILENO;;Millenial;PROVIDENCIA                   ;METROPOLITANA;0;0;0;0;0;0;0;0;0;PACK 2 ALMOHADAS C+L;DORMITORIO
10189110;Casado;F;58;CHILENO;;Boomers;RENCA                         ;METROPOLITANA;0;0;0;0;0;0;0;0;0;ALMOHADA ROSEN SOFT PLUS AMERICANA;DORMITORIO
25064201;;F;30;PERUANO;;Extranjero;PROVIDENCIA                   ;METROPOLITANA;0;0;0;0;0;0;0;0;0;BOX AMERICANO BEAT 1,5 PLAZAS 105 X 190 CM;DORMITORIO
19377958;Soltero;F;25;CHILENO;;Z;QUINTA NORMAL;METROPOLITANA;0;0;0;0;0;0;0;0;0;SET SABANA MICROFIBRA SAND 2P;DORMITORIO
9217315;;F;61;CHILENO;;Boomers;PROVIDENCIA                   ;METROPOLITANA;0;0;0;0;0;0;0;0;0;CLOSET M-803 3P 2C ALTO 1,82 BLANCO NATURAL;DORMITORIO
20195196;;F;23;CHILENO;;Z;N/D;N/D;0;0;0;0;0;0;0;0;0;PACK 2 ALMOHADAS C+L;DORMITORIO
12596678;;F;56;CHILENO;;Boomers;CHANARAL                      ;ATACAMA;0;0;0;0;0;0;0;0;0;ALMOHADA SOFT MICROGEL;DORMITORIO
26286127;;F;42;VENEZOLANO;;Extranjero;INDEPENDENCIA                 ;METROPOLITANA;0;0;0;0;0;0;0;0;0;COLCHON EVEREST 2P HILOS DE COBRE;DORMITORIO
15235177;;M;40;CHILENO;;X;SANTIAGO                      ;METROPOLITANA;0;0;0;0;0;0;0;0;0;BOX AMERICANO EXCELLENCE 2P BASE NORMAL;DORMITORIO
11819475;;F;51;CHILENO;;X;ANTOFAGASTA                   ;ANTOFAGASTA;0;0;0;0;0;0;0;0;0;COLCHON NEW ORTOPEDIC 2P;DORMITORIO
20065780;;F;23;CHILENO;;Z;PROVIDENCIA                   ;METROPOLITANA;0;0;0;0;0;0;0;0;0;CE ERGO T 2P 2MT BD;DORMITORIO
15961495;;M;37;CHILENO;;Millenial;CUREPTO                       ;MAULE;0;0;0;0;0;0;0;0;0;COMODA CIPRES MODELO CP010D, COLOR DEMIOLICION,;DORMITORIO
19019850;Soltero;F;27;CHILENO;;Z;PROVIDENCIA                   ;METROPOLITANA;0;0;0;0;0;0;0;0;0;ESCRITORIO FREEMAN;DORMITORIO
18546520;Soltero;F;28;CHILENO;;Millenial;PROVIDENCIA                   ;METROPOLITANA;0;0;0;0;0;0;0;0;0;SET SABANA MICROFIBRA ROUGE 1,5P;DORMITORIO
5135031;;M;79;CHILENO;;Silencioso;RENCA                         ;METROPOLITANA;0;0;0;0;0;0;0;0;0;COLCHON ERGO T 2P;DORMITORIO
19363392;;F;26;CHILENO;;Z;N/D;N/D;0;0;0;0;0;0;0;0;0;CE EVEREST 2P 2MTS BD DUAL SIDE;DORMITORIO
9430828;Soltero;M;49;CHILENO;;X;PROVIDENCIA                   ;METROPOLITANA;0;0;0;0;0;0;0;0;0;DIVAN NEW ORTOPEDIC BCK +RESP+1VEL NEW GALES;DORMITORIO
9292330;;M;61;CHILENO;;Silencioso;PROVIDENCIA                   ;METROPOLITANA;0;0;0;0;0;0;0;0;0;BOX AMERICANO EXCELLENCE FULL +RESP+2VEL OLMO;DORMITORIO
19594325;;F;24;CHILENO;;Silencioso;PROVIDENCIA                   ;METROPOLITANA;0;0;0;0;0;0;0;0;0;PACK 2 ALMOHADAS 100% PLUMA 50 X 70 CM;DORMITORIO
8950054;;F;62;CHILENO;;Boomers;COQUIMBO                      ;COQUIMBO;0;0;0;0;0;0;0;0;0;ALMOHADA VISCO ELASTICA BAMBOO 60X40 CM;DORMITORIO
20435321;;F;21;CHILENO;;Z;N/D;N/D;0;0;0;0;0;0;0;0;0;SET 2 ALMOHADAS VISCO MEDIUM 60X40 CM;DORMITORIO
16964443;;M;33;CHILENO;;Millenial;PROVIDENCIA                   ;METROPOLITANA;0;0;0;0;0;0;0;0;0;CE NEW ORTOPEDIC KING;DORMITORIO
17720584;;M;28;CHILENO;;Silencioso;PROVIDENCIA                   ;METROPOLITANA;0;0;0;0;0;0;0;0;0;ALMOHADA ROSEN SOFT PLUS KING;DORMITORIO
12595421;;F;47;CHILENO;;X;PROVIDENCIA                   ;METROPOLITANA;0;0;0;0;0;0;0;0;0;SET SABANA MICROFIBRA BLUE 1,5P;DORMITORIO
19987772;;F;24;CHILENO;;Z;SAN FERNANDO                  ;L.G.B.OÂ´HIGGINS;0;0;0;0;0;0;0;0;0;COLCHON NEW STYLE 4 2P;DORMITORIO
19045925;Soltero;F;27;CHILENO;;Z;PROVIDENCIA                   ;METROPOLITANA;0;0;0;0;0;0;0;0;0;DIVAN NEW ORTOPEDIC BCK +RESP+1VEL NEW VILLA;DORMITORIO
7646668;;M;60;CHILENO;;Silencioso;PROVIDENCIA                   ;METROPOLITANA;0;0;0;0;0;0;0;0;0;DIVAN CAMA ERGO T 1,5P 2 MTS;DORMITORIO
15776957;;M;38;CHILENO;;Silencioso;PROVIDENCIA                   ;METROPOLITANA;0;0;0;0;0;0;0;0;0;Almohada Bamboo Classic 70x40;DORMITORIO
17547991;;M;31;CHILENO;;Millenial;ANTOFAGASTA;ANTOFAGASTA;0;0;0;0;0;0;0;0;0;Camarote 1P Texas Evolution + 2 Al;DORMITORIO
18997419;;F;27;CHILENO;;Z;PROVIDENCIA                   ;METROPOLITANA;0;0;0;0;0;0;0;0;0;CE EVOLUTION BLACK 1,5P BN RESP+VEL;DORMITORIO
9770777;;F;43;CHILENO;;X;ANCUD                         ;LOS LAGOS;0;0;0;0;0;0;0;0;0;CLOSET M-701 6 PUERTAS 2 CAJONES ALTO 1,82 COLOR;DORMITORIO
15168337;Soltero;F;40;CHILENO;TECNICO EN ENFERMERIA DE NIVEL SUPERIOR;X;RENCA                         ;METROPOLITANA;0;0;0;0;0;0;0;0;0;Almohada Visco Bamboo Classic Pack 60x40 cm;DORMITORIO
17517534;;M;31;CHILENO;;Silencioso;PROVIDENCIA                   ;METROPOLITANA;0;0;0;0;0;0;0;0;0;CE NEW STYLE 6 2P 2MT BD;DORMITORIO
10678044;;M;54;CHILENO;;X;RENCA                         ;METROPOLITANA;0;0;0;0;0;0;0;0;0;COLCHON NEW STYLE 6 2P 150X200;DORMITORIO
8892832;;F;62;CHILENO;;Boomers;CHIMBARONGO                   ;L.G.B.OÂ´HIGGINS;0;0;0;0;0;0;0;0;0;CE ERGO T 2P 2MT BD;DORMITORIO
11629125;;F;52;CHILENO;;X;MALLOA                        ;L.G.B.OÂ´HIGGINS;0;0;0;0;0;0;0;0;0;CE EVOLUTION BLACK 2P BD DUAL SIDE;DORMITORIO
17945247;;M;30;CHILENO;;Millenial;PROVIDENCIA                   ;METROPOLITANA;0;0;0;0;0;0;0;0;0;CLOSET BALI 8 PUERTAS BICOLOR;DORMITORIO
7073721;;F;67;CHILENO;;Boomers;SALAMANCA                     ;COQUIMBO;0;0;0;0;0;0;0;0;0;CE EVOLUTION BLACK 1,5P BN RESP+VEL;DORMITORIO
6843614;;F;77;CHILENO;;Silencioso;CASTRO                        ;LOS LAGOS;0;0;0;0;0;0;0;0;0;COLCHON EVOLUTION BLACK 2P DUAL SIDE;DORMITORIO
16076483;;F;36;CHILENO;;Millenial;PENAFLOR                      ;METROPOLITANA;0;0;0;0;0;0;0;0;0;PANEL GOYA;DORMITORIO
17041919;;M;34;CHILENO;;Millenial;VINA DEL MAR                  ;VALPARAISO;0;0;0;0;0;0;0;0;0;BOX AMERICANO EXCELLENCE 1.5 PLAZA + ALM;DORMITORIO
18865883;;F;26;CHILENO;;Z;PROVIDENCIA                   ;METROPOLITANA;0;0;0;0;0;0;0;0;0;SET SABANA MICROFIBRA MUSTARD 2P;DORMITORIO
9508495;;M;60;CHILENO;;Boomers;RANCAGUA                      ;L.G.B.OÂ´HIGGINS;0;0;0;0;0;0;0;0;0;COLCHON SPRING III 1P;DORMITORIO
8161134;;F;64;CHILENO;;Boomers;TALAGANTE                     ;METROPOLITANA;0;0;0;0;0;0;0;0;0;COLCHON THERAPEDIC 2P;DORMITORIO
17295711;;F;32;CHILENO;;Millenial;PROVIDENCIA                   ;METROPOLITANA;0;0;0;0;0;0;0;0;0;CAMA EUROPEA BAMBOO 1,5P;DORMITORIO
14085440;;M;40;CHILENO;;X;OSORNO                        ;LOS LAGOS;0;0;0;0;0;0;0;0;0;BOX AMERICANO EXCELLENCE 1.5 PLAZAS;DORMITORIO
16158222;Soltero;F;36;CHILENO;;Millenial;PROVIDENCIA                   ;METROPOLITANA;0;0;0;0;0;0;0;0;0;COLCHON ORTOPEDIC ADVANCE 2P ALM;DORMITORIO
13945962;;F;41;CHILENO;;X;PEUMO                         ;L.G.B.OÂ´HIGGINS;0;0;0;0;0;0;0;0;0;COLCHON EXCELLENCE PLUS 2P + CUBRECOLCHON;DORMITORIO
13786920;;M;42;CHILENO;;X;SAN CLEMENTE                  ;MAULE;0;0;0;0;0;0;0;0;0;COLCHON TERAPEUTIC 2P PILLOW TOP;DORMITORIO
20232150;;M;32;CHILENO;;Millenial;LEBU                          ;BIO BIO;0;0;0;0;0;0;0;0;0;CE NEW ORTOPEDIC 2PBD;DORMITORIO
20206538;;F;22;CHILENO;;Z;CASTRO;LOS LAGOS;0;0;0;0;0;0;0;0;0;PACK 2 ALMOHADAS C+L;DORMITORIO
10472495;;F;54;CHILENO;;X;PROVIDENCIA                   ;METROPOLITANA;0;0;0;0;0;0;0;0;0;COLCHON NEW ORTOPEDIC 2P;DORMITORIO
16502773;;F;35;CHILENO;;Millenial;PROVIDENCIA                   ;METROPOLITANA;0;0;0;0;0;0;0;0;0;COLCHON EXCELLENCE 2 PLAZA + 2 ALM;DORMITORIO
19907637;;F;24;CHILENO;;Z;PROVIDENCIA                   ;METROPOLITANA;0;0;0;0;0;0;0;0;0;BOX AMERICANO EXCELLENCE 2P BN +2ALM+PLU;DORMITORIO
10984299;;F;45;CHILENO;;X;RENCA                         ;METROPOLITANA;0;0;0;0;0;0;0;0;0;SET SABANA MICROFIBRA ROUGE 2P;DORMITORIO
19374759;;F;26;CHILENO;;Z;PROVIDENCIA                   ;METROPOLITANA;0;0;0;0;0;0;0;0;0;COLCHON EXCELLENCE FULL + 2 ALM;DORMITORIO
20646033;;F;21;CHILENO;;Z;N/D;N/D;0;0;0;0;0;0;0;0;0;COLCHON EXCELLENCE 1 PLAZA + ALM;DORMITORIO
18671390;;M;35;CHILENO;;Millenial;PANGUIPULLI                   ;LOS RIOS;0;0;0;0;0;0;0;0;0;COLCHON ACTIVE 1P DUAL SIDE;DORMITORIO
9211438;Casado;F;61;CHILENO;PROFESOR;Boomers;PROVIDENCIA                   ;METROPOLITANA;0;0;0;0;0;0;0;0;0;CAMA ERGO T 1,5P + RESP + 1 VEL FERRARA;DORMITORIO
19125962;;F;26;CHILENO;;Z;N/D;N/D;0;0;0;0;0;0;0;0;0;CE NEW ORTOPEDIC KING +RESP+2VEL NEW TORINO;DORMITORIO
15626349;;F;38;CHILENO;;Millenial;PROVIDENCIA                   ;METROPOLITANA;0;0;0;0;0;0;0;0;0;ALMOHADA MEMORY MAX BASIC AMERICANA;DORMITORIO
18723629;Soltero;F;26;CHILENO;TECNICO DE NIVEL SUPERIOR PARAMEDICO EN ODONTOLOGIA;Z;PROVIDENCIA                   ;METROPOLITANA;0;0;0;0;0;0;0;0;0;CAMA EUROPEA BAMBOO 1,5P;DORMITORIO
19709157;;F;26;CHILENO;;Z;INDEPENDENCIA;METROPOLITANA;0;0;0;0;0;0;0;0;0;CAMA EUROPEA EXCELLENCE 1.5P +RESP+VEL OLMO;DORMITORIO
19377795;Soltero;F;25;CHILENO;;Z;PROVIDENCIA                   ;METROPOLITANA;0;0;0;0;0;0;0;0;0;ESCRITORIO FAVATEX YATES CASTANO-NEGRO;DORMITORIO
4990486;;F;74;CHILENO;;Silencioso;ANCUD                         ;LOS LAGOS;0;0;0;0;0;0;0;0;0;CE ORTOPEDIC ADVANCE 1.5P;DORMITORIO
16253889;;M;36;CHILENO;;Millenial;MACHALI                       ;L.G.B.OÂ´HIGGINS;0;0;0;0;0;0;0;0;0;CAMA EUROPEA CANNABIS 2PBD + RESP + VEL CASTILLA;DORMITORIO
16219413;;F;35;CHILENO;;Millenial;PROVIDENCIA                   ;METROPOLITANA;0;0;0;0;0;0;0;0;0;DIVAN CAMA ERGO T 1,5P 2 MTS;DORMITORIO
15842646;;F;37;CHILENO;;Extranjero;LA GRANJA                     ;METROPOLITANA;0;0;0;0;0;0;0;0;0;CE EVOLUTION BLACK 1,5P + RESPALDO CASTILLA;DORMITORIO
11915224;;F;50;CHILENO;;X;PROVIDENCIA                   ;METROPOLITANA;0;0;0;0;0;0;0;0;0;SET 2 ALMOHADAS VISCO MEDIUM 60X40 CM;DORMITORIO
12214677;;F;50;CHILENO;;X;ANTOFAGASTA;ANTOFAGASTA;0;0;0;0;0;0;0;0;0;Camarote Texas + 2 Colchones Esp + 2PS2A;DORMITORIO
18033055;;F;30;CHILENO;;Millenial;PROVIDENCIA                   ;METROPOLITANA;0;0;0;0;0;0;0;0;0;CE ERGO T 2P 2MT BD;DORMITORIO
18805081;;F;27;CHILENO;;Millenial;N/D;N/D;0;0;0;0;0;0;0;0;0;PACK 2 ALMOHADAS 100% PLUMA 50 X 70 CM;DORMITORIO
11882939;Viudo;F;51;CHILENO;;X;RENCA                         ;METROPOLITANA;0;0;0;0;0;0;0;0;0;COLCHON EXCELLENCE PLUS 1.5P + CUBRECOLCHON;DORMITORIO
6636984;;M;63;CHILENO;;Boomers;CHILLAN                       ;BIO BIO;0;0;0;0;0;0;0;0;0;ALMOHADA SOFT MICROGEL;DORMITORIO
16264511;;F;37;CHILENO;;Millenial;N/D;N/D;0;0;0;0;0;0;0;0;0;BOX AMERICANO EXCELLENCE PLUS 1 PLAZA;DORMITORIO
16603112;;F;35;CHILENO;;Millenial;PROVIDENCIA                   ;METROPOLITANA;0;0;0;0;0;0;0;0;0;COLCHON TEMPO 2P 150X190;DORMITORIO
9507853;;M;59;CHILENO;;Boomers;RENCA                         ;METROPOLITANA;0;0;0;0;0;0;0;0;0;Almohada Bamboo Classic 70x40;DORMITORIO
10664412;;F;53;CHILENO;;X;ANGOL                         ;ARAUCANIA;0;0;0;0;0;0;0;0;0;BS NEW ORTOPEDIC B5 BCK 2PBN RESPALDO BAKER;DORMITORIO
8300992;;F;68;CHILENO;;Boomers;VALPARAISO                    ;VALPARAISO;0;0;0;0;0;0;0;0;0;BA EXCELLENCE 2P BN +RESP+2VEL OLMO +2ALM+PL;DORMITORIO
19681009;;F;25;CHILENO;;Z;RAUCO                         ;MAULE;0;0;0;0;0;0;0;0;0;ALMOHADA MEMORY MAX BASIC AMERICANA;DORMITORIO
18419110;;F;28;CHILENO;;Millenial;"";"";0;0;0;0;0;0;0;0;0;COLCHON THERAPEDIC 2P;DORMITORIO
17541392;;M;31;CHILENO;;Silencioso;PROVIDENCIA                   ;METROPOLITANA;0;0;0;0;0;0;0;0;0;CE NEW STYLE 6 2P 2MT BD;DORMITORIO
16669764;Soltero;M;34;CHILENO;ARTISTA;Silencioso;PROVIDENCIA                   ;METROPOLITANA;0;0;0;0;0;0;0;0;0;COLCHON EXCELLENCE FULL + 2 ALM;DORMITORIO
6911545;;F;68;CHILENO;;Silencioso;SANTA CRUZ                    ;L.G.B.OÂ´HIGGINS;0;0;0;0;0;0;0;0;0;CE EVEREST 2P 2MTS BD DUAL SIDE;DORMITORIO
13163154;;M;45;CHILENO;;X;OSORNO                        ;LOS LAGOS;0;0;0;0;0;0;0;0;0;COLCHON EXCELLENCE 2 PLAZAS + CUBRECOLCHON;DORMITORIO
7969272;;F;67;CHILENO;;Boomers;PADRE LAS CASAS               ;ARAUCANIA;0;0;0;0;0;0;0;0;0;COLCHON ERGO T 1P;DORMITORIO
17424458;;M;32;CHILENO;;Millenial;PUDAHUEL                      ;METROPOLITANA;0;0;0;0;0;0;0;0;0;BOX AMERICANO EXCELLENCE 1.5 PLAZA + ALM+PL;DORMITORIO
8209037;;M;60;CHILENO;;Boomers;CALAMA                        ;ANTOFAGASTA;0;0;0;0;0;0;0;0;0;CE EVEREST 2P 2MTS BD DUAL SIDE;DORMITORIO
19215774;Soltero;M;26;CHILENO;TECNICO ELECTRICO;Z;PROVIDENCIA                   ;METROPOLITANA;0;0;0;0;0;0;0;0;0;COLCHON NEW ORTOPEDIC 2P 150X190 + CUBREC;DORMITORIO
13279255;;F;45;CHILENO;;X;PROVIDENCIA                   ;METROPOLITANA;0;0;0;0;0;0;0;0;0;CLOSET CROACIA BLANCO 4P;DORMITORIO
13121382;Soltero;M;46;CHILENO;;X;PROVIDENCIA                   ;METROPOLITANA;0;0;0;0;0;0;0;0;0;COLCHON EXCELLENCE 1.5 PLAZA + CUBRECOLCHON;DORMITORIO
15935677;;M;37;CHILENO;;Silencioso;PROVIDENCIA                   ;METROPOLITANA;0;0;0;0;0;0;0;0;0;COLCHON SPRING III 1P;DORMITORIO
25409434;;M;36;COLOMBIANO;;Extranjero;CONCHALI                      ;METROPOLITANA;0;0;0;0;0;0;0;0;0;DIVAN CAMA ERGO T 1,5P 2 MTS;DORMITORIO
25873404;;F;39;COLOMBIANO;;Extranjero;N/D;N/D;0;0;0;0;0;0;0;0;0;CE ERGO T 2P 2MT BD;DORMITORIO
12949554;;F;45;CHILENO;;X;SAN FELIPE                    ;VALPARAISO;0;0;0;0;0;0;0;0;0;COLCHON NEW ORTOPEDIC 2P;DORMITORIO
16907546;;M;34;CHILENO;;Millenial;CERRILLOS                     ;METROPOLITANA;0;0;0;0;0;0;0;0;0;PACK 2 ALMOHADAS C+L;DORMITORIO
10800264;Casado;M;54;CHILENO;;Silencioso;PARRAL                        ;MAULE;0;0;0;0;0;0;0;0;0;BOX AMERICANO EXCELLENCE PLUS 1.5 PLAZA+ ALM;DORMITORIO
9291567;;M;59;CHILENO;;Boomers;CONCEPCION                    ;BIO BIO;0;0;0;0;0;0;0;0;0;COLCHON NOVUM BIOACTIVE 2P x 2M;DORMITORIO
13415757;;F;44;CHILENO;;X;PROVIDENCIA                   ;METROPOLITANA;0;0;0;0;0;0;0;0;0;Multiple Turin Bicolor 1,38x38;DORMITORIO
26376321;;F;43;EXTRANJERO - NO INFORMA NACIONALIDAD;;Extranjero;N/D;N/D;0;0;0;0;0;0;0;0;0;COLCHON ERGO T 1,5P;DORMITORIO
20195893;;F;22;CHILENO;;Z;N/D;N/D;0;0;0;0;0;0;0;0;0;CAMA NEW STYLE 6 KING BD;DORMITORIO
19060551;Soltero;F;27;CHILENO;;Silencioso;PROVIDENCIA                   ;METROPOLITANA;0;0;0;0;0;0;0;0;0;CLOSET NIZA 6P+2C;DORMITORIO
19385658;;F;25;CHILENO;;Z;LO PRADO                      ;METROPOLITANA;0;0;0;0;0;0;0;0;0;CLOSET M-803 3P 2C ALTO 1,82 BLANCO NATURAL;DORMITORIO
11840215;;M;51;CHILENO;;X;PROVIDENCIA                   ;METROPOLITANA;0;0;0;0;0;0;0;0;0;ALMOHADA SOFT MICROGEL;DORMITORIO
10195471;;M;53;CHILENO;;X;COPIAPO                       ;ATACAMA;0;0;0;0;0;0;0;0;0;ALMOHADA SOFT MICROGEL;DORMITORIO
20095060;;M;23;CHILENO;;Z;PROVIDENCIA                   ;METROPOLITANA;0;0;0;0;0;0;0;0;0;BOX AMERICANO EXCELLENCE 1.5 PLAZA + ALM;DORMITORIO
14207318;;M;41;CHILENO;;Silencioso;PROVIDENCIA                   ;METROPOLITANA;0;0;0;0;0;0;0;0;0;COLCHON EVEREST 2P HILOS DE COBRE;DORMITORIO
19839080;;F;24;CHILENO;;Silencioso;PROVIDENCIA                   ;METROPOLITANA;0;0;0;0;0;0;0;0;0;CLOSET CROACIA BLANCO 4P;DORMITORIO
18271062;;M;29;CHILENO;;Silencioso;PROVIDENCIA                   ;METROPOLITANA;0;0;0;0;0;0;0;0;0;BOX AMERICANO EXCELLENCE 2P BASE NORMAL+2ALM;DORMITORIO
5778468;;M;74;CHILENO;;Silencioso;LLANQUIHUE                    ;LOS LAGOS;0;0;0;0;0;0;0;0;0;COLCHON NEW STYLE 6 2P;DORMITORIO
17758664;Casado;F;31;CHILENO;PROFESOR;Silencioso;PROVIDENCIA                   ;METROPOLITANA;0;0;0;0;0;0;0;0;0;COLCHON NEW STYLE 4 2P;DORMITORIO
18000128;Soltero;M;30;CHILENO;BIOQUIMICO;Millenial;PROVIDENCIA                   ;METROPOLITANA;0;0;0;0;0;0;0;0;0;COLCHON NEW ORTOPEDIC 1,5P;DORMITORIO
19364499;;F;25;CHILENO;;Z;PROVIDENCIA                   ;METROPOLITANA;0;0;0;0;0;0;0;0;0;CE ERGO T 2P 2MT BD;DORMITORIO
18205360;;M;30;CHILENO;;Millenial;PROVIDENCIA                   ;METROPOLITANA;0;0;0;0;0;0;0;0;0;CLOSET ARICA TV 32 M302 TEXTURADO CASTANO;DORMITORIO
16775575;Soltero;F;34;CHILENO;PROFESOR;Millenial;PROVIDENCIA                   ;METROPOLITANA;0;0;0;0;0;0;0;0;0;CE EVOLUTION BLACK 2P BD+RESP+2 VEL;DORMITORIO
19511942;;M;24;CHILENO;;Silencioso;PROVIDENCIA                   ;METROPOLITANA;0;0;0;0;0;0;0;0;0;BA BEAT 2P 2MTS BN;DORMITORIO
10922765;;F;55;CHILENO;;Silencioso;PROVIDENCIA                   ;METROPOLITANA;0;0;0;0;0;0;0;0;0;ALMOHADA MEMORY MAX BASIC AMERICANA;DORMITORIO
16936573;Soltero;M;34;CHILENO;INGENIERO EN ADMINISTRACION DE EMPRESAS;Silencioso;PROVIDENCIA                   ;METROPOLITANA;0;0;0;0;0;0;0;0;0;COLCHON EXCELLENCE 1.5 PLAZA + CUBRECOLCHON;DORMITORIO
17493153;Soltero;F;32;CHILENO;;Millenial;PROVIDENCIA                   ;METROPOLITANA;0;0;0;0;0;0;0;0;0;PACK 2 ALMOHADAS C+L;DORMITORIO
11167071;;F;55;CHILENO;;Silencioso;PROVIDENCIA                   ;METROPOLITANA;0;0;0;0;0;0;0;0;0;CLOSET NEWCAPRI M-330 AVELLANA/CARVALHO4P3C+ESPE;DORMITORIO
5655228;;F;77;CHILENO;;Silencioso;PROVIDENCIA                   ;METROPOLITANA;0;0;0;0;0;0;0;0;0;CAMA EUROPEA CANNABIS 2PBD + RESP + VEL CASTILLA;DORMITORIO
10841637;;F;49;CHILENO;;X;RENCA                         ;METROPOLITANA;0;0;0;0;0;0;0;0;0;SET 2 ALMOHADAS VISCO MEDIUM 60X40 CM;DORMITORIO
15305213;;F;44;CHILENO;;X;PROVIDENCIA                   ;METROPOLITANA;0;0;0;0;0;0;0;0;0;CE NEW ORTOPEDIC 2PBD +RESP+2VEL NEW DUBLIN;DORMITORIO
19073378;;F;26;CHILENO;;Z;PROVIDENCIA                   ;METROPOLITANA;0;0;0;0;0;0;0;0;0;CLOSET CROACIA BLANCO 4P;DORMITORIO
16669306;;M;34;CHILENO;;Millenial;N/D;N/D;0;0;0;0;0;0;0;0;0;CAMA EUROPEA CANNABIS 2PBN + RESP + 2VEL CASTIL;DORMITORIO
16193796;;F;36;CHILENO;;Millenial;SAN BERNARDO                  ;METROPOLITANA;0;0;0;0;0;0;0;0;0;Almohada Visco Bamboo Classic Pack 60x40 cm;DORMITORIO
17448056;;M;32;CHILENO;;Millenial;PROVIDENCIA                   ;METROPOLITANA;0;0;0;0;0;0;0;0;0;CLOSET M-803 3P 2C ALTO 1,82 BLANCO NATURAL;DORMITORIO
13147578;;M;45;CHILENO;;X;PROVIDENCIA                   ;METROPOLITANA;0;0;0;0;0;0;0;0;0;CE EVOLUTION BLACK 2P BD DUAL SIDE;DORMITORIO
11673636;;F;51;CHILENO;;X;SAN VICENTE                   ;L.G.B.OÂ´HIGGINS;0;0;0;0;0;0;0;0;0;PACK 2 ALMOHADAS C+L;DORMITORIO
13868896;;F;42;CHILENO;;X;PROVIDENCIA                   ;METROPOLITANA;0;0;0;0;0;0;0;0;0;CE BLACK 1,5P EVOLUTION+ALM+CUBRECAMA+SABANA;DORMITORIO
10512055;;M;56;CHILENO;;Boomers;SAN FERNANDO                  ;L.G.B.OÂ´HIGGINS;0;0;0;0;0;0;0;0;0;COLCHON TERAPEUTIC 2P PILLOW TOP;DORMITORIO
11377081;;F;53;CHILENO;;X;CALAMA                        ;ANTOFAGASTA;0;0;0;0;0;0;0;0;0;ALMOHADA SOFT MICROGEL;DORMITORIO
9189053;;F;60;CHILENO;;Extranjero;TEMUCO                        ;ARAUCANIA;0;0;0;0;0;0;0;0;0;CAMAROTE TRIPLE CORINA CAFE OSCURO;DORMITORIO
12195883;;F;50;CHILENO;;X;PITRUFQUEN                    ;ARAUCANIA;0;0;0;0;0;0;0;0;0;ALMOHADA SOFT MICROGEL;DORMITORIO
16285519;;F;35;CHILENO;;Millenial;HUALPEN;BIO BIO;0;0;0;0;0;0;0;0;0;CAMAROTE TRIPLE CORINA CAFE OSCURO;DORMITORIO
11178627;;M;55;CHILENO;;Boomers;PROVIDENCIA                   ;METROPOLITANA;0;0;0;0;0;0;0;0;0;BOX AMERICANO EXCELLENCE 2P BASE NORMAL+2ALM;DORMITORIO
19324904;;F;24;CHILENO;;Z;PROVIDENCIA                   ;METROPOLITANA;0;0;0;0;0;0;0;0;0;CE EVOLUTION BLACK 2P BD DUAL SIDE;DORMITORIO
16990699;;F;33;CHILENO;;Millenial;SAN FELIPE                    ;VALPARAISO;0;0;0;0;0;0;0;0;0;COLCHON EVEREST 2P 150X200;DORMITORIO
9095210;;F;61;CHILENO;;Boomers;PUENTE ALTO                   ;METROPOLITANA;0;0;0;0;0;0;0;0;0;CE EVOLUTION BLACK 1,5P + RESPALDO CASTILLA;DORMITORIO
8154471;;M;58;CHILENO;;Boomers;NATALES                       ;MAGALLANES;0;0;0;0;0;0;0;0;0;COLCHON NEW STYLE 4 2P;DORMITORIO
10760182;;M;56;CHILENO;;Boomers;CURANILAHUE                   ;BIO BIO;0;0;0;0;0;0;0;0;0;CE EVOLUTION BLACK 2P BD DUAL SIDE;DORMITORIO
17981254;;F;29;CHILENO;;Millenial;RENCA                         ;METROPOLITANA;0;0;0;0;0;0;0;0;0;CLOSET CROACIA BLANCO 4P;DORMITORIO
16194176;;M;35;CHILENO;;Millenial;PROVIDENCIA                   ;METROPOLITANA;0;0;0;0;0;0;0;0;0;COLCHON IBIZA 2P;DORMITORIO
8184524;;M;65;CHILENO;;Boomers;PUENTE ALTO                   ;METROPOLITANA;0;0;0;0;0;0;0;0;0;SET 2 ALMOHADAS VISCO MEDIUM 60X40 CM;DORMITORIO
10811405;;F;43;CHILENO;;X;PROVIDENCIA                   ;METROPOLITANA;0;0;0;0;0;0;0;0;0;CE EVOLUTION BLACK 1,5P + RESPALDO CASTILLA;DORMITORIO
15693583;;F;41;CHILENO;;X;ARICA                         ;ARICA Y PARINACOTA;0;0;0;0;0;0;0;0;0;CAMA ERGO T 2PBD + RESP + 2 VEL FERRARA;DORMITORIO
6401731;;M;70;CHILENO;;Silencioso;PROVIDENCIA                   ;METROPOLITANA;0;0;0;0;0;0;0;0;0;CLOSET CAJONERA NEW BELGICA M-398-NW;DORMITORIO
9980113;Soltero;M;44;CHILENO;INGENIERO COMERCIAL;X;RENCA                         ;METROPOLITANA;0;0;0;0;0;0;0;0;0;COMODA ALTAIR WALNUT;DORMITORIO
19229076;Soltero;M;26;CHILENO;;Z;PROVIDENCIA                   ;METROPOLITANA;0;0;0;0;0;0;0;0;0;CLOSET CROACIA BLANCO 4P;DORMITORIO
14388919;;M;44;CHILENO;;X;LINARES                       ;MAULE;0;0;0;0;0;0;0;0;0;CE BAMBOO 2P BD FIBRAS BAMBOO DUAL SIDE;DORMITORIO
14510005;Divorciado;F;47;CHILENO;;X;PROVIDENCIA                   ;METROPOLITANA;0;0;0;0;0;0;0;0;0;PACK 2 ALMOHADAS C+L;DORMITORIO
17770782;;F;31;CHILENO;;Millenial;RENCA                         ;METROPOLITANA;0;0;0;0;0;0;0;0;0;BS NEW ORTOPEDIC B5 BLACK 2PBN;DORMITORIO
14371463;;F;50;CHILENO;;X;CALAMA                        ;ANTOFAGASTA;0;0;0;0;0;0;0;0;0;ALMOHADA ROSEN SOFT PLUS AMERICANA;DORMITORIO
13639421;;F;42;CHILENO;;X;ARICA                         ;ARICA Y PARINACOTA;0;0;0;0;0;0;0;0;0;BA BEAT 2P 2MTS BN;DORMITORIO
17759990;Soltero;F;31;CHILENO;;Millenial;PROVIDENCIA                   ;METROPOLITANA;0;0;0;0;0;0;0;0;0;PACK 2 ALMOHADAS C+L;DORMITORIO
11966125;;M;49;CHILENO;;X;QUILICURA                     ;METROPOLITANA;0;0;0;0;0;0;0;0;0;CE EVOLUTION BLACK 1P + RESPALDO ASTURIAS;DORMITORIO
12809323;;F;47;CHILENO;;X;PROVIDENCIA                   ;METROPOLITANA;0;0;0;0;0;0;0;0;0;CE EVOLUTION BLACK 1,5P + RESPALDO CASTILLA;DORMITORIO
8285487;;M;55;CHILENO;;Boomers;HUALQUI;BIO-BIO;0;0;0;0;0;0;0;0;0;COLCHON EVEREST 2P 150X200;DORMITORIO
14571420;Casado;F;48;CHILENO;;X;LOS MUERMOS                   ;LOS LAGOS;0;0;0;0;0;0;0;0;0;BA EXCEL PLUS 2P BN +RESP+2VEL NEW VILLARRICA;DORMITORIO
8190634;;F;63;CHILENO;;Boomers;LA SERENA                     ;COQUIMBO;0;0;0;0;0;0;0;0;0;PACK 2 ALMOHADAS C+L;DORMITORIO
10962363;;F;53;CHILENO;;X;PENALOLEN                     ;METROPOLITANA;0;0;0;0;0;0;0;0;0;CE EVOLUTION BLACK 2P BD DUAL SIDE;DORMITORIO
18587512;Soltero;M;28;CHILENO;PSICOLOGO;Millenial;PROVIDENCIA                   ;METROPOLITANA;0;0;0;0;0;0;0;0;0;CLOSET 03 PUERTAS ANTHONY ];DORMITORIO
17199769;Soltero;M;32;CHILENO;INGENIERO CIVIL MECANICO;Millenial;PROVIDENCIA                   ;METROPOLITANA;0;0;0;0;0;0;0;0;0;ESCRITORIO COLLEGE CHOCOLATE;DORMITORIO
12932840;Casado;F;47;CHILENO;;X;PROVIDENCIA                   ;METROPOLITANA;0;0;0;0;0;0;0;0;0;COLCHON BAMBOO 2P FIBRAS BAMBOO;DORMITORIO
15580502;;F;38;CHILENO;;Millenial;PROVIDENCIA                   ;METROPOLITANA;0;0;0;0;0;0;0;0;0;CAMA EURO GRIS NEW ENTREE-D 2PBD;DORMITORIO
13886395;;M;42;CHILENO;;X;N/D;N/D;0;0;0;0;0;0;0;0;0;ALMOHADA SOFT MICROGEL;DORMITORIO
18237185;Soltero;M;29;CHILENO;;Millenial;PROVIDENCIA                   ;METROPOLITANA;0;0;0;0;0;0;0;0;0;CE BAMBOO 2P BD FIBRAS BAMBOO DUAL SIDE;DORMITORIO
16503480;;F;35;CHILENO;;Millenial;PROVIDENCIA                   ;METROPOLITANA;0;0;0;0;0;0;0;0;0;ESCRITORIO COLLEGE BLANCO;DORMITORIO
10337565;;M;55;CHILENO;;Boomers;CALERA                        ;VALPARAISO;0;0;0;0;0;0;0;0;0;CE EVOLUTION BLACK 1,5P + RESPALDO ASTURIAS;DORMITORIO
24714828;;F;35;COLOMBIANO;;Extranjero;BUIN;METROPOLITANA;0;0;0;0;0;0;0;0;0;CLOSET NIZA 6P+2C;DORMITORIO
19066146;;M;27;CHILENO;;Z;PROVIDENCIA                   ;METROPOLITANA;0;0;0;0;0;0;0;0;0;ALMOHADA MEMORY MAX BASIC AMERICANA;DORMITORIO
8410903;Casado;F;60;CHILENO;;Boomers;RENCA                         ;METROPOLITANA;0;0;0;0;0;0;0;0;0;ALMOHADA SOFT MICROGEL;DORMITORIO
7830280;Viudo;F;65;CHILENO;;Boomers;PROVIDENCIA                   ;METROPOLITANA;0;0;0;0;0;0;0;0;0;ALMOHADA SOFT MICROGEL;DORMITORIO
16157487;;M;36;CHILENO;;Millenial;PROVIDENCIA                   ;METROPOLITANA;0;0;0;0;0;0;0;0;0;Cama Tempo 2PBD;DORMITORIO
8025315;;F;53;CHILENO;;X;SAN ANTONIO                   ;VALPARAISO;0;0;0;0;0;0;0;0;0;PACK 2 ALMOHADAS 100% PLUMA 50 X 70 CM;DORMITORIO
7718279;;F;68;CHILENO;;Silencioso;RENCA                         ;METROPOLITANA;0;0;0;0;0;0;0;0;0;COLCHON EXCELLENCE 2P;DORMITORIO
16153050;;F;36;CHILENO;;Millenial;CONCEPCION                    ;BIO BIO;0;0;0;0;0;0;0;0;0;CE ERGO T 2P 2MT BD;DORMITORIO
10320291;;F;55;CHILENO;;Boomers;PROVIDENCIA                   ;METROPOLITANA;0;0;0;0;0;0;0;0;0;BA BEAT 2P 2MTS BN;DORMITORIO
18515873;Soltero;M;29;CHILENO;TECNICO DE NIVEL SUPERIOR EN ODONTOLOGIA;Millenial;PROVIDENCIA                   ;METROPOLITANA;0;0;0;0;0;0;0;0;0;ALMOHADA SOFT MICROGEL;DORMITORIO
10142049;;F;55;CHILENO;;Boomers;PROVIDENCIA                   ;METROPOLITANA;0;0;0;0;0;0;0;0;0;CLOSET ESPANA 6P+4C;DORMITORIO
18518094;;M;29;CHILENO;;Millenial;N/D;N/D;0;0;0;0;0;0;0;0;0;PACK 2 ALMOHADAS C+L;DORMITORIO
15106153;;M;36;CHILENO;;Millenial;N/D;N/D;0;0;0;0;0;0;0;0;0;BS NEW ORTOPEDIC B5 BLACK 2PBD;DORMITORIO
24024531;;M;45;HAITIANO;;Extranjero;QUILICURA                     ;METROPOLITANA;0;0;0;0;0;0;0;0;0;CLOSET MARITTIMA 6P+2C;DORMITORIO
10601424;;M;53;CHILENO;;X;SANTIAGO                      ;METROPOLITANA;0;0;0;0;0;0;0;0;0;BOX AAMERICANO EXCELLENCE FULL;DORMITORIO
12843949;;M;47;CHILENO;;X;LA SERENA;COQUIMBO;0;0;0;0;0;0;0;0;0;CE EVOLUTION BLACK 2P BD+RESP+2 VEL;DORMITORIO
18271499;;F;29;CHILENO;;Millenial;VALPARAISO                    ;VALPARAISO;0;0;0;0;0;0;0;0;0;Cama Europea Therapedic MAS 2PBN+ Resp + 2Vel Lo;DORMITORIO
5049359;;F;78;CHILENO;;Silencioso;TALCAHUANO                    ;BIO BIO;0;0;0;0;0;0;0;0;0;COLCHON MODDULA 1,5P;DORMITORIO
18298306;Soltero;F;29;CHILENO;;Millenial;PROVIDENCIA                   ;METROPOLITANA;0;0;0;0;0;0;0;0;0;PACK 2 ALMOHADAS C+L;DORMITORIO
11895252;;F;52;CHILENO;;X;TALCA                         ;MAULE;0;0;0;0;0;0;0;0;0;PACK 2 ALMOHADAS C+L;DORMITORIO
19697920;;F;24;CHILENO;;Z;PROVIDENCIA                   ;METROPOLITANA;0;0;0;0;0;0;0;0;0;COLCHON THERAPEDIC MAS 1P;DORMITORIO
4581743;;F;83;CHILENO;;Silencioso;N/D;N/D;0;0;0;0;0;0;0;0;0;Cama Europea Terapeutic King+ Resp + 2 Vel Villa;DORMITORIO
13845613;;F;42;CHILENO;;X;RENCA                         ;METROPOLITANA;0;0;0;0;0;0;0;0;0;DUPLEX CE EVOLUTION BLACK 1P + 2 RESP + VEL ASTU;DORMITORIO
9059989;Casado;M;59;CHILENO;;Boomers;RENCA                         ;METROPOLITANA;0;0;0;0;0;0;0;0;0;COLCHON NEW STYLE 4 2P;DORMITORIO
14632182;;M;56;PERUANO;;Extranjero;SAN MIGUEL                    ;METROPOLITANA;0;0;0;0;0;0;0;0;0;CLOSET CABURGUA 2 PT CORREDERA CEREZO;DORMITORIO
16237138;;F;36;CHILENO;;Millenial;PROVIDENCIA                   ;METROPOLITANA;0;0;0;0;0;0;0;0;0;Cama Europea Cannabis 1.5 plazas + Sabanas Imper;DORMITORIO
12634276;;M;47;CHILENO;;X;PROVIDENCIA                   ;METROPOLITANA;0;0;0;0;0;0;0;0;0;DUPLEX CE EVOLUTION BLACK 1P + 2 RESP + VEL ASTU;DORMITORIO
17861868;Casado;M;31;CHILENO;;Millenial;PROVIDENCIA                   ;METROPOLITANA;0;0;0;0;0;0;0;0;0;BS NEW ORTO B5 BCK 2PBD+RESP+2VEL NEW DUBLIN;DORMITORIO
14684626;;F;41;PERUANO;;Extranjero;PROVIDENCIA                   ;METROPOLITANA;0;0;0;0;0;0;0;0;0;CAMA EUROPEA GRIS THERAPEDIC 2PBD;DORMITORIO
18837001;;F;27;CHILENO;;Millenial;PROVIDENCIA                   ;METROPOLITANA;0;0;0;0;0;0;0;0;0;CE EVOLUTION BLACK 2P BN+RESP+2 VEL;DORMITORIO
18154889;;F;30;CHILENO;;Millenial;PROVIDENCIA                   ;METROPOLITANA;0;0;0;0;0;0;0;0;0;Closet MAIPO 6PT 4CJ 180 CM CHOCOLATE;DORMITORIO
7112598;;F;66;CHILENO;;Boomers;PROVIDENCIA                   ;METROPOLITANA;0;0;0;0;0;0;0;0;0;COLCHON EXCELLENCE PLUS 2 PLAZAS + 2 ALM;DORMITORIO
17922413;Soltero;F;31;CHILENO;PROFESOR;Millenial;PROVIDENCIA                   ;METROPOLITANA;0;0;0;0;0;0;0;0;0;COMODA 6 CAJONES LEGNO;DORMITORIO
7815773;;F;61;CHILENO;;Boomers;RENCA                         ;METROPOLITANA;0;0;0;0;0;0;0;0;0;COLCHON MAXIMO COBRE 2P 2MTS;DORMITORIO
9954462;Casado;M;59;CHILENO;;Boomers;YERBAS BUENAS                 ;MAULE;0;0;0;0;0;0;0;0;0;BOX AMERICANO MIRAGE 2PBN;DORMITORIO
17442949;Soltero;F;32;CHILENO;;Millenial;RENCA                         ;METROPOLITANA;0;0;0;0;0;0;0;0;0;COLCHON NEW STYLE 4 2P;DORMITORIO
14326430;;M;45;CHILENO;;X;RENCA                         ;METROPOLITANA;0;0;0;0;0;0;0;0;0;CAMAROTE TRIPLE CORINA BLANCO;DORMITORIO
12390902;;M;49;CHILENO;;X;QUEMCHI                       ;LOS LAGOS;0;0;0;0;0;0;0;0;0;CE EVOLUTION BLACK 1P + RESPALDO CASTILLA;DORMITORIO
5336987;;F;80;CHILENO;;Silencioso;N/D;N/D;0;0;0;0;0;0;0;0;0;COLCHON COTTON ORGANIC KING 2MT FIBRAS ALGODON O;DORMITORIO
11796859;;F;54;CHILENO;;X;LA FLORIDA                    ;METROPOLITANA;0;0;0;0;0;0;0;0;0;COLCHON NEW ORTOPEDIC 1,5P;DORMITORIO
18436333;Soltero;F;29;CHILENO;PROFESOR;Millenial;PROVIDENCIA                   ;METROPOLITANA;0;0;0;0;0;0;0;0;0;BOX AMERICANO EXCELLENCE 2P BN +2ALM+PLU;DORMITORIO
16619284;Soltero;M;34;CHILENO;;Millenial;PROVIDENCIA                   ;METROPOLITANA;0;0;0;0;0;0;0;0;0;COLCHON BEAT 1P;DORMITORIO
14409160;;F;52;CHILENO;;Silencioso;PROVIDENCIA                   ;METROPOLITANA;0;0;0;0;0;0;0;0;0;BASE AMERICANA SPRING VI 1.5 PL;DORMITORIO
16287563;;M;36;CHILENO;;Millenial;QUILLOTA                      ;VALPARAISO;0;0;0;0;0;0;0;0;0;CE EVOLUTION BLACK 2P BN+RESP+2 VEL;DORMITORIO
16838227;;M;33;CHILENO;;Millenial;RENCA                         ;METROPOLITANA;0;0;0;0;0;0;0;0;0;CAMA NIDO EVOLUTION BLACK 1,5P;DORMITORIO
18926649;Soltero;F;27;CHILENO;;Millenial;PROVIDENCIA                   ;METROPOLITANA;0;0;0;0;0;0;0;0;0;BOX AMERICANO EXCELLENCE 2P BASE NORMAL;DORMITORIO
16730825;;F;34;CHILENO;;Millenial;TALCA;MAULE;0;0;0;0;0;0;0;0;0;CE EVOLUTION BLACK 1,5P + RESPALDO CASTILLA;DORMITORIO
10579467;;F;51;CHILENO;;X;DALCAHUE                      ;LOS LAGOS;0;0;0;0;0;0;0;0;0;Closet TRANCURA 6PT 4CJ 156 CM CEREZO;DORMITORIO
18136719;Soltero;F;29;CHILENO;;Millenial;PROVIDENCIA                   ;METROPOLITANA;0;0;0;0;0;0;0;0;0;COLCHON EVOLUTION BLACK 2P DUAL SIDE;DORMITORIO
13626602;;F;43;CHILENO;;X;NACIMIENTO                    ;BIO BIO;0;0;0;0;0;0;0;0;0;DIVAN COLORS DREAMS MORADO 1,5P;DORMITORIO
16633460;;M;34;CHILENO;;Millenial;PROVIDENCIA                   ;METROPOLITANA;0;0;0;0;0;0;0;0;0;CAMA NIDO EVOLUTION BLACK 1,5P;DORMITORIO
6601671;;F;73;CHILENO;;Silencioso;RENCA                         ;METROPOLITANA;0;0;0;0;0;0;0;0;0;CE EVOLUTION BLACK 2P BD+RESP+2 VEL;DORMITORIO
18989431;;F;26;CHILENO;;Z;PROVIDENCIA                   ;METROPOLITANA;0;0;0;0;0;0;0;0;0;CLOSET CAJONERA NEW BELGICA M-398-NW;DORMITORIO
13108284;Soltero;F;46;CHILENO;;X;PROVIDENCIA                   ;METROPOLITANA;0;0;0;0;0;0;0;0;0;DUPLEX CE EVOLUTION BLACK 1P + 2 RESP + VEL ASTU;DORMITORIO
5131467;;M;76;CHILENO;;Silencioso;TALAGANTE                     ;METROPOLITANA;0;0;0;0;0;0;0;0;0;COLCHON ERGO T 2P;DORMITORIO
13817620;;M;42;CHILENO;;X;N/D;N/D;228980;2;1;2;1;228980;0;0;0;NTBK Inspiron 3505 Athlon 3050U/12GB/256 SSD/15P;COMPUTACION
17913046;;F;30;CHILENO;;Millenial;PROVIDENCIA                   ;METROPOLITANA;259970;3;3;0;0;0;3;3;259970;TAB Galaxy A7 Lite (8.7, 32GB, WIFI);COMPUTACION
11515235;Divorciado;F;52;CHILENO;;X;RENCA                         ;METROPOLITANA;158220;2;1;0;0;0;2;1;158220;NTBK BR11 Celeron N4500/4GB/64GB eMMC/11P;COMPUTACION
19447417;;M;25;CHILENO;;Z;HIJUELAS;VALPARAISO;876980;2;1;0;0;0;2;1;876980;NTBK L5i Ci7-10750H/16GB/128SSD+1TB/RTX2060 6GB;COMPUTACION
17495169;;F;32;CHILENO;;Millenial;SAN JAVIER                    ;MAULE;669940;6;5;0;0;0;6;5;669940;NTBK IP3 Ryzen 3-5300U/8GB/256GB SSD/14P FHD;COMPUTACION
25741629;;F;61;VENEZOLANO;;Extranjero;NUNOA                         ;METROPOLITANA;563970;3;2;2;1;233980;1;1;329990;NTBK Inspiron 3505 Athlon 3050U/12GB/256 SSD/15P;COMPUTACION
19786871;;F;24;CHILENO;;Z;PROVIDENCIA                   ;METROPOLITANA;409970;3;2;3;2;409970;0;0;0;NTBK D330 Celeron N4020/4GB/64GB/10P+OfficeHS;COMPUTACION
16733793;;F;34;CHILENO;;Millenial;VALLENAR;ATACAMA;835730;3;2;0;0;0;3;2;835730;NTBK 250 G8 Ci5-1135G7/8GB/256 SSD/15P/Win10Pro;COMPUTACION
15056007;Soltero;F;39;CHILENO;INGENIERO INFORMATICO;X;PROVIDENCIA                   ;METROPOLITANA;403980;2;1;2;1;403980;0;0;0;NTBK 250 G8 Ci5-1135G7/8GB/256 SSD/15P/Win10Pro;COMPUTACION
10532754;;M;50;CHILENO;;X;PROVIDENCIA                   ;METROPOLITANA;273980;2;1;2;1;273980;0;0;0;Galaxy Tab S6 Lite + Book Cover (10.4,128GB,Blue;COMPUTACION
13630077;;M;42;CHILENO;;X;TALAGANTE                     ;METROPOLITANA;504630;8;2;0;0;0;8;2;504630;NTBK 240 G8 Celeron N4020/4GB/500GB/14P;COMPUTACION
26079582;;M;42;EXTRANJERO - NO INFORMA NACIONALIDAD;;Extranjero;SAN MIGUEL;METROPOLITANA;103980;2;3;2;3;103980;0;0;0;NTBK 240G7 CelN4020 14 4GB/500 PC;COMPUTACION
21839521;;F;39;PERUANO;;Extranjero;PUENTE ALTO                   ;METROPOLITANA;264960;4;5;0;0;0;4;5;264960;Multifuncional EcoTank L3250 Wifi;COMPUTACION
9269023;;M;57;CHILENO;;Boomers;PROVIDENCIA                   ;METROPOLITANA;83980;2;1;2;1;83980;0;0;0;Impresora Monofuncional Laser 107w;COMPUTACION
15950037;;M;37;CHILENO;;Millenial;TALCAHUANO                    ;BIO BIO;35980;2;1;2;1;35980;0;0;0;365 Familia 6 usuarios Anual 6GQ-01604;COMPUTACION
9852489;;F;57;CHILENO;;Boomers;ARICA                         ;ARICA Y PARINACOTA;716960;5;3;0;0;0;5;3;716960;NTBK Aero 13-be0501la R5-5600U/8GB/512G/13P FHD;COMPUTACION
16232688;;M;36;CHILENO;;Millenial;"";"";813440;6;3;0;0;0;6;3;813440;Monitor Mi 23.8P Full HD;COMPUTACION
21336144;;M;36;CHILENO;;Millenial;NATALES                       ;MAGALLANES;1294949;6;4;2;2;379980;4;2;914969;NTBK IP3 Ryzen 3-5300U/8GB/256GB SSD/14P FHD;COMPUTACION
20089533;;M;23;CHILENO;;Z;"";"";1031850;6;2;0;0;0;6;2;1031850;NTBK FX506 Ci5-10300H/8GB/512GB SSD/GTX1650 4GB;COMPUTACION
11444668;;F;52;CHILENO;;X;N/D;N/D;811890;9;5;0;0;0;9;5;811890;Multifuncional EcoTank L3250 Wifi;COMPUTACION
15067201;;F;42;CHILENO;;X;QUILLOTA                      ;VALPARAISO;217000;3;2;0;0;0;3;2;217000;NTBK 240 G8 Celeron N4020/4GB/500GB/14P;COMPUTACION
20281807;;M;21;CHILENO;;Z;LA FLORIDA;METROPOLITANA;153980;2;1;2;1;153980;0;0;0;Monitor Gamer Redragon Jade 27P 165Hz Full HD;COMPUTACION
15618275;;M;39;CHILENO;;X;PROVIDENCIA                   ;METROPOLITANA;58980;2;1;2;1;58980;0;0;0;Multifuncional DeskJet Ink Advantage 3775 Wifi;COMPUTACION
5346744;;M;72;CHILENO;;Silencioso;RANCAGUA                      ;L.G.B.OÂ´HIGGINS;586850;4;3;2;1;485980;2;2;100870;NTBK 2en1 Ci5-1135G7/8GB/256GB SSD/13P FHD TOUCH;COMPUTACION
18986195;;M;26;CHILENO;;Z;PROVIDENCIA                   ;METROPOLITANA;175010;2;1;0;0;0;2;1;175010;NTBK Tecra A30-G Intel Celeron 5205U/ Ram 4GB/ 1;COMPUTACION
16983337;;F;33;CHILENO;;Millenial;PROVIDENCIA                   ;METROPOLITANA;169990;1;1;0;0;0;1;1;169990;NTBK 240 G8 Celeron N4020/4GB/500GB/14P;COMPUTACION
12109754;;M;48;CHILENO;;X;LA PINTANA                    ;METROPOLITANA;269990;1;1;0;0;0;1;1;269990;TAB S6 Lite (610) 4GB 64GB 10.4P PINK;COMPUTACION
5627428;;M;72;CHILENO;;Silencioso;VILLA ALEMANA                 ;VALPARAISO;318970;3;2;3;2;318970;0;0;0;Multifuncional EcoTank L3210;COMPUTACION
17023524;;M;33;CHILENO;;Millenial;"";"";749950;5;3;2;1;553980;3;2;195970;Multifuncional Smart Tank 515 Wifi;COMPUTACION
7186022;;M;68;CHILENO;;Silencioso;SAN FERNANDO                  ;L.G.B.OÂ´HIGGINS;179990;3;1;0;0;0;3;1;179990;TAB M8 QC 2GB 32GB 8P Gris;COMPUTACION
24648062;;F;47;BOLIVIANO;;Extranjero;ANTOFAGASTA                   ;ANTOFAGASTA;1433390;8;3;0;0;0;8;3;1433390;NTBK Aspire 3 Athlon 3020e/8GB/256GB SSD/14P;COMPUTACION
9921107;;F;43;CHILENO;;X;"";"";328980;2;1;0;0;0;2;1;328980;NTBK 15-ef1015la Ryzen 3-4300U/4GB/256GBSSD/15P;COMPUTACION
9553026;Casado;M;58;CHILENO;INGENIERO MECANICO;Boomers;RENCA                         ;METROPOLITANA;799990;1;1;1;1;799990;0;0;0;MBA 13.3 SLV/8C CPU/7C GPU/8GB/256GB-BES;COMPUTACION
8912300;;M;59;CHILENO;;Boomers;NATALES                       ;MAGALLANES;186550;3;2;0;0;0;3;2;186550;NTBK 240 G8 Celeron N4020/4GB/500GB/14P;COMPUTACION
17632212;Soltero;F;31;CHILENO;;Millenial;PROVIDENCIA                   ;METROPOLITANA;619990;1;1;1;1;619990;0;0;0;NTBK IP5 Ryzen 7-4700U/16GB/256GB SSD/15P FHD;COMPUTACION
23210664;Soltero;M;26;NO INFORMA NACIONALIDAD;;Extranjero;PROVIDENCIA                   ;N/D;683980;2;1;2;1;683980;0;0;0;NTBK GAMER GF66 Ci5-11400H/8GB/512GB/GTX1650 4GB;COMPUTACION
13851081;;F;42;CHILENO;;X;PUCHUNCAVI                    ;VALPARAISO;44990;1;1;1;1;44990;0;0;0;Multifuncional DeskJet Ink Advantage 2775 Wifi;COMPUTACION
8227727;;F;61;CHILENO;;Boomers;LOS ALAMOS                    ;BIO BIO;1032840;7;4;0;0;0;7;4;1032840;NTBK S145-14IIL I3 10/4G 128SSD/14HD;COMPUTACION
19179206;Soltero;F;26;CHILENO;;Z;CALERA                        ;VALPARAISO;49990;1;1;0;0;0;1;1;49990;Impresora Laser HL-1202 Monocromatica;COMPUTACION
6432742;;M;71;CHILENO;;Silencioso;PROVIDENCIA                   ;METROPOLITANA;374969;3;1;0;0;0;3;1;374969;Multifuncional DCPT520W Wifi;COMPUTACION
17188488;;M;33;CHILENO;;Millenial;N/D;N/D;39970;3;1;3;1;39970;0;0;0;Multifuncional DCPT520W Wifi;COMPUTACION
19603035;;F;25;CHILENO;;Z;SAN FERNANDO                  ;L.G.B.OÂ´HIGGINS;478000;6;3;4;2;372960;2;1;105040;Multifuncional Ecotank L6270 Wifi, Duplex y ADF;COMPUTACION
13747380;;F;41;CHILENO;;X;LA SERENA                     ;COQUIMBO;129990;1;1;0;0;0;1;1;129990;Tab M10 Plus FHD 4GB 64GB 10.3P platinum grey;COMPUTACION
17742487;Soltero;F;31;CHILENO;;Millenial;PROVIDENCIA                   ;METROPOLITANA;710980;2;1;2;1;710980;0;0;0;NTBK FX506 Ci5-10300H/8GB/512GB SSD/GTX1650 4GB;COMPUTACION
8723258;Casado;F;61;CHILENO;INGENIERO EN PREVENCION DE RIESGOS;Boomers;PROVIDENCIA                   ;METROPOLITANA;653980;2;1;2;1;653980;0;0;0;NTBK GAMER GF66 Ci5-11400H/8GB/512GB/GTX1650 4GB;COMPUTACION
21508598;;F;48;BOLIVIANO;;Extranjero;PROVIDENCIA                   ;METROPOLITANA;283980;2;1;2;1;283980;0;0;0;TAB S6 Lite (610) 4GB 64GB 10.4P PINK;COMPUTACION
14071895;;F;41;CHILENO;;X;LEBU                          ;BIO BIO;450930;7;4;0;0;0;7;4;450930;NTBK 240 G8 Celeron N4020/4GB/500GB/14P;COMPUTACION
17751208;Soltero;F;31;CHILENO;;Millenial;PROVIDENCIA                   ;METROPOLITANA;457790;4;2;2;1;228980;2;1;228810;Galaxy Tab A8 (10.5, 32GB, WIFI) Pink Gold;COMPUTACION
20342370;;M;30;CHILENO;;Millenial;N/D;N/D;666880;12;7;1;1;129990;11;6;536890;TINTA EPSON T504 CYAN BOTELLA C13T03N22A;COMPUTACION
17756626;Soltero;F;30;CHILENO;TRABAJADOR SOCIAL;Millenial;PROVIDENCIA                   ;METROPOLITANA;58980;2;3;0;2;0;2;1;58980;TABLET MLAB 7 MB4 PLUS 1+16GB RED;COMPUTACION
16049919;;M;37;CHILENO;;Millenial;N/D;N/D;403960;4;2;0;0;0;4;2;403960;NTBK 15-ef1015la Ryzen 3-4300U/4GB/256GBSSD/15P;COMPUTACION
17687258;;M;31;CHILENO;;Millenial;PROVIDENCIA                   ;METROPOLITANA;200960;4;1;4;1;200960;0;0;0;Impresora Laser HL-1202 Monocromatica;COMPUTACION
19569357;Soltero;M;25;CHILENO;;Silencioso;PROVIDENCIA                   ;METROPOLITANA;627960;4;2;4;2;627960;0;0;0;NTBK 2en1 Flex5 R5-4500U/8GB/256SSD/14P FHD+Pen;COMPUTACION
26328572;;F;35;CHILENO;;Extranjero;VALDIVIA                      ;LOS RIOS;556000;6;3;6;3;556000;0;0;0;NTBK Inspiron 3501 Ci3-1115G4/4GB/1TB/14P;COMPUTACION
17563148;;M;32;CHILENO;;Millenial;EL BOSQUE                     ;METROPOLITANA;259970;3;2;2;1;69980;1;1;189990;NTBK IP Chromebook Octacore/4GB/128GB/10P FHD;COMPUTACION
19656180;;F;33;CHILENO;;Millenial;"";"";146980;2;1;2;1;146980;0;0;0;NTBK Inspiron 3502 Celeron/4GB/128GB SSD/+O365;COMPUTACION
15304878;;F;45;CHILENO;;X;COIHAIQUE                     ;AYSEN;315970;3;2;0;0;0;3;2;315970;TAB Galaxy A7 Lite (8.7, 32GB, WIFI);COMPUTACION
18287729;;M;29;CHILENO;;Millenial;N/D;N/D;709990;1;1;0;0;0;1;1;709990;NTBK FX506 Ci5-10300H/8GB/512GB SSD/GTX1650 4GB;COMPUTACION
20310283;;F;22;CHILENO;;Z;PROVIDENCIA                   ;METROPOLITANA;104980;2;1;2;1;104980;0;0;0;NTBK BR11 Celeron N4500/4GB/64GB eMMC/11P;COMPUTACION
13312056;;F;44;CHILENO;;X;N/D;N/D;169990;1;1;1;1;169990;0;0;0;Multifuncional EcoTank L3250 Wifi;COMPUTACION
11287307;;F;53;CHILENO;;X;LINARES                       ;MAULE;1048451;6;2;0;0;0;6;2;1048451;NTBK FX506 Ci5-10300H/8GB/512GB SSD/GTX1650 4GB;COMPUTACION
11090338;;F;56;CHILENO;;Boomers;VILLARICA                     ;ARAUCANIA;264970;3;3;3;3;264970;0;0;0;NTBK 240 G8 Celeron N4020/4GB/500GB/14P;COMPUTACION
20222817;;M;22;CHILENO;;Z;QUILICURA;METROPOLITANA;203980;2;1;2;1;203980;0;0;0;Monitor Nitro QG1QG241Y 23,8P 165Hz Full HD;COMPUTACION
16490292;Soltero;M;35;CHILENO;;Silencioso;PROVIDENCIA                   ;METROPOLITANA;49990;1;1;1;1;49990;0;0;0;Multifuncional Pixma TR4522 Wifi;COMPUTACION
13965358;;M;41;CHILENO;;X;TEMUCO                        ;ARAUCANIA;254980;2;2;1;1;74990;1;1;179990;TAB M8 QC 2GB 32GB 8P Gris;COMPUTACION
16465108;;F;35;CHILENO;;Millenial;PROVIDENCIA                   ;METROPOLITANA;219970;3;1;3;1;219970;0;0;0;NTBK 240 G8 Celeron N4020/4GB/500GB/14P;COMPUTACION
13465695;;F;44;CHILENO;;X;N/D;N/D;509940;6;7;0;0;0;6;7;509940;NTBK 240 G8 Celeron N4020/4GB/500GB/14P;COMPUTACION
16595446;;F;35;CHILENO;;Millenial;N/D;N/D;74990;1;1;0;0;0;1;1;74990;TAB M8 QC 2GB 32GB 8P Gris;COMPUTACION
7493180;;F;68;CHILENO;;Silencioso;VALDIVIA                      ;LOS LAGOS;257360;3;2;0;0;0;3;2;257360;TAB MLAB 7 MB4 PLUS 3G 1+16GB WHITE 8762;COMPUTACION
16423414;;M;35;CHILENO;;Millenial;N/D;N/D;627960;4;2;4;2;627960;0;0;0;TAB S6 Lite (610) 4GB 64GB 10.4P DARK GREY;COMPUTACION
19346084;;F;26;CHILENO;;Z;LINARES;MAULE;169970;3;2;1;1;159990;2;1;9980;TINTA BOTELLA EPSON T664120 NEGRA SERIE L;COMPUTACION
16640572;Casado;F;35;CHILENO;;Millenial;PROVIDENCIA                   ;METROPOLITANA;149980;2;1;2;1;149980;0;0;0;NTBK Inspiron 3502 Celeron/4GB/128GB SSD/+O365;COMPUTACION
25674946;Soltero;M;30;VENEZOLANO;;Extranjero;PROVIDENCIA                   ;METROPOLITANA;833980;2;1;2;1;833980;0;0;0;MBA 13.3 SPG/8C CPU/7C GPU/8GB/256GB (MGN63BE/A);COMPUTACION
7202355;;M;67;CHILENO;;Boomers;CERRILLOS                     ;METROPOLITANA;329990;2;1;0;0;0;2;1;329990;NTBK 15-ef1015la Ryzen 3-4300U/4GB/256GBSSD/15P;COMPUTACION
10127603;;F;58;CHILENO;;Boomers;COLINA                        ;METROPOLITANA;257640;7;4;0;0;0;7;4;257640;TAB Galaxy A7 Lite (8.7, 32GB, WIFI);COMPUTACION
16183754;;M;36;CHILENO;;Millenial;PROVIDENCIA                   ;METROPOLITANA;179980;2;2;2;2;179980;0;0;0;NTBK BR11 Celeron N4500/4GB/64GB eMMC/11P;COMPUTACION
18851983;;F;28;CHILENO;;Millenial;PROVIDENCIA                   ;METROPOLITANA;132980;2;1;2;1;132980;0;0;0;NTBK XH02 Celeron 4GB/64GB eMMC/11P/T+W ingles;COMPUTACION
20011662;;M;23;CHILENO;;Millenial;PROVIDENCIA                   ;METROPOLITANA;51980;2;1;2;1;51980;0;0;0;TAB MLAB MBX 8 QUAD CORE 1G+16G 8716;COMPUTACION
10860856;;M;55;CHILENO;;Boomers;PROVIDENCIA                   ;METROPOLITANA;89990;1;1;1;1;89990;0;0;0;NTBK BR11 Celeron N4500/4GB/64GB eMMC/11P;COMPUTACION
26285941;;M;32;CHILENO;;Extranjero;LINARES                       ;MAULE;622720;8;5;0;0;0;8;5;622720;Monitor UltraGear 23.8P 144Hz Full HD IPS;COMPUTACION
15124503;;M;39;CHILENO;;X;RANCAGUA                      ;L.G.B.OÂ´HIGGINS;74990;1;1;0;0;0;1;1;74990;TAB M8 QC 2GB 32GB 8P Gris;COMPUTACION
16348496;Casado;M;35;CHILENO;TECNICO EN AUTOMATIZACION Y CONTROL INDUSTRIAL;Millenial;CORONEL                       ;BIO BIO;449990;1;1;1;1;449990;0;0;0;AIO IC A340 Core i3/4GB/1TB/24P Full HD;COMPUTACION
19131673;;M;26;CHILENO;;Millenial;N/D;N/D;389980;2;2;1;1;349990;1;1;39990;NTBK IP3 Ryzen 3-5300U/8GB/256GB SSD/14P FHD;COMPUTACION
17511508;;F;32;CHILENO;;Millenial;VILLA ALEMANA;VALPARAISO;34990;1;1;1;1;34990;0;0;0;TAB MLAB MBX 8 QUAD CORE 1G+16G 8716;COMPUTACION
18181278;;F;30;CHILENO;;Millenial;SAN VICENTE                   ;L.G.B.OÂ´HIGGINS;8990;1;1;1;1;8990;0;0;0;TINTA EPSON T504 NG BOTELLA C13T03N12A;COMPUTACION
16357827;Soltero;F;36;CHILENO;;Millenial;PROVIDENCIA                   ;METROPOLITANA;279980;3;2;3;2;279980;0;0;0;NTBK Herobook Celeron N4020/8GB/256SSD/14P FHD;COMPUTACION
13170603;;F;45;CHILENO;;X;QUELLON                       ;LOS LAGOS;679950;5;2;2;1;658980;3;1;20970;NTBK GAMER GF66 Ci5-11400H/8GB/512GB/GTX1650 4GB;COMPUTACION
10010201;;M;51;CHILENO;;X;COIHAIQUE                     ;AYSEN;494950;5;3;0;0;0;5;3;494950;NTBK 14-ck2091la i3-10110U 4GB 128GB 14 HD;COMPUTACION
8872482;;M;58;CHILENO;;Boomers;SAN FERNANDO                  ;L.G.B.OÂ´HIGGINS;531940;6;3;3;2;287970;3;1;243970;Galaxy Tab A8 (10.5, 32GB, WIFI) Gray;COMPUTACION
7745599;;M;61;CHILENO;;Boomers;PROVIDENCIA                   ;METROPOLITANA;149990;1;1;1;1;149990;0;0;0;Multifuncional Smart Tank 515 Wifi;COMPUTACION
15983003;Soltero;M;37;CHILENO;;Millenial;RENCA                         ;METROPOLITANA;136980;2;1;2;1;136980;0;0;0;NTBK S13A Celeron/6GB/128SSD/13P FHD/Tec-Ingles;COMPUTACION
18376435;Casado;M;29;CHILENO;;Millenial;RENGO;O HIGGINS;44990;1;1;1;1;44990;0;0;0;TAB MLAB MBX 8 QUAD CORE 1G+16G 8716;COMPUTACION
18355877;Soltero;M;29;CHILENO;ANALISTA DE SISTEMAS;Silencioso;PROVIDENCIA                   ;METROPOLITANA;133980;2;1;2;1;133980;0;0;0;Tab M10 FHD Plus LTE 10.3IN 2GB 32GB;COMPUTACION
19860716;;M;24;CHILENO;;Z;PROVIDENCIA                   ;METROPOLITANA;7990;1;1;1;1;7990;0;0;0;TINTA BOTELLA EPSON T664120 NEGRA SERIE L;COMPUTACION
26686058;;M;29;HAITIANO;;Extranjero;PROVIDENCIA                   ;METROPOLITANA;297920;9;3;2;1;38980;7;2;258940;TAB MLAB MBX 8 QUAD CORE 1G+16G 8716;COMPUTACION
17527813;;M;51;CHILENO;;X;PROVIDENCIA                   ;METROPOLITANA;137980;2;1;2;1;137980;0;0;0;NTBK BR11 Celeron N4500/4GB/64GB eMMC/11P;COMPUTACION
12399240;;M;49;CHILENO;;X;PETORCA                       ;VALPARAISO;208200;2;1;0;0;0;2;1;208200;Multifuncional DCPT520W Wifi;COMPUTACION
15885088;;F;38;CHILENO;;Millenial;VALLENAR;ATACAMA;589980;2;2;0;0;0;2;2;589980;NTBK 15-ef1015la Ryzen 3-4300U/4GB/256GBSSD/15P;COMPUTACION
20511072;;F;21;CHILENO;;Z;VILLARRICA;ARAUCANIA;159980;2;2;1;1;59990;1;1;99990;Multifuncional DeskJet Ink Advantage 2752 Wifi;COMPUTACION
9861579;;M;58;CHILENO;;Boomers;HUALPEN;BIO BIO;415320;6;3;0;0;0;6;3;415320;NTBK XH02 Celeron 4GB/64GB eMMC/11P/T+W ingles;COMPUTACION
19350724;Soltero;F;25;CHILENO;;Silencioso;PROVIDENCIA                   ;METROPOLITANA;31960;4;1;4;1;31960;0;0;0;TINTA BOTELLA EPSON T664120 NEGRA SERIE L;COMPUTACION
24465409;;M;30;PERUANO;;Extranjero;N/D;N/D;654150;7;3;0;0;0;7;3;654150;NTBK IP S145 AMD A4-9125/4GB/500GB/14P;COMPUTACION
13354682;;M;43;CHILENO;;X;RENCA                         ;METROPOLITANA;305980;2;1;2;1;305980;0;0;0;TAB P11 6G-128GB Case + KB + Pen + Wifi +Â  Slate;COMPUTACION
16251577;Soltero;M;36;CHILENO;INGENIERO EN ADMINISTRACION DE EMPRESAS;Silencioso;PROVIDENCIA                   ;METROPOLITANA;59990;2;1;2;1;59990;0;0;0;Multifuncional Pixma TR4522 Wifi;COMPUTACION
17894003;;F;33;CHILENO;;Millenial;LO PRADO                      ;METROPOLITANA;517960;4;2;0;0;0;4;2;517960;NTBK 15-ef1015la Ryzen 3-4300U/4GB/256GBSSD/15P;COMPUTACION
7356230;;F;70;CHILENO;;Silencioso;TALCAHUANO                    ;BIO BIO;203280;2;1;0;0;0;2;1;203280;Multifuncional EcoTank L3210;COMPUTACION
16349317;;F;36;CHILENO;;Millenial;ALTO HOSPICIO;TARAPACA;392199;4;2;0;0;0;4;2;392199;TAB Galaxy A7 Lite (8.7, 32GB, WIFI);COMPUTACION
10530115;;M;53;CHILENO;;X;PROVIDENCIA                   ;METROPOLITANA;319990;2;1;2;1;319990;0;0;0;TAB P11 6G-128GB Case + KB + Pen + Wifi +Â  Slate;COMPUTACION
20429099;;M;22;CHILENO;;Millenial;"";"";553970;3;1;3;1;553970;0;0;0;TAB Galaxy S7 FE (12.4, 64GB WIFI) BLACK;COMPUTACION
15216891;Casado;F;39;CHILENO;INGENIERO CIVIL INDUSTRIAL;Silencioso;PROVIDENCIA                   ;METROPOLITANA;64990;1;1;1;1;64990;0;0;0;Multifuncional Pixma TR4522 Wifi;COMPUTACION
17138708;;M;32;CHILENO;;Millenial;PROVIDENCIA                   ;METROPOLITANA;296980;2;1;2;1;296980;0;0;0;NTBK 15-ef1015la Ryzen 3-4300U/4GB/256GBSSD/15P;COMPUTACION
6286241;;M;72;CHILENO;;Silencioso;RENCA                         ;METROPOLITANA;53980;2;1;2;1;53980;0;0;0;Multifuncional DeskJet Ink Advantage 2775 Wifi;COMPUTACION
15011081;;M;40;CHILENO;;X;N/D;N/D;459990;1;1;0;0;0;1;1;459990;AIO IC A340 Core i3/4GB/1TB/24P Full HD;COMPUTACION
15223436;;F;39;CHILENO;;X;CHIGUAYANTE                   ;BIO BIO;1207660;5;2;5;2;1207660;0;0;0;NTBK FX506 Ci5-10300H/8GB/512GB SSD/GTX1650 4GB;COMPUTACION
8444961;;F;66;CHILENO;;Boomers;SANTA JUANA                   ;BIO BIO;1929920;11;5;0;0;0;11;5;1929920;Multifuncional Smart Tank 515 Wifi;COMPUTACION
17100556;;F;33;CHILENO;;Millenial;PROVIDENCIA                   ;METROPOLITANA;159990;1;1;0;0;0;1;1;159990;Multifuncional EcoTank L3210;COMPUTACION
16829286;;F;35;CHILENO;;Millenial;LOS LAGOS                     ;LOS LAGOS;700950;7;3;0;0;0;7;3;700950;NTBK IP1 AMD 3020e/4GB/64GB eMMC/14P;COMPUTACION
16913252;;M;33;CHILENO;;Millenial;PROVIDENCIA                   ;METROPOLITANA;178980;2;1;2;1;178980;0;0;0;Multifuncional EcoTank L3250 Wifi;COMPUTACION
12833775;;M;47;CHILENO;;X;ARICA                         ;TARAPACA;1712400;9;3;0;0;0;9;3;1712400;NTBK M3500 Ryzen 5 -5600H/8GB/512GB SSD/15P FHD;COMPUTACION
16631307;;F;35;CHILENO;;Millenial;PROVIDENCIA                   ;METROPOLITANA;557480;2;1;2;1;557480;0;0;0;NTBK 2en1 Ci5-1135G7/8GB/256GB SSD/13P FHD TOUCH;COMPUTACION
16571303;;F;35;CHILENO;;X;SAN BERNARDO;METROPOLITANA;144980;3;2;2;1;129990;1;1;14990;Tab M10 FHD Plus LTE 10.3IN 2GB 32GB;COMPUTACION
12184328;;M;50;CHILENO;;X;"";"";443960;4;2;4;2;443960;0;0;0;NTBK 15-ef1015la Ryzen 3-4300U/4GB/256GBSSD/15P;COMPUTACION
10705843;;F;56;CHILENO;;Boomers;PUENTE ALTO                   ;METROPOLITANA;474970;3;2;0;0;0;3;2;474970;NTBK D330 Celeron N4020/4GB/64GB/10P+OfficeHS;COMPUTACION
16363861;;F;36;CHILENO;;Millenial;COIHAIQUE                     ;AYSEN;147400;2;3;0;0;0;2;3;147400;TAB Galaxy A7 Lite (8.7, 32GB, WIFI);COMPUTACION
19049233;;M;26;CHILENO;;Z;LA LIGUA                      ;VALPARAISO;514980;2;2;0;0;0;2;2;514980;Multifuncional DCPT520W Wifi;COMPUTACION
9518145;;F;56;CHILENO;;Boomers;CATEMU                        ;VALPARAISO;289980;2;2;0;0;0;2;2;289980;Galaxy Tab A8 (10.5, 32GB, WIFI) Gray;COMPUTACION
26948155;;M;36;EXTRANJERO - NO INFORMA NACIONALIDAD;;Extranjero;N/D;N/D;508520;5;3;0;0;0;5;3;508520;TAB Galaxy A7 Lite (8.7, 32GB, WIFI + 4G);COMPUTACION
16460293;;M;35;CHILENO;;Millenial;N/D;N/D;247930;7;2;0;0;0;7;2;247930;TAB 7 MB4 Plus 4Core 1GB 16GB 7 Plata;COMPUTACION
19483747;Soltero;F;25;CHILENO;;Z;PROVIDENCIA                   ;METROPOLITANA;447960;4;2;4;2;447960;0;0;0;NTBK 15-ef1015la Ryzen 3-4300U/4GB/256GBSSD/15P;COMPUTACION
20345344;;M;21;CHILENO;;Z;PROVIDENCIA                   ;METROPOLITANA;24970;3;1;3;1;24970;0;0;0;TINTA EPSON T504 NG BOTELLA C13T03N12A;COMPUTACION
18055330;Soltero;F;29;CHILENO;;Millenial;PROVIDENCIA                   ;METROPOLITANA;399990;1;1;1;1;399990;0;0;0;NTBK IP3 R5-5500U 8GB/256GB SSD/14P FHD/T+W ingl;COMPUTACION
17178165;Casado;F;33;CHILENO;PROFESOR;Millenial;PROVIDENCIA                   ;METROPOLITANA;349990;1;1;1;1;349990;0;0;0;NTBK IP3 Ryzen 3-5300U/8GB/256GB SSD/14P FHD;COMPUTACION
13625327;Casado;M;42;CHILENO;;Silencioso;PROVIDENCIA                   ;METROPOLITANA;386980;2;1;2;1;386980;0;0;0;NTBK 15-eh0006la Ryzen 5-4500U/8GB/512GB/15P;COMPUTACION
15262903;;M;39;CHILENO;;X;N/D;N/D;1204010;6;4;0;0;0;6;4;1204010;Multifuncional EcoTank L3250 Wifi;COMPUTACION
15884501;;F;37;CHILENO;;Millenial;PUERTO MONTT;LOS LAGOS;169990;1;1;1;1;169990;0;0;0;NTBK D330 Celeron N4020/4GB/64GB/10P+OfficeHS;COMPUTACION
12982268;;F;45;CHILENO;;X;PROVIDENCIA                   ;METROPOLITANA;325980;2;1;2;1;325980;0;0;0;TAB P11 6G-128GB Case + KB + Pen + Wifi +Â  Slate;COMPUTACION
19619916;;M;24;CHILENO;;Z;QUILLOTA;VALPARAISO;269990;1;1;1;1;269990;0;0;0;NTBK 15-ef1015la Ryzen 3-4300U/4GB/256GBSSD/15P;COMPUTACION
16768328;Soltero;F;34;CHILENO;INGENIERO QUIMICO;Silencioso;PROVIDENCIA                   ;METROPOLITANA;119410;1;2;0;0;0;1;2;119410;TAB Galaxy A7 Lite (8.7, 32GB, WIFI + 4G);COMPUTACION
12897640;;M;47;CHILENO;;Millenial;"";"";295940;5;2;5;2;295940;0;0;0;NTBK IP3i Celeron N4020/4G/500GB/14P/Rojo;COMPUTACION
7802074;;F;65;CHILENO;;Boomers;ANGOL                         ;ARAUCANIA;159990;1;1;0;0;0;1;1;159990;Multifuncional EcoTank L3210;COMPUTACION
26484023;Soltero;F;48;EXTRANJERO - NO INFORMA NACIONALIDAD;;Extranjero;"";"";235970;3;2;3;2;235970;0;0;0;NTBK 15-dw1080la Celeron N4020/4GB/1TB/15P;COMPUTACION
16977567;;M;33;CHILENO;;Millenial;PROVIDENCIA                   ;METROPOLITANA;11980;2;1;2;1;11980;0;0;0;T544 DYE BLACK INK BOTTLE (65ml);COMPUTACION
26355659;;F;37;PERUANO;;Extranjero;N/D;N/D;484970;6;3;5;2;399980;1;1;84990;TAB Galaxy A7 Lite (8.7, 32GB, WIFI);COMPUTACION
14040251;;F;43;CHILENO;;X;RIO NEGRO                     ;LOS LAGOS;899260;6;1;0;0;0;6;1;899260;NTBK 15-ef1015la Ryzen 3-4300U/4GB/256GBSSD/15P;COMPUTACION
10339918;;M;48;CHILENO;;X;LA SERENA;COQUIMBO;107630;3;1;0;0;0;3;1;107630;Multifuncional XP-2101 wifi;COMPUTACION
17987878;Casado;F;30;CHILENO;;Millenial;PARRAL                        ;MAULE;150000;2;1;0;0;0;2;1;150000;Multifuncional EcoTank L3210;COMPUTACION
7053948;Viudo;M;69;CHILENO;;Silencioso;PROVIDENCIA                   ;METROPOLITANA;289990;1;1;1;1;289990;0;0;0;NTBK 15-ef1015la Ryzen 3-4300U/4GB/256GBSSD/15P;COMPUTACION
15198180;;M;39;CHILENO;;X;N/D;N/D;416530;5;3;0;0;0;5;3;416530;NTBK Aspire 3 Athlon 3020e/8GB/256GB SSD/14P;COMPUTACION
17885705;;F;30;CHILENO;;Millenial;TOCOPILLA                     ;ANTOFAGASTA;109990;1;1;0;0;0;1;1;109990;TAB Galaxy A7 Lite (8.7, 32GB, WIFI);COMPUTACION
19341289;Soltero;F;26;CHILENO;;Z;COLINA                        ;METROPOLITANA;606640;6;5;0;0;0;6;5;606640;NTBK 240 G8 Celeron N4020/4GB/500GB/14P;COMPUTACION
20546226;;F;22;CHILENO;;Z;ARICA                         ;ARICA Y PARINACOTA;179450;5;5;0;0;0;5;5;179450;TAB GAMER 7 QUAD CORE 2G+16G 8715;COMPUTACION
18564055;;F;29;CHILENO;;Millenial;VALPARAISO                    ;VALPARAISO;106980;2;1;2;1;106980;0;0;0;TAB Galaxy A7 Lite (8.7, 32GB, WIFI);COMPUTACION
14110249;;F;43;CHILENO;;X;ANTOFAGASTA                   ;ANTOFAGASTA;802420;9;5;2;1;122480;7;4;679940;Multifuncional EcoTank L3250 Wifi;COMPUTACION
19966425;;F;24;CHILENO;;Z;PROVIDENCIA                   ;METROPOLITANA;845960;4;2;1;1;89990;3;1;755970;TABLET GALAXY S7+ (T970) 256GB 12.4P Cooper;COMPUTACION
18000749;;M;30;CHILENO;;Silencioso;N/D;N/D;286970;3;2;2;1;186980;1;1;99990;TAB Galaxy A7 Lite (8.7, 32GB, WIFI);COMPUTACION
26178749;Soltero;M;44;VENEZOLANO;MEDICO CIRUJANO;Extranjero;PROVIDENCIA                   ;METROPOLITANA;1193970;3;2;2;1;203980;1;1;989990;NTBK Herobook Celeron N4020/8GB/256SSD/14P FHD;COMPUTACION
18539938;;M;29;CHILENO;;Silencioso;PROVIDENCIA                   ;METROPOLITANA;463960;4;2;4;2;463960;0;0;0;NTBK 15-dw1080la Celeron N4020/4GB/1TB/15P;COMPUTACION
8077840;;F;65;CHILENO;;Boomers;SAN CARLOS                    ;BIO BIO;129990;1;1;0;0;0;1;1;129990;TAB M8 QC 2GB 32GB 8P Gris;COMPUTACION
4973250;;F;79;CHILENO;;Silencioso;ARICA                         ;TARAPACA;393620;2;1;0;0;0;2;1;393620;NTBK X415 Core i3-10110U/4GB/256GB SSD/14P FHD;COMPUTACION
13109567;;F;46;CHILENO;;X;CORONEL                       ;BIO BIO;150000;2;1;0;0;0;2;1;150000;Multifuncional EcoTank L3210;COMPUTACION
19029539;;F;26;CHILENO;;Z;PUERTO MONTT                  ;LOS LAGOS;234970;3;3;1;1;179990;2;2;54980;NTBK D330 Celeron N4020/4GB/64GB/10P+OfficeHS;COMPUTACION
18806296;;F;27;CHILENO;;Z;CABRERO                       ;BIO BIO;379990;1;1;1;1;379990;0;0;0;NTBK IP3 Ryzen 3-3250U/8GB/1TB/15P;COMPUTACION
8724241;;F;64;CHILENO;;Boomers;SAN VICENTE                   ;L.G.B.OÂ´HIGGINS;259990;1;1;0;0;0;1;1;259990;Multifuncional EcoTank L4260 Wifi y Duplex;COMPUTACION
16123115;;F;37;CHILENO;;Silencioso;PROVIDENCIA                   ;METROPOLITANA;262960;4;2;4;2;262960;0;0;0;Multifuncional EcoTank L3250 Wifi;COMPUTACION
8936882;;F;61;CHILENO;;Boomers;MALLOA                        ;L.G.B.OÂ´HIGGINS;181790;3;2;0;0;0;3;2;181790;TAB Galaxy A7 Lite (8.7, 32GB, WIFI);COMPUTACION
18089817;;M;30;CHILENO;;Millenial;PROVIDENCIA                   ;METROPOLITANA;129990;2;1;2;1;129990;0;0;0;Multifuncional Ink Tank 315;COMPUTACION
5632861;Soltero;M;74;CHILENO;INGENIERO;Silencioso;RENCA                         ;METROPOLITANA;155790;3;1;0;0;0;3;1;155790;TAB Galaxy A7 Lite (8.7, 32GB, WIFI);COMPUTACION
9643520;;M;63;CHILENO;;Boomers;PUERTO MONTT                  ;LOS LAGOS;866140;4;2;0;0;0;4;2;866140;NTBK Aspire 3 Athlon 3020e/8GB/256GB SSD/14P;COMPUTACION
7686683;;M;63;CHILENO;;Boomers;"";"";402980;2;2;0;0;0;2;2;402980;NTBK IP3 Core i3-1115G4/4GB/512GB SSD/14P FHD;COMPUTACION
19145311;;F;26;CHILENO;;Z;N/D;N/D;199990;1;1;0;0;0;1;1;199990;Multifuncional EcoTank L3250 Wifi;COMPUTACION
17247115;;F;33;CHILENO;;Millenial;N/D;N/D;220830;3;2;2;1;125840;1;1;94990;TAB Galaxy A7 Lite (8.7, 32GB, WIFI);COMPUTACION
15165965;;M;44;CHILENO;;X;CHILLAN                       ;BIO BIO;329990;1;1;0;0;0;1;1;329990;NTBK 240 G8 Core i3-1005G1/4GB/1TB/14P;COMPUTACION
15003215;;F;40;CHILENO;;X;IQUIQUE                       ;TARAPACA;279990;1;1;0;0;0;1;1;279990;NTBK 240 G8 Celeron N4020/4GB/500GB/14P;COMPUTACION
14059696;;F;41;CHILENO;;Silencioso;PROVIDENCIA                   ;METROPOLITANA;167980;2;1;0;0;0;2;1;167980;Multifuncional EcoTank L3210;COMPUTACION
10814106;;M;54;CHILENO;;X;TOME                          ;BIO BIO;11990;1;1;0;0;0;1;1;11990;T544 DYE BLACK INK BOTTLE (65ml);COMPUTACION
12679933;;M;47;CHILENO;;X;EL QUISCO                     ;VALPARAISO;61980;2;1;0;0;0;2;1;61980;TAB MLAB MBX 8 QUAD CORE 1G+16G 8716;COMPUTACION
17757571;;M;32;CHILENO;;Millenial;LONGAVI                       ;MAULE;705931;8;6;0;0;0;8;6;705931;Multifuncional EcoTank L3210;COMPUTACION
9785001;Soltero;F;56;CHILENO;QUIMICO FARMACEUTICO;Boomers;PROVIDENCIA                   ;METROPOLITANA;919990;2;1;2;1;919990;0;0;0;Galaxy Tab S8 (11, 256GB, WIFI) Dark Gray;COMPUTACION
11288359;;F;53;CHILENO;;X;CAUQUENES                     ;MAULE;169980;2;2;0;0;0;2;2;169980;Multifuncional EcoTank L3210;COMPUTACION
20524453;;F;21;CHILENO;;Z;PROVIDENCIA                   ;METROPOLITANA;440980;2;1;2;1;440980;0;0;0;TAB Galaxy S7 FE (12.4, 128GB WIFI) LIGHT PINK;COMPUTACION
14130673;;F;44;CHILENO;;X;LA SERENA;COQUIMBO;179990;1;1;0;0;0;1;1;179990;NTBK 15-dw1080la Celeron N4020/4GB/1TB/15P;COMPUTACION
17530288;;F;31;CHILENO;;Millenial;CALAMA;ANTOFAGASTA;290980;2;1;2;1;290980;0;0;0;NTBK 15-ef1015la Ryzen 3-4300U/4GB/256GBSSD/15P;COMPUTACION
18391905;;F;31;CHILENO;;Millenial;PROVIDENCIA                   ;METROPOLITANA;257970;3;1;3;1;257970;0;0;0;MONITOR LS27F350FHLXZS 1920X1080 PLANO;COMPUTACION
16453072;;F;35;CHILENO;;Silencioso;PROVIDENCIA                   ;METROPOLITANA;438980;2;1;2;1;438980;0;0;0;TAB Galaxy S7 FE (12.4, 128GB WIFI) LIGHT PINK;COMPUTACION
17952296;;F;31;CHILENO;;Millenial;N/D;N/D;233980;2;1;2;1;233980;0;0;0;NTBK IP3i Celeron N4020/4G/500GB/14P/Rojo;COMPUTACION
12069523;Soltero;M;50;CHILENO;;X;CHILLAN VIEJO                 ;BIO BIO;180000;2;1;0;0;0;2;1;180000;Multifuncional EcoTank L3250 Wifi;COMPUTACION
8916112;;M;59;CHILENO;;Boomers;COIHAIQUE                     ;AYSEN;325960;4;2;0;0;0;4;2;325960;TAB Galaxy A7 Lite (8.7, 32GB, WIFI + 4G);COMPUTACION
9532243;;F;59;CHILENO;;Boomers;VINA DEL MAR                  ;VALPARAISO;179990;1;1;0;0;0;1;1;179990;Multifuncional EcoTank L3250 Wifi;COMPUTACION
24502200;Casado;F;46;PERUANO;;Extranjero;PROVIDENCIA                   ;METROPOLITANA;178950;6;2;0;0;0;6;2;178950;TINTA EPSON BOTELLA MAGENTA T664320 SERIE L;COMPUTACION
17022736;;M;33;CHILENO;;Millenial;CONCHALI                      ;METROPOLITANA;0;0;2;1;1;34990;-1;1;-34990;TAB 7 MB4 Plus 4Core 1GB 16GB 7 Negra;COMPUTACION
6717531;;F;69;CHILENO;;Silencioso;PROVIDENCIA                   ;METROPOLITANA;46990;1;1;0;0;0;1;1;46990;365 Personal Suscripcion Anual QQ2-01445;COMPUTACION
6790874;;F;69;CHILENO;;Silencioso;CHILLAN                       ;BIO BIO;159990;1;1;1;1;159990;0;0;0;Multifuncional EcoTank L3210;COMPUTACION
17561668;;F;31;CHILENO;;Millenial;COQUIMBO;COQUIMBO;191980;2;1;2;1;191980;0;0;0;NTBK 15-dw1080la Celeron N4020/4GB/1TB/15P;COMPUTACION
26466445;;M;42;HAITIANO;;Extranjero;SALAMANCA                     ;COQUIMBO;154980;2;1;0;0;0;2;1;154980;TAB Galaxy A7 Lite (8.7, 32GB, WIFI + 4G);COMPUTACION
13532631;;F;45;CHILENO;;X;VALLENAR;ATACAMA;159990;1;1;0;0;0;1;1;159990;Multifuncional EcoTank L3210;COMPUTACION
14393600;Casado;M;43;CHILENO;INGENIERO CIVIL;X;RENCA                         ;METROPOLITANA;170480;2;1;2;1;170480;0;0;0;Multifuncional EcoTank L3210;COMPUTACION
7861985;;F;63;CHILENO;;Boomers;TALCAHUANO                    ;BIO BIO;199980;2;2;0;0;0;2;2;199980;TAB Galaxy A7 Lite (8.7, 32GB, WIFI + 4G);COMPUTACION
17721635;;M;31;CHILENO;;Millenial;COQUIMBO;COQUIMBO;209980;2;1;2;1;209980;0;0;0;NTBK 240 G8 Celeron N4020/4GB/500GB/14P;COMPUTACION
11520643;;F;51;CHILENO;;X;TALCAHUANO                    ;BIO BIO;190980;2;1;0;0;0;2;1;190980;Multifuncional EcoTank L3210;COMPUTACION
20069987;;F;23;CHILENO;;Z;"";"";264170;2;1;0;0;0;2;1;264170;NTBK 15-dw1080la Celeron N4020/4GB/1TB/15P;COMPUTACION
18199492;;F;30;CHILENO;;Millenial;N/D;N/D;45000;2;1;0;0;0;2;1;45000;TAB MLAB MBX 8 QUAD CORE 1G+16G 8716;COMPUTACION
15193041;;M;40;CHILENO;;X;RENCA                         ;METROPOLITANA;319980;2;2;0;0;0;2;2;319980;Multifuncional EcoTank L3210;COMPUTACION
8714129;;F;59;CHILENO;;Boomers;RENCA                         ;METROPOLITANA;46990;1;1;1;1;46990;0;0;0;365 Familia 6 usuarios Anual 6GQ-01604;COMPUTACION
10699913;;F;55;CHILENO;;Boomers;EMPEDRADO                     ;MAULE;134990;1;1;0;0;0;1;1;134990;Multifuncional EcoTank L3210;COMPUTACION
13271446;;F;45;CHILENO;;Silencioso;PROVIDENCIA                   ;METROPOLITANA;403980;2;1;2;1;403980;0;0;0;TAB Galaxy S7 FE (12.4, 64GB WIFI) SILVER;COMPUTACION
14109131;;M;41;CHILENO;;X;OVALLE                        ;COQUIMBO;159990;1;1;0;0;0;1;1;159990;Multifuncional EcoTank L3210;COMPUTACION
17380967;;F;32;CHILENO;;Millenial;PROVIDENCIA                   ;METROPOLITANA;8990;1;1;1;1;8990;0;0;0;T544 DYE BLACK INK BOTTLE (65ml);COMPUTACION
18973298;;F;27;CHILENO;;Z;SAN ESTEBAN                   ;VALPARAISO;579980;2;1;0;0;0;2;1;579980;NTBK Aspire 5 Ci3-10110U/12GB/512GB SSD/15P FHD;COMPUTACION
16551432;;M;35;COLOMBIANO;;Millenial;TEMUCO                        ;ARAUCANIA;120000;2;1;0;0;0;2;1;120000;TAB Galaxy A7 Lite (8.7, 32GB, WIFI + 4G);COMPUTACION
14017399;Soltero;M;40;CHILENO;INGENIERO EN ADMINISTRACION DE EMPRESAS;X;PROVIDENCIA                   ;METROPOLITANA;175980;2;1;2;1;175980;0;0;0;Galaxy Tab A7 (10.4 ,32GB, WIFI + 4G) Dark Gray;COMPUTACION
8633897;;M;62;CHILENO;;Boomers;PENAFLOR                      ;METROPOLITANA;953910;9;4;0;0;0;9;4;953910;NTBK Aero 13-be0501la R5-5600U/8GB/512G/13P FHD;COMPUTACION
13750689;;F;42;CHILENO;;X;PROVIDENCIA                   ;METROPOLITANA;189990;1;1;0;0;0;1;1;189990;Multifuncional Ink Tank 415 Wifi;COMPUTACION
8356080;;M;53;CHILENO;;Silencioso;CALAMA                        ;ANTOFAGASTA;252980;2;1;0;0;0;2;1;252980;NTBK IP S145 AMD A4-9125/4GB/500GB/14P;COMPUTACION
25413539;;M;41;PERUANO;;Extranjero;N/D;N/D;1863870;13;7;2;1;183980;11;6;1679890;NTBK 348 G7 Core i5-10210U/4GB/1TB/14P;COMPUTACION
17231207;;F;32;CHILENO;;Millenial;CONCHALI                      ;METROPOLITANA;203980;2;1;2;1;203980;0;0;0;Multifuncional Smart tank 530 WiFi ADF;COMPUTACION
20294512;;F;22;CHILENO;;Silencioso;PROVIDENCIA                   ;METROPOLITANA;329960;4;1;0;0;0;4;1;329960;NTBK IP S145 AMD A4-9125/4GB/500GB/14P;COMPUTACION
19252149;;F;26;CHILENO;;Z;OLMUE                         ;VALPARAISO;383930;7;2;0;0;0;7;2;383930;NTBK 15-dw1080la Celeron N4020/4GB/1TB/15P;COMPUTACION
19332323;;F;26;CHILENO;;Z;N/D;N/D;235970;3;2;2;1;205980;1;1;29990;Multifuncional DCPT720DW Wifi, Duplex y ADF;COMPUTACION
25708292;;F;52;COLOMBIANO;;Extranjero;PEDRO AGUIRRE CERDA           ;METROPOLITANA;845950;5;3;0;0;0;5;3;845950;Multifuncional Ink Tank 415 Wifi;COMPUTACION
14187499;Soltero;M;40;CHILENO;;X;PROVIDENCIA                   ;METROPOLITANA;483970;3;1;3;1;483970;0;0;0;Multifuncional EcoTank L4260 Wifi y Duplex;COMPUTACION
9135350;;F;61;CHILENO;;Boomers;QUINTA DE TILCOCO             ;L.G.B.OÂ´HIGGINS;477950;5;3;0;0;0;5;3;477950;NTBK IP S145 AMD A4-9125/4GB/500GB/14P;COMPUTACION
13115757;;F;45;CHILENO;;X;TEMUCO                        ;ARAUCANIA;313960;4;2;4;2;313960;0;0;0;Multifuncional EcoTank L3250 Wifi;COMPUTACION
14101058;;F;45;CHILENO;;X;LINARES                       ;MAULE;149990;1;1;0;0;0;1;1;149990;Multifuncional EcoTank L3210;COMPUTACION
10160160;;F;43;CHILENO;;X;NOGALES                       ;VALPARAISO;194980;2;1;2;1;194980;0;0;0;NTBK IP S145 AMD A4-9125/4GB/500GB/14P;COMPUTACION
14000364;;F;40;CHILENO;;X;CASABLANCA                    ;VALPARAISO;165980;2;1;2;1;165980;0;0;0;Multifuncional EcoTank L3210;COMPUTACION
13977657;;M;40;CHILENO;;X;ILLAPEL                       ;COQUIMBO;829980;2;2;0;0;0;2;2;829980;NTBK 255 G8 Ryzen 5-5500U/8GB/256GB SSD/15P;COMPUTACION
15562121;;F;38;CHILENO;;X;LAUTARO;ARAUCANIA;69990;1;1;1;1;69990;0;0;0;TAB GAMER 7 QUAD CORE 2G+16G 8715;COMPUTACION
16974491;;M;33;CHILENO;;Millenial;SALAMANCA                     ;COQUIMBO;379560;3;2;0;0;0;3;2;379560;NTBK D330 Celeron N4020/4GB/64GB/10P+OfficeHS;COMPUTACION
14348007;;F;42;CHILENO;;X;PUENTE ALTO                   ;METROPOLITANA;233980;2;1;2;1;233980;0;0;0;NTBK IP3i Celeron N4020/4G/500GB/14P/Rojo;COMPUTACION
12743355;;F;47;CHILENO;;X;VILLARICA                     ;ARAUCANIA;629970;3;3;0;0;0;3;3;629970;TAB Galaxy A7 Lite (8.7, 32GB, WIFI);COMPUTACION
17311519;;M;32;CHILENO;;Millenial;"";"";163980;2;1;2;1;163980;0;0;0;Multifuncional EcoTank L3210;COMPUTACION
22567880;;F;38;PERUANO;;Extranjero;CONCHALI                      ;METROPOLITANA;59980;2;1;0;0;0;2;1;59980;TAB MLAB MBX 8 QUAD CORE 1G+16G 8716;COMPUTACION
20293355;;M;22;CHILENO;;Z;N/D;N/D;379990;1;1;0;0;0;1;1;379990;NTBK IP3 Ryzen 3-5300U/8GB/256GB SSD/14P FHD;COMPUTACION
13128254;;F;45;CHILENO;;X;TREGUACO                      ;BIO BIO;519960;4;1;0;0;0;4;1;519960;NTBK Aspire 3 Athlon 3020e/8GB/256GB SSD/14P;COMPUTACION
14106933;;F;41;CHILENO;;X;ALTO HOSPICIO;TARAPACA;1111440;6;1;6;1;1111440;0;0;0;NTBK GAMER N5 Ci5-10300H/16GB/512SSD/GTX1650 4GB;COMPUTACION
18855497;;F;27;CHILENO;;Millenial;N/D;N/D;159990;1;1;0;0;0;1;1;159990;Multifuncional EcoTank L3210;COMPUTACION
13965051;;M;41;CHILENO;;X;QUINTA NORMAL;METROPOLITANA;203980;2;1;2;1;203980;0;0;0;NTBK IP S145 AMD A4-9125/4GB/500GB/14P;COMPUTACION
14303296;;F;49;CHILENO;;X;VITACURA                      ;METROPOLITANA;159990;1;1;0;0;0;1;1;159990;Multifuncional EcoTank L3210;COMPUTACION
13208040;Soltero;M;44;CHILENO;INGENIERO DE EJECUCION EN INFORMATICA;X;PROVIDENCIA                   ;METROPOLITANA;1099990;1;1;0;0;0;1;1;1099990;NTBK VOSTRO Core i7-11370H/8GB/512SSD/MX450 2GB;COMPUTACION
12317366;;F;49;CHILENO;;X;CAUQUENES                     ;MAULE;149990;1;1;0;0;0;1;1;149990;Multifuncional EcoTank L3210;COMPUTACION
14335748;;M;44;CHILENO;;X;TALCA                         ;MAULE;121960;4;5;0;0;0;4;5;121960;TAB GAMER 7 QUAD CORE 2G+16G 8715;COMPUTACION
11244968;;M;54;CHILENO;;Boomers;LOS ALAMOS                    ;BIO BIO;179990;1;1;1;1;179990;0;0;0;NTBK 240 G8 Celeron N4020/4GB/500GB/14P;COMPUTACION
17104255;;F;33;CHILENO;;Millenial;PROVIDENCIA                   ;METROPOLITANA;0;0;2;1;1;31000;-1;1;-31000;TAB 7 MB4 Plus 4Core 1GB 16GB 7 Plata;COMPUTACION
19977495;;F;23;CHILENO;;Z;PROVIDENCIA                   ;METROPOLITANA;109990;1;1;1;1;109990;0;0;0;Multifuncional Pixma TR4522 Wifi;COMPUTACION
13115365;;F;45;CHILENO;;X;N/D;N/D;619970;4;3;0;0;0;4;3;619970;NTBK IP3i Celeron N4020/4G/500GB/14P/Rojo;COMPUTACION
19995192;;F;23;CHILENO;;Z;PROVIDENCIA                   ;METROPOLITANA;243980;2;1;2;1;243980;0;0;0;NTBK 14-cf2097la Pentium Gold 6405U/8GB/256GB/14;COMPUTACION
9807574;;M;57;CHILENO;;Boomers;ESTACION CENTRAL              ;METROPOLITANA;219990;1;1;0;0;0;1;1;219990;NTBK IP3i Celeron N4020/4G/500GB/14P/Rojo;COMPUTACION
6434422;;M;70;CHILENO;;Silencioso;TALCA                         ;MAULE;139990;1;1;0;0;0;1;1;139990;Multifuncional DCPT220;COMPUTACION
16125461;;M;36;CHILENO;;Millenial;PROVIDENCIA                   ;METROPOLITANA;40990;1;1;1;1;40990;0;0;0;Impresora Monofuncional Laser 107w;COMPUTACION
17638641;;M;31;CHILENO;;Millenial;"";"";459990;1;1;0;0;0;1;1;459990;NTBK IP3 Ryzen 3-5300U/8GB/256GB SSD/14P FHD;COMPUTACION
18030044;Soltero;M;30;CHILENO;;Silencioso;PROVIDENCIA                   ;METROPOLITANA;643970;3;2;2;1;503980;1;1;139990;NTBK 255 G8 Ryzen 5-5500U/8GB/256GB SSD/15P;COMPUTACION
11364881;;M;53;CHILENO;;X;RENCA                         ;METROPOLITANA;0;0;2;0;2;0;0;0;0;TAB 7 MB4 Plus 4Core 1GB 16GB 7 Negra;COMPUTACION
6834407;;F;67;CHILENO;;Boomers;ARICA                         ;ARICA Y PARINACOTA;1259970;3;2;0;0;0;3;2;1259970;MBP 13.3 SPG/8C CPU/8C GPU/8GB/512GB-BES;COMPUTACION
15461082;;F;39;CHILENO;;X;SAN RAMON;METROPOLITANA;39990;1;1;1;1;39990;0;0;0;TAB MLAB MBX 8 QUAD CORE 1G+16G 8716;COMPUTACION
16958450;;M;33;CHILENO;;Millenial;N/D;N/D;89990;1;1;0;0;0;1;1;89990;TAB M8 QC 2GB 32GB 8P Gris;COMPUTACION
16688303;;F;34;CHILENO;;Millenial;LA SERENA                     ;COQUIMBO;132540;2;1;2;1;132540;0;0;0;Multifuncional Ink Tank 315;COMPUTACION
16286294;;F;35;CHILENO;;Millenial;N/D;N/D;209640;2;1;2;1;209640;0;0;0;Multifuncional DCPT720DW Wifi, Duplex y ADF;COMPUTACION
17447965;;F;32;CHILENO;;Millenial;PROVIDENCIA                   ;METROPOLITANA;371730;6;3;2;1;85480;4;2;286250;TAB M8 4G QC 2GB 16GB 8P Gris;COMPUTACION
11479798;;F;53;CHILENO;;X;MAIPU                         ;METROPOLITANA;169980;2;1;0;0;0;2;1;169980;TAB Galaxy A 8 + S Pen (8, 32GB, WIFI);COMPUTACION
25815914;;M;29;VENEZOLANO;;Extranjero;SANTIAGO                      ;METROPOLITANA;233980;2;1;2;1;233980;0;0;0;NTBK 14-cf2097la Pentium Gold 6405U/8GB/256GB/14;COMPUTACION
19380283;Soltero;M;25;CHILENO;;Z;PROVIDENCIA                   ;METROPOLITANA;269990;1;1;1;1;269990;0;0;0;NTBK IP3 Core i3-1115G4/4GB/512GB SSD/14P FHD;COMPUTACION
7001472;;M;63;CHILENO;;Boomers;PROVIDENCIA                   ;METROPOLITANA;403980;2;1;2;1;403980;0;0;0;NTBK IP3 Ryzen 3-5300U/8GB/256GB SSD/14P FHD;COMPUTACION
16850666;;F;34;CHILENO;;Millenial;ANGOL                         ;ARAUCANIA;359990;1;1;0;0;0;1;1;359990;NTBK Aspire 3 Athlon 3020e/8GB/256GB SSD/14P;COMPUTACION
5813272;;F;73;CHILENO;;Silencioso;PAINE                         ;METROPOLITANA;333980;2;1;2;1;333980;0;0;0;NTBK 14-ck2091la i3-10110U 4GB 128GB 14 HD;COMPUTACION
13873156;;M;42;CHILENO;;X;COPIAPO                       ;ATACAMA;319990;1;1;0;0;0;1;1;319990;NTBK 240 G8 Core i3-1005G1/4GB/1TB/14P;COMPUTACION
13173634;;F;45;CHILENO;;X;ALTO HOSPICIO;TARAPACA;299990;1;1;0;0;0;1;1;299990;TAB S6 Lite (610) 4GB 64GB 10.4P DARK GREY;COMPUTACION
27312607;;M;37;CHILENO;;Extranjero;VALPARAISO;VALPARAISO;83970;3;1;0;0;0;3;1;83970;TABLET MLAB 7 MB4 PLUS 1+16GB RED;COMPUTACION
12483357;;F;48;CHILENO;;X;RENCA                         ;METROPOLITANA;353980;2;1;2;1;353980;0;0;0;NTBK ASUS Ci3/4GB/128GB Win+Tec Ingles+S/adap;COMPUTACION
16077565;;F;36;CHILENO;;Millenial;SAN FELIPE                    ;VALPARAISO;179990;1;1;1;1;179990;0;0;0;Galaxy Tab A7 (10.4 ,32GB, WIFI + 4G) Dark Gray;COMPUTACION
17410341;;F;32;CHILENO;;Millenial;N/D;N/D;109990;1;1;0;0;0;1;1;109990;Tablet HMS Matepad T10;COMPUTACION
12229884;;F;50;CHILENO;;X;VALPARAISO                    ;VALPARAISO;445970;3;1;0;0;0;3;1;445970;BUNDLE TAB P11 6GB 128SSD Slate Grey;COMPUTACION
13588257;;F;43;CHILENO;;X;MAIPU                         ;METROPOLITANA;139990;1;1;0;0;0;1;1;139990;TAB-X306X 10-INCH 4G+64G HD WIFI+4G LTE;COMPUTACION
12872730;;F;47;CHILENO;;X;SAN MIGUEL                    ;METROPOLITANA;223980;2;1;2;1;223980;0;0;0;NTBK IP3i Celeron N4020/4G/500GB/14P/Rojo;COMPUTACION
17799770;;F;31;CHILENO;;Millenial;ARICA                         ;TARAPACA;60980;2;1;0;0;0;2;1;60980;TAB MLAB MBX 8 QUAD CORE 1G+16G 8716;COMPUTACION
14196955;;F;41;CHILENO;;X;CANETE                        ;BIO BIO;179990;1;1;0;0;0;1;1;179990;Galaxy Tab A7 (10.4 ,32GB, WIFI) Dark Gray;COMPUTACION
12040385;;F;55;CHILENO;;Boomers;QUINTA NORMAL                 ;METROPOLITANA;203980;2;1;2;1;203980;0;0;0;Monitor Emerald 27P 165Hz Full HD;COMPUTACION
5498987;Casado;M;74;CHILENO;MEDICO CIRUJANO;Silencioso;PROVIDENCIA                   ;METROPOLITANA;403980;2;1;2;1;403980;0;0;0;NTBK IP3 Ryzen 3-3250U/8GB/1TB/15P;COMPUTACION
7985822;;F;65;CHILENO;;Boomers;SANTIAGO                      ;METROPOLITANA;229990;1;1;0;0;0;1;1;229990;NTBK 240 G8 Celeron N4020/4GB/500GB/14P;COMPUTACION
17752616;Soltero;F;31;CHILENO;;Millenial;PROVIDENCIA                   ;METROPOLITANA;229990;1;1;1;1;229990;0;0;0;NTBK 14-cf2097la Pentium Gold 6405U/8GB/256GB/14;COMPUTACION
17082592;Soltero;M;33;CHILENO;;Millenial;RENCA                         ;METROPOLITANA;818980;2;1;2;1;818980;0;0;0;TAB GALAXY S7+ (T970) 256GB 12.4P Negra;COMPUTACION
6912910;;F;69;CHILENO;;Silencioso;LOS ALAMOS                    ;BIO BIO;545228;6;2;0;0;0;6;2;545228;AIO 200 G4 Pentium J5040/4GB/1TB/21.5P Full HD;COMPUTACION
8045432;Casado;M;64;CHILENO;INGENIERO INDUSTRIAL;Boomers;RENCA                         ;METROPOLITANA;7990;1;1;0;0;0;1;1;7990;TINTA EPSON T504 NG BOTELLA C13T03N12A;COMPUTACION
14102083;;F;44;CHILENO;;X;ARICA                         ;ARICA Y PARINACOTA;849990;1;1;0;0;0;1;1;849990;NTBK GAMER N5 Ci5-10300H/16GB/512SSD/GTX1650 4GB;COMPUTACION
16878148;Casado;F;33;CHILENO;;Millenial;PROVIDENCIA                   ;METROPOLITANA;299990;1;1;1;1;299990;0;0;0;NTBK 240 G8 Core i3-1005G1/4GB/1TB/14P;COMPUTACION
16907227;;F;34;CHILENO;;Millenial;LITUECHE                      ;L.G.B.OÂ´HIGGINS;234970;3;2;0;0;0;3;2;234970;TAB M8 QC 2GB 32GB 8P Gris;COMPUTACION
13539449;;M;42;CHILENO;;X;N/D;N/D;539990;1;1;0;0;0;1;1;539990;NTBK G3 3500 Core i5-10300 8GB 256SSD 1650 4GB;COMPUTACION
17481366;;F;31;CHILENO;;Millenial;PROVIDENCIA                   ;METROPOLITANA;204980;2;1;2;1;204980;0;0;0;BUNDLE TAB P11 6GB 128SSD Slate Grey;COMPUTACION
15791407;;M;38;CHILENO;;Millenial;N/D;N/D;560940;6;2;0;0;0;6;2;560940;NTBK IP3i Celeron N4020/4G/500GB/14P/Rojo;COMPUTACION
14727827;Soltero;M;56;ARGENTINO;;Extranjero;SAN ANTONIO                   ;VALPARAISO;199990;1;1;0;0;0;1;1;199990;NTBK 240 G8 Celeron N4020/4GB/500GB/14P;COMPUTACION
7027794;;M;65;CHILENO;;Boomers;ANTOFAGASTA                   ;ANTOFAGASTA;261960;4;2;0;0;0;4;2;261960;TAB GAMER 7 QUAD CORE 2G+16G 8715;COMPUTACION
15522690;;F;40;CHILENO;;X;N/D;N/D;34990;1;1;1;1;34990;0;0;0;TAB 7 MB4 Plus 4Core 1GB 16GB 7 Plata;COMPUTACION
14420278;Casado;F;50;CHILENO;;X;LINARES                       ;MAULE;932970;3;2;0;0;0;3;2;932970;NTBK GAMER N5 Ci5-10300H/16GB/512SSD/GTX1650 4GB;COMPUTACION
18236800;;F;29;CHILENO;;Millenial;QUILPUE                       ;VALPARAISO;99980;2;1;0;0;0;2;1;99980;TAB MLAB MBX 8 QUAD CORE 1G+16G 8716;COMPUTACION
13575043;Casado;F;43;CHILENO;CONTADOR GENERAL;X;RENCA                         ;METROPOLITANA;79990;1;1;1;1;79990;0;0;0;TAB M8 QC 2GB 32GB 8P Gris;COMPUTACION
16976902;;F;33;CHILENO;;Millenial;N/D;N/D;315830;3;2;3;2;315830;0;0;0;TAB Galaxy A7 Lite (8.7, 64GB, WIFI);COMPUTACION
15472294;;F;40;CHILENO;;X;PROVIDENCIA                   ;METROPOLITANA;419980;2;1;2;1;419980;0;0;0;NTBK IP Chromebook Octacore/4GB/128GB/10P FHD;COMPUTACION
15560522;;F;39;CHILENO;;X;VINA DEL MAR                  ;VALPARAISO;220960;4;1;0;0;0;4;1;220960;Tab Yoga Smart;COMPUTACION
8905945;;M;61;CHILENO;;Boomers;TALCA                         ;MAULE;138980;2;1;0;0;0;2;1;138980;TAB M8 QC 2GB 32GB 8P Gris;COMPUTACION
16772671;;M;34;CHILENO;;Millenial;PROVIDENCIA                   ;METROPOLITANA;48980;2;2;1;1;34990;1;1;13990;TABLET MLAB 7 MB4 PLUS 1+16GB RED;COMPUTACION
19538447;;F;25;CHILENO;;Z;N/D;N/D;45990;1;1;1;1;45990;0;0;0;TAB MLAB MBX 8 QUAD CORE 1G+16G 8716;COMPUTACION
18822338;;M;28;CHILENO;;Millenial;OVALLE                        ;COQUIMBO;225980;2;1;0;0;0;2;1;225980;NTBK HT14 Celeron N4020 4GB/128GB SSD/14P;COMPUTACION
18626069;Soltero;F;28;CHILENO;;Millenial;PROVIDENCIA                   ;METROPOLITANA;303980;2;1;2;1;303980;0;0;0;TAB P11 6GB128SG Pen Slate Grey;COMPUTACION
12796812;;M;47;CHILENO;;X;CHIGUAYANTE                   ;BIO BIO;363220;4;1;0;0;0;4;1;363220;NTBK 14-cf2097la Pentium Gold 6405U/8GB/256GB/14;COMPUTACION
20225146;;M;22;CHILENO;;Z;LA PINTANA                    ;METROPOLITANA;45990;1;1;0;0;0;1;1;45990;TAB MLAB MBX 8 QUAD CORE 1G+16G 8716;COMPUTACION
9481692;;M;59;CHILENO;;Millenial;N/D;N/D;303980;2;1;2;1;303980;0;0;0;TAB P11 6GB128SG Pen Slate Grey;COMPUTACION
17071525;;F;33;CHILENO;;Millenial;PROVIDENCIA                   ;METROPOLITANA;79980;3;1;3;1;79980;0;0;0;TAB 7 MB4 Plus 4Core 1GB 16GB 7 Plata;COMPUTACION
21441137;;M;28;CHILENO;;Millenial;N/D;N/D;136000;1;1;1;1;136000;0;0;0;TAB-X306X 10-INCH 4G+64G HD WIFI+4G LTE;COMPUTACION
12268547;;F;50;CHILENO;;X;RENCA                         ;METROPOLITANA;318540;2;1;2;1;318540;0;0;0;TAB P11 6GB128SG Pen Slate Grey;COMPUTACION
17001563;;F;34;CHILENO;;Millenial;LICANTEN                      ;MAULE;34990;1;1;1;1;34990;0;0;0;TABLET MLAB 7 MB4 PLUS 1+16GB RED;COMPUTACION
15432538;;F;40;CHILENO;;X;PROVIDENCIA                   ;METROPOLITANA;223980;2;1;2;1;223980;0;0;0;MULTIFUNCIONAL ECOTANK L5190 Wifi/ Fax;COMPUTACION
17855203;;M;30;CHILENO;;Millenial;PROVIDENCIA                   ;METROPOLITANA;299990;1;1;1;1;299990;0;0;0;NTBK 240 G8 Core i3-1005G1/4GB/1TB/14P;COMPUTACION
8640768;;M;50;CHILENO;;X;VILLARICA                     ;ARAUCANIA;119990;1;1;0;0;0;1;1;119990;Monitor 22 FHD 75Hz HDMI VGA/Flat IPS/Black;COMPUTACION
25989782;;F;30;HAITIANO;;Extranjero;MELIPILLA                     ;METROPOLITANA;228620;2;1;0;0;0;2;1;228620;TAB-X306X 10-INCH 4G+64G HD WIFI+4G LTE;COMPUTACION
11516925;;M;51;CHILENO;;X;SAN FELIPE;VALPARAISO;229990;1;1;1;1;229990;0;0;0;NTBK IP Chromebook Octacore/4GB/128GB/10P FHD;COMPUTACION
16552210;;F;34;CHILENO;;Millenial;PROVIDENCIA                   ;METROPOLITANA;20980;2;1;2;1;20980;0;0;0;TINTA 664 NEGRA;COMPUTACION
15908323;Casado;F;37;CHILENO;PROFESOR;Millenial;PROVIDENCIA                   ;METROPOLITANA;147540;2;1;2;1;147540;0;0;0;Galaxy Tab A7 (10.4 ,32GB, WIFI) Dark Gray;COMPUTACION
15724629;;M;38;CHILENO;;Millenial;N/D;N/D;239990;2;1;2;1;239990;0;0;0;TAB S6 Lite (610) 4GB 64GB 10.4P BLUE;COMPUTACION
26935595;;F;23;CHILENO;;Extranjero;N/D;N/D;94990;1;1;0;0;0;1;1;94990;TAB Galaxy Tab A 8 4Core 2GB 32GB 8 Gris;COMPUTACION
8562992;;M;64;CHILENO;;Boomers;ANGOL                         ;ARAUCANIA;419990;1;1;0;0;0;1;1;419990;NTBK IP3 Athlon 3050U/8GB/1TB/14P;COMPUTACION
13467762;;F;43;CHILENO;;X;N/D;N/D;249990;1;1;1;1;249990;0;0;0;NTBK 240 G8 Celeron N4020/4GB/500GB/14P;COMPUTACION
18683260;;F;27;CHILENO;;Millenial;PROVIDENCIA                   ;METROPOLITANA;7990;1;1;0;0;0;1;1;7990;TINTA BOTELLA EPSON T664120 NEGRA SERIE L;COMPUTACION
8851137;;F;58;CHILENO;;Boomers;LA LIGUA                      ;VALPARAISO;309990;4;1;0;0;0;4;1;309990;NTBK 240 G8 Celeron N4020/4GB/500GB/14P;COMPUTACION
10188408;;M;57;CHILENO;;Boomers;PENALOLEN                     ;METROPOLITANA;583980;2;1;2;1;583980;0;0;0;NTBK 14-dq2028la Ci5-1135G7/8GB256GB+16GB/FHD;COMPUTACION
9222061;;F;56;CHILENO;;Boomers;CHANARAL                      ;ATACAMA;298670;2;1;0;0;0;2;1;298670;NTBK IP1 AMD 3020e/4GB/64GB eMMC/14P;COMPUTACION
16391303;;F;36;CHILENO;;Millenial;COIHUECO;BIO-BIO;57830;3;2;2;1;45840;1;1;11990;TAB 7 MB4 Plus 4Core 1GB 16GB 7 Negra;COMPUTACION
7161550;;F;70;CHILENO;;Silencioso;PENAFLOR                      ;METROPOLITANA;122470;2;1;0;0;0;2;1;122470;TAB M8 QC 2GB 32GB 8P Gris;COMPUTACION
16453890;;M;36;CHILENO;;Millenial;TALCA                         ;MAULE;109990;1;1;1;1;109990;0;0;0;TAB Galaxy A7 Lite (8.7, 32GB, WIFI);COMPUTACION
11374203;;M;53;CHILENO;;X;SAN JAVIER                    ;MAULE;303972;3;2;0;0;0;3;2;303972;NTBK 240 G8 Celeron N4020/4GB/500GB/14P;COMPUTACION
16346875;;F;35;CHILENO;;Millenial;PROVIDENCIA                   ;METROPOLITANA;368970;3;1;3;1;368970;0;0;0;NTBK 240 G8 Core i3-1005G1/4GB/1TB/14P;COMPUTACION
18533845;;M;28;CHILENO;;Millenial;PROVIDENCIA                   ;METROPOLITANA;1053980;2;1;2;1;1053980;0;0;0;MBP 13.3 SPG/8C CPU/8C GPU/8GB/512GB (MYD92CI/A);COMPUTACION
7291680;;F;68;CHILENO;;Boomers;ARICA                         ;ARICA Y PARINACOTA;377870;2;1;0;0;0;2;1;377870;NTBK IP3 Athlon 3050U/8GB/1TB/14P;COMPUTACION
16809719;Casado;M;34;CHILENO;;Millenial;PROVIDENCIA                   ;METROPOLITANA;133980;2;1;2;1;133980;0;0;0;Galaxy Tab A7 (10.4 ,32GB, WIFI) Dark Gray;COMPUTACION
14033179;;F;40;CHILENO;;X;PROVIDENCIA                   ;METROPOLITANA;116980;2;1;2;1;116980;0;0;0;Monitor L24e-30 (C20238FL0) 23.8inch-HDMI;COMPUTACION
6679349;;F;69;CHILENO;;Silencioso;PROVIDENCIA                   ;METROPOLITANA;161200;2;1;0;0;0;2;1;161200;Tab M10 HD 2G-32GB 10.1 Iron grey WiFi;COMPUTACION
20175143;;F;22;CHILENO;;Silencioso;"";"";169990;1;1;1;1;169990;0;0;0;Tablet Matepad 10.4;COMPUTACION
8039426;;M;60;CHILENO;;Boomers;BUIN                          ;METROPOLITANA;619990;1;1;0;0;0;1;1;619990;NTBK M14 Ryzen 5-5500U 8GB/256GB SSD/14P FHD;COMPUTACION
16694352;;M;34;CHILENO;;Millenial;PROVIDENCIA                   ;METROPOLITANA;89990;2;1;2;1;89990;0;0;0;TAB Galaxy A7 Lite (8.7, 32GB, WIFI);COMPUTACION
19799223;;F;24;CHILENO;;Silencioso;PROVIDENCIA                   ;METROPOLITANA;180220;2;1;0;0;0;2;1;180220;Galaxy Tab A7 (10.4 ,32GB, WIFI) Dark Gray;COMPUTACION
18376116;;M;29;CHILENO;;Millenial;PROVIDENCIA                   ;METROPOLITANA;219530;3;2;3;2;219530;0;0;0;Multifuncional DCPT520W Wifi;COMPUTACION
15812692;;F;38;CHILENO;;Millenial;N/D;N/D;179640;2;1;2;1;179640;0;0;0;IMPRESORA MONOCR B215V-DNI;COMPUTACION
19767017;;F;24;CHILENO;;Z;N/D;N/D;136970;4;3;0;0;0;4;3;136970;Tab M10 HD 2G-32GB 10.1 Iron grey WiFi;COMPUTACION
19666398;;M;25;CHILENO;;Silencioso;PROVIDENCIA                   ;METROPOLITANA;129990;1;1;1;1;129990;0;0;0;Galaxy Tab A7 (10.4 ,32GB, WIFI) Dark Gray;COMPUTACION
19133942;Soltero;M;27;CHILENO;;Z;PROVIDENCIA                   ;METROPOLITANA;629990;2;1;2;1;629990;0;0;0;NTBK Gaming 3 Ryzen 5 4600H 8GB 512SSD G1650 4GB;COMPUTACION
18550238;;F;27;CHILENO;;Z;PROVIDENCIA                   ;METROPOLITANA;133980;2;1;2;1;133980;0;0;0;Galaxy Tab A7 (10.4 ,32GB, WIFI) Dark Gray;COMPUTACION
13247406;;M;46;CHILENO;;X;RENCA                         ;METROPOLITANA;93980;2;1;2;1;93980;0;0;0;TAB Galaxy A7 Lite (8.7, 32GB, WIFI);COMPUTACION
7462407;;F;78;CHILENO;;Silencioso;TRAIGUEN                      ;ARAUCANIA;397870;2;1;0;0;0;2;1;397870;NTBK 240 G8 Core i3-1005G1/4GB/1TB/14P;COMPUTACION
25313539;;M;42;ECUATORIANO;;Extranjero;INDEPENDENCIA                 ;METROPOLITANA;89990;2;1;2;1;89990;0;0;0;MATEPAD T10 KIDS;COMPUTACION
17470953;;F;32;CHILENO;;Millenial;CHIMBARONGO                   ;L.G.B.OÂ´HIGGINS;119990;1;1;1;1;119990;0;0;0;TAB Galaxy Tab A+SPen 8Core 3GB 32GB 8 Gris;COMPUTACION
19093922;Soltero;F;27;CHILENO;TECNICO DE NIVEL SUPERIOR EN ENFERMERIA;Z;PROVIDENCIA                   ;METROPOLITANA;326000;1;1;1;1;326000;0;0;0;NTBK IP3 Athlon 3050U/8GB/1TB/14P;COMPUTACION
7778673;;M;63;CHILENO;;Boomers;RENCA                         ;METROPOLITANA;158980;2;1;2;1;158980;0;0;0;Galaxy Tab A7 (10.4 ,64GB, WIFI) Dark Gray;COMPUTACION
17649039;;M;32;CHILENO;;Millenial;ANTOFAGASTA                   ;ANTOFAGASTA;178090;3;1;0;0;0;3;1;178090;TAB Galaxy Tab A+SPen 8Core 3GB 32GB 8 Gris;COMPUTACION
17451122;;F;32;CHILENO;;Millenial;LAJA                          ;BIO BIO;501680;3;1;3;1;501680;0;0;0;NTBK 348G7 i3-10110U 14 4GB/1T PC WHOME;COMPUTACION
13450856;;F;44;CHILENO;;X;PROVIDENCIA                   ;METROPOLITANA;449990;2;1;2;1;449990;0;0;0;NTBK CoreBook X i5-8259U/ 8GB/ 512GB SSD/ 14/ W1;COMPUTACION
16911749;;M;33;CHILENO;;Millenial;PROVIDENCIA                   ;METROPOLITANA;473980;2;1;2;1;473980;0;0;0;TAB Galaxy S7 FE (12.4, 64GB WIFI) LIGHT PINK;COMPUTACION
17132633;;F;33;CHILENO;;Silencioso;PROVIDENCIA                   ;METROPOLITANA;169640;2;1;2;1;169640;0;0;0;Multifuncional DCPT720DW Wifi, Duplex y ADF;COMPUTACION
18891633;;F;27;CHILENO;;Millenial;PROVIDENCIA                   ;METROPOLITANA;673070;2;1;0;0;0;2;1;673070;NTBK Gaming 3 Ryzen 5 4600H 8GB 512SSD G1650 4GB;COMPUTACION
19842213;;F;24;CHILENO;;Silencioso;PROVIDENCIA                   ;METROPOLITANA;53980;2;1;2;1;53980;0;0;0;Impresora Monofuncional Laser 107w;COMPUTACION
4819198;;M;73;CHILENO;;Silencioso;ESTACION CENTRAL              ;METROPOLITANA;613360;3;2;0;0;0;3;2;613360;NTBK 15-cw1021la Ryzen 3-3300U 12GB 256SSD 15P;COMPUTACION
19243170;;M;26;CHILENO;;Silencioso;PROVIDENCIA                   ;METROPOLITANA;524980;2;1;2;1;524980;0;0;0;NTBK M14 Ryzen 5-5500U 8GB/256GB SSD/14P FHD;COMPUTACION
18499320;;F;28;CHILENO;;Silencioso;PROVIDENCIA                   ;METROPOLITANA;349990;2;1;2;1;349990;0;0;0;NTBK 240 G8 Core i3-1005G1/4GB/1TB/14P;COMPUTACION
18360548;Casado;M;29;CHILENO;;Silencioso;PROVIDENCIA                   ;METROPOLITANA;263970;3;1;3;1;263970;0;0;0;Galaxy Tab A7 (10.4 ,32GB, WIFI) Dark Gray;COMPUTACION
8101898;;M;59;CHILENO;;Silencioso;PROVIDENCIA                   ;METROPOLITANA;159990;1;1;0;0;0;1;1;159990;MULTIFUNCIONAL ECOTANK L3150 Wifi;COMPUTACION
14199602;Casado;M;40;CHILENO;;X;PROVIDENCIA                   ;METROPOLITANA;1295920;5;1;5;1;1295920;0;0;0;NTBK S145-14IIL I3 10/4G 128SSD/14HD;COMPUTACION
23481196;Soltero;F;48;PERUANO;;Extranjero;PROVIDENCIA                   ;METROPOLITANA;496810;8;3;0;0;0;8;3;496810;NTBK 240 G8 Core i3-1005G1/4GB/1TB/14P;COMPUTACION
20294721;;M;22;CHILENO;;Silencioso;PROVIDENCIA                   ;METROPOLITANA;1071480;2;1;2;1;1071480;0;0;0;NTBK Legion 5 R7 16GB 1TB 128SSD 6V W10H;COMPUTACION
10458946;;F;58;CHILENO;;Boomers;PENCO                         ;BIO BIO;816370;2;1;0;0;0;2;1;816370;NTBK 15-dk1028la Ci5-10300H/8GB/256SSD/1050 3GB;COMPUTACION
15565404;;M;38;CHILENO;;X;TALCA                         ;MAULE;297980;2;2;0;0;0;2;2;297980;NTBK 240G7 CelN4020 14 4GB/500 PC;COMPUTACION
13208203;;M;44;CHILENO;;X;PROVIDENCIA                   ;METROPOLITANA;359990;1;1;0;0;0;1;1;359990;NTBK 240 G8 Core i3-1005G1/4GB/1TB/14P;COMPUTACION
18839541;;F;28;CHILENO;;Silencioso;PROVIDENCIA                   ;METROPOLITANA;11980;2;1;2;1;11980;0;0;0;TINTA BOTELLA CYAN BT5001C;COMPUTACION
14375779;;F;47;CHILENO;;X;SAN FERNANDO                  ;L.G.B.OÂ´HIGGINS;379990;1;3;0;0;0;1;3;379990;NTBK 14-cf2051la i3-10110U 4GB 256GB+16GB 14 HD;COMPUTACION
7094109;;F;70;CHILENO;;Silencioso;LEBU                          ;BIO BIO;289140;2;1;0;0;0;2;1;289140;MULTIFUNCIONAL ECOTANK L3150 Wifi;COMPUTACION
6796805;;F;70;CHILENO;;Silencioso;MAIPU                         ;METROPOLITANA;127349;3;1;0;0;0;3;1;127349;Tab M10 HD 2G-32GB 10.1 Iron grey WiFi;COMPUTACION
7338855;;F;69;CHILENO;;Silencioso;CONCEPCION                    ;BIO BIO;290450;3;2;0;0;0;3;2;290450;Galaxy Tab A7 (10.4 ,32GB, WIFI + 4G) Dark Gray;COMPUTACION
18321754;;M;29;CHILENO;;Millenial;N/D;N/D;655840;2;1;2;1;655840;0;0;0;PC ERICE Serie IRX560BSB;COMPUTACION
18923139;;F;27;CHILENO;;Millenial;COQUIMBO                      ;COQUIMBO;142470;2;1;0;0;0;2;1;142470;Tab M10 HD 2G-32GB 10.1 Iron grey WiFi;COMPUTACION
19576418;;F;24;CHILENO;;Millenial;"";"";179990;1;1;0;0;0;1;1;179990;TAB Galaxy A7 Lite (8.7, 32GB, WIFI + 4G);COMPUTACION
14523581;;F;46;CHILENO;;X;N/D;N/D;119990;1;1;1;1;119990;0;0;0;TAB Galaxy A 8 + S Pen (8, 32GB, WIFI);COMPUTACION
11633440;;F;52;CHILENO;;X;LA FLORIDA                    ;METROPOLITANA;703980;2;1;2;1;703980;0;0;0;NTBK Gaming 3 Ryzen 5 4600H 8GB 512SSD G1650 4GB;COMPUTACION
12650577;;F;47;CHILENO;;X;INDEPENDENCIA                 ;METROPOLITANA;803970;4;2;2;1;703980;2;1;99990;NTBK Gaming 3 Ryzen 5 4600H 8GB 512SSD G1650 4GB;COMPUTACION
17495757;;F;32;CHILENO;;Millenial;TALCA                         ;MAULE;119990;1;1;0;0;0;1;1;119990;TAB Galaxy A 8 + S Pen (8, 32GB, WIFI);COMPUTACION
15106773;;M;40;CHILENO;;X;GRANEROS                      ;L.G.B.OÂ´HIGGINS;0;0;2;0;0;0;0;2;0;NTBK 240 G8 Core i3-1005G1/4GB/1TB/14P;COMPUTACION
15935899;;F;37;CHILENO;;Millenial;MAIPU                         ;METROPOLITANA;0;0;0;0;0;0;0;0;0;IMPRESORA LASER PASHER 3020;COMPUTACION
17364209;;M;32;CHILENO;;Millenial;TEMUCO                        ;ARAUCANIA;0;0;0;0;0;0;0;0;0;TAB Galaxy Tab A+SPen 8Core 3GB 32GB 8 Gris;COMPUTACION
10544784;;F;55;CHILENO;;Boomers;N/D;N/D;0;0;0;0;0;0;0;0;0;Tab Yoga Smart;COMPUTACION
20387471;;M;22;CHILENO;;Z;MELIPILLA                     ;METROPOLITANA;0;0;0;0;0;0;0;0;0;NTBK GemiBook Celeron/12GB/256GB/2K/Tec-Ingles;COMPUTACION
10671103;Soltero;F;56;CHILENO;PROFESOR;Boomers;RENCA                         ;METROPOLITANA;0;0;0;0;0;0;0;0;0;IMPRESORA LASER PASHER 3020;COMPUTACION
13989634;;M;41;CHILENO;;X;N/D;N/D;0;0;0;0;0;0;0;0;0;NTBK 348G7 i3-10110U 14 4GB/1T PC WHOME;COMPUTACION
6052774;;M;70;CHILENO;;Silencioso;N/D;N/D;0;0;0;0;0;0;0;0;0;NTBK 240 G8 Core i3-1005G1/4GB/1TB/14P;COMPUTACION
10903260;;F;55;CHILENO;;Boomers;TEMUCO                        ;ARAUCANIA;0;0;0;0;0;0;0;0;0;NTBK 240G7 CelN4020 14 4GB/500 PC;COMPUTACION
12641428;;F;47;CHILENO;;X;PROVIDENCIA                   ;METROPOLITANA;0;0;0;0;0;0;0;0;0;NTBK 240 G8 Core i3-1005G1/4GB/1TB/14P;COMPUTACION
12735679;;F;47;CHILENO;;X;COLLIPULLI                    ;ARAUCANIA;0;0;0;0;0;0;0;0;0;NTBK 348G7 i3-10110U 14 4GB/1T PC WHOME;COMPUTACION
7563909;;M;68;CHILENO;;Boomers;RENCA                         ;METROPOLITANA;0;0;0;0;0;0;0;0;0;Tab M10 HD 2G-32GB 10.1 Iron grey WiFi;COMPUTACION
14390607;;F;44;CHILENO;;X;PROVIDENCIA                   ;METROPOLITANA;0;0;0;0;0;0;0;0;0;MULTIFUNCIONAL ECOTANK L3110;COMPUTACION
20402622;;F;22;CHILENO;;Silencioso;PROVIDENCIA                   ;METROPOLITANA;0;0;0;0;0;0;0;0;0;NTBK 240 G8 Core i3-1005G1/4GB/1TB/14P;COMPUTACION
20076319;;M;23;CHILENO;;Z;PROVIDENCIA                   ;METROPOLITANA;0;0;0;0;0;0;0;0;0;Multifuncional DCPT520W Wifi;COMPUTACION
13737435;;F;43;CHILENO;;X;N/D;N/D;0;0;0;0;0;0;0;0;0;MULTIFUNCIONAL ECOTANK L3150 Wifi;COMPUTACION
19137240;;F;26;CHILENO;;Silencioso;PROVIDENCIA                   ;METROPOLITANA;0;0;0;0;0;0;0;0;0;Tab M10 Plus FHD 4GB 64GB 10.3P platinum grey;COMPUTACION
20284044;;M;22;CHILENO;;Silencioso;PROVIDENCIA                   ;METROPOLITANA;0;0;0;0;0;0;0;0;0;Monitor 24 FHD 75Hz HDMI VGA/Flat IPS/Black;COMPUTACION
12466289;Casado;M;49;CHILENO;;X;RENCA                         ;METROPOLITANA;0;0;0;0;0;0;0;0;0;NTBK 240 G8 Core i3-1005G1/4GB/1TB/14P;COMPUTACION
19067304;;M;26;CHILENO;;Z;PROVIDENCIA                   ;METROPOLITANA;0;0;0;0;0;0;0;0;0;NTBK 15 FHD Core i5 16/1T+128 + 1650;COMPUTACION
15204778;;M;40;CHILENO;;X;LOS ANGELES                   ;BIO BIO;0;0;0;0;0;0;0;0;0;Multifuncional XP-2101 wifi;COMPUTACION
12256349;;F;50;CHILENO;;X;SANTIAGO                      ;METROPOLITANA;0;0;0;0;0;0;0;0;0;Galaxy Tab A7 (10.4 ,32GB, WIFI) Dark Gray;COMPUTACION
20155022;;F;23;CHILENO;;Z;"";"";0;0;0;0;0;0;0;0;0;TAB Galaxy A7 Lite (8.7, 32GB, WIFI + 4G);COMPUTACION
16700318;;F;27;CHILENO;;Millenial;LIMACHE                       ;VALPARAISO;0;0;0;0;0;0;0;0;0;TINTA HP GT53 90ml Black Original Ink Bottle;COMPUTACION
16559960;;F;35;CHILENO;;Silencioso;PROVIDENCIA                   ;METROPOLITANA;0;0;0;0;0;0;0;0;0;Tablet PRO 8 32GB WIFI + Funda Rosado;COMPUTACION
19814362;;M;24;CHILENO;;Silencioso;PROVIDENCIA                   ;METROPOLITANA;0;0;0;0;0;0;0;0;0;Galaxy Tab A7 (10.4 ,32GB, WIFI) Dark Gray;COMPUTACION
13438928;;M;44;CHILENO;;X;PROVIDENCIA                   ;METROPOLITANA;0;0;0;0;0;0;0;0;0;NTBK 15-dk1043la i5-10300H 8GB512SSD4V W10H;COMPUTACION
23432334;Soltero;F;40;BOLIVIANO;;Extranjero;ANTOFAGASTA                   ;ANTOFAGASTA;0;0;0;0;0;0;0;0;0;Multifuncional DCPT520W Wifi;COMPUTACION
7577569;;F;66;CHILENO;;Boomers;PUENTE ALTO                   ;METROPOLITANA;0;0;0;0;0;0;0;0;0;NTBK X15 15.6 Intel Core 8GB RAM + 256GB SDD;COMPUTACION
6707774;;F;71;CHILENO;;Silencioso;PANGUIPULLI                   ;LOS RIOS;0;0;0;0;0;0;0;0;0;NTBK 14-ck2091la i3-10110U 4GB 128GB 14 HD;COMPUTACION
12536788;;F;48;CHILENO;;X;RENCA                         ;METROPOLITANA;0;0;0;0;0;0;0;0;0;Multifuncional Ink Tank 415 Wifi;COMPUTACION
17588550;;F;30;CHILENO;;Millenial;PROVIDENCIA                   ;METROPOLITANA;0;0;0;0;0;0;0;0;0;NTBK 14-ck2091la i3-10110U 4GB 128GB 14 HD;COMPUTACION
12532652;;M;49;CHILENO;;X;RENCA                         ;METROPOLITANA;0;0;0;0;0;0;0;0;0;TAB Galaxy A7 Lite (8.7, 32GB, WIFI);COMPUTACION
27034881;;M;28;COLOMBIANO;;Extranjero;N/D;N/D;0;0;0;0;0;0;0;0;0;NTBK 15-dk1028la Ci5-10300H/8GB/256SSD/1050 3GB;COMPUTACION
15677936;;F;38;CHILENO;;Millenial;"";"";0;0;0;0;0;0;0;0;0;Tab M10 HD 2G-32GB 10.1 Iron grey WiFi;COMPUTACION
18985099;Soltero;F;27;CHILENO;;Z;PROVIDENCIA                   ;METROPOLITANA;0;0;0;0;0;0;0;0;0;NTBK GemiBook Celeron/12GB/256GB/2K/Tec-Ingles;COMPUTACION
18362887;Soltero;M;30;CHILENO;;Silencioso;PROVIDENCIA                   ;METROPOLITANA;0;0;0;0;0;0;0;0;0;TAB P11 6GB128SG Pen Slate Grey;COMPUTACION
13279275;;M;44;CHILENO;;Silencioso;PROVIDENCIA                   ;METROPOLITANA;0;0;0;0;0;0;0;0;0;AIO 330-20IGM J4025 500 4G;COMPUTACION
19868470;;F;23;CHILENO;;Z;PROVIDENCIA                   ;METROPOLITANA;0;0;0;0;0;0;0;0;0;TAB Matepad T10S 3GB 64GB 10P;COMPUTACION
10977063;;F;53;CHILENO;;X;NIQUEN                        ;BIO BIO;0;0;0;0;0;0;0;0;0;NTBK 14-dw0005la Core i7-1065G7 8GB 512SSD 14P;COMPUTACION
15158980;;F;38;CHILENO;;Millenial;PROVIDENCIA                   ;METROPOLITANA;0;0;0;0;0;0;0;0;0;TAB Galaxy Tab A 8 4Core 2GB 32GB 8 Gris;COMPUTACION
5297060;;F;79;CHILENO;;Silencioso;LONCOCHE                      ;ARAUCANIA;0;0;0;0;0;0;0;0;0;NTBK 240 G8 Core i3-1005G1/4GB/1TB/14P;COMPUTACION
18986836;Soltero;F;26;CHILENO;;Z;PROVIDENCIA                   ;METROPOLITANA;0;0;0;0;0;0;0;0;0;MULTIFUNCIONAL ECOTANK L3150 Wifi;COMPUTACION
15966690;;F;37;CHILENO;;Millenial;PROVIDENCIA                   ;METROPOLITANA;0;0;0;0;0;0;0;0;0;Multifuncional Laser DCP-1602 Monocromatica;COMPUTACION
18527609;;M;29;CHILENO;;Millenial;PENAFLOR                      ;METROPOLITANA;0;0;0;0;0;0;0;0;0;Galaxy Tab A7 (10.4 ,32GB, WIFI) Dark Gray;COMPUTACION
19961577;;F;23;CHILENO;;Z;PROVIDENCIA                   ;METROPOLITANA;0;0;0;0;0;0;0;0;0;Tablet Lite 2.0 7 16 GB WIFI + Funda Rosado;COMPUTACION
8566317;;F;66;CHILENO;;Boomers;PUYEHUE                       ;LOS LAGOS;0;0;0;0;0;0;0;0;0;Multifuncional Smart Tank 515 Wifi;COMPUTACION
13812077;;M;41;CHILENO;;X;PROVIDENCIA                   ;METROPOLITANA;0;0;0;0;0;0;0;0;0;NTBK 14-ck2091la i3-10110U 4GB 128GB 14 HD;COMPUTACION
16919558;Casado;F;34;CHILENO;;Millenial;PROVIDENCIA                   ;METROPOLITANA;0;0;0;0;0;0;0;0;0;AIO 21-b0021la Pentium J5040 8GB 1TB;COMPUTACION
8961510;;M;52;CHILENO;;X;PROVIDENCIA                   ;METROPOLITANA;0;0;0;0;0;0;0;0;0;NTBK IP S145 AMD 3020E/4GB/500GB/14P;COMPUTACION
11670155;;F;51;CHILENO;;X;N/D;N/D;0;0;0;0;0;0;0;0;0;NTBK Legion7 15IMH05 I7-10750H 16GB(8+8);COMPUTACION
16613124;;F;33;CHILENO;;Millenial;HUALPEN;BIO BIO;0;0;0;0;0;0;0;0;0;Tab M10 HD 2G-32GB 10.1 Iron grey WiFi;COMPUTACION
17190769;;M;32;CHILENO;;Millenial;MELIPILLA                     ;METROPOLITANA;0;0;0;0;0;0;0;0;0;NTBK 14-cf2051la i3-10110U 4GB 256GB+16GB 14 HD;COMPUTACION
5068291;;M;78;CHILENO;;Silencioso;PANGUIPULLI                   ;LOS RIOS;0;0;0;0;0;0;0;0;0;Tab M10 HD 2G-32GB 10.1 Iron grey WiFi;COMPUTACION
10949079;;M;54;CHILENO;;X;CHANARAL                      ;ATACAMA;0;0;0;0;0;0;0;0;0;MULTIFUNCIONAL DCP-T710W Wifi/ ADF;COMPUTACION
13128479;Casado;M;45;CHILENO;;X;RENCA                         ;METROPOLITANA;0;0;0;0;0;0;0;0;0;TAB Galaxy Tab A 8 4Core 2GB 32GB 8 Negra;COMPUTACION
15850436;;M;38;CHILENO;;Boomers;MAULE                         ;MAULE;0;0;0;0;0;0;0;0;0;TAB Galaxy Tab A 8 4G 4Core 2GB 32GB 8 Gris;COMPUTACION
19581570;;M;25;CHILENO;;Z;PROVIDENCIA                   ;METROPOLITANA;0;0;0;0;0;0;0;0;0;Tab M10 HD 2G-32GB 10.1 Iron grey WiFi;COMPUTACION
10205185;;F;58;CHILENO;;Boomers;ARICA                         ;TARAPACA;0;0;0;0;0;0;0;0;0;NTBK 15-dk1028la Ci5-10300H/8GB/256SSD/1050 3GB;COMPUTACION
16166209;Divorciado;M;36;CHILENO;PROFESOR;Millenial;PROVIDENCIA                   ;METROPOLITANA;0;0;0;0;0;0;0;0;0;NTBK 15-dy2051la i3-1115G4 8GB 256GB+16GB 15IN S;COMPUTACION
19422786;;M;25;CHILENO;;Z;PUENTE ALTO                   ;METROPOLITANA;0;0;0;0;0;0;0;0;0;NTBK 14-ck2091la i3-10110U 4GB 128GB 14 HD;COMPUTACION
15519121;;F;39;CHILENO;;Silencioso;PROVIDENCIA                   ;METROPOLITANA;0;0;0;0;0;0;0;0;0;TAB Galaxy Tab A 8 4Core 2GB 32GB 8 Gris;COMPUTACION
12115457;Soltero;M;43;CHILENO;;X;PROVIDENCIA                   ;METROPOLITANA;0;0;0;0;0;0;0;0;0;MONITOR 22x 21.5-inch Display;COMPUTACION
17197095;Soltero;M;28;CHILENO;;Millenial;PROVIDENCIA                   ;METROPOLITANA;0;0;0;0;0;0;0;0;0;T544 DYE BLACK INK BOTTLE (65ml);COMPUTACION
14150619;;M;41;CHILENO;;Silencioso;PROVIDENCIA                   ;METROPOLITANA;0;0;0;0;0;0;0;0;0;NTBK 14-ck2096la CeleronN4020 4GB500GB W10H;COMPUTACION
9718258;;F;58;CHILENO;;Boomers;RENCA                         ;METROPOLITANA;0;0;0;0;0;0;0;0;0;NTBK 14-cf2051la i3-10110U 4GB 256GB+16GB 14 HD;COMPUTACION
16741510;;M;34;CHILENO;;Millenial;RENCA                         ;METROPOLITANA;0;0;0;0;0;0;0;0;0;NTBK IP S145 AMD 3020E/4GB/500GB/14P;COMPUTACION
15516017;;F;39;CHILENO;;X;COIHAIQUE                     ;AYSEN;0;0;0;0;0;0;0;0;0;MULTIFUNCIONAL ECOTANK L3110;COMPUTACION
15413140;;M;40;CHILENO;;X;SANTIAGO                      ;METROPOLITANA;0;0;0;0;0;0;0;0;0;Galaxy Tab A7 (10.4 ,32GB, WIFI) Dark Gray;COMPUTACION
20260622;;F;22;CHILENO;;Silencioso;PROVIDENCIA                   ;METROPOLITANA;0;0;0;0;0;0;0;0;0;MULTIFUNCIONAL ECOTANK L3110;COMPUTACION
17624826;;F;32;CHILENO;;Millenial;N/D;N/D;0;0;0;0;0;0;0;0;0;TABLET 7 WIFI 1+16;COMPUTACION
8741711;;F;60;CHILENO;;Boomers;N/D;N/D;0;0;0;0;0;0;0;0;0;TAB Galaxy Tab A 8 4G 4Core 2GB 32GB 8 Gris;COMPUTACION
16899194;;F;34;CHILENO;;Millenial;MOLINA                        ;MAULE;0;0;0;0;0;0;0;0;0;NTBK 14-ck2091la i3-10110U 4GB 128GB 14 HD;COMPUTACION
13915992;;M;42;CHILENO;;X;RENCA                         ;METROPOLITANA;0;0;0;0;0;0;0;0;0;TAB Galaxy Tab A 8 4Core 2GB 32GB 8 Negra;COMPUTACION
8574756;;M;64;CHILENO;;Silencioso;PROVIDENCIA                   ;METROPOLITANA;0;0;0;0;0;0;0;0;0;NTBK 14-ck2091la i3-10110U 4GB 128GB 14 HD;COMPUTACION
15590316;Soltero;M;39;CHILENO;ABOGADO;X;PROVIDENCIA                   ;METROPOLITANA;0;0;0;0;0;0;0;0;0;NTBK 15-dy2051la i3-1115G4 8GB 256GB+16GB 15IN S;COMPUTACION
10178297;;F;51;CHILENO;;X;"";"";0;0;0;0;0;0;0;0;0;MULTIFUNCIONAL HP INK ADVANTAGE 3785/3775;COMPUTACION
13972436;;F;40;CHILENO;;Silencioso;PROVIDENCIA                   ;METROPOLITANA;0;0;0;0;0;0;0;0;0;NTBK 14-cf2051la i3-10110U 4GB 256GB+16GB 14 HD;COMPUTACION
12560271;;M;48;CHILENO;;X;ARAUCO                        ;BIO BIO;0;0;0;0;0;0;0;0;0;AIO 21-b0021la Pentium J5040 8GB 1TB;COMPUTACION
7002376;;M;64;CHILENO;;Boomers;CONSTITUCION                  ;MAULE;0;0;0;0;0;0;0;0;0;NTBK 14-cf2051la i3-10110U 4GB 256GB+16GB 14 HD;COMPUTACION
19877411;;F;24;CHILENO;;Silencioso;PROVIDENCIA                   ;METROPOLITANA;0;0;0;0;0;0;0;0;0;T544 DYE BLACK INK BOTTLE (65ml);COMPUTACION
17652536;;F;32;CHILENO;;Millenial;LONCOCHE                      ;ARAUCANIA;0;0;0;0;0;0;0;0;0;MULTIFUNCIONAL ECOTANK L3110;COMPUTACION
14598235;Soltero;F;42;CHILENO;SECRETARIA;X;RENCA                         ;METROPOLITANA;0;0;0;0;0;0;0;0;0;AIO 21-b0021la Pentium J5040 8GB 1TB;COMPUTACION
15996298;Casado;F;36;CHILENO;;Millenial;PROVIDENCIA                   ;METROPOLITANA;0;0;0;0;0;0;0;0;0;NTBK 14-ck2091la i3-10110U 4GB 128GB 14 HD;COMPUTACION
20186506;;F;23;CHILENO;;Silencioso;PROVIDENCIA                   ;METROPOLITANA;0;0;0;0;0;0;0;0;0;MULTIFUNCIONAL ECOTANK L3150 Wifi;COMPUTACION
10609499;;M;52;CHILENO;;X;N/D;N/D;0;0;0;0;0;0;0;0;0;NTBK 14-ck2096la CeleronN4020 4GB500GB W10H;COMPUTACION
16816330;;F;34;CHILENO;;Millenial;PROVIDENCIA                   ;METROPOLITANA;0;0;0;0;0;0;0;0;0;NTBK 14-dq1004la Core i5-1035G1 8GB 256SSD 14P;COMPUTACION
13030960;Casado;M;46;CHILENO;PROFESOR;X;PROVIDENCIA                   ;METROPOLITANA;0;0;0;0;0;0;0;0;0;TINTA BOTELLA EPSON T664120 NEGRA SERIE L;COMPUTACION
15062253;;F;40;CHILENO;;X;PROVIDENCIA                   ;METROPOLITANA;0;0;0;0;0;0;0;0;0;Multifuncional Laser DCP-1602 Monocromatica;COMPUTACION
18359189;;F;29;CHILENO;;Millenial;PROVIDENCIA                   ;METROPOLITANA;0;0;0;0;0;0;0;0;0;MBA 13.3 SLV/8C CPU/7C GPU/8GB/256GB-BES;COMPUTACION
17712791;Soltero;F;31;CHILENO;;Millenial;PROVIDENCIA                   ;METROPOLITANA;0;0;0;0;0;0;0;0;0;TAB Galaxy Tab A 8 4Core 2GB 32GB 8 Negra;COMPUTACION
18769897;;F;27;CHILENO;;Silencioso;PROVIDENCIA                   ;METROPOLITANA;0;0;0;0;0;0;0;0;0;MBA 13.3 SPG/8C CPU/7C GPU/8GB/256GB (MGN63BE/A);COMPUTACION
17453997;;F;31;CHILENO;;Millenial;LAS CONDES                    ;METROPOLITANA;0;0;0;0;0;0;0;0;0;NTBK INSPIRON 3505 AMD R3 3250U 8GB 1TB;COMPUTACION
19740108;;M;25;CHILENO;;Silencioso;PROVIDENCIA                   ;METROPOLITANA;0;0;0;0;0;0;0;0;0;TAB S6 Lite (610) 4GB 64GB 10.4P BLUE;COMPUTACION
8189664;Casado;M;61;CHILENO;;Boomers;RENCA                         ;METROPOLITANA;0;0;0;0;0;0;0;0;0;NTBK 14-dq1004la Core i5-1035G1 8GB 256SSD 14P;COMPUTACION
13103804;;F;46;CHILENO;;X;PALMILLA                      ;L.G.B.OÂ´HIGGINS;0;0;0;0;0;0;0;0;0;AIO 21-b0021la Pentium J5040 8GB 1TB;COMPUTACION
20242615;;F;22;CHILENO;;Silencioso;PROVIDENCIA                   ;METROPOLITANA;0;0;0;0;0;0;0;0;0;IPAD WI-FI 32GB GOLD (MYLC2CI/A);COMPUTACION
19961284;;M;23;CHILENO;;Z;LINARES                       ;MAULE;0;0;0;0;0;0;0;0;0;NTBK 245 G7 AMD Ryzen 5 3500U 8GB 1TB 14P;COMPUTACION
11366670;;F;53;CHILENO;;X;CASTRO                        ;LOS LAGOS;0;0;0;0;0;0;0;0;0;NTBK INSPIRON 3505 AMD R3 3250U 8GB 1TB;COMPUTACION
17558809;Soltero;F;32;CHILENO;TECNOLOGO MEDICO;Silencioso;PROVIDENCIA                   ;METROPOLITANA;0;0;0;0;0;0;0;0;0;NTBK 14-cf2051la i3-10110U 4GB 256GB+16GB 14 HD;COMPUTACION
11891348;Casado;F;51;CHILENO;;X;PROVIDENCIA                   ;METROPOLITANA;0;0;0;0;0;0;0;0;0;NTBK 14-cf2051la i3-10110U 4GB 256GB+16GB 14 HD;COMPUTACION
16247360;;M;36;CHILENO;;Silencioso;PROVIDENCIA                   ;METROPOLITANA;0;0;0;0;0;0;0;0;0;TAB S6 Lite (610) 4GB 64GB 10.4P BLUE;COMPUTACION
18878353;;M;26;CHILENO;;Z;PROVIDENCIA                   ;METROPOLITANA;0;0;0;0;0;0;0;0;0;NTBK 15-dy2051la i3-1115G4 8GB 256GB+16GB 15IN S;COMPUTACION
12843887;;F;47;CHILENO;;X;N/D;N/D;0;0;0;0;0;0;0;0;0;NTBK 15-dy2051la i3-1115G4 8GB 256GB+16GB 15IN S;COMPUTACION
17675848;Soltero;F;31;CHILENO;TECNICO EN ADMINISTRACION DE EMPRESAS;Silencioso;PROVIDENCIA                   ;METROPOLITANA;0;0;0;0;0;0;0;0;0;NTBK 15-dy2051la i3-1115G4 8GB 256GB+16GB 15IN S;COMPUTACION
12461330;;F;48;CHILENO;;X;PROVIDENCIA                   ;METROPOLITANA;0;0;0;0;0;0;0;0;0;Multifuncional DCPT220;COMPUTACION
10022670;Soltero;F;55;CHILENO;;Silencioso;PROVIDENCIA                   ;METROPOLITANA;0;0;0;0;0;0;0;0;0;TAB Galaxy Tab A 8 4G 4Core 2GB 32GB 8 Gris;COMPUTACION
9677697;Soltero;F;44;CHILENO;INGENIERO COMERCIAL;X;RENCA                         ;METROPOLITANA;0;0;0;0;0;0;0;0;0;Impresora Laser HL-1202 Monocromatica;COMPUTACION
11825119;;F;51;CHILENO;;X;PROVIDENCIA                   ;METROPOLITANA;0;0;0;0;0;0;0;0;0;NTBK INSPIRON 3505 AMD R3 3250U 8GB 1TB;COMPUTACION
7692818;Soltero;M;66;CHILENO;;Boomers;RENCA                         ;METROPOLITANA;0;0;0;0;0;0;0;0;0;Impresora Laser HL-1202 Monocromatica;COMPUTACION
12553229;;M;47;CHILENO;;X;PROVIDENCIA                   ;METROPOLITANA;0;0;0;0;0;0;0;0;0;NTBK INSPIRON 5505 AMD R5 4500U 8GB 512SSD;COMPUTACION
7828038;;M;63;CHILENO;;Boomers;PROVIDENCIA                   ;METROPOLITANA;0;0;0;0;0;0;0;0;0;Tab M10 Plus FHD 4GB 64GB 10.3P platinum grey;COMPUTACION
10247486;;F;52;CHILENO;;X;RENCA                         ;METROPOLITANA;0;0;0;0;0;0;0;0;0;MULTIFUNCIONAL HP INK ADVANTAGE 3785/3775;COMPUTACION
16591718;;M;35;CHILENO;;Silencioso;PROVIDENCIA                   ;METROPOLITANA;0;0;0;0;0;0;0;0;0;NTBK 245 G7 AMD Ryzen 5 3500U 8GB 1TB 14P;COMPUTACION
14567181;;M;42;CHILENO;;X;MAIPU                         ;METROPOLITANA;0;0;0;0;0;0;0;0;0;MULTIFUNCIONAL ECOTANK L5190 Wifi/ Fax;COMPUTACION
11984524;;F;50;CHILENO;;X;CHILLAN VIEJO                 ;BIO BIO;0;0;0;0;0;0;0;0;0;TAB S6 Lite (610) 4GB 64GB 10.4P PINK;COMPUTACION
13490749;Casado;F;43;CHILENO;;X;PROVIDENCIA                   ;METROPOLITANA;0;0;0;0;0;0;0;0;0;AIO 21-b0021la Pentium J5040 8GB 1TB;COMPUTACION
10257090;Casado;M;53;CHILENO;TECNICO EN ADMINISTRACION DE EMPRESAS;X;PROVIDENCIA                   ;METROPOLITANA;0;0;0;0;0;0;0;0;0;AIO 21-b0021la Pentium J5040 8GB 1TB;COMPUTACION
15068237;;M;40;CHILENO;;X;SAN FELIPE                    ;VALPARAISO;0;0;0;0;0;0;0;0;0;Galaxy Tab A7 (10.4 ,32GB, WIFI + 4G) Dark Gray;COMPUTACION
15762003;;M;38;CHILENO;;Millenial;N/D;N/D;0;0;0;0;0;0;0;0;0;MULTIFUNCIONAL ECOTANK L3110;COMPUTACION
15613160;;M;39;CHILENO;;X;"";"";0;0;0;0;0;0;0;0;0;Galaxy Tab A7 (10.4 ,32GB, WIFI) Gold;COMPUTACION
5911703;;F;72;CHILENO;;Silencioso;ARICA                         ;ARICA Y PARINACOTA;0;0;0;0;0;0;0;0;0;Galaxy Tab A7 (10.4 ,64GB, WIFI) Gray;COMPUTACION
10446426;;M;54;CHILENO;;Boomers;MARIQUINA                     ;LOS LAGOS;0;0;0;0;0;0;0;0;0;MULTIFUNCIONAL ECOTANK L3110;COMPUTACION
18152155;Soltero;M;30;CHILENO;KINESIOLOGO;Millenial;PROVIDENCIA                   ;METROPOLITANA;0;0;0;0;0;0;0;0;0;MULTIFUNCIONAL ECOTANK L3150 Wifi;COMPUTACION
8511607;;F;48;CHILENO;;X;MAIPU                         ;METROPOLITANA;0;0;0;0;0;0;0;0;0;NTBK 245 G7 AMD Ryzen 5 3500U 8GB 1TB 14P;COMPUTACION
19521275;;M;25;CHILENO;;Silencioso;PROVIDENCIA                   ;METROPOLITANA;0;0;0;0;0;0;0;0;0;NTBK A515-43-R7RU-3 15 Ryzen 7/8GB/256SSD;COMPUTACION
13869183;;F;42;CHILENO;;Silencioso;PROVIDENCIA                   ;METROPOLITANA;0;0;0;0;0;0;0;0;0;TAB MBXR 8717 4Core 2GB 16GB 10 Negra;COMPUTACION
15959917;;F;37;CHILENO;;Millenial;PROVIDENCIA                   ;METROPOLITANA;0;0;0;0;0;0;0;0;0;NTBK 245 G7 AMD Ryzen 5 3500U 8GB 1TB 14P;COMPUTACION
12837205;;M;48;CHILENO;;X;ANTOFAGASTA                   ;ANTOFAGASTA;0;0;0;0;0;0;0;0;0;NTBK G3 3500 Core i5-10300 8GB 256SSD 1650 4GB;COMPUTACION
15144787;;M;40;CHILENO;;X;CONSTITUCION                  ;MAULE;0;0;0;0;0;0;0;0;0;TAB Galaxy Tab A 10.1 8Core 2GB 32GB 10 Negra;COMPUTACION
15145607;;F;39;CHILENO;;X;PROVIDENCIA                   ;METROPOLITANA;0;0;0;0;0;0;0;0;0;TAB MLAB MBX 8 QUAD CORE 1G+16G 8716;COMPUTACION
12465298;;M;50;CHILENO;;X;SANTIAGO                      ;METROPOLITANA;0;0;0;0;0;0;0;0;0;NTBK IP3 Athlon 3050U/4GB/500GB/15P;COMPUTACION
15509725;;M;39;CHILENO;;X;SAN BERNARDO                  ;METROPOLITANA;0;0;0;0;0;0;0;0;0;Multifuncional Laser DCP-1602 Monocromatica;COMPUTACION
16704437;Casado;M;34;CHILENO;;Millenial;PROVIDENCIA                   ;METROPOLITANA;0;0;0;0;0;0;0;0;0;Galaxy Tab A7 (10.4 ,32GB, WIFI) Dark Gray;COMPUTACION
7586545;;F;68;CHILENO;;Boomers;HUASCO                        ;ATACAMA;0;0;0;0;0;0;0;0;0;TAB Galaxy Tab A 8 4Core 2GB 32GB 8 Negra;COMPUTACION
12856466;Casado;M;48;CHILENO;ANALISTA DE SISTEMAS;Silencioso;PROVIDENCIA                   ;METROPOLITANA;0;0;0;0;0;0;0;0;0;NTBK 14-dq1004la Core i5-1035G1 8GB 256SSD 14P;COMPUTACION
19458080;;F;24;CHILENO;;Z;CARAHUE                       ;ARAUCANIA;0;0;0;0;0;0;0;0;0;NTBK 240 G7 Core i3-1005G1 4GB 1TB 14P;COMPUTACION
10800860;;M;55;CHILENO;;Silencioso;PROVIDENCIA                   ;METROPOLITANA;0;0;0;0;0;0;0;0;0;NTBK 240 G7 Core i3-1005G1 4GB 1TB 14P;COMPUTACION
10019320;;F;58;CHILENO;;Boomers;MELIPILLA                     ;METROPOLITANA;0;0;0;0;0;0;0;0;0;TAB Matepad 10.4;COMPUTACION
15193296;;F;39;CHILENO;;X;LOTA                          ;BIO BIO;0;0;0;0;0;0;0;0;0;Tab M10 Plus FHD 4GB 64GB 10.3P platinum grey;COMPUTACION
15877078;;F;37;CHILENO;;Millenial;PROVIDENCIA                   ;METROPOLITANA;0;0;0;0;0;0;0;0;0;Macbook Air Core I5 8GB 128SSD 13P;COMPUTACION
9017611;;F;63;CHILENO;;Boomers;RENCA                         ;METROPOLITANA;0;0;0;0;0;0;0;0;0;TAB Galaxy Tab A 8 4Core 2GB 32GB 8 Gris;COMPUTACION
19824025;;M;24;CHILENO;;Z;"";"";0;0;0;0;0;0;0;0;0;Multifuncional Smart Tank 515 Wifi;COMPUTACION
6862656;;M;76;CHILENO;;Silencioso;NUEVA IMPERIAL                ;ARAUCANIA;0;0;0;0;0;0;0;0;0;NTBK A314-22-R7EL-1 Ryzen 3-3250U 8GB 256SSD 14P;COMPUTACION
15984483;;M;36;CHILENO;;Millenial;PROVIDENCIA                   ;METROPOLITANA;0;0;0;0;0;0;0;0;0;MULTIFUNCIONAL ECOTANK L5190 Wifi/ Fax;COMPUTACION
17630786;;F;31;CHILENO;;Millenial;FRESIA                        ;LOS LAGOS;0;0;0;0;0;0;0;0;0;NTBK IP S340 Core i7-1065G7 8GB 512SSD 14P;COMPUTACION
27112115;;F;38;VENEZOLANO;;Extranjero;N/D;N/D;0;0;0;0;0;0;0;0;0;TAB Galaxy Tab A 8 4Core 2GB 32GB 8 Gris;COMPUTACION
8888628;;M;62;CHILENO;;Boomers;PROVIDENCIA                   ;METROPOLITANA;0;0;0;0;0;0;0;0;0;Galaxy Tab A7 (10.4 ,32GB, WIFI + 4G) Dark Gray;COMPUTACION
16507020;;M;35;CHILENO;;Millenial;PUERTO MONTT                  ;LOS LAGOS;0;0;0;0;0;0;0;0;0;NTBK 15-cw1006la Ryzen 7-3700U 8GB 512SSD 15P;COMPUTACION
20315642;;F;22;CHILENO;;Millenial;"";"";0;0;0;0;0;0;0;0;0;MULTIFUNCIONAL ECOTANK L4160 Wifi;COMPUTACION
18851512;;F;28;CHILENO;;Millenial;ANGOL                         ;ARAUCANIA;0;0;0;0;0;0;0;0;0;Tab M10 Plus FHD 4GB 64GB 10.3P platinum grey;COMPUTACION
17972035;;F;30;CHILENO;;Millenial;PROVIDENCIA                   ;METROPOLITANA;0;0;0;0;0;0;0;0;0;NTBK 240 G7 Core i3-1005G1 4GB 1TB 14P;COMPUTACION
9297533;;M;58;CHILENO;;Boomers;COIHAIQUE                     ;AYSEN;0;0;0;0;0;0;0;0;0;MULTIFUNCIONAL ECOTANK L3110;COMPUTACION
19604748;;F;24;CHILENO;;Z;PLACILLA                      ;L.G.B.OÂ´HIGGINS;0;0;0;0;0;0;0;0;0;NTBK 245 G7 AMD Ryzen 5 3500U 8GB 1TB 14P;COMPUTACION
13617427;;M;43;CHILENO;;X;SAN CARLOS                    ;BIO BIO;0;0;0;0;0;0;0;0;0;NTBK G7 240 Intel Celeron 4GB 500GB 14;COMPUTACION
18134275;Soltero;M;29;CHILENO;INGENIERO INFORMATICO;Millenial;PROVIDENCIA                   ;METROPOLITANA;0;0;0;0;0;0;0;0;0;NTBK 15-DA2034LA PENTIUM GOLD 6405U 8GB1TB W10;COMPUTACION
13728581;;M;43;CHILENO;;X;NUEVA IMPERIAL                ;ARAUCANIA;0;0;0;0;0;0;0;0;0;NTBK 240 Core i5-1035G1 4GB 1TB 14P;COMPUTACION
16566741;;M;34;CHILENO;;Silencioso;PROVIDENCIA                   ;METROPOLITANA;0;0;0;0;0;0;0;0;0;TAB Galaxy Tab A 8 4Core 2GB 32GB 8 Negra;COMPUTACION
6930142;;M;67;CHILENO;;Boomers;PROVIDENCIA                   ;METROPOLITANA;0;0;0;0;0;0;0;0;0;Multifuncional DeskJet Ink Advantage 3775 Wifi;COMPUTACION
10593442;;M;52;CHILENO;;X;"";"";0;0;0;0;0;0;0;0;0;TAB MBX Cinema 8866 OctaCore 2GB 32GB 10P;COMPUTACION
18320703;;F;29;CHILENO;;Millenial;BUIN                          ;METROPOLITANA;0;0;0;0;0;0;0;0;0;NTBK G7 240 Intel Celeron 4GB 500GB 14;COMPUTACION
8927563;Casado;M;60;CHILENO;TECNICO MECANICO;Boomers;RENCA                         ;METROPOLITANA;0;0;0;0;0;0;0;0;0;NTBK Matebook D14 AMD Ryzen 5 8GB 512SSD 14P;COMPUTACION
18078328;;M;30;CHILENO;;Silencioso;PROVIDENCIA                   ;METROPOLITANA;0;0;0;0;0;0;0;0;0;NTBK 15-DA2034LA PENTIUM GOLD 6405U 8GB1TB W10;COMPUTACION
17836125;;F;32;CHILENO;;Millenial;PROVIDENCIA                   ;METROPOLITANA;0;0;0;0;0;0;0;0;0;TINTA 664 NEGRA;COMPUTACION
19072478;Soltero;F;26;CHILENO;;Z;PROVIDENCIA                   ;METROPOLITANA;0;0;0;0;0;0;0;0;0;NTBK 14-DQ1001 Core i3-1005G1 4+16 256SSD 14;COMPUTACION
9700699;;F;61;CHILENO;;Boomers;N/D;N/D;0;0;0;0;0;0;0;0;0;NTBK 14-dq1004la Core i5-1035G1 8GB 256SSD 14P;COMPUTACION
16554228;;M;35;CHILENO;;Millenial;CODEGUA                       ;L.G.B.OÂ´HIGGINS;0;0;0;0;0;0;0;0;0;Galaxy Tab A7 (10.4 ,32GB, WIFI) Silver;COMPUTACION
14065817;Soltero;M;41;CHILENO;ANALISTA DE SISTEMAS;Silencioso;PROVIDENCIA                   ;METROPOLITANA;0;0;0;0;0;0;0;0;0;Multifuncional Ink Tank 415 Wifi;COMPUTACION
5050212;;F;74;CHILENO;;Silencioso;N/D;N/D;0;0;0;0;0;0;0;0;0;NTBK IP S340 Core I5-1035G4 4GB 256GB SSD 14P;COMPUTACION
13319028;;M;45;CHILENO;;X;VALDIVIA                      ;LOS RIOS;0;0;0;0;0;0;0;0;0;NTBK 15-ek0008la Core i7 32+32GB 512SSD 2070 8GB;COMPUTACION
16289711;;F;36;CHILENO;;Millenial;PUERTO MONTT                  ;LOS LAGOS;0;0;0;0;0;0;0;0;0;Galaxy Tab A7 (10.4 ,32GB, WIFI) Dark Gray;COMPUTACION
14350513;;F;43;CHILENO;;X;LOS ANGELES                   ;BIO BIO;0;0;0;0;0;0;0;0;0;NTBK 245 G7 AMD Ryzen 5 3500U 8GB 1TB 14P;COMPUTACION
19251890;;F;26;CHILENO;;Z;N/D;N/D;0;0;0;0;0;0;0;0;0;NTBK Matebook D15 AMD Ryzen 5 8GB 256SSD 15P;COMPUTACION
11838974;;F;50;CHILENO;;X;N/D;N/D;0;0;0;0;0;0;0;0;0;NTBK 14-DQ1001 Core i3-1005G1 4+16 256SSD 14;COMPUTACION
20292612;;M;22;CHILENO;;Millenial;PROVIDENCIA                   ;METROPOLITANA;0;0;0;0;0;0;0;0;0;NTBK G7 240 Intel Celeron 4GB 500GB 14;COMPUTACION
7613411;;M;64;CHILENO;;Boomers;VALLENAR;ATACAMA;0;0;0;0;0;0;0;0;0;NTBK IP S340 Core I5-1035G4 4GB 256GB SSD 14P;COMPUTACION
10792471;;M;56;CHILENO;;Boomers;LA FLORIDA                    ;METROPOLITANA;0;0;0;0;0;0;0;0;0;NTBK 15-cw1020la Ryzen 5-3500U 8GB 256GB 15P;COMPUTACION
14100994;;F;40;CHILENO;;X;MARIA PINTO                   ;METROPOLITANA;0;0;0;0;0;0;0;0;0;MULTIFUNCIONAL ECOTANK L3110;COMPUTACION
17923339;;M;31;CHILENO;;Millenial;ANGOL                         ;ARAUCANIA;0;0;0;0;0;0;0;0;0;Tab M10 Plus FHD 4GB 64GB 10.3P platinum grey;COMPUTACION
13256285;Casado;M;45;CHILENO;;X;RENCA                         ;METROPOLITANA;0;0;0;0;0;0;0;0;0;TAB S6 Lite (615) 4GB 64GB 10.4P SILVER 4G;COMPUTACION
14349445;;M;44;CHILENO;;X;N/D;N/D;0;0;0;0;0;0;0;0;0;NTBK 14-dq1004la Core i5-1035G1 8GB 256SSD 14P;COMPUTACION
17189323;;M;33;CHILENO;;Millenial;FRESIA;LOS LAGOS;0;0;0;0;0;0;0;0;0;MBP 13.3 SPG/8C CPU/8C GPU/8GB/256GB (MYD82CI/A);COMPUTACION
13385811;Soltero;M;44;CHILENO;TECNICO EN ADMINISTRACION DE EMPRESAS;X;PROVIDENCIA                   ;METROPOLITANA;0;0;0;0;0;0;0;0;0;NTBK 16-a0001 Core i5-10300H 8GB 512SSD 1650 4GB;COMPUTACION
16679281;;F;35;CHILENO;;Millenial;N/D;N/D;0;0;0;0;0;0;0;0;0;TABLET GALAXY S7+ (T970) 256GB 12.4P Cooper;COMPUTACION
13184248;Soltero;M;44;CHILENO;;X;RENCA                         ;METROPOLITANA;0;0;0;0;0;0;0;0;0;TAB M5 Lite Octa Core 32GB 10P FHD;COMPUTACION
17132223;Soltero;M;33;CHILENO;;Millenial;PROVIDENCIA                   ;METROPOLITANA;0;0;0;0;0;0;0;0;0;NTBK IP3 Athlon 3050U/4GB/500GB/15P;COMPUTACION
18277206;Soltero;M;29;CHILENO;;Millenial;PROVIDENCIA                   ;METROPOLITANA;0;0;0;0;0;0;0;0;0;TAB Galaxy Tab A 8 4Core 2GB 32GB 8 Negra;COMPUTACION
13539906;;F;42;CHILENO;;X;PROVIDENCIA                   ;METROPOLITANA;0;0;0;0;0;0;0;0;0;TAB Galaxy Tab A 8 4Core 2GB 32GB 8 Negra;COMPUTACION
25992757;;M;52;VENEZOLANO;;Extranjero;ESTACION CENTRAL              ;METROPOLITANA;0;0;0;0;0;0;0;0;0;TAB Galaxy Tab A 8 4Core 2GB 32GB 8 Gris;COMPUTACION
10405199;Casado;M;54;CHILENO;INGENIERO DE EJECUCION EN ADMINISTRACION DE EMPRESAS;X;PROVIDENCIA                   ;METROPOLITANA;0;0;0;0;0;0;0;0;0;NTBK Matebook D14 AMD Ryzen 5 8GB 512SSD 14P;COMPUTACION
12761815;;F;46;CHILENO;;X;COIHAIQUE                     ;AYSEN;0;0;0;0;0;0;0;0;0;NTBK Matebook D14 AMD Ryzen 5 8GB 512SSD 14P;COMPUTACION
20223575;;M;23;CHILENO;;Silencioso;PROVIDENCIA                   ;METROPOLITANA;0;0;0;0;0;0;0;0;0;NTBK 15-dk0007la Core i7 16GB 1TB+128 1660ti 6GB;COMPUTACION
10313359;Soltero;F;56;CHILENO;;Boomers;RENCA                         ;METROPOLITANA;0;0;0;0;0;0;0;0;0;NTBK Matebook D14 AMD Ryzen 5 8GB 512SSD 14P;COMPUTACION
8942714;Casado;F;61;CHILENO;;Boomers;RENCA                         ;METROPOLITANA;0;0;0;0;0;0;0;0;0;NTBK A314-22-R7EL-1 Ryzen 3-3250U 8GB 256SSD 14P;COMPUTACION
16882097;;F;34;CHILENO;;Millenial;RANCAGUA                      ;L.G.B.OÂ´HIGGINS;0;0;0;0;0;0;0;0;0;NTBK A314-22-R4P7-1 Ryzen 5 3500U 8GB 256SSD 14P;COMPUTACION
14374353;Casado;M;46;CHILENO;INGENIERO EJECUCION. EN COMPUTACION E INFORMATICA;Silencioso;PROVIDENCIA                   ;METROPOLITANA;0;0;0;0;0;0;0;0;0;Tab Yoga Smart;COMPUTACION
14149462;;M;41;CHILENO;;X;TEODORO SCHMIDT;ARAUCANIA;0;0;0;0;0;0;0;0;0;MULTIFUNCIONAL ECOTANK L3110;COMPUTACION
15671959;Soltero;M;38;CHILENO;CONSTRUCTOR CIVIL;Millenial;PROVIDENCIA                   ;METROPOLITANA;0;0;0;0;0;0;0;0;0;NTBK IP3 Ryzen 3-3250U/8GB/1TB/15P;COMPUTACION
15347906;Soltero;M;40;CHILENO;;X;PROVIDENCIA                   ;METROPOLITANA;0;0;0;0;0;0;0;0;0;TAB M8 QC 2GB 32GB 8P Gris;COMPUTACION
16605689;Soltero;F;34;CHILENO;;Millenial;PROVIDENCIA                   ;METROPOLITANA;0;0;0;0;0;0;0;0;0;TAB MediaPad T5 10 3GB 32GB 10.1P Azul;COMPUTACION
16459566;;F;35;CHILENO;;Millenial;PROVIDENCIA                   ;METROPOLITANA;0;0;0;0;0;0;0;0;0;TAB Galaxy Tab A+SPen 8Core 3GB 32GB 8 Gris;COMPUTACION
19059606;;F;26;CHILENO;;Z;CAUQUENES                     ;MAULE;0;0;0;0;0;0;0;0;0;TAB Galaxy Tab A 10.1 4G 8Core 2GB 32GB 10 Gold;COMPUTACION
19768877;;F;23;CHILENO;;Z;PROVIDENCIA                   ;METROPOLITANA;0;0;0;0;0;0;0;0;0;TAB S6 Lite (610) 4GB 64GB 10.4P BLUE;COMPUTACION
11618265;;M;52;CHILENO;;X;LA SERENA                     ;COQUIMBO;0;0;0;0;0;0;0;0;0;NTBK 15-cw1020la Ryzen 5-3500U 8GB 256GB 15P;COMPUTACION
16508666;;F;33;CHILENO;;Millenial;PROVIDENCIA                   ;METROPOLITANA;0;0;0;0;0;0;0;0;0;TAB M8 QC 2GB 32GB 8P Gris;COMPUTACION
14315615;;M;46;CHILENO;;X;"";"";0;0;0;0;0;0;0;0;0;NTBK IP3 Ryzen 3-3250U/8GB/1TB/15P;COMPUTACION
22776867;;F;48;PERUANO;;Extranjero;PROVIDENCIA                   ;METROPOLITANA;0;0;0;0;0;0;0;0;0;TAB 7 MB4 PLUS 3G 1+16GB BLACK 8761;COMPUTACION
17233763;;M;33;CHILENO;;Silencioso;PROVIDENCIA                   ;METROPOLITANA;0;0;0;0;0;0;0;0;0;NTBK Matebook D15 AMD Ryzen 5 8GB 256SSD+1TB 15P;COMPUTACION
16981071;;M;33;CHILENO;;Millenial;VALDIVIA                      ;LOS RIOS;0;0;0;0;0;0;0;0;0;TAB M7 QC 1GB 8GB 7P Gris;COMPUTACION
10026790;;M;56;CHILENO;;Boomers;RENCA                         ;METROPOLITANA;0;0;0;0;0;0;0;0;0;MULTIFUNCIONAL ECOTANK L3110;COMPUTACION
16776768;;F;34;CHILENO;;Millenial;PROVIDENCIA                   ;METROPOLITANA;0;0;0;0;0;0;0;0;0;TINTA BOTELLA NEGRA BTD60BK;COMPUTACION
5704648;;F;78;CHILENO;;Silencioso;CABILDO                       ;VALPARAISO;0;0;0;0;0;0;0;0;0;TAB 7 MB4 Plus 4Core 1GB 16GB 7 Plata;COMPUTACION
10284947;;M;41;CHILENO;;X;PROVIDENCIA                   ;METROPOLITANA;0;0;0;0;0;0;0;0;0;NTBK Gaming 3i Core i5-10300H 8GB 1TB 1650 4GB;COMPUTACION
9951062;;F;56;CHILENO;;Boomers;RENCA                         ;METROPOLITANA;0;0;0;0;0;0;0;0;0;TAB MLAB MBX 8 QUAD CORE 1G+16G 8716;COMPUTACION
17516795;;M;31;CHILENO;;Millenial;QUILLOTA                      ;VALPARAISO;0;0;0;0;0;0;0;0;0;NTBK G7 240 Intel Celeron 4GB 500GB 14;COMPUTACION
11260563;;F;53;CHILENO;;X;COPIAPO                       ;ATACAMA;0;0;0;0;0;0;0;0;0;TAB MBXR 8717 4Core 2GB 16GB 10 Negra;COMPUTACION
19043415;;F;26;CHILENO;;Z;TALCA                         ;MAULE;0;0;0;0;0;0;0;0;0;TAB Matepad T8 wifi 2GB 16GB;COMPUTACION
8288808;;M;52;CHILENO;;X;HUALPEN;BIO BIO;0;0;0;0;0;0;0;0;0;TAB Galaxy Tab A 10.1 8Core 2GB 32GB 10 Negra;COMPUTACION
15540755;;F;39;CHILENO;;X;EL BOSQUE                     ;METROPOLITANA;0;0;0;0;0;0;0;0;0;NTBK IP3 Athlon 3050U/4GB/500GB/15P;COMPUTACION
14075735;Soltero;M;41;CHILENO;;X;PROVIDENCIA                   ;METROPOLITANA;0;0;0;0;0;0;0;0;0;TAB Matepad T8 wifi 2GB 16GB;COMPUTACION
19667838;;M;24;CHILENO;;Z;PROVIDENCIA                   ;METROPOLITANA;0;0;0;0;0;0;0;0;0;TAB Galaxy Tab A 10.1 8Core 2GB 32GB 10 Negra;COMPUTACION
9069407;;M;60;CHILENO;;Boomers;ALTO HOSPICIO;TARAPACA;0;0;0;0;0;0;0;0;0;TAB Galaxy Tab A 8 4Core 2GB 32GB 8 Negra;COMPUTACION
11805032;;F;52;CHILENO;;X;PANGUIPULLI                   ;LOS LAGOS;0;0;0;0;0;0;0;0;0;TAB M7 QC 1GB 8GB 7P Gris;COMPUTACION
10311247;;F;61;CHILENO;;Boomers;CASTRO                        ;LOS LAGOS;0;0;0;0;0;0;0;0;0;TAB 7 PLAY AND LEARN PLUS PURPLE 8867;COMPUTACION
8527450;Viudo;M;60;CHILENO;;Boomers;RENCA                         ;METROPOLITANA;0;0;0;0;0;0;0;0;0;NTBK IP3 Athlon 3050U/4GB/500GB/15P;COMPUTACION
7370667;;M;69;CHILENO;;Silencioso;SAN MIGUEL                    ;METROPOLITANA;0;0;0;0;0;0;0;0;0;TAB MBX Cinema 8866 OctaCore 2GB 32GB 10P;COMPUTACION
8851439;Casado;M;56;CHILENO;;Boomers;RENCA                         ;METROPOLITANA;0;0;0;0;0;0;0;0;0;TAB Matepad 10.4;COMPUTACION
16631434;;F;35;CHILENO;;Millenial;CONCEPCION                    ;BIO BIO;0;0;0;0;0;0;0;0;0;Galaxy Tab A7 (10.4 ,32GB, WIFI) Dark Gray;COMPUTACION
12029866;;M;46;CHILENO;;X;OSORNO                        ;LOS LAGOS;0;0;0;0;0;0;0;0;0;TAB MLAB MBX 8 QUAD CORE 1G+16G 8716;COMPUTACION
17822532;Soltero;M;31;CHILENO;;Millenial;PROVIDENCIA                   ;METROPOLITANA;0;0;0;0;0;0;0;0;0;Tab M10 Plus FHD 4GB 64GB 10.3P platinum grey;COMPUTACION
12664240;;F;48;CHILENO;;X;PROVIDENCIA                   ;METROPOLITANA;0;0;0;0;0;0;0;0;0;Galaxy Tab A7 (10.4 ,32GB, WIFI) Silver;COMPUTACION
12906306;;F;47;CHILENO;;X;PROVIDENCIA                   ;METROPOLITANA;0;0;0;0;0;0;0;0;0;TABLET GALAXY TAB S5e (720) Dorado;COMPUTACION
12486864;;M;49;CHILENO;;X;PROVIDENCIA                   ;METROPOLITANA;0;0;0;0;0;0;0;0;0;TAB 7 MB4 Plus 4Core 1GB 16GB 7 Plata;COMPUTACION
17127007;;M;36;CHILENO;;Millenial;PROVIDENCIA                   ;METROPOLITANA;0;0;0;0;0;0;0;0;0;TAB MLAB MBX 8 QUAD CORE 1G+16G 8716;COMPUTACION
10979991;;F;49;CHILENO;;X;PROVIDENCIA                   ;METROPOLITANA;0;0;0;0;0;0;0;0;0;NTBK IP3 Core i3-1005G1 4GB 256SSD 14P;COMPUTACION
11891704;;F;51;CHILENO;;X;RANCAGUA                      ;L.G.B.OÂ´HIGGINS;0;0;0;0;0;0;0;0;0;TAB 7 MB4 Plus 4Core 1GB 16GB 7 Plata;COMPUTACION
17664867;Soltero;M;31;CHILENO;TECNICO DE NIVEL SUPERIOR EN ENFERMERIA;Millenial;PROVIDENCIA                   ;METROPOLITANA;0;0;0;0;0;0;0;0;0;NTBK Matebook 13 Core i5-10210U 8GB 512SSD 13P;COMPUTACION
16459734;;M;35;CHILENO;;Millenial;PROVIDENCIA                   ;METROPOLITANA;0;0;0;0;0;0;0;0;0;MULTIFUNCIONAL ECOTANK L4160 Wifi;COMPUTACION
18256446;;M;29;CHILENO;;Millenial;PROVIDENCIA                   ;METROPOLITANA;0;0;0;0;0;0;0;0;0;Impresora Laser HL-1202 Monocromatica;COMPUTACION
15009878;;M;39;CHILENO;;X;PROVIDENCIA                   ;METROPOLITANA;0;0;0;0;0;0;0;0;0;NTBK 15-dk1022la Core i7 8+16 256SSD 1650 4GB;COMPUTACION
13469933;;F;43;CHILENO;;X;PROVIDENCIA                   ;METROPOLITANA;0;0;0;0;0;0;0;0;0;MULTIFUNCIONAL DCP-T710W Wifi/ ADF;COMPUTACION
19713322;;F;24;CHILENO;;Z;N/D;N/D;0;0;0;0;0;0;0;0;0;TAB 7 PLAY AND LEARN PLUS PURPLE 8867;COMPUTACION
12370625;Divorciado;F;48;CHILENO;CONTADOR AUDITOR;X;RENCA                         ;METROPOLITANA;0;0;0;0;0;0;0;0;0;NTBK IP3 AMD Ryzen 5-4500U 8GB 1TB 15P;COMPUTACION
19305181;;F;26;CHILENO;;Z;TEMUCO                        ;ARAUCANIA;0;0;0;0;0;0;0;0;0;NTBK A315-42-R0W1-1 Ryzen 7-3700U 8GB 256SSD 15P;COMPUTACION
15144037;;M;40;CHILENO;;X;CALAMA                        ;ANTOFAGASTA;0;0;0;0;0;0;0;0;0;NTBK 240 G7 Core i3-1005G1 4GB 1TB 14P;COMPUTACION
15414397;Soltero;M;39;CHILENO;;X;RENCA                         ;METROPOLITANA;0;0;0;0;0;0;0;0;0;TAB Galaxy Tab A 8 4Core 2GB 32GB 8 Gris;COMPUTACION
8596546;;F;64;CHILENO;;Boomers;VINA DEL MAR                  ;VALPARAISO;0;0;0;0;0;0;0;0;0;MULTIFUNCIONAL ECOTANK L5190 Wifi/ Fax;COMPUTACION
15162451;;F;40;CHILENO;;X;CHILLAN                       ;BIO BIO;0;0;0;0;0;0;0;0;0;TAB Galaxy Tab A 8 4G 4Core 2GB 32GB 8 Gris;COMPUTACION
17133667;;M;32;CHILENO;;Millenial;PROVIDENCIA                   ;METROPOLITANA;0;0;0;0;0;0;0;0;0;NTBK 15-dk0015 Core i5-9300H 8GB 256SSD 1050 3GB;COMPUTACION
6982618;;F;70;CHILENO;;Silencioso;MAIPU                         ;METROPOLITANA;0;0;0;0;0;0;0;0;0;MULTIFUNCIONAL ECOTANK L3150 Wifi;COMPUTACION
17957378;Soltero;M;31;CHILENO;;Millenial;PROVIDENCIA                   ;METROPOLITANA;0;0;0;0;0;0;0;0;0;NTBK 15-ek0007la Core i7 16+32GB 512SSD 2070 8GB;COMPUTACION
15719102;;F;38;CHILENO;;X;QUILPUE                       ;VALPARAISO;0;0;0;0;0;0;0;0;0;NTBK IP3 Athlon 3050U/4GB/500GB/15P;COMPUTACION
9894592;;M;57;CHILENO;;Boomers;SALAMANCA                     ;COQUIMBO;0;0;0;0;0;0;0;0;0;MULTIFUNCIONAL ECOTANK L3150 Wifi;COMPUTACION
14066805;;M;40;CHILENO;;X;PROVIDENCIA                   ;METROPOLITANA;0;0;0;0;0;0;0;0;0;NTBK G7 240 Intel Celeron 4GB 500GB 14;COMPUTACION
15428210;;M;39;CHILENO;;X;"";"";0;0;0;0;0;0;0;0;0;TAB Galaxy Tab A 10.1 4G 8Core 2GB 32GB 10 Gold;COMPUTACION
16185367;;M;36;CHILENO;;Millenial;RANCAGUA                      ;L.G.B.OÂ´HIGGINS;0;0;0;0;0;0;0;0;0;NTBK HP 15-da0082la Pentium 4GB 500GB 15P;COMPUTACION
13087552;;M;47;CHILENO;;X;SAN RAMON                     ;METROPOLITANA;0;0;0;0;0;0;0;0;0;TAB Galaxy Tab A 10.1 4G 8Core 2GB 32GB 10 Gold;COMPUTACION
25764324;;F;41;VENEZOLANO;;Extranjero;PROVIDENCIA                   ;METROPOLITANA;0;0;0;0;0;0;0;0;0;NTBK IP3 Athlon 3050U/4GB/500GB/15P;COMPUTACION
15693830;;M;38;CHILENO;;X;PROVIDENCIA                   ;METROPOLITANA;0;0;0;0;0;0;0;0;0;TAB GALAXY S6 (T860) 6GB 128GB 10.5;COMPUTACION
16709991;;F;35;CHILENO;;Millenial;LA PINTANA                    ;METROPOLITANA;0;0;0;0;0;0;0;0;0;MULTIFUNCIONAL ECOTANK L3110;COMPUTACION
25760990;;M;44;EXTRANJERO - NO INFORMA NACIONALIDAD;;Extranjero;SAN RAMON                     ;METROPOLITANA;0;0;0;0;0;0;0;0;0;TAB Matepad T8 4G LTE 2GB 16GB;COMPUTACION
19970326;;F;24;CHILENO;;Z;PROVIDENCIA                   ;METROPOLITANA;0;0;0;0;0;0;0;0;0;NTBK G7 240 Intel Celeron 4GB 500GB 14;COMPUTACION
15491089;;F;39;CHILENO;;X;CHILLAN                       ;BIO BIO;0;0;0;0;0;0;0;0;0;TAB 7 MB4 Plus 4Core 1GB 16GB 7 Plata;COMPUTACION
19016925;;F;27;CHILENO;;Z;PROVIDENCIA                   ;METROPOLITANA;0;0;0;0;0;0;0;0;0;TAB M8 QC 2GB 32GB 8P Gris;COMPUTACION
9256218;Casado;M;61;CHILENO;;Boomers;RENCA                         ;METROPOLITANA;0;0;0;0;0;0;0;0;0;MULTIFUNCIONAL ECOTANK L3150 Wifi;COMPUTACION
17294700;;M;32;CHILENO;;Millenial;"";"";0;0;0;0;0;0;0;0;0;TAB Galaxy Tab A 8 4G 4Core 2GB 32GB 8 Gris;COMPUTACION
19472310;;M;26;CHILENO;;Z;SAN CLEMENTE                  ;MAULE;0;0;0;0;0;0;0;0;0;NTBK G7 240 Intel Celeron 4GB 500GB 14;COMPUTACION
11233729;;F;54;CHILENO;;X;CURICO                        ;MAULE;0;0;0;0;0;0;0;0;0;TABLET LENOVO Tab 7 4G/1GB/16GB/7P;COMPUTACION
14231279;;F;53;CHILENO;;X;LOTA                          ;BIO BIO;0;0;0;0;0;0;0;0;0;TAB Mediapad T3 7 4Core 1GB 8GB 7 Gris;COMPUTACION
16768187;;F;34;CHILENO;;Millenial;PROVIDENCIA                   ;METROPOLITANA;0;0;0;0;0;0;0;0;0;NTBK 15-gw0016la AMD Athlon 8GB 256GBSSD 15P;COMPUTACION
12935617;;M;47;CHILENO;;X;ANCUD                         ;LOS LAGOS;0;0;0;0;0;0;0;0;0;NTBK G7 240 Intel Celeron 4GB 500GB 14;COMPUTACION
7047733;Casado;F;66;CHILENO;;Boomers;PROVIDENCIA                   ;METROPOLITANA;0;0;0;0;0;0;0;0;0;TAB M8 QC 2GB 32GB 8P Gris;COMPUTACION
16135743;Soltero;M;36;CHILENO;;Millenial;PROVIDENCIA                   ;METROPOLITANA;0;0;0;0;0;0;0;0;0;NTBK IP3 Athlon 3050U/4GB/500GB/15P;COMPUTACION
13708190;;M;43;CHILENO;;X;PROVIDENCIA                   ;METROPOLITANA;0;0;0;0;0;0;0;0;0;NTBK IP3 Ryzen 3-3250U/8GB/1TB/15P;COMPUTACION
16100476;;F;36;CHILENO;;Millenial;PROVIDENCIA                   ;METROPOLITANA;0;0;0;0;0;0;0;0;0;TAB Galaxy Tab A 10.1 4G 8Core 2GB 32GB 10 Gold;COMPUTACION
18392338;;F;29;CHILENO;;Millenial;PROVIDENCIA                   ;METROPOLITANA;0;0;0;0;0;0;0;0;0;NTBK 13-an1016la Core i7-1065G7 8+16 256SSD 13P;COMPUTACION
14627098;;M;42;CHILENO;;X;N/D;N/D;0;0;0;0;0;0;0;0;0;NTBK IP3 Athlon 3050U/4GB/500GB/15P;COMPUTACION
14490247;;M;46;CHILENO;;X;SAN FERNANDO                  ;L.G.B.OÂ´HIGGINS;0;0;0;0;0;0;0;0;0;TAB M8 QC 2GB 32GB 8P Gris;COMPUTACION
16428036;;M;35;CHILENO;;Millenial;PROVIDENCIA                   ;METROPOLITANA;0;0;0;0;0;0;0;0;0;MULTIFUNCIONAL ECOTANK L3150 Wifi;COMPUTACION
26342596;;F;40;EXTRANJERO - NO INFORMA NACIONALIDAD;;Extranjero;"";"";0;0;0;0;0;0;0;0;0;NTBK Matebook D15 AMD Ryzen 5 8GB 256SSD 15P;COMPUTACION
17337862;Soltero;M;32;CHILENO;;Millenial;PROVIDENCIA                   ;METROPOLITANA;0;0;0;0;0;0;0;0;0;NTBK 16-a0001 Core i5-10300H 8GB 512SSD 1650 4GB;COMPUTACION
14120515;;F;41;CHILENO;;Millenial;PANGUIPULLI                   ;LOS RIOS;0;0;0;0;0;0;0;0;0;TAB Galaxy Tab A 10.1 8Core 2GB 32GB 10 Negra;COMPUTACION
19007877;Soltero;F;27;CHILENO;PSICOLOGO;Z;PROVIDENCIA                   ;METROPOLITANA;0;0;0;0;0;0;0;0;0;NTBK 14-DQ1001 Core i3-1005G1 4+16 256SSD 14;COMPUTACION
18250365;Soltero;M;29;CHILENO;TECNICO DE NIVEL SUPERIOR EN NUTRICION Y DIETETICA;Millenial;PROVIDENCIA                   ;METROPOLITANA;0;0;0;0;0;0;0;0;0;NTBK IP3 Ryzen 3-3250U/8GB/1TB/15P;COMPUTACION
18847590;Soltero;F;28;CHILENO;TECNICO DE NIVEL MEDIO EN ALIMENTACION;Millenial;N/D;N/D;0;0;0;0;0;0;0;0;0;NTBK Matebook D14 AMD Ryzen 5 8GB 256SSD 14P;COMPUTACION
18540293;;M;29;CHILENO;;Millenial;N/D;N/D;0;0;0;0;0;0;0;0;0;NTBK 16-a0001 Core i5-10300H 8GB 512SSD 1650 4GB;COMPUTACION
17400915;;M;32;CHILENO;;Millenial;N/D;N/D;0;0;0;0;0;0;0;0;0;TAB Galaxy Tab A 8 4Core 2GB 32GB 8 Gris;COMPUTACION
13762709;Soltero;F;42;CHILENO;CONTADOR AUDITOR;X;RENCA                         ;METROPOLITANA;0;0;0;0;0;0;0;0;0;NTBK HP 14-cf0011la Ci3-8130U 4GB 128SSD 14P;COMPUTACION
11561813;Casado;F;52;CHILENO;;X;RENCA                         ;METROPOLITANA;0;0;0;0;0;0;0;0;0;NTBK IP3 Athlon 3050U/4GB/500GB/15P;COMPUTACION
19670960;;F;25;CHILENO;;Z;PROVIDENCIA                   ;METROPOLITANA;0;0;0;0;0;0;0;0;0;NTBK 14-ds002la AMD A4 4GB 64GB eMMC 14P;COMPUTACION
18221314;Soltero;F;30;CHILENO;;Millenial;PROVIDENCIA                   ;METROPOLITANA;0;0;0;0;0;0;0;0;0;NTBK 15-ek0010la Core i5 8+32 512SSD 2060 6GB;COMPUTACION
13969335;;F;42;CHILENO;;X;AISEN                         ;AYSEN;0;0;0;0;0;0;0;0;0;Multifuncional Smart Tank 515 Wifi;COMPUTACION
7406243;;F;67;CHILENO;;Boomers;PROVIDENCIA                   ;METROPOLITANA;0;0;0;0;0;0;0;0;0;NTBK IP3 Athlon 3050U/4GB/500GB/15P;COMPUTACION
16164785;;F;37;CHILENO;;Extranjero;SAN FERNANDO                  ;L.G.B.OÂ´HIGGINS;0;0;0;0;0;0;0;0;0;TAB M8 QC 2GB 32GB 8P Gris;COMPUTACION
10960413;;F;52;CHILENO;;X;CURICO                        ;MAULE;0;0;0;0;0;0;0;0;0;NTBK 14-DQ1001 Core i3-1005G1 4+16 256SSD 14;COMPUTACION
20171502;;F;23;CHILENO;;Extranjero;PROVIDENCIA                   ;METROPOLITANA;34980;2;1;2;1;34980;0;0;0;Cooler Soberana 35 Litros SP0103-68;MERCADO ABC
18762774;Soltero;M;28;CHILENO;;Millenial;PROVIDENCIA                   ;METROPOLITANA;18980;2;1;2;1;18980;0;0;0;Repisa Cascada Blanco 25x25x81.5cm;MERCADO ABC
18537459;;F;29;CHILENO;;Millenial;EL QUISCO;VALPARAISO;194940;5;2;5;2;194940;0;0;0;Silla de Comer Vectra Azul;MERCADO ABC
20196164;;F;22;CHILENO;;Z;PENCO;BIO-BIO;184660;6;3;6;3;184660;0;0;0;BATERIA 7 PZS SLIDE AZUL;MERCADO ABC
20563787;;M;21;CHILENO;;Millenial;"";"";32980;2;1;2;1;32980;0;0;0;Set Mancuernas Con Barra Ajustable 10Kg K-FIT;MERCADO ABC
19216571;;F;26;CHILENO;;Z;PROVIDENCIA                   ;METROPOLITANA;642940;6;4;6;4;642940;0;0;0;Juego comedor Perola Blanco 4 sillas Nicoli Blan;MERCADO ABC
13050229;Casado;F;46;CHILENO;TECNICO EN SONIDO;X;RENCA                         ;METROPOLITANA;43980;2;1;2;1;43980;0;0;0;CASA PARA PERRO RIMAX PEQUENA TECHO AZUL;MERCADO ABC
18835682;;F;28;CHILENO;;Millenial;LO PRADO                      ;METROPOLITANA;31980;2;1;2;1;31980;0;0;0;AUTO CORREPASILLOS CON LUZ BLANCO;MERCADO ABC
18180570;;M;30;CHILENO;;Millenial;PROVIDENCIA                   ;METROPOLITANA;198980;2;1;2;1;198980;0;0;0;HOME VENECIA BLANCO HOME VIBES;MERCADO ABC
17602109;;F;31;CHILENO;;Millenial;PENALOLEN;METROPOLITANA;251930;6;2;6;2;251930;0;0;0;MESA DE CENTRO BENGALI - CONAC / WENGUE MCW 4400;MERCADO ABC
17045973;;M;33;CHILENO;;Silencioso;PROVIDENCIA                   ;METROPOLITANA;0;0;2;0;2;0;0;0;0;Baby Monitor Lite SoyMomo Azul;MERCADO ABC
17908313;;F;30;CHILENO;;Millenial;EL BOSQUE;METROPOLITANA;712900;8;3;8;3;712900;0;0;0;Plataforma Vibratoria FullFit 7000 4D Bluetooth;MERCADO ABC
26917509;;M;31;NO INFORMA NACIONALIDAD;;Extranjero;PROVIDENCIA                   ;METROPOLITANA;106960;3;1;3;1;106960;0;0;0;KIT COCINA 120 PORRA;MERCADO ABC
16088790;Soltero;M;36;CHILENO;INGENIERO INFORMATICO;Millenial;PROVIDENCIA                   ;METROPOLITANA;43980;2;1;2;1;43980;0;0;0;LIBRERO OFFICE 1 - WENGUE;MERCADO ABC
19750624;;M;24;CHILENO;;Silencioso;PROVIDENCIA                   ;METROPOLITANA;328980;2;1;2;1;328980;0;0;0;Motor Loncin Gas. G390f 13hp;MERCADO ABC
26720953;;M;44;NO INFORMA NACIONALIDAD;;Extranjero;"";"";166960;4;2;4;2;166960;0;0;0;S Comer Snack SXVERDE;MERCADO ABC
12460348;;F;49;CHILENO;;X;LAS CONDES                    ;METROPOLITANA;214980;2;1;2;1;214980;0;0;0;BUFFET IRON MOSAICO;MERCADO ABC
9137332;;F;61;CHILENO;;Silencioso;NINHUE                        ;BIO BIO;1468680;7;1;0;0;0;7;1;1468680;JGO LIVING IRLANDA 3.2 C/AZUL;MERCADO ABC
4965401;;F;82;CHILENO;;Silencioso;ANCUD                         ;LOS LAGOS;142980;2;1;2;1;142980;0;0;0;Bicicleta De Spinning Boonen K-FIT;MERCADO ABC
13661806;;F;43;CHILENO;;Millenial;PROVIDENCIA                   ;METROPOLITANA;25980;2;1;2;1;25980;0;0;0;Plumon Single Colo Colo Invencible;MERCADO ABC
16415333;Soltero;F;36;CHILENO;DISENADOR GRAFICO;Silencioso;PROVIDENCIA                   ;METROPOLITANA;47960;3;1;3;1;47960;0;0;0;Sabana Bordada. 144 Hilos Super king Globo Coral;MERCADO ABC
11666068;;F;52;CHILENO;;X;SAN JOAQUIN                   ;METROPOLITANA;93980;2;1;2;1;93980;0;0;0;Juego comedor Perola Blanco 4 sillas Nicoli Blan;MERCADO ABC
18961162;Soltero;F;27;CHILENO;;Millenial;TALAGANTE                     ;METROPOLITANA;589980;2;1;2;1;589980;0;0;0;COMEDOR MARSELLA 1 + 4 + 2;MERCADO ABC
20013393;;M;23;CHILENO;;Z;VILLA ALEMANA                 ;VALPARAISO;445980;2;1;2;1;445980;0;0;0;COMEDOR PRISMA 6 S NOGAL;MERCADO ABC
10601432;Casado;F;50;CHILENO;PSICOLOGO;X;PROVIDENCIA                   ;METROPOLITANA;16980;2;1;2;1;16980;0;0;0;Sabana MF Single Paw Patrol-Nino Action;MERCADO ABC
13950066;;M;42;CHILENO;;X;SAN MIGUEL                    ;METROPOLITANA;81960;3;1;3;1;81960;0;0;0;Plumon Coral Sherpa Super King Verde;MERCADO ABC
16903355;;F;33;CHILENO;;Millenial;LA GRANJA                     ;METROPOLITANA;82970;3;4;4;2;81960;-1;2;1010;Casa Para Perro Large Con Ventilacion Coolpets 9;MERCADO ABC
7697843;;M;63;CHILENO;;Boomers;PUENTE ALTO                   ;METROPOLITANA;43980;2;1;2;1;43980;0;0;0;OLLA A PRESION DYNAMIC 5 LTS;MERCADO ABC
16419737;;M;36;CHILENO;;Millenial;PROVIDENCIA                   ;METROPOLITANA;236970;3;1;3;1;236970;0;0;0;BAR ESQUINERO KAVA BEIJING CONAC BLC 4457;MERCADO ABC
9748342;;F;59;CHILENO;;Boomers;PROVIDENCIA                   ;METROPOLITANA;53980;2;1;2;1;53980;0;0;0;MESA DE CENTRO CROSS 100X50X45CM;MERCADO ABC
14213246;Casado;F;41;CHILENO;CONTADOR AUDITOR;X;PROVIDENCIA                   ;METROPOLITANA;403980;2;1;2;1;403980;0;0;0;SOFA MIRA 3 CPO CUE BITONO RSN;MERCADO ABC
12865799;;M;47;CHILENO;;X;"";"";395980;2;1;2;1;395980;0;0;0;RACK RENNES BLANCO;MERCADO ABC
16624535;;M;35;CHILENO;;Millenial;MAIPU;METROPOLITANA;123980;2;1;2;1;123980;0;0;0;PACK DE GUITARRA ACUSTICA MAC01 NATURAL;MERCADO ABC
19050736;;F;27;CHILENO;;Z;LOS ANGELES                   ;BIO BIO;41970;3;1;3;1;41970;0;0;0;SET BATERIA CON PISO;MERCADO ABC
17827450;;F;30;CHILENO;;Millenial;PROVIDENCIA                   ;METROPOLITANA;42980;2;1;2;1;42980;0;0;0;MUEBLE MICROONDAS ESTRELLA BLANCO FVTX;MERCADO ABC
6344007;Casado;M;66;CHILENO;PROFESOR;Boomers;PROVIDENCIA                   ;METROPOLITANA;71980;2;1;2;1;71980;0;0;0;APARADOR RT 3021 BLANCO;MERCADO ABC
16129436;;M;36;CHILENO;;Millenial;PROVIDENCIA                   ;METROPOLITANA;137970;3;1;3;1;137970;0;0;0;BIBLIOTECA ESCALERA SALAMANCA - WENGUE;MERCADO ABC
10540361;;M;56;CHILENO;;Boomers;PROVIDENCIA                   ;METROPOLITANA;82950;5;2;5;2;82950;0;0;0;Cubrecolchon impermeable y respirable x 1.90 mts;MERCADO ABC
19363726;;M;25;CHILENO;;Z;N/D;N/D;29980;2;1;2;1;29980;0;0;0;Plumon Microfibra Sherpa Single D.Ball Z Fight;MERCADO ABC
18485741;;F;28;CHILENO;;Millenial;PROVIDENCIA                   ;METROPOLITANA;157980;2;1;2;1;157980;0;0;0;CENTRO DE ENTRETENIMIENTO RAVENA TV60 - MIEL / P;MERCADO ABC
17631995;;F;31;CHILENO;;Millenial;"";"";140960;3;1;3;1;140960;0;0;0;MUEBLE DE LAVAMANOS MADRID - WENGUE;MERCADO ABC
16281020;;F;36;CHILENO;;Millenial;LINARES                       ;MAULE;3990;1;1;0;0;0;1;1;3990;Colchoneta Outback Eva Aluminizada;MERCADO ABC
18754755;;F;27;CHILENO;;Millenial;COLLIPULLI                    ;ARAUCANIA;156980;2;1;2;1;156980;0;0;0;Bicicleta De Spinning Strong Pro-Fit K-FIT;MERCADO ABC
19118631;;F;26;CHILENO;;Millenial;"";"";24980;2;1;2;1;24980;0;0;0;Termo Sifon Acero 1,5 Lt Metalico Thermos;MERCADO ABC
19429730;;F;25;CHILENO;;Z;N/D;N/D;183980;2;1;2;1;183980;0;0;0;Bicicleta De Spinning Strong Pro-Fit K-FIT;MERCADO ABC
18496310;;F;29;CHILENO;;Millenial;PROVIDENCIA                   ;METROPOLITANA;81970;3;1;3;1;81970;0;0;0;SILLA FUNCIONAL NAPOLES C/BRAZOS - NEGRA / NEGRA;MERCADO ABC
17351529;;F;32;CHILENO;;Millenial;NINHUE                        ;BIO BIO;55840;2;1;2;1;55840;0;0;0;Mesa Plegable Tipo Maleta + 4 Pisos 120Cms;MERCADO ABC
19512643;Soltero;M;26;CHILENO;;Z;PROVIDENCIA                   ;METROPOLITANA;270830;3;2;2;1;255840;1;1;14990;Trotadora Electrica Baldini 1,5HP;MERCADO ABC
14169676;;F;44;CHILENO;;Silencioso;PROVIDENCIA                   ;METROPOLITANA;31970;3;1;3;1;31970;0;0;0;Mopa con atomizador P12 Boomjoy;MERCADO ABC
17598954;;F;32;CHILENO;;Millenial;SAN VICENTE                   ;L.G.B.OÂ´HIGGINS;27970;3;1;3;1;27970;0;0;0;AUTO R/C DESERT REBELS 070 MAY;MERCADO ABC
15551977;Soltero;M;36;CHILENO;INGENIERO CIVIL INDUSTRIAL;Millenial;PROVIDENCIA                   ;METROPOLITANA;56980;2;1;2;1;56980;0;0;0;CAMA ACOLCHADA MASCOTA T/M;MERCADO ABC
17333367;;F;32;CHILENO;;Millenial;PROVIDENCIA                   ;METROPOLITANA;32530;3;1;3;1;32530;0;0;0;AUTO RADIO CONTROL 3 RUEDAS;MERCADO ABC
26670075;Soltero;F;36;VENEZOLANO;;Extranjero;"";"";12980;2;1;2;1;12980;0;0;0;ALZADOR BEBESIT CS101 ROJO;MERCADO ABC
13817181;;M;42;CHILENO;;Silencioso;PROVIDENCIA                   ;METROPOLITANA;52840;2;1;2;1;52840;0;0;0;Set Mancuernas Con Barra Ajustable 20Kg K-FIT;MERCADO ABC
20105554;;F;23;CHILENO;;Silencioso;N/D;N/D;299990;2;1;2;1;299990;0;0;0;Trotadora Electrica Baldini 1,5HP;MERCADO ABC
18942760;;M;26;CHILENO;;Z;CURACAUTIN;ARAUCANIA;314980;2;1;2;1;314980;0;0;0;Trotadora Electrica Baldini 1,5HP;MERCADO ABC
7984191;;F;63;CHILENO;;Boomers;N/D;N/D;199980;2;1;2;1;199980;0;0;0;Bicicleta De Spinning Boonen K-FIT;MERCADO ABC
11670724;;F;52;CHILENO;;X;RANCAGUA                      ;L.G.B.OÂ´HIGGINS;328980;2;1;2;1;328980;0;0;0;Trotadora Electrica Spirig 1,5HP;MERCADO ABC
11693737;;M;51;CHILENO;;X;PROVIDENCIA                   ;METROPOLITANA;459980;2;1;2;1;459980;0;0;0;SET MUEBLES PARA TERRAZA NORTHWEST MENORCA;MERCADO ABC
18761402;;F;27;CHILENO;;Z;N/D;N/D;2990;1;1;0;0;0;1;1;2990;JUEGOS DE MESA FAST FUN;MERCADO ABC
7560055;;M;65;CHILENO;;Boomers;SAN VICENTE                   ;L.G.B.OÂ´HIGGINS;195360;3;1;0;0;0;3;1;195360;TECLADO CT-S200BKC2 ESTANDAR CASIOTONE C/ TRANSF;MERCADO ABC
15170876;;F;39;CHILENO;;X;N/D;N/D;0;0;0;0;0;0;0;0;0;MESA DE HERRAMIENTAS CON BLOQUES;MERCADO ABC
20238249;;M;23;CHILENO;;Silencioso;PROVIDENCIA                   ;METROPOLITANA;0;0;0;0;0;0;0;0;0;100 Toallas De Entrenamiento Mascotas 45x60cm;MERCADO ABC
16464988;;F;35;CHILENO;;Millenial;PROVIDENCIA                   ;METROPOLITANA;0;0;0;0;0;0;0;0;0;AUTO R/C DESERT REBELS 070 MAY;MERCADO ABC
13343858;;F;43;CHILENO;;X;PROVIDENCIA                   ;METROPOLITANA;0;0;0;0;0;0;0;0;0;WALKIE TALKIE SPIDERMAN;MERCADO ABC
15327825;Divorciado;F;40;CHILENO;ABOGADO;Silencioso;PROVIDENCIA                   ;METROPOLITANA;0;0;0;0;0;0;0;0;0;TECLADO MONOFONICO NINO;MERCADO ABC
8155830;Soltero;F;66;CHILENO;;Boomers;RENCA                         ;METROPOLITANA;0;0;0;0;0;0;0;0;0;MESA BAR PLEGABLE NORTHWEST 80 CM;MERCADO ABC
15768999;Casado;F;38;CHILENO;;Millenial;PROVIDENCIA                   ;METROPOLITANA;0;0;0;0;0;0;0;0;0;WALKIE TALKIE SPIDERMAN;MERCADO ABC
15359779;;M;39;CHILENO;;Silencioso;PROVIDENCIA                   ;METROPOLITANA;0;0;0;0;0;0;0;0;0;GRUA PLUMA RADIO CONTROL;MERCADO ABC
16600121;;F;34;CHILENO;;Millenial;PROVIDENCIA                   ;METROPOLITANA;0;0;0;0;0;0;0;0;0;Colchoneta Outback Eva Aluminizada;MERCADO ABC
25243723;;F;43;PERUANO;;Extranjero;IQUIQUE                       ;TARAPACA;0;0;0;0;0;0;0;0;0;PLUMON MINNIE 1,5 P;MERCADO ABC
18177414;Soltero;F;29;CHILENO;AUXILIAR PARAMEDICO DE ODONTOLOGIA;Millenial;PROVIDENCIA                   ;METROPOLITANA;0;0;0;0;0;0;0;0;0;SAXO ALTO LSXA1;MERCADO ABC
17441800;Soltero;F;32;CHILENO;INGENIERO INFORMATICO;Millenial;PROVIDENCIA                   ;METROPOLITANA;0;0;0;0;0;0;0;0;0;B5521 PD Hamburguesas a la Parrilla;MERCADO ABC
14261544;;M;47;CHILENO;;X;SAN FERNANDO                  ;L.G.B.OÂ´HIGGINS;0;0;0;0;0;0;0;0;0;PARRILLA A GAS 2 QUEMADORES;MERCADO ABC
17882077;;F;30;CHILENO;;Millenial;PROVIDENCIA                   ;METROPOLITANA;0;0;0;0;0;0;0;0;0;Colchoneta Outback Eva Aluminizada;MERCADO ABC
17286208;;F;32;CHILENO;;Millenial;PROVIDENCIA                   ;METROPOLITANA;0;0;0;0;0;0;0;0;0;JUEGO PHILL EL REFRIGERADOR;MERCADO ABC
14378068;Soltero;M;43;CHILENO;;X;PROVIDENCIA                   ;METROPOLITANA;0;0;0;0;0;0;0;0;0;PERGOLA 300x300x250CM;MERCADO ABC
17334674;Casado;M;32;CHILENO;;Millenial;PROVIDENCIA                   ;METROPOLITANA;0;0;0;0;0;0;0;0;0;JUEGO TERRAZA CUERDA ALGODON;MERCADO ABC
13992488;;M;41;CHILENO;;X;RENCA                         ;METROPOLITANA;0;0;0;0;0;0;0;0;0;SET 125 DESAFIOS CIENTIFICOS;MERCADO ABC
9301178;;M;60;CHILENO;;Boomers;RENCA                         ;METROPOLITANA;0;0;0;0;0;0;0;0;0;Bianchi Trotadora Motorizada Bft-2515;MERCADO ABC
18136353;;M;30;CHILENO;;Millenial;PROVIDENCIA                   ;METROPOLITANA;0;0;0;0;0;0;0;0;0;TECLADO CT-S100 61 TECLAS CON TRANSFORMADOR;MERCADO ABC
12881326;;M;46;CHILENO;;X;PROVIDENCIA                   ;METROPOLITANA;0;0;0;0;0;0;0;0;0;Bianchi Eliptica E-1250;MERCADO ABC
14123465;;M;40;CHILENO;;X;PROVIDENCIA                   ;METROPOLITANA;0;0;0;0;0;0;0;0;0;GUITARRA CLASICA MGN01-P NINO (PINK);MERCADO ABC
17052567;;M;33;CHILENO;;Millenial;EL MONTE                      ;METROPOLITANA;0;0;0;0;0;0;0;0;0;MPH Papa Tematico Pirata/En la Playa B0093 HAS;MERCADO ABC
15574631;;F;31;CHILENO;;Millenial;OVALLE                        ;COQUIMBO;0;0;0;0;0;0;0;0;0;TRANSFORMER CON 15 BLOQUES Y SONIDOS;MERCADO ABC
17401298;;M;32;CHILENO;;Millenial;PROVIDENCIA                   ;METROPOLITANA;0;0;0;0;0;0;0;0;0;SABANA POLAR ESTAMPADA MUSTARD 1,5P;MERCADO ABC
17677624;;M;31;CHILENO;;Millenial;PROVIDENCIA                   ;METROPOLITANA;0;0;0;0;0;0;0;0;0;Puma Big Cat 2 Ball Verde-Azul;MERCADO ABC
18141495;Soltero;M;29;CHILENO;;Millenial;PROVIDENCIA                   ;METROPOLITANA;0;0;0;0;0;0;0;0;0;MONOPOLY BANCO ELECTRONICO;MERCADO ABC
19152772;;F;26;CHILENO;;Z;PROVIDENCIA                   ;METROPOLITANA;0;0;0;0;0;0;0;0;0;SILLA COMEDOR TERRAZA;MERCADO ABC
24396878;;M;31;IRAQUÃ;;Extranjero;"";"";0;0;0;0;0;0;0;0;0;MUNECA EQUESTRIA GIRL CON PONY;MERCADO ABC
13586377;;F;42;CHILENO;;X;N/D;N/D;0;0;0;0;0;0;0;0;0;TECLADO HARMONY61 61T CON SILLIN Y STAND ALESIS;MERCADO ABC
14428578;;F;47;CHILENO;;X;RENCA                         ;METROPOLITANA;0;0;0;0;0;0;0;0;0;PLUMON ESTAMPADO 2P OCRE;MERCADO ABC
19610555;;F;25;CHILENO;;Z;CURICO                        ;MAULE;0;0;0;0;0;0;0;0;0;COLUMPIO TERRAZA C/QUITASOL VERDE 469 PLI;MERCADO ABC
8393858;;F;57;CHILENO;;Boomers;LOS ANGELES                   ;BIO BIO;0;0;0;0;0;0;0;0;0;PACK FRAZADAS STONE 1,5P;MERCADO ABC
13693840;Soltero;F;43;CHILENO;TECNICO EN ADMINISTRACION DE EMPRESAS;X;PROVIDENCIA                   ;METROPOLITANA;0;0;0;0;0;0;0;0;0;CAMION VOLCADOR;MERCADO ABC
16398372;;F;35;CHILENO;;Millenial;PENAFLOR                      ;METROPOLITANA;0;0;0;0;0;0;0;0;0;COLUMPIO TERRAZA C/QUITASOL VERDE 469 PLI;MERCADO ABC
16403979;Soltero;F;36;CHILENO;EDUCADOR DE PARVULO;Millenial;RENCA                         ;METROPOLITANA;0;0;0;0;0;0;0;0;0;PUF CASS MADERA BEIGE;MERCADO ABC
14060266;;M;41;CHILENO;;X;TALCAHUANO                    ;BIO BIO;35590;5;5;0;0;0;5;5;35590;Bolsa Papel Abcdin;PROMOCIONES
18214435;;F;30;CHILENO;;Millenial;PROVIDENCIA                   ;METROPOLITANA;13240;2;2;1;1;12990;1;1;250;Bolsa Papel Grande Abcdin;PROMOCIONES
15553083;;M;35;CHILENO;;Millenial;IQUIQUE                       ;TARAPACA;990;1;1;0;0;0;1;1;990;KEY FINDER ASD-ATL1003-1;PROMOCIONES
19549899;;M;25;CHILENO;;Millenial;"";"";900;6;1;0;0;0;6;1;900;Bolsa Papel Abcdin;PROMOCIONES
9284105;;M;58;CHILENO;;Boomers;CHIGUAYANTE                   ;BIO BIO;150;1;1;0;0;0;1;1;150;Bolsa Papel Abcdin;PROMOCIONES
17575791;;F;32;CHILENO;;Millenial;MAIPU                         ;METROPOLITANA;0;0;2;4;1;229990;-4;1;-229990;OMO MULTIACCION POLVO BOLSA 400 G;PROMOCIONES
19267358;;M;26;CHILENO;;Z;LOS ANDES                     ;VALPARAISO;0;0;0;0;0;0;0;0;0;KEY FINDER ASD-ATL1003-2;PROMOCIONES
6681564;;M;72;CHILENO;;Silencioso;VINA DEL MAR                  ;VALPARAISO;166980;2;1;0;0;0;2;1;166980;Freezer 99Lts MFH-1000B131CN Horizontal;LINEA BLANCA
4369957;;F;81;CHILENO;;Silencioso;ESTACION CENTRAL              ;METROPOLITANA;293200;3;1;0;0;0;3;1;293200;Refrigerador 244Lts Frio Directo Progress 3100;LINEA BLANCA
15497511;;F;37;CHILENO;;Millenial;MELIPILLA                     ;METROPOLITANA;855760;5;2;0;0;0;5;2;855760;Cocina F 5500 T 5P Reflex Silver;LINEA BLANCA
22516119;;M;37;PERUANO;;Extranjero;ARICA                         ;ARICA Y PARINACOTA;437120;5;3;0;0;0;5;3;437120;Lavadora Semiautomatica Twister 5300 4Kg;LINEA BLANCA
17496309;;F;32;CHILENO;;Millenial;TALCA;MAULE;396980;2;1;2;1;396980;0;0;0;Lavadora Secadora MLSF-13510SC01I 13,5Kg/10Kg Gr;LINEA BLANCA
15503005;;M;39;CHILENO;;X;RENCA                         ;METROPOLITANA;514950;5;2;5;2;514950;0;0;0;ENCIMERA UT PRIME G4 GL;LINEA BLANCA
13750187;;F;42;CHILENO;;X;CATEMU                        ;VALPARAISO;447960;4;2;0;0;0;4;2;447960;Lavadora Efficace SZG 17,5Kg Silver;LINEA BLANCA
20205654;;F;22;CHILENO;;Z;N/D;N/D;159860;3;2;1;1;99990;2;1;59870;Calefont 5Lts GL Essenetial ECO;LINEA BLANCA
16851595;;F;34;CHILENO;;Millenial;SAN ESTEBAN                   ;VALPARAISO;560830;6;5;0;0;0;6;5;560830;Lavadora Premium Care 20SZ 20Kg Silver;LINEA BLANCA
11608907;;F;51;CHILENO;;X;MELIPILLA                     ;METROPOLITANA;1010102;8;6;0;0;0;8;6;1010102;Secadora Ropa MD100A90/W 9Kg Ventilacion Blanca;LINEA BLANCA
16775604;;F;34;CHILENO;;Millenial;SALAMANCA                     ;COQUIMBO;152980;2;1;2;1;152980;0;0;0;Freezer 145 Lts FDHM150BY0 Horizontal;LINEA BLANCA
22631836;;M;57;CHILENO;;Extranjero;SANTIAGO                      ;METROPOLITANA;394260;4;2;0;0;0;4;2;394260;Refrigerador 254Lts No Frost GT29WPPDC;LINEA BLANCA
10586773;;F;53;CHILENO;;X;NATALES                       ;MAGALLANES;939960;4;2;0;0;0;4;2;939960;Lavadora Secadora WD10WVC4S6 10,5/6Kg Blanca;LINEA BLANCA
15237138;;F;40;CHILENO;;X;NUEVA IMPERIAL                ;ARAUCANIA;214980;2;2;0;0;0;2;2;214980;Secadora 7Kg 7D BZG Ventilacion Blanca;LINEA BLANCA
13097684;;F;46;CHILENO;;X;N/D;N/D;1022591;8;5;0;0;0;8;5;1022591;Calefont 8Lts GL Essenetial ECO;LINEA BLANCA
5837459;;M;70;CHILENO;;Silencioso;QUILPUE                       ;VALPARAISO;526960;4;2;4;2;526960;0;0;0;Lavadora Premium Care Pro 16Kg Silver;LINEA BLANCA
7233091;;M;69;CHILENO;;Silencioso;CASTRO                        ;LOS LAGOS;237150;2;1;0;0;0;2;1;237150;Secadora Ropa MD100A90/W 9Kg Ventilacion Blanca;LINEA BLANCA
9063374;;M;60;CHILENO;;Boomers;N/D;N/D;3095810;20;12;0;0;0;20;12;3095810;Refrigerador 400 Lts No Frost RMP410FZUC Negro;LINEA BLANCA
20477362;;F;22;CHILENO;;Z;SAN BERNARDO;METROPOLITANA;217940;6;4;5;3;210950;1;1;6990;Freezer 145 Lts FDHM150BY0 Horizontal;LINEA BLANCA
11442142;;M;52;CHILENO;;X;SAN VICENTE                   ;L.G.B.OÂ´HIGGINS;459990;1;1;0;0;0;1;1;459990;Lavadora WT19DSBP 19Kg Silver;LINEA BLANCA
9113588;;F;63;CHILENO;;Boomers;LOS ANGELES                   ;BIO BIO;924960;4;4;0;0;0;4;4;924960;Cocina MCG-5QI30NS 5P;LINEA BLANCA
11965817;;F;51;CHILENO;;X;ANGOL                         ;ARAUCANIA;1237880;14;8;10;4;1090920;4;4;146960;Lavadora MLS-160BSC03T 16Kg Blanca;LINEA BLANCA
14017469;;M;42;CHILENO;;X;N/D;N/D;370970;3;3;0;0;0;3;3;370970;Lavadora Premium Care 20SZ 20Kg Silver;LINEA BLANCA
7858821;;F;64;CHILENO;;Boomers;N/D;N/D;267140;3;1;0;0;0;3;1;267140;Secadora Electrica SEM101BDBY Blanca 10 KG;LINEA BLANCA
11814154;;M;51;CHILENO;;X;ARICA                         ;ARICA Y PARINACOTA;279277;5;1;0;0;0;5;1;279277;Lavadora Efficace SZG 17,5Kg Silver;LINEA BLANCA
7691148;;F;66;CHILENO;;Boomers;MELIPILLA                     ;METROPOLITANA;589950;5;2;0;0;0;5;2;589950;Cocina M 795 T 4P Silver;LINEA BLANCA
7942323;Casado;M;66;CHILENO;AGRONOMO;Boomers;PROVIDENCIA                   ;METROPOLITANA;411090;2;1;0;0;0;2;1;411090;Cocina MCG-5QI30NS 5P;LINEA BLANCA
9430353;;M;59;CHILENO;;Boomers;LLAILLAY                      ;VALPARAISO;171970;3;2;0;0;0;3;2;171970;Secadora 7Kg 7D BZG Ventilacion Blanca;LINEA BLANCA
16258655;;F;36;CHILENO;;Millenial;N/D;N/D;701770;4;2;2;1;259980;2;1;441790;Lavadora WA17T6260BW/ZS 17Kg Blanca;LINEA BLANCA
16008310;;F;37;CHILENO;;Millenial;N/D;N/D;579960;4;3;0;0;0;4;3;579960;Cocina M 775 ST 4P Silver;LINEA BLANCA
8480175;;F;65;CHILENO;;Boomers;CAUQUENES                     ;MAULE;609310;4;3;0;0;0;4;3;609310;Cocina MCG-5QI30NS 5P;LINEA BLANCA
5183991;;F;77;CHILENO;;Silencioso;PUENTE ALTO                   ;METROPOLITANA;227860;3;2;0;0;0;3;2;227860;Calefon ionizado 7 litros GL AS0;LINEA BLANCA
7299037;Soltero;M;68;CHILENO;;Silencioso;IQUIQUE                       ;TARAPACA;259990;1;1;0;0;0;1;1;259990;Refrigerador 251Lts No Frost Altus 1250;LINEA BLANCA
15348865;;F;40;CHILENO;;X;PEDRO AGUIRRE CERDA           ;METROPOLITANA;1076830;17;6;17;6;1076830;0;0;0;Lavadora Efficace SZG 17,5Kg Silver;LINEA BLANCA
17694789;Soltero;M;31;CHILENO;;Millenial;PROVIDENCIA                   ;METROPOLITANA;169990;1;1;1;1;169990;0;0;0;Secadora 7Kg 7D BZG Ventilacion Blanca;LINEA BLANCA
6348425;Divorciado;M;66;CHILENO;MEDICO VETERINARIO;Boomers;RENCA                         ;METROPOLITANA;484980;2;2;0;0;0;2;2;484980;Lavadora Superior WA19T6260BW/ZS 19Kg;LINEA BLANCA
13986281;;M;40;CHILENO;;X;QUILLOTA                      ;VALPARAISO;569980;2;2;0;0;0;2;2;569980;Lavadora Secadora WD11TA046BX/ZS 11Kg/7Kg Inox;LINEA BLANCA
10713050;;M;53;CHILENO;;X;PUCHUNCAVI                    ;VALPARAISO;266960;4;3;0;0;0;4;3;266960;Secadora Ropa MD100A90/W 9Kg Ventilacion Blanca;LINEA BLANCA
8053632;;F;65;CHILENO;;Boomers;CONSTITUCION                  ;MAULE;326980;2;1;2;1;326980;0;0;0;Lavadora WT16DSBP 16Kg Silver;LINEA BLANCA
11373750;;M;53;CHILENO;;X;YERBAS BUENAS                 ;MAULE;720910;9;8;0;0;0;9;8;720910;Lavadora Efficace SZG 17,5Kg Silver;LINEA BLANCA
5098898;;M;79;CHILENO;;Silencioso;IQUIQUE                       ;TARAPACA;329990;1;1;0;0;0;1;1;329990;REFRIGERADOR TOP MOUNT GT29BPPK NO FROST 254 Lt;LINEA BLANCA
5741204;;F;76;CHILENO;;Silencioso;ALGARROBO                     ;VALPARAISO;361980;2;1;0;0;0;2;1;361980;Refrigerador 255Lts No Frost RT25FARADS8/ZS;LINEA BLANCA
19492662;;F;25;CHILENO;;Millenial;N/D;N/D;269990;1;1;0;0;0;1;1;269990;Lavadora Efficace SZG 17,5Kg Silver;LINEA BLANCA
14283813;;F;48;CHILENO;;X;CAUQUENES                     ;MAULE;358969;3;2;0;0;0;3;2;358969;Cocina CH-6900IN 4P;LINEA BLANCA
6264176;;F;74;CHILENO;;Silencioso;TEMUCO                        ;ARAUCANIA;154640;2;1;0;0;0;2;1;154640;Calefont 8Lts GL Essenetial ECO;LINEA BLANCA
13883961;;F;42;CHILENO;;X;LOS VILOS                     ;COQUIMBO;412130;3;2;0;0;0;3;2;412130;Secadora 7Kg 7D BZG Ventilacion Blanca;LINEA BLANCA
19368187;;F;25;CHILENO;;Z;NATALES;MAGALLANES;664110;6;3;0;0;0;6;3;664110;Refrigerador 262Lts No Frost MRFI-2760S349RW-DA;LINEA BLANCA
19060973;Soltero;M;27;CHILENO;CONTADOR AUDITOR;Z;PROVIDENCIA                   ;METROPOLITANA;389980;2;1;2;1;389980;0;0;0;Freezer Vertical MFV-2400S312FW 227Lts;LINEA BLANCA
22241625;;F;40;ECUATORIANO;;Extranjero;IQUIQUE                       ;TARAPACA;3393910;24;19;0;0;0;24;19;3393910;Secadora 9 Kg 9D BZG Ventilacion Blanca;LINEA BLANCA
7092502;;M;70;CHILENO;;Silencioso;CALDERA                       ;ATACAMA;1100020;9;4;0;0;0;9;4;1100020;Lavadora WT19DSBP 19Kg Silver;LINEA BLANCA
9544007;;F;59;CHILENO;;Boomers;PROVIDENCIA                   ;METROPOLITANA;545950;5;4;0;0;0;5;4;545950;Lavadora WT13WSBP 13Kg Blanca;LINEA BLANCA
8059894;;M;62;CHILENO;;Boomers;QUILPUE                       ;VALPARAISO;186980;2;1;0;0;0;2;1;186980;Freezer Horizontal M 150 142Lts;LINEA BLANCA
10451177;;F;55;CHILENO;;Boomers;COPIAPO                       ;ATACAMA;682881;21;12;0;0;0;21;12;682881;CANASTO TEXTURA RATAN TAPA ABATIBLE;LINEA BLANCA
7632979;;M;65;CHILENO;;Boomers;N/D;N/D;1545480;9;4;0;0;0;9;4;1545480;Calefont 10Lts GL Essenetial ECO;LINEA BLANCA
16513314;;F;35;CHILENO;;Millenial;CONCEPCION                    ;BIO BIO;1010470;10;4;0;0;0;10;4;1010470;Cocina M 775 ST 4P Silver;LINEA BLANCA
6419235;;F;70;CHILENO;;Silencioso;N/D;N/D;669970;3;2;0;0;0;3;2;669970;Lavadora Premium Care 20SZ 20Kg Silver;LINEA BLANCA
14081602;;M;41;CHILENO;;X;"";"";459211;6;5;0;0;0;6;5;459211;Cocina Diva 920 5P;LINEA BLANCA
16167156;;M;37;CHILENO;;Millenial;PROVIDENCIA                   ;METROPOLITANA;276980;2;1;0;0;0;2;1;276980;Lavadora Efficace SZG 17,5Kg Silver;LINEA BLANCA
11009353;Soltero;F;57;CHILENO;;Boomers;RENCA                         ;METROPOLITANA;232140;2;1;0;0;0;2;1;232140;Lavadora 9,5Kg BZG Blanca;LINEA BLANCA
7654274;;F;65;CHILENO;;Boomers;VILLARICA                     ;ARAUCANIA;159990;1;1;0;0;0;1;1;159990;Lavadora MLS-090GE04N 9Kg Gris;LINEA BLANCA
13770095;;F;41;CHILENO;;Millenial;SANTA MARIA                   ;VALPARAISO;365360;4;1;0;0;0;4;1;365360;Refrigerador 303Lts BF Frio Directo Nordik 480;LINEA BLANCA
17466667;Casado;M;32;CHILENO;;Millenial;RENCA                         ;METROPOLITANA;224970;3;3;0;0;0;3;3;224970;Freezer 99Lts MFH-1000B131CN Horizontal;LINEA BLANCA
17275148;;M;32;CHILENO;;Extranjero;PUNTA ARENAS                  ;MAGALLANES;227150;2;1;0;0;0;2;1;227150;Secadora 7Kg 7D BZG Ventilacion Blanca;LINEA BLANCA
13313649;;F;44;CHILENO;;X;CANETE                        ;BIO BIO;894960;4;4;0;0;0;4;4;894960;Cocina F 2608 T 4P Reflex Silver;LINEA BLANCA
6711628;Viudo;M;72;CHILENO;;Silencioso;RENCA                         ;METROPOLITANA;236680;2;1;0;0;0;2;1;236680;Lavadora WA90H4400SW1ZS 9Kg Blanca;LINEA BLANCA
7980257;Soltero;F;61;CHILENO;AUXILIAR PARAMEDICO DE ENFERMERIA;Boomers;RENCA                         ;METROPOLITANA;471980;2;1;2;1;471980;0;0;0;Lavadora Secadora WD10WVC4S6 10,5/6Kg Blanca;LINEA BLANCA
6275943;;F;73;CHILENO;;Silencioso;LOS ANDES                     ;VALPARAISO;282880;2;1;0;0;0;2;1;282880;Lavadora Efficace SZG 17,5Kg Silver;LINEA BLANCA
10762170;;M;55;CHILENO;;Boomers;QUEILEN                       ;LOS LAGOS;860928;7;2;0;0;0;7;2;860928;Refrigerador 527Lts Side by Side MRSBS5300G689WE;LINEA BLANCA
13558276;;F;43;CHILENO;;X;TALAGANTE                     ;METROPOLITANA;1344130;6;3;0;0;0;6;3;1344130;Refrigerador 525Lts Side by Side SFX500;LINEA BLANCA
16826650;;F;33;CHILENO;;Millenial;CURICO                        ;MAULE;359791;6;2;0;0;0;6;2;359791;Secadora Ropa MD100A90/W 9Kg Ventilacion Blanca;LINEA BLANCA
7638143;;F;66;CHILENO;;Boomers;COPIAPO                       ;ATACAMA;632490;5;2;0;0;0;5;2;632490;Cocina M 820 T 6P Silver;LINEA BLANCA
22917642;;F;54;PERUANO;;Extranjero;ARICA                         ;TARAPACA;1221800;5;3;0;0;0;5;3;1221800;Lavadora Efficace SZG 17,5Kg Silver;LINEA BLANCA
17657855;;F;31;CHILENO;;Millenial;NATALES;MAGALLANES;244810;3;2;0;0;0;3;2;244810;Lavadora WA80H4200SW1ZS 8Kg Blanca;LINEA BLANCA
17975641;Soltero;F;30;CHILENO;TECNICO EN TURISMO;Millenial;PROVIDENCIA                   ;METROPOLITANA;296970;4;2;4;2;296970;0;0;0;Cocina F 5500 T 5P Reflex Silver;LINEA BLANCA
14366234;;F;54;CHILENO;;Silencioso;N/D;N/D;911720;11;8;0;0;0;11;8;911720;Secadora 9 Kg 9D BZG Ventilacion Blanca;LINEA BLANCA
18646285;;F;28;CHILENO;;Millenial;MALLOA;O HIGGINS;277860;4;2;0;0;0;4;2;277860;Freezer Horizontal M 150 142Lts;LINEA BLANCA
11568300;Casado;F;51;CHILENO;;X;RENCA                         ;METROPOLITANA;119990;1;1;0;0;0;1;1;119990;Calefont 5Lts GL Essenetial ECO;LINEA BLANCA
14042292;;F;40;CHILENO;;X;CASTRO                        ;LOS LAGOS;1449910;9;4;0;0;0;9;4;1449910;Lavadora WA90H4400SW1ZS 9Kg Blanca;LINEA BLANCA
15249634;;M;40;CHILENO;;X;PROVIDENCIA                   ;METROPOLITANA;259990;1;1;0;0;0;1;1;259990;Lavadora MLS-160BSC03T 16Kg Blanca;LINEA BLANCA
18029277;;F;29;CHILENO;;Millenial;CONSTITUCION                  ;MAULE;899950;7;5;1;1;159990;6;4;739960;Refrigerador 244Lts Frio Directo Progress 3100;LINEA BLANCA
16275686;;F;35;CHILENO;;Millenial;LINARES                       ;MAULE;282880;2;1;0;0;0;2;1;282880;Lavadora Efficace SZG 17,5Kg Silver;LINEA BLANCA
6693855;Casado;M;70;CHILENO;ADMINISTRADOR PUBLICO;Silencioso;EL BOSQUE                     ;METROPOLITANA;319980;2;1;0;0;0;2;1;319980;Lavadora Premium Care Pro 16Kg Silver;LINEA BLANCA
10177021;;F;59;CHILENO;;Boomers;MELIPILLA                     ;METROPOLITANA;344980;2;2;0;0;0;2;2;344980;Cocina MCG-5QI30NS 5P;LINEA BLANCA
10456958;;M;58;CHILENO;;Boomers;COLINA                        ;METROPOLITANA;144390;2;1;0;0;0;2;1;144390;Calefont 5Lts GL Essenetial ECO;LINEA BLANCA
20899477;;F;38;CHILENO;;Millenial;CALBUCO                       ;LOS LAGOS;469970;4;2;2;1;399990;2;1;69980;Lavadora Secadora Perfect Care 8Kg/5Kg Blanca;LINEA BLANCA
10772335;Casado;F;56;CHILENO;;Boomers;RENCA                         ;METROPOLITANA;189990;1;1;0;0;0;1;1;189990;Lavadora WA90H4400SW1ZS 9Kg Blanca;LINEA BLANCA
15569221;;F;39;CHILENO;;X;PROVIDENCIA                   ;METROPOLITANA;341970;3;2;2;1;131980;1;1;209990;CALEFON ATMD TIRO NATURAL 6 LT GL ALBIN TROTTER;LINEA BLANCA
20308658;;F;22;CHILENO;;Z;OVALLE                        ;COQUIMBO;262880;2;1;0;0;0;2;1;262880;Cocina CH-7400 4P;LINEA BLANCA
13683319;;F;43;CHILENO;;X;N/D;N/D;463960;4;2;4;2;463960;0;0;0;Lavadora Efficace SZG 17,5Kg Silver;LINEA BLANCA
14227893;;F;40;CHILENO;;X;RENCA                         ;METROPOLITANA;459520;4;2;4;2;459520;0;0;0;ENCIMERA A GAS CMG6044SD-0CL 4Q MABE;LINEA BLANCA
18484312;;M;29;CHILENO;;Millenial;OVALLE                        ;COQUIMBO;388970;3;1;0;0;0;3;1;388970;Lavadora Secadora 11/8Kg MF100D110B/W Blanca;LINEA BLANCA
12965247;;F;46;CHILENO;;X;CAUQUENES                     ;MAULE;326272;8;6;0;0;0;8;6;326272;Secadora Ropa MD100A90/W 9Kg Ventilacion Blanca;LINEA BLANCA
19110213;;F;26;CHILENO;;Z;SAN PEDRO DE LA PAZ;BIO-BIO;450970;3;1;3;1;450970;0;0;0;Lavadora Efficace SZG 17,5Kg Silver;LINEA BLANCA
14274581;;M;49;CHILENO;;X;SANTO DOMINGO                 ;VALPARAISO;261980;2;1;0;0;0;2;1;261980;Cocina MCG-4QI24NS 4P;LINEA BLANCA
10577464;;F;57;CHILENO;;Boomers;CHONCHI                       ;LOS LAGOS;749950;5;4;0;0;0;5;4;749950;Lavadora MLS-160BSC03T 16Kg Blanca;LINEA BLANCA
16679324;;M;35;CHILENO;;Millenial;PUERTO MONTT                  ;LOS LAGOS;526980;2;1;2;1;526980;0;0;0;Refrigerador 527Lts Side by Side MRSBS5300G689WE;LINEA BLANCA
11482450;;F;53;CHILENO;;X;RENCA                         ;METROPOLITANA;167130;2;1;0;0;0;2;1;167130;Centrifuga Primma 5B 5,5Kilos;LINEA BLANCA
16070836;;F;37;CHILENO;;Millenial;"";"";943910;8;3;6;2;865930;2;1;77980;Lavadora secadora WD14BVC2S6 14kg/8kg Negra;LINEA BLANCA
18711844;;M;28;CHILENO;;Millenial;SANTA BARBARA                 ;BIO BIO;857930;7;4;7;4;857930;0;0;0;Refrigerador 259Lts BF No frost MDRB379FGF02;LINEA BLANCA
7341741;;M;66;CHILENO;;Boomers;NATALES                       ;MAGALLANES;427090;6;3;0;0;0;6;3;427090;Lavadora Semiautomatica Twister 5300 4Kg;LINEA BLANCA
18879196;;F;27;CHILENO;;Z;N/D;N/D;804930;7;4;0;0;0;7;4;804930;Lavadora MLS-160BSC03T 16Kg Blanca;LINEA BLANCA
20345350;;M;21;CHILENO;;Z;"";"";235970;3;3;0;0;0;3;3;235970;Secadora Electrica SEM101BDBY Blanca 10 KG;LINEA BLANCA
6932203;;F;75;CHILENO;;Silencioso;VILLA ALEMANA                 ;VALPARAISO;285800;3;1;0;0;0;3;1;285800;Secadora 9 Kg 9D BZG Ventilacion Blanca;LINEA BLANCA
18834148;;F;27;CHILENO;;Z;PROVIDENCIA                   ;METROPOLITANA;378950;5;3;5;3;378950;0;0;0;Refrigerador 180Lts BF Frio Directo MDRB275FGF42;LINEA BLANCA
9235153;;M;56;CHILENO;;Boomers;TALCA                         ;MAULE;569850;4;2;0;0;0;4;2;569850;Secadora Ropa MD100A90/W 9Kg Ventilacion Blanca;LINEA BLANCA
19371508;;M;25;CHILENO;;Z;LOS ANGELES                   ;BIO BIO;681640;7;3;0;0;0;7;3;681640;Secadora Ropa MD100A90/W 9Kg Ventilacion Blanca;LINEA BLANCA
13408641;;F;44;CHILENO;;X;ANCUD                         ;LOS LAGOS;593960;4;2;0;0;0;4;2;593960;Refrigerador 432Lts Side by Side MDRS619FGE46;LINEA BLANCA
9518283;;M;59;CHILENO;;Boomers;CURICO                        ;MAULE;349870;2;1;0;0;0;2;1;349870;Lavadora Efficace SZG 19,5Kg Silver;LINEA BLANCA
10863053;;M;55;CHILENO;;Boomers;TALCA                         ;MAULE;495330;3;1;0;0;0;3;1;495330;Lavadora Efficace SZG 15,5Kg Silver;LINEA BLANCA
8260958;;M;65;CHILENO;;Boomers;CURANILAHUE                   ;BIO BIO;504460;4;2;0;0;0;4;2;504460;Lavadora WA13T5260BW/ZS 13Kg Blanca;LINEA BLANCA
9020223;;F;60;CHILENO;;Boomers;NATALES                       ;MAGALLANES;1506930;7;9;0;0;0;7;9;1506930;Refrigerador 244Lts Frio Directo Progress 3100;LINEA BLANCA
19127208;Soltero;F;26;CHILENO;;Z;PANGUIPULLI                   ;LOS LAGOS;171820;2;1;0;0;0;2;1;171820;Lavadora MLS-090GE04N 9Kg Gris;LINEA BLANCA
12788526;;F;47;CHILENO;;X;SAN JAVIER                    ;MAULE;176980;2;1;0;0;0;2;1;176980;Freezer 99Lts MFH-1000B131CN Horizontal;LINEA BLANCA
11979432;;F;50;CHILENO;;X;PAINE                         ;METROPOLITANA;2007319;26;10;0;0;0;26;10;2007319;Lavadora MLS-090GE04N 9Kg Gris;LINEA BLANCA
17420268;;M;32;CHILENO;;Millenial;PROVIDENCIA                   ;METROPOLITANA;327950;5;2;5;2;327950;0;0;0;Refrigerador MDRB424FGE46 302 Lts No Frost;LINEA BLANCA
10246368;;M;50;CHILENO;;X;RENCA                         ;METROPOLITANA;400660;4;1;0;0;0;4;1;400660;Cocina CMC20AXX-1 4P Inox;LINEA BLANCA
15504783;;M;39;CHILENO;;X;ISLA DE MAIPO                 ;METROPOLITANA;637850;5;4;0;0;0;5;4;637850;Lavadora Efficace SZG 17,5Kg Silver;LINEA BLANCA
12877264;;F;47;CHILENO;;X;CONCHALI;METROPOLITANA;849970;5;3;4;2;589980;1;1;259990;Cocina MCG-5QI30NS 5P;LINEA BLANCA
19902392;;M;24;CHILENO;;Z;PROVIDENCIA                   ;METROPOLITANA;59980;2;1;2;1;59980;0;0;0;SECADORA SR-10 8KG GRIS SINDELEN;LINEA BLANCA
25944096;Soltero;M;40;VENEZOLANO;;Extranjero;PROVIDENCIA                   ;METROPOLITANA;259990;3;1;3;1;259990;0;0;0;Lavadora Premium Care Pro 16Kg Silver;LINEA BLANCA
17949540;;M;41;CHILENO;;X;VILLARICA                     ;ARAUCANIA;481970;4;2;1;1;299990;3;1;181980;Lavadora Efficace SZG 19,5Kg Silver;LINEA BLANCA
10569756;;F;57;CHILENO;;Boomers;OSORNO                        ;LOS LAGOS;344970;3;2;0;0;0;3;2;344970;Lavadora Efficace SZG 17,5Kg Blanca;LINEA BLANCA
14394355;;F;43;CHILENO;;X;VICTORIA                      ;ARAUCANIA;279990;1;1;0;0;0;1;1;279990;Lavadora MLS-160BSC03T 16Kg Blanca;LINEA BLANCA
4907436;;F;81;CHILENO;;Silencioso;COIHAIQUE                     ;AYSEN;209990;1;1;0;0;0;1;1;209990;Lavadora WA90H4400SW1ZS 9Kg Blanca;LINEA BLANCA
7522671;;F;68;CHILENO;;Silencioso;PENAFLOR                      ;METROPOLITANA;1101922;6;3;0;0;0;6;3;1101922;Cocina F 5500 T 5P Reflex Silver;LINEA BLANCA
17892588;;M;31;CHILENO;;Millenial;CAUQUENES;MAULE;186980;2;1;2;1;186980;0;0;0;Secadora Ropa MD100A90/W 9Kg Ventilacion Blanca;LINEA BLANCA
18977675;Soltero;F;27;CHILENO;PROFESOR;Z;PROVIDENCIA                   ;METROPOLITANA;149990;1;1;0;0;0;1;1;149990;Calefont 10Lts GL Essenetial ECO;LINEA BLANCA
15752373;;M;38;CHILENO;;X;QUILLOTA                      ;VALPARAISO;336970;4;3;0;0;0;4;3;336970;Secadora 7Kg 7D BZG Ventilacion Blanca;LINEA BLANCA
10277066;;F;58;CHILENO;;Boomers;SAN ANTONIO                   ;VALPARAISO;693930;8;3;0;0;0;8;3;693930;Lavadora Premium Care 20SZ 20Kg Silver;LINEA BLANCA
8215137;;F;65;CHILENO;;Boomers;LINARES                       ;MAULE;266990;3;1;0;0;0;3;1;266990;Lavadora Efficace SZG 17,5Kg Silver;LINEA BLANCA
6789514;;F;69;CHILENO;;Silencioso;CORONEL                       ;BIO BIO;78980;2;1;0;0;0;2;1;78980;SECADORA SR-10 8KG GRIS SINDELEN;LINEA BLANCA
20234066;;M;22;CHILENO;;Z;PROVIDENCIA                   ;METROPOLITANA;364980;2;1;2;1;364980;0;0;0;Lavadora Premium Care Pro 16Kg Silver;LINEA BLANCA
11176732;;F;55;CHILENO;;Boomers;CAUQUENES                     ;MAULE;1031710;7;4;0;0;0;7;4;1031710;Lavadora Secadora MLSF-1108BN05N 11Kg/8Kg Blanca;LINEA BLANCA
20181124;;M;35;CHILENO;;Millenial;PUNTA ARENAS                  ;MAGALLANES;283530;2;1;0;0;0;2;1;283530;Lavadora MLS-160BSC03T 16Kg Blanca;LINEA BLANCA
14101242;;F;41;CHILENO;;X;LAMPA;METROPOLITANA;343960;4;2;4;2;343960;0;0;0;Secadora 9 Kg 9D BZG Ventilacion Blanca;LINEA BLANCA
10523747;;M;55;CHILENO;;Boomers;MAIPU                         ;METROPOLITANA;364750;5;3;2;1;159980;3;2;204770;Secadora Ropa MSV-90 9K Blanca Ventilacion;LINEA BLANCA
6020155;;M;68;CHILENO;;Boomers;VILLARICA                     ;ARAUCANIA;486750;4;2;0;0;0;4;2;486750;Lavadora MLS-160BSC03T 16Kg Blanca;LINEA BLANCA
20310891;;F;22;CHILENO;;Z;PROVIDENCIA                   ;METROPOLITANA;200980;2;1;2;1;200980;0;0;0;Lavadora MLS-090GE04N 9Kg Gris;LINEA BLANCA
14595018;;F;48;CHILENO;;X;LOLOL                         ;L.G.B.OÂ´HIGGINS;119990;1;1;0;0;0;1;1;119990;Calefon ionizado 7 litros GL AS0;LINEA BLANCA
15459274;;F;39;CHILENO;;X;PUENTE ALTO                   ;METROPOLITANA;221420;3;1;0;0;0;3;1;221420;Secadora Ropa MD100A90/W 9Kg Ventilacion Blanca;LINEA BLANCA
6168966;Casado;M;73;CHILENO;;Silencioso;SAN ANTONIO                   ;VALPARAISO;330980;2;1;0;0;0;2;1;330980;Cocina MCG-5QI30NS 5P;LINEA BLANCA
17669362;;F;31;CHILENO;;Millenial;PROVIDENCIA                   ;METROPOLITANA;383460;4;3;0;0;0;4;3;383460;Secadora 7Kg 7D BZG Ventilacion Blanca;LINEA BLANCA
19106911;;F;26;CHILENO;;Z;N/D;N/D;833430;7;5;5;3;543450;2;2;289980;Secadora Ropa MD100A90/T 9Kg Ventilacion Gris;LINEA BLANCA
16569225;;F;34;CHILENO;;Millenial;BUIN                          ;METROPOLITANA;179990;2;1;0;0;0;2;1;179990;Secadora 7Kg 7D BZG Ventilacion Blanca;LINEA BLANCA
7447732;;F;64;CHILENO;;Boomers;VILCUN                        ;ARAUCANIA;318980;2;1;0;0;0;2;1;318980;Lavadora MLS-160BSC03T 16Kg Blanca;LINEA BLANCA
15146904;;M;38;CHILENO;;X;CHANCO                        ;MAULE;166980;2;1;2;1;166980;0;0;0;Lavadora WA80H4200SW1ZS 8Kg Blanca;LINEA BLANCA
6180406;Casado;M;74;CHILENO;;Silencioso;MELIPILLA                     ;METROPOLITANA;201430;2;1;0;0;0;2;1;201430;Secadora Ropa MSV-90 9K Blanca Ventilacion;LINEA BLANCA
15512665;;F;39;CHILENO;;X;ANGOL                         ;ARAUCANIA;718190;3;2;0;0;0;3;2;718190;Lavadora WA80H4200SW1ZS 8Kg Blanca;LINEA BLANCA
14379056;;M;44;CHILENO;;X;N/D;N/D;650510;5;3;5;3;650510;0;0;0;Secadora Ropa MSV-90 9K Blanca Ventilacion;LINEA BLANCA
26183802;Soltero;M;29;VENEZOLANO;;Extranjero;PROVIDENCIA                   ;METROPOLITANA;189980;2;1;2;1;189980;0;0;0;Lavadora WA90H4400SW1ZS 9Kg Blanca;LINEA BLANCA
19047361;;M;27;CHILENO;;Z;LA CRUZ                       ;VALPARAISO;1318481;10;5;0;0;0;10;5;1318481;Lavadora WT16DSBP 16Kg Silver;LINEA BLANCA
12534278;Soltero;M;49;CHILENO;INGENIERO INFORMATICO;X;LA FLORIDA                    ;METROPOLITANA;189980;2;1;2;1;189980;0;0;0;Lavadora Efficace BZG 11,5Kg Blanca;LINEA BLANCA
17287216;;M;32;CHILENO;;Millenial;MACHALI;O HIGGINS;231970;3;2;3;2;231970;0;0;0;Secadora Ropa MD100A90/W 9Kg Ventilacion Blanca;LINEA BLANCA
7727305;;M;63;CHILENO;;Boomers;RENCA                         ;METROPOLITANA;288200;3;1;0;0;0;3;1;288200;Lavadora Efficace SZG 15,5Kg Silver;LINEA BLANCA
13516975;;M;44;CHILENO;;X;PROVIDENCIA                   ;METROPOLITANA;558970;3;2;2;1;368980;1;1;189990;Lavadora MLS-090GE04N 9Kg Gris;LINEA BLANCA
12987050;;F;46;CHILENO;;X;VICTORIA                      ;ARAUCANIA;360870;3;1;0;0;0;3;1;360870;Lavadora Efficace SZG 15,5Kg Silver;LINEA BLANCA
21290052;;F;51;PERUANO;;Extranjero;ARICA                         ;ARICA Y PARINACOTA;1899500;9;5;0;0;0;9;5;1899500;Refrigerador 341Lts BF No Frost GB37MPD;LINEA BLANCA
8898320;;F;60;CHILENO;;Boomers;LOS ANGELES                   ;BIO BIO;509970;3;3;0;0;0;3;3;509970;Lavadora Efficace SZG 17,5Kg Silver;LINEA BLANCA
12036662;;M;48;CHILENO;;X;LEBU                          ;BIO BIO;211430;2;1;0;0;0;2;1;211430;Freezer Horizontal M 150 142Lts;LINEA BLANCA
26029246;;F;33;PERUANO;;Extranjero;BUIN;METROPOLITANA;329980;2;1;0;0;0;2;1;329980;Lavadora WA17T6260BW/ZS 17Kg Blanca;LINEA BLANCA
9638622;;F;53;CHILENO;;X;ILLAPEL                       ;COQUIMBO;439970;3;2;0;0;0;3;2;439970;Lavadora WT19DSBP 19Kg Silver;LINEA BLANCA
7900962;Casado;M;70;CHILENO;;Silencioso;RENCA                         ;METROPOLITANA;509970;3;3;0;0;0;3;3;509970;Lavadora WA15T5260BW/ZS 15Kg Blanca;LINEA BLANCA
9080502;;M;57;CHILENO;;Boomers;TEMUCO                        ;ARAUCANIA;260000;2;1;0;0;0;2;1;260000;Cocina M 775 ST 4P Silver;LINEA BLANCA
8700713;;M;61;CHILENO;;Boomers;NANCAGUA                      ;L.G.B.OÂ´HIGGINS;249913;4;2;0;0;0;4;2;249913;Secadora Ropa MD100A90/W 9Kg Ventilacion Blanca;LINEA BLANCA
15984847;;F;37;CHILENO;;Millenial;PROVIDENCIA                   ;METROPOLITANA;216570;4;2;0;0;0;4;2;216570;Lavadora Semiautomatica Twister 5300 4Kg;LINEA BLANCA
8581723;;F;62;CHILENO;;Boomers;RENCA                         ;METROPOLITANA;252480;2;1;0;0;0;2;1;252480;Secadora 9 Kg 9D BZG Ventilacion Blanca;LINEA BLANCA
14651917;Soltero;F;65;PORTUGUÃS;;Extranjero;PENALOLEN                     ;METROPOLITANA;159980;2;1;2;1;159980;0;0;0;Lavadora WA80H4200SW1ZS 8Kg Blanca;LINEA BLANCA
17017885;;F;33;CHILENO;;Millenial;N/D;N/D;182480;2;1;2;1;182480;0;0;0;Cocina CMC20AXX-1 4P Inox;LINEA BLANCA
24479269;;F;39;BOLIVIANO;;Extranjero;N/D;N/D;2553320;18;7;18;7;2553320;0;0;0;Cocina MCG-5QI30NS 5P;LINEA BLANCA
16714967;;M;34;CHILENO;;Millenial;PROVIDENCIA                   ;METROPOLITANA;256980;2;1;2;1;256980;0;0;0;Cocina PRO 423 4P Inox - Serie 2 HSG18C20SE;LINEA BLANCA
13545788;Soltero;F;43;CHILENO;;X;ALGARROBO                     ;VALPARAISO;418960;4;2;4;2;418960;0;0;0;Refrigerador MDRB424FGE46 302 Lts No Frost;LINEA BLANCA
20318174;;F;22;CHILENO;;Z;N/D;N/D;605600;9;4;2;1;389980;7;3;215620;Lavadora Secadora MLSF-13510SC01I 13,5Kg/10Kg Gr;LINEA BLANCA
15705006;;F;39;CHILENO;;X;NUEVA IMPERIAL                ;ARAUCANIA;386162;5;3;0;0;0;5;3;386162;Calefont 8Lts GL Essenetial ECO;LINEA BLANCA
18575080;;F;28;CHILENO;;Millenial;PROVIDENCIA                   ;METROPOLITANA;272980;2;1;2;1;272980;0;0;0;Lavadora Efficace SZG 17,5Kg Silver;LINEA BLANCA
7732385;;F;70;CHILENO;;Silencioso;VINA DEL MAR                  ;VALPARAISO;119990;1;1;0;0;0;1;1;119990;Calefon ionizado 7 litros GL AS0;LINEA BLANCA
10841907;Casado;M;53;CHILENO;;X;PROVIDENCIA                   ;METROPOLITANA;275970;3;1;3;1;275970;0;0;0;Lavadora Efficace SZG 17,5Kg Silver;LINEA BLANCA
17970817;Soltero;M;31;CHILENO;INGENIERO DE EJECUCION MECANICO;Millenial;PANQUEHUE;VALPARAISO;1234930;7;5;6;4;1104940;1;1;129990;Centrifuga Primma 5B 5,5Kilos;LINEA BLANCA
11598941;;F;53;CHILENO;;X;QUEILEN                       ;LOS LAGOS;512810;8;2;0;0;0;8;2;512810;Lavadora Superior WA17T6260BY/ZS 17Kg;LINEA BLANCA
16755843;;M;34;CHILENO;;Millenial;N/D;N/D;230980;4;2;2;1;216980;2;1;14000;Secadora 9 Kg 9D BZG Ventilacion Blanca;LINEA BLANCA
8713512;;M;62;CHILENO;;Boomers;LA GRANJA                     ;METROPOLITANA;367720;6;2;0;0;0;6;2;367720;Lavadora Efficace SZG 15,5Kg Silver;LINEA BLANCA
26683352;;F;39;EXTRANJERO - NO INFORMA NACIONALIDAD;;Extranjero;ISLA DE MAIPO                 ;METROPOLITANA;399970;3;2;2;1;359980;1;1;39990;Cocina MCG-5QI30NS 5P;LINEA BLANCA
8720119;Casado;M;63;CHILENO;;Boomers;PROVIDENCIA                   ;METROPOLITANA;30000;0;2;0;0;0;0;2;30000;Lavadora WT13WSBP 13Kg Blanca;LINEA BLANCA
26184207;;M;36;HAITIANO;;Extranjero;N/D;N/D;263930;3;1;0;0;0;3;1;263930;Secadora 9 Kg Premium Care Pro 9D;LINEA BLANCA
17819353;;F;25;CHILENO;;Z;TALCA                         ;MAULE;226980;2;1;0;0;0;2;1;226980;Refrigerador 166 Lts Frio Directo BF MED165;LINEA BLANCA
12402641;;F;48;CHILENO;;X;QUILLOTA                      ;VALPARAISO;1503940;9;3;0;0;0;9;3;1503940;Cocina CMC20AXX 4P Inox;LINEA BLANCA
9688856;;F;58;CHILENO;;Boomers;MELIPILLA                     ;METROPOLITANA;314140;8;3;0;0;0;8;3;314140;Lavadora MLS-080BE04N 8Kg Blanca;LINEA BLANCA
13708417;;M;43;CHILENO;;X;CURACAUTIN;ARAUCANIA;227970;3;1;3;1;227970;0;0;0;Secadora Ropa MD100A90/W 9Kg Ventilacion Blanca;LINEA BLANCA
12795381;;F;46;CHILENO;;X;LA CISTERNA                   ;METROPOLITANA;499970;3;2;2;1;189980;1;1;309990;Lavadora Efficace BZG 11,5Kg Blanca;LINEA BLANCA
10559920;;M;54;CHILENO;;Boomers;RENCA                         ;METROPOLITANA;227980;2;1;2;1;227980;0;0;0;Secadora Ropa MD100A90/T 9Kg Ventilacion Gris;LINEA BLANCA
9004881;;F;62;CHILENO;;Boomers;NEGRETE                       ;BIO BIO;1664470;12;5;0;0;0;12;5;1664470;Lavadora MLS-190GC03N 19Kg Gris;LINEA BLANCA
23621996;;F;31;ARGENTINO;;Extranjero;PROVIDENCIA                   ;METROPOLITANA;442980;2;1;2;1;442980;0;0;0;Lavadora Secadora MLSF-13510SC01I 13,5Kg/10Kg Gr;LINEA BLANCA
18884318;;F;27;CHILENO;;Millenial;PROVIDENCIA                   ;METROPOLITANA;279980;2;1;0;0;0;2;1;279980;Refrigerador 244Lts Frio Directo Progress 3100;LINEA BLANCA
6287470;;F;71;CHILENO;;Silencioso;LA GRANJA                     ;METROPOLITANA;461140;6;3;0;0;0;6;3;461140;Lavadora Efficace SZG 17,5Kg Blanca;LINEA BLANCA
18818868;;M;27;CHILENO;;Millenial;N/D;N/D;907810;8;3;0;0;0;8;3;907810;Refrigerador 252Lts No Frost MRFS-2700G333FW;LINEA BLANCA
12974967;;F;45;CHILENO;;X;TALCAHUANO                    ;BIO BIO;2317870;13;7;7;4;969930;6;3;1347940;Secadora Electrica SEM101BDBY Blanca 10 KG;LINEA BLANCA
14078626;;F;41;CHILENO;;X;N/D;N/D;279980;2;4;1;1;149990;1;3;129990;Lavadora MLS-090GE04N 9Kg Gris;LINEA BLANCA
10929081;;M;51;CHILENO;;X;RENCA                         ;METROPOLITANA;329990;1;1;0;0;0;1;1;329990;Lavadora WA17T6260BW/ZS 17Kg Blanca;LINEA BLANCA
6445239;;F;70;CHILENO;;Silencioso;EL QUISCO                     ;VALPARAISO;277320;4;1;0;0;0;4;1;277320;Secadora Ropa MD100A90/W 9Kg Ventilacion Blanca;LINEA BLANCA
10148831;;M;58;CHILENO;;Boomers;RETIRO                        ;MAULE;402950;6;2;0;0;0;6;2;402950;Lavadora Premium Care 20SZ 20Kg Silver;LINEA BLANCA
13854396;;F;42;CHILENO;;X;DALCAHUE                      ;LOS LAGOS;404980;2;2;0;0;0;2;2;404980;Lavadora MLS-160BSC03T 16Kg Blanca;LINEA BLANCA
17281547;;F;32;CHILENO;;Millenial;SANTA CRUZ                    ;L.G.B.OÂ´HIGGINS;331980;2;1;0;0;0;2;1;331980;Cocina F 2608 T 4P Reflex Silver;LINEA BLANCA
6146455;;F;75;CHILENO;;Silencioso;N/D;N/D;772170;4;1;0;0;0;4;1;772170;Refrigerador 527Lts Side by Side MRSBS5300G689WE;LINEA BLANCA
12081578;;F;48;CHILENO;;X;RENCA                         ;METROPOLITANA;473960;4;2;4;2;473960;0;0;0;Lavadora Efficace SZG 19,5Kg Silver;LINEA BLANCA
6319726;;F;68;CHILENO;;Silencioso;PUENTE ALTO                   ;METROPOLITANA;1103590;8;4;0;0;0;8;4;1103590;Calefon ionizado 7 litros GL AS0;LINEA BLANCA
8573783;;F;59;CHILENO;;Boomers;REQUINOA                      ;L.G.B.OÂ´HIGGINS;272360;3;1;0;0;0;3;1;272360;Lavadora Efficace SZG 15,5Kg Silver;LINEA BLANCA
18642717;;F;28;CHILENO;;Millenial;QUINCHAO                      ;LOS LAGOS;463960;3;1;3;1;463960;0;0;0;Refrigerador 260Lts BF Frio Direc MRFI2660SR346W;LINEA BLANCA
19272924;;F;26;CHILENO;;Z;CANETE                        ;BIO BIO;763530;6;3;0;0;0;6;3;763530;Lavadora MLS-090GE04N 9Kg Gris;LINEA BLANCA
19042900;;F;26;CHILENO;;Z;RENCA                         ;METROPOLITANA;211980;2;1;2;1;211980;0;0;0;Secadora 9 Kg 9D BZG Ventilacion Blanca;LINEA BLANCA
15754434;;F;38;CHILENO;;Millenial;RENCA                         ;METROPOLITANA;139980;2;1;2;1;139980;0;0;0;Centrifuga Primma 5B 5,5Kilos;LINEA BLANCA
15895353;;F;40;CHILENO;;X;OSORNO                        ;LOS LAGOS;625880;5;4;0;0;0;5;4;625880;Secadora Ropa MD100A90/W 9Kg Ventilacion Blanca;LINEA BLANCA
10212689;Casado;F;56;CHILENO;;Boomers;OVALLE                        ;COQUIMBO;1204470;7;2;0;0;0;7;2;1204470;Refrigerador 525Lts Side by Side SFX500;LINEA BLANCA
8273704;;M;63;CHILENO;;Boomers;SALAMANCA                     ;COQUIMBO;230910;2;1;0;0;0;2;1;230910;Lavadora WA80H4200SW1ZS 8Kg Blanca;LINEA BLANCA
12201769;;F;50;CHILENO;;X;OSORNO                        ;LOS LAGOS;244980;3;1;0;0;0;3;1;244980;Lavadora Efficace SZG 15,5Kg Silver;LINEA BLANCA
18269020;;F;30;CHILENO;;Millenial;"";"";571940;6;3;6;3;571940;0;0;0;Lavadora Premium Care 20SZ 20Kg Silver;LINEA BLANCA
15330066;;F;39;CHILENO;;X;VILLA ALEGRE                  ;MAULE;199990;3;1;0;0;0;3;1;199990;Secadora Ropa MD100A90/W 9Kg Ventilacion Blanca;LINEA BLANCA
8006415;;F;63;CHILENO;;Boomers;PROVIDENCIA                   ;METROPOLITANA;209980;2;1;2;1;209980;0;0;0;Refrigerador 166 Lts Frio Directo BF MED165;LINEA BLANCA
18067936;;F;30;CHILENO;;Millenial;TALCAHUANO                    ;BIO BIO;247980;2;1;2;1;247980;0;0;0;Lavadora Efficace SZG 15,5Kg Silver;LINEA BLANCA
6180542;;M;73;CHILENO;;Silencioso;CONCEPCION                    ;BIO BIO;197980;2;1;0;0;0;2;1;197980;Refrigerador 166 Lts Frio Directo BF MED165;LINEA BLANCA
8130306;;F;64;CHILENO;;Boomers;VALPARAISO                    ;VALPARAISO;260890;4;1;0;0;0;4;1;260890;Lavadora Semiautomatica LC-6550 6,5Kg;LINEA BLANCA
19024923;;F;27;CHILENO;;Z;SAN RAMON                     ;METROPOLITANA;359970;3;2;2;1;179980;1;1;179990;Secadora 9 Kg 9D BZG Ventilacion Blanca;LINEA BLANCA
11943197;Soltero;F;50;CHILENO;;X;PUTAENDO                      ;VALPARAISO;200180;3;1;0;0;0;3;1;200180;Lavadora Semiautomatica Twister 5100 4Kg;LINEA BLANCA
20071605;;M;23;CHILENO;;Millenial;MAIPU                         ;METROPOLITANA;199980;2;1;2;1;199980;0;0;0;Secadora 9 Kg 9D BZG Ventilacion Blanca;LINEA BLANCA
17054229;;F;33;CHILENO;;Millenial;SANTA BARBARA                 ;BIO BIO;1169980;2;1;0;0;0;2;1;1169980;COCINA COMBUSTION LENTA S-800 BURDEO 82X56;LINEA BLANCA
13565284;;M;43;CHILENO;;X;N/D;N/D;369980;2;2;0;0;0;2;2;369980;Secadora Electrica SEM101BDBY Blanca 10 KG;LINEA BLANCA
9073664;;F;59;CHILENO;;Boomers;QUIRIHUE                      ;BIO BIO;561890;8;2;0;0;0;8;2;561890;Lavadora Efficace BZG 11,5Kg Blanca;LINEA BLANCA
11127423;Casado;F;55;CHILENO;;Boomers;PROVIDENCIA                   ;METROPOLITANA;259990;2;1;2;1;259990;0;0;0;Secadora 9 Kg Premium Care Pro 9D;LINEA BLANCA
7677158;;F;68;CHILENO;;Silencioso;TALCAHUANO                    ;BIO BIO;638860;9;4;0;0;0;9;4;638860;Secadora Ropa MD100A90/W 9Kg Ventilacion Blanca;LINEA BLANCA
10828025;;F;55;CHILENO;;Boomers;PUERTO MONTT                  ;LOS LAGOS;241940;2;1;0;0;0;2;1;241940;Freezer 142Lts EFC14A5MNW Horizontal;LINEA BLANCA
17326159;Soltero;M;33;CHILENO;QUIMICO FARMACEUTICO;Millenial;PROVIDENCIA                   ;METROPOLITANA;317960;4;2;4;2;317960;0;0;0;Secadora 9 Kg Premium Care Pro 9D;LINEA BLANCA
11775944;;M;51;CHILENO;;X;CONCEPCION                    ;BIO BIO;224970;3;1;0;0;0;3;1;224970;Secadora Ropa MD100A90/W 9Kg Ventilacion Blanca;LINEA BLANCA
17116387;;M;32;CHILENO;;Millenial;VILLARICA                     ;ARAUCANIA;521980;2;1;2;1;521980;0;0;0;Lavadora Secadora WD11TA046BE/ZS 11Kg/7Kg Blanca;LINEA BLANCA
19404873;;M;25;CHILENO;;Z;PROVIDENCIA                   ;METROPOLITANA;1350870;11;4;11;4;1350870;0;0;0;Lavadora WA13T5260BW/ZS 13Kg Blanca;LINEA BLANCA
12365617;;F;49;CHILENO;;X;VICTORIA                      ;ARAUCANIA;370960;5;3;2;1;150980;3;2;219980;Minibar MMB91S 94Lts;LINEA BLANCA
19865455;;F;24;CHILENO;;Silencioso;MARCHIHUE                     ;L.G.B.OÂ´HIGGINS;489950;5;3;4;2;444960;1;1;44990;Lavadora WA15T5260BW/ZS 15Kg Blanca;LINEA BLANCA
19526940;;F;25;CHILENO;;Z;SAN VICENTE                   ;L.G.B.OÂ´HIGGINS;675499;6;4;3;2;314530;3;2;360969;Lavadora Efficace SZG 17,5Kg Silver;LINEA BLANCA
6643951;;F;72;CHILENO;;Silencioso;CAUQUENES                     ;MAULE;412980;3;2;0;0;0;3;2;412980;Cocina F 5500 T 5P Reflex Silver;LINEA BLANCA
25562882;;M;29;HAITIANO;;Extranjero;SAN ANTONIO                   ;VALPARAISO;319990;1;1;0;0;0;1;1;319990;Cocina Andes60TX4 4P Inox;LINEA BLANCA
13125645;;M;45;CHILENO;;X;GRANEROS                      ;L.G.B.OÂ´HIGGINS;180920;3;1;0;0;0;3;1;180920;Calefont 10Lts GL Essenetial ECO;LINEA BLANCA
12414123;Casado;M;48;CHILENO;;X;RENCA                         ;METROPOLITANA;223980;2;1;0;0;0;2;1;223980;Lavadora WA80H4200SW1ZS 8Kg Blanca;LINEA BLANCA
10987136;;M;49;CHILENO;;X;RANCAGUA                      ;L.G.B.OÂ´HIGGINS;201980;2;1;2;1;201980;0;0;0;Secadora 9 Kg 9D BZG Ventilacion Blanca;LINEA BLANCA
7926471;Casado;M;65;CHILENO;;Boomers;PROVIDENCIA                   ;METROPOLITANA;350170;4;2;0;0;0;4;2;350170;Lavadora Semiautomatica Twister 5100 4Kg;LINEA BLANCA
10280151;;F;58;CHILENO;;Boomers;NATALES                       ;MAGALLANES;522940;6;5;0;0;0;6;5;522940;Cocina CH-9050SI 4P;LINEA BLANCA
23772991;;M;41;ECUATORIANO;;Extranjero;SAN MIGUEL                    ;METROPOLITANA;362970;3;2;0;0;0;3;2;362970;Refrigerador 262Lts No Frost MRFI-2760S349RW-DA;LINEA BLANCA
8752683;;M;50;CHILENO;;X;LOS ANGELES                   ;BIO BIO;236750;3;1;0;0;0;3;1;236750;Secadora Ropa MD100A90/W 9Kg Ventilacion Blanca;LINEA BLANCA
2825076;;F;93;CHILENO;;Silencioso;VINA DEL MAR                  ;VALPARAISO;396870;5;1;0;0;0;5;1;396870;Refrigerador 252Lts No Frost MRFS-2700G333FW;LINEA BLANCA
7309902;;M;63;CHILENO;;Boomers;VILLA ALEMANA                 ;VALPARAISO;251530;2;1;0;0;0;2;1;251530;Cocina CH-7400 4P;LINEA BLANCA
6354653;;F;70;CHILENO;;Silencioso;SAN VICENTE                   ;L.G.B.OÂ´HIGGINS;206380;3;2;0;0;0;3;2;206380;Calefont 8Lts GL Essenetial ECO;LINEA BLANCA
9514416;;M;59;CHILENO;;Boomers;QUEMCHI                       ;LOS LAGOS;231510;3;1;0;0;0;3;1;231510;Freezer Horizontal M 150 142Lts;LINEA BLANCA
8602342;Viudo;F;60;CHILENO;CONTADOR GENERAL;Boomers;CHILLAN                       ;BIO BIO;153390;2;1;0;0;0;2;1;153390;Centrifuga Primma 5B 5,5Kilos;LINEA BLANCA
17900692;;F;30;CHILENO;;Millenial;LEBU                          ;BIO BIO;397490;5;3;0;0;0;5;3;397490;Secadora Ropa MD100A90/W 9Kg Ventilacion Blanca;LINEA BLANCA
15412587;;M;40;CHILENO;;Millenial;N/D;N/D;263980;2;1;2;1;263980;0;0;0;Secadora 9 Kg Premium Care Pro 9D;LINEA BLANCA
15371788;;F;41;CHILENO;;X;PROVIDENCIA                   ;METROPOLITANA;904400;10;4;4;1;205450;6;3;698950;Refrigerador 250 Lts No Frost RMA250PHUG1;LINEA BLANCA
11894997;;F;51;CHILENO;;X;TALCA                         ;MAULE;287970;3;1;0;0;0;3;1;287970;Lavadora Semiautomatica Twister 5100 4Kg;LINEA BLANCA
9187940;;F;61;CHILENO;;Boomers;SAN BERNARDO                  ;METROPOLITANA;693730;4;2;0;0;0;4;2;693730;Refrigerador 527Lts Side by Side MRSBS5300G689WE;LINEA BLANCA
12036874;;M;53;CHILENO;;X;SALAMANCA                     ;COQUIMBO;254980;2;1;0;0;0;2;1;254980;Cocina CMC20AXX 4P Inox;LINEA BLANCA
17060309;Casado;M;34;CHILENO;;Millenial;PROVIDENCIA                   ;METROPOLITANA;137980;2;1;2;1;137980;0;0;0;Centrifuga Primma 5B 5,5Kilos;LINEA BLANCA
15709866;;M;38;CHILENO;;Millenial;RENCA                         ;METROPOLITANA;249980;2;1;2;1;249980;0;0;0;Cocina CH-9700IN 4P;LINEA BLANCA
9782434;;M;59;CHILENO;;Boomers;PROVIDENCIA                   ;METROPOLITANA;200520;2;1;0;0;0;2;1;200520;Lavadora MLS-090GE04N 9Kg Gris;LINEA BLANCA
14277869;;F;49;CHILENO;;X;EL BOSQUE                     ;METROPOLITANA;500869;7;2;0;0;0;7;2;500869;Secadora Ropa MD100A90/W 9Kg Ventilacion Blanca;LINEA BLANCA
17426583;;M;32;CHILENO;;Millenial;TALAGANTE;METROPOLITANA;289990;2;1;2;1;289990;0;0;0;Refrigerador 244Lts Frio Directo Progress 3100;LINEA BLANCA
9955900;;M;53;CHILENO;;X;IQUIQUE                       ;TARAPACA;335970;3;1;0;0;0;3;1;335970;Calefon ionizado 13 litros GL;LINEA BLANCA
18123376;Soltero;M;29;CHILENO;INGENIERO EN AUTOMATIZACION Y CONTROL INDUSTRIAL;Millenial;PROVIDENCIA                   ;METROPOLITANA;289980;2;1;2;1;289980;0;0;0;Lavadora WT13WSBP 13Kg Blanca;LINEA BLANCA
9966974;;F;56;CHILENO;;Boomers;LO PRADO                      ;METROPOLITANA;426950;5;2;0;0;0;5;2;426950;Secadora 9 Kg 9D SZG Silver;LINEA BLANCA
17715086;;F;31;CHILENO;;Millenial;CASTRO                        ;LOS LAGOS;1330990;6;1;0;0;0;6;1;1330990;Refrigerador 468Lts Side by Side MRTT-4790S312FW;LINEA BLANCA
15240559;;M;38;CHILENO;;Millenial;"";"";222980;2;1;0;0;0;2;1;222980;Lavadora Semiautomatica LC-6550 6,5Kg;LINEA BLANCA
9282783;;M;60;CHILENO;;Boomers;RENCA                         ;METROPOLITANA;263470;3;1;0;0;0;3;1;263470;Lavadora WA80H4200SW1ZS 8Kg Blanca;LINEA BLANCA
7624410;;F;66;CHILENO;;Boomers;INDEPENDENCIA                 ;METROPOLITANA;292540;3;1;0;0;0;3;1;292540;Refrigerador 252Lts No Frost MRFS-2700G333FW;LINEA BLANCA
10188255;;M;56;CHILENO;;Boomers;LONGAVI                       ;MAULE;721750;3;1;0;0;0;3;1;721750;Refrigerador 535Lts Side by Side RS54N3003SL/ZS;LINEA BLANCA
10817686;;F;55;CHILENO;;Boomers;CURANILAHUE                   ;BIO BIO;402980;2;2;0;0;0;2;2;402980;Lavadora WT16DSBP 16Kg Silver;LINEA BLANCA
15051446;;F;40;CHILENO;;X;LA SERENA                     ;COQUIMBO;338980;2;1;0;0;0;2;1;338980;Lavadora Efficace SZG 19,5Kg Silver;LINEA BLANCA
12963394;;M;46;CHILENO;;X;LONGAVI                       ;MAULE;302550;2;1;0;0;0;2;1;302550;Lavadora Efficace SZG 17,5Kg Silver;LINEA BLANCA
17281595;;M;32;CHILENO;;Millenial;SANTIAGO                      ;METROPOLITANA;139980;2;1;2;1;139980;0;0;0;FRIGOBAR 93 LTS MFB-930S121LN;LINEA BLANCA
11234993;;F;54;CHILENO;;X;TOME                          ;BIO BIO;599980;2;1;2;1;599980;0;0;0;COCINA LENA ENLOZADA 72x56;LINEA BLANCA
13485489;;M;44;CHILENO;;X;PUENTE ALTO                   ;METROPOLITANA;539670;3;1;0;0;0;3;1;539670;Refrigerador 527Lts Side by Side MRSBS5300G689WE;LINEA BLANCA
13392253;;M;44;CHILENO;;X;ANGOL                         ;ARAUCANIA;904970;4;3;0;0;0;4;3;904970;Refrigerador 290Lts BF No Frost RB30N4020S8;LINEA BLANCA
17466831;;M;32;CHILENO;;Millenial;PROVIDENCIA                   ;METROPOLITANA;393960;4;2;4;2;393960;0;0;0;Cocina CMC20AXX 4P Inox;LINEA BLANCA
20564715;;M;21;CHILENO;;Millenial;N/D;N/D;228980;4;2;2;1;203980;2;1;25000;Cocina CMC20AXX 4P Inox;LINEA BLANCA
15553855;;M;38;CHILENO;;X;N/D;N/D;627920;8;4;8;4;627920;0;0;0;Lavadora MLS-090GE04N 9Kg Gris;LINEA BLANCA
6554251;;F;66;CHILENO;;Boomers;QUINTA NORMAL                 ;METROPOLITANA;359980;2;1;2;1;359980;0;0;0;Refrigerador GT32BPPDC 312Lts No Frost;LINEA BLANCA
18789914;;F;27;CHILENO;;Z;SAN CARLOS                    ;BIO BIO;153390;2;1;0;0;0;2;1;153390;Centrifuga Primma 5B 5,5Kilos;LINEA BLANCA
19462620;Soltero;M;25;CHILENO;;Z;PROVIDENCIA                   ;METROPOLITANA;473940;6;3;6;3;473940;0;0;0;Lavadora Semiautomatica Twister 5300 4Kg;LINEA BLANCA
18708911;Soltero;F;27;CHILENO;NUTRICIONISTA;Z;PROVIDENCIA                   ;METROPOLITANA;360920;7;2;6;1;300930;1;1;59990;Secadora 9 Kg 9D BZG Ventilacion Blanca;LINEA BLANCA
15575959;;F;39;CHILENO;;X;N/D;N/D;109980;2;2;0;0;0;2;2;109980;Campana Cocina FXU6160 60CM;LINEA BLANCA
9802245;;M;58;CHILENO;;Boomers;PENCO                         ;BIO BIO;633980;2;1;0;0;0;2;1;633980;Refrigerador 535Lts Side by Side RS54N3003SL/ZS;LINEA BLANCA
7790485;;F;68;CHILENO;;Boomers;PUNTA ARENAS                  ;MAGALLANES;317820;2;1;0;0;0;2;1;317820;Lavadora MLS-160BSC03T 16Kg Blanca;LINEA BLANCA
16134245;;M;37;CHILENO;;Millenial;ARICA                         ;ARICA Y PARINACOTA;798930;7;4;0;0;0;7;4;798930;Lavadora Efficace SZG 15,5Kg Silver;LINEA BLANCA
10511501;;M;56;CHILENO;;Boomers;PENAFLOR                      ;METROPOLITANA;309980;2;1;2;1;309980;0;0;0;Lavadora WT13WSBP 13Kg Blanca;LINEA BLANCA
17648231;;F;31;CHILENO;;Millenial;CURANILAHUE                   ;BIO BIO;1070190;8;5;0;0;0;8;5;1070190;Refrigerador 244Lts Frio Directo Progress 3100;LINEA BLANCA
13372579;;M;43;CHILENO;;X;CHANCO                        ;MAULE;1737160;5;2;0;0;0;5;2;1737160;COCINA LENA ENLOZADA 82x56;LINEA BLANCA
8196192;;M;62;CHILENO;;Boomers;COIHAIQUE                     ;AYSEN;499980;2;2;0;0;0;2;2;499980;Lavadora Efficace SZG 17,5Kg Blanca;LINEA BLANCA
18447701;;M;29;CHILENO;;Millenial;"";"";284980;2;1;0;0;0;2;1;284980;Lavadora WA90H4400SW1ZS 9Kg Blanca;LINEA BLANCA
8595061;;F;59;CHILENO;;Boomers;PANGUIPULLI                   ;LOS RIOS;697970;3;2;0;0;0;3;2;697970;Cocina CH-8900IN 5P;LINEA BLANCA
14312228;;M;46;CHILENO;;X;MELIPILLA                     ;METROPOLITANA;473960;5;1;0;0;0;5;1;473960;Cocina CMC20AXX 4P Inox;LINEA BLANCA
25178746;;F;29;COLOMBIANO;;Extranjero;NATALES                       ;MAGALLANES;449970;3;3;0;0;0;3;3;449970;Cocina CMC20AXX 4P Inox;LINEA BLANCA
11037744;;F;56;CHILENO;;Boomers;RENCA                         ;METROPOLITANA;296980;2;1;0;0;0;2;1;296980;Refrigerador 244Lts Frio Directo Progress 3100;LINEA BLANCA
8817422;;F;62;CHILENO;;Boomers;N/D;N/D;611940;6;3;6;3;611940;0;0;0;Freezer 99Lts MFH-1000B131CN Horizontal;LINEA BLANCA
25573723;;F;50;COLOMBIANO;;Extranjero;"";"";271980;2;1;0;0;0;2;1;271980;Lavadora MLS-160BSC03T 16Kg Blanca;LINEA BLANCA
8711151;;F;61;CHILENO;;Boomers;SANTIAGO                      ;METROPOLITANA;607930;7;8;0;0;0;7;8;607930;Cocina Andes76HG0 6P Inox;LINEA BLANCA
17963824;;M;30;CHILENO;;Millenial;VALDIVIA                      ;LOS RIOS;389990;1;1;0;0;0;1;1;389990;Lavadora Secadora Perfect Care 11/7Kg Blanca;LINEA BLANCA
18587142;Soltero;F;29;CHILENO;ENFERMERA;Millenial;PROVIDENCIA                   ;METROPOLITANA;663960;4;2;4;2;663960;0;0;0;Freezer 160 Lts MFV-1600B208FN vertical;LINEA BLANCA
15705505;Soltero;F;38;CHILENO;TECNICO EN ENFERMERIA DE NIVEL SUPERIOR;X;PELLUHUE                      ;MAULE;329990;3;1;0;0;0;3;1;329990;Lavadora Efficace SZG 17,5Kg Blanca;LINEA BLANCA
7561555;;F;68;CHILENO;;Boomers;CONCHALI                      ;METROPOLITANA;259980;2;1;2;1;259980;0;0;0;Lavadora MLS-160BSC03T 16Kg Blanca;LINEA BLANCA
14321008;;M;47;CHILENO;;X;SAN FERNANDO                  ;L.G.B.OÂ´HIGGINS;129990;1;1;0;0;0;1;1;129990;Calefont 8Lts GL Essenetial ECO;LINEA BLANCA
17248033;;M;33;CHILENO;;Millenial;N/D;N/D;947960;4;4;0;0;0;4;4;947960;Refrigerador DW44S 400Lts Dispen No Frost;LINEA BLANCA
17816899;;M;30;CHILENO;;Millenial;PROVIDENCIA                   ;METROPOLITANA;179980;2;1;2;1;179980;0;0;0;Refrigerador 167Lts Frio Directo 1700-S;LINEA BLANCA
18183584;;F;29;CHILENO;;Millenial;N/D;N/D;229990;1;1;0;0;0;1;1;229990;Freezer 200 Lts FDHM200BY0 Horizontal;LINEA BLANCA
7460782;;M;58;CHILENO;;Boomers;SAN CARLOS                    ;BIO BIO;210980;2;2;0;0;0;2;2;210980;Cocina CMC20AXX 4P Inox;LINEA BLANCA
9306865;;M;60;CHILENO;;Boomers;PROVIDENCIA                   ;METROPOLITANA;169990;1;1;0;0;0;1;1;169990;Cocina CH-9050SI 4P;LINEA BLANCA
10536576;Casado;M;52;CHILENO;;X;RENCA                         ;METROPOLITANA;365470;2;1;0;0;0;2;1;365470;Lavadora WT16DSBP 16Kg Silver;LINEA BLANCA
15012055;Soltero;M;38;CHILENO;PROFESOR;Millenial;CALAMA                        ;ANTOFAGASTA;339970;3;1;0;0;0;3;1;339970;Lavadora LMA0920WGCL0 9,5Kg Gris;LINEA BLANCA
10871533;;M;54;CHILENO;;Boomers;N/D;N/D;1247940;6;3;0;0;0;6;3;1247940;Lavadora WT16DSBP 16Kg Silver;LINEA BLANCA
24704267;;M;36;HAITIANO;;Extranjero;PROVIDENCIA                   ;METROPOLITANA;270980;2;1;0;0;0;2;1;270980;Freezer 200 Lts FDHM200BY0 Horizontal;LINEA BLANCA
14094881;;M;42;CHILENO;;Millenial;VALDIVIA                      ;LOS RIOS;367970;4;2;0;0;0;4;2;367970;Freezer 99Lts MFH-1000B131CN Horizontal;LINEA BLANCA
17926778;;F;30;CHILENO;;Millenial;PUENTE ALTO                   ;METROPOLITANA;389980;2;1;0;0;0;2;1;389980;Cocina MCG-5QI30NS 5P;LINEA BLANCA
18677301;;F;27;CHILENO;;Millenial;CATEMU                        ;VALPARAISO;199990;1;1;0;0;0;1;1;199990;Cocina CH-7400 4P;LINEA BLANCA
20216694;;F;22;CHILENO;;Z;PROVIDENCIA                   ;METROPOLITANA;415600;6;2;4;1;113620;2;1;301980;Lavadora MLS-160BSC03T 16Kg Blanca;LINEA BLANCA
17669866;;M;31;CHILENO;;Millenial;RENCA                         ;METROPOLITANA;196980;2;1;2;1;196980;0;0;0;Secadora Ropa MD100A90/W 9Kg Ventilacion Blanca;LINEA BLANCA
9592870;;F;60;CHILENO;;Boomers;VICTORIA                      ;ARAUCANIA;1390880;13;8;0;0;0;13;8;1390880;Lavadora WA17T6260BW/ZS 17Kg Blanca;LINEA BLANCA
12520512;;M;49;CHILENO;;X;TALCA                         ;MAULE;414950;5;4;0;0;0;5;4;414950;Freezer 142Lts EFC14A5MNW Horizontal;LINEA BLANCA
11979256;;F;50;CHILENO;;X;N/D;N/D;261970;4;1;0;0;0;4;1;261970;Lavadora MLS-090GE04N 9Kg Gris;LINEA BLANCA
6737619;;F;78;CHILENO;;Silencioso;COPIAPO                       ;ATACAMA;598630;6;3;0;0;0;6;3;598630;LAVAVAJILLA B MLV-12SB5203;LINEA BLANCA
20338854;;F;22;CHILENO;;Z;PROVIDENCIA                   ;METROPOLITANA;179980;2;1;2;1;179980;0;0;0;Refrigerador 167Lts Frio Directo 1700-S;LINEA BLANCA
6451436;;M;66;CHILENO;;Boomers;ARICA                         ;ARICA Y PARINACOTA;245980;2;1;0;0;0;2;1;245980;Lavadora WA90H4400SW1ZS 9Kg Blanca;LINEA BLANCA
9644687;;F;57;CHILENO;;Boomers;ANTOFAGASTA                   ;ANTOFAGASTA;137980;2;1;0;0;0;2;1;137980;Calefont 8Lts GL Essenetial ECO;LINEA BLANCA
12816370;;F;47;CHILENO;;X;LA LIGUA                      ;VALPARAISO;320960;4;3;0;0;0;4;3;320960;Lavadora MLS-160BSC03T 16Kg Blanca;LINEA BLANCA
16732855;;F;35;CHILENO;;Millenial;FREIRINA                      ;ATACAMA;1799940;6;4;0;0;0;6;4;1799940;Centrifuga Primma 5B 5,5Kilos;LINEA BLANCA
12769173;;M;46;CHILENO;;X;MAIPU                         ;METROPOLITANA;336960;4;2;0;0;0;4;2;336960;Lavadora WT13WSBP 13Kg Blanca;LINEA BLANCA
14556559;;F;43;CHILENO;;X;VINA DEL MAR                  ;VALPARAISO;159990;1;1;0;0;0;1;1;159990;Freezer 142Lts MFH-1430B186C Horizontal;LINEA BLANCA
13681652;;F;43;CHILENO;;X;N/D;N/D;169990;2;1;2;1;169990;0;0;0;Secadora Ropa MD100A90/W 9Kg Ventilacion Blanca;LINEA BLANCA
12817225;;F;47;CHILENO;;X;LOS ANDES                     ;VALPARAISO;203960;4;3;0;0;0;4;3;203960;Calefon 7Lts GL Master;LINEA BLANCA
7004814;;M;70;CHILENO;;Silencioso;N/D;N/D;1063940;6;5;2;1;263980;4;4;799960;Secadora Ropa MD100A90/W 9Kg Ventilacion Blanca;LINEA BLANCA
11381813;;M;52;CHILENO;;X;PROVIDENCIA                   ;METROPOLITANA;202480;2;1;2;1;202480;0;0;0;Secadora Ropa MD100A90/W 9Kg Ventilacion Blanca;LINEA BLANCA
16859010;;M;34;CHILENO;;Millenial;CURICO;MAULE;341980;2;1;2;1;341980;0;0;0;Refrigerador MDRB424FGE46 302 Lts No Frost;LINEA BLANCA
19851139;;F;24;CHILENO;;Z;N/D;N/D;239980;2;2;0;0;0;2;2;239980;Freezer 142Lts MFH-1430B186C Horizontal;LINEA BLANCA
12800070;Soltero;F;46;CHILENO;;X;MELIPILLA                     ;METROPOLITANA;227920;8;1;0;0;0;8;1;227920;Calefont 8Lts GL Essenetial ECO;LINEA BLANCA
7293018;;M;67;CHILENO;;Boomers;N/D;N/D;229980;2;1;0;0;0;2;1;229980;Cocina CH-7400 4P;LINEA BLANCA
5947997;;M;74;CHILENO;;Silencioso;COPIAPO                       ;ATACAMA;199990;1;1;0;0;0;1;1;199990;Cocina 775X 4P;LINEA BLANCA
9413279;;M;60;CHILENO;;Boomers;VICTORIA                      ;ARAUCANIA;511960;4;3;0;0;0;4;3;511960;Lavadora WA90H4400SW1ZS 9Kg Blanca;LINEA BLANCA
11683997;;M;52;CHILENO;;X;LOTA                          ;BIO BIO;279990;1;1;0;0;0;1;1;279990;Lavadora Efficace SZG 17,5Kg Blanca;LINEA BLANCA
9654127;;M;61;CHILENO;;Boomers;LLAILLAY                      ;VALPARAISO;370980;2;3;0;0;0;2;3;370980;Lavadora WA17T6260BW/ZS 17Kg Blanca;LINEA BLANCA
8476380;;F;67;CHILENO;;Boomers;RANCAGUA                      ;L.G.B.OÂ´HIGGINS;376970;3;1;0;0;0;3;1;376970;Cocina Andes76HG0 6P Inox;LINEA BLANCA
17851595;;F;31;CHILENO;;Millenial;PADRE HURTADO                 ;METROPOLITANA;239980;2;1;2;1;239980;0;0;0;Cocina CH-9950NG-1 6P Negro;LINEA BLANCA
19121179;Soltero;F;26;CHILENO;HOTELES Y RESTAURANTES;Z;PROVIDENCIA                   ;METROPOLITANA;313980;2;1;2;1;313980;0;0;0;Lavadora WA17T6260BW/ZS 17Kg Blanca;LINEA BLANCA
10966830;;F;52;CHILENO;;X;VALLENAR;ATACAMA;336980;2;1;0;0;0;2;1;336980;Lavadora MLS-160BSC03T 16Kg Blanca;LINEA BLANCA
23762804;;F;42;PERUANO;;Extranjero;PENALOLEN                     ;METROPOLITANA;659980;2;1;0;0;0;2;1;659980;Refrigerador 535Lts Side by Side RS54N3003SL/ZS;LINEA BLANCA
7562996;Casado;F;65;CHILENO;;Boomers;PROVIDENCIA                   ;METROPOLITANA;853960;4;1;0;0;0;4;1;853960;Lavadora WT19DSBP 19Kg Silver;LINEA BLANCA
7743264;;M;66;CHILENO;;Boomers;PROVIDENCIA                   ;METROPOLITANA;245960;3;1;3;1;245960;0;0;0;Cocina CH-9600RJ 4P;LINEA BLANCA
18987320;;F;27;CHILENO;;Z;"";"";196970;3;2;2;1;183980;1;1;12990;Lavadora MLS-090GE04N 9Kg Gris;LINEA BLANCA
8888263;;F;61;CHILENO;;Boomers;PROVIDENCIA                   ;METROPOLITANA;249990;1;1;0;0;0;1;1;249990;Refrigerador 260Lts BF Frio Direc MRFI2660SR346W;LINEA BLANCA
10960425;;F;42;CHILENO;;X;COIHAIQUE                     ;AYSEN;509980;2;2;1;1;179990;1;1;329990;Lavadora WT16DSBP 16Kg Silver;LINEA BLANCA
9801240;;F;59;CHILENO;;Boomers;PEUMO                         ;L.G.B.OÂ´HIGGINS;321980;2;1;0;0;0;2;1;321980;Lavadora MLS-160BSC03T 16Kg Blanca;LINEA BLANCA
13419177;;F;44;CHILENO;;X;ANTOFAGASTA                   ;ANTOFAGASTA;545980;4;2;2;1;325980;2;1;220000;Lavadora WT16DSBP 16Kg Silver;LINEA BLANCA
9766001;;M;58;CHILENO;;Boomers;EL BOSQUE                     ;METROPOLITANA;319990;1;1;0;0;0;1;1;319990;Lavadora Efficace SZG 17,5Kg Blanca;LINEA BLANCA
9042993;;M;60;CHILENO;;Boomers;ISLA DE MAIPO                 ;METROPOLITANA;436960;4;2;0;0;0;4;2;436960;Refrigerador 244Lts Frio Directo Progress 3100;LINEA BLANCA
15779151;;F;37;CHILENO;;Millenial;EL MONTE                      ;METROPOLITANA;962870;12;5;7;3;712920;5;2;249950;Cocina CMC20AXX 4P Inox;LINEA BLANCA
13540278;;M;43;CHILENO;;X;CALERA                        ;VALPARAISO;299990;1;1;0;0;0;1;1;299990;Lavadora WT16DSBP 16Kg Silver;LINEA BLANCA
20118627;;F;23;CHILENO;;Z;SANTA CRUZ                    ;L.G.B.OÂ´HIGGINS;348980;2;1;0;0;0;2;1;348980;Lavadora WT16DSBP 16Kg Silver;LINEA BLANCA
12544023;Casado;F;49;CHILENO;;X;PUENTE ALTO                   ;METROPOLITANA;179990;1;1;0;0;0;1;1;179990;Cocina CH-9400 4P SILVER;LINEA BLANCA
15114871;;F;40;CHILENO;;X;SAN FERNANDO                  ;L.G.B.OÂ´HIGGINS;1212960;4;3;2;1;612980;2;2;599980;Refrigerador 535Lts Side by Side RS54N3003SL/ZS;LINEA BLANCA
16599026;;F;35;CHILENO;;Millenial;N/D;N/D;838910;10;5;0;0;0;10;5;838910;Refrigerador 252Lts No Frost MRFS-2700G333FW;LINEA BLANCA
16495921;Soltero;F;35;CHILENO;ADMINISTRADOR HOTELERO;Millenial;CHILLAN                       ;BIO BIO;179990;1;1;0;0;0;1;1;179990;Cocina CH-7400 4P;LINEA BLANCA
8664296;;F;65;CHILENO;;Boomers;QUILICURA                     ;METROPOLITANA;301980;2;1;0;0;0;2;1;301980;Lavadora MLS-160BSC03T 16Kg Blanca;LINEA BLANCA
11980961;;F;50;CHILENO;;X;RANCAGUA                      ;L.G.B.OÂ´HIGGINS;228980;2;1;0;0;0;2;1;228980;Freezer Horizontal M 150 142Lts;LINEA BLANCA
6961277;;F;74;CHILENO;;Silencioso;CANETE                        ;BIO BIO;645250;4;2;0;0;0;4;2;645250;REFRIGERADOR 340 Lts BMF RB34T602FSA/ZS;LINEA BLANCA
13399746;;M;45;CHILENO;;X;SAN CARLOS                    ;BIO BIO;471530;6;3;0;0;0;6;3;471530;Lavadora LMA0920WGCL0 9,5Kg Gris;LINEA BLANCA
26952020;;F;31;VENEZOLANO;;Extranjero;VALDIVIA                      ;LOS RIOS;355980;2;1;2;1;355980;0;0;0;Refrigerador 290LTS No Frost RMB302PXLRS0;LINEA BLANCA
7601265;;F;68;CHILENO;;Boomers;NOGALES                       ;VALPARAISO;109990;1;1;0;0;0;1;1;109990;Calefont 5Lts GL Essenetial ECO;LINEA BLANCA
20332157;;F;22;CHILENO;;Z;PROVIDENCIA                   ;METROPOLITANA;58980;2;1;2;1;58980;0;0;0;CAMPANA AT-XN REIN 60 INOX;LINEA BLANCA
9850829;;F;59;CHILENO;;Boomers;CALAMA                        ;ANTOFAGASTA;568140;5;3;0;0;0;5;3;568140;Lavadora Premium Care 20SZ 20Kg Silver;LINEA BLANCA
6300339;;F;71;CHILENO;;Silencioso;VICTORIA                      ;ARAUCANIA;169990;1;1;0;0;0;1;1;169990;Cocina CH-9050SI 4P;LINEA BLANCA
7441239;Casado;F;66;CHILENO;;Boomers;LOS ANDES                     ;VALPARAISO;279990;1;1;0;0;0;1;1;279990;Refrigerador 252Lts No Frost MRFS-2700G333FW;LINEA BLANCA
18161233;;F;30;CHILENO;;Millenial;PROVIDENCIA                   ;METROPOLITANA;630860;5;2;0;0;0;5;2;630860;Lavadora WA17T6260BW/ZS 17Kg Blanca;LINEA BLANCA
4483824;;M;76;CHILENO;;Silencioso;RENCA                         ;METROPOLITANA;139990;1;1;0;0;0;1;1;139990;Lavadora WA90H4400SW/ZS 9Kg Blanca;LINEA BLANCA
10877531;Soltero;F;55;CHILENO;;Boomers;RENGO                         ;L.G.B.OÂ´HIGGINS;271980;2;1;0;0;0;2;1;271980;Refrigerador 241Lts BF Frio Directo Nordik 415;LINEA BLANCA
10848928;;M;55;CHILENO;;Boomers;CURANILAHUE                   ;BIO BIO;1279960;3;1;0;0;0;3;1;1279960;Refrigerador 535Lts Side by Side RS54N3003SL/ZS;LINEA BLANCA
6523841;;M;77;CHILENO;;Silencioso;BUIN                          ;METROPOLITANA;529443;5;3;0;0;0;5;3;529443;Calefon 7Lts GL ATMD;LINEA BLANCA
9866575;;M;58;CHILENO;;Boomers;PROVIDENCIA                   ;METROPOLITANA;428960;4;1;0;0;0;4;1;428960;Refrigerador 303Lts BF Frio Directo Nordik 480;LINEA BLANCA
9049900;;F;59;CHILENO;;Boomers;RENCA                         ;METROPOLITANA;239990;1;1;0;0;0;1;1;239990;Refrigerador 260Lts BF Frio Direc MRFI2660SR346W;LINEA BLANCA
6154185;;M;73;CHILENO;;Silencioso;SAN BERNARDO                  ;METROPOLITANA;206970;3;2;0;0;0;3;2;206970;Lavadora Semiautomatica Twister 5300 4Kg;LINEA BLANCA
11450849;Casado;F;53;CHILENO;;X;RENCA                         ;METROPOLITANA;165480;2;1;2;1;165480;0;0;0;Freezer 142Lts MFH-1430B186C Horizontal;LINEA BLANCA
6020944;Viudo;M;71;CHILENO;;Silencioso;RENCA                         ;METROPOLITANA;299990;1;1;0;0;0;1;1;299990;Refrigerador 303Lts BF Frio Directo Nordik 480;LINEA BLANCA
7884950;;F;70;CHILENO;;Silencioso;PAINE                         ;METROPOLITANA;379970;3;2;0;0;0;3;2;379970;Cocina F-2808 4P;LINEA BLANCA
6492190;;F;71;CHILENO;;X;VILLARICA                     ;ARAUCANIA;417980;2;1;0;0;0;2;1;417980;Lavadora WT16DSBP 16Kg Silver;LINEA BLANCA
26872271;Soltero;F;44;VENEZOLANO;;Extranjero;"";"";179990;1;1;0;0;0;1;1;179990;Cocina CMC20AXX 4P Inox;LINEA BLANCA
17467836;;M;32;CHILENO;;Millenial;VICTORIA                      ;ARAUCANIA;427980;2;1;0;0;0;2;1;427980;Lavadora Secadora WD95T4046CE/ZS 9,5Kg/6Kg Blanc;LINEA BLANCA
15918538;;M;37;CHILENO;;Millenial;COIHAIQUE                     ;AYSEN;312980;2;1;2;1;312980;0;0;0;Refrigerador 241Lts BF Frio Directo Nordik 415;LINEA BLANCA
23978875;;M;29;PERUANO;;Extranjero;N/D;N/D;477970;3;1;0;0;0;3;1;477970;Refrigerador 322Lts No Frost BF DB60S;LINEA BLANCA
8097222;;F;76;CHILENO;;Silencioso;COPIAPO                       ;ATACAMA;187980;2;1;0;0;0;2;1;187980;Freezer 99Lts MFH-1000B131CN Horizontal;LINEA BLANCA
12999314;;F;46;CHILENO;;X;"";"";407970;3;1;0;0;0;3;1;407970;KIT-138 HORNO HE-7200IN+CEG-4600IN+CA-610EIN;LINEA BLANCA
17743582;;F;32;CHILENO;;Millenial;MULCHEN                       ;BIO BIO;350550;4;1;0;0;0;4;1;350550;Refrigerador 260Lts BF Frio Direc MRFI2660SR346W;LINEA BLANCA
15291029;;M;37;CHILENO;;Millenial;NATALES                       ;MAGALLANES;516940;6;4;0;0;0;6;4;516940;Cocina CMC20AXX 4P Inox;LINEA BLANCA
10754784;;F;55;CHILENO;;Boomers;COPIAPO                       ;ATACAMA;357980;2;1;0;0;0;2;1;357980;Lavadora Efficace SZG 17,5Kg Silver;LINEA BLANCA
7549030;;F;64;CHILENO;;Boomers;RENCA                         ;METROPOLITANA;143980;2;1;2;1;143980;0;0;0;Lavadora/Centrifuga LC4550 4,5Kg Blanca;LINEA BLANCA
8282886;;F;65;CHILENO;;Boomers;CONSTITUCION                  ;MAULE;346980;2;1;0;0;0;2;1;346980;Lavadora WD10J6410AX/ZS 10,5Kg;LINEA BLANCA
10628039;;F;57;CHILENO;;Boomers;PUERTO MONTT                  ;LOS LAGOS;1305930;6;1;0;0;0;6;1;1305930;Refrigerador 331Lts No Frost BF RB34T632FSA/ZS;LINEA BLANCA
12994417;;M;46;CHILENO;;X;VALDIVIA                      ;LOS LAGOS;746960;4;2;0;0;0;4;2;746960;Refrigerador 260Lts BF Frio Direc MRFI2660SR346W;LINEA BLANCA
15553427;;F;35;CHILENO;;Millenial;RENCA                         ;METROPOLITANA;421960;4;3;2;1;106980;2;2;314980;Freezer 200 Lts FDHM200BY0 Horizontal;LINEA BLANCA
18854168;;F;27;CHILENO;;Millenial;PROVIDENCIA                   ;METROPOLITANA;237960;4;2;4;2;237960;0;0;0;Freezer 99Lts MFH-1000B131CN Horizontal;LINEA BLANCA
18285241;;M;30;CHILENO;;Millenial;PAILLACO                      ;LOS RIOS;208540;2;1;2;1;208540;0;0;0;Secadora Ropa MSV-90 9K Blanca Ventilacion;LINEA BLANCA
13463092;;F;50;CHILENO;;X;N/D;N/D;309970;3;1;0;0;0;3;1;309970;Lavadora Efficace SZG 15,5Kg Silver;LINEA BLANCA
9062108;;M;59;CHILENO;;Boomers;IQUIQUE                       ;TARAPACA;299990;1;1;0;0;0;1;1;299990;Cocina F-2808 4P;LINEA BLANCA
11360806;Casado;F;52;CHILENO;;X;PROVIDENCIA                   ;METROPOLITANA;159990;1;1;0;0;0;1;1;159990;Freezer 142Lts MFH-1430B186C Horizontal;LINEA BLANCA
9791020;;M;58;CHILENO;;Boomers;NANCAGUA                      ;L.G.B.OÂ´HIGGINS;591970;3;1;0;0;0;3;1;591970;Lavadora Efficace SZG 19,5Kg Silver;LINEA BLANCA
15302027;;F;40;CHILENO;;X;N/D;N/D;188540;2;1;2;1;188540;0;0;0;Secadora Ropa MSV-90 9K Blanca Ventilacion;LINEA BLANCA
4992187;;F;80;CHILENO;;Silencioso;RANCAGUA                      ;L.G.B.OÂ´HIGGINS;140980;2;1;0;0;0;2;1;140980;Freezer 99Lts MFH-1000B131CN Horizontal;LINEA BLANCA
19510843;;F;25;CHILENO;;Z;N/D;N/D;85840;2;1;2;1;85840;0;0;0;ENCIMERA A GAS CMG6044SD-0CL 4Q MABE;LINEA BLANCA
8884721;;F;60;CHILENO;;Boomers;PARRAL                        ;MAULE;469970;3;1;0;0;0;3;1;469970;Cocina Andes7650FX 5P Inox;LINEA BLANCA
16737580;;F;34;CHILENO;;Millenial;PROVIDENCIA                   ;METROPOLITANA;136980;2;1;0;0;0;2;1;136980;FRIGOBAR 93 LTS MFB-930S121LN;LINEA BLANCA
9898749;Casado;F;57;CHILENO;;Boomers;PROVIDENCIA                   ;METROPOLITANA;688970;3;1;0;0;0;3;1;688970;Refrigerador 254Lts No Frost GT29WPPDC;LINEA BLANCA
10827752;;M;56;CHILENO;;Millenial;ANTOFAGASTA                   ;ANTOFAGASTA;409950;5;2;0;0;0;5;2;409950;Cocina CH-9950NG-1 6P Negro;LINEA BLANCA
16347748;;M;36;CHILENO;;Millenial;PROVIDENCIA                   ;METROPOLITANA;126980;2;1;2;1;126980;0;0;0;FRIGOBAR 93 LTS MFB-930S121LN;LINEA BLANCA
9140912;;F;61;CHILENO;;Boomers;PROVIDENCIA                   ;METROPOLITANA;89990;1;1;0;0;0;1;1;89990;Calefon 5Lts GL Master;LINEA BLANCA
16320330;;F;35;CHILENO;;Millenial;VALDIVIA                      ;LOS RIOS;738960;4;3;1;1;129990;3;2;608970;Cocina CH-8700IN 5P;LINEA BLANCA
15926691;;M;37;CHILENO;;Millenial;CASTRO                        ;LOS LAGOS;329990;1;1;0;0;0;1;1;329990;Refrigerador GT32BPPDC 312Lts No Frost;LINEA BLANCA
15111831;;F;42;CHILENO;;X;RENCA                         ;METROPOLITANA;329980;2;1;2;1;329980;0;0;0;Lavadora Premium Care 20SZ 20Kg Silver;LINEA BLANCA
13111690;;F;45;CHILENO;;X;PROVIDENCIA                   ;METROPOLITANA;199990;1;1;0;0;0;1;1;199990;Cocina CH-7400 4P;LINEA BLANCA
11128570;Casado;F;54;CHILENO;;Boomers;CISNES                        ;AYSEN;341970;3;2;0;0;0;3;2;341970;Lavadora MLS-160BSC03T 16Kg Blanca;LINEA BLANCA
9110071;Casado;F;61;CHILENO;;Boomers;RENCA                         ;METROPOLITANA;299990;1;1;0;0;0;1;1;299990;Cocina F-2808 4P;LINEA BLANCA
15983761;;F;37;CHILENO;;Millenial;SAN CARLOS                    ;BIO BIO;179990;1;1;0;0;0;1;1;179990;Lavadora MLS-090GE04N 9Kg Gris;LINEA BLANCA
12992915;;M;47;CHILENO;;X;PANGUIPULLI                   ;LOS LAGOS;555980;2;1;0;0;0;2;1;555980;Refrigerador DW44S 400Lts Dispen No Frost;LINEA BLANCA
22601740;;M;33;CHILENO;;Extranjero;PROVIDENCIA                   ;METROPOLITANA;121980;2;1;2;1;121980;0;0;0;Lavadora MLS-080BE04N 8Kg Blanca;LINEA BLANCA
12142328;Casado;F;52;CHILENO;;X;RENCA                         ;METROPOLITANA;219980;2;1;0;0;0;2;1;219980;Cocina CH-7400 4P;LINEA BLANCA
6664491;;F;66;CHILENO;;Boomers;RENCA                         ;METROPOLITANA;209980;2;1;0;0;0;2;1;209980;Lavadora WA90H4400SW/ZS 9Kg Blanca;LINEA BLANCA
10597927;;M;53;CHILENO;;X;VALPARAISO                    ;VALPARAISO;1519780;10;3;0;0;0;10;3;1519780;Lavadora WA13T5260BW/ZS 13Kg Blanca;LINEA BLANCA
8810405;;F;63;CHILENO;;Boomers;PROVIDENCIA                   ;METROPOLITANA;344980;2;1;0;0;0;2;1;344980;Refrigerador 303Lts BF Frio Directo Nordik 480;LINEA BLANCA
10910336;;F;59;CHILENO;;Boomers;LOS ANGELES                   ;BIO BIO;403850;4;1;0;0;0;4;1;403850;Cocina CH-7400 4P;LINEA BLANCA
18286479;;M;29;CHILENO;;Millenial;PARRAL                        ;MAULE;220570;2;1;0;0;0;2;1;220570;Cocina CMC5515GCH-1 4P;LINEA BLANCA
17994498;;F;31;CHILENO;;Silencioso;PROVIDENCIA                   ;METROPOLITANA;149970;2;2;2;2;149970;0;0;0;Cocina CH-7400 4P;LINEA BLANCA
8152241;Casado;F;65;CHILENO;;Boomers;MELIPILLA                     ;METROPOLITANA;301970;3;1;0;0;0;3;1;301970;Freezer MFH-2950B384CN 295 lts blanco;LINEA BLANCA
5760051;;F;72;CHILENO;;Silencioso;EL QUISCO                     ;VALPARAISO;250980;2;1;0;0;0;2;1;250980;Freezer 196Lts M200 Horizontal;LINEA BLANCA
15600030;;F;42;CHILENO;;X;PANGUIPULLI                   ;LOS LAGOS;200980;2;1;0;0;0;2;1;200980;Freezer 99Lts MFH-1000B131CN Horizontal;LINEA BLANCA
10956774;;F;59;CHILENO;;Boomers;PROVIDENCIA                   ;METROPOLITANA;803980;2;1;0;0;0;2;1;803980;Refrigerador 626Lt Side by Side GS65MPP1 APZPECL;LINEA BLANCA
8904740;;F;63;CHILENO;;Boomers;QUILPUE                       ;VALPARAISO;407970;3;1;0;0;0;3;1;407970;Lavadora WT16DSBP 16Kg Silver;LINEA BLANCA
9712179;;F;60;CHILENO;;Boomers;SAN VICENTE                   ;L.G.B.OÂ´HIGGINS;811960;4;1;0;0;0;4;1;811960;Lavadora WT19DSBP 19Kg Silver;LINEA BLANCA
10810105;;M;55;CHILENO;;Boomers;LOS ANDES                     ;VALPARAISO;355970;3;2;0;0;0;3;2;355970;Lavadora WT13WSBP 13Kg Blanca;LINEA BLANCA
8342201;Casado;M;63;CHILENO;;Boomers;PROVIDENCIA                   ;METROPOLITANA;219990;1;1;0;0;0;1;1;219990;Lavadora WA90H4400SW/ZS 9Kg Blanca;LINEA BLANCA
19194367;;F;26;CHILENO;;Millenial;"";"";433940;5;3;4;2;398950;1;1;34990;Freezer horizontal 142Lts lfh-151 blanco;LINEA BLANCA
9029534;;M;59;CHILENO;;Boomers;QUILPUE                       ;VALPARAISO;473930;7;2;0;0;0;7;2;473930;Lavadora Premium Care 20SZ 20Kg Silver;LINEA BLANCA
9030116;;F;62;CHILENO;;Boomers;PUENTE ALTO                   ;METROPOLITANA;199980;2;1;0;0;0;2;1;199980;Cocina CH-7400 4P;LINEA BLANCA
19576544;;M;24;CHILENO;;Z;"";"";145480;2;1;2;1;145480;0;0;0;Lavadora MLS-090GE04N 9Kg Gris;LINEA BLANCA
10942095;;F;54;CHILENO;;X;CAUQUENES                     ;MAULE;299990;1;1;0;0;0;1;1;299990;REFRIGERADOR TOP MOUNT GT29BPPK NO FROST 254 Lt;LINEA BLANCA
12916135;;F;46;CHILENO;;X;SAN VICENTE                   ;L.G.B.OÂ´HIGGINS;359650;4;2;0;0;0;4;2;359650;Lavadora WT16DSBP 16Kg Silver;LINEA BLANCA
11263504;;F;54;CHILENO;;X;INDEPENDENCIA                 ;METROPOLITANA;299980;2;1;0;0;0;2;1;299980;Lavadora Top In 10K MLF-100GMFEI Blanca;LINEA BLANCA
8540043;;M;59;CHILENO;;Boomers;CERRO NAVIA                   ;METROPOLITANA;219980;2;1;0;0;0;2;1;219980;Freezer Horizontal MFH-1990B258CN 198Lts;LINEA BLANCA
7850529;;F;64;CHILENO;;Boomers;COLINA                        ;METROPOLITANA;299990;1;1;0;0;0;1;1;299990;REFRIGERADOR TOP MOUNT GT29BPPK NO FROST 254 Lt;LINEA BLANCA
6465564;;F;68;CHILENO;;Boomers;QUILPUE                       ;VALPARAISO;388060;3;1;0;0;0;3;1;388060;Refrigerador 254Lts No Frost GT29WPPDC;LINEA BLANCA
16061236;;M;37;CHILENO;;Millenial;LOS ANGELES                   ;BIO BIO;229990;1;1;0;0;0;1;1;229990;Freezer 150 Lts SFH-151 BL Horizontal;LINEA BLANCA
18822891;;M;27;CHILENO;;Millenial;CALAMA;ANTOFAGASTA;234980;2;1;0;0;0;2;1;234980;Freezer horizontal 142Lts lfh-151 blanco;LINEA BLANCA
16432666;;M;35;CHILENO;;Millenial;SANTA CRUZ                    ;L.G.B.OÂ´HIGGINS;144540;2;1;2;1;144540;0;0;0;Lavadora Semiautomatica Twister 5100 4Kg;LINEA BLANCA
15422255;;M;40;CHILENO;;Millenial;N/D;N/D;239980;2;1;0;0;0;2;1;239980;Lavadora MLS-160BSC03T 16Kg Blanca;LINEA BLANCA
26621161;;M;31;VENEZOLANO;;Extranjero;TEMUCO                        ;ARAUCANIA;561940;6;1;0;0;0;6;1;561940;Refrigerador 260Lts BF Frio Direc MRFI2660SR346W;LINEA BLANCA
16741908;;F;34;CHILENO;;Millenial;MAIPU                         ;METROPOLITANA;252960;4;2;0;0;0;4;2;252960;Refrigerador 252Lts No Frost MRFS-2700G333FW;LINEA BLANCA
16981116;;M;33;CHILENO;;Millenial;GORBEA                        ;ARAUCANIA;1945860;13;1;0;0;0;13;1;1945860;Refrigerador 527Lts Side by Side MRSBS5300G689WE;LINEA BLANCA
15692034;;M;38;CHILENO;;X;ANTOFAGASTA                   ;ANTOFAGASTA;470960;4;1;0;0;0;4;1;470960;Cocina F-5500 Premium 5P;LINEA BLANCA
5763919;;M;76;CHILENO;;Silencioso;LOS ANGELES                   ;BIO BIO;451960;3;1;0;0;0;3;1;451960;Freezer Vertical MFV-2400S312FW 227Lts;LINEA BLANCA
13599000;;M;43;CHILENO;;X;RENCA                         ;METROPOLITANA;254980;2;3;0;0;0;2;3;254980;Encimera a Gas F GC75V A 5P;LINEA BLANCA
18353621;;F;29;CHILENO;;Millenial;PROVIDENCIA                   ;METROPOLITANA;271480;2;1;0;0;0;2;1;271480;Lavadora MLS-160GSC03T 16Kg Gris;LINEA BLANCA
12653807;;M;48;CHILENO;;X;SAN ANTONIO                   ;VALPARAISO;309980;2;1;0;0;0;2;1;309980;REFRIGERADOR 234Lt TMF RT22FARADS8/ZS;LINEA BLANCA
18653440;;M;28;CHILENO;;Millenial;N/D;N/D;303980;2;1;2;1;303980;0;0;0;Lavadora WT13WSBP 13Kg Blanca;LINEA BLANCA
5574972;;F;69;CHILENO;;Silencioso;RENCA                         ;METROPOLITANA;229890;2;1;2;1;229890;0;0;0;Refrigerador 252Lts No Frost MRFS-2700G333FW;LINEA BLANCA
17759049;;F;31;CHILENO;;Millenial;LINARES                       ;MAULE;129990;1;1;0;0;0;1;1;129990;Cocina CH-7400 4P;LINEA BLANCA
12788014;;F;47;CHILENO;;X;SAN CLEMENTE                  ;MAULE;279990;1;1;0;0;0;1;1;279990;Lavadora MLS-160BSC03T 16Kg Blanca;LINEA BLANCA
11912452;;M;50;CHILENO;;X;SAN BERNARDO                  ;METROPOLITANA;522730;7;3;0;0;0;7;3;522730;Lavadora MLS-090GE04N 9Kg Gris;LINEA BLANCA
8747230;;F;60;CHILENO;;Boomers;LOTA                          ;BIO BIO;339980;3;1;0;0;0;3;1;339980;Cocina CH-7400 4P;LINEA BLANCA
16307243;;F;36;CHILENO;;Millenial;PUENTE ALTO                   ;METROPOLITANA;207360;3;1;0;0;0;3;1;207360;Cocina CH-7400 4P;LINEA BLANCA
5940133;;F;73;CHILENO;;Silencioso;LOS ANGELES                   ;BIO BIO;289370;2;1;0;0;0;2;1;289370;Cocina 785FX 4P;LINEA BLANCA
9864485;;M;58;CHILENO;;Boomers;RENCA                         ;METROPOLITANA;327970;3;4;0;0;0;3;4;327970;Lavadora MLS-160BSC03T 16Kg Blanca;LINEA BLANCA
16957297;;M;33;CHILENO;;Millenial;SAN BERNARDO                  ;METROPOLITANA;299360;3;1;0;0;0;3;1;299360;Refrigerador 252Lts No Frost MRFS-2700G333FW;LINEA BLANCA
14051083;Casado;F;41;CHILENO;;X;RAUCO                         ;MAULE;370860;3;1;0;0;0;3;1;370860;Lavadora Efficace SZG 17,5Kg Silver;LINEA BLANCA
11673628;;M;51;CHILENO;;X;"";"";394740;4;1;0;0;0;4;1;394740;Lavadora LMA0920WGCL0 9,5Kg Gris;LINEA BLANCA
6087853;;F;70;CHILENO;;Silencioso;EL BOSQUE                     ;METROPOLITANA;498340;5;2;0;0;0;5;2;498340;Freezer 145 Lts FDHM150BY0 Horizontal;LINEA BLANCA
12412591;;F;48;CHILENO;;X;MELIPILLA                     ;METROPOLITANA;351860;3;2;0;0;0;3;2;351860;Lavadora MLS-160BSC03T 16Kg Blanca;LINEA BLANCA
25484123;;M;37;HAITIANO;;Extranjero;CERRO NAVIA                   ;METROPOLITANA;858320;6;3;0;0;0;6;3;858320;Lavadora Efficace SZG 17,5Kg Silver;LINEA BLANCA
16961927;Soltero;M;34;CHILENO;;Millenial;PROVIDENCIA                   ;METROPOLITANA;339980;2;1;2;1;339980;0;0;0;Cocina Diva 920 5P;LINEA BLANCA
5612324;;F;74;CHILENO;;Silencioso;VALPARAISO                    ;VALPARAISO;724650;4;2;0;0;0;4;2;724650;Refrigerador 525Lts Side by Side SFX500;LINEA BLANCA
10772618;;F;55;CHILENO;;Boomers;CORONEL                       ;BIO BIO;962530;5;1;0;0;0;5;1;962530;Refrigerador 527Lts Side by Side MRSBS5300G689WE;LINEA BLANCA
12357406;;F;49;CHILENO;;X;MAIPU                         ;METROPOLITANA;285340;5;1;0;0;0;5;1;285340;Lavadora Efficace BZG 9,5Kg Blanca;LINEA BLANCA
3812703;;M;86;CHILENO;;Silencioso;VILLARICA                     ;ARAUCANIA;272870;2;1;0;0;0;2;1;272870;Refrigerador 210Lts Rojo Frio Dir MRFS2100R273FN;LINEA BLANCA
14158796;;F;41;CHILENO;;X;PROVIDENCIA                   ;METROPOLITANA;443950;5;1;0;0;0;5;1;443950;Freezer 142Lts MFH-1430B186C Horizontal;LINEA BLANCA
16432610;;M;35;CHILENO;;Millenial;SAN ANTONIO                   ;VALPARAISO;297350;4;1;0;0;0;4;1;297350;Cocina CMC20AXX 4P Inox;LINEA BLANCA
13205330;;F;45;CHILENO;;X;RENCA                         ;METROPOLITANA;339990;1;1;0;0;0;1;1;339990;Cocina Diva 920 5P;LINEA BLANCA
15358721;;F;39;CHILENO;;X;N/D;N/D;415860;3;1;0;0;0;3;1;415860;Lavadora Efficace SZG 17,5Kg Silver;LINEA BLANCA
26130600;;M;40;ECUATORIANO;;Extranjero;"";"";1460500;10;2;0;0;0;10;2;1460500;Refrigerador 535Lts Side by Side RS54N3003SL/ZS;LINEA BLANCA
8913175;;F;59;CHILENO;;Boomers;SAN FELIPE                    ;VALPARAISO;721560;3;1;0;0;0;3;1;721560;Refrigerador 535Lts Side by Side RS54N3003SL/ZS;LINEA BLANCA
9757810;;F;56;CHILENO;;Boomers;PROVIDENCIA                   ;METROPOLITANA;338640;2;1;2;1;338640;0;0;0;KIT-138 HORNO HE-7200IN+CEG-4600IN+CA-610EIN;LINEA BLANCA
7237500;;F;69;CHILENO;;Silencioso;ANTOFAGASTA                   ;ANTOFAGASTA;219250;4;1;0;0;0;4;1;219250;Centrifuga Primma 5B 5,5Kilos;LINEA BLANCA
15578979;;M;38;CHILENO;;X;PROVIDENCIA                   ;METROPOLITANA;276360;3;1;0;0;0;3;1;276360;Cocina CMC5515GCH-1 4P;LINEA BLANCA
13937457;;F;42;CHILENO;;X;PROVIDENCIA                   ;METROPOLITANA;78540;2;1;2;1;78540;0;0;0;Encimera CE2-435I 2P Inox;LINEA BLANCA
8432374;;F;61;CHILENO;;Boomers;TOME                          ;BIO BIO;131270;2;1;0;0;0;2;1;131270;Calefon 7Lts GL Master;LINEA BLANCA
19143945;Soltero;M;26;CHILENO;;Z;PROVIDENCIA                   ;METROPOLITANA;325980;2;1;2;1;325980;0;0;0;Refrigerador Altus 1200V 197Lts No Frost;LINEA BLANCA
12212618;;F;49;CHILENO;;X;PICA                          ;TARAPACA;208660;3;4;0;0;0;3;4;208660;Lavadora MLS-160BSC03T 16Kg Blanca;LINEA BLANCA
12033113;;F;57;CHILENO;;Boomers;CURICO                        ;MAULE;224560;3;1;0;0;0;3;1;224560;Freezer 145 Lts FDHM150BY0 Horizontal;LINEA BLANCA
13750626;;M;43;CHILENO;;X;CATEMU                        ;VALPARAISO;548060;3;1;0;0;0;3;1;548060;Refrigerador 331Lts No Frost BF RB34T632FSA/ZS;LINEA BLANCA
12379113;;F;48;CHILENO;;X;PROVIDENCIA                   ;METROPOLITANA;410470;3;2;0;0;0;3;2;410470;Lavadora LMA8120WGCL0 18Kg Gris;LINEA BLANCA
16538074;;F;35;CHILENO;;Millenial;LINARES                       ;MAULE;697350;4;1;0;0;0;4;1;697350;Refrigerador 255Lts No Frost RT25FARADS8/ZS;LINEA BLANCA
14473180;;F;49;CHILENO;;X;SAN PABLO                     ;LOS LAGOS;285970;3;1;3;1;285970;0;0;0;Lavadora MLS-090GE04N 9Kg Gris;LINEA BLANCA
9593507;;M;60;CHILENO;;Boomers;CARAHUE                       ;ARAUCANIA;237870;2;1;0;0;0;2;1;237870;Freezer 145 Lts FDHM150BY0 Horizontal;LINEA BLANCA
6201701;;F;77;CHILENO;;Silencioso;CORONEL                       ;BIO BIO;436960;4;2;0;0;0;4;2;436960;Lavadora MLS-140GSC03T 14Kg Gris;LINEA BLANCA
13855483;;F;42;CHILENO;;X;QUILPUE                       ;VALPARAISO;0;1;2;0;0;0;1;2;0;Cocina CH-7400 4P;LINEA BLANCA
16077838;;F;36;CHILENO;;Millenial;N/D;N/D;134540;2;1;2;1;134540;0;0;0;FRIGOBAR 93 LTS MFB-930S121LN;LINEA BLANCA
14473438;;F;46;CHILENO;;X;CURICO                        ;MAULE;272570;2;1;0;0;0;2;1;272570;Lavadora MLS-160BSC03T 16Kg Blanca;LINEA BLANCA
18292623;;M;29;CHILENO;;Millenial;CURACAVI                      ;METROPOLITANA;289990;1;1;0;0;0;1;1;289990;Refrigerador 260Lts BF Frio Direc MRFI2660SR346W;LINEA BLANCA
18941824;;F;27;CHILENO;;Z;PLACILLA                      ;L.G.B.OÂ´HIGGINS;326970;3;2;0;0;0;3;2;326970;Lavadora WT13WSBP 13Kg Blanca;LINEA BLANCA
16846754;;M;34;CHILENO;;Millenial;N/D;N/D;105480;2;1;2;1;105480;0;0;0;Calefon 7Lts GL Master;LINEA BLANCA
18515161;;M;28;CHILENO;;Millenial;LA CISTERNA                   ;METROPOLITANA;289980;2;1;2;1;289980;0;0;0;Lavadora WT16WPB 16 KG Blanca;LINEA BLANCA
10207322;;F;57;CHILENO;;Boomers;LA LIGUA                      ;VALPARAISO;131309;4;2;0;0;0;4;2;131309;Calefon 7Lts GL ATMD;LINEA BLANCA
10052757;;M;57;CHILENO;;Boomers;PROVIDENCIA                   ;METROPOLITANA;229980;2;1;2;1;229980;0;0;0;Freezaer Vertical MFV 545B 165Lts;LINEA BLANCA
18677932;;M;28;CHILENO;;Millenial;N/D;N/D;249370;2;1;0;0;0;2;1;249370;Lavadora WA90H4400SW/ZS 9Kg Blanca;LINEA BLANCA
23815302;;M;37;PERUANO;;Extranjero;LA PINTANA                    ;METROPOLITANA;269990;1;1;0;0;0;1;1;269990;Refrigerador 241Lts BF Frio Directo Nordik 415;LINEA BLANCA
26224241;;M;36;HAITIANO;;Extranjero;LO ESPEJO                     ;METROPOLITANA;173980;2;1;2;1;173980;0;0;0;Lavadora Efficace BZG 9,5Kg Blanca;LINEA BLANCA
18401571;;M;28;CHILENO;;Millenial;PUENTE ALTO;METROPOLITANA;229980;2;1;2;1;229980;0;0;0;Refrigerador 260Lts BF Frio Direc MRFI2660SR346W;LINEA BLANCA
19814137;;M;30;CHILENO;;Millenial;SAN PEDRO DE LA PAZ           ;BIO BIO;344980;2;1;2;1;344980;0;0;0;Refrigerador 254Lts No Frost GT29WPPDC;LINEA BLANCA
15785014;;M;38;CHILENO;;Millenial;PROVIDENCIA                   ;METROPOLITANA;335980;2;1;2;1;335980;0;0;0;REFRIGERADOR TOP MOUNT GT29BPPK NO FROST 254 Lt;LINEA BLANCA
10524363;;F;58;CHILENO;;Boomers;RENCA                         ;METROPOLITANA;138270;2;1;0;0;0;2;1;138270;Centrifuga Primma 5B 5,5Kilos;LINEA BLANCA
13106242;;M;46;CHILENO;;X;CONCEPCION                    ;BIO BIO;273980;2;1;2;1;273980;0;0;0;Lavadora Efficace SZG 17,5Kg Silver;LINEA BLANCA
12898700;;F;47;CHILENO;;X;PROVIDENCIA                   ;METROPOLITANA;209980;2;1;2;1;209980;0;0;0;Secadora Ropa Solare 9100 9K Ventilacion;LINEA BLANCA
17025178;;F;33;CHILENO;;Millenial;N/D;N/D;399980;2;1;2;1;399980;0;0;0;Refrigerador No Frost con Dispensador 312 Lts GT;LINEA BLANCA
10246189;;M;50;CHILENO;;X;LEBU                          ;BIO BIO;425470;2;1;0;0;0;2;1;425470;Lavadora WT19DSBP 19Kg Silver;LINEA BLANCA
18624718;;M;28;CHILENO;;Millenial;PROVIDENCIA                   ;METROPOLITANA;335560;3;1;0;0;0;3;1;335560;Cocina CH-9950NG-1 6P Negro;LINEA BLANCA
15738896;;M;38;CHILENO;;Millenial;N/D;N/D;512460;3;1;0;0;0;3;1;512460;Refrigerador DW44S 400Lts Dispen No Frost;LINEA BLANCA
8587185;;M;63;CHILENO;;Boomers;CHONCHI                       ;LOS LAGOS;626060;3;1;0;0;0;3;1;626060;COCINA 76GS 5P Glass Negro;LINEA BLANCA
13494526;;F;44;CHILENO;;X;CASTRO                        ;LOS LAGOS;139980;2;1;0;0;0;2;1;139980;Lavadora MLS-090GE04N 9Kg Gris;LINEA BLANCA
17216703;;F;32;CHILENO;;Millenial;N/D;N/D;506480;2;1;0;0;0;2;1;506480;Refrigerador 527Lts Side by Side MRSBS5300G689WE;LINEA BLANCA
13505970;;F;45;CHILENO;;X;PENALOLEN                     ;METROPOLITANA;591970;3;2;3;2;591970;0;0;0;Refrigerador 527Lts Side by Side MRSBS5300G689WE;LINEA BLANCA
16995638;;M;33;CHILENO;;Silencioso;PROVIDENCIA                   ;METROPOLITANA;147540;2;1;2;1;147540;0;0;0;Lavadora WA80H4200SW/ZS 8Kg Blanca;LINEA BLANCA
20046458;;M;23;CHILENO;;Z;PROVIDENCIA                   ;METROPOLITANA;417960;4;2;4;2;417960;0;0;0;Lavadora 9 Kg Carga Superior Blanca;LINEA BLANCA
8578058;Casado;F;64;CHILENO;;Boomers;RENCA                         ;METROPOLITANA;116980;2;2;0;0;0;2;2;116980;Calefon 7Lts GL Master;LINEA BLANCA
13046147;;M;45;CHILENO;;X;PROVIDENCIA                   ;METROPOLITANA;143980;2;1;2;1;143980;0;0;0;Cocina CMC20AXX 4P Inox;LINEA BLANCA
6461718;Casado;F;73;CHILENO;;Silencioso;RENCA                         ;METROPOLITANA;175470;2;1;0;0;0;2;1;175470;Lavadora MLS-090GE04N 9Kg Gris;LINEA BLANCA
17845134;;M;30;CHILENO;;Millenial;TALCAHUANO                    ;BIO BIO;626970;3;1;0;0;0;3;1;626970;Refrigerador 300Lts No Frost RT29K500JS8/ZS;LINEA BLANCA
12491312;;F;49;CHILENO;;X;N/D;N/D;422760;3;1;0;0;0;3;1;422760;Cocina F-5500 Premium 5P;LINEA BLANCA
8148011;;F;60;CHILENO;;Boomers;SAN IGNACIO                   ;BIO BIO;308460;3;1;0;0;0;3;1;308460;Refrigerador 2100-S 207Lts Frio Directo;LINEA BLANCA
17726735;;F;31;CHILENO;;Silencioso;PROVIDENCIA                   ;METROPOLITANA;226980;2;1;0;0;0;2;1;226980;Cocina CH-9400 4P SILVER;LINEA BLANCA
3604426;;F;91;CHILENO;;Silencioso;ARICA                         ;ARICA Y PARINACOTA;209990;1;1;0;0;0;1;1;209990;Lavadora WA90H4400SW/ZS 9Kg Blanca;LINEA BLANCA
9977297;;M;52;CHILENO;;Silencioso;PROVIDENCIA                   ;METROPOLITANA;609980;2;1;2;1;609980;0;0;0;Refrigerador LT44AGP 424Lts Dispensador No Frost;LINEA BLANCA
16861398;;M;34;CHILENO;;Millenial;PUENTE ALTO                   ;METROPOLITANA;103170;2;1;0;0;0;2;1;103170;Calefon 7Lts GL ATMD;LINEA BLANCA
6514156;;M;71;CHILENO;;Silencioso;CORONEL                       ;BIO BIO;362460;3;1;0;0;0;3;1;362460;Cocina F-2808 4P;LINEA BLANCA
7006131;;M;69;CHILENO;;Silencioso;SAN FERNANDO                  ;L.G.B.OÂ´HIGGINS;219990;1;1;0;0;0;1;1;219990;Freezer 142Lts EFC14A5MNW Horizontal;LINEA BLANCA
13590715;;F;43;CHILENO;;X;N/D;N/D;508950;4;2;0;0;0;4;2;508950;Lavadora Brilliant SG 15Kg Silver;LINEA BLANCA
7844814;;M;65;CHILENO;;Boomers;PUENTE ALTO                   ;METROPOLITANA;319980;2;1;0;0;0;2;1;319980;Lavadora Efficace SZG 15,5Kg Silver;LINEA BLANCA
14609420;;M;41;CHILENO;;X;"";"";412770;2;1;0;0;0;2;1;412770;Lavadora WA17T6260BW/ZS 17Kg Blanca;LINEA BLANCA
8086290;;F;67;CHILENO;;Boomers;TEMUCO                        ;ARAUCANIA;266360;3;1;0;0;0;3;1;266360;Freezer 142Lts EFC14A5MNW Horizontal;LINEA BLANCA
26403355;;F;36;VENEZOLANO;;Extranjero;PURRANQUE                     ;LOS LAGOS;295980;2;1;2;1;295980;0;0;0;Lavadora WA13T5260BW/ZS 13Kg Blanca;LINEA BLANCA
18460296;;M;29;CHILENO;;Millenial;PUERTO MONTT                  ;LOS LAGOS;279990;2;1;0;0;0;2;1;279990;Refrigerador 241Lts BF Frio Directo Nordik 415;LINEA BLANCA
10108757;;F;58;CHILENO;;Boomers;LINARES                       ;MAULE;169990;1;1;0;0;0;1;1;169990;Cocina CH-7400 4P;LINEA BLANCA
11348594;;F;54;CHILENO;;X;QUILICURA                     ;METROPOLITANA;549970;3;1;0;0;0;3;1;549970;Refrigerador 241Lts BF Frio Directo Nordik 415;LINEA BLANCA
18086532;;M;30;CHILENO;;Millenial;"";"";345460;3;1;0;0;0;3;1;345460;Refrigerador 260Lts BF Frio Direc MRFI2660SR346W;LINEA BLANCA
7856982;;F;64;CHILENO;;Boomers;COIHAIQUE                     ;AYSEN;248370;2;1;0;0;0;2;1;248370;Calefon ionizado 13 litros GL;LINEA BLANCA
11652532;;F;52;CHILENO;;X;RENCA                         ;METROPOLITANA;409980;2;1;2;1;409980;0;0;0;Lavadora Superior WA19T6260BW/ZS 19Kg;LINEA BLANCA
18231494;Soltero;M;30;CHILENO;;Millenial;PROVIDENCIA                   ;METROPOLITANA;273980;2;1;2;1;273980;0;0;0;Lavadora MLS-140GSC03T 14Kg Gris;LINEA BLANCA
15264290;;F;39;CHILENO;;X;LANCO                         ;LOS RIOS;220570;2;1;0;0;0;2;1;220570;Cocina CMC20AXX 4P Inox;LINEA BLANCA
19474287;;F;25;CHILENO;;Z;TALCA                         ;MAULE;279370;2;1;0;0;0;2;1;279370;Refrigerador 241Lts BF Frio Directo Nordik 415;LINEA BLANCA
7161698;;F;71;CHILENO;;Silencioso;PROVIDENCIA                   ;METROPOLITANA;315980;2;1;2;1;315980;0;0;0;Lavadora Efficace SZG 15,5Kg Silver;LINEA BLANCA
9958906;;M;57;CHILENO;;Boomers;CHEPICA                       ;L.G.B.OÂ´HIGGINS;262570;2;1;0;0;0;2;1;262570;Freezer 142Lts EFC14A5MNW Horizontal;LINEA BLANCA
10445125;;M;56;CHILENO;;Boomers;PROVIDENCIA                   ;METROPOLITANA;240570;2;1;0;0;0;2;1;240570;Cocina CH-7400 4P;LINEA BLANCA
15449258;;F;39;CHILENO;;Millenial;PROVIDENCIA                   ;METROPOLITANA;209980;2;1;2;1;209980;0;0;0;Lavadora WA90H4400SW/ZS 9Kg Blanca;LINEA BLANCA
18010442;;F;30;CHILENO;;Millenial;PROVIDENCIA                   ;METROPOLITANA;288970;3;1;0;0;0;3;1;288970;Lavadora WA80H4200SW/ZS 8Kg Blanca;LINEA BLANCA
8067676;;F;61;CHILENO;;Boomers;TEMUCO                        ;ARAUCANIA;890550;4;1;0;0;0;4;1;890550;Refrigerador 535Lts Side by Side RS54N3003SL/ZS;LINEA BLANCA
11439750;;F;52;CHILENO;;X;PROVIDENCIA                   ;METROPOLITANA;400480;2;1;0;0;0;2;1;400480;Cocina CH-8900IN 5P;LINEA BLANCA
16309035;;F;32;CHILENO;;Millenial;ANCUD                         ;LOS LAGOS;201980;2;1;0;0;0;2;1;201980;Freezer 142Lts MFH-1430B186C Horizontal;LINEA BLANCA
14380690;;F;44;CHILENO;;X;MELIPILLA                     ;METROPOLITANA;692970;3;1;0;0;0;3;1;692970;Refrigerador 527Lts Side by Side MRSBS5300G689WE;LINEA BLANCA
7827357;;F;66;CHILENO;;Boomers;RENCA                         ;METROPOLITANA;559970;3;1;0;0;0;3;1;559970;Refrigerador 241Lts BF Frio Directo Nordik 415;LINEA BLANCA
15268211;;M;40;CHILENO;;Silencioso;N/D;N/D;227370;2;1;0;0;0;2;1;227370;Cocina CH-7400 4P;LINEA BLANCA
4548963;;F;81;CHILENO;;Silencioso;CHILLAN                       ;BIO BIO;0;0;0;0;0;0;0;0;0;Refrigerador 260Lts BF Frio Direc MRFI2660SR346W;LINEA BLANCA
4629132;;F;82;CHILENO;;Silencioso;LOS ALAMOS                    ;BIO BIO;0;0;0;0;0;0;0;0;0;Refrigerador 602Lts SBS SAMSUNG RS60T5200S9/ZS;LINEA BLANCA
13570652;;F;42;CHILENO;;Silencioso;SAN FERNANDO                  ;L.G.B.OÂ´HIGGINS;0;0;0;0;0;0;0;0;0;Cocina 775X 4P;LINEA BLANCA
8080572;;F;60;CHILENO;;Boomers;PUNTA ARENAS                  ;MAGALLANES;0;0;0;0;0;0;0;0;0;Refrigerador 249Lts No Frost RMA250PHUG;LINEA BLANCA
18155815;;F;29;CHILENO;;Millenial;CHILLAN                       ;BIO BIO;0;0;0;0;0;0;0;0;0;Cocina MV 220 4P;LINEA BLANCA
4595706;;M;77;CHILENO;;Silencioso;CONCEPCION                    ;BIO BIO;0;0;0;0;0;0;0;0;0;Cocina Diva 920 5P;LINEA BLANCA
17197764;Soltero;F;33;CHILENO;QUIMICO FARMACEUTICO;Silencioso;PROVIDENCIA                   ;METROPOLITANA;0;0;0;0;0;0;0;0;0;Lavadora Secadora WD12N64FR 12/7Kg;LINEA BLANCA
18261537;;F;29;CHILENO;;Millenial;N/D;N/D;0;0;0;0;0;0;0;0;0;Cocina F-5500 Premium 5P;LINEA BLANCA
24433242;;F;46;BOLIVIANO;;Extranjero;ANTOFAGASTA                   ;ANTOFAGASTA;0;0;0;0;0;0;0;0;0;Refrigerador 244Lts Frio Directo Progress 3100;LINEA BLANCA
7253820;;F;64;CHILENO;;Boomers;PROVIDENCIA                   ;METROPOLITANA;0;0;0;0;0;0;0;0;0;CENTRIFUGA C-752;LINEA BLANCA
11843985;Casado;M;51;CHILENO;AGRONOMO;X;PROVIDENCIA                   ;METROPOLITANA;0;0;0;0;0;0;0;0;0;Refrigerador 626Lt Side by Side GS65MPP1 APZPECL;LINEA BLANCA
26489067;Soltero;F;25;CHILENO;;Extranjero;PROVIDENCIA                   ;METROPOLITANA;0;0;0;0;0;0;0;0;0;Refrigerador 241Lts BF Frio Directo Nordik 415;LINEA BLANCA
6453790;;F;71;CHILENO;;Silencioso;BUIN                          ;METROPOLITANA;0;0;0;0;0;0;0;0;0;Lavadora WT19DSBP 19Kg Silver;LINEA BLANCA
8527857;;M;63;CHILENO;;Boomers;RENCA                         ;METROPOLITANA;0;0;0;0;0;0;0;0;0;Refrigerador 254Lts No Frost GT29WPPDC;LINEA BLANCA
16771718;;F;35;CHILENO;;Millenial;N/D;N/D;0;0;0;0;0;0;0;0;0;CAMPANA AT-MD BOGEN N19 60;LINEA BLANCA
16851624;Soltero;F;34;CHILENO;;Millenial;RENCA                         ;METROPOLITANA;0;0;0;0;0;0;0;0;0;Lavadora Efficace SZG 17,5Kg Silver;LINEA BLANCA
13399136;;F;44;CHILENO;;X;LONCOCHE                      ;ARAUCANIA;0;0;0;0;0;0;0;0;0;Refrigerador 290Lts BF No Frost RB30N4020S8;LINEA BLANCA
11901099;;F;50;CHILENO;;X;TALCAHUANO                    ;BIO BIO;0;0;0;0;0;0;0;0;0;Lavadora WA13T5260BW/ZS 13Kg Blanca;LINEA BLANCA
6491387;;F;73;CHILENO;;Silencioso;PROVIDENCIA                   ;METROPOLITANA;0;0;0;0;0;0;0;0;0;Cocina MV 110 4 Platos;LINEA BLANCA
7960422;;M;63;CHILENO;;Boomers;COIHAIQUE                     ;AYSEN;0;0;0;0;0;0;0;0;0;Cocina Andes60TX4 4P Inox;LINEA BLANCA
17935765;;F;30;CHILENO;;Millenial;N/D;N/D;0;0;0;0;0;0;0;0;0;Refrigerador 527Lts Side by Side MRSBS5300G689WE;LINEA BLANCA
7122546;;F;67;CHILENO;;Boomers;PROVIDENCIA                   ;METROPOLITANA;0;0;0;0;0;0;0;0;0;Refrigerador 260Lts BF Frio Direc MRFI2660SR346W;LINEA BLANCA
11831608;;M;51;CHILENO;;Millenial;VALPARAISO                    ;VALPARAISO;0;0;0;0;0;0;0;0;0;CENTRIFUGA C-752;LINEA BLANCA
11613454;;M;51;CHILENO;;X;N/D;N/D;0;0;0;0;0;0;0;0;0;Cocina MV 110 4 Platos;LINEA BLANCA
15867979;;M;38;CHILENO;;Millenial;N/D;N/D;0;0;0;0;0;0;0;0;0;Lavadora MLS-090GE04N 9Kg Gris;LINEA BLANCA
9531649;;F;47;CHILENO;;X;RENCA                         ;METROPOLITANA;0;0;0;0;0;0;0;0;0;Lavadora superior MLS-110GE04N 11Kg;LINEA BLANCA
7482128;;M;66;CHILENO;;Boomers;PADRE LAS CASAS               ;ARAUCANIA;0;0;0;0;0;0;0;0;0;Cocina F-2608 4P Inox;LINEA BLANCA
10143885;Soltero;F;60;CHILENO;;Boomers;PENAFLOR                      ;METROPOLITANA;0;0;0;0;0;0;0;0;0;Cocina F-2525 4P;LINEA BLANCA
15147598;;M;40;CHILENO;;X;PROVIDENCIA                   ;METROPOLITANA;0;0;0;0;0;0;0;0;0;Lavadora Superior WA15T5260BY/ZS 15 Kg;LINEA BLANCA
12164173;;F;48;CHILENO;;X;QUELLON                       ;LOS LAGOS;0;0;0;0;0;0;0;0;0;Lavadora WA15T5260BW/ZS 15Kg Blanca;LINEA BLANCA
12761219;Casado;M;47;CHILENO;;X;RENCA                         ;METROPOLITANA;0;0;0;0;0;0;0;0;0;Cocina Diva 920 5P;LINEA BLANCA
12724836;;M;47;CHILENO;;X;BUIN                          ;METROPOLITANA;0;0;0;0;0;0;0;0;0;Lavadora MLS-160BSC03T 16Kg Blanca;LINEA BLANCA
25860238;;M;30;VENEZOLANO;;Extranjero;VINA DEL MAR                  ;VALPARAISO;0;0;0;0;0;0;0;0;0;Lavadora Secadora WD90M4453JW/ZS 9/5Kg Blanca;LINEA BLANCA
20169499;;F;23;CHILENO;;Z;PROVIDENCIA                   ;METROPOLITANA;0;0;0;0;0;0;0;0;0;Refrigerador 260Lts BF Frio Direc MRFI2660SR346W;LINEA BLANCA
10709860;;M;56;CHILENO;;Boomers;ARAUCO                        ;BIO BIO;0;0;0;0;0;0;0;0;0;Refrigerador 3560-S 337Lts No Frost;LINEA BLANCA
13662929;;M;42;CHILENO;;X;LA FLORIDA                    ;METROPOLITANA;0;0;0;0;0;0;0;0;0;Secadora Ropa Reverplus 6470 7Kg Gris Ventilacio;LINEA BLANCA
11440166;;F;53;CHILENO;;X;LOS ALAMOS                    ;BIO BIO;0;0;0;0;0;0;0;0;0;Cocina Andes60TX4 4P Inox;LINEA BLANCA
7988119;;F;61;CHILENO;;Boomers;SAN BERNARDO                  ;METROPOLITANA;0;0;0;0;0;0;0;0;0;Secadora Ropa MSV-90 9K Blanca Ventilacion;LINEA BLANCA
6987123;;F;72;CHILENO;;Silencioso;SAN FELIPE                    ;VALPARAISO;0;0;0;0;0;0;0;0;0;Cocina MCG-4QI24AME4 4P Inox;LINEA BLANCA
17056505;;M;33;CHILENO;;Millenial;AISEN                         ;AYSEN;0;0;0;0;0;0;0;0;0;Refrigerador 254Lts No Frost GT29WPPDC;LINEA BLANCA
13646755;Soltero;M;43;CHILENO;;X;PROVIDENCIA                   ;METROPOLITANA;0;0;0;0;0;0;0;0;0;Lavadora Semiautomatica Twister 5100 4Kg;LINEA BLANCA
8488927;;F;64;CHILENO;;Boomers;RENCA                         ;METROPOLITANA;0;0;0;0;0;0;0;0;0;CALEFON 13 LITROS MASTER GL (SPLENDID);LINEA BLANCA
16703118;Soltero;F;34;CHILENO;;Millenial;RENAICO                       ;ARAUCANIA;0;0;0;0;0;0;0;0;0;Freezer Horizontal M100 99Lts;LINEA BLANCA
17440150;;M;32;CHILENO;;Millenial;TEMUCO                        ;ARAUCANIA;0;0;0;0;0;0;0;0;0;Secadora Ropa MSC-90 9K Blanca Condensacion;LINEA BLANCA
12139891;;F;43;CHILENO;;X;NATALES                       ;MAGALLANES;0;0;0;0;0;0;0;0;0;Refrigerador 400Lts No Frost RMP400FZUC Dispen;LINEA BLANCA
15649573;Soltero;F;38;CHILENO;;Millenial;PROVIDENCIA                   ;METROPOLITANA;0;0;0;0;0;0;0;0;0;Lavadora WT16DSBP 16Kg Silver;LINEA BLANCA
15271297;;M;38;CHILENO;;X;N/D;N/D;0;0;0;0;0;0;0;0;0;Secadora Ropa MSC-90 9K Blanca Condensacion;LINEA BLANCA
6723930;;F;68;CHILENO;;Silencioso;OLMUE                         ;VALPARAISO;0;0;0;0;0;0;0;0;0;Refrigerador 260Lts BF Frio Direc MRFI2660SR346W;LINEA BLANCA
15250250;;M;40;CHILENO;;Silencioso;PROVIDENCIA                   ;METROPOLITANA;0;0;0;0;0;0;0;0;0;Cocina 56DXQ 4P Doble Horno;LINEA BLANCA
12890202;;M;47;CHILENO;;X;EL QUISCO                     ;VALPARAISO;0;0;0;0;0;0;0;0;0;CALEFON 6 LITROS MASTER (SPLENDID);LINEA BLANCA
7915332;Casado;F;64;CHILENO;;Boomers;PROVIDENCIA                   ;METROPOLITANA;0;0;0;0;0;0;0;0;0;Cocina MCG-4QI24AME4 4P Inox;LINEA BLANCA
8051425;;F;62;CHILENO;;Boomers;COIHAIQUE                     ;AYSEN;0;0;0;0;0;0;0;0;0;Lavadora Brilliant SG 11,5Kg Silver;LINEA BLANCA
12164493;;F;48;CHILENO;;X;"";"";0;0;0;0;0;0;0;0;0;Freezer Horizontal M100 99Lts;LINEA BLANCA
5901087;;F;75;CHILENO;;Silencioso;PROVIDENCIA                   ;METROPOLITANA;0;0;0;0;0;0;0;0;0;Cocina Andes60TX4 4P Inox;LINEA BLANCA
18189875;;M;29;CHILENO;;Silencioso;PROVIDENCIA                   ;METROPOLITANA;0;0;0;0;0;0;0;0;0;Refrigerador 260Lts BF Frio Direc MRFI2660SR346W;LINEA BLANCA
8477709;Casado;F;65;CHILENO;;Boomers;RENCA                         ;METROPOLITANA;0;0;0;0;0;0;0;0;0;Calefon Neckar 10 litros GL;LINEA BLANCA
11048322;Casado;F;55;CHILENO;;Boomers;PENAFLOR                      ;METROPOLITANA;0;0;0;0;0;0;0;0;0;Cocina MV 220 4P;LINEA BLANCA
11768369;;M;50;CHILENO;;X;CAUQUENES                     ;MAULE;0;0;0;0;0;0;0;0;0;Lavadora MLS-160BSC03T 16Kg Blanca;LINEA BLANCA
15643634;;F;38;CHILENO;;Millenial;PROVIDENCIA                   ;METROPOLITANA;0;0;0;0;0;0;0;0;0;Lavadora Superior WA13T5260BY/ZS 13Kg;LINEA BLANCA
7198055;;F;67;CHILENO;;Boomers;CALERA DE TANGO               ;METROPOLITANA;0;0;0;0;0;0;0;0;0;Secadora Ropa MSV-90 9K Blanca Ventilacion;LINEA BLANCA
17234820;;M;33;CHILENO;;Millenial;PROVIDENCIA                   ;METROPOLITANA;0;0;0;0;0;0;0;0;0;Cocina MV 110 4 Platos;LINEA BLANCA
17303696;;M;33;CHILENO;;X;PROVIDENCIA                   ;METROPOLITANA;0;0;0;0;0;0;0;0;0;Freezer Horizontal MFH-1990B258CN 198Lts;LINEA BLANCA
18186763;;F;30;CHILENO;;Millenial;PROVIDENCIA                   ;METROPOLITANA;0;0;0;0;0;0;0;0;0;Cocina MV 110 4 Platos;LINEA BLANCA
10170760;;M;58;CHILENO;;Boomers;LOS ANGELES                   ;BIO BIO;0;0;0;0;0;0;0;0;0;Cocina CH-7400 4P;LINEA BLANCA
6904164;Casado;M;67;CHILENO;;Boomers;PROVIDENCIA                   ;METROPOLITANA;0;0;0;0;0;0;0;0;0;Refrigerador 241Lts BF Frio Directo Nordik 415;LINEA BLANCA
23227106;;M;46;BOLIVIANO;;Extranjero;IQUIQUE                       ;TARAPACA;0;0;0;0;0;0;0;0;0;Lavadora WA90H4400SW/ZS 9Kg Blanca;LINEA BLANCA
7174692;;F;69;CHILENO;;Silencioso;OSORNO                        ;LOS LAGOS;0;0;0;0;0;0;0;0;0;Lavadora Efficace SZG 15,5Kg Silver;LINEA BLANCA
18282946;;M;28;CHILENO;;Silencioso;PROVIDENCIA                   ;METROPOLITANA;0;0;0;0;0;0;0;0;0;Lavadora WD10J6410AX/ZS 10,5Kg;LINEA BLANCA
14180471;;F;41;CHILENO;;X;LA GRANJA                     ;METROPOLITANA;0;0;0;0;0;0;0;0;0;Calefont 7 Litros GL Tiro Forzado;LINEA BLANCA
18476837;Soltero;M;29;CHILENO;;Millenial;PROVIDENCIA                   ;METROPOLITANA;0;0;0;0;0;0;0;0;0;Lavadora MLS-160BSC03T 16Kg Blanca;LINEA BLANCA
8884349;;M;62;CHILENO;;Boomers;CAUQUENES                     ;MAULE;0;0;0;0;0;0;0;0;0;Refrigerador 249Lts No Frost RMA250PHUG;LINEA BLANCA
19212864;;F;26;CHILENO;;Z;PROVIDENCIA                   ;METROPOLITANA;0;0;0;0;0;0;0;0;0;Refrigerador MRFI1800R234RN 180Lts BF Frio Dir;LINEA BLANCA
13817590;;M;44;CHILENO;;X;CALBUCO                       ;LOS LAGOS;0;0;0;0;0;0;0;0;0;Secadora Ropa Solare 7100 7K Ventilacion;LINEA BLANCA
19810404;;F;24;CHILENO;;Z;TEMUCO;ARAUCANIA;0;0;0;0;0;0;0;0;0;Refrigerador MRFI1800S234RN 180Lts BF Frio Direc;LINEA BLANCA
19049211;;F;26;CHILENO;;Millenial;PROVIDENCIA                   ;METROPOLITANA;0;0;0;0;0;0;0;0;0;ENCIMERA A GAS 4 PLATOS CEG-4600 INOX;LINEA BLANCA
9948259;Soltero;M;58;CHILENO;;Boomers;RENCA                         ;METROPOLITANA;0;0;0;0;0;0;0;0;0;Refrigerador 241Lts BF Frio Directo Nordik 415;LINEA BLANCA
12385784;;F;48;CHILENO;;X;CURANILAHUE                   ;BIO BIO;0;0;0;0;0;0;0;0;0;Refrigerador 290Lts BF No Frost RB30N4020S8;LINEA BLANCA
15332497;;F;39;CHILENO;;X;BUIN                          ;METROPOLITANA;0;0;0;0;0;0;0;0;0;Lavadora Efficace BZG 9,5Kg Blanca;LINEA BLANCA
10003241;;M;57;CHILENO;;Boomers;CONSTITUCION                  ;MAULE;0;0;0;0;0;0;0;0;0;Refrigerador RMN222PXLRS0 222LTS No Frost;LINEA BLANCA
12095701;;F;59;CHILENO;;Boomers;PROVIDENCIA                   ;METROPOLITANA;0;0;0;0;0;0;0;0;0;Secadora Ropa MSV-90 9K Blanca Ventilacion;LINEA BLANCA
13388300;;M;43;CHILENO;;X;ANTOFAGASTA                   ;ANTOFAGASTA;0;0;0;0;0;0;0;0;0;Refrigerador 252Lts No Frost MRFS-2700G333FW;LINEA BLANCA
7417291;;M;65;CHILENO;;Boomers;MAIPU                         ;METROPOLITANA;0;0;0;0;0;0;0;0;0;ENCIMERA A GAS 4 PLATOS CEG-4600 INOX;LINEA BLANCA
14631692;;F;43;CHILENO;;X;PROVIDENCIA                   ;METROPOLITANA;0;0;0;0;0;0;0;0;0;ENCIMERA URSUS AVANTGARDE GLG-90T GN;LINEA BLANCA
15440778;;M;39;CHILENO;;Silencioso;PROVIDENCIA                   ;METROPOLITANA;0;0;0;0;0;0;0;0;0;Refrigerador LT44AGP 424Lts Dispensador No Frost;LINEA BLANCA
11278063;;F;54;CHILENO;;X;SAN VICENTE                   ;L.G.B.OÂ´HIGGINS;0;0;0;0;0;0;0;0;0;Refrigerador 244Lts Frio Directo Progress 3100;LINEA BLANCA
13366093;;F;44;CHILENO;;X;N/D;N/D;0;0;0;0;0;0;0;0;0;Lavadora MLS-090GE04N 9Kg Gris;LINEA BLANCA
5284086;;F;75;CHILENO;;Silencioso;PROVIDENCIA                   ;METROPOLITANA;0;0;0;0;0;0;0;0;0;Refrigerador 252Lts No Frost MRFS-2700G333FW;LINEA BLANCA
19107720;;F;26;CHILENO;;Z;PROVIDENCIA                   ;METROPOLITANA;0;0;0;0;0;0;0;0;0;FRIGOBAR 93 LTS MFB-930S121LN;LINEA BLANCA
5457733;;M;74;CHILENO;;Silencioso;RENCA                         ;METROPOLITANA;0;0;0;0;0;0;0;0;0;Calefont 10Lts GL Essenetial ECO;LINEA BLANCA
14585009;;M;46;CHILENO;;X;PROVIDENCIA                   ;METROPOLITANA;0;0;0;0;0;0;0;0;0;Lavadora 9 Kg Carga Superior Blanca;LINEA BLANCA
11669375;;F;51;CHILENO;;X;CONSTITUCION                  ;MAULE;0;0;0;0;0;0;0;0;0;Cocina CMC20AXX 4P Inox;LINEA BLANCA
9756409;;F;50;CHILENO;;X;SAN FELIPE                    ;VALPARAISO;0;0;0;0;0;0;0;0;0;Secadora 9Kg Solare 9200 Ventilacion;LINEA BLANCA
15758730;;F;38;CHILENO;;Silencioso;PROVIDENCIA                   ;METROPOLITANA;0;0;0;0;0;0;0;0;0;Cocina CMC5515GCH-1 4P;LINEA BLANCA
9335398;;F;62;CHILENO;;Boomers;TALCA                         ;MAULE;0;0;0;0;0;0;0;0;0;Secadora Ropa MSC-90 9K Blanca Condensacion;LINEA BLANCA
11269001;;F;54;CHILENO;;X;PUERTO MONTT                  ;LOS LAGOS;0;0;0;0;0;0;0;0;0;Secadora Ropa Reverplus 6470 7Kg Gris Ventilacio;LINEA BLANCA
18267008;;F;30;CHILENO;;Millenial;PROVIDENCIA                   ;METROPOLITANA;0;0;0;0;0;0;0;0;0;Refrigerador MRFI1800R234RN 180Lts BF Frio Dir;LINEA BLANCA
4427302;;M;80;CHILENO;;Silencioso;RENCA                         ;METROPOLITANA;0;0;0;0;0;0;0;0;0;Lavadora MLS-160BSC03T 16Kg Blanca;LINEA BLANCA
13145494;;M;44;CHILENO;;X;LOS ANGELES                   ;BIO BIO;0;0;0;0;0;0;0;0;0;Lavadora MLS-080BE04N 8Kg Blanca;LINEA BLANCA
14619013;;M;46;CHILENO;;X;LA PINTANA                    ;METROPOLITANA;0;0;0;0;0;0;0;0;0;Lavadora WT16DSBP 16Kg Silver;LINEA BLANCA
10267298;;M;57;CHILENO;;Boomers;SAN CARLOS                    ;BIO BIO;0;0;0;0;0;0;0;0;0;Lavadora WA13T5260BW/ZS 13Kg Blanca;LINEA BLANCA
5648434;;F;76;CHILENO;;Silencioso;PUENTE ALTO                   ;METROPOLITANA;0;0;0;0;0;0;0;0;0;Lavadora MLS-090GE04N 9Kg Gris;LINEA BLANCA
17530796;;M;32;CHILENO;;Millenial;PROVIDENCIA                   ;METROPOLITANA;0;0;0;0;0;0;0;0;0;Secadora Ropa Solare 7100 7K Ventilacion;LINEA BLANCA
15390055;;F;38;CHILENO;;Millenial;PROVIDENCIA                   ;METROPOLITANA;0;0;0;0;0;0;0;0;0;Lavadora MLS-090GE04N 9Kg Gris;LINEA BLANCA
4569329;;F;80;CHILENO;;Silencioso;ARICA                         ;ARICA Y PARINACOTA;0;0;0;0;0;0;0;0;0;Lavadora WT16DSBP 16Kg Silver;LINEA BLANCA
14082884;;F;41;CHILENO;;X;PROVIDENCIA                   ;METROPOLITANA;0;0;0;0;0;0;0;0;0;Refrigerador MRFI1800S234RN 180Lts BF Frio Direc;LINEA BLANCA
8602500;;M;63;CHILENO;;Boomers;RENCA                         ;METROPOLITANA;0;0;0;0;0;0;0;0;0;Cocina CR91+ 4P;LINEA BLANCA
5315898;;M;73;CHILENO;;Silencioso;ALHUE                         ;METROPOLITANA;0;0;0;0;0;0;0;0;0;Refrigerador 244Lts Frio Directo Progress 3100;LINEA BLANCA
12123686;;F;43;CHILENO;;X;PROVIDENCIA                   ;METROPOLITANA;0;0;0;0;0;0;0;0;0;Secadora Ropa Solare 7100 7K Ventilacion;LINEA BLANCA
12091447;;F;57;CHILENO;;Boomers;CONSTITUCION                  ;MAULE;0;0;0;0;0;0;0;0;0;Lavadora WA17T6260BW/ZS 17Kg Blanca;LINEA BLANCA
19492930;;M;25;CHILENO;;Silencioso;PROVIDENCIA                   ;METROPOLITANA;0;0;0;0;0;0;0;0;0;Refrigerador 255Lts No Frost RT25FARADS8/ZS;LINEA BLANCA
6509343;;F;69;CHILENO;;Silencioso;PUNTA ARENAS                  ;MAGALLANES;0;0;0;0;0;0;0;0;0;Refrigerador 244Lts Frio Directo Progress 3100;LINEA BLANCA
9958201;;F;59;CHILENO;;Silencioso;PROVIDENCIA                   ;METROPOLITANA;0;0;0;0;0;0;0;0;0;Calefont 8Lts GL Essenetial ECO;LINEA BLANCA
19883299;;F;24;CHILENO;;Z;RENCA                         ;METROPOLITANA;0;0;0;0;0;0;0;0;0;Calefont 8Lts GL Essenetial ECO;LINEA BLANCA
18388305;;M;29;CHILENO;;Millenial;CARTAGENA                     ;VALPARAISO;0;0;0;0;0;0;0;0;0;Refrigerador 260Lts BF Frio Direc MRFI2660SR346W;LINEA BLANCA
17726722;;F;31;CHILENO;;Millenial;TEMUCO                        ;ARAUCANIA;0;0;0;0;0;0;0;0;0;Secadora Ropa Reverplus 6470 7Kg Gris Ventilacio;LINEA BLANCA
16578348;;F;34;CHILENO;;Millenial;QUELLON                       ;LOS LAGOS;0;0;0;0;0;0;0;0;0;Cocina F-2525 4P;LINEA BLANCA
15936328;;M;37;CHILENO;;Millenial;N/D;N/D;0;0;0;0;0;0;0;0;0;Lavadora C Frontal 12K WM12WVC4S6 Inverter Dire;LINEA BLANCA
5726838;;M;76;CHILENO;;Silencioso;TALCAHUANO                    ;BIO BIO;0;0;0;0;0;0;0;0;0;Lavadora WT13WSBP 13Kg Blanca;LINEA BLANCA
18992715;Casado;F;27;CHILENO;;Silencioso;PROVIDENCIA                   ;METROPOLITANA;0;0;0;0;0;0;0;0;0;Lavadora WA15T5260BW/ZS 15Kg Blanca;LINEA BLANCA
8495628;;M;65;CHILENO;;Boomers;VALDIVIA                      ;LOS LAGOS;0;0;0;0;0;0;0;0;0;Cocina 775X 4P;LINEA BLANCA
5942921;Casado;M;73;CHILENO;;Silencioso;CURICO                        ;MAULE;0;0;0;0;0;0;0;0;0;Lavadora MLS-090GE04N 9Kg Gris;LINEA BLANCA
16701524;;M;35;CHILENO;;Millenial;N/D;N/D;0;0;0;0;0;0;0;0;0;Cocina CH-9050SI 4P;LINEA BLANCA
11068836;Soltero;F;56;CHILENO;;Boomers;NANCAGUA                      ;L.G.B.OÂ´HIGGINS;0;0;0;0;0;0;0;0;0;Secadora Ropa Solare 7100 7K Ventilacion;LINEA BLANCA
17092909;;F;33;CHILENO;;Millenial;PROVIDENCIA                   ;METROPOLITANA;0;0;0;0;0;0;0;0;0;Lavadora MLS-090GE04N 9Kg Gris;LINEA BLANCA
7396914;;M;67;CHILENO;;Boomers;PROVIDENCIA                   ;METROPOLITANA;0;0;0;0;0;0;0;0;0;Refrigerador 290Lts BF No Frost RB30N4020S8;LINEA BLANCA
18953569;;F;27;CHILENO;;Millenial;SAN NICOLAS                   ;BIO BIO;0;0;0;0;0;0;0;0;0;ENCIMERA BREIT PRO 75 GL 5P ALBIN TROTTER;LINEA BLANCA
16968686;;M;34;CHILENO;;Silencioso;PROVIDENCIA                   ;METROPOLITANA;0;0;0;0;0;0;0;0;0;Frigobar RMF04HV0 93Llts Negro;LINEA BLANCA
19867977;;F;24;CHILENO;;Z;N/D;N/D;0;0;0;0;0;0;0;0;0;Cocina CH-7400 4P;LINEA BLANCA
13901957;;F;42;CHILENO;;X;COQUIMBO;COQUIMBO;0;0;0;0;0;0;0;0;0;Cocina CH-9700IN 4P;LINEA BLANCA
5521097;Viudo;F;75;CHILENO;;Silencioso;ESTACION CENTRAL              ;METROPOLITANA;0;0;0;0;0;0;0;0;0;Secadora Electrica SEM101BDBY Blanca 10 KG;LINEA BLANCA
15595485;;M;38;CHILENO;;Millenial;IQUIQUE                       ;TARAPACA;0;0;0;0;0;0;0;0;0;Secadora Electrica SEM101BDBY Blanca 10 KG;LINEA BLANCA
7917184;;F;63;CHILENO;;Boomers;RENCA                         ;METROPOLITANA;0;0;0;0;0;0;0;0;0;Secadora Ropa Solare 7100 7K Ventilacion;LINEA BLANCA
10662905;;F;57;CHILENO;;Boomers;QUILPUE                       ;VALPARAISO;0;0;0;0;0;0;0;0;0;Cocina CH-9500 NG 4P;LINEA BLANCA
18151436;;F;30;CHILENO;;Millenial;PROVIDENCIA                   ;METROPOLITANA;0;0;0;0;0;0;0;0;0;Lavadora MLS-140GSC03T 14Kg Gris;LINEA BLANCA
13547272;;F;43;CHILENO;;X;PROVIDENCIA                   ;METROPOLITANA;0;0;0;0;0;0;0;0;0;Secadora Electrica SEM101BDBY Blanca 10 KG;LINEA BLANCA
11249806;;F;54;CHILENO;;X;PROVIDENCIA                   ;METROPOLITANA;0;0;0;0;0;0;0;0;0;Refrigerador 290Lts BF No Frost RB30N4020S8;LINEA BLANCA
7080655;;F;68;CHILENO;;Boomers;RENCA                         ;METROPOLITANA;0;0;0;0;0;0;0;0;0;Cocina CH-9400 4P SILVER;LINEA BLANCA
8100820;;F;70;CHILENO;;Silencioso;CASTRO                        ;LOS LAGOS;0;0;0;0;0;0;0;0;0;Secadora Ropa MSV-90 9K Blanca Ventilacion;LINEA BLANCA
17078030;;F;33;CHILENO;;Z;PROVIDENCIA                   ;METROPOLITANA;0;0;0;0;0;0;0;0;0;Lavadora Efficace SZG 17,5Kg Silver;LINEA BLANCA
7902585;;M;63;CHILENO;;Boomers;ANTOFAGASTA                   ;ANTOFAGASTA;0;0;0;0;0;0;0;0;0;Refrigerador RMN222PXLRS0 222LTS No Frost;LINEA BLANCA
19354298;;F;26;CHILENO;;Z;COQUIMBO;COQUIMBO;0;0;0;0;0;0;0;0;0;Lavadora WA80H4200SW/ZS 8Kg Blanca;LINEA BLANCA
13219742;;M;45;CHILENO;;X;N/D;N/D;0;0;0;0;0;0;0;0;0;COCINA 76GS 5P Glass Negro;LINEA BLANCA
13075926;;M;45;CHILENO;;Silencioso;PROVIDENCIA                   ;METROPOLITANA;0;0;0;0;0;0;0;0;0;ENCIMERA XNG FEIN PRO FF GL 4P ALBIN TROTTER;LINEA BLANCA
6812682;;F;68;CHILENO;;Silencioso;PANGUIPULLI                   ;LOS RIOS;0;0;0;0;0;0;0;0;0;Cocina CH-7400 4P;LINEA BLANCA
17838961;;M;31;CHILENO;;Millenial;PROVIDENCIA                   ;METROPOLITANA;0;0;0;0;0;0;0;0;0;Secadora Electrica SEM101BDBY Blanca 10 KG;LINEA BLANCA
14249053;Divorciado;F;48;CHILENO;;X;PROVIDENCIA                   ;METROPOLITANA;0;0;0;0;0;0;0;0;0;CAMPANA AT-MD BOGEN TOUCH N19 90;LINEA BLANCA
20408707;;F;21;CHILENO;;Z;RENCA                         ;METROPOLITANA;0;0;0;0;0;0;0;0;0;Lavadora WA13T5260BW/ZS 13Kg Blanca;LINEA BLANCA
19718223;;F;25;CHILENO;;Z;PROVIDENCIA                   ;METROPOLITANA;0;0;0;0;0;0;0;0;0;Refrigerador 260Lts BF Frio Direc MRFI2660SR346W;LINEA BLANCA
18207531;Soltero;M;30;CHILENO;;Silencioso;PROVIDENCIA                   ;METROPOLITANA;0;0;0;0;0;0;0;0;0;Secadora Electrica SEM101BDBY Blanca 10 KG;LINEA BLANCA
11696213;;M;50;CHILENO;;X;SAN BERNARDO                  ;METROPOLITANA;0;0;0;0;0;0;0;0;0;Lavadora Efficace BZG 11,5Kg Blanca;LINEA BLANCA
8672334;;M;60;CHILENO;;Boomers;QUILPUE                       ;VALPARAISO;0;0;0;0;0;0;0;0;0;Campana Cocina FXU6160 60CM;LINEA BLANCA
13533885;;F;42;CHILENO;;X;ANDACOLLO                     ;COQUIMBO;0;0;0;0;0;0;0;0;0;Cocina MCG-4QI24AME4 4P Inox;LINEA BLANCA
20208345;;F;22;CHILENO;;Z;PROVIDENCIA                   ;METROPOLITANA;0;0;0;0;0;0;0;0;0;SECADORA SR-10 8KG GRIS SINDELEN;LINEA BLANCA
18055674;;F;29;CHILENO;;Millenial;PROVIDENCIA                   ;METROPOLITANA;0;0;0;0;0;0;0;0;0;Secadora Ropa Solare 7100 7K Ventilacion;LINEA BLANCA
19801398;;F;24;CHILENO;;Z;N/D;N/D;0;0;0;0;0;0;0;0;0;Cocina F-2525 4P;LINEA BLANCA
9772825;;M;55;CHILENO;;Boomers;RENCA                         ;METROPOLITANA;0;0;0;0;0;0;0;0;0;Encimera CE2-435I 2P Inox;LINEA BLANCA
9714306;;F;61;CHILENO;;Boomers;VALDIVIA                      ;LOS LAGOS;0;0;0;0;0;0;0;0;0;Lavadora Semiautomatica LC-6550 6,5Kg;LINEA BLANCA
10988286;;M;40;CHILENO;;X;N/D;N/D;0;0;0;0;0;0;0;0;0;Lavadora WA17T6260BW/ZS 17Kg Blanca;LINEA BLANCA
24924629;;M;49;HAITIANO;;Extranjero;EL BOSQUE                     ;METROPOLITANA;0;0;0;0;0;0;0;0;0;Cocina Diva 920 5P;LINEA BLANCA
17044691;;F;33;CHILENO;;Millenial;PROVIDENCIA                   ;METROPOLITANA;0;0;0;0;0;0;0;0;0;Lavadora WA90H4400SW/ZS 9Kg Blanca;LINEA BLANCA
8867712;;M;59;CHILENO;;Boomers;RENCA                         ;METROPOLITANA;0;0;0;0;0;0;0;0;0;Calefon ionizado 13 litros GL;LINEA BLANCA
6821949;Casado;F;70;CHILENO;AUXILIAR DE ENFERMERIA;Silencioso;MARCHIHUE                     ;L.G.B.OÂ´HIGGINS;0;0;0;0;0;0;0;0;0;Cocina Andes60TX4 4P Inox;LINEA BLANCA
6297338;;F;71;CHILENO;;Silencioso;CURICO                        ;MAULE;0;0;0;0;0;0;0;0;0;Lavadora Efficace SZG 17,5Kg Silver;LINEA BLANCA
11598724;;F;53;CHILENO;;X;PROVIDENCIA                   ;METROPOLITANA;0;0;0;0;0;0;0;0;0;Secadora Ropa Solare 7100 7K Ventilacion;LINEA BLANCA
17861290;Soltero;M;30;CHILENO;;Silencioso;PROVIDENCIA                   ;METROPOLITANA;0;0;0;0;0;0;0;0;0;Refrigerador 303Lts BF Frio Directo Nordik 480;LINEA BLANCA
16545070;;M;35;CHILENO;;Millenial;MULCHEN                       ;BIO BIO;0;0;0;0;0;0;0;0;0;Secadora Ropa MSV-90 9K Blanca Ventilacion;LINEA BLANCA
13658430;;F;42;CHILENO;;X;MELIPILLA                     ;METROPOLITANA;0;0;0;0;0;0;0;0;0;Cocina 775X 4P;LINEA BLANCA
10504681;;F;58;CHILENO;;Boomers;TEMUCO                        ;ARAUCANIA;0;0;0;0;0;0;0;0;0;Refrigerador 525Lts Side by Side SFX500;LINEA BLANCA
18857209;Soltero;F;27;CHILENO;;Z;PROVIDENCIA                   ;METROPOLITANA;0;0;0;0;0;0;0;0;0;Lavadora Efficace BZG 9,5Kg Blanca;LINEA BLANCA
11570897;;F;51;CHILENO;;X;TALCAHUANO                    ;BIO BIO;0;0;0;0;0;0;0;0;0;Cocina CH-9050SI 4P;LINEA BLANCA
17951676;Soltero;M;30;CHILENO;;Millenial;PROVIDENCIA                   ;METROPOLITANA;0;0;0;0;0;0;0;0;0;Lavadora MLS-190GC03N 19Kg Gris;LINEA BLANCA
21929010;;F;56;BOLIVIANO;;Extranjero;POZO ALMONTE                  ;TARAPACA;0;0;0;0;0;0;0;0;0;Lavadora WT16DSBP 16Kg Silver;LINEA BLANCA
14371391;;F;50;CHILENO;;X;PROVIDENCIA                   ;METROPOLITANA;0;0;0;0;0;0;0;0;0;Lavadora Efficace SZG 17,5Kg Silver;LINEA BLANCA
15787958;Soltero;M;38;CHILENO;;Silencioso;PROVIDENCIA                   ;METROPOLITANA;0;0;0;0;0;0;0;0;0;Refrigerador 244Lts Frio Directo Progress 3100;LINEA BLANCA
15422771;Soltero;F;40;CHILENO;;Silencioso;PROVIDENCIA                   ;METROPOLITANA;0;0;0;0;0;0;0;0;0;Cocina CH-9950NG-1 6P Negro;LINEA BLANCA
12931165;;F;46;CHILENO;;X;TEMUCO                        ;ARAUCANIA;0;0;0;0;0;0;0;0;0;Secadora Ropa Solare 7100 7K Ventilacion;LINEA BLANCA
9170944;Casado;F;60;CHILENO;;Boomers;PELLUHUE                      ;MAULE;0;0;0;0;0;0;0;0;0;Lavadora MLS-160BSC03T 16Kg Blanca;LINEA BLANCA
16847515;Soltero;F;34;CHILENO;;Millenial;PROVIDENCIA                   ;METROPOLITANA;0;0;0;0;0;0;0;0;0;Lavadora Efficace BZG 15,5Kg Blanca;LINEA BLANCA
12173138;;F;50;CHILENO;;X;CALERA                        ;VALPARAISO;0;0;0;0;0;0;0;0;0;Lavadora Efficace SZG 17,5Kg Silver;LINEA BLANCA
18873280;;M;28;CHILENO;;Silencioso;TEMUCO                        ;ARAUCANIA;0;0;0;0;0;0;0;0;0;Cocina MCG-5QI30AME5 5P Inox;LINEA BLANCA
15576687;;M;38;CHILENO;;Silencioso;PROVIDENCIA                   ;METROPOLITANA;0;0;0;0;0;0;0;0;0;Lavavajillas Computer 9430 Inox 14 cubiertos;LINEA BLANCA
11738426;;M;50;CHILENO;;Silencioso;PROVIDENCIA                   ;METROPOLITANA;0;0;0;0;0;0;0;0;0;Refrigerador 255Lts No Frost RT25FARADS8/ZS;LINEA BLANCA
16954731;Casado;F;33;CHILENO;CONSTRUCTOR CIVIL;Millenial;PROVIDENCIA                   ;METROPOLITANA;0;0;0;0;0;0;0;0;0;Cocina CH-9900SI 6P Silver;LINEA BLANCA
8208038;;M;62;CHILENO;;Boomers;LA PINTANA                    ;METROPOLITANA;0;0;0;0;0;0;0;0;0;Lavadora Secadora WD12N64FR2X/ZS 12/7Kg Silver;LINEA BLANCA
18009805;;F;31;CHILENO;;Millenial;PROVIDENCIA                   ;METROPOLITANA;0;0;0;0;0;0;0;0;0;FRIGOBAR 45 LTS MDRD86FGF02;LINEA BLANCA
16490333;Soltero;F;35;CHILENO;PROFESOR;Millenial;TALCAHUANO                    ;BIO BIO;0;0;0;0;0;0;0;0;0;Refrigerador 290Lts BF No Frost RB30N4020S8;LINEA BLANCA
12405950;;F;49;CHILENO;;X;PROVIDENCIA                   ;METROPOLITANA;0;0;0;0;0;0;0;0;0;Refrigerador RMN222PXLRS0 222LTS No Frost;LINEA BLANCA
8705273;;F;60;CHILENO;;Boomers;ANTOFAGASTA                   ;ANTOFAGASTA;0;0;0;0;0;0;0;0;0;Lavadora Efficace SZG 15,5Kg Silver;LINEA BLANCA
17268319;Soltero;F;32;CHILENO;;Silencioso;PROVIDENCIA                   ;METROPOLITANA;0;0;0;0;0;0;0;0;0;Lavadora Secadora WD10WVC4S6 10,5/6Kg Blanca;LINEA BLANCA
15329956;;F;39;CHILENO;;X;LA PINTANA                    ;METROPOLITANA;0;0;0;0;0;0;0;0;0;Refrigerador 210Lts Rojo Frio Dir MRFS2100R273FN;LINEA BLANCA
17552465;Soltero;M;32;CHILENO;;Silencioso;PROVIDENCIA                   ;METROPOLITANA;0;0;0;0;0;0;0;0;0;Lavadora Secadora WD10WVC4S6 10,5/6Kg Blanca;LINEA BLANCA
15423487;;M;40;CHILENO;;X;RANCAGUA                      ;L.G.B.OÂ´HIGGINS;0;0;0;0;0;0;0;0;0;Lavadora MLS-190GC03N 19Kg Gris;LINEA BLANCA
19730975;;F;25;CHILENO;;Z;CABRERO                       ;BIO BIO;0;0;0;0;0;0;0;0;0;Lavadora Secadora MLSF-1108BN05N 11Kg/8Kg Blanca;LINEA BLANCA
12836058;;F;47;CHILENO;;X;IQUIQUE                       ;TARAPACA;0;0;0;0;0;0;0;0;0;Refrigerador 241Lts BF Frio Directo Nordik 415;LINEA BLANCA
14083109;;F;40;CHILENO;;X;VALDIVIA                      ;LOS RIOS;0;0;0;0;0;0;0;0;0;Cocina 775X 4P;LINEA BLANCA
13804019;;F;48;CHILENO;;X;SANTA BARBARA                 ;BIO BIO;0;0;0;0;0;0;0;0;0;Freezer Vertical MFV-2400S312FW 227Lts;LINEA BLANCA
15695704;;F;38;CHILENO;;Millenial;RENCA                         ;METROPOLITANA;0;0;0;0;0;0;0;0;0;REFRIGERADOR 340 Lts BMF RB34T602FSA/ZS;LINEA BLANCA
19698461;;F;24;CHILENO;;Z;PROVIDENCIA                   ;METROPOLITANA;0;0;0;0;0;0;0;0;0;Cocina CH-9600RJ 4P;LINEA BLANCA
17866320;;F;30;CHILENO;;Millenial;VALLENAR;ATACAMA;0;0;0;0;0;0;0;0;0;Cocina MCG-4QI24AME4 4P Inox;LINEA BLANCA
4059045;;M;77;CHILENO;;Silencioso;RENCA                         ;METROPOLITANA;0;0;0;0;0;0;0;0;0;Lavadora WA80H4200SW/ZS 8Kg Blanca;LINEA BLANCA
15067612;;M;40;CHILENO;;X;PROVIDENCIA                   ;METROPOLITANA;0;0;0;0;0;0;0;0;0;Refrigerador 525Lts Side by Side SFX500;LINEA BLANCA
7088613;;F;70;CHILENO;;Silencioso;PAINE                         ;METROPOLITANA;0;0;0;0;0;0;0;0;0;Calefont 5Lts GL Essenetial ECO;LINEA BLANCA
20061472;;M;23;CHILENO;;Z;PROVIDENCIA                   ;METROPOLITANA;0;0;0;0;0;0;0;0;0;Lavadora WA90H4400SW/ZS 9Kg Blanca;LINEA BLANCA
25527771;;M;30;PERUANO;;Extranjero;N/D;N/D;0;0;0;0;0;0;0;0;0;Cocina PRO425 4P Inox;LINEA BLANCA
12401278;;M;48;CHILENO;;X;PUTAENDO                      ;VALPARAISO;0;0;0;0;0;0;0;0;0;Cocina F-5500 Premium 5P;LINEA BLANCA
20403016;;M;22;CHILENO;;Silencioso;PROVIDENCIA                   ;METROPOLITANA;0;0;0;0;0;0;0;0;0;Freezer Horizontal MFH-1990B258CN 198Lts;LINEA BLANCA
7349797;;M;68;CHILENO;;Silencioso;ALHUE                         ;METROPOLITANA;0;0;0;0;0;0;0;0;0;Lavadora WT19DSBP 19Kg Silver;LINEA BLANCA
16520925;;F;35;CHILENO;;Millenial;N/D;N/D;0;0;0;0;0;0;0;0;0;Lavadora LMA0920WGCL0 9,5Kg Gris;LINEA BLANCA
9510236;;M;57;CHILENO;;Boomers;LA UNION                      ;LOS LAGOS;0;0;0;0;0;0;0;0;0;Cocina Andes76HG0 6P Inox;LINEA BLANCA
19480273;;M;25;CHILENO;;Z;PROVIDENCIA                   ;METROPOLITANA;0;0;0;0;0;0;0;0;0;Lavadora Superior 14.5 Kg Blanca;LINEA BLANCA
13354808;;F;44;CHILENO;;X;N/D;N/D;0;0;0;0;0;0;0;0;0;Secadora Ropa MSV-90 9K Blanca Ventilacion;LINEA BLANCA
11178824;;M;55;CHILENO;;Boomers;N/D;N/D;0;0;0;0;0;0;0;0;0;Secadora Ropa MSV-90 9K Blanca Ventilacion;LINEA BLANCA
17175639;Soltero;F;33;CHILENO;;Silencioso;PROVIDENCIA                   ;METROPOLITANA;0;0;0;0;0;0;0;0;0;Refrigerador 331Lts No Frost BF RB34T632FSA/ZS;LINEA BLANCA
13361232;;M;43;CHILENO;;X;N/D;N/D;0;0;0;0;0;0;0;0;0;Lavadora Superior WW10J6410CW1ZS 10Kg;LINEA BLANCA
12239975;Divorciado;M;50;CHILENO;INGENIERO CIVIL;Millenial;PROVIDENCIA                   ;METROPOLITANA;0;0;0;0;0;0;0;0;0;Cocina CH-7400 4P;LINEA BLANCA
15377067;Soltero;F;40;CHILENO;BIOLOGO;X;PROVIDENCIA                   ;METROPOLITANA;0;0;0;0;0;0;0;0;0;Lavadora MLS-160BSC03T 16Kg Blanca;LINEA BLANCA
18443447;;M;29;CHILENO;;Millenial;PROVIDENCIA                   ;METROPOLITANA;0;0;0;0;0;0;0;0;0;Refrigerador 254Lts No Frost GT29WPPDC;LINEA BLANCA
16703585;;F;35;CHILENO;;Millenial;"";"";0;0;0;0;0;0;0;0;0;Lavadora Efficace BZG 9,5Kg Blanca;LINEA BLANCA
11900469;;M;50;CHILENO;;X;PROVIDENCIA                   ;METROPOLITANA;0;0;0;0;0;0;0;0;0;Cocina 795XF 4P;LINEA BLANCA
18651109;;M;27;CHILENO;;Z;MAIPU                         ;METROPOLITANA;0;0;0;0;0;0;0;0;0;Secadora Ropa Solare 7100 7K Ventilacion;LINEA BLANCA
6761143;;F;71;CHILENO;;Silencioso;PROVIDENCIA                   ;METROPOLITANA;0;0;0;0;0;0;0;0;0;Refrigerador RT25FARADSP/ZS 260Lts No Frost;LINEA BLANCA
13237461;;F;45;CHILENO;;X;LICANTEN                      ;MAULE;0;0;0;0;0;0;0;0;0;Refrigerador 527Lts Side by Side MRSBS5300G689WE;LINEA BLANCA
13001535;Casado;M;46;CHILENO;;X;PROVIDENCIA                   ;METROPOLITANA;0;0;0;0;0;0;0;0;0;FREEZER SFH-300 300 LTS BLANCO SINDELEN;LINEA BLANCA
5623069;;F;75;CHILENO;;Silencioso;OSORNO                        ;LOS LAGOS;0;0;0;0;0;0;0;0;0;Cocina 775X 4P;LINEA BLANCA
12470781;;M;48;CHILENO;;X;RENCA                         ;METROPOLITANA;0;0;0;0;0;0;0;0;0;Refrigerador RT22FARADSP/ZS 236Lts No Frost;LINEA BLANCA
6424947;;M;69;CHILENO;;Millenial;PROVIDENCIA                   ;METROPOLITANA;0;0;0;0;0;0;0;0;0;Refrigerador 244Lts Frio Directo Progress 3100;LINEA BLANCA
17594147;;M;34;CHILENO;;Silencioso;PROVIDENCIA                   ;METROPOLITANA;0;0;0;0;0;0;0;0;0;Lavadora Efficace BZG 15,5Kg Blanca;LINEA BLANCA
17969992;;F;30;CHILENO;;Millenial;CORONEL                       ;BIO BIO;0;0;0;0;0;0;0;0;0;Secadora 8 Kg Blanca WKR-08K1W3;LINEA BLANCA
14446111;;M;48;CHILENO;;X;PROVIDENCIA                   ;METROPOLITANA;0;0;0;0;0;0;0;0;0;ENCIMERA BREIT PRO 90 GL 5P ALBIN TROTTER;LINEA BLANCA
17723574;;F;31;CHILENO;;Silencioso;PROVIDENCIA                   ;METROPOLITANA;0;0;0;0;0;0;0;0;0;Lavadora WA90H4400SW/ZS 9Kg Blanca;LINEA BLANCA
19979628;;F;23;CHILENO;;Z;PROVIDENCIA                   ;METROPOLITANA;0;0;0;0;0;0;0;0;0;Cocina 755 S 4P;LINEA BLANCA
6637213;;M;67;CHILENO;;Boomers;QUILPUE                       ;VALPARAISO;0;0;0;0;0;0;0;0;0;Refrigerador 244Lts Frio Directo Progress 3100;LINEA BLANCA
16532945;;F;34;CHILENO;;Millenial;RANCAGUA                      ;L.G.B.OÂ´HIGGINS;0;0;0;0;0;0;0;0;0;HORNO EMPOTRABLE 2250W 57LTS HE-7220R NEGRO;LINEA BLANCA
16572443;;F;34;CHILENO;;Millenial;LIMACHE                       ;VALPARAISO;0;0;0;0;0;0;0;0;0;Cocina CH-9900SI 6P Silver;LINEA BLANCA
13051055;;M;46;CHILENO;;X;LA PINTANA                    ;METROPOLITANA;0;0;0;0;0;0;0;0;0;Lavadora Secadora Perfect Care 8Kg/5Kg Blanca;LINEA BLANCA
7446971;;F;64;CHILENO;;Boomers;NATALES                       ;MAGALLANES;0;0;0;0;0;0;0;0;0;Refrigerador 244Lts Frio Directo Progress 3100;LINEA BLANCA
19858627;;F;24;CHILENO;;Silencioso;PROVIDENCIA                   ;METROPOLITANA;0;0;0;0;0;0;0;0;0;Lavadora Efficace BZG 15,5Kg Blanca;LINEA BLANCA
15956694;;F;37;CHILENO;;Silencioso;PROVIDENCIA                   ;METROPOLITANA;0;0;0;0;0;0;0;0;0;Refrigerador Altus 1200V 197Lts No Frost;LINEA BLANCA
7621368;;F;63;CHILENO;;Boomers;N/D;N/D;0;0;0;0;0;0;0;0;0;Refrigerador LRT-200DFI 168Lts Frio Directo;LINEA BLANCA
19385133;Soltero;M;25;CHILENO;TECNICO DE NIVEL MEDIO EN ALIMENTACION;Silencioso;PROVIDENCIA                   ;METROPOLITANA;0;0;0;0;0;0;0;0;0;Secadora Ropa Solare 9100 9K Ventilacion;LINEA BLANCA
18681419;Soltero;M;28;CHILENO;;Silencioso;PROVIDENCIA                   ;METROPOLITANA;0;0;0;0;0;0;0;0;0;Refrigerador LRT-200DFI 168Lts Frio Directo;LINEA BLANCA
18373926;;F;29;CHILENO;;Millenial;COLTAUCO                      ;L.G.B.OÂ´HIGGINS;0;0;0;0;0;0;0;0;0;Refrigerador 251Lts No Frost Altus 1250;LINEA BLANCA
9148494;Soltero;F;57;CHILENO;;Boomers;LA PINTANA                    ;METROPOLITANA;0;0;0;0;0;0;0;0;0;Refrigerador 468Lts Side by Side MRTT-4790S312FW;LINEA BLANCA
17531542;;M;32;CHILENO;;Millenial;SANTIAGO                      ;METROPOLITANA;0;0;0;0;0;0;0;0;0;Secadora Ropa MSV-90 9K Blanca Ventilacion;LINEA BLANCA
7769744;;F;64;CHILENO;;Boomers;ERCILLA                       ;ARAUCANIA;0;0;0;0;0;0;0;0;0;Refrigerador 254Lts No Frost GT29WPPDC;LINEA BLANCA
11282862;;F;54;CHILENO;;X;PROVIDENCIA                   ;METROPOLITANA;0;0;0;0;0;0;0;0;0;Lavadora Efficace SZG 15,5Kg Silver;LINEA BLANCA
16807688;;F;34;CHILENO;;Millenial;SAN PEDRO DE LA PAZ           ;BIO BIO;0;0;0;0;0;0;0;0;0;Lavadora Efficace SZG 17,5Kg Blanca;LINEA BLANCA
7483958;Viudo;F;70;CHILENO;;Silencioso;COPIAPO                       ;ATACAMA;0;0;0;0;0;0;0;0;0;Refrigerador 260Lts BF Frio Direc MRFI2660SR346W;LINEA BLANCA
16113031;;F;36;CHILENO;;Millenial;OSORNO                        ;LOS LAGOS;0;0;0;0;0;0;0;0;0;Cocina CH-9900SI 6P Silver;LINEA BLANCA
17591350;;F;32;CHILENO;;Silencioso;PROVIDENCIA                   ;METROPOLITANA;0;0;0;0;0;0;0;0;0;Cocina CH-9600RJ 4P;LINEA BLANCA
11304745;Casado;M;55;CHILENO;AGROINDUSTRIA;Boomers;VILLARICA                     ;ARAUCANIA;0;0;0;0;0;0;0;0;0;Cocina Andes60TX4 4P Inox;LINEA BLANCA
25707421;;M;31;COLOMBIANO;;Extranjero;N/D;N/D;0;0;0;0;0;0;0;0;0;Refrigerador 260Lts BF Frio Direc MRFI2660SR346W;LINEA BLANCA
19176147;Casado;M;25;CHILENO;;Z;PROVIDENCIA                   ;METROPOLITANA;0;0;0;0;0;0;0;0;0;Freezer Horizontal FFH Z300 291Lts;LINEA BLANCA
11929802;;M;49;CHILENO;;X;CASTRO                        ;LOS LAGOS;0;0;0;0;0;0;0;0;0;Refrigerador 400Lts No Frost RMP400FHUG;LINEA BLANCA
5389884;;F;78;CHILENO;;Silencioso;LLANQUIHUE                    ;LOS LAGOS;0;0;0;0;0;0;0;0;0;Lavadora Efficace SZG 17,5Kg Silver;LINEA BLANCA
10158810;;F;58;CHILENO;;Boomers;ANTOFAGASTA                   ;ANTOFAGASTA;0;0;0;0;0;0;0;0;0;Cocina CH-7400 4P;LINEA BLANCA
16209490;;M;36;CHILENO;;Silencioso;PROVIDENCIA                   ;METROPOLITANA;0;0;0;0;0;0;0;0;0;Refrigerador MRFI2740G332RW BF 255Lts Frio Direc;LINEA BLANCA
19797726;;F;24;CHILENO;;Silencioso;PROVIDENCIA                   ;METROPOLITANA;0;0;0;0;0;0;0;0;0;CONGELADOR LFH-300 TAPA DURA 300L;LINEA BLANCA
18929893;Soltero;F;28;CHILENO;PROFESOR;Millenial;PROVIDENCIA                   ;METROPOLITANA;0;0;0;0;0;0;0;0;0;Freezer 80Lts LFV-100I Vertical Inox;LINEA BLANCA
15105727;;F;37;CHILENO;;Silencioso;PROVIDENCIA                   ;METROPOLITANA;0;0;0;0;0;0;0;0;0;Lavadora WT19DSBP 19Kg Silver;LINEA BLANCA
17726593;;F;31;CHILENO;;Silencioso;PROVIDENCIA                   ;METROPOLITANA;0;0;0;0;0;0;0;0;0;Refrigerador Altus 1200V 197Lts No Frost;LINEA BLANCA
8356115;;F;58;CHILENO;;Boomers;NATALES                       ;MAGALLANES;0;0;0;0;0;0;0;0;0;Cocina Andes76HG0 6P Inox;LINEA BLANCA
12871909;Casado;F;46;CHILENO;PSICOLOGO;Silencioso;PROVIDENCIA                   ;METROPOLITANA;0;0;0;0;0;0;0;0;0;Campana Cocina CA-610EBL 60Cms Blanca;LINEA BLANCA
19027910;;M;27;CHILENO;;Z;PROVIDENCIA                   ;METROPOLITANA;0;0;0;0;0;0;0;0;0;Lavadora superior MLS-110GE04N 11Kg;LINEA BLANCA
14510818;;F;47;CHILENO;;X;SAN FERNANDO                  ;L.G.B.OÂ´HIGGINS;0;0;0;0;0;0;0;0;0;Cocina Andes76HG0 6P Inox;LINEA BLANCA
9313005;;F;58;CHILENO;;Boomers;SANTIAGO                      ;METROPOLITANA;0;0;0;0;0;0;0;0;0;Freezer Horizontal M100 99Lts;LINEA BLANCA
9854721;;M;54;CHILENO;;Millenial;PROVIDENCIA                   ;METROPOLITANA;0;0;0;0;0;0;0;0;0;Refrigerador 252Lts No Frost MRFS-2700G333FW;LINEA BLANCA
15282824;;F;37;CHILENO;;Millenial;PROVIDENCIA                   ;METROPOLITANA;0;0;0;0;0;0;0;0;0;Lavadora Efficace SZG 19,5Kg Silver;LINEA BLANCA
17113758;Casado;M;33;CHILENO;;Millenial;PROVIDENCIA                   ;METROPOLITANA;0;0;0;0;0;0;0;0;0;Cocina F-2808 4P;LINEA BLANCA
10371485;Viudo;M;56;CHILENO;;X;PROVIDENCIA                   ;METROPOLITANA;0;0;0;0;0;0;0;0;0;Cocina CH-7400 4P;LINEA BLANCA
12183442;;F;49;CHILENO;;X;TALCA                         ;MAULE;0;0;0;0;0;0;0;0;0;Refrigerador 244Lts Frio Directo Progress 3100;LINEA BLANCA
9093685;Casado;F;45;CHILENO;PERIODISTA;Silencioso;PROVIDENCIA                   ;METROPOLITANA;0;0;0;0;0;0;0;0;0;Lavadora WA80H4200SW/ZS 8Kg Blanca;LINEA BLANCA
18655532;Soltero;M;28;CHILENO;INGENIERO INFORMATICO;Silencioso;PROVIDENCIA                   ;METROPOLITANA;0;0;0;0;0;0;0;0;0;Lavadora LMA6120WGCL0 16Kg Gris;LINEA BLANCA
11109727;;F;54;CHILENO;;Boomers;LONGAVI                       ;MAULE;0;0;0;0;0;0;0;0;0;Refrigerador 525Lts Side by Side SFX500;LINEA BLANCA
12314431;;M;49;CHILENO;;X;RENCA                         ;METROPOLITANA;0;0;0;0;0;0;0;0;0;Cocina F-2808 4P;LINEA BLANCA
7134623;Casado;M;67;CHILENO;;Boomers;SAN FELIPE                    ;VALPARAISO;0;0;0;0;0;0;0;0;0;Refrigerador RB31K3210S9/ZS 311 LTRS No Frost;LINEA BLANCA
17664278;;F;31;CHILENO;;Millenial;SAN BERNARDO                  ;METROPOLITANA;0;0;0;0;0;0;0;0;0;Refrigerador 244Lts Frio Directo Progress 3100;LINEA BLANCA
6753071;;F;76;CHILENO;;Silencioso;RENCA                         ;METROPOLITANA;0;0;0;0;0;0;0;0;0;Campana Cocina CA-650PS 60Cms Inox;LINEA BLANCA
7482944;;F;67;CHILENO;;Boomers;NATALES                       ;MAGALLANES;0;0;0;0;0;0;0;0;0;Refrigerador 254Lts No Frost GT29WPPDC;LINEA BLANCA
10913895;;M;44;CHILENO;;X;N/D;N/D;0;0;0;0;0;0;0;0;0;Refrigerador 244Lts Frio Directo Progress 3100;LINEA BLANCA
18326902;;F;29;CHILENO;;Millenial;"";"";0;0;0;0;0;0;0;0;0;SECADORA SR-10 8KG GRIS SINDELEN;LINEA BLANCA
13146162;;F;45;CHILENO;;X;NACIMIENTO                    ;BIO BIO;0;0;0;0;0;0;0;0;0;Refrigerador 260Lts BF Frio Direc MRFI2660SR346W;LINEA BLANCA
13206308;;M;44;CHILENO;;X;RENCA                         ;METROPOLITANA;0;0;0;0;0;0;0;0;0;Calefon 7Lts GL Master;LINEA BLANCA
13223277;;M;45;CHILENO;;X;RENCA                         ;METROPOLITANA;0;0;0;0;0;0;0;0;0;Refrigerador LB37MPGK 341Lts No Frost;LINEA BLANCA
17805948;;M;31;CHILENO;;Silencioso;PROVIDENCIA                   ;METROPOLITANA;0;0;0;0;0;0;0;0;0;SECADORA SR-10 8KG GRIS SINDELEN;LINEA BLANCA
4160723;;M;84;CHILENO;;Silencioso;PROVIDENCIA                   ;METROPOLITANA;0;0;0;0;0;0;0;0;0;Secadora Ropa MSV-90 9K Blanca Ventilacion;LINEA BLANCA
13868568;Soltero;F;42;CHILENO;INGENIERO COMERCIAL;X;N/D;N/D;0;0;0;0;0;0;0;0;0;Freezer Horizontal M 150 142Lts;LINEA BLANCA
10650823;;F;57;CHILENO;;Boomers;BUIN                          ;METROPOLITANA;0;0;0;0;0;0;0;0;0;Cocina CH-9950NG-1 6P Negro;LINEA BLANCA
10294563;;M;57;CHILENO;;Boomers;CALAMA                        ;ANTOFAGASTA;0;0;0;0;0;0;0;0;0;Lavadora LMA0920WGCL0 9,5Kg Gris;LINEA BLANCA
13694510;;F;43;CHILENO;;X;PUENTE ALTO                   ;METROPOLITANA;0;0;0;0;0;0;0;0;0;Calefont Essential 11 ECO GL;LINEA BLANCA
12814534;Casado;M;47;CHILENO;;X;PROVIDENCIA                   ;METROPOLITANA;0;0;0;0;0;0;0;0;0;Lavadora WA13T5260BW/ZS 13Kg Blanca;LINEA BLANCA
12672256;;F;49;CHILENO;;X;PUENTE ALTO                   ;METROPOLITANA;0;0;0;0;0;0;0;0;0;Lavadora Semiautomatica Twister 5100 4Kg;LINEA BLANCA
15085375;;M;39;CHILENO;;X;OLMUE                         ;VALPARAISO;0;0;0;0;0;0;0;0;0;Cocina MV 220 4P;LINEA BLANCA
7132921;;F;66;CHILENO;;Boomers;PROVIDENCIA                   ;METROPOLITANA;0;0;0;0;0;0;0;0;0;Lavadora WA90H4400SW/ZS 9Kg Blanca;LINEA BLANCA
16070024;;F;37;CHILENO;;Millenial;N/D;N/D;0;0;0;0;0;0;0;0;0;Centrifuga Primma 5B 5,5Kilos;LINEA BLANCA
10737675;Casado;F;53;CHILENO;;Silencioso;PROVIDENCIA                   ;METROPOLITANA;0;0;0;0;0;0;0;0;0;Lavadora WA13T5260BW/ZS 13Kg Blanca;LINEA BLANCA
14016186;Casado;F;41;CHILENO;;X;TALCA                         ;MAULE;0;0;0;0;0;0;0;0;0;Refrigerador 260Lts BF Frio Direc MRFI2660SR346W;LINEA BLANCA
13981118;;M;40;CHILENO;;X;"";"";0;0;0;0;0;0;0;0;0;Freezer Horizontal M 150 142Lts;LINEA BLANCA
15499613;;M;39;CHILENO;;X;PUENTE ALTO                   ;METROPOLITANA;0;0;0;0;0;0;0;0;0;Cocina CMC20AXX 4P Inox;LINEA BLANCA
11170398;;M;54;CHILENO;;Boomers;MELIPILLA                     ;METROPOLITANA;0;0;0;0;0;0;0;0;0;Refrigerador RMN222PXLRS0 222LTS No Frost;LINEA BLANCA
11663219;;F;52;CHILENO;;X;RENCA                         ;METROPOLITANA;0;0;0;0;0;0;0;0;0;Lavadora WA80H4200SW/ZS 8Kg Blanca;LINEA BLANCA
15506561;;M;39;CHILENO;;Silencioso;PROVIDENCIA                   ;METROPOLITANA;0;0;0;0;0;0;0;0;0;ENCIMERA A GAS 4 PLATOS CEG-4600 INOX;LINEA BLANCA
5768096;;F;76;CHILENO;;Silencioso;TALAGANTE                     ;METROPOLITANA;0;0;0;0;0;0;0;0;0;Refrigerador RB31K3210S9/ZS 311 LTRS No Frost;LINEA BLANCA
18594948;;F;28;CHILENO;;Millenial;TALCA                         ;MAULE;0;0;0;0;0;0;0;0;0;SECADORA ROPA TH-D9KC 9KG BLANCA THOMAS;LINEA BLANCA
18680373;;F;28;CHILENO;;Millenial;LOS ANDES                     ;VALPARAISO;0;0;0;0;0;0;0;0;0;Lavadora WA17T6260BW/ZS 17Kg Blanca;LINEA BLANCA
18387604;;F;29;CHILENO;;Millenial;"";"";0;0;0;0;0;0;0;0;0;COCINA CH-5700SI 4P;LINEA BLANCA
11177931;;F;55;CHILENO;;Boomers;CHILLAN                       ;BIO BIO;0;0;0;0;0;0;0;0;0;Refrigerador Altus 1350W 342Lts No Frost;LINEA BLANCA
7368802;;F;68;CHILENO;;Boomers;PUENTE ALTO                   ;METROPOLITANA;0;0;0;0;0;0;0;0;0;Freezer Horizontal M 150 142Lts;LINEA BLANCA
10683997;;F;56;CHILENO;;Boomers;PUENTE ALTO                   ;METROPOLITANA;0;0;0;0;0;0;0;0;0;Cocina F-5500 Premium 5P;LINEA BLANCA
16839563;;F;34;CHILENO;;Millenial;MAIPU                         ;METROPOLITANA;0;0;0;0;0;0;0;0;0;Refrigerador RMN222PXLRS0 222LTS No Frost;LINEA BLANCA
12839915;;F;46;CHILENO;;X;PROVIDENCIA                   ;METROPOLITANA;0;0;0;0;0;0;0;0;0;Cocina 755 S 4P;LINEA BLANCA
14175480;;F;41;CHILENO;;X;CHILLAN                       ;BIO BIO;0;0;0;0;0;0;0;0;0;Cocina 775X 4P;LINEA BLANCA
12459240;;F;49;CHILENO;;X;LA CISTERNA                   ;METROPOLITANA;0;0;0;0;0;0;0;0;0;Lavadora Efficace SZG 17,5Kg Silver;LINEA BLANCA
6830000;;F;73;CHILENO;;Silencioso;LA CRUZ                       ;VALPARAISO;0;0;0;0;0;0;0;0;0;Lavadora WA90H4400SW/ZS 9Kg Blanca;LINEA BLANCA
18433545;Soltero;F;29;CHILENO;ENFERMERA;Millenial;PROVIDENCIA                   ;METROPOLITANA;0;0;0;0;0;0;0;0;0;Refrigerador 249Lts No Frost RMA250PHUG;LINEA BLANCA
14453780;;F;48;CHILENO;;X;ARICA                         ;TARAPACA;0;0;0;0;0;0;0;0;0;Lavadora superior MLS-110GE04N 11Kg;LINEA BLANCA
9372964;;M;59;CHILENO;;Boomers;RENCA                         ;METROPOLITANA;0;0;0;0;0;0;0;0;0;Lavadora MLS-090GE04N 9Kg Gris;LINEA BLANCA
25253171;;F;32;PERUANO;;Extranjero;QUINTA NORMAL                 ;METROPOLITANA;0;0;0;0;0;0;0;0;0;Cocina MV 220 4P;LINEA BLANCA
14710157;;F;50;BOLIVIANO;;X;CALAMA                        ;ANTOFAGASTA;0;0;0;0;0;0;0;0;0;Refrigerador 251Lts No Frost Altus 1250;LINEA BLANCA
18581621;;M;28;CHILENO;;Millenial;NUEVA IMPERIAL                ;ARAUCANIA;0;0;0;0;0;0;0;0;0;Lavadora WA15T5260BW/ZS 15Kg Blanca;LINEA BLANCA
15662575;;F;39;CHILENO;;X;PROVIDENCIA                   ;METROPOLITANA;0;0;0;0;0;0;0;0;0;Refrigerador RT25FARADSP/ZS 260Lts No Frost;LINEA BLANCA
19834920;;F;24;CHILENO;;Z;TALCAHUANO                    ;BIO BIO;0;0;0;0;0;0;0;0;0;Cocina F-5500 Premium 5P;LINEA BLANCA
7541973;;F;70;CHILENO;;Silencioso;LA CISTERNA                   ;METROPOLITANA;0;0;0;0;0;0;0;0;0;Freezer 99Lts MFH-1000B131CN Horizontal;LINEA BLANCA
17252297;Casado;M;32;CHILENO;INGENIERO MECANICO;Millenial;PROVIDENCIA                   ;METROPOLITANA;0;0;0;0;0;0;0;0;0;ENCIMERA A GAS 4 PLATOS CEG-4650 INOX;LINEA BLANCA
17507873;Soltero;M;31;CHILENO;KINESIOLOGO;Millenial;PROVIDENCIA                   ;METROPOLITANA;0;0;0;0;0;0;0;0;0;Lavadora superior MLS-110GE04N 11Kg;LINEA BLANCA
6564791;;M;72;CHILENO;;Silencioso;PUENTE ALTO                   ;METROPOLITANA;0;0;0;0;0;0;0;0;0;Cocina Diva 920 5P;LINEA BLANCA
8713255;;F;46;CHILENO;;X;RENCA                         ;METROPOLITANA;0;0;0;0;0;0;0;0;0;Refrigerador 251Lts No Frost Altus 1250;LINEA BLANCA
20245182;;F;22;CHILENO;;Millenial;"";"";0;0;0;0;0;0;0;0;0;Freezer Horizontal M100 99Lts;LINEA BLANCA
12900619;;F;46;CHILENO;;X;PROVIDENCIA                   ;METROPOLITANA;0;0;0;0;0;0;0;0;0;Freezer FDHM150BY1 150Lts Horizontal;LINEA BLANCA
5324841;Casado;M;74;CHILENO;;Silencioso;RENCA                         ;METROPOLITANA;0;0;0;0;0;0;0;0;0;Cocina CMC20AXX 4P Inox;LINEA BLANCA
14114503;;M;41;CHILENO;;X;COPIAPO                       ;ATACAMA;0;0;0;0;0;0;0;0;0;Cocina Nova CH9850NG 6P;LINEA BLANCA
8539560;;F;65;CHILENO;;Boomers;PROVIDENCIA                   ;METROPOLITANA;0;0;0;0;0;0;0;0;0;Cocina CH-9400 4P SILVER;LINEA BLANCA
5550589;;F;80;CHILENO;;Silencioso;IQUIQUE                       ;TARAPACA;0;0;0;0;0;0;0;0;0;Lavadora MLS-140GSC03T 14Kg Gris;LINEA BLANCA
16553544;;M;35;CHILENO;;Millenial;RENCA                         ;METROPOLITANA;0;0;0;0;0;0;0;0;0;FRIGOBAR 93 LTS MFB-930S121LN;LINEA BLANCA
11457188;;M;52;CHILENO;;X;CONSTITUCION                  ;MAULE;0;0;0;0;0;0;0;0;0;Cocina CH-7400 4P;LINEA BLANCA
16527527;;M;35;CHILENO;;Millenial;PROVIDENCIA                   ;METROPOLITANA;0;0;0;0;0;0;0;0;0;Freezer 99Lts MFH-1000B131CN Horizontal;LINEA BLANCA
8168134;;F;64;CHILENO;;Boomers;TEODORO SCHMIDT               ;ARAUCANIA;0;0;0;0;0;0;0;0;0;Cocina Andes60TX4 4P Inox;LINEA BLANCA
10423200;;F;55;CHILENO;;Boomers;RENCA                         ;METROPOLITANA;0;0;0;0;0;0;0;0;0;Cocina 775X 4P;LINEA BLANCA
10002284;Casado;M;75;CHILENO;;Silencioso;PROVIDENCIA                   ;METROPOLITANA;0;0;0;0;0;0;0;0;0;Lavadora WA90H4400SW/ZS 9Kg Blanca;LINEA BLANCA
15155363;;F;40;CHILENO;;X;PROVIDENCIA                   ;METROPOLITANA;0;0;0;0;0;0;0;0;0;Lavadora Efficace BZG 9,5Kg Blanca;LINEA BLANCA
26034765;;M;45;VENEZOLANO;;Extranjero;"";"";0;0;0;0;0;0;0;0;0;Refrigerador 241Lts BF Frio Directo Nordik 415;LINEA BLANCA
8266984;;F;61;CHILENO;;Boomers;SANTO DOMINGO                 ;VALPARAISO;0;0;0;0;0;0;0;0;0;Lavadora Efficace SZG 15,5Kg Silver;LINEA BLANCA
9912812;;F;58;CHILENO;;Boomers;RENCA                         ;METROPOLITANA;0;0;0;0;0;0;0;0;0;Lavadora WA90H4400SW/ZS 9Kg Blanca;LINEA BLANCA
19300269;;F;25;CHILENO;;Z;CURICO                        ;MAULE;0;0;0;0;0;0;0;0;0;Encimera CE2-435I 2P Inox;LINEA BLANCA
10766747;;F;56;CHILENO;;Boomers;RENCA                         ;METROPOLITANA;0;0;0;0;0;0;0;0;0;Refrigerador RT25FARADSP/ZS 260Lts No Frost;LINEA BLANCA
18106564;;M;30;CHILENO;;Millenial;CONCEPCION                    ;BIO BIO;0;0;0;0;0;0;0;0;0;Refrigerador 241Lts BF Frio Directo Nordik 415;LINEA BLANCA
14048151;;F;41;CHILENO;;X;PROVIDENCIA                   ;METROPOLITANA;0;0;0;0;0;0;0;0;0;Refrigerador 252Lts No Frost MRFS-2700G333FW;LINEA BLANCA
7800628;;F;66;CHILENO;;Boomers;YERBAS BUENAS                 ;MAULE;0;0;0;0;0;0;0;0;0;Lavadora Efficace BZG 9,5Kg Blanca;LINEA BLANCA
7948152;;M;65;CHILENO;;Boomers;VINA DEL MAR                  ;VALPARAISO;0;0;0;0;0;0;0;0;0;Freezer 142Lts MFH-1430B186C Horizontal;LINEA BLANCA
11745367;;M;50;CHILENO;;X;RENCA                         ;METROPOLITANA;0;0;0;0;0;0;0;0;0;Lavadora WA80H4200SW/ZS 8Kg Blanca;LINEA BLANCA
10961565;;M;52;CHILENO;;X;CHANARAL                      ;ATACAMA;0;0;0;0;0;0;0;0;0;Cocina CMC5515GCH-1 4P;LINEA BLANCA
18317854;Casado;F;29;CHILENO;;Millenial;PROVIDENCIA                   ;METROPOLITANA;0;0;0;0;0;0;0;0;0;ENCIMERA CE4-600 INOX 4P SINDELEN;LINEA BLANCA
24403807;;M;31;PERUANO;;Extranjero;IQUIQUE                       ;TARAPACA;0;0;0;0;0;0;0;0;0;Refrigerador 626Lt Side by Side GS65MPP1 APZPECL;LINEA BLANCA
26035362;;M;48;EXTRANJERO - NO INFORMA NACIONALIDAD;;Extranjero;N/D;N/D;0;0;0;0;0;0;0;0;0;Cocina Andes60TX4 4P Inox;LINEA BLANCA
10274175;;F;56;CHILENO;;Boomers;RENCA                         ;METROPOLITANA;0;0;0;0;0;0;0;0;0;Cocina F-2808 4P;LINEA BLANCA
13275992;;M;45;CHILENO;;X;ISLA DE MAIPO                 ;METROPOLITANA;0;0;0;0;0;0;0;0;0;Refrigerador MBF60X 322Lts BF No Frost;LINEA BLANCA
19135297;Soltero;F;26;CHILENO;;Z;PROVIDENCIA                   ;METROPOLITANA;0;0;0;0;0;0;0;0;0;Lavadora WA90H4400SW/ZS 9Kg Blanca;LINEA BLANCA
11556347;Soltero;F;51;CHILENO;;X;RENCA                         ;METROPOLITANA;0;0;0;0;0;0;0;0;0;Lavadora Semiautomatica Twister 5300 4Kg;LINEA BLANCA
11775886;;M;50;CHILENO;;X;RENCA                         ;METROPOLITANA;0;0;0;0;0;0;0;0;0;Lavadora Efficace BZG 9,5Kg Blanca;LINEA BLANCA
17732421;Casado;F;31;CHILENO;;Millenial;PROVIDENCIA                   ;METROPOLITANA;0;0;0;0;0;0;0;0;0;Cocina CH-9050SI 4P;LINEA BLANCA
6796742;Viudo;F;73;CHILENO;;Silencioso;PAINE                         ;METROPOLITANA;0;0;0;0;0;0;0;0;0;Refrigerador 241Lts BF Frio Directo Nordik 415;LINEA BLANCA
9719376;Casado;M;55;CHILENO;INGENIERO;Boomers;CONSTITUCION                  ;MAULE;0;0;0;0;0;0;0;0;0;Refrigerador 252Lts No Frost MRFS-2700G333FW;LINEA BLANCA
8505179;Divorciado;M;63;CHILENO;;Boomers;PROVIDENCIA                   ;METROPOLITANA;0;0;0;0;0;0;0;0;0;Refrigerador 244Lts Frio Directo Progress 3100;LINEA BLANCA
7396878;Casado;M;65;CHILENO;;Boomers;COINCO                        ;L.G.B.OÂ´HIGGINS;0;0;0;0;0;0;0;0;0;Lavadora Brilliant SG 11,5Kg Silver;LINEA BLANCA
8935757;;M;62;CHILENO;;Boomers;PROVIDENCIA                   ;METROPOLITANA;0;0;0;0;0;0;0;0;0;Lavadora Semiautomatica Twister 5300 4Kg;LINEA BLANCA
7204481;Soltero;F;72;CHILENO;;Silencioso;LITUECHE                      ;L.G.B.OÂ´HIGGINS;0;0;0;0;0;0;0;0;0;Freezer 142Lts EFC14A5MNW Horizontal;LINEA BLANCA
10574154;;F;52;CHILENO;;X;BUIN                          ;METROPOLITANA;0;0;0;0;0;0;0;0;0;Cocina MV 110 4 Platos;LINEA BLANCA
13385028;;M;44;CHILENO;;X;RENCA                         ;METROPOLITANA;0;0;0;0;0;0;0;0;0;ENCIMERA MCE 435E MADEMSA;LINEA BLANCA
7831453;;F;63;CHILENO;;Boomers;CALAMA                        ;ANTOFAGASTA;0;0;0;0;0;0;0;0;0;Refrigerador 244Lts Frio Directo Progress 3100;LINEA BLANCA
7218957;;M;68;CHILENO;;Silencioso;SAN BERNARDO                  ;METROPOLITANA;0;0;0;0;0;0;0;0;0;Refrigerador RT25FARADSP/ZS 260Lts No Frost;LINEA BLANCA
16535571;;M;35;CHILENO;;Millenial;SAN CARLOS                    ;BIO BIO;0;0;0;0;0;0;0;0;0;Lavadora Efficace SZG 17,5Kg Silver;LINEA BLANCA
13933216;Casado;M;41;CHILENO;INGENIERO EN TELECOMUNICACIONES;X;PROVIDENCIA                   ;METROPOLITANA;0;0;0;0;0;0;0;0;0;Freezer Horizontal M100 99Lts;LINEA BLANCA
6884735;;M;70;CHILENO;;Silencioso;CAUQUENES                     ;MAULE;0;0;0;0;0;0;0;0;0;Refrigerador 244Lts Frio Directo Progress 3100;LINEA BLANCA
25538988;;F;27;VENEZOLANO;;Extranjero;LAS CONDES                    ;METROPOLITANA;0;0;0;0;0;0;0;0;0;Lavadora WA90H4400SW/ZS 9Kg Blanca;LINEA BLANCA
8498858;;M;64;CHILENO;;Boomers;PROVIDENCIA                   ;METROPOLITANA;0;0;0;0;0;0;0;0;0;Lavadora Efficace SZG 15,5Kg Silver;LINEA BLANCA
8998030;Casado;F;61;CHILENO;;Boomers;CERRO NAVIA                   ;METROPOLITANA;0;0;0;0;0;0;0;0;0;Lavadora Semiautomatica Twister 5300 4Kg;LINEA BLANCA
5992350;;F;70;CHILENO;;Silencioso;ARAUCO                        ;BIO BIO;0;0;0;0;0;0;0;0;0;Freezer FDHM150BY1 150Lts Horizontal;LINEA BLANCA
16728602;;F;35;CHILENO;;Millenial;PROVIDENCIA                   ;METROPOLITANA;0;0;0;0;0;0;0;0;0;Refrigerador 303Lts BF Frio Directo Nordik 480;LINEA BLANCA
19521974;Soltero;M;25;CHILENO;;Millenial;LA FLORIDA;METROPOLITANA;0;0;0;0;0;0;0;0;0;Lavadora WA80H4200SW/ZS 8Kg Blanca;LINEA BLANCA
11255188;;F;54;CHILENO;;X;RECOLETA                      ;METROPOLITANA;0;0;0;0;0;0;0;0;0;Refrigerador 527Lts Side by Side MRSBS5300G689WE;LINEA BLANCA
8707501;;M;58;CHILENO;;Boomers;RETIRO                        ;MAULE;0;0;0;0;0;0;0;0;0;Refrigerador 249Lts No Frost RMA250PHUG;LINEA BLANCA
7332250;;F;78;CHILENO;;Silencioso;RENCA                         ;METROPOLITANA;0;0;0;0;0;0;0;0;0;Cocina CMC20AXX 4P Inox;LINEA BLANCA
7152309;;F;71;CHILENO;;Silencioso;CHONCHI                       ;LOS LAGOS;0;0;0;0;0;0;0;0;0;Calefon 7Lts GL Master;LINEA BLANCA
14447978;;F;48;CHILENO;;X;NACIMIENTO                    ;BIO BIO;0;0;0;0;0;0;0;0;0;Refrigerador 252Lts No Frost MRFS-2700G333FW;LINEA BLANCA
19157357;;M;21;CHILENO;;Z;PENCO;BIO-BIO;0;0;0;0;0;0;0;0;0;ENCIMERA CE4-600 INOX 4P SINDELEN;LINEA BLANCA
11130485;;F;55;CHILENO;;Boomers;RENCA                         ;METROPOLITANA;0;0;0;0;0;0;0;0;0;Lavadora WA80H4200SW/ZS 8Kg Blanca;LINEA BLANCA
15004501;;M;39;CHILENO;;X;PROVIDENCIA                   ;METROPOLITANA;0;0;0;0;0;0;0;0;0;Freezer 142Lts MFH-1430B186C Horizontal;LINEA BLANCA
7366556;;M;65;CHILENO;;Boomers;LA CISTERNA                   ;METROPOLITANA;0;0;0;0;0;0;0;0;0;Cocina Andes60TX4 4P Inox;LINEA BLANCA
11105072;;F;55;CHILENO;;Boomers;TEMUCO                        ;ARAUCANIA;0;0;0;0;0;0;0;0;0;Cocina Andes60TX4 4P Inox;LINEA BLANCA
25265559;;M;29;ECUATORIANO;;Extranjero;"";"";0;0;0;0;0;0;0;0;0;Lavadora MLS-090GE04N 9Kg Gris;LINEA BLANCA
15345838;Casado;M;39;CHILENO;INGENIERO;X;PROVIDENCIA                   ;METROPOLITANA;0;0;0;0;0;0;0;0;0;Cocina Andes60TX4 4P Inox;LINEA BLANCA
8581577;;M;62;CHILENO;;Boomers;LOS ANGELES                   ;BIO BIO;0;0;0;0;0;0;0;0;0;Lavadora MLS-140BSC03T 14Kg Blanca;LINEA BLANCA
7583564;Casado;M;65;CHILENO;;Boomers;CONCEPCION                    ;BIO BIO;0;0;0;0;0;0;0;0;0;Lavadora WA80H4200SW/ZS 8Kg Blanca;LINEA BLANCA
10638761;Casado;F;55;CHILENO;CONTADOR GENERAL;Boomers;RENCA                         ;METROPOLITANA;0;0;0;0;0;0;0;0;0;Freezer Horizontal M100 99Lts;LINEA BLANCA
10013043;;F;59;CHILENO;;Boomers;CUNCO                         ;ARAUCANIA;0;0;0;0;0;0;0;0;0;Refrigerador 260Lts BF Frio Direc MRFI2660SR346W;LINEA BLANCA
18400525;;M;29;CHILENO;;Millenial;"";"";0;0;0;0;0;0;0;0;0;Lavadora WT16DSBP 16Kg Silver;LINEA BLANCA
5493334;;F;76;CHILENO;;Silencioso;PROVIDENCIA                   ;METROPOLITANA;0;0;0;0;0;0;0;0;0;Lavadora WA90H4400SW/ZS 9Kg Blanca;LINEA BLANCA
19844801;;F;24;CHILENO;;Z;PROVIDENCIA                   ;METROPOLITANA;0;0;0;0;0;0;0;0;0;Refrigerador 244Lts Frio Directo Progress 3100;LINEA BLANCA
5978920;;M;73;CHILENO;;Silencioso;PARRAL                        ;MAULE;0;0;0;0;0;0;0;0;0;Refrigerador 241Lts BF Frio Directo Nordik 415;LINEA BLANCA
17481037;;M;32;CHILENO;;Millenial;PROVIDENCIA                   ;METROPOLITANA;0;0;0;0;0;0;0;0;0;Refrigerador 300Lts No Frost RT29K500JS8/ZS;LINEA BLANCA
18761072;;F;27;CHILENO;;Millenial;ESTACION CENTRAL;METROPOLITANA;1649990;2;1;0;0;0;2;1;1649990;MOTO HONDA CB125F TWISTER AZUL;MOTOCICLETAS
9453897;;M;60;CHILENO;;Boomers;RENCA                         ;METROPOLITANA;0;0;0;0;0;0;0;0;0;MOTO LX125-76A LONCIN NEGRO/ROJO;MOTOCICLETAS
26795614;;M;31;VENEZOLANO;;Extranjero;ESTACION CENTRAL;METROPOLITANA;34980;2;1;2;1;34980;0;0;0;JUEGO SPIDER-MAN MILES MORALES - LATAM PS4;VIDEO JUEGOS
12820321;;M;47;CHILENO;;X;PROVIDENCIA                   ;METROPOLITANA;556980;2;1;2;1;556980;0;0;0;Consola Xbox Series X 1TB;VIDEO JUEGOS
14047717;;F;43;CHILENO;;X;RENGO                         ;L.G.B.OÂ´HIGGINS;384990;1;1;0;0;0;1;1;384990;Consola PlayStation 4 500GB;VIDEO JUEGOS
20620088;;F;21;CHILENO;;Millenial;"";"";1497880;25;10;25;10;1497880;0;0;0;Consola PlayStation 4 500GB;VIDEO JUEGOS
14059728;;F;41;CHILENO;;X;CORONEL;BIO-BIO;34490;2;1;2;1;34490;0;0;0;JGO FIFA 22 ROLA NSW;VIDEO JUEGOS
19704573;;M;24;CHILENO;;Z;TEMUCO                        ;ARAUCANIA;729981;3;2;0;0;0;3;2;729981;Consola PlayStation 4 500GB;VIDEO JUEGOS
16378266;Soltero;F;36;CHILENO;;Millenial;SANTIAGO;METROPOLITANA;53480;2;1;2;1;53480;0;0;0;CONTROL NINTENDO SWITCH PRO CONTROLLER;VIDEO JUEGOS
19042930;;M;26;CHILENO;;Z;TALCA                         ;MAULE;59990;1;1;0;0;0;1;1;59990;ACC CONTROL PS4 DUALSHOCK;VIDEO JUEGOS
15586917;;M;39;CHILENO;;X;PROVIDENCIA                   ;METROPOLITANA;44990;1;1;0;0;0;1;1;44990;JUEGO SWITCH Super Smash Bros Ultimate;VIDEO JUEGOS
15474607;;M;39;CHILENO;;Extranjero;PROVIDENCIA                   ;N/D;283980;2;1;2;1;283980;0;0;0;Consola Xbox Series S 512GB;VIDEO JUEGOS
7387352;;F;64;CHILENO;;Boomers;LA SERENA                     ;COQUIMBO;1080850;4;1;0;0;0;4;1;1080850;Consola PlayStation 5 con Disco (Internacional);VIDEO JUEGOS
25910307;;M;31;EXTRANJERO - NO INFORMA NACIONALIDAD;;Extranjero;ESTACION CENTRAL              ;METROPOLITANA;1207020;5;2;0;0;0;5;2;1207020;Consola PlayStation 5 con Disco (Internacional);VIDEO JUEGOS
10072533;;F;57;CHILENO;;Boomers;RENCA                         ;METROPOLITANA;992230;5;2;0;0;0;5;2;992230;Consola PlayStation 5 con Disco (Internacional);VIDEO JUEGOS
13847425;;M;41;CHILENO;;X;N/D;N/D;650000;3;1;0;0;0;3;1;650000;Consola PlayStation 5 con Disco (Internacional);VIDEO JUEGOS
17135883;;M;33;CHILENO;;Millenial;RENGO                         ;L.G.B.OÂ´HIGGINS;439990;1;1;0;0;0;1;1;439990;Consola PlayStation 4 500GB;VIDEO JUEGOS
16732542;;F;35;CHILENO;;Millenial;N/D;N/D;2794720;20;8;4;1;721960;16;7;2072760;Consola PlayStation 4 500GB;VIDEO JUEGOS
12716741;;F;49;CHILENO;;X;QUILPUE                       ;VALPARAISO;764960;4;3;2;1;94980;2;2;669980;Consola PlayStation 4 500GB;VIDEO JUEGOS
18069275;;M;30;CHILENO;;Millenial;SAN PEDRO DE LA PAZ           ;BIO BIO;469990;1;1;0;0;0;1;1;469990;Consola PlayStation 4 500GB;VIDEO JUEGOS
10721267;;F;55;CHILENO;;Boomers;CERRILLOS                     ;METROPOLITANA;359990;1;1;0;0;0;1;1;359990;CONSOLA PS4 1TB SLIM;VIDEO JUEGOS
16539967;;F;36;CHILENO;;Millenial;PROVIDENCIA                   ;METROPOLITANA;374980;2;1;2;1;374980;0;0;0;CONSOLA SWITCH LT2 NEON;VIDEO JUEGOS
19864587;;F;23;CHILENO;;Z;PROVIDENCIA                   ;METROPOLITANA;377540;2;1;2;1;377540;0;0;0;HW SWITCH 1 1 NEON LT2 BUNDLE BLACK FRIDAY;VIDEO JUEGOS
18830323;Soltero;F;28;CHILENO;;Millenial;PROVIDENCIA                   ;METROPOLITANA;41980;2;1;2;1;41980;0;0;0;JUEGO SWITCH Super Mario Party;VIDEO JUEGOS
15047207;;F;40;CHILENO;;X;PROVIDENCIA                   ;METROPOLITANA;1199980;2;2;0;0;0;2;2;1199980;Consola PlayStation 5 con Disco (Internacional);VIDEO JUEGOS
26928467;;M;50;VENEZOLANO;;Extranjero;"";"";375840;2;1;2;1;375840;0;0;0;HW SWITCH 1 1 NEON LT2 BUNDLE BLACK FRIDAY;VIDEO JUEGOS
17639868;;F;32;CHILENO;;Millenial;CALBUCO                       ;LOS LAGOS;577950;5;4;0;0;0;5;4;577950;CONSOLA SWITCH LT2 NEON;VIDEO JUEGOS
26322579;;M;30;VENEZOLANO;;Extranjero;"";"";384960;4;2;4;2;384960;0;0;0;CONSOLA SWITCH LT2 NEON;VIDEO JUEGOS
16703882;;M;35;CHILENO;;Millenial;RENCA                         ;METROPOLITANA;1042980;2;1;0;0;0;2;1;1042980;Consola PlayStation 5 con Disco (Internacional);VIDEO JUEGOS
10309354;;F;59;CHILENO;;Boomers;HUECHURABA                    ;METROPOLITANA;981970;3;2;0;0;0;3;2;981970;Consola PlayStation 5 con Disco (Internacional);VIDEO JUEGOS
15594296;Casado;F;39;CHILENO;;X;PROVIDENCIA                   ;METROPOLITANA;1007540;2;1;2;1;1007540;0;0;0;Consola PlayStation 5 con Disco (Internacional);VIDEO JUEGOS
12600124;;F;48;CHILENO;;X;SAN FELIPE                    ;VALPARAISO;1229980;2;1;0;0;0;2;1;1229980;Consola PlayStation 5 con Disco (Internacional);VIDEO JUEGOS
20140365;;F;23;CHILENO;;Z;PROVIDENCIA                   ;METROPOLITANA;41980;2;1;2;1;41980;0;0;0;JUEGO SWITCH Zelda: Breath of the Wild;VIDEO JUEGOS
17925056;;F;31;CHILENO;;Millenial;PUENTE ALTO                   ;METROPOLITANA;714980;2;2;0;0;0;2;2;714980;Consola PlayStation 5 con Disco;VIDEO JUEGOS
16402304;;F;36;CHILENO;;Millenial;PROVIDENCIA                   ;METROPOLITANA;354980;2;1;2;1;354980;0;0;0;CONSOLA SWITCH LT2 NEON;VIDEO JUEGOS
10640356;;F;55;CHILENO;;Boomers;RENCA                         ;METROPOLITANA;58540;2;1;2;1;58540;0;0;0;Control inalambrico Xbox + cable USB-C Negro;VIDEO JUEGOS
19227427;;M;26;CHILENO;;Z;LA GRANJA;METROPOLITANA;53980;2;1;2;1;53980;0;0;0;Control inalambrico Xbox + cable USB-C Negro;VIDEO JUEGOS
17909679;Soltero;F;30;CHILENO;TECNICO DE NIVEL SUPERIOR EN ENFERMERIA;Millenial;"";"";59980;2;1;2;1;59980;0;0;0;Juego Switch Ring Fit Adventure;VIDEO JUEGOS
18024078;Soltero;F;30;CHILENO;FONOAUDIOLOGA;Millenial;PROVIDENCIA                   ;METROPOLITANA;305480;2;1;2;1;305480;0;0;0;Consola Xbox Series S 512GB;VIDEO JUEGOS
19113701;;M;26;CHILENO;;Z;PROVIDENCIA                   ;METROPOLITANA;617960;4;2;4;2;617960;0;0;0;Consola Xbox Series S 512GB;VIDEO JUEGOS
10488383;;F;55;CHILENO;;Boomers;RENCA                         ;METROPOLITANA;313980;2;1;2;1;313980;0;0;0;Consola Xbox Series S 512GB;VIDEO JUEGOS
19260961;Soltero;M;26;CHILENO;;Silencioso;PROVIDENCIA                   ;METROPOLITANA;0;0;0;0;0;0;0;0;0;CONSOLA SWITCH LT2 NEON;VIDEO JUEGOS
11811043;;F;51;CHILENO;;X;LA PINTANA                    ;METROPOLITANA;0;0;0;0;0;0;0;0;0;CONSOLA SWITCH LT2 NEON;VIDEO JUEGOS
15997111;;M;37;CHILENO;;Silencioso;N/D;N/D;0;0;0;0;0;0;0;0;0;SW SWITCH ZELDA SKYWARD SWORD;VIDEO JUEGOS
7682977;;F;69;CHILENO;;Silencioso;ARICA                         ;ARICA Y PARINACOTA;0;0;0;0;0;0;0;0;0;CONSOLA SWITCH LT2 NEON;VIDEO JUEGOS
11363840;;F;52;CHILENO;;X;MOSTAZAL                      ;L.G.B.OÂ´HIGGINS;0;0;0;0;0;0;0;0;0;SW SUPER MARO 3D WORLD + BF;VIDEO JUEGOS
18536655;Soltero;M;28;CHILENO;;Silencioso;PROVIDENCIA                   ;METROPOLITANA;0;0;0;0;0;0;0;0;0;Consola Xbox Series S 512GB;VIDEO JUEGOS
19995074;;M;23;CHILENO;;Z;PROVIDENCIA                   ;METROPOLITANA;0;0;0;0;0;0;0;0;0;Control inalambrico Xbox + cable USB-C Negro;VIDEO JUEGOS
15083908;;M;39;CHILENO;;X;PROVIDENCIA                   ;METROPOLITANA;0;0;0;0;0;0;0;0;0;JUEGO PS4 God OF War;VIDEO JUEGOS
18329061;Soltero;M;29;CHILENO;;Millenial;PROVIDENCIA                   ;METROPOLITANA;0;0;0;0;0;0;0;0;0;PS4 HW 1TB MEGA 15 - SPDMN GOTY, R C, HZDCE BNDL;VIDEO JUEGOS
13241665;;F;44;CHILENO;;X;TALAGANTE                     ;METROPOLITANA;0;0;0;0;0;0;0;0;0;CONTROL PS4 CAMOUFLAGE;VIDEO JUEGOS
18405815;Soltero;M;29;CHILENO;;Millenial;PROVIDENCIA                   ;METROPOLITANA;0;0;0;0;0;0;0;0;0;Consola Xbox Series S 512GB;VIDEO JUEGOS
8369284;;M;64;CHILENO;;Boomers;PUERTO MONTT                  ;LOS LAGOS;0;0;0;0;0;0;0;0;0;Consola PS4 Slim 500gb FIFA 21 Bundle;VIDEO JUEGOS
16129680;;F;34;CHILENO;;Millenial;RENCA                         ;METROPOLITANA;0;0;0;0;0;0;0;0;0;CONSOLA PS4 HW 1TB MEGA 16 - R6, HZD UCC;VIDEO JUEGOS
12113886;Casado;M;47;CHILENO;;Silencioso;PROVIDENCIA                   ;METROPOLITANA;0;0;0;0;0;0;0;0;0;Control inalambrico Xbox + cable USB-C Negro;VIDEO JUEGOS
19009855;Soltero;M;27;CHILENO;;Z;PROVIDENCIA                   ;METROPOLITANA;0;0;0;0;0;0;0;0;0;Consola Series X;VIDEO JUEGOS
10530506;;M;56;CHILENO;;Boomers;PUENTE ALTO                   ;METROPOLITANA;0;0;0;0;0;0;0;0;0;JUEGO FIFA 21 PS4;VIDEO JUEGOS
20121373;;M;23;CHILENO;;Silencioso;PROVIDENCIA                   ;METROPOLITANA;0;0;0;0;0;0;0;0;0;Control inalambrico Xbox + cable USB-C Negro;VIDEO JUEGOS
18293927;;M;29;CHILENO;;Millenial;VALPARAISO                    ;VALPARAISO;0;0;0;0;0;0;0;0;0;PS4 SLIM 1TB MEGAPACK HIT 13;VIDEO JUEGOS
15702073;;F;38;CHILENO;;X;PUENTE ALTO                   ;METROPOLITANA;0;0;0;0;0;0;0;0;0;CONSOLA SWITCH LITE YELLOW;VIDEO JUEGOS
16070318;;F;37;CHILENO;;Millenial;N/D;N/D;0;0;0;0;0;0;0;0;0;PS4 SLIM 1TB MEGAPACK HIT 13;VIDEO JUEGOS
17569241;;M;32;CHILENO;;Millenial;PROVIDENCIA                   ;METROPOLITANA;0;0;0;0;0;0;0;0;0;JUEGO SW SWITCH POKEMON SWORD;VIDEO JUEGOS
17483561;;M;32;CHILENO;;Millenial;MAIPU                         ;METROPOLITANA;0;0;0;0;0;0;0;0;0;CONSOLA Switch + Mario Kart 8 Deluxe (Digital) +;VIDEO JUEGOS
11552977;;M;51;CHILENO;;X;N/D;N/D;0;0;0;0;0;0;0;0;0;PS4 SLIM 1TB MEGAPACK HIT 13;VIDEO JUEGOS
17235624;Soltero;F;33;CHILENO;TECNICO EN FINANZAS;Millenial;PROVIDENCIA                   ;METROPOLITANA;0;0;0;0;0;0;0;0;0;JUEGO PS4 The Last Of US Remastered;VIDEO JUEGOS
14465891;Casado;M;48;CHILENO;PROFESOR;X;RENCA                         ;METROPOLITANA;0;0;0;0;0;0;0;0;0;Headset for PS4 A10 Logitech (Grey/Blue);VIDEO JUEGOS
8268514;;F;66;CHILENO;;Boomers;LOS ANDES                     ;VALPARAISO;0;0;0;0;0;0;0;0;0;CONSOLA PS4 1TB MEGA 6 3 Juegos 3M PS Plus;VIDEO JUEGOS
18928865;;F;27;CHILENO;;Millenial;PROVIDENCIA                   ;METROPOLITANA;0;0;0;0;0;0;0;0;0;JUEGO SWITCH Zelda: Breath of the Wild;VIDEO JUEGOS
9191603;;F;58;CHILENO;;Boomers;MOLINA                        ;MAULE;0;0;0;0;0;0;0;0;0;PS4 SLIM 1TB MEGAPACK HIT 13;VIDEO JUEGOS
16611862;;F;33;CHILENO;;Millenial;CAUQUENES                     ;MAULE;0;0;0;0;0;0;0;0;0;JUEGO SWITCH Super Mario Odyssey;VIDEO JUEGOS
18182593;;M;30;CHILENO;;Millenial;PROVIDENCIA                   ;METROPOLITANA;0;0;0;0;0;0;0;0;0;JUEGO SW SWITCH POKEMON SWORD;VIDEO JUEGOS
17252771;;F;32;CHILENO;;Millenial;CERRILLOS                     ;METROPOLITANA;0;0;0;0;0;0;0;0;0;CONSOLA PS4 1TB MEGA 6 3 Juegos 3M PS Plus;VIDEO JUEGOS
8405508;;F;64;CHILENO;;Boomers;SAN RAFAEL                    ;MAULE;0;0;0;0;0;0;0;0;0;CONSOLA PS4 FIFA 2021 BUNDLE;VIDEO JUEGOS
16568670;;M;34;CHILENO;;Millenial;PAINE                         ;METROPOLITANA;0;0;0;0;0;0;0;0;0;CONSOLA PS4 1TB MEGA 6 3 Juegos 3M PS Plus;VIDEO JUEGOS
20525095;;M;21;CHILENO;;Z;PROVIDENCIA                   ;METROPOLITANA;0;0;0;0;0;0;0;0;0;ACC CONTROL PS4 DUALSHOCK;VIDEO JUEGOS
17752111;;M;31;CHILENO;;Millenial;RECOLETA;METROPOLITANA;0;0;0;0;0;0;0;0;0;Control inalambrico + cable USB-C Negro;VIDEO JUEGOS
15564853;;F;39;CHILENO;;X;SANTIAGO;METROPOLITANA;0;0;0;0;0;0;0;0;0;JUEGO PS4 Spiderman;VIDEO JUEGOS
17671028;;M;31;CHILENO;;Millenial;PROVIDENCIA                   ;METROPOLITANA;0;0;0;0;0;0;0;0;0;Consola Xbox Series S 512GB;VIDEO JUEGOS
14127680;;F;41;CHILENO;;X;COLINA;METROPOLITANA;0;0;0;0;0;0;0;0;0;Consola PlayStation 5 con Disco;VIDEO JUEGOS
16799933;Soltero;F;34;CHILENO;TECNOLOGO MEDICO;Millenial;PROVIDENCIA                   ;METROPOLITANA;0;0;0;0;0;0;0;0;0;CONSOLA SWITCH LITE + JUEGO ZELDA Link s Awakeni;VIDEO JUEGOS
15119489;;F;40;CHILENO;;X;CHIMBARONGO                   ;L.G.B.OÂ´HIGGINS;136055;6;4;0;0;0;6;4;136055;CALIENTACAMA KIOTO DIGITAL 2 PLAZAS KTC-1006;CLIMATIZACION
16795199;;F;34;CHILENO;;Millenial;PANGUIPULLI                   ;LOS LAGOS;357980;2;2;0;0;0;2;2;357980;ESTUFA CUARZO KIOTO 800W KTE-011A;CLIMATIZACION
18081858;Soltero;F;29;CHILENO;;Millenial;QUINTA NORMAL;METROPOLITANA;27980;2;4;3;3;37970;-1;1;-9990;TERMOVENTILADOR KIOTO BLANCO 2000W KTE-1028B;CLIMATIZACION
9675076;;F;61;CHILENO;;Boomers;PELLUHUE                      ;MAULE;281960;4;3;0;0;0;4;3;281960;ESTUFA CUARZO KIOTO 800W KTE-011A;CLIMATIZACION
16255463;;M;36;CHILENO;;Millenial;CONSTITUCION                  ;MAULE;14000;1;1;0;0;0;1;1;14000;ESTUFA CUARZO KIOTO 800W KTE-011A;CLIMATIZACION
26460295;;F;29;CHILENO;;Extranjero;PUERTO MONTT                  ;LOS LAGOS;322460;4;3;4;3;322460;0;0;0;ESTUFA CUARZO KIOTO 800W KTE-011A;CLIMATIZACION
16955138;;F;33;CHILENO;;Millenial;PROVIDENCIA                   ;METROPOLITANA;623480;52;37;52;35;610480;0;2;13000;ESTUFA CUARZO KIOTO 800W KTE-011A;CLIMATIZACION
14442570;;F;41;CHILENO;;X;PROVIDENCIA                   ;METROPOLITANA;340930;7;6;4;3;281960;3;3;58970;CALIENTACAMAS MANUAL 2N SG-5121D4 2PL;CLIMATIZACION
4184475;;M;80;CHILENO;;Silencioso;EL BOSQUE                     ;METROPOLITANA;6990;1;1;0;0;0;1;1;6990;ESTUFA CUARZO KIOTO 800W KTE-011A;CLIMATIZACION
17070216;;F;33;CHILENO;;Millenial;QUILICURA;METROPOLITANA;10480;2;1;2;1;10480;0;0;0;ESTUFA CUARZO KIOTO 800W KTE-011A;CLIMATIZACION
13751737;;F;42;CHILENO;;X;RENCA                         ;METROPOLITANA;149990;1;3;0;2;0;1;1;149990;ESTUFA ELECTRICA CUARZO KIOTO 1200W KTE 1033;CLIMATIZACION
17521556;;F;31;CHILENO;;Millenial;PROVIDENCIA                   ;METROPOLITANA;159960;4;2;4;2;159960;0;0;0;ESTUFA CUARZO KIOTO 800W KTE-011A;CLIMATIZACION
18864348;Soltero;M;26;CHILENO;;Z;PROVIDENCIA                   ;METROPOLITANA;5842;2;1;0;0;0;2;1;5842;ESTUFA CUARZO KIOTO 800W KTE-011A;CLIMATIZACION
20066744;;F;23;CHILENO;;Z;VALDIVIA;LOS LAGOS;0;0;2;0;0;0;0;2;0;ESTUFA CUARZO KIOTO 800W KTE-011A;CLIMATIZACION
19252047;;F;26;CHILENO;;Z;LIMACHE                       ;VALPARAISO;6490;1;1;1;1;6490;0;0;0;ESTUFA CUARZO KIOTO 800W KTE-011A;CLIMATIZACION
14180654;;F;41;CHILENO;;X;LA PINTANA                    ;METROPOLITANA;264640;5;3;0;0;0;5;3;264640;ESTUFA CUARZO KIOTO 800W KTE-011A;CLIMATIZACION
11140133;;F;55;CHILENO;;Boomers;PROVIDENCIA                   ;METROPOLITANA;6990;1;1;0;0;0;1;1;6990;ESTUFA CUARZO KIOTO 800W KTE-011A;CLIMATIZACION
18524153;;M;28;CHILENO;;Millenial;YUMBEL                        ;BIO BIO;444890;12;10;0;0;0;12;10;444890;ESTUFA CUARZO KIOTO 800W KTE-011A;CLIMATIZACION
23373969;;M;29;EXTRANJERO - NO INFORMA NACIONALIDAD;;Millenial;PROVIDENCIA                   ;METROPOLITANA;348330;9;3;4;2;262520;5;1;85810;CALIENTACAMA KIOTO DIGITAL 2 PLAZAS KTC-1006;CLIMATIZACION
14062874;;F;40;CHILENO;;Millenial;TALCA;MAULE;12980;2;2;2;2;12980;0;0;0;ESTUFA CUARZO KIOTO 800W KTE-011A;CLIMATIZACION
17300026;;F;33;CHILENO;;Millenial;PROVIDENCIA                   ;METROPOLITANA;5592;1;1;0;0;0;1;1;5592;ESTUFA CUARZO KIOTO 800W KTE-011A;CLIMATIZACION
14488981;;F;50;CHILENO;;X;N/D;N/D;104970;3;3;0;0;0;3;3;104970;CALIENTACAMA KIOTO DIGITAL 2 PLAZAS KTC-1006;CLIMATIZACION
18202541;;F;30;CHILENO;;Millenial;N/D;N/D;164960;6;3;0;0;0;6;3;164960;ESTUFA CUARZO KIOTO 800W KTE-011A;CLIMATIZACION
19812738;;M;24;CHILENO;;Z;PROVIDENCIA                   ;METROPOLITANA;76980;2;1;0;0;0;2;1;76980;CHIMENEA ELECTRICA KIOTO 2000W KTE-1101;CLIMATIZACION
12589073;Soltero;F;48;CHILENO;;X;PROVIDENCIA                   ;METROPOLITANA;6990;1;1;0;0;0;1;1;6990;ESTUFA CUARZO KIOTO 800W KTE-011A;CLIMATIZACION
20598542;;F;21;CHILENO;;Z;EL BOSQUE;METROPOLITANA;340950;5;3;5;3;340950;0;0;0;CALIENTACAMA KIOTO DIGITAL 2 PLAZAS KTC-1006;CLIMATIZACION
12544113;;M;47;CHILENO;;X;CHANCO                        ;MAULE;67972;3;1;0;0;0;3;1;67972;CHIMENEA ELECTRICA KIOTO 2000W KTE-1101;CLIMATIZACION
17301345;;F;32;CHILENO;;Millenial;PANQUEHUE                     ;VALPARAISO;95300;7;3;0;0;0;7;3;95300;TERMOVENTILADOR KIOTO BLANCO 2000W KTE-1028B;CLIMATIZACION
15407666;;M;39;CHILENO;;X;BUIN                          ;METROPOLITANA;84980;2;2;0;0;0;2;2;84980;MINI OLEOELECTRICA KIOTO 500W NEGRO KTE-1081N;CLIMATIZACION
23350489;;F;45;COLOMBIANO;;Extranjero;CHILLAN                       ;BIO BIO;106570;4;3;0;0;0;4;3;106570;ESTUFA ELECTRICA CUARZO KIOTO 1200W KTE 1033;CLIMATIZACION
13196263;;M;45;CHILENO;;X;RENCA                         ;METROPOLITANA;13980;2;1;0;0;0;2;1;13980;ESTUFA CUARZO KIOTO 800W KTE-011A;CLIMATIZACION
17008274;;M;33;CHILENO;;Millenial;PROVIDENCIA                   ;METROPOLITANA;99980;2;1;2;1;99980;0;0;0;CHIMENEA ELECTRICA KIOTO 2000W KTE-1101;CLIMATIZACION
18880642;;M;28;CHILENO;;Silencioso;PROVIDENCIA                   ;METROPOLITANA;83960;3;3;3;3;83960;0;0;0;TERMOVENTILADOR KIOTO BLANCO 2000W KTE-1028B;CLIMATIZACION
19068281;Soltero;F;27;CHILENO;;Z;N/D;N/D;207980;2;2;1;1;7990;1;1;199990;ESTUFA CUARZO KIOTO 800W KTE-011A;CLIMATIZACION
19208123;;M;31;CHILENO;;Millenial;RENCA                         ;METROPOLITANA;53980;2;1;2;1;53980;0;0;0;CONVECTOR ELECT. UT HMC-2000;CLIMATIZACION
5756164;;F;72;CHILENO;;Silencioso;VINA DEL MAR                  ;VALPARAISO;302200;6;3;0;0;0;6;3;302200;ESTUFA CUARZO KIOTO 800W KTE-011A;CLIMATIZACION
7444013;;M;64;CHILENO;;Millenial;"";"";29990;1;3;0;2;0;1;1;29990;CALIENTACAMA KIOTO ANALOGO 1 PLAZA KTC-1004;CLIMATIZACION
5055577;Casado;M;74;CHILENO;;Silencioso;ANTOFAGASTA                   ;ANTOFAGASTA;49990;1;1;1;1;49990;0;0;0;CHIMENEA ELECTRICA KIOTO 2000W KTE-1101;CLIMATIZACION
10049566;;F;58;CHILENO;;Boomers;CAUQUENES                     ;MAULE;371622;3;3;0;0;0;3;3;371622;ESTUFA CUARZO KIOTO 800W KTE-011A;CLIMATIZACION
14137977;;F;41;CHILENO;;X;PROVIDENCIA                   ;METROPOLITANA;19980;2;1;0;0;0;2;1;19980;TERMOVENTILADOR KIOTO NEGRO 2000W KTE-1028N;CLIMATIZACION
16615958;;M;35;CHILENO;;Millenial;"";"";404600;4;5;0;0;0;4;5;404600;ESTUFA CUARZO KIOTO 800W KTE-011A;CLIMATIZACION
19766832;;F;25;CHILENO;;Z;N/D;N/D;8792;1;1;0;0;0;1;1;8792;TERMOVENTILADOR KIOTO NEGRO 2000W KTE-1028N;CLIMATIZACION
18483074;;F;28;CHILENO;;Millenial;N/D;N/D;65900;2;1;0;0;0;2;1;65900;CHIMENEA ELECTRICA KIOTO 2000W KTE-1101;CLIMATIZACION
14019511;Soltero;M;40;CHILENO;ABOGADO;X;RENCA                         ;METROPOLITANA;10990;1;1;0;0;0;1;1;10990;TERMOVENTILADOR KIOTO BLANCO 2000W KTE-1028B;CLIMATIZACION
16546966;;F;35;CHILENO;;Millenial;PROVIDENCIA                   ;METROPOLITANA;7990;1;1;1;1;7990;0;0;0;TERMOVENTILADOR KIOTO BLANCO 2000W KTE-1028B;CLIMATIZACION
17102976;;M;33;CHILENO;;Millenial;COLINA                        ;METROPOLITANA;514940;6;5;2;1;189980;4;4;324960;ESTUFA INFRAROJA TH-IR60;CLIMATIZACION
18982207;Soltero;F;27;CHILENO;TECNICO DE NIVEL SUPERIOR EN LABORATORIO CLINICO Y BANCO DE SANGRE;Z;PROVIDENCIA                   ;METROPOLITANA;19990;1;1;1;1;19990;0;0;0;ESTUFA ELECTRICA CUARZO KIOTO 1200W KTE 1033;CLIMATIZACION
11539961;;F;52;CHILENO;;X;"";"";56970;3;6;1;1;17990;2;5;38980;TERMOVENTILADOR KIOTO BLANCO 2000W KTE-1028B;CLIMATIZACION
20259615;;F;23;CHILENO;;Millenial;PROVIDENCIA                   ;METROPOLITANA;7990;1;1;1;1;7990;0;0;0;TERMOVENTILADOR KIOTO NEGRO 2000W KTE-1028N;CLIMATIZACION
14359816;;F;45;CHILENO;;X;ANGOL                         ;ARAUCANIA;1104860;14;9;9;5;538910;5;4;565950;CHIMENEA ELECTRICA KIOTO 2000W KTE-1101;CLIMATIZACION
14261625;;F;48;CHILENO;;X;TENO                          ;MAULE;460900;10;7;0;0;0;10;7;460900;CALIENTACAMAS MANUAL 2N SG-5121D4 2PL;CLIMATIZACION
19125971;;F;26;CHILENO;;Z;PROVIDENCIA                   ;METROPOLITANA;19980;2;2;0;0;0;2;2;19980;TERMOVENTILADOR KIOTO BLANCO 2000W KTE-1028B;CLIMATIZACION
12161341;;M;50;CHILENO;;X;PROVIDENCIA                   ;METROPOLITANA;10990;1;1;1;1;10990;0;0;0;CALIENTACAMA KIOTO ANALOGO 1 PLAZA KTC-1004;CLIMATIZACION
18222805;;F;29;CHILENO;;Millenial;"";"";31950;5;2;5;2;31950;0;0;0;TERMOVENTILADOR KIOTO BLANCO 2000W KTE-1028B;CLIMATIZACION
14008349;;M;40;CHILENO;;X;PROVIDENCIA                   ;METROPOLITANA;9990;1;1;0;0;0;1;1;9990;TERMOVENTILADOR KIOTO NEGRO 2000W KTE-1028N;CLIMATIZACION
16528432;;F;35;CHILENO;;Millenial;RENGO                         ;L.G.B.OÂ´HIGGINS;9990;1;1;0;0;0;1;1;9990;TERMOVENTILADOR KIOTO NEGRO 2000W KTE-1028N;CLIMATIZACION
17797450;;F;31;CHILENO;;Extranjero;IQUIQUE                       ;TARAPACA;17990;1;1;1;1;17990;0;0;0;ESTUFA ELECTRICA CUARZO KIOTO 1200W KTE 1033;CLIMATIZACION
7024945;Divorciado;F;56;CHILENO;EDUCADOR DE PARVULO;Boomers;LA SERENA                     ;COQUIMBO;6990;1;1;0;0;0;1;1;6990;ESTUFA CUARZO KIOTO 800W KTE-011A;CLIMATIZACION
19059558;;F;26;CHILENO;;Z;CAUQUENES                     ;MAULE;6990;1;1;0;0;0;1;1;6990;ESTUFA CUARZO KIOTO 800W KTE-011A;CLIMATIZACION
18079774;;F;30;CHILENO;;Millenial;PROVIDENCIA                   ;METROPOLITANA;19970;3;1;3;1;19970;0;0;0;TERMOVENTILADOR KIOTO BLANCO 2000W KTE-1028B;CLIMATIZACION
17573907;;F;32;CHILENO;;Millenial;COLINA                        ;METROPOLITANA;90882;4;2;0;0;0;4;2;90882;CHIMENEA ELECTRICA KIOTO 2000W KTE-1101;CLIMATIZACION
8801421;;F;61;CHILENO;;Boomers;RENCA                         ;METROPOLITANA;29990;1;1;0;0;0;1;1;29990;CALIENTACAMA KIOTO DIGITAL 2 PLAZAS KTC-1006;CLIMATIZACION
17282984;Soltero;M;32;CHILENO;INGENIERO COMERCIAL;Millenial;PROVIDENCIA                   ;METROPOLITANA;19970;3;1;3;1;19970;0;0;0;TERMOVENTILADOR KIOTO NEGRO 2000W KTE-1028N;CLIMATIZACION
16797820;;F;34;CHILENO;;Millenial;PROVIDENCIA                   ;METROPOLITANA;32970;3;1;3;1;32970;0;0;0;CALIENTACAMA KIOTO ANALOGO 1 PLAZA KTC-1004;CLIMATIZACION
12793889;;F;46;CHILENO;;X;PUENTE ALTO                   ;METROPOLITANA;333980;2;1;2;1;333980;0;0;0;ESTUFA PARAFINA KPL-36;CLIMATIZACION
17354697;Soltero;F;32;CHILENO;EDUCADOR DE PARVULO;Millenial;PROVIDENCIA                   ;METROPOLITANA;25970;3;3;3;3;25970;0;0;0;ESTUFA CUARZO KIOTO 800W KTE-011A;CLIMATIZACION
14503691;;M;46;CHILENO;;X;TALCA                         ;MAULE;9990;1;1;0;0;0;1;1;9990;TERMOVENTILADOR KIOTO BLANCO 2000W KTE-1028B;CLIMATIZACION
7877466;;M;64;CHILENO;;Boomers;VICTORIA                      ;ARAUCANIA;39970;3;2;0;0;0;3;2;39970;ESTUFA ELECTRICA CUARZO KIOTO 1200W KTE 1033;CLIMATIZACION
26006716;;M;38;VENEZOLANO;;Extranjero;N/D;N/D;14980;2;1;2;1;14980;0;0;0;CALIENTACAMA KIOTO ANALOGO 1 PLAZA KTC-1004;CLIMATIZACION
8429529;;F;58;PERUANO;;Boomers;PROVIDENCIA                   ;METROPOLITANA;56580;3;2;0;0;0;3;2;56580;ESTUFA ELECTRICA CUARZO KIOTO 1200W KTE 1033;CLIMATIZACION
20501564;;F;22;CHILENO;;Z;CALAMA;ANTOFAGASTA;10990;1;1;1;1;10990;0;0;0;CALIENTACAMA KIOTO ANALOGO 1 PLAZA KTC-1004;CLIMATIZACION
11374211;Soltero;M;53;CHILENO;;X;RENCA                         ;METROPOLITANA;9990;1;1;0;0;0;1;1;9990;TERMOVENTILADOR KIOTO BLANCO 2000W KTE-1028B;CLIMATIZACION
15211981;;M;37;CHILENO;;Millenial;PROVIDENCIA                   ;METROPOLITANA;10990;1;1;1;1;10990;0;0;0;CALIENTACAMA KIOTO ANALOGO 1 PLAZA KTC-1004;CLIMATIZACION
25465829;Soltero;F;42;ECUATORIANO;MEDICO CIRUJANO;Extranjero;PROVIDENCIA                   ;METROPOLITANA;227970;3;3;3;3;227970;0;0;0;TERMOVENTILADOR KIOTO NEGRO 2000W KTE-1028N;CLIMATIZACION
16066478;;F;36;CHILENO;;Millenial;PUNTA ARENAS                  ;MAGALLANES;34970;3;2;0;0;0;3;2;34970;TERMOVENTILADOR KIOTO BLANCO 2000W KTE-1028B;CLIMATIZACION
8016106;;F;51;CHILENO;;X;BUIN                          ;METROPOLITANA;19980;2;1;0;0;0;2;1;19980;TERMOVENTILADOR KIOTO NEGRO 2000W KTE-1028N;CLIMATIZACION
18053888;;F;30;CHILENO;;Millenial;PROVIDENCIA                   ;METROPOLITANA;9990;1;1;0;0;0;1;1;9990;TERMOVENTILADOR KIOTO NEGRO 2000W KTE-1028N;CLIMATIZACION
17070326;;F;33;CHILENO;;Millenial;PROVIDENCIA                   ;METROPOLITANA;23980;2;1;2;1;23980;0;0;0;TERMOVENTILADOR CERAMICO TH-CH40;CLIMATIZACION
18774573;;F;28;CHILENO;;Millenial;PUENTE ALTO                   ;METROPOLITANA;311960;4;2;2;1;286980;2;1;24980;CALIENTACAMA KIOTO ANALOGO 1 PLAZA KTC-1004;CLIMATIZACION
9512678;;F;60;CHILENO;;Boomers;N/D;N/D;90970;3;3;0;0;0;3;3;90970;ESTUFA CUARZO KIOTO 800W KTE-011A;CLIMATIZACION
11745089;;F;50;CHILENO;;X;PROVIDENCIA                   ;METROPOLITANA;6990;1;1;0;0;0;1;1;6990;ESTUFA CUARZO KIOTO 800W KTE-011A;CLIMATIZACION
18121965;;F;30;CHILENO;;Millenial;N/D;N/D;0;0;2;0;2;0;0;0;0;ESTUFA CUARZO KIOTO 800W KTE-011A;CLIMATIZACION
25865047;;F;29;COLOMBIANO;;Extranjero;ANTOFAGASTA                   ;ANTOFAGASTA;84970;3;2;0;0;0;3;2;84970;TERMOVENTILADOR KIOTO BLANCO 2000W KTE-1028B;CLIMATIZACION
16919915;;F;34;CHILENO;;Millenial;PROVIDENCIA                   ;METROPOLITANA;9990;1;1;1;1;9990;0;0;0;TERMOVENTILADOR KIOTO BLANCO 2000W KTE-1028B;CLIMATIZACION
14024169;Soltero;F;40;CHILENO;PROFESOR;X;PROVIDENCIA                   ;METROPOLITANA;18990;1;1;0;0;0;1;1;18990;CALIENTACAMA KIOTO DIGITAL 1 PLAZA KTC-1005;CLIMATIZACION
18255272;;F;29;CHILENO;;Millenial;N/D;N/D;110190;7;3;0;0;0;7;3;110190;CALIENTACAMA KIOTO ANALOGO 1 PLAZA KTC-1004;CLIMATIZACION
7736287;;M;66;CHILENO;;Boomers;RENCA                         ;METROPOLITANA;8990;1;1;0;0;0;1;1;8990;ESTUFA ELECTRICA CUARZO KIOTO 1200W KTE 1033;CLIMATIZACION
13345608;Soltero;M;43;CHILENO;;X;RENCA                         ;METROPOLITANA;49990;1;1;0;0;0;1;1;49990;CHIMENEA ELECTRICA KIOTO 2000W KTE-1101;CLIMATIZACION
15109293;;M;38;CHILENO;;X;LAS CABRAS                    ;L.G.B.OÂ´HIGGINS;761650;9;5;0;0;0;9;5;761650;ESTUFA CUARZO KIOTO 800W KTE-011A;CLIMATIZACION
26996378;;F;27;VENEZOLANO;;Extranjero;PROVIDENCIA                   ;METROPOLITANA;11980;2;1;2;1;11980;0;0;0;TERMOVENTILADOR KIOTO BLANCO 2000W KTE-1028B;CLIMATIZACION
26499073;;M;41;VENEZOLANO;;Extranjero;N/D;N/D;334960;4;3;0;0;0;4;3;334960;CHIMENEA ELECTRICA KIOTO 2000W KTE-1101;CLIMATIZACION
17844824;;M;30;CHILENO;;Millenial;PROVIDENCIA                   ;METROPOLITANA;167980;2;1;2;1;167980;0;0;0;ESTUFA INFRARROJA THOR GREEN 1500 WIFI;CLIMATIZACION
10830629;;M;55;CHILENO;;Boomers;EL MONTE                      ;METROPOLITANA;579940;6;5;5;4;544950;1;1;34990;TERMOVENTILADOR KIOTO NEGRO 2000W KTE-1028N;CLIMATIZACION
9905592;;F;55;CHILENO;;Boomers;N/D;N/D;647960;6;2;2;1;393980;4;1;253980;A/C SPLIT ON/OFF FRIO-CALOR 12.000;CLIMATIZACION
25548454;;M;33;VENEZOLANO;;Extranjero;PROVIDENCIA                   ;METROPOLITANA;19970;3;1;3;1;19970;0;0;0;TERMOVENTILADOR KIOTO BLANCO 2000W KTE-1028B;CLIMATIZACION
13088434;;M;46;CHILENO;;X;EL BOSQUE                     ;METROPOLITANA;7990;1;1;1;1;7990;0;0;0;TERMOVENTILADOR KIOTO NEGRO 2000W KTE-1028N;CLIMATIZACION
18376049;;F;29;CHILENO;;Millenial;"";"";33980;2;2;0;0;0;2;2;33980;ESTUFA ELECTRICA CUARZO KIOTO 1200W KTE 1033;CLIMATIZACION
16342067;;F;36;CHILENO;;Silencioso;PROVIDENCIA                   ;METROPOLITANA;29990;1;1;1;1;29990;0;0;0;CALIENTACAMA KIOTO DIGITAL 2 PLAZAS KTC-1006;CLIMATIZACION
5780280;;F;74;CHILENO;;Silencioso;PROVIDENCIA                   ;METROPOLITANA;363010;7;3;0;0;0;7;3;363010;CALIENTACAMA KIOTO ANALOGO 1 PLAZA KTC-1004;CLIMATIZACION
18426177;;F;28;CHILENO;;Millenial;COLINA;METROPOLITANA;17980;2;1;0;0;0;2;1;17980;TERMOVENTILADOR KIOTO BLANCO 2000W KTE-1028B;CLIMATIZACION
13951945;;F;42;CHILENO;;X;TALCAHUANO                    ;BIO BIO;68960;4;4;0;0;0;4;4;68960;CALIENTACAMA KIOTO DIGITAL 2 PLAZAS KTC-1006;CLIMATIZACION
19723126;;F;24;CHILENO;;Z;PROVIDENCIA                   ;METROPOLITANA;36980;2;1;0;0;0;2;1;36980;CALIENTACAMA KIOTO DIGITAL 2 PLAZAS KTC-1006;CLIMATIZACION
5967472;;F;76;CHILENO;;Silencioso;PROVIDENCIA                   ;METROPOLITANA;8990;1;1;0;0;0;1;1;8990;TERMOVENTILADOR KIOTO NEGRO 2000W KTE-1028N;CLIMATIZACION
14600584;Casado;F;40;CHILENO;TECNICO DE NIVEL SUPERIOR EN ENFERMERIA;X;SANTIAGO;METROPOLITANA;59990;1;1;1;1;59990;0;0;0;CHIMENEA ELECTRICA KIOTO 2000W KTE-1101;CLIMATIZACION
11373825;;F;53;CHILENO;;X;MAULE                         ;MAULE;207570;22;23;0;0;0;22;23;207570;ESTUFA ELECTRICA CUARZO KIOTO 1200W KTE 1033;CLIMATIZACION
9100800;;M;61;CHILENO;;Boomers;N/D;N/D;799990;1;1;0;0;0;1;1;799990;CALEFACTOR LENA ITALY6100 ROJO;CLIMATIZACION
19804530;;F;24;CHILENO;;Z;"";"";116970;3;1;0;0;0;3;1;116970;CHIMENEA ELECTRICA KIOTO 2000W KTE-1101;CLIMATIZACION
19796096;;F;24;CHILENO;;Z;PROVIDENCIA                   ;METROPOLITANA;29990;1;1;1;1;29990;0;0;0;CALIENTACAMA KIOTO DIGITAL 2 PLAZAS KTC-1006;CLIMATIZACION
17003986;;M;33;CHILENO;;Millenial;LA FLORIDA                    ;METROPOLITANA;54990;1;1;0;0;0;1;1;54990;CHIMENEA ELECTRICA KIOTO 2000W KTE-1101;CLIMATIZACION
14195430;;M;41;CHILENO;;X;SAN RAMON                     ;METROPOLITANA;50991;1;1;0;0;0;1;1;50991;CHIMENEA ELECTRICA KIOTO 2000W KTE-1101;CLIMATIZACION
16281489;;F;36;CHILENO;;Millenial;PROVIDENCIA                   ;METROPOLITANA;8990;1;1;0;0;0;1;1;8990;TERMOVENTILADOR KIOTO NEGRO 2000W KTE-1028N;CLIMATIZACION
11077711;;F;55;CHILENO;;Boomers;VILLARICA                     ;ARAUCANIA;521840;5;3;2;1;19980;3;2;501860;TERMOVENTILADOR KIOTO BLANCO 2000W KTE-1028B;CLIMATIZACION
8413226;;F;55;CHILENO;;Boomers;VINA DEL MAR                  ;VALPARAISO;19980;2;2;0;0;0;2;2;19980;TERMOVENTILADOR KIOTO BLANCO 2000W KTE-1028B;CLIMATIZACION
6963647;;M;67;CHILENO;;Boomers;MAIPU                         ;METROPOLITANA;514190;7;5;0;0;0;7;5;514190;CALIENTACAMA KIOTO DIGITAL 2 PLAZAS KTC-1006;CLIMATIZACION
15982128;;F;37;CHILENO;;Millenial;N/D;N/D;8990;1;1;0;0;0;1;1;8990;TERMOVENTILADOR KIOTO NEGRO 2000W KTE-1028N;CLIMATIZACION
18960451;;F;27;CHILENO;;Millenial;N/D;N/D;32980;2;2;2;2;32980;0;0;0;CALIENTACAMA KIOTO DIGITAL 2 PLAZAS KTC-1006;CLIMATIZACION
17644064;;M;32;CHILENO;;Millenial;VALLENAR;ATACAMA;738450;8;3;0;0;0;8;3;738450;ESTUFA ELECTRICA CUARZO KIOTO 1200W KTE 1033;CLIMATIZACION
15372902;;F;40;CHILENO;;X;PUENTE ALTO                   ;METROPOLITANA;113980;2;1;2;1;113980;0;0;0;ESTUFA FOGUITA PRO;CLIMATIZACION
12333201;;F;49;CHILENO;;X;RENCA                         ;METROPOLITANA;9990;1;1;0;0;0;1;1;9990;TERMOVENTILADOR KIOTO BLANCO 2000W KTE-1028B;CLIMATIZACION
15699719;Soltero;M;38;CHILENO;;X;RENCA                         ;METROPOLITANA;169450;3;2;1;1;139990;2;1;29460;CALIENTACAMA KIOTO DIGITAL 1 PLAZA KTC-1005;CLIMATIZACION
8083696;;F;67;CHILENO;;Boomers;SALAMANCA                     ;COQUIMBO;17990;1;1;0;0;0;1;1;17990;CALIENTACAMA KIOTO DIGITAL 1 PLAZA KTC-1005;CLIMATIZACION
10076714;;M;58;CHILENO;;Boomers;N/D;N/D;179980;2;2;1;1;159990;1;1;19990;ESTUFA ELECTRICA CUARZO KIOTO 1200W KTE 1033;CLIMATIZACION
6228127;;M;69;CHILENO;;Silencioso;RENCA                         ;METROPOLITANA;17990;1;1;0;0;0;1;1;17990;CALIENTACAMA KIOTO DIGITAL 1 PLAZA KTC-1005;CLIMATIZACION
18341901;Soltero;M;29;CHILENO;;Millenial;PROVIDENCIA                   ;METROPOLITANA;121980;2;1;2;1;121980;0;0;0;ESTUFA FOGUITA PRO;CLIMATIZACION
13183449;;M;45;CHILENO;;X;LA LIGUA                      ;VALPARAISO;15980;2;1;2;1;15980;0;0;0;TERMOVENTILADOR KIOTO BLANCO 2000W KTE-1028B;CLIMATIZACION
15803188;;M;38;CHILENO;;Millenial;"";"";103960;4;2;0;0;0;4;2;103960;ESTUFA CUARZO KIOTO 800W KTE-011A;CLIMATIZACION
9814018;;F;59;CHILENO;;Boomers;PROVIDENCIA                   ;METROPOLITANA;219970;3;2;0;0;0;3;2;219970;CALEFACTOR CUARZO VERTICAL 800 W HQ 80 AIROLITE;CLIMATIZACION
14036583;;M;41;CHILENO;;X;N/D;N/D;260950;5;4;0;0;0;5;4;260950;CALIENTACAMA KIOTO DIGITAL 2 PLAZAS KTC-1006;CLIMATIZACION
18778178;;M;27;CHILENO;;Millenial;MELIPILLA                     ;METROPOLITANA;137979;5;3;0;0;0;5;3;137979;ESTUFA ELECTRICA CUARZO KIOTO 1200W KTE 1033;CLIMATIZACION
25335033;;F;30;HAITIANO;;Extranjero;SAN BERNARDO;METROPOLITANA;241960;4;2;4;2;241960;0;0;0;ESTUFA CUARZO KIOTO 800W KTE-011A;CLIMATIZACION
19803484;;F;24;CHILENO;;Z;PROVIDENCIA                   ;METROPOLITANA;11980;2;1;2;1;11980;0;0;0;TERMOVENTILADOR KIOTO BLANCO 2000W KTE-1028B;CLIMATIZACION
8422666;;F;63;CHILENO;;Boomers;FREIRINA                      ;ATACAMA;818940;6;3;0;0;0;6;3;818940;ESTUFA PARAFINA KPM-3300;CLIMATIZACION
16138176;;F;36;CHILENO;;Millenial;HUALPEN;BIO BIO;38483;2;2;0;0;0;2;2;38483;CALIENTACAMA KIOTO DIGITAL 2 PLAZAS KTC-1006;CLIMATIZACION
17570461;;F;32;CHILENO;;Millenial;N/D;N/D;8990;1;1;0;0;0;1;1;8990;TERMOVENTILADOR KIOTO NEGRO 2000W KTE-1028N;CLIMATIZACION
20496235;;F;21;CHILENO;;Z;PROVIDENCIA                   ;METROPOLITANA;12990;1;1;0;0;0;1;1;12990;CALIENTACAMA KIOTO ANALOGO 1 PLAZA KTC-1004;CLIMATIZACION
13494567;;F;44;CHILENO;;X;PROVIDENCIA                   ;METROPOLITANA;66980;2;1;2;1;66980;0;0;0;CALIENTACAMAS ANALOGO BASICO 2 PL;CLIMATIZACION
24256097;;F;60;CHILENO;;Boomers;PUERTO VARAS                  ;LOS LAGOS;0;0;2;0;0;0;0;2;0;CALIENTACAMA KIOTO DIGITAL 1 PLAZA KTC-1005;CLIMATIZACION
9693765;;F;62;CHILENO;;Boomers;SAN CARLOS                    ;BIO BIO;33560;2;2;0;0;0;2;2;33560;TERMOVENTILADOR VERTICAL SUN05 PURP.;CLIMATIZACION
19581291;;F;25;CHILENO;;Z;LOS ANDES                     ;VALPARAISO;44990;1;1;0;0;0;1;1;44990;CHIMENEA ELECTRICA KIOTO 2000W KTE-1101;CLIMATIZACION
10313786;;M;53;CHILENO;;X;N/D;N/D;386971;3;3;0;0;0;3;3;386971;TERMOVENTILADOR KIOTO BLANCO 2000W KTE-1028B;CLIMATIZACION
11082162;;F;56;CHILENO;;Boomers;FRESIA                        ;LOS LAGOS;239960;4;2;1;1;209990;3;1;29970;TERMOVENTILADOR KIOTO NEGRO 2000W KTE-1028N;CLIMATIZACION
19515472;;M;25;CHILENO;;Millenial;PROVIDENCIA                   ;METROPOLITANA;29990;1;1;0;0;0;1;1;29990;CALIENTACAMA KIOTO DIGITAL 2 PLAZAS KTC-1006;CLIMATIZACION
16393342;;F;35;CHILENO;;Millenial;"";"";79900;2;1;0;0;0;2;1;79900;CHIMENEA ELECTRICA KIOTO 2000W KTE-1101;CLIMATIZACION
7442819;;F;68;CHILENO;;Boomers;SAN ANTONIO                   ;VALPARAISO;40980;2;1;0;0;0;2;1;40980;CALIENTACAMA KIOTO DIGITAL 2 PLAZAS KTC-1006;CLIMATIZACION
17186139;;F;33;CHILENO;;Millenial;SAN JAVIER                    ;MAULE;9990;1;1;1;1;9990;0;0;0;ESTUFA ELECTRICA CUARZO KIOTO 1200W KTE 1033;CLIMATIZACION
14036783;;F;40;CHILENO;;X;PROVIDENCIA                   ;METROPOLITANA;27990;1;1;0;0;0;1;1;27990;MINI OLEOELECTRICA KIOTO 500W BLANCO KTE-1081B;CLIMATIZACION
7397206;;F;60;CHILENO;;Boomers;VALPARAISO                    ;VALPARAISO;89900;4;2;0;0;0;4;2;89900;TERMOVENTILADOR CALMA IPX1 T2000;CLIMATIZACION
26346052;;F;30;VENEZOLANO;;Extranjero;TALAGANTE                     ;METROPOLITANA;9990;1;1;1;1;9990;0;0;0;TERMOVENTILADOR KIOTO BLANCO 2000W KTE-1028B;CLIMATIZACION
15973474;;M;37;CHILENO;;Millenial;PROVIDENCIA                   ;METROPOLITANA;89980;2;1;0;0;0;2;1;89980;CALEFACTOR CARBONO EEC-6000NW;CLIMATIZACION
5805857;;F;79;CHILENO;;Silencioso;SAN JAVIER                    ;MAULE;9990;1;1;0;0;0;1;1;9990;ESTUFA CUARZO KIOTO 800W KTE-011A;CLIMATIZACION
16412824;;F;35;CHILENO;;Millenial;PUENTE ALTO                   ;METROPOLITANA;36740;4;2;0;0;0;4;2;36740;ESTUFA ELECTRICA CUARZO KIOTO 1200W KTE 1033;CLIMATIZACION
3880775;;M;82;"";;Silencioso;RENCA                         ;METROPOLITANA;58980;2;2;0;0;0;2;2;58980;TERMOVENTILADOR KIOTO BLANCO 2000W KTE-1028B;CLIMATIZACION
16007590;;F;36;CHILENO;;Millenial;PROVIDENCIA                   ;METROPOLITANA;11990;1;1;1;1;11990;0;0;0;CALIENTACAMA KIOTO ANALOGO 1 PLAZA KTC-1004;CLIMATIZACION
14366723;;F;45;CHILENO;;X;ARAUCO                        ;BIO BIO;45983;2;2;0;0;0;2;2;45983;CALIENTACAMA KIOTO DIGITAL 1 PLAZA KTC-1005;CLIMATIZACION
4488181;;M;79;CHILENO;;Silencioso;RENCA                         ;METROPOLITANA;21460;2;1;0;0;0;2;1;21460;TERMOVENTILADOR KIOTO NEGRO 2000W KTE-1028N;CLIMATIZACION
9147020;;M;57;CHILENO;;Boomers;LA FLORIDA                    ;METROPOLITANA;7990;1;1;1;1;7990;0;0;0;TERMOVENTILADOR KIOTO BLANCO 2000W KTE-1028B;CLIMATIZACION
17390816;;F;32;CHILENO;;Millenial;"";"";277951;5;5;0;0;0;5;5;277951;CALIENTACAMA KIOTO DIGITAL 2 PLAZAS KTC-1006;CLIMATIZACION
16172488;;M;37;CHILENO;;Millenial;CHANCO                        ;MAULE;1099286;23;18;0;0;0;23;18;1099286;TERMOVENTILADOR KIOTO NEGRO 2000W KTE-1028N;CLIMATIZACION
18925964;Soltero;M;27;CHILENO;;Millenial;PROVIDENCIA                   ;METROPOLITANA;27990;1;1;1;1;27990;0;0;0;CALIENTACAMA KIOTO DIGITAL 2 PLAZAS KTC-1006;CLIMATIZACION
25387795;;F;32;VENEZOLANO;;Extranjero;PROVIDENCIA                   ;METROPOLITANA;13980;2;1;2;1;13980;0;0;0;ESTUFA ELECTRICA CUARZO KIOTO 1200W KTE 1033;CLIMATIZACION
7643636;;M;69;CHILENO;;Silencioso;CAUQUENES                     ;MAULE;27990;1;1;0;0;0;1;1;27990;CALIENTACAMA KIOTO DIGITAL 2 PLAZAS KTC-1006;CLIMATIZACION
16593271;;F;34;CHILENO;;Millenial;PROVIDENCIA                   ;METROPOLITANA;12990;1;1;1;1;12990;0;0;0;CALIENTACAMA KIOTO ANALOGO 1 PLAZA KTC-1004;CLIMATIZACION
14055138;;F;40;CHILENO;;X;CONSTITUCION                  ;MAULE;163394;10;3;0;0;0;10;3;163394;CALIENTACAMA KIOTO ANALOGO 1 PLAZA KTC-1004;CLIMATIZACION
20228222;;F;22;CHILENO;;Z;PROVIDENCIA                   ;METROPOLITANA;11990;1;1;1;1;11990;0;0;0;CALIENTACAMA KIOTO ANALOGO 1 PLAZA KTC-1004;CLIMATIZACION
15011036;;F;40;CHILENO;;X;TOCOPILLA                     ;ANTOFAGASTA;160970;3;1;0;0;0;3;1;160970;CONVECTOR UT N10;CLIMATIZACION
15322277;Soltero;F;40;CHILENO;;X;RENCA                         ;METROPOLITANA;51950;5;4;5;4;51950;0;0;0;TERMOVENTILADOR KIOTO BLANCO 2000W KTE-1028B;CLIMATIZACION
16894058;;F;34;CHILENO;;Millenial;N/D;N/D;9000;2;1;0;0;0;2;1;9000;TERMOVENTILADOR KIOTO NEGRO 2000W KTE-1028N;CLIMATIZACION
20549754;;F;22;CHILENO;;Z;PROVIDENCIA                   ;METROPOLITANA;616950;5;5;2;2;138980;3;3;477970;ESTUFA CUARZO KIOTO 800W KTE-011A;CLIMATIZACION
15899156;;M;38;CHILENO;;Millenial;"";"";266970;3;2;2;1;211980;1;1;54990;CHIMENEA ELECTRICA KIOTO 2000W KTE-1101;CLIMATIZACION
10416879;;M;57;CHILENO;;Boomers;RENCA                         ;METROPOLITANA;65710;2;1;0;0;0;2;1;65710;ESTUFA ELECTRICA CUARZO KC 220 ROJA;CLIMATIZACION
18746780;;F;28;CHILENO;;Millenial;PROVIDENCIA                   ;METROPOLITANA;12990;1;1;1;1;12990;0;0;0;CALIENTACAMA KIOTO ANALOGO 1 PLAZA KTC-1004;CLIMATIZACION
4309093;;M;78;CHILENO;;Silencioso;RENCA                         ;METROPOLITANA;28460;2;1;0;0;0;2;1;28460;ESTUFA ELECTRICA CUARZO KIOTO 1200W KTE 1033;CLIMATIZACION
6681380;;M;71;CHILENO;;Silencioso;PROVIDENCIA                   ;METROPOLITANA;45240;2;1;0;0;0;2;1;45240;CALIENTACAMAS MANUAL 2N SG-5120D4 1PL;CLIMATIZACION
8758774;;F;63;CHILENO;;Boomers;SAN ANTONIO                   ;VALPARAISO;298939;6;3;0;0;0;6;3;298939;TERMOVENTILADOR KIOTO NEGRO 2000W KTE-1028N;CLIMATIZACION
27039279;;M;24;VENEZOLANO;;Extranjero;PROVIDENCIA                   ;METROPOLITANA;12990;1;1;1;1;12990;0;0;0;TERMOVENTILADOR KIOTO NEGRO 2000W KTE-1028N;CLIMATIZACION
11404081;;F;53;CHILENO;;X;LA PINTANA                    ;METROPOLITANA;50910;4;2;0;0;0;4;2;50910;CALIENTACAMA KIOTO ANALOGO 1 PLAZA KTC-1004;CLIMATIZACION
8517347;Casado;M;47;CHILENO;INGENIERO EN PREVENCION DE RIESGOS;X;RENCA                         ;METROPOLITANA;23980;2;1;2;1;23980;0;0;0;CALIENTACAMA KIOTO ANALOGO 1 PLAZA KTC-1004;CLIMATIZACION
7928216;;M;66;CHILENO;;Boomers;MACHALI                       ;L.G.B.OÂ´HIGGINS;88970;3;3;0;0;0;3;3;88970;TERMOVENTILADOR VERTICAL SUN05 PURP.;CLIMATIZACION
19168421;;F;27;CHILENO;;Millenial;PROVIDENCIA                   ;METROPOLITANA;159330;2;1;0;0;0;2;1;159330;ESTUFA GAS KG5 5K NEGRO EUROPEA;CLIMATIZACION
19390311;Soltero;M;25;CHILENO;;Z;PROVIDENCIA                   ;METROPOLITANA;12990;1;1;1;1;12990;0;0;0;CALIENTACAMA KIOTO ANALOGO 1 PLAZA KTC-1004;CLIMATIZACION
26361239;;F;28;VENEZOLANO;;Extranjero;N/D;N/D;32970;3;2;0;0;0;3;2;32970;CALIENTACAMA KIOTO ANALOGO 1 PLAZA KTC-1004;CLIMATIZACION
11422102;;F;53;CHILENO;;X;VALLENAR;ATACAMA;210970;3;1;0;0;0;3;1;210970;ESTUFA VITTALE-40 15K;CLIMATIZACION
6873400;;F;70;CHILENO;;Silencioso;LA FLORIDA                    ;METROPOLITANA;730880;9;3;0;0;0;9;3;730880;CALIENTACAMA KIOTO DIGITAL 1 PLAZA KTC-1005;CLIMATIZACION
26880122;Soltero;M;28;EXTRANJERO - NO INFORMA NACIONALIDAD;;Extranjero;ANTOFAGASTA                   ;ANTOFAGASTA;17980;2;1;2;1;17980;0;0;0;TERMOVENTILADOR KIOTO NEGRO 2000W KTE-1028N;CLIMATIZACION
11529992;;M;52;CHILENO;;X;SAN FERNANDO                  ;L.G.B.OÂ´HIGGINS;170272;3;4;0;0;0;3;4;170272;CALIENTACAMA KIOTO DIGITAL 1 PLAZA KTC-1005;CLIMATIZACION
17964728;;M;30;CHILENO;;Millenial;LA LIGUA                      ;VALPARAISO;28982;2;2;0;0;0;2;2;28982;ESTUFA CUARZO KIOTO 800W KTE-011A;CLIMATIZACION
14253694;;F;47;CHILENO;;X;QUILLOTA                      ;VALPARAISO;109980;2;2;0;0;0;2;2;109980;CHIMENEA ELECTRICA KIOTO 2000W KTE-1101;CLIMATIZACION
13600352;;F;42;CHILENO;;X;RENCA                         ;METROPOLITANA;93970;3;3;0;0;0;3;3;93970;TERMOVENTILADOR KIOTO NEGRO 2000W KTE-1028N;CLIMATIZACION
12104190;;F;53;CHILENO;;X;LA PINTANA                    ;METROPOLITANA;8990;1;1;0;0;0;1;1;8990;ESTUFA CUARZO KIOTO 800W KTE-011A;CLIMATIZACION
19412362;;M;25;CHILENO;;Z;PROVIDENCIA                   ;METROPOLITANA;34960;4;1;4;1;34960;0;0;0;ESTUFA ELECTRICA CUARZO KIOTO 1200W KTE 1033;CLIMATIZACION
14296206;;M;46;CHILENO;;X;PROVIDENCIA                   ;METROPOLITANA;346950;7;4;4;2;320960;3;2;25990;CALIENTACAMA KIOTO DIGITAL 1 PLAZA KTC-1005;CLIMATIZACION
8789719;;F;62;CHILENO;;Boomers;RANCAGUA                      ;L.G.B.OÂ´HIGGINS;128980;2;2;0;0;0;2;2;128980;TERMOVENTILADOR KIOTO BLANCO 2000W KTE-1028B;CLIMATIZACION
15101939;;M;39;CHILENO;;X;PAIGUANO                      ;COQUIMBO;8990;1;1;1;1;8990;0;0;0;ESTUFA CUARZO KIOTO 800W KTE-011A;CLIMATIZACION
6127115;;M;74;CHILENO;;Silencioso;TALCAHUANO                    ;BIO BIO;542280;7;2;0;0;0;7;2;542280;ESTUFA A GAS CALMA 5 KG COMPAK;CLIMATIZACION
18552751;;F;29;CHILENO;;Millenial;PROVIDENCIA                   ;METROPOLITANA;9990;1;1;1;1;9990;0;0;0;TERMOVENTILADOR KIOTO BLANCO 2000W KTE-1028B;CLIMATIZACION
15621268;;F;38;CHILENO;;Millenial;SAN BERNARDO                  ;METROPOLITANA;50970;5;2;3;1;36970;2;1;14000;CALIENTACAMA KIOTO DIGITAL 1 PLAZA KTC-1005;CLIMATIZACION
16780772;;M;34;CHILENO;;Millenial;RANCAGUA                      ;L.G.B.OÂ´HIGGINS;23980;2;2;0;0;0;2;2;23980;TERMOVENTILADOR KIOTO NEGRO 2000W KTE-1028N;CLIMATIZACION
18516162;;M;28;CHILENO;;Millenial;PROVIDENCIA                   ;METROPOLITANA;19980;2;1;2;1;19980;0;0;0;TERMOVENTILADOR KIOTO NEGRO 2000W KTE-1028N;CLIMATIZACION
17021838;Soltero;F;34;CHILENO;GEOLOGO;Millenial;PROVIDENCIA                   ;METROPOLITANA;51980;2;1;2;1;51980;0;0;0;ESTUFA ELECTRICA PORTATIL EEP-2200BLBLANCA;CLIMATIZACION
17815490;Soltero;M;31;CHILENO;CONTADOR AUDITOR;Millenial;N/D;N/D;39960;4;1;4;1;39960;0;0;0;ESTUFA ELECTRICA CUARZO KIOTO 1200W KTE 1033;CLIMATIZACION
15597180;;F;39;CHILENO;;X;N/D;N/D;567480;9;8;-1;2;-144990;10;6;712470;CALIENTACAMA KIOTO DIGITAL 2 PLAZAS KTC-1006;CLIMATIZACION
9889920;;M;58;CHILENO;;Boomers;SAN BERNARDO                  ;METROPOLITANA;9990;1;1;0;0;0;1;1;9990;TERMOVENTILADOR KIOTO NEGRO 2000W KTE-1028N;CLIMATIZACION
19489296;;F;25;CHILENO;;Z;"";"";29990;1;1;1;1;29990;0;0;0;CALIENTACAMA KIOTO DIGITAL 2 PLAZAS KTC-1006;CLIMATIZACION
17091265;;F;33;CHILENO;;Millenial;PROVIDENCIA                   ;METROPOLITANA;8990;1;1;0;0;0;1;1;8990;TERMOVENTILADOR KIOTO BLANCO 2000W KTE-1028B;CLIMATIZACION
10357824;;F;52;CHILENO;;X;N/D;N/D;113555;5;3;0;0;0;5;3;113555;CHIMENEA ELECTRICA KIOTO 2000W KTE-1101;CLIMATIZACION
15625174;;M;36;CHILENO;;Millenial;"";"";316960;4;2;4;2;316960;0;0;0;CALIENTACAMAS ANALOGO BASICO 2 PL;CLIMATIZACION
12787484;Casado;M;47;CHILENO;AGROINDUSTRIA;X;RENCA                         ;METROPOLITANA;19990;1;1;0;0;0;1;1;19990;ESTUFA ELECTRICA CUARZO KIOTO 1200W KTE 1033;CLIMATIZACION
9625309;Casado;F;61;CHILENO;;Boomers;PROVIDENCIA                   ;METROPOLITANA;159990;1;1;0;0;0;1;1;159990;ESTUFA A GAS SINDELEN SR-5250NG;CLIMATIZACION
17974431;;F;30;CHILENO;;Millenial;CALAMA;ANTOFAGASTA;18220;2;1;0;0;0;2;1;18220;TERMOVENTILADOR KIOTO BLANCO 2000W KTE-1028B;CLIMATIZACION
24994822;;M;40;COLOMBIANO;;Extranjero;RECOLETA                      ;METROPOLITANA;212930;7;3;0;0;0;7;3;212930;ESTUFA ELECTRICA CUARZO KIOTO 1200W KTE 1033;CLIMATIZACION
7800437;;F;64;CHILENO;;Boomers;TALCA                         ;MAULE;88910;2;1;0;0;0;2;1;88910;CALIENTACAMAS MANUAL 2N SG-5121D4 2PL;CLIMATIZACION
10360162;;F;45;CHILENO;;X;NATALES                       ;MAGALLANES;22240;2;1;0;0;0;2;1;22240;CALIENTACAMA KIOTO DIGITAL 1 PLAZA KTC-1005;CLIMATIZACION
15160503;Casado;F;40;CHILENO;;X;RENCA                         ;METROPOLITANA;79980;2;2;0;0;0;2;2;79980;ESTUFA ELECTRICA CUARZO KIOTO 1200W KTE 1033;CLIMATIZACION
8024944;;F;63;CHILENO;;Boomers;TALCA                         ;MAULE;513950;5;3;0;0;0;5;3;513950;ESTUFA FOGUITA PRO;CLIMATIZACION
13861165;;F;41;CHILENO;;X;N/D;N/D;29990;1;1;0;0;0;1;1;29990;CALIENTACAMA KIOTO DIGITAL 2 PLAZAS KTC-1006;CLIMATIZACION
14037105;;F;41;CHILENO;;X;PROVIDENCIA                   ;METROPOLITANA;997909;14;7;1;1;249990;13;6;747919;TERMOVENTILADOR KIOTO BLANCO 2000W KTE-1028B;CLIMATIZACION
14281792;Casado;F;47;CHILENO;;X;RENCA                         ;METROPOLITANA;49990;1;1;0;0;0;1;1;49990;TERMOVENTILADOR CALMA IPX1 T2000;CLIMATIZACION
11358830;Soltero;M;53;CHILENO;ADMINISTRADOR PUBLICO;X;PROVIDENCIA                   ;METROPOLITANA;55980;2;2;0;0;0;2;2;55980;MINI OLEOELECTRICA KIOTO 500W NEGRO KTE-1081N;CLIMATIZACION
15430982;;F;40;CHILENO;;X;TALCA                         ;MAULE;92654;10;3;0;0;0;10;3;92654;TERMOVENTILADOR KIOTO BLANCO 2000W KTE-1028B;CLIMATIZACION
8993723;;M;62;CHILENO;;Boomers;TEMUCO                        ;ARAUCANIA;654330;6;4;0;0;0;6;4;654330;ESTUFA GAS EH5200 15K GRAFITO;CLIMATIZACION
7122655;Viudo;M;67;CHILENO;;Boomers;RANCAGUA                      ;L.G.B.OÂ´HIGGINS;79980;2;1;0;0;0;2;1;79980;TERMOVENTILADOR CERAMICO TH-CH41 NG 1000W-2000W;CLIMATIZACION
10056432;;F;50;CHILENO;;X;RENCA                         ;METROPOLITANA;29990;1;1;0;0;0;1;1;29990;CALIENTACAMA KIOTO DIGITAL 2 PLAZAS KTC-1006;CLIMATIZACION
14470151;;M;48;CHILENO;;X;TALAGANTE                     ;METROPOLITANA;536820;5;2;0;0;0;5;2;536820;ESTUFA HIBRIDA SR-6300NG;CLIMATIZACION
6492724;;M;67;CHILENO;;Boomers;RENCA                         ;METROPOLITANA;8990;1;1;0;0;0;1;1;8990;TERMOVENTILADOR KIOTO BLANCO 2000W KTE-1028B;CLIMATIZACION
14020950;;M;40;CHILENO;;X;SAN JAVIER                    ;MAULE;20000;2;1;0;0;0;2;1;20000;ESTUFA ELECTRICA CUARZO KIOTO 1200W KTE 1033;CLIMATIZACION
8674460;;F;64;CHILENO;;Boomers;RENCA                         ;METROPOLITANA;69990;1;1;1;1;69990;0;0;0;CHIMENEA ELECTRICA KIOTO 2000W KTE-1101;CLIMATIZACION
8036494;;M;65;CHILENO;;Boomers;RECOLETA                      ;METROPOLITANA;237970;3;5;0;0;0;3;5;237970;ESTUFA FIAMMA PRO;CLIMATIZACION
18177344;;F;30;CHILENO;;Millenial;PROVIDENCIA                   ;METROPOLITANA;77980;2;2;0;0;0;2;2;77980;CALIENTACAMA KIOTO DIGITAL 2 PLAZAS KTC-1006;CLIMATIZACION
11957753;;F;49;CHILENO;;X;N/D;N/D;213960;4;3;0;0;0;4;3;213960;CALIENTACAMA KIOTO ANALOGO 1 PLAZA KTC-1004;CLIMATIZACION
20170988;;M;22;CHILENO;;Z;N/D;N/D;132950;5;3;2;1;73980;3;2;58970;CALIENTACAMA KIOTO DIGITAL 2 PLAZAS KTC-1006;CLIMATIZACION
7308549;;F;72;CHILENO;;Silencioso;PADRE LAS CASAS               ;ARAUCANIA;139990;1;1;0;0;0;1;1;139990;ESTUFA GAS EH2500 5K NEGRO;CLIMATIZACION
14509530;;F;49;CHILENO;;X;LINARES                       ;MAULE;9990;1;1;0;0;0;1;1;9990;ESTUFA CUARZO KIOTO 800W KTE-011A;CLIMATIZACION
7602505;;F;73;CHILENO;;Silencioso;PROVIDENCIA                   ;METROPOLITANA;0;0;2;0;0;0;0;2;0;ESTUFA A GAS UT GRX-4200 15 KILOS;CLIMATIZACION
10965202;;F;57;CHILENO;;Boomers;TEMUCO                        ;ARAUCANIA;59990;1;1;0;0;0;1;1;59990;CONVECTOR UT N10;CLIMATIZACION
12384676;;F;51;CHILENO;;X;TUCAPEL                       ;BIO BIO;26990;1;1;0;0;0;1;1;26990;CALEFACTOR CARBONO 800W EEC-3000 NEGRO;CLIMATIZACION
13459748;;F;44;CHILENO;;X;RENCA                         ;METROPOLITANA;0;0;2;0;0;0;0;2;0;CALIENTACAMAS MANUAL 3N SG-5010 1PL;CLIMATIZACION
15825922;;F;38;CHILENO;;Millenial;PARRAL                        ;MAULE;534399;6;3;0;0;0;6;3;534399;ESTUFA FIBRA DE CARBONO KFC 90 - NEGRA ROJA;CLIMATIZACION
16513209;;F;35;CHILENO;;Millenial;PROVIDENCIA                   ;METROPOLITANA;9990;1;1;1;1;9990;0;0;0;TERMOVENTILADOR KIOTO NEGRO 2000W KTE-1028N;CLIMATIZACION
6147104;;M;71;CHILENO;;Silencioso;N/D;N/D;17220;2;1;0;0;0;2;1;17220;TERMOVENTILADOR KIOTO NEGRO 2000W KTE-1028N;CLIMATIZACION
26753415;;M;35;HAITIANO;;Extranjero;CURICO                        ;MAULE;678309;6;3;0;0;0;6;3;678309;Calefactor Halogeno Ha-10T 1000W;CLIMATIZACION
12522317;;F;48;CHILENO;;X;TALCA                         ;MAULE;36981;2;2;0;0;0;2;2;36981;ESTUFA ELECTRICA CUARZO KIOTO 1200W KTE 1033;CLIMATIZACION
18390966;;M;29;CHILENO;;Millenial;MAIPU                         ;METROPOLITANA;108960;4;3;0;0;0;4;3;108960;TERMOVENTILADOR CURVE BLACK;CLIMATIZACION
17292804;;F;32;CHILENO;;Millenial;RENCA                         ;METROPOLITANA;19990;1;1;0;0;0;1;1;19990;ESTUFA ELECTRICA CUARZO KIOTO 1200W KTE 1033;CLIMATIZACION
5989365;;F;77;CHILENO;;Silencioso;RENGO                         ;L.G.B.OÂ´HIGGINS;114560;3;3;0;0;0;3;3;114560;CHIMENEA ELECTRICA KIOTO 2000W KTE-1101;CLIMATIZACION
25733621;Soltero;M;35;VENEZOLANO;;Extranjero;PROVIDENCIA                   ;METROPOLITANA;21970;3;1;3;1;21970;0;0;0;TERMOVENTILADOR KIOTO NEGRO 2000W KTE-1028N;CLIMATIZACION
12098485;;M;48;CHILENO;;X;RENCA                         ;METROPOLITANA;62980;2;1;0;0;0;2;1;62980;ESTUFA FIBRA DE CARBONO KFC 90 - NEGRA ROJA;CLIMATIZACION
17886540;;M;30;CHILENO;;Millenial;PROVIDENCIA                   ;METROPOLITANA;79990;1;1;0;0;0;1;1;79990;CHIMENEA ELECTRICA KIOTO 2000W KTE-1101;CLIMATIZACION
20103446;;F;23;CHILENO;;Z;PROVIDENCIA                   ;METROPOLITANA;354263;6;4;0;0;0;6;4;354263;ESTUFA ELECTRICA CUARZO KIOTO 1200W KTE 1033;CLIMATIZACION
11379392;Casado;F;53;CHILENO;ENFERMERA;X;RENCA                         ;METROPOLITANA;21980;2;1;0;0;0;2;1;21980;TERMOVENTILADOR KIOTO NEGRO 2000W KTE-1028N;CLIMATIZACION
6778672;Casado;F;71;CHILENO;;Silencioso;CAUQUENES                     ;MAULE;59982;3;2;0;0;0;3;2;59982;CALIENTACAMA KIOTO DIGITAL 2 PLAZAS KTC-1006;CLIMATIZACION
4053861;;M;80;CHILENO;;Silencioso;NATALES                       ;MAGALLANES;27990;1;1;0;0;0;1;1;27990;MINI OLEOELECTRICA KIOTO 500W BLANCO KTE-1081B;CLIMATIZACION
9828789;;F;59;CHILENO;;Boomers;PROVIDENCIA                   ;METROPOLITANA;86960;4;3;0;0;0;4;3;86960;CALIENTACAMA KIOTO DIGITAL 2 PLAZAS KTC-1006;CLIMATIZACION
5309198;;F;80;CHILENO;;Silencioso;TEMUCO                        ;ARAUCANIA;170000;2;1;0;0;0;2;1;170000;ESTUFA GAS SR-6250NG;CLIMATIZACION
14022337;;F;41;CHILENO;;X;N/D;N/D;9990;1;1;0;0;0;1;1;9990;CALIENTACAMA KIOTO DIGITAL 1 PLAZA KTC-1005;CLIMATIZACION
19955020;;F;24;CHILENO;;Z;N/D;N/D;130980;2;1;2;1;130980;0;0;0;ESTUFA FIAMMA PRO;CLIMATIZACION
13216443;;F;45;CHILENO;;X;ANTOFAGASTA                   ;ANTOFAGASTA;272480;2;1;2;1;272480;0;0;0;ESTUFA ELEC. CHIMENEA TH-FP100 CAFE 1000W-2000W;CLIMATIZACION
23404711;;F;29;CHILENO;;Extranjero;PROVIDENCIA                   ;METROPOLITANA;19980;2;2;1;1;9990;1;1;9990;ESTUFA CUARZO KIOTO 800W KTE-011A;CLIMATIZACION
19136281;;M;26;CHILENO;;Z;PROVIDENCIA                   ;METROPOLITANA;1384580;7;3;7;3;1384580;0;0;0;ESTUFA PARAFINA KPM-23;CLIMATIZACION
17002080;;M;34;CHILENO;;Millenial;CURICO                        ;MAULE;17980;2;1;0;0;0;2;1;17980;TERMOVENTILADOR KIOTO BLANCO 2000W KTE-1028B;CLIMATIZACION
13153084;;M;45;CHILENO;;Silencioso;PROVIDENCIA                   ;METROPOLITANA;160980;2;1;2;1;160980;0;0;0;ESTUFA PARAFINA KPM-23;CLIMATIZACION
5659937;;F;74;CHILENO;;Silencioso;CONCEPCION                    ;BIO BIO;505800;7;4;0;0;0;7;4;505800;ESTUFA GAS KGQ15N 15K NEGRO EUROPEA;CLIMATIZACION
16859493;;M;34;CHILENO;;Millenial;"";"";14990;1;1;1;1;14990;0;0;0;CALIENTACAMA KIOTO ANALOGO 1 PLAZA KTC-1004;CLIMATIZACION
19069436;Soltero;F;26;CHILENO;;Z;"";"";12990;1;1;1;1;12990;0;0;0;TERMOVENTILADOR KIOTO NEGRO 2000W KTE-1028N;CLIMATIZACION
13237129;;M;45;CHILENO;;X;N/D;N/D;19980;2;1;2;1;19980;0;0;0;ESTUFA CUARZO KIOTO 800W KTE-011A;CLIMATIZACION
14055351;;M;41;CHILENO;;X;PAINE                         ;METROPOLITANA;69980;3;4;0;0;0;3;4;69980;CALIENTACAMA KIOTO DIGITAL 2 PLAZAS KTC-1006;CLIMATIZACION
20324549;;F;21;CHILENO;;Z;PROVIDENCIA                   ;METROPOLITANA;8990;1;1;1;1;8990;0;0;0;TERMOVENTILADOR KIOTO NEGRO 2000W KTE-1028N;CLIMATIZACION
19679888;;F;25;CHILENO;;Z;PROVIDENCIA                   ;METROPOLITANA;9990;1;1;0;0;0;1;1;9990;TERMOVENTILADOR KIOTO NEGRO 2000W KTE-1028N;CLIMATIZACION
17871664;;F;31;CHILENO;;Millenial;PROVIDENCIA                   ;METROPOLITANA;19990;1;1;0;0;0;1;1;19990;TURBO CALEFACTOR VERT. TC-2100V BLANCO;CLIMATIZACION
17081224;;F;34;CHILENO;;Millenial;PROVIDENCIA                   ;METROPOLITANA;249971;4;3;0;0;0;4;3;249971;TERMOVENTILADOR CERAMICO TH-CH41 NG 1000W-2000W;CLIMATIZACION
16992351;;M;33;CHILENO;;Millenial;PROVIDENCIA                   ;METROPOLITANA;29990;1;1;1;1;29990;0;0;0;CALIENTACAMA KIOTO DIGITAL 2 PLAZAS KTC-1006;CLIMATIZACION
6894996;Soltero;F;74;CHILENO;;Silencioso;PROVIDENCIA                   ;METROPOLITANA;14990;1;1;0;0;0;1;1;14990;TURBO CALEFACTOR VERT. TC-2070V BLANCO;CLIMATIZACION
15393196;;F;40;CHILENO;;X;SAN RAMON                     ;METROPOLITANA;232930;7;3;7;3;232930;0;0;0;CALIENTACAMA KIOTO DIGITAL 1 PLAZA KTC-1005;CLIMATIZACION
5456938;;M;75;CHILENO;;Silencioso;SAN JAVIER                    ;MAULE;159990;1;1;0;0;0;1;1;159990;ESTUFA ELEC. CHIMENEA TH-FP70 NG 1000W-2000W;CLIMATIZACION
16366079;;F;35;CHILENO;;Millenial;PROVIDENCIA                   ;METROPOLITANA;63960;4;4;4;2;178960;0;2;-115000;TERMOVENTILADOR TH-FH30 BLANCO 1000W-2000W;CLIMATIZACION
8592916;;M;62;CHILENO;;Boomers;COIHAIQUE                     ;AYSEN;299970;3;2;0;0;0;3;2;299970;ESTUFA ELEC. FIBRA DE CARBONO NSB120K5 ROJA;CLIMATIZACION
20137865;;M;22;CHILENO;;Z;ISLA DE MAIPO                 ;METROPOLITANA;311980;2;2;0;0;0;2;2;311980;Termoventilador Ht 2014 R;CLIMATIZACION
16377396;;M;35;CHILENO;;Millenial;CURICO                        ;MAULE;159990;1;1;0;0;0;1;1;159990;ESTUFA FIAMMA PRO;CLIMATIZACION
16995870;;M;33;CHILENO;;Millenial;CAUQUENES                     ;MAULE;12990;1;1;0;0;0;1;1;12990;CALIENTACAMA KIOTO ANALOGO 1 PLAZA KTC-1004;CLIMATIZACION
9657020;Soltero;M;59;CHILENO;TECNICO;Boomers;RENCA                         ;METROPOLITANA;36990;1;1;0;0;0;1;1;36990;CALIENTACAMAS ANALOGO BASICO 1PL;CLIMATIZACION
17347253;;F;32;CHILENO;;Millenial;PROVIDENCIA                   ;METROPOLITANA;73960;4;4;1;1;269990;3;3;-196030;TURBO CALEFACTOR VERT. TC-2070V BLANCO;CLIMATIZACION
9475582;;F;61;CHILENO;;Boomers;MAIPU                         ;METROPOLITANA;18990;1;1;1;1;18990;0;0;0;CALEFACTOR HALOGENO 1200W EEH-1210 GRIS;CLIMATIZACION
12826723;;F;46;CHILENO;;X;CARTAGENA                     ;VALPARAISO;9990;1;1;0;0;0;1;1;9990;TERMOVENTILADOR KIOTO NEGRO 2000W KTE-1028N;CLIMATIZACION
16168647;;F;36;CHILENO;;Millenial;CONCEPCION                    ;BIO BIO;339980;2;2;0;0;0;2;2;339980;ESTUFA HIBRIDA SR-6300NG;CLIMATIZACION
17687367;;M;31;CHILENO;;Millenial;N/D;N/D;294980;2;2;0;0;0;2;2;294980;ESTUFA INFRARROJA ELECTRICA KIOTO 1500W KTE-1045;CLIMATIZACION
5347044;;F;78;CHILENO;;Silencioso;SAN BERNARDO                  ;METROPOLITANA;505960;4;2;0;0;0;4;2;505960;Termoventilador 2000W Ht 2018;CLIMATIZACION
6885033;;F;58;CHILENO;;Boomers;RENCA                         ;METROPOLITANA;110970;3;1;0;0;0;3;1;110970;CALIENTACAMAS ANALOGO BASICO 1PL;CLIMATIZACION
14503504;;F;46;CHILENO;;X;PUDAHUEL                      ;METROPOLITANA;430040;5;3;0;0;0;5;3;430040;ESTUFA FOGUITA PRO;CLIMATIZACION
15949524;;M;37;CHILENO;;Millenial;RENCA                         ;METROPOLITANA;16990;1;1;1;1;16990;0;0;0;CALIENTACAMA KIOTO DIGITAL 1 PLAZA KTC-1005;CLIMATIZACION
13778302;;F;42;CHILENO;;X;RENGO                         ;L.G.B.OÂ´HIGGINS;64990;1;1;0;0;0;1;1;64990;ESTUFA ELEC. FIBRA DE CARBONO NSB120K5 ROJA;CLIMATIZACION
18107124;;M;30;CHILENO;;Millenial;PROVIDENCIA                   ;METROPOLITANA;69990;1;1;0;0;0;1;1;69990;CHIMENEA ELECTRICA KIOTO 2000W KTE-1101;CLIMATIZACION
15898553;;M;38;CHILENO;;Millenial;MELIPILLA;METROPOLITANA;24990;1;1;0;0;0;1;1;24990;TERMOVENTILADOR NICROM VFH500 BL 2000W;CLIMATIZACION
15583370;;F;39;CHILENO;;X;PAINE                         ;METROPOLITANA;297560;6;4;0;0;0;6;4;297560;TERMOVENTILADOR KFH-18 BL 2000W;CLIMATIZACION
15333944;;F;46;CHILENO;;Millenial;PROVIDENCIA                   ;METROPOLITANA;14990;1;1;0;0;0;1;1;14990;TURBO CALEFACTOR VERT. TC-2070V BLANCO;CLIMATIZACION
15786054;;F;38;CHILENO;;Millenial;ISLA DE MAIPO                 ;METROPOLITANA;90040;-4;5;3;2;152970;-7;3;-62930;ESTUFA KEROSENE F 1120+;CLIMATIZACION
19465053;;F;25;CHILENO;;Z;"";"";21990;1;1;0;0;0;1;1;21990;Termoventilador Ht 2014 R;CLIMATIZACION
17838073;Soltero;M;31;CHILENO;;Millenial;N/D;N/D;424980;2;2;1;1;399990;1;1;24990;Termoventilador Ht 2014 R;CLIMATIZACION
15520170;;F;33;CHILENO;;Millenial;PROVIDENCIA                   ;METROPOLITANA;195980;2;1;2;1;195980;0;0;0;ESTUFA A GAS SUNNY CLASSIC WOOD 6600 NEGRA;CLIMATIZACION
15126614;;F;38;CHILENO;;Millenial;N/D;N/D;66970;3;1;3;1;66970;0;0;0;CALIENTACAMAS ANALOGO BASICO 1PL;CLIMATIZACION
10298707;;F;58;CHILENO;;Boomers;COLTAUCO                      ;L.G.B.OÂ´HIGGINS;435020;7;4;0;0;0;7;4;435020;ESTUFA GAS KGQ15N 15K NEGRO EUROPEA;CLIMATIZACION
5208218;;F;78;CHILENO;;Silencioso;RENCA                         ;METROPOLITANA;25160;2;1;0;0;0;2;1;25160;TURBO CALEFACTOR VERT. TC-2070V BLANCO;CLIMATIZACION
18631401;;F;28;CHILENO;;Millenial;VILLARICA                     ;ARAUCANIA;38990;1;1;0;0;0;1;1;38990;CALIENTACAMA KIOTO DIGITAL 2 PLAZAS KTC-1006;CLIMATIZACION
18987069;;F;27;CHILENO;;Z;PROVIDENCIA                   ;METROPOLITANA;14990;1;1;1;1;14990;0;0;0;CALIENTACAMA KIOTO ANALOGO 1 PLAZA KTC-1004;CLIMATIZACION
20511805;;F;21;CHILENO;;Z;PROVIDENCIA                   ;METROPOLITANA;130980;2;1;2;1;130980;0;0;0;KIT INSTALACION VERTICAL 6X4MTS ACERO;CLIMATIZACION
19414084;;F;25;CHILENO;;Z;TEMUCO                        ;ARAUCANIA;18990;1;1;0;0;0;1;1;18990;TERMOVENTILADOR KFH-18 BL 2000W;CLIMATIZACION
18414960;;F;29;CHILENO;;Millenial;SAN PEDRO DE LA PAZ           ;BIO BIO;9980;2;3;2;3;9980;0;0;0;ESTUFA CUARZO KIOTO 800W KTE-011A;CLIMATIZACION
7321617;;F;67;CHILENO;;Boomers;N/D;N/D;89860;3;2;0;0;0;3;2;89860;VENTILADOR PEDESTAL KTP-1015;CLIMATIZACION
18603682;;M;29;CHILENO;;Millenial;"";"";64990;1;1;0;0;0;1;1;64990;VENTILADOR 18 PLG CP 18 GUN METAL C/ SOPORTE;CLIMATIZACION
19239470;;F;26;CHILENO;;Z;MAIPU                         ;METROPOLITANA;182960;4;2;2;1;133980;2;1;48980;VENTILADOR PEDESTAL KTP-1015;CLIMATIZACION
13332350;;F;43;CHILENO;;X;RENCA                         ;METROPOLITANA;59990;1;1;0;0;0;1;1;59990;VENTILADOR THOMAS TH-16CP Pedestal 16;CLIMATIZACION
26607546;;F;28;EXTRANJERO - NO INFORMA NACIONALIDAD;;Extranjero;N/D;N/D;304772;3;2;2;1;303980;1;1;792;AC PORTATIL ECO III 12000;CLIMATIZACION
17690235;;M;33;CHILENO;;Millenial;N/D;N/D;94980;2;2;0;0;0;2;2;94980;VENTILADOR PEDESTAL KTP-1015;CLIMATIZACION
16966388;;F;33;CHILENO;;Millenial;N/D;N/D;25592;1;1;0;0;0;1;1;25592;VENTILADOR PEDESTAL KTP-1015;CLIMATIZACION
17091105;;F;33;CHILENO;;Millenial;PROVIDENCIA                   ;METROPOLITANA;31990;1;1;0;0;0;1;1;31990;VENTILADOR PEDESTAL KTP-1015;CLIMATIZACION
18974042;;F;27;CHILENO;;Z;N/D;N/D;34990;1;1;0;0;0;1;1;34990;VENTILADOR PEDESTAL KTP-1015;CLIMATIZACION
15676301;;F;35;CHILENO;;Millenial;CHIMBARONGO                   ;L.G.B.OÂ´HIGGINS;244950;5;4;0;0;0;5;4;244950;VENTILADOR PEDESTAL KTP-1015;CLIMATIZACION
18616729;;M;28;CHILENO;;Millenial;PALMILLA                      ;L.G.B.OÂ´HIGGINS;19990;1;1;0;0;0;1;1;19990;Ventilador Sobremesa Plastico KF 12D;CLIMATIZACION
10190993;;M;57;CHILENO;;Boomers;CALBUCO                       ;LOS LAGOS;79980;3;2;0;0;0;3;2;79980;VENTILADOR PEDESTAL KTP-1016;CLIMATIZACION
16011269;Casado;M;37;CHILENO;PROFESOR;Millenial;RENCA                         ;METROPOLITANA;0;0;2;0;2;0;0;0;0;ESTUFA CUARZO KIOTO 800W KTE-011A;CLIMATIZACION
21954884;;F;43;PERUANO;;Extranjero;SAN BERNARDO                  ;METROPOLITANA;258350;4;2;0;0;0;4;2;258350;Ventilador Sobremesa Plastico KF 12D;CLIMATIZACION
26324368;;M;33;COLOMBIANO;;Extranjero;PROVIDENCIA                   ;METROPOLITANA;54990;1;1;0;0;0;1;1;54990;Ventilador BOX 20 Metalico FE-45 20Â¿;CLIMATIZACION
7700850;;F;67;CHILENO;;Boomers;VICTORIA                      ;ARAUCANIA;59980;2;2;0;0;0;2;2;59980;VENTILADOR PEDESTAL KTP-1015;CLIMATIZACION
7608102;;F;69;CHILENO;;Silencioso;TALCAHUANO                    ;BIO BIO;29990;1;1;0;0;0;1;1;29990;VENTILADOR PEDESTAL KTP-1015;CLIMATIZACION
9436533;;F;59;CHILENO;;Boomers;CARAHUE                       ;ARAUCANIA;24990;1;1;0;0;0;1;1;24990;VENTILADOR PEDESTAL KTP-1015;CLIMATIZACION
12529203;;M;48;CHILENO;;X;LOS ANGELES                   ;BIO BIO;94980;2;2;1;1;69990;1;1;24990;VENTILADOR PEDESTAL KTP-1016;CLIMATIZACION
11783938;;F;51;CHILENO;;X;ILLAPEL                       ;COQUIMBO;34990;1;1;0;0;0;1;1;34990;VENTILADOR PEDESTAL KTP-1015;CLIMATIZACION
8742868;;M;60;CHILENO;;Boomers;SANTA MARIA                   ;VALPARAISO;34990;1;1;0;0;0;1;1;34990;VENTILADOR PEDESTAL KTP-1015;CLIMATIZACION
26147584;;M;48;VENEZOLANO;;Extranjero;"";"";659810;5;5;5;5;659810;0;0;0;VENTILADOR PEDESTAL KTP-1015;CLIMATIZACION
19274302;;M;26;CHILENO;;Z;PROVIDENCIA                   ;METROPOLITANA;201090;3;3;3;3;201090;0;0;0;V-VENTILADOR PEDESTAL 16 AIROLITE;CLIMATIZACION
15534905;Soltero;M;39;CHILENO;;X;PROVIDENCIA                   ;METROPOLITANA;319990;2;1;2;1;319990;0;0;0;A/C FRIO/CALOR PORTATIL 12000BTU;CLIMATIZACION
18973259;;F;27;CHILENO;;Z;PUTAENDO;VALPARAISO;24990;1;1;0;0;0;1;1;24990;VENTILADOR PEDESTAL KTP-1015;CLIMATIZACION
13201311;;M;45;CHILENO;;X;SAN FERNANDO                  ;L.G.B.OÂ´HIGGINS;29990;1;1;0;0;0;1;1;29990;VENTILADOR PEDESTAL KTP-1015;CLIMATIZACION
17640956;Soltero;M;31;CHILENO;;Silencioso;PROVIDENCIA                   ;METROPOLITANA;33980;2;1;2;1;33980;0;0;0;VENTILADOR THOMAS TH-08NM;CLIMATIZACION
20178953;;F;22;CHILENO;;Z;PROVIDENCIA                   ;METROPOLITANA;28540;2;1;2;1;28540;0;0;0;VENTILADOR DE PEDESTAL F804;CLIMATIZACION
13671126;Soltero;M;43;CHILENO;;Millenial;PROVIDENCIA                   ;METROPOLITANA;223980;2;1;2;1;223980;0;0;0;AIRE AC. PORTATIL FRIO 7000BTU/H GRIS;CLIMATIZACION
7140860;;F;69;CHILENO;;Silencioso;VALLENAR;ATACAMA;228970;3;2;0;0;0;3;2;228970;VENTILADOR PEDESTAL16 PLG MODELO CPE 160 3 EN 1;CLIMATIZACION
8907501;Soltero;M;49;CHILENO;;X;PROVIDENCIA                   ;METROPOLITANA;8990;1;1;0;0;0;1;1;8990;CALIENTACAMA KIOTO ANALOGO 1 PLAZA KTC-1004;CLIMATIZACION
18902512;Soltero;M;27;CHILENO;TECNICO DE NIVEL SUPERIOR EN ENFERMERIA;Z;PROVIDENCIA                   ;METROPOLITANA;25570;2;1;0;0;0;2;1;25570;CALIENTACAMA KIOTO DIGITAL 2 PLAZAS KTC-1006;CLIMATIZACION
5969066;;F;68;CHILENO;;Silencioso;RANCAGUA                      ;L.G.B.OÂ´HIGGINS;4990;1;1;0;0;0;1;1;4990;CIRCULADOR DE AIRE VORTEX RC 12P;CLIMATIZACION
12371950;;F;49;CHILENO;;X;SAN JAVIER                    ;MAULE;40670;2;1;0;0;0;2;1;40670;VENTILADOR DE TORRE 301M;CLIMATIZACION
18229969;;F;30;CHILENO;;Millenial;LOS ALAMOS                    ;BIO BIO;29990;1;1;0;0;0;1;1;29990;VENTILADOR INDUSTRIAL KTI-1013;CLIMATIZACION
12252662;;M;50;CHILENO;;X;SANTIAGO                      ;METROPOLITANA;77560;3;1;0;0;0;3;1;77560;Ventilador BOX 20 Metalico FE-45 20Â¿;CLIMATIZACION
7028932;;M;65;CHILENO;;Boomers;PROVIDENCIA                   ;METROPOLITANA;319990;1;1;0;0;0;1;1;319990;AIRE AC. PORTATIL FRIO 7000BTU/H GRIS;CLIMATIZACION
10084596;;F;59;CHILENO;;Boomers;QUILPUE                       ;VALPARAISO;11593;1;1;0;0;0;1;1;11593;VENTILADOR PEDESTAL KTP-1015;CLIMATIZACION
12468176;;F;49;CHILENO;;X;LA FLORIDA;METROPOLITANA;471960;3;1;3;1;471960;0;0;0;CALEFACTOR BOSCA LIMIT 360;CLIMATIZACION
13257776;;M;44;CHILENO;;X;N/D;N/D;383980;2;1;2;1;383980;0;0;0;AC EVA II 12000 WIFI;CLIMATIZACION
12062419;Soltero;F;65;CHILENO;;Boomers;RENCA                         ;METROPOLITANA;129960;4;2;0;0;0;4;2;129960;VENTILADOR INDUSTRIAL KTI-1013;CLIMATIZACION
18292253;;M;29;CHILENO;;Silencioso;PROVIDENCIA                   ;METROPOLITANA;343980;2;1;2;1;343980;0;0;0;CALEFACTOR LENA SCANTEK360 GRIS CHARCOAL;CLIMATIZACION
19320002;;F;26;CHILENO;;Z;PROVIDENCIA                   ;METROPOLITANA;8990;1;1;0;0;0;1;1;8990;TERMOVENTILADOR KIOTO NEGRO 2000W KTE-1028N;CLIMATIZACION
9417935;;M;59;CHILENO;;Boomers;LEBU                          ;BIO BIO;56670;2;1;0;0;0;2;1;56670;CHIMENEA ELECTRICA KIOTO 2000W KTE-1101;CLIMATIZACION
15548251;;F;39;CHILENO;;Extranjero;RENCA                         ;METROPOLITANA;-16990;-1;1;-1;1;-16990;0;0;0;MINI OLEOELECTRICA KIOTO 500W BLANCO KTE-1081B;CLIMATIZACION
15703119;;F;38;CHILENO;;X;PROVIDENCIA                   ;METROPOLITANA;0;0;2;0;2;0;0;0;0;ESTUFA CUARZO KIOTO 800W KTE-011A;CLIMATIZACION
19528828;;F;25;CHILENO;;Silencioso;PROVIDENCIA                   ;METROPOLITANA;0;0;0;0;0;0;0;0;0;CALIENTACAMAS ANALOGO BASICO 2 PL;CLIMATIZACION
17412354;;F;32;CHILENO;;Millenial;PROVIDENCIA                   ;METROPOLITANA;0;0;0;0;0;0;0;0;0;CALIENTACAMA KIOTO DIGITAL 2 PLAZAS KTC-1006;CLIMATIZACION
20239347;;F;23;CHILENO;;Z;TALAGANTE;METROPOLITANA;0;0;0;0;0;0;0;0;0;PRODUCTO 2A CLIMATIZACION BANDA 3;CLIMATIZACION
13578156;;F;43;CHILENO;;X;N/D;N/D;0;0;0;0;0;0;0;0;0;ESTUFA CUARZO KIOTO 800W KTE-011A;CLIMATIZACION
17123052;;F;35;CHILENO;;Millenial;N/D;N/D;0;0;0;0;0;0;0;0;0;CALIENTACAMA KIOTO DIGITAL 1 PLAZA KTC-1005;CLIMATIZACION
10402600;Casado;F;55;CHILENO;;Boomers;RENCA                         ;METROPOLITANA;0;0;0;0;0;0;0;0;0;CALIENTACAMA KIOTO DIGITAL 2 PLAZAS KTC-1006;CLIMATIZACION
15658703;;F;45;CHILENO;;X;CANETE                        ;BIO BIO;0;0;0;0;0;0;0;0;0;CALIENTACAMA KIOTO DIGITAL 2 PLAZAS KTC-1006;CLIMATIZACION
15758042;;F;38;CHILENO;;Millenial;COIHAIQUE                     ;AYSEN;0;0;0;0;0;0;0;0;0;ESTUFA ELECTRICA CUARZO KIOTO 1200W KTE 1033;CLIMATIZACION
17560251;;F;31;CHILENO;;Millenial;PROVIDENCIA                   ;METROPOLITANA;0;0;0;0;0;0;0;0;0;CALIENTACAMAS ANALOGO BASICO 2 PL;CLIMATIZACION
8705024;;F;62;CHILENO;;Boomers;VALLENAR;ATACAMA;0;0;0;0;0;0;0;0;0;CALIENTACAMA KIOTO ANALOGO 1 PLAZA KTC-1004;CLIMATIZACION
10155963;;F;59;CHILENO;;Boomers;CABILDO                       ;VALPARAISO;0;0;0;0;0;0;0;0;0;CONVECTOR VC 1800 1750 WATT GRIS/BLANCO;CLIMATIZACION
16194505;;F;38;CHILENO;;Millenial;N/D;N/D;0;0;0;0;0;0;0;0;0;CHIMENEA ELECTRICA KIOTO 2000W KTE-1101;CLIMATIZACION
12652628;;F;48;CHILENO;;Silencioso;PROVIDENCIA                   ;METROPOLITANA;0;0;0;0;0;0;0;0;0;ESTUFA RADIADOR OL OLEOELECTRICO RD 1500;CLIMATIZACION
19315703;Soltero;F;26;CHILENO;TECNICO DE NIVEL MEDIO EN ALIMENTACION;Z;PROVIDENCIA                   ;METROPOLITANA;0;0;0;0;0;0;0;0;0;TERMOVENTILADOR CERAMICO HTC 2013 OSCILANTE;CLIMATIZACION
18777129;;F;28;CHILENO;;Silencioso;PROVIDENCIA                   ;METROPOLITANA;0;0;0;0;0;0;0;0;0;ESTUFA ELECTRICA CUARZO KIOTO 1200W KTE 1033;CLIMATIZACION
10831212;;F;53;CHILENO;;X;N/D;N/D;0;0;0;0;0;0;0;0;0;TERMOVENTILADOR VERTICAL MOD. FH 403;CLIMATIZACION
7580799;;M;64;CHILENO;;Silencioso;PROVIDENCIA                   ;METROPOLITANA;0;0;0;0;0;0;0;0;0;CALIENTACAMA KIOTO ANALOGO 1 PLAZA KTC-1004;CLIMATIZACION
17058499;;F;33;CHILENO;;Millenial;PROVIDENCIA                   ;METROPOLITANA;0;0;0;0;0;0;0;0;0;TERMOVENTILADOR KIOTO NEGRO 2000W KTE-1028N;CLIMATIZACION
13268411;;M;44;CHILENO;;X;PROVIDENCIA                   ;METROPOLITANA;0;0;0;0;0;0;0;0;0;TERMOVENTILADOR KIOTO BLANCO 2000W KTE-1028B;CLIMATIZACION
15532420;;F;38;CHILENO;;Millenial;SANTA CRUZ                    ;L.G.B.OÂ´HIGGINS;0;0;0;0;0;0;0;0;0;CALIENTACAMAS DIGITAL TIMER SG-5150 1PL;CLIMATIZACION
13865438;;M;44;CHILENO;;X;COPIAPO                       ;ATACAMA;0;0;0;0;0;0;0;0;0;CALIENTACAMAS ANALOGO BASICO 1PL;CLIMATIZACION
7482486;Casado;M;67;CHILENO;;Boomers;N/D;N/D;0;0;0;0;0;0;0;0;0;CONVECTOR TURBO KCH 2000 BL;CLIMATIZACION
15617337;;F;39;CHILENO;;X;PROVIDENCIA                   ;METROPOLITANA;0;0;0;0;0;0;0;0;0;CALIENTACAMA KIOTO DIGITAL 2 PLAZAS KTC-1006;CLIMATIZACION
7753492;;M;66;CHILENO;;Boomers;RENCA                         ;METROPOLITANA;0;0;0;0;0;0;0;0;0;TERMOVENTILADOR NICROM VFH300 BL 1800W;CLIMATIZACION
9997851;;M;55;CHILENO;;Boomers;RENCA                         ;METROPOLITANA;0;0;0;0;0;0;0;0;0;CALIENTACAMA KIOTO DIGITAL 2 PLAZAS KTC-1006;CLIMATIZACION
17745958;Casado;F;31;CHILENO;INGENIERO COMERCIAL;Millenial;PROVIDENCIA                   ;METROPOLITANA;0;0;0;0;0;0;0;0;0;KIT INSTALACION PLUS 6PULGADAS ACERO;CLIMATIZACION
5966788;Viudo;F;74;CHILENO;;Silencioso;SAN CARLOS                    ;BIO BIO;0;0;0;0;0;0;0;0;0;ESTUFA CUARZO KIOTO 800W KTE-011A;CLIMATIZACION
7002337;Casado;M;66;CHILENO;;Boomers;RENCA                         ;METROPOLITANA;0;0;0;0;0;0;0;0;0;TERMOVENTILADOR KIOTO BLANCO 2000W KTE-1028B;CLIMATIZACION
15168226;Soltero;M;40;CHILENO;INGENIERO ACUICOLA;X;RENCA                         ;METROPOLITANA;0;0;0;0;0;0;0;0;0;CALIENTACAMA KIOTO DIGITAL 2 PLAZAS KTC-1006;CLIMATIZACION
6036084;;F;69;CHILENO;;Silencioso;RENCA                         ;METROPOLITANA;0;0;0;0;0;0;0;0;0;CALIENTACAMAS ANALOGO 1PL;CLIMATIZACION
18236027;Soltero;M;30;CHILENO;;Millenial;PROVIDENCIA                   ;METROPOLITANA;0;0;0;0;0;0;0;0;0;ESTUFA A GAS UT GRX-6200 ET ROJA 15 KILOS;CLIMATIZACION
16242060;;F;36;CHILENO;;Millenial;PROVIDENCIA                   ;METROPOLITANA;0;0;0;0;0;0;0;0;0;TERMOVENTILADOR VERTICAL SUN05 PURP.;CLIMATIZACION
12572976;;F;47;CHILENO;;X;MONTE PATRIA                  ;COQUIMBO;0;0;0;0;0;0;0;0;0;ESTUFA CUARZO KIOTO 800W KTE-011A;CLIMATIZACION
8305648;;F;61;CHILENO;;Boomers;N/D;N/D;0;0;0;0;0;0;0;0;0;ESTUFA INFRAROJA TH-IR60;CLIMATIZACION
12446378;;F;49;CHILENO;;X;RENCA                         ;METROPOLITANA;0;0;0;0;0;0;0;0;0;CALIENTACAMA KIOTO DIGITAL 2 PLAZAS KTC-1006;CLIMATIZACION
19252225;Soltero;F;25;CHILENO;;Z;PROVIDENCIA                   ;METROPOLITANA;0;0;0;0;0;0;0;0;0;CALIENTACAMA KIOTO ANALOGO 1 PLAZA KTC-1004;CLIMATIZACION
16585284;Soltero;M;35;CHILENO;CONTADOR;Millenial;PROVIDENCIA                   ;METROPOLITANA;0;0;0;0;0;0;0;0;0;CALEFACTOR LENA ITALY6100 ROJO;CLIMATIZACION
18170891;;F;29;CHILENO;;Millenial;PROVIDENCIA                   ;METROPOLITANA;0;0;0;0;0;0;0;0;0;CALIENTACAMA KIOTO ANALOGO 1 PLAZA KTC-1004;CLIMATIZACION
8379060;;F;61;CHILENO;;Boomers;PROVIDENCIA                   ;METROPOLITANA;0;0;0;0;0;0;0;0;0;TERMOVENTILADOR KIOTO NEGRO 2000W KTE-1028N;CLIMATIZACION
15802754;Soltero;F;38;CHILENO;TECNICO EN ADMINISTRACION DE EMPRESAS;X;PROVIDENCIA                   ;METROPOLITANA;0;0;0;0;0;0;0;0;0;CALIENTACAMA KIOTO DIGITAL 2 PLAZAS KTC-1006;CLIMATIZACION
7551058;;M;65;CHILENO;;Boomers;N/D;N/D;0;0;0;0;0;0;0;0;0;ESTUFA A GAS UT GRX-6200 ET ROJA 15 KILOS;CLIMATIZACION
16272584;;M;37;CHILENO;;Millenial;SAN FERNANDO                  ;L.G.B.OÂ´HIGGINS;0;0;0;0;0;0;0;0;0;CALIENTACAMAS MANUAL 3N SG-5010 1PL;CLIMATIZACION
13370638;;M;44;CHILENO;;X;RENCA                         ;METROPOLITANA;0;0;0;0;0;0;0;0;0;CALIENTACAMA KIOTO DIGITAL 1 PLAZA KTC-1005;CLIMATIZACION
7063916;Casado;M;67;CHILENO;;Boomers;VILLARICA                     ;ARAUCANIA;0;0;0;0;0;0;0;0;0;CALIENTACAMA KIOTO ANALOGO 1 PLAZA KTC-1004;CLIMATIZACION
5512387;;F;73;CHILENO;;Silencioso;CURICO                        ;MAULE;0;0;0;0;0;0;0;0;0;ESTUFA A GAS UT GRX-4200 15 KILOS;CLIMATIZACION
16700827;;F;34;CHILENO;;Millenial;LA LIGUA                      ;VALPARAISO;0;0;0;0;0;0;0;0;0;TERMOVENTILADOR KIOTO BLANCO 2000W KTE-1028B;CLIMATIZACION
20373971;;F;22;CHILENO;;Z;PROVIDENCIA                   ;METROPOLITANA;0;0;0;0;0;0;0;0;0;CALIENTACAMA KIOTO DIGITAL 1 PLAZA KTC-1005;CLIMATIZACION
5324758;;M;73;CHILENO;;Silencioso;LO ESPEJO                     ;METROPOLITANA;0;0;0;0;0;0;0;0;0;ESTUFA A GAS VALORY NEW BLACK 15K;CLIMATIZACION
13458579;;M;43;CHILENO;;X;"";"";0;0;0;0;0;0;0;0;0;CONVECTOR ELECTRICO KIOTO 2000W KTE-1105;CLIMATIZACION
16846731;;F;34;CHILENO;;Millenial;PELLUHUE                      ;MAULE;0;0;0;0;0;0;0;0;0;CALIENTACAMA KIOTO DIGITAL 2 PLAZAS KTC-1006;CLIMATIZACION
13524664;;F;44;CHILENO;;X;N/D;N/D;0;0;0;0;0;0;0;0;0;TERMOVENTILADOR KIOTO NEGRO 2000W KTE-1028N;CLIMATIZACION
20239626;;F;23;CHILENO;;Z;PROVIDENCIA                   ;METROPOLITANA;0;0;0;0;0;0;0;0;0;ESTUFA CUARZO KIOTO 800W KTE-011A;CLIMATIZACION
16197199;;F;37;CHILENO;;Millenial;PROVIDENCIA                   ;METROPOLITANA;0;0;0;0;0;0;0;0;0;CALIENTACAMAS MANUAL 2N SG-5121D4 2PL;CLIMATIZACION
11327999;;F;53;CHILENO;;X;OVALLE                        ;COQUIMBO;0;0;0;0;0;0;0;0;0;ESTUFA CUARZO KIOTO 800W KTE-011A;CLIMATIZACION
16199018;;M;36;CHILENO;;Millenial;PROVIDENCIA                   ;METROPOLITANA;0;0;0;0;0;0;0;0;0;CALIENTACAMA KIOTO DIGITAL 2 PLAZAS KTC-1006;CLIMATIZACION
14642712;;F;44;RUSO;;X;LA FLORIDA                    ;METROPOLITANA;0;0;0;0;0;0;0;0;0;ESTUFA INFRARROJA ELECTRICA KIOTO 1500W KTE-1045;CLIMATIZACION
26812588;Soltero;F;47;VENEZOLANO;;Extranjero;N/D;N/D;0;0;0;0;0;0;0;0;0;ESTUFA HIBRIDA SR-6300NG;CLIMATIZACION
14364504;;F;41;CHILENO;;X;SAN BERNARDO                  ;METROPOLITANA;0;0;0;0;0;0;0;0;0;CALIENTACAMA KIOTO DIGITAL 1 PLAZA KTC-1005;CLIMATIZACION
5694972;;F;75;CHILENO;;Silencioso;LOS ANDES                     ;VALPARAISO;0;0;0;0;0;0;0;0;0;ESTUFA CUARZO KIOTO 800W KTE-011A;CLIMATIZACION
19097836;;M;26;CHILENO;;Z;CAUQUENES                     ;MAULE;0;0;0;0;0;0;0;0;0;ESTUFA CUARZO KIOTO 800W KTE-011A;CLIMATIZACION
13807675;;M;42;CHILENO;;X;SAN BERNARDO                  ;METROPOLITANA;0;0;0;0;0;0;0;0;0;TERMOVENTILADOR KIOTO BLANCO 2000W KTE-1028B;CLIMATIZACION
5403167;;F;72;CHILENO;;Silencioso;RANCAGUA                      ;L.G.B.OÂ´HIGGINS;0;0;0;0;0;0;0;0;0;ESTUFA CUARZO KIOTO 800W KTE-011A;CLIMATIZACION
19723578;;F;25;CHILENO;;Silencioso;PROVIDENCIA                   ;METROPOLITANA;0;0;0;0;0;0;0;0;0;ESTUFA CUARZO KIOTO 800W KTE-011A;CLIMATIZACION
9607568;;F;59;CHILENO;;Boomers;TALCA                         ;MAULE;0;0;0;0;0;0;0;0;0;TERMOVENTILADOR KIOTO NEGRO 2000W KTE-1028N;CLIMATIZACION
10492611;;F;59;CHILENO;;Boomers;PARRAL                        ;MAULE;0;0;0;0;0;0;0;0;0;TERMOVENTILADOR KIOTO NEGRO 2000W KTE-1028N;CLIMATIZACION
20143033;;F;22;CHILENO;;Z;PENAFLOR                      ;METROPOLITANA;0;0;0;0;0;0;0;0;0;TERMOVENTILADOR KIOTO NEGRO 2000W KTE-1028N;CLIMATIZACION
14577216;;M;46;CHILENO;;X;CALAMA                        ;ANTOFAGASTA;0;0;0;0;0;0;0;0;0;CHIMENEA ELECTRICA KIOTO 2000W KTE-1101;CLIMATIZACION
13243478;;M;45;CHILENO;;X;CONCHALI                      ;METROPOLITANA;0;0;0;0;0;0;0;0;0;ESTUFA A GAS UT GRX-4200 15 KILOS;CLIMATIZACION
11047894;Casado;F;56;CHILENO;;Silencioso;PROVIDENCIA                   ;METROPOLITANA;0;0;0;0;0;0;0;0;0;ESTUFA A GAS UT GRX-4200 15 KILOS;CLIMATIZACION
18317574;Soltero;F;29;CHILENO;FONOAUDIOLOGA;Millenial;PROVIDENCIA                   ;METROPOLITANA;0;0;0;0;0;0;0;0;0;CHIMENEA ELECTRICA ROBLE NEGRA;CLIMATIZACION
6102499;;M;72;CHILENO;;Silencioso;VILLARICA                     ;ARAUCANIA;0;0;0;0;0;0;0;0;0;ESTUFA GAS EH5300 15K BURDEOS;CLIMATIZACION
9006140;;M;61;CHILENO;;Boomers;CURICO                        ;MAULE;0;0;0;0;0;0;0;0;0;ESTUFA FOGUITA PRO;CLIMATIZACION
24052923;;M;48;COLOMBIANO;;Extranjero;N/D;N/D;0;0;0;0;0;0;0;0;0;ESTUFA GAS SR-6250NG;CLIMATIZACION
5499345;;F;71;CHILENO;;Silencioso;SAN VICENTE                   ;L.G.B.OÂ´HIGGINS;0;0;0;0;0;0;0;0;0;ESTUFA FIAMMA PRO;CLIMATIZACION
12168173;;M;47;CHILENO;;X;VALLENAR;ATACAMA;0;0;0;0;0;0;0;0;0;TERMOVENTILADOR KIOTO NEGRO 2000W KTE-1028N;CLIMATIZACION
13790543;;F;41;CHILENO;;X;LINARES                       ;MAULE;0;0;0;0;0;0;0;0;0;CALEFACTOR LENA SCANTEK380 GRIS CHARCOAL;CLIMATIZACION
8721862;;M;63;CHILENO;;Boomers;SANTA CRUZ                    ;L.G.B.OÂ´HIGGINS;0;0;0;0;0;0;0;0;0;CALIENTACAMAS ANALOGO 1PL;CLIMATIZACION
18943066;;F;27;CHILENO;;Millenial;PADRE HURTADO                 ;METROPOLITANA;0;0;0;0;0;0;0;0;0;CHIMENEA ELECTRICA KIOTO 2000W KTE-1101;CLIMATIZACION
12544478;;M;48;CHILENO;;X;PROVIDENCIA                   ;METROPOLITANA;0;0;0;0;0;0;0;0;0;CALIENTACAMA KIOTO DIGITAL 1 PLAZA KTC-1005;CLIMATIZACION
10202708;Casado;F;43;CHILENO;QUIMICO FARMACEUTICO;Silencioso;PROVIDENCIA                   ;METROPOLITANA;0;0;0;0;0;0;0;0;0;CONVECTOR ELECT. UT HMC-2000;CLIMATIZACION
18045916;;F;30;CHILENO;;Millenial;VINA DEL MAR;VALPARAISO;0;0;0;0;0;0;0;0;0;CALIENTACAMAS UFESA INDIVIDUAL CIE;CLIMATIZACION
17463308;;M;32;CHILENO;;Millenial;PROVIDENCIA                   ;METROPOLITANA;0;0;0;0;0;0;0;0;0;CALIENTACAMA KIOTO DIGITAL 2 PLAZAS KTC-1006;CLIMATIZACION
18340864;;F;29;CHILENO;;Millenial;EL BOSQUE                     ;METROPOLITANA;0;0;0;0;0;0;0;0;0;Estufa a gas Kaly 15;CLIMATIZACION
19807560;;F;24;CHILENO;;Z;N/D;N/D;0;0;0;0;0;0;0;0;0;CALIENTACAMA KIOTO DIGITAL 2 PLAZAS KTC-1006;CLIMATIZACION
11556632;;M;53;CHILENO;;X;RENCA                         ;METROPOLITANA;0;0;0;0;0;0;0;0;0;CONVECTOR ELECTRICO KIOTO 2000W KTE-1105;CLIMATIZACION
11276717;;F;53;CHILENO;;Silencioso;PROVIDENCIA                   ;METROPOLITANA;0;0;0;0;0;0;0;0;0;ESTUFA INFRARROJA ELECTRICA KIOTO 1500W KTE-1045;CLIMATIZACION
7581922;;F;73;CHILENO;;Silencioso;PROVIDENCIA                   ;METROPOLITANA;0;0;0;0;0;0;0;0;0;CALIENTACAMA KIOTO ANALOGO 1 PLAZA KTC-1004;CLIMATIZACION
16282733;;F;35;CHILENO;;Millenial;RENCA                         ;METROPOLITANA;0;0;0;0;0;0;0;0;0;ESTUFA ELECTRICA CUARZO KIOTO 1200W KTE 1033;CLIMATIZACION
8767384;;M;62;CHILENO;;Boomers;PROVIDENCIA                   ;METROPOLITANA;0;0;0;0;0;0;0;0;0;CHIMENEA ELECTRICA KIOTO 2000W KTE-1101;CLIMATIZACION
5985815;Casado;M;75;CHILENO;;Silencioso;PROVIDENCIA                   ;METROPOLITANA;0;0;0;0;0;0;0;0;0;Estufa a gas Kaly 15;CLIMATIZACION
19580922;;M;24;CHILENO;;Silencioso;TEMUCO                        ;ARAUCANIA;0;0;0;0;0;0;0;0;0;Estufa a gas Kaly 15;CLIMATIZACION
11538947;;M;52;CHILENO;;X;CURANILAHUE                   ;BIO BIO;0;0;0;0;0;0;0;0;0;TERMOVENTILADOR KIOTO NEGRO 2000W KTE-1028N;CLIMATIZACION
20690645;;F;21;CHILENO;;Z;PROVIDENCIA                   ;METROPOLITANA;0;0;0;0;0;0;0;0;0;TERMOVENTILADOR TH-FH30 BLANCO 1000W-2000W;CLIMATIZACION
16458987;Soltero;F;35;CHILENO;;Millenial;MAIPU                         ;METROPOLITANA;0;0;0;0;0;0;0;0;0;CALIENTACAMA KIOTO ANALOGO 1 PLAZA KTC-1004;CLIMATIZACION
18478538;Soltero;F;29;CHILENO;;Silencioso;PROVIDENCIA                   ;METROPOLITANA;0;0;0;0;0;0;0;0;0;ESTUFA FAN HEATER MFHK 540 PLUS;CLIMATIZACION
4495811;;M;82;CHILENO;;Silencioso;PUTAENDO                      ;VALPARAISO;0;0;0;0;0;0;0;0;0;TERMOVENTILADOR NICROM VFH300 BL 1800W;CLIMATIZACION
15912368;;F;38;CHILENO;;Millenial;PROVIDENCIA                   ;METROPOLITANA;0;0;0;0;0;0;0;0;0;CHIMENEA ELECTRICA KIOTO 2000W KTE-1101;CLIMATIZACION
9206709;Viudo;M;70;CHILENO;;Silencioso;MAIPU                         ;METROPOLITANA;0;0;0;0;0;0;0;0;0;TERMOVENTILADOR KIOTO NEGRO 2000W KTE-1028N;CLIMATIZACION
12519065;;F;49;CHILENO;;X;SAN VICENTE                   ;L.G.B.OÂ´HIGGINS;0;0;0;0;0;0;0;0;0;ESTUFA ELECTRICA CUARZO KIOTO 1200W KTE 1033;CLIMATIZACION
12107244;;F;48;CHILENO;;X;CHILLAN                       ;BIO BIO;0;0;0;0;0;0;0;0;0;ESTUFA ELECTRICA CUARZO KIOTO 1200W KTE 1033;CLIMATIZACION
6810085;;F;66;CHILENO;;Boomers;PARRAL                        ;MAULE;0;0;0;0;0;0;0;0;0;TERMOVENTILADOR KIOTO NEGRO 2000W KTE-1028N;CLIMATIZACION
11271826;Divorciado;F;53;CHILENO;;X;PROVIDENCIA                   ;METROPOLITANA;0;0;0;0;0;0;0;0;0;ESTUFA ELECTRICA CUARZO KIOTO 1200W KTE 1033;CLIMATIZACION
12443190;;M;49;CHILENO;;X;N/D;N/D;0;0;0;0;0;0;0;0;0;TURBO CALEFACTOR VERT. TC-2100V BLANCO;CLIMATIZACION
13037598;;M;46;CHILENO;;X;RENCA                         ;METROPOLITANA;0;0;0;0;0;0;0;0;0;CHIMENEA ELECTRICA KIOTO 2000W KTE-1101;CLIMATIZACION
18992439;;F;27;CHILENO;;Z;"";"";0;0;0;0;0;0;0;0;0;CALIENTACAMA KIOTO DIGITAL 2 PLAZAS KTC-1006;CLIMATIZACION
10818019;;M;41;CHILENO;;X;EL BOSQUE                     ;METROPOLITANA;0;0;0;0;0;0;0;0;0;ESTUFA ELECTRICA CUARZO KIOTO 1200W KTE 1033;CLIMATIZACION
15236152;;F;40;CHILENO;;X;QUINTA NORMAL                 ;METROPOLITANA;0;0;0;0;0;0;0;0;0;TERMOVENTILADOR NICROM VFH300 BL 1800W;CLIMATIZACION
6278621;Soltero;M;72;CHILENO;;Silencioso;RENCA                         ;METROPOLITANA;0;0;0;0;0;0;0;0;0;ESTUFA GAS EH2500 5K NEGRO;CLIMATIZACION
10358147;;M;55;CHILENO;;Boomers;AISEN                         ;AYSEN;0;0;0;0;0;0;0;0;0;VITTALE 8;CLIMATIZACION
18740866;;F;28;CHILENO;;Millenial;ESTACION CENTRAL              ;METROPOLITANA;0;0;0;0;0;0;0;0;0;ESTUFA VITTALE-40 15K;CLIMATIZACION
15882244;;F;37;CHILENO;;Millenial;"";"";0;0;0;0;0;0;0;0;0;VITTALE 8;CLIMATIZACION
18351340;Soltero;F;28;CHILENO;;Silencioso;PROVIDENCIA                   ;METROPOLITANA;0;0;0;0;0;0;0;0;0;ESTUFA HIBRIDO GAS-ELECTRICA FEL 1500 H;CLIMATIZACION
14508902;;F;48;CHILENO;;X;COINCO                        ;L.G.B.OÂ´HIGGINS;0;0;0;0;0;0;0;0;0;KIT INSTALACION PLUS 6PULGADAS ACERO;CLIMATIZACION
17533771;Soltero;M;32;CHILENO;ENFERMERO;Millenial;PROVIDENCIA                   ;METROPOLITANA;0;0;0;0;0;0;0;0;0;ESTUFA A GAS SUNNY CLASSIC WOOD 6600 NEGRA;CLIMATIZACION
18444654;Soltero;F;28;CHILENO;;Millenial;PROVIDENCIA                   ;METROPOLITANA;0;0;0;0;0;0;0;0;0;ESTUFA GAS KG5 5K NEGRO EUROPEA;CLIMATIZACION
10667863;;F;46;CHILENO;;X;PROVIDENCIA                   ;METROPOLITANA;0;0;0;0;0;0;0;0;0;ESTUFA PARAFINA KPM-3300;CLIMATIZACION
7249786;;F;77;CHILENO;;Silencioso;PROVIDENCIA                   ;METROPOLITANA;0;0;0;0;0;0;0;0;0;TERMOVENTILADOR NICROM VFH300 BL 1800W;CLIMATIZACION
21936723;;F;56;ECUATORIANO;;Extranjero;VALLENAR;ATACAMA;0;0;0;0;0;0;0;0;0;TERMOVENTILADOR KIOTO BLANCO 2000W KTE-1028B;CLIMATIZACION
15477134;;M;39;CHILENO;;X;COINCO                        ;L.G.B.OÂ´HIGGINS;0;0;0;0;0;0;0;0;0;ESTUFA VITTALE-40 15K;CLIMATIZACION
18369393;;F;29;CHILENO;;Millenial;PROVIDENCIA                   ;METROPOLITANA;0;0;0;0;0;0;0;0;0;CALIENTACAMAS ANALOGO 1PL;CLIMATIZACION
18084750;Soltero;M;30;CHILENO;;Silencioso;PROVIDENCIA                   ;METROPOLITANA;0;0;0;0;0;0;0;0;0;ESTUFA INFRARROJA UT-IRH-S1500;CLIMATIZACION
5625446;;F;75;CHILENO;;Silencioso;VINA DEL MAR                  ;VALPARAISO;0;0;0;0;0;0;0;0;0;ESTUFA ELECTRICA CUARZO KIOTO 1200W KTE 1033;CLIMATIZACION
7650662;Casado;M;66;CHILENO;;Boomers;RENCA                         ;METROPOLITANA;0;0;0;0;0;0;0;0;0;TERMOVENTILADOR KIOTO NEGRO 2000W KTE-1028N;CLIMATIZACION
11685315;;F;52;CHILENO;;X;PROVIDENCIA                   ;METROPOLITANA;0;0;0;0;0;0;0;0;0;CONVECTOR UT N10;CLIMATIZACION
10418059;;F;54;CHILENO;;X;LOS ANGELES                   ;BIO BIO;0;0;0;0;0;0;0;0;0;ESTUFA ELECTRICA CUARZO KIOTO 1200W KTE 1033;CLIMATIZACION
9695188;;F;59;CHILENO;;Boomers;PROVIDENCIA                   ;METROPOLITANA;0;0;0;0;0;0;0;0;0;CALIENTACAMAS DIGITAL TIMER SG-5351 2PL;CLIMATIZACION
19603081;;M;25;CHILENO;;Silencioso;PROVIDENCIA                   ;METROPOLITANA;0;0;0;0;0;0;0;0;0;CONVECTOR ELECTRICO UT MC -20 WIFI;CLIMATIZACION
18066555;;F;29;CHILENO;;Millenial;LINARES                       ;MAULE;0;0;0;0;0;0;0;0;0;TERMOVENTILADOR OSCILANTE FH-120S BL;CLIMATIZACION
18103905;;M;29;CHILENO;;Millenial;PROVIDENCIA                   ;METROPOLITANA;0;0;0;0;0;0;0;0;0;CALIENTACAMA KIOTO DIGITAL 1 PLAZA KTC-1005;CLIMATIZACION
9881568;Casado;F;57;CHILENO;;Boomers;PROVIDENCIA                   ;METROPOLITANA;0;0;0;0;0;0;0;0;0;ESTUFA GAS KG5 5K NEGRO EUROPEA;CLIMATIZACION
9229816;;M;60;CHILENO;;Boomers;RENCA                         ;METROPOLITANA;0;0;0;0;0;0;0;0;0;ESTUFA ELECTRICA CARBONO ECOHEATEH1000 1000W;CLIMATIZACION
17063939;;M;33;CHILENO;;Silencioso;PROVIDENCIA                   ;METROPOLITANA;0;0;0;0;0;0;0;0;0;CALIENTACAMAS ANALOGO BASICO 2 PL;CLIMATIZACION
19666323;;F;25;CHILENO;;Z;PROVIDENCIA                   ;METROPOLITANA;0;0;0;0;0;0;0;0;0;CALEFACTOR LENA SCANTEK380 GRIS CHARCOAL;CLIMATIZACION
11384424;Soltero;F;53;CHILENO;;X;RENCA                         ;METROPOLITANA;0;0;0;0;0;0;0;0;0;TURBO CALEFACTOR VERT. TC-2070V BLANCO;CLIMATIZACION
18835765;Soltero;F;28;CHILENO;;Millenial;PROVIDENCIA                   ;METROPOLITANA;0;0;0;0;0;0;0;0;0;ESTUFA VITTALE-40 15K;CLIMATIZACION
19149555;;F;26;CHILENO;;Z;ARICA                         ;TARAPACA;0;0;0;0;0;0;0;0;0;ESTUFA VITTALE-40 15K;CLIMATIZACION
18266001;Soltero;M;29;CHILENO;PSICOLOGO;Millenial;PROVIDENCIA                   ;METROPOLITANA;0;0;0;0;0;0;0;0;0;CALEFACTOR LENA ECO360 CHARCOAL;CLIMATIZACION
16309232;;M;36;CHILENO;;Millenial;PROVIDENCIA                   ;METROPOLITANA;0;0;0;0;0;0;0;0;0;KIT INSTALACION PLUS 6PULGADAS ACERO;CLIMATIZACION
12792649;;F;46;CHILENO;;X;PROVIDENCIA                   ;METROPOLITANA;0;0;0;0;0;0;0;0;0;KIT INSTALACION PLUS 6PULGADAS ACERO;CLIMATIZACION
8907925;Soltero;M;55;CHILENO;;Silencioso;PROVIDENCIA                   ;METROPOLITANA;0;0;0;0;0;0;0;0;0;ESTUFA ELECTRICA CARBONO ECOHEATEH1000 1000W;CLIMATIZACION
11751380;;F;51;CHILENO;;X;PROVIDENCIA                   ;METROPOLITANA;0;0;0;0;0;0;0;0;0;CONVECTOR TURBO KCH 2000 BL;CLIMATIZACION
19145243;;F;26;CHILENO;;Z;N/D;N/D;0;0;0;0;0;0;0;0;0;TERMOVENTILADOR KIOTO NEGRO 2000W KTE-1028N;CLIMATIZACION
15559483;;F;38;CHILENO;;X;PROVIDENCIA                   ;METROPOLITANA;0;0;0;0;0;0;0;0;0;ESTUFA VITTALE-40 15K;CLIMATIZACION
13776855;;M;42;CHILENO;;X;PROVIDENCIA                   ;METROPOLITANA;0;0;0;0;0;0;0;0;0;Calefactor Bosca a Lena Gold 500 Burdeo CERT.;CLIMATIZACION
17719177;;F;30;CHILENO;;Silencioso;PROVIDENCIA                   ;METROPOLITANA;0;0;0;0;0;0;0;0;0;Ventilador Sobremesa Plastico KF 9D;CLIMATIZACION
19574502;Soltero;F;25;CHILENO;;Silencioso;PROVIDENCIA                   ;METROPOLITANA;0;0;0;0;0;0;0;0;0;CALEFACTOR INFRAROJO GR2800 ET;CLIMATIZACION
15911480;;M;37;CHILENO;;Millenial;RENCA                         ;METROPOLITANA;0;0;0;0;0;0;0;0;0;KIT INSTALACION VERTICAL 6X4MTS ACERO;CLIMATIZACION
19609579;;F;24;CHILENO;;Z;PROVIDENCIA                   ;METROPOLITANA;0;0;0;0;0;0;0;0;0;Ventilador Sobremesa Plastico KF 12D;CLIMATIZACION
11982577;;F;50;CHILENO;;X;CODEGUA                       ;L.G.B.OÂ´HIGGINS;0;0;0;0;0;0;0;0;0;V-VENTILADOR OSCILANTE MURAL 16 CON PIOLA;CLIMATIZACION
10737173;;F;52;CHILENO;;X;RENCA                         ;METROPOLITANA;0;0;0;0;0;0;0;0;0;VENTILADOR PEDESTAL KF-16P;CLIMATIZACION
11052255;Soltero;F;56;CHILENO;;Boomers;RENCA                         ;METROPOLITANA;0;0;0;0;0;0;0;0;0;AIRE AC. PORTATIL FRIO 7000BTU/H GRIS;CLIMATIZACION
15782186;;M;38;CHILENO;;Millenial;PROVIDENCIA                   ;METROPOLITANA;0;0;0;0;0;0;0;0;0;VENTILADOR PEDESTAL 18 PLASTICO;CLIMATIZACION
10464797;;F;57;CHILENO;;Boomers;RETIRO                        ;MAULE;0;0;0;0;0;0;0;0;0;VENTILADOR WIND BREEZE (160S);CLIMATIZACION
18877810;Soltero;F;27;CHILENO;NUTRICIONISTA;Z;PROVIDENCIA                   ;METROPOLITANA;0;0;0;0;0;0;0;0;0;VENTILADOR PEDESTAL KTP-1015;CLIMATIZACION
11161415;;F;55;CHILENO;;Boomers;RENCA                         ;METROPOLITANA;0;0;0;0;0;0;0;0;0;Enfriador KSH-16R;CLIMATIZACION
16781349;;F;34;CHILENO;;Millenial;OSORNO                        ;LOS LAGOS;0;0;0;0;0;0;0;0;0;A/C FRIO/CALOR PORTATIL 12000BTU;CLIMATIZACION
10258619;;F;54;CHILENO;;X;LO ESPEJO                     ;METROPOLITANA;0;0;0;0;0;0;0;0;0;VENTILADOR PEDESTAL KTP-1016;CLIMATIZACION
11952487;;F;49;CHILENO;;X;RENCA                         ;METROPOLITANA;0;0;0;0;0;0;0;0;0;VENTILADOR WIND BREEZE PRO 2 EN 1;CLIMATIZACION
6435202;;M;71;CHILENO;;Silencioso;VILLA ALEMANA                 ;VALPARAISO;0;0;0;0;0;0;0;0;0;ENFRIADOR Y HUMIFICADOR THOMAS Blanco/Negro;CLIMATIZACION
8604916;;F;58;CHILENO;;Boomers;VALLENAR;ATACAMA;0;0;0;0;0;0;0;0;0;Enfriador KSH-16R;CLIMATIZACION
16336481;;M;35;CHILENO;;Millenial;CURICO                        ;MAULE;0;0;0;0;0;0;0;0;0;VENTILADOR PEDESTAL KTP-1015;CLIMATIZACION
25477786;;M;29;HAITIANO;;Extranjero;RENCA                         ;METROPOLITANA;0;0;0;0;0;0;0;0;0;VENTILADOR VALORY VSF 9 SOBREMESA 9Â¿ 35W;CLIMATIZACION
8722079;;F;62;CHILENO;;Boomers;PROVIDENCIA                   ;METROPOLITANA;0;0;0;0;0;0;0;0;0;VENTILADOR VALORY VSF 9 SOBREMESA 9Â¿ 35W;CLIMATIZACION
6563511;Casado;F;66;CHILENO;;Boomers;RENCA                         ;METROPOLITANA;0;0;0;0;0;0;0;0;0;VENTILADOR VALORY VSF 9 SOBREMESA 9Â¿ 35W;CLIMATIZACION
14204458;;F;53;CHILENO;;X;RANCAGUA                      ;L.G.B.OÂ´HIGGINS;0;0;0;0;0;0;0;0;0;Enfriador KSH-16R;CLIMATIZACION
17678736;Soltero;F;31;CHILENO;;Millenial;PROVIDENCIA                   ;METROPOLITANA;0;0;0;0;0;0;0;0;0;VENTILADOR PEDESTAL KTP-1015;CLIMATIZACION
15579448;;M;38;CHILENO;;Millenial;"";"";0;0;0;0;0;0;0;0;0;A/C FRIO/CALOR PORTATIL 12000BTU;CLIMATIZACION
11322416;;F;54;CHILENO;;X;LOS ANGELES                   ;BIO BIO;0;0;0;0;0;0;0;0;0;CALIENTACAMAS ANALOGO BASICO 1PL;CLIMATIZACION
15465485;;F;40;CHILENO;;X;VALDIVIA                      ;LOS RIOS;0;0;0;0;0;0;0;0;0;CALIENTACAMA KIOTO ANALOGO 1 PLAZA KTC-1004;CLIMATIZACION
8443225;;F;64;CHILENO;;Boomers;MAIPU                         ;METROPOLITANA;0;0;0;0;0;0;0;0;0;ESTUFA PARAFINA SUNNYMET EP-7600BL;CLIMATIZACION
9423797;;M;58;CHILENO;;Boomers;PROVIDENCIA                   ;METROPOLITANA;0;0;0;0;0;0;0;0;0;CHIMENEA ELECTRICA KIOTO 2000W KTE-1101;CLIMATIZACION
10202841;;M;56;CHILENO;;Boomers;RANCAGUA                      ;L.G.B.OÂ´HIGGINS;0;0;0;0;0;0;0;0;0;TERMOVENTILADOR NICROM VFH300 BL 1800W;CLIMATIZACION
10633673;Divorciado;F;57;CHILENO;;Boomers;PROVIDENCIA                   ;METROPOLITANA;0;0;0;0;0;0;0;0;0;ESTUFA CUARZO KIOTO 800W KTE-011A;CLIMATIZACION
6718184;;F;74;CHILENO;;Silencioso;SAN JAVIER                    ;MAULE;0;0;0;0;0;0;0;0;0;CALIENTACAMA KIOTO ANALOGO 1 PLAZA KTC-1004;CLIMATIZACION
17880920;;M;30;CHILENO;;Extranjero;"";"";0;0;0;0;0;0;0;0;0;TERMOVENTILADOR KIOTO BLANCO 2000W KTE-1028B;CLIMATIZACION
18853361;;F;27;CHILENO;;Millenial;N/D;N/D;24990;1;1;0;0;0;1;1;24990;SECADOR DE PELO SE-3049C01 FUCSIA;PERSONAL CARE
12770926;Soltero;F;47;CHILENO;;X;PROVIDENCIA                   ;METROPOLITANA;21990;1;1;0;0;0;1;1;21990;AFEITADORA SPORT;PERSONAL CARE
25921905;;M;32;VENEZOLANO;;Extranjero;SANTIAGO                      ;METROPOLITANA;39840;2;1;0;0;0;2;1;39840;CORTA PELO SPORT GCX 623 BVT;PERSONAL CARE
17635719;;F;31;CHILENO;;Millenial;N/D;N/D;34990;1;1;0;0;0;1;1;34990;COMBO GAMA SECADOR+ALISADOR+CEPILLO;PERSONAL CARE
18029307;;F;29;CHILENO;;Millenial;CONSTITUCION;MAULE;178970;3;2;1;1;139990;2;1;38980;SECADOR GAMA BORA KERATION;PERSONAL CARE
8538299;;F;50;CHILENO;;X;LA SERENA                     ;COQUIMBO;27990;1;1;0;0;0;1;1;27990;ALISADOR DE PELO SG-3512D1 ROSA;PERSONAL CARE
16361802;;F;35;CHILENO;;Millenial;OVALLE                        ;COQUIMBO;44980;2;2;0;0;0;2;2;44980;DEPILADORA OASIS NEXT BVT;PERSONAL CARE
12564605;;F;48;CHILENO;;X;NUEVA IMPERIAL                ;ARAUCANIA;67970;3;3;0;0;0;3;3;67970;SECADOR DIAMOND STD;PERSONAL CARE
13872873;;F;42;CHILENO;;X;RENCA                         ;METROPOLITANA;37980;2;2;0;0;0;2;2;37980;CORTA PELO SG-8410;PERSONAL CARE
18088103;Soltero;M;30;CHILENO;;Millenial;PROVIDENCIA                   ;METROPOLITANA;34990;1;1;1;1;34990;0;0;0;AFEITADORA GAMA GSH986 SPORT;PERSONAL CARE
14562659;;F;46;CHILENO;;X;ANCUD                         ;LOS LAGOS;21990;1;1;0;0;0;1;1;21990;SECADOR DE PELO SIEGEN SG-3035;PERSONAL CARE
11795461;Casado;F;50;CHILENO;PROFESOR;X;ANGOL                         ;ARAUCANIA;21990;1;1;0;0;0;1;1;21990;SECADOR DE PELO SIEGEN SG-3035;PERSONAL CARE
20306168;;F;22;CHILENO;;Z;SAN CLEMENTE;MAULE;136810;5;3;2;1;58980;3;2;77830;AFEITADORA SG-7250 NEGRO;PERSONAL CARE
13547123;Casado;M;43;CHILENO;INGENIERO ELECTRICO;X;N/D;N/D;14990;1;1;0;0;0;1;1;14990;CORTAPELO GAMA TITANIUM T827;PERSONAL CARE
27442474;;F;38;EXTRANJERO - NO INFORMA NACIONALIDAD ;;Millenial;"";"";21990;1;1;0;0;0;1;1;21990;ALISADOR DE PELO SG-3510 FUCSIA;PERSONAL CARE
19477247;;F;25;CHILENO;;Z;PROVIDENCIA                   ;METROPOLITANA;117960;4;4;2;2;82980;2;2;34980;SECADOR DE PELO SG-3012C29 MORADO;PERSONAL CARE
16558945;;F;34;CHILENO;;Millenial;MELIPILLA                     ;METROPOLITANA;35980;2;1;0;0;0;2;1;35980;SECADOR GAMA BRILLIAN AQUA;PERSONAL CARE
13358330;;F;43;CHILENO;;X;LINARES                       ;MAULE;284970;3;2;0;0;0;3;2;284970;DEPILADORA IPL MAGNA PK;PERSONAL CARE
10049687;;F;48;CHILENO;;X;N/D;N/D;85960;4;3;0;0;0;4;3;85960;SECADOR DE PELO SIEGEN SG-3035;PERSONAL CARE
15951615;;F;38;CHILENO;;Millenial;N/D;N/D;41990;1;1;0;0;0;1;1;41990;DEPILADORA OASIS NEXT BVT;PERSONAL CARE
15508869;;F;40;CHILENO;;X;PUERTO MONTT                  ;LOS LAGOS;12990;1;1;0;0;0;1;1;12990;SECADOR DE PELO SG-3012C29 MORADO;PERSONAL CARE
17986238;;M;30;CHILENO;;Millenial;PROVIDENCIA                   ;METROPOLITANA;19990;1;1;0;0;0;1;1;19990;SECADOR DE PELO SIEGEN SG-3035;PERSONAL CARE
9432225;;M;59;CHILENO;;Boomers;TOCOPILLA                     ;ANTOFAGASTA;1362940;6;3;0;0;0;6;3;1362940;COMBO SIEGEN AFEITADORA + MULTISTYLER SG-8440;PERSONAL CARE
15826449;;F;37;CHILENO;;Millenial;N/D;N/D;447950;5;4;2;1;354980;3;3;92970;ALISADOR SG-3510C11 VERDE;PERSONAL CARE
15914637;;F;38;CHILENO;;Millenial;LEBU                          ;BIO BIO;44990;1;1;0;0;0;1;1;44990;ALISADOR DE PELO S12A(220) Shine Therapy PALTA M;PERSONAL CARE
18433967;;F;28;CHILENO;;Millenial;N/D;N/D;55490;3;1;0;0;0;3;1;55490;COMBO SIEGEN AFEITADORA + MULTISTYLER SG-8440;PERSONAL CARE
19957524;;F;24;CHILENO;;Z;N/D;N/D;39990;1;1;0;0;0;1;1;39990;ALISADOR DE PELO S12A(220) Shine Therapy PALTA M;PERSONAL CARE
19431693;;M;25;CHILENO;;Z;PROVIDENCIA                   ;METROPOLITANA;16990;1;1;0;0;0;1;1;16990;CORTA PELO SG-8200;PERSONAL CARE
10324871;;M;41;CHILENO;;X;COIHAIQUE                     ;AYSEN;64990;1;1;0;0;0;1;1;64990;ALISADOR DE PELO SG-4651 ROJO;PERSONAL CARE
20179244;;F;22;CHILENO;;Z;PROVIDENCIA                   ;METROPOLITANA;156520;4;3;2;1;24540;2;2;131980;SECADOR GAMA BORA KERATION;PERSONAL CARE
11912070;;F;50;CHILENO;;X;PELLUHUE                      ;MAULE;45463;2;1;0;0;0;2;1;45463;COMBO GAMA SECADOR+ALISADOR+CEPILLO;PERSONAL CARE
7861861;;F;60;CHILENO;;Boomers;OSORNO                        ;LOS LAGOS;44990;1;1;0;0;0;1;1;44990;ALISADOR DE PELO S12A(220) Shine Therapy PALTA M;PERSONAL CARE
12111665;;M;51;CHILENO;;X;SAN FELIPE                    ;VALPARAISO;606930;7;4;0;0;0;7;4;606930;AFEITADORA SG-7210 NEGRO;PERSONAL CARE
11840305;;M;51;CHILENO;;Millenial;"";"";594970;3;4;2;1;524980;1;3;69990;ALISADOR DE PELO SG-4651 ROJO;PERSONAL CARE
7852675;;F;66;CHILENO;;Boomers;RENCA                         ;METROPOLITANA;36980;2;2;0;0;0;2;2;36980;AFEITADORA SG-7210 NEGRO;PERSONAL CARE
14003864;;F;40;CHILENO;;X;SANTO DOMINGO                 ;VALPARAISO;1203930;7;4;3;2;489970;4;2;713960;DEPILADORA IPL MAGNA PK;PERSONAL CARE
14135481;;F;40;CHILENO;;X;N/D;N/D;379303;6;6;0;0;0;6;6;379303;ALISADOR +SECADOR PELO;PERSONAL CARE
12498723;;F;49;CHILENO;;X;PUCON                         ;ARAUCANIA;297962;4;4;0;0;0;4;4;297962;ALISADOR DE PELO SG-4651 ROJO;PERSONAL CARE
14154008;;F;41;CHILENO;;X;PROVIDENCIA                   ;METROPOLITANA;49990;1;1;0;0;0;1;1;49990;DEPILADORA BRE700/00 MID-END CLOSED BOX;PERSONAL CARE
7563326;;F;70;CHILENO;;Silencioso;MELIPILLA                     ;METROPOLITANA;61980;2;2;0;0;0;2;2;61980;SECADOR DE PELO SG-3049 NEGRO;PERSONAL CARE
23191612;;F;25;CHILENO;;Extranjero;IQUIQUE                       ;TARAPACA;11041;1;1;0;0;0;1;1;11041;SECADOR DE PELO SG-3012C29 MORADO;PERSONAL CARE
17717070;;F;31;CHILENO;;Millenial;"";"";14990;1;1;0;0;0;1;1;14990;SECADOR DE PELO SG-3012C23 VERDE;PERSONAL CARE
15998475;;M;35;CHILENO;;Millenial;LA SERENA                     ;COQUIMBO;269970;3;2;0;0;0;3;2;269970;COMBO GAMA SECADOR+ALISADOR+CEPILLO;PERSONAL CARE
16434402;;F;36;CHILENO;;Millenial;ANGOL                         ;ARAUCANIA;139970;3;2;0;0;0;3;2;139970;DEPILADORA OASIS SENSATION;PERSONAL CARE
11987756;Divorciado;M;49;CHILENO;;X;PROVIDENCIA                   ;METROPOLITANA;57980;2;2;0;0;0;2;2;57980;CORTA PELO GC-615;PERSONAL CARE
11863918;;M;51;CHILENO;;X;EL BOSQUE                     ;METROPOLITANA;21990;1;1;0;0;0;1;1;21990;AFEITADORA SG-7210 NEGRO;PERSONAL CARE
5913224;;F;74;CHILENO;;Silencioso;COLLIPULLI                    ;ARAUCANIA;330950;5;4;0;0;0;5;4;330950;COMBO GAMA SECADOR+ALISADOR+CEPILLO;PERSONAL CARE
13718948;;M;43;CHILENO;;X;N/D;N/D;169930;7;6;0;0;0;7;6;169930;DEPILADORA SG-9003;PERSONAL CARE
18368318;;M;29;CHILENO;;Millenial;VILLARICA                     ;ARAUCANIA;73970;3;2;0;0;0;3;2;73970;SECADOR DE PELO SE-3049C01 FUCSIA;PERSONAL CARE
12350705;;M;49;CHILENO;;X;PROVIDENCIA                   ;METROPOLITANA;19990;1;1;0;0;0;1;1;19990;SECADOR DE PELO SIEGEN SG-3035;PERSONAL CARE
19081867;;F;27;CHILENO;;Z;QUILPUE                       ;VALPARAISO;12990;1;1;0;0;0;1;1;12990;SECADOR GAMA EOLIC MINI TRAVEL;PERSONAL CARE
11616639;;F;51;CHILENO;;X;COQUIMBO;COQUIMBO;35240;2;1;0;0;0;2;1;35240;COMBO GAMA SECADOR+ALISADOR+CEPILLO;PERSONAL CARE
18895051;;F;31;CHILENO;;Millenial;CONSTITUCION;MAULE;191210;5;4;2;2;18980;3;2;172230;ALISADOR ELEGANCE LED KER;PERSONAL CARE
8926400;;M;47;CHILENO;;X;QUILPUE                       ;VALPARAISO;30086;2;1;0;0;0;2;1;30086;CORTA PELO SG-8520;PERSONAL CARE
20288120;;F;23;CHILENO;;Z;PROVIDENCIA                   ;METROPOLITANA;14990;1;1;0;0;0;1;1;14990;SECADOR DE PELO SG-3025 SILVER;PERSONAL CARE
16567758;;F;35;CHILENO;;Millenial;BUIN;METROPOLITANA;147960;4;3;1;1;49990;3;2;97970;AFEITADORA SG-7250 NEGRO;PERSONAL CARE
18480354;Soltero;F;29;CHILENO;TECNICO DE NIVEL SUPERIOR EN LABORATORIO CLINICO BANCO DE SANGRE E IMAGENOLOGIA;Millenial;PROVIDENCIA                   ;METROPOLITANA;19990;1;1;0;0;0;1;1;19990;SECADOR DE PELO SIEGEN SG-3035;PERSONAL CARE
7859427;;M;67;CHILENO;;Boomers;N/D;N/D;65900;2;1;0;0;0;2;1;65900;AFEITADORA GAMA SH 1527 WD;PERSONAL CARE
19934405;;M;24;CHILENO;;Z;PROVIDENCIA                   ;METROPOLITANA;17990;1;1;0;0;0;1;1;17990;ALISADOR DE PELO HP8321;PERSONAL CARE
20125831;;F;22;CHILENO;;Z;CORONEL;BIO-BIO;13990;1;1;0;0;0;1;1;13990;SECADOR DE PELO SG-3012 NEGRO;PERSONAL CARE
6305734;;F;72;CHILENO;;Silencioso;PROVIDENCIA                   ;METROPOLITANA;81970;3;3;0;0;0;3;3;81970;COMBO SIEGEN AFEITADORA + MULTISTYLER SG-8440;PERSONAL CARE
18894615;;F;27;CHILENO;;Millenial;CONSTITUCION                  ;MAULE;45980;2;2;0;0;0;2;2;45980;SECADOR DE PELO SIEGEN SG-3035;PERSONAL CARE
20326371;;F;22;CHILENO;;Z;PROVIDENCIA                   ;METROPOLITANA;14990;1;1;0;0;0;1;1;14990;SECADOR DE PELO MISTRAL STD;PERSONAL CARE
24388975;;F;24;CHILENO;;Extranjero;PROVIDENCIA                   ;METROPOLITANA;12990;1;1;0;0;0;1;1;12990;SECADOR GAMA EOLIC MINI TRAVEL;PERSONAL CARE
19875961;;F;23;CHILENO;;Z;PROVIDENCIA                   ;METROPOLITANA;54840;2;1;0;0;0;2;1;54840;ALISADOR DE PELO S12A(220) Shine Therapy PALTA M;PERSONAL CARE
13291832;;F;45;CHILENO;;X;MAIPU                         ;METROPOLITANA;19990;1;1;0;0;0;1;1;19990;SECADOR DE PELO SIEGEN SG-3035;PERSONAL CARE
16454933;;M;35;CHILENO;;Silencioso;PROVIDENCIA                   ;METROPOLITANA;18990;1;1;0;0;0;1;1;18990;ALISADOR SG-3510C12 BLANCO;PERSONAL CARE
14056692;;F;41;CHILENO;;X;CAUQUENES                     ;MAULE;15990;1;1;0;0;0;1;1;15990;SECADOR DE PELO SG-3025 SILVER;PERSONAL CARE
19982814;;M;23;CHILENO;;Z;CALERA                        ;VALPARAISO;59980;4;3;0;0;0;4;3;59980;CORTAPELO GAMA TITANIUM T827;PERSONAL CARE
13670032;;M;44;CHILENO;;X;PROVIDENCIA                   ;METROPOLITANA;26990;1;1;0;0;0;1;1;26990;SECADOR DE PELO SG-3049 NEGRO;PERSONAL CARE
17252351;;F;32;CHILENO;;Millenial;ESTACION CENTRAL              ;METROPOLITANA;26990;1;1;0;0;0;1;1;26990;SECADOR DE PELO SG-3049 NEGRO;PERSONAL CARE
14527469;;M;46;CHILENO;;X;SAN ANTONIO                   ;VALPARAISO;219980;2;2;0;0;0;2;2;219980;COMBO GAMA SECADOR+ALISADOR+CEPILLO;PERSONAL CARE
18202810;;F;29;CHILENO;;Millenial;PROVIDENCIA                   ;METROPOLITANA;14990;1;1;0;0;0;1;1;14990;CORTA PELO SG-8200;PERSONAL CARE
15242885;;F;52;CHILENO;;X;PADRE LAS CASAS               ;ARAUCANIA;74980;2;2;0;0;0;2;2;74980;ALISADOR DE PELO SG-3540 MORADO MORADO;PERSONAL CARE
19098138;Soltero;M;27;CHILENO;;Z;TREGUACO                      ;BIO BIO;328690;5;3;0;0;0;5;3;328690;CORTAPELO GAMA MG 566;PERSONAL CARE
19215328;;F;26;CHILENO;;Z;TOCOPILLA                     ;ANTOFAGASTA;700770;12;7;2;1;122980;10;6;577790;ALISADOR DE PELO SG-3510 FUCSIA;PERSONAL CARE
15555799;;F;39;CHILENO;;X;VALPARAISO;VALPARAISO;38990;2;1;0;0;0;2;1;38990;AFEITADORA SG-7250 NEGRO;PERSONAL CARE
19097230;;F;27;CHILENO;;Millenial;CAUQUENES                     ;MAULE;19990;1;1;0;0;0;1;1;19990;SECADOR DE PELO SIEGEN SG-3035;PERSONAL CARE
15288875;;M;38;CHILENO;;Millenial;CHONCHI                       ;LOS LAGOS;30470;3;1;0;0;0;3;1;30470;AFEITADORA SG-7210 NEGRO;PERSONAL CARE
12488151;;F;48;CHILENO;;X;BUIN                          ;METROPOLITANA;295950;6;3;4;2;191970;2;1;103980;ALISADOR DE PELO SG-4651 ROJO;PERSONAL CARE
19703664;;F;25;CHILENO;;Z;PUENTE ALTO                   ;METROPOLITANA;667360;9;4;0;0;0;9;4;667360;ALISADOR CP14 Titanio D 4D Bvt.;PERSONAL CARE
15881186;;F;37;CHILENO;;Millenial;N/D;N/D;359940;6;5;0;0;0;6;5;359940;ALISADOR SG-3510C11 VERDE;PERSONAL CARE
17848223;Soltero;F;31;CHILENO;;Millenial;PROVIDENCIA                   ;METROPOLITANA;34990;1;1;0;0;0;1;1;34990;ALISADOR DE PELO SG-3540 MORADO MORADO;PERSONAL CARE
10467373;;F;55;CHILENO;;Boomers;REQUINOA                      ;L.G.B.OÂ´HIGGINS;327211;4;2;0;0;0;4;2;327211;CORTA PELO SG-8520;PERSONAL CARE
13910306;;F;42;CHILENO;;X;N/D;N/D;119970;3;2;2;1;79980;1;1;39990;COMBO GAMA SECADOR+ALISADOR+CEPILLO;PERSONAL CARE
18272960;;F;29;CHILENO;;Millenial;VALPARAISO                    ;VALPARAISO;224950;5;2;0;0;0;5;2;224950;ALISADOR X-WIDE DIGITAL KERATION;PERSONAL CARE
20557244;;F;22;CHILENO;;Z;QUILLOTA;VALPARAISO;74980;2;1;0;0;0;2;1;74980;COMBO GAMA SECADOR+ALISADOR+CEPILLO;PERSONAL CARE
11373406;;F;52;CHILENO;;X;TALCA                         ;MAULE;483930;7;4;0;0;0;7;4;483930;SECADOR DE PELO SIEGEN SG-3035;PERSONAL CARE
19125958;;F;26;CHILENO;;Z;SAN VICENTE                   ;L.G.B.OÂ´HIGGINS;19990;1;1;0;0;0;1;1;19990;SECADOR DE PELO SIEGEN SG-3035;PERSONAL CARE
11242350;;F;54;CHILENO;;X;LOS ANGELES                   ;BIO BIO;71990;3;2;0;0;0;3;2;71990;SECADOR DIAMOND STD;PERSONAL CARE
19943272;;M;24;CHILENO;;Z;"";"";41980;2;1;0;0;0;2;1;41980;SECADOR GAMA BORA KERATION;PERSONAL CARE
17254145;Casado;F;32;CHILENO;CIRUJANO DENTISTA;Millenial;PROVIDENCIA                   ;METROPOLITANA;21990;1;1;0;0;0;1;1;21990;DEPILADORA SG-9003;PERSONAL CARE
11449545;;F;53;CHILENO;;X;ARAUCO                        ;BIO BIO;37560;2;1;0;0;0;2;1;37560;CORTA PELO SG-8520;PERSONAL CARE
9716739;Casado;F;56;CHILENO;;Boomers;RENCA                         ;METROPOLITANA;12990;1;1;0;0;0;1;1;12990;SECADOR GAMA EOLIC MINI TRAVEL;PERSONAL CARE
12898238;;F;47;CHILENO;;X;LA PINTANA                    ;METROPOLITANA;44990;1;1;0;0;0;1;1;44990;ALISADOR X-WIDE DIGITAL KERATION;PERSONAL CARE
14270933;;M;48;CHILENO;;X;N/D;N/D;74980;2;2;0;0;0;2;2;74980;AFEITADORA SG-7250 NEGRO;PERSONAL CARE
16005434;;F;35;CHILENO;;Millenial;BUIN                          ;METROPOLITANA;25000;2;1;0;0;0;2;1;25000;CORTA PELO SG-8520;PERSONAL CARE
10776066;;M;48;CHILENO;;X;RENCA                         ;METROPOLITANA;24990;1;1;0;0;0;1;1;24990;CORTA PELO SG-8520;PERSONAL CARE
19616268;;F;25;CHILENO;;Z;MULCHEN                       ;BIO BIO;74220;4;1;0;0;0;4;1;74220;AFEITADORA SPORT SH 886 BAT;PERSONAL CARE
17060197;Soltero;F;33;CHILENO;;Millenial;N/D;N/D;150990;3;2;0;0;0;3;2;150990;COMBO GAMA DEPILADORA+SET MANICURE;PERSONAL CARE
19141492;;F;27;CHILENO;;Z;"";"";32990;1;1;0;0;0;1;1;32990;AFEITADORA S1223/41 ELECTRICA;PERSONAL CARE
23025386;;F;45;PERUANO;;Extranjero;RECOLETA                      ;METROPOLITANA;19990;1;1;0;0;0;1;1;19990;AFEITADORA SG-7210 NEGRO;PERSONAL CARE
17291296;;F;33;CHILENO;;Millenial;CURANILAHUE                   ;BIO BIO;119960;4;4;0;0;0;4;4;119960;CORTA PELO SPORT GCX 623 BVT;PERSONAL CARE
17457422;;F;32;CHILENO;;Millenial;CHILLAN;BIO-BIO;413252;5;3;2;1;263980;3;2;149272;COMBO GAMA SECADOR+ALISADOR+CEPILLO;PERSONAL CARE
19340172;;M;25;CHILENO;;Z;N/D;N/D;324970;5;2;0;0;0;5;2;324970;COMBO GAMA SECADOR+ALISADOR+CEPILLO;PERSONAL CARE
16325859;;F;35;CHILENO;;Millenial;N/D;N/D;34990;1;1;0;0;0;1;1;34990;ALISADOR DE PELO SG-3540 MORADO MORADO;PERSONAL CARE
19357234;;F;25;CHILENO;;Extranjero;ARICA                         ;ARICA Y PARINACOTA;74970;3;5;0;0;0;3;5;74970;SECADOR DE PELO SG-3012C29 MORADO;PERSONAL CARE
18381663;;F;29;CHILENO;;Millenial;VINA DEL MAR                  ;VALPARAISO;121980;2;2;1;1;99990;1;1;21990;SECADOR GAMA BORA KERATION;PERSONAL CARE
15345910;;F;39;CHILENO;;X;LA FLORIDA                    ;METROPOLITANA;1827460;11;7;6;3;1363950;5;4;463510;COMBO GAMA SECADOR+ALISADOR+CEPILLO;PERSONAL CARE
17497070;;F;31;CHILENO;;Millenial;TALCA                         ;MAULE;79980;2;1;0;0;0;2;1;79980;TRICOMBO SECADOR+ALISADOR+ONDULAD;PERSONAL CARE
25725355;Soltero;F;26;COLOMBIANO;;Extranjero;PROVIDENCIA                   ;METROPOLITANA;619590;7;6;2;3;79640;5;3;539950;SECADOR GAMA BORA KERATION;PERSONAL CARE
6301171;Casado;M;72;CHILENO;;Silencioso;SANTA CRUZ                    ;L.G.B.OÂ´HIGGINS;614960;4;2;0;0;0;4;2;614960;SECADOR DE PELO SG-3012 NEGRO;PERSONAL CARE
16511235;;M;35;CHILENO;;Millenial;SAN BERNARDO;METROPOLITANA;24990;1;1;0;0;0;1;1;24990;CORTA PELO SG-8520;PERSONAL CARE
20647807;;F;21;CHILENO;;Z;PROVIDENCIA                   ;METROPOLITANA;16980;2;1;2;1;16980;0;0;0;SECADOR DE PELO SG-3012 NEGRO;PERSONAL CARE
6192164;Divorciado;M;70;CHILENO;INGENIERO COMERCIAL;Silencioso;CONCHALI                      ;METROPOLITANA;1737810;18;4;8;2;319910;10;2;1417900;AFEITADORA SG-7250 NEGRO;PERSONAL CARE
8985087;;F;62;CHILENO;;Boomers;CARTAGENA                     ;VALPARAISO;24990;1;3;0;0;0;1;3;24990;CORTA PELO SPORT GCX 623 BVT;PERSONAL CARE
12430056;;F;48;CHILENO;;X;N/D;N/D;26990;1;1;0;0;0;1;1;26990;SECADOR DE PELO SG-3049 NEGRO;PERSONAL CARE
17630170;;F;32;CHILENO;;Millenial;COIHAIQUE                     ;AYSEN;69980;4;1;0;0;0;4;1;69980;ALISADOR DE PELO S12A(220) Shine Therapy PALTA M;PERSONAL CARE
10368266;;F;57;CHILENO;;Boomers;PEDRO AGUIRRE CERDA           ;METROPOLITANA;19990;1;1;0;0;0;1;1;19990;SECADOR DE PELO SIEGEN SG-3035;PERSONAL CARE
14241944;;F;48;CHILENO;;X;RENGO                         ;L.G.B.OÂ´HIGGINS;485420;6;2;0;0;0;6;2;485420;COMBO GAMA SECADOR+ALISADOR+CEPILLO;PERSONAL CARE
12358275;;F;51;CHILENO;;X;SAN CLEMENTE                  ;MAULE;355960;4;3;0;0;0;4;3;355960;COMBO SIEGEN AFEITADORA + MULTISTYLER SG-8440;PERSONAL CARE
6325565;;F;76;CHILENO;;Silencioso;ARICA                         ;ARICA Y PARINACOTA;308970;3;4;0;0;0;3;4;308970;ALISADOR DE PELO S12A(220) Shine Therapy PALTA M;PERSONAL CARE
5670668;;F;78;CHILENO;;Silencioso;RENCA                         ;METROPOLITANA;19990;1;1;0;0;0;1;1;19990;SECADOR DE PELO SG-3043 DC CAFE 2200 WATTS;PERSONAL CARE
11738548;;F;50;CHILENO;;X;RENCA                         ;METROPOLITANA;16990;1;1;0;0;0;1;1;16990;SECADOR DE PELO MISTRAL STD;PERSONAL CARE
16016028;;F;37;CHILENO;;Millenial;HUECHURABA;METROPOLITANA;75970;3;2;3;2;75970;0;0;0;ONDULADOR GAMA 33MM TURMALINA;PERSONAL CARE
10678305;;F;55;CHILENO;;Boomers;PROVIDENCIA                   ;METROPOLITANA;16990;1;1;0;0;0;1;1;16990;SECADOR DIAMOND STD;PERSONAL CARE
17098913;;F;33;CHILENO;;Millenial;"";"";19990;1;1;0;0;0;1;1;19990;SECADOR DE PELO SIEGEN SG-3035;PERSONAL CARE
15172805;;M;38;CHILENO;;Millenial;N/D;N/D;42000;2;1;0;0;0;2;1;42000;TRICOMBO SECADOR+ALISADOR+ONDULAD;PERSONAL CARE
11374421;;M;52;CHILENO;;X;PELARCO                       ;MAULE;22990;1;1;0;0;0;1;1;22990;AFEITADORA SG-7210 NEGRO;PERSONAL CARE
9748816;;F;58;CHILENO;;Boomers;LA LIGUA                      ;VALPARAISO;33980;2;1;0;0;0;2;1;33980;AFEITADORA SG-7210 NEGRO;PERSONAL CARE
7810635;;F;65;CHILENO;;Boomers;SAN FERNANDO;O HIGGINS;31980;2;1;0;0;0;2;1;31980;SECADOR DIAMOND STD;PERSONAL CARE
13030350;;M;46;CHILENO;;X;N/D;N/D;49410;3;1;0;0;0;3;1;49410;TRICOMBO SECADOR+ALISADOR+ONDULADOR;PERSONAL CARE
17820783;Soltero;F;31;CHILENO;;Millenial;PROVIDENCIA                   ;METROPOLITANA;12990;1;1;0;0;0;1;1;12990;SECADOR DE PELO SG-3012C29 MORADO;PERSONAL CARE
12394705;;M;48;CHILENO;;Millenial;"";"";19990;1;1;0;0;0;1;1;19990;SECADOR DE PELO SG-3043 DC CAFE 2200 WATTS;PERSONAL CARE
15089830;Soltero;F;39;CHILENO;;X;PROVIDENCIA                   ;METROPOLITANA;29990;1;1;0;0;0;1;1;29990;ALISADOR +SECADOR PELO;PERSONAL CARE
20419393;;F;22;CHILENO;;Z;N/D;N/D;199960;6;3;0;0;0;6;3;199960;SECADOR DE PELO SIEGEN SG-3035;PERSONAL CARE
16452402;;F;36;CHILENO;;Millenial;RENCA                         ;METROPOLITANA;24990;1;1;1;1;24990;0;0;0;AFEITADORA SG-7250 NEGRO;PERSONAL CARE
9665311;;M;56;CHILENO;;Boomers;PAINE                         ;METROPOLITANA;24990;1;1;0;0;0;1;1;24990;SECADOR DE PELO SE-3049C01 FUCSIA;PERSONAL CARE
7453376;;F;66;CHILENO;;Boomers;COIHAIQUE                     ;AYSEN;30980;2;1;0;0;0;2;1;30980;ONDULADOR DE PELO SG-2420 33MM;PERSONAL CARE
12140191;;M;47;CHILENO;;Millenial;N/D;N/D;12990;1;1;0;0;0;1;1;12990;SECADOR GAMA EOLIC MINI TRAVEL;PERSONAL CARE
11902059;Casado;F;51;CHILENO;TECNICO DE NIVEL SUPERIOR AYUDANTE DE ENFERMERIA;X;RENCA                         ;METROPOLITANA;39990;1;1;0;0;0;1;1;39990;ALISADOR DE PELO SG-3540 MORADO MORADO;PERSONAL CARE
8102255;;F;64;CHILENO;;Boomers;VILLA ALEMANA                 ;VALPARAISO;370950;5;3;0;0;0;5;3;370950;KIT CORTABARBA MG3731;PERSONAL CARE
13528407;Soltero;F;43;CHILENO;;X;PROVIDENCIA                   ;METROPOLITANA;26980;2;1;0;0;0;2;1;26980;ALISADOR DE PELO SG-3510 FUCSIA;PERSONAL CARE
16193838;;M;35;CHILENO;;Millenial;N/D;N/D;15000;2;1;0;0;0;2;1;15000;SECADOR DE PELO SG-3025 SILVER;PERSONAL CARE
7286653;;M;68;CHILENO;;Boomers;VALPARAISO                    ;VALPARAISO;19990;1;1;0;0;0;1;1;19990;AFEITADORA S1121/41 ELECTRICA;PERSONAL CARE
12880154;;M;47;CHILENO;;X;LA PINTANA                    ;METROPOLITANA;231970;3;2;0;0;0;3;2;231970;AFEITADORA SPORT;PERSONAL CARE
5534503;;F;75;CHILENO;;Silencioso;RENGO                         ;L.G.B.OÂ´HIGGINS;452930;7;6;0;0;0;7;6;452930;CORTA PELO HC-5850;PERSONAL CARE
18705184;;F;28;CHILENO;;Millenial;N/D;N/D;60560;3;2;0;0;0;3;2;60560;CORTA PELO SG-8520;PERSONAL CARE
19691566;;M;25;CHILENO;;Z;PROVIDENCIA                   ;METROPOLITANA;9990;1;1;1;1;9990;0;0;0;SECADOR DE PELO SG-3012 NEGRO;PERSONAL CARE
7189072;Casado;M;65;CHILENO;;Boomers;RENCA                         ;METROPOLITANA;9990;1;1;0;0;0;1;1;9990;SECADOR DE PELO SG-3012 NEGRO;PERSONAL CARE
6936111;;M;68;CHILENO;;Silencioso;REQUINOA                      ;L.G.B.OÂ´HIGGINS;114960;4;4;0;0;0;4;4;114960;AFEITADORA SG-7250 NEGRO;PERSONAL CARE
19807703;;M;24;CHILENO;;Z;TALCA                         ;MAULE;197230;3;2;0;0;0;3;2;197230;TRICOMBO SECADOR+ALISADOR+ONDULADOR;PERSONAL CARE
19647558;;F;25;CHILENO;;Z;SAN BERNARDO                  ;METROPOLITANA;38990;1;1;0;0;0;1;1;38990;ALISADOR REMIG. WET2 S27A (BV) R;PERSONAL CARE
9178655;;F;60;CHILENO;;Boomers;RANCAGUA                      ;L.G.B.OÂ´HIGGINS;49990;1;1;0;0;0;1;1;49990;ALISADOR DE PELO S12A(220) Shine Therapy PALTA M;PERSONAL CARE
14072027;;F;41;CHILENO;;X;PROVIDENCIA                   ;METROPOLITANA;12990;1;1;0;0;0;1;1;12990;SECADOR DE PELO SG-3012C29 MORADO;PERSONAL CARE
13504256;Casado;M;44;CHILENO;;X;RENCA                         ;METROPOLITANA;65450;2;1;0;0;0;2;1;65450;ALISADOR DE PELO S12A(220) Shine Therapy PALTA M;PERSONAL CARE
10699341;;F;54;CHILENO;;Boomers;CURACAVI                      ;METROPOLITANA;77230;3;2;0;0;0;3;2;77230;SECADOR DE PELO MISTRAL STD;PERSONAL CARE
14601308;;F;42;CHILENO;;X;TALCAHUANO                    ;BIO BIO;301970;3;2;0;0;0;3;2;301970;TRICOMBO SECADOR+ALISADOR+ONDULAD;PERSONAL CARE
10101575;;F;62;CHILENO;;Boomers;RENCA                         ;METROPOLITANA;29990;1;1;0;0;0;1;1;29990;SECADOR DE PELO SG-3051;PERSONAL CARE
26738587;;F;43;VENEZOLANO;;Extranjero;QUINTA NORMAL                 ;METROPOLITANA;58830;5;1;0;0;0;5;1;58830;SECADOR DE PELO SIEGEN SG-3035;PERSONAL CARE
15848583;Soltero;F;27;CHILENO;;Millenial;PROVIDENCIA                   ;METROPOLITANA;49980;2;2;0;0;0;2;2;49980;SPA PARA PIES SG-1560;PERSONAL CARE
17582735;;M;31;CHILENO;;Millenial;"";"";37350;2;1;0;0;0;2;1;37350;KIT CORTABARBA MG3711;PERSONAL CARE
8499833;;F;59;CHILENO;;Boomers;PROVIDENCIA                   ;METROPOLITANA;15240;2;2;0;0;0;2;2;15240;SECADOR DE VIAJE REMINGTON D2400;PERSONAL CARE
17885910;;F;31;CHILENO;;Millenial;VILLA ALEGRE                  ;MAULE;14990;1;1;0;0;0;1;1;14990;CORTAPELO GAMA TITANIUM T827;PERSONAL CARE
14067965;;F;41;CHILENO;;Silencioso;LOS ANGELES                   ;BIO BIO;59990;1;1;0;0;0;1;1;59990;ALISADOR DE PELO SG-4651 ROJO;PERSONAL CARE
14161782;Casado;F;40;CHILENO;INGENIERA FORESTAL;X;RENCA                         ;METROPOLITANA;21990;1;1;0;0;0;1;1;21990;SECADOR DE PELO SIEGEN SG-3035;PERSONAL CARE
19340935;;F;26;CHILENO;;Z;N/D;N/D;369990;1;3;0;0;0;1;3;369990;ALISADOR DE PELO SG-3540 MORADO MORADO;PERSONAL CARE
18892399;;F;27;CHILENO;;Millenial;SAN JAVIER                    ;MAULE;69841;2;1;0;0;0;2;1;69841;ALISADOR DE PELO SG-4651 ROJO;PERSONAL CARE
15792081;;F;37;CHILENO;;Millenial;PROVIDENCIA                   ;METROPOLITANA;829910;11;6;2;1;124980;9;5;704930;SECADOR DE PELO SE-3049C01 FUCSIA;PERSONAL CARE
7273223;;M;68;CHILENO;;Silencioso;RANCAGUA                      ;L.G.B.OÂ´HIGGINS;34990;1;1;0;0;0;1;1;34990;AFEITADORA SG-7250 NEGRO;PERSONAL CARE
16315332;;F;36;CHILENO;;Millenial;SAAVEDRA                      ;ARAUCANIA;88980;2;2;0;0;0;2;2;88980;Lapiz recortador para retoques Philips HP6389/00;PERSONAL CARE
6769448;;F;70;CHILENO;;Silencioso;CURICO                        ;MAULE;19990;1;1;0;0;0;1;1;19990;SECADOR DE PELO SIEGEN SG-3035;PERSONAL CARE
25908289;;F;39;VENEZOLANO;;Extranjero;CHILLAN                       ;BIO BIO;34990;1;1;0;0;0;1;1;34990;ALISADOR ELEGANCE LED KER;PERSONAL CARE
6443228;;F;66;CHILENO;;Boomers;LA PINTANA                    ;METROPOLITANA;48110;3;2;0;0;0;3;2;48110;CORTA PELO GM 562;PERSONAL CARE
16510303;;F;35;CHILENO;;Millenial;N/D;N/D;19990;1;1;1;1;19990;0;0;0;SECADOR DE PELO SG-3043 DC CAFE 2200 WATTS;PERSONAL CARE
5438229;Casado;M;75;CHILENO;;Silencioso;RENCA                         ;METROPOLITANA;32990;1;1;0;0;0;1;1;32990;AFEITADORA S1223/41 ELECTRICA;PERSONAL CARE
12818538;;F;47;CHILENO;;X;N/D;N/D;20240;2;2;0;0;0;2;2;20240;SECADOR GAMA BRILLIAN AQUA;PERSONAL CARE
16761843;Soltero;M;34;CHILENO;;Millenial;PROVIDENCIA                   ;METROPOLITANA;21990;1;1;0;0;0;1;1;21990;KIT CORTABARBA MG3711;PERSONAL CARE
13350466;;F;44;CHILENO;;X;PELARCO                       ;MAULE;130221;3;3;0;0;0;3;3;130221;SECADOR DE PELO SG-3051;PERSONAL CARE
18290578;;F;30;CHILENO;;Millenial;CANETE                        ;BIO BIO;-164020;1;4;-3;2;-299980;4;2;135960;SECADOR DE PELO SIEGEN SG-3035;PERSONAL CARE
10446736;;F;54;CHILENO;;Boomers;LONGAVI                       ;MAULE;21990;1;1;0;0;0;1;1;21990;KIT CORTABARBA MG3711;PERSONAL CARE
6634742;;F;70;CHILENO;;Silencioso;EL BOSQUE                     ;METROPOLITANA;545940;6;6;0;0;0;6;6;545940;ALISADOR DE PELO SG-4651 ROJO;PERSONAL CARE
16403726;;F;36;CHILENO;;Millenial;SAN ANTONIO                   ;VALPARAISO;16990;1;1;0;0;0;1;1;16990;CORTAPELO GAMA MG 566;PERSONAL CARE
11538523;Casado;M;51;CHILENO;;X;RENCA                         ;METROPOLITANA;32990;1;1;0;0;0;1;1;32990;CORTA PELO SG-8520;PERSONAL CARE
12016607;;M;48;CHILENO;;X;"";"";26990;1;1;0;0;0;1;1;26990;SECADOR DE PELO SG-3049 NEGRO;PERSONAL CARE
17903673;;F;30;CHILENO;;Millenial;N/D;N/D;59980;2;1;0;0;0;2;1;59980;CORTAPELOS GM 596;PERSONAL CARE
26265281;;F;31;VENEZOLANO;;Extranjero;PUERTO MONTT                  ;LOS LAGOS;33991;1;1;0;0;0;1;1;33991;DEPILADORA SG-9040;PERSONAL CARE
17582359;;M;35;CHILENO;;Millenial;PROVIDENCIA                   ;METROPOLITANA;21990;1;1;0;0;0;1;1;21990;KIT CORTABARBA MG3711;PERSONAL CARE
11799248;;F;50;CHILENO;;X;PADRE LAS CASAS               ;ARAUCANIA;24990;1;1;0;0;0;1;1;24990;SECADOR DE PELO SG-3051;PERSONAL CARE
26326218;;M;30;CHILENO;;Extranjero;QUILLOTA                      ;VALPARAISO;44990;1;1;0;0;0;1;1;44990;ALISADOR DE PELO S12A(220) Shine Therapy PALTA M;PERSONAL CARE
10674068;;F;57;CHILENO;;Boomers;LANCO                         ;LOS LAGOS;64990;3;1;0;0;0;3;1;64990;DEPILADORA OASIS SENSATION;PERSONAL CARE
11487769;;M;53;CHILENO;;X;N/D;N/D;21990;1;1;0;0;0;1;1;21990;SECADOR DE PELO SG-3049 NEGRO;PERSONAL CARE
9800349;;F;58;CHILENO;;Boomers;TALCA                         ;MAULE;182220;4;3;0;0;0;4;3;182220;SECADOR DE PELO SE-3049C01 FUCSIA;PERSONAL CARE
10738245;;M;53;CHILENO;;X;CONCEPCION                    ;BIO BIO;44990;1;1;0;0;0;1;1;44990;AFEITADORA S1323/41 ELECTRICA;PERSONAL CARE
11444172;;M;52;CHILENO;;X;N/D;N/D;583720;7;5;0;0;0;7;5;583720;ALISADOR REMIG. WET2 S27A (BV) R;PERSONAL CARE
14384192;;M;41;CHILENO;;X;LOS ANGELES;BIO-BIO;34990;1;1;0;0;0;1;1;34990;TRICOMBO SECADOR+ALISADOR+ONDULADOR;PERSONAL CARE
18158444;;F;33;CHILENO;;Millenial;N/D;N/D;18990;1;1;0;0;0;1;1;18990;SECADOR DE PELO D3019 PRO TITANIO;PERSONAL CARE
12224272;Casado;F;50;CHILENO;;X;PROVIDENCIA                   ;METROPOLITANA;54980;2;2;0;0;0;2;2;54980;ALISADOR GAMA BELLA SHINE;PERSONAL CARE
15192739;;M;40;CHILENO;;X;PROVIDENCIA                   ;METROPOLITANA;31990;1;1;0;0;0;1;1;31990;AFEITADORA SPORT SH 886 BAT;PERSONAL CARE
16957480;;F;33;CHILENO;;Millenial;TOLTEN                        ;ARAUCANIA;141960;4;3;0;0;0;4;3;141960;AFEITADORA SG-7250 NEGRO;PERSONAL CARE
6670931;;M;70;CHILENO;;Silencioso;CALERA                        ;VALPARAISO;103073;3;2;0;0;0;3;2;103073;AFEITADORA S1223/41 ELECTRICA;PERSONAL CARE
14369310;;M;47;CHILENO;;X;CANETE                        ;BIO BIO;16990;1;1;0;0;0;1;1;16990;CORTA PELO SPORT GCX 623 BVT;PERSONAL CARE
17254666;;M;32;CHILENO;;Millenial;"";"";55000;2;1;0;0;0;2;1;55000;ALISADOR DE PELO SG-4651 ROJO;PERSONAL CARE
7978091;;F;65;CHILENO;;Boomers;ANCUD                         ;LOS LAGOS;20990;1;1;0;0;0;1;1;20990;SECADOR GAMA BRILLIAN AQUA;PERSONAL CARE
12133578;;F;56;CHILENO;;Boomers;LA CISTERNA                   ;METROPOLITANA;69980;2;2;0;0;0;2;2;69980;AFEITADORA SG-7250 NEGRO;PERSONAL CARE
19745212;;F;25;CHILENO;;Z;N/D;N/D;29990;1;1;1;1;29990;0;0;0;TRICOMBO SECADOR+ALISADOR+ONDULADOR;PERSONAL CARE
14213241;;M;41;CHILENO;;X;PROVIDENCIA                   ;METROPOLITANA;17990;1;1;0;0;0;1;1;17990;CORTA PELO SG-8200;PERSONAL CARE
15986458;;F;37;CHILENO;;Millenial;TEMUCO                        ;ARAUCANIA;119980;2;2;0;0;0;2;2;119980;ALISADOR DE PELO SG-3540 MORADO MORADO;PERSONAL CARE
10741789;;M;53;CHILENO;;X;PROVIDENCIA                   ;METROPOLITANA;32990;1;1;0;0;0;1;1;32990;AFEITADORA S1223/41 ELECTRICA;PERSONAL CARE
15357533;;M;39;CHILENO;;Silencioso;PROVIDENCIA                   ;METROPOLITANA;19990;1;1;0;0;0;1;1;19990;KIT CORTABARBA MG3711;PERSONAL CARE
9801557;;F;57;CHILENO;;Boomers;ANGOL                         ;ARAUCANIA;63970;3;2;0;0;0;3;2;63970;SECADOR DE PELO SG-3012 NEGRO;PERSONAL CARE
17381462;;F;32;CHILENO;;Millenial;PROVIDENCIA                   ;METROPOLITANA;34990;1;1;0;0;0;1;1;34990;DEPILADORA SG-9004EX;PERSONAL CARE
5796449;;M;73;CHILENO;;Silencioso;VALDIVIA                      ;LOS RIOS;12990;1;1;0;0;0;1;1;12990;CORTA PELO SG-8200;PERSONAL CARE
8424287;;M;51;CHILENO;;X;RENCA                         ;METROPOLITANA;189980;2;2;0;0;0;2;2;189980;COMBO SIEGEN AFEITADORA + MULTISTYLER SG-8440;PERSONAL CARE
13374665;;F;43;CHILENO;;X;PARRAL                        ;MAULE;31990;1;1;0;0;0;1;1;31990;KIT CORTABARBA MG3731;PERSONAL CARE
12950109;;F;46;CHILENO;;X;RENCA                         ;METROPOLITANA;33980;2;1;0;0;0;2;1;33980;SECADOR GAMA BORA KERATION;PERSONAL CARE
18298937;;F;29;CHILENO;;Millenial;VINA DEL MAR                  ;VALPARAISO;14990;1;1;0;0;0;1;1;14990;CORTA PELO HC3505;PERSONAL CARE
15730888;;M;38;CHILENO;;X;MALLOA                        ;L.G.B.OÂ´HIGGINS;406980;2;2;0;0;0;2;2;406980;CORTA PELO SG-8410;PERSONAL CARE
17754969;;M;31;CHILENO;;Millenial;TUCAPEL                       ;BIO BIO;12990;1;1;0;0;0;1;1;12990;SECADOR DE PELO SG-3012 NEGRO;PERSONAL CARE
16295828;;F;35;CHILENO;;Millenial;CANETE                        ;BIO BIO;49990;1;1;0;0;0;1;1;49990;ALISADOR DE PELO S12A(220) Shine Therapy PALTA M;PERSONAL CARE
11587905;;M;53;CHILENO;;X;VILLARICA                     ;ARAUCANIA;275970;3;3;0;0;0;3;3;275970;CORTA PELO SG-8520;PERSONAL CARE
18246886;;F;29;CHILENO;;Millenial;PROVIDENCIA                   ;METROPOLITANA;32990;1;1;0;0;0;1;1;32990;SECADOR DE PELO SG-3051;PERSONAL CARE
8344788;;F;60;CHILENO;;Boomers;RENCA                         ;METROPOLITANA;24990;1;1;0;0;0;1;1;24990;SECADOR DE PELO SG-3051;PERSONAL CARE
17444386;;F;32;CHILENO;;Millenial;"";"";32000;2;1;0;0;0;2;1;32000;SECADOR DE PELO SG-3051;PERSONAL CARE
13202396;;F;47;CHILENO;;X;N/D;N/D;1525960;4;2;0;0;0;4;2;1525960;SECADOR DE PELO SIEGEN SG-3035;PERSONAL CARE
11440155;;F;53;CHILENO;;X;N/D;N/D;153970;3;2;0;0;0;3;2;153970;TRICOMBO SECADOR+ALISADOR+ONDULADOR;PERSONAL CARE
18889305;Soltero;F;28;CHILENO;;Millenial;PROVIDENCIA                   ;METROPOLITANA;12990;1;1;0;0;0;1;1;12990;SECADOR DE PELO SIEGEN SG-3035;PERSONAL CARE
14549536;;F;46;CHILENO;;X;CANETE                        ;BIO BIO;169980;2;2;0;0;0;2;2;169980;ALISADOR +SECADOR PELO;PERSONAL CARE
18285636;;F;30;CHILENO;;Millenial;PROVIDENCIA                   ;METROPOLITANA;19990;1;1;0;0;0;1;1;19990;CORTA PELO HC3520;PERSONAL CARE
16215966;Casado;F;36;CHILENO;ADMINISTRADOR PUBLICO;Silencioso;PROVIDENCIA                   ;METROPOLITANA;13990;1;1;0;0;0;1;1;13990;SECADOR DE PELO SG-3025 SILVER;PERSONAL CARE
8265989;;M;57;CHILENO;;Boomers;RENCA                         ;METROPOLITANA;29990;1;1;0;0;0;1;1;29990;AFEITADORA S1121/41 ELECTRICA;PERSONAL CARE
7682632;;M;63;CHILENO;;Boomers;PROVIDENCIA                   ;METROPOLITANA;29990;1;1;0;0;0;1;1;29990;CORTA PELO SG-8520;PERSONAL CARE
18575872;;F;28;CHILENO;;Millenial;N/D;N/D;39990;1;1;0;0;0;1;1;39990;ALISADOR DE PELO S12A(220) Shine Therapy PALTA M;PERSONAL CARE
10021777;;M;54;CHILENO;;Boomers;N/D;N/D;64990;1;1;0;0;0;1;1;64990;ALISADOR DE PELO SG-4651 ROJO;PERSONAL CARE
18741431;;M;28;CHILENO;;Millenial;SAN BERNARDO                  ;METROPOLITANA;9990;1;1;0;0;0;1;1;9990;SECADOR DE PELO SG-3012 NEGRO;PERSONAL CARE
10922218;Casado;M;53;CHILENO;;X;RENCA                         ;METROPOLITANA;39980;2;1;0;0;0;2;1;39980;CORTABARBA BT3206;PERSONAL CARE
8184218;;M;67;CHILENO;;Boomers;OVALLE                        ;COQUIMBO;102980;3;2;0;0;0;3;2;102980;ALISADOR DE PELO S12A(220) Shine Therapy PALTA M;PERSONAL CARE
16733231;;F;34;CHILENO;;Millenial;PROVIDENCIA                   ;METROPOLITANA;10990;1;1;0;0;0;1;1;10990;SECADOR GAMA EOLIC MINI TRAVEL;PERSONAL CARE
11787749;;M;50;CHILENO;;X;LICANTEN                      ;MAULE;214971;4;2;0;0;0;4;2;214971;SECADOR DE PELO SG-3012 NEGRO;PERSONAL CARE
18960983;Soltero;F;27;CHILENO;;Z;PROVIDENCIA                   ;METROPOLITANA;14990;1;1;0;0;0;1;1;14990;ALISADOR DE PELO HP8321;PERSONAL CARE
15422334;;F;40;CHILENO;;X;PROVIDENCIA                   ;METROPOLITANA;39990;1;1;0;0;0;1;1;39990;DEPILADORA SG-9004EX;PERSONAL CARE
17916983;;M;30;CHILENO;;Millenial;PROVIDENCIA                   ;METROPOLITANA;34990;1;1;0;0;0;1;1;34990;CORTA PELO MGK3220 BLACK BOX MN;PERSONAL CARE
6322312;Casado;M;70;CHILENO;;Silencioso;PROVIDENCIA                   ;METROPOLITANA;24990;1;1;0;0;0;1;1;24990;CORTA PELO SG-8410;PERSONAL CARE
10218981;Casado;F;58;CHILENO;;Boomers;RENCA                         ;METROPOLITANA;21990;1;1;0;0;0;1;1;21990;DEPILADORA SG-9003;PERSONAL CARE
14041414;;F;41;CHILENO;;X;ANCUD                         ;LOS LAGOS;54990;1;1;0;0;0;1;1;54990;DEPILADORA BRE285/00 CONVENCIONAL;PERSONAL CARE
16539077;;F;35;CHILENO;;Millenial;"";"";16990;1;1;0;0;0;1;1;16990;SECADOR GAMA BRILLIAN AQUA;PERSONAL CARE
11513834;;F;51;CHILENO;;X;ILLAPEL                       ;COQUIMBO;336980;2;2;0;0;0;2;2;336980;Pack depiladoras HP6306/00 + BRE225/00;PERSONAL CARE
20094733;;F;23;CHILENO;;Z;LAUTARO;ARAUCANIA;59980;2;2;0;0;0;2;2;59980;TRICOMBO SECADOR+ALISADOR+ONDULADOR;PERSONAL CARE
12675248;;M;48;CHILENO;;X;PUENTE ALTO                   ;METROPOLITANA;75650;4;2;0;0;0;4;2;75650;CORTAPELOS GM 596;PERSONAL CARE
11079989;;F;56;CHILENO;;Boomers;LUMACO                        ;ARAUCANIA;41980;2;1;0;0;0;2;1;41980;AFEITADORA SG-7210 NEGRO;PERSONAL CARE
13578143;;F;44;CHILENO;;X;CHILLAN VIEJO                 ;BIO BIO;168980;2;4;0;0;0;2;4;168980;DEPILADORA OASIS NEXT BVT;PERSONAL CARE
10543512;;M;55;CHILENO;;Boomers;N/D;N/D;13990;1;1;0;0;0;1;1;13990;ONDULADOR DE PELO SG-2411 25MM;PERSONAL CARE
10900736;;F;57;CHILENO;;Boomers;RENCA                         ;METROPOLITANA;0;0;2;0;0;0;0;2;0;AFEITADORA GAMA SH 860;PERSONAL CARE
16690199;;F;35;CHILENO;;Millenial;LOTA                          ;BIO BIO;80980;2;2;0;0;0;2;2;80980;ALISADOR DE PELO SG-4651 ROJO;PERSONAL CARE
17045139;;F;33;CHILENO;;Millenial;PARRAL                        ;MAULE;17990;1;1;0;0;0;1;1;17990;ALISADOR PELO FINA CP1;PERSONAL CARE
9455013;;F;58;CHILENO;;Boomers;CORONEL                       ;BIO BIO;27140;2;1;0;0;0;2;1;27140;CORTA PELO SG-8520;PERSONAL CARE
15945702;;M;44;CHILENO;;X;CHILLAN                       ;BIO BIO;39990;1;1;0;0;0;1;1;39990;ALISADOR DE PELO I X-WIDE ST TITAN KERATIN GRIS;PERSONAL CARE
16348059;;M;35;CHILENO;;Millenial;PROVIDENCIA                   ;METROPOLITANA;37240;2;2;0;0;0;2;2;37240;CORTA PELO MGK3220 BLACK BOX MN;PERSONAL CARE
9158352;Casado;F;61;CHILENO;;Boomers;PROVIDENCIA                   ;METROPOLITANA;14990;1;1;0;0;0;1;1;14990;CORTA PELO GM 562;PERSONAL CARE
7804778;;M;66;CHILENO;;Boomers;RENCA                         ;METROPOLITANA;19990;1;1;0;0;0;1;1;19990;DEPILADORA BRE225/00;PERSONAL CARE
15849875;;M;37;CHILENO;;Millenial;VILLARICA                     ;ARAUCANIA;59980;2;1;0;0;0;2;1;59980;DEPILADORA OASIS LOOK BVT;PERSONAL CARE
16949722;;F;33;CHILENO;;Millenial;PADRE LAS CASAS               ;ARAUCANIA;34990;1;1;0;0;0;1;1;34990;AFEITADORA SH 887 WD BAT;PERSONAL CARE
15759820;;F;37;CHILENO;;Millenial;PROVIDENCIA                   ;METROPOLITANA;24990;1;1;0;0;0;1;1;24990;ALISADOR GAMA BELLA SHINE;PERSONAL CARE
10499967;;M;55;CHILENO;;X;ARICA                         ;ARICA Y PARINACOTA;18990;1;1;0;0;0;1;1;18990;ALISADORA SIEGEN SG-3510C06;PERSONAL CARE
16160574;;F;37;CHILENO;;Millenial;N/D;N/D;24990;1;1;0;0;0;1;1;24990;CORTA PELO SG-8520;PERSONAL CARE
24798422;;F;22;BOLIVIANO;;Extranjero;"";"";16990;1;1;0;0;0;1;1;16990;AFEITADORA SPORT;PERSONAL CARE
13936052;;M;42;CHILENO;;X;SAN JOAQUIN                   ;METROPOLITANA;173980;2;1;2;1;173980;0;0;0;DEPILADORA BRI920/00 IPL LUMEA ADVANCE;PERSONAL CARE
10074562;;F;59;CHILENO;;Boomers;VALLENAR;ATACAMA;14990;1;1;0;0;0;1;1;14990;SECADOR DE PELO SG-3012 NEGRO;PERSONAL CARE
15125031;;F;40;CHILENO;;X;PROVIDENCIA                   ;METROPOLITANA;39980;2;1;0;0;0;2;1;39980;ALISADOR ELEGANCE LED BLOOM VT;PERSONAL CARE
16636209;;F;34;CHILENO;;Millenial;PUERTO MONTT                  ;LOS LAGOS;108530;3;1;3;1;108530;0;0;0;MEN SHAVER SG-7280;PERSONAL CARE
19414551;;F;26;CHILENO;;Z;CHILLAN                       ;BIO BIO;16990;1;1;0;0;0;1;1;16990;AFEITADORA SPORT;PERSONAL CARE
16975027;;F;34;CHILENO;;Millenial;COIHAIQUE                     ;AYSEN;18990;1;1;0;0;0;1;1;18990;SECADOR GAMA BRILLIAN AQUA;PERSONAL CARE
24671891;;F;39;BOLIVIANO;;Extranjero;IQUIQUE                       ;TARAPACA;94950;5;2;5;2;94950;0;0;0;ALISADOR +SECADOR PELO;PERSONAL CARE
9249943;;M;60;CHILENO;;Boomers;TEMUCO                        ;ARAUCANIA;54990;1;1;0;0;0;1;1;54990;ALISADOR DE PELO SG-4651 ROJO;PERSONAL CARE
9808230;;M;56;CHILENO;;Boomers;INDEPENDENCIA                 ;METROPOLITANA;24990;1;1;1;1;24990;0;0;0;CORTAPELOS GM 596;PERSONAL CARE
14451577;;F;50;CHILENO;;X;RENCA                         ;METROPOLITANA;34990;1;1;0;0;0;1;1;34990;AFEITADORA SH 887 WD BAT;PERSONAL CARE
18016506;Soltero;F;30;CHILENO;;Millenial;PROVIDENCIA                   ;METROPOLITANA;29990;1;1;0;0;0;1;1;29990;AFEITADORA SG-7250 NEGRO;PERSONAL CARE
17292640;;F;33;CHILENO;;Millenial;PROVIDENCIA                   ;METROPOLITANA;39990;1;1;0;0;0;1;1;39990;TRICOMBO SECADOR+ALISADOR+ONDULADOR;PERSONAL CARE
14372856;;F;47;CHILENO;;X;TALCAHUANO                    ;BIO BIO;24990;1;1;0;0;0;1;1;24990;ALISADOR +SECADOR PELO;PERSONAL CARE
15711951;;F;38;CHILENO;;X;PROVIDENCIA                   ;METROPOLITANA;39990;1;1;0;0;0;1;1;39990;ALISADOR DE PELO S12A(220) Shine Therapy PALTA M;PERSONAL CARE
7142088;;F;69;CHILENO;;Silencioso;TALCA                         ;MAULE;16990;1;1;0;0;0;1;1;16990;ALISADORA SIEGEN SG-3510C06;PERSONAL CARE
14390318;;F;44;CHILENO;;X;TALCAHUANO                    ;BIO BIO;19990;1;1;0;0;0;1;1;19990;SECADOR GAMA BORA KERATION;PERSONAL CARE
7283640;;F;65;CHILENO;;Boomers;LINARES                       ;MAULE;29990;1;1;0;0;0;1;1;29990;DEPILADORA SG-9004EX;PERSONAL CARE
18558182;;F;28;CHILENO;;Millenial;RENGO                         ;L.G.B.OÂ´HIGGINS;31990;1;1;0;0;0;1;1;31990;ALISADOR AQUA THERAPY LED;PERSONAL CARE
18180616;;F;30;CHILENO;;Silencioso;PROVIDENCIA                   ;METROPOLITANA;16990;1;1;0;0;0;1;1;16990;SECADOR GAMA BRILLIAN AQUA;PERSONAL CARE
18468553;;F;29;CHILENO;;Millenial;SAN BERNARDO                  ;METROPOLITANA;39990;1;1;0;0;0;1;1;39990;DEPILADORA 3170 BRAUN;PERSONAL CARE
18895901;;F;27;CHILENO;;Z;N/D;N/D;36990;1;1;1;1;36990;0;0;0;Pack depiladoras HP6306/00 + BRE225/00;PERSONAL CARE
18199386;;M;30;CHILENO;;Millenial;MAIPU                         ;METROPOLITANA;124960;4;2;0;0;0;4;2;124960;DEPILADORA SES 5/500 PINK BOX MN;PERSONAL CARE
18311808;;M;29;CHILENO;;Millenial;ANTOFAGASTA                   ;ANTOFAGASTA;16990;1;1;0;0;0;1;1;16990;SECADOR GAMA BRILLIAN AQUA;PERSONAL CARE
12960190;;F;46;CHILENO;;X;N/D;N/D;24990;1;1;0;0;0;1;1;24990;ALISADOR +SECADOR PELO;PERSONAL CARE
17504275;Soltero;F;32;CHILENO;;Millenial;PROVIDENCIA                   ;METROPOLITANA;179990;1;1;0;0;0;1;1;179990;DEPILADORA LASER SIEGEN SG-9303;PERSONAL CARE
13031158;;F;46;CHILENO;;X;PROVIDENCIA                   ;METROPOLITANA;14990;1;1;0;0;0;1;1;14990;ONDULADOR GAMA 33MM TURMALINA;PERSONAL CARE
9639092;;F;56;CHILENO;;Boomers;CHIMBARONGO                   ;L.G.B.OÂ´HIGGINS;37980;2;2;0;0;0;2;2;37980;DEPILADORA BRE225/00;PERSONAL CARE
17163206;Soltero;F;32;CHILENO;;Millenial;PROVIDENCIA                   ;METROPOLITANA;15990;1;1;0;0;0;1;1;15990;CORTA PELO SG-8200;PERSONAL CARE
10646317;;F;58;CHILENO;;Boomers;OVALLE                        ;COQUIMBO;29980;2;1;0;0;0;2;1;29980;AFEITADORA SG-7210 NEGRO;PERSONAL CARE
14338275;;M;47;CHILENO;;X;N/D;N/D;134980;2;2;0;0;0;2;2;134980;ALISADOR +SECADOR PELO;PERSONAL CARE
9392269;;M;60;CHILENO;;Boomers;PROVIDENCIA                   ;METROPOLITANA;16990;1;1;0;0;0;1;1;16990;AFEITADORA SPORT;PERSONAL CARE
16702965;Soltero;F;34;CHILENO;PROFESOR;Millenial;PROVIDENCIA                   ;METROPOLITANA;16990;1;1;0;0;0;1;1;16990;Lapiz recortador para retoques Philips HP6389/00;PERSONAL CARE
15737856;Casado;M;38;CHILENO;;X;PROVIDENCIA                   ;METROPOLITANA;19990;1;1;0;0;0;1;1;19990;CORTA PELO SG-8410;PERSONAL CARE
13331959;;M;43;CHILENO;;X;PROVIDENCIA                   ;METROPOLITANA;99990;1;1;0;0;0;1;1;99990;DEPILADORA IPL MAGNA PK;PERSONAL CARE
19984517;;F;24;CHILENO;;Z;PROVIDENCIA                   ;METROPOLITANA;29990;1;1;1;1;29990;0;0;0;COMBO GAMA SECADOR+ALISADOR+CEPILLO;PERSONAL CARE
6638042;;M;66;CHILENO;;Boomers;TALCAHUANO                    ;BIO BIO;37980;2;1;0;0;0;2;1;37980;SECADOR GAMA BORA KERATION;PERSONAL CARE
17398492;;F;32;CHILENO;;Millenial;MARIA PINTO                   ;METROPOLITANA;269970;3;3;0;0;0;3;3;269970;DEPILADORA BRE255/00;PERSONAL CARE
16327010;;M;36;CHILENO;;Millenial;TALCAHUANO                    ;BIO BIO;17990;1;1;0;0;0;1;1;17990;SECADOR DE PELO MISTRAL STD;PERSONAL CARE
6188107;;M;69;CHILENO;;Extranjero;CABRERO                       ;BIO BIO;29990;1;1;0;0;0;1;1;29990;AFEITADORA SG-7250 NEGRO;PERSONAL CARE
14209150;;F;41;CHILENO;;X;PROVIDENCIA                   ;METROPOLITANA;13990;1;1;0;0;0;1;1;13990;SECADOR DE PELO MISTRAL STD;PERSONAL CARE
13894698;;F;41;CHILENO;;X;MAIPU                         ;METROPOLITANA;9990;1;1;0;0;0;1;1;9990;SECADOR GAMA EOLIC MINI TRAVEL;PERSONAL CARE
19851700;;F;24;CHILENO;;Silencioso;PROVIDENCIA                   ;METROPOLITANA;29990;1;1;1;1;29990;0;0;0;TRICOMBO SECADOR+ALISADOR+ONDULADOR;PERSONAL CARE
27193598;;M;0;"";;Extranjero;PROVIDENCIA                   ;METROPOLITANA;10990;1;1;1;1;10990;0;0;0;ONDULADOR GAMA 33MM TURMALINA;PERSONAL CARE
16649977;;F;34;CHILENO;;Millenial;N/D;N/D;29990;1;1;0;0;0;1;1;29990;COMBO GAMA SECADOR+ALISADOR+CEPILLO;PERSONAL CARE
16684141;;F;34;CHILENO;;Millenial;VINA DEL MAR                  ;VALPARAISO;39990;1;1;0;0;0;1;1;39990;COMBO SIEGEN AFEITADORA + MULTISTYLER SG-8440;PERSONAL CARE
12279371;;M;50;CHILENO;;X;PROVIDENCIA                   ;METROPOLITANA;109220;4;2;0;0;0;4;2;109220;AFEITADORA S1121/41 ELECTRICA;PERSONAL CARE
18920165;Soltero;F;26;CHILENO;INGENIERO EN PREVENCION DE RIESGOS;Z;PROVIDENCIA                   ;METROPOLITANA;28570;2;1;0;0;0;2;1;28570;DEPILADORA BRE225/00;PERSONAL CARE
11079283;;F;55;CHILENO;;Boomers;LO ESPEJO                     ;METROPOLITANA;24990;1;1;0;0;0;1;1;24990;AFEITADORA QP2521/50 ONE BLADE GRAFITO;PERSONAL CARE
19970671;;F;23;CHILENO;;Z;ANCUD                         ;LOS LAGOS;47130;3;2;0;0;0;3;2;47130;DEPILADORA BRE255/00;PERSONAL CARE
15983223;Soltero;M;34;CHILENO;;Millenial;PROVIDENCIA                   ;METROPOLITANA;252820;4;2;4;2;252820;0;0;0;COMBO GAMA SECADOR+ALISADOR+CEPILLO;PERSONAL CARE
22197303;;F;46;PERUANO;;Extranjero;RECOLETA                      ;METROPOLITANA;16990;1;1;0;0;0;1;1;16990;ALISADORA SIEGEN SG-3510C06;PERSONAL CARE
18444165;;M;29;CHILENO;;Millenial;PROVIDENCIA;METROPOLITANA;29990;1;1;0;0;0;1;1;29990;COMBO GAMA SECADOR+ALISADOR+CEPILLO;PERSONAL CARE
16194925;;F;35;CHILENO;;Millenial;RENCA                         ;METROPOLITANA;24990;1;1;0;0;0;1;1;24990;CORTAPELOS GM 596;PERSONAL CARE
11397358;;M;53;CHILENO;;X;PROVIDENCIA                   ;METROPOLITANA;349980;2;2;0;0;0;2;2;349980;CORTA PELO SG-8410;PERSONAL CARE
8302080;Soltero;M;59;CHILENO;INGENIERO AGRICOLA;Boomers;RENCA                         ;METROPOLITANA;29990;1;1;0;0;0;1;1;29990;AFEITADORA SG-7250 NEGRO;PERSONAL CARE
16099675;;F;36;CHILENO;;Millenial;PROVIDENCIA                   ;METROPOLITANA;62990;2;1;2;1;62990;0;0;0;DEPILADORA IPL Verina Bvt;PERSONAL CARE
4662457;;M;78;CHILENO;;Silencioso;RENCA                         ;METROPOLITANA;34990;1;1;0;0;0;1;1;34990;AFEITADORA SH 887 WD BAT;PERSONAL CARE
16496429;;F;35;CHILENO;;Millenial;N/D;N/D;66230;3;1;0;0;0;3;1;66230;DEPILADORA OASIS SENSATION;PERSONAL CARE
14228940;;M;41;CHILENO;;X;RENCA                         ;METROPOLITANA;31990;1;1;0;0;0;1;1;31990;AFEITADORA SG-7250 NEGRO;PERSONAL CARE
14105277;;F;40;CHILENO;;X;ARICA                         ;ARICA Y PARINACOTA;79990;1;1;1;1;79990;0;0;0;DEPILADORA IPL MAGNA PK;PERSONAL CARE
10502746;;F;56;CHILENO;;Boomers;SAN FERNANDO                  ;L.G.B.OÂ´HIGGINS;58970;3;3;0;0;0;3;3;58970;SPA PARA PIES SG-1560;PERSONAL CARE
16810613;;F;34;CHILENO;;Silencioso;PROVIDENCIA                   ;METROPOLITANA;9990;1;1;0;0;0;1;1;9990;SECADOR GAMA EOLIC MINI TRAVEL;PERSONAL CARE
16013317;;M;37;CHILENO;;Millenial;ARAUCO                        ;BIO BIO;75420;6;1;0;0;0;6;1;75420;DEPILADORA OASIS SENSATION;PERSONAL CARE
9820454;;F;57;CHILENO;;Boomers;PANGUIPULLI                   ;LOS LAGOS;89980;2;2;0;0;0;2;2;89980;AFEITADORA SG-7210 NEGRO;PERSONAL CARE
16164591;;F;35;CHILENO;;Millenial;LA GRANJA                     ;METROPOLITANA;41980;2;1;0;0;0;2;1;41980;CORTAPELOS GM 596;PERSONAL CARE
10887658;;F;51;CHILENO;;X;N/D;N/D;157970;3;3;0;0;0;3;3;157970;AFEITADORA S1121/41 ELECTRICA;PERSONAL CARE
16688282;;M;34;CHILENO;;Millenial;PROVIDENCIA                   ;METROPOLITANA;29990;1;1;0;0;0;1;1;29990;AFEITADORA SPORT SH 886 BAT;PERSONAL CARE
16990093;;F;34;CHILENO;;Millenial;RENCA                         ;METROPOLITANA;34990;1;1;0;0;0;1;1;34990;AFEITADORA SH 887 WD BAT;PERSONAL CARE
18484226;Soltero;M;32;CHILENO;INGENIERO AGRICOLA;Millenial;PROVIDENCIA                   ;METROPOLITANA;29990;1;1;0;0;0;1;1;29990;CORTA PELO SG-8520;PERSONAL CARE
20016404;;M;23;CHILENO;;Z;VALDIVIA                      ;LOS LAGOS;107970;3;2;0;0;0;3;2;107970;ALISADOR DE PELO S12A(220) Shine Therapy PALTA M;PERSONAL CARE
17758347;;F;31;CHILENO;;Silencioso;PROVIDENCIA                   ;METROPOLITANA;149990;2;1;2;1;149990;0;0;0;DEPILADORA BRI920/00 IPL LUMEA ADVANCE;PERSONAL CARE
18256090;;F;30;CHILENO;;Millenial;QUILLOTA                      ;VALPARAISO;29990;1;1;1;1;29990;0;0;0;COMBO SIEGEN AFEITADORA + MULTISTYLER SG-8440;PERSONAL CARE
19166095;;M;27;CHILENO;;Z;N/D;N/D;20792;1;1;0;0;0;1;1;20792;SECADOR DE PELO SE-3049C01 FUCSIA;PERSONAL CARE
4915642;;M;78;CHILENO;;Silencioso;VALDIVIA                      ;LOS LAGOS;17990;1;1;0;0;0;1;1;17990;AFEITADORA SPORT;PERSONAL CARE
10166256;;F;56;CHILENO;;Boomers;OVALLE                        ;COQUIMBO;23990;1;1;0;0;0;1;1;23990;SECADOR DE PELO SIEGEN SG-3049C02;PERSONAL CARE
20021215;;F;23;CHILENO;;Z;TIRUA                         ;BIO BIO;76980;2;1;0;0;0;2;1;76980;ALISADOR DE PELO S12A(220) Shine Therapy PALTA M;PERSONAL CARE
15121835;;M;40;CHILENO;;X;N/D;N/D;19980;2;1;0;0;0;2;1;19980;SECADOR DE VIAJE REMINGTON D2400;PERSONAL CARE
17866558;Soltero;M;30;CHILENO;ANALISTA PROGRAMADOR;Millenial;PROVIDENCIA                   ;METROPOLITANA;12990;1;1;0;0;0;1;1;12990;SECADOR DIAMOND STD;PERSONAL CARE
19975460;;F;23;CHILENO;;Silencioso;PROVIDENCIA                   ;METROPOLITANA;9990;1;1;0;0;0;1;1;9990;RECORTADOR DE VELLO NT3160/15 PHILIPS;PERSONAL CARE
26069783;;M;45;EXTRANJERO - NO INFORMA NACIONALIDAD;;Extranjero;INDEPENDENCIA                 ;METROPOLITANA;47670;2;1;0;0;0;2;1;47670;ALISADOR DE PELO SG-3540 MORADO MORADO;PERSONAL CARE
18672715;;F;28;CHILENO;;Silencioso;PROVIDENCIA                   ;METROPOLITANA;16990;1;1;0;0;0;1;1;16990;SECADOR DIAMOND STD;PERSONAL CARE
12801119;;F;47;CHILENO;;X;CALAMA                        ;ANTOFAGASTA;9990;1;1;0;0;0;1;1;9990;ONDULADOR SIEGEN SG-2352;PERSONAL CARE
11608641;Soltero;M;51;CHILENO;;X;RENCA                         ;METROPOLITANA;26990;1;1;0;0;0;1;1;26990;CORTAPELOS GM 596;PERSONAL CARE
18729985;Soltero;F;27;CHILENO;;Millenial;PROVIDENCIA                   ;METROPOLITANA;24990;1;1;1;1;24990;0;0;0;ALISADOR ELEGANCE LED BLOOM VT;PERSONAL CARE
7497577;;M;67;CHILENO;;Boomers;RENGO                         ;L.G.B.OÂ´HIGGINS;29393;1;1;0;0;0;1;1;29393;AFEITADORA S1323/41 ELECTRICA;PERSONAL CARE
19875453;;F;24;CHILENO;;Z;N/D;N/D;32990;1;1;0;0;0;1;1;32990;ALISADOR ELEGANCE LED KER;PERSONAL CARE
10687019;;M;56;CHILENO;;Boomers;TEMUCO                        ;ARAUCANIA;32990;1;1;0;0;0;1;1;32990;AFEITADORA SPORT SH 886 BAT;PERSONAL CARE
15091685;;F;39;CHILENO;;X;PROVIDENCIA                   ;METROPOLITANA;26990;1;1;0;0;0;1;1;26990;CORTAPELOS GM 596;PERSONAL CARE
11945472;Soltero;F;50;CHILENO;;X;EL QUISCO                     ;VALPARAISO;28990;1;1;0;0;0;1;1;28990;DEPILADORA SG-9004EX;PERSONAL CARE
15269559;;M;39;CHILENO;;X;FUTRONO                       ;LOS RIOS;26990;1;1;0;0;0;1;1;26990;CORTAPELOS GM 596;PERSONAL CARE
5980683;;M;74;CHILENO;;Silencioso;CONCEPCION                    ;BIO BIO;16990;1;1;0;0;0;1;1;16990;SECADOR DE PELO SG-3043 DC CAFE 2200 WATTS;PERSONAL CARE
13057364;;F;45;CHILENO;;X;PROVIDENCIA                   ;METROPOLITANA;32990;1;1;0;0;0;1;1;32990;ALISADOR ELEGANCE LED KER;PERSONAL CARE
9541557;;M;60;CHILENO;;Boomers;PROVIDENCIA                   ;METROPOLITANA;20990;1;1;0;0;0;1;1;20990;AFEITADORA SG-7210 NEGRO;PERSONAL CARE
20206131;;F;22;CHILENO;;Silencioso;PROVIDENCIA                   ;METROPOLITANA;29990;1;1;0;0;0;1;1;29990;DEPILADORA SG-9004EX;PERSONAL CARE
17861048;;F;36;CHILENO;;Millenial;TALCA                         ;MAULE;25240;2;2;0;0;0;2;2;25240;ALISADOR ELEGANCE LED BLOOM VT;PERSONAL CARE
16898803;;F;33;CHILENO;;Millenial;TALCAHUANO                    ;BIO BIO;38980;2;1;0;0;0;2;1;38980;ALISADOR REMIG. WET2 S27A (BV) R;PERSONAL CARE
17053041;;F;33;CHILENO;;Silencioso;PROVIDENCIA                   ;METROPOLITANA;19990;1;1;0;0;0;1;1;19990;ALISADOR SG3510C09 MORADO PLACAS DE CERAMICA 21;PERSONAL CARE
7476096;;F;68;CHILENO;;Extranjero;EL TABO                       ;VALPARAISO;19990;1;1;0;0;0;1;1;19990;ALISADOR SG3510C09 MORADO PLACAS DE CERAMICA 21;PERSONAL CARE
25899638;;F;45;COLOMBIANO;;Extranjero;N/D;N/D;47670;2;1;0;0;0;2;1;47670;CORTA PELO HC-5850;PERSONAL CARE
8745279;;M;62;CHILENO;;Boomers;CHIMBARONGO                   ;L.G.B.OÂ´HIGGINS;23992;1;1;0;0;0;1;1;23992;AFEITADORA SG-7250 NEGRO;PERSONAL CARE
17982377;;F;30;CHILENO;;Millenial;PROVIDENCIA                   ;METROPOLITANA;99980;2;1;0;0;0;2;1;99980;ALISADOR SIEGEN SG-4716;PERSONAL CARE
15392934;;F;41;CHILENO;;X;PROVIDENCIA                   ;METROPOLITANA;28820;3;1;0;0;0;3;1;28820;ALISADOR PELO FINA CP1;PERSONAL CARE
20080316;;F;23;CHILENO;;Z;PROVIDENCIA                   ;METROPOLITANA;9990;1;1;0;0;0;1;1;9990;SECADOR GAMA EOLIC MINI TRAVEL;PERSONAL CARE
17781402;;F;31;CHILENO;;Millenial;PROVIDENCIA                   ;METROPOLITANA;49990;1;1;0;0;0;1;1;49990;ALISADOR DE PELO S12A(220) Shine Therapy PALTA M;PERSONAL CARE
19076732;;M;26;CHILENO;;Silencioso;PROVIDENCIA                   ;METROPOLITANA;21990;1;1;0;0;0;1;1;21990;AFEITADORA SG-7210 NEGRO;PERSONAL CARE
13837174;;F;42;CHILENO;;X;N/D;N/D;121350;4;1;0;0;0;4;1;121350;ALISADOR DE PELO SG-4651 ROJO;PERSONAL CARE
10088609;;M;54;CHILENO;;Boomers;BUIN                          ;METROPOLITANA;54990;1;1;0;0;0;1;1;54990;ALISADOR DE PELO SG-4651 ROJO;PERSONAL CARE
11467149;;M;52;CHILENO;;X;ANTOFAGASTA                   ;ANTOFAGASTA;12990;1;1;0;0;0;1;1;12990;SECADOR PELO SG-3012C19;PERSONAL CARE
7628720;;F;66;CHILENO;;Boomers;LA PINTANA                    ;METROPOLITANA;58980;2;1;0;0;0;2;1;58980;CORTA PELO HC-5850;PERSONAL CARE
19750148;;F;24;CHILENO;;Z;PROVIDENCIA                   ;METROPOLITANA;0;0;0;0;0;0;0;0;0;AFEITADORA QP2521/50 ONE BLADE GRAFITO;PERSONAL CARE
11979661;;F;49;CHILENO;;X;PROVIDENCIA                   ;METROPOLITANA;0;0;0;0;0;0;0;0;0;ALISADOR SG3510C09 MORADO PLACAS DE CERAMICA 21;PERSONAL CARE
17646117;Soltero;M;31;CHILENO;;Millenial;PROVIDENCIA                   ;METROPOLITANA;0;0;0;0;0;0;0;0;0;AFEITADORA SG-7250 NEGRO;PERSONAL CARE
7672213;;F;67;CHILENO;;Boomers;LOS ANDES                     ;VALPARAISO;0;0;0;0;0;0;0;0;0;SECADOR DE PELO SIEGEN SG-3035;PERSONAL CARE
11958144;;M;49;CHILENO;;X;PENCO                         ;BIO BIO;0;0;0;0;0;0;0;0;0;ALISADOR ELEGANCE LED KER;PERSONAL CARE
15622421;;F;39;CHILENO;;X;MELIPILLA                     ;METROPOLITANA;0;0;0;0;0;0;0;0;0;SECADOR DIAMOND STD;PERSONAL CARE
19461215;Soltero;F;25;CHILENO;TECNICO DE NIVEL SUPERIOR EN ENFERMERIA;Z;PROVIDENCIA                   ;METROPOLITANA;0;0;0;0;0;0;0;0;0;SECADOR DE PELO SG-3025 SILVER;PERSONAL CARE
15618047;;F;39;CHILENO;;X;SAN VICENTE                   ;L.G.B.OÂ´HIGGINS;0;0;0;0;0;0;0;0;0;ALISADOR DE PELO SG-4651 ROJO;PERSONAL CARE
12778922;;F;47;CHILENO;;X;PLACILLA                      ;L.G.B.OÂ´HIGGINS;0;0;0;0;0;0;0;0;0;SECADOR DIAMOND STD;PERSONAL CARE
13447524;;F;44;CHILENO;;Millenial;TEMUCO                        ;ARAUCANIA;0;0;0;0;0;0;0;0;0;ALISADOR ELEGANCE W L IT 3D BLUE BVT;PERSONAL CARE
17325141;Soltero;F;32;CHILENO;ADMINISTRADOR GASTRONOMICO;Millenial;PROVIDENCIA                   ;METROPOLITANA;0;0;0;0;0;0;0;0;0;CORTA PELO HC-5850;PERSONAL CARE
13954639;;F;42;CHILENO;;Silencioso;PROVIDENCIA                   ;METROPOLITANA;0;0;0;0;0;0;0;0;0;SECADOR DE PELO MISTRAL STD;PERSONAL CARE
19985333;;F;23;CHILENO;;Z;PROVIDENCIA                   ;METROPOLITANA;0;0;0;0;0;0;0;0;0;SECADOR DE PELO SIEGEN SG-3049C02;PERSONAL CARE
9691503;;F;60;CHILENO;;Boomers;ALTO HOSPICIO;TARAPACA;0;0;0;0;0;0;0;0;0;SECADOR DE PELO SG-3012 NEGRO;PERSONAL CARE
18771197;;M;28;CHILENO;;Millenial;N/D;N/D;0;0;0;0;0;0;0;0;0;ALISADOR DE PELO SG-4651 ROJO;PERSONAL CARE
13803100;;F;41;CHILENO;;X;PROVIDENCIA                   ;METROPOLITANA;0;0;0;0;0;0;0;0;0;AFEITADORA SPORT SH 886 BAT;PERSONAL CARE
19141880;Soltero;F;27;CHILENO;ENFERMERA;Z;PROVIDENCIA                   ;METROPOLITANA;0;0;0;0;0;0;0;0;0;DEPILADORA SG-9004;PERSONAL CARE
9119788;;F;62;CHILENO;;Boomers;PAINE                         ;METROPOLITANA;0;0;0;0;0;0;0;0;0;SECADOR PELO SG-3012C19;PERSONAL CARE
12740599;;F;49;CHILENO;;X;N/D;N/D;0;0;0;0;0;0;0;0;0;ALISADOR SIEGEN SG-4716;PERSONAL CARE
18902812;;F;27;CHILENO;;Z;ANCUD                         ;LOS LAGOS;0;0;0;0;0;0;0;0;0;DEPILADORA LASER SIEGEN SG-9302;PERSONAL CARE
20015250;;F;23;CHILENO;;Silencioso;PROVIDENCIA                   ;METROPOLITANA;0;0;0;0;0;0;0;0;0;DEPILADORA BRE225/00;PERSONAL CARE
18752301;;F;27;CHILENO;;Millenial;FREIRINA                      ;ATACAMA;0;0;0;0;0;0;0;0;0;ALISADOR DE PELO SG-4651 ROJO;PERSONAL CARE
18310999;;F;30;CHILENO;;Millenial;N/D;N/D;0;0;0;0;0;0;0;0;0;ALISADOR DE PELO SG-4651 ROJO;PERSONAL CARE
26312593;;M;43;COLOMBIANO;;Extranjero;N/D;N/D;0;0;0;0;0;0;0;0;0;AFEITADORA S1121/41 ELECTRICA;PERSONAL CARE
16807292;Soltero;M;34;CHILENO;;Millenial;PROVIDENCIA                   ;METROPOLITANA;0;0;0;0;0;0;0;0;0;ALISADOR DE PELO SG-3510 FUCSIA;PERSONAL CARE
14206400;;M;41;CHILENO;;X;CASTRO                        ;LOS LAGOS;0;0;0;0;0;0;0;0;0;CORTADOR DE PELO PACL GC 542 Sport Bat GT 527;PERSONAL CARE
17282061;;F;32;CHILENO;;Millenial;PROVIDENCIA                   ;METROPOLITANA;0;0;0;0;0;0;0;0;0;ONDULADOR DE PELO SG-2420 33MM;PERSONAL CARE
12377073;;F;49;CHILENO;;X;PROVIDENCIA                   ;METROPOLITANA;0;0;0;0;0;0;0;0;0;SECADOR DE PELO TEMPO 3D 220 BLACK;PERSONAL CARE
13375896;;F;43;CHILENO;;X;PROVIDENCIA                   ;METROPOLITANA;0;0;0;0;0;0;0;0;0;SECADOR DE PELO SE-3049C01 FUCSIA;PERSONAL CARE
9692205;;F;58;CHILENO;;Boomers;VILLARICA                     ;ARAUCANIA;0;0;0;0;0;0;0;0;0;AFEITADORA S1223/41 ELECTRICA;PERSONAL CARE
24256843;;M;31;CHILENO;;Extranjero;N/D;N/D;0;0;0;0;0;0;0;0;0;PACK AFEITADORA S1223/41+CORTA PELO HC3505/15;PERSONAL CARE
9633551;;M;59;CHILENO;;Boomers;PROVIDENCIA                   ;METROPOLITANA;0;0;0;0;0;0;0;0;0;AFEITADORA SG-7250 NEGRO;PERSONAL CARE
19922393;;F;24;CHILENO;;Z;PROVIDENCIA                   ;METROPOLITANA;0;0;0;0;0;0;0;0;0;DEPILADORA SG-9004EX;PERSONAL CARE
18434269;;M;29;CHILENO;;Millenial;PROVIDENCIA                   ;METROPOLITANA;0;0;0;0;0;0;0;0;0;SECADOR GAMA EOLIC MINI TRAVEL;PERSONAL CARE
10607149;;M;53;CHILENO;;X;PUENTE ALTO                   ;METROPOLITANA;0;0;0;0;0;0;0;0;0;AFEITADORA SG-7250 NEGRO;PERSONAL CARE
20348220;;F;21;CHILENO;;Z;PROVIDENCIA                   ;METROPOLITANA;0;0;0;0;0;0;0;0;0;ALISADOR DE PELO SG-3540 MORADO MORADO;PERSONAL CARE
12828796;;F;48;CHILENO;;X;RENCA                         ;METROPOLITANA;0;0;0;0;0;0;0;0;0;AFEITADORA S1121/41 ELECTRICA;PERSONAL CARE
10180261;Casado;F;57;CHILENO;;Boomers;RENCA                         ;METROPOLITANA;0;0;0;0;0;0;0;0;0;AFEITADORA SG-7250 NEGRO;PERSONAL CARE
20471308;;M;22;CHILENO;;Silencioso;PROVIDENCIA                   ;METROPOLITANA;0;0;0;0;0;0;0;0;0;SECADOR DE PELO MISTRAL STD;PERSONAL CARE
17962786;;M;30;CHILENO;;Millenial;CABILDO                       ;VALPARAISO;0;0;0;0;0;0;0;0;0;KIT CORTABARBA MG3711;PERSONAL CARE
20142687;;F;22;CHILENO;;Silencioso;PROVIDENCIA                   ;METROPOLITANA;0;0;0;0;0;0;0;0;0;SECADOR DE PELO SG-3043 DC CAFE 2200 WATTS;PERSONAL CARE
10877560;;F;55;CHILENO;;Boomers;N/D;N/D;0;0;0;0;0;0;0;0;0;SECADOR DE PELO TEMPO MORADO;PERSONAL CARE
8981322;Casado;F;61;CHILENO;;Boomers;CONSTITUCION                  ;MAULE;0;0;0;0;0;0;0;0;0;SECADOR DE PELO TEMPO 3D 220 BLACK;PERSONAL CARE
13491406;;F;49;CHILENO;;X;MELIPILLA                     ;METROPOLITANA;0;0;0;0;0;0;0;0;0;AFEITADORA SPORT SH 886 BAT;PERSONAL CARE
10722862;;M;52;CHILENO;;X;PROVIDENCIA                   ;METROPOLITANA;0;0;0;0;0;0;0;0;0;Afeitadora Corporal Serie 3000 Philips BG105/11;PERSONAL CARE
19576708;;F;24;CHILENO;;Z;LONGAVI                       ;MAULE;0;0;0;0;0;0;0;0;0;ALISADOR DE PELO SG-4651 ROJO;PERSONAL CARE
18575863;;M;28;CHILENO;;Millenial;RENCA                         ;METROPOLITANA;0;0;0;0;0;0;0;0;0;SECADOR PHILIPS HP8230;PERSONAL CARE
8675826;;F;62;CHILENO;;Boomers;PUNTA ARENAS                  ;MAGALLANES;0;0;0;0;0;0;0;0;0;SECADOR DE PELO DIAMOND ST BLOOM VT 220;PERSONAL CARE
14389446;;F;44;CHILENO;;X;RENCA                         ;METROPOLITANA;0;0;0;0;0;0;0;0;0;DEPILADORA SG-9004;PERSONAL CARE
24358039;;F;48;COLOMBIANO;;Extranjero;N/D;N/D;0;0;0;0;0;0;0;0;0;SECADOR PELO SG-3012C20;PERSONAL CARE
557615;;F;84;CHILENO;;Silencioso;ANTOFAGASTA                   ;ANTOFAGASTA;0;0;0;0;0;0;0;0;0;SECADOR DIAMOND STD;PERSONAL CARE
7090519;Divorciado;F;67;CHILENO;;Boomers;LOS ANDES                     ;VALPARAISO;0;0;0;0;0;0;0;0;0;SECADOR DE PELO MISTRAL STD;PERSONAL CARE
9609504;;F;59;CHILENO;;Boomers;CURICO                        ;MAULE;0;0;0;0;0;0;0;0;0;SECADOR DE PELO SG-3012 NEGRO;PERSONAL CARE
12189195;;F;50;CHILENO;;X;PROVIDENCIA                   ;METROPOLITANA;0;0;0;0;0;0;0;0;0;AFEITADORA GAMA 890;PERSONAL CARE
10315026;Casado;F;56;CHILENO;;Boomers;PROVIDENCIA                   ;METROPOLITANA;0;0;0;0;0;0;0;0;0;CORTA PELO SPORT GCX 623 BVT;PERSONAL CARE
16092632;;M;36;CHILENO;;Silencioso;"";"";0;0;0;0;0;0;0;0;0;AFEITADORA SG-7250 NEGRO;PERSONAL CARE
13592493;;F;43;CHILENO;;X;LOS LAGOS                     ;LOS LAGOS;0;0;0;0;0;0;0;0;0;CORTA PELO SG-8520;PERSONAL CARE
12966580;;F;45;CHILENO;;X;N/D;N/D;0;0;0;0;0;0;0;0;0;ALISADOR DE PELO SG-3540 MORADO MORADO;PERSONAL CARE
19334014;;F;26;CHILENO;;Z;N/D;N/D;0;0;0;0;0;0;0;0;0;CORTAPELOS GM 596;PERSONAL CARE
9775688;;F;57;CHILENO;;Boomers;RENCA                         ;METROPOLITANA;0;0;0;0;0;0;0;0;0;SECADOR PELO SG-3012C19;PERSONAL CARE
8221454;;F;62;CHILENO;;Boomers;VALDIVIA                      ;LOS RIOS;0;0;0;0;0;0;0;0;0;CORTA PELO SG-8520;PERSONAL CARE
18557694;Soltero;F;28;CHILENO;KINESIOLOGA;Millenial;PROVIDENCIA                   ;METROPOLITANA;0;0;0;0;0;0;0;0;0;TRICOMBO SECADOR+ALISADOR+ONDULADOR;PERSONAL CARE
17990287;Soltero;M;30;CHILENO;;Silencioso;PROVIDENCIA                   ;METROPOLITANA;0;0;0;0;0;0;0;0;0;COMBO SIEGEN AFEITADORA + MULTISTYLER SG-8440;PERSONAL CARE
13479488;;F;43;CHILENO;;Millenial;PENALOLEN                     ;METROPOLITANA;0;0;0;0;0;0;0;0;0;CORTA PELO SG-8200;PERSONAL CARE
18250845;;M;29;CHILENO;;Millenial;PROVIDENCIA                   ;METROPOLITANA;0;0;0;0;0;0;0;0;0;KIT CORTABARBA MG3731;PERSONAL CARE
7733450;;M;67;CHILENO;;Boomers;TALCA                         ;MAULE;0;0;0;0;0;0;0;0;0;SECADOR DE PELO SG-3051;PERSONAL CARE
9141359;;F;60;CHILENO;;Boomers;QUILLOTA                      ;VALPARAISO;0;0;0;0;0;0;0;0;0;CORTA PELO PG6025 KIT RECORTE;PERSONAL CARE
15331426;;M;40;CHILENO;;X;LA FLORIDA                    ;METROPOLITANA;0;0;0;0;0;0;0;0;0;CORTA PELO GM 562;PERSONAL CARE
20190377;;M;22;CHILENO;;Silencioso;PROVIDENCIA                   ;METROPOLITANA;0;0;0;0;0;0;0;0;0;SECADOR DE PELO SIEGEN SG-3035;PERSONAL CARE
18953073;Soltero;F;27;CHILENO;;Silencioso;PROVIDENCIA                   ;METROPOLITANA;0;0;0;0;0;0;0;0;0;Secador Diamond My Style Gama;PERSONAL CARE
15903788;;M;37;CHILENO;;Millenial;N/D;N/D;0;0;0;0;0;0;0;0;0;AFEITADORA S1121/41 ELECTRICA;PERSONAL CARE
11083804;;F;56;CHILENO;;Boomers;PARRAL                        ;MAULE;0;0;0;0;0;0;0;0;0;DEPILADORA CYBELE IPL GOLD 200 MIL PULSACIONES;PERSONAL CARE
15669955;;F;38;CHILENO;;Millenial;"";"";0;0;0;0;0;0;0;0;0;ALISADOR +SECADOR PELO;PERSONAL CARE
15299771;;F;40;CHILENO;;X;"";"";0;0;0;0;0;0;0;0;0;CORTA PELO SG-8520;PERSONAL CARE
10015343;;F;57;CHILENO;;Boomers;TALCAHUANO                    ;BIO BIO;0;0;0;0;0;0;0;0;0;ALISADOR ELEGANCE LED KER;PERSONAL CARE
19986059;;F;23;CHILENO;;Silencioso;PROVIDENCIA                   ;METROPOLITANA;0;0;0;0;0;0;0;0;0;SECADOR TEMPO TITAN KERATIN;PERSONAL CARE
16511362;;F;35;CHILENO;;Millenial;ANGOL                         ;ARAUCANIA;0;0;0;0;0;0;0;0;0;ALISADOR DE PELO SG-3540 MORADO MORADO;PERSONAL CARE
11437562;Casado;F;52;CHILENO;;X;RENCA                         ;METROPOLITANA;0;0;0;0;0;0;0;0;0;SECADOR DE PELO DIAMOND ST BLOOM VT 220;PERSONAL CARE
19591958;;F;25;CHILENO;;Z;PROVIDENCIA                   ;METROPOLITANA;0;0;0;0;0;0;0;0;0;ALISADOR DE PELO ERGOSTYLER ION DUO ROJO;PERSONAL CARE
20136040;;F;22;CHILENO;;Z;PENCAHUE;MAULE;0;0;0;0;0;0;0;0;0;SECADOR DIAMOND STD;PERSONAL CARE
8716644;;M;60;CHILENO;;Z;PROVIDENCIA                   ;METROPOLITANA;0;0;0;0;0;0;0;0;0;SECADOR DE VIAJE REMINGTON D2400;PERSONAL CARE
11636750;;M;51;CHILENO;;X;N/D;N/D;0;0;0;0;0;0;0;0;0;SECADOR TEMPO TITAN KERATIN;PERSONAL CARE
16629190;;M;34;CHILENO;;Millenial;PROVIDENCIA                   ;METROPOLITANA;0;0;0;0;0;0;0;0;0;SECADOR DE PELO STD TITAN KERATIN PLATA;PERSONAL CARE
11513228;;F;52;CHILENO;;X;OVALLE                        ;COQUIMBO;0;0;0;0;0;0;0;0;0;ALISADOR GAMA BELLA SHINE;PERSONAL CARE
18718534;Soltero;F;27;CHILENO;;Z;PROVIDENCIA                   ;METROPOLITANA;0;0;0;0;0;0;0;0;0;CORTA PELO SG-8200;PERSONAL CARE
12823940;;M;47;CHILENO;;X;PROVIDENCIA                   ;METROPOLITANA;0;0;0;0;0;0;0;0;0;SECADOR DE PELO STD TITAN KERATIN PLATA;PERSONAL CARE
8839666;Casado;M;63;CHILENO;TECNICO ELECTRICO;Boomers;RENCA                         ;METROPOLITANA;0;0;0;0;0;0;0;0;0;CORTA PELO GM 562;PERSONAL CARE
16017121;;M;37;CHILENO;;Silencioso;PROVIDENCIA                   ;METROPOLITANA;0;0;0;0;0;0;0;0;0;ALISADOR ELEGANCE LED KER;PERSONAL CARE
19367866;;F;25;CHILENO;;Z;PROVIDENCIA                   ;METROPOLITANA;0;0;0;0;0;0;0;0;0;CORTA PELO GM 562;PERSONAL CARE
27062094;;F;28;VENEZOLANO;;Extranjero;RANCAGUA                      ;L.G.B.OÂ´HIGGINS;0;0;0;0;0;0;0;0;0;SECADOR DE PELO STD TITAN KERATIN PLATA;PERSONAL CARE
12416711;;F;48;CHILENO;;X;PROVIDENCIA                   ;METROPOLITANA;0;0;0;0;0;0;0;0;0;CORTA PELO HC3520;PERSONAL CARE
7457123;;M;66;CHILENO;;Boomers;VINA DEL MAR                  ;VALPARAISO;0;0;0;0;0;0;0;0;0;DEPILADORA BRE285/00 CONVENCIONAL;PERSONAL CARE
4359347;;M;80;CHILENO;;Silencioso;TEMUCO                        ;ARAUCANIA;0;0;0;0;0;0;0;0;0;AFEITADORA S1223/41 ELECTRICA;PERSONAL CARE
17391643;;M;32;CHILENO;;Millenial;MAIPU                         ;METROPOLITANA;0;0;0;0;0;0;0;0;0;SECADOR TEMPO TITAN KERATIN;PERSONAL CARE
17453937;Soltero;F;31;CHILENO;TECNICO DE NIVEL SUPERIOR EN ENFERMERIA;Millenial;PROVIDENCIA                   ;METROPOLITANA;0;0;0;0;0;0;0;0;0;DEPILADORA IPL 3500 LUZ PULSADA;PERSONAL CARE
16006969;Soltero;F;37;CHILENO;TECNOLOGO MEDICO;Millenial;PROVIDENCIA                   ;METROPOLITANA;0;0;0;0;0;0;0;0;0;SECADOR PELO SG-3012C19;PERSONAL CARE
17386650;;F;32;CHILENO;;Millenial;ANCUD                         ;LOS LAGOS;0;0;0;0;0;0;0;0;0;ALISADOR DE PELO SG-3540 MORADO MORADO;PERSONAL CARE
19607315;;M;25;CHILENO;;Z;N/D;N/D;0;0;0;0;0;0;0;0;0;ALISADOR DE PELO SG-3540 MORADO MORADO;PERSONAL CARE
11977744;Soltero;M;49;CHILENO;;X;RENCA                         ;METROPOLITANA;0;0;0;0;0;0;0;0;0;AFEITADORA SPORT SH 886 BAT;PERSONAL CARE
12249514;;F;50;CHILENO;;Silencioso;PROVIDENCIA                   ;METROPOLITANA;0;0;0;0;0;0;0;0;0;AFEITADORA S1121/41 ELECTRICA;PERSONAL CARE
18674875;Soltero;F;28;CHILENO;;Millenial;PROVIDENCIA                   ;METROPOLITANA;0;0;0;0;0;0;0;0;0;CORTA PELO GC-615;PERSONAL CARE
9708273;;M;57;CHILENO;;Boomers;PUNTA ARENAS                  ;MAGALLANES;0;0;0;0;0;0;0;0;0;RECORTADOR DE VELLO NT3160/15 PHILIPS;PERSONAL CARE
19089451;;F;27;CHILENO;;Millenial;N/D;N/D;0;0;0;0;0;0;0;0;0;CORTA PELO SG-8200;PERSONAL CARE
17518165;Soltero;M;31;CHILENO;;Silencioso;PROVIDENCIA                   ;METROPOLITANA;0;0;0;0;0;0;0;0;0;RECORTADOR DE VELLO NT3160/15 PHILIPS;PERSONAL CARE
10543574;;M;56;CHILENO;;Boomers;RENCA                         ;METROPOLITANA;0;0;0;0;0;0;0;0;0;SECADOR DIAMOND STD;PERSONAL CARE
13898402;;F;42;CHILENO;;X;RENCA                         ;METROPOLITANA;0;0;0;0;0;0;0;0;0;CORTA PELO GM 562;PERSONAL CARE
19028980;Soltero;F;27;CHILENO;;Silencioso;PROVIDENCIA                   ;METROPOLITANA;0;0;0;0;0;0;0;0;0;SECADOR DIAMOND STD;PERSONAL CARE
7684414;;M;63;CHILENO;;Silencioso;PROVIDENCIA                   ;METROPOLITANA;0;0;0;0;0;0;0;0;0;CORTA PELO MGK3220 BLACK BOX MN;PERSONAL CARE
4008081;;M;79;CHILENO;;Silencioso;PROVIDENCIA                   ;METROPOLITANA;0;0;0;0;0;0;0;0;0;CORTA PELO GM 562;PERSONAL CARE
6361318;;F;71;CHILENO;;Silencioso;N/D;N/D;0;0;0;0;0;0;0;0;0;DEPILADORA IPL 3500 LUZ PULSADA;PERSONAL CARE
20092602;;F;23;CHILENO;;Z;PROVIDENCIA                   ;METROPOLITANA;0;0;0;0;0;0;0;0;0;SECADOR PHILIPS BHC010;PERSONAL CARE
19229803;Soltero;F;26;CHILENO;;Z;PROVIDENCIA                   ;METROPOLITANA;0;0;0;0;0;0;0;0;0;DEPILADORA BRE285/00 CONVENCIONAL;PERSONAL CARE
19502169;;F;25;CHILENO;;Z;CALBUCO                       ;LOS LAGOS;0;0;0;0;0;0;0;0;0;AFEITADORA S1223/41 ELECTRICA;PERSONAL CARE
17022921;;M;33;CHILENO;;Millenial;N/D;N/D;0;0;0;0;0;0;0;0;0;ALISADOR ATTIVA STD;PERSONAL CARE
5925137;;M;74;CHILENO;;Silencioso;LA PINTANA                    ;METROPOLITANA;0;0;0;0;0;0;0;0;0;AFEITADORA XR1430 NEGRO;PERSONAL CARE
12699645;;F;48;CHILENO;;X;SAN FERNANDO                  ;L.G.B.OÂ´HIGGINS;0;0;0;0;0;0;0;0;0;SECADOR DE PELO MISTRAL STD;PERSONAL CARE
17152418;Soltero;F;33;CHILENO;;Millenial;PROVIDENCIA                   ;METROPOLITANA;0;0;0;0;0;0;0;0;0;ALISADOR ATTIVA STD;PERSONAL CARE
12932008;;F;48;CHILENO;;X;PROVIDENCIA                   ;METROPOLITANA;0;0;0;0;0;0;0;0;0;TRICOMBO SECADOR+ALISADOR+ONDULAD;PERSONAL CARE
16313692;Soltero;M;36;CHILENO;;Millenial;PROVIDENCIA                   ;METROPOLITANA;0;0;0;0;0;0;0;0;0;ALISADOR DE PELO SG-3540 MORADO MORADO;PERSONAL CARE
10765347;;M;55;CHILENO;;Boomers;NAVIDAD                       ;L.G.B.OÂ´HIGGINS;0;0;0;0;0;0;0;0;0;ALISADOR SIEGEN SG-4716;PERSONAL CARE
11458271;;F;53;CHILENO;;X;RENCA                         ;METROPOLITANA;0;0;0;0;0;0;0;0;0;AFEITADORA S1121/41 ELECTRICA;PERSONAL CARE
16920594;Soltero;F;34;CHILENO;;Millenial;PROVIDENCIA                   ;METROPOLITANA;0;0;0;0;0;0;0;0;0;ALISADOR DE PELO S12A(220) Shine Therapy PALTA M;PERSONAL CARE
15317008;;F;37;CHILENO;;Millenial;PROVIDENCIA                   ;METROPOLITANA;0;0;0;0;0;0;0;0;0;SECADOR PHILIPS BHC010;PERSONAL CARE
12821352;;M;46;CHILENO;;X;CABILDO                       ;VALPARAISO;0;0;0;0;0;0;0;0;0;CORTA PELO GM 562;PERSONAL CARE
12756825;;M;47;CHILENO;;X;PROVIDENCIA                   ;METROPOLITANA;0;0;0;0;0;0;0;0;0;CORTA PELO SPORT GC 542 BVT;PERSONAL CARE
12028646;;F;48;CHILENO;;X;RANCAGUA                      ;L.G.B.OÂ´HIGGINS;0;0;0;0;0;0;0;0;0;ALISADOR GAMA BELLA SHINE;PERSONAL CARE
17222779;;M;32;CHILENO;;Millenial;TALCAHUANO                    ;BIO BIO;0;0;0;0;0;0;0;0;0;DEPILADORA BRE225/00;PERSONAL CARE
13810716;;F;42;CHILENO;;X;GALVARINO                     ;ARAUCANIA;0;0;0;0;0;0;0;0;0;DEPILADORA GAMA ESSENCIAL;PERSONAL CARE
15191659;;M;33;CHILENO;;Millenial;SANTA BARBARA                 ;BIO BIO;0;0;0;0;0;0;0;0;0;ALISADOR DE PELO SG-4651 ROJO;PERSONAL CARE
12949553;;F;45;CHILENO;;X;PROVIDENCIA                   ;METROPOLITANA;0;0;0;0;0;0;0;0;0;AFEITADORA XR1430 NEGRO;PERSONAL CARE
10906830;;F;49;CHILENO;;X;PROVIDENCIA                   ;METROPOLITANA;0;0;0;0;0;0;0;0;0;DEPILADORA GAMA ESSENCIAL;PERSONAL CARE
15785617;;M;37;CHILENO;;Millenial;LA SERENA                     ;COQUIMBO;0;0;0;0;0;0;0;0;0;DEPILADORA SG-9004;PERSONAL CARE
17683428;;M;31;CHILENO;;Millenial;MELIPILLA                     ;METROPOLITANA;0;0;0;0;0;0;0;0;0;AFEITADORA S1223/41 ELECTRICA;PERSONAL CARE
10404265;;F;51;CHILENO;;X;CABILDO                       ;VALPARAISO;0;0;0;0;0;0;0;0;0;AFEITADORA S1121/41 ELECTRICA;PERSONAL CARE
12869049;;M;47;CHILENO;;X;PROVIDENCIA                   ;METROPOLITANA;0;0;0;0;0;0;0;0;0;CORTA PELO SG-8200;PERSONAL CARE
13838255;;M;42;CHILENO;;X;CUNCO                         ;ARAUCANIA;0;0;0;0;0;0;0;0;0;ALISADOR DE PELO SG-3540 MORADO MORADO;PERSONAL CARE
15559203;;M;38;CHILENO;;X;PROVIDENCIA                   ;METROPOLITANA;0;0;0;0;0;0;0;0;0;KIT PG181;PERSONAL CARE
14331406;;F;45;CHILENO;;X;PROVIDENCIA                   ;METROPOLITANA;0;0;0;0;0;0;0;0;0;KIT CORTABARBA MG3731;PERSONAL CARE
18476621;;F;28;CHILENO;;Millenial;TALCA                         ;MAULE;0;0;0;0;0;0;0;0;0;ALISADOR STARLIGHT 5D WIDE TITANIO;PERSONAL CARE
8614234;;M;63;CHILENO;;Boomers;AISEN                         ;AYSEN;0;0;0;0;0;0;0;0;0;AFEITADORA XR1430 NEGRO;PERSONAL CARE
17261631;;M;32;CHILENO;;Millenial;TEMUCO                        ;ARAUCANIA;0;0;0;0;0;0;0;0;0;CORTA PELO GM 562;PERSONAL CARE
14324302;;M;45;CHILENO;;X;RENCA                         ;METROPOLITANA;0;0;0;0;0;0;0;0;0;AFEITADORA SPORT SH 886 BAT;PERSONAL CARE
16156604;;M;37;CHILENO;;Millenial;PROVIDENCIA                   ;METROPOLITANA;0;0;0;0;0;0;0;0;0;AFEITADORA 3000BT NEGRA;PERSONAL CARE
13974550;Soltero;F;40;CHILENO;PROFESOR;X;PROVIDENCIA                   ;METROPOLITANA;0;0;0;0;0;0;0;0;0;COMBO BALANZA NEGRA+SECADOR DIAMOND ST NEGRO;PERSONAL CARE
10427606;;M;54;CHILENO;;Boomers;RENCA                         ;METROPOLITANA;0;0;0;0;0;0;0;0;0;DEPILADORA SG-9004;PERSONAL CARE
16181246;Soltero;M;37;CHILENO;;Millenial;PROVIDENCIA                   ;METROPOLITANA;0;0;0;0;0;0;0;0;0;CORTA PELO GM 562;PERSONAL CARE
11728426;;F;51;CHILENO;;X;LA LIGUA                      ;VALPARAISO;0;0;0;0;0;0;0;0;0;ALISADOR DE PELO SG-3540 MORADO MORADO;PERSONAL CARE
12939064;;M;46;CHILENO;;X;RENCA                         ;METROPOLITANA;0;0;0;0;0;0;0;0;0;DEPILADORA SG-9040;PERSONAL CARE
17714467;;F;31;CHILENO;;Millenial;CURACO DE VELEZ               ;LOS LAGOS;0;0;0;0;0;0;0;0;0;SECADOR PELO SG-3012C19;PERSONAL CARE
11176038;;F;54;CHILENO;;Boomers;RENCA                         ;METROPOLITANA;0;0;0;0;0;0;0;0;0;ALISADOR SIEGEN SG-4716;PERSONAL CARE
19512545;;F;24;CHILENO;;Z;CONCEPCION;BIO-BIO;0;0;0;0;0;0;0;0;0;DEPILADORA SG-9004;PERSONAL CARE
26501687;;M;31;VENEZOLANO;;Extranjero;ESTACION CENTRAL              ;METROPOLITANA;0;0;0;0;0;0;0;0;0;ONDULADOR DE PELO TURMALINA 25MM;PERSONAL CARE
15013802;;F;40;CHILENO;;X;PROVIDENCIA                   ;METROPOLITANA;0;0;0;0;0;0;0;0;0;DEPILADORA BRE225/00;PERSONAL CARE
14526619;;M;40;CHILENO;;X;PROVIDENCIA                   ;METROPOLITANA;0;0;0;0;0;0;0;0;0;TRICOMBO SECADOR+ALISADOR+ONDULAD;PERSONAL CARE
11752782;;F;50;CHILENO;;X;RENCA                         ;METROPOLITANA;0;0;0;0;0;0;0;0;0;ALISADOR ELEGANCE LED KER;PERSONAL CARE
6720899;;M;69;CHILENO;;Silencioso;RENCA                         ;METROPOLITANA;0;0;0;0;0;0;0;0;0;SECADOR DE PELO SG-3035 NEGRO;PERSONAL CARE
11298257;;M;53;CHILENO;;X;RENCA                         ;METROPOLITANA;0;0;0;0;0;0;0;0;0;SECADOR DE PELO SG-3116;PERSONAL CARE
12544718;;F;48;CHILENO;;X;RETIRO                        ;MAULE;0;0;0;0;0;0;0;0;0;ALISADOR DE PELO SG-3540 MORADO MORADO;PERSONAL CARE
17526802;;M;32;CHILENO;;Millenial;N/D;N/D;0;0;0;0;0;0;0;0;0;SECADOR DE PELO SG-3116;PERSONAL CARE
17501299;;M;31;CHILENO;;Millenial;PROVIDENCIA                   ;METROPOLITANA;0;0;0;0;0;0;0;0;0;CORTA PELO GM 562;PERSONAL CARE
16883049;;M;34;CHILENO;;Millenial;PROVIDENCIA                   ;METROPOLITANA;0;0;0;0;0;0;0;0;0;ALISADOR DE PELO S9100 PRO THERMA-LUXE;PERSONAL CARE
13144608;;F;45;CHILENO;;X;LOS ANGELES                   ;BIO BIO;0;0;0;0;0;0;0;0;0;DEPILADORA SG-9004;PERSONAL CARE
10183194;;M;57;CHILENO;;Boomers;TALAGANTE                     ;METROPOLITANA;0;0;0;0;0;0;0;0;0;SECADOR DE PELO D-3190 STYLE;PERSONAL CARE
19399428;;M;26;CHILENO;;Extranjero;"";"";0;0;0;0;0;0;0;0;0;AFEITADORA SG-7210 NEGRO;PERSONAL CARE
19068061;Soltero;M;27;CHILENO;;Z;MELIPILLA                     ;METROPOLITANA;0;0;0;0;0;0;0;0;0;SECADOR DE PELO SG-3051;PERSONAL CARE
11423444;;F;52;CHILENO;;X;PROVIDENCIA                   ;METROPOLITANA;0;0;0;0;0;0;0;0;0;ALISADOR GAMA BELLA SHINE;PERSONAL CARE
13357421;;F;44;CHILENO;;X;MARIA ELENA                   ;ANTOFAGASTA;0;0;0;0;0;0;0;0;0;ALISADOR DE PELO S12A(220) Shine Therapy PALTA M;PERSONAL CARE
18687694;;M;28;CHILENO;;Millenial;OVALLE                        ;COQUIMBO;0;0;0;0;0;0;0;0;0;CORTA PELO SIEGEN SG-8610;PERSONAL CARE
15990026;;M;36;CHILENO;;Millenial;PROVIDENCIA                   ;METROPOLITANA;0;0;0;0;0;0;0;0;0;ALISADOR DE PELO ELEGANCE TITAN KERATIN LED GRIS;PERSONAL CARE
8819052;;F;63;CHILENO;;Boomers;ARAUCO                        ;BIO BIO;0;0;0;0;0;0;0;0;0;ALISADOR DE PELO PHILIPS HP8316;PERSONAL CARE
15500366;;F;39;CHILENO;;X;PARRAL                        ;MAULE;0;0;0;0;0;0;0;0;0;SECADOR DE PELO STD TITAN KERATIN PLATA;PERSONAL CARE
26622232;;F;24;NO INFORMA NACIONALIDAD;;Extranjero;PROVIDENCIA                   ;METROPOLITANA;0;0;0;0;0;0;0;0;0;COMBO SECADOR+ALISADOR+ONDULADOR DE PELO;PERSONAL CARE
12359018;;F;49;CHILENO;;X;SAN JAVIER                    ;MAULE;0;0;0;0;0;0;0;0;0;SECADOR DE PELO STD TITAN KERATIN PLATA;PERSONAL CARE
10474347;;F;56;CHILENO;;Boomers;LA GRANJA                     ;METROPOLITANA;0;0;0;0;0;0;0;0;0;ALISADOR DE PELO PHILIPS HP8316;PERSONAL CARE
15928807;;F;37;CHILENO;;Millenial;PROVIDENCIA                   ;METROPOLITANA;0;0;0;0;0;0;0;0;0;DEPILADORA HP-6543;PERSONAL CARE
13751862;Soltero;F;42;CHILENO;;X;PROVIDENCIA                   ;METROPOLITANA;0;0;0;0;0;0;0;0;0;DEPILADORA SG-9004;PERSONAL CARE
7373962;;F;65;CHILENO;;Boomers;PROVIDENCIA                   ;METROPOLITANA;0;0;0;0;0;0;0;0;0;AFEITADORA S1323 + Toalla y Set afeitado;PERSONAL CARE
19821378;;F;24;CHILENO;;Z;PROVIDENCIA                   ;METROPOLITANA;0;0;0;0;0;0;0;0;0;CORTA PELO GM 562;PERSONAL CARE
17524156;Soltero;F;30;CHILENO;;Millenial;PROVIDENCIA                   ;METROPOLITANA;0;0;0;0;0;0;0;0;0;SECADOR DE PELO SG-3035 NEGRO;PERSONAL CARE
14599736;;F;46;CHILENO;;X;CAUQUENES                     ;MAULE;0;0;0;0;0;0;0;0;0;CORTA PELO GM 562;PERSONAL CARE
17352485;;M;32;CHILENO;;Millenial;PROVIDENCIA                   ;METROPOLITANA;0;0;0;0;0;0;0;0;0;CORTA PELO GM 562;PERSONAL CARE
9668106;Casado;F;57;CHILENO;PROFESOR;Boomers;RENCA                         ;METROPOLITANA;0;0;0;0;0;0;0;0;0;AFEITADORA ONE BLADE QP2521/10 + ESTUCHE;PERSONAL CARE
10401316;;F;57;CHILENO;;Boomers;VALDIVIA                      ;LOS RIOS;0;0;0;0;0;0;0;0;0;SECADOR DE PELO TEMPO MORADO;PERSONAL CARE
9931654;Casado;F;42;CHILENO;;X;RENCA                         ;METROPOLITANA;0;0;0;0;0;0;0;0;0;SECADOR DE PELO STD TITAN KERATIN PLATA;PERSONAL CARE
16228812;;F;35;CHILENO;;Millenial;NIQUEN                        ;BIO BIO;153950;5;5;2;2;49980;3;3;103970;Horno Microondas Mecanico Easy Wave 20Lts;ELECTRODOMESTICOS
10316892;;F;56;CHILENO;;Boomers;TOME                          ;BIO BIO;17240;2;2;0;0;0;2;2;17240;Sandwichera TH-952 2 Panes Blanca;ELECTRODOMESTICOS
13519383;;F;44;CHILENO;;X;N/D;N/D;107970;3;3;1;1;49990;2;2;57980;Hervidor Family Kettle HE500;ELECTRODOMESTICOS
9868421;;F;58;CHILENO;;Boomers;SAN FERNANDO                  ;L.G.B.OÂ´HIGGINS;169979;4;2;0;0;0;4;2;169979;Horno Microondas Digital TH-20S01 20Lts;ELECTRODOMESTICOS
18288098;;M;29;CHILENO;;Millenial;VALDIVIA                      ;LOS LAGOS;1766556;45;41;0;0;0;45;41;1766556;Batidora Vertical Stick Mixer 2609;ELECTRODOMESTICOS
6773330;Divorciado;F;70;CHILENO;;Silencioso;RENCA                         ;METROPOLITANA;29990;1;1;0;0;0;1;1;29990;Licuadora TH-320 Roja/Negro 1,5 Lts Vaso Vidrio;ELECTRODOMESTICOS
17868790;;F;31;CHILENO;;Millenial;"";"";17990;5;2;0;0;0;5;2;17990;Exprimidor de Jugo 407W 1Lts;ELECTRODOMESTICOS
22564768;;F;32;EXTRANJERO - NO INFORMA NACIONALIDAD;;Extranjero;"";"";66060;2;1;0;0;0;2;1;66060;Horno Microondas Mecanico Easy Wave 20Lts;ELECTRODOMESTICOS
15685780;;F;38;CHILENO;;Millenial;IQUIQUE;TARAPACA;29483;2;1;2;1;29483;0;0;0;Picadora 1-2-3 AD6011CL 750W;ELECTRODOMESTICOS
12399810;;M;49;CHILENO;;X;LA LIGUA                      ;VALPARAISO;34990;1;1;0;0;0;1;1;34990;Horno Electrico TH-25N01 25Lts;ELECTRODOMESTICOS
17201198;;M;33;CHILENO;;Millenial;FUTRONO;LOS LAGOS;172140;2;1;0;0;0;2;1;172140;Horno Electrico TH-80i 80Lts;ELECTRODOMESTICOS
16795154;;F;34;CHILENO;;Millenial;VILLARICA                     ;ARAUCANIA;473600;4;2;0;0;0;4;2;473600;Horno Electrico TH-100i 100Lts;ELECTRODOMESTICOS
10192003;;M;55;CHILENO;;Boomers;CHILLAN                       ;BIO BIO;246960;4;3;0;0;0;4;3;246960;Horno Electrico TH62I 60Lts;ELECTRODOMESTICOS
6196548;;M;71;CHILENO;;Silencioso;RENCA                         ;METROPOLITANA;81980;2;1;0;0;0;2;1;81980;FREIDORA DE AIRE BAVIERA 3,8 LITROS;ELECTRODOMESTICOS
9885125;;F;58;CHILENO;;Boomers;RENCA                         ;METROPOLITANA;14990;1;1;0;0;0;1;1;14990;Hervidor Electrico TH-4212N 1,7Lts Negro;ELECTRODOMESTICOS
20242779;;F;22;CHILENO;;Silencioso;PROVIDENCIA                   ;METROPOLITANA;645900;10;4;10;4;645900;0;0;0;PLANCHA VERTICAL V-1600VBL;ELECTRODOMESTICOS
16341370;Casado;M;35;CHILENO;;Millenial;RENCA                         ;METROPOLITANA;31990;1;1;0;0;0;1;1;31990;LICUADORA KASSEL 1,5 LITROS;ELECTRODOMESTICOS
10681928;;M;54;CHILENO;;Boomers;CORONEL                       ;BIO BIO;137972;3;3;0;0;0;3;3;137972;HORNO ELECTRICO DORTMUND 45 LITROS;ELECTRODOMESTICOS
8150155;;M;64;CHILENO;;Boomers;N/D;N/D;418710;4;3;0;0;0;4;3;418710;Licuadora L-1630V Negra 1,5Lts Vaso Vidrio;ELECTRODOMESTICOS
25530078;;F;37;PERUANO;;Extranjero;N/D;N/D;1604930;7;5;0;0;0;7;5;1604930;Hervidor Electrico TH-4515N 2Lts Negro;ELECTRODOMESTICOS
13789706;;F;42;CHILENO;;X;LINARES                       ;MAULE;119172;3;2;0;0;0;3;2;119172;Licuadora TH-401V Roja 1,75Lts Vaso Vidrio;ELECTRODOMESTICOS
12534198;;F;58;CHILENO;;Boomers;RENCA                         ;METROPOLITANA;29990;1;1;0;0;0;1;1;29990;Licuadora TH-320 Roja/Negro 1,5 Lts Vaso Vidrio;ELECTRODOMESTICOS
8555690;;F;67;CHILENO;;Boomers;SAN BERNARDO                  ;METROPOLITANA;736640;11;6;0;0;0;11;6;736640;Hervidor Family Kettle HE500;ELECTRODOMESTICOS
17401178;;F;33;CHILENO;;Millenial;COPIAPO                       ;ATACAMA;291950;5;2;0;0;0;5;2;291950;HORNO ELECTRICO MUNICH 60 LITROS;ELECTRODOMESTICOS
5598313;;F;73;CHILENO;;Silencioso;PROVIDENCIA                   ;METROPOLITANA;28990;1;1;0;0;0;1;1;28990;Plancha UT-PLATTEISEN 2000Watts Base Ceramica;ELECTRODOMESTICOS
6447581;;M;71;CHILENO;;Silencioso;PROVIDENCIA                   ;METROPOLITANA;80820;4;1;0;0;0;4;1;80820;HORNO ELECTRICO BREMEN 23 LITROS;ELECTRODOMESTICOS
8941190;;M;64;CHILENO;;Boomers;RENCA                         ;METROPOLITANA;596380;7;4;0;0;0;7;4;596380;Licuadora L-25000NG;ELECTRODOMESTICOS
26517983;;M;27;HAITIANO;;Extranjero;TEMUCO                        ;ARAUCANIA;49990;2;1;0;0;0;2;1;49990;Cafetera UT-KAFFEEKLASSIK;ELECTRODOMESTICOS
16533487;;F;35;CHILENO;;Millenial;NUEVA IMPERIAL                ;ARAUCANIA;36980;2;2;0;0;0;2;2;36980;Plancha a Vapor 5001;ELECTRODOMESTICOS
8987580;;F;62;CHILENO;;Boomers;CURANILAHUE                   ;BIO BIO;2499650;17;10;0;0;0;17;10;2499650;Horno Electrico TH-48N 48Lts;ELECTRODOMESTICOS
13540022;;F;43;CHILENO;;X;PROVIDENCIA                   ;METROPOLITANA;19990;1;1;0;0;0;1;1;19990;Combo Hervidor + Batidora;ELECTRODOMESTICOS
9858351;Soltero;F;41;CHILENO;PSICOLOGO;X;PROVIDENCIA                   ;METROPOLITANA;69950;5;2;3;1;41970;2;1;27980;HERVIDOR TH-4340;ELECTRODOMESTICOS
12348112;;F;50;CHILENO;;X;TOCOPILLA                     ;ANTOFAGASTA;21990;1;1;0;0;0;1;1;21990;Batidora Manual 3532;ELECTRODOMESTICOS
13389424;;F;44;CHILENO;;X;ARAUCO                        ;BIO BIO;25990;1;1;0;0;0;1;1;25990;Licuadora Berry Blender Roja 1400 Vaso Vidrio;ELECTRODOMESTICOS
14165358;;F;40;CHILENO;;X;"";"";127960;4;2;0;0;0;4;2;127960;HORNO ELECTRICO MUNICH 60 LITROS;ELECTRODOMESTICOS
15266794;;M;40;CHILENO;;X;PANGUIPULLI                   ;LOS RIOS;795950;10;6;6;2;554990;4;4;240960;Hervidor Electrico Tetera TH-6505RT 1,7Lts Rojo;ELECTRODOMESTICOS
17035683;;M;33;CHILENO;;Millenial;PUERTO MONTT                  ;LOS LAGOS;346970;3;2;2;1;324980;1;1;21990;Combo Hervidor + Batidora;ELECTRODOMESTICOS
10082686;;F;58;CHILENO;;Boomers;CHILLAN                       ;BIO BIO;250310;6;2;0;0;0;6;2;250310;HERVIDOR HAMBURGO 2,0 LITROS;ELECTRODOMESTICOS
16764744;Soltero;M;34;CHILENO;KINESIOLOGO;Silencioso;PROVIDENCIA                   ;METROPOLITANA;14980;2;1;2;1;14980;0;0;0;Hervidor Inox One Midea;ELECTRODOMESTICOS
18656666;;F;28;CHILENO;;Millenial;LONGAVI                       ;MAULE;411950;5;5;0;0;0;5;5;411950;Hervidor Electrico TH-4212N 1,7Lts Negro;ELECTRODOMESTICOS
6845212;;M;65;CHILENO;;Boomers;YUNGAY                        ;BIO BIO;74970;3;1;0;0;0;3;1;74970;Parrilla Electrica TH-180;ELECTRODOMESTICOS
7835671;;F;68;CHILENO;;Boomers;N/D;N/D;14693;1;1;0;0;0;1;1;14693;Plancha UT-DUNST 2200Watts Base Ceramica;ELECTRODOMESTICOS
19126054;Soltero;M;26;CHILENO;;Z;PROVIDENCIA                   ;METROPOLITANA;16990;1;1;0;0;0;1;1;16990;HERVIDOR BERLIN 1,7 LITROS;ELECTRODOMESTICOS
17382465;;M;32;CHILENO;;Millenial;PROVIDENCIA                   ;METROPOLITANA;35980;2;2;0;0;0;2;2;35980;Hervidor Electrico UT-KLAR20PW 2Lts Blanco;ELECTRODOMESTICOS
9931862;;M;58;CHILENO;;Boomers;CABILDO                       ;VALPARAISO;202212;4;3;0;0;0;4;3;202212;Horno Microondas Mecanico Easy Wave 20Lts;ELECTRODOMESTICOS
17940693;;F;30;CHILENO;;Millenial;N/D;N/D;38990;1;1;0;0;0;1;1;38990;Hervidor Electrico Tetera TH-6505RT 1,7Lts Rojo;ELECTRODOMESTICOS
7389853;;F;66;CHILENO;;Boomers;PUERTO MONTT                  ;LOS LAGOS;415960;4;3;4;3;415960;0;0;0;Horno Electrico TH62I 60Lts;ELECTRODOMESTICOS
12812068;Soltero;F;47;CHILENO;CONTADOR AUDITOR;X;PROVIDENCIA                   ;METROPOLITANA;39990;1;1;1;1;39990;0;0;0;Horno Microonda Columba 1700;ELECTRODOMESTICOS
15655528;Casado;M;38;CHILENO;;Millenial;RENCA                         ;METROPOLITANA;214980;2;2;0;0;0;2;2;214980;Hervidor Electrico TH-5407i 2Lts;ELECTRODOMESTICOS
12737264;;F;47;CHILENO;;X;N/D;N/D;444970;3;2;0;0;0;3;2;444970;Combo Juguera + Hervidor;ELECTRODOMESTICOS
15613289;;F;39;CHILENO;;X;"";"";99980;2;2;1;1;54990;1;1;44990;FREIDORA DE AIRE BAVIERA 3,8 LITROS;ELECTRODOMESTICOS
17320360;;F;33;CHILENO;;Millenial;CORONEL                       ;BIO BIO;101970;3;2;0;0;0;3;2;101970;Horno Electrico TH-48N 48Lts;ELECTRODOMESTICOS
12377826;;F;48;CHILENO;;X;CHILLAN VIEJO                 ;BIO BIO;404020;6;4;0;0;0;6;4;404020;Aspiradora TH1870 Arrastre 1800Watts Gris;ELECTRODOMESTICOS
18338998;;F;29;CHILENO;;Millenial;MAIPU                         ;METROPOLITANA;116970;4;2;4;2;116970;0;0;0;Batidora Vertical Minipimer UT-KLOT400P;ELECTRODOMESTICOS
3557918;;M;84;CHILENO;;Silencioso;EL QUISCO                     ;VALPARAISO;74980;2;4;0;0;0;2;4;74980;Licuadora Kaliman Negra con Teclas;ELECTRODOMESTICOS
11601693;;F;52;CHILENO;;X;N/D;N/D;11990;1;1;0;0;0;1;1;11990;Hervidor Inox One Midea;ELECTRODOMESTICOS
12610162;;F;47;CHILENO;;X;ARICA                         ;ARICA Y PARINACOTA;18193;1;1;0;0;0;1;1;18193;Plancha UT-KERAMIKTOP 2200Watts Base Ceramica;ELECTRODOMESTICOS
15147252;Soltero;F;37;CHILENO;;Millenial;SAN JAVIER                    ;MAULE;592940;6;3;0;0;0;6;3;592940;HORNO ELECTRICO MUNICH 60 LITROS;ELECTRODOMESTICOS
16463387;;M;35;CHILENO;;Millenial;TOCOPILLA                     ;ANTOFAGASTA;268940;6;6;1;1;11990;5;5;256950;Plancha a Vapor 5001;ELECTRODOMESTICOS
15439660;;F;40;CHILENO;;X;PROVIDENCIA                   ;METROPOLITANA;185970;3;1;0;0;0;3;1;185970;Maquina de Coser JS-2135CL Calipso;ELECTRODOMESTICOS
9648738;;F;59;CHILENO;;Boomers;VALDIVIA                      ;LOS LAGOS;585430;7;4;7;4;585430;0;0;0;Horno Electrico TH-25N01 25Lts;ELECTRODOMESTICOS
8464202;;M;61;CHILENO;;Boomers;LOS ANGELES                   ;BIO BIO;49990;1;1;0;0;0;1;1;49990;Horno Microondas Mecanico Easy Wave 20Lts;ELECTRODOMESTICOS
14322942;;F;44;CHILENO;;X;RENCA                         ;METROPOLITANA;36990;1;1;0;0;0;1;1;36990;Combo Juguera + Hervidor;ELECTRODOMESTICOS
13212175;;F;45;CHILENO;;X;N/D;N/D;14990;1;1;0;0;0;1;1;14990;HERVIDOR COLONIA 1,7 LITROS;ELECTRODOMESTICOS
11683514;;M;51;CHILENO;;X;CORONEL                       ;BIO BIO;219980;2;2;0;0;0;2;2;219980;Horno Microondas Digital UT-CLASSY720 20Lts;ELECTRODOMESTICOS
16056821;;M;36;CHILENO;;Millenial;IQUIQUE;TARAPACA;131940;6;1;6;1;131940;0;0;0;Horno Microonda Columba 1700;ELECTRODOMESTICOS
17091199;;F;33;CHILENO;;Millenial;RETIRO                        ;MAULE;26990;1;1;0;0;0;1;1;26990;Batidora Vertical Multimixer TH-8720;ELECTRODOMESTICOS
8021708;;F;61;CHILENO;;Boomers;N/D;N/D;1619080;8;5;0;0;0;8;5;1619080;Horno Electrico TH62I 60Lts;ELECTRODOMESTICOS
8550994;;M;61;CHILENO;;Boomers;RENCA                         ;METROPOLITANA;29990;1;1;0;0;0;1;1;29990;Licuadora L2000VNG 1,5Lts Vaso Vidrio;ELECTRODOMESTICOS
10514963;;M;54;CHILENO;;Boomers;CURANILAHUE                   ;BIO BIO;1251460;7;5;0;0;0;7;5;1251460;Aspiradora TH1870 Arrastre 1800Watts Gris;ELECTRODOMESTICOS
6895127;;F;63;CHILENO;;Boomers;SAN FELIPE                    ;VALPARAISO;64980;2;2;0;0;0;2;2;64980;Plancha UT-KERAMIK1 2200Watts Base Ceramica;ELECTRODOMESTICOS
7789272;;M;58;CHILENO;;Boomers;ANGOL                         ;ARAUCANIA;1008120;4;2;0;0;0;4;2;1008120;Horno Electrico TH-100i 100Lts;ELECTRODOMESTICOS
11556188;;F;52;CHILENO;;X;SANTA CRUZ                    ;L.G.B.OÂ´HIGGINS;302983;2;2;0;0;0;2;2;302983;Freidora de Aire 18M Oster;ELECTRODOMESTICOS
11346102;Casado;M;53;CHILENO;;X;LA SERENA                     ;COQUIMBO;105980;2;2;0;0;0;2;2;105980;Horno Electrico TH62I 60Lts;ELECTRODOMESTICOS
3934028;;M;84;CHILENO;;Silencioso;N/D;N/D;105735;6;4;0;0;0;6;4;105735;Hervidor Electrico UT-REIN17SS;ELECTRODOMESTICOS
9435559;;M;60;CHILENO;;Boomers;N/D;N/D;54990;1;1;0;0;0;1;1;54990;Horno Microondas Mecanico Easy Wave 20Lts;ELECTRODOMESTICOS
16894852;;F;34;CHILENO;;Millenial;PUERTO MONTT                  ;LOS LAGOS;346930;7;4;3;2;239970;4;2;106960;Aspiradora VCC4190V3E/XZS Arrastre 2000Watts;ELECTRODOMESTICOS
17891980;Soltero;F;30;CHILENO;;Millenial;PROVIDENCIA                   ;METROPOLITANA;13990;1;1;0;0;0;1;1;13990;Batidora Vertical Stick Mixer 2609;ELECTRODOMESTICOS
13028295;;F;45;CHILENO;;X;HUECHURABA                    ;METROPOLITANA;33980;2;1;2;1;33980;0;0;0;Batidora de Mano y Pedestal 3612;ELECTRODOMESTICOS
15193930;;F;38;CHILENO;;X;LOTA;BIO-BIO;340941;7;4;0;0;0;7;4;340941;Horno Electrico TH62I 60Lts;ELECTRODOMESTICOS
17826509;Soltero;F;30;CHILENO;;Millenial;VILLARICA                     ;ARAUCANIA;205961;6;4;0;0;0;6;4;205961;HERVIDOR HAMBURGO 2,0 LITROS;ELECTRODOMESTICOS
17364822;;F;32;CHILENO;;Millenial;N/D;N/D;29990;1;1;0;0;0;1;1;29990;Combo Licuadora + Batidora;ELECTRODOMESTICOS
5648403;;M;71;CHILENO;;Silencioso;RENCA                         ;METROPOLITANA;248560;3;2;0;0;0;3;2;248560;Hervidor Electrico UT-MANLY17 1,7Lts Negro;ELECTRODOMESTICOS
6706244;;F;74;CHILENO;;Silencioso;VALDIVIA                      ;LOS RIOS;64990;1;1;0;0;0;1;1;64990;Horno Microondas Mecanico UT-SYDNEY18 18Lts;ELECTRODOMESTICOS
13140993;;F;45;CHILENO;;X;YUMBEL                        ;BIO BIO;109640;2;1;0;0;0;2;1;109640;Horno Electrico UT-BACKOFEN60 60Lts;ELECTRODOMESTICOS
7858162;;M;66;CHILENO;;Boomers;ALGARROBO                     ;VALPARAISO;719920;8;5;0;0;0;8;5;719920;Aspiradora UT-SILENT1603 Arrastre 1600Watts;ELECTRODOMESTICOS
7599757;;M;65;CHILENO;;Boomers;CORONEL                       ;BIO BIO;774910;9;3;0;0;0;9;3;774910;Combo Licuadora + Batidora;ELECTRODOMESTICOS
9046994;Divorciado;F;65;CHILENO;;Boomers;RENCA                         ;METROPOLITANA;34990;1;3;0;0;0;1;3;34990;MAQUINA COSER 2250;ELECTRODOMESTICOS
8816749;;F;63;CHILENO;;Boomers;CHONCHI                       ;LOS LAGOS;271960;4;3;0;0;0;4;3;271960;Licuadora L-25000NG;ELECTRODOMESTICOS
18109853;;F;30;CHILENO;;Millenial;TALCAHUANO                    ;BIO BIO;29700;2;1;0;0;0;2;1;29700;Hervidor Family Kettle HE500;ELECTRODOMESTICOS
11920862;;F;50;CHILENO;;X;N/D;N/D;137970;3;2;0;0;0;3;2;137970;PLANCHA A VAPOR GCSTCS401 SUELA CERAMICA 2200W;ELECTRODOMESTICOS
12065273;;M;52;CHILENO;;X;SAN JAVIER                    ;MAULE;77980;2;1;0;0;0;2;1;77980;Aspiradora TH1870 Arrastre 1800Watts Gris;ELECTRODOMESTICOS
18076339;;F;30;CHILENO;;Millenial;N/D;N/D;14990;1;3;0;0;0;1;3;14990;Enceradora EA-5000;ELECTRODOMESTICOS
8527051;;F;63;CHILENO;;Boomers;RENCA                         ;METROPOLITANA;16990;1;1;0;0;0;1;1;16990;Hervidor Electrico HA-3300 2,5Lts Blanco;ELECTRODOMESTICOS
11051652;;F;56;CHILENO;;Boomers;LA SERENA                     ;COQUIMBO;69980;2;2;0;0;0;2;2;69980;Batidora Vertical Minipimer UT-KLOT400P;ELECTRODOMESTICOS
18558285;;F;28;CHILENO;;Millenial;RENGO                         ;L.G.B.OÂ´HIGGINS;219980;5;3;0;0;0;5;3;219980;Extractor de Jugo EX800 1,4Lts;ELECTRODOMESTICOS
12145556;;M;52;CHILENO;;X;CHILLAN                       ;BIO BIO;21686;2;1;0;0;0;2;1;21686;Sandwichera TH-952 2 Panes Blanca;ELECTRODOMESTICOS
12787312;;M;47;CHILENO;;X;TALCA                         ;MAULE;515750;4;3;0;0;0;4;3;515750;Licuadora Sport Blender BSE10;ELECTRODOMESTICOS
16345593;;M;37;CHILENO;;Millenial;PARRAL                        ;MAULE;219980;3;2;0;0;0;3;2;219980;Freidora de Aire 18M Oster;ELECTRODOMESTICOS
17471631;;M;31;CHILENO;;Millenial;N/D;N/D;405940;6;4;0;0;0;6;4;405940;Olla Arrocera OA-400NG 1,8Lts;ELECTRODOMESTICOS
8055185;;F;62;CHILENO;;Boomers;CABILDO                       ;VALPARAISO;268240;6;3;0;0;0;6;3;268240;HORNO ELECTRICO 16N01 16LTS NEGRO;ELECTRODOMESTICOS
17696629;;F;31;CHILENO;;Millenial;SAN NICOLAS                   ;BIO BIO;27840;3;2;0;0;0;3;2;27840;Sandwichera TH-952 2 Panes Blanca;ELECTRODOMESTICOS
16017804;;F;37;CHILENO;;Millenial;"";"";11990;1;1;0;0;0;1;1;11990;Hervidor Inox One Midea;ELECTRODOMESTICOS
15799277;;F;38;CHILENO;;Millenial;PUDAHUEL                      ;METROPOLITANA;49990;1;1;0;0;0;1;1;49990;BATIDORA PEDESTAL RENANIA 5 LITROS;ELECTRODOMESTICOS
13381646;;F;44;CHILENO;;X;SAN IGNACIO                   ;BIO BIO;302980;2;2;0;0;0;2;2;302980;Batidora Vertical Stick Mixer 2609;ELECTRODOMESTICOS
10751325;;F;55;CHILENO;;Boomers;ARAUCO                        ;BIO BIO;240510;5;4;0;0;0;5;4;240510;Hervidor Electrico TH-4212N 1,7Lts Negro;ELECTRODOMESTICOS
26579220;;F;31;EXTRANJERO - NO INFORMA NACIONALIDAD;;Extranjero;"";"";39990;1;1;0;0;0;1;1;39990;Aspiradora AP1700 Arrastre 1700Watts;ELECTRODOMESTICOS
5765785;Casado;M;73;CHILENO;ABOGADO;Silencioso;RENCA                         ;METROPOLITANA;51840;2;1;0;0;0;2;1;51840;HORNO ELECTRICO 16N01 16LTS NEGRO;ELECTRODOMESTICOS
11910747;;F;51;CHILENO;;X;COIHAIQUE                     ;AYSEN;587880;4;2;0;0;0;4;2;587880;FREIDORA DE AIRE BAVIERA 3,8 LITROS;ELECTRODOMESTICOS
7419957;;F;71;CHILENO;;Silencioso;SAN BERNARDO                  ;METROPOLITANA;432960;4;2;0;0;0;4;2;432960;Batidora de Mano y Pedestal 3612;ELECTRODOMESTICOS
9782836;Casado;M;58;CHILENO;;Boomers;RENCA                         ;METROPOLITANA;108970;3;3;0;0;0;3;3;108970;Batidora Pedestal Bowl 300 Inox;ELECTRODOMESTICOS
9935367;;F;58;CHILENO;;Boomers;IQUIQUE                       ;TARAPACA;477250;5;2;0;0;0;5;2;477250;MAQUINA COSER 2250;ELECTRODOMESTICOS
11727442;;M;51;CHILENO;;X;TOCOPILLA                     ;ANTOFAGASTA;239969;3;2;0;0;0;3;2;239969;Batidora Vertical Minipimer UT-KLOT800SS;ELECTRODOMESTICOS
16213438;;F;35;CHILENO;;Millenial;PROVIDENCIA                   ;METROPOLITANA;400060;6;3;6;3;400060;0;0;0;Licuadora Oster Clasica Azul 4134 1,25 lt;ELECTRODOMESTICOS
18813795;;F;28;CHILENO;;Millenial;ILLAPEL                       ;COQUIMBO;548410;8;4;0;0;0;8;4;548410;FREIDORA DE AIRE BAVIERA 3,8 LITROS;ELECTRODOMESTICOS
17428866;;F;32;CHILENO;;Millenial;N/D;N/D;24990;1;1;0;0;0;1;1;24990;LICUADORA HANOVER 1,5 LITROS;ELECTRODOMESTICOS
12533864;;F;48;CHILENO;;X;PAINE                         ;METROPOLITANA;310180;5;4;0;0;0;5;4;310180;HORNO ELECTRICO THOMAS TH-38i;ELECTRODOMESTICOS
14376998;;F;45;CHILENO;;X;SAN BERNARDO                  ;METROPOLITANA;95972;3;3;0;0;0;3;3;95972;Parrilla Electrica M18W;ELECTRODOMESTICOS
4994762;;F;79;CHILENO;;Silencioso;LLAILLAY                      ;VALPARAISO;31493;1;1;0;0;0;1;1;31493;Picadora TH-9020V Vaso Vidrio 2Lts;ELECTRODOMESTICOS
8056645;;M;65;CHILENO;;Boomers;TORRES DEL PAINE              ;MAGALLANES;134990;1;1;0;0;0;1;1;134990;Horno Electrico TH-80i 80Lts;ELECTRODOMESTICOS
10166831;;M;57;CHILENO;;Boomers;TALCA                         ;MAULE;191810;3;2;0;0;0;3;2;191810;BATIDORA PEDESTAL RENANIA 5 LITROS;ELECTRODOMESTICOS
14346809;;F;47;CHILENO;;X;CALBUCO                       ;LOS LAGOS;70579;3;1;0;0;0;3;1;70579;HORNO ELECTRICO DORTMUND 45 LITROS;ELECTRODOMESTICOS
10534077;;F;59;CHILENO;;Boomers;RENCA                         ;METROPOLITANA;69980;3;1;0;0;0;3;1;69980;FREIDORA DE AIRE BAVIERA 3,8 LITROS;ELECTRODOMESTICOS
12897488;;F;47;CHILENO;;X;"";"";78890;3;1;0;0;0;3;1;78890;Horno Electrico UT-BACKOFEN26 26Lts;ELECTRODOMESTICOS
17470960;;F;32;CHILENO;;Millenial;SAN FERNANDO                  ;L.G.B.OÂ´HIGGINS;288400;9;3;6;2;75940;3;1;212460;ASPIRADORA THOMAS TH-1022C;ELECTRODOMESTICOS
6231483;;F;70;CHILENO;;Silencioso;PROVIDENCIA                   ;METROPOLITANA;16990;1;1;0;0;0;1;1;16990;HERVIDOR BERLIN 1,7 LITROS;ELECTRODOMESTICOS
20020646;;F;23;CHILENO;;Z;N/D;N/D;84990;1;1;0;0;0;1;1;84990;Horno Electrico TH-38N 38Lts;ELECTRODOMESTICOS
19437458;;F;25;CHILENO;;Z;PUERTO MONTT;LOS LAGOS;192960;4;2;4;2;192960;0;0;0;CAFETERA PRIMA LATTE 6603 ROJA;ELECTRODOMESTICOS
17498855;;M;23;CHILENO;;Z;"";"";224950;5;4;3;2;116970;2;2;107980;HORNO ELECTRICO MUNICH 60 LITROS;ELECTRODOMESTICOS
8706839;;M;59;CHILENO;;Boomers;RENCA                         ;METROPOLITANA;-5000;0;2;0;0;0;0;2;-5000;Licuadora L2000VNG 1,5Lts Vaso Vidrio;ELECTRODOMESTICOS
12586963;;F;48;CHILENO;;X;EL BOSQUE                     ;METROPOLITANA;328210;5;4;0;0;0;5;4;328210;Hervidor Electrico TH-4515N 2Lts Negro;ELECTRODOMESTICOS
15051468;;F;40;CHILENO;;Extranjero;PROVIDENCIA                   ;N/D;46990;1;1;1;1;46990;0;0;0;Horno Microondas Mecanico Fancy 20Lts;ELECTRODOMESTICOS
8576753;;M;64;CHILENO;;Boomers;LOS ALAMOS                    ;BIO BIO;258963;6;3;0;0;0;6;3;258963;BATIDORA PEDESTAL RENANIA 5 LITROS;ELECTRODOMESTICOS
11195702;;F;54;CHILENO;;Boomers;PROVIDENCIA                   ;METROPOLITANA;19990;1;1;0;0;0;1;1;19990;PLANCHA VAPOR TH-7146;ELECTRODOMESTICOS
26674207;;M;44;VENEZOLANO;;Extranjero;VILLA ALEMANA                 ;VALPARAISO;29990;1;1;0;0;0;1;1;29990;FREIDORA DE AIRE HESSIA 2,0 LITROS;ELECTRODOMESTICOS
9230569;Casado;F;58;CHILENO;;Boomers;"";"";713420;7;5;0;0;0;7;5;713420;Hervidor Electrico Tetera UT-LECKER18R 1,8Lts;ELECTRODOMESTICOS
9053672;;F;61;CHILENO;;Boomers;TALCA                         ;MAULE;13990;1;1;0;0;0;1;1;13990;HERVIDOR COLONIA 1,7 LITROS;ELECTRODOMESTICOS
17078303;;F;33;CHILENO;;Millenial;QUILLOTA                      ;VALPARAISO;56980;2;1;2;1;56980;0;0;0;Olla Multiuso TH-40PC 0,5Lts;ELECTRODOMESTICOS
11993344;;F;50;CHILENO;;X;SAN RAMON                     ;METROPOLITANA;-277020;-1;5;0;0;0;-1;5;-277020;Tostador de Pan TH-126 4 Rebanadas Negro;ELECTRODOMESTICOS
17863833;;F;31;CHILENO;;Millenial;VALDIVIA                      ;LOS LAGOS;10990;1;1;0;0;0;1;1;10990;Hervidor Inox One Midea;ELECTRODOMESTICOS
25790133;;M;55;EXTRANJERO - NO INFORMA NACIONALIDAD;;Extranjero;RENGO                         ;L.G.B.OÂ´HIGGINS;405250;12;6;0;0;0;12;6;405250;Licuadora Roja 550W 1,5Lts Vaso Vidrio;ELECTRODOMESTICOS
13817601;;M;42;CHILENO;;X;N/D;N/D;89990;1;1;0;0;0;1;1;89990;Horno Electrico TH62I 60Lts;ELECTRODOMESTICOS
13854193;;M;42;CHILENO;;X;CASTRO                        ;LOS LAGOS;79980;2;2;0;0;0;2;2;79980;Plancha UT-DUNST 2200Watts Base Ceramica;ELECTRODOMESTICOS
16215940;;M;36;CHILENO;;Millenial;N/D;N/D;109960;4;2;0;0;0;4;2;109960;Horno Microondas Digital L UT-25KROMM 25Lts;ELECTRODOMESTICOS
10222328;Casado;M;56;CHILENO;;Boomers;PROVIDENCIA                   ;METROPOLITANA;44990;1;1;0;0;0;1;1;44990;HERVIDOR TETERA RELOJ 900R 2,5L ROJO;ELECTRODOMESTICOS
7960060;Casado;F;62;CHILENO;;Boomers;TALAGANTE                     ;METROPOLITANA;646330;6;3;0;0;0;6;3;646330;Hervidor Electrico UT-REIN17SS;ELECTRODOMESTICOS
20366369;;F;22;CHILENO;;Z;CASTRO;LOS LAGOS;84990;1;1;0;0;0;1;1;84990;Aspiradora TH1870 Arrastre 1800Watts Gris;ELECTRODOMESTICOS
10957990;;F;45;CHILENO;;X;RENCA                         ;METROPOLITANA;407960;4;2;0;0;0;4;2;407960;Hervidor Electrico TH-4515N 2Lts Negro;ELECTRODOMESTICOS
18419409;;M;28;CHILENO;;Millenial;N/D;N/D;195450;4;3;0;0;0;4;3;195450;BATIDORA PEDESTAL RENANIA 5 LITROS;ELECTRODOMESTICOS
15945898;;M;43;CHILENO;;X;RENCA                         ;METROPOLITANA;16990;1;1;0;0;0;1;1;16990;Exprimidor de Jugo 407W 1Lts;ELECTRODOMESTICOS
9439244;;F;59;CHILENO;;Boomers;ARICA                         ;ARICA Y PARINACOTA;32990;1;1;0;0;0;1;1;32990;Combo Juguera + Hervidor;ELECTRODOMESTICOS
10452721;;F;56;CHILENO;;Boomers;RENCA                         ;METROPOLITANA;79990;1;3;0;0;0;1;3;79990;Enceradora EA-5000;ELECTRODOMESTICOS
16180030;Soltero;F;36;CHILENO;;Millenial;SAN VICENTE                   ;L.G.B.OÂ´HIGGINS;322030;6;4;0;0;0;6;4;322030;Wafflera time blanca WJ170112 700W;ELECTRODOMESTICOS
6754185;Casado;F;72;CHILENO;;Silencioso;PROVIDENCIA                   ;METROPOLITANA;11990;1;1;0;0;0;1;1;11990;Hervidor Inox One Midea;ELECTRODOMESTICOS
16316795;;F;35;CHILENO;;Millenial;SAN PEDRO DE LA PAZ;BIO-BIO;23590;2;1;0;0;0;2;1;23590;Hervidor Inox One Midea;ELECTRODOMESTICOS
12561330;;F;48;CHILENO;;X;PROVIDENCIA                   ;METROPOLITANA;12990;1;1;0;0;0;1;1;12990;Batidora Vertical Stick Mixer 2609;ELECTRODOMESTICOS
13452113;;M;44;CHILENO;;X;RENCA                         ;METROPOLITANA;76980;2;2;0;0;0;2;2;76980;Aspiradora Tambor APA1000 1000Watts;ELECTRODOMESTICOS
6507511;;F;71;CHILENO;;Silencioso;VILLA ALEMANA                 ;VALPARAISO;392960;4;5;2;1;206980;2;4;185980;Horno Electrico TH-100i 100Lts;ELECTRODOMESTICOS
6452401;;F;69;CHILENO;;Silencioso;TALAGANTE                     ;METROPOLITANA;34993;1;1;0;0;0;1;1;34993;Horno Electrico UT-BACKOFEN26 26Lts;ELECTRODOMESTICOS
11719561;;F;51;CHILENO;;X;TOCOPILLA                     ;ANTOFAGASTA;1337760;10;7;0;0;0;10;7;1337760;ASPIRADORA VCC4580V3K/XZS SAMSUNG BLACK;ELECTRODOMESTICOS
9348370;;F;57;CHILENO;;Boomers;N/D;N/D;19990;1;1;0;0;0;1;1;19990;Hervidor Electrico UT-DUNKEL17P 2Lts Negro;ELECTRODOMESTICOS
7676516;;F;66;CHILENO;;Boomers;RANCAGUA                      ;L.G.B.OÂ´HIGGINS;0;0;4;0;0;0;0;4;0;Exprimidor de Jugo CJ-2000 1Lts;ELECTRODOMESTICOS
11550702;;F;52;CHILENO;;X;RENCA                         ;METROPOLITANA;16990;1;1;0;0;0;1;1;16990;Sandwichera TH-952 2 Panes Blanca;ELECTRODOMESTICOS
7046331;;F;66;CHILENO;;Boomers;VINA DEL MAR                  ;VALPARAISO;74970;3;3;0;0;0;3;3;74970;Batidora Vertical Stick Mixer 2609;ELECTRODOMESTICOS
12791136;;M;46;CHILENO;;X;COLBUN                        ;MAULE;237930;7;4;0;0;0;7;4;237930;Horno Microondas Digital TH-25DM 25Lts;ELECTRODOMESTICOS
12766498;;F;47;CHILENO;;X;PROVIDENCIA                   ;METROPOLITANA;145950;5;3;2;1;137980;3;2;7970;Parrilla Electrica M18W;ELECTRODOMESTICOS
19900757;;F;23;CHILENO;;Z;ANCUD                         ;LOS LAGOS;561930;13;7;4;2;265960;9;5;295970;FREIDORA DE AIRE BAVIERA 3,8 LITROS;ELECTRODOMESTICOS
16206491;;M;36;CHILENO;;Millenial;"";"";53840;2;1;0;0;0;2;1;53840;Hervidor Electrico Tetera TH-6505RT 1,7Lts Rojo;ELECTRODOMESTICOS
20230413;;F;22;CHILENO;;Z;PROVIDENCIA                   ;METROPOLITANA;84950;5;4;0;0;0;5;4;84950;LICUADORA HANOVER 1,5 LITROS;ELECTRODOMESTICOS
27214830;;F;35;CHILENO;;Extranjero;"";"";82980;2;2;0;0;0;2;2;82980;BATIDORA MANUAL 260R;ELECTRODOMESTICOS
18909516;Soltero;M;34;CHILENO;;Extranjero;PROVIDENCIA                   ;N/D;64990;1;1;0;0;0;1;1;64990;Horno Microondas Mecanico UT-SYDNEY18 18Lts;ELECTRODOMESTICOS
7548107;;M;65;CHILENO;;Boomers;PROVIDENCIA                   ;METROPOLITANA;49990;1;1;0;0;0;1;1;49990;Horno Microondas Mecanico Fancy 20Lts;ELECTRODOMESTICOS
16715794;Soltero;F;34;CHILENO;PROFESOR;Millenial;PROVIDENCIA                   ;METROPOLITANA;31460;3;1;0;0;0;3;1;31460;Hervidor Electrico TH-4212N 1,7Lts Negro;ELECTRODOMESTICOS
15600697;;F;42;CHILENO;;X;PANGUIPULLI                   ;LOS LAGOS;694070;9;5;0;0;0;9;5;694070;Aspiradora AP3400 Arrastre 2000Watts;ELECTRODOMESTICOS
16793228;;F;34;CHILENO;;Millenial;SAN JAVIER                    ;MAULE;30980;2;2;0;0;0;2;2;30980;Licuadora L-1630V Negra 1,5Lts Vaso Vidrio;ELECTRODOMESTICOS
9153490;;M;60;CHILENO;;Boomers;LOS ANDES                     ;VALPARAISO;362960;4;3;0;0;0;4;3;362960;HORNO ELECTRICO THOMAS TH-38i;ELECTRODOMESTICOS
9717871;;F;58;CHILENO;;Boomers;TEMUCO                        ;ARAUCANIA;19990;1;1;0;0;0;1;1;19990;Combo Hervidor + Batidora;ELECTRODOMESTICOS
13473956;;M;43;CHILENO;;X;CANETE                        ;BIO BIO;233980;4;2;0;0;0;4;2;233980;Plancha Paninis 2880;ELECTRODOMESTICOS
15684042;;F;39;CHILENO;;X;ALTO HOSPICIO;TARAPACA;313230;3;4;0;0;0;3;4;313230;Combo Licuadora + Batidora;ELECTRODOMESTICOS
18243181;;F;30;CHILENO;;Millenial;LA REINA                      ;METROPOLITANA;73980;2;1;2;1;73980;0;0;0;Licuadora Reversible Roja;ELECTRODOMESTICOS
18724946;;M;28;CHILENO;;Millenial;N/D;N/D;1370920;11;6;0;0;0;11;6;1370920;Horno Microondas Digital TH-20S01 20Lts;ELECTRODOMESTICOS
15717389;;F;38;CHILENO;;X;SAN ANTONIO                   ;VALPARAISO;602950;5;3;0;0;0;5;3;602950;HORNO ELECTRICO HE-600IN INOX SINDELEN;ELECTRODOMESTICOS
10964524;;M;48;CHILENO;;X;N/D;N/D;19990;1;1;0;0;0;1;1;19990;Hervidor Electrico TH-4515N 2Lts Negro;ELECTRODOMESTICOS
11343648;;F;54;CHILENO;;X;LA SERENA                     ;COQUIMBO;232030;6;3;0;0;0;6;3;232030;HERVIDOR TETERA RELOJ 900R 2,5L ROJO;ELECTRODOMESTICOS
25350733;Soltero;F;52;VENEZOLANO;;Extranjero;PROVIDENCIA                   ;METROPOLITANA;33980;2;1;2;1;33980;0;0;0;Licuadora Roja 550W 1,5Lts Vaso Vidrio;ELECTRODOMESTICOS
5787846;;M;74;CHILENO;;Silencioso;INDEPENDENCIA                 ;METROPOLITANA;14990;1;1;0;0;0;1;1;14990;HERVIDOR HAMBURGO 2,0 LITROS;ELECTRODOMESTICOS
16244600;;F;36;CHILENO;;Millenial;ANTOFAGASTA;ANTOFAGASTA;443950;6;4;0;0;0;6;4;443950;Hervidor Inox One Midea;ELECTRODOMESTICOS
16102044;;F;37;CHILENO;;Millenial;"";"";102980;2;2;0;0;0;2;2;102980;Parrilla Electrica M18W;ELECTRODOMESTICOS
16156772;;F;37;CHILENO;;Millenial;N/D;N/D;182960;3;1;3;1;182960;0;0;0;CAFETERA PRIMA LATTE 6603 ROJA;ELECTRODOMESTICOS
18966238;;F;26;CHILENO;;Z;TEMUCO                        ;ARAUCANIA;409950;5;3;2;1;88980;3;2;320970;FREIDORA DE AIRE THOMAS TH-AF60Mi;ELECTRODOMESTICOS
15651454;;F;39;CHILENO;;X;"";"";64990;1;1;0;0;0;1;1;64990;Aspiradora TH1870 Arrastre 1800Watts Gris;ELECTRODOMESTICOS
12661700;;M;47;CHILENO;;X;LOS ANGELES;BIO-BIO;119990;1;1;1;1;119990;0;0;0;Horno Electrico UT-BACKOFEN60 60Lts;ELECTRODOMESTICOS
18525347;;M;28;CHILENO;;Millenial;SANTA BARBARA;BIO-BIO;65000;2;1;0;0;0;2;1;65000;Aspiradora UT-SILENT1804 Arrastre 1800Watts;ELECTRODOMESTICOS
19538628;;F;25;CHILENO;;Z;N/D;N/D;349970;3;2;0;0;0;3;2;349970;FREIDORA DE AIRE HESSIA 2,0 LITROS;ELECTRODOMESTICOS
5266358;;M;77;CHILENO;;Silencioso;MELIPILLA                     ;METROPOLITANA;19990;1;1;0;0;0;1;1;19990;Hervidor Electrico TH-4515N 2Lts Negro;ELECTRODOMESTICOS
8387047;;F;64;CHILENO;;Boomers;PANGUIPULLI                   ;LOS LAGOS;268970;3;3;0;0;0;3;3;268970;Plancha Easy Steam (PV4500);ELECTRODOMESTICOS
14638143;;F;42;CHILENO;;X;RENCA                         ;METROPOLITANA;259080;5;2;0;0;0;5;2;259080;Horno Electrico TH-80i 80Lts;ELECTRODOMESTICOS
18258281;;M;30;CHILENO;;Millenial;N/D;N/D;156970;3;2;2;1;96980;1;1;59990;Aspiradora Trapeadora Robot Ut-Excellenza (B);ELECTRODOMESTICOS
7107309;;F;65;CHILENO;;Boomers;LA GRANJA                     ;METROPOLITANA;672940;6;3;0;0;0;6;3;672940;HERVIDOR HAMBURGO 2,0 LITROS;ELECTRODOMESTICOS
19094520;;F;27;CHILENO;;Z;RENCA                         ;METROPOLITANA;32990;1;1;0;0;0;1;1;32990;Hervidor Electrico Tetera HA-4100 4Lts Iox;ELECTRODOMESTICOS
20496126;;M;21;CHILENO;;Millenial;"";"";78980;2;1;2;1;78980;0;0;0;H MICROONDA MMP-25GE3D 25L;ELECTRODOMESTICOS
17078699;;F;33;CHILENO;;Millenial;"";"";32240;4;1;0;0;0;4;1;32240;Batidora Manual 3532;ELECTRODOMESTICOS
20795429;;F;21;CHILENO;;Z;PROVIDENCIA                   ;METROPOLITANA;605930;6;2;6;2;605930;0;0;0;MICROONDAS 30L MG30T5018CK/ZS SAMSUNG;ELECTRODOMESTICOS
6173710;Divorciado;M;72;CHILENO;;Silencioso;PENCO                         ;BIO BIO;186670;2;1;0;0;0;2;1;186670;Maquina de Coser VX1445 con 14 puntadas;ELECTRODOMESTICOS
11941075;;M;50;CHILENO;;X;N/D;N/D;311970;3;2;2;1;293980;1;1;17990;HERVIDOR TH-4340;ELECTRODOMESTICOS
16454558;;F;35;CHILENO;;Millenial;PROVIDENCIA                   ;METROPOLITANA;89990;1;1;0;0;0;1;1;89990;Horno Microondas Digital TH-25DM 25Lts;ELECTRODOMESTICOS
16214171;;F;55;CHILENO;;Boomers;PANGUIPULLI                   ;LOS RIOS;47980;2;1;0;0;0;2;1;47980;Aspiradora Handy Clean Black 1400;ELECTRODOMESTICOS
18920262;;M;25;CHILENO;;Z;RECOLETA                      ;METROPOLITANA;31990;1;1;0;0;0;1;1;31990;Wafflera time blanca WJ170112 700W;ELECTRODOMESTICOS
11799658;;M;50;CHILENO;;X;TEMUCO                        ;ARAUCANIA;64980;2;2;0;0;0;2;2;64980;Hervidor Inox One Midea;ELECTRODOMESTICOS
17220816;;F;33;CHILENO;;Millenial;PROVIDENCIA                   ;METROPOLITANA;29990;1;1;1;1;29990;0;0;0;FREIDORA DE AIRE HESSIA 2,0 LITROS;ELECTRODOMESTICOS
10661094;;M;55;CHILENO;;Boomers;RENCA                         ;METROPOLITANA;60970;3;4;0;0;0;3;4;60970;MULTIMIXER THOMAS TH- 8706;ELECTRODOMESTICOS
15874850;;F;37;CHILENO;;Millenial;N/D;N/D;994061;11;6;0;0;0;11;6;994061;Combo Licuadora + Batidora;ELECTRODOMESTICOS
18721470;;M;27;CHILENO;;Z;PADRE LAS CASAS               ;ARAUCANIA;74980;2;2;0;0;0;2;2;74980;Picadora TH-9020V Vaso Vidrio 2Lts;ELECTRODOMESTICOS
7790453;;F;67;CHILENO;;Boomers;SAN PEDRO DE LA PAZ           ;BIO BIO;94970;3;2;0;0;0;3;2;94970;Licuadora Osterizer 4112/72 1,25Lts Vaso Vidrio;ELECTRODOMESTICOS
19177927;;F;26;CHILENO;;Z;N/D;N/D;43990;1;1;0;0;0;1;1;43990;Licuadora Kaliman Negra con Teclas;ELECTRODOMESTICOS
8048524;;M;65;CHILENO;;Boomers;EL BOSQUE                     ;METROPOLITANA;526180;6;4;0;0;0;6;4;526180;Hervidor Electrico Tetera HA-4100 4Lts Iox;ELECTRODOMESTICOS
7569204;;M;68;CHILENO;;Boomers;MELIPILLA                     ;METROPOLITANA;511210;6;4;0;0;0;6;4;511210;Horno Electrico UT-BACKOFEN48 48Lts;ELECTRODOMESTICOS
11626407;;F;52;CHILENO;;X;TEMUCO                        ;ARAUCANIA;49660;2;1;0;0;0;2;1;49660;Hervidor Electrico Tetera TH-6505RT 1,7Lts Rojo;ELECTRODOMESTICOS
11646287;;M;51;CHILENO;;X;N/D;N/D;59990;1;1;0;0;0;1;1;59990;Horno Microondas Mecanico TH-18B05 18Lts;ELECTRODOMESTICOS
6626918;Casado;F;67;CHILENO;;Boomers;RENCA                         ;METROPOLITANA;154980;2;2;0;0;0;2;2;154980;Horno Electrico TH-80i 80Lts;ELECTRODOMESTICOS
7073136;Soltero;F;73;CHILENO;;Silencioso;MAIPU                         ;METROPOLITANA;15240;2;2;0;0;0;2;2;15240;HERVIDOR HAMBURGO 2,0 LITROS;ELECTRODOMESTICOS
6157617;;M;69;CHILENO;;Silencioso;RENCA                         ;METROPOLITANA;49990;1;1;0;0;0;1;1;49990;Aspiradora TH1415 Arrastre 1500Watts;ELECTRODOMESTICOS
10870469;;M;54;CHILENO;;Boomers;VALPARAISO                    ;VALPARAISO;35560;2;1;0;0;0;2;1;35560;Tostador de PanTH-120R 2 Rebanadas Rojo;ELECTRODOMESTICOS
10619641;;F;55;CHILENO;;Boomers;N/D;N/D;535200;6;3;0;0;0;6;3;535200;HERVIDOR COLONIA 1,7 LITROS;ELECTRODOMESTICOS
8932308;;M;59;CHILENO;;Boomers;"";"";39990;1;1;0;0;0;1;1;39990;Plancha Paninis 2880;ELECTRODOMESTICOS
16777975;;F;34;CHILENO;;Millenial;VINA DEL MAR                  ;VALPARAISO;52980;2;2;0;0;0;2;2;52980;Licuadora Kaliman Negra con Teclas;ELECTRODOMESTICOS
8272537;;M;64;CHILENO;;Boomers;PROVIDENCIA                   ;METROPOLITANA;19990;1;1;0;0;0;1;1;19990;Hervidor Electrico TH-4515N 2Lts Negro;ELECTRODOMESTICOS
5862513;;M;71;CHILENO;;Silencioso;LA FLORIDA                    ;METROPOLITANA;49990;1;1;0;0;0;1;1;49990;Horno Microondas Mecanico Easy Wave 20Lts;ELECTRODOMESTICOS
12106496;;F;49;CHILENO;;X;CALAMA                        ;ANTOFAGASTA;109990;1;1;0;0;0;1;1;109990;SUPER FREIDORA DE AIRE OV3;ELECTRODOMESTICOS
17287401;;F;32;CHILENO;;Millenial;N/D;N/D;944800;9;5;0;0;0;9;5;944800;CAFETERA PRIMA LATTE 6603 ROJA;ELECTRODOMESTICOS
8185117;;F;64;CHILENO;;Boomers;VILLA ALEGRE                  ;MAULE;215430;4;2;0;0;0;4;2;215430;Batidora Pedestal TH910PN 4,6Lts 1300Watts;ELECTRODOMESTICOS
16828704;;F;34;CHILENO;;Millenial;SANTA CRUZ                    ;L.G.B.OÂ´HIGGINS;231970;3;2;2;1;201980;1;1;29990;Batidora Vertical Minipimer UT-KLOT400P;ELECTRODOMESTICOS
15803537;;M;37;CHILENO;;Millenial;SANTA CRUZ                    ;L.G.B.OÂ´HIGGINS;84980;2;2;0;0;0;2;2;84980;Parrilla Electrica M18W;ELECTRODOMESTICOS
12774033;;F;49;CHILENO;;X;LOS VILOS                     ;COQUIMBO;47990;1;1;0;0;0;1;1;47990;Horno Microondas Mecanico Fancy 20Lts;ELECTRODOMESTICOS
11666696;;F;52;CHILENO;;X;RENCA                         ;METROPOLITANA;34990;1;1;1;1;34990;0;0;0;Licuadora TH-501V 1,5Lts Vaso Vidrio;ELECTRODOMESTICOS
12507343;;F;49;CHILENO;;X;PROVIDENCIA                   ;METROPOLITANA;289970;3;2;2;1;239980;1;1;49990;Horno Microondas Mecanico Easy Wave 20Lts;ELECTRODOMESTICOS
10713284;;M;56;CHILENO;;Boomers;PERALILLO                     ;L.G.B.OÂ´HIGGINS;243300;7;4;0;0;0;7;4;243300;Horno Microondas Mecanico Fancy 20Lts;ELECTRODOMESTICOS
9204025;;F;69;CHILENO;;Boomers;TENO                          ;MAULE;44990;1;1;0;0;0;1;1;44990;Horno Electrico TH-25N01 25Lts;ELECTRODOMESTICOS
17038521;;F;33;CHILENO;;Millenial;VALLENAR;ATACAMA;323930;4;3;0;0;0;4;3;323930;Horno Microondas Mecanico TH-18B05 18Lts;ELECTRODOMESTICOS
22581828;;M;67;PERUANO;;Extranjero;INDEPENDENCIA                 ;METROPOLITANA;389980;2;2;0;0;0;2;2;389980;Horno Microondas Digital TH-25DM 25Lts;ELECTRODOMESTICOS
9644031;;F;58;CHILENO;;Boomers;QUILLOTA                      ;VALPARAISO;345963;3;2;0;0;0;3;2;345963;Plancha Easy Steam (PV4500);ELECTRODOMESTICOS
13414159;;M;43;CHILENO;;X;"";"";99980;2;2;0;0;0;2;2;99980;Horno Electrico UT-LEIF36 36Lts;ELECTRODOMESTICOS
12517206;;M;48;CHILENO;;X;NATALES                       ;MAGALLANES;54990;1;1;0;0;0;1;1;54990;Aspiradora TH1870 Arrastre 1800Watts Gris;ELECTRODOMESTICOS
20270966;;F;22;CHILENO;;Z;N/D;N/D;16000;2;1;0;0;0;2;1;16000;Hervidor Electrico UT-MANLY17 1,7Lts Negro;ELECTRODOMESTICOS
10832601;;F;43;CHILENO;;Millenial;LEBU                          ;BIO BIO;13990;1;1;0;0;0;1;1;13990;Plancha Easy Steam (PV4500);ELECTRODOMESTICOS
8062251;;F;60;CHILENO;;Boomers;RENGO                         ;L.G.B.OÂ´HIGGINS;806390;10;7;0;0;0;10;7;806390;HORNO ELECTRICO BREMEN 23 LITROS;ELECTRODOMESTICOS
9504047;;F;59;CHILENO;;Boomers;LOS ANGELES                   ;BIO BIO;13990;1;1;0;0;0;1;1;13990;Hervidor Electrico 3101 1,7Lts Negro;ELECTRODOMESTICOS
12803838;;M;48;CHILENO;;X;PROVIDENCIA                   ;METROPOLITANA;24990;1;1;0;0;0;1;1;24990;HORNO 10 LITROS OSTER ROJO;ELECTRODOMESTICOS
12376173;;M;49;CHILENO;;X;RENCA                         ;METROPOLITANA;54990;1;1;1;1;54990;0;0;0;FREIDORA DE AIRE BAVIERA 3,8 LITROS;ELECTRODOMESTICOS
13534741;;M;43;CHILENO;;X;N/D;N/D;614140;4;2;2;1;119980;2;1;494160;Maquina de Coser 3008 Janome Blanco;ELECTRODOMESTICOS
18813580;;F;28;CHILENO;;Millenial;N/D;N/D;34990;1;1;0;0;0;1;1;34990;Cafetera UT-KAFFEEKLASSIK;ELECTRODOMESTICOS
13530671;;F;42;CHILENO;;X;RENCA                         ;METROPOLITANA;44990;1;1;0;0;0;1;1;44990;Parrilla Electrica M18W;ELECTRODOMESTICOS
18653266;;F;28;CHILENO;;Millenial;COIHAIQUE                     ;AYSEN;207980;2;2;1;1;179990;1;1;27990;Cafetera TH-138i;ELECTRODOMESTICOS
16847589;;F;34;CHILENO;;Millenial;COLINA;METROPOLITANA;124940;6;3;5;2;104950;1;1;19990;Combo Hervidor + Batidora;ELECTRODOMESTICOS
17717452;;F;31;CHILENO;;Millenial;PARRAL                        ;MAULE;25980;2;2;0;0;0;2;2;25980;Hervidor Family Kettle HE500;ELECTRODOMESTICOS
7125622;Casado;F;70;CHILENO;;Silencioso;PROVIDENCIA                   ;METROPOLITANA;38990;1;1;0;0;0;1;1;38990;Picadora 1-2-3 AD6011CL 750W;ELECTRODOMESTICOS
18787076;;F;28;CHILENO;;Millenial;PROVIDENCIA                   ;METROPOLITANA;758160;11;6;0;0;0;11;6;758160;Hervidor Inox One Midea;ELECTRODOMESTICOS
8359123;;F;63;CHILENO;;Boomers;CHILLAN                       ;BIO BIO;49990;1;1;0;0;0;1;1;49990;ASPIRADORA THOMAS TH-1640;ELECTRODOMESTICOS
13380213;;F;52;CHILENO;;X;TALCAHUANO                    ;BIO BIO;68220;4;3;0;0;0;4;3;68220;Extractor de Jugo EX800 1,4Lts;ELECTRODOMESTICOS
26618439;;M;31;VENEZOLANO;;Extranjero;TEMUCO                        ;ARAUCANIA;13990;1;1;0;0;0;1;1;13990;Hervidor Electrico 3101 1,7Lts Negro;ELECTRODOMESTICOS
4949295;;F;79;CHILENO;;Silencioso;QUILPUE                       ;VALPARAISO;44980;2;2;0;0;0;2;2;44980;TOSTADOR OLDEMBURGO 2 REBANADAS;ELECTRODOMESTICOS
8800530;;F;63;CHILENO;;Boomers;CHILLAN                       ;BIO BIO;0;0;2;0;0;0;0;2;0;Horno Electrico UT-BACKOFEN60 60Lts;ELECTRODOMESTICOS
10180602;;F;56;CHILENO;;Boomers;RENCA                         ;METROPOLITANA;49990;1;1;0;0;0;1;1;49990;Freidora de Aire 18M Oster;ELECTRODOMESTICOS
12228300;;F;50;CHILENO;;X;"";"";15990;1;1;0;0;0;1;1;15990;Hervidor Electrico UT-MANLY17 1,7Lts Negro;ELECTRODOMESTICOS
18543492;;F;32;CHILENO;;Millenial;N/D;N/D;887900;10;8;0;0;0;10;8;887900;Tostador de PanTH-120R 2 Rebanadas Rojo;ELECTRODOMESTICOS
11564075;;M;52;CHILENO;;X;N/D;N/D;324560;3;2;0;0;0;3;2;324560;Combo Licuadora + Batidora;ELECTRODOMESTICOS
3783144;;M;86;CHILENO;;Silencioso;TALCA                         ;MAULE;34990;1;2;0;0;0;1;2;34990;Licuadora TH-501V 1,5Lts Vaso Vidrio;ELECTRODOMESTICOS
17576011;;F;32;CHILENO;;Millenial;N/D;N/D;27990;1;1;0;0;0;1;1;27990;Picadora UT-PETRUS320 1Lts Vaso Vidrio;ELECTRODOMESTICOS
13088094;;M;46;CHILENO;;X;PROVIDENCIA                   ;METROPOLITANA;33980;2;2;0;0;0;2;2;33980;Hervidor Electrico HA-3300 2,5Lts Blanco;ELECTRODOMESTICOS
16425931;;F;35;CHILENO;;Millenial;CANETE                        ;BIO BIO;99990;1;1;0;0;0;1;1;99990;Maquina de coser Singer 1605;ELECTRODOMESTICOS
10928066;;F;46;CHILENO;;X;EL BOSQUE                     ;METROPOLITANA;59990;1;1;0;0;0;1;1;59990;Horno electrico Black Oven 42lts;ELECTRODOMESTICOS
13855240;;M;42;CHILENO;;X;PROVIDENCIA                   ;METROPOLITANA;109990;1;1;1;1;109990;0;0;0;SUPER FREIDORA DE AIRE OV3;ELECTRODOMESTICOS
24928668;;F;47;PERUANO;;Extranjero;N/D;N/D;143980;2;1;2;1;143980;0;0;0;MICROONDAS 40L MG402MADXBB/ZS SAMSUNG;ELECTRODOMESTICOS
6906808;;M;69;CHILENO;;Silencioso;PANQUEHUE                     ;VALPARAISO;398960;4;3;0;0;0;4;3;398960;Horno Microondas Mecanico M-2020NG 20Lts;ELECTRODOMESTICOS
16174785;;M;37;CHILENO;;Millenial;SAN PABLO                     ;LOS LAGOS;99990;1;1;0;0;0;1;1;99990;Horno Microondas Digital ME0113MB1/XZS 32Lts;ELECTRODOMESTICOS
14094621;;M;49;CHILENO;;X;LAJA                          ;BIO BIO;79990;1;1;0;0;0;1;1;79990;Batidora Pedestal UT-KLEIN700;ELECTRODOMESTICOS
14397770;;M;44;CHILENO;;X;TALCA;MAULE;64990;1;1;1;1;64990;0;0;0;Horno Electrico TH-38N 38Lts;ELECTRODOMESTICOS
24914555;;F;33;ECUATORIANO;;Extranjero;N/D;N/D;302940;6;3;4;2;247960;2;1;54980;SUPER FREIDORA DE AIRE OV3;ELECTRODOMESTICOS
12361002;;M;50;CHILENO;;X;LAS CONDES                    ;METROPOLITANA;98970;3;2;2;1;93980;1;1;4990;Aspiradora Trapeadora Robot Ut-Excellenza (B);ELECTRODOMESTICOS
14523719;Soltero;F;47;CHILENO;INGENIERO;X;RENCA                         ;METROPOLITANA;84990;1;1;0;0;0;1;1;84990;Horno Microondas Digital MS23K3513AK/ZS 23Lts;ELECTRODOMESTICOS
14459660;;F;48;CHILENO;;X;ARICA                         ;ARICA Y PARINACOTA;46980;2;2;0;0;0;2;2;46980;PLANCHA A VAPOR 6953 BASE AEROCERAMICA AUTAPA.22;ELECTRODOMESTICOS
6725866;;F;70;CHILENO;;Silencioso;QUILPUE                       ;VALPARAISO;14990;1;1;0;0;0;1;1;14990;Hervidor Inox One Midea;ELECTRODOMESTICOS
14048661;;F;41;CHILENO;;X;CHIMBARONGO                   ;L.G.B.OÂ´HIGGINS;77980;2;2;0;0;0;2;2;77980;Licuadora L-1630V Negra 1,5Lts Vaso Vidrio;ELECTRODOMESTICOS
16590036;Soltero;M;35;CHILENO;;Millenial;PROVIDENCIA                   ;METROPOLITANA;26990;1;1;0;0;0;1;1;26990;Hervidor Electrico UT-REIN17SS;ELECTRODOMESTICOS
26701970;;M;32;VENEZOLANO;;Extranjero;PUERTO MONTT                  ;LOS LAGOS;49990;1;1;1;1;49990;0;0;0;Licuadora Oster Clasica Azul 4134 1,25 lt;ELECTRODOMESTICOS
20018456;;M;24;CHILENO;;Z;N/D;N/D;453950;5;4;5;4;453950;0;0;0;FREIDORA DE AIRE BAVIERA 3,8 LITROS;ELECTRODOMESTICOS
18152486;;M;29;CHILENO;;Millenial;"";"";128980;2;1;2;1;128980;0;0;0;SUPER FREIDORA DE AIRE OV3;ELECTRODOMESTICOS
16467813;;F;35;CHILENO;;Millenial;"";"";176940;6;3;6;3;176940;0;0;0;Horno Microondas Mecanico Easy Wave 20Lts;ELECTRODOMESTICOS
25693460;;M;37;HAITIANO;;Extranjero;EL BOSQUE                     ;METROPOLITANA;122210;5;3;0;0;0;5;3;122210;Hervidor Electrico TH-4515N 2Lts Negro;ELECTRODOMESTICOS
18168567;;M;30;CHILENO;;Millenial;LAS CONDES;METROPOLITANA;103980;2;1;2;1;103980;0;0;0;Maquina de Coser 3008 Janome Blanco;ELECTRODOMESTICOS
13728323;Casado;M;42;CHILENO;INGENIERO EN PREVENCION DE RIESGOS;X;PROVIDENCIA                   ;METROPOLITANA;84990;1;1;0;0;0;1;1;84990;Horno Electrico UT-BACKOFEN38 38Lts;ELECTRODOMESTICOS
15871684;;M;38;CHILENO;;Millenial;PROVIDENCIA                   ;METROPOLITANA;180910;2;1;0;0;0;2;1;180910;Horno Electrico TH-80i 80Lts;ELECTRODOMESTICOS
10679624;;M;55;CHILENO;;Boomers;YUMBEL                        ;BIO BIO;135440;3;2;0;0;0;3;2;135440;Horno Electrico UT-BACKOFEN38 38Lts;ELECTRODOMESTICOS
7319131;;M;67;CHILENO;;Boomers;BUIN                          ;METROPOLITANA;175440;3;2;0;0;0;3;2;175440;Enceradora EA-5000;ELECTRODOMESTICOS
10556087;;F;53;CHILENO;;X;RENCA                         ;METROPOLITANA;189990;1;1;0;0;0;1;1;189990;Horno Electrico TH-100i 100Lts;ELECTRODOMESTICOS
18786490;;M;27;CHILENO;;Millenial;SAN FERNANDO                  ;L.G.B.OÂ´HIGGINS;129980;2;2;0;0;0;2;2;129980;HORNO ELECTRICO HE-600IN INOX SINDELEN;ELECTRODOMESTICOS
14012239;;F;40;CHILENO;;X;COLTAUCO                      ;L.G.B.OÂ´HIGGINS;99270;4;1;0;0;0;4;1;99270;Horno Microondas Mecanico TH-18B05 18Lts;ELECTRODOMESTICOS
23898112;Casado;F;36;VENEZOLANO;;Extranjero;PROVIDENCIA                   ;METROPOLITANA;99990;1;1;1;1;99990;0;0;0;CAFETERA PRIMA LATTE 6603 ROJA;ELECTRODOMESTICOS
7704281;;F;65;CHILENO;;Boomers;VINA DEL MAR                  ;VALPARAISO;186980;2;1;2;1;186980;0;0;0;OVERLOCK BSQ MOD 3250;ELECTRODOMESTICOS
8206800;;M;62;CHILENO;;Boomers;COLBUN                        ;MAULE;244020;4;2;0;0;0;4;2;244020;Aspiradora TH1870 Arrastre 1800Watts Gris;ELECTRODOMESTICOS
25765088;;M;48;EXTRANJERO - NO INFORMA NACIONALIDAD;;Extranjero;CERRILLOS                     ;METROPOLITANA;99990;1;1;0;0;0;1;1;99990;FREIDORA DE AIRE THOMAS TH-AF60Mi;ELECTRODOMESTICOS
15800253;;F;37;CHILENO;;Millenial;RENCA                         ;METROPOLITANA;25980;2;2;0;0;0;2;2;25980;Exprimidor de Jugo CJ-2000 1Lts;ELECTRODOMESTICOS
16583363;Soltero;F;34;CHILENO;;Millenial;CAUQUENES                     ;MAULE;170440;4;2;0;0;0;4;2;170440;Horno Microondas Digital TH20DM 20Lts Espejado;ELECTRODOMESTICOS
17277171;;F;32;CHILENO;;Millenial;LA SERENA                     ;COQUIMBO;75980;2;1;2;1;75980;0;0;0;Freidora FDV Airflow;ELECTRODOMESTICOS
10083410;Casado;F;51;CHILENO;;X;SAN VICENTE                   ;L.G.B.OÂ´HIGGINS;24990;1;1;0;0;0;1;1;24990;HORNO 10 LITROS OSTER ROJO;ELECTRODOMESTICOS
7280660;;F;64;CHILENO;;Boomers;TALCA                         ;MAULE;49950;5;4;0;0;0;5;4;49950;Tostador de Pan TH-116 2 Rebanadas Negro;ELECTRODOMESTICOS
18770992;Soltero;F;28;CHILENO;;Millenial;PROVIDENCIA                   ;METROPOLITANA;34990;1;1;1;1;34990;0;0;0;HORNO ELECTRICO 16N01 16LTS NEGRO;ELECTRODOMESTICOS
5305349;;M;78;CHILENO;;Silencioso;QUILLOTA                      ;VALPARAISO;309980;4;2;0;0;0;4;2;309980;HORNO ELECTRICO HE-600IN INOX SINDELEN;ELECTRODOMESTICOS
26841380;;M;29;EXTRANJERO - NO INFORMA NACIONALIDAD;;Extranjero;N/D;N/D;351940;10;4;10;4;351940;0;0;0;FREIDORA DE AIRE HESSIA 2,0 LITROS;ELECTRODOMESTICOS
14317394;;M;45;CHILENO;;X;RENGO                         ;L.G.B.OÂ´HIGGINS;119990;4;2;0;0;0;4;2;119990;Aspiradora AP3400 Arrastre 2000Watts;ELECTRODOMESTICOS
13123677;;M;45;CHILENO;;X;COIHAIQUE                     ;AYSEN;189980;2;2;1;1;139990;1;1;49990;Aspiradora TH1415 Arrastre 1500Watts;ELECTRODOMESTICOS
7903785;;M;64;CHILENO;;Boomers;CALAMA                        ;ANTOFAGASTA;92481;2;2;0;0;0;2;2;92481;PROCESADOR THOMAS TH-9160;ELECTRODOMESTICOS
25389819;;M;36;VENEZOLANO;;Extranjero;N/D;N/D;201940;6;3;6;3;201940;0;0;0;SUPER FREIDORA DE AIRE OV3;ELECTRODOMESTICOS
14294882;;M;47;CHILENO;;X;CHILLAN                       ;BIO BIO;1090090;6;4;0;0;0;6;4;1090090;Freidora electrica Ut-KeramikAir;ELECTRODOMESTICOS
11779268;;F;51;CHILENO;;X;N/D;N/D;1121930;7;4;0;0;0;7;4;1121930;Batidora Vertical Multimixer TH-8720;ELECTRODOMESTICOS
13506533;;F;45;CHILENO;;X;CONCEPCION                    ;BIO BIO;433970;3;2;0;0;0;3;2;433970;FREIDORA DE AIRE THOMAS TH-AF60Mi;ELECTRODOMESTICOS
18263656;Soltero;F;29;CHILENO;TECNICO DE NIVEL SUPERIOR EN ENFERMERIA;Millenial;PROVIDENCIA                   ;METROPOLITANA;48980;2;1;2;1;48980;0;0;0;Freidora de Aire 18M Oster;ELECTRODOMESTICOS
8914222;;F;58;CHILENO;;Boomers;CARTAGENA                     ;VALPARAISO;121970;3;3;0;0;0;3;3;121970;Aspiradora UT-SILENT1804 Arrastre 1800Watts;ELECTRODOMESTICOS
19274614;;M;26;CHILENO;;Z;OVALLE                        ;COQUIMBO;66980;2;1;0;0;0;2;1;66980;Licuadora TH-401V Roja 1,75Lts Vaso Vidrio;ELECTRODOMESTICOS
6280002;Casado;M;68;CHILENO;;Silencioso;"";"";54990;1;1;0;0;0;1;1;54990;Horno Microondas Mecanico UT-SYDNEY18 18Lts;ELECTRODOMESTICOS
7630447;;F;68;CHILENO;;Boomers;QUILLOTA                      ;VALPARAISO;155970;4;3;0;0;0;4;3;155970;HERVIDOR HAMBURGO 2,0 LITROS;ELECTRODOMESTICOS
18319637;Soltero;F;29;CHILENO;;Millenial;"";"";32990;1;1;0;0;0;1;1;32990;Combo Licuadora + Batidora;ELECTRODOMESTICOS
18679623;;F;28;CHILENO;;Millenial;LOS ANDES                     ;VALPARAISO;29990;1;1;0;0;0;1;1;29990;Combo Licuadora + Batidora;ELECTRODOMESTICOS
10527960;;M;56;CHILENO;;Boomers;"";"";167330;4;1;0;0;0;4;1;167330;Horno Microondas Mecanico UT-SYDNEY18 18Lts;ELECTRODOMESTICOS
17506350;;M;32;CHILENO;;Millenial;"";"";34990;1;1;0;0;0;1;1;34990;Aspiradora Handy Clean Black 1400;ELECTRODOMESTICOS
16841605;;F;34;CHILENO;;Extranjero;"";"";109990;1;1;0;0;0;1;1;109990;Horno Electrico TH62I 60Lts;ELECTRODOMESTICOS
8447456;;M;55;CHILENO;;Boomers;PROVIDENCIA                   ;METROPOLITANA;74980;2;2;0;0;0;2;2;74980;Picadora TH-9020V Vaso Vidrio 2Lts;ELECTRODOMESTICOS
8739974;;F;61;CHILENO;;Boomers;COLINA                        ;METROPOLITANA;157970;3;2;0;0;0;3;2;157970;Horno Electrico TH62I 60Lts;ELECTRODOMESTICOS
11739435;;F;52;CHILENO;;X;RECOLETA                      ;METROPOLITANA;379950;5;3;0;0;0;5;3;379950;Aspiradora TH1870 Arrastre 1800Watts Gris;ELECTRODOMESTICOS
10255586;;F;68;CHILENO;;Boomers;MELIPILLA                     ;METROPOLITANA;14990;1;1;0;0;0;1;1;14990;Hervidor Inox One Midea;ELECTRODOMESTICOS
12612799;Casado;F;48;CHILENO;;X;RENCA                         ;METROPOLITANA;109990;1;1;1;1;109990;0;0;0;SUPER FREIDORA DE AIRE OV3;ELECTRODOMESTICOS
17628815;Soltero;M;32;CHILENO;;Millenial;ILLAPEL;COQUIMBO;26990;1;1;0;0;0;1;1;26990;Batidora Vertical Multimixer TH-8720;ELECTRODOMESTICOS
11725216;Soltero;F;50;CHILENO;;X;PROVIDENCIA                   ;METROPOLITANA;33980;2;1;0;0;0;2;1;33980;HERVIDOR BERLIN 1,7 LITROS;ELECTRODOMESTICOS
6729105;;F;73;CHILENO;;Silencioso;RENGO                         ;L.G.B.OÂ´HIGGINS;16000;2;1;0;0;0;2;1;16000;TOSTADOR OLDEMBURGO 2 REBANADAS;ELECTRODOMESTICOS
9687503;Casado;M;57;CHILENO;;Boomers;RENCA                         ;METROPOLITANA;139990;1;1;0;0;0;1;1;139990;SUPER FREIDORA DE AIRE OV3;ELECTRODOMESTICOS
17745926;;F;31;CHILENO;;Millenial;N/D;N/D;99970;3;1;3;1;99970;0;0;0;Licuadora Reversible Roja;ELECTRODOMESTICOS
16743530;;F;34;CHILENO;;Millenial;PROVIDENCIA                   ;METROPOLITANA;103980;2;1;2;1;103980;0;0;0;CAFETERA PRIMA LATTE 6603 ROJA;ELECTRODOMESTICOS
26664790;;F;37;NO INFORMA NACIONALIDAD;;Extranjero;PUDAHUEL                      ;METROPOLITANA;477290;8;4;0;0;0;8;4;477290;Licuadora L2000VNG 1,5Lts Vaso Vidrio;ELECTRODOMESTICOS
14018278;;F;41;CHILENO;;X;PROVIDENCIA                   ;METROPOLITANA;39990;1;1;0;0;0;1;1;39990;Licuadora Kaliman Negra con Teclas;ELECTRODOMESTICOS
7407574;;M;62;CHILENO;;Boomers;TOCOPILLA                     ;ANTOFAGASTA;646920;8;5;0;0;0;8;5;646920;Batidora Vertical Stick Mixer 2609;ELECTRODOMESTICOS
12342181;;M;50;CHILENO;;X;N/D;N/D;85440;3;2;0;0;0;3;2;85440;Horno Microondas Mecanico Easy Wave 20Lts;ELECTRODOMESTICOS
13002334;;F;46;CHILENO;;X;RENCA                         ;METROPOLITANA;50230;3;2;0;0;0;3;2;50230;Plancha TH-7052 2000Watts Base Inox;ELECTRODOMESTICOS
14343101;Soltero;M;45;CHILENO;;X;RENCA                         ;METROPOLITANA;52980;2;1;0;0;0;2;1;52980;Batidora Vertical Minipimer UT-KLOT400P;ELECTRODOMESTICOS
14454605;;F;47;CHILENO;;X;ANCUD                         ;LOS LAGOS;112980;2;1;0;0;0;2;1;112980;SUPER FREIDORA DE AIRE OV3;ELECTRODOMESTICOS
26103906;;M;34;EXTRANJERO - NO INFORMA NACIONALIDAD;;Extranjero;PUERTO MONTT                  ;LOS LAGOS;106960;4;4;0;0;0;4;4;106960;Combo Hervidor + Tostador + Sandwichera;ELECTRODOMESTICOS
8982343;;F;64;CHILENO;;Boomers;HIJUELAS                      ;VALPARAISO;50480;4;1;0;0;0;4;1;50480;Tostador de Pan TH-126 4 Rebanadas Negro;ELECTRODOMESTICOS
8490366;;M;56;CHILENO;;Boomers;VALDIVIA                      ;LOS RIOS;44990;1;1;0;0;0;1;1;44990;Horno Electrico TH-25N01 25Lts;ELECTRODOMESTICOS
8441440;;F;61;CHILENO;;Boomers;SAN FERNANDO                  ;L.G.B.OÂ´HIGGINS;321971;3;2;0;0;0;3;2;321971;Horno Microondas Mecanico TH-18B05 18Lts;ELECTRODOMESTICOS
8720159;;F;60;CHILENO;;Boomers;TALCA                         ;MAULE;283190;7;2;0;0;0;7;2;283190;PROCESADOR THOMAS TH-9160;ELECTRODOMESTICOS
16638302;;F;35;CHILENO;;Millenial;RECOLETA;METROPOLITANA;28980;2;1;0;0;0;2;1;28980;Hervidor Inox One Midea;ELECTRODOMESTICOS
9175870;;M;60;CHILENO;;Boomers;CURICO                        ;MAULE;196971;3;3;0;0;0;3;3;196971;HERVIDOR ELECTRICO UT-STARK18;ELECTRODOMESTICOS
7497272;;F;65;CHILENO;;Boomers;PUENTE ALTO                   ;METROPOLITANA;424900;10;5;0;0;0;10;5;424900;Aspiradora TH1870 Arrastre 1800Watts Gris;ELECTRODOMESTICOS
20088949;;M;23;CHILENO;;Silencioso;PROVIDENCIA                   ;METROPOLITANA;29990;1;1;1;1;29990;0;0;0;FREIDORA DE AIRE HESSIA 2,0 LITROS;ELECTRODOMESTICOS
6939354;;F;69;CHILENO;;Silencioso;VALLENAR;ATACAMA;68980;2;2;0;0;0;2;2;68980;Horno Microondas Mecanico Easy Wave 20Lts;ELECTRODOMESTICOS
8004469;;M;61;CHILENO;;Boomers;N/D;N/D;115980;2;1;0;0;0;2;1;115980;Horno Microondas Digital ME0113MB1/XZS 32Lts;ELECTRODOMESTICOS
20497692;;F;21;CHILENO;;Z;CONCHALI;METROPOLITANA;83980;2;1;2;1;83980;0;0;0;ASPIRADORA SAMSUNG VC18M3110VB/ZS;ELECTRODOMESTICOS
20398125;;M;22;CHILENO;;Z;EL MONTE                      ;METROPOLITANA;938220;8;5;2;1;379980;6;4;558240;Maquina de Coser VX1445 con 14 puntadas;ELECTRODOMESTICOS
4551008;;M;79;CHILENO;;Silencioso;MAIPU                         ;METROPOLITANA;51980;2;2;0;0;0;2;2;51980;HERVIDOR TH-4340;ELECTRODOMESTICOS
5229496;;M;78;CHILENO;;Silencioso;CONSTITUCION                  ;MAULE;658880;12;6;11;5;498890;1;1;159990;Licuadora Reversible Roja;ELECTRODOMESTICOS
11932646;;M;50;CHILENO;;X;ANTOFAGASTA                   ;ANTOFAGASTA;123840;6;1;0;0;0;6;1;123840;Horno Microondas Mecanico Fancy 20Lts;ELECTRODOMESTICOS
8508887;;F;64;CHILENO;;Boomers;MELIPILLA                     ;METROPOLITANA;742890;11;4;0;0;0;11;4;742890;Hervidor Electrico 3101 1,7Lts Negro;ELECTRODOMESTICOS
9092409;;F;61;CHILENO;;Boomers;LA PINTANA                    ;METROPOLITANA;46980;2;2;0;0;0;2;2;46980;Hervidor Electrico Tetera HA-4100 4Lts Iox;ELECTRODOMESTICOS
8881405;;M;60;CHILENO;;Boomers;RENCA                         ;METROPOLITANA;34990;1;1;0;0;0;1;1;34990;Batidora Vertical Minipimer UT-KLOT400P;ELECTRODOMESTICOS
16048584;;F;37;CHILENO;;Millenial;VICTORIA                      ;ARAUCANIA;295440;3;2;1;1;209990;2;1;85450;Aspiradora UT-SILENT1804 Arrastre 1800Watts;ELECTRODOMESTICOS
17334878;;F;33;CHILENO;;Millenial;"";"";357960;4;2;2;1;43980;2;1;313980;Horno Microondas Mecanico C1700N 17Lts Blanco;ELECTRODOMESTICOS
26030237;;F;34;VENEZOLANO;;Extranjero;PUERTO MONTT                  ;LOS LAGOS;441970;3;3;3;3;441970;0;0;0;Hervidor Inox One Midea;ELECTRODOMESTICOS
20425350;;F;21;CHILENO;;Z;ISLA DE MAIPO;METROPOLITANA;68950;4;2;3;1;61960;1;1;6990;PANINI/WAFLERA TH-965;ELECTRODOMESTICOS
18263930;Soltero;M;29;CHILENO;;Millenial;TOCOPILLA                     ;ANTOFAGASTA;71980;4;1;0;0;0;4;1;71980;Licuadora L2000VNG 1,5Lts Vaso Vidrio;ELECTRODOMESTICOS
6557680;;F;54;CHILENO;;X;PROVIDENCIA                   ;METROPOLITANA;12990;1;1;0;0;0;1;1;12990;HERVIDOR COLONIA 1,7 LITROS;ELECTRODOMESTICOS
13709552;;F;43;CHILENO;;X;EL BOSQUE;METROPOLITANA;36990;1;1;0;0;0;1;1;36990;Combo Hervidor + Tostador + Sandwichera;ELECTRODOMESTICOS
19129951;Soltero;F;27;CHILENO;;Z;PROVIDENCIA                   ;METROPOLITANA;109990;1;1;1;1;109990;0;0;0;SUPER FREIDORA DE AIRE OV3;ELECTRODOMESTICOS
12725792;;M;47;CHILENO;;X;PROVIDENCIA                   ;METROPOLITANA;74990;1;1;0;0;0;1;1;74990;Horno Electrico UT-LEIF36 36Lts;ELECTRODOMESTICOS
5791091;;F;69;CHILENO;;Silencioso;RENCA                         ;METROPOLITANA;47980;2;1;0;0;0;2;1;47980;Plancha THOMAS TH-7170 2200Watts Base Ceramica;ELECTRODOMESTICOS
8925132;;M;54;CHILENO;;Boomers;ANGOL                         ;ARAUCANIA;465970;3;3;0;0;0;3;3;465970;Plancha Paninis 2880;ELECTRODOMESTICOS
10074200;;F;61;CHILENO;;Boomers;RENCA                         ;METROPOLITANA;39990;1;1;0;0;0;1;1;39990;LICUADORA CROMADA CON TECLAS PLUS;ELECTRODOMESTICOS
16251821;;M;36;CHILENO;;Millenial;RANCAGUA                      ;L.G.B.OÂ´HIGGINS;145960;4;2;0;0;0;4;2;145960;Aspiradora Handy Clean Black 1400;ELECTRODOMESTICOS
11929820;;F;49;CHILENO;;X;PUNTA ARENAS                  ;MAGALLANES;1715860;14;9;0;0;0;14;9;1715860;Hervidor Inox One Midea;ELECTRODOMESTICOS
12924595;;F;46;CHILENO;;X;PROVIDENCIA                   ;METROPOLITANA;21140;2;2;0;0;0;2;2;21140;Hervidor Electrico TH-4515N 2Lts Negro;ELECTRODOMESTICOS
12473045;;M;49;CHILENO;;X;LO BARNECHEA;METROPOLITANA;44990;1;1;0;0;0;1;1;44990;Horno Electrico TH-25N01 25Lts;ELECTRODOMESTICOS
10986731;Soltero;F;50;CHILENO;CONTADOR GENERAL;X;RENCA                         ;METROPOLITANA;68980;2;1;2;1;68980;0;0;0;Horno electrico Black Oven 42lts;ELECTRODOMESTICOS
14312786;;M;45;CHILENO;;X;MELIPILLA                     ;METROPOLITANA;27990;1;1;0;0;0;1;1;27990;Plancha THOMAS TH-7170 2200Watts Base Ceramica;ELECTRODOMESTICOS
4641725;;F;81;CHILENO;;Silencioso;COPIAPO                       ;ATACAMA;54970;3;2;0;0;0;3;2;54970;Batidora Vertical Stick Mixer 2609;ELECTRODOMESTICOS
19930653;;F;24;CHILENO;;Z;PROVIDENCIA                   ;METROPOLITANA;180980;2;2;0;0;0;2;2;180980;MULTIMIXER THOMAS TH- 8706;ELECTRODOMESTICOS
7729501;;M;67;CHILENO;;Boomers;MELIPILLA                     ;METROPOLITANA;34990;1;1;0;0;0;1;1;34990;Licuadora TH-501V 1,5Lts Vaso Vidrio;ELECTRODOMESTICOS
13508410;;M;44;CHILENO;;Extranjero;"";"";21990;1;1;1;1;21990;0;0;0;Licuadora L-1630V Negra 1,5Lts Vaso Vidrio;ELECTRODOMESTICOS
15586613;;F;39;CHILENO;;Millenial;TALCA                         ;MAULE;27990;1;1;0;0;0;1;1;27990;Picadora UT-PETRUS320 1Lts Vaso Vidrio;ELECTRODOMESTICOS
8889835;;F;61;CHILENO;;Boomers;PROVIDENCIA                   ;METROPOLITANA;99970;3;2;0;0;0;3;2;99970;Batidora Vertical Minipimer UT-KLOT400P;ELECTRODOMESTICOS
15207865;;F;39;CHILENO;;X;LOS ANGELES                   ;BIO BIO;160970;3;3;0;0;0;3;3;160970;Aspiradora Tambor APA1000 1000Watts;ELECTRODOMESTICOS
16240311;;F;36;CHILENO;;Millenial;PERALILLO                     ;L.G.B.OÂ´HIGGINS;139990;1;1;0;0;0;1;1;139990;Horno Electrico TH-80i 80Lts;ELECTRODOMESTICOS
13511984;;F;44;CHILENO;;X;CORONEL                       ;BIO BIO;302640;8;4;4;2;111680;4;2;190960;Licuadora TH-320 Roja/Negro 1,5 Lts Vaso Vidrio;ELECTRODOMESTICOS
18342383;;M;29;CHILENO;;Millenial;N/D;N/D;123390;2;1;0;0;0;2;1;123390;Maquina de coser Singer 1605;ELECTRODOMESTICOS
9825578;;F;57;CHILENO;;Boomers;TOLTEN                        ;ARAUCANIA;24990;1;1;0;0;0;1;1;24990;Batidora Vertical Multimixer TH-8720;ELECTRODOMESTICOS
6454557;;F;70;CHILENO;;Silencioso;RENCA                         ;METROPOLITANA;145600;2;1;0;0;0;2;1;145600;Maquina de coser Singer 1605;ELECTRODOMESTICOS
13791597;;F;42;CHILENO;;X;PELLUHUE                      ;MAULE;54990;1;1;0;0;0;1;1;54990;Horno Electrico TH-25N01 25Lts;ELECTRODOMESTICOS
18123848;Soltero;F;29;CHILENO;NUTRICIONISTA;Millenial;PROVIDENCIA                   ;METROPOLITANA;19990;1;1;0;0;0;1;1;19990;Hervidor Electrico UT-DUNKEL17P 2Lts Negro;ELECTRODOMESTICOS
17400451;;F;32;CHILENO;;Millenial;PICHILEMU                     ;L.G.B.OÂ´HIGGINS;72980;2;1;0;0;0;2;1;72980;Freidora de Aire 18M Oster;ELECTRODOMESTICOS
11916153;;M;49;CHILENO;;X;TALCAHUANO                    ;BIO BIO;512190;7;3;0;0;0;7;3;512190;Batidora Vertical Minipimer UT-KLOT400P;ELECTRODOMESTICOS
16287580;;M;36;CHILENO;;Millenial;PROVIDENCIA                   ;METROPOLITANA;229990;1;1;0;0;0;1;1;229990;Maquina de Coser ST-371HD Heavy Duty;ELECTRODOMESTICOS
15200340;Soltero;M;39;CHILENO;;X;PROVIDENCIA                   ;METROPOLITANA;74990;1;1;0;0;0;1;1;74990;Horno Microondas Digital TH-20S01 20Lts;ELECTRODOMESTICOS
10947179;Soltero;F;52;CHILENO;CONTADOR PUBLICO;X;PROVIDENCIA                   ;METROPOLITANA;102520;2;1;0;0;0;2;1;102520;Batidora Pedestal UT-KLEIN700;ELECTRODOMESTICOS
16570423;;F;35;CHILENO;;Millenial;N/D;N/D;104980;2;2;1;1;39990;1;1;64990;HERVIDOR TETERA RELOJ 900R 2,5L ROJO;ELECTRODOMESTICOS
4935407;;F;77;CHILENO;;Silencioso;LA SERENA                     ;COQUIMBO;99990;1;1;0;0;0;1;1;99990;Horno Electrico TH62I 60Lts;ELECTRODOMESTICOS
8826077;;M;62;CHILENO;;Boomers;MAIPU                         ;METROPOLITANA;49990;1;1;0;0;0;1;1;49990;Horno Microondas Mecanico Easy Wave 20Lts;ELECTRODOMESTICOS
14048727;;M;41;CHILENO;;X;PROVIDENCIA                   ;METROPOLITANA;138970;3;1;3;1;138970;0;0;0;Arrocera Oster 10 en 1 con freidora de aire CKST;ELECTRODOMESTICOS
16028338;;F;38;CHILENO;;Millenial;"";"";49990;1;1;0;0;0;1;1;49990;Horno Microondas Mecanico Easy Wave 20Lts;ELECTRODOMESTICOS
10213480;;F;59;CHILENO;;Boomers;PENALOLEN                     ;METROPOLITANA;412150;10;6;6;4;170800;4;2;241350;Aspiradora Trapeadora Robot Ut-Excellenza (B);ELECTRODOMESTICOS
9006416;Casado;M;60;CHILENO;;Boomers;LOS VILOS                     ;COQUIMBO;15000;2;1;0;0;0;2;1;15000;Batidora Vertical Stick Mixer 2609;ELECTRODOMESTICOS
9051653;;F;57;CHILENO;;Boomers;CHILLAN                       ;BIO BIO;801450;5;3;0;0;0;5;3;801450;FREIDORA DE AIRE THOMAS TH-AF60Mi;ELECTRODOMESTICOS
4314417;;M;83;CHILENO;;Silencioso;VALLENAR;ATACAMA;12741;1;1;0;0;0;1;1;12741;Hervidor Inox One Midea;ELECTRODOMESTICOS
18071014;;F;34;CHILENO;;Millenial;NUEVA IMPERIAL                ;ARAUCANIA;229970;3;2;0;0;0;3;2;229970;Aspiradora Tambor APA1000 1000Watts;ELECTRODOMESTICOS
21828680;;F;31;PERUANO;;Extranjero;PAINE;METROPOLITANA;26990;1;1;0;0;0;1;1;26990;Cafetera TH-138i;ELECTRODOMESTICOS
10607844;;F;43;CHILENO;;X;QUILPUE                       ;VALPARAISO;80980;2;1;2;1;80980;0;0;0;Freidora de Aire Oster 40M;ELECTRODOMESTICOS
6641751;;M;68;CHILENO;;Boomers;ARICA                         ;ARICA Y PARINACOTA;29990;1;1;0;0;0;1;1;29990;PLANCHA A VAPOR 6953 BASE AEROCERAMICA AUTAPA.22;ELECTRODOMESTICOS
11878250;;F;50;CHILENO;;X;VINA DEL MAR                  ;VALPARAISO;99990;1;1;0;0;0;1;1;99990;Maquina de coser Singer 1605;ELECTRODOMESTICOS
8901902;Casado;F;61;CHILENO;;Boomers;RENCA                         ;METROPOLITANA;29990;1;1;0;0;0;1;1;29990;Licuadora L2000VNG 1,5Lts Vaso Vidrio;ELECTRODOMESTICOS
5800713;Viudo;F;70;CHILENO;TECNICO DE NIVEL SUPERIOR EN ENFERMERIA;Silencioso;PUENTE ALTO                   ;METROPOLITANA;133980;2;1;2;1;133980;0;0;0;FREIDORA DE AIRE Y HORNO ELECTRICO MAF1;ELECTRODOMESTICOS
18992837;Soltero;F;27;CHILENO;;Z;LA REINA;METROPOLITANA;38980;2;1;2;1;38980;0;0;0;Combo Hervidor + Tostador + Sandwichera;ELECTRODOMESTICOS
11110252;;F;54;CHILENO;;Boomers;NANCAGUA                      ;L.G.B.OÂ´HIGGINS;159940;6;4;0;0;0;6;4;159940;Batidora Pedestal Bowl 300 Inox;ELECTRODOMESTICOS
12438253;;F;49;CHILENO;;X;IQUIQUE                       ;TARAPACA;53532;2;1;0;0;0;2;1;53532;Licuadora Personal TH-300PB;ELECTRODOMESTICOS
15092625;Soltero;F;39;CHILENO;;X;PROVIDENCIA                   ;METROPOLITANA;19990;1;1;0;0;0;1;1;19990;Combo Hervidor + Batidora;ELECTRODOMESTICOS
9377133;;F;59;CHILENO;;Boomers;HUALANE                       ;MAULE;181470;3;2;0;0;0;3;2;181470;FREIDORA DE AIRE THOMAS TH-AF60Mi;ELECTRODOMESTICOS
17694787;;F;32;CHILENO;;Millenial;PANGUIPULLI                   ;LOS LAGOS;54990;1;1;0;0;0;1;1;54990;Aspiradora AP3400 Arrastre 2000Watts;ELECTRODOMESTICOS
14330314;Casado;F;44;CHILENO;SECRETARIA;X;LINARES                       ;MAULE;59990;1;2;0;0;0;1;2;59990;Horno Electrico TH-38N 38Lts;ELECTRODOMESTICOS
7549929;;F;66;CHILENO;;Boomers;RENCA                         ;METROPOLITANA;24990;1;1;0;0;0;1;1;24990;Batidora Vertical Multimixer TH-8720;ELECTRODOMESTICOS
10841296;;F;59;CHILENO;;Boomers;LA LIGUA                      ;VALPARAISO;89980;2;1;0;0;0;2;1;89980;Horno Microondas Digital TH-20S01 20Lts;ELECTRODOMESTICOS
14533927;;M;45;CHILENO;;X;RANCAGUA                      ;L.G.B.OÂ´HIGGINS;29990;1;1;0;0;0;1;1;29990;Tostador de Pan TH-126 4 Rebanadas Negro;ELECTRODOMESTICOS
12603026;;F;48;CHILENO;;X;QUILPUE                       ;VALPARAISO;29990;1;1;0;0;0;1;1;29990;Licuadora Roja 550W 1,5Lts Vaso Vidrio;ELECTRODOMESTICOS
16768399;;F;34;CHILENO;;Millenial;CONCEPCION                    ;BIO BIO;109990;1;1;0;0;0;1;1;109990;Horno Microondas Digital L UT-25KROMM 25Lts;ELECTRODOMESTICOS
20125508;;M;23;CHILENO;;Z;PROVIDENCIA                   ;METROPOLITANA;69990;1;1;1;1;69990;0;0;0;Batidora Pedestal UT-KLEIN700;ELECTRODOMESTICOS
19987428;;M;23;CHILENO;;Silencioso;PROVIDENCIA                   ;METROPOLITANA;51970;3;4;0;0;0;3;4;51970;Horno Electrico UT-BACKOFEN60 60Lts;ELECTRODOMESTICOS
11414886;;F;53;CHILENO;;X;AISEN                         ;AYSEN;126980;2;2;0;0;0;2;2;126980;Tostador de Pan TH-126 4 Rebanadas Negro;ELECTRODOMESTICOS
6678720;;F;71;CHILENO;;Silencioso;CHILLAN                       ;BIO BIO;75250;2;1;0;0;0;2;1;75250;Aspiradora UT-SILENT1804 Arrastre 1800Watts;ELECTRODOMESTICOS
14003238;Casado;F;41;CHILENO;PROFESOR;X;RENCA                         ;METROPOLITANA;35240;2;1;0;0;0;2;1;35240;Licuadora Roja 550W 1,5Lts Vaso Vidrio;ELECTRODOMESTICOS
18007584;;F;29;CHILENO;;Millenial;PROVIDENCIA                   ;METROPOLITANA;44970;3;1;3;1;44970;0;0;0;Licuadora L-1630V Negra 1,5Lts Vaso Vidrio;ELECTRODOMESTICOS
19372431;;F;25;CHILENO;;Z;N/D;N/D;506660;6;4;4;2;321680;2;2;184980;CAFETERA PRIMA LATTE 6603 ROJA;ELECTRODOMESTICOS
13573354;;M;46;CHILENO;;X;ROMERAL                       ;MAULE;31493;1;1;0;0;0;1;1;31493;HERVIDOR TETERA RELOJ 900R 2,5L ROJO;ELECTRODOMESTICOS
9033115;Casado;F;60;CHILENO;;Boomers;RENCA                         ;METROPOLITANA;29990;1;1;0;0;0;1;1;29990;Plancha THOMAS TH-7170 2200Watts Base Ceramica;ELECTRODOMESTICOS
17822040;Soltero;F;31;CHILENO;INGENIERO EN ADMINISTRACION DE EMPRESAS;Millenial;PROVIDENCIA                   ;METROPOLITANA;27990;1;1;0;0;0;1;1;27990;Plancha THOMAS TH-7170 2200Watts Base Ceramica;ELECTRODOMESTICOS
3971999;;F;75;CHILENO;;Silencioso;RENCA                         ;METROPOLITANA;19990;1;1;0;0;0;1;1;19990;Licuadora Berry Blender Roja 1400 Vaso Vidrio;ELECTRODOMESTICOS
8762670;;F;65;CHILENO;;Boomers;COLTAUCO                      ;L.G.B.OÂ´HIGGINS;368960;4;3;0;0;0;4;3;368960;Horno Electrico TH62I 60Lts;ELECTRODOMESTICOS
11900896;;F;51;CHILENO;;X;CONCEPCION                    ;BIO BIO;340960;4;3;2;1;293980;2;2;46980;Licuadora L-1630V Negra 1,5Lts Vaso Vidrio;ELECTRODOMESTICOS
18017022;;M;30;CHILENO;;Millenial;FRUTILLAR;LOS LAGOS;215970;3;2;1;1;34990;2;1;180980;Aspiradora AP1700 Arrastre 1700Watts;ELECTRODOMESTICOS
15735465;;F;38;CHILENO;;X;COIHUECO                      ;BIO BIO;124980;2;2;0;0;0;2;2;124980;Aspiradora TH1870 Arrastre 1800Watts Gris;ELECTRODOMESTICOS
8191511;Casado;F;64;CHILENO;PROFESOR;Boomers;RENCA                         ;METROPOLITANA;12990;1;1;0;0;0;1;1;12990;HERVIDOR COLONIA 1,7 LITROS;ELECTRODOMESTICOS
7522322;Casado;M;64;CHILENO;;Boomers;CALAMA                        ;ANTOFAGASTA;872890;10;2;0;0;0;10;2;872890;Horno Microondas Mecanico TH-18B05 18Lts;ELECTRODOMESTICOS
10309178;;F;57;CHILENO;;Boomers;CAUQUENES                     ;MAULE;113980;2;2;0;0;0;2;2;113980;PLANCHA A VAPOR 4070 SUELA CERAMICA 2500W;ELECTRODOMESTICOS
18752216;;F;27;CHILENO;;Millenial;CALAMA                        ;ANTOFAGASTA;202980;2;2;0;0;0;2;2;202980;HERVIDOR COLONIA 1,7 LITROS;ELECTRODOMESTICOS
11492389;;F;53;CHILENO;;X;PICHIDEGUA                    ;L.G.B.OÂ´HIGGINS;79990;1;1;0;0;0;1;1;79990;Horno Electrico TH-48N 48Lts;ELECTRODOMESTICOS
13049661;;M;46;CHILENO;;X;ESTACION CENTRAL              ;METROPOLITANA;53980;2;1;2;1;53980;0;0;0;Horno Microondas Digital MMP-20GC3D 20Lts;ELECTRODOMESTICOS
27064310;;M;34;EXTRANJERO - NO INFORMA NACIONALIDAD;;Extranjero;N/D;N/D;510570;9;2;0;0;0;9;2;510570;Horno Microondas Digital TH-20S01 20Lts;ELECTRODOMESTICOS
12947423;;M;46;CHILENO;;X;LA LIGUA                      ;VALPARAISO;54990;1;1;0;0;0;1;1;54990;Aspiradora TH1415 Arrastre 1500Watts;ELECTRODOMESTICOS
18009639;;M;30;CHILENO;;Extranjero;ANGOL                         ;ARAUCANIA;15990;1;1;0;0;0;1;1;15990;Hervidor Electrico 3101 1,7Lts Negro;ELECTRODOMESTICOS
16746610;;M;34;CHILENO;;Millenial;SAN BERNARDO                  ;METROPOLITANA;30240;2;1;0;0;0;2;1;30240;Procesador TH-9010 Multimixer 1,5Lts Vaso Vidrio;ELECTRODOMESTICOS
26385013;;F;33;COLOMBIANO;;Extranjero;PROVIDENCIA                   ;METROPOLITANA;153980;2;1;2;1;153980;0;0;0;SUPER FREIDORA DE AIRE OV3;ELECTRODOMESTICOS
10751911;;M;53;CHILENO;;X;LOTA                          ;BIO BIO;242810;4;3;0;0;0;4;3;242810;Licuadora L-1630V Negra 1,5Lts Vaso Vidrio;ELECTRODOMESTICOS
18471709;;F;29;CHILENO;;Millenial;PUERTO MONTT                  ;LOS LAGOS;44990;1;1;0;0;0;1;1;44990;Aspiradora AP1700 Arrastre 1700Watts;ELECTRODOMESTICOS
7328101;Viudo;F;72;CHILENO;;Silencioso;SAN CARLOS                    ;BIO BIO;15990;1;1;0;0;0;1;1;15990;Hervidor Electrico TH-4212N 1,7Lts Negro;ELECTRODOMESTICOS
11597010;;M;52;CHILENO;;X;PURRANQUE                     ;LOS LAGOS;50991;1;1;0;0;0;1;1;50991;ASPIRADORA THOMAS TH-1640;ELECTRODOMESTICOS
10568310;;M;57;CHILENO;;Boomers;SANTA CRUZ                    ;L.G.B.OÂ´HIGGINS;112980;2;1;0;0;0;2;1;112980;Horno Microondas Digital TH-25DM 25Lts;ELECTRODOMESTICOS
13867960;Soltero;F;44;CHILENO;;X;RENCA                         ;METROPOLITANA;24980;2;2;0;0;0;2;2;24980;Hervidor Electrico UT-DUNKEL17P 2Lts Negro;ELECTRODOMESTICOS
8488630;;M;63;CHILENO;;Boomers;EL BOSQUE                     ;METROPOLITANA;61970;3;2;2;1;43980;1;1;17990;Hervidor Electrico UT-KLAR20PW 2Lts Blanco;ELECTRODOMESTICOS
16994801;;M;34;CHILENO;;Millenial;PROVIDENCIA                   ;METROPOLITANA;54990;1;1;0;0;0;1;1;54990;Horno Microondas Mecanico Fancy 20Lts;ELECTRODOMESTICOS
12355607;;M;49;CHILENO;;X;SAN JOAQUIN                   ;METROPOLITANA;69990;1;1;0;0;0;1;1;69990;HORNO ELECTRICO DORTMUND 45 LITROS;ELECTRODOMESTICOS
7479322;;F;62;CHILENO;;Boomers;BUIN                          ;METROPOLITANA;59970;3;2;0;0;0;3;2;59970;Licuadora BL1500 Silver 1,75Lts Vaso Vidrio;ELECTRODOMESTICOS
25903445;;M;39;HAITIANO;;Extranjero;TALCA                         ;MAULE;39990;1;1;0;0;0;1;1;39990;Licuadora TH-501V 1,5Lts Vaso Vidrio;ELECTRODOMESTICOS
13878388;;F;42;CHILENO;;Millenial;VINA DEL MAR                  ;VALPARAISO;21990;1;1;0;0;0;1;1;21990;Licuadora Berry Blender Roja 1400 Vaso Vidrio;ELECTRODOMESTICOS
4595237;;M;82;CHILENO;;Silencioso;CHIGUAYANTE                   ;BIO BIO;275353;4;3;0;0;0;4;3;275353;Hervidor Electrico TH-4515N 2Lts Negro;ELECTRODOMESTICOS
6164424;Divorciado;M;73;CHILENO;;Silencioso;RENCA                         ;METROPOLITANA;163390;2;1;0;0;0;2;1;163390;MAQUINA COSER 2250;ELECTRODOMESTICOS
17163581;;F;32;CHILENO;;Millenial;SAN ESTEBAN                   ;VALPARAISO;347960;4;2;4;2;347960;0;0;0;FREIDORA DE AIRE BAVIERA 3,8 LITROS;ELECTRODOMESTICOS
13903866;;M;42;CHILENO;;X;SAN JOAQUIN;METROPOLITANA;125930;6;2;4;1;85950;2;1;39980;Parrilla Electrica TH-224;ELECTRODOMESTICOS
14055697;;F;43;CHILENO;;X;PROVIDENCIA                   ;METROPOLITANA;71990;1;1;0;0;0;1;1;71990;Batidora Pedestal UT-KLEIN700;ELECTRODOMESTICOS
15023864;;F;41;CHILENO;;X;"";"";59980;2;1;2;1;59980;0;0;0;FREIDORA DE AIRE BAVIERA 3,8 LITROS;ELECTRODOMESTICOS
14330707;;F;44;CHILENO;;X;LINARES                       ;MAULE;99990;1;1;0;0;0;1;1;99990;FREIDORA DE AIRE THOMAS TH-AF60Mi;ELECTRODOMESTICOS
14214731;;F;41;CHILENO;;X;CORONEL                       ;BIO BIO;27970;3;2;0;0;0;3;2;27970;TOSTADOR OLDEMBURGO 2 REBANADAS;ELECTRODOMESTICOS
14464590;;F;50;CHILENO;;X;SAN BERNARDO                  ;METROPOLITANA;64980;2;2;0;0;0;2;2;64980;Aspiradora TH1407 Arrastre 1400Watts;ELECTRODOMESTICOS
17828221;;F;31;CHILENO;;Millenial;LA SERENA                     ;COQUIMBO;119990;1;1;0;0;0;1;1;119990;Horno Microondas Digital ME0113MB1/XZS 32Lts;ELECTRODOMESTICOS
17783516;;F;31;CHILENO;;Millenial;PENALOLEN;METROPOLITANA;16990;1;1;0;0;0;1;1;16990;Hervidor Electrico HA-3300 2,5Lts Blanco;ELECTRODOMESTICOS
16804828;;M;34;CHILENO;;Millenial;PUENTE ALTO                   ;METROPOLITANA;16990;1;1;0;0;0;1;1;16990;Hervidor Electrico HA-3300 2,5Lts Blanco;ELECTRODOMESTICOS
17276619;;M;33;CHILENO;;Millenial;SAN CARLOS                    ;BIO BIO;20990;1;1;0;0;0;1;1;20990;Hervidor Electrico TH-4515N 2Lts Negro;ELECTRODOMESTICOS
18876629;Soltero;F;27;CHILENO;;Z;PROVIDENCIA                   ;METROPOLITANA;196970;3;2;2;1;146980;1;1;49990;Horno Electrico TH-25N01 25Lts;ELECTRODOMESTICOS
4828631;;M;76;CHILENO;;Silencioso;PENALOLEN                     ;METROPOLITANA;83980;2;1;0;0;0;2;1;83980;Horno Microondas Digital TH-20S01 20Lts;ELECTRODOMESTICOS
7057270;Casado;M;67;CHILENO;;Boomers;PROVIDENCIA                   ;METROPOLITANA;44990;1;1;0;0;0;1;1;44990;Horno Electrico TH-25N01 25Lts;ELECTRODOMESTICOS
19009811;;F;27;CHILENO;;Z;N/D;N/D;613910;9;3;0;0;0;9;3;613910;Aspiradora Trapeadora Robot Ut-Excellenza (B);ELECTRODOMESTICOS
6097094;;F;71;CHILENO;;Silencioso;ANGOL                         ;ARAUCANIA;89990;1;1;0;0;0;1;1;89990;Enceradora EA-5000;ELECTRODOMESTICOS
6119398;;M;73;CHILENO;;Silencioso;TALCA                         ;MAULE;16990;1;1;0;0;0;1;1;16990;Plancha Easy Steam (PV4500);ELECTRODOMESTICOS
11583127;;F;51;CHILENO;;X;LAUTARO                       ;ARAUCANIA;530040;5;4;0;0;0;5;4;530040;Hervidor Electrico Tetera TH-6505RT 1,7Lts Rojo;ELECTRODOMESTICOS
16353172;;M;35;CHILENO;;Millenial;RENCA                         ;METROPOLITANA;74990;1;1;0;0;0;1;1;74990;Horno Microondas Mecanico UT-SYDNEY18 18Lts;ELECTRODOMESTICOS
10018638;;F;56;CHILENO;;Boomers;CASTRO                        ;LOS LAGOS;89980;2;1;0;0;0;2;1;89980;Freidora de Aire 18M Oster;ELECTRODOMESTICOS
13814913;;F;41;CHILENO;;X;VILLARICA                     ;ARAUCANIA;17990;1;1;0;0;0;1;1;17990;Hervidor Electrico UT-MANLY17 1,7Lts Negro;ELECTRODOMESTICOS
11872323;;M;51;CHILENO;;X;PROVIDENCIA                   ;METROPOLITANA;46980;2;1;0;0;0;2;1;46980;Licuadora Berry Blender Roja 1400 Vaso Vidrio;ELECTRODOMESTICOS
14603301;;F;42;CHILENO;;X;TALCAHUANO                    ;BIO BIO;17990;1;1;0;0;0;1;1;17990;Plancha Easy Steam (PV4500);ELECTRODOMESTICOS
8708518;;F;63;CHILENO;;Boomers;LOS LAGOS                     ;LOS LAGOS;139990;1;1;0;0;0;1;1;139990;Horno Electrico TH-80i 80Lts;ELECTRODOMESTICOS
16062096;Soltero;F;37;CHILENO;;Millenial;RENCA                         ;METROPOLITANA;362960;4;2;2;1;253980;2;1;108980;Batidora Pedestal TH910PN 4,6Lts 1300Watts;ELECTRODOMESTICOS
7015522;;F;55;CHILENO;;Boomers;LA LIGUA                      ;VALPARAISO;13990;1;1;0;0;0;1;1;13990;Hervidor Inox One Midea;ELECTRODOMESTICOS
6533491;;M;71;CHILENO;;Silencioso;RENCA                         ;METROPOLITANA;14990;1;1;0;0;0;1;1;14990;HERVIDOR HAMBURGO 2,0 LITROS;ELECTRODOMESTICOS
9204317;Casado;F;56;CHILENO;;Boomers;RENCA                         ;METROPOLITANA;19990;1;1;0;0;0;1;1;19990;Licuadora Berry Blender Roja 1400 Vaso Vidrio;ELECTRODOMESTICOS
8900351;;M;48;CHILENO;;X;"";"";30990;1;1;0;0;0;1;1;30990;Plancha THOMAS TH-7170 2200Watts Base Ceramica;ELECTRODOMESTICOS
6872590;;M;65;CHILENO;;Boomers;"";"";27990;1;1;0;0;0;1;1;27990;Plancha THOMAS TH-7170 2200Watts Base Ceramica;ELECTRODOMESTICOS
17963715;;F;30;CHILENO;;Millenial;PROVIDENCIA                   ;METROPOLITANA;94980;2;1;0;0;0;2;1;94980;Aspiradora UT-SILENT1603 Arrastre 1600Watts;ELECTRODOMESTICOS
19141168;;F;26;CHILENO;;Z;N/D;N/D;55970;5;3;1;1;24990;4;2;30980;Licuadora TH-320 Roja/Negro 1,5 Lts Vaso Vidrio;ELECTRODOMESTICOS
13750957;;F;41;CHILENO;;X;N/D;N/D;73980;2;2;0;0;0;2;2;73980;Hervidor Electrico TH-4515N 2Lts Negro;ELECTRODOMESTICOS
8330772;;M;52;CHILENO;;X;"";"";16992;1;2;0;0;0;1;2;16992;Hervidor Electrico HA-3300 2,5Lts Blanco;ELECTRODOMESTICOS
14595837;;M;43;CHILENO;;X;PROVIDENCIA                   ;METROPOLITANA;10990;1;1;0;0;0;1;1;10990;Plancha a Vapor Oster 3803;ELECTRODOMESTICOS
13802099;;M;48;CHILENO;;X;TEMUCO                        ;ARAUCANIA;169970;3;1;0;0;0;3;1;169970;Horno Electrico TH-80i 80Lts;ELECTRODOMESTICOS
12469370;;M;48;CHILENO;;X;PROVIDENCIA                   ;METROPOLITANA;24990;1;1;0;0;0;1;1;24990;Hervidor Electrico TH-5407i 2Lts;ELECTRODOMESTICOS
7725053;Casado;M;65;CHILENO;CONTADOR GENERAL;Boomers;PROVIDENCIA                   ;METROPOLITANA;38990;1;1;0;0;0;1;1;38990;Licuadora Roja 550W 1,5Lts Vaso Vidrio;ELECTRODOMESTICOS
11419121;;F;53;CHILENO;;X;CANETE                        ;BIO BIO;314960;4;3;0;0;0;4;3;314960;Plancha THOMAS TH-7170 2200Watts Base Ceramica;ELECTRODOMESTICOS
18958708;;M;27;CHILENO;;Millenial;ALTO BIO BIO;BIO BIO;29990;1;1;0;0;0;1;1;29990;Licuadora L-5500IN 1,5Lts;ELECTRODOMESTICOS
8917491;;F;61;CHILENO;;Boomers;RANCAGUA                      ;L.G.B.OÂ´HIGGINS;53980;2;1;0;0;0;2;1;53980;LICUADORA CROMADA CON TECLAS PLUS;ELECTRODOMESTICOS
6237976;;F;76;CHILENO;;Silencioso;RENCA                         ;METROPOLITANA;47990;1;1;0;0;0;1;1;47990;HERVIDOR TETERA RELOJ 900R 2,5L ROJO;ELECTRODOMESTICOS
18532755;;F;28;CHILENO;;Millenial;N/D;N/D;123950;5;2;5;2;123950;0;0;0;Batidora Vertical Multimixer TH-8720;ELECTRODOMESTICOS
21694268;;M;46;PERUANO;;Extranjero;SAN JOAQUIN                   ;METROPOLITANA;51980;2;2;0;0;0;2;2;51980;LICUADORA CROMADA CON TECLAS PLUS;ELECTRODOMESTICOS
5548245;;F;69;CHILENO;;Silencioso;CAUQUENES                     ;MAULE;49990;1;1;0;0;0;1;1;49990;Horno Microondas Mecanico Easy Wave 20Lts;ELECTRODOMESTICOS
12368830;;M;48;CHILENO;;X;PAINE                         ;METROPOLITANA;49990;1;1;0;0;0;1;1;49990;Horno Microondas Mecanico Easy Wave 20Lts;ELECTRODOMESTICOS
4534629;;F;84;CHILENO;;Silencioso;VALLENAR;ATACAMA;149980;2;2;0;0;0;2;2;149980;FREIDORA DE AIRE THOMAS TH-AF60Mi;ELECTRODOMESTICOS
11965145;;F;49;CHILENO;;X;PROVIDENCIA                   ;METROPOLITANA;219170;9;5;0;0;0;9;5;219170;Plancha UT-PLATTEISEN 2000Watts Base Ceramica;ELECTRODOMESTICOS
7288828;;F;70;CHILENO;;Silencioso;CAUQUENES                     ;MAULE;49990;1;1;0;0;0;1;1;49990;Horno Microondas Mecanico Easy Wave 20Lts;ELECTRODOMESTICOS
6527740;;M;70;CHILENO;;Silencioso;ANCUD                         ;LOS LAGOS;129990;1;1;0;0;0;1;1;129990;MAQUINA COSER 2250;ELECTRODOMESTICOS
20234080;;F;22;CHILENO;;Z;N/D;N/D;29990;1;1;0;0;0;1;1;29990;Combo Licuadora + Batidora;ELECTRODOMESTICOS
6344817;;F;66;CHILENO;;Boomers;PROVIDENCIA                   ;METROPOLITANA;242970;3;2;0;0;0;3;2;242970;Horno Microondas Digital UT-CLASSY720 20Lts;ELECTRODOMESTICOS
12827198;;M;47;CHILENO;;X;PROVIDENCIA                   ;METROPOLITANA;24990;1;1;0;0;0;1;1;24990;Licuadora L2000VNG 1,5Lts Vaso Vidrio;ELECTRODOMESTICOS
18825787;;F;28;CHILENO;;Millenial;"";"";72980;2;1;2;1;72980;0;0;0;Extractor de Jugo TH-2660i 2Lts;ELECTRODOMESTICOS
15605147;;M;38;CHILENO;;X;SAN JOAQUIN                   ;METROPOLITANA;132980;2;1;0;0;0;2;1;132980;Horno Microondas Digital L UT-25KROMM 25Lts;ELECTRODOMESTICOS
6122045;;F;72;CHILENO;;Silencioso;VALPARAISO                    ;VALPARAISO;21990;1;1;0;0;0;1;1;21990;Licuadora L-1630V Negra 1,5Lts Vaso Vidrio;ELECTRODOMESTICOS
7004789;Casado;M;66;CHILENO;;Boomers;RENCA                         ;METROPOLITANA;23990;1;1;0;0;0;1;1;23990;Hervidor Family Kettle HE500;ELECTRODOMESTICOS
11275361;;F;53;CHILENO;;X;RANCAGUA                      ;L.G.B.OÂ´HIGGINS;34990;1;1;0;0;0;1;1;34990;Plancha UT-SHANGRILA Inalambrica 2200Watss;ELECTRODOMESTICOS
13997736;;F;41;CHILENO;;X;"";"";39980;2;1;2;1;39980;0;0;0;Aspiradora AP1700 Arrastre 1700Watts;ELECTRODOMESTICOS
15520465;;F;43;CHILENO;;X;N/D;N/D;346820;4;2;4;2;346820;0;0;0;ASPIRADORA VCC4580V3K/XZS SAMSUNG BLACK;ELECTRODOMESTICOS
10118305;;F;55;CHILENO;;Boomers;RENCA                         ;METROPOLITANA;19990;1;1;0;0;0;1;1;19990;Licuadora Berry Blender Roja 1400 Vaso Vidrio;ELECTRODOMESTICOS
5846940;;F;77;CHILENO;;Silencioso;QUILLOTA                      ;VALPARAISO;26990;1;1;0;0;0;1;1;26990;Licuadora Berry Blender Roja 1400 Vaso Vidrio;ELECTRODOMESTICOS
8682014;;M;63;CHILENO;;Boomers;RENCA                         ;METROPOLITANA;19990;1;1;0;0;0;1;1;19990;Hervidor Electrico UT-DUNKEL17P 2Lts Negro;ELECTRODOMESTICOS
14036277;;M;49;CHILENO;;X;N/D;N/D;479930;7;3;0;0;0;7;3;479930;FREIDORA DE AIRE THOMAS TH-AF60Mi;ELECTRODOMESTICOS
11148737;;F;54;CHILENO;;Boomers;CHILLAN                       ;BIO BIO;51980;2;1;0;0;0;2;1;51980;Extractor de Jugo EX800 1,4Lts;ELECTRODOMESTICOS
10392887;;F;55;CHILENO;;Boomers;PARRAL                        ;MAULE;94990;1;1;0;0;0;1;1;94990;HORNO ELECTRICO HE-600IN INOX SINDELEN;ELECTRODOMESTICOS
9303406;;M;55;CHILENO;;Boomers;PROVIDENCIA                   ;METROPOLITANA;97980;2;2;0;0;0;2;2;97980;Horno Microondas Mecanico Fancy 20Lts;ELECTRODOMESTICOS
12826160;;F;47;CHILENO;;X;SAN ANTONIO                   ;VALPARAISO;239970;3;2;3;2;239970;0;0;0;ASPIRADORA ROBOT WIFI FIDDLER HOME BLANCA;ELECTRODOMESTICOS
26383237;;M;36;VENEZOLANO;;Extranjero;QUILLOTA                      ;VALPARAISO;189970;3;2;0;0;0;3;2;189970;PLANCHA A VAPOR 4070 SUELA CERAMICA 2500W;ELECTRODOMESTICOS
17894511;;F;33;CHILENO;;Millenial;VALDIVIA                      ;LOS RIOS;14990;1;1;0;0;0;1;1;14990;Exprimidor de Jugo CJ-2000 1Lts;ELECTRODOMESTICOS
11434674;;F;53;CHILENO;;X;PROVIDENCIA                   ;METROPOLITANA;39990;1;1;0;0;0;1;1;39990;Procesador TH-9010 Multimixer 1,5Lts Vaso Vidrio;ELECTRODOMESTICOS
10958384;;M;41;CHILENO;;X;ARICA                         ;ARICA Y PARINACOTA;54990;1;1;0;0;0;1;1;54990;Aspiradora VCC4190V3E/XZS Arrastre 2000Watts;ELECTRODOMESTICOS
7619786;;M;67;CHILENO;;Boomers;CHIMBARONGO                   ;L.G.B.OÂ´HIGGINS;14990;1;1;0;0;0;1;1;14990;Hervidor Electrico TH-4212N 1,7Lts Negro;ELECTRODOMESTICOS
10344605;;M;54;CHILENO;;Boomers;QUILPUE                       ;VALPARAISO;134970;3;1;0;0;0;3;1;134970;Horno Electrico TH-25N01 25Lts;ELECTRODOMESTICOS
8340946;;F;60;CHILENO;;Boomers;N/D;N/D;29990;1;1;0;0;0;1;1;29990;Combo Licuadora + Batidora;ELECTRODOMESTICOS
24740780;;F;28;BOLIVIANO;;Extranjero;N/D;N/D;57660;3;2;0;0;0;3;2;57660;HERVIDOR TH-4340;ELECTRODOMESTICOS
10052274;Casado;F;56;CHILENO;;Boomers;PROVIDENCIA                   ;METROPOLITANA;103980;2;1;2;1;103980;0;0;0;Horno Pizza FDV Napoles;ELECTRODOMESTICOS
11829248;;F;50;CHILENO;;X;QUILPUE                       ;VALPARAISO;15990;1;1;0;0;0;1;1;15990;Hervidor Electrico UT-MANLY17 1,7Lts Negro;ELECTRODOMESTICOS
20095519;;F;22;CHILENO;;Z;PROVIDENCIA                   ;METROPOLITANA;12990;1;1;0;0;0;1;1;12990;PLANCHA A VAPOR 4070 SUELA CERAMICA 2500W;ELECTRODOMESTICOS
19378219;Soltero;F;25;CHILENO;;Z;PROVIDENCIA                   ;METROPOLITANA;22990;1;1;0;0;0;1;1;22990;Tostador de PanTH-120R 2 Rebanadas Rojo;ELECTRODOMESTICOS
16692716;Soltero;F;35;CHILENO;;Millenial;PROVIDENCIA                   ;METROPOLITANA;34970;3;2;0;0;0;3;2;34970;PLANCHA A VAPOR 4070 SUELA CERAMICA 2500W;ELECTRODOMESTICOS
6167974;;M;68;CHILENO;;Silencioso;LA LIGUA                      ;VALPARAISO;219960;4;2;0;0;0;4;2;219960;Horno Microondas Digital TH-25DM 25Lts;ELECTRODOMESTICOS
10909431;Soltero;F;45;CHILENO;TECNICO;X;RENCA                         ;METROPOLITANA;49990;1;1;0;0;0;1;1;49990;Picadora TH-9020V Vaso Vidrio 2Lts;ELECTRODOMESTICOS
10276968;;F;56;CHILENO;;Boomers;RENCA                         ;METROPOLITANA;17990;1;1;0;0;0;1;1;17990;Hervidor Electrico UT-KLAR20PW 2Lts Blanco;ELECTRODOMESTICOS
9610773;;F;60;CHILENO;;Boomers;LINARES                       ;MAULE;29990;1;1;0;0;0;1;1;29990;PICADORA 123 SILHQUETTE;ELECTRODOMESTICOS
8756710;Casado;M;61;CHILENO;;Boomers;ANTOFAGASTA                   ;ANTOFAGASTA;241970;3;3;0;0;0;3;3;241970;Hervidor Family Kettle HE500;ELECTRODOMESTICOS
7831742;Casado;F;63;CHILENO;;Boomers;COIHAIQUE                     ;AYSEN;33980;2;2;0;0;0;2;2;33980;Sandwichera TH-952 2 Panes Blanca;ELECTRODOMESTICOS
16759662;;F;34;CHILENO;;Millenial;RENCA                         ;METROPOLITANA;17990;1;1;0;0;0;1;1;17990;Hervidor Electrico UT-KLAR20PW 2Lts Blanco;ELECTRODOMESTICOS
11634415;;M;52;CHILENO;;X;N/D;N/D;272970;3;3;0;0;0;3;3;272970;Freidora de Aire 18M Oster;ELECTRODOMESTICOS
15196552;;F;39;CHILENO;;Silencioso;PROVIDENCIA                   ;METROPOLITANA;12990;1;1;1;1;12990;0;0;0;Cafetera TH-130;ELECTRODOMESTICOS
14169623;;F;46;CHILENO;;X;LA PINTANA                    ;METROPOLITANA;99990;1;1;0;0;0;1;1;99990;FREIDORA DE AIRE THOMAS TH-AF60Mi;ELECTRODOMESTICOS
18375328;;F;29;CHILENO;;Millenial;N/D;N/D;39990;1;1;1;1;39990;0;0;0;ASPIRADORA ROBOT WIFI FIDDLER HOME BLANCA;ELECTRODOMESTICOS
19718800;;F;24;CHILENO;;Z;CURICO                        ;MAULE;23980;2;1;2;1;23980;0;0;0;ARROCERA ROJA 4723;ELECTRODOMESTICOS
13785871;;F;46;CHILENO;;X;PLACILLA                      ;L.G.B.OÂ´HIGGINS;26980;2;2;0;0;0;2;2;26980;Sandwichera TH-952 2 Panes Blanca;ELECTRODOMESTICOS
11497139;Casado;F;52;CHILENO;INGENIERO COMERCIAL;X;RENCA                         ;METROPOLITANA;235980;2;1;2;1;235980;0;0;0;MICROONDAS MC32K7055CT/ZS SAMSUNG BLACK;ELECTRODOMESTICOS
10821305;Casado;M;54;CHILENO;CONTADOR GENERAL;X;RENCA                         ;METROPOLITANA;64990;1;1;0;0;0;1;1;64990;Horno Microondas Mecanico UT-SYDNEY18 18Lts;ELECTRODOMESTICOS
17423070;;M;32;CHILENO;;Millenial;PROVIDENCIA                   ;METROPOLITANA;56980;2;1;0;0;0;2;1;56980;Licuadora Kaliman Negra con Teclas;ELECTRODOMESTICOS
11160614;;F;54;CHILENO;;Boomers;PROVIDENCIA                   ;METROPOLITANA;79980;2;1;0;0;0;2;1;79980;Licuadora Kaliman Negra con Teclas;ELECTRODOMESTICOS
8674237;;F;61;CHILENO;;Boomers;COIHUECO                      ;BIO BIO;29990;1;1;0;0;0;1;1;29990;Batidora Pedestal Bowl 300 Inox;ELECTRODOMESTICOS
16725747;;F;35;CHILENO;;Millenial;TALCA                         ;MAULE;757540;5;4;0;0;0;5;4;757540;Procesador TH-9010 Multimixer 1,5Lts Vaso Vidrio;ELECTRODOMESTICOS
7821774;;F;66;CHILENO;;Boomers;TEMUCO                        ;ARAUCANIA;229950;4;2;0;0;0;4;2;229950;Tostador de Pan TH-126 4 Rebanadas Negro;ELECTRODOMESTICOS
12009247;;M;48;CHILENO;;X;SAN CARLOS                    ;BIO BIO;119990;1;1;0;0;0;1;1;119990;Horno Electrico TH62I 60Lts;ELECTRODOMESTICOS
17491581;;F;32;CHILENO;;Millenial;OVALLE                        ;COQUIMBO;28973;3;2;0;0;0;3;2;28973;Combo Licuadora + Batidora;ELECTRODOMESTICOS
10711775;;F;56;CHILENO;;Boomers;ANGOL                         ;ARAUCANIA;374950;5;4;0;0;0;5;4;374950;Licuadora Personal TH-300PB;ELECTRODOMESTICOS
7431147;;F;68;CHILENO;;Boomers;PROVIDENCIA                   ;METROPOLITANA;41980;2;2;0;0;0;2;2;41980;Licuadora L2000VNG 1,5Lts Vaso Vidrio;ELECTRODOMESTICOS
14364654;;F;41;CHILENO;;X;N/D;N/D;403960;4;2;4;2;403960;0;0;0;MICROONDAS 40L MG402MADXBB/ZS SAMSUNG;ELECTRODOMESTICOS
25512017;Soltero;F;63;BOLIVIANO;;Extranjero;PROVIDENCIA                   ;METROPOLITANA;49990;1;1;0;0;0;1;1;49990;Licuadora Osterizer 4112/72 1,25Lts Vaso Vidrio;ELECTRODOMESTICOS
11488351;;F;53;CHILENO;;X;ARICA                         ;TARAPACA;22980;2;1;0;0;0;2;1;22980;PLANCHA A VAPOR 4070 SUELA CERAMICA 2500W;ELECTRODOMESTICOS
13584548;;F;49;CHILENO;;X;RENCA                         ;METROPOLITANA;49980;2;1;0;0;0;2;1;49980;Procesador TH-9010 Multimixer 1,5Lts Vaso Vidrio;ELECTRODOMESTICOS
12691052;;F;48;CHILENO;;X;SAN CARLOS                    ;BIO BIO;99990;1;1;0;0;0;1;1;99990;HORNO ELECTRICO HE-600IN INOX SINDELEN;ELECTRODOMESTICOS
12022848;;M;52;CHILENO;;X;PAINE                         ;METROPOLITANA;34990;1;1;0;0;0;1;1;34990;Plancha UT-SHANGRILA Inalambrica 2200Watss;ELECTRODOMESTICOS
12166990;Soltero;F;45;CHILENO;;X;PARRAL                        ;MAULE;34990;1;1;0;0;0;1;1;34990;Licuadora Personal TH-300PB;ELECTRODOMESTICOS
6350991;Casado;M;73;CHILENO;PROFESOR;Silencioso;RENCA                         ;METROPOLITANA;64990;1;1;0;0;0;1;1;64990;Horno Microondas Digital UT-CLASSY720 20Lts;ELECTRODOMESTICOS
11071357;;F;56;CHILENO;;Boomers;"";"";48980;2;2;0;0;0;2;2;48980;HERVIDOR ELECTRICO UT-STARK18;ELECTRODOMESTICOS
10187496;;F;59;CHILENO;;Boomers;LA LIGUA                      ;VALPARAISO;1047890;11;4;0;0;0;11;4;1047890;Horno Electrico TH-38N 38Lts;ELECTRODOMESTICOS
7960103;;F;67;CHILENO;;Boomers;PROVIDENCIA                   ;METROPOLITANA;18990;1;1;0;0;0;1;1;18990;Batidora Manual UT-TEKLA300;ELECTRODOMESTICOS
17467135;;M;32;CHILENO;;Millenial;ARICA                         ;ARICA Y PARINACOTA;160970;3;2;3;2;160970;0;0;0;Freidora de Aire Digital 40D;ELECTRODOMESTICOS
9895707;;F;55;CHILENO;;Boomers;LOTA                          ;BIO BIO;188750;4;3;0;0;0;4;3;188750;Hervidor Electrico Tetera HA-4100 4Lts Iox;ELECTRODOMESTICOS
8265728;;F;65;CHILENO;;Boomers;CANETE                        ;BIO BIO;38990;1;1;0;0;0;1;1;38990;Licuadora Roja 550W 1,5Lts Vaso Vidrio;ELECTRODOMESTICOS
16829820;Soltero;F;33;CHILENO;;Millenial;PROVIDENCIA                   ;METROPOLITANA;44990;1;1;0;0;0;1;1;44990;Aspiradora TH1407 Arrastre 1400Watts;ELECTRODOMESTICOS
19124612;Soltero;F;27;CHILENO;;Millenial;PROVIDENCIA                   ;METROPOLITANA;298430;6;4;0;0;0;6;4;298430;Procesador TH-9010 Multimixer 1,5Lts Vaso Vidrio;ELECTRODOMESTICOS
11568073;;F;51;CHILENO;;X;SAN CARLOS                    ;BIO BIO;174970;3;3;0;0;0;3;3;174970;Hervidor Electrico TH-4515N 2Lts Negro;ELECTRODOMESTICOS
10419079;;M;57;CHILENO;;Boomers;PENALOLEN                     ;METROPOLITANA;16990;1;1;0;0;0;1;1;16990;Batidora Manual 3532;ELECTRODOMESTICOS
7880966;;M;65;CHILENO;;Boomers;LINARES                       ;MAULE;194980;2;2;0;0;0;2;2;194980;Hervidor Electrico HA-3300 2,5Lts Blanco;ELECTRODOMESTICOS
8299185;;M;64;CHILENO;;Boomers;CALERA DE TANGO               ;METROPOLITANA;79980;2;2;0;0;0;2;2;79980;Combo Juguera + Hervidor;ELECTRODOMESTICOS
6795113;;F;66;CHILENO;;Boomers;RENCA                         ;METROPOLITANA;46980;2;1;2;1;46980;0;0;0;Horno Microondas Mecanico C1700N 17Lts Blanco;ELECTRODOMESTICOS
26362631;;F;58;NO INFORMA NACIONALIDAD;;Extranjero;"";"";28990;1;1;0;0;0;1;1;28990;Licuadora Personal TH-300PB;ELECTRODOMESTICOS
13582863;;F;44;CHILENO;;X;CARAHUE                       ;ARAUCANIA;176950;5;2;0;0;0;5;2;176950;Horno Electrico UT-BACKOFEN26 26Lts;ELECTRODOMESTICOS
13015266;;F;46;CHILENO;;X;COPIAPO                       ;ATACAMA;40980;4;2;0;0;0;4;2;40980;MULTIMIXER THOMAS TH- 8706;ELECTRODOMESTICOS
18779935;;M;28;CHILENO;;Millenial;SAN CLEMENTE                  ;MAULE;19990;1;1;0;0;0;1;1;19990;Exprimidor de Jugo TH-1215 1,5Lts;ELECTRODOMESTICOS
14451148;;M;48;CHILENO;;X;LOS ANGELES                   ;BIO BIO;29990;1;1;0;0;0;1;1;29990;Combo Licuadora + Batidora;ELECTRODOMESTICOS
5351360;;F;71;CHILENO;;Silencioso;SANTA MARIA                   ;VALPARAISO;163910;7;4;0;0;0;7;4;163910;Combo Licuadora + Batidora;ELECTRODOMESTICOS
11659504;Soltero;F;52;CHILENO;;X;PUENTE ALTO                   ;METROPOLITANA;59990;1;1;0;0;0;1;1;59990;Horno Electrico UT-LEIF36 36Lts;ELECTRODOMESTICOS
9033407;;F;62;CHILENO;;Boomers;TOCOPILLA                     ;ANTOFAGASTA;44980;2;2;0;0;0;2;2;44980;Batidora Manual 3532;ELECTRODOMESTICOS
16896381;Soltero;F;34;CHILENO;;Millenial;PROVIDENCIA                   ;METROPOLITANA;253960;4;2;4;2;253960;0;0;0;CAFETERA PRIMA LATTE 6603 ROJA;ELECTRODOMESTICOS
10923798;;M;55;CHILENO;;Boomers;OVALLE                        ;COQUIMBO;18990;1;1;0;0;0;1;1;18990;Hervidor Electrico TH-4515N 2Lts Negro;ELECTRODOMESTICOS
9115472;;M;58;CHILENO;;Boomers;LA GRANJA                     ;METROPOLITANA;59980;2;1;0;0;0;2;1;59980;Horno Electrico UT-BACKOFEN26 26Lts;ELECTRODOMESTICOS
15288611;Casado;F;38;CHILENO;;X;PROVIDENCIA                   ;METROPOLITANA;24980;2;1;0;0;0;2;1;24980;Hervidor Inox One Midea;ELECTRODOMESTICOS
14049054;;F;40;CHILENO;;X;MAIPU                         ;METROPOLITANA;134990;3;1;0;0;0;3;1;134990;Horno Electrico UT-BACKOFEN60 60Lts;ELECTRODOMESTICOS
19691509;;M;25;CHILENO;;Z;ANTOFAGASTA                   ;ANTOFAGASTA;14990;1;1;0;0;0;1;1;14990;HERVIDOR HAMBURGO 2,0 LITROS;ELECTRODOMESTICOS
9369795;;F;63;CHILENO;;Boomers;N/D;N/D;106970;3;2;0;0;0;3;2;106970;Horno Microondas Mecanico M-2030 NG 20Lts;ELECTRODOMESTICOS
6539648;;F;69;CHILENO;;Silencioso;CARAHUE                       ;ARAUCANIA;59980;2;1;0;0;0;2;1;59980;Horno Electrico UT-BACKOFEN26 26Lts;ELECTRODOMESTICOS
12345293;Casado;F;49;CHILENO;;X;PROVIDENCIA                   ;METROPOLITANA;24990;1;1;0;0;0;1;1;24990;Licuadora L2000VNG 1,5Lts Vaso Vidrio;ELECTRODOMESTICOS
13342405;;M;43;CHILENO;;X;BUIN                          ;METROPOLITANA;285960;4;5;0;0;0;4;5;285960;Batidora Pedestal TH910PN 4,6Lts 1300Watts;ELECTRODOMESTICOS
7904304;Casado;F;65;CHILENO;;Boomers;CURACAVI                      ;METROPOLITANA;100000;2;1;0;0;0;2;1;100000;Horno Electrico TH62I 60Lts;ELECTRODOMESTICOS
12914831;;F;46;CHILENO;;X;VINA DEL MAR                  ;VALPARAISO;21990;1;1;0;0;0;1;1;21990;Hervidor Electrico Tetera HA-4100 4Lts Iox;ELECTRODOMESTICOS
19233542;Soltero;M;26;CHILENO;;Z;PROVIDENCIA                   ;METROPOLITANA;19990;1;1;0;0;0;1;1;19990;Combo Hervidor + Batidora;ELECTRODOMESTICOS
10069394;;F;58;CHILENO;;Boomers;SANTO DOMINGO                 ;VALPARAISO;457440;5;2;0;0;0;5;2;457440;Aspiradora UT-SILENT1603 Arrastre 1600Watts;ELECTRODOMESTICOS
5575932;;F;72;CHILENO;;Silencioso;LA GRANJA                     ;METROPOLITANA;218970;3;3;0;0;0;3;3;218970;ASPIRADORA ROBOT VR05R5050WK/ZS;ELECTRODOMESTICOS
17121290;;M;33;CHILENO;;Millenial;"";"";78970;3;1;0;0;0;3;1;78970;Licuadora L1000 Inox 1,7LtsVaso Vidrio;ELECTRODOMESTICOS
19299310;Soltero;F;26;CHILENO;;Z;PROVIDENCIA                   ;METROPOLITANA;87970;3;1;3;1;87970;0;0;0;Horno Microondas Mecanico C1700N 17Lts Blanco;ELECTRODOMESTICOS
12581432;;F;48;CHILENO;;X;"";"";14990;1;1;0;0;0;1;1;14990;Batidora Vertical Stick Mixer 2609;ELECTRODOMESTICOS
10348334;;F;59;CHILENO;;Boomers;ARICA                         ;ARICA Y PARINACOTA;54990;1;1;0;0;0;1;1;54990;Freidora de Aire 18M Oster;ELECTRODOMESTICOS
10355153;Soltero;F;58;CHILENO;;Boomers;RENCA                         ;METROPOLITANA;26990;1;1;0;0;0;1;1;26990;Licuadora L2000VNG 1,5Lts Vaso Vidrio;ELECTRODOMESTICOS
14201015;;M;41;CHILENO;;X;"";"";84980;2;1;0;0;0;2;1;84980;Horno Microondas Mecanico Easy Wave 20Lts;ELECTRODOMESTICOS
21190100;;F;49;BOLIVIANO;;Extranjero;PROVIDENCIA                   ;METROPOLITANA;69990;1;1;0;0;0;1;1;69990;Aspiradora TH1870 Arrastre 1800Watts Gris;ELECTRODOMESTICOS
18931412;;M;27;CHILENO;;Z;CHEPICA                       ;L.G.B.OÂ´HIGGINS;88980;2;1;0;0;0;2;1;88980;Horno Microondas Digital TH-25DM 25Lts;ELECTRODOMESTICOS
11346746;;F;54;CHILENO;;X;LA SERENA                     ;COQUIMBO;57980;2;2;0;0;0;2;2;57980;Exprimidor Fauna 500 cc;ELECTRODOMESTICOS
10300340;;M;55;CHILENO;;Boomers;ANTOFAGASTA                   ;ANTOFAGASTA;84980;2;1;0;0;0;2;1;84980;ASPIRADORA THOMAS TH-1640;ELECTRODOMESTICOS
7488207;;F;66;CHILENO;;Boomers;CALERA                        ;VALPARAISO;99990;1;1;0;0;0;1;1;99990;Horno Electrico UT-BACKOFEN60 60Lts;ELECTRODOMESTICOS
7240434;Divorciado;F;55;CHILENO;;Millenial;PUNTA ARENAS                  ;MAGALLANES;154960;3;1;3;1;154960;0;0;0;Horno Microondas Digital UT-CLASSY720 20Lts;ELECTRODOMESTICOS
6439676;Casado;M;69;CHILENO;;Silencioso;PROVIDENCIA                   ;METROPOLITANA;99990;1;1;0;0;0;1;1;99990;FREIDORA DE AIRE THOMAS TH-AF60Mi;ELECTRODOMESTICOS
27138195;;F;43;VENEZOLANO;;Extranjero;LAS CONDES                    ;METROPOLITANA;12990;1;3;0;0;0;1;3;12990;Aspiradora UT-SILENT1804 Arrastre 1800Watts;ELECTRODOMESTICOS
15835090;Soltero;F;38;CHILENO;;Millenial;PROVIDENCIA                   ;METROPOLITANA;19990;1;1;0;0;0;1;1;19990;MULTIMIXER THOMAS TH- 8706;ELECTRODOMESTICOS
16509179;;F;35;CHILENO;;Millenial;PROVIDENCIA                   ;METROPOLITANA;16990;1;1;0;0;0;1;1;16990;Plancha Easy Steam (PV4500);ELECTRODOMESTICOS
6663782;;F;67;CHILENO;;Boomers;N/D;N/D;102990;3;2;1;1;99990;2;1;3000;SUPER FREIDORA DE AIRE OV3;ELECTRODOMESTICOS
18397854;;F;29;CHILENO;;Millenial;PROVIDENCIA                   ;METROPOLITANA;79980;2;1;2;1;79980;0;0;0;Olla Multiuso 6801 5,7Lts;ELECTRODOMESTICOS
8441170;;F;64;CHILENO;;Boomers;CURICO                        ;MAULE;310950;5;3;0;0;0;5;3;310950;Hervidor Electrico UT-REIN17SS;ELECTRODOMESTICOS
7117013;Divorciado;M;67;CHILENO;;Boomers;ARICA                         ;ARICA Y PARINACOTA;49990;1;1;0;0;0;1;1;49990;Horno Electrico UT-BACKOFEN26 26Lts;ELECTRODOMESTICOS
16734716;;M;35;CHILENO;;Millenial;CHILLAN                       ;BIO BIO;0;0;2;0;0;0;0;2;0;Licuadora TH-320 Roja/Negro 1,5 Lts Vaso Vidrio;ELECTRODOMESTICOS
6903945;Casado;F;70;CHILENO;;Silencioso;RENCA                         ;METROPOLITANA;15990;1;1;0;0;0;1;1;15990;Hervidor Electrico UT-MANLY17 1,7Lts Negro;ELECTRODOMESTICOS
18496109;;M;29;CHILENO;;Millenial;PROVIDENCIA                   ;METROPOLITANA;116910;9;2;0;0;0;9;2;116910;Horno Microondas Mecanico M-2030 NG 20Lts;ELECTRODOMESTICOS
14056298;Casado;F;41;CHILENO;PERIODISTA;X;PROVIDENCIA                   ;METROPOLITANA;31980;2;1;2;1;31980;0;0;0;Plancha UT-PLATTEISEN 2000Watts Base Ceramica;ELECTRODOMESTICOS
5017198;;F;80;CHILENO;;Silencioso;NATALES                       ;MAGALLANES;21990;1;1;0;0;0;1;1;21990;Plancha TH-7052 2000Watts Base Inox;ELECTRODOMESTICOS
10136288;;F;60;CHILENO;;Boomers;SAN BERNARDO                  ;METROPOLITANA;99980;2;1;0;0;0;2;1;99980;Horno Microondas Mecanico M-2020NG 20Lts;ELECTRODOMESTICOS
7984393;;F;58;CHILENO;;Boomers;RENCA                         ;METROPOLITANA;17990;1;1;0;0;0;1;1;17990;HERVIDOR TH-4340;ELECTRODOMESTICOS
9392340;;F;58;CHILENO;;Boomers;PROVIDENCIA                   ;METROPOLITANA;24980;2;1;0;0;0;2;1;24980;Sandwichera TH-952 2 Panes Blanca;ELECTRODOMESTICOS
15370373;;F;39;CHILENO;;Silencioso;PROVIDENCIA                   ;METROPOLITANA;126960;4;1;0;0;0;4;1;126960;Licuadora Osterizer 4112/72 1,25Lts Vaso Vidrio;ELECTRODOMESTICOS
9595804;;F;63;CHILENO;;Boomers;SAN FERNANDO                  ;L.G.B.OÂ´HIGGINS;785960;4;4;0;0;0;4;4;785960;Horno Microondas Mecanico UT-SYDNEY18 18Lts;ELECTRODOMESTICOS
18198216;Soltero;M;29;CHILENO;;Millenial;PROVIDENCIA                   ;METROPOLITANA;537970;3;2;0;0;0;3;2;537970;Horno Microondas Digital TH-20S01 20Lts;ELECTRODOMESTICOS
10313319;;M;54;CHILENO;;Boomers;SAN BERNARDO                  ;METROPOLITANA;309970;3;3;0;0;0;3;3;309970;Licuadora Berry Blender Roja 1400 Vaso Vidrio;ELECTRODOMESTICOS
9567944;;F;55;CHILENO;;Boomers;CISNES                        ;AYSEN;46983;2;2;0;0;0;2;2;46983;Exprimidor de Jugo CJ-2000 1Lts;ELECTRODOMESTICOS
13544125;;M;42;CHILENO;;X;QUILPUE                       ;VALPARAISO;39990;1;1;0;0;0;1;1;39990;Parrilla Electrica M18W;ELECTRODOMESTICOS
8182102;;F;64;CHILENO;;Boomers;RENCA                         ;METROPOLITANA;64990;1;1;0;0;0;1;1;64990;Horno Microondas Mecanico UT-SYDNEY18 18Lts;ELECTRODOMESTICOS
14218021;Casado;M;41;CHILENO;INGENIERO INFORMATICO;X;RENCA                         ;METROPOLITANA;17990;1;1;0;0;0;1;1;17990;Hervidor Electrico UT-MANLY17 1,7Lts Negro;ELECTRODOMESTICOS
18401932;Soltero;F;28;CHILENO;TECNICO DE NIVEL SUPERIOR EN ENFERMERIA;Millenial;PROVIDENCIA                   ;METROPOLITANA;109990;1;1;0;0;0;1;1;109990;Horno Electrico TH62I 60Lts;ELECTRODOMESTICOS
7832370;;F;65;CHILENO;;Boomers;GRANEROS                      ;L.G.B.OÂ´HIGGINS;742930;7;3;0;0;0;7;3;742930;Cafetera TH-130;ELECTRODOMESTICOS
7948590;;F;59;CHILENO;;Boomers;PROVIDENCIA                   ;METROPOLITANA;15990;1;1;0;0;0;1;1;15990;HERVIDOR TH-4340;ELECTRODOMESTICOS
19962751;;F;24;CHILENO;;Z;PUERTO MONTT                  ;LOS LAGOS;152970;3;2;0;0;0;3;2;152970;Licuadora L1000 Inox 1,7LtsVaso Vidrio;ELECTRODOMESTICOS
11191259;;F;55;CHILENO;;Boomers;CERRILLOS                     ;METROPOLITANA;14990;1;1;0;0;0;1;1;14990;Hervidor Electrico UT-MANLY17 1,7Lts Negro;ELECTRODOMESTICOS
14315627;;F;46;CHILENO;;X;PROVIDENCIA                   ;METROPOLITANA;75970;3;2;0;0;0;3;2;75970;PICADORA 123 SILHQUETTE;ELECTRODOMESTICOS
9599326;Casado;M;60;CHILENO;;Boomers;PROVIDENCIA                   ;METROPOLITANA;44990;1;1;0;0;0;1;1;44990;Licuadora TH-501V 1,5Lts Vaso Vidrio;ELECTRODOMESTICOS
12788612;;F;47;CHILENO;;X;LINARES                       ;MAULE;34990;1;1;0;0;0;1;1;34990;Plancha UT-SHANGRILA Inalambrica 2200Watss;ELECTRODOMESTICOS
18765880;;M;28;CHILENO;;Millenial;PROVIDENCIA                   ;METROPOLITANA;74050;4;2;0;0;0;4;2;74050;Aspiradora AP1700 Arrastre 1700Watts;ELECTRODOMESTICOS
17752388;Soltero;M;31;CHILENO;INGENIERO CIVIL INDUSTRIAL;Silencioso;PROVIDENCIA                   ;METROPOLITANA;1304980;2;1;2;1;1304980;0;0;0;Maquina Bordadora MC550E;ELECTRODOMESTICOS
19594567;;F;25;CHILENO;;Z;PROVIDENCIA                   ;METROPOLITANA;194970;3;4;0;0;0;3;4;194970;Horno Electrico UT-BACKOFEN60 60Lts;ELECTRODOMESTICOS
19758952;;M;24;CHILENO;;Z;PUERTO MONTT                  ;LOS LAGOS;44990;1;1;0;0;0;1;1;44990;Aspiradora TH1415 Arrastre 1500Watts;ELECTRODOMESTICOS
10864858;;F;57;CHILENO;;Boomers;RENCA                         ;METROPOLITANA;19990;1;1;0;0;0;1;1;19990;Plancha TH-7052 2000Watts Base Inox;ELECTRODOMESTICOS
10265690;;F;57;CHILENO;;Boomers;N/D;N/D;389970;3;2;2;1;299980;1;1;89990;Batidora Pedestal TH910PN 4,6Lts 1300Watts;ELECTRODOMESTICOS
6761762;;M;71;CHILENO;;Silencioso;VALDIVIA                      ;LOS RIOS;54980;2;2;0;0;0;2;2;54980;Hervidor Electrico UT-MANLY17 1,7Lts Negro;ELECTRODOMESTICOS
16683589;;F;34;CHILENO;;Millenial;COPIAPO                       ;ATACAMA;79990;1;1;0;0;0;1;1;79990;Aspiradora TH1870 Arrastre 1800Watts Gris;ELECTRODOMESTICOS
15840310;;M;40;CHILENO;;X;N/D;N/D;34990;1;1;0;0;0;1;1;34990;Licuadora L1000 Inox 1,7LtsVaso Vidrio;ELECTRODOMESTICOS
13182558;;F;45;CHILENO;;X;PROVIDENCIA                   ;METROPOLITANA;18990;1;1;0;0;0;1;1;18990;Plancha UT-DUNST 2200Watts Base Ceramica;ELECTRODOMESTICOS
11673196;;M;52;CHILENO;;X;RENCA                         ;METROPOLITANA;12990;1;1;0;0;0;1;1;12990;Exprimidor de Jugo CJ-2000 1Lts;ELECTRODOMESTICOS
11577600;;F;52;CHILENO;;X;RENCA                         ;METROPOLITANA;149990;1;1;0;0;0;1;1;149990;Aspiradora Trapeadora Robot Ut-Excellenza (B);ELECTRODOMESTICOS
8304179;;F;67;CHILENO;;Boomers;ARICA                         ;ARICA Y PARINACOTA;14990;1;1;0;0;0;1;1;14990;Hervidor Electrico HA-3300 2,5Lts Blanco;ELECTRODOMESTICOS
19957851;;M;24;CHILENO;;Silencioso;PROVIDENCIA                   ;METROPOLITANA;111900;10;2;10;2;111900;0;0;0;PLANCHA A VAPOR 4070 SUELA CERAMICA 2500W;ELECTRODOMESTICOS
13521075;;M;43;CHILENO;;X;N/D;N/D;99990;1;1;0;0;0;1;1;99990;Horno Microondas Digital TH-25DM 25Lts;ELECTRODOMESTICOS
14498242;Soltero;M;46;CHILENO;;X;RENCA                         ;METROPOLITANA;41990;1;1;0;0;0;1;1;41990;Licuadora Kaliman Negra con Teclas;ELECTRODOMESTICOS
13572076;;F;46;CHILENO;;X;N/D;N/D;99980;2;2;0;0;0;2;2;99980;Procesador TH-9010 Multimixer 1,5Lts Vaso Vidrio;ELECTRODOMESTICOS
12935572;;F;47;CHILENO;;X;PROVIDENCIA                   ;METROPOLITANA;249980;2;2;0;0;0;2;2;249980;ASPIRADORA ROBOT WIFI FIDDLER HOME BLANCA;ELECTRODOMESTICOS
19426860;;M;25;CHILENO;;Extranjero;PUREN                         ;ARAUCANIA;12990;1;1;0;0;0;1;1;12990;Exprimidor de Jugo CJ-2000 1Lts;ELECTRODOMESTICOS
18667989;Casado;M;29;CHILENO;;Millenial;PROVIDENCIA                   ;METROPOLITANA;109990;1;1;0;0;0;1;1;109990;Horno Microondas Digital L UT-25KROMM 25Lts;ELECTRODOMESTICOS
10946066;Soltero;F;51;CHILENO;;X;COPIAPO                       ;ATACAMA;35582;2;2;0;0;0;2;2;35582;Hervidor Electrico Tetera HA-4100 4Lts Iox;ELECTRODOMESTICOS
13817817;;M;45;CHILENO;;X;CONCEPCION                    ;BIO BIO;53980;2;1;0;0;0;2;1;53980;Aspiradora Handy Clean Black 1400;ELECTRODOMESTICOS
7563288;Casado;F;66;CHILENO;;Boomers;LINARES                       ;MAULE;59990;1;1;0;0;0;1;1;59990;Horno Microondas Mecanico TH-18B05 18Lts;ELECTRODOMESTICOS
11684733;Casado;F;51;CHILENO;;X;PROVIDENCIA                   ;METROPOLITANA;52970;3;2;0;0;0;3;2;52970;Hervidor Electrico UT-MANLY17 1,7Lts Negro;ELECTRODOMESTICOS
10018792;;F;58;CHILENO;;Boomers;CANETE                        ;BIO BIO;27990;1;1;0;0;0;1;1;27990;Plancha UT-KERAMIKTOP 2200Watts Base Ceramica;ELECTRODOMESTICOS
11436176;;F;53;CHILENO;;X;VINA DEL MAR                  ;VALPARAISO;136960;4;4;0;0;0;4;4;136960;Licuadora L2000VNG 1,5Lts Vaso Vidrio;ELECTRODOMESTICOS
8558798;;M;64;CHILENO;;Boomers;SANTIAGO                      ;METROPOLITANA;17990;1;1;0;0;0;1;1;17990;Hervidor Electrico UT-KLAR20PW 2Lts Blanco;ELECTRODOMESTICOS
6347888;;M;73;CHILENO;;Silencioso;INDEPENDENCIA                 ;METROPOLITANA;64990;1;1;0;0;0;1;1;64990;Horno Microondas Mecanico TH-18B05 18Lts;ELECTRODOMESTICOS
6394036;;F;72;CHILENO;;Silencioso;RENCA                         ;METROPOLITANA;69990;1;1;0;0;0;1;1;69990;Horno Electrico TH-38N 38Lts;ELECTRODOMESTICOS
15916547;;M;37;CHILENO;;Millenial;SAN FERNANDO                  ;L.G.B.OÂ´HIGGINS;44990;1;1;0;0;0;1;1;44990;Licuadora Osterizer 4112/72 1,25Lts Vaso Vidrio;ELECTRODOMESTICOS
16835100;;F;34;CHILENO;;Millenial;MARCHIHUE                     ;L.G.B.OÂ´HIGGINS;189980;2;2;2;2;189980;0;0;0;Horno Microondas Mecanico TH-18B05 18Lts;ELECTRODOMESTICOS
7441400;;F;68;CHILENO;;Boomers;LA LIGUA                      ;VALPARAISO;23990;1;1;0;0;0;1;1;23990;Hervidor Electrico TH-4515N 2Lts Negro;ELECTRODOMESTICOS
14052311;;F;40;CHILENO;;X;CURICO                        ;MAULE;64990;1;2;0;0;0;1;2;64990;Horno Microondas Mecanico UT-SYDNEY18 18Lts;ELECTRODOMESTICOS
5461068;;M;73;CHILENO;;Silencioso;OSORNO                        ;LOS LAGOS;621340;5;5;0;0;0;5;5;621340;Horno Electrico TH62I 60Lts;ELECTRODOMESTICOS
7689524;;F;67;CHILENO;;Boomers;RENCA                         ;METROPOLITANA;29980;2;1;0;0;0;2;1;29980;Hervidor Electrico TH-4515N 2Lts Negro;ELECTRODOMESTICOS
13091385;;M;46;CHILENO;;X;PROVIDENCIA                   ;METROPOLITANA;29990;1;1;0;0;0;1;1;29990;Licuadora L2000VNG 1,5Lts Vaso Vidrio;ELECTRODOMESTICOS
14506633;;F;48;CHILENO;;X;CONSTITUCION                  ;MAULE;41990;1;1;0;0;0;1;1;41990;Licuadora TH-401V Roja 1,75Lts Vaso Vidrio;ELECTRODOMESTICOS
18333324;;F;29;CHILENO;;Millenial;NUEVA IMPERIAL                ;ARAUCANIA;99980;3;2;0;0;0;3;2;99980;Hervidor Electrico TH-4515N 2Lts Negro;ELECTRODOMESTICOS
6629803;;F;65;CHILENO;;Boomers;PUDAHUEL                      ;METROPOLITANA;458920;8;7;0;0;0;8;7;458920;Hervidor Electrico UT-MANLY17 1,7Lts Negro;ELECTRODOMESTICOS
9852795;;F;57;CHILENO;;Boomers;PROVIDENCIA                   ;METROPOLITANA;14990;1;1;0;0;0;1;1;14990;Hervidor Electrico HA-3300 2,5Lts Blanco;ELECTRODOMESTICOS
8047287;;F;63;CHILENO;;Boomers;MAIPU                         ;METROPOLITANA;59990;1;1;0;0;0;1;1;59990;Aspiradora TH1870 Arrastre 1800Watts Gris;ELECTRODOMESTICOS
15631360;Divorciado;F;38;CHILENO;;X;RENCA                         ;METROPOLITANA;49990;1;1;0;0;0;1;1;49990;PROCESADOR THOMAS TH-9160;ELECTRODOMESTICOS
11782896;;F;53;CHILENO;;X;N/D;N/D;209970;3;2;0;0;0;3;2;209970;Procesador TH-9010 Multimixer 1,5Lts Vaso Vidrio;ELECTRODOMESTICOS
6712896;;F;70;CHILENO;;Silencioso;RENCA                         ;METROPOLITANA;79970;3;2;0;0;0;3;2;79970;Procesador TH-9010 Multimixer 1,5Lts Vaso Vidrio;ELECTRODOMESTICOS
6451572;Casado;M;71;CHILENO;;Silencioso;LO ESPEJO                     ;METROPOLITANA;36990;1;1;0;0;0;1;1;36990;Licuadora Roja 550W 1,5Lts Vaso Vidrio;ELECTRODOMESTICOS
11078459;;F;55;CHILENO;;Boomers;RENCA                         ;METROPOLITANA;24990;1;1;0;0;0;1;1;24990;Licuadora L2000VNG 1,5Lts Vaso Vidrio;ELECTRODOMESTICOS
11230526;Soltero;M;53;CHILENO;;X;PROVIDENCIA                   ;METROPOLITANA;54990;1;1;0;0;0;1;1;54990;Horno Electrico UT-BACKOFEN26 26Lts;ELECTRODOMESTICOS
8385478;;M;61;CHILENO;;Boomers;SAN FERNANDO                  ;L.G.B.OÂ´HIGGINS;149990;1;1;0;0;0;1;1;149990;ASPIRADORA ROBOT THOMAS TH-1060SC;ELECTRODOMESTICOS
13561675;;M;42;CHILENO;;X;NANCAGUA                      ;L.G.B.OÂ´HIGGINS;44990;1;1;0;0;0;1;1;44990;Aspiradora TH1415 Arrastre 1500Watts;ELECTRODOMESTICOS
6860011;Casado;M;67;CHILENO;;Boomers;PROVIDENCIA                   ;METROPOLITANA;44990;1;1;0;0;0;1;1;44990;Picadora TH-9020V Vaso Vidrio 2Lts;ELECTRODOMESTICOS
6107125;;F;75;CHILENO;;Silencioso;OSORNO                        ;LOS LAGOS;21990;1;1;0;0;0;1;1;21990;Plancha TH-7052 2000Watts Base Inox;ELECTRODOMESTICOS
13387164;;F;44;CHILENO;;X;PROVIDENCIA                   ;METROPOLITANA;64980;2;1;2;1;64980;0;0;0;Batidora de Pedestal FDV Venus Grey;ELECTRODOMESTICOS
12399985;;F;48;CHILENO;;X;LA LIGUA                      ;VALPARAISO;15990;1;1;0;0;0;1;1;15990;HERVIDOR TH-4340;ELECTRODOMESTICOS
10486668;;F;59;CHILENO;;Boomers;LINARES                       ;MAULE;227440;5;2;0;0;0;5;2;227440;Plancha UT-KERAMIK1 2200Watts Base Ceramica;ELECTRODOMESTICOS
12414891;;F;49;CHILENO;;X;RENCA                         ;METROPOLITANA;22990;1;1;0;0;0;1;1;22990;PLANCHA VAPOR TH-7146;ELECTRODOMESTICOS
10518623;;F;56;CHILENO;;Boomers;CERRO NAVIA                   ;METROPOLITANA;24990;1;1;0;0;0;1;1;24990;Licuadora TH-320 Roja/Negro 1,5 Lts Vaso Vidrio;ELECTRODOMESTICOS
16461238;;M;35;CHILENO;;Millenial;ANCUD                         ;LOS LAGOS;47990;1;1;0;0;0;1;1;47990;LICUADORA CROMADA CON TECLAS PLUS;ELECTRODOMESTICOS
13144576;;F;45;CHILENO;;Extranjero;LOS ANGELES                   ;BIO BIO;55840;2;1;2;1;55840;0;0;0;Aspiradora VCC4190V3E/XZS Arrastre 2000Watts;ELECTRODOMESTICOS
13136297;;F;44;CHILENO;;X;PROVIDENCIA                   ;METROPOLITANA;55840;2;1;2;1;55840;0;0;0;Horno Microondas Digital TH-20S01 20Lts;ELECTRODOMESTICOS
24810721;Soltero;M;30;PERUANO;;Extranjero;PROVIDENCIA                   ;METROPOLITANA;69990;1;1;0;0;0;1;1;69990;Horno Microondas Digital UT-CLASSY720 20Lts;ELECTRODOMESTICOS
7954324;;F;66;CHILENO;;Boomers;VALLENAR;ATACAMA;58980;2;2;0;0;0;2;2;58980;Hervidor Electrico UT-KLAR20PW 2Lts Blanco;ELECTRODOMESTICOS
15150303;;M;38;CHILENO;;X;SAN JAVIER                    ;MAULE;54990;1;1;0;0;0;1;1;54990;ASPIRADORA ROBOT WIFI FIDDLER HOME BLANCA;ELECTRODOMESTICOS
10438498;;M;56;CHILENO;;Boomers;LAMPA                         ;METROPOLITANA;56980;2;2;0;0;0;2;2;56980;Hervidor Electrico TH-4515N 2Lts Negro;ELECTRODOMESTICOS
9656756;Casado;F;58;CHILENO;;Boomers;RENCA                         ;METROPOLITANA;55980;2;2;0;0;0;2;2;55980;Plancha Paninis 2880;ELECTRODOMESTICOS
11199168;;F;56;CHILENO;;Boomers;BUIN                          ;METROPOLITANA;79990;1;1;0;0;0;1;1;79990;Aspiradora TH1870 Arrastre 1800Watts Gris;ELECTRODOMESTICOS
14212862;;F;41;CHILENO;;X;LOTA                          ;BIO BIO;26990;1;1;0;0;0;1;1;26990;Batidora Pedestal B5300 Inox;ELECTRODOMESTICOS
11375205;;M;54;CHILENO;;Boomers;RENCA                         ;METROPOLITANA;42990;1;1;0;0;0;1;1;42990;LICUADORA CROMADA CON TECLAS PLUS;ELECTRODOMESTICOS
3304387;;F;84;CHILENO;;Silencioso;PENALOLEN                     ;METROPOLITANA;19990;1;1;0;0;0;1;1;19990;Hervidor Electrico TH-5407i 2Lts;ELECTRODOMESTICOS
16415150;Casado;M;35;CHILENO;;Millenial;PROVIDENCIA                   ;METROPOLITANA;29990;1;1;0;0;0;1;1;29990;Licuadora Osterizer 4112/72 1,25Lts Vaso Vidrio;ELECTRODOMESTICOS
5468434;;M;77;CHILENO;;Silencioso;LA CISTERNA                   ;METROPOLITANA;366970;3;2;0;0;0;3;2;366970;Licuadora TH-320 Roja/Negro 1,5 Lts Vaso Vidrio;ELECTRODOMESTICOS
10951574;;F;52;CHILENO;;X;RENGO                         ;L.G.B.OÂ´HIGGINS;99990;3;1;0;0;0;3;1;99990;Horno Microondas Mecanico TH-18B05 18Lts;ELECTRODOMESTICOS
16193713;;M;36;CHILENO;;Millenial;PROVIDENCIA                   ;METROPOLITANA;21990;1;1;1;1;21990;0;0;0;Olla Arrocera OA-400NG 1,8Lts;ELECTRODOMESTICOS
8425883;;F;64;CHILENO;;Boomers;VILLARICA                     ;ARAUCANIA;39980;2;1;0;0;0;2;1;39980;Combo Licuadora + Batidora;ELECTRODOMESTICOS
16034830;;F;36;CHILENO;;Millenial;QUILPUE                       ;VALPARAISO;294980;2;1;2;1;294980;0;0;0;Aspiradora Mi Robot Vacuum-Mop P Black XIAOMI;ELECTRODOMESTICOS
6608600;;M;67;CHILENO;;Boomers;TALCAHUANO                    ;BIO BIO;47990;1;1;0;0;0;1;1;47990;Aspiradora Handy Clean Black 1400;ELECTRODOMESTICOS
23256296;;F;37;COLOMBIANO;;Extranjero;IQUIQUE                       ;TARAPACA;201400;8;3;0;0;0;8;3;201400;Combo Licuadora + Batidora;ELECTRODOMESTICOS
6857221;;F;72;CHILENO;;Silencioso;MELIPILLA                     ;METROPOLITANA;29980;2;2;0;0;0;2;2;29980;HERVIDOR TH-4340;ELECTRODOMESTICOS
9122051;Soltero;M;70;CHILENO;;Silencioso;RENCA                         ;METROPOLITANA;12990;1;1;0;0;0;1;1;12990;Hervidor Electrico HA-2650NG;ELECTRODOMESTICOS
7455586;Divorciado;F;62;CHILENO;;Boomers;PROVIDENCIA                   ;METROPOLITANA;29990;1;1;0;0;0;1;1;29990;Licuadora Personal TH-300PB;ELECTRODOMESTICOS
13329594;;M;44;CHILENO;;X;OVALLE                        ;COQUIMBO;248960;4;2;2;1;155980;2;1;92980;Enceradora EA-5000;ELECTRODOMESTICOS
13629983;;F;43;CHILENO;;X;ANGOL                         ;ARAUCANIA;19990;1;1;0;0;0;1;1;19990;Hervidor Electrico TH-4515N 2Lts Negro;ELECTRODOMESTICOS
7670100;;F;65;CHILENO;;Boomers;COIHAIQUE                     ;AYSEN;20990;1;1;0;0;0;1;1;20990;Tostador de PanTH-120R 2 Rebanadas Rojo;ELECTRODOMESTICOS
9061233;;M;59;CHILENO;;Boomers;N/D;N/D;564980;3;2;0;0;0;3;2;564980;Licuadora L-1630V Negra 1,5Lts Vaso Vidrio;ELECTRODOMESTICOS
14306332;;M;47;CHILENO;;X;N/D;N/D;145950;3;2;0;0;0;3;2;145950;Horno Microondas Mecanico Easy Wave 20Lts;ELECTRODOMESTICOS
5782331;;F;70;CHILENO;;Silencioso;ALTO HOSPICIO;TARAPACA;33980;2;1;0;0;0;2;1;33980;Licuadora TH-320 Roja/Negro 1,5 Lts Vaso Vidrio;ELECTRODOMESTICOS
9324389;Casado;F;60;CHILENO;;Boomers;PROVIDENCIA                   ;METROPOLITANA;18990;1;1;0;0;0;1;1;18990;Batidora Manual UT-TEKLA300;ELECTRODOMESTICOS
9890878;;M;53;CHILENO;;X;TALCA                         ;MAULE;69970;3;1;3;1;69970;0;0;0;Hervidor Electrico Tetera HA-4100 4Lts Iox;ELECTRODOMESTICOS
12830538;;F;47;CHILENO;;X;PROVIDENCIA                   ;METROPOLITANA;21990;1;1;0;0;0;1;1;21990;Licuadora TH-320 Roja/Negro 1,5 Lts Vaso Vidrio;ELECTRODOMESTICOS
11414242;Casado;M;52;CHILENO;;X;ANCUD                         ;LOS LAGOS;18990;1;1;0;0;0;1;1;18990;Hervidor Electrico TH-4515N 2Lts Negro;ELECTRODOMESTICOS
5388841;;F;78;CHILENO;;Silencioso;ANTOFAGASTA                   ;ANTOFAGASTA;24990;1;1;0;0;0;1;1;24990;HERVIDOR ELECTRICO UT-STARK18;ELECTRODOMESTICOS
9529058;;M;60;CHILENO;;Boomers;N/D;N/D;636420;8;6;0;0;0;8;6;636420;PLANCHA A VAPOR 6953 BASE AEROCERAMICA AUTAPA.22;ELECTRODOMESTICOS
7949749;;M;64;CHILENO;;Boomers;PUDAHUEL                      ;METROPOLITANA;69990;1;1;1;1;69990;0;0;0;Horno Microondas Digital UT-CLASSY720 20Lts;ELECTRODOMESTICOS
6127751;;M;74;CHILENO;;Silencioso;ARICA                         ;ARICA Y PARINACOTA;12990;1;1;0;0;0;1;1;12990;Exprimidor de Jugo CJ-2000 1Lts;ELECTRODOMESTICOS
5880582;Casado;F;74;CHILENO;;Silencioso;VINA DEL MAR                  ;VALPARAISO;79990;1;1;0;0;0;1;1;79990;Batidora Pedestal UT-KLEIN700;ELECTRODOMESTICOS
8212484;Soltero;F;69;CHILENO;;Silencioso;RENCA                         ;METROPOLITANA;13240;2;2;0;0;0;2;2;13240;Exprimidor de Jugo CJ-2000 1Lts;ELECTRODOMESTICOS
11367952;;F;52;CHILENO;;X;SAN FERNANDO                  ;L.G.B.OÂ´HIGGINS;145960;4;4;0;0;0;4;4;145960;Combo Juguera + Hervidor;ELECTRODOMESTICOS
9340026;;M;61;CHILENO;;Boomers;CHEPICA                       ;L.G.B.OÂ´HIGGINS;61980;2;1;0;0;0;2;1;61980;Licuadora TH-501V 1,5Lts Vaso Vidrio;ELECTRODOMESTICOS
18788219;;M;28;CHILENO;;Millenial;IQUIQUE                       ;TARAPACA;36980;2;1;0;0;0;2;1;36980;Combo Licuadora + Batidora;ELECTRODOMESTICOS
8842606;;F;60;CHILENO;;Boomers;TOME                          ;BIO BIO;26990;1;1;0;0;0;1;1;26990;Hervidor Electrico UT-REIN17SS;ELECTRODOMESTICOS
6504865;;F;70;CHILENO;;Silencioso;CABILDO                       ;VALPARAISO;41582;2;1;0;0;0;2;1;41582;Licuadora TH-501V 1,5Lts Vaso Vidrio;ELECTRODOMESTICOS
15331501;Casado;F;39;CHILENO;;X;RENCA                         ;METROPOLITANA;68980;2;1;2;1;68980;0;0;0;Horno Microondas Digital Deli (2017 DM) 20Lts;ELECTRODOMESTICOS
10425686;;M;55;CHILENO;;Boomers;PROVIDENCIA                   ;METROPOLITANA;33980;2;1;0;0;0;2;1;33980;Hervidor Electrico UT-MANLY17 1,7Lts Negro;ELECTRODOMESTICOS
19218168;Soltero;M;26;CHILENO;PSICOLOGO;Z;PROVIDENCIA                   ;METROPOLITANA;49990;1;1;1;1;49990;0;0;0;Aspiradora TH1415 Arrastre 1500Watts;ELECTRODOMESTICOS
18756031;;F;28;CHILENO;;Millenial;PROVIDENCIA                   ;METROPOLITANA;28990;1;1;1;1;28990;0;0;0;Plancha Paninis 2880;ELECTRODOMESTICOS
9074104;;M;62;CHILENO;;Boomers;LINARES                       ;MAULE;29990;1;1;0;0;0;1;1;29990;Licuadora Kaliman Negra con Teclas;ELECTRODOMESTICOS
20088472;;F;22;CHILENO;;Z;N/D;N/D;157970;3;3;0;0;0;3;3;157970;Horno Electrico TH-48N 48Lts;ELECTRODOMESTICOS
13766064;;M;42;CHILENO;;X;VALPARAISO;VALPARAISO;384970;3;2;3;2;384970;0;0;0;Batidora de Pedestal FDV Venus Grey;ELECTRODOMESTICOS
9435608;;M;59;CHILENO;;Boomers;RENCA                         ;METROPOLITANA;30990;1;1;0;0;0;1;1;30990;Hervidor Electrico Tetera TH-6505RT 1,7Lts Rojo;ELECTRODOMESTICOS
12555756;;F;47;CHILENO;;X;YUMBEL                        ;BIO BIO;19990;1;1;0;0;0;1;1;19990;Hervidor Electrico UT-DUNKEL17P 2Lts Negro;ELECTRODOMESTICOS
16123099;;M;37;CHILENO;;Millenial;N/D;N/D;74990;1;1;0;0;0;1;1;74990;Batidora Pedestal UT-KLEIN700;ELECTRODOMESTICOS
15784402;Casado;F;38;CHILENO;;Millenial;ALTO HOSPICIO;TARAPACA;39980;2;1;0;0;0;2;1;39980;Parrilla Electrica TH-180;ELECTRODOMESTICOS
15784084;Soltero;F;40;CHILENO;INGENIERO CIVIL;X;PROVIDENCIA                   ;METROPOLITANA;29990;1;1;1;1;29990;0;0;0;Licuadora TH-401V Roja 1,75Lts Vaso Vidrio;ELECTRODOMESTICOS
5584117;;M;75;CHILENO;;Silencioso;LONGAVI                       ;MAULE;89980;2;1;0;0;0;2;1;89980;Aspiradora TH1870 Arrastre 1800Watts Gris;ELECTRODOMESTICOS
16842285;;F;33;CHILENO;;Millenial;PROVIDENCIA                   ;METROPOLITANA;279990;2;1;2;1;279990;0;0;0;Maquina de Coser Overlock MY8002D;ELECTRODOMESTICOS
10920397;;F;59;CHILENO;;Boomers;RENCA                         ;METROPOLITANA;104980;4;1;0;0;0;4;1;104980;Horno Electrico TH-25N01 25Lts;ELECTRODOMESTICOS
19613417;;F;24;CHILENO;;Z;PROVIDENCIA                   ;METROPOLITANA;24990;1;1;1;1;24990;0;0;0;Combo Licuadora + Batidora;ELECTRODOMESTICOS
11152600;;F;55;CHILENO;;Boomers;RENCA                         ;METROPOLITANA;19990;1;1;0;0;0;1;1;19990;Licuadora Berry Blender Roja 1400 Vaso Vidrio;ELECTRODOMESTICOS
20028342;;F;23;CHILENO;;Z;"";"";129990;1;1;0;0;0;1;1;129990;Maquina de Coser JS-2135CL Calipso;ELECTRODOMESTICOS
26541873;;M;28;VENEZOLANO;;Extranjero;"";"";109980;2;2;0;0;0;2;2;109980;Aspiradora TH1870 Arrastre 1800Watts Gris;ELECTRODOMESTICOS
16986836;;F;33;CHILENO;;Extranjero;MELIPILLA                     ;METROPOLITANA;59990;1;1;0;0;0;1;1;59990;Aspiradora TH1870 Arrastre 1800Watts Gris;ELECTRODOMESTICOS
8935798;;F;63;CHILENO;;Boomers;SAN CARLOS                    ;BIO BIO;59990;1;1;0;0;0;1;1;59990;Aspiradora TH1870 Arrastre 1800Watts Gris;ELECTRODOMESTICOS
17847730;;F;31;CHILENO;;Millenial;GORBEA;ARAUCANIA;46980;2;1;2;1;46980;0;0;0;Horno Electrico TH-25N01 25Lts;ELECTRODOMESTICOS
12492358;;F;49;CHILENO;;X;"";"";139990;1;1;0;0;0;1;1;139990;Maquina de Coser Remington J011;ELECTRODOMESTICOS
13373826;;F;43;CHILENO;;X;CAUQUENES                     ;MAULE;36990;1;1;0;0;0;1;1;36990;Combo Hervidor + Tostador + Sandwichera;ELECTRODOMESTICOS
16649024;;M;34;CHILENO;;Millenial;N/D;N/D;78980;2;1;2;1;78980;0;0;0;FREIDORA DE AIRE THOMAS TH-AF60Mi;ELECTRODOMESTICOS
7483845;;F;64;CHILENO;;Boomers;N/D;N/D;39980;2;1;0;0;0;2;1;39980;Licuadora Kaliman Negra con Teclas;ELECTRODOMESTICOS
18949781;;F;27;CHILENO;;Z;N/D;N/D;33980;2;1;0;0;0;2;1;33980;Licuadora TH-320 Roja/Negro 1,5 Lts Vaso Vidrio;ELECTRODOMESTICOS
26266095;;M;46;HAITIANO;;Extranjero;EL QUISCO                     ;VALPARAISO;237970;3;2;0;0;0;3;2;237970;HERVIDOR TH-4340;ELECTRODOMESTICOS
8218829;;F;68;CHILENO;;Boomers;EL BOSQUE                     ;METROPOLITANA;44990;1;1;0;0;0;1;1;44990;Picadora TH-9020V Vaso Vidrio 2Lts;ELECTRODOMESTICOS
12334611;;M;49;CHILENO;;X;TEMUCO                        ;ARAUCANIA;99990;1;1;0;0;0;1;1;99990;Horno Electrico UT-BACKOFEN60 60Lts;ELECTRODOMESTICOS
9613047;;F;61;CHILENO;;Boomers;PROVIDENCIA                   ;METROPOLITANA;49990;1;1;0;0;0;1;1;49990;ASPIRADORA ROBOT WIFI FIDDLER HOME BLANCA;ELECTRODOMESTICOS
16453339;;M;35;CHILENO;;Millenial;PROVIDENCIA                   ;METROPOLITANA;32990;1;1;0;0;0;1;1;32990;Licuadora Osterizer 4112/72 1,25Lts Vaso Vidrio;ELECTRODOMESTICOS
16946324;;M;34;CHILENO;;Millenial;PROVIDENCIA                   ;METROPOLITANA;40980;2;1;0;0;0;2;1;40980;Plancha UT-KERAMIKTOP 2200Watts Base Ceramica;ELECTRODOMESTICOS
6569357;Casado;F;70;CHILENO;;Silencioso;RENCA                         ;METROPOLITANA;18990;1;1;0;0;0;1;1;18990;Batidora Manual TH-8830;ELECTRODOMESTICOS
5045254;;F;77;CHILENO;;Silencioso;PROVIDENCIA                   ;METROPOLITANA;31990;1;1;0;0;0;1;1;31990;HORNO ELECTRICO 16N01 16LTS NEGRO;ELECTRODOMESTICOS
11174368;;M;55;CHILENO;;Boomers;TALCA                         ;MAULE;129990;1;1;0;0;0;1;1;129990;Horno Electrico TH-80i 80Lts;ELECTRODOMESTICOS
8847672;;F;59;CHILENO;;Boomers;PROVIDENCIA                   ;METROPOLITANA;84990;1;1;0;0;0;1;1;84990;Horno Electrico UT-BACKOFEN48 48Lts;ELECTRODOMESTICOS
11077605;;F;55;CHILENO;;Boomers;CURARREHUE                    ;ARAUCANIA;109980;2;1;0;0;0;2;1;109980;Horno Electrico UT-BACKOFEN48 48Lts;ELECTRODOMESTICOS
4929046;;F;77;CHILENO;;Silencioso;CARTAGENA                     ;VALPARAISO;104980;2;2;0;0;0;2;2;104980;Horno Electrico TH-38N 38Lts;ELECTRODOMESTICOS
12320775;;F;49;CHILENO;;X;IQUIQUE                       ;TARAPACA;91540;2;1;2;1;91540;0;0;0;Horno Microondas Digital MS28F303TAS/ZS 28Lts;ELECTRODOMESTICOS
13721914;;F;43;CHILENO;;X;PROVIDENCIA                   ;METROPOLITANA;47982;2;2;0;0;0;2;2;47982;Hervidor Electrico TH-5407i 2Lts;ELECTRODOMESTICOS
9480681;Casado;F;59;CHILENO;;Boomers;MELIPILLA                     ;METROPOLITANA;26990;1;1;0;0;0;1;1;26990;Hervidor Electrico UT-REIN17SS;ELECTRODOMESTICOS
8638325;;F;62;CHILENO;;Boomers;SANTIAGO                      ;METROPOLITANA;194970;3;2;0;0;0;3;2;194970;Maquina de Coser ME9100;ELECTRODOMESTICOS
22265861;;F;49;PERUANO;;Extranjero;LAS CONDES                    ;METROPOLITANA;992930;9;4;4;2;478970;5;2;513960;LICUADORA CROMADA CON TECLAS PLUS;ELECTRODOMESTICOS
17253675;;M;32;CHILENO;;Silencioso;PROVIDENCIA                   ;METROPOLITANA;24990;1;1;1;1;24990;0;0;0;Combo Licuadora + Batidora;ELECTRODOMESTICOS
17549836;;M;30;CHILENO;;Millenial;PROVIDENCIA                   ;METROPOLITANA;20990;1;1;0;0;0;1;1;20990;Hervidor Electrico HE420 2lts Negro;ELECTRODOMESTICOS
26361744;;M;42;VENEZOLANO;;Extranjero;N/D;N/D;39990;1;1;1;1;39990;0;0;0;Horno Electrico TH-25N01 25Lts;ELECTRODOMESTICOS
19978016;;F;23;CHILENO;;Z;PROVIDENCIA                   ;METROPOLITANA;49990;1;1;0;0;0;1;1;49990;Freidora de Aire 18M Oster;ELECTRODOMESTICOS
18659545;;F;28;CHILENO;;Millenial;VINA DEL MAR                  ;VALPARAISO;29980;2;1;2;1;29980;0;0;0;Licuadora Roja 550W 1,5Lts Vaso Vidrio;ELECTRODOMESTICOS
19875451;;M;24;CHILENO;;Z;PLACILLA                      ;L.G.B.OÂ´HIGGINS;14990;1;1;0;0;0;1;1;14990;HERVIDOR TH-4340;ELECTRODOMESTICOS
9623291;;F;59;CHILENO;;Boomers;COLLIPULLI                    ;ARAUCANIA;94970;3;2;0;0;0;3;2;94970;Hervidor Electrico Tetera UT-LECKER18R 1,8Lts;ELECTRODOMESTICOS
8127100;;M;64;CHILENO;;Boomers;RENCA                         ;METROPOLITANA;28980;2;1;2;1;28980;0;0;0;HORNO 10 LITROS OSTER ROJO;ELECTRODOMESTICOS
5628479;;F;75;CHILENO;;Silencioso;OVALLE                        ;COQUIMBO;22990;1;1;0;0;0;1;1;22990;Batidora Manual BA-5010 Inox;ELECTRODOMESTICOS
8099534;;F;74;CHILENO;;Silencioso;CURICO                        ;MAULE;64990;1;1;0;0;0;1;1;64990;Horno Microondas Mecanico UT-SYDNEY18 18Lts;ELECTRODOMESTICOS
7146959;;F;65;CHILENO;;Boomers;SANTA CRUZ                    ;L.G.B.OÂ´HIGGINS;44990;1;1;0;0;0;1;1;44990;Freidora de Aire 18M Oster;ELECTRODOMESTICOS
17391353;;F;32;CHILENO;;Millenial;MAIPU;METROPOLITANA;138220;6;2;6;2;138220;0;0;0;BATIDORA PLANETARIA BP-4500 BL;ELECTRODOMESTICOS
10662951;;M;48;CHILENO;;X;CALAMA                        ;ANTOFAGASTA;84990;3;1;0;0;0;3;1;84990;Horno Electrico TH-38N 38Lts;ELECTRODOMESTICOS
12572830;;M;47;CHILENO;;X;PROVIDENCIA                   ;METROPOLITANA;14990;1;1;0;0;0;1;1;14990;HERVIDOR TH-4340;ELECTRODOMESTICOS
16288034;;F;36;CHILENO;;Millenial;PROVIDENCIA                   ;METROPOLITANA;99970;3;1;0;0;0;3;1;99970;Horno Microondas Mecanico M-2030 NG 20Lts;ELECTRODOMESTICOS
14537694;Casado;M;43;CHILENO;TECNICO EN CONSTRUCCION;X;PROVIDENCIA                   ;METROPOLITANA;187960;4;2;4;2;187960;0;0;0;Horno Microondas Digital MS28F303TAS/ZS 28Lts;ELECTRODOMESTICOS
6992760;;M;69;CHILENO;;Silencioso;PROVIDENCIA                   ;METROPOLITANA;74970;3;1;0;0;0;3;1;74970;BATIDORA INMERSION S MIX 2616;ELECTRODOMESTICOS
19141951;Soltero;F;27;CHILENO;;Z;PROVIDENCIA                   ;METROPOLITANA;19990;1;1;0;0;0;1;1;19990;Hervidor Electrico TH-5407i 2Lts;ELECTRODOMESTICOS
12016149;;M;41;CHILENO;;X;PADRE LAS CASAS               ;ARAUCANIA;44990;1;1;1;1;44990;0;0;0;Freidora de Aire 18M Oster;ELECTRODOMESTICOS
18547371;;M;29;CHILENO;;Millenial;N/D;N/D;279980;2;2;0;0;0;2;2;279980;Hervidor Electrico UT-DUNKEL17P 2Lts Negro;ELECTRODOMESTICOS
6158214;;M;70;CHILENO;;Silencioso;LA GRANJA                     ;METROPOLITANA;64980;2;1;0;0;0;2;1;64980;Horno Microondas Mecanico TH-18B05 18Lts;ELECTRODOMESTICOS
18334435;;F;29;CHILENO;;Millenial;RENGO                         ;L.G.B.OÂ´HIGGINS;109990;1;1;0;0;0;1;1;109990;Horno Electrico TH-80i 80Lts;ELECTRODOMESTICOS
15370845;;M;39;CHILENO;;Millenial;"";"";173980;2;1;2;1;173980;0;0;0;Horno Electrico TH-100i 100Lts;ELECTRODOMESTICOS
5635922;;M;75;CHILENO;;Silencioso;EL BOSQUE                     ;METROPOLITANA;131860;4;3;0;0;0;4;3;131860;Aspiradora Tambor APA1000 1000Watts;ELECTRODOMESTICOS
25836557;;M;36;HAITIANO;;Extranjero;N/D;N/D;54990;1;1;0;0;0;1;1;54990;Horno Microondas Mecanico TH-18B05 18Lts;ELECTRODOMESTICOS
8924106;;F;80;CHILENO;;Silencioso;COIHAIQUE                     ;AYSEN;37670;2;1;0;0;0;2;1;37670;Licuadora L2000VNG 1,5Lts Vaso Vidrio;ELECTRODOMESTICOS
17912618;;F;30;CHILENO;;Millenial;LEBU                          ;BIO BIO;52670;2;1;0;0;0;2;1;52670;Aspiradora AP1700 Arrastre 1700Watts;ELECTRODOMESTICOS
25392280;;M;38;HAITIANO;;Extranjero;QUINTA NORMAL                 ;METROPOLITANA;17990;1;1;0;0;0;1;1;17990;Hervidor Electrico TH-4515N 2Lts Negro;ELECTRODOMESTICOS
8794330;;F;60;CHILENO;;Boomers;LA CRUZ                       ;VALPARAISO;9990;1;1;0;0;0;1;1;9990;Exprimidor Fauna 500 cc;ELECTRODOMESTICOS
18208775;;F;30;CHILENO;;Millenial;PROVIDENCIA                   ;METROPOLITANA;41980;2;1;0;0;0;2;1;41980;Licuadora L2000VNG 1,5Lts Vaso Vidrio;ELECTRODOMESTICOS
5918403;;F;75;CHILENO;;Silencioso;VALDIVIA                      ;LOS RIOS;27990;1;1;0;0;0;1;1;27990;Plancha THOMAS TH-7170 2200Watts Base Ceramica;ELECTRODOMESTICOS
12256089;;F;50;CHILENO;;X;CERRO NAVIA                   ;METROPOLITANA;79979;2;1;0;0;0;2;1;79979;Horno Microondas Digital TH20DM 20Lts Espejado;ELECTRODOMESTICOS
7162534;;F;69;CHILENO;;Silencioso;MALLOA                        ;L.G.B.OÂ´HIGGINS;47990;1;1;0;0;0;1;1;47990;Picadora TH-9020V Vaso Vidrio 2Lts;ELECTRODOMESTICOS
5959032;Casado;M;73;CHILENO;;Silencioso;RENCA                         ;METROPOLITANA;23570;2;1;0;0;0;2;1;23570;HERVIDOR TH-4340;ELECTRODOMESTICOS
15145026;;M;40;CHILENO;;X;CONSTITUCION                  ;MAULE;19990;1;1;0;0;0;1;1;19990;Hervidor Electrico TH-5407i 2Lts;ELECTRODOMESTICOS
10599298;;M;57;CHILENO;;Boomers;PROVIDENCIA                   ;METROPOLITANA;19990;1;1;0;0;0;1;1;19990;Batidora Manual UT-TEKLA300;ELECTRODOMESTICOS
17524022;;F;30;CHILENO;;Millenial;N/D;N/D;42660;3;2;0;0;0;3;2;42660;Batidora Manual 3532;ELECTRODOMESTICOS
13494300;;F;45;CHILENO;;X;NUEVA IMPERIAL                ;ARAUCANIA;12990;1;1;0;0;0;1;1;12990;Batidora Vertical Stick Mixer 2609;ELECTRODOMESTICOS
4454156;;F;84;CHILENO;;Silencioso;LA CISTERNA                   ;METROPOLITANA;38670;2;1;0;0;0;2;1;38670;Licuadora L-1630V Negra 1,5Lts Vaso Vidrio;ELECTRODOMESTICOS
16757801;;F;34;CHILENO;;Millenial;PROVIDENCIA                   ;METROPOLITANA;187830;17;4;15;3;122850;2;1;64980;Procesador TH-9010 Multimixer 1,5Lts Vaso Vidrio;ELECTRODOMESTICOS
17917026;;M;30;CHILENO;;Millenial;CONCEPCION;BIO-BIO;85840;2;1;2;1;85840;0;0;0;Aspiradora AS 4050 Sin Bolsa 800 Watt 2Lt;ELECTRODOMESTICOS
8633024;;F;75;CHILENO;;Silencioso;HUALPEN;BIO BIO;73170;2;1;0;0;0;2;1;73170;Horno Electrico TH-38N 38Lts;ELECTRODOMESTICOS
6542619;;M;69;CHILENO;;Silencioso;LA SERENA                     ;COQUIMBO;21990;1;1;0;0;0;1;1;21990;Plancha UT-KERAMIK1 2200Watts Base Ceramica;ELECTRODOMESTICOS
6936186;;F;64;CHILENO;;Boomers;PROVIDENCIA                   ;METROPOLITANA;59980;2;1;0;0;0;2;1;59980;Licuadora TH-401V Roja 1,75Lts Vaso Vidrio;ELECTRODOMESTICOS
9370045;;F;45;CHILENO;;Millenial;"";"";89980;2;1;0;0;0;2;1;89980;Horno Electrico TH-38N 38Lts;ELECTRODOMESTICOS
18885423;;F;28;CHILENO;;Millenial;LANCO                         ;LOS RIOS;24990;1;1;0;0;0;1;1;24990;Licuadora Roja 550W 1,5Lts Vaso Vidrio;ELECTRODOMESTICOS
18259996;;M;29;CHILENO;;Millenial;QUIRIHUE;BIO-BIO;38990;1;1;1;1;38990;0;0;0;Picadora TH-9020V Vaso Vidrio 2Lts;ELECTRODOMESTICOS
12156658;;F;46;CHILENO;;X;RENCA                         ;METROPOLITANA;59992;1;2;0;0;0;1;2;59992;Horno Microondas Mecanico M-2030 NG 20Lts;ELECTRODOMESTICOS
17401123;Soltero;F;33;CHILENO;;Millenial;PROVIDENCIA                   ;METROPOLITANA;93270;2;1;0;0;0;2;1;93270;Horno Electrico TH-48N 48Lts;ELECTRODOMESTICOS
10442648;;F;54;CHILENO;;X;LA SERENA                     ;COQUIMBO;78270;2;1;0;0;0;2;1;78270;Aspiradora TH1870 Arrastre 1800Watts Gris;ELECTRODOMESTICOS
14709170;Casado;M;39;CHILENO;INGENIERO COMERCIAL;X;PROVIDENCIA                   ;METROPOLITANA;93980;2;1;2;1;93980;0;0;0;Horno Pizza FDV Napoles;ELECTRODOMESTICOS
17138950;;M;32;CHILENO;;Millenial;DONIHUE                       ;L.G.B.OÂ´HIGGINS;192410;4;2;3;1;144530;1;1;47880;Cafetera P65 Silver;ELECTRODOMESTICOS
6302153;Soltero;M;70;CHILENO;;Silencioso;SAN FELIPE                    ;VALPARAISO;169990;1;1;0;0;0;1;1;169990;ASPIRADORA ROBOT VR05R5050WK/ZS;ELECTRODOMESTICOS
19624065;;F;24;CHILENO;;Z;PROVIDENCIA                   ;METROPOLITANA;124990;1;1;0;0;0;1;1;124990;FREIDORA DE AIRE THOMAS TH-AF60Mi;ELECTRODOMESTICOS
16373978;;F;36;CHILENO;;X;PROVIDENCIA                   ;METROPOLITANA;26990;1;1;0;0;0;1;1;26990;Licuadora UT-METALLEK505P 1,5Lts Vaso Vidrio;ELECTRODOMESTICOS
6016089;;F;75;CHILENO;;Silencioso;PROVIDENCIA                   ;METROPOLITANA;19990;1;1;0;0;0;1;1;19990;Hervidor Electrico TH-5407i 2Lts;ELECTRODOMESTICOS
16447702;;M;35;CHILENO;;Millenial;SAN IGNACIO                   ;BIO BIO;32990;1;1;0;0;0;1;1;32990;Hervidor Electrico Tetera HA-4100 4Lts Iox;ELECTRODOMESTICOS
15522366;;F;37;CHILENO;;Millenial;PROVIDENCIA                   ;METROPOLITANA;79990;1;1;0;0;0;1;1;79990;Batidora Pedestal TH910PN 4,6Lts 1300Watts;ELECTRODOMESTICOS
14116042;;F;40;CHILENO;;X;PROVIDENCIA                   ;METROPOLITANA;151270;2;1;0;0;0;2;1;151270;Maquina de Coser JS-2135CL Calipso;ELECTRODOMESTICOS
4346325;;M;80;CHILENO;;Silencioso;RENCA                         ;METROPOLITANA;14990;1;1;0;0;0;1;1;14990;Batidora Manual 3532;ELECTRODOMESTICOS
6670840;Casado;M;64;CHILENO;INGENIERO FORESTAL;Boomers;RENCA                         ;METROPOLITANA;17990;1;1;0;0;0;1;1;17990;Hervidor Electrico UT-KLAR20PW 2Lts Blanco;ELECTRODOMESTICOS
7779118;;F;62;CHILENO;;Boomers;CORONEL                       ;BIO BIO;54990;1;1;0;0;0;1;1;54990;Olla Arrocera Multiuso Oster 7129S;ELECTRODOMESTICOS
4896546;;M;78;CHILENO;;Silencioso;PROVIDENCIA                   ;METROPOLITANA;14990;1;1;0;0;0;1;1;14990;HERVIDOR TH-4340;ELECTRODOMESTICOS
16662460;Casado;M;34;CHILENO;TECNOLOGO MEDICO;Millenial;PROVIDENCIA                   ;METROPOLITANA;52980;2;3;0;0;0;2;3;52980;Licuadora L2000VNG 1,5Lts Vaso Vidrio;ELECTRODOMESTICOS
17833285;;M;31;CHILENO;;Millenial;"";"";24990;1;1;0;0;0;1;1;24990;Parrilla Electrica TH-180;ELECTRODOMESTICOS
16327490;;F;36;CHILENO;;Millenial;PROVIDENCIA                   ;METROPOLITANA;29990;1;1;0;0;0;1;1;29990;Combo Hervidor + Tostador + Sandwichera;ELECTRODOMESTICOS
18193867;;M;30;CHILENO;;Millenial;N/D;N/D;84980;2;1;0;0;0;2;1;84980;Parrilla Electrica TH-224;ELECTRODOMESTICOS
18286266;;M;29;CHILENO;;Extranjero;N/D;N/D;64980;2;2;0;0;0;2;2;64980;PROCESADOR THOMAS TH-9160;ELECTRODOMESTICOS
17124138;;F;33;CHILENO;;Millenial;ANCUD                         ;LOS LAGOS;67980;2;2;0;0;0;2;2;67980;Combo Hervidor + Tostador + Sandwichera;ELECTRODOMESTICOS
15474680;;F;39;CHILENO;;X;PENALOLEN                     ;METROPOLITANA;40840;2;1;2;1;40840;0;0;0;Aspiradora TH1407 Arrastre 1400Watts;ELECTRODOMESTICOS
9585023;;F;60;CHILENO;;Boomers;PUENTE ALTO                   ;METROPOLITANA;52980;2;1;0;0;0;2;1;52980;Aspiradora TH1407 Arrastre 1400Watts;ELECTRODOMESTICOS
11310208;;F;54;CHILENO;;Boomers;CALBUCO                       ;LOS LAGOS;48980;2;2;0;0;0;2;2;48980;Tostador de PanTH-120R 2 Rebanadas Rojo;ELECTRODOMESTICOS
4769540;;F;79;CHILENO;;Silencioso;CORONEL                       ;BIO BIO;18990;1;1;0;0;0;1;1;18990;Plancha UT-DUNST 2200Watts Base Ceramica;ELECTRODOMESTICOS
7714767;;F;66;CHILENO;;Boomers;N/D;N/D;146970;3;1;0;0;0;3;1;146970;Horno Electrico TH62I 60Lts;ELECTRODOMESTICOS
14343372;;M;44;CHILENO;;X;PROVIDENCIA                   ;METROPOLITANA;28980;2;1;2;1;28980;0;0;0;Licuadora Roja 550W 1,5Lts Vaso Vidrio;ELECTRODOMESTICOS
12818451;;M;47;CHILENO;;X;CALERA                        ;VALPARAISO;89980;2;1;0;0;0;2;1;89980;Horno Microondas Digital MS23K3513AK/ZS 23Lts;ELECTRODOMESTICOS
8526017;;F;63;CHILENO;;Boomers;PLACILLA                      ;L.G.B.OÂ´HIGGINS;12990;1;1;0;0;0;1;1;12990;Batidora Vertical Stick Mixer 2609;ELECTRODOMESTICOS
13139695;;F;50;CHILENO;;X;PROVIDENCIA                   ;METROPOLITANA;62980;2;1;0;0;0;2;1;62980;PROCESADOR THOMAS TH-9160;ELECTRODOMESTICOS
8700272;;F;64;CHILENO;;Boomers;LA SERENA                     ;COQUIMBO;54990;1;1;0;0;0;1;1;54990;Horno Microondas Mecanico UT-SYDNEY18 18Lts;ELECTRODOMESTICOS
15646231;;F;34;CHILENO;;Millenial;PROVIDENCIA                   ;METROPOLITANA;34990;1;3;0;0;0;1;3;34990;Licuadora TH-501V 1,5Lts Vaso Vidrio;ELECTRODOMESTICOS
17372773;;F;32;CHILENO;;Millenial;PROVIDENCIA                   ;METROPOLITANA;14990;1;1;0;0;0;1;1;14990;Exprimidor de Jugo 407W 1Lts;ELECTRODOMESTICOS
9789188;;F;60;CHILENO;;Boomers;N/D;N/D;192640;5;2;0;0;0;5;2;192640;Horno Electrico TH-80i 80Lts;ELECTRODOMESTICOS
9431949;;M;61;CHILENO;;Boomers;RENCA                         ;METROPOLITANA;27990;1;1;0;0;0;1;1;27990;Combo Juguera + Hervidor;ELECTRODOMESTICOS
11340025;;F;54;CHILENO;;X;PUENTE ALTO                   ;METROPOLITANA;74990;1;1;0;0;0;1;1;74990;Batidora Pedestal UT-KLEIN700;ELECTRODOMESTICOS
12897855;;F;47;CHILENO;;Silencioso;PROVIDENCIA                   ;METROPOLITANA;33980;2;1;2;1;33980;0;0;0;Aspiradora Polvo AP-700 GR;ELECTRODOMESTICOS
10172519;;M;56;CHILENO;;Boomers;RENCA                         ;METROPOLITANA;14990;1;1;0;0;0;1;1;14990;Tostador de Pan TH-116 2 Rebanadas Negro;ELECTRODOMESTICOS
9916665;;F;57;CHILENO;;Silencioso;PROVIDENCIA                   ;METROPOLITANA;169990;1;1;0;0;0;1;1;169990;Horno Electrico TH-100i 100Lts;ELECTRODOMESTICOS
9186124;Divorciado;F;60;CHILENO;;Boomers;PROVIDENCIA                   ;METROPOLITANA;34990;1;1;0;0;0;1;1;34990;Licuadora TH-401V Roja 1,75Lts Vaso Vidrio;ELECTRODOMESTICOS
14279783;Casado;M;49;CHILENO;INGENIERO;X;N/D;N/D;39980;2;1;0;0;0;2;1;39980;Licuadora Personal TH-300PB;ELECTRODOMESTICOS
12172368;;F;49;CHILENO;;X;RENCA                         ;METROPOLITANA;29990;1;1;1;1;29990;0;0;0;Horno Electrico TH-25N01 25Lts;ELECTRODOMESTICOS
9271591;;F;57;CHILENO;;Boomers;PROVIDENCIA                   ;METROPOLITANA;49990;1;1;0;0;0;1;1;49990;Aspiradora VCC4190V3E/XZS Arrastre 2000Watts;ELECTRODOMESTICOS
17252938;Soltero;M;32;CHILENO;;Millenial;MAIPU                         ;METROPOLITANA;58980;2;1;2;1;58980;0;0;0;Horno Microondas Mecanico UT-SYDNEY18 18Lts;ELECTRODOMESTICOS
18547986;;F;28;CHILENO;;Millenial;PROVIDENCIA                   ;METROPOLITANA;143980;2;1;2;1;143980;0;0;0;Maquina de Coser 311;ELECTRODOMESTICOS
15238393;;F;40;CHILENO;;X;PROVIDENCIA                   ;METROPOLITANA;25990;1;1;0;0;0;1;1;25990;Combo Licuadora + Batidora;ELECTRODOMESTICOS
9131191;;F;58;CHILENO;;Boomers;PARRAL                        ;MAULE;227450;4;3;0;0;0;4;3;227450;Procesador TH-9010 Multimixer 1,5Lts Vaso Vidrio;ELECTRODOMESTICOS
16572995;;M;34;CHILENO;;Millenial;PROVIDENCIA                   ;METROPOLITANA;64990;1;1;0;0;0;1;1;64990;Aspiradora AP3400 Arrastre 2000Watts;ELECTRODOMESTICOS
11444219;;F;53;CHILENO;;X;SAN CARLOS                    ;BIO BIO;29990;1;1;0;0;0;1;1;29990;Licuadora TH-501V 1,5Lts Vaso Vidrio;ELECTRODOMESTICOS
12523954;Casado;F;49;CHILENO;ASISTENTE SOCIAL;X;RENCA                         ;METROPOLITANA;58670;2;1;0;0;0;2;1;58670;Horno Electrico TH-25N01 25Lts;ELECTRODOMESTICOS
24666288;;F;56;BOLIVIANO;;Extranjero;IQUIQUE                       ;TARAPACA;39980;2;2;0;0;0;2;2;39980;Hervidor Electrico UT-DUNKEL17P 2Lts Negro;ELECTRODOMESTICOS
11728408;;M;51;CHILENO;;X;LA LIGUA                      ;VALPARAISO;51670;2;1;0;0;0;2;1;51670;Aspiradora AP1700 Arrastre 1700Watts;ELECTRODOMESTICOS
9129551;;F;59;CHILENO;;Boomers;PROVIDENCIA                   ;METROPOLITANA;39990;1;1;1;1;39990;0;0;0;Aspiradora TH1415 Arrastre 1500Watts;ELECTRODOMESTICOS
11280271;;F;54;CHILENO;;X;PAREDONES                     ;L.G.B.OÂ´HIGGINS;26990;1;1;0;0;0;1;1;26990;Licuadora L2000VNG 1,5Lts Vaso Vidrio;ELECTRODOMESTICOS
12945280;;F;46;CHILENO;;X;QUINTA NORMAL                 ;METROPOLITANA;59990;1;1;0;0;0;1;1;59990;Horno Microondas Mecanico UT-SYDNEY18 18Lts;ELECTRODOMESTICOS
6610307;;F;78;CHILENO;;Silencioso;RENCA                         ;METROPOLITANA;17990;1;1;0;0;0;1;1;17990;Plancha a vapor 6052 Oster;ELECTRODOMESTICOS
6612612;Casado;F;69;CHILENO;;Silencioso;LONGAVI                       ;MAULE;29990;1;1;0;0;0;1;1;29990;Hervidor Electrico Tetera HA-4100 4Lts Iox;ELECTRODOMESTICOS
19704955;;M;25;CHILENO;;Z;PROVIDENCIA                   ;METROPOLITANA;43980;2;1;2;1;43980;0;0;0;Horno Microonda Columba 1700;ELECTRODOMESTICOS
16334247;Soltero;F;35;CHILENO;ASISTENTE SOCIAL;Millenial;PROVIDENCIA                   ;METROPOLITANA;28990;1;1;1;1;28990;0;0;0;Hervidor Electrico Tetera TH-6505RT 1,7Lts Rojo;ELECTRODOMESTICOS
7146083;;M;68;CHILENO;;Boomers;PROVIDENCIA                   ;METROPOLITANA;26990;1;1;0;0;0;1;1;26990;Licuadora Roja 550W 1,5Lts Vaso Vidrio;ELECTRODOMESTICOS
10949118;;M;55;CHILENO;;Boomers;VILCUN                        ;ARAUCANIA;12990;1;1;0;0;0;1;1;12990;Hervidor Acero Inoxidable 40989-CL Hamilton Beac;ELECTRODOMESTICOS
8287864;;F;63;CHILENO;;Boomers;N/D;N/D;99990;1;1;0;0;0;1;1;99990;Horno Electrico TH62I 60Lts;ELECTRODOMESTICOS
11733637;;M;51;CHILENO;;Silencioso;PROVIDENCIA                   ;METROPOLITANA;89990;1;1;1;1;89990;0;0;0;Horno Electrico TH-80i 80Lts;ELECTRODOMESTICOS
7636740;Casado;F;59;CHILENO;ASISTENTE SOCIAL;Boomers;ARICA                         ;TARAPACA;79990;1;1;0;0;0;1;1;79990;Enceradora EA-5000;ELECTRODOMESTICOS
14551656;;F;46;CHILENO;;X;N/D;N/D;19980;2;1;2;1;19980;0;0;0;Hervidor Family Kettle HE500;ELECTRODOMESTICOS
6030660;Casado;M;68;CHILENO;INGENIERO;Silencioso;PROVIDENCIA                   ;METROPOLITANA;133980;2;1;2;1;133980;0;0;0;Maquina de Coser JS-2135CL Calipso;ELECTRODOMESTICOS
14586745;;F;41;CHILENO;;X;PROVIDENCIA                   ;METROPOLITANA;48990;1;1;1;1;48990;0;0;0;ASPIRADORA THOMAS TH-1640;ELECTRODOMESTICOS
19623902;;F;24;CHILENO;;Z;PROVIDENCIA                   ;METROPOLITANA;33980;2;1;0;0;0;2;1;33980;Cafetera TH-130;ELECTRODOMESTICOS
15396634;;M;40;CHILENO;;X;PROVIDENCIA                   ;METROPOLITANA;109990;1;1;0;0;0;1;1;109990;Horno Electrico TH62I 60Lts;ELECTRODOMESTICOS
8180534;Casado;M;62;CHILENO;INGENIERO;Boomers;TALCA                         ;MAULE;34990;1;1;1;1;34990;0;0;0;ASPIRADORA THOMAS TH-1640;ELECTRODOMESTICOS
26060692;;M;41;VENEZOLANO;;Extranjero;N/D;N/D;27970;3;1;0;0;0;3;1;27970;Plancha a Vapor Oster 3803;ELECTRODOMESTICOS
9234436;;F;61;CHILENO;;Boomers;RENCA                         ;METROPOLITANA;47670;2;1;0;0;0;2;1;47670;LICUADORA CROMADA CON TECLAS PLUS;ELECTRODOMESTICOS
14260283;;F;50;CHILENO;;X;PROVIDENCIA                   ;METROPOLITANA;44990;1;1;1;1;44990;0;0;0;Horno Microondas Mecanico Easy Wave 20Lts;ELECTRODOMESTICOS
11447694;;F;52;CHILENO;;X;CHILLAN VIEJO                 ;BIO BIO;19990;1;1;0;0;0;1;1;19990;Hervidor Electrico TH-5407i 2Lts;ELECTRODOMESTICOS
13056881;;F;45;CHILENO;;X;LA FLORIDA                    ;METROPOLITANA;50980;2;1;2;1;50980;0;0;0;Batidora Pedestal Desmontable 64650-CL;ELECTRODOMESTICOS
18477489;;M;28;CHILENO;;Millenial;N/D;N/D;26990;1;1;0;0;0;1;1;26990;Hervidor Electrico Tetera UT-LECKER18R 1,8Lts;ELECTRODOMESTICOS
12306462;;F;49;CHILENO;;X;PROVIDENCIA                   ;METROPOLITANA;31980;2;1;0;0;0;2;1;31980;HERVIDOR ELECTRICO UT-STARK18;ELECTRODOMESTICOS
19233423;;F;26;CHILENO;;Z;VINA DEL MAR                  ;VALPARAISO;35240;2;2;0;0;0;2;2;35240;Batidora Vertical Minipimer UT-KLOT400P;ELECTRODOMESTICOS
19120057;;M;26;CHILENO;;Z;"";"";24990;1;1;0;0;0;1;1;24990;Licuadora L2000VNG 1,5Lts Vaso Vidrio;ELECTRODOMESTICOS
15755554;;F;37;CHILENO;;Millenial;SAN JAVIER                    ;MAULE;64980;2;1;0;0;0;2;1;64980;Horno Electrico UT-BACKOFEN26 26Lts;ELECTRODOMESTICOS
17725361;;M;31;CHILENO;;Millenial;PROVIDENCIA                   ;METROPOLITANA;49990;1;1;1;1;49990;0;0;0;Horno Microondas Digital TH-20S01 20Lts;ELECTRODOMESTICOS
6960466;;F;68;CHILENO;;Silencioso;TENO                          ;MAULE;17990;1;1;0;0;0;1;1;17990;Hervidor Electrico TH-4515N 2Lts Negro;ELECTRODOMESTICOS
6586429;;F;69;CHILENO;;Silencioso;COLLIPULLI                    ;ARAUCANIA;219980;2;1;0;0;0;2;1;219980;Horno Electrico UT-BACKOFEN60 60Lts;ELECTRODOMESTICOS
6465431;;F;70;CHILENO;;Silencioso;NATALES                       ;MAGALLANES;25990;1;1;0;0;0;1;1;25990;Plancha UT-KERAMIKTOP 2200Watts Base Ceramica;ELECTRODOMESTICOS
8122469;Casado;M;63;CHILENO;;Boomers;PROVIDENCIA                   ;METROPOLITANA;62810;4;1;0;0;0;4;1;62810;Batidora Pedestal B5300 Inox;ELECTRODOMESTICOS
18803845;;F;28;CHILENO;;Millenial;QUILLECO                      ;BIO BIO;44970;3;2;0;0;0;3;2;44970;Exprimidor Fauna 500 cc;ELECTRODOMESTICOS
19798626;;F;23;CHILENO;;Z;PROVIDENCIA                   ;METROPOLITANA;14240;2;1;0;0;0;2;1;14240;Batidora Vertical Stick Mixer 2609;ELECTRODOMESTICOS
7043538;;F;64;CHILENO;;Boomers;TALAGANTE                     ;METROPOLITANA;25990;1;1;0;0;0;1;1;25990;Combo Licuadora + Batidora;ELECTRODOMESTICOS
18808628;Soltero;F;28;CHILENO;;Silencioso;PROVIDENCIA                   ;METROPOLITANA;39990;1;1;1;1;39990;0;0;0;Parrilla Electrica TH-224;ELECTRODOMESTICOS
5389971;;F;78;CHILENO;;Silencioso;PROVIDENCIA                   ;METROPOLITANA;19990;1;1;0;0;0;1;1;19990;Licuadora Berry Blender Roja 1400 Vaso Vidrio;ELECTRODOMESTICOS
17181805;;F;34;CHILENO;;Millenial;MARCHIHUE                     ;L.G.B.OÂ´HIGGINS;74990;1;1;0;0;0;1;1;74990;Cafetera P65 Silver;ELECTRODOMESTICOS
20135653;;M;23;CHILENO;;Z;N/D;N/D;143960;4;4;1;1;49990;3;3;93970;Aspiradora VCC4190V3E/XZS Arrastre 2000Watts;ELECTRODOMESTICOS
19616327;;F;25;CHILENO;;Z;SANTA CRUZ                    ;L.G.B.OÂ´HIGGINS;19990;1;1;0;0;0;1;1;19990;Licuadora Berry Blender Roja 1400 Vaso Vidrio;ELECTRODOMESTICOS
18436296;;F;29;CHILENO;;Millenial;PROVIDENCIA                   ;METROPOLITANA;86980;2;1;0;0;0;2;1;86980;Horno Electrico TH-38N 38Lts;ELECTRODOMESTICOS
6112594;;F;72;CHILENO;;Silencioso;TIERRA AMARILLA               ;ATACAMA;94980;2;2;0;0;0;2;2;94980;BATIDORA INMERSION S MIX 2616;ELECTRODOMESTICOS
17586515;;M;31;CHILENO;;Silencioso;PROVIDENCIA                   ;METROPOLITANA;203980;2;1;2;1;203980;0;0;0;Apiradora Mi Robot Vacuum-Mop XIAOMI;ELECTRODOMESTICOS
10143183;;F;55;CHILENO;;Boomers;PROVIDENCIA                   ;METROPOLITANA;79990;1;1;0;0;0;1;1;79990;Horno Electrico TH-48N 48Lts;ELECTRODOMESTICOS
12700069;;F;48;CHILENO;;X;ANGOL                         ;ARAUCANIA;189949;5;2;0;0;0;5;2;189949;Horno Microondas Digital TH-20S01 20Lts;ELECTRODOMESTICOS
7285655;;F;68;CHILENO;;Silencioso;OVALLE                        ;COQUIMBO;44990;1;1;0;0;0;1;1;44990;Horno Electrico TH-25N01 25Lts;ELECTRODOMESTICOS
12780850;;F;46;CHILENO;;X;MOLINA                        ;MAULE;20000;2;1;0;0;0;2;1;20000;Hervidor Electrico TH-5407i 2Lts;ELECTRODOMESTICOS
6979426;;F;68;CHILENO;;Silencioso;PROVIDENCIA                   ;METROPOLITANA;29990;1;1;0;0;0;1;1;29990;Licuadora Personal TH-300PB;ELECTRODOMESTICOS
18206043;;F;30;CHILENO;;Millenial;CALBUCO                       ;LOS LAGOS;49990;1;1;0;0;0;1;1;49990;Horno Microondas Digital TH-20S01 20Lts;ELECTRODOMESTICOS
9083702;;M;60;CHILENO;;Boomers;N/D;N/D;99990;1;1;0;0;0;1;1;99990;Horno Electrico UT-BACKOFEN60 60Lts;ELECTRODOMESTICOS
10042292;;F;58;CHILENO;;Boomers;QUILPUE                       ;VALPARAISO;18990;1;1;0;0;0;1;1;18990;Combo Hervidor + Batidora;ELECTRODOMESTICOS
19329463;;M;25;CHILENO;;Silencioso;PROVIDENCIA                   ;METROPOLITANA;29990;1;1;1;1;29990;0;0;0;Horno Electrico TH-25N01 25Lts;ELECTRODOMESTICOS
25239184;;F;44;COLOMBIANO;;Extranjero;PENCO                         ;BIO BIO;9093;1;1;0;0;0;1;1;9093;Sandwichera TH-952 2 Panes Blanca;ELECTRODOMESTICOS
13803716;;F;42;CHILENO;;X;ARAUCO                        ;BIO BIO;39990;1;1;1;1;39990;0;0;0;Horno Microondas Mecanico Easy Wave 20Lts;ELECTRODOMESTICOS
15024635;;M;39;CHILENO;;X;PROVIDENCIA                   ;METROPOLITANA;497450;4;2;0;0;0;4;2;497450;Maquina de Coser 311;ELECTRODOMESTICOS
8748842;Soltero;F;65;CHILENO;;Boomers;RENCA                         ;METROPOLITANA;68660;3;1;0;0;0;3;1;68660;Horno Microondas Mecanico Easy Wave 20Lts;ELECTRODOMESTICOS
8920462;;F;70;CHILENO;;Silencioso;LOS ALAMOS                    ;BIO BIO;18990;1;1;0;0;0;1;1;18990;Batidora Manual TH-8830;ELECTRODOMESTICOS
10305229;;F;56;CHILENO;;Boomers;RENCA                         ;METROPOLITANA;109990;1;1;0;0;0;1;1;109990;Horno Electrico UT-BACKOFEN60 60Lts;ELECTRODOMESTICOS
10104448;;F;57;CHILENO;;Boomers;BUIN                          ;METROPOLITANA;44990;1;1;0;0;0;1;1;44990;Horno Microondas Mecanico Easy Wave 20Lts;ELECTRODOMESTICOS
13452101;;M;43;CHILENO;;X;MAIPU                         ;METROPOLITANA;14990;1;1;0;0;0;1;1;14990;Batidora Vertical Stick Mixer 2609;ELECTRODOMESTICOS
25813743;;F;30;COLOMBIANO;;Extranjero;CALAMA                        ;ANTOFAGASTA;16990;1;1;0;0;0;1;1;16990;Plancha a vapor 6052 Oster;ELECTRODOMESTICOS
19084142;;F;26;CHILENO;;Silencioso;PROVIDENCIA                   ;METROPOLITANA;79990;1;1;1;1;79990;0;0;0;Cafetera P65 Silver;ELECTRODOMESTICOS
16702360;;F;34;CHILENO;;Millenial;SAN FELIPE                    ;VALPARAISO;9990;1;1;0;0;0;1;1;9990;Exprimidor de Jugo CJ-2000 1Lts;ELECTRODOMESTICOS
7590046;;F;69;CHILENO;;Silencioso;PROVIDENCIA                   ;METROPOLITANA;44990;1;1;0;0;0;1;1;44990;Horno Electrico TH-25N01 25Lts;ELECTRODOMESTICOS
9138984;;F;63;CHILENO;;Boomers;PROVIDENCIA                   ;METROPOLITANA;24990;1;1;0;0;0;1;1;24990;BATIDORA INMERSION S MIX 2616;ELECTRODOMESTICOS
8055321;;M;66;CHILENO;;Boomers;RENCA                         ;METROPOLITANA;59990;1;1;0;0;0;1;1;59990;Horno Microondas Mecanico Fancy 20Lts;ELECTRODOMESTICOS
13898303;;F;42;CHILENO;;X;CHEPICA                       ;L.G.B.OÂ´HIGGINS;89990;1;1;1;1;89990;0;0;0;Horno Electrico TH-80i 80Lts;ELECTRODOMESTICOS
12011498;Soltero;F;54;CHILENO;;Boomers;PROVIDENCIA                   ;METROPOLITANA;32990;1;1;0;0;0;1;1;32990;Hervidor Electrico Tetera HA-4100 4Lts Iox;ELECTRODOMESTICOS
9648264;;F;58;CHILENO;;Boomers;PROVIDENCIA                   ;METROPOLITANA;24670;2;1;0;0;0;2;1;24670;Combo Juguera + Hervidor;ELECTRODOMESTICOS
9538853;Casado;F;58;CHILENO;;Boomers;RENCA                         ;METROPOLITANA;21990;1;1;0;0;0;1;1;21990;Licuadora L-1630V Negra 1,5Lts Vaso Vidrio;ELECTRODOMESTICOS
15575597;;F;38;CHILENO;;Millenial;PROVIDENCIA                   ;METROPOLITANA;42540;2;1;2;1;42540;0;0;0;Aspiradora TH1407 Arrastre 1400Watts;ELECTRODOMESTICOS
10837519;;M;53;CHILENO;;X;OVALLE                        ;COQUIMBO;34990;1;1;0;0;0;1;1;34990;Aspiradora TH1407 Arrastre 1400Watts;ELECTRODOMESTICOS
18267935;;F;29;CHILENO;;Millenial;PROVIDENCIA                   ;METROPOLITANA;12990;1;1;1;1;12990;0;0;0;Exprimidor de Jugo CJ-2000 1Lts;ELECTRODOMESTICOS
27329637;;M;30;CHILENO;;Extranjero;N/D;N/D;61980;2;1;0;0;0;2;1;61980;Freidora de Aire 18M Oster;ELECTRODOMESTICOS
18894628;Soltero;M;29;CHILENO;;Millenial;CONSTITUCION                  ;MAULE;18990;1;1;0;0;0;1;1;18990;Hervidor Electrico TH-4515N 2Lts Negro;ELECTRODOMESTICOS
4711121;;M;81;CHILENO;;Silencioso;MAULE                         ;MAULE;44990;1;1;0;0;0;1;1;44990;Picadora TH-9020V Vaso Vidrio 2Lts;ELECTRODOMESTICOS
6824653;Soltero;M;64;CHILENO;;Boomers;RENCA                         ;METROPOLITANA;29990;1;1;0;0;0;1;1;29990;PLANCHA A VAPOR 6953 BASE AEROCERAMICA AUTAPA.22;ELECTRODOMESTICOS
13225884;;M;45;CHILENO;;X;RENCA                         ;METROPOLITANA;59990;1;1;0;0;0;1;1;59990;Horno Electrico HE-300NG 30Lts;ELECTRODOMESTICOS
7609591;;F;65;CHILENO;;Extranjero;QUILPUE                       ;VALPARAISO;39990;1;1;0;0;0;1;1;39990;Picadora TH-9020V Vaso Vidrio 2Lts;ELECTRODOMESTICOS
9123258;;F;61;CHILENO;;Boomers;PUERTO MONTT                  ;LOS LAGOS;74990;2;1;0;0;0;2;1;74990;Horno Electrico TH-48N 48Lts;ELECTRODOMESTICOS
11166532;;F;55;CHILENO;;Boomers;PROVIDENCIA                   ;METROPOLITANA;22990;1;1;0;0;0;1;1;22990;ARROCERA ROJA 4723;ELECTRODOMESTICOS
5229200;;F;81;CHILENO;;Silencioso;LO ESPEJO                     ;METROPOLITANA;12990;1;1;0;0;0;1;1;12990;Exprimidor de Jugo CJ-2000 1Lts;ELECTRODOMESTICOS
27141108;;M;33;VENEZOLANO;;Extranjero;N/D;N/D;93980;2;1;2;1;93980;0;0;0;Mi Vacuum Cleaner Light -29761;ELECTRODOMESTICOS
8918323;;F;60;CHILENO;;Boomers;LIMACHE                       ;VALPARAISO;111980;2;1;0;0;0;2;1;111980;Horno Electrico TH62I 60Lts;ELECTRODOMESTICOS
11224234;;M;54;CHILENO;;X;MELIPILLA                     ;METROPOLITANA;52990;1;1;0;0;0;1;1;52990;Horno Microondas Mecanico Easy Wave 20Lts;ELECTRODOMESTICOS
11563421;;F;51;CHILENO;;X;SAN JAVIER                    ;MAULE;118163;3;2;0;0;0;3;2;118163;Horno Electrico TH62I 60Lts;ELECTRODOMESTICOS
15159558;;M;39;CHILENO;;X;TREGUACO                      ;BIO BIO;31990;1;1;0;0;0;1;1;31990;Licuadora Roja 550W 1,5Lts Vaso Vidrio;ELECTRODOMESTICOS
7535496;Divorciado;M;66;CHILENO;;Boomers;OLMUE                         ;VALPARAISO;25990;1;1;0;0;0;1;1;25990;Combo Licuadora + Batidora;ELECTRODOMESTICOS
15485241;;F;39;CHILENO;;X;"";"";143980;2;1;2;1;143980;0;0;0;SUPER FREIDORA DE AIRE OV3;ELECTRODOMESTICOS
19452534;;F;43;CHILENO;;X;PROVIDENCIA                   ;METROPOLITANA;49670;2;1;0;0;0;2;1;49670;Aspiradora AP1700 Arrastre 1700Watts;ELECTRODOMESTICOS
10309595;;M;52;CHILENO;;X;RENCA                         ;METROPOLITANA;15990;1;1;0;0;0;1;1;15990;Hervidor Electrico HA-3300 2,5Lts Blanco;ELECTRODOMESTICOS
17865394;;M;31;CHILENO;;Millenial;VALLENAR;ATACAMA;108270;2;1;0;0;0;2;1;108270;Horno electrico Black Oven 42lts;ELECTRODOMESTICOS
7798537;Casado;M;67;CHILENO;;Boomers;RENCA                         ;METROPOLITANA;17990;1;1;0;0;0;1;1;17990;Hervidor Electrico HA-3300 2,5Lts Blanco;ELECTRODOMESTICOS
5158407;;F;80;CHILENO;;Silencioso;COIHAIQUE                     ;AYSEN;34980;2;1;0;0;0;2;1;34980;Licuadora L-1630V Negra 1,5Lts Vaso Vidrio;ELECTRODOMESTICOS
11466590;;F;53;CHILENO;;X;HUASCO                        ;ATACAMA;117980;2;1;0;0;0;2;1;117980;MICROONDAS ME83X/XZS SAMSUNG MIRROR;ELECTRODOMESTICOS
8329494;;F;60;CHILENO;;Boomers;RENCA                         ;METROPOLITANA;56990;1;1;0;0;0;1;1;56990;Aspiradora VCC4190V3E/XZS Arrastre 2000Watts;ELECTRODOMESTICOS
17000508;;F;33;CHILENO;;Millenial;PROVIDENCIA                   ;METROPOLITANA;104980;2;1;0;0;0;2;1;104980;Horno Microondas Mecanico M-2030 NG 20Lts;ELECTRODOMESTICOS
4823980;;M;76;CHILENO;;Silencioso;RENCA                         ;METROPOLITANA;39990;1;1;0;0;0;1;1;39990;Horno Electrico TH-25N01 25Lts;ELECTRODOMESTICOS
13600167;;F;44;CHILENO;;X;SAN JAVIER                    ;MAULE;23980;2;2;0;0;0;2;2;23980;Exprimidor de Jugo CJ-2000 1Lts;ELECTRODOMESTICOS
6630045;;M;68;CHILENO;;Boomers;PAINE                         ;METROPOLITANA;94990;1;1;0;0;0;1;1;94990;Batidora Pedestal TH910PN 4,6Lts 1300Watts;ELECTRODOMESTICOS
11072165;;F;56;CHILENO;;Boomers;YERBAS BUENAS                 ;MAULE;14990;1;1;0;0;0;1;1;14990;Batidora Manual 3532;ELECTRODOMESTICOS
15727306;;F;39;CHILENO;;X;PROVIDENCIA                   ;METROPOLITANA;19990;1;1;0;0;0;1;1;19990;Licuadora L-1630V Negra 1,5Lts Vaso Vidrio;ELECTRODOMESTICOS
19343581;;F;26;CHILENO;;Z;SANTIAGO;METROPOLITANA;14990;1;1;0;0;0;1;1;14990;Tostador de Pan TH-116 2 Rebanadas Negro;ELECTRODOMESTICOS
17573760;;F;31;CHILENO;;Millenial;CURANILAHUE                   ;BIO BIO;32990;1;1;0;0;0;1;1;32990;Licuadora Roja 550W 1,5Lts Vaso Vidrio;ELECTRODOMESTICOS
12064473;Casado;F;52;CHILENO;;X;RENCA                         ;METROPOLITANA;29990;1;1;0;0;0;1;1;29990;Batidora Pedestal Bowl 300 Inox;ELECTRODOMESTICOS
9389042;;F;61;CHILENO;;Boomers;PROVIDENCIA                   ;METROPOLITANA;234440;4;1;0;0;0;4;1;234440;Horno Microondas Digital L UT-25KROMM 25Lts;ELECTRODOMESTICOS
8788343;;F;70;CHILENO;;Silencioso;CAUQUENES                     ;MAULE;20990;1;1;0;0;0;1;1;20990;Hervidor Electrico UT-DUNKEL17P 2Lts Negro;ELECTRODOMESTICOS
11775122;;M;52;CHILENO;;X;RENCA                         ;METROPOLITANA;34990;1;1;0;0;0;1;1;34990;Batidora Vertical Minipimer UT-KLOT400P;ELECTRODOMESTICOS
12702633;;F;48;CHILENO;;X;RENCA                         ;METROPOLITANA;49990;1;1;0;0;0;1;1;49990;Aspiradora UT-ZYKLON1402 Arrastre 1400Watts;ELECTRODOMESTICOS
10254605;;M;53;CHILENO;;Extranjero;N/D;N/D;14990;1;1;0;0;0;1;1;14990;Tostador de Pan TH-116 2 Rebanadas Negro;ELECTRODOMESTICOS
9278179;;F;60;CHILENO;;Boomers;RENCA                         ;METROPOLITANA;13990;1;1;0;0;0;1;1;13990;Exprimidor de Jugo CJ-2000 1Lts;ELECTRODOMESTICOS
15904570;;M;37;CHILENO;;Millenial;PROVIDENCIA                   ;METROPOLITANA;169990;1;1;0;0;0;1;1;169990;Horno Electrico TH-100i 100Lts;ELECTRODOMESTICOS
10732573;;F;60;CHILENO;;Boomers;N/D;N/D;21990;1;1;0;0;0;1;1;21990;Batidora Manual BA-5010 Inox;ELECTRODOMESTICOS
12506538;;F;49;CHILENO;;X;LA CISTERNA                   ;METROPOLITANA;44990;1;1;0;0;0;1;1;44990;Aspiradora TH1415 Arrastre 1500Watts;ELECTRODOMESTICOS
13789723;;M;42;CHILENO;;X;VILLA ALEGRE                  ;MAULE;65010;3;1;0;0;0;3;1;65010;Horno Microondas Digital TH-20S01 20Lts;ELECTRODOMESTICOS
4611865;;F;85;CHILENO;;Silencioso;VINA DEL MAR                  ;VALPARAISO;17990;1;1;0;0;0;1;1;17990;Hervidor Electrico UT-KLAR20PW 2Lts Blanco;ELECTRODOMESTICOS
12065405;Soltero;F;59;CHILENO;;Silencioso;PROVIDENCIA                   ;METROPOLITANA;25540;2;1;2;1;25540;0;0;0;Hervidor Electrico UT-KLAR20PW 2Lts Blanco;ELECTRODOMESTICOS
4623743;;M;81;CHILENO;;Silencioso;SALAMANCA                     ;COQUIMBO;-49990;-1;1;0;0;0;-1;1;-49990;Horno Microondas Mecanico TH-18B05 18Lts;ELECTRODOMESTICOS
17123034;Soltero;F;33;CHILENO;;Millenial;PROVIDENCIA                   ;METROPOLITANA;166980;2;1;2;1;166980;0;0;0;MAQUINA COSER MERRITT ME 9300;ELECTRODOMESTICOS
15410258;;F;40;CHILENO;;X;BUIN                          ;METROPOLITANA;78980;2;1;2;1;78980;0;0;0;Aspiradora de arrastre C/Bolsa Equipt 1800 watts;ELECTRODOMESTICOS
7677831;;F;64;CHILENO;;Boomers;LA PINTANA                    ;METROPOLITANA;17990;1;1;0;0;0;1;1;17990;Hervidor Electrico UT-KLAR20PW 2Lts Blanco;ELECTRODOMESTICOS
17556528;;M;32;CHILENO;;Millenial;ARICA                         ;ARICA Y PARINACOTA;39990;1;1;0;0;0;1;1;39990;Licuadora TH-501V 1,5Lts Vaso Vidrio;ELECTRODOMESTICOS
8071170;Divorciado;F;64;CHILENO;;Boomers;RENCA                         ;METROPOLITANA;21990;1;1;0;0;0;1;1;21990;Olla Arrocera OA-400NG 1,8Lts;ELECTRODOMESTICOS
9726775;;F;53;CHILENO;;X;PROVIDENCIA                   ;METROPOLITANA;38670;2;1;0;0;0;2;1;38670;Combo Juguera + Hervidor;ELECTRODOMESTICOS
7421348;;F;70;CHILENO;;Silencioso;CALLE LARGA                   ;VALPARAISO;39990;1;1;0;0;0;1;1;39990;Horno Electrico TH-25N01 25Lts;ELECTRODOMESTICOS
5969508;;M;73;CHILENO;;Silencioso;IQUIQUE                       ;TARAPACA;27990;1;1;0;0;0;1;1;27990;Combo Juguera + Hervidor;ELECTRODOMESTICOS
6595060;;F;75;CHILENO;;Silencioso;RENCA                         ;METROPOLITANA;31990;1;1;0;0;0;1;1;31990;Extractor de Jugo EX800 1,4Lts;ELECTRODOMESTICOS
13328714;;F;51;CHILENO;;X;PROVIDENCIA                   ;METROPOLITANA;19990;1;1;0;0;0;1;1;19990;Licuadora L-1630V Negra 1,5Lts Vaso Vidrio;ELECTRODOMESTICOS
17992465;;F;30;CHILENO;;Millenial;PROVIDENCIA                   ;METROPOLITANA;26990;1;1;0;0;0;1;1;26990;PICADORA 123 SILHQUETTE;ELECTRODOMESTICOS
9192691;;F;63;CHILENO;;Boomers;N/D;N/D;126270;2;1;0;0;0;2;1;126270;Horno Microondas Digital L UT-25KROMM 25Lts;ELECTRODOMESTICOS
6908593;;F;74;CHILENO;;Silencioso;CURICO                        ;MAULE;34990;1;1;0;0;0;1;1;34990;Licuadora TH-401V Roja 1,75Lts Vaso Vidrio;ELECTRODOMESTICOS
7580572;;F;69;CHILENO;;Silencioso;LOS ANDES                     ;VALPARAISO;59990;1;1;0;0;0;1;1;59990;Horno Microondas Mecanico Fancy 20Lts;ELECTRODOMESTICOS
17716508;Soltero;M;31;CHILENO;TECNICO DE NIVEL SUPERIOR EN ENFERMERIA;Millenial;N/D;N/D;169990;1;1;0;0;0;1;1;169990;Horno Electrico TH-100i 100Lts;ELECTRODOMESTICOS
18885435;;F;29;CHILENO;;Millenial;PROVIDENCIA                   ;METROPOLITANA;21990;1;1;0;0;0;1;1;21990;Plancha UT-KERAMIK1 2200Watts Base Ceramica;ELECTRODOMESTICOS
7240044;;F;62;CHILENO;;Boomers;PAINE                         ;METROPOLITANA;24990;1;1;0;0;0;1;1;24990;Licuadora TH-320 Roja/Negro 1,5 Lts Vaso Vidrio;ELECTRODOMESTICOS
8308343;;F;62;CHILENO;;Boomers;CARAHUE                       ;ARAUCANIA;29990;1;1;0;0;0;1;1;29990;Hervidor Electrico Tetera HA-4100 4Lts Iox;ELECTRODOMESTICOS
7141367;;M;56;CHILENO;;Boomers;BUIN                          ;METROPOLITANA;49990;1;1;0;0;0;1;1;49990;Horno Microondas Mecanico Fancy 20Lts;ELECTRODOMESTICOS
13728113;;M;42;CHILENO;;X;LOTA                          ;BIO BIO;149990;1;1;1;1;149990;0;0;0;Horno Electrico TH-100i 100Lts;ELECTRODOMESTICOS
13114440;;M;46;CHILENO;;Millenial;N/D;N/D;27990;1;1;0;0;0;1;1;27990;Combo Juguera + Hervidor;ELECTRODOMESTICOS
14161541;Soltero;F;40;CHILENO;ANALISTA DE SISTEMAS;X;N/D;N/D;19990;1;1;0;0;0;1;1;19990;Hervidor Family Kettle HE500;ELECTRODOMESTICOS
17716560;;M;31;CHILENO;;Millenial;N/D;N/D;14990;1;1;0;0;0;1;1;14990;Tostador de Pan TH-116 2 Rebanadas Negro;ELECTRODOMESTICOS
11249026;;F;54;CHILENO;;Boomers;RECOLETA                      ;METROPOLITANA;243980;2;1;2;1;243980;0;0;0;Maquina Overlock 3534T Azul;ELECTRODOMESTICOS
6028246;;M;71;CHILENO;;Silencioso;LA FLORIDA                    ;METROPOLITANA;14990;1;1;0;0;0;1;1;14990;Batidora Manual 3532;ELECTRODOMESTICOS
18056160;;F;29;CHILENO;;Millenial;N/D;N/D;90960;4;1;0;0;0;4;1;90960;Combo Plancha Batidora Secador de Pelo;ELECTRODOMESTICOS
9656622;Casado;F;67;CHILENO;;Boomers;RENCA                         ;METROPOLITANA;35980;2;1;0;0;0;2;1;35980;Hervidor Electrico Tetera TH-6505RT 1,7Lts Rojo;ELECTRODOMESTICOS
9369415;;M;59;CHILENO;;Boomers;COLINA                        ;METROPOLITANA;25990;1;1;0;0;0;1;1;25990;Combo Licuadora + Batidora;ELECTRODOMESTICOS
8994080;;F;67;CHILENO;;Boomers;PROVIDENCIA                   ;METROPOLITANA;19990;1;1;0;0;0;1;1;19990;Hervidor Electrico TH-5407i 2Lts;ELECTRODOMESTICOS
5932662;;F;71;CHILENO;;Silencioso;QUILPUE                       ;VALPARAISO;301970;3;2;0;0;0;3;2;301970;Aspiradora Trapeadora Robot Ut-Excellenza (B);ELECTRODOMESTICOS
10223621;;F;54;CHILENO;;Boomers;PADRE LAS CASAS               ;ARAUCANIA;79980;2;2;0;0;0;2;2;79980;Picadora TH-9020V Vaso Vidrio 2Lts;ELECTRODOMESTICOS
17101335;;M;33;CHILENO;;Millenial;BULNES                        ;BIO BIO;22392;1;1;0;0;0;1;1;22392;Combo Juguera + Hervidor;ELECTRODOMESTICOS
17141226;Soltero;F;33;CHILENO;TECNICO DE NIVEL SUPERIOR EN ENFERMERIA;Millenial;PROVIDENCIA                   ;METROPOLITANA;144980;2;1;2;1;144980;0;0;0;CAFETERA PRIMA LATTE 6603 NEGRA;ELECTRODOMESTICOS
19913861;;F;24;CHILENO;;Z;SAN BERNARDO;METROPOLITANA;0;0;0;0;0;0;0;0;0;Combo Hervidor + Batidora;ELECTRODOMESTICOS
15115552;Casado;F;39;CHILENO;;X;PROVIDENCIA                   ;METROPOLITANA;0;0;0;0;0;0;0;0;0;Tostador de Pan TH-116 2 Rebanadas Negro;ELECTRODOMESTICOS
9928320;;F;58;CHILENO;;Boomers;PROVIDENCIA                   ;METROPOLITANA;0;0;0;0;0;0;0;0;0;Picadora TH-9005 1Lts Vaso Vidrio;ELECTRODOMESTICOS
11907773;;M;50;CHILENO;;X;TEMUCO                        ;ARAUCANIA;0;0;0;0;0;0;0;0;0;Aspiradora Tambor APA1000 1000Watts;ELECTRODOMESTICOS
13367645;;M;43;CHILENO;;X;N/D;N/D;0;0;0;0;0;0;0;0;0;Maquina para Hacer Pan MPP-600 BL;ELECTRODOMESTICOS
7714371;Casado;F;67;CHILENO;;Boomers;RENCA                         ;METROPOLITANA;0;0;0;0;0;0;0;0;0;Procesador TH-9010 Multimixer 1,5Lts Vaso Vidrio;ELECTRODOMESTICOS
17458081;;F;32;CHILENO;;Millenial;CHILLAN                       ;BIO BIO;0;0;0;0;0;0;0;0;0;Horno Microondas Digital TH20DM 20Lts Espejado;ELECTRODOMESTICOS
14547369;;F;48;CHILENO;;X;SANTIAGO                      ;METROPOLITANA;0;0;0;0;0;0;0;0;0;Combo Licuadora + Batidora;ELECTRODOMESTICOS
19405243;;M;25;CHILENO;;Z;PROVIDENCIA                   ;METROPOLITANA;0;0;0;0;0;0;0;0;0;Horno Microondas Mecanico Easy Wave 20Lts;ELECTRODOMESTICOS
17172185;;F;33;CHILENO;;Millenial;LINARES                       ;MAULE;0;0;0;0;0;0;0;0;0;ARROCERA ROJA 4723;ELECTRODOMESTICOS
14340486;;F;44;CHILENO;;X;QUILICURA                     ;METROPOLITANA;0;0;0;0;0;0;0;0;0;Combo Hervidor + Tostador + Sandwichera;ELECTRODOMESTICOS
16603817;;F;35;CHILENO;;Millenial;COQUIMBO                      ;COQUIMBO;0;0;0;0;0;0;0;0;0;Picadora UT-PETRUS320 1Lts Vaso Vidrio;ELECTRODOMESTICOS
7633405;Casado;M;63;CHILENO;CONTADOR GENERAL;Boomers;TEMUCO                        ;ARAUCANIA;0;0;0;0;0;0;0;0;0;Horno Microondas Mecanico UT-SYDNEY18 18Lts;ELECTRODOMESTICOS
11792751;;F;51;CHILENO;;X;TALCA                         ;MAULE;0;0;0;0;0;0;0;0;0;Aspiradora UT-SILENT1603 Arrastre 1600Watts;ELECTRODOMESTICOS
10190630;;M;58;CHILENO;;Boomers;RENCA                         ;METROPOLITANA;0;0;0;0;0;0;0;0;0;Aspiradora TH1870 Arrastre 1800Watts Gris;ELECTRODOMESTICOS
16731507;;F;34;CHILENO;;Silencioso;PROVIDENCIA                   ;METROPOLITANA;0;0;0;0;0;0;0;0;0;Aspiradora Braava 380t;ELECTRODOMESTICOS
14262112;;F;48;CHILENO;;X;MAIPU                         ;METROPOLITANA;0;0;0;0;0;0;0;0;0;Horno Electrico TH62I 60Lts;ELECTRODOMESTICOS
13205812;;F;44;CHILENO;;X;LINARES                       ;MAULE;0;0;0;0;0;0;0;0;0;Horno Electrico TH-80i 80Lts;ELECTRODOMESTICOS
13692358;;F;43;CHILENO;;X;PENALOLEN                     ;METROPOLITANA;0;0;0;0;0;0;0;0;0;Hervidor Electrico HA-2650NG;ELECTRODOMESTICOS
17128128;;F;33;CHILENO;;Millenial;SANTA CRUZ                    ;L.G.B.OÂ´HIGGINS;0;0;0;0;0;0;0;0;0;Batidora Pedestal UT-KLEIN700;ELECTRODOMESTICOS
18053783;Soltero;F;30;CHILENO;;Millenial;PROVIDENCIA                   ;METROPOLITANA;0;0;0;0;0;0;0;0;0;Licuadora L2000VNG 1,5Lts Vaso Vidrio;ELECTRODOMESTICOS
16479022;;F;35;CHILENO;;Millenial;N/D;N/D;0;0;0;0;0;0;0;0;0;Aspiradora Polvo AP-700 GR;ELECTRODOMESTICOS
6039854;;F;72;CHILENO;;Silencioso;TEMUCO                        ;ARAUCANIA;0;0;0;0;0;0;0;0;0;Extractor de Jugo EX800 1,4Lts;ELECTRODOMESTICOS
15078011;Soltero;F;40;CHILENO;;X;PROVIDENCIA                   ;METROPOLITANA;0;0;0;0;0;0;0;0;0;Hervidor Electrico UT-DUNKEL17P 2Lts Negro;ELECTRODOMESTICOS
17716759;Soltero;F;32;CHILENO;PROFESOR;Millenial;PROVIDENCIA                   ;METROPOLITANA;0;0;0;0;0;0;0;0;0;Batidora Manual 3532;ELECTRODOMESTICOS
13579035;Casado;F;42;CHILENO;;X;RENCA                         ;METROPOLITANA;0;0;0;0;0;0;0;0;0;Hervidor Electrico Tetera HA-4100 4Lts Iox;ELECTRODOMESTICOS
17963078;;M;31;CHILENO;;Millenial;CASTRO                        ;LOS LAGOS;0;0;0;0;0;0;0;0;0;Exprimidor de Jugo 407W 1Lts;ELECTRODOMESTICOS
8657330;;M;53;CHILENO;;X;VILLA ALEMANA                 ;VALPARAISO;0;0;0;0;0;0;0;0;0;Hervidor Electrico 3101 1,7Lts Negro;ELECTRODOMESTICOS
15889639;;M;38;CHILENO;;Millenial;N/D;N/D;0;0;0;0;0;0;0;0;0;Exprimidor de Jugo 407W 1Lts;ELECTRODOMESTICOS
17551844;;M;31;CHILENO;;Millenial;PROVIDENCIA                   ;METROPOLITANA;0;0;0;0;0;0;0;0;0;HORNO ELECTRICO 16N01 16LTS NEGRO;ELECTRODOMESTICOS
13766637;;F;42;CHILENO;;X;RENCA                         ;METROPOLITANA;0;0;0;0;0;0;0;0;0;Hervidor Electrico TH-5407i 2Lts;ELECTRODOMESTICOS
8848939;;F;61;CHILENO;;Boomers;RENCA                         ;METROPOLITANA;0;0;0;0;0;0;0;0;0;Licuadora L2000VNG 1,5Lts Vaso Vidrio;ELECTRODOMESTICOS
9318786;Casado;M;62;CHILENO;PROFESOR;Boomers;RENCA                         ;METROPOLITANA;0;0;0;0;0;0;0;0;0;PROCESADOR THOMAS TH-9160;ELECTRODOMESTICOS
11601331;;F;51;CHILENO;;X;CANETE                        ;BIO BIO;0;0;0;0;0;0;0;0;0;Licuadora TH-501V 1,5Lts Vaso Vidrio;ELECTRODOMESTICOS
3522852;;F;76;CHILENO;;Silencioso;PROVIDENCIA                   ;METROPOLITANA;0;0;0;0;0;0;0;0;0;Plancha TH-7052 2000Watts Base Inox;ELECTRODOMESTICOS
13173713;;M;45;CHILENO;;Silencioso;PROVIDENCIA                   ;METROPOLITANA;0;0;0;0;0;0;0;0;0;Batidora Pedestal TH910PN 4,6Lts 1300Watts;ELECTRODOMESTICOS
13354190;;F;44;CHILENO;;X;CONSTITUCION                  ;MAULE;0;0;0;0;0;0;0;0;0;Horno Electrico UT-BACKOFEN26 26Lts;ELECTRODOMESTICOS
8627465;;F;60;CHILENO;;Boomers;PROVIDENCIA                   ;METROPOLITANA;0;0;0;0;0;0;0;0;0;Licuadora L2000VNG 1,5Lts Vaso Vidrio;ELECTRODOMESTICOS
16333309;;M;36;CHILENO;;Z;PROVIDENCIA                   ;METROPOLITANA;0;0;0;0;0;0;0;0;0;Hervidor Electrico 3100 1,7Lts Negro;ELECTRODOMESTICOS
13917129;;F;41;CHILENO;;X;N/D;N/D;0;0;0;0;0;0;0;0;0;Plancha THOMAS TH-7170 2200Watts Base Ceramica;ELECTRODOMESTICOS
18891122;;F;28;CHILENO;;Millenial;PROVIDENCIA                   ;METROPOLITANA;0;0;0;0;0;0;0;0;0;Horno Electrico TH62I 60Lts;ELECTRODOMESTICOS
23134926;;F;51;PERUANO;;Extranjero;ILLAPEL                       ;COQUIMBO;0;0;0;0;0;0;0;0;0;Hervidor Electrico 3101 1,7Lts Negro;ELECTRODOMESTICOS
15432853;;M;40;CHILENO;;Silencioso;PROVIDENCIA                   ;METROPOLITANA;0;0;0;0;0;0;0;0;0;SUPER FREIDORA DE AIRE OV3;ELECTRODOMESTICOS
9953450;;M;58;CHILENO;;Boomers;RENCA                         ;METROPOLITANA;0;0;0;0;0;0;0;0;0;Horno Microondas Digital TH-25DM 25Lts;ELECTRODOMESTICOS
19921695;;F;23;CHILENO;;Z;N/D;N/D;0;0;0;0;0;0;0;0;0;Exprimidor Fauna 500 cc;ELECTRODOMESTICOS
9688150;;M;58;CHILENO;;Boomers;TEMUCO                        ;ARAUCANIA;0;0;0;0;0;0;0;0;0;Hervidor Electrico UT-MANLY17 1,7Lts Negro;ELECTRODOMESTICOS
8970511;;F;62;CHILENO;;Boomers;CALAMA                        ;ANTOFAGASTA;0;0;0;0;0;0;0;0;0;Plancha UT-DUNST 2200Watts Base Ceramica;ELECTRODOMESTICOS
5333372;;F;78;CHILENO;;Silencioso;RENCA                         ;METROPOLITANA;0;0;0;0;0;0;0;0;0;Aspiradora AP1700 Arrastre 1700Watts;ELECTRODOMESTICOS
13727617;;F;43;CHILENO;;X;PROVIDENCIA                   ;METROPOLITANA;0;0;0;0;0;0;0;0;0;Horno Electrico TH-100i 100Lts;ELECTRODOMESTICOS
18267467;Soltero;F;30;CHILENO;;Millenial;PROVIDENCIA                   ;METROPOLITANA;0;0;0;0;0;0;0;0;0;Aspiradora AP1700 Arrastre 1700Watts;ELECTRODOMESTICOS
18132067;;F;30;CHILENO;;Millenial;N/D;N/D;0;0;0;0;0;0;0;0;0;Batidora Manual UT-TEKLA300;ELECTRODOMESTICOS
17183170;;F;32;CHILENO;;Millenial;N/D;N/D;0;0;0;0;0;0;0;0;0;Aspiradora UT-SILENT1603 Arrastre 1600Watts;ELECTRODOMESTICOS
14183927;;F;41;CHILENO;;X;ALTO HOSPICIO;TARAPACA;0;0;0;0;0;0;0;0;0;Horno Electrico UT-LEIF36 36Lts;ELECTRODOMESTICOS
16306673;;F;35;CHILENO;;Millenial;N/D;N/D;0;0;0;0;0;0;0;0;0;Enceradora EA-5000;ELECTRODOMESTICOS
11762212;;M;50;CHILENO;;X;RENCA                         ;METROPOLITANA;0;0;0;0;0;0;0;0;0;Horno Electrico UT-BACKOFEN48 48Lts;ELECTRODOMESTICOS
11536044;;F;52;CHILENO;;X;PROVIDENCIA                   ;METROPOLITANA;0;0;0;0;0;0;0;0;0;Licuadora TH-501V 1,5Lts Vaso Vidrio;ELECTRODOMESTICOS
11391495;;M;53;CHILENO;;X;PROVIDENCIA                   ;METROPOLITANA;0;0;0;0;0;0;0;0;0;Cafetera TH-130;ELECTRODOMESTICOS
8733582;Soltero;F;64;CHILENO;;Boomers;ANGOL                         ;ARAUCANIA;0;0;0;0;0;0;0;0;0;PICADORA 123 SILHQUETTE;ELECTRODOMESTICOS
19115903;;F;28;CHILENO;;Millenial;PROVIDENCIA                   ;METROPOLITANA;0;0;0;0;0;0;0;0;0;Horno Electrico UT-LEIF36 36Lts;ELECTRODOMESTICOS
8423740;;F;66;CHILENO;;Boomers;SAN PEDRO DE LA PAZ           ;BIO BIO;0;0;0;0;0;0;0;0;0;Licuadora TH-501V 1,5Lts Vaso Vidrio;ELECTRODOMESTICOS
9348175;;M;60;CHILENO;;Boomers;PROVIDENCIA                   ;METROPOLITANA;0;0;0;0;0;0;0;0;0;Aspiradora Tambor APA1000 1000Watts;ELECTRODOMESTICOS
14621393;;F;41;CHILENO;;X;ARICA                         ;ARICA Y PARINACOTA;0;0;0;0;0;0;0;0;0;Combo Juguera + Hervidor;ELECTRODOMESTICOS
15140437;;F;38;CHILENO;;X;PROVIDENCIA                   ;METROPOLITANA;0;0;0;0;0;0;0;0;0;Aspiradora UT-SILENT1603 Arrastre 1600Watts;ELECTRODOMESTICOS
17470116;;M;32;CHILENO;;Millenial;PROVIDENCIA                   ;METROPOLITANA;0;0;0;0;0;0;0;0;0;Horno Microondas Mecanico Easy Wave 20Lts;ELECTRODOMESTICOS
16707923;;F;36;CHILENO;;Millenial;TUCAPEL                       ;BIO BIO;0;0;0;0;0;0;0;0;0;Horno Microondas Mecanico UT-SYDNEY18 18Lts;ELECTRODOMESTICOS
13061789;Casado;F;45;CHILENO;;X;PARRAL                        ;MAULE;0;0;0;0;0;0;0;0;0;Horno Electrico TH-100i 100Lts;ELECTRODOMESTICOS
17780029;;F;31;CHILENO;;Millenial;LA REINA;METROPOLITANA;0;0;0;0;0;0;0;0;0;Batidora Manual 3532;ELECTRODOMESTICOS
17977729;Soltero;M;30;CHILENO;;Millenial;PROVIDENCIA                   ;METROPOLITANA;0;0;0;0;0;0;0;0;0;Horno Microondas Mecanico C1700N 17Lts Blanco;ELECTRODOMESTICOS
6386001;;M;72;CHILENO;;Silencioso;PROVIDENCIA                   ;METROPOLITANA;0;0;0;0;0;0;0;0;0;Parrilla Electrica PE2650;ELECTRODOMESTICOS
7363966;;F;66;CHILENO;;Silencioso;NAVIDAD                       ;L.G.B.OÂ´HIGGINS;0;0;0;0;0;0;0;0;0;Tostador de Pan TH-116 2 Rebanadas Negro;ELECTRODOMESTICOS
10280969;;M;56;CHILENO;;Z;N/D;N/D;0;0;0;0;0;0;0;0;0;Horno Microondas Digital ME0113MB1/XZS 32Lts;ELECTRODOMESTICOS
5282297;;M;72;CHILENO;;Silencioso;CANETE                        ;BIO BIO;0;0;0;0;0;0;0;0;0;Plancha Paninis 2880;ELECTRODOMESTICOS
8737552;;F;51;CHILENO;;X;RENCA                         ;METROPOLITANA;0;0;0;0;0;0;0;0;0;Sandwichera TH-952 2 Panes Blanca;ELECTRODOMESTICOS
8273004;;F;68;CHILENO;;Boomers;PANGUIPULLI                   ;LOS RIOS;0;0;0;0;0;0;0;0;0;Plancha THOMAS TH-7170 2200Watts Base Ceramica;ELECTRODOMESTICOS
20310774;;F;22;CHILENO;;Millenial;PROVIDENCIA                   ;METROPOLITANA;0;0;0;0;0;0;0;0;0;Combo Licuadora + Batidora;ELECTRODOMESTICOS
9083478;;F;61;CHILENO;;Boomers;VINA DEL MAR                  ;VALPARAISO;0;0;0;0;0;0;0;0;0;Combo Juguera + Hervidor;ELECTRODOMESTICOS
8346489;;F;49;CHILENO;;X;PROVIDENCIA                   ;METROPOLITANA;0;0;0;0;0;0;0;0;0;Licuadora TH-320 Roja/Negro 1,5 Lts Vaso Vidrio;ELECTRODOMESTICOS
8767616;;F;61;CHILENO;;Boomers;PROVIDENCIA                   ;METROPOLITANA;0;0;0;0;0;0;0;0;0;Hervidor Electrico Tetera UT-LECKER18R 1,8Lts;ELECTRODOMESTICOS
15450254;;M;40;CHILENO;;X;PROVIDENCIA                   ;METROPOLITANA;0;0;0;0;0;0;0;0;0;Aspiradora AP1700 Arrastre 1700Watts;ELECTRODOMESTICOS
18643606;;F;28;CHILENO;;Millenial;N/D;N/D;0;0;0;0;0;0;0;0;0;Tostador de Pan TH-116 2 Rebanadas Negro;ELECTRODOMESTICOS
10342803;;F;57;CHILENO;;Boomers;N/D;N/D;0;0;0;0;0;0;0;0;0;Horno Microondas Digital TH20DM 20Lts Espejado;ELECTRODOMESTICOS
19749230;;F;25;CHILENO;;Z;N/D;N/D;0;0;0;0;0;0;0;0;0;Horno Microondas Mecanico C1700N 17Lts Blanco;ELECTRODOMESTICOS
13089301;;F;46;CHILENO;;X;SAN MIGUEL                    ;METROPOLITANA;0;0;0;0;0;0;0;0;0;Freidora de Aire 18M Oster;ELECTRODOMESTICOS
7509418;;F;66;CHILENO;;Boomers;PROVIDENCIA                   ;METROPOLITANA;0;0;0;0;0;0;0;0;0;PROCESADOR DE ALIMENTOS UT-PROCESSOR750;ELECTRODOMESTICOS
8644887;;M;63;CHILENO;;Boomers;OSORNO                        ;LOS LAGOS;0;0;0;0;0;0;0;0;0;Licuadora L-1630V Negra 1,5Lts Vaso Vidrio;ELECTRODOMESTICOS
9683999;;F;57;CHILENO;;Boomers;RENCA                         ;METROPOLITANA;0;0;0;0;0;0;0;0;0;Tostador de Pan TH-116 2 Rebanadas Negro;ELECTRODOMESTICOS
18014463;;M;30;CHILENO;;Millenial;N/D;N/D;0;0;0;0;0;0;0;0;0;Batidora Manual 3532;ELECTRODOMESTICOS
14451648;;M;48;CHILENO;;X;PROVIDENCIA                   ;METROPOLITANA;0;0;0;0;0;0;0;0;0;Batidora Vertical Stick Mixer 2609;ELECTRODOMESTICOS
17648363;;F;32;CHILENO;;Millenial;RIO BUENO                     ;LOS LAGOS;0;0;0;0;0;0;0;0;0;Plancha Vertical UT-TURBOSTEAMER 1400Watts;ELECTRODOMESTICOS
15300198;;F;39;CHILENO;;X;PUERTO MONTT                  ;LOS LAGOS;0;0;0;0;0;0;0;0;0;Cafetera UT-KAFFEEKLASSIK;ELECTRODOMESTICOS
23442260;;F;50;PERUANO;;Extranjero;RECOLETA                      ;METROPOLITANA;0;0;0;0;0;0;0;0;0;Horno Electrico UT-BACKOFEN38 38Lts;ELECTRODOMESTICOS
14393547;;F;43;CHILENO;;X;PROVIDENCIA                   ;METROPOLITANA;0;0;0;0;0;0;0;0;0;Aspiradora TH1870 Arrastre 1800Watts Gris;ELECTRODOMESTICOS
20217554;;F;22;CHILENO;;Z;PROVIDENCIA                   ;METROPOLITANA;0;0;0;0;0;0;0;0;0;Aspiradora Tambor APA1000 1000Watts;ELECTRODOMESTICOS
7717604;;M;63;CHILENO;;Boomers;ANGOL                         ;ARAUCANIA;0;0;0;0;0;0;0;0;0;Batidora Vertical Stick Mixer 2609;ELECTRODOMESTICOS
18562720;;M;28;CHILENO;;Millenial;LLAILLAY                      ;VALPARAISO;0;0;0;0;0;0;0;0;0;Horno Microondas Digital Deli (2017 DM) 20Lts;ELECTRODOMESTICOS
15201636;;M;40;CHILENO;;X;CURANILAHUE                   ;BIO BIO;0;0;0;0;0;0;0;0;0;Horno Electrico UT-BACKOFEN38 38Lts;ELECTRODOMESTICOS
10101880;;F;58;CHILENO;;Boomers;RENCA                         ;METROPOLITANA;0;0;0;0;0;0;0;0;0;Horno Electrico UT-BACKOFEN26 26Lts;ELECTRODOMESTICOS
17430903;;F;32;CHILENO;;Millenial;N/D;N/D;0;0;0;0;0;0;0;0;0;Maquina de coser Singer 3305;ELECTRODOMESTICOS
9337146;Soltero;F;61;CHILENO;;Boomers;PROVIDENCIA                   ;METROPOLITANA;0;0;0;0;0;0;0;0;0;Horno Electrico TH-25N01 25Lts;ELECTRODOMESTICOS
5774253;;M;76;CHILENO;;Silencioso;RENCA                         ;METROPOLITANA;0;0;0;0;0;0;0;0;0;Horno Microondas Mecanico Easy Wave 20Lts;ELECTRODOMESTICOS
17561408;Soltero;F;32;CHILENO;PROFESOR;Millenial;PROVIDENCIA                   ;METROPOLITANA;0;0;0;0;0;0;0;0;0;LICUADORA MULTIFUNCION LCM-18000 GF;ELECTRODOMESTICOS
13864604;;F;41;CHILENO;;X;N/D;N/D;0;0;0;0;0;0;0;0;0;Aspiradora Trapeadora Robot Ut-Excellenza (B);ELECTRODOMESTICOS
9602901;;F;61;CHILENO;;Boomers;TALCA                         ;MAULE;0;0;0;0;0;0;0;0;0;Horno Microondas Digital TH-20S01 20Lts;ELECTRODOMESTICOS
12087094;Casado;F;56;CHILENO;;Boomers;RENCA                         ;METROPOLITANA;0;0;0;0;0;0;0;0;0;Hervidor Electrico UT-REIN17SS;ELECTRODOMESTICOS
8738527;;M;62;CHILENO;;Boomers;RENCA                         ;METROPOLITANA;0;0;0;0;0;0;0;0;0;Hervidor Electrico UT-REIN17SS;ELECTRODOMESTICOS
12956754;;F;45;CHILENO;;X;RENCA                         ;METROPOLITANA;0;0;0;0;0;0;0;0;0;Maquina de Coser JS-2135CL Calipso;ELECTRODOMESTICOS
19667059;;F;25;CHILENO;;Silencioso;"";"";0;0;0;0;0;0;0;0;0;Horno electrico Black Oven 42lts;ELECTRODOMESTICOS
4172772;;M;82;CHILENO;;Silencioso;RENCA                         ;METROPOLITANA;0;0;0;0;0;0;0;0;0;Horno Microondas Digital L UT-25KROMM 25Lts;ELECTRODOMESTICOS
17715414;;M;31;CHILENO;;Millenial;ILLAPEL                       ;COQUIMBO;0;0;0;0;0;0;0;0;0;Hervidor Electrico UT-DUNKEL17P 2Lts Negro;ELECTRODOMESTICOS
9365889;;F;60;CHILENO;;Boomers;SALAMANCA                     ;COQUIMBO;0;0;0;0;0;0;0;0;0;Aspiradora TH1415 Arrastre 1500Watts;ELECTRODOMESTICOS
7902414;;F;64;CHILENO;;Boomers;RENCA                         ;METROPOLITANA;0;0;0;0;0;0;0;0;0;LICUADORA CROMADA CON TECLAS PLUS;ELECTRODOMESTICOS
13692294;Soltero;F;43;CHILENO;;X;RENCA                         ;METROPOLITANA;0;0;0;0;0;0;0;0;0;Aspiradora UT-SILENT1804 Arrastre 1800Watts;ELECTRODOMESTICOS
12619492;;F;48;CHILENO;;X;LA SERENA                     ;COQUIMBO;0;0;0;0;0;0;0;0;0;Licuadora TH-501V 1,5Lts Vaso Vidrio;ELECTRODOMESTICOS
13420513;;F;44;CHILENO;;X;OVALLE                        ;COQUIMBO;0;0;0;0;0;0;0;0;0;BATIDORA INMERSION S MIX 2616;ELECTRODOMESTICOS
9468198;;M;59;CHILENO;;Boomers;COPIAPO                       ;ATACAMA;0;0;0;0;0;0;0;0;0;Hervidor Electrico 3100 1,7Lts Negro;ELECTRODOMESTICOS
16217880;;M;40;CHILENO;;X;CARAHUE                       ;ARAUCANIA;0;0;0;0;0;0;0;0;0;Maquina de Coser 3008 Janome Blanco;ELECTRODOMESTICOS
9511609;;M;60;CHILENO;;Boomers;PROVIDENCIA                   ;METROPOLITANA;0;0;0;0;0;0;0;0;0;Tostador de Pan TH-116 2 Rebanadas Negro;ELECTRODOMESTICOS
7810059;;F;64;CHILENO;;Boomers;PENAFLOR                      ;METROPOLITANA;0;0;0;0;0;0;0;0;0;Horno Electrico UT-LEIF36 36Lts;ELECTRODOMESTICOS
7423403;Divorciado;F;66;CHILENO;;Boomers;ILLAPEL                       ;COQUIMBO;0;0;0;0;0;0;0;0;0;Batidora Manual TH-8830;ELECTRODOMESTICOS
17234511;;M;33;CHILENO;;Millenial;PROVIDENCIA                   ;METROPOLITANA;0;0;0;0;0;0;0;0;0;Parrilla Electrica TH-224;ELECTRODOMESTICOS
10309792;Casado;M;46;CHILENO;INGENIERO;Silencioso;PROVIDENCIA                   ;METROPOLITANA;0;0;0;0;0;0;0;0;0;ASPIRADORA ROBOT VR05R5050WK/ZS;ELECTRODOMESTICOS
9001481;;F;61;CHILENO;;Boomers;RENCA                         ;METROPOLITANA;0;0;0;0;0;0;0;0;0;Robot aspirador Roomba 675;ELECTRODOMESTICOS
23576664;;F;36;PERUANO;;Extranjero;LA CISTERNA                   ;METROPOLITANA;0;0;0;0;0;0;0;0;0;Licuadora Kaliman Negra con Teclas;ELECTRODOMESTICOS
6558482;Casado;F;69;CHILENO;;Silencioso;PROVIDENCIA                   ;METROPOLITANA;0;0;0;0;0;0;0;0;0;Licuadora UT-METALLEK505P 1,5Lts Vaso Vidrio;ELECTRODOMESTICOS
17301208;Soltero;F;32;CHILENO;TECNICO DE NIVEL SUPERIOR EN ENFERMERIA;Millenial;PROVIDENCIA                   ;METROPOLITANA;0;0;0;0;0;0;0;0;0;Parrilla Electrica TH-180;ELECTRODOMESTICOS
7271190;Divorciado;M;68;CHILENO;PROFESOR;Silencioso;CAUQUENES                     ;MAULE;0;0;0;0;0;0;0;0;0;Extractor de Jugo EX800 1,4Lts;ELECTRODOMESTICOS
17388963;;M;32;CHILENO;;Silencioso;PROVIDENCIA                   ;METROPOLITANA;0;0;0;0;0;0;0;0;0;CAFETERA PRIMA LATTE 6603 NEGRA;ELECTRODOMESTICOS
9802118;;F;59;CHILENO;;Boomers;PUNTA ARENAS                  ;MAGALLANES;0;0;0;0;0;0;0;0;0;Aspiradora TH1870 Arrastre 1800Watts Gris;ELECTRODOMESTICOS
20132984;;F;23;CHILENO;;Z;PROVIDENCIA                   ;METROPOLITANA;0;0;0;0;0;0;0;0;0;Hervidor Electrico TH-4515N 2Lts Negro;ELECTRODOMESTICOS
8598209;;M;64;CHILENO;;Boomers;PROVIDENCIA                   ;METROPOLITANA;0;0;0;0;0;0;0;0;0;Batidora Manual BA-5010 Inox;ELECTRODOMESTICOS
11739559;;F;51;CHILENO;;X;PROVIDENCIA                   ;METROPOLITANA;0;0;0;0;0;0;0;0;0;Hervidor Electrico UT-DUNKEL17P 2Lts Negro;ELECTRODOMESTICOS
11913119;;F;50;CHILENO;;X;CHIGUAYANTE                   ;BIO BIO;0;0;0;0;0;0;0;0;0;Tostador de Pan TP-1400 4 Rebanadas Inox;ELECTRODOMESTICOS
7877392;;F;67;CHILENO;;Boomers;N/D;N/D;0;0;0;0;0;0;0;0;0;Horno Microondas Mecanico Easy Wave 20Lts;ELECTRODOMESTICOS
12867572;;F;46;CHILENO;;X;RENCA                         ;METROPOLITANA;0;0;0;0;0;0;0;0;0;Freidora de Aire 18M Oster;ELECTRODOMESTICOS
16054791;;M;37;CHILENO;;Millenial;ALTO HOSPICIO;TARAPACA;0;0;0;0;0;0;0;0;0;Licuadora UT-METALLEK505P 1,5Lts Vaso Vidrio;ELECTRODOMESTICOS
11358872;;F;53;CHILENO;;X;PUNTA ARENAS                  ;MAGALLANES;0;0;0;0;0;0;0;0;0;Tostador de PanTH-120R 2 Rebanadas Rojo;ELECTRODOMESTICOS
12713003;Soltero;M;48;CHILENO;;X;RENCA                         ;METROPOLITANA;0;0;0;0;0;0;0;0;0;Aspiradora VCC4190V3E/XZS Arrastre 2000Watts;ELECTRODOMESTICOS
9454611;;F;59;CHILENO;;Boomers;N/D;N/D;0;0;0;0;0;0;0;0;0;Horno Electrico UT-LEIF36 36Lts;ELECTRODOMESTICOS
11944928;;F;49;CHILENO;;X;RENCA                         ;METROPOLITANA;0;0;0;0;0;0;0;0;0;Hervidor Electrico TH-4515N 2Lts Negro;ELECTRODOMESTICOS
10523006;;F;54;CHILENO;;Boomers;LINARES                       ;MAULE;0;0;0;0;0;0;0;0;0;Horno Electrico TH-38N 38Lts;ELECTRODOMESTICOS
19758406;;M;24;CHILENO;;Silencioso;PROVIDENCIA                   ;METROPOLITANA;0;0;0;0;0;0;0;0;0;Batidora Manual 3532;ELECTRODOMESTICOS
14176127;;F;41;CHILENO;;Silencioso;PROVIDENCIA                   ;METROPOLITANA;0;0;0;0;0;0;0;0;0;Batidora Manual 3532;ELECTRODOMESTICOS
16061073;;M;37;CHILENO;;Millenial;N/D;N/D;0;0;0;0;0;0;0;0;0;Horno Microondas Digital L UT-25KROMM 25Lts;ELECTRODOMESTICOS
26794345;;M;33;EXTRANJERO - NO INFORMA NACIONALIDAD;;Extranjero;MELIPILLA                     ;METROPOLITANA;0;0;0;0;0;0;0;0;0;Batidora Pedestal UT-KLEIN700;ELECTRODOMESTICOS
5592721;;F;72;CHILENO;;Silencioso;ANTOFAGASTA                   ;ANTOFAGASTA;0;0;0;0;0;0;0;0;0;ARROCERA ROJA 4723;ELECTRODOMESTICOS
6931928;;F;70;CHILENO;;Silencioso;CORONEL                       ;BIO BIO;0;0;0;0;0;0;0;0;0;Hervidor Electrico HA-3300 2,5Lts Blanco;ELECTRODOMESTICOS
13614031;;F;43;CHILENO;;X;SAN JAVIER                    ;MAULE;0;0;0;0;0;0;0;0;0;Horno Electrico UT-BACKOFEN38 38Lts;ELECTRODOMESTICOS
7457625;;M;67;CHILENO;;Boomers;MOLINA                        ;MAULE;0;0;0;0;0;0;0;0;0;Licuadora TH-320 Roja/Negro 1,5 Lts Vaso Vidrio;ELECTRODOMESTICOS
11766170;Casado;F;52;CHILENO;;X;RENCA                         ;METROPOLITANA;0;0;0;0;0;0;0;0;0;Plancha THOMAS TH-7170 2200Watts Base Ceramica;ELECTRODOMESTICOS
8523667;Divorciado;M;60;CHILENO;;Boomers;LA REINA                      ;METROPOLITANA;0;0;0;0;0;0;0;0;0;Horno Microondas Digital L UT-25KROMM 25Lts;ELECTRODOMESTICOS
10555248;;F;57;CHILENO;;Boomers;PROVIDENCIA                   ;METROPOLITANA;0;0;0;0;0;0;0;0;0;ASPIRADORA THOMAS TH-1640;ELECTRODOMESTICOS
24323814;;M;47;COLOMBIANO;;Extranjero;ANTOFAGASTA                   ;ANTOFAGASTA;0;0;0;0;0;0;0;0;0;Horno Electrico TH-25N01 25Lts;ELECTRODOMESTICOS
16248405;;F;36;CHILENO;;Millenial;LA SERENA                     ;COQUIMBO;0;0;0;0;0;0;0;0;0;Horno Electrico UT-BACKOFEN26 26Lts;ELECTRODOMESTICOS
6494149;Casado;M;73;CHILENO;TECNICO EN ADMINISTRACION DE EMPRESAS;Silencioso;PROVIDENCIA                   ;METROPOLITANA;0;0;0;0;0;0;0;0;0;Tostador de Pan TH-126 4 Rebanadas Negro;ELECTRODOMESTICOS
6604447;;F;74;CHILENO;;Silencioso;CURICO                        ;MAULE;0;0;0;0;0;0;0;0;0;Horno Electrico UT-BACKOFEN48 48Lts;ELECTRODOMESTICOS
15126159;Soltero;F;38;CHILENO;INTERPRETE DE IDIOMAS;X;PROVIDENCIA                   ;METROPOLITANA;0;0;0;0;0;0;0;0;0;Hervidor Electrico 3100 1,7Lts Negro;ELECTRODOMESTICOS
4512586;;M;77;CHILENO;;Silencioso;LOS ANDES                     ;VALPARAISO;0;0;0;0;0;0;0;0;0;Licuadora TH-401V Roja 1,75Lts Vaso Vidrio;ELECTRODOMESTICOS
9372420;;F;59;CHILENO;;Boomers;PROVIDENCIA                   ;METROPOLITANA;0;0;0;0;0;0;0;0;0;Horno Electrico UT-BACKOFEN48 48Lts;ELECTRODOMESTICOS
10209095;Casado;M;56;CHILENO;;Boomers;RENCA                         ;METROPOLITANA;0;0;0;0;0;0;0;0;0;Hervidor Electrico TH-4515N 2Lts Negro;ELECTRODOMESTICOS
18417280;;F;28;CHILENO;;Millenial;CONCEPCION                    ;BIO BIO;0;0;0;0;0;0;0;0;0;Combo Licuadora + Batidora;ELECTRODOMESTICOS
7920092;Casado;F;66;CHILENO;;Boomers;PROVIDENCIA                   ;METROPOLITANA;0;0;0;0;0;0;0;0;0;Batidora Vertical Stick Mixer 2609;ELECTRODOMESTICOS
11521069;;M;51;CHILENO;;X;QUILPUE                       ;VALPARAISO;0;0;0;0;0;0;0;0;0;Horno Microondas Digital L UT-25KROMM 25Lts;ELECTRODOMESTICOS
11372120;;F;52;CHILENO;;X;ILLAPEL                       ;COQUIMBO;0;0;0;0;0;0;0;0;0;Horno Microondas Digital TH-20S01 20Lts;ELECTRODOMESTICOS
7213651;;F;70;CHILENO;;Silencioso;PAREDONES                     ;L.G.B.OÂ´HIGGINS;0;0;0;0;0;0;0;0;0;Aspiradora UT-SILENT1804 Arrastre 1800Watts;ELECTRODOMESTICOS
11795998;;F;50;CHILENO;;X;LOS ANGELES                   ;BIO BIO;0;0;0;0;0;0;0;0;0;Hervidor 41020-CL 1,7Lts Inox;ELECTRODOMESTICOS
13012719;;M;45;CHILENO;;X;PROVIDENCIA                   ;METROPOLITANA;0;0;0;0;0;0;0;0;0;Licuadora L-1630V Negra 1,5Lts Vaso Vidrio;ELECTRODOMESTICOS
11914162;;M;50;CHILENO;;X;PUENTE ALTO                   ;METROPOLITANA;0;0;0;0;0;0;0;0;0;MAQUINA DE COSER ME 3B FULL MERRITT;ELECTRODOMESTICOS
18875467;;M;31;CHILENO;;Millenial;ARICA                         ;ARICA Y PARINACOTA;0;0;0;0;0;0;0;0;0;Horno Microondas Digital L UT-25KROMM 25Lts;ELECTRODOMESTICOS
18692530;;M;28;CHILENO;;Millenial;SAN JAVIER                    ;MAULE;0;0;0;0;0;0;0;0;0;Horno Microondas Digital TH-20S01 20Lts;ELECTRODOMESTICOS
10782629;;F;56;CHILENO;;Boomers;ARAUCO                        ;BIO BIO;0;0;0;0;0;0;0;0;0;Horno Electrico TH-48N 48Lts;ELECTRODOMESTICOS
6579885;Casado;F;67;CHILENO;;Boomers;SANTA CRUZ                    ;L.G.B.OÂ´HIGGINS;0;0;0;0;0;0;0;0;0;Hervidor Electrico Tetera HA-4100 4Lts Iox;ELECTRODOMESTICOS
4815494;;F;80;CHILENO;;Silencioso;PROVIDENCIA                   ;METROPOLITANA;0;0;0;0;0;0;0;0;0;PROCESADOR DE ALIMENTOS UT-PROCESSOR750;ELECTRODOMESTICOS
15115898;Soltero;M;37;CHILENO;;Millenial;CHEPICA                       ;L.G.B.OÂ´HIGGINS;0;0;0;0;0;0;0;0;0;Hervidor Electrico TH-4515N 2Lts Negro;ELECTRODOMESTICOS
25426223;;F;47;PERUANO;;Extranjero;ANTOFAGASTA                   ;ANTOFAGASTA;0;0;0;0;0;0;0;0;0;HERVIDOR TH-4340;ELECTRODOMESTICOS
10576219;;M;55;CHILENO;;Boomers;PUERTO MONTT                  ;LOS LAGOS;0;0;0;0;0;0;0;0;0;Licuadora Kaliman Negra con Teclas;ELECTRODOMESTICOS
17983865;;F;28;CHILENO;;Millenial;PROVIDENCIA                   ;METROPOLITANA;0;0;0;0;0;0;0;0;0;Cafetera UT-KAFFEEKLASSIK;ELECTRODOMESTICOS
10991686;;M;48;CHILENO;;Extranjero;RANCAGUA                      ;L.G.B.OÂ´HIGGINS;0;0;0;0;0;0;0;0;0;Hervidor Electrico HA-3300 2,5Lts Blanco;ELECTRODOMESTICOS
19419390;;M;25;CHILENO;;Z;N/D;N/D;0;0;0;0;0;0;0;0;0;Licuadora Osterizer 4112/72 1,25Lts Vaso Vidrio;ELECTRODOMESTICOS
16483747;;M;35;CHILENO;;Millenial;PROVIDENCIA                   ;METROPOLITANA;0;0;0;0;0;0;0;0;0;Hervidor Electrico TH-4515N 2Lts Negro;ELECTRODOMESTICOS
15648288;;M;38;CHILENO;;X;YUNGAY                        ;BIO BIO;0;0;0;0;0;0;0;0;0;Batidora Pedestal UT-KLEIN700;ELECTRODOMESTICOS
13473453;;F;43;CHILENO;;Silencioso;PROVIDENCIA                   ;METROPOLITANA;0;0;0;0;0;0;0;0;0;Horno Electrico TH-48N 48Lts;ELECTRODOMESTICOS
10645114;;F;55;CHILENO;;Boomers;PROVIDENCIA                   ;METROPOLITANA;0;0;0;0;0;0;0;0;0;Batidora Manual UT-TEKLA300;ELECTRODOMESTICOS
6614070;;M;68;CHILENO;;Boomers;LOS ANDES                     ;VALPARAISO;0;0;0;0;0;0;0;0;0;Horno Electrico TH-38N 38Lts;ELECTRODOMESTICOS
9419820;;F;59;CHILENO;;Boomers;QUILPUE                       ;VALPARAISO;0;0;0;0;0;0;0;0;0;Aspiradora UT-MEINER1803 Arrastre 1800Watts;ELECTRODOMESTICOS
7173639;;F;65;CHILENO;;Boomers;SAN JAVIER                    ;MAULE;0;0;0;0;0;0;0;0;0;Licuadora L2000VNG 1,5Lts Vaso Vidrio;ELECTRODOMESTICOS
5912350;;F;75;CHILENO;;Silencioso;VICTORIA                      ;ARAUCANIA;0;0;0;0;0;0;0;0;0;Batidora Pedestal Bowl 300 Inox;ELECTRODOMESTICOS
11130048;;F;54;CHILENO;;Silencioso;VALDIVIA                      ;LOS LAGOS;0;0;0;0;0;0;0;0;0;Batidora de Pedestal FDV Venus Grey;ELECTRODOMESTICOS
12047319;;M;54;CHILENO;;X;LA PINTANA                    ;METROPOLITANA;0;0;0;0;0;0;0;0;0;Batidora Manual UT-TEKLA300;ELECTRODOMESTICOS
9782882;;M;42;CHILENO;;X;PROVIDENCIA                   ;METROPOLITANA;0;0;0;0;0;0;0;0;0;Hervidor Electrico HA-3300 2,5Lts Blanco;ELECTRODOMESTICOS
18690762;;F;28;CHILENO;;Millenial;TOME                          ;BIO BIO;0;0;0;0;0;0;0;0;0;Turbo Airfryer Oster;ELECTRODOMESTICOS
11933050;;F;53;CHILENO;;X;N/D;N/D;0;0;0;0;0;0;0;0;0;Horno Microondas Mecanico C1700N 17Lts Blanco;ELECTRODOMESTICOS
17955323;;F;33;CHILENO;;Millenial;LOS ANDES                     ;VALPARAISO;0;0;0;0;0;0;0;0;0;Licuadora Kaliman Negra con Teclas;ELECTRODOMESTICOS
19096982;;M;26;CHILENO;;Z;N/D;N/D;0;0;0;0;0;0;0;0;0;Horno Microondas Digital L UT-25KROMM 25Lts;ELECTRODOMESTICOS
15948308;;F;36;CHILENO;;Millenial;SAN FELIPE                    ;VALPARAISO;0;0;0;0;0;0;0;0;0;Hervidor Electrico HA-2650NG;ELECTRODOMESTICOS
19048582;;F;26;CHILENO;;Z;QUILLOTA                      ;VALPARAISO;0;0;0;0;0;0;0;0;0;LICUADORA CROMADA CON TECLAS PLUS;ELECTRODOMESTICOS
10973443;Casado;M;42;CHILENO;MEDICO CIRUJANO;Silencioso;PROVIDENCIA                   ;METROPOLITANA;0;0;0;0;0;0;0;0;0;Turbo Airfryer Oster;ELECTRODOMESTICOS
19156689;;M;23;CHILENO;;Z;PROVIDENCIA                   ;METROPOLITANA;0;0;0;0;0;0;0;0;0;Aspiradora Trapeadora Robot Ut-Excellenza (B);ELECTRODOMESTICOS
8198330;;M;62;CHILENO;;Boomers;VALDIVIA                      ;LOS RIOS;0;0;0;0;0;0;0;0;0;Plancha UT-KERAMIK1 2200Watts Base Ceramica;ELECTRODOMESTICOS
7960647;;F;68;CHILENO;;Silencioso;PUNTA ARENAS                  ;MAGALLANES;0;0;0;0;0;0;0;0;0;Aspiradora TH1870 Arrastre 1800Watts Gris;ELECTRODOMESTICOS
18386155;;F;29;CHILENO;;Millenial;CALAMA                        ;ANTOFAGASTA;0;0;0;0;0;0;0;0;0;Tostador de Pan TH-126 4 Rebanadas Negro;ELECTRODOMESTICOS
11895474;;M;50;CHILENO;;X;SAN CLEMENTE                  ;MAULE;0;0;0;0;0;0;0;0;0;PROCESADOR DE ALIMENTOS UT-PROCESSOR750;ELECTRODOMESTICOS
19641549;;F;24;CHILENO;;Z;PUYEHUE                       ;LOS LAGOS;0;0;0;0;0;0;0;0;0;FREIDORA DE AIRE CKSTAF15B 1850W;ELECTRODOMESTICOS
15453854;Soltero;F;40;CHILENO;;Silencioso;PROVIDENCIA                   ;METROPOLITANA;0;0;0;0;0;0;0;0;0;Combo Licuadora + Batidora;ELECTRODOMESTICOS
19334915;Soltero;F;26;CHILENO;;Silencioso;PROVIDENCIA                   ;METROPOLITANA;0;0;0;0;0;0;0;0;0;Batidora Vertical Minipimer UT-KLOT400P;ELECTRODOMESTICOS
10689586;;F;50;CHILENO;;X;N/D;N/D;0;0;0;0;0;0;0;0;0;Hervidor Electrico UT-DUNKEL17P 2Lts Negro;ELECTRODOMESTICOS
25083351;;M;28;PERUANO;;Extranjero;QUINTA NORMAL                 ;METROPOLITANA;0;0;0;0;0;0;0;0;0;Hervidor Electrico Tetera HA-4100 4Lts Iox;ELECTRODOMESTICOS
13687409;;M;43;CHILENO;;Silencioso;PROVIDENCIA                   ;METROPOLITANA;0;0;0;0;0;0;0;0;0;Tostador de Pan TP-1310 NG;ELECTRODOMESTICOS
12920543;Soltero;F;47;CHILENO;;X;PROVIDENCIA                   ;METROPOLITANA;0;0;0;0;0;0;0;0;0;Hervidor Electrico UT-KLAR20PW 2Lts Blanco;ELECTRODOMESTICOS
17155046;Soltero;F;33;CHILENO;PSICOLOGA;Millenial;PROVIDENCIA                   ;METROPOLITANA;0;0;0;0;0;0;0;0;0;Horno Electrico UT-BACKOFEN26 26Lts;ELECTRODOMESTICOS
20061823;;M;23;CHILENO;;Millenial;N/D;N/D;0;0;0;0;0;0;0;0;0;Aspiradora TH1415 Arrastre 1500Watts;ELECTRODOMESTICOS
17869008;;F;31;CHILENO;;Millenial;SAN CARLOS                    ;BIO BIO;0;0;0;0;0;0;0;0;0;ASPIRADORA THOMAS TH-1640;ELECTRODOMESTICOS
12198543;;F;50;CHILENO;;X;RENCA                         ;METROPOLITANA;0;0;0;0;0;0;0;0;0;Horno Electrico UT-BACKOFEN48 48Lts;ELECTRODOMESTICOS
19528437;;F;25;CHILENO;;Silencioso;PROVIDENCIA                   ;METROPOLITANA;0;0;0;0;0;0;0;0;0;Aspiradora Trapeadora Robot Ut-Excellenza (B);ELECTRODOMESTICOS
9469374;;F;61;CHILENO;;Boomers;CAUQUENES                     ;MAULE;0;0;0;0;0;0;0;0;0;Horno Electrico TH-38N 38Lts;ELECTRODOMESTICOS
4575969;;F;80;CHILENO;;Silencioso;CONSTITUCION                  ;MAULE;0;0;0;0;0;0;0;0;0;Hervidor Electrico UT-KLAR20PW 2Lts Blanco;ELECTRODOMESTICOS
17255523;;F;32;CHILENO;;Silencioso;PROVIDENCIA                   ;METROPOLITANA;0;0;0;0;0;0;0;0;0;Horno Electrico UT-BACKOFEN26 26Lts;ELECTRODOMESTICOS
8258125;Casado;F;62;CHILENO;;Boomers;RENCA                         ;METROPOLITANA;0;0;0;0;0;0;0;0;0;Picadora TH-9020V Vaso Vidrio 2Lts;ELECTRODOMESTICOS
12062403;;M;48;CHILENO;;X;PROVIDENCIA                   ;METROPOLITANA;0;0;0;0;0;0;0;0;0;Aspiradora Mi Robot Vacuum-Mop P Black XIAOMI;ELECTRODOMESTICOS
12375955;;M;49;CHILENO;;Silencioso;PROVIDENCIA                   ;METROPOLITANA;0;0;0;0;0;0;0;0;0;Hervidor Electrico 3100 1,7Lts Negro;ELECTRODOMESTICOS
15012907;;M;37;CHILENO;;Millenial;ANTOFAGASTA                   ;ANTOFAGASTA;0;0;0;0;0;0;0;0;0;Batidora Vertical Minipimer UT-KLOT400P;ELECTRODOMESTICOS
9812794;;M;59;CHILENO;;Boomers;SAN ANTONIO                   ;VALPARAISO;0;0;0;0;0;0;0;0;0;Horno Electrico UT-BACKOFEN48 48Lts;ELECTRODOMESTICOS
17332091;;F;33;CHILENO;;Millenial;N/D;N/D;0;0;0;0;0;0;0;0;0;Horno Microondas Digital TH20DM 20Lts Espejado;ELECTRODOMESTICOS
10807718;;F;55;CHILENO;;Boomers;RENCA                         ;METROPOLITANA;0;0;0;0;0;0;0;0;0;Producto Segunda Seleccion Banda 8;ELECTRODOMESTICOS
13362066;;F;44;CHILENO;;X;LA SERENA                     ;COQUIMBO;0;0;0;0;0;0;0;0;0;Horno Electrico UT-BACKOFEN26 26Lts;ELECTRODOMESTICOS
19446433;;M;25;CHILENO;;Z;N/D;N/D;0;0;0;0;0;0;0;0;0;Horno Electrico UT-LEIF36 36Lts;ELECTRODOMESTICOS
19807153;;F;24;CHILENO;;Millenial;PROVIDENCIA                   ;METROPOLITANA;0;0;0;0;0;0;0;0;0;Batidora Manual 2532;ELECTRODOMESTICOS
9299341;Casado;F;54;CHILENO;PROFESOR;Boomers;RENCA                         ;METROPOLITANA;0;0;0;0;0;0;0;0;0;BATIDORA PEDESTAL THOMAS TH-910PB;ELECTRODOMESTICOS
15231346;;M;39;CHILENO;;X;N/D;N/D;0;0;0;0;0;0;0;0;0;Aspiradora TH1870 Arrastre 1800Watts Gris;ELECTRODOMESTICOS
20167046;;F;23;CHILENO;;Z;PROVIDENCIA                   ;METROPOLITANA;0;0;0;0;0;0;0;0;0;Maquina de Coser Remington J011;ELECTRODOMESTICOS
15194517;;F;39;CHILENO;;X;YUMBEL                        ;BIO BIO;0;0;0;0;0;0;0;0;0;Horno Electrico UT-BACKOFEN38 38Lts;ELECTRODOMESTICOS
18731936;;F;27;CHILENO;;Millenial;PROVIDENCIA                   ;METROPOLITANA;0;0;0;0;0;0;0;0;0;Aspiradora AP1700 Arrastre 1700Watts;ELECTRODOMESTICOS
17507422;Soltero;F;31;CHILENO;;Millenial;PROVIDENCIA                   ;METROPOLITANA;0;0;0;0;0;0;0;0;0;Horno Electrico TH-80i 80Lts;ELECTRODOMESTICOS
9650990;;F;63;CHILENO;;Boomers;VALDIVIA                      ;LOS LAGOS;0;0;0;0;0;0;0;0;0;Hervidor Electrico UT-DUNKEL17P 2Lts Negro;ELECTRODOMESTICOS
20610809;;F;26;CHILENO;;Z;PROVIDENCIA                   ;METROPOLITANA;0;0;0;0;0;0;0;0;0;Freidora de Aire 18M Oster;ELECTRODOMESTICOS
16299292;;F;36;CHILENO;;Millenial;PROVIDENCIA                   ;METROPOLITANA;0;0;0;0;0;0;0;0;0;Batidora Vertical Minipimer UT-KLOT800SS;ELECTRODOMESTICOS
16770759;;F;35;CHILENO;;Millenial;RENCA                         ;METROPOLITANA;0;0;0;0;0;0;0;0;0;Licuadora L2000VNG 1,5Lts Vaso Vidrio;ELECTRODOMESTICOS
19552836;;F;25;CHILENO;;Z;PROVIDENCIA                   ;METROPOLITANA;0;0;0;0;0;0;0;0;0;Horno Electrico UT-BACKOFEN26 26Lts;ELECTRODOMESTICOS
10367809;;F;49;CHILENO;;X;VILLA ALEMANA                 ;VALPARAISO;0;0;0;0;0;0;0;0;0;Batidora Manual BA-5010 Inox;ELECTRODOMESTICOS
16256693;;M;36;CHILENO;;Millenial;N/D;N/D;0;0;0;0;0;0;0;0;0;Picadora TH-9020V Vaso Vidrio 2Lts;ELECTRODOMESTICOS
7958389;;F;63;CHILENO;;Boomers;RENCA                         ;METROPOLITANA;0;0;0;0;0;0;0;0;0;Cafetera TH-130;ELECTRODOMESTICOS
15695877;;F;38;CHILENO;;Millenial;ARICA                         ;TARAPACA;0;0;0;0;0;0;0;0;0;Batidora Manual BA-5010 Inox;ELECTRODOMESTICOS
17360300;;F;32;CHILENO;;Millenial;N/D;N/D;0;0;0;0;0;0;0;0;0;Aspiradora UT-SILENT1804 Arrastre 1800Watts;ELECTRODOMESTICOS
7192923;;F;71;CHILENO;;Silencioso;PUENTE ALTO                   ;METROPOLITANA;0;0;0;0;0;0;0;0;0;Batidora Manual 2532;ELECTRODOMESTICOS
19165509;Soltero;F;26;CHILENO;;Z;PROVIDENCIA                   ;METROPOLITANA;0;0;0;0;0;0;0;0;0;Horno Electrico TH62I 60Lts;ELECTRODOMESTICOS
11069062;;F;56;CHILENO;;Boomers;PLACILLA                      ;L.G.B.OÂ´HIGGINS;0;0;0;0;0;0;0;0;0;Licuadora TH-320 Roja/Negro 1,5 Lts Vaso Vidrio;ELECTRODOMESTICOS
10822136;Casado;F;55;CHILENO;;Boomers;RENCA                         ;METROPOLITANA;0;0;0;0;0;0;0;0;0;Extractor de Jugo EX800 1,4Lts;ELECTRODOMESTICOS
14147987;;M;40;CHILENO;;Silencioso;"";"";0;0;0;0;0;0;0;0;0;Aspiradora TH1415 Arrastre 1500Watts;ELECTRODOMESTICOS
13519644;;F;44;CHILENO;;X;"";"";0;0;0;0;0;0;0;0;0;Horno Electrico TH-80i 80Lts;ELECTRODOMESTICOS
8334533;;F;66;CHILENO;;Boomers;CONCHALI                      ;METROPOLITANA;0;0;0;0;0;0;0;0;0;Extractor de Jugo EX800 1,4Lts;ELECTRODOMESTICOS
15932094;;F;36;CHILENO;;Millenial;PROVIDENCIA                   ;METROPOLITANA;0;0;0;0;0;0;0;0;0;Horno Electrico TH-38N 38Lts;ELECTRODOMESTICOS
12554671;;F;49;CHILENO;;X;RENCA                         ;METROPOLITANA;0;0;0;0;0;0;0;0;0;Hervidor Electrico TH-4212N 1,7Lts Negro;ELECTRODOMESTICOS
15716788;;F;39;CHILENO;;X;"";"";0;0;0;0;0;0;0;0;0;Horno Electrico TH-25N01 25Lts;ELECTRODOMESTICOS
9463860;;F;56;CHILENO;;Boomers;CABILDO                       ;VALPARAISO;0;0;0;0;0;0;0;0;0;Plancha UT-PLATTEISEN 2000Watts Base Ceramica;ELECTRODOMESTICOS
15269201;;F;43;CHILENO;;X;RIO BUENO                     ;LOS RIOS;0;0;0;0;0;0;0;0;0;Batidora Pedestal UT-KLEIN700;ELECTRODOMESTICOS
19508335;Soltero;F;25;CHILENO;TECNICO DE NIVEL SUPERIOR EN ENFERMERIA;Z;PROVIDENCIA                   ;METROPOLITANA;0;0;0;0;0;0;0;0;0;Horno Electrico TH62I 60Lts;ELECTRODOMESTICOS
7459347;;F;69;CHILENO;;Silencioso;LOS ANGELES                   ;BIO BIO;0;0;0;0;0;0;0;0;0;Batidora Vertical Minipimer UT-KLOT400P;ELECTRODOMESTICOS
3307144;;M;88;CHILENO;;Silencioso;RENCA                         ;METROPOLITANA;0;0;0;0;0;0;0;0;0;Hervidor Termo TH-5440TK 1,5Lts Inox;ELECTRODOMESTICOS
18119274;;M;30;CHILENO;;Millenial;LO PRADO                      ;METROPOLITANA;0;0;0;0;0;0;0;0;0;Aspiradora TH1415 Arrastre 1500Watts;ELECTRODOMESTICOS
16428248;Soltero;F;35;CHILENO;;Silencioso;PROVIDENCIA                   ;METROPOLITANA;0;0;0;0;0;0;0;0;0;Aspiradora AP1700 Arrastre 1700Watts;ELECTRODOMESTICOS
15466578;Casado;F;41;CHILENO;CONTADOR GENERAL;Silencioso;PROVIDENCIA                   ;METROPOLITANA;0;0;0;0;0;0;0;0;0;Horno Microondas Digital TH-20S01 20Lts;ELECTRODOMESTICOS
14432221;;M;51;CHILENO;;X;SAN BERNARDO                  ;METROPOLITANA;0;0;0;0;0;0;0;0;0;Horno Microondas Mecanico Fancy 20Lts;ELECTRODOMESTICOS
6016519;Casado;M;74;CHILENO;;Silencioso;RENCA                         ;METROPOLITANA;0;0;0;0;0;0;0;0;0;HERVIDOR TH-4340;ELECTRODOMESTICOS
5741009;;F;71;CHILENO;;Silencioso;RENCA                         ;METROPOLITANA;0;0;0;0;0;0;0;0;0;Horno Electrico TH-48N 48Lts;ELECTRODOMESTICOS
16656676;;F;35;CHILENO;;Millenial;COQUIMBO;COQUIMBO;0;0;0;0;0;0;0;0;0;Aspiradora Trapeadora Robot Ut-Excellenza (B);ELECTRODOMESTICOS
9772126;Soltero;F;59;CHILENO;PROFESOR;Boomers;PROVIDENCIA                   ;METROPOLITANA;0;0;0;0;0;0;0;0;0;Aspiradora TH1415 Arrastre 1500Watts;ELECTRODOMESTICOS
17036680;;M;35;CHILENO;;Millenial;PROVIDENCIA                   ;METROPOLITANA;0;0;0;0;0;0;0;0;0;Hervidor Electrico TH-4350 3Lts Blanco;ELECTRODOMESTICOS
9917700;;M;54;CHILENO;;Silencioso;PROVIDENCIA                   ;METROPOLITANA;0;0;0;0;0;0;0;0;0;Combo Plancha Batidora Secador de Pelo;ELECTRODOMESTICOS
18605035;;F;28;CHILENO;;Millenial;PROVIDENCIA                   ;METROPOLITANA;0;0;0;0;0;0;0;0;0;Horno Electrico TH62I 60Lts;ELECTRODOMESTICOS
10994951;;F;54;CHILENO;;X;PROVIDENCIA                   ;METROPOLITANA;0;0;0;0;0;0;0;0;0;Horno Electrico UT-BACKOFEN26 26Lts;ELECTRODOMESTICOS
19318267;Soltero;M;26;CHILENO;;Z;PROVIDENCIA                   ;METROPOLITANA;0;0;0;0;0;0;0;0;0;Licuadora TH-320 Roja/Negro 1,5 Lts Vaso Vidrio;ELECTRODOMESTICOS
12634730;;M;47;CHILENO;;X;PADRE HURTADO                 ;METROPOLITANA;0;0;0;0;0;0;0;0;0;Horno Microondas Digital L UT-25KROMM 25Lts;ELECTRODOMESTICOS
13092155;;F;46;CHILENO;;X;PROVIDENCIA                   ;METROPOLITANA;0;0;0;0;0;0;0;0;0;Maquina de Coser 311;ELECTRODOMESTICOS
16753983;;F;34;CHILENO;;Silencioso;PROVIDENCIA                   ;METROPOLITANA;0;0;0;0;0;0;0;0;0;Batidora Pedestal TH910PN 4,6Lts 1300Watts;ELECTRODOMESTICOS
16490885;Soltero;F;28;CHILENO;;Millenial;PROVIDENCIA                   ;METROPOLITANA;0;0;0;0;0;0;0;0;0;Plancha OSTER 4801T 1200Watts Base Ceramica;ELECTRODOMESTICOS
14049307;;M;40;CHILENO;;X;NANCAGUA                      ;L.G.B.OÂ´HIGGINS;0;0;0;0;0;0;0;0;0;Horno Electrico UT-BACKOFEN60 60Lts;ELECTRODOMESTICOS
11593101;;F;51;CHILENO;;Silencioso;PROVIDENCIA                   ;METROPOLITANA;0;0;0;0;0;0;0;0;0;Licuadora TH-501V 1,5Lts Vaso Vidrio;ELECTRODOMESTICOS
6845307;;M;69;CHILENO;;Silencioso;MELIPILLA                     ;METROPOLITANA;0;0;0;0;0;0;0;0;0;Batidora Pedestal UT-KLEIN700;ELECTRODOMESTICOS
15530976;;M;39;CHILENO;;X;ANGOL                         ;ARAUCANIA;0;0;0;0;0;0;0;0;0;FREIDORA DE AIRE CKSTAF15B 1850W;ELECTRODOMESTICOS
9677485;Casado;F;58;CHILENO;;Boomers;PROVIDENCIA                   ;METROPOLITANA;0;0;0;0;0;0;0;0;0;Horno Microondas Digital L UT-25KROMM 25Lts;ELECTRODOMESTICOS
12885199;;F;49;CHILENO;;X;N/D;N/D;0;0;0;0;0;0;0;0;0;EXTRACTOR DE JUGOS UT-NUTRISMART;ELECTRODOMESTICOS
18488987;;M;29;CHILENO;;Millenial;SAN CARLOS                    ;BIO BIO;0;0;0;0;0;0;0;0;0;Horno Electrico TH-25N01 25Lts;ELECTRODOMESTICOS
5993053;;F;71;CHILENO;;Silencioso;RENCA                         ;METROPOLITANA;0;0;0;0;0;0;0;0;0;HERVIDOR ELECTRICO UT-STARK18;ELECTRODOMESTICOS
15645506;;M;38;CHILENO;;Millenial;PROVIDENCIA                   ;METROPOLITANA;0;0;0;0;0;0;0;0;0;Exprimidor Fauna 500 cc;ELECTRODOMESTICOS
15584959;;M;39;CHILENO;;Millenial;"";"";0;0;0;0;0;0;0;0;0;Horno Electrico UT-BACKOFEN38 38Lts;ELECTRODOMESTICOS
19430844;;F;25;CHILENO;;Z;TALAGANTE                     ;METROPOLITANA;0;0;0;0;0;0;0;0;0;Batidora Pedestal B5300 Inox;ELECTRODOMESTICOS
15620057;;F;38;CHILENO;;X;SAN BERNARDO                  ;METROPOLITANA;0;0;0;0;0;0;0;0;0;Batidora Pedestal B5300 Inox;ELECTRODOMESTICOS
14455714;;F;46;CHILENO;;X;SAN ANTONIO                   ;VALPARAISO;0;0;0;0;0;0;0;0;0;Hervidor Electrico TH-4212N 1,7Lts Negro;ELECTRODOMESTICOS
12585419;;F;47;CHILENO;;X;CHIMBARONGO                   ;L.G.B.OÂ´HIGGINS;0;0;0;0;0;0;0;0;0;Aspiradora Tambor APA1000 1000Watts;ELECTRODOMESTICOS
17559754;Casado;F;31;CHILENO;;Silencioso;PROVIDENCIA                   ;METROPOLITANA;0;0;0;0;0;0;0;0;0;MICROONDAS ME83X/XZS SAMSUNG MIRROR;ELECTRODOMESTICOS
8218689;Soltero;F;63;CHILENO;;Boomers;RENCA                         ;METROPOLITANA;0;0;0;0;0;0;0;0;0;Horno Electrico UT-BACKOFEN60 60Lts;ELECTRODOMESTICOS
6077467;;M;71;CHILENO;;Silencioso;PROVIDENCIA                   ;METROPOLITANA;0;0;0;0;0;0;0;0;0;BATIDORA PEDESTAL THOMAS TH-910PB;ELECTRODOMESTICOS
9351046;Casado;F;61;CHILENO;PROFESOR;Boomers;PROVIDENCIA                   ;METROPOLITANA;0;0;0;0;0;0;0;0;0;Picadora TH-9020V Vaso Vidrio 2Lts;ELECTRODOMESTICOS
6597860;;F;68;CHILENO;;Boomers;PUDAHUEL                      ;METROPOLITANA;0;0;0;0;0;0;0;0;0;Horno Microondas Digital UT-CLASSY720 20Lts;ELECTRODOMESTICOS
8384805;;F;72;CHILENO;;Silencioso;PROVIDENCIA                   ;METROPOLITANA;0;0;0;0;0;0;0;0;0;Batidora Manual 2532;ELECTRODOMESTICOS
5939244;;F;72;CHILENO;;Silencioso;CERRO NAVIA                   ;METROPOLITANA;0;0;0;0;0;0;0;0;0;Horno Microondas Digital UT-CLASSY720 20Lts;ELECTRODOMESTICOS
18387146;Soltero;M;29;CHILENO;NUTRICIONISTA;Millenial;PROVIDENCIA                   ;METROPOLITANA;0;0;0;0;0;0;0;0;0;Aspiradora AP1700 Arrastre 1700Watts;ELECTRODOMESTICOS
16083405;;F;37;CHILENO;;Millenial;PROVIDENCIA                   ;METROPOLITANA;0;0;0;0;0;0;0;0;0;Horno Microondas Mecanico Easy Wave 20Lts;ELECTRODOMESTICOS
9984839;;F;58;CHILENO;;Boomers;CHILLAN VIEJO                 ;BIO BIO;0;0;0;0;0;0;0;0;0;Plancha TH-7052 2000Watts Base Inox;ELECTRODOMESTICOS
17425603;Soltero;F;32;CHILENO;NUTRICIONISTA;Millenial;PROVIDENCIA                   ;METROPOLITANA;0;0;0;0;0;0;0;0;0;Aspiradora VCC4190V3E/XZS Arrastre 2000Watts;ELECTRODOMESTICOS
10518704;;F;52;CHILENO;;X;TEMUCO                        ;ARAUCANIA;0;0;0;0;0;0;0;0;0;Horno Microondas Mecanico TH-18B05 18Lts;ELECTRODOMESTICOS
9297968;Casado;F;61;CHILENO;;Boomers;RENCA                         ;METROPOLITANA;0;0;0;0;0;0;0;0;0;Hervidor Electrico 388R Rojo;ELECTRODOMESTICOS
18847290;Soltero;M;28;CHILENO;;Silencioso;PROVIDENCIA                   ;METROPOLITANA;0;0;0;0;0;0;0;0;0;Horno Electrico TH-80i 80Lts;ELECTRODOMESTICOS
15633749;;M;39;CHILENO;;Silencioso;PROVIDENCIA                   ;METROPOLITANA;0;0;0;0;0;0;0;0;0;Horno Electrico UT-BACKOFEN38 38Lts;ELECTRODOMESTICOS
13460980;;F;44;CHILENO;;X;"";"";0;0;0;0;0;0;0;0;0;Exprimidor de Jugo 407W 1Lts;ELECTRODOMESTICOS
17520366;;M;31;CHILENO;;Millenial;PROVIDENCIA                   ;METROPOLITANA;0;0;0;0;0;0;0;0;0;Horno Electrico TH-25N01 25Lts;ELECTRODOMESTICOS
17014370;;F;33;CHILENO;;Millenial;MELIPILLA                     ;METROPOLITANA;0;0;0;0;0;0;0;0;0;Horno Microondas Mecanico Easy Wave 20Lts;ELECTRODOMESTICOS
13096838;;M;46;CHILENO;;X;N/D;N/D;0;0;0;0;0;0;0;0;0;Aspiradora Tambor APA1000 1000Watts;ELECTRODOMESTICOS
15618418;;F;39;CHILENO;;X;PROVIDENCIA                   ;METROPOLITANA;0;0;0;0;0;0;0;0;0;Batidora Manual BM-490IN Multi Accesorios;ELECTRODOMESTICOS
5141342;;F;79;CHILENO;;Silencioso;SALAMANCA                     ;COQUIMBO;0;0;0;0;0;0;0;0;0;Horno Electrico TH-48N 48Lts;ELECTRODOMESTICOS
19768146;;M;24;CHILENO;;Z;SAGRADA FAMILIA               ;MAULE;0;0;0;0;0;0;0;0;0;Horno Microondas Mecanico Easy Wave 20Lts;ELECTRODOMESTICOS
18626619;Soltero;F;28;CHILENO;ENFERMERA;Silencioso;PROVIDENCIA                   ;METROPOLITANA;0;0;0;0;0;0;0;0;0;Plancha Paninis 2880;ELECTRODOMESTICOS
10393380;Casado;F;56;CHILENO;PROFESOR;Boomers;PROVIDENCIA                   ;METROPOLITANA;0;0;0;0;0;0;0;0;0;Horno Microondas Mecanico Easy Wave 20Lts;ELECTRODOMESTICOS
19169796;Soltero;F;26;CHILENO;TECNICO DE NIVEL SUPERIOR COMO ENFERMERO MILITAR;Z;PROVIDENCIA                   ;METROPOLITANA;0;0;0;0;0;0;0;0;0;Freidora de Aire 2,5 L 35051-CL Hamilton Beach;ELECTRODOMESTICOS
10292528;;F;57;CHILENO;;Boomers;CALERA                        ;VALPARAISO;0;0;0;0;0;0;0;0;0;Licuadora L2000VNG 1,5Lts Vaso Vidrio;ELECTRODOMESTICOS
16501943;;M;35;CHILENO;;Millenial;N/D;N/D;0;0;0;0;0;0;0;0;0;H. Microondas Grill Reflection (3000 DGM);ELECTRODOMESTICOS
16813627;Soltero;F;34;CHILENO;PSICOLOGO;Millenial;PROVIDENCIA                   ;METROPOLITANA;0;0;0;0;0;0;0;0;0;Robot aspirador Roomba E5;ELECTRODOMESTICOS
17380056;;F;32;CHILENO;;Silencioso;PROVIDENCIA                   ;METROPOLITANA;0;0;0;0;0;0;0;0;0;Enceradora EA-5000;ELECTRODOMESTICOS
13343176;;M;44;CHILENO;;Silencioso;PROVIDENCIA                   ;METROPOLITANA;0;0;0;0;0;0;0;0;0;Horno Electrico UT-BACKOFEN38 38Lts;ELECTRODOMESTICOS
12140919;;M;52;CHILENO;;X;PROVIDENCIA                   ;METROPOLITANA;0;0;0;0;0;0;0;0;0;PICADORA 123 SILHQUETTE;ELECTRODOMESTICOS
9754616;;F;59;CHILENO;;Boomers;RENCA                         ;METROPOLITANA;0;0;0;0;0;0;0;0;0;Olla Arrocera OA-400NG 1,8Lts;ELECTRODOMESTICOS
8194481;;M;62;CHILENO;;Boomers;TALCAHUANO                    ;BIO BIO;0;0;0;0;0;0;0;0;0;Horno Electrico UT-BACKOFEN60 60Lts;ELECTRODOMESTICOS
5047002;;F;76;CHILENO;;Silencioso;OVALLE                        ;COQUIMBO;0;0;0;0;0;0;0;0;0;Batidora Vertical Multimixer TH-8720;ELECTRODOMESTICOS
26074450;;M;28;HAITIANO;;Extranjero;PUERTO MONTT                  ;LOS LAGOS;0;0;0;0;0;0;0;0;0;Horno Microondas Mecanico TH-18B05 18Lts;ELECTRODOMESTICOS
20535160;;M;21;CHILENO;;Millenial;"";"";0;0;0;0;0;0;0;0;0;Hervidor Electrico Tetera HA-4100 4Lts Iox;ELECTRODOMESTICOS
17196982;;F;29;CHILENO;;Millenial;PROVIDENCIA                   ;METROPOLITANA;0;0;0;0;0;0;0;0;0;Licuadora L2000VNG 1,5Lts Vaso Vidrio;ELECTRODOMESTICOS
7008258;;F;68;CHILENO;;Boomers;BUIN                          ;METROPOLITANA;0;0;0;0;0;0;0;0;0;Aspiradora TH1870 Arrastre 1800Watts Gris;ELECTRODOMESTICOS
18328161;Soltero;M;29;CHILENO;;Millenial;PROVIDENCIA                   ;METROPOLITANA;0;0;0;0;0;0;0;0;0;LICUADORA BLANCA CON ROTOR 1,5LTS;ELECTRODOMESTICOS
16126554;Soltero;F;36;CHILENO;KINESIOLOGA;Silencioso;PROVIDENCIA                   ;METROPOLITANA;0;0;0;0;0;0;0;0;0;Aspiradora UT-SILENT1603 Arrastre 1600Watts;ELECTRODOMESTICOS
19129777;;F;27;CHILENO;;Z;SAN FELIPE                    ;VALPARAISO;0;0;0;0;0;0;0;0;0;Plancha UT-SHANGRILA Inalambrica 2200Watss;ELECTRODOMESTICOS
13749497;Casado;F;41;CHILENO;;X;ILLAPEL                       ;COQUIMBO;0;0;0;0;0;0;0;0;0;Aspiradora VCC4190V3E/XZS Arrastre 2000Watts;ELECTRODOMESTICOS
17520390;Soltero;F;31;CHILENO;FONOAUDIOLOGO;Millenial;PROVIDENCIA                   ;METROPOLITANA;0;0;0;0;0;0;0;0;0;Parrilla Electrica TH-224;ELECTRODOMESTICOS
18739296;Soltero;M;28;CHILENO;;Millenial;HUECHURABA;METROPOLITANA;0;0;0;0;0;0;0;0;0;Horno Microondas Mecanico UT-SYDNEY18 18Lts;ELECTRODOMESTICOS
14242187;;F;48;CHILENO;;X;PROVIDENCIA                   ;METROPOLITANA;0;0;0;0;0;0;0;0;0;Horno Electrico TH-48N 48Lts;ELECTRODOMESTICOS
18955209;Soltero;F;27;CHILENO;;Silencioso;PROVIDENCIA                   ;METROPOLITANA;0;0;0;0;0;0;0;0;0;Maquina para Hacer Pan MPP-600 BL;ELECTRODOMESTICOS
15146588;;F;40;CHILENO;;X;COELEMU                       ;BIO BIO;0;0;0;0;0;0;0;0;0;Licuadora L2000VNG 1,5Lts Vaso Vidrio;ELECTRODOMESTICOS
6385465;Casado;F;70;CHILENO;INGENIERO;Silencioso;PROVIDENCIA                   ;METROPOLITANA;0;0;0;0;0;0;0;0;0;Aspiradora VCC4190V3E/XZS Arrastre 2000Watts;ELECTRODOMESTICOS
19766882;;F;24;CHILENO;;Z;PROVIDENCIA                   ;METROPOLITANA;0;0;0;0;0;0;0;0;0;Horno Electrico TH-38N 38Lts;ELECTRODOMESTICOS
18353167;Soltero;M;29;CHILENO;;Millenial;PROVIDENCIA                   ;METROPOLITANA;0;0;0;0;0;0;0;0;0;Horno Electrico TH62I 60Lts;ELECTRODOMESTICOS
10343780;;F;51;CHILENO;;X;PROVIDENCIA                   ;METROPOLITANA;0;0;0;0;0;0;0;0;0;Horno Electrico UT-BACKOFEN26 26Lts;ELECTRODOMESTICOS
14283586;;F;48;CHILENO;;X;PROVIDENCIA                   ;METROPOLITANA;0;0;0;0;0;0;0;0;0;Licuadora UT-METALLEK605P 1,55Lts;ELECTRODOMESTICOS
11592813;;M;53;CHILENO;;Millenial;"";"";0;0;0;0;0;0;0;0;0;Horno Electrico UT-LEIF36 36Lts;ELECTRODOMESTICOS
17483073;;M;32;CHILENO;;Silencioso;PROVIDENCIA                   ;METROPOLITANA;0;0;0;0;0;0;0;0;0;BATIDORA MANUAL 150W 5VEL. B-1500 BLANCA;ELECTRODOMESTICOS
15420217;;M;40;CHILENO;;X;PROVIDENCIA                   ;METROPOLITANA;0;0;0;0;0;0;0;0;0;Picadora TH-9020V Vaso Vidrio 2Lts;ELECTRODOMESTICOS
16512238;;F;35;CHILENO;;Millenial;ANGOL                         ;ARAUCANIA;0;0;0;0;0;0;0;0;0;Licuadora TH-501V 1,5Lts Vaso Vidrio;ELECTRODOMESTICOS
13032794;;F;45;CHILENO;;X;CERRO NAVIA                   ;METROPOLITANA;0;0;0;0;0;0;0;0;0;TERMOHERVIDOR ELECTRON 3,1 LTS BA-6932 RG;ELECTRODOMESTICOS
26022156;;F;55;EXTRANJERO - NO INFORMA NACIONALIDAD;;Extranjero;SANTIAGO                      ;METROPOLITANA;0;0;0;0;0;0;0;0;0;Maquina de Coser JS-2135CL Calipso;ELECTRODOMESTICOS
5150347;;M;77;CHILENO;;Silencioso;ALTO HOSPICIO;TARAPACA;0;0;0;0;0;0;0;0;0;PROCESADOR THOMAS TH-9160;ELECTRODOMESTICOS
8685906;;M;51;CHILENO;;X;NATALES                       ;MAGALLANES;0;0;0;0;0;0;0;0;0;Licuadora Roja 550W 1,5Lts Vaso Vidrio;ELECTRODOMESTICOS
19057708;;F;27;CHILENO;;Z;PUDAHUEL                      ;METROPOLITANA;0;0;0;0;0;0;0;0;0;Hervidor Electrico HA-3300 2,5Lts Blanco;ELECTRODOMESTICOS
19674770;;F;25;CHILENO;;Z;PUERTO MONTT                  ;LOS LAGOS;0;0;0;0;0;0;0;0;0;Batidora Pedestal UT-KLEIN700;ELECTRODOMESTICOS
17600070;;F;31;CHILENO;;Silencioso;PROVIDENCIA                   ;METROPOLITANA;0;0;0;0;0;0;0;0;0;Robot aspirador Roomba 675;ELECTRODOMESTICOS
5530766;;F;76;CHILENO;;Silencioso;PROVIDENCIA                   ;METROPOLITANA;0;0;0;0;0;0;0;0;0;Horno Microondas Mecanico C1700N 17Lts Blanco;ELECTRODOMESTICOS
9666274;;F;49;CHILENO;;Silencioso;PROVIDENCIA                   ;METROPOLITANA;0;0;0;0;0;0;0;0;0;Horno Electrico TH-16N 16Lts;ELECTRODOMESTICOS
10869191;;M;55;CHILENO;;Boomers;RENCA                         ;METROPOLITANA;0;0;0;0;0;0;0;0;0;Hervidor Electrico 3100 1,7Lts Negro;ELECTRODOMESTICOS
17465409;;M;32;CHILENO;;Millenial;LA SERENA                     ;COQUIMBO;0;0;0;0;0;0;0;0;0;Licuadora L-25000NG;ELECTRODOMESTICOS
4837371;;M;79;CHILENO;;Silencioso;RETIRO                        ;MAULE;0;0;0;0;0;0;0;0;0;Horno Electrico TH62I 60Lts;ELECTRODOMESTICOS
8400570;;F;63;CHILENO;;Boomers;RENCA                         ;METROPOLITANA;0;0;0;0;0;0;0;0;0;Licuadora Roja 550W 1,5Lts Vaso Vidrio;ELECTRODOMESTICOS
19225970;;F;26;CHILENO;;Z;PROVIDENCIA                   ;METROPOLITANA;0;0;0;0;0;0;0;0;0;BATIDORA PLANETARIA BP-4500 BL;ELECTRODOMESTICOS
10038310;;M;54;CHILENO;;Boomers;ARICA                         ;ARICA Y PARINACOTA;0;0;0;0;0;0;0;0;0;Licuadora Roja 550W 1,5Lts Vaso Vidrio;ELECTRODOMESTICOS
18228762;;F;29;CHILENO;;Millenial;"";"";0;0;0;0;0;0;0;0;0;Maquina para Hacer Pan MPP-600 BL;ELECTRODOMESTICOS
10746487;;M;45;CHILENO;;X;N/D;N/D;0;0;0;0;0;0;0;0;0;Horno Microondas Digital L UT-25KROMM 25Lts;ELECTRODOMESTICOS
7076549;Casado;M;66;CHILENO;;Boomers;OVALLE                        ;COQUIMBO;0;0;0;0;0;0;0;0;0;PLANCHA A VAPOR 6003 BASE ANTIADHERENTE 1600W;ELECTRODOMESTICOS
12633653;;F;48;CHILENO;;X;LO PRADO                      ;METROPOLITANA;0;0;0;0;0;0;0;0;0;Horno Electrico TH-25N01 25Lts;ELECTRODOMESTICOS
18594064;Soltero;F;28;CHILENO;;Silencioso;PROVIDENCIA                   ;METROPOLITANA;0;0;0;0;0;0;0;0;0;Batidora Manual 2532;ELECTRODOMESTICOS
8406130;;M;60;CHILENO;;Boomers;PROVIDENCIA                   ;METROPOLITANA;0;0;0;0;0;0;0;0;0;Licuadora L2000VNG 1,5Lts Vaso Vidrio;ELECTRODOMESTICOS
7557219;;F;62;CHILENO;;Boomers;PROVIDENCIA                   ;METROPOLITANA;0;0;0;0;0;0;0;0;0;Batidora Manual Easy Mix HM250;ELECTRODOMESTICOS
15881154;;F;37;CHILENO;;Millenial;RENCA                         ;METROPOLITANA;0;0;0;0;0;0;0;0;0;Plancha UT-KERAMIK1 2200Watts Base Ceramica;ELECTRODOMESTICOS
9131208;;F;60;CHILENO;;Boomers;RENCA                         ;METROPOLITANA;0;0;0;0;0;0;0;0;0;Enceradora EA-5000;ELECTRODOMESTICOS
15417166;;M;40;CHILENO;;X;PENALOLEN                     ;METROPOLITANA;0;0;0;0;0;0;0;0;0;Aspiradora UT-MEINER1803 Arrastre 1800Watts;ELECTRODOMESTICOS
10267498;;F;54;CHILENO;;Silencioso;PROVIDENCIA                   ;METROPOLITANA;0;0;0;0;0;0;0;0;0;BATIDORA PEDESTAL THOMAS TH-910PB;ELECTRODOMESTICOS
13290215;;M;45;CHILENO;;X;LO ESPEJO                     ;METROPOLITANA;0;0;0;0;0;0;0;0;0;Olla Arrocera TH38IF 1,8Lts;ELECTRODOMESTICOS
11218713;Divorciado;F;54;CHILENO;;Boomers;PROVIDENCIA                   ;METROPOLITANA;0;0;0;0;0;0;0;0;0;Hervidor Electrico UT-MANLY17 1,7Lts Negro;ELECTRODOMESTICOS
13319674;;M;44;CHILENO;;X;PROVIDENCIA                   ;METROPOLITANA;0;0;0;0;0;0;0;0;0;Hervidor Electrico UT-MANLY17 1,7Lts Negro;ELECTRODOMESTICOS
16226007;Soltero;M;36;CHILENO;;Millenial;PROVIDENCIA                   ;METROPOLITANA;0;0;0;0;0;0;0;0;0;Licuadora UT-METALLEK505P 1,5Lts Vaso Vidrio;ELECTRODOMESTICOS
17143706;;F;33;CHILENO;;Millenial;PROVIDENCIA                   ;METROPOLITANA;0;0;0;0;0;0;0;0;0;Horno Microondas Digital TH-20S01 20Lts;ELECTRODOMESTICOS
16623676;;M;35;CHILENO;;Silencioso;PROVIDENCIA                   ;METROPOLITANA;0;0;0;0;0;0;0;0;0;Hervidor 41020-CL 1,7Lts Inox;ELECTRODOMESTICOS
6235351;;M;69;CHILENO;;Silencioso;PROVIDENCIA                   ;METROPOLITANA;0;0;0;0;0;0;0;0;0;Hervidor Electrico TH-5407i 2Lts;ELECTRODOMESTICOS
12061742;;F;54;CHILENO;;X;RENCA                         ;METROPOLITANA;0;0;0;0;0;0;0;0;0;Aspiradora VCC4190V3E/XZS Arrastre 2000Watts;ELECTRODOMESTICOS
12368329;;F;48;CHILENO;;X;PERALILLO                     ;L.G.B.OÂ´HIGGINS;0;0;0;0;0;0;0;0;0;Licuadora TH-501V 1,5Lts Vaso Vidrio;ELECTRODOMESTICOS
18940780;;F;27;CHILENO;;Z;PROVIDENCIA                   ;METROPOLITANA;0;0;0;0;0;0;0;0;0;PLANCHA VERTICAL V-1600VBL;ELECTRODOMESTICOS
18735167;;F;28;CHILENO;;Millenial;PROVIDENCIA                   ;METROPOLITANA;0;0;0;0;0;0;0;0;0;Horno Microondas Mecanico Easy Wave 20Lts;ELECTRODOMESTICOS
18896659;;M;28;CHILENO;;Millenial;PROVIDENCIA                   ;METROPOLITANA;0;0;0;0;0;0;0;0;0;HORNO ELECTRICO 16 LITROS HE-16NG;ELECTRODOMESTICOS
16986812;;F;33;CHILENO;;Millenial;LONCOCHE                      ;ARAUCANIA;0;0;0;0;0;0;0;0;0;Aspiradora UT-MEINER1803 Arrastre 1800Watts;ELECTRODOMESTICOS
12951951;Casado;M;45;CHILENO;;X;PROVIDENCIA                   ;METROPOLITANA;0;0;0;0;0;0;0;0;0;Hervidor Electrico HA-3300 2,5Lts Blanco;ELECTRODOMESTICOS
16489261;;F;35;CHILENO;;Millenial;N/D;N/D;0;0;0;0;0;0;0;0;0;Aspiradora Trapeadora Robot Ut-Excellenza (B);ELECTRODOMESTICOS
19473687;;F;25;CHILENO;;Z;PROVIDENCIA                   ;METROPOLITANA;0;0;0;0;0;0;0;0;0;Freidora FE-2510 BL 3Lts;ELECTRODOMESTICOS
9899491;Casado;M;58;CHILENO;ANALISTA DE SISTEMAS;Boomers;RENCA                         ;METROPOLITANA;0;0;0;0;0;0;0;0;0;LICUADORA MA-4210;ELECTRODOMESTICOS
13338066;Divorciado;F;44;CHILENO;;X;RENCA                         ;METROPOLITANA;0;0;0;0;0;0;0;0;0;Licuadora TH-320 Roja/Negro 1,5 Lts Vaso Vidrio;ELECTRODOMESTICOS
16716358;;F;34;CHILENO;;Silencioso;PROVIDENCIA                   ;METROPOLITANA;0;0;0;0;0;0;0;0;0;Horno Electrico TH-25N01 25Lts;ELECTRODOMESTICOS
16719592;;F;34;CHILENO;;Millenial;PROVIDENCIA                   ;METROPOLITANA;0;0;0;0;0;0;0;0;0;Hervidor Electrico TH-4350 3Lts Blanco;ELECTRODOMESTICOS
13325711;;M;44;CHILENO;;X;NATALES                       ;MAGALLANES;0;0;0;0;0;0;0;0;0;Licuadora L-1630V Negra 1,5Lts Vaso Vidrio;ELECTRODOMESTICOS
10489678;;F;54;CHILENO;;Boomers;RENCA                         ;METROPOLITANA;0;0;0;0;0;0;0;0;0;PROCESADOR THOMAS TH-9160;ELECTRODOMESTICOS
10332949;;F;53;CHILENO;;X;N/D;N/D;0;0;0;0;0;0;0;0;0;Horno Microondas Digital Deli (2017 DM) 20Lts;ELECTRODOMESTICOS
11619322;;M;51;CHILENO;;X;PROVIDENCIA                   ;METROPOLITANA;0;0;0;0;0;0;0;0;0;Hervidor Electrico HA-2650NG;ELECTRODOMESTICOS
6567107;Casado;M;68;CHILENO;;Silencioso;RENCA                         ;METROPOLITANA;0;0;0;0;0;0;0;0;0;Licuadora Osterizer 4112/72 1,25Lts Vaso Vidrio;ELECTRODOMESTICOS
6443879;;M;72;CHILENO;;Silencioso;RENCA                         ;METROPOLITANA;0;0;0;0;0;0;0;0;0;Horno Electrico UT-LEIF36 36Lts;ELECTRODOMESTICOS
8167561;;F;65;CHILENO;;Boomers;PROVIDENCIA                   ;METROPOLITANA;0;0;0;0;0;0;0;0;0;Licuadora Roja 550W 1,5Lts Vaso Vidrio;ELECTRODOMESTICOS
12753239;;M;47;CHILENO;;X;PROVIDENCIA                   ;METROPOLITANA;0;0;0;0;0;0;0;0;0;Aspiradora AP1700 Arrastre 1700Watts;ELECTRODOMESTICOS
16039010;;M;36;CHILENO;;Millenial;PROVIDENCIA                   ;METROPOLITANA;0;0;0;0;0;0;0;0;0;Aspiradora UT-MEINER1803 Arrastre 1800Watts;ELECTRODOMESTICOS
14213453;;F;40;CHILENO;;X;PROVIDENCIA                   ;METROPOLITANA;0;0;0;0;0;0;0;0;0;Aspiradora VCC4190V3E/XZS Arrastre 2000Watts;ELECTRODOMESTICOS
6219196;;F;75;CHILENO;;Silencioso;TALAGANTE                     ;METROPOLITANA;0;0;0;0;0;0;0;0;0;Plancha UT-KERAMIKTOP 2200Watts Base Ceramica;ELECTRODOMESTICOS
15814560;Soltero;F;37;CHILENO;PRODUCTOR DE EVENTOS;Millenial;PROVIDENCIA                   ;METROPOLITANA;0;0;0;0;0;0;0;0;0;Tostador de PanTH-120R 2 Rebanadas Rojo;ELECTRODOMESTICOS
10837461;Casado;F;56;CHILENO;;Silencioso;PROVIDENCIA                   ;METROPOLITANA;0;0;0;0;0;0;0;0;0;Combo Maquina 311+ Overlock 8002D;ELECTRODOMESTICOS
10035731;;F;55;CHILENO;;Millenial;"";"";0;0;0;0;0;0;0;0;0;Batidora Manual BA-5010 Inox;ELECTRODOMESTICOS
10514818;Casado;F;57;CHILENO;CONTADOR AUDITOR;Boomers;PROVIDENCIA                   ;METROPOLITANA;0;0;0;0;0;0;0;0;0;Batidora Vertical Minipimer UT-KLOT400P;ELECTRODOMESTICOS
19266806;Soltero;M;25;CHILENO;INGENIERIA EN PREVENCION DE RIESGOS CALIDAD Y AMBIENTE;Z;PROVIDENCIA                   ;METROPOLITANA;0;0;0;0;0;0;0;0;0;Horno Microondas Digital TH-20S01 20Lts;ELECTRODOMESTICOS
12358665;Soltero;F;49;CHILENO;;X;SAN CLEMENTE                  ;MAULE;0;0;0;0;0;0;0;0;0;Hervidor Electrico UT-MANLY17 1,7Lts Negro;ELECTRODOMESTICOS
11331578;;F;53;CHILENO;;X;RENCA                         ;METROPOLITANA;0;0;0;0;0;0;0;0;0;Horno Electrico TH-38N 38Lts;ELECTRODOMESTICOS
5852339;;F;73;CHILENO;;Silencioso;ANGOL                         ;ARAUCANIA;0;0;0;0;0;0;0;0;0;Plancha THOMAS TH-7170 2200Watts Base Ceramica;ELECTRODOMESTICOS
14154417;;M;41;CHILENO;;X;CONSTITUCION                  ;MAULE;0;0;0;0;0;0;0;0;0;Hervidor Electrico TH-4350 3Lts Blanco;ELECTRODOMESTICOS
17003928;;F;33;CHILENO;;Millenial;RENCA                         ;METROPOLITANA;0;0;0;0;0;0;0;0;0;Licuadora TH-501V 1,5Lts Vaso Vidrio;ELECTRODOMESTICOS
14580967;;F;48;CHILENO;;X;EL BOSQUE                     ;METROPOLITANA;0;0;0;0;0;0;0;0;0;PLANCHA A VAPOR 6953 BASE AEROCERAMICA AUTAPA.22;ELECTRODOMESTICOS
16045751;;F;36;CHILENO;;Millenial;PROVIDENCIA                   ;METROPOLITANA;0;0;0;0;0;0;0;0;0;Hervidor Electrico HA-3300 2,5Lts Blanco;ELECTRODOMESTICOS
15208281;;M;39;CHILENO;;X;PROVIDENCIA                   ;METROPOLITANA;0;0;0;0;0;0;0;0;0;Aspiradora Roomba 621;ELECTRODOMESTICOS
13511553;;F;44;CHILENO;;X;RENCA                         ;METROPOLITANA;0;0;0;0;0;0;0;0;0;Batidora Vertical Multimixer TH-8720;ELECTRODOMESTICOS
15967528;;F;37;CHILENO;;Millenial;PENAFLOR                      ;METROPOLITANA;0;0;0;0;0;0;0;0;0;Horno Microondas Mecanico Easy Wave 20Lts;ELECTRODOMESTICOS
6585585;Viudo;M;69;CHILENO;;Silencioso;RENCA                         ;METROPOLITANA;0;0;0;0;0;0;0;0;0;Aspiradora Cyclonic Adventage roja CA4000N;ELECTRODOMESTICOS
19216273;;F;26;CHILENO;;Z;"";"";0;0;0;0;0;0;0;0;0;Maquina de Coser 1412;ELECTRODOMESTICOS
8945546;;F;58;CHILENO;;Boomers;RENCA                         ;METROPOLITANA;0;0;0;0;0;0;0;0;0;Hervidor Electrico 3100 1,7Lts Negro;ELECTRODOMESTICOS
11374652;;F;53;CHILENO;;X;CONSTITUCION                  ;MAULE;0;0;0;0;0;0;0;0;0;Horno Electrico TH-25N01 25Lts;ELECTRODOMESTICOS
19002986;Soltero;F;28;CHILENO;;Millenial;PROVIDENCIA                   ;METROPOLITANA;0;0;0;0;0;0;0;0;0;PROCESADOR THOMAS TH-9160;ELECTRODOMESTICOS
16454873;;F;35;CHILENO;;Millenial;PROVIDENCIA                   ;METROPOLITANA;0;0;0;0;0;0;0;0;0;Plancha UT-DUNST 2200Watts Base Ceramica;ELECTRODOMESTICOS
12129619;;F;51;CHILENO;;X;ARICA                         ;TARAPACA;0;0;0;0;0;0;0;0;0;Horno Electrico TH62I 60Lts;ELECTRODOMESTICOS
4947799;;M;76;CHILENO;;Silencioso;PUDAHUEL                      ;METROPOLITANA;0;0;0;0;0;0;0;0;0;Plancha Vertical TH-7300 1200Watts;ELECTRODOMESTICOS
16065824;Soltero;F;37;CHILENO;;Millenial;PROVIDENCIA                   ;METROPOLITANA;0;0;0;0;0;0;0;0;0;Horno Microondas Mecanico Easy Wave 20Lts;ELECTRODOMESTICOS
14700444;;F;54;PERUANO;;Extranjero;IQUIQUE                       ;TARAPACA;0;0;0;0;0;0;0;0;0;Hervidor Electrico 3100 1,7Lts Negro;ELECTRODOMESTICOS
14394926;;M;44;CHILENO;;Millenial;N/D;N/D;0;0;0;0;0;0;0;0;0;Maquina de Coser 311;ELECTRODOMESTICOS
12191243;;F;52;CHILENO;;X;PUENTE ALTO                   ;METROPOLITANA;0;0;0;0;0;0;0;0;0;Licuadora TH-401V Roja 1,75Lts Vaso Vidrio;ELECTRODOMESTICOS
16271281;;F;36;CHILENO;;Millenial;N/D;N/D;0;0;0;0;0;0;0;0;0;Horno Microondas Digital TH-25DM 25Lts;ELECTRODOMESTICOS
17047924;Soltero;M;34;CHILENO;;Silencioso;PROVIDENCIA                   ;METROPOLITANA;0;0;0;0;0;0;0;0;0;Licuadora TH-401V Roja 1,75Lts Vaso Vidrio;ELECTRODOMESTICOS
11404560;;F;52;CHILENO;;X;RENCA                         ;METROPOLITANA;0;0;0;0;0;0;0;0;0;Licuadora TH-401V Roja 1,75Lts Vaso Vidrio;ELECTRODOMESTICOS
20081854;;F;23;CHILENO;;Silencioso;NOGALES;VALPARAISO;0;0;0;0;0;0;0;0;0;Parrilla Electrica TH-205;ELECTRODOMESTICOS
9812286;;F;58;CHILENO;;Boomers;CALAMA                        ;ANTOFAGASTA;0;0;0;0;0;0;0;0;0;Licuadora L-5500IN 1,5Lts;ELECTRODOMESTICOS
7822531;;M;66;CHILENO;;Boomers;RENCA                         ;METROPOLITANA;0;0;0;0;0;0;0;0;0;Horno Electrico TH62I 60Lts;ELECTRODOMESTICOS
19360387;;F;28;CHILENO;;Millenial;PROVIDENCIA                   ;METROPOLITANA;0;0;0;0;0;0;0;0;0;Batidora Manual UT-TEKLA300;ELECTRODOMESTICOS
15004262;;M;39;CHILENO;;X;N/D;N/D;0;0;0;0;0;0;0;0;0;Aspiradora Cyclonic Adventage roja CA4000N;ELECTRODOMESTICOS
15405346;;M;39;CHILENO;;X;PROVIDENCIA                   ;METROPOLITANA;0;0;0;0;0;0;0;0;0;Horno Microondas Mecanico TH-18B05 18Lts;ELECTRODOMESTICOS
8339507;;F;54;CHILENO;;Silencioso;PROVIDENCIA                   ;METROPOLITANA;0;0;0;0;0;0;0;0;0;Licuadora Roja 550W 1,5Lts Vaso Vidrio;ELECTRODOMESTICOS
17147778;;M;33;CHILENO;;Millenial;PROVIDENCIA                   ;METROPOLITANA;0;0;0;0;0;0;0;0;0;Batidora Manual BA-5010 Inox;ELECTRODOMESTICOS
12048625;Soltero;M;53;CHILENO;;X;RENCA                         ;METROPOLITANA;0;0;0;0;0;0;0;0;0;Picadora TH-9020V Vaso Vidrio 2Lts;ELECTRODOMESTICOS
6823466;Casado;F;65;CHILENO;;Boomers;PROVIDENCIA                   ;METROPOLITANA;0;0;0;0;0;0;0;0;0;Licuadora Roja 550W 1,5Lts Vaso Vidrio;ELECTRODOMESTICOS
15638338;;F;38;CHILENO;;X;NUNOA                         ;METROPOLITANA;0;0;0;0;0;0;0;0;0;Licuadora TH-401V Roja 1,75Lts Vaso Vidrio;ELECTRODOMESTICOS
26906569;;F;43;EXTRANJERO - NO INFORMA NACIONALIDAD;;Extranjero;TALCAHUANO                    ;BIO BIO;0;0;0;0;0;0;0;0;0;Aspiradora VCC4190V3E/XZS Arrastre 2000Watts;ELECTRODOMESTICOS
4997101;;M;77;CHILENO;;Silencioso;PROVIDENCIA                   ;METROPOLITANA;0;0;0;0;0;0;0;0;0;HERVIDOR ELECTRICO UT-STARK18;ELECTRODOMESTICOS
16345427;Soltero;F;36;CHILENO;;Silencioso;PROVIDENCIA                   ;METROPOLITANA;0;0;0;0;0;0;0;0;0;BATIDORA INMERSION S MIX 2616;ELECTRODOMESTICOS
12244385;;M;50;CHILENO;;X;RENCA                         ;METROPOLITANA;0;0;0;0;0;0;0;0;0;Hervidor Electrico 388R Rojo;ELECTRODOMESTICOS
8537492;;F;61;CHILENO;;Boomers;"";"";0;0;0;0;0;0;0;0;0;Hervidor Electrico UT-KLAR20PW 2Lts Blanco;ELECTRODOMESTICOS
18839315;Soltero;F;28;CHILENO;TERAPEUTA OCUPACIONAL;Millenial;PROVIDENCIA                   ;METROPOLITANA;0;0;0;0;0;0;0;0;0;Aspiradora TH1415 Arrastre 1500Watts;ELECTRODOMESTICOS
8731779;Soltero;F;64;CHILENO;;Boomers;PROVIDENCIA                   ;METROPOLITANA;0;0;0;0;0;0;0;0;0;Licuadora TH-401V Roja 1,75Lts Vaso Vidrio;ELECTRODOMESTICOS
9761218;Casado;F;55;CHILENO;PROFESOR;Boomers;RENCA                         ;METROPOLITANA;0;0;0;0;0;0;0;0;0;Aspiradora TH1415 Arrastre 1500Watts;ELECTRODOMESTICOS
10759920;;F;53;CHILENO;;X;PROVIDENCIA                   ;METROPOLITANA;0;0;0;0;0;0;0;0;0;Horno Microondas Mecanico TH-18B05 18Lts;ELECTRODOMESTICOS
6961690;;M;66;CHILENO;;Boomers;MELIPILLA                     ;METROPOLITANA;0;0;0;0;0;0;0;0;0;Horno Microondas Digital UT-CLASSY720 20Lts;ELECTRODOMESTICOS
14205119;;M;41;CHILENO;;X;RENCA                         ;METROPOLITANA;0;0;0;0;0;0;0;0;0;Hervidor Electrico HA-3300 2,5Lts Blanco;ELECTRODOMESTICOS
6297092;Viudo;F;74;CHILENO;;Silencioso;N/D;N/D;0;0;0;0;0;0;0;0;0;Horno Electrico TH-80i 80Lts;ELECTRODOMESTICOS
20038106;;M;22;CHILENO;;Silencioso;PROVIDENCIA                   ;METROPOLITANA;0;0;0;0;0;0;0;0;0;Batidora Manual BA-5010 Inox;ELECTRODOMESTICOS
19290625;;F;26;CHILENO;;Z;PROVIDENCIA                   ;METROPOLITANA;0;0;0;0;0;0;0;0;0;Tostador de Pan TH-116 2 Rebanadas Negro;ELECTRODOMESTICOS
7752349;;M;58;CHILENO;;Boomers;RENCA                         ;METROPOLITANA;0;0;0;0;0;0;0;0;0;Batidora Pedestal TH910PN 4,6Lts 1300Watts;ELECTRODOMESTICOS
12705263;Casado;M;48;CHILENO;ASISTENTE SOCIAL;X;RENCA                         ;METROPOLITANA;0;0;0;0;0;0;0;0;0;Horno Electrico UT-BACKOFEN26 26Lts;ELECTRODOMESTICOS
19549151;Soltero;F;26;CHILENO;FONOAUDIOLOGA;Z;PROVIDENCIA                   ;METROPOLITANA;0;0;0;0;0;0;0;0;0;Licuadora Roja 550W 1,5Lts Vaso Vidrio;ELECTRODOMESTICOS
10136404;;F;67;CHILENO;;Boomers;TALCAHUANO                    ;BIO BIO;0;0;0;0;0;0;0;0;0;Aspiradora TH1415 Arrastre 1500Watts;ELECTRODOMESTICOS
19043245;Soltero;F;26;CHILENO;MATRONA;Z;PROVIDENCIA                   ;METROPOLITANA;0;0;0;0;0;0;0;0;0;PANINI/WAFLERA TH-965;ELECTRODOMESTICOS
11174259;;M;55;CHILENO;;Boomers;TALCA                         ;MAULE;0;0;0;0;0;0;0;0;0;Horno Electrico TH-80i 80Lts;ELECTRODOMESTICOS
8982929;Casado;F;60;CHILENO;;Boomers;RENCA                         ;METROPOLITANA;0;0;0;0;0;0;0;0;0;Tostador de Pan TH-126 4 Rebanadas Negro;ELECTRODOMESTICOS
18219793;;F;30;CHILENO;;Millenial;EL BOSQUE                     ;METROPOLITANA;0;0;0;0;0;0;0;0;0;Plancha THOMAS TH-7170 2200Watts Base Ceramica;ELECTRODOMESTICOS
12847956;Casado;F;47;CHILENO;;X;RENCA                         ;METROPOLITANA;0;0;0;0;0;0;0;0;0;Licuadora TH-320 Roja/Negro 1,5 Lts Vaso Vidrio;ELECTRODOMESTICOS
11895620;;F;51;CHILENO;;Silencioso;PROVIDENCIA                   ;METROPOLITANA;0;0;0;0;0;0;0;0;0;Tostador de Pan TH-126 4 Rebanadas Negro;ELECTRODOMESTICOS
8809523;;F;58;CHILENO;;Boomers;PROVIDENCIA                   ;METROPOLITANA;0;0;0;0;0;0;0;0;0;Batidora Manual UT-TEKLA300;ELECTRODOMESTICOS
19908835;;F;23;CHILENO;;Z;PROVIDENCIA                   ;METROPOLITANA;0;0;0;0;0;0;0;0;0;Horno Electrico UT-BACKOFEN26 26Lts;ELECTRODOMESTICOS
12383702;Casado;F;48;CHILENO;;Silencioso;PROVIDENCIA                   ;METROPOLITANA;0;0;0;0;0;0;0;0;0;Aspiradora TH1870 Arrastre 1800Watts Gris;ELECTRODOMESTICOS
17089243;Soltero;F;33;CHILENO;KINESIOLOGA;Silencioso;PROVIDENCIA                   ;METROPOLITANA;0;0;0;0;0;0;0;0;0;Horno Microondas Digital UT-CLASSY720 20Lts;ELECTRODOMESTICOS
8261550;;M;61;CHILENO;;Boomers;VINA DEL MAR                  ;VALPARAISO;0;0;0;0;0;0;0;0;0;Olla Arrocera TH38IF 1,8Lts;ELECTRODOMESTICOS
12999041;Soltero;F;46;CHILENO;;X;RENCA                         ;METROPOLITANA;0;0;0;0;0;0;0;0;0;Hervidor Termo BA-6928 Rojo 2,8Lts;ELECTRODOMESTICOS
11779073;;M;51;CHILENO;;X;QUILPUE                       ;VALPARAISO;0;0;0;0;0;0;0;0;0;Hervidor Electrico Tetera UT-LECKER18R 1,8Lts;ELECTRODOMESTICOS
13399445;;M;44;CHILENO;;X;PROVIDENCIA                   ;METROPOLITANA;0;0;0;0;0;0;0;0;0;Horno Electrico TH-16N 16Lts;ELECTRODOMESTICOS
6520396;Casado;M;68;CHILENO;;Silencioso;PROVIDENCIA                   ;METROPOLITANA;0;0;0;0;0;0;0;0;0;Hervidor Electrico HA-3300 2,5Lts Blanco;ELECTRODOMESTICOS
13614614;;M;43;CHILENO;;X;CAUQUENES                     ;MAULE;0;0;0;0;0;0;0;0;0;Horno Electrico TH-38N 38Lts;ELECTRODOMESTICOS
6942065;;F;69;CHILENO;;Silencioso;CUNCO                         ;ARAUCANIA;0;0;0;0;0;0;0;0;0;Horno Microondas Mecanico TH-18B05 18Lts;ELECTRODOMESTICOS
14325759;Casado;F;45;CHILENO;AUXILIAR DE ENFERMERIA;X;PROVIDENCIA                   ;METROPOLITANA;0;0;0;0;0;0;0;0;0;PLANCHA VERTICAL V-1600VBL;ELECTRODOMESTICOS
6307295;;M;69;CHILENO;;Silencioso;PROVIDENCIA                   ;METROPOLITANA;0;0;0;0;0;0;0;0;0;Batidora Vertical Multimixer TH-8720;ELECTRODOMESTICOS
18842558;;F;27;CHILENO;;Millenial;"";"";0;0;0;0;0;0;0;0;0;Licuadora TH-320 Roja/Negro 1,5 Lts Vaso Vidrio;ELECTRODOMESTICOS
17863597;;F;31;CHILENO;;Millenial;VALDIVIA                      ;LOS LAGOS;0;0;0;0;0;0;0;0;0;Horno Electrico TH62I 60Lts;ELECTRODOMESTICOS
11745373;;F;50;CHILENO;;X;SAN JAVIER                    ;MAULE;0;0;0;0;0;0;0;0;0;Combo Licuadora + Batidora;ELECTRODOMESTICOS
9517188;;M;60;CHILENO;;Boomers;SAN CARLOS                    ;BIO BIO;0;0;0;0;0;0;0;0;0;Horno Electrico TH62I 60Lts;ELECTRODOMESTICOS
17224953;Soltero;F;33;CHILENO;;Millenial;PROVIDENCIA                   ;METROPOLITANA;0;0;0;0;0;0;0;0;0;Set Picador KP-123BL 1,2Lts;ELECTRODOMESTICOS
15040381;Soltero;M;39;CHILENO;;X;PROVIDENCIA                   ;METROPOLITANA;0;0;0;0;0;0;0;0;0;Licuadora TH-320 Roja/Negro 1,5 Lts Vaso Vidrio;ELECTRODOMESTICOS
12534490;;F;50;CHILENO;;X;NUEVA IMPERIAL                ;ARAUCANIA;0;0;0;0;0;0;0;0;0;Hervidor Electrico TH-4350 3Lts Blanco;ELECTRODOMESTICOS
7226755;;F;65;CHILENO;;Boomers;ARICA                         ;TARAPACA;0;0;0;0;0;0;0;0;0;Horno Microondas Digital ME0113MB1/XZS 32Lts;ELECTRODOMESTICOS
10839436;Soltero;M;55;CHILENO;;Boomers;RENCA                         ;METROPOLITANA;0;0;0;0;0;0;0;0;0;Hervidor Electrico UT-MANLY17 1,7Lts Negro;ELECTRODOMESTICOS
8500094;;M;60;CHILENO;;Boomers;VILLARICA;XI - LA ARAUCANÃA;0;0;0;0;0;0;0;0;0;Horno Microondas Digital TH-25DM 25Lts;ELECTRODOMESTICOS
9633853;Casado;F;57;CHILENO;;Boomers;PROVIDENCIA                   ;METROPOLITANA;0;0;0;0;0;0;0;0;0;Licuadora TH-501V 1,5Lts Vaso Vidrio;ELECTRODOMESTICOS
12348055;;M;49;CHILENO;;X;DIEGO DE ALMAGRO              ;ATACAMA;0;0;0;0;0;0;0;0;0;Horno Microondas Digital L UT-25KROMM 25Lts;ELECTRODOMESTICOS
18139985;;F;31;CHILENO;;Millenial;COPIAPO                       ;ATACAMA;0;0;0;0;0;0;0;0;0;Hervidor Electrico HA-3300 2,5Lts Blanco;ELECTRODOMESTICOS
11747700;;F;51;CHILENO;;X;RENCA                         ;METROPOLITANA;0;0;0;0;0;0;0;0;0;Licuadora TH-401V Roja 1,75Lts Vaso Vidrio;ELECTRODOMESTICOS
6176369;;F;71;CHILENO;;Silencioso;RENCA                         ;METROPOLITANA;0;0;0;0;0;0;0;0;0;Batidora Manual 2532;ELECTRODOMESTICOS
14279009;Casado;F;49;CHILENO;DISENADOR;X;PROVIDENCIA                   ;METROPOLITANA;0;0;0;0;0;0;0;0;0;Plancha UT-SHANGRILA Inalambrica 2200Watss;ELECTRODOMESTICOS
13472493;Casado;M;44;CHILENO;INGENIERO;Silencioso;PROVIDENCIA                   ;METROPOLITANA;0;0;0;0;0;0;0;0;0;MICROONDAS ME83X/XZS SAMSUNG MIRROR;ELECTRODOMESTICOS
9958256;;F;57;CHILENO;;Boomers;RENCA                         ;METROPOLITANA;0;0;0;0;0;0;0;0;0;Aspiradora TH1870 Arrastre 1800Watts Gris;ELECTRODOMESTICOS
19575356;;F;25;CHILENO;;Z;PROVIDENCIA                   ;METROPOLITANA;0;0;0;0;0;0;0;0;0;Horno Electrico TH62I 60Lts;ELECTRODOMESTICOS
20026338;;F;23;CHILENO;;Z;PROVIDENCIA                   ;METROPOLITANA;0;0;0;0;0;0;0;0;0;Horno Electrico TH-48N 48Lts;ELECTRODOMESTICOS
11769099;;M;51;CHILENO;;X;MACUL                         ;METROPOLITANA;0;0;0;0;0;0;0;0;0;Licuadora TH-401V Roja 1,75Lts Vaso Vidrio;ELECTRODOMESTICOS
19762167;;F;24;CHILENO;;Z;PROVIDENCIA                   ;METROPOLITANA;0;0;0;0;0;0;0;0;0;Licuadora TH-401V Roja 1,75Lts Vaso Vidrio;ELECTRODOMESTICOS
11352903;;M;54;CHILENO;;X;CORONEL                       ;BIO BIO;0;0;0;0;0;0;0;0;0;PARRILLA ELECTRICA UT-ECOKERAMIK;ELECTRODOMESTICOS
10015732;;M;57;CHILENO;;Boomers;SAN FERNANDO                  ;L.G.B.OÂ´HIGGINS;0;0;0;0;0;0;0;0;0;Horno Microondas Mecanico UT-SYDNEY18 18Lts;ELECTRODOMESTICOS
7034690;;M;66;CHILENO;;Boomers;PROVIDENCIA                   ;METROPOLITANA;0;0;0;0;0;0;0;0;0;Horno Microondas Digital TH-20S01 20Lts;ELECTRODOMESTICOS
9791373;Viudo;F;59;CHILENO;;Boomers;N/D;N/D;0;0;0;0;0;0;0;0;0;Aspiradora Handy Clean Black 1400;ELECTRODOMESTICOS
9760146;Casado;M;59;CHILENO;;Boomers;RENCA                         ;METROPOLITANA;0;0;0;0;0;0;0;0;0;Maquina de Coser ME9100;ELECTRODOMESTICOS
7024846;Casado;F;58;CHILENO;;Silencioso;PROVIDENCIA                   ;METROPOLITANA;0;0;0;0;0;0;0;0;0;Aspiradora AP1700 Arrastre 1700Watts;ELECTRODOMESTICOS
10564434;;F;59;CHILENO;;Boomers;RIO CLARO                     ;MAULE;0;0;0;0;0;0;0;0;0;Hervidor Electrico TH-4212N 1,7Lts Negro;ELECTRODOMESTICOS
10410025;;M;57;CHILENO;;Boomers;LA PINTANA                    ;METROPOLITANA;0;0;0;0;0;0;0;0;0;Batidora Vertical Minipimer UT-KLOT800SS;ELECTRODOMESTICOS
8668228;;F;63;CHILENO;;Boomers;RENCA                         ;METROPOLITANA;0;0;0;0;0;0;0;0;0;Horno Electrico TH-25N01 25Lts;ELECTRODOMESTICOS
8607478;;M;61;CHILENO;;Boomers;RENCA                         ;METROPOLITANA;0;0;0;0;0;0;0;0;0;Plancha UT-DUNST 2200Watts Base Ceramica;ELECTRODOMESTICOS
15464413;;F;39;CHILENO;;X;SANTIAGO                      ;METROPOLITANA;0;0;0;0;0;0;0;0;0;Horno Microondas Digital L UT-25KROMM 25Lts;ELECTRODOMESTICOS
13192723;;F;45;CHILENO;;X;VINA DEL MAR                  ;VALPARAISO;0;0;0;0;0;0;0;0;0;Combo Hervidor + Batidora;ELECTRODOMESTICOS
7916752;;F;63;CHILENO;;Boomers;PROVIDENCIA                   ;METROPOLITANA;0;0;0;0;0;0;0;0;0;Hervidor Electrico TH-5407i 2Lts;ELECTRODOMESTICOS
18302429;Soltero;F;32;CHILENO;TERAPEUTA OCUPACIONAL;Millenial;PROVIDENCIA                   ;METROPOLITANA;0;0;0;0;0;0;0;0;0;Batidora Vertical Multimixer TH-8720;ELECTRODOMESTICOS
7896761;Casado;F;65;CHILENO;;Boomers;RENCA                         ;METROPOLITANA;0;0;0;0;0;0;0;0;0;Licuadora UT-METALLEK505P 1,5Lts Vaso Vidrio;ELECTRODOMESTICOS
9958491;;M;58;CHILENO;;Boomers;MELIPILLA                     ;METROPOLITANA;0;0;0;0;0;0;0;0;0;Aspiradora Polvo AP-700 GR;ELECTRODOMESTICOS
11941834;;F;50;CHILENO;;X;RENCA                         ;METROPOLITANA;0;0;0;0;0;0;0;0;0;Plancha UT-DUNST 2200Watts Base Ceramica;ELECTRODOMESTICOS
13450250;Casado;M;44;CHILENO;MATRON;X;RENCA                         ;METROPOLITANA;0;0;0;0;0;0;0;0;0;Horno Electrico UT-BACKOFEN48 48Lts;ELECTRODOMESTICOS
15389117;;M;39;CHILENO;;X;RENCA                         ;METROPOLITANA;0;0;0;0;0;0;0;0;0;Aspiradora UT-ZYKLON1402 Arrastre 1400Watts;ELECTRODOMESTICOS
12392143;;F;48;CHILENO;;X;LLAILLAY                      ;VALPARAISO;0;0;0;0;0;0;0;0;0;TERMOHERVIDOR ELECTRON 4,6 LTS BA-6950 INX;ELECTRODOMESTICOS
16182995;Soltero;F;36;CHILENO;PSICOLOGO;Millenial;PROVIDENCIA                   ;METROPOLITANA;0;0;0;0;0;0;0;0;0;Plancha OSTER 4801T 1200Watts Base Ceramica;ELECTRODOMESTICOS
16021353;;F;36;CHILENO;;Millenial;EL BOSQUE                     ;METROPOLITANA;0;0;0;0;0;0;0;0;0;Aspiradora UT-SILENT1804 Arrastre 1800Watts;ELECTRODOMESTICOS
6076693;;F;76;CHILENO;;Silencioso;RENCA                         ;METROPOLITANA;0;0;0;0;0;0;0;0;0;Plancha TH-7052 2000Watts Base Inox;ELECTRODOMESTICOS
19896932;Soltero;F;27;CHILENO;TECNICO DE NIVEL MEDIO EN ALIMENTACION;Millenial;PROVIDENCIA                   ;METROPOLITANA;0;0;0;0;0;0;0;0;0;Hervidor Electrico TH-4212N 1,7Lts Negro;ELECTRODOMESTICOS
11485831;;F;52;CHILENO;;X;PROVIDENCIA                   ;METROPOLITANA;0;0;0;0;0;0;0;0;0;Hervidor Electrico Tetera HA-4100 4Lts Iox;ELECTRODOMESTICOS
7611647;;F;68;CHILENO;;Boomers;PEMUCO                        ;BIO BIO;0;0;0;0;0;0;0;0;0;Licuadora TH-401V Roja 1,75Lts Vaso Vidrio;ELECTRODOMESTICOS
10967989;;F;52;CHILENO;;X;PROVIDENCIA                   ;METROPOLITANA;0;0;0;0;0;0;0;0;0;Batidora Vertical Multimixer TH-8720;ELECTRODOMESTICOS
18988634;Soltero;F;27;CHILENO;;Z;PROVIDENCIA                   ;METROPOLITANA;0;0;0;0;0;0;0;0;0;Licuadora TH-501V 1,5Lts Vaso Vidrio;ELECTRODOMESTICOS
7888884;;M;62;CHILENO;;Boomers;VALPARAISO                    ;VALPARAISO;0;0;0;0;0;0;0;0;0;Hervidor Electrico UT-REIN17SS;ELECTRODOMESTICOS
13900967;Soltero;F;41;CHILENO;;X;PROVIDENCIA                   ;METROPOLITANA;0;0;0;0;0;0;0;0;0;Aspiradora Polvo AP-700 GR;ELECTRODOMESTICOS
10919755;;M;54;CHILENO;;Boomers;PROVIDENCIA                   ;METROPOLITANA;0;0;0;0;0;0;0;0;0;PICADORA 123 SILHQUETTE;ELECTRODOMESTICOS
8167229;;F;60;CHILENO;;Boomers;RENCA                         ;METROPOLITANA;0;0;0;0;0;0;0;0;0;Plancha Paninis 2880;ELECTRODOMESTICOS
18606233;Soltero;F;28;CHILENO;TECNICO UNIVERSITARIO EN ENFERMERIA;Millenial;PROVIDENCIA                   ;METROPOLITANA;0;0;0;0;0;0;0;0;0;Licuadora TH-501V 1,5Lts Vaso Vidrio;ELECTRODOMESTICOS
8507625;Casado;F;63;CHILENO;;Boomers;RENCA                         ;METROPOLITANA;0;0;0;0;0;0;0;0;0;Batidora Vertical Minipimer UT-KLOT800SS;ELECTRODOMESTICOS
15140448;;F;38;CHILENO;;X;TALCA                         ;MAULE;0;0;0;0;0;0;0;0;0;Horno Electrico TH62I 60Lts;ELECTRODOMESTICOS
15122370;;M;40;CHILENO;;X;PROVIDENCIA                   ;METROPOLITANA;0;0;0;0;0;0;0;0;0;Licuadora Personal TH-300PB;ELECTRODOMESTICOS
14049372;;F;40;CHILENO;;X;SAN FERNANDO                  ;L.G.B.OÂ´HIGGINS;0;0;0;0;0;0;0;0;0;PLANCHA A VAPOR 6003 BASE ANTIADHERENTE 1600W;ELECTRODOMESTICOS
6620241;;M;71;CHILENO;;Silencioso;PROVIDENCIA                   ;METROPOLITANA;0;0;0;0;0;0;0;0;0;Horno Microondas Mecanico TH-18B05 18Lts;ELECTRODOMESTICOS
26141745;;F;35;HAITIANO;;Extranjero;LOS ANGELES                   ;BIO BIO;0;0;0;0;0;0;0;0;0;Licuadora Berry Blender Roja 1400 Vaso Vidrio;ELECTRODOMESTICOS
15874906;Soltero;M;38;CHILENO;;Millenial;RENCA                         ;METROPOLITANA;0;0;0;0;0;0;0;0;0;Hervidor Electrico TH-4515N 2Lts Negro;ELECTRODOMESTICOS
10942814;;F;56;CHILENO;;Boomers;VINA DEL MAR                  ;VALPARAISO;0;0;0;0;0;0;0;0;0;Horno Electrico TH-38N 38Lts;ELECTRODOMESTICOS
4826391;;M;79;CHILENO;;Silencioso;LOS ANDES                     ;VALPARAISO;0;0;0;0;0;0;0;0;0;Cafetera UT-KAFFEEKLASSIK;ELECTRODOMESTICOS
12691921;;M;48;CHILENO;;X;RENCA                         ;METROPOLITANA;0;0;0;0;0;0;0;0;0;Hervidor Electrico HA-3300 2,5Lts Blanco;ELECTRODOMESTICOS
17675844;Soltero;M;31;CHILENO;TECNOLOGO MEDICO;Millenial;PROVIDENCIA                   ;METROPOLITANA;0;0;0;0;0;0;0;0;0;Robot aspirador Roomba 675;ELECTRODOMESTICOS
12975172;;F;45;CHILENO;;X;HUALPEN;BIO BIO;0;0;0;0;0;0;0;0;0;Batidora Manual TH-8830;ELECTRODOMESTICOS
13368592;;F;44;CHILENO;;X;"";"";0;0;0;0;0;0;0;0;0;Hervidor Electrico TH-4515N 2Lts Negro;ELECTRODOMESTICOS
19528894;;F;25;CHILENO;;Z;LAMPA                         ;METROPOLITANA;0;0;0;0;0;0;0;0;0;Horno Electrico TH-25N01 25Lts;ELECTRODOMESTICOS
5776752;Casado;F;69;CHILENO;;Silencioso;PROVIDENCIA                   ;METROPOLITANA;0;0;0;0;0;0;0;0;0;Picadora P-123TOPBL 1,5Lts;ELECTRODOMESTICOS
10345981;Soltero;M;57;CHILENO;;Boomers;RENCA                         ;METROPOLITANA;0;0;0;0;0;0;0;0;0;Licuadora TH-320 Roja/Negro 1,5 Lts Vaso Vidrio;ELECTRODOMESTICOS
8916493;;F;60;CHILENO;;Boomers;PROVIDENCIA                   ;METROPOLITANA;0;0;0;0;0;0;0;0;0;Hervidor Electrico UT-DUNKEL17P 2Lts Negro;ELECTRODOMESTICOS
8569260;;F;62;CHILENO;;Boomers;ARICA                         ;ARICA Y PARINACOTA;0;0;0;0;0;0;0;0;0;Hervidor Electrico UT-DUNKEL17P 2Lts Negro;ELECTRODOMESTICOS
16856889;Soltero;F;34;CHILENO;;Millenial;RENCA                         ;METROPOLITANA;0;0;0;0;0;0;0;0;0;Hervidor Electrico UT-MANLY17 1,7Lts Negro;ELECTRODOMESTICOS
16400931;;F;35;CHILENO;;Millenial;N/D;N/D;0;0;0;0;0;0;0;0;0;Enceradora EA-5000;ELECTRODOMESTICOS
9105788;;F;55;CHILENO;;Boomers;PROVIDENCIA                   ;METROPOLITANA;0;0;0;0;0;0;0;0;0;Aspiradora Trapeadora Robot Ut-Excellenza (B);ELECTRODOMESTICOS
13775759;;F;42;CHILENO;;X;PROVIDENCIA                   ;METROPOLITANA;0;0;0;0;0;0;0;0;0;Batidora Vertical Stick Mixer 2609;ELECTRODOMESTICOS
11773255;Casado;F;51;CHILENO;;X;RENCA                         ;METROPOLITANA;0;0;0;0;0;0;0;0;0;Horno Electrico UT-BACKOFEN60 60Lts;ELECTRODOMESTICOS
17516406;Soltero;F;32;CHILENO;;Millenial;PROVIDENCIA                   ;METROPOLITANA;0;0;0;0;0;0;0;0;0;Horno Electrico TH-16N 16Lts;ELECTRODOMESTICOS
16141860;;M;37;CHILENO;;Millenial;RENCA                         ;METROPOLITANA;0;0;0;0;0;0;0;0;0;Hervidor Electrico Tetera UT-LECKER18R 1,8Lts;ELECTRODOMESTICOS
7530589;Casado;F;67;CHILENO;AUXILIAR DE FARMACIA PRIVADA;Boomers;QUILPUE                       ;VALPARAISO;0;0;0;0;0;0;0;0;0;Hervidor Electrico UT-MANLY17 1,7Lts Negro;ELECTRODOMESTICOS
18986023;Soltero;M;27;CHILENO;INGENIERIA EN MAQUINARIA VEHICULOS AUTOMOTRICES Y SISTEMAS ELECTRONICOS;Z;PROVIDENCIA                   ;METROPOLITANA;0;0;0;0;0;0;0;0;0;Horno Microondas Digital TH-20S01 20Lts;ELECTRODOMESTICOS
6270998;;F;73;CHILENO;;Silencioso;RENCA                         ;METROPOLITANA;0;0;0;0;0;0;0;0;0;Aspiradora UT-MEINER1803 Arrastre 1800Watts;ELECTRODOMESTICOS
13794138;;M;49;CHILENO;;X;PROVIDENCIA                   ;METROPOLITANA;0;0;0;0;0;0;0;0;0;Maquina de Coser ME9100;ELECTRODOMESTICOS
7653278;;M;66;CHILENO;;Boomers;PUENTE ALTO                   ;METROPOLITANA;0;0;0;0;0;0;0;0;0;Hervidor Electrico TH-6200 R 1,7Lts Rojo;ELECTRODOMESTICOS
15341842;;M;38;CHILENO;;X;PROVIDENCIA                   ;METROPOLITANA;0;0;0;0;0;0;0;0;0;Parrilla Electrica UT-ECOKERAMIK(RED);ELECTRODOMESTICOS
10506062;Soltero;M;56;CHILENO;;Boomers;RENCA                         ;METROPOLITANA;0;0;0;0;0;0;0;0;0;Horno Electrico TH-25N01 25Lts;ELECTRODOMESTICOS
16842050;Soltero;F;34;CHILENO;KINESIOLOGO;Millenial;RENCA                         ;METROPOLITANA;0;0;0;0;0;0;0;0;0;Horno Microondas Digital TH-20S01 20Lts;ELECTRODOMESTICOS
15308665;;M;39;CHILENO;;X;N/D;N/D;0;0;0;0;0;0;0;0;0;Hervidor Electrico Tetera UT-LECKER18R 1,8Lts;ELECTRODOMESTICOS
14008144;;M;40;CHILENO;;X;MELIPILLA                     ;METROPOLITANA;0;0;0;0;0;0;0;0;0;Horno Microondas Mecanico UT-SYDNEY18 18Lts;ELECTRODOMESTICOS
19424976;;F;24;CHILENO;;Z;PUNTA ARENAS                  ;MAGALLANES;0;0;0;0;0;0;0;0;0;Aspiradora TH1407 Arrastre 1400Watts;ELECTRODOMESTICOS
15119258;;F;39;CHILENO;;X;SAN FERNANDO                  ;L.G.B.OÂ´HIGGINS;0;0;0;0;0;0;0;0;0;Batidora Manual TH-8830;ELECTRODOMESTICOS
12889608;;F;47;CHILENO;;X;PROVIDENCIA                   ;METROPOLITANA;0;0;0;0;0;0;0;0;0;Set Picador KP-123BL 1,2Lts;ELECTRODOMESTICOS
20002191;;M;23;CHILENO;;Z;PROVIDENCIA                   ;METROPOLITANA;0;0;0;0;0;0;0;0;0;Licuadora Osterizer 4112/72 1,25Lts Vaso Vidrio;ELECTRODOMESTICOS
6890329;;M;60;CHILENO;;Boomers;RENCA                         ;METROPOLITANA;0;0;0;0;0;0;0;0;0;PROCESADOR DE ALIMENTOS UT-PROCESSOR750;ELECTRODOMESTICOS
9499598;;M;59;CHILENO;;Boomers;SANTIAGO                      ;METROPOLITANA;0;0;0;0;0;0;0;0;0;Batidora Vertical Multimixer TH-8720;ELECTRODOMESTICOS
7440710;;F;62;CHILENO;;Boomers;CARTAGENA                     ;VALPARAISO;0;0;0;0;0;0;0;0;0;Aspiradora TH1870 Arrastre 1800Watts Gris;ELECTRODOMESTICOS
6822142;;F;73;CHILENO;;Silencioso;PROVIDENCIA                   ;METROPOLITANA;0;0;0;0;0;0;0;0;0;Batidora Manual TH-8830;ELECTRODOMESTICOS
13409313;;M;44;CHILENO;;X;QUINCHAO                      ;LOS LAGOS;0;0;0;0;0;0;0;0;0;Licuadora Roja 550W 1,5Lts Vaso Vidrio;ELECTRODOMESTICOS
9601925;;F;60;CHILENO;;Boomers;RENCA                         ;METROPOLITANA;0;0;0;0;0;0;0;0;0;Procesador TH-9010 Multimixer 1,5Lts Vaso Vidrio;ELECTRODOMESTICOS
14306306;;F;47;CHILENO;;X;RENCA                         ;METROPOLITANA;0;0;0;0;0;0;0;0;0;PICADORA 123 SILHQUETTE;ELECTRODOMESTICOS
15129493;;M;40;CHILENO;;X;VICHUQUEN                     ;MAULE;0;0;0;0;0;0;0;0;0;Procesador TH-9010 Multimixer 1,5Lts Vaso Vidrio;ELECTRODOMESTICOS
16566151;;F;35;CHILENO;;Millenial;PROVIDENCIA                   ;METROPOLITANA;0;0;0;0;0;0;0;0;0;Plancha UT-KERAMIK1 2200Watts Base Ceramica;ELECTRODOMESTICOS
10026438;;F;57;CHILENO;;Boomers;RENCA                         ;METROPOLITANA;0;0;0;0;0;0;0;0;0;Extractor de Jugo EX800 1,4Lts;ELECTRODOMESTICOS
8827036;;F;50;CHILENO;;X;ARICA                         ;ARICA Y PARINACOTA;0;0;0;0;0;0;0;0;0;Batidora Vertical Multimixer TH-8720;ELECTRODOMESTICOS
5098979;;F;80;CHILENO;;Silencioso;RENCA                         ;METROPOLITANA;0;0;0;0;0;0;0;0;0;Licuadora TH-320 Roja/Negro 1,5 Lts Vaso Vidrio;ELECTRODOMESTICOS
15268380;;F;39;CHILENO;;X;PANGUIPULLI                   ;LOS RIOS;0;0;0;0;0;0;0;0;0;Licuadora L2000VNG 1,5Lts Vaso Vidrio;ELECTRODOMESTICOS
11418641;;F;53;CHILENO;;X;ANGOL                         ;ARAUCANIA;0;0;0;0;0;0;0;0;0;Hervidor Electrico HE420 2lts Negro;ELECTRODOMESTICOS
18748924;;M;28;CHILENO;;Millenial;SAN BERNARDO                  ;METROPOLITANA;0;0;0;0;0;0;0;0;0;Aspiradora UT-SILENT1603 Arrastre 1600Watts;ELECTRODOMESTICOS
11281713;;F;54;CHILENO;;X;CHIMBARONGO                   ;L.G.B.OÂ´HIGGINS;0;0;0;0;0;0;0;0;0;Exprimidor de Jugo 407W 1Lts;ELECTRODOMESTICOS
8013034;;M;56;CHILENO;;Boomers;COIHAIQUE                     ;AYSEN;0;0;0;0;0;0;0;0;0;Horno Electrico UT-BACKOFEN60 60Lts;ELECTRODOMESTICOS
15115724;;F;40;CHILENO;;X;SAN FERNANDO                  ;L.G.B.OÂ´HIGGINS;0;0;0;0;0;0;0;0;0;Plancha 6201 2200Watts Base Ceramica;ELECTRODOMESTICOS
9283024;;F;59;CHILENO;;Boomers;RENCA                         ;METROPOLITANA;0;0;0;0;0;0;0;0;0;Hervidor Electrico HE1723 1,7Lts Inox;ELECTRODOMESTICOS
8812837;;M;60;CHILENO;;Boomers;LINARES                       ;MAULE;0;0;0;0;0;0;0;0;0;Batidora Vertical Multimixer TH-8720;ELECTRODOMESTICOS
12183811;;F;49;CHILENO;;X;RENCA                         ;METROPOLITANA;0;0;0;0;0;0;0;0;0;Plancha 6201 2200Watts Base Ceramica;ELECTRODOMESTICOS
12462322;;F;49;CHILENO;;X;SAN BERNARDO                  ;METROPOLITANA;0;0;0;0;0;0;0;0;0;Batidora Manual BA-5010 Inox;ELECTRODOMESTICOS
15237174;;F;48;CHILENO;;X;NUEVA IMPERIAL                ;ARAUCANIA;0;0;0;0;0;0;0;0;0;Procesador TH-9010 Multimixer 1,5Lts Vaso Vidrio;ELECTRODOMESTICOS
12864277;Casado;M;47;CHILENO;DISENADOR INDUSTRIAL;X;PROVIDENCIA                   ;METROPOLITANA;0;0;0;0;0;0;0;0;0;Cafetera P65 Silver;ELECTRODOMESTICOS
15598678;;M;38;CHILENO;;X;PROVIDENCIA                   ;METROPOLITANA;0;0;0;0;0;0;0;0;0;Horno Electrico TH-38N 38Lts;ELECTRODOMESTICOS
18672013;Soltero;F;28;CHILENO;;Millenial;PROVIDENCIA                   ;METROPOLITANA;0;0;0;0;0;0;0;0;0;Aspiradora AP1700 Arrastre 1700Watts;ELECTRODOMESTICOS
12438104;Soltero;F;50;CHILENO;;X;RENCA                         ;METROPOLITANA;0;0;0;0;0;0;0;0;0;Horno Microondas Digital TH-20S01 20Lts;ELECTRODOMESTICOS
15675950;;M;36;CHILENO;;Millenial;RENCA                         ;METROPOLITANA;0;0;0;0;0;0;0;0;0;Hervidor Electrico TH-4515N 2Lts Negro;ELECTRODOMESTICOS
9669330;;F;64;CHILENO;;Boomers;SAN ANTONIO                   ;VALPARAISO;0;0;0;0;0;0;0;0;0;Picadora TH-9020V Vaso Vidrio 2Lts;ELECTRODOMESTICOS
12815312;;F;47;CHILENO;;X;RENCA                         ;METROPOLITANA;0;0;0;0;0;0;0;0;0;Hervidor Electrico UT-MANLY17 1,7Lts Negro;ELECTRODOMESTICOS
16093099;;M;36;CHILENO;;Millenial;"";"";0;0;0;0;0;0;0;0;0;Horno Electrico TH-16N 16Lts;ELECTRODOMESTICOS
7601020;;F;68;CHILENO;;Boomers;RENCA                         ;METROPOLITANA;0;0;0;0;0;0;0;0;0;Batidora Manual TH-8830;ELECTRODOMESTICOS
5123129;;F;73;CHILENO;;Silencioso;PROVIDENCIA                   ;METROPOLITANA;0;0;0;0;0;0;0;0;0;Horno Microondas Mecanico M-2030 NG 20Lts;ELECTRODOMESTICOS
10945234;;F;49;CHILENO;;X;ARICA                         ;ARICA Y PARINACOTA;0;0;0;0;0;0;0;0;0;Horno Microondas Digital ME0113MB1/XZS 32Lts;ELECTRODOMESTICOS
14516379;;F;50;CHILENO;;X;PROVIDENCIA                   ;METROPOLITANA;0;0;0;0;0;0;0;0;0;Maquina para Hacer Pan MPP-600 BL;ELECTRODOMESTICOS
9144288;;F;60;CHILENO;;Boomers;RENCA                         ;METROPOLITANA;0;0;0;0;0;0;0;0;0;Batidora Vertical Multimixer TH-8720;ELECTRODOMESTICOS
17759880;;M;31;CHILENO;;Millenial;PROVIDENCIA                   ;METROPOLITANA;0;0;0;0;0;0;0;0;0;Horno Electrico TH-25N01 25Lts;ELECTRODOMESTICOS
6286089;;F;71;CHILENO;;Silencioso;SAN BERNARDO                  ;METROPOLITANA;0;0;0;0;0;0;0;0;0;Licuadora Roja 550W 1,5Lts Vaso Vidrio;ELECTRODOMESTICOS
8142514;;F;63;CHILENO;;Boomers;RENCA                         ;METROPOLITANA;0;0;0;0;0;0;0;0;0;TOSTADOR ELECTRICO UT-ECKART2;ELECTRODOMESTICOS
9510451;;F;60;CHILENO;;Boomers;SAN CLEMENTE                  ;MAULE;0;0;0;0;0;0;0;0;0;Aspiradora TH1870 Arrastre 1800Watts Gris;ELECTRODOMESTICOS
15816715;;M;37;CHILENO;;Millenial;"";"";0;0;0;0;0;0;0;0;0;Licuadora Berry Blender Roja 1400 Vaso Vidrio;ELECTRODOMESTICOS
16183458;;F;37;CHILENO;;Millenial;FREIRINA                      ;ATACAMA;0;0;0;0;0;0;0;0;0;Combo Hervidor + Batidora;ELECTRODOMESTICOS
15906812;;F;38;CHILENO;;Millenial;VINA DEL MAR                  ;VALPARAISO;0;0;0;0;0;0;0;0;0;Aspiradora Handy Clean Black 1400;ELECTRODOMESTICOS
18561360;Soltero;F;29;CHILENO;;Millenial;PROVIDENCIA                   ;METROPOLITANA;0;0;0;0;0;0;0;0;0;Cafetera TH-138i;ELECTRODOMESTICOS
5720888;;F;80;CHILENO;;Silencioso;RENCA                         ;METROPOLITANA;0;0;0;0;0;0;0;0;0;Combo Hervidor + Batidora;ELECTRODOMESTICOS
18069791;Soltero;F;29;CHILENO;;Millenial;PROVIDENCIA                   ;METROPOLITANA;0;0;0;0;0;0;0;0;0;Hervidor Electrico UT-MANLY17 1,7Lts Negro;ELECTRODOMESTICOS
6794289;;F;73;CHILENO;;Silencioso;ISLA DE MAIPO                 ;METROPOLITANA;0;0;0;0;0;0;0;0;0;Aspiradora UT-MEINER1803 Arrastre 1800Watts;ELECTRODOMESTICOS
7910329;;F;70;CHILENO;;Silencioso;SAN VICENTE                   ;L.G.B.OÂ´HIGGINS;0;0;0;0;0;0;0;0;0;Horno Microondas Digital L UT-25KROMM 25Lts;ELECTRODOMESTICOS
11424642;;F;52;CHILENO;;X;SAN JOAQUIN                   ;METROPOLITANA;0;0;0;0;0;0;0;0;0;Hervidor Electrico UT-MANLY17 1,7Lts Negro;ELECTRODOMESTICOS
10343666;;M;55;CHILENO;;Boomers;PROVIDENCIA                   ;METROPOLITANA;0;0;0;0;0;0;0;0;0;Maquina de Coser 311;ELECTRODOMESTICOS
6830237;;F;74;CHILENO;;Silencioso;RENCA                         ;METROPOLITANA;0;0;0;0;0;0;0;0;0;Batidora Manual TH-8830;ELECTRODOMESTICOS
12109115;;F;53;CHILENO;;X;PROVIDENCIA                   ;METROPOLITANA;0;0;0;0;0;0;0;0;0;Batidora Manual TH-8830;ELECTRODOMESTICOS
4500112;;M;81;CHILENO;;Silencioso;RENCA                         ;METROPOLITANA;0;0;0;0;0;0;0;0;0;Combo Hervidor + Batidora;ELECTRODOMESTICOS
8465771;;M;63;CHILENO;;Boomers;PROVIDENCIA                   ;METROPOLITANA;0;0;0;0;0;0;0;0;0;Batidora Manual BA-5010 Inox;ELECTRODOMESTICOS
10017323;;M;58;CHILENO;;Boomers;RENCA                         ;METROPOLITANA;0;0;0;0;0;0;0;0;0;Batidora Pedestal TH910PN 4,6Lts 1300Watts;ELECTRODOMESTICOS
9488033;Viudo;F;57;CHILENO;FONOAUDIOLOGO;Boomers;PROVIDENCIA                   ;METROPOLITANA;0;0;0;0;0;0;0;0;0;Enceradora EA-5000;ELECTRODOMESTICOS
27054340;;M;40;COLOMBIANO;;Extranjero;SANTIAGO                      ;METROPOLITANA;0;0;0;0;0;0;0;0;0;Licuadora TH-501V 1,5Lts Vaso Vidrio;ELECTRODOMESTICOS
15526880;;F;38;CHILENO;;Millenial;RENGO                         ;L.G.B.OÂ´HIGGINS;0;0;0;0;0;0;0;0;0;Licuadora TH-320 Roja/Negro 1,5 Lts Vaso Vidrio;ELECTRODOMESTICOS
12869854;;F;47;CHILENO;;X;PARRAL                        ;MAULE;0;0;0;0;0;0;0;0;0;Plancha THOMAS TH-7170 2200Watts Base Ceramica;ELECTRODOMESTICOS
9391609;;F;61;CHILENO;;Boomers;CURICO                        ;MAULE;0;0;0;0;0;0;0;0;0;Horno Electrico TH-25N01 25Lts;ELECTRODOMESTICOS
10251514;;M;56;CHILENO;;Boomers;RENCA                         ;METROPOLITANA;0;0;0;0;0;0;0;0;0;Combo Plancha Batidora Secador de Pelo;ELECTRODOMESTICOS
15927557;Soltero;F;36;CHILENO;;Millenial;FREIRE                        ;ARAUCANIA;0;0;0;0;0;0;0;0;0;Licuadora TH-320 Roja/Negro 1,5 Lts Vaso Vidrio;ELECTRODOMESTICOS
13060384;;M;46;CHILENO;;X;RENCA                         ;METROPOLITANA;0;0;0;0;0;0;0;0;0;Horno Microondas Digital TH-25DM 25Lts;ELECTRODOMESTICOS
5913068;;M;72;CHILENO;;Silencioso;SAN ANTONIO                   ;VALPARAISO;0;0;0;0;0;0;0;0;0;Batidora Vertical Multimixer TH-8720;ELECTRODOMESTICOS
8920729;Casado;F;61;CHILENO;;Boomers;LINARES                       ;MAULE;0;0;0;0;0;0;0;0;0;Horno Electrico HE-110 10Lts;ELECTRODOMESTICOS
6288613;;F;70;CHILENO;;Silencioso;N/D;N/D;0;0;0;0;0;0;0;0;0;Licuadora TH-320 Roja/Negro 1,5 Lts Vaso Vidrio;ELECTRODOMESTICOS
10228876;;F;51;CHILENO;;X;RENCA                         ;METROPOLITANA;0;0;0;0;0;0;0;0;0;Plancha UT-PLATTEISEN 2000Watts Base Ceramica;ELECTRODOMESTICOS
11848243;;M;51;CHILENO;;X;RENCA                         ;METROPOLITANA;0;0;0;0;0;0;0;0;0;Licuadora Personal TH-300PB;ELECTRODOMESTICOS
13138068;Casado;F;45;CHILENO;;X;PROVIDENCIA                   ;METROPOLITANA;0;0;0;0;0;0;0;0;0;Licuadora TH-320 Roja/Negro 1,5 Lts Vaso Vidrio;ELECTRODOMESTICOS
7050414;Soltero;M;69;CHILENO;;Silencioso;PROVIDENCIA                   ;METROPOLITANA;0;0;0;0;0;0;0;0;0;Horno Microondas Mecanico UT-SYDNEY18 18Lts;ELECTRODOMESTICOS
9788844;;F;54;CHILENO;;Boomers;VILCUN                        ;ARAUCANIA;0;0;0;0;0;0;0;0;0;Horno Electrico TH62I 60Lts;ELECTRODOMESTICOS
7737352;Casado;M;60;CHILENO;;Boomers;RENCA                         ;METROPOLITANA;0;0;0;0;0;0;0;0;0;Plancha UT-KERAMIK1 2200Watts Base Ceramica;ELECTRODOMESTICOS
11303960;Viudo;F;54;CHILENO;;X;RENCA                         ;METROPOLITANA;0;0;0;0;0;0;0;0;0;Hervidor Electrico HE420 2lts Negro;ELECTRODOMESTICOS
13160907;;F;49;CHILENO;;X;MARIQUINA                     ;LOS LAGOS;0;0;0;0;0;0;0;0;0;Horno Electrico TH62I 60Lts;ELECTRODOMESTICOS
17272341;Casado;M;32;CHILENO;TECNICO DE NIVEL SUPERIOR EN ENFERMERIA;Millenial;PROVIDENCIA                   ;METROPOLITANA;0;0;0;0;0;0;0;0;0;Horno Microondas Mecanico M-2020NG 20Lts;ELECTRODOMESTICOS
8797200;;F;63;CHILENO;;Boomers;RENCA                         ;METROPOLITANA;0;0;0;0;0;0;0;0;0;Licuadora BL-2000 Negra1,5 Lts Vaso Vidrio;ELECTRODOMESTICOS
10004985;;F;58;CHILENO;;Boomers;MONTE PATRIA                  ;COQUIMBO;0;0;0;0;0;0;0;0;0;Batidora Manual TH-8830;ELECTRODOMESTICOS
6373262;Viudo;F;66;CHILENO;PROFESOR;Boomers;RENCA                         ;METROPOLITANA;0;0;0;0;0;0;0;0;0;Picadora TH-9005 1Lts Vaso Vidrio;ELECTRODOMESTICOS
6774387;;F;59;CHILENO;;Silencioso;PROVIDENCIA                   ;METROPOLITANA;0;0;0;0;0;0;0;0;0;Hervidor Electrico UT-MANLY17 1,7Lts Negro;ELECTRODOMESTICOS
6080313;;F;72;CHILENO;;Silencioso;PENAFLOR                      ;METROPOLITANA;0;0;0;0;0;0;0;0;0;Olla Arrocera TH38IF 1,8Lts;ELECTRODOMESTICOS
8990551;;F;62;CHILENO;;Boomers;CURICO                        ;MAULE;0;0;0;0;0;0;0;0;0;Licuadora TH-320 Roja/Negro 1,5 Lts Vaso Vidrio;ELECTRODOMESTICOS
8481794;;M;61;CHILENO;;Boomers;CAUQUENES                     ;MAULE;0;0;0;0;0;0;0;0;0;Hervidor Electrico UT-KLAR20PW 2Lts Blanco;ELECTRODOMESTICOS
8225189;Casado;F;64;CHILENO;;Boomers;RENCA                         ;METROPOLITANA;0;0;0;0;0;0;0;0;0;Hervidor Electrico TH-5407i 2Lts;ELECTRODOMESTICOS
15226848;;F;39;CHILENO;;X;N/D;N/D;0;0;0;0;0;0;0;0;0;Plancha THOMAS TH-7170 2200Watts Base Ceramica;ELECTRODOMESTICOS
18240734;;M;30;CHILENO;;Millenial;PUTAENDO                      ;VALPARAISO;0;0;0;0;0;0;0;0;0;Licuadora UT-METALLEK705 1,75Lts Vaso Vidrio;ELECTRODOMESTICOS
19589361;;M;25;CHILENO;;Z;N/D;N/D;0;0;0;0;0;0;0;0;0;Aspiradora TH2220 Arrastre 2200Watts;ELECTRODOMESTICOS
4940278;;M;79;CHILENO;;Silencioso;PUDAHUEL                      ;METROPOLITANA;0;0;0;0;0;0;0;0;0;Hervidor Electrico UT-KLAR20PW 2Lts Blanco;ELECTRODOMESTICOS
9941067;;F;58;CHILENO;;Boomers;PROVIDENCIA                   ;METROPOLITANA;0;0;0;0;0;0;0;0;0;Horno Microondas Digital TH-20S01 20Lts;ELECTRODOMESTICOS
11311744;;M;53;CHILENO;;X;PALMILLA                      ;L.G.B.OÂ´HIGGINS;0;0;0;0;0;0;0;0;0;Horno Electrico TH62I 60Lts;ELECTRODOMESTICOS
16780005;;M;34;CHILENO;;Millenial;CORRAL                        ;LOS RIOS;0;0;0;0;0;0;0;0;0;Horno Microondas Digital TH-20S01 20Lts;ELECTRODOMESTICOS
13789596;;M;42;CHILENO;;X;PROVIDENCIA                   ;METROPOLITANA;0;0;0;0;0;0;0;0;0;Exprimidor de Jugo 407W 1Lts;ELECTRODOMESTICOS
8621029;;M;63;CHILENO;;Boomers;MELIPILLA                     ;METROPOLITANA;0;0;0;0;0;0;0;0;0;Licuadora TH-320 Roja/Negro 1,5 Lts Vaso Vidrio;ELECTRODOMESTICOS
13220358;;M;44;CHILENO;;X;"";"";0;0;0;0;0;0;0;0;0;Hervidor Electrico TH-4515N 2Lts Negro;ELECTRODOMESTICOS
8226162;Soltero;F;64;CHILENO;;Boomers;PROVIDENCIA                   ;METROPOLITANA;0;0;0;0;0;0;0;0;0;Licuadora TH-401V Roja 1,75Lts Vaso Vidrio;ELECTRODOMESTICOS
18254379;;M;29;CHILENO;;Millenial;MAIPU                         ;METROPOLITANA;0;0;0;0;0;0;0;0;0;Batidora Vertical Multimixer TH-8720;ELECTRODOMESTICOS
13553650;;M;50;CHILENO;;X;QUILICURA                     ;METROPOLITANA;0;0;0;0;0;0;0;0;0;Horno Microondas Mecanico TH-18B05 18Lts;ELECTRODOMESTICOS
8705460;;F;61;CHILENO;;Boomers;CURACAVI                      ;METROPOLITANA;0;0;0;0;0;0;0;0;0;Hervidor Electrico TH-4350 3Lts Blanco;ELECTRODOMESTICOS
19098097;;F;26;CHILENO;;Z;PROVIDENCIA                   ;METROPOLITANA;0;0;0;0;0;0;0;0;0;Hervidor Electrico UT-MANLY17 1,7Lts Negro;ELECTRODOMESTICOS
18488277;Soltero;F;28;CHILENO;INGENIERO EN PREVENCION DE RIESGOS;Millenial;PROVIDENCIA                   ;METROPOLITANA;0;0;0;0;0;0;0;0;0;Hervidor Electrico UT-DUNKEL17P 2Lts Negro;ELECTRODOMESTICOS
14694049;Soltero;F;54;PERUANO;;Boomers;PROVIDENCIA                   ;METROPOLITANA;0;0;0;0;0;0;0;0;0;Hervidor Electrico UT-MANLY17 1,7Lts Negro;ELECTRODOMESTICOS
17592338;Soltero;F;32;CHILENO;PROFESOR;Millenial;PROVIDENCIA                   ;METROPOLITANA;0;0;0;0;0;0;0;0;0;Horno Electrico TH-25N01 25Lts;ELECTRODOMESTICOS
9393541;Divorciado;F;58;CHILENO;CONTADOR AUDITOR;Boomers;RENCA                         ;METROPOLITANA;0;0;0;0;0;0;0;0;0;Horno Electrico TH-48N 48Lts;ELECTRODOMESTICOS
15196183;;F;40;CHILENO;;X;ARAUCO                        ;BIO BIO;0;0;0;0;0;0;0;0;0;Plancha UT-KERAMIK1 2200Watts Base Ceramica;ELECTRODOMESTICOS
10508904;;M;57;CHILENO;;Boomers;CURICO                        ;MAULE;0;0;0;0;0;0;0;0;0;Aspiradora TH1870 Arrastre 1800Watts Gris;ELECTRODOMESTICOS
3777352;;M;79;CHILENO;;Silencioso;PROVIDENCIA                   ;METROPOLITANA;0;0;0;0;0;0;0;0;0;Batidora Vertical Stick Mixer 2609;ELECTRODOMESTICOS
12922453;Soltero;F;46;CHILENO;CONTADOR AUDITOR;X;RENCA                         ;METROPOLITANA;0;0;0;0;0;0;0;0;0;Plancha Vertical TH-7300 1200Watts;ELECTRODOMESTICOS
16165696;;M;36;CHILENO;;Millenial;SAN FERNANDO                  ;L.G.B.OÂ´HIGGINS;0;0;0;0;0;0;0;0;0;Licuadora BL1500 Silver 1,75Lts Vaso Vidrio;ELECTRODOMESTICOS
18212947;;M;30;CHILENO;;Millenial;SAN PEDRO                     ;METROPOLITANA;0;0;0;0;0;0;0;0;0;Horno Microondas Digital TH-20S01 20Lts;ELECTRODOMESTICOS
17075447;;F;33;CHILENO;;Millenial;TEMUCO                        ;ARAUCANIA;0;0;0;0;0;0;0;0;0;Aspiradora TH1870 Arrastre 1800Watts Gris;ELECTRODOMESTICOS
11365912;;M;53;CHILENO;;X;RANCAGUA                      ;L.G.B.OÂ´HIGGINS;0;0;0;0;0;0;0;0;0;Hervidor Electrico UT-DUNKEL17P 2Lts Negro;ELECTRODOMESTICOS
20228005;;F;22;CHILENO;;Z;PROVIDENCIA                   ;METROPOLITANA;0;0;0;0;0;0;0;0;0;Plancha Perfect Steam (PV7200) 2200 watts;ELECTRODOMESTICOS
4529499;;M;79;CHILENO;;Silencioso;INDEPENDENCIA                 ;METROPOLITANA;0;0;0;0;0;0;0;0;0;Plancha 6204 2200Watts;ELECTRODOMESTICOS
19705368;;F;24;CHILENO;;Z;PROVIDENCIA                   ;METROPOLITANA;0;0;0;0;0;0;0;0;0;Batidora Manual 2532;ELECTRODOMESTICOS
14902737;;F;41;CHILENO;;X;ARAUCO                        ;BIO BIO;0;0;0;0;0;0;0;0;0;Hervidor Electrico HA-3300 2,5Lts Blanco;ELECTRODOMESTICOS
18353499;Soltero;M;29;CHILENO;MEDICO CIRUJANO;Millenial;PROVIDENCIA                   ;METROPOLITANA;0;0;0;0;0;0;0;0;0;Horno Microondas Digital MS23K3513AK/ZS 23Lts;ELECTRODOMESTICOS
12240846;Soltero;F;49;CHILENO;;X;PROVIDENCIA                   ;METROPOLITANA;0;0;0;0;0;0;0;0;0;Batidora Manual UT-TEKLA300;ELECTRODOMESTICOS
8798547;;F;61;CHILENO;;Boomers;LA PINTANA                    ;METROPOLITANA;0;0;0;0;0;0;0;0;0;Horno Electrico UT-LEIF36 36Lts;ELECTRODOMESTICOS
16711742;;M;34;CHILENO;;Millenial;PROVIDENCIA                   ;METROPOLITANA;0;0;0;0;0;0;0;0;0;Licuadora Low Cost Roja 1,5Lts Vaso Vidrio;ELECTRODOMESTICOS
19657291;;F;31;CHILENO;;Millenial;PUCON                         ;ARAUCANIA;0;0;0;0;0;0;0;0;0;Hervidor Electrico TH-4800 2Lts Negro Azul;ELECTRODOMESTICOS
14497869;Casado;F;45;CHILENO;;X;RENCA                         ;METROPOLITANA;0;0;0;0;0;0;0;0;0;Plancha UT-DUNST 2200Watts Base Ceramica;ELECTRODOMESTICOS
18200345;;M;29;CHILENO;;Millenial;PENAFLOR                      ;METROPOLITANA;0;0;0;0;0;0;0;0;0;Horno Microondas Mecanico TH-18B05 18Lts;ELECTRODOMESTICOS
15782617;;F;40;CHILENO;;X;QUILPUE                       ;VALPARAISO;0;0;0;0;0;0;0;0;0;Horno Electrico TH-100i 100Lts;ELECTRODOMESTICOS
5255714;;F;79;CHILENO;;Silencioso;RENCA                         ;METROPOLITANA;0;0;0;0;0;0;0;0;0;Batidora Vertical Multimixer TH-8735I;ELECTRODOMESTICOS
16549413;;F;35;CHILENO;;Millenial;PROVIDENCIA                   ;METROPOLITANA;0;0;0;0;0;0;0;0;0;Parrilla Electrica UT-ECOKERAMIK(RED);ELECTRODOMESTICOS
12992434;;F;46;CHILENO;;X;PANGUIPULLI                   ;LOS RIOS;0;0;0;0;0;0;0;0;0;Batidora Manual TH-8830;ELECTRODOMESTICOS
9344533;;F;78;CHILENO;;Silencioso;RENCA                         ;METROPOLITANA;0;0;0;0;0;0;0;0;0;Picadora UT-PETRUS320 1Lts Vaso Vidrio;ELECTRODOMESTICOS
15237474;;F;39;CHILENO;;X;PROVIDENCIA                   ;METROPOLITANA;0;0;0;0;0;0;0;0;0;Hervidor Electrico TH-4800 2Lts Negro Azul;ELECTRODOMESTICOS
17146389;;M;33;CHILENO;;Millenial;N/D;N/D;608960;6;3;0;0;0;6;3;608960;LED 40 KEHD4020 SMART TV;ELECTRONICA MAYOR
17996839;;F;31;CHILENO;;Millenial;N/D;N/D;487950;5;4;2;1;232980;3;3;254970;PARLANTE ULTRAFUSION;ELECTRONICA MAYOR
12006025;;F;50;CHILENO;;X;RENCA                         ;METROPOLITANA;419990;1;1;0;0;0;1;1;419990;LED 58 UN58AU7000GXZS UHD 4K SMART TV;ELECTRONICA MAYOR
6140506;;M;71;CHILENO;;Silencioso;RENCA                         ;METROPOLITANA;402160;2;1;0;0;0;2;1;402160;LED 55 55P615 UHD ANDROID TV 4K;ELECTRONICA MAYOR
14227757;;F;40;CHILENO;;X;PUERTO MONTT                  ;LOS LAGOS;2101690;12;5;4;1;543950;8;4;1557740;LED 55UP7500 UHD SMART;ELECTRONICA MAYOR
5487458;;F;76;CHILENO;;Silencioso;NATALES                       ;MAGALLANES;219990;1;1;0;0;0;1;1;219990;LED 43 UN43T5202AGXZS FHD SMART TV;ELECTRONICA MAYOR
18574604;;F;28;CHILENO;;Millenial;N/D;N/D;189450;7;4;0;0;0;7;4;189450;POP CORN MAKER;ELECTRONICA MAYOR
15120906;Casado;M;37;CHILENO;PROFESOR;Millenial;PROVIDENCIA                   ;METROPOLITANA;472520;4;3;2;1;134540;2;2;337980;LED 50 50UP7500 UHD SMART TV;ELECTRONICA MAYOR
17230036;;M;32;CHILENO;;Extranjero;PROVIDENCIA                   ;N/D;591970;3;1;3;1;591970;0;0;0;LED SAMSUNG 50 AU7090 CRYSTAL UHD 4K SMART TV 20;ELECTRONICA MAYOR
11713201;;M;52;CHILENO;;X;PUERTO MONTT                  ;LOS LAGOS;0;0;2;0;0;0;0;2;0;PARLANTE ULTRA BOOSTER Z2;ELECTRONICA MAYOR
5900643;;M;72;CHILENO;;Silencioso;CUNCO                         ;ARAUCANIA;204980;2;2;0;0;0;2;2;204980;LED LG 32 SMART TV FHD 32LQ630BPSA.AWH;ELECTRONICA MAYOR
10002272;;M;56;CHILENO;;Boomers;VALLENAR;ATACAMA;307490;3;2;0;0;0;3;2;307490;PARLANTE KARAOKE K3421;ELECTRONICA MAYOR
18447705;;F;29;CHILENO;;Millenial;SAN ANTONIO                   ;VALPARAISO;157520;2;1;0;0;0;2;1;157520;PARLANTE SCREAMER 5;ELECTRONICA MAYOR
26084678;;F;37;COLOMBIANO;;Millenial;INDEPENDENCIA;METROPOLITANA;193980;2;1;2;1;193980;0;0;0;LED 43 43S5195 ROKU TV FHD;ELECTRONICA MAYOR
7535428;;M;69;CHILENO;;Silencioso;PROVIDENCIA                   ;METROPOLITANA;463810;7;3;0;0;0;7;3;463810;MINICOMPONENTE CJ45;ELECTRONICA MAYOR
15330813;;F;40;CHILENO;;X;PROVIDENCIA                   ;METROPOLITANA;169980;2;2;0;0;0;2;2;169980;LED 42 42S6500 ANDROID TV FHD;ELECTRONICA MAYOR
11440862;;F;52;CHILENO;;X;PUENTE ALTO                   ;METROPOLITANA;686400;6;3;0;0;0;6;3;686400;LED 43 43UP7500 UHD SMART TV;ELECTRONICA MAYOR
16005186;;F;35;CHILENO;;Millenial;N/D;N/D;519950;5;4;1;1;139990;4;3;379960;LED 40 KEHD4020 SMART TV;ELECTRONICA MAYOR
19578944;;F;25;CHILENO;;Z;PROVIDENCIA                   ;METROPOLITANA;1689710;14;9;13;8;1519720;1;1;169990;PARLANTE ULTRAMEGA;ELECTRONICA MAYOR
17145653;;F;33;CHILENO;;Millenial;CAUQUENES                     ;MAULE;146980;2;2;0;0;0;2;2;146980;MINICOMPONENTE RN5;ELECTRONICA MAYOR
11979912;;F;49;CHILENO;;X;PAINE                         ;METROPOLITANA;721920;9;7;0;0;0;9;7;721920;PARLANTE ULTRABUZZ;ELECTRONICA MAYOR
4738464;;M;80;CHILENO;;Silencioso;SAN ANTONIO                   ;VALPARAISO;196290;3;4;0;0;0;3;4;196290;LED 32 32PHD6825 HD SMART TV;ELECTRONICA MAYOR
17446370;;F;32;CHILENO;;Millenial;NUEVA IMPERIAL                ;ARAUCANIA;401960;4;3;0;0;0;4;3;401960;LED 42 42S6500 ANDROID TV FHD;ELECTRONICA MAYOR
14080054;;M;41;CHILENO;;X;LAS CONDES;METROPOLITANA;936930;7;3;7;3;936930;0;0;0;LED SAMSUNG 50 AU7090 CRYSTAL UHD 4K SMART TV 20;ELECTRONICA MAYOR
17261128;Casado;M;33;CHILENO;;Millenial;N/D;N/D;103980;2;1;2;1;103980;0;0;0;LED 32 32PHD6825 HD SMART TV;ELECTRONICA MAYOR
9590620;;F;60;CHILENO;;Boomers;SAN JAVIER                    ;MAULE;39493;2;1;0;0;0;2;1;39493;KARAOKE RHYTHM CHARGER 12 MIC CABLE 8890;ELECTRONICA MAYOR
15949328;;M;38;CHILENO;;Millenial;ALGARROBO                     ;VALPARAISO;201980;2;1;2;1;201980;0;0;0;LED 50 KEUH50 SMART TV UHD;ELECTRONICA MAYOR
11758926;Casado;F;51;CHILENO;;X;RENGO                         ;L.G.B.OÂ´HIGGINS;518950;5;4;0;0;0;5;4;518950;LED 42 42S6500 ANDROID TV FHD;ELECTRONICA MAYOR
8305027;;M;59;CHILENO;;Boomers;BUIN                          ;METROPOLITANA;1232870;13;9;13;9;1232870;0;0;0;LED 32 UN32T4300AGXZS HD SMART TV;ELECTRONICA MAYOR
17504756;;F;32;CHILENO;;Millenial;PICHIDEGUA                    ;L.G.B.OÂ´HIGGINS;913910;10;6;0;0;0;10;6;913910;LED 55 KEUH5521 SMART TV UHD;ELECTRONICA MAYOR
15572074;;F;39;CHILENO;;X;VICUNA;COQUIMBO;301980;2;1;2;1;301980;0;0;0;MINICOMPONENTE MX-T70/ZS ALL IN ONE;ELECTRONICA MAYOR
16257785;;F;36;CHILENO;;Millenial;N/D;N/D;1734850;20;5;6;2;198440;14;3;1536410;LED SAMSUNG 50 AU7090 CRYSTAL UHD 4K SMART TV 20;ELECTRONICA MAYOR
19545973;;F;25;CHILENO;;Z;HUECHURABA;METROPOLITANA;554930;8;5;7;4;404940;1;1;149990;LED 40 KEHD4020 SMART TV;ELECTRONICA MAYOR
18336854;;M;29;CHILENO;;Millenial;PROVIDENCIA                   ;METROPOLITANA;459990;2;2;1;1;279990;1;1;180000;LED 55 55P615 UHD ANDROID TV 4K;ELECTRONICA MAYOR
12035852;;M;53;CHILENO;;X;PUDAHUEL                      ;METROPOLITANA;26480;2;1;0;0;0;2;1;26480;PARLANTE KARAOKE 8 MAXEIGHT;ELECTRONICA MAYOR
17208884;;M;33;CHILENO;;Millenial;N/D;N/D;279990;1;1;0;0;0;1;1;279990;LED 43 43UP7500 UHD SMART TV;ELECTRONICA MAYOR
6800402;;F;68;CHILENO;;Boomers;RENCA                         ;METROPOLITANA;196980;2;1;0;0;0;2;1;196980;LED 32LM637B HD SMART;ELECTRONICA MAYOR
8081046;;M;63;CHILENO;;Boomers;N/D;N/D;1390850;15;13;0;0;0;15;13;1390850;LED 32 32S5305 HD HDR10/HLG;ELECTRONICA MAYOR
6523031;;M;69;CHILENO;;Silencioso;N/D;N/D;736590;11;6;0;0;0;11;6;736590;LED KIOTO 32 MI3228 SMART TV;ELECTRONICA MAYOR
18094468;;F;30;CHILENO;;Millenial;N/D;N/D;219960;4;4;0;0;0;4;4;219960;MLAB KARAOKE 8 CITY SET MICROFONO INALAMBRICO AT;ELECTRONICA MAYOR
22253204;;M;58;BOLIVIANO;;Extranjero;CALAMA                        ;ANTOFAGASTA;1009970;4;2;0;0;0;4;2;1009970;LED SAMSUNG 75 BU82000 CRYSTAL UHD 4K SMART TV;ELECTRONICA MAYOR
20140714;;F;23;CHILENO;;Z;PROVIDENCIA                   ;METROPOLITANA;148980;2;1;2;1;148980;0;0;0;LED 32 32S60-32P ANDROID TV SMART LINE HD;ELECTRONICA MAYOR
3724585;;M;87;CHILENO;;Silencioso;PUERTO MONTT                  ;LOS LAGOS;29990;1;1;0;0;0;1;1;29990;PARLANTE SCREAMER 3;ELECTRONICA MAYOR
12727239;;F;47;CHILENO;;X;CONSTITUCION                  ;MAULE;909789;6;3;0;0;0;6;3;909789;LED NanoCell 55NANO80 UHD SMART + MAGIC;ELECTRONICA MAYOR
5859640;;F;76;CHILENO;;Silencioso;PANGUIPULLI                   ;LOS LAGOS;469980;3;1;0;0;0;3;1;469980;LED 50 50UP7750 FHD SMART TV + MAGIC;ELECTRONICA MAYOR
8106178;;F;63;CHILENO;;Boomers;PADRE LAS CASAS               ;ARAUCANIA;439970;3;4;0;0;0;3;4;439970;PARLANTE ULTRABUZZ;ELECTRONICA MAYOR
6383781;;M;67;CHILENO;;Boomers;ANGOL                         ;ARAUCANIA;635970;3;2;0;0;0;3;2;635970;LED 58 UN58AU7000GXZS UHD 4K SMART TV;ELECTRONICA MAYOR
13812079;;F;41;CHILENO;;X;NUEVA IMPERIAL                ;ARAUCANIA;742920;8;7;3;2;66970;5;5;675950;QLED 50 QN50Q60AAGXZS 4K UHD SMART TV;ELECTRONICA MAYOR
18369128;;F;25;CHILENO;;Z;OSORNO;LOS LAGOS;563980;3;1;3;1;563980;0;0;0;LED SAMSUNG 50 AU7090 CRYSTAL UHD 4K SMART TV 20;ELECTRONICA MAYOR
15581753;;F;38;CHILENO;;Millenial;PROVIDENCIA                   ;METROPOLITANA;159990;1;1;1;1;159990;0;0;0;LED 42 42S6500 ANDROID TV FHD;ELECTRONICA MAYOR
16388859;;F;36;CHILENO;;Millenial;PROVIDENCIA                   ;METROPOLITANA;248950;5;2;0;0;0;5;2;248950;MINICOMPONENTE RN7;ELECTRONICA MAYOR
6909340;;M;67;CHILENO;;Boomers;LOS ANDES                     ;VALPARAISO;488690;2;1;0;0;0;2;1;488690;LED 65 KEUH6521 SMART TV UHD;ELECTRONICA MAYOR
18431436;;F;28;CHILENO;;Millenial;CHILLAN                       ;BIO BIO;299990;1;1;0;0;0;1;1;299990;LED 55 55P615 UHD ANDROID TV 4K;ELECTRONICA MAYOR
18136573;;M;29;CHILENO;;Millenial;LOS VILOS                     ;COQUIMBO;317270;5;2;0;0;0;5;2;317270;MINICOMPONENTE MX-T40/ZS ALL IN ONE;ELECTRONICA MAYOR
10614849;;M;55;CHILENO;;Boomers;LOS ALAMOS                    ;BIO BIO;701619;5;2;0;0;0;5;2;701619;LED 32 32S5305 HD HDR10/HLG;ELECTRONICA MAYOR
18880264;;F;28;CHILENO;;Millenial;SAN BERNARDO                  ;METROPOLITANA;296920;8;7;4;4;222960;4;3;73960;KARAOKE PORTATIL TWO-EIGHT 8860;ELECTRONICA MAYOR
7375685;;M;67;CHILENO;;Boomers;PROVIDENCIA                   ;N/D;349990;1;1;0;0;0;1;1;349990;LED LG 50 50UQ7500PSF.AWH UHD TV;ELECTRONICA MAYOR
5902856;;F;73;CHILENO;;Silencioso;EL MONTE                      ;METROPOLITANA;541962;4;3;0;0;0;4;3;541962;LED 55 55P615 UHD ANDROID TV 4K;ELECTRONICA MAYOR
19595929;;F;25;CHILENO;;Z;CONCEPCION;BIO-BIO;94970;3;1;3;1;94970;0;0;0;PARLANTE SCREAMER 4;ELECTRONICA MAYOR
14103150;;F;41;CHILENO;;X;ARICA                         ;ARICA Y PARINACOTA;150120;4;2;0;0;0;4;2;150120;LED KIOTO 32 MI3228 SMART TV;ELECTRONICA MAYOR
9919914;;F;56;CHILENO;;Boomers;N/D;N/D;289990;1;1;0;0;0;1;1;289990;LED 55 55P615 UHD ANDROID TV 4K;ELECTRONICA MAYOR
14494682;;M;50;CHILENO;;X;MELIPILLA                     ;METROPOLITANA;4449760;28;17;0;0;0;28;17;4449760;LED SAMSUNG 50 AU7090 CRYSTAL UHD 4K SMART TV 20;ELECTRONICA MAYOR
8486993;;F;63;CHILENO;;Boomers;PANGUIPULLI                   ;LOS RIOS;306970;3;3;0;0;0;3;3;306970;LED 32 32S60-32P ANDROID TV SMART LINE HD;ELECTRONICA MAYOR
16888788;;M;34;CHILENO;;Millenial;N/D;N/D;1831000;13;8;0;0;0;13;8;1831000;LED SAMSUNG 55 4K UHD SMART TV UN55AU7090GXZS;ELECTRONICA MAYOR
9741089;;F;61;CHILENO;;Boomers;MAIPU                         ;METROPOLITANA;859690;7;3;0;0;0;7;3;859690;LED 40 KEHD4020 SMART TV;ELECTRONICA MAYOR
7259201;;F;63;CHILENO;;Boomers;N/D;N/D;73980;2;1;2;1;73980;0;0;0;KARAOKE 15 HEAVY BASS MIC INA CON ATRIL 8892;ELECTRONICA MAYOR
10847988;;F;55;CHILENO;;Boomers;N/D;N/D;417270;11;6;0;0;0;11;6;417270;LED 43 43S5195 ROKU TV FHD;ELECTRONICA MAYOR
18400291;Soltero;M;30;CHILENO;INGENIERO DE PROYECTOS;Millenial;COQUIMBO                      ;COQUIMBO;100980;4;2;0;0;0;4;2;100980;PARLANTE ULTRAMAGIC;ELECTRONICA MAYOR
19120172;;F;27;CHILENO;;Z;CANETE                        ;BIO BIO;277940;6;4;0;0;0;6;4;277940;MINICOMPONENTE RN7;ELECTRONICA MAYOR
12467958;;F;49;CHILENO;;X;LA PINTANA                    ;METROPOLITANA;178970;3;3;2;1;143980;1;2;34990;PARLANTE ULTRABOOSTER 1;ELECTRONICA MAYOR
13099766;;F;46;CHILENO;;X;SAN VICENTE                   ;L.G.B.OÂ´HIGGINS;184990;1;1;0;0;0;1;1;184990;LED 42 KHFH4221 SMART TV;ELECTRONICA MAYOR
9565168;;F;60;CHILENO;;Boomers;N/D;N/D;198960;4;3;0;0;0;4;3;198960;LED 32 32PHD6825 HD SMART TV;ELECTRONICA MAYOR
11757871;;M;50;CHILENO;;X;LAS CABRAS;O HIGGINS;652388;6;5;0;0;0;6;5;652388;LED 50 KEUH50 SMART TV UHD;ELECTRONICA MAYOR
20564229;;F;21;CHILENO;;Z;"";"";38720;2;1;0;0;0;2;1;38720;PARLANTE SCREAMER 3;ELECTRONICA MAYOR
26897984;;F;41;EXTRANJERO - NO INFORMA NACIONALIDAD;;Extranjero;"";"";161120;3;1;0;0;0;3;1;161120;MINICOMPONENTE RN5;ELECTRONICA MAYOR
7075128;;F;63;CHILENO;;Boomers;LO PRADO;METROPOLITANA;193980;2;1;2;1;193980;0;0;0;LED 43 43S5195 ROKU TV FHD;ELECTRONICA MAYOR
16401748;;M;35;CHILENO;;Millenial;RENCA                         ;METROPOLITANA;437972;5;3;0;0;0;5;3;437972;LED 42 42S6500 ANDROID TV FHD;ELECTRONICA MAYOR
11796840;;F;51;CHILENO;;X;"";"";558170;7;4;0;0;0;7;4;558170;LED 43 43UP7500 UHD SMART TV;ELECTRONICA MAYOR
9327991;;F;67;CHILENO;;Boomers;CERRO NAVIA                   ;METROPOLITANA;434960;4;3;0;0;0;4;3;434960;LED 58 KEUH5821 SMART TV UHD;ELECTRONICA MAYOR
5610267;;F;70;CHILENO;;Silencioso;RENCA                         ;METROPOLITANA;521600;2;1;0;0;0;2;1;521600;LED LG 50 50UQ7500PSF.AWH UHD TV;ELECTRONICA MAYOR
19767720;;M;24;CHILENO;;Z;N/D;N/D;191980;2;1;0;0;0;2;1;191980;LED 42 KHFH4221 SMART TV;ELECTRONICA MAYOR
19620906;;M;25;CHILENO;;Millenial;N/D;N/D;299990;1;1;0;0;0;1;1;299990;LED 55 KEUH5521 SMART TV UHD;ELECTRONICA MAYOR
12056811;;F;56;CHILENO;;Boomers;SAN RAMON                     ;METROPOLITANA;187130;2;1;0;0;0;2;1;187130;MINICOMPONENTE RN5;ELECTRONICA MAYOR
13150968;;F;44;CHILENO;;Extranjero;LOS SAUCES                    ;ARAUCANIA;340930;2;1;0;0;0;2;1;340930;LED SAMSUNG 50 AU7090 CRYSTAL UHD 4K SMART TV 20;ELECTRONICA MAYOR
16156783;Soltero;M;37;CHILENO;;Millenial;CORONEL                       ;BIO BIO;197130;2;1;0;0;0;2;1;197130;SOUNDBAR HW-A450/ZS;ELECTRONICA MAYOR
12416837;;M;48;CHILENO;;X;RENCA                         ;METROPOLITANA;59970;3;1;3;1;59970;0;0;0;MAGIC REMOTE MR21G;ELECTRONICA MAYOR
9321115;;F;61;CHILENO;;Boomers;N/D;N/D;1317502;7;5;0;0;0;7;5;1317502;LED 55 KEUH5521 SMART TV UHD;ELECTRONICA MAYOR
19462016;;F;25;CHILENO;;Z;N/D;N/D;739980;2;2;0;0;0;2;2;739980;LED SAMSUNG 50 AU7090 CRYSTAL UHD 4K SMART TV 20;ELECTRONICA MAYOR
10771073;Soltero;M;55;CHILENO;;Boomers;PROVIDENCIA                   ;METROPOLITANA;196680;2;1;0;0;0;2;1;196680;PARLANTE KARAOKE K3421;ELECTRONICA MAYOR
15412643;;M;40;CHILENO;;X;SAN BERNARDO                  ;METROPOLITANA;0;0;2;0;2;0;0;0;0;LED 43 Full HD Smart TV 43PFD6825;ELECTRONICA MAYOR
15773614;;F;43;CHILENO;;X;N/D;N/D;245610;3;2;0;0;0;3;2;245610;LED 42 42S6500 ANDROID TV FHD;ELECTRONICA MAYOR
17087301;Soltero;M;33;CHILENO;;Millenial;PROVIDENCIA                   ;METROPOLITANA;119990;1;1;0;0;0;1;1;119990;MINICOMPONENTE OL45;ELECTRONICA MAYOR
11979020;;F;50;CHILENO;;X;BUIN                          ;METROPOLITANA;132980;2;2;0;0;0;2;2;132980;MINICOMPONENTE OL45;ELECTRONICA MAYOR
19000969;;F;26;CHILENO;;Z;PROVIDENCIA                   ;METROPOLITANA;119990;1;1;1;1;119990;0;0;0;LED 40 KEHD4020 SMART TV;ELECTRONICA MAYOR
15183610;;F;39;CHILENO;;X;SAN PEDRO DE LA PAZ           ;BIO BIO;1405920;8;5;0;0;0;8;5;1405920;LED 50 50P615-50P ANDROID TV PASSION LINE UHD 4K;ELECTRONICA MAYOR
16245594;;F;36;CHILENO;;Millenial;VILCUN                        ;ARAUCANIA;342460;4;2;4;2;342460;0;0;0;LED 50 KEUH50 SMART TV UHD;ELECTRONICA MAYOR
12389151;;F;50;CHILENO;;X;N/D;N/D;520100;4;2;0;0;0;4;2;520100;LED 55 KEUH5521 SMART TV UHD;ELECTRONICA MAYOR
3912262;;M;87;CHILENO;;Silencioso;LA SERENA                     ;COQUIMBO;564170;5;2;0;0;0;5;2;564170;LED 43 43S5195 ROKU TV FHD;ELECTRONICA MAYOR
11360186;;M;53;CHILENO;;X;SAN ANTONIO                   ;VALPARAISO;208989;2;1;0;0;0;2;1;208989;LED 50 KEUH50 SMART TV UHD;ELECTRONICA MAYOR
7108346;;M;62;CHILENO;;Boomers;CANETE                        ;BIO BIO;129990;3;4;0;0;0;3;4;129990;MINICOMPONENTE MHC-V02 ALL IN ONE;ELECTRONICA MAYOR
8461398;;M;59;CHILENO;;Boomers;IQUIQUE                       ;TARAPACA;185060;2;1;0;0;0;2;1;185060;LED 40 KEHD4020 SMART TV;ELECTRONICA MAYOR
11442428;;M;53;CHILENO;;X;RENCA                         ;METROPOLITANA;31990;1;1;0;0;0;1;1;31990;KARAOKE FUNKY DISCO;ELECTRONICA MAYOR
5673741;;F;74;CHILENO;;Silencioso;RENCA                         ;METROPOLITANA;189980;2;2;1;1;119990;1;1;69990;LED 40 KEHD4020 SMART TV;ELECTRONICA MAYOR
6368637;;F;69;CHILENO;;Silencioso;SAN JOAQUIN                   ;METROPOLITANA;185060;2;1;0;0;0;2;1;185060;LED 40 KEHD4020 SMART TV;ELECTRONICA MAYOR
13806248;;M;42;CHILENO;;X;PROVIDENCIA                   ;METROPOLITANA;169990;1;1;1;1;169990;0;0;0;LED 50 KEUH50 SMART TV UHD;ELECTRONICA MAYOR
10539299;;M;56;CHILENO;;Boomers;ISLA DE MAIPO                 ;METROPOLITANA;726640;5;3;0;0;0;5;3;726640;PARLANTE MGULTRAEXTREME;ELECTRONICA MAYOR
16854324;;F;34;CHILENO;;Millenial;N/D;N/D;796930;9;8;2;1;136980;7;7;659950;LED 58 KEUH5821 SMART TV UHD;ELECTRONICA MAYOR
10245399;;M;57;CHILENO;;Boomers;ALTO DEL CARMEN               ;ATACAMA;389980;2;2;0;0;0;2;2;389980;PARLANTE ULTRAMEGA;ELECTRONICA MAYOR
12142303;;M;49;CHILENO;;X;PORTEZUELO                    ;BIO BIO;485120;6;3;0;0;0;6;3;485120;LED 50 KEUH50 SMART TV UHD;ELECTRONICA MAYOR
16398503;;F;35;CHILENO;;Millenial;PROVIDENCIA                   ;METROPOLITANA;457950;5;3;4;2;267960;1;1;189990;PARLANTE ULTRAMAGIC;ELECTRONICA MAYOR
16452848;;M;35;CHILENO;;Millenial;PROVIDENCIA                   ;METROPOLITANA;169980;2;2;2;2;169980;0;0;0;LED KIOTO 32 MI3228 SMART TV;ELECTRONICA MAYOR
17884568;;M;30;CHILENO;;Millenial;PROVIDENCIA                   ;METROPOLITANA;79990;1;1;1;1;79990;0;0;0;LED KIOTO 32 MI3228 SMART TV;ELECTRONICA MAYOR
10157612;;F;58;CHILENO;;Boomers;PUENTE ALTO                   ;METROPOLITANA;432940;6;2;2;1;343980;4;1;88960;LED SAMSUNG 55 4K UHD SMART TV UN55AU7090GXZS;ELECTRONICA MAYOR
7395523;;F;68;CHILENO;;Boomers;CARTAGENA                     ;VALPARAISO;29990;1;1;0;0;0;1;1;29990;PARLANTE SCREAMER 3;ELECTRONICA MAYOR
19357648;;F;25;CHILENO;;Z;CURICO                        ;MAULE;246980;2;1;2;1;246980;0;0;0;LED 58 KEUH5821 SMART TV UHD;ELECTRONICA MAYOR
12310005;Soltero;M;49;CHILENO;TECNICO DE NIVEL SUPERIOR EN ENFERMERIA;X;RENCA                         ;METROPOLITANA;139990;1;1;0;0;0;1;1;139990;LED 40 KEHD4020 SMART TV;ELECTRONICA MAYOR
26878009;;M;35;NO INFORMA NACIONALIDAD;;Extranjero;"";"";298410;4;2;2;1;206980;2;1;91430;LED 55 KEUH5521 SMART TV UHD;ELECTRONICA MAYOR
17036591;;M;33;CHILENO;;Millenial;CURANILAHUE                   ;BIO BIO;1079940;6;4;0;0;0;6;4;1079940;LED 55 KEUH5521 SMART TV UHD;ELECTRONICA MAYOR
11992856;;F;50;CHILENO;;X;CURICO                        ;MAULE;412970;3;2;1;1;129990;2;1;282980;LED 40 KEHD4020 SMART TV;ELECTRONICA MAYOR
11726250;;F;51;CHILENO;;X;N/D;N/D;331090;7;2;0;0;0;7;2;331090;LED 58 KEUH5821 SMART TV UHD;ELECTRONICA MAYOR
19457687;;F;25;CHILENO;;Z;PROVIDENCIA                   ;METROPOLITANA;289980;2;2;1;1;139990;1;1;149990;LED 40 KEHD4020 SMART TV;ELECTRONICA MAYOR
16392251;;F;35;CHILENO;;Millenial;LO ESPEJO                     ;METROPOLITANA;119990;1;1;0;0;0;1;1;119990;MINICOMPONENTE OL45;ELECTRONICA MAYOR
23724863;;F;42;BOLIVIANO;;Extranjero;ARICA                         ;ARICA Y PARINACOTA;1415580;8;3;0;0;0;8;3;1415580;LED 43 Full HD Smart TV 43PFD6825;ELECTRONICA MAYOR
7868962;;F;64;CHILENO;;Boomers;SALAMANCA                     ;COQUIMBO;454690;5;3;0;0;0;5;3;454690;LED KIOTO 32 MI3228 SMART TV;ELECTRONICA MAYOR
13430352;Casado;F;44;CHILENO;;X;VALPARAISO                    ;VALPARAISO;90000;2;1;0;0;0;2;1;90000;LED KIOTO 32 MI3228 SMART TV;ELECTRONICA MAYOR
13046482;;M;45;CHILENO;;X;N/D;N/D;1452930;7;5;4;2;787960;3;3;664970;LED 32 UN32T4300AGXZS HD SMART TV;ELECTRONICA MAYOR
16555547;;F;35;CHILENO;;Millenial;N/D;N/D;216980;2;1;2;1;216980;0;0;0;LED 58 KEUH5821 SMART TV UHD;ELECTRONICA MAYOR
17109694;;F;34;CHILENO;;Millenial;"";"";200150;4;1;0;0;0;4;1;200150;LED 40 KEHD4020 SMART TV;ELECTRONICA MAYOR
25938763;;F;36;VENEZOLANO;;Extranjero;N/D;N/D;245970;3;2;3;2;245970;0;0;0;LED 50 KEUH50 SMART TV UHD;ELECTRONICA MAYOR
14744412;;M;64;PERUANO;;Boomers;N/D;N/D;89990;1;1;0;0;0;1;1;89990;LED KIOTO 32 MI3228 SMART TV;ELECTRONICA MAYOR
13683151;;M;42;CHILENO;;X;SANTIAGO;METROPOLITANA;329940;6;3;5;2;276950;1;1;52990;LED 42 KHFH4221 SMART TV;ELECTRONICA MAYOR
19607681;;M;24;CHILENO;;Z;N/D;N/D;311886;9;4;0;0;0;9;4;311886;LED 50 KEUH50 SMART TV UHD;ELECTRONICA MAYOR
13558968;;F;43;CHILENO;;X;N/D;N/D;669950;5;4;1;1;119990;4;3;549960;LED 40 KEHD4020 SMART TV;ELECTRONICA MAYOR
14036317;;F;50;CHILENO;;X;N/D;N/D;374119;6;4;0;0;0;6;4;374119;LED KIOTO 32 MI3228 SMART TV;ELECTRONICA MAYOR
10011309;;F;59;CHILENO;;Boomers;CALBUCO                       ;LOS LAGOS;185970;3;1;0;0;0;3;1;185970;LED 42 KHFH4221 SMART TV;ELECTRONICA MAYOR
18592619;Soltero;F;28;CHILENO;;Millenial;N/D;N/D;229960;4;2;0;0;0;4;2;229960;LED 58 KEUH5821 SMART TV UHD;ELECTRONICA MAYOR
17911520;;M;30;CHILENO;;Millenial;PROVIDENCIA                   ;METROPOLITANA;79990;1;1;1;1;79990;0;0;0;LED KIOTO 32 MI3228 SMART TV;ELECTRONICA MAYOR
16613879;;F;34;CHILENO;;Millenial;N/D;N/D;1162609;13;7;4;2;377520;9;5;785089;LED 50 KEUH50 SMART TV UHD;ELECTRONICA MAYOR
18524422;;M;29;CHILENO;;Millenial;MULCHEN                       ;BIO BIO;1159310;7;2;0;0;0;7;2;1159310;LED 50 KEUH50 SMART TV UHD;ELECTRONICA MAYOR
17758886;;F;31;CHILENO;;Millenial;LINARES                       ;MAULE;226960;4;2;2;1;186980;2;1;39980;LED 50 KEUH50 SMART TV UHD;ELECTRONICA MAYOR
7190258;;F;70;CHILENO;;Silencioso;BUIN                          ;METROPOLITANA;339980;2;2;0;0;0;2;2;339980;LED SAMSUNG 50 AU7090 CRYSTAL UHD 4K SMART TV 20;ELECTRONICA MAYOR
13512040;;M;44;CHILENO;;X;SANTIAGO                      ;METROPOLITANA;199990;1;1;1;1;199990;0;0;0;LED 50 KEUH50 SMART TV UHD;ELECTRONICA MAYOR
12986300;;F;47;CHILENO;;X;PROVIDENCIA                   ;METROPOLITANA;232980;2;1;2;1;232980;0;0;0;LED 55 KEUH5521 SMART TV UHD;ELECTRONICA MAYOR
9399402;;M;60;CHILENO;;Boomers;QUINCHAO                      ;LOS LAGOS;120000;2;1;0;0;0;2;1;120000;PARLANTE ULTRAMEGA;ELECTRONICA MAYOR
7007087;;F;67;CHILENO;;Boomers;PARRAL                        ;MAULE;764890;6;3;0;0;0;6;3;764890;LED 55 KEUH5521 SMART TV UHD;ELECTRONICA MAYOR
13524434;;F;45;CHILENO;;X;PUERTO MONTT                  ;LOS LAGOS;177220;4;3;0;0;0;4;3;177220;LED KIOTO 32 MI3228 SMART TV;ELECTRONICA MAYOR
20344052;;F;35;CHILENO;;Millenial;PUENTE ALTO                   ;METROPOLITANA;179990;1;1;0;0;0;1;1;179990;LED 32LM637B HD SMART;ELECTRONICA MAYOR
15775518;;M;38;CHILENO;;Millenial;PROVIDENCIA                   ;METROPOLITANA;209990;1;1;1;1;209990;0;0;0;LED 43 UN43T5202AGXZS FHD SMART TV;ELECTRONICA MAYOR
11770516;;M;51;CHILENO;;X;SAN CARLOS                    ;BIO BIO;141280;3;2;0;0;0;3;2;141280;PARLANTE ULTRAMEGA;ELECTRONICA MAYOR
17111398;Soltero;M;32;CHILENO;;Millenial;PROVIDENCIA                   ;METROPOLITANA;1094910;9;4;0;0;0;9;4;1094910;LED 32 AOC ROKU TV HD 32S5195;ELECTRONICA MAYOR
16814990;;F;34;CHILENO;;Millenial;PROVIDENCIA                   ;METROPOLITANA;199970;3;3;1;1;139990;2;2;59980;LED 40 KEHD4020 SMART TV;ELECTRONICA MAYOR
19469387;;M;25;CHILENO;;Z;PROVIDENCIA                   ;METROPOLITANA;959930;7;4;0;0;0;7;4;959930;LED 32 AOC ROKU TV HD 32S5195;ELECTRONICA MAYOR
10995033;;F;49;CHILENO;;X;TALCA                         ;MAULE;359770;4;2;0;0;0;4;2;359770;LED 50 KEUH50 SMART TV UHD;ELECTRONICA MAYOR
16852951;;F;34;CHILENO;;Millenial;N/D;N/D;359990;1;1;0;0;0;1;1;359990;LED 58 58PUD7625 BORDES ULTRA DELGADOS 4K UHD;ELECTRONICA MAYOR
5954921;;M;74;CHILENO;;Silencioso;CANETE                        ;BIO BIO;201580;3;1;0;0;0;3;1;201580;LED 40 KEHD4020 SMART TV;ELECTRONICA MAYOR
5022909;;M;80;CHILENO;;Silencioso;LA PINTANA                    ;METROPOLITANA;220270;4;2;0;0;0;4;2;220270;PARLANTE KARAOKE 8 MAXEIGHT;ELECTRONICA MAYOR
20386928;;F;22;CHILENO;;Millenial;N/D;N/D;279980;2;2;2;2;279980;0;0;0;LED KIOTO 32 MI3228 SMART TV;ELECTRONICA MAYOR
11432298;Casado;M;54;CHILENO;;X;RENCA                         ;METROPOLITANA;79990;1;1;0;0;0;1;1;79990;PARLANTE MGVIPER;ELECTRONICA MAYOR
8748860;;M;57;CHILENO;;Boomers;PROVIDENCIA                   ;METROPOLITANA;156980;2;1;0;0;0;2;1;156980;LED 40 KEHD4020 SMART TV;ELECTRONICA MAYOR
19664657;;F;24;CHILENO;;Millenial;QUILPUE;VALPARAISO;396970;3;1;3;1;396970;0;0;0;LED 55 KEUH5521 SMART TV UHD;ELECTRONICA MAYOR
19070057;;F;25;CHILENO;;Millenial;PROVIDENCIA                   ;METROPOLITANA;132980;2;1;2;1;132980;0;0;0;LED 40 KEHD4020 SMART TV;ELECTRONICA MAYOR
9777851;;M;59;CHILENO;;Boomers;ILLAPEL                       ;COQUIMBO;970408;8;5;0;0;0;8;5;970408;LED 43 Full HD Smart TV 43PFD6825;ELECTRONICA MAYOR
13716200;Soltero;F;42;CHILENO;;X;PUENTE ALTO                   ;METROPOLITANA;202980;2;1;0;0;0;2;1;202980;LED 32LM637B HD SMART;ELECTRONICA MAYOR
26424803;;M;47;EXTRANJERO - NO INFORMA NACIONALIDAD;;Extranjero;N/D;N/D;689980;2;1;0;0;0;2;1;689980;LED NanoCell 65NANO75 UHD SMART + MAGIC;ELECTRONICA MAYOR
16522858;;F;34;CHILENO;;Millenial;SAN VICENTE                   ;L.G.B.OÂ´HIGGINS;226372;2;2;0;0;0;2;2;226372;LED 32 UN32T4300AGXZS HD SMART TV;ELECTRONICA MAYOR
23864166;Soltero;M;35;PANAMEÃO;;Extranjero;PROVIDENCIA                   ;METROPOLITANA;189980;2;1;2;1;189980;0;0;0;LED 32 AOC ROKU TV HD 32S5195;ELECTRONICA MAYOR
19389527;;F;25;CHILENO;;Z;TALCA;MAULE;189990;1;1;1;1;189990;0;0;0;LED 32LM637B HD SMART;ELECTRONICA MAYOR
17833854;;F;31;CHILENO;;Millenial;ESTACION CENTRAL;METROPOLITANA;192960;4;1;0;0;0;4;1;192960;LED KIOTO 32 MI3228 SMART TV;ELECTRONICA MAYOR
7443972;;M;66;CHILENO;;Boomers;CAUQUENES                     ;MAULE;130000;2;1;0;0;0;2;1;130000;LED KIOTO 32 MI3228 SMART TV;ELECTRONICA MAYOR
13949053;;F;41;CHILENO;;X;RENGO                         ;L.G.B.OÂ´HIGGINS;383980;2;2;0;0;0;2;2;383980;LED 65 KEUH6521 SMART TV UHD;ELECTRONICA MAYOR
20270614;;F;22;CHILENO;;Z;QUILPUE;VALPARAISO;18193;1;1;1;1;18193;0;0;0;SOUNDBAR BLIK SURREAL 2.0;ELECTRONICA MAYOR
12303526;;M;50;CHILENO;;X;PROVIDENCIA                   ;METROPOLITANA;199990;1;1;0;0;0;1;1;199990;LED 43 43S5195 ROKU TV FHD;ELECTRONICA MAYOR
19917505;;M;24;CHILENO;;Z;PROVIDENCIA                   ;METROPOLITANA;248970;3;1;3;1;248970;0;0;0;LED 40 KEHD4020 SMART TV;ELECTRONICA MAYOR
7366002;;F;65;CHILENO;;Boomers;EL BOSQUE                     ;METROPOLITANA;136980;2;1;0;0;0;2;1;136980;LED KIOTO 32 MI3228 SMART TV;ELECTRONICA MAYOR
7917740;;F;65;CHILENO;;Boomers;EL BOSQUE                     ;METROPOLITANA;139990;1;1;0;0;0;1;1;139990;LED KIOTO 32 MI3228 SMART TV;ELECTRONICA MAYOR
7970089;;F;62;CHILENO;;Boomers;VALLENAR;ATACAMA;580390;2;1;0;0;0;2;1;580390;LED 65 65PUD7625 4K UHD HDR;ELECTRONICA MAYOR
20313188;;F;22;CHILENO;;Z;PUERTO MONTT                  ;LOS LAGOS;124980;2;2;2;2;124980;0;0;0;LED 32 32S5305 HD HDR10/HLG;ELECTRONICA MAYOR
13708918;;M;44;CHILENO;;X;"";"";519980;3;1;0;0;0;3;1;519980;LED 43 43UP7500 UHD SMART TV;ELECTRONICA MAYOR
17167149;;F;33;CHILENO;;Millenial;PROVIDENCIA                   ;METROPOLITANA;489980;2;1;2;1;489980;0;0;0;QLED 55 QN55Q60AAGXZS 4K UHD SMART TV;ELECTRONICA MAYOR
9863642;;F;50;CHILENO;;X;AISEN                         ;AYSEN;1280870;13;5;0;0;0;13;5;1280870;LED 55 KEUH5521 SMART TV UHD;ELECTRONICA MAYOR
8236053;;M;55;CHILENO;;Boomers;NATALES                       ;MAGALLANES;169990;1;1;0;0;0;1;1;169990;LED 32 AOC ROKU TV HD 32S5195;ELECTRONICA MAYOR
7144272;Divorciado;M;66;CHILENO;;Boomers;ANGOL                         ;ARAUCANIA;207980;2;1;0;0;0;2;1;207980;LED 50 KEUH50 SMART TV UHD;ELECTRONICA MAYOR
13929914;;F;42;CHILENO;;X;PROVIDENCIA                   ;METROPOLITANA;197970;3;2;0;0;0;3;2;197970;MINICOMPONENTE CJ45;ELECTRONICA MAYOR
13000480;;F;46;CHILENO;;X;PUERTO MONTT                  ;LOS LAGOS;170560;9;3;0;0;0;9;3;170560;PARLANTE SCREAMER 3;ELECTRONICA MAYOR
8020318;;F;65;CHILENO;;Boomers;QUILPUE                       ;VALPARAISO;296960;3;1;3;1;296960;0;0;0;LED 58 KEUH5821 SMART TV UHD;ELECTRONICA MAYOR
19694137;;M;25;CHILENO;;Silencioso;PROVIDENCIA                   ;METROPOLITANA;22990;1;2;0;0;0;1;2;22990;KARAOKE STREET SONG 4 MICÂ CABLEÂ BLACK 8900;ELECTRONICA MAYOR
18225715;;M;30;CHILENO;;Millenial;TALCA                         ;MAULE;39190;2;1;0;0;0;2;1;39190;KARAOKE FUNKY DISCO;ELECTRONICA MAYOR
8765207;;M;60;CHILENO;;Boomers;RENCA                         ;METROPOLITANA;226370;2;1;0;0;0;2;1;226370;LED 32LM637B HD SMART;ELECTRONICA MAYOR
18230679;;M;29;CHILENO;;Millenial;PROVIDENCIA                   ;METROPOLITANA;164980;2;1;0;0;0;2;1;164980;LED 40 KEHD4020 SMART TV;ELECTRONICA MAYOR
14487263;;M;42;CHILENO;;X;N/D;N/D;49990;1;3;1;3;49990;0;0;0;PARLANTE KARAOKE 12 FM/BT/USB;ELECTRONICA MAYOR
15894042;;F;37;CHILENO;;Millenial;EL BOSQUE;METROPOLITANA;199980;2;1;0;0;0;2;1;199980;PARLANTE MGULTRAEXTREME;ELECTRONICA MAYOR
17870259;;F;30;CHILENO;;Millenial;PROVIDENCIA                   ;METROPOLITANA;219990;1;1;1;1;219990;0;0;0;LED 43 43S5305 SMART TV FULL HD;ELECTRONICA MAYOR
19594225;;F;24;CHILENO;;Z;N/D;N/D;366830;3;2;0;0;0;3;2;366830;LED 50 UN50TU7090GXZS UHD SMART TV;ELECTRONICA MAYOR
6712195;Casado;M;67;CHILENO;;Boomers;RENCA                         ;METROPOLITANA;346830;3;1;0;0;0;3;1;346830;LED 50 UN50TU7090GXZS UHD SMART TV;ELECTRONICA MAYOR
6094294;;F;83;CHILENO;;Silencioso;PEDRO AGUIRRE CERDA           ;METROPOLITANA;719740;7;4;0;0;0;7;4;719740;LED 60 UN60AU8000GXZS UHD SMART TV;ELECTRONICA MAYOR
7371336;;M;69;CHILENO;;Silencioso;MELIPILLA                     ;METROPOLITANA;1609680;9;4;0;0;0;9;4;1609680;LED NanoCell 55NANO80 UHD SMART + MAGIC;ELECTRONICA MAYOR
13061313;;M;46;CHILENO;;X;COLINA;METROPOLITANA;209980;2;1;0;0;0;2;1;209980;LED 50 KEUH50 SMART TV UHD;ELECTRONICA MAYOR
13018743;;M;45;CHILENO;;X;LA SERENA                     ;COQUIMBO;699920;6;1;0;0;0;6;1;699920;LED 50 UN50TU7090GXZS UHD SMART TV;ELECTRONICA MAYOR
15951989;;F;37;CHILENO;;Millenial;N/D;N/D;580940;6;3;4;2;525960;2;1;54980;LED 65 KEUH6521 SMART TV UHD;ELECTRONICA MAYOR
10506336;;M;55;CHILENO;;Boomers;LA LIGUA                      ;VALPARAISO;317970;3;2;0;0;0;3;2;317970;LED 50 KEUH50 SMART TV UHD;ELECTRONICA MAYOR
17941358;Soltero;F;31;CHILENO;TRABAJADOR SOCIAL;Millenial;PROVIDENCIA                   ;METROPOLITANA;2980;1;2;0;0;0;1;2;2980;LED 43 UN43T5202AGXZS FHD SMART TV;ELECTRONICA MAYOR
9740246;;F;60;CHILENO;;Boomers;TEMUCO                        ;ARAUCANIA;354010;2;1;0;0;0;2;1;354010;LED 50 50UP7500 UHD SMART TV;ELECTRONICA MAYOR
14013905;;M;41;CHILENO;;X;PERALILLO                     ;L.G.B.OÂ´HIGGINS;394980;2;2;0;0;0;2;2;394980;LED 50 UN50TU7090GXZS UHD SMART TV;ELECTRONICA MAYOR
10877146;Divorciado;M;54;CHILENO;;X;COLINA                        ;METROPOLITANA;358970;3;2;0;0;0;3;2;358970;SOUNDBAR BLIK SURREAL 2.0;ELECTRONICA MAYOR
11510515;;M;52;CHILENO;;X;N/D;N/D;619820;5;2;0;0;0;5;2;619820;LED 50 50PUD7625 SMART TV ULTRA HD 4K;ELECTRONICA MAYOR
13156671;;F;44;CHILENO;;X;N/D;N/D;139990;1;1;0;0;0;1;1;139990;PARLANTE ULTRABUZZ;ELECTRONICA MAYOR
15287686;;F;40;CHILENO;;X;ANCUD                         ;LOS LAGOS;843860;3;1;0;0;0;3;1;843860;LED NanoCell 65NANO75 UHD SMART + MAGIC;ELECTRONICA MAYOR
17242452;;F;35;CHILENO;;Millenial;PROVIDENCIA                   ;METROPOLITANA;532960;4;4;0;0;0;4;4;532960;LED 42 KHFH4221 SMART TV;ELECTRONICA MAYOR
5703661;;F;77;CHILENO;;Silencioso;PROVIDENCIA                   ;METROPOLITANA;985450;7;3;0;0;0;7;3;985450;LED 60UP7750 UHD SMART + MAGIC;ELECTRONICA MAYOR
7283918;;M;69;CHILENO;;Silencioso;LAJA                          ;BIO BIO;426470;3;2;0;0;0;3;2;426470;MINICOMPONENTE MX-T50/ZS ALL IN ONE;ELECTRONICA MAYOR
12485973;;F;51;CHILENO;;X;LO PRADO                      ;METROPOLITANA;852060;7;3;0;0;0;7;3;852060;LED 43 UN43T5202AGXZS FHD SMART TV;ELECTRONICA MAYOR
11615103;;F;52;CHILENO;;X;ANTOFAGASTA                   ;ANTOFAGASTA;675190;4;2;0;0;0;4;2;675190;LED 50 UN50TU7090GXZS UHD SMART TV;ELECTRONICA MAYOR
10164372;;F;58;CHILENO;;Boomers;SANTIAGO                      ;METROPOLITANA;217970;3;1;0;0;0;3;1;217970;PARLANTE ULTRAFORCE-I;ELECTRONICA MAYOR
16803053;;F;34;CHILENO;;Millenial;PROVIDENCIA                   ;METROPOLITANA;1520960;5;1;5;1;1520960;0;0;0;QLED 50 QN50Q60AAGXZS 4K UHD SMART TV;ELECTRONICA MAYOR
7141383;;F;69;CHILENO;;Silencioso;CANETE                        ;BIO BIO;999980;3;2;0;0;0;3;2;999980;LED NanoCell 55NANO80 UHD SMART + MAGIC;ELECTRONICA MAYOR
10000092;;F;53;CHILENO;;X;CANETE                        ;BIO BIO;359980;2;2;0;0;0;2;2;359980;LED 55UP7500 UHD SMART;ELECTRONICA MAYOR
9731999;;M;56;CHILENO;;Boomers;LOS VILOS                     ;COQUIMBO;34990;1;1;0;0;0;1;1;34990;MLAB KARAOKE 8 CITY SET MICROFONO INALAMBRICO AT;ELECTRONICA MAYOR
13206466;;M;45;CHILENO;;X;CAUQUENES                     ;MAULE;156980;2;2;0;0;0;2;2;156980;MINICOMPONENTE RN5;ELECTRONICA MAYOR
19868814;;M;24;CHILENO;;Z;ARICA                         ;TARAPACA;615960;4;2;0;0;0;4;2;615960;SOUNDBAR HW-T400/ZS;ELECTRONICA MAYOR
17890774;;F;30;CHILENO;;Millenial;N/D;N/D;281950;7;3;0;0;0;7;3;281950;LED 42 KHFH4221 SMART TV;ELECTRONICA MAYOR
16354492;;F;36;CHILENO;;Millenial;"";"";176980;2;1;0;0;0;2;1;176980;LED 43 CS43S1USM UHD SMART TV NEGRO;ELECTRONICA MAYOR
16273582;Soltero;M;36;CHILENO;;Millenial;PROVIDENCIA                   ;METROPOLITANA;309990;1;1;0;0;0;1;1;309990;LED 50 UN50TU7090GXZS UHD SMART TV;ELECTRONICA MAYOR
8934191;;F;59;CHILENO;;Boomers;N/D;N/D;333860;3;3;0;0;0;3;3;333860;LED 50 50PUD7625 SMART TV ULTRA HD 4K;ELECTRONICA MAYOR
4673044;;F;75;CHILENO;;Silencioso;TEMUCO                        ;ARAUCANIA;166980;2;1;0;0;0;2;1;166980;LED 32 UN32T4300AGXZS HD SMART TV;ELECTRONICA MAYOR
13354472;;F;44;CHILENO;;X;CONSTITUCION                  ;MAULE;184980;2;2;0;0;0;2;2;184980;LED KIOTO 32 MI3228 SMART TV;ELECTRONICA MAYOR
17643578;Soltero;M;29;CHILENO;;Millenial;PROVIDENCIA                   ;METROPOLITANA;119990;1;1;0;0;0;1;1;119990;PARLANTE ULTRAMEGA;ELECTRONICA MAYOR
6513807;;M;66;CHILENO;;Silencioso;PROVIDENCIA                   ;METROPOLITANA;309990;1;1;0;0;0;1;1;309990;LED 50 50UP7500 UHD SMART TV;ELECTRONICA MAYOR
9229255;;M;59;CHILENO;;Boomers;VALPARAISO                    ;VALPARAISO;179980;2;1;0;0;0;2;1;179980;PARLANTE MGULTRAEXTREME;ELECTRONICA MAYOR
7649998;;M;66;CHILENO;;Boomers;N/D;N/D;306980;2;1;0;0;0;2;1;306980;LED 50 UN50TU7090GXZS UHD SMART TV;ELECTRONICA MAYOR
26024033;;F;38;EXTRANJERO - NO INFORMA NACIONALIDAD;;Extranjero;SANTIAGO;METROPOLITANA;346950;5;3;4;2;76960;1;1;269990;LED 50 50P615-50P ANDROID TV PASSION LINE UHD 4K;ELECTRONICA MAYOR
26547855;;M;33;EXTRANJERO - NO INFORMA NACIONALIDAD;;Extranjero;PAINE                         ;METROPOLITANA;194970;3;1;0;0;0;3;1;194970;LED KIOTO 32 MI3228 SMART TV;ELECTRONICA MAYOR
14028503;;F;40;CHILENO;;X;PEMUCO                        ;BIO BIO;525660;5;4;5;4;525660;0;0;0;LED 55 UN55TU7090GXZS SMART TV UHD;ELECTRONICA MAYOR
11091235;;F;56;CHILENO;;Boomers;OVALLE                        ;COQUIMBO;519990;1;1;0;0;0;1;1;519990;LED 60UP7750 UHD SMART + MAGIC;ELECTRONICA MAYOR
16685252;;F;34;CHILENO;;Millenial;SANTIAGO                      ;METROPOLITANA;375210;5;2;0;0;0;5;2;375210;LED 43 Full HD Smart TV 43PFD6825;ELECTRONICA MAYOR
19740251;;M;25;CHILENO;;Silencioso;PROVIDENCIA                   ;METROPOLITANA;189980;2;3;2;1;93980;0;2;96000;LED 58 UN58AU7000GXZS UHD 4K SMART TV;ELECTRONICA MAYOR
5955619;;F;74;CHILENO;;Silencioso;LOS ALAMOS                    ;BIO BIO;347970;3;1;0;0;0;3;1;347970;LED 43 UN43T5202AGXZS FHD SMART TV;ELECTRONICA MAYOR
15812098;;F;38;CHILENO;;Millenial;IQUIQUE                       ;TARAPACA;243980;2;1;2;1;243980;0;0;0;LED 43 43LM6370 SMART TV FHD;ELECTRONICA MAYOR
22179394;;F;45;PERUANO;;Extranjero;N/D;N/D;289990;1;1;0;0;0;1;1;289990;LED 50 50UP7500 UHD SMART TV;ELECTRONICA MAYOR
14104068;;F;41;CHILENO;;X;ARICA                         ;TARAPACA;192980;2;1;0;0;0;2;1;192980;LED 32LM637B HD SMART;ELECTRONICA MAYOR
20292561;;F;22;CHILENO;;Z;LA SERENA                     ;COQUIMBO;209980;2;1;0;0;0;2;1;209980;MINICOMPONENTE RN7;ELECTRONICA MAYOR
13806677;;M;41;CHILENO;;X;CANETE                        ;BIO BIO;412970;3;2;0;0;0;3;2;412970;LED 40 UN40T5290AGXZS FHD SMART TV;ELECTRONICA MAYOR
16348873;;M;35;CHILENO;;Millenial;CORONEL                       ;BIO BIO;149990;1;1;0;0;0;1;1;149990;LED 32 32S5305 HD HDR10/HLG;ELECTRONICA MAYOR
15514428;Soltero;F;39;CHILENO;;X;PROVIDENCIA                   ;METROPOLITANA;229990;1;1;0;0;0;1;1;229990;LED 43 43LM6370 SMART TV FHD;ELECTRONICA MAYOR
8053824;;F;62;CHILENO;;Boomers;"";"";399980;2;2;0;0;0;2;2;399980;LED 50 50PUD7625 SMART TV ULTRA HD 4K;ELECTRONICA MAYOR
15146999;;F;38;CHILENO;;Millenial;CAUQUENES                     ;MAULE;849960;4;2;0;0;0;4;2;849960;LED 49 49UN7100 UHD SMART TV;ELECTRONICA MAYOR
18322333;Soltero;M;29;CHILENO;;Millenial;PROVIDENCIA                   ;METROPOLITANA;802520;4;2;4;2;802520;0;0;0;LED 43 43LM33911 ANDROID SMART TV UHD 4K;ELECTRONICA MAYOR
15538776;;M;39;CHILENO;;X;SAN BERNARDO                  ;METROPOLITANA;159990;1;1;0;0;0;1;1;159990;LED 32 UN32T4300AGXZS HD SMART TV;ELECTRONICA MAYOR
11815118;;F;50;CHILENO;;Extranjero;ARICA                         ;ARICA Y PARINACOTA;317980;2;1;0;0;0;2;1;317980;LED 50 UN50TU7090GXZS UHD SMART TV;ELECTRONICA MAYOR
16864035;;M;34;CHILENO;;Millenial;"";"";593960;4;3;0;0;0;4;3;593960;LED 55UP7500 UHD SMART;ELECTRONICA MAYOR
15847641;;F;37;CHILENO;;Millenial;LLANQUIHUE                    ;LOS LAGOS;905622;7;4;0;0;0;7;4;905622;LED 60UP7750 UHD SMART + MAGIC;ELECTRONICA MAYOR
26827989;Soltero;F;34;CHILENO;MEDICO CIRUJANO;Extranjero;PROVIDENCIA                   ;METROPOLITANA;226980;2;1;2;1;226980;0;0;0;LED 43 UN43T5202AGXZS FHD SMART TV;ELECTRONICA MAYOR
15444361;;F;39;CHILENO;;X;LA PINTANA                    ;METROPOLITANA;337960;4;2;4;2;337960;0;0;0;LED 43 43LM6370 SMART TV FHD;ELECTRONICA MAYOR
12976486;;F;46;CHILENO;;X;CONCHALI;METROPOLITANA;339990;1;1;1;1;339990;0;0;0;LED 55UP7500 UHD SMART;ELECTRONICA MAYOR
24452590;;M;50;COLOMBIANO;;Extranjero;N/D;N/D;182980;2;1;0;0;0;2;1;182980;LED 32 UN32T4300AGXZS HD SMART TV;ELECTRONICA MAYOR
20326042;;M;22;CHILENO;;Z;N/D;N/D;19990;1;1;0;0;0;1;1;19990;PARLANTE KARAOKE 8 MAXEIGHT;ELECTRONICA MAYOR
10666365;;M;54;CHILENO;;X;BUIN                          ;METROPOLITANA;491980;2;4;0;0;0;2;4;491980;LED 65 KEUH6521 SMART TV UHD;ELECTRONICA MAYOR
26123380;;F;33;NO INFORMA NACIONALIDAD;;Extranjero;CANETE                        ;BIO BIO;148950;5;3;0;0;0;5;3;148950;LED KIOTO 32 MI3228 SMART TV;ELECTRONICA MAYOR
13629824;;M;51;CHILENO;;X;CANETE                        ;BIO BIO;222970;3;3;0;0;0;3;3;222970;PARLANTE KARAOKE SPB8B;ELECTRONICA MAYOR
7220550;;M;69;CHILENO;;Silencioso;SALAMANCA                     ;COQUIMBO;649050;4;2;0;0;0;4;2;649050;LED 32 32PHD6825 HD SMART TV;ELECTRONICA MAYOR
5808386;;F;75;CHILENO;;Silencioso;VALLENAR;ATACAMA;289990;1;1;0;0;0;1;1;289990;LED 50 50P615-50P ANDROID TV PASSION LINE UHD 4K;ELECTRONICA MAYOR
22155850;;M;34;PERUANO;;Extranjero;SANTIAGO                      ;METROPOLITANA;480980;2;1;0;0;0;2;1;480980;LED 55UP7500 UHD SMART;ELECTRONICA MAYOR
17886272;;F;31;CHILENO;;Millenial;SAN JAVIER                    ;MAULE;211470;4;2;0;0;0;4;2;211470;2a ELECTRONICA MAYOR;ELECTRONICA MAYOR
10703155;;M;55;CHILENO;;Boomers;N/D;N/D;179990;1;1;0;0;0;1;1;179990;LED 40 KEHD4020 SMART TV;ELECTRONICA MAYOR
18655531;;F;28;CHILENO;;Millenial;LONGAVI                       ;MAULE;309980;2;1;0;0;0;2;1;309980;LED 58 KEUH5821 SMART TV UHD;ELECTRONICA MAYOR
13532742;;M;54;CHILENO;;X;TOCOPILLA                     ;ANTOFAGASTA;383960;4;2;0;0;0;4;2;383960;KARAOKE SP-101BT ALL IN ONE PORTATIL 60W;ELECTRONICA MAYOR
12826784;;M;46;CHILENO;;X;RENCA                         ;METROPOLITANA;299980;2;2;0;0;0;2;2;299980;LED 32 32PHD6825 HD SMART TV;ELECTRONICA MAYOR
13805254;;M;42;CHILENO;;X;PROVIDENCIA                   ;METROPOLITANA;245980;2;1;0;0;0;2;1;245980;PARLANTE ULTRAFUSION;ELECTRONICA MAYOR
12820817;;M;47;CHILENO;;X;CALERA                        ;VALPARAISO;329980;2;2;0;0;0;2;2;329980;LED 50 KEUH50 SMART TV UHD;ELECTRONICA MAYOR
14020885;;F;40;CHILENO;;X;SAN JAVIER                    ;MAULE;339980;2;2;0;0;0;2;2;339980;LED 50 KEUH50 SMART TV UHD;ELECTRONICA MAYOR
23052312;Soltero;F;35;BOLIVIANO;;Extranjero;PROVIDENCIA                   ;METROPOLITANA;462550;4;4;0;0;0;4;4;462550;LED 58 KEUH5821 SMART TV UHD;ELECTRONICA MAYOR
26177948;;F;47;NO INFORMA NACIONALIDAD;;Extranjero;COLINA                        ;METROPOLITANA;385970;3;1;0;0;0;3;1;385970;LED 43 43S5305 SMART TV FULL HD;ELECTRONICA MAYOR
13103500;;F;46;CHILENO;;X;N/D;N/D;1083951;8;4;0;0;0;8;4;1083951;LED NanoCell 65NANO75 UHD SMART + MAGIC;ELECTRONICA MAYOR
7539274;Soltero;M;67;CHILENO;;Boomers;PUNTA ARENAS                  ;MAGALLANES;411340;5;2;0;0;0;5;2;411340;LED 32 32LM630BPSB SMART TV;ELECTRONICA MAYOR
19965971;;F;23;CHILENO;;Z;CONSTITUCION                  ;MAULE;187990;3;1;0;0;0;3;1;187990;LED 42 KHFH4221 SMART TV;ELECTRONICA MAYOR
13224958;;F;44;CHILENO;;Millenial;"";"";250970;3;1;0;0;0;3;1;250970;LED KIOTO 32 MI3228 SMART TV;ELECTRONICA MAYOR
22290822;Soltero;F;38;ECUATORIANO;;Extranjero;VALPARAISO                    ;VALPARAISO;139990;1;3;1;1;129990;0;2;10000;LED KIOTO 32 MI3228 SMART TV;ELECTRONICA MAYOR
17899864;;F;30;CHILENO;;Millenial;N/D;N/D;345980;2;2;1;1;299990;1;1;45990;LED 50 UN50TU7090GXZS UHD SMART TV;ELECTRONICA MAYOR
15905740;Casado;M;37;CHILENO;PROFESOR;Millenial;RENCA                         ;METROPOLITANA;159990;1;1;1;1;159990;0;0;0;LED 43 43S5305 SMART TV FULL HD;ELECTRONICA MAYOR
10922049;;M;52;CHILENO;;X;TALCA                         ;MAULE;224980;3;1;0;0;0;3;1;224980;LED 40 KEHD4020 SMART TV;ELECTRONICA MAYOR
20662496;;F;21;CHILENO;;Z;COLTAUCO;O HIGGINS;147980;2;1;2;1;147980;0;0;0;LED KIOTO 32 MI3228 SMART TV;ELECTRONICA MAYOR
15571290;;F;38;CHILENO;;Millenial;PUNTA ARENAS                  ;MAGALLANES;49990;1;1;0;0;0;1;1;49990;PARLANTE KARAOKE 12 FM/BT/USB;ELECTRONICA MAYOR
17346288;;F;32;CHILENO;;Millenial;TALCAHUANO                    ;BIO BIO;179990;1;1;0;0;0;1;1;179990;LED 42 KHFH4221 SMART TV;ELECTRONICA MAYOR
20309259;;F;22;CHILENO;;Z;OVALLE                        ;COQUIMBO;643960;4;5;0;0;0;4;5;643960;PARLANTE ULTRAMAGIC;ELECTRONICA MAYOR
26296642;;M;32;HAITIANO;;Extranjero;CERRO NAVIA                   ;METROPOLITANA;317980;2;1;0;0;0;2;1;317980;LED 43 43UP7500 UHD SMART TV;ELECTRONICA MAYOR
7566419;;M;64;CHILENO;;Boomers;ALTO HOSPICIO;TARAPACA;475980;3;1;0;0;0;3;1;475980;LED 65 KEUH6521 SMART TV UHD;ELECTRONICA MAYOR
16450617;;F;35;CHILENO;;Millenial;VALLENAR;ATACAMA;209990;1;1;0;0;0;1;1;209990;LED 40 UN40T5290AGXZS FHD SMART TV;ELECTRONICA MAYOR
8096119;;F;63;CHILENO;;Boomers;TEMUCO                        ;ARAUCANIA;324970;3;4;0;0;0;3;4;324970;LED 55 KEUH5521 SMART TV UHD;ELECTRONICA MAYOR
14035767;;F;40;CHILENO;;X;PADRE LAS CASAS               ;ARAUCANIA;549990;1;1;1;1;549990;0;0;0;LED 70 UN70AU7000GXZS UHD;ELECTRONICA MAYOR
8971362;;M;60;CHILENO;;Boomers;TOME                          ;BIO BIO;256980;2;1;0;0;0;2;1;256980;LED 43 Full HD Smart TV 43PFD6825;ELECTRONICA MAYOR
26890638;;M;30;CHILENO;;Extranjero;"";"";349980;2;1;0;0;0;2;1;349980;LED 50 UN50TU7090GXZS UHD SMART TV;ELECTRONICA MAYOR
12345797;;F;50;CHILENO;;X;RENCA                         ;METROPOLITANA;349960;4;2;0;0;0;4;2;349960;LED 32 UN32T4300AGXZS HD SMART TV;ELECTRONICA MAYOR
25739992;;M;46;VENEZOLANO;;Extranjero;N/D;N/D;246980;2;1;2;1;246980;0;0;0;LED 43 43LM33911 ANDROID SMART TV UHD 4K;ELECTRONICA MAYOR
17887030;;M;31;CHILENO;;Millenial;MOSTAZAL                      ;L.G.B.OÂ´HIGGINS;423950;5;4;2;1;108980;3;3;314970;SOUNDBAR TS6110;ELECTRONICA MAYOR
16184310;;M;36;CHILENO;;Millenial;VALLENAR;ATACAMA;379980;2;2;0;0;0;2;2;379980;LED 42 KHFH4221 SMART TV;ELECTRONICA MAYOR
8872670;;M;60;CHILENO;;Boomers;SAN FERNANDO                  ;L.G.B.OÂ´HIGGINS;139990;2;1;0;0;0;2;1;139990;LED KIOTO 32 MI3228 SMART TV;ELECTRONICA MAYOR
12048464;;F;57;CHILENO;;Boomers;LO PRADO                      ;METROPOLITANA;280000;2;1;0;0;0;2;1;280000;LED 55 KEUH5521 SMART TV UHD;ELECTRONICA MAYOR
12816838;;F;46;CHILENO;;X;LA LIGUA                      ;VALPARAISO;79980;2;2;0;0;0;2;2;79980;SOUNDBAR XTS-801 Negro 40W;ELECTRONICA MAYOR
26104371;;F;40;VENEZOLANO;MEDICO CIRUJANO;Extranjero;PROVIDENCIA                   ;METROPOLITANA;114980;2;3;0;0;0;2;3;114980;KARAOKE STREET SONG 4 MICÂ CABLEÂ BLACK 8900;ELECTRONICA MAYOR
7048664;Casado;M;61;CHILENO;;Boomers;PROVIDENCIA                   ;METROPOLITANA;139990;1;1;0;0;0;1;1;139990;LED KIOTO 32 MI3228 SMART TV;ELECTRONICA MAYOR
5883590;;M;70;CHILENO;;Silencioso;MELIPILLA                     ;METROPOLITANA;389990;1;1;0;0;0;1;1;389990;LED 58 UN58AU7000GXZS UHD 4K SMART TV;ELECTRONICA MAYOR
20746406;;M;21;CHILENO;;Z;PROVIDENCIA                   ;METROPOLITANA;179990;2;1;0;0;0;2;1;179990;LED 40 KEHD4020 SMART TV;ELECTRONICA MAYOR
12945805;;M;46;CHILENO;;X;ILLAPEL                       ;COQUIMBO;199990;1;1;0;0;0;1;1;199990;LED 40 UN40T5290AGXZS FHD SMART TV;ELECTRONICA MAYOR
7593074;;F;74;CHILENO;;Silencioso;NIQUEN                        ;BIO BIO;199990;1;1;0;0;0;1;1;199990;LED 50 KEUH50 SMART TV UHD;ELECTRONICA MAYOR
5810728;;M;72;CHILENO;;Silencioso;MAIPU                         ;METROPOLITANA;124990;3;1;0;0;0;3;1;124990;PARLANTE ULTRABUZZ;ELECTRONICA MAYOR
20475493;;F;21;CHILENO;;Z;PROVIDENCIA                   ;METROPOLITANA;159990;1;1;1;1;159990;0;0;0;LED 43 43S5305 SMART TV FULL HD;ELECTRONICA MAYOR
6167867;;M;74;CHILENO;;Silencioso;CARAHUE                       ;ARAUCANIA;99990;1;1;0;0;0;1;1;99990;PARLANTE ULTRAMAGIC;ELECTRONICA MAYOR
5899347;;F;73;CHILENO;;Silencioso;PUENTE ALTO                   ;METROPOLITANA;409970;3;1;0;0;0;3;1;409970;LED 40 UN40T5290AGXZS FHD SMART TV;ELECTRONICA MAYOR
8852944;;M;61;CHILENO;;Boomers;RENCA                         ;METROPOLITANA;174980;2;1;0;0;0;2;1;174980;MONITOR 24 24TL520S SMART TV HD;ELECTRONICA MAYOR
18870664;Soltero;F;27;CHILENO;;Millenial;MARIQUINA                     ;LOS LAGOS;401960;4;3;0;0;0;4;3;401960;LED 43 43LM6370 SMART TV FHD;ELECTRONICA MAYOR
11599657;;M;51;CHILENO;;X;TOCOPILLA                     ;ANTOFAGASTA;239990;1;1;0;0;0;1;1;239990;LED 43 UN43TU7090GXZS UHD SMART TV;ELECTRONICA MAYOR
11208568;;F;55;CHILENO;;Boomers;COLINA                        ;METROPOLITANA;196980;2;1;0;0;0;2;1;196980;PARLANTE ULTRABUZZ;ELECTRONICA MAYOR
12694642;Soltero;M;48;CHILENO;;X;PICHIDEGUA                    ;L.G.B.OÂ´HIGGINS;384980;2;2;0;0;0;2;2;384980;KARAOKE STREET SONG 4 MICÂ CABLEÂ BLACK 8900;ELECTRONICA MAYOR
17585329;;F;31;CHILENO;;Millenial;TEMUCO                        ;ARAUCANIA;179990;1;1;0;0;0;1;1;179990;LED 32LM637B HD SMART;ELECTRONICA MAYOR
20030198;;F;23;CHILENO;;Millenial;"";"";209990;1;1;1;1;209990;0;0;0;LED 43 Full HD Smart TV 43PFD6825;ELECTRONICA MAYOR
15122199;Soltero;M;39;CHILENO;;X;PROVIDENCIA                   ;METROPOLITANA;41980;2;1;0;0;0;2;1;41980;KARAOKE STREET SONG 4 MICÂ CABLEÂ BLACK 8900;ELECTRONICA MAYOR
9134917;;F;57;CHILENO;;Boomers;ANCUD                         ;LOS LAGOS;476940;6;4;0;0;0;6;4;476940;LED 32 KHHD3221 SMART TV;ELECTRONICA MAYOR
16263929;Soltero;M;36;CHILENO;;Millenial;NINHUE                        ;BIO BIO;219970;3;1;0;0;0;3;1;219970;PARLANTE ULTRAMAGIC;ELECTRONICA MAYOR
10395346;;F;52;CHILENO;;X;PROVIDENCIA                   ;METROPOLITANA;489990;1;1;0;0;0;1;1;489990;LED 60UP7750 UHD SMART + MAGIC;ELECTRONICA MAYOR
11848108;;F;50;CHILENO;;X;SAN ANTONIO                   ;VALPARAISO;299990;1;1;0;0;0;1;1;299990;LED 50 50PUD7625 SMART TV ULTRA HD 4K;ELECTRONICA MAYOR
17090698;;F;33;CHILENO;;Millenial;PARRAL                        ;MAULE;24990;1;1;0;0;0;1;1;24990;KARAOKE STREET SONG 4 MICÂ CABLEÂ BLACK 8900;ELECTRONICA MAYOR
9833580;;M;57;CHILENO;;Boomers;RENCA                         ;METROPOLITANA;29990;1;1;0;0;0;1;1;29990;PARLANTE KARAOKE 8 MAXEIGHT;ELECTRONICA MAYOR
8989003;;M;62;CHILENO;;Boomers;ARICA                         ;ARICA Y PARINACOTA;839950;5;4;0;0;0;5;4;839950;LED 55 UN55TU7090GXZS SMART TV UHD;ELECTRONICA MAYOR
15424457;;F;39;CHILENO;;X;PANGUIPULLI                   ;LOS LAGOS;439960;4;3;0;0;0;4;3;439960;LED 50 UN50TU7090GXZS UHD SMART TV;ELECTRONICA MAYOR
12946868;;F;45;CHILENO;;X;SALAMANCA                     ;COQUIMBO;447970;3;3;0;0;0;3;3;447970;PARLANTE COBRA;ELECTRONICA MAYOR
5942056;;M;71;CHILENO;;Silencioso;ANCUD                         ;LOS LAGOS;285980;3;1;0;0;0;3;1;285980;LED 50 KEUH50 SMART TV UHD;ELECTRONICA MAYOR
7958508;;M;63;CHILENO;;Boomers;BUIN                          ;METROPOLITANA;179990;1;1;0;0;0;1;1;179990;LED 40 KEHD4020 SMART TV;ELECTRONICA MAYOR
16224733;;F;36;CHILENO;;Millenial;PROVIDENCIA                   ;METROPOLITANA;199990;1;1;0;0;0;1;1;199990;LED 42 KHFH4221 SMART TV;ELECTRONICA MAYOR
13537398;Casado;M;43;CHILENO;;X;SALAMANCA                     ;COQUIMBO;947950;5;5;0;0;0;5;5;947950;PARLANTE ULTRABUZZ;ELECTRONICA MAYOR
13530217;;M;43;CHILENO;;X;ARICA                         ;ARICA Y PARINACOTA;779970;3;3;0;0;0;3;3;779970;LED 58 UN58AU7000GXZS UHD 4K SMART TV;ELECTRONICA MAYOR
18102967;;F;30;CHILENO;;Millenial;COIHAIQUE                     ;AYSEN;745930;7;2;0;0;0;7;2;745930;LED 58 UN58AU7000GXZS UHD 4K SMART TV;ELECTRONICA MAYOR
6384039;;M;68;CHILENO;;Boomers;RECOLETA                      ;METROPOLITANA;181980;2;1;0;0;0;2;1;181980;LED KIOTO 32 MI3228 SMART TV;ELECTRONICA MAYOR
10964107;;F;45;CHILENO;;X;PROVIDENCIA                   ;METROPOLITANA;882960;4;1;0;0;0;4;1;882960;LED 58 UN58AU7000GXZS UHD 4K SMART TV;ELECTRONICA MAYOR
13480047;;F;43;CHILENO;;X;PROVIDENCIA                   ;METROPOLITANA;24990;1;1;0;0;0;1;1;24990;KARAOKE STREET SONG 4 MICÂ CABLEÂ BLACK 8900;ELECTRONICA MAYOR
4574998;;M;79;CHILENO;;Silencioso;COPIAPO                       ;ATACAMA;444910;9;4;0;0;0;9;4;444910;SOUNDBAR XTS-801 Negro 40W;ELECTRONICA MAYOR
4319557;;F;88;CHILENO;;Silencioso;SANTO DOMINGO                 ;VALPARAISO;139990;1;3;0;0;0;1;3;139990;LED KIOTO 32 MI3228 SMART TV;ELECTRONICA MAYOR
12901644;;F;48;CHILENO;;X;PUENTE ALTO                   ;METROPOLITANA;279950;5;3;0;0;0;5;3;279950;LED KIOTO 32 MI3228 SMART TV;ELECTRONICA MAYOR
9820760;;M;59;CHILENO;;Boomers;CORONEL                       ;BIO BIO;387970;3;3;0;0;0;3;3;387970;LED 43 UN43TU7090GXZS UHD SMART TV;ELECTRONICA MAYOR
12869080;;M;47;CHILENO;;X;"";"";767950;5;2;0;0;0;5;2;767950;LED 70 70UP7750 UHD SMART + MAGIC;ELECTRONICA MAYOR
9688525;;M;58;CHILENO;;Boomers;SAN ANTONIO                   ;VALPARAISO;189990;1;1;0;0;0;1;1;189990;LED 42 KHFH4221 SMART TV;ELECTRONICA MAYOR
6296804;;F;77;CHILENO;;Silencioso;LOS VILOS                     ;COQUIMBO;266980;2;1;0;0;0;2;1;266980;LED 40 UN40T5290AGXZS FHD SMART TV;ELECTRONICA MAYOR
13749204;;F;42;CHILENO;;X;ILLAPEL                       ;COQUIMBO;265950;5;3;0;0;0;5;3;265950;LED 32 32PHD6825 HD SMART TV;ELECTRONICA MAYOR
10580432;;F;56;CHILENO;;Boomers;SALAMANCA                     ;COQUIMBO;229990;1;1;0;0;0;1;1;229990;LED 50 KEUH50 SMART TV UHD;ELECTRONICA MAYOR
25965142;Soltero;M;38;HAITIANO;;Extranjero;SAN FELIPE                    ;VALPARAISO;239990;1;1;0;0;0;1;1;239990;LED 40 UN40T5290AGXZS FHD SMART TV;ELECTRONICA MAYOR
12318854;Casado;F;49;CHILENO;;X;RENCA                         ;METROPOLITANA;24990;1;1;0;0;0;1;1;24990;KARAOKE STREET SONG 4 MICÂ CABLEÂ BLACK 8900;ELECTRONICA MAYOR
8475205;;M;51;CHILENO;;X;PROVIDENCIA                   ;METROPOLITANA;324990;1;1;0;0;0;1;1;324990;LED 50 UN50TU7090GXZS UHD SMART TV;ELECTRONICA MAYOR
15166189;;M;38;CHILENO;;Millenial;CHILLAN                       ;BIO BIO;129980;2;1;0;0;0;2;1;129980;KARAOKE 15 HEAVY BASS MIC INA CON ATRIL 8892;ELECTRONICA MAYOR
15068271;Casado;F;40;CHILENO;INGENIERO CIVIL QUIMICO;X;SALAMANCA                     ;COQUIMBO;299990;1;1;0;0;0;1;1;299990;LED 50 50UP7500 UHD SMART TV;ELECTRONICA MAYOR
19379893;;M;26;CHILENO;;Z;N/D;N/D;239990;1;1;1;1;239990;0;0;0;LED 43 43LM6370 SMART TV FHD;ELECTRONICA MAYOR
15616981;;F;38;CHILENO;;Millenial;N/D;N/D;174450;5;3;0;0;0;5;3;174450;KARAOKE TOWER OUTDOOR POWER MIC BT BK 8571;ELECTRONICA MAYOR
10118071;;F;52;CHILENO;;X;MELIPILLA                     ;METROPOLITANA;211970;3;2;0;0;0;3;2;211970;MINICOMPONENTE OL45;ELECTRONICA MAYOR
9153593;;F;60;CHILENO;;Boomers;RENCA                         ;METROPOLITANA;199990;1;1;0;0;0;1;1;199990;LED 32LM637B HD SMART;ELECTRONICA MAYOR
16262056;;M;35;CHILENO;;Millenial;SAN BERNARDO                  ;METROPOLITANA;34990;1;1;0;0;0;1;1;34990;PARLANTE KARAOKE MGROCKET PLUS;ELECTRONICA MAYOR
7040604;Casado;M;64;CHILENO;ARQUITECTO;Boomers;PROVIDENCIA                   ;METROPOLITANA;266980;2;1;0;0;0;2;1;266980;LED 40 UN40T5290AGXZS FHD SMART TV;ELECTRONICA MAYOR
15928733;;M;37;CHILENO;;Millenial;PROVIDENCIA                   ;METROPOLITANA;289990;1;1;1;1;289990;0;0;0;LED 50 50UP7500 UHD SMART TV;ELECTRONICA MAYOR
26746935;;M;29;VENEZOLANO;;Extranjero;N/D;N/D;267980;2;1;0;0;0;2;1;267980;LED 50 KEUH50 SMART TV UHD;ELECTRONICA MAYOR
11516104;;M;52;CHILENO;;X;PAPUDO                        ;VALPARAISO;1003920;8;3;0;0;0;8;3;1003920;PARLANTE ULTRAFORCE-I;ELECTRONICA MAYOR
10270048;;M;57;CHILENO;;Boomers;N/D;N/D;129980;2;2;0;0;0;2;2;129980;PARLANTE ULTRAMAGIC;ELECTRONICA MAYOR
11526231;;F;51;CHILENO;;X;PROVIDENCIA                   ;METROPOLITANA;184960;4;3;0;0;0;4;3;184960;PARLANTE SENSEIGTH K3175;ELECTRONICA MAYOR
13292758;;M;45;CHILENO;;X;VICTORIA                      ;ARAUCANIA;169990;1;1;0;0;0;1;1;169990;LED 32 UN32T4300AGXZS HD SMART TV;ELECTRONICA MAYOR
5674838;;M;75;CHILENO;;Silencioso;RENCA                         ;METROPOLITANA;268980;2;1;0;0;0;2;1;268980;LED 32 UN32T4300AGXZS HD SMART TV;ELECTRONICA MAYOR
15248524;;M;40;CHILENO;;Extranjero;TRAIGUEN                      ;ARAUCANIA;259990;1;1;0;0;0;1;1;259990;LED 43 UN43TU7090GXZS UHD SMART TV;ELECTRONICA MAYOR
9767468;;F;57;CHILENO;;Boomers;TILTIL                        ;METROPOLITANA;793970;3;2;3;2;793970;0;0;0;LED 55UP7500 UHD SMART;ELECTRONICA MAYOR
7567219;;M;67;CHILENO;;Boomers;HIJUELAS                      ;VALPARAISO;410980;2;2;0;0;0;2;2;410980;LED 58 UN58AU7000GXZS UHD 4K SMART TV;ELECTRONICA MAYOR
13747672;;F;45;CHILENO;;X;OVALLE                        ;COQUIMBO;171970;3;1;0;0;0;3;1;171970;MINICOMPONENTE OL45;ELECTRONICA MAYOR
6990974;;F;70;CHILENO;;Silencioso;ARICA                         ;ARICA Y PARINACOTA;1283960;4;1;0;0;0;4;1;1283960;LED 70 UN70AU7000GXZS UHD;ELECTRONICA MAYOR
18718517;;F;27;CHILENO;;Z;PROVIDENCIA                   ;METROPOLITANA;222980;2;1;0;0;0;2;1;222980;PARLANTE ULTRAFORCE-I;ELECTRONICA MAYOR
13084860;;M;45;CHILENO;;X;SAN RAMON                     ;METROPOLITANA;99990;1;1;0;0;0;1;1;99990;PARLANTE ULTRAMAGIC;ELECTRONICA MAYOR
18274148;;M;29;CHILENO;;Millenial;SAN JAVIER                    ;MAULE;44990;1;1;0;0;0;1;1;44990;PARLANTE KARAOKE 12 FM/BT/USB;ELECTRONICA MAYOR
13885065;;M;42;CHILENO;;X;CURICO                        ;MAULE;252980;2;1;0;0;0;2;1;252980;PARLANTE ULTRASENSATION;ELECTRONICA MAYOR
17200126;;F;32;CHILENO;;Millenial;GORBEA                        ;ARAUCANIA;463970;3;2;0;0;0;3;2;463970;LED 58 UN58AU7000GXZS UHD 4K SMART TV;ELECTRONICA MAYOR
12280936;;F;52;CHILENO;;X;N/D;N/D;375970;3;2;0;0;0;3;2;375970;LED 55 UN55TU7090GXZS SMART TV UHD;ELECTRONICA MAYOR
15229475;;M;39;CHILENO;;X;PROVIDENCIA                   ;METROPOLITANA;222960;4;3;0;0;0;4;3;222960;PARLANTE SENSEIGTH K3175;ELECTRONICA MAYOR
11989722;;F;49;CHILENO;;X;PROVIDENCIA                   ;METROPOLITANA;375980;2;1;0;0;0;2;1;375980;LED 43 43UP7500 UHD SMART TV;ELECTRONICA MAYOR
12428526;Divorciado;M;48;CHILENO;;X;RENCA                         ;METROPOLITANA;149990;1;1;0;0;0;1;1;149990;PARLANTE ULTRAFUSION;ELECTRONICA MAYOR
9729584;;F;58;CHILENO;;Boomers;LOS ANGELES                   ;BIO BIO;119980;2;1;0;0;0;2;1;119980;MINICOMPONENTE OL45;ELECTRONICA MAYOR
19741285;;M;25;CHILENO;;Z;MAIPU;METROPOLITANA;73980;2;1;2;1;73980;0;0;0;PARLANTE KARAOKE MGROKR NEGRO;ELECTRONICA MAYOR
5958683;Casado;M;74;CHILENO;AGROINDUSTRIA;Silencioso;RENCA                         ;METROPOLITANA;54990;1;1;0;0;0;1;1;54990;PARLANTE KARAOKE 12 FM/BT/USB;ELECTRONICA MAYOR
10073256;;M;56;CHILENO;;Millenial;N/D;N/D;249990;1;1;0;0;0;1;1;249990;LED 43 UN43TU7090GXZS UHD SMART TV;ELECTRONICA MAYOR
9698178;;F;59;CHILENO;;Boomers;TEMUCO                        ;ARAUCANIA;396970;3;2;0;0;0;3;2;396970;LED 43 43UP7500 UHD SMART TV;ELECTRONICA MAYOR
12345905;;F;49;CHILENO;;X;AISEN                         ;AYSEN;306980;2;1;2;1;306980;0;0;0;LED 50 50PUD7625 SMART TV ULTRA HD 4K;ELECTRONICA MAYOR
10196590;;M;53;CHILENO;;X;OVALLE                        ;COQUIMBO;65970;3;3;0;0;0;3;3;65970;KARAOKE STREET SONG 4 MICÂ CABLEÂ BLACK 8900;ELECTRONICA MAYOR
9844808;;F;56;CHILENO;;Boomers;PANGUIPULLI                   ;LOS RIOS;137980;2;1;0;0;0;2;1;137980;LED 32 KHHD3221 SMART TV;ELECTRONICA MAYOR
18752323;;F;27;CHILENO;;Z;HUASCO                        ;ATACAMA;229990;1;1;0;0;0;1;1;229990;LED 50 KEUH50 SMART TV UHD;ELECTRONICA MAYOR
8819942;;F;63;CHILENO;;Boomers;N/D;N/D;307970;3;1;0;0;0;3;1;307970;LED 50 KEUH50 SMART TV UHD;ELECTRONICA MAYOR
13031322;;M;46;CHILENO;;X;PROVIDENCIA                   ;METROPOLITANA;197980;2;1;0;0;0;2;1;197980;LED 32LM637B HD SMART;ELECTRONICA MAYOR
14048418;;M;41;CHILENO;;X;CHIMBARONGO                   ;L.G.B.OÂ´HIGGINS;224980;4;2;0;0;0;4;2;224980;LED 32 32S60-32P ANDROID TV SMART LINE HD;ELECTRONICA MAYOR
5356240;;F;78;CHILENO;;Silencioso;LINARES                       ;MAULE;217980;2;1;0;0;0;2;1;217980;LED 40 UN40T5290AGXZS FHD SMART TV;ELECTRONICA MAYOR
15646913;;M;39;CHILENO;;X;CORONEL                       ;BIO BIO;69990;1;1;0;0;0;1;1;69990;PARLANTE SENSEIGTH K3175;ELECTRONICA MAYOR
7327437;Casado;M;65;CHILENO;;Boomers;TOCOPILLA                     ;ANTOFAGASTA;369980;2;2;0;0;0;2;2;369980;LED 43 Full HD Smart TV 43PFD6825;ELECTRONICA MAYOR
16426927;;F;36;CHILENO;;Z;N/D;N/D;214980;2;2;0;0;0;2;2;214980;PARLANTE ULTRAFORCE-I;ELECTRONICA MAYOR
12718377;;M;46;CHILENO;;Silencioso;PROVIDENCIA                   ;METROPOLITANA;395080;4;2;3;1;325090;1;1;69990;LED 50 50PUD7625 SMART TV ULTRA HD 4K;ELECTRONICA MAYOR
20042678;;F;23;CHILENO;;Z;PROVIDENCIA                   ;METROPOLITANA;69991;1;2;0;0;0;1;2;69991;PARLANTE BOLA DISCO CON MICROFONO INAL;ELECTRONICA MAYOR
10471126;Casado;F;54;CHILENO;;Boomers;PROVIDENCIA                   ;METROPOLITANA;189990;1;1;0;0;0;1;1;189990;LED 32LM637B HD SMART;ELECTRONICA MAYOR
10828162;;M;54;CHILENO;;Boomers;CAUQUENES                     ;MAULE;252980;2;1;0;0;0;2;1;252980;LED 42 KHFH4221 SMART TV;ELECTRONICA MAYOR
9621629;;F;60;CHILENO;;Boomers;LA SERENA                     ;COQUIMBO;220283;2;2;0;0;0;2;2;220283;LED 40 UN40T5290AGXZS FHD SMART TV;ELECTRONICA MAYOR
9443339;;F;59;CHILENO;;Boomers;PROVIDENCIA                   ;METROPOLITANA;193980;2;1;2;1;193980;0;0;0;LED 43 Full HD Smart TV 43PFD6825;ELECTRONICA MAYOR
10873016;;F;56;CHILENO;;Boomers;QUILPUE                       ;VALPARAISO;248970;3;2;0;0;0;3;2;248970;LED 32 32PHD6825 HD SMART TV;ELECTRONICA MAYOR
13978729;Soltero;M;41;CHILENO;;X;RENCA                         ;METROPOLITANA;129990;1;1;0;0;0;1;1;129990;PARLANTE ULTRAMAGIC;ELECTRONICA MAYOR
12649305;;F;47;CHILENO;;X;CHANARAL                      ;ATACAMA;565460;3;2;0;0;0;3;2;565460;LED 32 32PHD6825 HD SMART TV;ELECTRONICA MAYOR
11075626;;F;56;CHILENO;;Boomers;N/D;N/D;704930;7;4;0;0;0;7;4;704930;LED 50 50UP7500 UHD SMART TV;ELECTRONICA MAYOR
17081688;;M;33;CHILENO;;Millenial;ALHUE                         ;METROPOLITANA;139990;1;1;0;0;0;1;1;139990;LED KIOTO 32 MI3228 SMART TV;ELECTRONICA MAYOR
8615746;;M;60;CHILENO;;Boomers;MELIPILLA                     ;METROPOLITANA;209990;1;1;0;0;0;1;1;209990;KARAOKE TRUE WIRELESS DUAL 10 PULGADAS LIGHT SHO;ELECTRONICA MAYOR
9542981;;F;62;CHILENO;;Boomers;TALCA                         ;MAULE;99990;1;1;0;0;0;1;1;99990;PARLANTE ULTRAMAGIC;ELECTRONICA MAYOR
8609590;;F;63;CHILENO;;Boomers;RENCA                         ;METROPOLITANA;136980;2;1;2;1;136980;0;0;0;LED KIOTO 32 MI3228 SMART TV;ELECTRONICA MAYOR
10845354;;M;55;CHILENO;;Boomers;VILLARICA                     ;ARAUCANIA;154990;1;1;0;0;0;1;1;154990;MONITOR 24 24TL520S SMART TV HD;ELECTRONICA MAYOR
6752901;;F;69;CHILENO;;Silencioso;SAN BERNARDO                  ;METROPOLITANA;612200;8;2;0;0;0;8;2;612200;LED 43 UN43TU7090GXZS UHD SMART TV;ELECTRONICA MAYOR
6120733;;F;70;CHILENO;;Silencioso;PROVIDENCIA                   ;METROPOLITANA;650350;4;2;0;0;0;4;2;650350;LED 60UP7750 UHD SMART + MAGIC;ELECTRONICA MAYOR
18524633;;M;28;CHILENO;;Millenial;PROVIDENCIA                   ;METROPOLITANA;179990;1;1;1;1;179990;0;0;0;LED 42 KHFH4221 SMART TV;ELECTRONICA MAYOR
13881639;;M;41;CHILENO;;X;VALPARAISO                    ;VALPARAISO;79990;1;1;0;0;0;1;1;79990;PARLANTE KARAOKE MGROKR NEGRO;ELECTRONICA MAYOR
17199254;;M;33;CHILENO;;Silencioso;PROVIDENCIA                   ;METROPOLITANA;137540;2;1;2;1;137540;0;0;0;LED 32 KHHD3221 SMART TV;ELECTRONICA MAYOR
13188752;;F;44;CHILENO;;X;COLINA                        ;METROPOLITANA;129990;1;1;0;0;0;1;1;129990;LED KIOTO 32 MI3228 SMART TV;ELECTRONICA MAYOR
12693360;;M;47;CHILENO;;X;RANCAGUA                      ;L.G.B.OÂ´HIGGINS;374540;2;1;2;1;374540;0;0;0;LED 50 50NANO75 NanoCell UHD SMART + MAGIC;ELECTRONICA MAYOR
18887072;;M;29;CHILENO;;Millenial;VALDIVIA                      ;LOS RIOS;299990;1;1;0;0;0;1;1;299990;LED 50 50U6305 SMART TV ULTRA HD;ELECTRONICA MAYOR
14332755;;F;45;CHILENO;;X;MELIPILLA                     ;METROPOLITANA;260800;3;1;0;0;0;3;1;260800;LED 42 KHFH4221 SMART TV;ELECTRONICA MAYOR
10244099;;F;56;CHILENO;;Boomers;TALCA                         ;MAULE;139990;1;1;1;1;139990;0;0;0;LED 32 32PHD6825 HD SMART TV;ELECTRONICA MAYOR
17006618;;M;33;CHILENO;;Millenial;N/D;N/D;414960;4;3;0;0;0;4;3;414960;LED 42 KHFH4221 SMART TV;ELECTRONICA MAYOR
19190671;;M;26;CHILENO;;Silencioso;PROVIDENCIA                   ;METROPOLITANA;289990;2;1;2;1;289990;0;0;0;LED 50 50UP7500 UHD SMART TV;ELECTRONICA MAYOR
26614375;;M;26;VENEZOLANO;;Extranjero;"";"";199990;1;1;0;0;0;1;1;199990;LED 43 CS43S1USM UHD SMART TV NEGRO;ELECTRONICA MAYOR
17113974;Soltero;F;33;CHILENO;;Millenial;MONTE PATRIA;COQUIMBO;137540;2;1;2;1;137540;0;0;0;LED KIOTO 32 MI3228 SMART TV;ELECTRONICA MAYOR
10367948;;F;49;CHILENO;;X;PUNTA ARENAS;MAGALLANES;129990;1;1;1;1;129990;0;0;0;LED 32 KHHD3221 SMART TV;ELECTRONICA MAYOR
12277121;;F;50;CHILENO;;X;COLBUN                        ;MAULE;29592;1;1;0;0;0;1;1;29592;KARAOKE FUNKY DISCO;ELECTRONICA MAYOR
13131895;;M;44;CHILENO;;X;N/D;N/D;69990;1;1;0;0;0;1;1;69990;PARLANTE KARAOKE MGROKR NEGRO;ELECTRONICA MAYOR
19548120;;F;25;CHILENO;;Z;PROVIDENCIA                   ;METROPOLITANA;289990;2;1;2;1;289990;0;0;0;LED 50 50UP7500 UHD SMART TV;ELECTRONICA MAYOR
17274133;;F;33;CHILENO;;Millenial;CURICO                        ;MAULE;369980;3;2;0;0;0;3;2;369980;LED 43 43S5305 SMART TV FULL HD;ELECTRONICA MAYOR
16046732;;F;36;CHILENO;;Millenial;ILLAPEL                       ;COQUIMBO;860713;7;2;0;0;0;7;2;860713;LED 50 50PUD7625 SMART TV ULTRA HD 4K;ELECTRONICA MAYOR
11783483;;F;50;CHILENO;;X;PROVIDENCIA                   ;METROPOLITANA;741840;5;1;0;0;0;5;1;741840;LED 50 UN50TU7090GXZS UHD SMART TV;ELECTRONICA MAYOR
7307511;;F;70;CHILENO;;Silencioso;ANGOL                         ;ARAUCANIA;609110;2;1;0;0;0;2;1;609110;LED 60 UN60AU8000GXZS UHD SMART TV;ELECTRONICA MAYOR
5068116;;F;80;CHILENO;;Silencioso;VINA DEL MAR                  ;VALPARAISO;313970;3;1;0;0;0;3;1;313970;LED 43 UN43TU7090GXZS UHD SMART TV;ELECTRONICA MAYOR
5955577;;F;70;CHILENO;;Silencioso;RENCA                         ;METROPOLITANA;230970;3;2;0;0;0;3;2;230970;LED 42 KHFH4221 SMART TV;ELECTRONICA MAYOR
14066628;;M;41;CHILENO;;X;LAJA                          ;BIO BIO;54990;1;1;0;0;0;1;1;54990;PARLANTE KARAOKE 12 FM/BT/USB;ELECTRONICA MAYOR
13750756;;F;41;CHILENO;;X;PETORCA                       ;VALPARAISO;194560;3;2;0;0;0;3;2;194560;LED 32 KHHD3221 SMART TV;ELECTRONICA MAYOR
10369797;;F;56;CHILENO;;Boomers;RENCA                         ;METROPOLITANA;69990;1;1;0;0;0;1;1;69990;PARLANTE COBRA;ELECTRONICA MAYOR
11150939;;F;55;CHILENO;;Boomers;VINA DEL MAR                  ;VALPARAISO;43980;2;1;0;0;0;2;1;43980;PARLANTE SPBYF7 PORTATIL;ELECTRONICA MAYOR
15874019;;M;37;CHILENO;;Millenial;N/D;N/D;483570;2;1;0;0;0;2;1;483570;LED 58 UN58AU7000GXZS UHD 4K SMART TV;ELECTRONICA MAYOR
13488906;;F;43;CHILENO;;X;N/D;N/D;269450;3;2;0;0;0;3;2;269450;LED 42 KHFH4221 SMART TV;ELECTRONICA MAYOR
16926916;;M;33;CHILENO;;Millenial;CALAMA                        ;ANTOFAGASTA;179990;1;1;1;1;179990;0;0;0;LED 42 KHFH4221 SMART TV;ELECTRONICA MAYOR
11167374;;F;55;CHILENO;;Boomers;LA PINTANA                    ;METROPOLITANA;192960;3;1;0;0;0;3;1;192960;PARLANTE ULTRAFUSION;ELECTRONICA MAYOR
10728807;;F;53;CHILENO;;X;ARICA                         ;ARICA Y PARINACOTA;91270;2;1;0;0;0;2;1;91270;PARLANTE KARAOKE MGROKR NEGRO;ELECTRONICA MAYOR
7238182;;M;69;CHILENO;;Silencioso;N/D;N/D;334570;2;1;0;0;0;2;1;334570;LED 43 43UP7500 UHD SMART TV;ELECTRONICA MAYOR
9776104;;M;57;CHILENO;;Boomers;VILLA ALEGRE                  ;MAULE;149990;1;1;0;0;0;1;1;149990;MONITOR 24 24TL520S SMART TV HD;ELECTRONICA MAYOR
11952558;;M;49;CHILENO;;X;SAN PEDRO DE LA PAZ           ;BIO BIO;152130;3;2;0;0;0;3;2;152130;LED 32 KHHD3221 SMART TV;ELECTRONICA MAYOR
24783941;;F;34;COLOMBIANO;;Extranjero;COLINA                        ;METROPOLITANA;79990;1;1;0;0;0;1;1;79990;PARLANTE KARAOKE MGROKR NEGRO;ELECTRONICA MAYOR
26882271;;F;58;VENEZOLANO;;Extranjero;N/D;N/D;399980;3;2;0;0;0;3;2;399980;LED 43 UN43TU7090GXZS UHD SMART TV;ELECTRONICA MAYOR
15052056;;F;39;CHILENO;;X;LA SERENA                     ;COQUIMBO;359720;3;1;0;0;0;3;1;359720;LED 50 KEUH50 SMART TV UHD;ELECTRONICA MAYOR
8534680;;M;48;CHILENO;;X;VILLA ALEMANA                 ;VALPARAISO;169990;1;1;0;0;0;1;1;169990;LED 32 32S60-32P ANDROID TV SMART LINE HD;ELECTRONICA MAYOR
15160230;;F;40;CHILENO;;X;N/D;N/D;951950;5;2;5;2;951950;0;0;0;LED 60UP7750 UHD SMART + MAGIC;ELECTRONICA MAYOR
8299969;;F;51;CHILENO;;X;AISEN                         ;AYSEN;275850;4;1;0;0;0;4;1;275850;LED 42 KHFH4221 SMART TV;ELECTRONICA MAYOR
11882953;;M;51;CHILENO;;X;SAN MIGUEL                    ;METROPOLITANA;109990;1;1;0;0;0;1;1;109990;KARAOKE SP-101BT ALL IN ONE PORTATIL 60W;ELECTRONICA MAYOR
12947108;;F;45;CHILENO;;X;N/D;N/D;348640;2;1;2;1;348640;0;0;0;LED 50 UN50TU7090GXZS UHD SMART TV;ELECTRONICA MAYOR
19749184;;F;24;CHILENO;;Z;CERRILLOS;METROPOLITANA;323980;2;1;2;1;323980;0;0;0;LED 49 49UN7100 UHD SMART TV;ELECTRONICA MAYOR
13243714;;F;45;CHILENO;;X;CONCHALI                      ;METROPOLITANA;383980;2;1;2;1;383980;0;0;0;LED 55UP7500 UHD SMART;ELECTRONICA MAYOR
6983839;;M;66;CHILENO;;Boomers;LA FLORIDA                    ;METROPOLITANA;303770;2;1;0;0;0;2;1;303770;LED 43 43S5305 SMART TV FULL HD;ELECTRONICA MAYOR
16144312;Soltero;M;37;CHILENO;TECNICO EN SONIDO;Millenial;PROVIDENCIA                   ;METROPOLITANA;183980;2;1;2;1;183980;0;0;0;LED 42 KHFH4221 SMART TV;ELECTRONICA MAYOR
12413630;;F;49;CHILENO;;X;SAN FERNANDO                  ;L.G.B.OÂ´HIGGINS;485440;5;1;0;0;0;5;1;485440;LED 50 50U6305 SMART TV ULTRA HD;ELECTRONICA MAYOR
18660408;;F;27;CHILENO;;Silencioso;PROVIDENCIA                   ;METROPOLITANA;519960;4;2;4;2;519960;0;0;0;LED 50 UN50TU7090GXZS UHD SMART TV;ELECTRONICA MAYOR
9922671;;M;58;CHILENO;;Boomers;ZAPALLAR                      ;VALPARAISO;139990;1;1;0;0;0;1;1;139990;SOUNDBAR HW-A450/ZS;ELECTRONICA MAYOR
18444054;;M;28;CHILENO;;Millenial;N/D;N/D;637950;5;2;5;2;637950;0;0;0;PARLANTE ULTRAFUSION;ELECTRONICA MAYOR
16109061;;F;36;CHILENO;;Millenial;CHILLAN                       ;BIO BIO;140830;3;2;2;1;125840;1;1;14990;LED 32 KHHD3221 SMART TV;ELECTRONICA MAYOR
12205558;;F;49;CHILENO;;X;NIQUEN                        ;BIO BIO;104990;1;1;0;0;0;1;1;104990;LED 32 KHHD3221 SMART TV;ELECTRONICA MAYOR
26247232;;M;49;VENEZOLANO;;Extranjero;N/D;N/D;489980;2;1;0;0;0;2;1;489980;LED 60UP7750 UHD SMART + MAGIC;ELECTRONICA MAYOR
19098049;;F;26;CHILENO;;Z;N/D;N/D;439990;1;1;0;0;0;1;1;439990;LED 55UP7500 UHD SMART;ELECTRONICA MAYOR
8670979;;F;65;CHILENO;;Boomers;N/D;N/D;229990;1;1;0;0;0;1;1;229990;LED 43 CS43S1USM UHD SMART TV NEGRO;ELECTRONICA MAYOR
19302120;;M;26;CHILENO;;Z;COINCO                        ;L.G.B.OÂ´HIGGINS;592330;5;1;0;0;0;5;1;592330;LED 55 UN55TU7090GXZS SMART TV UHD;ELECTRONICA MAYOR
12549058;;M;48;CHILENO;;X;CHILLAN                       ;BIO BIO;298870;2;1;0;0;0;2;1;298870;LED 43 Full HD Smart TV 43PFD6825;ELECTRONICA MAYOR
16275148;;M;36;CHILENO;;Millenial;PROVIDENCIA                   ;METROPOLITANA;295480;2;1;2;1;295480;0;0;0;LED 43 UN43TU7090GXZS UHD SMART TV;ELECTRONICA MAYOR
16495439;Soltero;M;35;CHILENO;;Millenial;PROVIDENCIA                   ;METROPOLITANA;383770;2;1;0;0;0;2;1;383770;LED 50 50UP7500 UHD SMART TV;ELECTRONICA MAYOR
10678781;;F;59;CHILENO;;Boomers;EL BOSQUE                     ;METROPOLITANA;442960;3;1;0;0;0;3;1;442960;LED 50 50UP7500 UHD SMART TV;ELECTRONICA MAYOR
4228378;;M;83;CHILENO;;Silencioso;LA GRANJA                     ;METROPOLITANA;179990;1;1;0;0;0;1;1;179990;LED 32 UN32T4300AGXZS HD SMART TV;ELECTRONICA MAYOR
13899527;Soltero;M;41;CHILENO;;X;RENCA                         ;METROPOLITANA;383980;2;1;2;1;383980;0;0;0;LED 55UP7500 UHD SMART;ELECTRONICA MAYOR
15351742;;M;39;CHILENO;;X;N/D;N/D;309990;1;1;0;0;0;1;1;309990;LED 49 49UN7100 UHD SMART TV;ELECTRONICA MAYOR
15999248;;M;36;CHILENO;;Millenial;PROVIDENCIA                   ;METROPOLITANA;29990;1;1;0;0;0;1;1;29990;KARAOKE STREET SONG 4 MICÂ CABLEÂ BLACK 8900;ELECTRONICA MAYOR
9491926;;F;58;CHILENO;;Boomers;LINARES                       ;MAULE;119990;1;1;0;0;0;1;1;119990;MINICOMPONENTE OL45;ELECTRONICA MAYOR
19031849;;M;27;CHILENO;;Silencioso;PROVIDENCIA                   ;METROPOLITANA;243980;2;1;2;1;243980;0;0;0;LED 40 UN40T5290AGXZS FHD SMART TV;ELECTRONICA MAYOR
19746684;;F;24;CHILENO;;Z;PROVIDENCIA                   ;METROPOLITANA;183980;2;1;2;1;183980;0;0;0;LED 42 KHFH4221 SMART TV;ELECTRONICA MAYOR
16061169;;F;37;CHILENO;;Millenial;LOS ANGELES                   ;BIO BIO;255840;2;1;2;1;255840;0;0;0;LED 43 43LM6300PSB SMART TV HD;ELECTRONICA MAYOR
8117338;;M;59;CHILENO;;Boomers;PROVIDENCIA                   ;METROPOLITANA;79990;1;1;0;0;0;1;1;79990;SOUNDBAR HW-T400/ZS;ELECTRONICA MAYOR
7729107;Divorciado;F;63;CHILENO;;Boomers;LOS ANDES                     ;VALPARAISO;456440;4;2;0;0;0;4;2;456440;PARLANTE ULTRASENSATION;ELECTRONICA MAYOR
8010273;;F;68;CHILENO;;Boomers;ERCILLA                       ;ARAUCANIA;227870;2;1;0;0;0;2;1;227870;LED 32 32PHD6825 HD SMART TV;ELECTRONICA MAYOR
19660955;;F;24;CHILENO;;Z;PROVIDENCIA                   ;METROPOLITANA;363520;3;1;3;1;363520;0;0;0;LED 42 KHFH4221 SMART TV;ELECTRONICA MAYOR
17410662;Soltero;F;32;CHILENO;TECNICO SUPERIOR DE LABORATORIO CLINICO Y BANCO DE SANGRE;Millenial;PROVIDENCIA                   ;METROPOLITANA;319990;1;1;1;1;319990;0;0;0;LED 50 50UP7500 UHD SMART TV;ELECTRONICA MAYOR
8551155;;M;46;CHILENO;;X;COIHAIQUE                     ;AYSEN;609980;2;1;0;0;0;2;1;609980;LED 55 55UP7750 UHD SMART + MAGIC;ELECTRONICA MAYOR
14615410;;F;41;CHILENO;;X;N/D;N/D;54990;1;1;0;0;0;1;1;54990;PARLANTE KARAOKE 12 FM/BT/USB;ELECTRONICA MAYOR
8186611;;F;57;CHILENO;;Boomers;ARICA                         ;ARICA Y PARINACOTA;17990;1;1;0;0;0;1;1;17990;PARLANTE MG TWISTER;ELECTRONICA MAYOR
14047634;;F;40;CHILENO;;X;COLTAUCO                      ;L.G.B.OÂ´HIGGINS;91270;2;1;0;0;0;2;1;91270;PARLANTE KARAOKE MGROKR NEGRO;ELECTRONICA MAYOR
7211093;;M;68;CHILENO;;Boomers;SAN BERNARDO                  ;METROPOLITANA;34990;1;1;0;0;0;1;1;34990;KARAOKE 8 CITY SET MIC WIRELESS ATRIL SILVER;ELECTRONICA MAYOR
12324771;;M;49;CHILENO;;X;ANGOL                         ;ARAUCANIA;179990;1;1;0;0;0;1;1;179990;LED 32 32PHD6825 HD SMART TV;ELECTRONICA MAYOR
9066997;;M;61;CHILENO;;Boomers;PROVIDENCIA                   ;METROPOLITANA;154990;1;1;0;0;0;1;1;154990;MONITOR 24 24TL520S SMART TV HD;ELECTRONICA MAYOR
26161522;;M;47;EXTRANJERO - NO INFORMA NACIONALIDAD;;Extranjero;N/D;N/D;449990;1;1;0;0;0;1;1;449990;LED 55 55P615 UHD ANDROID TV 4K;ELECTRONICA MAYOR
15557664;;F;39;CHILENO;;X;N/D;N/D;1015980;2;1;2;1;1015980;0;0;0;OLED 55 OLED55C1 UHD SMART + AUDIFONOS;ELECTRONICA MAYOR
18007969;;F;31;CHILENO;;Silencioso;PROVIDENCIA                   ;METROPOLITANA;233980;2;1;2;1;233980;0;0;0;LED 43 CS43S1USM UHD SMART TV NEGRO;ELECTRONICA MAYOR
17446978;;F;32;CHILENO;;Millenial;PROVIDENCIA                   ;METROPOLITANA;345480;2;1;2;1;345480;0;0;0;LED 43UP7750 UHD SMART + MAGIC;ELECTRONICA MAYOR
7117476;Casado;M;67;CHILENO;INGENIERO AGRICOLA;Boomers;RETIRO                        ;MAULE;337870;2;1;0;0;0;2;1;337870;LED 50 KHUH5021 SMART TV;ELECTRONICA MAYOR
7408091;;F;66;CHILENO;;Boomers;CALBUCO                       ;LOS LAGOS;309570;2;1;0;0;0;2;1;309570;LED 50 KHUH5021 SMART TV;ELECTRONICA MAYOR
4735442;;M;78;CHILENO;;Silencioso;EL BOSQUE                     ;METROPOLITANA;233470;2;1;0;0;0;2;1;233470;MINICOMPONENTE RN7;ELECTRONICA MAYOR
11608416;Soltero;M;53;CHILENO;AGROINDUSTRIA;X;PROVIDENCIA                   ;METROPOLITANA;79990;1;1;0;0;0;1;1;79990;PARLANTE KARAOKE MGROKR NEGRO;ELECTRONICA MAYOR
14495684;;M;48;CHILENO;;Silencioso;PROVIDENCIA                   ;METROPOLITANA;223470;2;1;0;0;0;2;1;223470;MINICOMPONENTE RN7;ELECTRONICA MAYOR
11886825;;M;50;CHILENO;;X;N/D;N/D;99990;1;1;0;0;0;1;1;99990;PARLANTE ULTRAMEGA;ELECTRONICA MAYOR
19503935;;M;25;CHILENO;;Z;PROVIDENCIA                   ;METROPOLITANA;159990;1;1;1;1;159990;0;0;0;LED 32 KHHD3221 SMART TV;ELECTRONICA MAYOR
15253316;;M;39;CHILENO;;X;LONCOCHE                      ;ARAUCANIA;384070;2;1;0;0;0;2;1;384070;LED 50 50U6305 SMART TV ULTRA HD;ELECTRONICA MAYOR
5655927;;M;76;CHILENO;;Silencioso;TALCA                         ;MAULE;139990;1;1;0;0;0;1;1;139990;LED 32 KHHD3221 SMART TV;ELECTRONICA MAYOR
7750685;;M;66;CHILENO;;Silencioso;PROVIDENCIA                   ;METROPOLITANA;139670;2;1;0;0;0;2;1;139670;PARLANTE ULTRAMAGIC;ELECTRONICA MAYOR
13194234;;M;44;CHILENO;;X;ALTO HOSPICIO;TARAPACA;149980;2;1;0;0;0;2;1;149980;LED 32 KHHD3221 SMART TV;ELECTRONICA MAYOR
14287692;;F;48;CHILENO;;X;N/D;N/D;290800;3;2;0;0;0;3;2;290800;LED 32 UN32T4300AGXZS HD SMART TV;ELECTRONICA MAYOR
15329546;;F;45;CHILENO;;X;N/D;N/D;187870;2;1;0;0;0;2;1;187870;MINICOMPONENTE CJ45;ELECTRONICA MAYOR
6570140;;M;72;CHILENO;;Silencioso;SANTIAGO                      ;METROPOLITANA;393550;4;1;0;0;0;4;1;393550;LED 32LM637B HD SMART;ELECTRONICA MAYOR
14242561;;F;48;CHILENO;;X;TOME                          ;BIO BIO;403770;3;1;0;0;0;3;1;403770;LED 50 50PUD7625 SMART TV ULTRA HD 4K;ELECTRONICA MAYOR
7630336;;F;64;CHILENO;;Boomers;CHILLAN                       ;BIO BIO;59980;2;3;0;0;0;2;3;59980;KARAOKE FUNKY DISCO;ELECTRONICA MAYOR
12192923;;F;50;CHILENO;;X;TEMUCO                        ;ARAUCANIA;287870;2;1;0;0;0;2;1;287870;MINICOMPONENTE RN9;ELECTRONICA MAYOR
6084204;;F;72;CHILENO;;Silencioso;LA PINTANA                    ;METROPOLITANA;466170;2;1;0;0;0;2;1;466170;LED 50 50UP7500 UHD SMART TV;ELECTRONICA MAYOR
9147048;;M;59;CHILENO;;Boomers;LOS LAGOS                     ;LOS LAGOS;164979;2;1;0;0;0;2;1;164979;LED 32 CS32S1 SMART TV HD NEGRO;ELECTRONICA MAYOR
15372250;;M;40;CHILENO;;X;ANCUD                         ;LOS LAGOS;348230;3;2;0;0;0;3;2;348230;LED 50 UN50TU7090GXZS UHD SMART TV;ELECTRONICA MAYOR
8431003;;F;64;CHILENO;;Boomers;RENCA                         ;METROPOLITANA;199990;1;1;0;0;0;1;1;199990;LED 32 UN32T4300AGXZS HD SMART TV;ELECTRONICA MAYOR
16384510;;M;36;CHILENO;;Millenial;PUDAHUEL                      ;METROPOLITANA;489990;1;1;0;0;0;1;1;489990;LED 55 NanoCell 55NANO75 UHD SMART + MAGIC;ELECTRONICA MAYOR
7258893;;M;68;CHILENO;;Boomers;PUENTE ALTO                   ;METROPOLITANA;193460;3;1;0;0;0;3;1;193460;PARLANTE ULTRAFORCE-I;ELECTRONICA MAYOR
12843457;;M;47;CHILENO;;X;LA SERENA                     ;COQUIMBO;549980;2;2;0;0;0;2;2;549980;LED 50 50NANO75 NanoCell UHD SMART + MAGIC;ELECTRONICA MAYOR
5977515;;F;76;CHILENO;;Silencioso;TALCA                         ;MAULE;49990;1;1;0;0;0;1;1;49990;KARAOKE RHYTHM CHARGER 12 MIC CABLE 8890;ELECTRONICA MAYOR
6509242;;M;68;CHILENO;;Silencioso;LLAILLAY                      ;VALPARAISO;445890;3;2;0;0;0;3;2;445890;LED 50 UN50TU7090GXZS UHD SMART TV;ELECTRONICA MAYOR
19072113;;M;26;CHILENO;;Z;CHILLAN                       ;BIO BIO;389990;1;1;0;0;0;1;1;389990;LED 55 UN55TU7090GXZS SMART TV UHD;ELECTRONICA MAYOR
12460890;;F;49;CHILENO;;X;N/D;N/D;359980;2;1;0;0;0;2;1;359980;LED 50 UN50TU7090GXZS UHD SMART TV;ELECTRONICA MAYOR
26094416;;F;51;COLOMBIANO;;Extranjero;N/D;N/D;299990;1;1;0;0;0;1;1;299990;LED 50 50PUD7625 SMART TV ULTRA HD 4K;ELECTRONICA MAYOR
5127288;;M;74;CHILENO;;Silencioso;RECOLETA                      ;METROPOLITANA;287870;2;1;0;0;0;2;1;287870;LED 40 UN40T5290AGXZS FHD SMART TV;ELECTRONICA MAYOR
12310102;;F;50;CHILENO;;Silencioso;PROVIDENCIA                   ;METROPOLITANA;52670;2;1;0;0;0;2;1;52670;PARLANTE SPBYF7 PORTATIL;ELECTRONICA MAYOR
7035246;;M;66;CHILENO;;Boomers;NACIMIENTO                    ;BIO BIO;147870;2;1;0;0;0;2;1;147870;PARLANTE ULTRAMEGA;ELECTRONICA MAYOR
19818043;;M;25;CHILENO;;Z;"";"";309990;1;1;0;0;0;1;1;309990;LED 50 50U6305 SMART TV ULTRA HD;ELECTRONICA MAYOR
8219100;;F;62;CHILENO;;Boomers;PROVIDENCIA                   ;METROPOLITANA;0;0;0;0;0;0;0;0;0;LED KIOTO 32 MI3228 SMART TV;ELECTRONICA MAYOR
14187871;;M;40;CHILENO;;X;PUENTE ALTO                   ;METROPOLITANA;0;0;0;0;0;0;0;0;0;LED 42 42S6500 ANDROID TV FHD;ELECTRONICA MAYOR
12562442;;F;48;CHILENO;;X;RENCA                         ;METROPOLITANA;0;0;0;0;0;0;0;0;0;KARAOKE STREET SONG 4 MICÂ CABLEÂ BLACK 8900;ELECTRONICA MAYOR
12967778;;M;45;CHILENO;;X;COIHUECO                      ;BIO BIO;0;0;0;0;0;0;0;0;0;PARLANTE ULTRAMAGIC;ELECTRONICA MAYOR
9685562;;F;58;CHILENO;;Boomers;LOS ANGELES                   ;BIO BIO;0;0;0;0;0;0;0;0;0;MINICOMPONENTE RN7;ELECTRONICA MAYOR
19275174;Soltero;F;25;CHILENO;;Z;PROVIDENCIA                   ;METROPOLITANA;0;0;0;0;0;0;0;0;0;LED 40 UN40T5290AGXZS FHD SMART TV;ELECTRONICA MAYOR
7353402;Soltero;M;69;CHILENO;;Silencioso;PROVIDENCIA                   ;METROPOLITANA;0;0;0;0;0;0;0;0;0;MINICOMPONENTE RN7;ELECTRONICA MAYOR
13733910;;F;42;CHILENO;;X;PADRE LAS CASAS               ;ARAUCANIA;0;0;0;0;0;0;0;0;0;MINICOMPONENTE OL45;ELECTRONICA MAYOR
17113252;;F;33;CHILENO;;Millenial;OVALLE                        ;COQUIMBO;0;0;0;0;0;0;0;0;0;SISTEMA DE SONIDO CM1560;ELECTRONICA MAYOR
13178506;;M;45;CHILENO;;X;OVALLE                        ;COQUIMBO;0;0;0;0;0;0;0;0;0;LED KIOTO 32 MI3228 SMART TV;ELECTRONICA MAYOR
25085702;;M;36;COLOMBIANO;;Extranjero;N/D;N/D;0;0;0;0;0;0;0;0;0;LED 43 43UP7500 UHD SMART TV;ELECTRONICA MAYOR
17288672;;F;32;CHILENO;;Millenial;SANTA CRUZ                    ;L.G.B.OÂ´HIGGINS;0;0;0;0;0;0;0;0;0;LED 43 UN43T5202AGXZS FHD SMART TV;ELECTRONICA MAYOR
11566234;;M;51;CHILENO;;X;MAIPU                         ;METROPOLITANA;0;0;0;0;0;0;0;0;0;LED 43 UN43T5202AGXZS FHD SMART TV;ELECTRONICA MAYOR
17684368;;F;31;CHILENO;;Millenial;MELIPILLA                     ;METROPOLITANA;0;0;0;0;0;0;0;0;0;PARLANTE ULTRASENSATION;ELECTRONICA MAYOR
16324311;Soltero;F;36;CHILENO;;Millenial;PROVIDENCIA                   ;METROPOLITANA;0;0;0;0;0;0;0;0;0;KARAOKE FUNKY DISCO;ELECTRONICA MAYOR
19412794;;M;25;CHILENO;;Silencioso;PROVIDENCIA                   ;METROPOLITANA;0;0;0;0;0;0;0;0;0;LED 70 UN70AU7000GXZS UHD;ELECTRONICA MAYOR
16035217;;M;36;CHILENO;;Millenial;PROVIDENCIA                   ;METROPOLITANA;0;0;0;0;0;0;0;0;0;MINICOMPONENTE RN9;ELECTRONICA MAYOR
10679640;;M;52;CHILENO;;X;ARICA                         ;TARAPACA;0;0;0;0;0;0;0;0;0;LED 60UP7750 UHD SMART + MAGIC;ELECTRONICA MAYOR
16321408;;M;36;CHILENO;;Silencioso;PROVIDENCIA                   ;METROPOLITANA;0;0;0;0;0;0;0;0;0;LED 50 50P615-50P ANDROID TV PASSION LINE UHD 4K;ELECTRONICA MAYOR
20368488;;M;22;CHILENO;;Silencioso;PROVIDENCIA                   ;METROPOLITANA;0;0;0;0;0;0;0;0;0;LED 43 Full HD Smart TV 43PFD6825;ELECTRONICA MAYOR
15692276;;F;38;CHILENO;;Millenial;RANCAGUA                      ;L.G.B.OÂ´HIGGINS;0;0;0;0;0;0;0;0;0;SOUNDBAR SK1D;ELECTRONICA MAYOR
25532344;;M;25;COLOMBIANO;;Extranjero;VALPARAISO                    ;VALPARAISO;0;0;0;0;0;0;0;0;0;LED 40 UN40T5290AGXZS FHD SMART TV;ELECTRONICA MAYOR
15758579;;F;37;CHILENO;;Millenial;PAINE                         ;METROPOLITANA;0;0;0;0;0;0;0;0;0;LED 55 UN55TU7090GXZS SMART TV UHD;ELECTRONICA MAYOR
14278839;Casado;M;48;CHILENO;TECNICO MECANICO;Boomers;NIQUEN                        ;BIO BIO;0;0;0;0;0;0;0;0;0;LED 32LM637B HD SMART;ELECTRONICA MAYOR
15677844;;M;38;CHILENO;;Millenial;"";"";0;0;0;0;0;0;0;0;0;LED 43 43LM6370 SMART TV FHD;ELECTRONICA MAYOR
14525498;;M;43;CHILENO;;X;MAIPU                         ;METROPOLITANA;0;0;0;0;0;0;0;0;0;LED 60 UN60AU8000GXZS UHD SMART TV;ELECTRONICA MAYOR
16364096;;F;46;CHILENO;;Extranjero;COIHAIQUE                     ;AYSEN;0;0;0;0;0;0;0;0;0;KARAOKE FUNKY DISCO;ELECTRONICA MAYOR
4897424;;M;74;CHILENO;;Silencioso;MAIPU                         ;METROPOLITANA;0;0;0;0;0;0;0;0;0;LED 32 UN32T4300AGXZS HD SMART TV;ELECTRONICA MAYOR
16527005;;M;35;CHILENO;;Millenial;PROVIDENCIA                   ;METROPOLITANA;0;0;0;0;0;0;0;0;0;KARAOKE BLACK PHANTER II;ELECTRONICA MAYOR
10530911;;M;53;CHILENO;;X;N/D;N/D;0;0;0;0;0;0;0;0;0;LED 60UP7750 UHD SMART + MAGIC;ELECTRONICA MAYOR
8782907;;M;57;CHILENO;;Boomers;LAGO VERDE                    ;AYSEN;0;0;0;0;0;0;0;0;0;PARLANTE KARAOKE MGROKR NEGRO;ELECTRONICA MAYOR
12291064;;M;50;CHILENO;;X;RANCAGUA                      ;L.G.B.OÂ´HIGGINS;0;0;0;0;0;0;0;0;0;LED 49 49UN7100 UHD SMART TV;ELECTRONICA MAYOR
7069463;;M;64;CHILENO;;Boomers;OSORNO                        ;LOS LAGOS;0;0;0;0;0;0;0;0;0;LED 32 32PHD5813 SMART TV HD;ELECTRONICA MAYOR
8357612;;M;61;CHILENO;;Boomers;MAIPU                         ;METROPOLITANA;0;0;0;0;0;0;0;0;0;LED 55UP7500 UHD SMART;ELECTRONICA MAYOR
19814069;;M;24;CHILENO;;Silencioso;PROVIDENCIA                   ;METROPOLITANA;0;0;0;0;0;0;0;0;0;LED 49 49UN7100 UHD SMART TV;ELECTRONICA MAYOR
16256635;;F;36;CHILENO;;Millenial;CAUQUENES                     ;MAULE;0;0;0;0;0;0;0;0;0;LED 42 42S6500 ANDROID TV FHD;ELECTRONICA MAYOR
10620551;;M;55;CHILENO;;Boomers;RENCA                         ;METROPOLITANA;0;0;0;0;0;0;0;0;0;MINICOMPONENTE RN5;ELECTRONICA MAYOR
17814142;;F;30;CHILENO;;Millenial;PROVIDENCIA                   ;METROPOLITANA;0;0;0;0;0;0;0;0;0;LED 49 49UN7100 UHD SMART TV;ELECTRONICA MAYOR
9997503;;M;44;CHILENO;;Boomers;PROVIDENCIA                   ;METROPOLITANA;0;0;0;0;0;0;0;0;0;LED 32 32S60-32P ANDROID TV SMART LINE HD;ELECTRONICA MAYOR
26675635;;M;29;EXTRANJERO - NO INFORMA NACIONALIDAD;;Extranjero;N/D;N/D;0;0;0;0;0;0;0;0;0;LED 55 UN55TU7090GXZS SMART TV UHD;ELECTRONICA MAYOR
7955059;;M;64;CHILENO;;Boomers;N/D;N/D;0;0;0;0;0;0;0;0;0;PARLANTE ULTRASENSATION;ELECTRONICA MAYOR
10713016;;M;51;CHILENO;;X;RANCAGUA                      ;L.G.B.OÂ´HIGGINS;0;0;0;0;0;0;0;0;0;SOUNDBAR HW-A450/ZS;ELECTRONICA MAYOR
13484155;;M;45;CHILENO;;X;LA CISTERNA                   ;METROPOLITANA;0;0;0;0;0;0;0;0;0;LED 50 50U6305 SMART TV ULTRA HD;ELECTRONICA MAYOR
7001378;;M;75;CHILENO;;Silencioso;SAN CARLOS                    ;BIO BIO;0;0;0;0;0;0;0;0;0;LED KIOTO 32 MI3228 SMART TV;ELECTRONICA MAYOR
19219429;Soltero;F;26;CHILENO;;Z;PROVIDENCIA                   ;METROPOLITANA;0;0;0;0;0;0;0;0;0;LED 70 UN70AU7000GXZS UHD;ELECTRONICA MAYOR
9564931;Casado;F;59;CHILENO;;Boomers;PROVIDENCIA                   ;METROPOLITANA;0;0;0;0;0;0;0;0;0;LED KIOTO 32 MI3228 SMART TV;ELECTRONICA MAYOR
13836356;;M;42;CHILENO;;X;N/D;N/D;0;0;0;0;0;0;0;0;0;MINICOMPONENTE CM4360;ELECTRONICA MAYOR
17571790;;M;32;CHILENO;;Silencioso;PROVIDENCIA                   ;METROPOLITANA;0;0;0;0;0;0;0;0;0;LED 32 32PHD6825 HD SMART TV;ELECTRONICA MAYOR
22925780;;M;43;PERUANO;;Extranjero;SANTIAGO                      ;METROPOLITANA;0;0;0;0;0;0;0;0;0;LED 55 55P615 UHD ANDROID TV 4K;ELECTRONICA MAYOR
11624373;;M;51;CHILENO;;X;LOS ANDES                     ;VALPARAISO;0;0;0;0;0;0;0;0;0;PARLANTE ULTRAFORCE-I;ELECTRONICA MAYOR
11750449;;M;51;CHILENO;;Silencioso;PROVIDENCIA                   ;METROPOLITANA;0;0;0;0;0;0;0;0;0;LED 50 50PUD6513/44 SMART TV UHD 4K;ELECTRONICA MAYOR
9751412;;M;57;CHILENO;;Boomers;LAS CABRAS                    ;L.G.B.OÂ´HIGGINS;0;0;0;0;0;0;0;0;0;PARLANTE ULTRASENSATION;ELECTRONICA MAYOR
6883565;;M;70;CHILENO;;Silencioso;NOGALES                       ;VALPARAISO;0;0;0;0;0;0;0;0;0;LED 32 32LM630BPSB SMART TV;ELECTRONICA MAYOR
18162222;;F;30;CHILENO;;Millenial;SAN ANTONIO                   ;VALPARAISO;0;0;0;0;0;0;0;0;0;LED 32 UN32T4300AGXZS HD SMART TV;ELECTRONICA MAYOR
5868175;;F;72;CHILENO;;Silencioso;LO PRADO                      ;METROPOLITANA;0;0;0;0;0;0;0;0;0;KARAOKE PORTATIL TWO-EIGHT 8860;ELECTRONICA MAYOR
5898586;;M;71;CHILENO;;Silencioso;PROVIDENCIA                   ;METROPOLITANA;0;0;0;0;0;0;0;0;0;LED 55UP7500 UHD SMART;ELECTRONICA MAYOR
25547201;;M;43;COLOMBIANO;;Extranjero;LA FLORIDA                    ;METROPOLITANA;0;0;0;0;0;0;0;0;0;PARLANTE ULTRAFORCE-I;ELECTRONICA MAYOR
12771922;;M;47;CHILENO;;X;HUALPEN;BIO BIO;0;0;0;0;0;0;0;0;0;LED KIOTO 32 MI3228 SMART TV;ELECTRONICA MAYOR
17108197;;F;33;CHILENO;;Millenial;RANCAGUA                      ;L.G.B.OÂ´HIGGINS;0;0;0;0;0;0;0;0;0;LED 60 UN60AU8000GXZS UHD SMART TV;ELECTRONICA MAYOR
14028209;;M;41;CHILENO;;X;SAN CARLOS                    ;BIO BIO;0;0;0;0;0;0;0;0;0;LED 50 50U6305 SMART TV ULTRA HD;ELECTRONICA MAYOR
11549902;;M;52;CHILENO;;Millenial;MAIPU                         ;METROPOLITANA;0;0;0;0;0;0;0;0;0;LED 43 43S5295 SMART TV FHD;ELECTRONICA MAYOR
16223873;;F;35;CHILENO;;Millenial;PROVIDENCIA                   ;METROPOLITANA;0;0;0;0;0;0;0;0;0;LED 32LM637B HD SMART;ELECTRONICA MAYOR
15772271;Casado;M;37;CHILENO;ABOGADO;Silencioso;PROVIDENCIA                   ;METROPOLITANA;0;0;0;0;0;0;0;0;0;LED 55 UN55TU7090GXZS SMART TV UHD;ELECTRONICA MAYOR
11767584;;F;51;CHILENO;;X;CHANCO                        ;MAULE;0;0;0;0;0;0;0;0;0;LED KIOTO 32 MI3228 SMART TV;ELECTRONICA MAYOR
7672017;;F;66;CHILENO;;Boomers;SAN PEDRO                     ;METROPOLITANA;0;0;0;0;0;0;0;0;0;MLAB KARAOKE 8 CITY SET MICROFONO INALAMBRICO AT;ELECTRONICA MAYOR
15435954;;F;40;CHILENO;;X;RENCA                         ;METROPOLITANA;0;0;0;0;0;0;0;0;0;PARLANTE ULTRAMAGIC;ELECTRONICA MAYOR
9931272;;M;55;CHILENO;;Boomers;N/D;N/D;0;0;0;0;0;0;0;0;0;LED 40 KEHD4020 SMART TV;ELECTRONICA MAYOR
14396711;Soltero;M;43;CHILENO;INGENIERO COMERCIAL;X;PROVIDENCIA                   ;METROPOLITANA;0;0;0;0;0;0;0;0;0;LED 32 32S60-32P ANDROID TV SMART LINE HD;ELECTRONICA MAYOR
20989387;;M;20;CHILENO;;Silencioso;N/D;N/D;0;0;0;0;0;0;0;0;0;LED KIOTO 32 MI3228 SMART TV;ELECTRONICA MAYOR
19661104;;F;24;CHILENO;;Silencioso;PROVIDENCIA                   ;METROPOLITANA;0;0;0;0;0;0;0;0;0;LED KIOTO 32 MI3228 SMART TV;ELECTRONICA MAYOR
16667389;;M;34;CHILENO;;Silencioso;PROVIDENCIA                   ;METROPOLITANA;0;0;0;0;0;0;0;0;0;LED 32 UN32T4300AGXZS HD SMART TV;ELECTRONICA MAYOR
19700493;;F;24;CHILENO;;Z;PROVIDENCIA                   ;METROPOLITANA;0;0;0;0;0;0;0;0;0;LED 40 UN40T5290AGXZS FHD SMART TV;ELECTRONICA MAYOR
17188831;;M;33;CHILENO;;Millenial;PROVIDENCIA                   ;METROPOLITANA;0;0;0;0;0;0;0;0;0;LED 43 43LM6370 SMART TV FHD;ELECTRONICA MAYOR
7095475;;M;69;CHILENO;;Silencioso;ARICA                         ;TARAPACA;0;0;0;0;0;0;0;0;0;LED 60UP7750 UHD SMART + MAGIC;ELECTRONICA MAYOR
18710580;;F;28;CHILENO;;Silencioso;PROVIDENCIA                   ;METROPOLITANA;0;0;0;0;0;0;0;0;0;MINICOMPONENTE OL45;ELECTRONICA MAYOR
16452321;;M;36;CHILENO;;Millenial;PROVIDENCIA                   ;METROPOLITANA;0;0;0;0;0;0;0;0;0;MINICOMPONENTE MHC-V02 ALL IN ONE;ELECTRONICA MAYOR
10238290;;F;60;CHILENO;;Boomers;ANGOL                         ;ARAUCANIA;0;0;0;0;0;0;0;0;0;LED 40 KEHD4020 SMART TV;ELECTRONICA MAYOR
13538882;Casado;M;44;CHILENO;;X;PROVIDENCIA                   ;METROPOLITANA;0;0;0;0;0;0;0;0;0;LED 43 43LM6370 SMART TV FHD;ELECTRONICA MAYOR
18333772;Soltero;M;30;CHILENO;DISENADOR GRAFICO;Millenial;PROVIDENCIA                   ;METROPOLITANA;0;0;0;0;0;0;0;0;0;LED 32 32S5295 SMART TV HD;ELECTRONICA MAYOR
18658146;;F;30;CHILENO;;Millenial;CUNCO                         ;ARAUCANIA;0;0;0;0;0;0;0;0;0;LED 60 UN60AU8000GXZS UHD SMART TV;ELECTRONICA MAYOR
13583837;;M;42;CHILENO;;X;FREIRE                        ;ARAUCANIA;0;0;0;0;0;0;0;0;0;MINICOMPONENTE CJ45;ELECTRONICA MAYOR
15528352;;M;60;CHILENO;;Boomers;RENCA                         ;METROPOLITANA;0;0;0;0;0;0;0;0;0;LED 40 KEHD4020 SMART TV;ELECTRONICA MAYOR
18991021;;M;27;CHILENO;;Silencioso;PROVIDENCIA                   ;METROPOLITANA;0;0;0;0;0;0;0;0;0;LED KIOTO 32 MI3228 SMART TV;ELECTRONICA MAYOR
6476037;;M;67;CHILENO;;Boomers;QUILPUE                       ;VALPARAISO;0;0;0;0;0;0;0;0;0;LED 55 55UN7100 UHD SMART TV;ELECTRONICA MAYOR
16273271;;F;36;CHILENO;;Silencioso;LONGAVI                       ;MAULE;0;0;0;0;0;0;0;0;0;LED 43 UN43T5202AGXZS FHD SMART TV;ELECTRONICA MAYOR
20077711;;F;23;CHILENO;;Z;PROVIDENCIA                   ;METROPOLITANA;0;0;0;0;0;0;0;0;0;LED 32 UN32T4300AGXZS HD SMART TV;ELECTRONICA MAYOR
18182839;;F;30;CHILENO;;Millenial;COPIAPO                       ;ATACAMA;0;0;0;0;0;0;0;0;0;LED 58 58PUD6654 Ultra HD Smart TV;ELECTRONICA MAYOR
13260900;;F;45;CHILENO;;Silencioso;N/D;N/D;0;0;0;0;0;0;0;0;0;LED 50 UN50TU7090GXZS UHD SMART TV;ELECTRONICA MAYOR
17331100;Soltero;F;32;CHILENO;;Millenial;PROVIDENCIA                   ;METROPOLITANA;0;0;0;0;0;0;0;0;0;LED 65 KUHK6520 UHD SMART TV;ELECTRONICA MAYOR
12603164;;F;48;CHILENO;;X;PROVIDENCIA                   ;METROPOLITANA;0;0;0;0;0;0;0;0;0;LED 43 UN43T5202AGXZS FHD SMART TV;ELECTRONICA MAYOR
7635189;;M;67;CHILENO;;Boomers;LAS CABRAS                    ;L.G.B.OÂ´HIGGINS;0;0;0;0;0;0;0;0;0;LED 43 43LM6300PSB SMART TV HD;ELECTRONICA MAYOR
15189048;;F;40;CHILENO;;X;CORONEL                       ;BIO BIO;0;0;0;0;0;0;0;0;0;LED 43 43S5295 SMART TV FHD;ELECTRONICA MAYOR
6954192;;M;68;CHILENO;;Silencioso;LA LIGUA                      ;VALPARAISO;0;0;0;0;0;0;0;0;0;LED 43 43LM6300PSB SMART TV HD;ELECTRONICA MAYOR
5289350;Casado;F;75;CHILENO;;Silencioso;VILLA ALEMANA                 ;VALPARAISO;0;0;0;0;0;0;0;0;0;LED 43 UN43T5202AGXZS FHD SMART TV;ELECTRONICA MAYOR
18954480;;F;27;CHILENO;;Millenial;N/D;N/D;0;0;0;0;0;0;0;0;0;PARLANTE ULTRAMEGA;ELECTRONICA MAYOR
7839698;;M;65;CHILENO;;Boomers;QUILPUE                       ;VALPARAISO;0;0;0;0;0;0;0;0;0;LED KIOTO 32 MI3228 SMART TV;ELECTRONICA MAYOR
19633068;;F;25;CHILENO;;Z;N/D;N/D;0;0;0;0;0;0;0;0;0;LED 43 Full HD Smart TV 43PFD6825;ELECTRONICA MAYOR
12596522;;F;47;CHILENO;;X;N/D;N/D;0;0;0;0;0;0;0;0;0;LED 55 55UN7100 UHD SMART TV;ELECTRONICA MAYOR
15115703;;M;40;CHILENO;;X;CHIMBARONGO                   ;L.G.B.OÂ´HIGGINS;0;0;0;0;0;0;0;0;0;MINICOMPONENTE RN5;ELECTRONICA MAYOR
16407803;Casado;M;36;CHILENO;;Silencioso;PROVIDENCIA                   ;METROPOLITANA;0;0;0;0;0;0;0;0;0;LED 49 49UN7100 UHD SMART TV;ELECTRONICA MAYOR
14022677;Casado;M;41;CHILENO;;X;PROVIDENCIA                   ;METROPOLITANA;0;0;0;0;0;0;0;0;0;LED 40 KEHD4020 SMART TV;ELECTRONICA MAYOR
13465477;;F;44;CHILENO;;X;"";"";0;0;0;0;0;0;0;0;0;LED 55UP7500 UHD SMART;ELECTRONICA MAYOR
9894873;;M;59;CHILENO;;Boomers;NATALES                       ;MAGALLANES;0;0;0;0;0;0;0;0;0;LED 40 KEHD4020 SMART TV;ELECTRONICA MAYOR
12947014;;F;46;CHILENO;;X;PROVIDENCIA                   ;METROPOLITANA;0;0;0;0;0;0;0;0;0;LED 40 KEHD4020 SMART TV;ELECTRONICA MAYOR
19389364;;F;26;CHILENO;;Z;N/D;N/D;0;0;0;0;0;0;0;0;0;LED 40 KEHD4020 SMART TV;ELECTRONICA MAYOR
9702760;;F;61;CHILENO;;Boomers;RENCA                         ;METROPOLITANA;0;0;0;0;0;0;0;0;0;LED 55 55UN7100 UHD SMART TV;ELECTRONICA MAYOR
18858553;Soltero;M;27;CHILENO;ANALISTA DE SISTEMAS;Silencioso;PROVIDENCIA                   ;METROPOLITANA;0;0;0;0;0;0;0;0;0;MINICOMPONENTE CJ45;ELECTRONICA MAYOR
13329259;;M;44;CHILENO;;X;OVALLE;COQUIMBO;0;0;0;0;0;0;0;0;0;LED 50 KEUH50 SMART TV UHD;ELECTRONICA MAYOR
12995936;;F;46;CHILENO;;X;LAGO RANCO                    ;LOS RIOS;0;0;0;0;0;0;0;0;0;KARAOKE BLACK PHANTER II;ELECTRONICA MAYOR
19520986;;F;25;CHILENO;;Silencioso;PROVIDENCIA                   ;METROPOLITANA;0;0;0;0;0;0;0;0;0;PARLANTE ULTRAMEGA;ELECTRONICA MAYOR
15308124;;F;40;CHILENO;;Silencioso;PROVIDENCIA                   ;METROPOLITANA;0;0;0;0;0;0;0;0;0;LED 32 UN32T4300AGXZS HD SMART TV;ELECTRONICA MAYOR
12597508;;M;48;CHILENO;;X;PROVIDENCIA                   ;METROPOLITANA;0;0;0;0;0;0;0;0;0;LED KIOTO 32 MI3228 SMART TV;ELECTRONICA MAYOR
15990999;;F;37;CHILENO;;Millenial;N/D;N/D;0;0;0;0;0;0;0;0;0;MINICOMPONENTE CJ45;ELECTRONICA MAYOR
18175381;;F;30;CHILENO;;Millenial;TALCA                         ;MAULE;0;0;0;0;0;0;0;0;0;LED 40 KEHD4020 SMART TV;ELECTRONICA MAYOR
18737555;;M;29;CHILENO;;Millenial;PEDRO AGUIRRE CERDA           ;METROPOLITANA;0;0;0;0;0;0;0;0;0;LED 49 49UN7100 UHD SMART TV;ELECTRONICA MAYOR
16493570;;M;35;CHILENO;;Millenial;RANCAGUA;O HIGGINS;0;0;0;0;0;0;0;0;0;LED 32 32LM630BPSB SMART TV;ELECTRONICA MAYOR
15795158;Casado;F;37;CHILENO;AUXILIAR DE FARMACIA;Millenial;PROVIDENCIA                   ;METROPOLITANA;0;0;0;0;0;0;0;0;0;LED 65 KUHK6520 UHD SMART TV;ELECTRONICA MAYOR
17854473;;F;30;CHILENO;;Millenial;PROVIDENCIA                   ;METROPOLITANA;0;0;0;0;0;0;0;0;0;LED 32 UN32T4300AGXZS HD SMART TV;ELECTRONICA MAYOR
16620935;;F;33;CHILENO;;Millenial;PROVIDENCIA                   ;METROPOLITANA;0;0;0;0;0;0;0;0;0;LED 50 UN50TU7090GXZS UHD SMART TV;ELECTRONICA MAYOR
8328335;Casado;F;60;CHILENO;;Silencioso;PROVIDENCIA                   ;METROPOLITANA;0;0;0;0;0;0;0;0;0;LED 65 KUHK6520 UHD SMART TV;ELECTRONICA MAYOR
14546910;;F;47;CHILENO;;X;SAN BERNARDO                  ;METROPOLITANA;0;0;0;0;0;0;0;0;0;LED 60 UN60AU8000GXZS UHD SMART TV;ELECTRONICA MAYOR
9776917;;F;59;CHILENO;;Boomers;SAN VICENTE                   ;L.G.B.OÂ´HIGGINS;0;0;0;0;0;0;0;0;0;MINICOMPONENTE CJ45;ELECTRONICA MAYOR
11156886;;M;55;CHILENO;;Boomers;LEBU                          ;BIO BIO;0;0;0;0;0;0;0;0;0;LED 32 UN32T4300AGXZS HD SMART TV;ELECTRONICA MAYOR
10255757;;M;58;CHILENO;;Boomers;PARRAL;MAULE;0;0;0;0;0;0;0;0;0;LED 50 KEUH50 SMART TV UHD;ELECTRONICA MAYOR
6787186;;F;69;CHILENO;;Silencioso;PROVIDENCIA                   ;METROPOLITANA;0;0;0;0;0;0;0;0;0;LED 43 UN43T5202AGXZS FHD SMART TV;ELECTRONICA MAYOR
9510254;;M;59;CHILENO;;Boomers;RENCA                         ;METROPOLITANA;0;0;0;0;0;0;0;0;0;LED 43 UN43TU7090GXZS UHD SMART TV;ELECTRONICA MAYOR
11236342;Casado;M;54;CHILENO;;X;PROVIDENCIA                   ;METROPOLITANA;0;0;0;0;0;0;0;0;0;LED 43 43LM6300PSB SMART TV HD;ELECTRONICA MAYOR
18114648;;F;30;CHILENO;;Millenial;PROVIDENCIA                   ;METROPOLITANA;0;0;0;0;0;0;0;0;0;LED 40 KEHD4020 SMART TV;ELECTRONICA MAYOR
13668850;;F;43;CHILENO;;X;PUENTE ALTO                   ;METROPOLITANA;0;0;0;0;0;0;0;0;0;LED 40 KEHD4020 SMART TV;ELECTRONICA MAYOR
18698483;;M;28;CHILENO;;Millenial;PROVIDENCIA                   ;METROPOLITANA;0;0;0;0;0;0;0;0;0;LED 43 43S5295 SMART TV FHD;ELECTRONICA MAYOR
15265722;;F;38;CHILENO;;X;PROVIDENCIA                   ;METROPOLITANA;0;0;0;0;0;0;0;0;0;PARLANTE COBRA;ELECTRONICA MAYOR
15588017;;F;38;CHILENO;;X;MAIPU                         ;METROPOLITANA;0;0;0;0;0;0;0;0;0;LED 40 KEHD4020 SMART TV;ELECTRONICA MAYOR
15131428;;M;40;CHILENO;;X;ROMERAL                       ;MAULE;0;0;0;0;0;0;0;0;0;LED 32 32LM630BPSB SMART TV;ELECTRONICA MAYOR
13738211;;F;43;CHILENO;;X;"";"";0;0;0;0;0;0;0;0;0;MINICOMPONENTE RN5;ELECTRONICA MAYOR
10579688;Divorciado;M;54;CHILENO;;X;RENCA                         ;METROPOLITANA;0;0;0;0;0;0;0;0;0;QLED 50 QN50Q60AAGXZS 4K UHD SMART TV;ELECTRONICA MAYOR
6417320;;M;69;CHILENO;;Silencioso;TALCAHUANO                    ;BIO BIO;0;0;0;0;0;0;0;0;0;MINICOMPONENTE CM4360;ELECTRONICA MAYOR
19065628;Soltero;M;27;CHILENO;;Millenial;PROVIDENCIA                   ;METROPOLITANA;0;0;0;0;0;0;0;0;0;LED 40 KEHD4020 SMART TV;ELECTRONICA MAYOR
17771512;Soltero;M;30;CHILENO;PROFESOR;Millenial;PROVIDENCIA                   ;METROPOLITANA;0;0;0;0;0;0;0;0;0;LED 32 UN32T4300AGXZS HD SMART TV;ELECTRONICA MAYOR
19570058;;M;25;CHILENO;;Silencioso;PROVIDENCIA                   ;METROPOLITANA;0;0;0;0;0;0;0;0;0;LED 50 UN50TU7090GXZS UHD SMART TV;ELECTRONICA MAYOR
10453343;Casado;F;58;CHILENO;;Boomers;LONCOCHE                      ;ARAUCANIA;0;0;0;0;0;0;0;0;0;MINICOMPONENTE RN5;ELECTRONICA MAYOR
6763068;;F;68;CHILENO;;Boomers;N/D;N/D;0;0;0;0;0;0;0;0;0;LED 43 UN43T5202AGXZS FHD SMART TV;ELECTRONICA MAYOR
17988653;;F;30;CHILENO;;Millenial;CHILLAN                       ;BIO BIO;0;0;0;0;0;0;0;0;0;LED KIOTO 32 MI3228 SMART TV;ELECTRONICA MAYOR
20319719;;M;22;CHILENO;;Z;PROVIDENCIA                   ;METROPOLITANA;0;0;0;0;0;0;0;0;0;LED 40 KEHD4020 SMART TV;ELECTRONICA MAYOR
18531407;;M;28;CHILENO;;Millenial;SANTIAGO                      ;METROPOLITANA;0;0;0;0;0;0;0;0;0;LED KIOTO 32 MI3228 SMART TV;ELECTRONICA MAYOR
17293647;;M;33;CHILENO;;Silencioso;PROVIDENCIA                   ;METROPOLITANA;0;0;0;0;0;0;0;0;0;LED 32 UN32T4300AGXZS HD SMART TV;ELECTRONICA MAYOR
7989737;;F;51;CHILENO;;X;PENALOLEN                     ;METROPOLITANA;0;0;0;0;0;0;0;0;0;LED 32 UN32T4300AGXZS HD SMART TV;ELECTRONICA MAYOR
16443672;Soltero;M;35;CHILENO;;Silencioso;PROVIDENCIA                   ;METROPOLITANA;0;0;0;0;0;0;0;0;0;LED 43 43LM6300PSB SMART TV HD;ELECTRONICA MAYOR
11619358;;F;51;CHILENO;;X;COQUIMBO                      ;COQUIMBO;0;0;0;0;0;0;0;0;0;LED 40 KEHD4020 SMART TV;ELECTRONICA MAYOR
13130855;;F;45;CHILENO;;X;SAN NICOLAS                   ;BIO BIO;0;0;0;0;0;0;0;0;0;LED KIOTO 32 MI3228 SMART TV;ELECTRONICA MAYOR
18701054;Soltero;M;28;CHILENO;;Silencioso;PROVIDENCIA                   ;METROPOLITANA;0;0;0;0;0;0;0;0;0;LED 50 UN50TU7090GXZS UHD SMART TV;ELECTRONICA MAYOR
26539972;;M;36;VENEZOLANO;;Extranjero;VILLARICA                     ;ARAUCANIA;0;0;0;0;0;0;0;0;0;PARLANTE KARAOKE RM2 15 PULGADAS;ELECTRONICA MAYOR
25838333;;M;29;VENEZOLANO;;Extranjero;CONCEPCION                    ;BIO BIO;0;0;0;0;0;0;0;0;0;LED 43 UN43T5202AGXZS FHD SMART TV;ELECTRONICA MAYOR
15159214;;M;37;CHILENO;;Millenial;NINHUE                        ;BIO BIO;0;0;0;0;0;0;0;0;0;LED 55 55UN7100 UHD SMART TV;ELECTRONICA MAYOR
16562653;Soltero;F;35;CHILENO;ENFERMERA;Millenial;RENCA                         ;METROPOLITANA;0;0;0;0;0;0;0;0;0;LED 50 UN50TU7090GXZS UHD SMART TV;ELECTRONICA MAYOR
15498730;;F;39;CHILENO;;Extranjero;LOS ANGELES                   ;BIO BIO;0;0;0;0;0;0;0;0;0;LED 40 KEHD4020 SMART TV;ELECTRONICA MAYOR
18647322;;F;28;CHILENO;;Millenial;RANCAGUA                      ;L.G.B.OÂ´HIGGINS;0;0;0;0;0;0;0;0;0;LED 55 55UN7100 UHD SMART TV;ELECTRONICA MAYOR
13507244;;F;44;CHILENO;;X;PROVIDENCIA                   ;METROPOLITANA;0;0;0;0;0;0;0;0;0;LED 50 50PUD6513/44 SMART TV UHD 4K;ELECTRONICA MAYOR
4655882;;F;81;CHILENO;;Silencioso;MAIPU                         ;METROPOLITANA;0;0;0;0;0;0;0;0;0;LED 43 43LM6300PSB SMART TV HD;ELECTRONICA MAYOR
7674085;;F;64;CHILENO;;Boomers;LEBU                          ;BIO BIO;0;0;0;0;0;0;0;0;0;LED 49 49UN7100 UHD SMART TV;ELECTRONICA MAYOR
16134397;Soltero;M;36;CHILENO;;Millenial;PROVIDENCIA                   ;METROPOLITANA;0;0;0;0;0;0;0;0;0;LED 50 UN50TU7090GXZS UHD SMART TV;ELECTRONICA MAYOR
6151889;;F;72;CHILENO;;Silencioso;N/D;N/D;0;0;0;0;0;0;0;0;0;MINICOMPONENTE OL45;ELECTRONICA MAYOR
9384766;;M;45;CHILENO;;X;MAIPU;METROPOLITANA;0;0;0;0;0;0;0;0;0;LED 70 UN70AU7000GXZS UHD;ELECTRONICA MAYOR
17868472;;M;31;CHILENO;;Millenial;PROVIDENCIA                   ;METROPOLITANA;0;0;0;0;0;0;0;0;0;LED 40 KEHD4020 SMART TV;ELECTRONICA MAYOR
18427664;;F;29;CHILENO;;Millenial;OSORNO                        ;LOS LAGOS;0;0;0;0;0;0;0;0;0;LED 40 KEHD4020 SMART TV;ELECTRONICA MAYOR
17682752;;F;32;CHILENO;;Millenial;N/D;N/D;0;0;0;0;0;0;0;0;0;LED 50 KEUH50 SMART TV UHD;ELECTRONICA MAYOR
15594614;;F;38;CHILENO;;X;COQUIMBO                      ;COQUIMBO;0;0;0;0;0;0;0;0;0;LED 50 UN50TU7090GXZS UHD SMART TV;ELECTRONICA MAYOR
13843856;;F;42;CHILENO;;X;LOS ANGELES                   ;BIO BIO;0;0;0;0;0;0;0;0;0;LED 50 UN50TU7090GXZS UHD SMART TV;ELECTRONICA MAYOR
10916626;Casado;F;55;CHILENO;;Boomers;RENCA                         ;METROPOLITANA;0;0;0;0;0;0;0;0;0;LED 43 UN43TU7090GXZS UHD SMART TV;ELECTRONICA MAYOR
6962455;Viudo;F;66;CHILENO;;Boomers;EL BOSQUE                     ;METROPOLITANA;0;0;0;0;0;0;0;0;0;LED 43 UN43T5202AGXZS FHD SMART TV;ELECTRONICA MAYOR
22204042;;F;49;SALVADOREÃO;;Extranjero;PROVIDENCIA                   ;METROPOLITANA;0;0;0;0;0;0;0;0;0;LED 65 65UN7100 UHD SMART TV;ELECTRONICA MAYOR
13363636;;F;44;CHILENO;;X;N/D;N/D;0;0;0;0;0;0;0;0;0;LED 32 UN32T4300AGXZS HD SMART TV;ELECTRONICA MAYOR
20152304;;F;22;CHILENO;;Silencioso;PROVIDENCIA                   ;METROPOLITANA;0;0;0;0;0;0;0;0;0;LED 50 50PUD6513/44 SMART TV UHD 4K;ELECTRONICA MAYOR
26573093;;F;50;VENEZOLANO;;Extranjero;RENCA                         ;METROPOLITANA;0;0;0;0;0;0;0;0;0;LED 65 KUHK6520 UHD SMART TV;ELECTRONICA MAYOR
16977840;;M;33;CHILENO;;Millenial;PROVIDENCIA                   ;METROPOLITANA;0;0;0;0;0;0;0;0;0;MINICOMPONENTE RN7;ELECTRONICA MAYOR
10656746;Casado;F;53;CHILENO;SECRETARIA;X;PROVIDENCIA                   ;METROPOLITANA;0;0;0;0;0;0;0;0;0;LED 50 50PUD6513/44 SMART TV UHD 4K;ELECTRONICA MAYOR
15213763;;M;40;CHILENO;;X;MULCHEN                       ;BIO BIO;0;0;0;0;0;0;0;0;0;LED 32 32LM630BPSB SMART TV;ELECTRONICA MAYOR
18829329;Soltero;F;28;CHILENO;TECNICO EN TURISMO;Millenial;PROVIDENCIA                   ;METROPOLITANA;0;0;0;0;0;0;0;0;0;LED 32 32LM630BPSB SMART TV;ELECTRONICA MAYOR
13061474;Casado;M;45;CHILENO;;X;RENCA                         ;METROPOLITANA;0;0;0;0;0;0;0;0;0;LED 75 UN75TU6900GXZS UHD SMART TV;ELECTRONICA MAYOR
6179154;;F;77;CHILENO;;Silencioso;RENCA                         ;METROPOLITANA;0;0;0;0;0;0;0;0;0;LED 50 50PUD6513/44 SMART TV UHD 4K;ELECTRONICA MAYOR
19821538;;F;23;CHILENO;;Z;PROVIDENCIA                   ;METROPOLITANA;0;0;0;0;0;0;0;0;0;LED 43 43LM6300PSB SMART TV HD;ELECTRONICA MAYOR
15947981;;F;37;CHILENO;;Millenial;"";"";0;0;0;0;0;0;0;0;0;LED 55 55UN7100 UHD SMART TV;ELECTRONICA MAYOR
17787855;;M;31;CHILENO;;Silencioso;PROVIDENCIA                   ;METROPOLITANA;0;0;0;0;0;0;0;0;0;LED 43 UN43TU7090GXZS UHD SMART TV;ELECTRONICA MAYOR
19267373;;F;26;CHILENO;;Z;CALLE LARGA                   ;VALPARAISO;0;0;0;0;0;0;0;0;0;LED 50 KEUH50 SMART TV UHD;ELECTRONICA MAYOR
20433619;;F;22;CHILENO;;Z;PROVIDENCIA                   ;METROPOLITANA;0;0;0;0;0;0;0;0;0;LED 50 50PUD6513/44 SMART TV UHD 4K;ELECTRONICA MAYOR
8713731;;M;59;CHILENO;;Boomers;"";"";0;0;0;0;0;0;0;0;0;LED 50 50NANO79 NanoCell UHD SMART TV;ELECTRONICA MAYOR
19302793;Soltero;F;26;CHILENO;TECNICO DE NIVEL MEDIO EN ATENCION DE ENFERMERIA;Z;PROVIDENCIA                   ;METROPOLITANA;0;0;0;0;0;0;0;0;0;PARLANTE BOLA DISCO CON MICROFONO INAL;ELECTRONICA MAYOR
15200594;Casado;F;58;CHILENO;;Boomers;LOS ALAMOS                    ;BIO BIO;0;0;0;0;0;0;0;0;0;LED 40 KEHD4020 SMART TV;ELECTRONICA MAYOR
19768916;;M;25;CHILENO;;Z;PROVIDENCIA                   ;METROPOLITANA;0;0;0;0;0;0;0;0;0;LED 50 UN50TU7090GXZS UHD SMART TV;ELECTRONICA MAYOR
18781786;Soltero;M;28;CHILENO;TECNICO MECANICO;Millenial;PROVIDENCIA                   ;METROPOLITANA;0;0;0;0;0;0;0;0;0;LED 55 55UN7100 UHD SMART TV;ELECTRONICA MAYOR
15629782;;F;39;CHILENO;;X;TALCA                         ;MAULE;0;0;0;0;0;0;0;0;0;LED 65 KUHK6520 UHD SMART TV;ELECTRONICA MAYOR
17381249;;F;32;CHILENO;;Millenial;PROVIDENCIA                   ;METROPOLITANA;0;0;0;0;0;0;0;0;0;LED 32 UN32T4300AGXZS HD SMART TV;ELECTRONICA MAYOR
18786651;Soltero;F;27;CHILENO;TECNOLOGO MEDICO;Silencioso;PROVIDENCIA                   ;METROPOLITANA;0;0;0;0;0;0;0;0;0;LED 43 43S5295 SMART TV FHD;ELECTRONICA MAYOR
19522819;Soltero;F;25;CHILENO;;Silencioso;PROVIDENCIA                   ;METROPOLITANA;0;0;0;0;0;0;0;0;0;LED 43 43UN7300 UHD SMART TV 4K;ELECTRONICA MAYOR
13058418;Divorciado;F;46;CHILENO;;Silencioso;PROVIDENCIA                   ;METROPOLITANA;0;0;0;0;0;0;0;0;0;LED 43 43UN7300 UHD SMART TV 4K;ELECTRONICA MAYOR
13463466;;F;44;CHILENO;;X;PUDAHUEL                      ;METROPOLITANA;0;0;0;0;0;0;0;0;0;KARAOKE URBAN ROJO;ELECTRONICA MAYOR
15839889;;F;38;CHILENO;;Millenial;N/D;N/D;0;0;0;0;0;0;0;0;0;PARLANTE ULTRABUZZ;ELECTRONICA MAYOR
9084805;;M;58;CHILENO;;Boomers;PROVIDENCIA                   ;METROPOLITANA;0;0;0;0;0;0;0;0;0;LED 55 UN55TU7090GXZS SMART TV UHD;ELECTRONICA MAYOR
18866825;;M;27;CHILENO;;Z;PROVIDENCIA                   ;METROPOLITANA;0;0;0;0;0;0;0;0;0;LED 32 UN32T4300AGXZS HD SMART TV;ELECTRONICA MAYOR
10458259;Casado;F;51;CHILENO;;X;RENCA                         ;METROPOLITANA;0;0;0;0;0;0;0;0;0;LED 40 KEHD4020 SMART TV;ELECTRONICA MAYOR
8825172;;M;55;CHILENO;;Silencioso;PROVIDENCIA                   ;METROPOLITANA;0;0;0;0;0;0;0;0;0;LED 50 KEUH50 SMART TV UHD;ELECTRONICA MAYOR
15906024;;F;37;CHILENO;;Millenial;PROVIDENCIA                   ;METROPOLITANA;0;0;0;0;0;0;0;0;0;LED 58 KUHK5820 UHD SMART TV;ELECTRONICA MAYOR
4664659;;F;76;CHILENO;;Silencioso;VICTORIA                      ;ARAUCANIA;0;0;0;0;0;0;0;0;0;LED 32 UN32T4300AGXZS HD SMART TV;ELECTRONICA MAYOR
10894488;Casado;M;48;CHILENO;INGENIERO ELECTRONICO;Silencioso;PROVIDENCIA                   ;METROPOLITANA;0;0;0;0;0;0;0;0;0;LED 55 UN55TU7090GXZS SMART TV UHD;ELECTRONICA MAYOR
12466987;;M;49;CHILENO;;X;MAIPU                         ;METROPOLITANA;0;0;0;0;0;0;0;0;0;LED 32 UN32T4300AGXZS HD SMART TV;ELECTRONICA MAYOR
16331920;;M;35;CHILENO;;Millenial;SAN PEDRO DE ATACAMA          ;ANTOFAGASTA;0;0;0;0;0;0;0;0;0;MINICOMPONENTE MX-T70/ZS ALL IN ONE;ELECTRONICA MAYOR
14611375;Casado;M;41;CHILENO;;Silencioso;PROVIDENCIA                   ;METROPOLITANA;0;0;0;0;0;0;0;0;0;LED 32 UN32T4300AGXZS HD SMART TV;ELECTRONICA MAYOR
9907579;;F;43;CHILENO;;X;RENCA                         ;METROPOLITANA;0;0;0;0;0;0;0;0;0;LED 50 50UN8000 UHD SMART;ELECTRONICA MAYOR
18785649;Soltero;M;28;CHILENO;;Millenial;PROVIDENCIA                   ;METROPOLITANA;0;0;0;0;0;0;0;0;0;LED 49 49UN7100 UHD SMART TV;ELECTRONICA MAYOR
12996507;;M;46;CHILENO;;X;PUNTA ARENAS                  ;MAGALLANES;0;0;0;0;0;0;0;0;0;KARAOKE FUNKY DISCO;ELECTRONICA MAYOR
18368434;Soltero;M;29;CHILENO;TECNICO DE NIVEL SUPERIOR EN ENFERMERIA;Millenial;PROVIDENCIA                   ;METROPOLITANA;0;0;0;0;0;0;0;0;0;MAGIC REMOTE MR20GA;ELECTRONICA MAYOR
13516274;;F;44;CHILENO;;X;TEMUCO                        ;ARAUCANIA;0;0;0;0;0;0;0;0;0;LED KIOTO 32 MI3228 SMART TV;ELECTRONICA MAYOR
15413004;;F;40;CHILENO;;X;LAMPA                         ;METROPOLITANA;0;0;0;0;0;0;0;0;0;LED 50 50P615-50P ANDROID TV PASSION LINE UHD 4K;ELECTRONICA MAYOR
16930715;Soltero;M;34;CHILENO;;Millenial;PROVIDENCIA                   ;METROPOLITANA;0;0;0;0;0;0;0;0;0;LED 55 55NANO79 NanoCell UHD SMART TV;ELECTRONICA MAYOR
8181567;;F;62;CHILENO;;Boomers;PROVIDENCIA                   ;METROPOLITANA;0;0;0;0;0;0;0;0;0;LED KIOTO 32 MI3228 SMART TV;ELECTRONICA MAYOR
16844520;;F;33;CHILENO;;Millenial;RENCA                         ;METROPOLITANA;0;0;0;0;0;0;0;0;0;LED 32 UN32T4300AGXZS HD SMART TV;ELECTRONICA MAYOR
16527868;Casado;M;34;CHILENO;;Silencioso;PROVIDENCIA                   ;METROPOLITANA;0;0;0;0;0;0;0;0;0;LED 50 UN50TU7090GXZS UHD SMART TV;ELECTRONICA MAYOR
12935628;;F;47;CHILENO;;X;AISEN                         ;AYSEN;0;0;0;0;0;0;0;0;0;LED 43 43UN7300 UHD SMART TV 4K;ELECTRONICA MAYOR
16964131;Soltero;M;34;CHILENO;;Millenial;PROVIDENCIA                   ;METROPOLITANA;0;0;0;0;0;0;0;0;0;MONITOR 24 24TL520S SMART TV HD;ELECTRONICA MAYOR
11543148;;M;51;CHILENO;;X;PROVIDENCIA                   ;METROPOLITANA;0;0;0;0;0;0;0;0;0;LED 55 55UN7100 UHD SMART TV;ELECTRONICA MAYOR
12340123;Casado;M;49;CHILENO;;Silencioso;PROVIDENCIA                   ;METROPOLITANA;0;0;0;0;0;0;0;0;0;LED 43 43UN7300 UHD SMART TV 4K;ELECTRONICA MAYOR
8571043;;M;64;CHILENO;;Boomers;DALCAHUE                      ;LOS LAGOS;0;0;0;0;0;0;0;0;0;LED 50 50U6295 SMART TV UHD;ELECTRONICA MAYOR
7107348;;F;63;CHILENO;;Boomers;PROVIDENCIA                   ;METROPOLITANA;0;0;0;0;0;0;0;0;0;SISTEMA DE SONIDO LK72B;ELECTRONICA MAYOR
11995650;;F;50;CHILENO;;Silencioso;PROVIDENCIA                   ;METROPOLITANA;0;0;0;0;0;0;0;0;0;LED 55 UN55TU7090GXZS SMART TV UHD;ELECTRONICA MAYOR
11865543;;M;51;CHILENO;;X;N/D;N/D;0;0;0;0;0;0;0;0;0;LED 50 50PUD6513/44 SMART TV UHD 4K;ELECTRONICA MAYOR
12551308;;M;47;CHILENO;;X;RENCA                         ;METROPOLITANA;0;0;0;0;0;0;0;0;0;LED 43 43LM6300PSB SMART TV HD;ELECTRONICA MAYOR
16029722;Soltero;M;37;CHILENO;PROFESOR;Millenial;PROVIDENCIA                   ;METROPOLITANA;0;0;0;0;0;0;0;0;0;LED 32 32S5295 SMART TV HD;ELECTRONICA MAYOR
11639708;;F;51;CHILENO;;X;EL BOSQUE                     ;METROPOLITANA;0;0;0;0;0;0;0;0;0;LED 50 KEUH50 SMART TV UHD;ELECTRONICA MAYOR
19089131;;M;27;CHILENO;;Z;PROVIDENCIA                   ;METROPOLITANA;0;0;0;0;0;0;0;0;0;LED 65 KTUHD6520 4K SMART TV;ELECTRONICA MAYOR
17585432;;F;37;CHILENO;;Millenial;PROVIDENCIA                   ;METROPOLITANA;0;0;0;0;0;0;0;0;0;LED 43 43LM6300PSB SMART TV HD;ELECTRONICA MAYOR
13582754;Soltero;M;51;CHILENO;;X;PENALOLEN                     ;METROPOLITANA;0;0;0;0;0;0;0;0;0;LED 43 UN43T5202AGXZS FHD SMART TV;ELECTRONICA MAYOR
16312368;;F;36;CHILENO;;Millenial;PROVIDENCIA                   ;METROPOLITANA;0;0;0;0;0;0;0;0;0;LED 32 UN32T4300AGXZS HD SMART TV;ELECTRONICA MAYOR
15752897;;F;38;CHILENO;;Millenial;PROVIDENCIA                   ;METROPOLITANA;0;0;0;0;0;0;0;0;0;LED KIOTO 32 MI3228 SMART TV;ELECTRONICA MAYOR
16905415;;F;33;CHILENO;;Millenial;PROVIDENCIA                   ;METROPOLITANA;0;0;0;0;0;0;0;0;0;LED KIOTO 32 MI3228 SMART TV;ELECTRONICA MAYOR
25943095;;F;49;COLOMBIANO;;Extranjero;SANTIAGO                      ;METROPOLITANA;0;0;0;0;0;0;0;0;0;LED 50 50P615-50P ANDROID TV PASSION LINE UHD 4K;ELECTRONICA MAYOR
13887037;;F;42;CHILENO;;X;COPIAPO                       ;ATACAMA;0;0;0;0;0;0;0;0;0;LED 58 KUHK5820 UHD SMART TV;ELECTRONICA MAYOR
20101791;;F;23;CHILENO;;Z;PROVIDENCIA                   ;METROPOLITANA;0;0;0;0;0;0;0;0;0;LED KIOTO 32 MI3228 SMART TV;ELECTRONICA MAYOR
13369645;Casado;F;44;CHILENO;;X;COLINA                        ;METROPOLITANA;0;0;0;0;0;0;0;0;0;LED 65 65UN7100 UHD SMART TV;ELECTRONICA MAYOR
19607406;;F;25;CHILENO;;Z;QUELLON                       ;LOS LAGOS;0;0;0;0;0;0;0;0;0;LED KIOTO 32 MI3228 SMART TV;ELECTRONICA MAYOR
20254079;;M;22;CHILENO;;Z;PROVIDENCIA                   ;METROPOLITANA;0;0;0;0;0;0;0;0;0;SOUNDBAR HW-T400/ZS;ELECTRONICA MAYOR
9354123;;M;60;CHILENO;;Boomers;LA FLORIDA                    ;METROPOLITANA;0;0;0;0;0;0;0;0;0;LED 40 KEHD4020 SMART TV;ELECTRONICA MAYOR
17989609;;M;30;CHILENO;;Millenial;CHILLAN;BIO-BIO;0;0;0;0;0;0;0;0;0;SISTEMA DE SONIDO LK72B;ELECTRONICA MAYOR
17755318;;F;31;CHILENO;;Millenial;COIHUECO                      ;BIO BIO;0;0;0;0;0;0;0;0;0;LED 50 KEUH50 SMART TV UHD;ELECTRONICA MAYOR
17605595;Casado;M;31;CHILENO;;Millenial;PROVIDENCIA                   ;METROPOLITANA;0;0;0;0;0;0;0;0;0;LED KIOTO 32 MI3228 SMART TV;ELECTRONICA MAYOR
17308799;;M;32;CHILENO;;Millenial;LA FLORIDA                    ;METROPOLITANA;0;0;0;0;0;0;0;0;0;SOUNDBAR HW-T400/ZS;ELECTRONICA MAYOR
20123243;;F;22;CHILENO;;Z;BUIN;METROPOLITANA;0;0;0;0;0;0;0;0;0;MINICOMPONENTE CJ45;ELECTRONICA MAYOR
18421656;;F;28;CHILENO;;Millenial;N/D;N/D;0;0;0;0;0;0;0;0;0;LED 40 KEHD4020 SMART TV;ELECTRONICA MAYOR
13336504;;M;43;CHILENO;;X;SAN BERNARDO                  ;METROPOLITANA;0;0;0;0;0;0;0;0;0;LED KIOTO 32 MI3228 SMART TV;ELECTRONICA MAYOR
19060169;;F;25;CHILENO;;Z;PROVIDENCIA                   ;METROPOLITANA;0;0;0;0;0;0;0;0;0;PARLANTE BOLA DISCO CON MICROFONO INAL;ELECTRONICA MAYOR
19096889;Soltero;F;28;CHILENO;;Millenial;PROVIDENCIA                   ;METROPOLITANA;0;0;0;0;0;0;0;0;0;LED 58 KUHK5820 UHD SMART TV;ELECTRONICA MAYOR
17258256;;F;32;CHILENO;;Millenial;TUCAPEL                       ;BIO BIO;0;0;0;0;0;0;0;0;0;MONITOR 24 24TL520S SMART TV HD;ELECTRONICA MAYOR
19126532;;M;31;CHILENO;;Millenial;N/D;N/D;0;0;0;0;0;0;0;0;0;LED 55 UN55TU7090GXZS SMART TV UHD;ELECTRONICA MAYOR
9721145;;F;61;CHILENO;;Boomers;RENCA                         ;METROPOLITANA;0;0;0;0;0;0;0;0;0;LED 32 32S60-32P ANDROID TV SMART LINE HD;ELECTRONICA MAYOR
9709046;;F;62;CHILENO;;Boomers;COQUIMBO                      ;COQUIMBO;0;0;0;0;0;0;0;0;0;LED 32 32LM630BPSB SMART TV;ELECTRONICA MAYOR
13814243;;M;42;CHILENO;;X;VILLARICA                     ;ARAUCANIA;0;0;0;0;0;0;0;0;0;PARLANTE KARAOKE RM2 15 PULGADAS;ELECTRONICA MAYOR
15080263;;M;39;CHILENO;;X;QUILPUE                       ;VALPARAISO;0;0;0;0;0;0;0;0;0;LED 43 43LM6300PSB SMART TV HD;ELECTRONICA MAYOR
12741152;;F;47;CHILENO;;Boomers;TEMUCO                        ;ARAUCANIA;0;0;0;0;0;0;0;0;0;LED 40 KEHD4020 SMART TV;ELECTRONICA MAYOR
4578862;;M;80;CHILENO;;Silencioso;COIHAIQUE                     ;AYSEN;0;0;0;0;0;0;0;0;0;LED 32 32PHD5813 SMART TV HD;ELECTRONICA MAYOR
9509523;Casado;M;59;CHILENO;;Boomers;"";"";0;0;0;0;0;0;0;0;0;LED 32 UN32T4300AGXZS HD SMART TV;ELECTRONICA MAYOR
8085873;;F;65;CHILENO;;Boomers;PROVIDENCIA                   ;METROPOLITANA;0;0;0;0;0;0;0;0;0;LED 50 KEUH50 SMART TV UHD;ELECTRONICA MAYOR
19051591;;M;28;CHILENO;;Millenial;MULCHEN                       ;BIO BIO;0;0;0;0;0;0;0;0;0;LED 50 50U6295 SMART TV UHD;ELECTRONICA MAYOR
11554520;;M;52;CHILENO;;X;REQUINOA                      ;L.G.B.OÂ´HIGGINS;0;0;0;0;0;0;0;0;0;LED 55 UN55TU8300GXZS UHD SMART TV CURVO;ELECTRONICA MAYOR
17261216;;F;33;CHILENO;;Millenial;N/D;N/D;0;0;0;0;0;0;0;0;0;LED 50 50PUD6513/44 SMART TV UHD 4K;ELECTRONICA MAYOR
16764522;;M;34;CHILENO;;Millenial;PROVIDENCIA                   ;METROPOLITANA;0;0;0;0;0;0;0;0;0;LED 65 KTUHD6520 4K SMART TV;ELECTRONICA MAYOR
15216445;Soltero;F;39;CHILENO;;X;CHILLAN                       ;NUBLE;0;0;0;0;0;0;0;0;0;LED 43 UN43T5202AGXZS FHD SMART TV;ELECTRONICA MAYOR
22521005;;M;63;PERUANO;;Extranjero;ESTACION CENTRAL              ;METROPOLITANA;0;0;0;0;0;0;0;0;0;LED KIOTO 32 MI3228 SMART TV;ELECTRONICA MAYOR
13882963;Casado;F;41;CHILENO;GASTRONOMIA INTERNACIONAL;Silencioso;PROVIDENCIA                   ;METROPOLITANA;0;0;0;0;0;0;0;0;0;MONITOR 24 24TL520S SMART TV HD;ELECTRONICA MAYOR
18764528;;M;27;CHILENO;;Z;EL BOSQUE                     ;METROPOLITANA;0;0;0;0;0;0;0;0;0;LED 50 KEUH50 SMART TV UHD;ELECTRONICA MAYOR
6502201;;M;70;CHILENO;;Silencioso;ARAUCO                        ;BIO BIO;0;0;0;0;0;0;0;0;0;LED 43 CS43S1USM UHD SMART TV NEGRO;ELECTRONICA MAYOR
7611762;;F;63;CHILENO;;Boomers;COPIAPO                       ;ATACAMA;0;0;0;0;0;0;0;0;0;LED 55 UN55TU8300GXZS UHD SMART TV CURVO;ELECTRONICA MAYOR
16284167;;F;35;CHILENO;;Millenial;PROVIDENCIA                   ;METROPOLITANA;0;0;0;0;0;0;0;0;0;LED 50 UN50TU7090GXZS UHD SMART TV;ELECTRONICA MAYOR
6336862;;F;76;CHILENO;;Silencioso;PARRAL                        ;MAULE;0;0;0;0;0;0;0;0;0;MINICOMPONENTE CJ45;ELECTRONICA MAYOR
16305705;Soltero;M;36;CHILENO;;Millenial;PROVIDENCIA                   ;METROPOLITANA;0;0;0;0;0;0;0;0;0;LED 50 UN50TU7090GXZS UHD SMART TV;ELECTRONICA MAYOR
10581169;;F;56;CHILENO;;Boomers;N/D;N/D;0;0;0;0;0;0;0;0;0;LED 32 32LM630BPSB SMART TV;ELECTRONICA MAYOR
9725511;;F;56;CHILENO;;Boomers;CABILDO                       ;VALPARAISO;0;0;0;0;0;0;0;0;0;LED KIOTO 32 MI3228 SMART TV;ELECTRONICA MAYOR
15262835;Soltero;F;39;CHILENO;;X;PROVIDENCIA                   ;METROPOLITANA;0;0;0;0;0;0;0;0;0;LED 50 50NANO79 NanoCell UHD SMART TV;ELECTRONICA MAYOR
15751772;;F;38;CHILENO;;Millenial;N/D;N/D;0;0;0;0;0;0;0;0;0;LED 55 M7650 SMART TV ULTRA HD;ELECTRONICA MAYOR
8223213;Casado;F;65;CHILENO;;Boomers;OSORNO                        ;LOS LAGOS;0;0;0;0;0;0;0;0;0;LED 32 32PHD5813 SMART TV HD;ELECTRONICA MAYOR
11472264;;F;53;CHILENO;;X;NUNOA                         ;METROPOLITANA;0;0;0;0;0;0;0;0;0;LED 50 UN50TU7090GXZS UHD SMART TV;ELECTRONICA MAYOR
10540093;;F;55;CHILENO;;Boomers;VALPARAISO                    ;VALPARAISO;0;0;0;0;0;0;0;0;0;LED 58 58PUD6513/44 SMART TV UHD;ELECTRONICA MAYOR
18109630;;M;30;CHILENO;;Millenial;LEBU                          ;BIO BIO;0;0;0;0;0;0;0;0;0;LED 50 50U6295 SMART TV UHD;ELECTRONICA MAYOR
5581394;;M;77;CHILENO;;Silencioso;VILLA ALEGRE                  ;MAULE;0;0;0;0;0;0;0;0;0;LED 40 KEHD4020 SMART TV;ELECTRONICA MAYOR
10734793;Casado;M;55;CHILENO;TECNICO MECANICO;Boomers;RENCA                         ;METROPOLITANA;0;0;0;0;0;0;0;0;0;LED 58 KUHK5820 UHD SMART TV;ELECTRONICA MAYOR
16219236;;M;35;CHILENO;;Millenial;PROVIDENCIA                   ;METROPOLITANA;0;0;0;0;0;0;0;0;0;MINICOMPONENTE RN7;ELECTRONICA MAYOR
7201589;;M;66;CHILENO;;Boomers;QUINTERO                      ;VALPARAISO;0;0;0;0;0;0;0;0;0;LED 49 49UN7100 UHD SMART TV;ELECTRONICA MAYOR
12201658;;F;50;CHILENO;;X;N/D;N/D;0;0;0;0;0;0;0;0;0;LED 50 UN50TU7090GXZS UHD SMART TV;ELECTRONICA MAYOR
19609936;;F;25;CHILENO;;Z;CURICO                        ;MAULE;0;0;0;0;0;0;0;0;0;LED KIOTO 32 MI3228 SMART TV;ELECTRONICA MAYOR
8086801;;F;61;CHILENO;;Boomers;COQUIMBO                      ;COQUIMBO;0;0;0;0;0;0;0;0;0;LED 60 60UN7310 SMART TV UHD;ELECTRONICA MAYOR
15896096;;F;37;CHILENO;;Millenial;N/D;N/D;0;0;0;0;0;0;0;0;0;LED 40 KEHD4020 SMART TV;ELECTRONICA MAYOR
9588146;;F;60;CHILENO;;Boomers;SANTIAGO                      ;METROPOLITANA;0;0;0;0;0;0;0;0;0;LED 40 KEHD4020 SMART TV;ELECTRONICA MAYOR
20021183;;F;23;CHILENO;;Z;PROVIDENCIA                   ;METROPOLITANA;0;0;0;0;0;0;0;0;0;LED 40 KEHD4020 SMART TV;ELECTRONICA MAYOR
9533234;;F;61;CHILENO;;Boomers;ARICA                         ;ARICA Y PARINACOTA;0;0;0;0;0;0;0;0;0;LED 50 50P615-50P ANDROID TV PASSION LINE UHD 4K;ELECTRONICA MAYOR
14311825;;F;47;CHILENO;;X;RENCA                         ;METROPOLITANA;0;0;0;0;0;0;0;0;0;LED 40 KEHD4020 SMART TV;ELECTRONICA MAYOR
16072654;;F;36;CHILENO;;Millenial;QUELLON                       ;LOS LAGOS;0;0;0;0;0;0;0;0;0;LED 40 KEHD4020 SMART TV;ELECTRONICA MAYOR
12277628;;F;50;CHILENO;;X;PROVIDENCIA                   ;METROPOLITANA;0;0;0;0;0;0;0;0;0;LED 43 43S5295 SMART TV FHD;ELECTRONICA MAYOR
12575558;;F;47;CHILENO;;X;CALAMA                        ;ANTOFAGASTA;0;0;0;0;0;0;0;0;0;LED 40 KEHD4020 SMART TV;ELECTRONICA MAYOR
15039969;;F;42;CHILENO;;X;RENCA                         ;METROPOLITANA;0;0;0;0;0;0;0;0;0;MONITOR 24 24TL520S SMART TV HD;ELECTRONICA MAYOR
12366647;Soltero;F;49;CHILENO;;X;PROVIDENCIA                   ;METROPOLITANA;0;0;0;0;0;0;0;0;0;LED 32 UN32T4300AGXZS HD SMART TV;ELECTRONICA MAYOR
18800305;;M;27;CHILENO;;Millenial;SAN ROSENDO                   ;BIO BIO;0;0;0;0;0;0;0;0;0;LED 40 KEHD4020 SMART TV;ELECTRONICA MAYOR
14002900;;F;41;CHILENO;;X;RENCA                         ;METROPOLITANA;0;0;0;0;0;0;0;0;0;LED 43 UN43T5202AGXZS FHD SMART TV;ELECTRONICA MAYOR
10233475;;M;52;CHILENO;;X;RENCA                         ;METROPOLITANA;0;0;0;0;0;0;0;0;0;SOUNDBAR HW-Q70T/ZS;ELECTRONICA MAYOR
9605909;;M;57;CHILENO;;Boomers;PROVIDENCIA                   ;METROPOLITANA;0;0;0;0;0;0;0;0;0;PARLANTE FD-DJ530 DJ NEGRO;ELECTRONICA MAYOR
17881917;;M;30;CHILENO;;Millenial;TEMUCO                        ;ARAUCANIA;0;0;0;0;0;0;0;0;0;KARAOKE RHYTHM CHARGER 12 MIC CABLE 8890;ELECTRONICA MAYOR
9660137;;F;59;CHILENO;;Boomers;VILLA ALEMANA                 ;VALPARAISO;0;0;0;0;0;0;0;0;0;LED 50 50UN8000 UHD SMART;ELECTRONICA MAYOR
14522342;;M;45;CHILENO;;X;OSORNO                        ;LOS LAGOS;0;0;0;0;0;0;0;0;0;LED 43 UN43TU7090GXZS UHD SMART TV;ELECTRONICA MAYOR
8910242;;M;72;CHILENO;;Silencioso;NATALES                       ;MAGALLANES;0;0;0;0;0;0;0;0;0;LED 58 58PUD6513/44 SMART TV UHD;ELECTRONICA MAYOR
25071329;;F;30;COLOMBIANO;;Extranjero;MAIPU                         ;METROPOLITANA;0;0;0;0;0;0;0;0;0;KARAOKE 8 CITY SET MIC WIRELESS ATRIL SILVER;ELECTRONICA MAYOR
12690141;;F;47;CHILENO;;X;SAN MIGUEL                    ;METROPOLITANA;0;0;0;0;0;0;0;0;0;LED 32 UN32T4300AGXZS HD SMART TV;ELECTRONICA MAYOR
19142041;;M;27;CHILENO;;Z;SAN ANTONIO                   ;VALPARAISO;0;0;0;0;0;0;0;0;0;SOUNDBAR SK1;ELECTRONICA MAYOR
19186291;Soltero;F;26;CHILENO;ENFERMERA;Z;PROVIDENCIA                   ;METROPOLITANA;0;0;0;0;0;0;0;0;0;LED 32 UN32T4300AGXZS HD SMART TV;ELECTRONICA MAYOR
13490452;;M;43;CHILENO;;X;ANTOFAGASTA                   ;ANTOFAGASTA;0;0;0;0;0;0;0;0;0;LED 58 KTUHD5820 4K SMART TV;ELECTRONICA MAYOR
18443899;;F;29;CHILENO;;Millenial;RENCA                         ;METROPOLITANA;0;0;0;0;0;0;0;0;0;LED 32 32LM630BPSB SMART TV;ELECTRONICA MAYOR
18558434;;F;28;CHILENO;;Millenial;PROVIDENCIA                   ;METROPOLITANA;0;0;0;0;0;0;0;0;0;PARLANTE ULTRAMAGIC;ELECTRONICA MAYOR
11334434;;M;54;CHILENO;;X;PROVIDENCIA                   ;METROPOLITANA;0;0;0;0;0;0;0;0;0;KARAOKE BLACK PHANTER II;ELECTRONICA MAYOR
15676011;Casado;M;36;CHILENO;ADMINISTRADOR PUBLICO;Millenial;CAUQUENES                     ;MAULE;0;0;0;0;0;0;0;0;0;LED 55 UN55TU7090GXZS SMART TV UHD;ELECTRONICA MAYOR
9999848;;M;55;CHILENO;;Boomers;QUINTA NORMAL                 ;METROPOLITANA;0;0;0;0;0;0;0;0;0;LED 49 49LJ5100 FHD;ELECTRONICA MAYOR
13203496;Soltero;F;45;CHILENO;;X;RENCA                         ;METROPOLITANA;0;0;0;0;0;0;0;0;0;MLAB KARAOKE 8 CITY SET MICROFONO INALAMBRICO AT;ELECTRONICA MAYOR
10820978;Casado;M;52;CHILENO;;X;RENCA                         ;METROPOLITANA;0;0;0;0;0;0;0;0;0;LED 43 43LM6300PSB SMART TV HD;ELECTRONICA MAYOR
11344931;;F;53;CHILENO;;X;ANTOFAGASTA                   ;ANTOFAGASTA;0;0;0;0;0;0;0;0;0;LED 32 32PHD5813 SMART TV HD;ELECTRONICA MAYOR
14375447;;M;49;CHILENO;;X;QUIRIHUE                      ;BIO BIO;0;0;0;0;0;0;0;0;0;PARLANTE ULTRAMAGIC;ELECTRONICA MAYOR
9296963;Casado;F;62;CHILENO;AUXILIAR PARAMEDICO DE ENFERMERIA;Boomers;RENCA                         ;METROPOLITANA;0;0;0;0;0;0;0;0;0;LED 32 UN32T4300AGXZS HD SMART TV;ELECTRONICA MAYOR
12401384;;M;48;CHILENO;;X;SAN FELIPE                    ;VALPARAISO;0;0;0;0;0;0;0;0;0;LED 32 UN32T4300AGXZS HD SMART TV;ELECTRONICA MAYOR
13877257;;M;42;CHILENO;;X;VALPARAISO                    ;VALPARAISO;0;0;0;0;0;0;0;0;0;LED 43 UN43TU7090GXZS UHD SMART TV;ELECTRONICA MAYOR
15402871;;F;40;CHILENO;;X;PROVIDENCIA                   ;METROPOLITANA;0;0;0;0;0;0;0;0;0;KARAOKE ROJO 15 PULGADAS;ELECTRONICA MAYOR
17716157;;F;32;CHILENO;;Millenial;MARCHIHUE                     ;L.G.B.OÂ´HIGGINS;0;0;0;0;0;0;0;0;0;LED 32 32LK540 HD SMART;ELECTRONICA MAYOR
9331217;Divorciado;M;57;CHILENO;;Boomers;PROVIDENCIA                   ;METROPOLITANA;0;0;0;0;0;0;0;0;0;MINICOMPONENTE RN5;ELECTRONICA MAYOR
10340493;;M;55;CHILENO;;Boomers;RENCA                         ;METROPOLITANA;0;0;0;0;0;0;0;0;0;KARAOKE RHYTHM CHARGER 12 MIC CABLE 8890;ELECTRONICA MAYOR
16212984;Casado;M;35;CHILENO;;Millenial;PROVIDENCIA                   ;METROPOLITANA;0;0;0;0;0;0;0;0;0;LED 49 49UN7100 UHD SMART TV;ELECTRONICA MAYOR
13982758;;M;40;CHILENO;;X;LOS ANDES;VALPARAISO;0;0;0;0;0;0;0;0;0;KARAOKE RHYTHM CHARGER 12 MIC CABLE 8890;ELECTRONICA MAYOR
11281599;;F;54;CHILENO;;X;PROVIDENCIA                   ;METROPOLITANA;0;0;0;0;0;0;0;0;0;MINICOMPONENTE OK55 ALL IN ONE;ELECTRONICA MAYOR
9719066;;M;58;CHILENO;;Boomers;RENCA                         ;METROPOLITANA;0;0;0;0;0;0;0;0;0;MINICOMPONENTE OK55 ALL IN ONE;ELECTRONICA MAYOR
18360389;;M;29;CHILENO;;Millenial;SAN JAVIER                    ;MAULE;0;0;0;0;0;0;0;0;0;LED 49 49UN7100 UHD SMART TV;ELECTRONICA MAYOR
12517238;;M;48;CHILENO;;X;RANCAGUA                      ;L.G.B.OÂ´HIGGINS;0;0;0;0;0;0;0;0;0;PARLANTE BOLA DISCO CON MICROFONO INAL;ELECTRONICA MAYOR
16894853;;F;34;CHILENO;;Millenial;PROVIDENCIA                   ;METROPOLITANA;0;0;0;0;0;0;0;0;0;LED 43 UN43T5202AGXZS FHD SMART TV;ELECTRONICA MAYOR
13528232;;F;43;CHILENO;;X;ALTO HOSPICIO;TARAPACA;0;0;0;0;0;0;0;0;0;MINICOMPONENTE CJ45;ELECTRONICA MAYOR
12804336;;M;47;CHILENO;;X;VALLENAR;ATACAMA;0;0;0;0;0;0;0;0;0;LED 32 32PHD5813 SMART TV HD;ELECTRONICA MAYOR
12543224;;F;48;CHILENO;;X;TALCA                         ;MAULE;0;0;0;0;0;0;0;0;0;LED KIOTO 32 MI3228 SMART TV;ELECTRONICA MAYOR
17435323;;M;32;CHILENO;;Millenial;ANTOFAGASTA                   ;ANTOFAGASTA;0;0;0;0;0;0;0;0;0;MINICOMPONENTE MHC-GT7;ELECTRONICA MAYOR
17789405;;F;31;CHILENO;;Millenial;ARAUCO                        ;BIO BIO;0;0;0;0;0;0;0;0;0;LED 49 49UN7100 UHD SMART TV;ELECTRONICA MAYOR
6793267;;F;70;CHILENO;;Silencioso;RETIRO                        ;MAULE;0;0;0;0;0;0;0;0;0;PARLANTE ULTRAMEGA;ELECTRONICA MAYOR
6861111;;F;67;CHILENO;;Boomers;ARICA                         ;ARICA Y PARINACOTA;0;0;0;0;0;0;0;0;0;MINICOMPONENTE MHC-M40D/C;ELECTRONICA MAYOR
16120527;;F;37;CHILENO;;Millenial;PADRE HURTADO                 ;METROPOLITANA;0;0;0;0;0;0;0;0;0;MONITOR 24 24TL520S SMART TV HD;ELECTRONICA MAYOR
15687159;;M;38;CHILENO;;Millenial;"";"";0;0;0;0;0;0;0;0;0;LED 32 32S5295 SMART TV HD;ELECTRONICA MAYOR
13886606;;M;42;CHILENO;;X;PROVIDENCIA                   ;METROPOLITANA;0;0;0;0;0;0;0;0;0;LED 50 UN50TU7090GXZS UHD SMART TV;ELECTRONICA MAYOR
17044477;;M;33;CHILENO;;Millenial;PROVIDENCIA                   ;METROPOLITANA;0;0;0;0;0;0;0;0;0;LED 43 43LM6300PSB SMART TV HD;ELECTRONICA MAYOR
18090574;Casado;F;30;CHILENO;;Millenial;PROVIDENCIA                   ;METROPOLITANA;0;0;0;0;0;0;0;0;0;PARLANTE ULTRAMAGIC;ELECTRONICA MAYOR
10212148;;M;58;CHILENO;;Boomers;RENCA                         ;METROPOLITANA;0;0;0;0;0;0;0;0;0;PARLANTE ULTRAMEGA;ELECTRONICA MAYOR
18429914;;M;29;CHILENO;;Millenial;ALHUE                         ;METROPOLITANA;0;0;0;0;0;0;0;0;0;LED 58 58PUD6513/44 SMART TV UHD;ELECTRONICA MAYOR
5154781;;F;78;CHILENO;;Silencioso;RENCA                         ;METROPOLITANA;0;0;0;0;0;0;0;0;0;LED 43 43S5295 SMART TV FHD;ELECTRONICA MAYOR
9183930;;M;61;CHILENO;;Boomers;CALERA DE TANGO               ;METROPOLITANA;0;0;0;0;0;0;0;0;0;LED 49 49UN7100 UHD SMART TV;ELECTRONICA MAYOR
8309978;;F;58;CHILENO;;Boomers;QUILPUE                       ;VALPARAISO;0;0;0;0;0;0;0;0;0;KARAOKE RHYTHM CHARGER 12 MIC CABLE 8890;ELECTRONICA MAYOR
18335074;;M;29;CHILENO;;Millenial;SANTIAGO;METROPOLITANA;0;0;0;0;0;0;0;0;0;KARAOKE RHYTHM CHARGER 12 MIC CABLE 8890;ELECTRONICA MAYOR
7845416;;M;59;CHILENO;;Boomers;LA GRANJA                     ;METROPOLITANA;0;0;0;0;0;0;0;0;0;MINICOMPONENTE RN5;ELECTRONICA MAYOR
6568175;;F;69;CHILENO;;Silencioso;SAN ANTONIO                   ;VALPARAISO;0;0;0;0;0;0;0;0;0;LED 32 CS32S1 SMART TV HD NEGRO;ELECTRONICA MAYOR
10024099;Casado;M;58;CHILENO;;Boomers;PROVIDENCIA                   ;METROPOLITANA;0;0;0;0;0;0;0;0;0;LED 32 UN32T4300AGXZS HD SMART TV;ELECTRONICA MAYOR
15685276;;M;38;CHILENO;;X;N/D;N/D;0;0;0;0;0;0;0;0;0;LED 55 55UN7100 UHD SMART TV;ELECTRONICA MAYOR
16041260;;M;37;CHILENO;;Millenial;PROVIDENCIA                   ;METROPOLITANA;0;0;0;0;0;0;0;0;0;MONITOR 24 24TL520S SMART TV HD;ELECTRONICA MAYOR
14137488;;M;41;CHILENO;;X;RENCA                         ;METROPOLITANA;0;0;0;0;0;0;0;0;0;LED 40 40S65A-40P ANDROID TV SMART LINE FHD;ELECTRONICA MAYOR
7008426;;M;67;CHILENO;;Boomers;SAN FERNANDO                  ;L.G.B.OÂ´HIGGINS;0;0;0;0;0;0;0;0;0;LED 49 49UN7100 UHD SMART TV;ELECTRONICA MAYOR
10755763;;M;50;CHILENO;;X;RENCA                         ;METROPOLITANA;0;0;0;0;0;0;0;0;0;LED KIOTO 32 MI3228 SMART TV;ELECTRONICA MAYOR
12519240;;F;48;CHILENO;;X;RANCAGUA                      ;L.G.B.OÂ´HIGGINS;0;0;0;0;0;0;0;0;0;LED 55 55UN7100 UHD SMART TV;ELECTRONICA MAYOR
12971995;;F;45;CHILENO;;X;RENCA                         ;METROPOLITANA;0;0;0;0;0;0;0;0;0;LED 43 43LM6300PSB SMART TV HD;ELECTRONICA MAYOR
16895570;Casado;F;34;CHILENO;;Millenial;PROVIDENCIA                   ;METROPOLITANA;0;0;0;0;0;0;0;0;0;LED 32 32S5295 SMART TV HD;ELECTRONICA MAYOR
15947171;;M;36;CHILENO;;Millenial;RIO HURTADO                   ;COQUIMBO;0;0;0;0;0;0;0;0;0;LED 50 50PUD6513/44 SMART TV UHD 4K;ELECTRONICA MAYOR
17314071;Soltero;M;32;CHILENO;PSICOLOGO;Millenial;PROVIDENCIA                   ;METROPOLITANA;0;0;0;0;0;0;0;0;0;LED 43 UN43J5202AGXZS SMART TV FHD;ELECTRONICA MAYOR
19095288;;F;26;CHILENO;;Z;PUENTE ALTO                   ;METROPOLITANA;0;0;0;0;0;0;0;0;0;LED KIOTO 32 MI3228 SMART TV;ELECTRONICA MAYOR
11724152;Casado;F;51;CHILENO;;X;VICUNA                        ;COQUIMBO;0;0;0;0;0;0;0;0;0;LED 43 UN43TU7090GXZS UHD SMART TV;ELECTRONICA MAYOR
16996514;;F;33;CHILENO;;Millenial;N/D;N/D;0;0;0;0;0;0;0;0;0;LED 43 MI4328 SMART TV;ELECTRONICA MAYOR
10230413;;M;52;CHILENO;;X;RENCA                         ;METROPOLITANA;0;0;0;0;0;0;0;0;0;LED 55 55UN7100 UHD SMART TV;ELECTRONICA MAYOR
11748804;;M;52;CHILENO;;X;LA LIGUA                      ;VALPARAISO;0;0;0;0;0;0;0;0;0;LED KIOTO 32 MI3228 SMART TV;ELECTRONICA MAYOR
21907436;;F;42;BOLIVIANO;;Extranjero;ANTOFAGASTA                   ;ANTOFAGASTA;0;0;0;0;0;0;0;0;0;LED 43 UN43J5202AGXZS SMART TV FHD;ELECTRONICA MAYOR
14247246;Casado;M;48;CHILENO;;X;RENCA                         ;METROPOLITANA;0;0;0;0;0;0;0;0;0;LED 49 49LJ5100 FHD;ELECTRONICA MAYOR
16135176;;F;36;CHILENO;;Millenial;COIHAIQUE                     ;AYSEN;0;0;0;0;0;0;0;0;0;QLED 55 QN55LS03TAGXZS FRAME SMART TV;ELECTRONICA MAYOR
11779864;;M;52;CHILENO;;X;ANGOL                         ;ARAUCANIA;0;0;0;0;0;0;0;0;0;LED 55 55UN7100 UHD SMART TV;ELECTRONICA MAYOR
7838080;;F;62;CHILENO;;Boomers;RENCA                         ;METROPOLITANA;0;0;0;0;0;0;0;0;0;LED 49 49UN7100 UHD SMART TV;ELECTRONICA MAYOR
9622883;;F;61;CHILENO;;Boomers;CHIMBARONGO                   ;L.G.B.OÂ´HIGGINS;0;0;0;0;0;0;0;0;0;LED 49 49LJ5100 FHD;ELECTRONICA MAYOR
11983686;;M;49;CHILENO;;X;SAN PEDRO DE LA PAZ           ;BIO BIO;0;0;0;0;0;0;0;0;0;LED 32 UN32T4300AGXZS HD SMART TV;ELECTRONICA MAYOR
22533066;;M;36;PERUANO;;Extranjero;SAN PEDRO DE LA PAZ           ;BIO BIO;0;0;0;0;0;0;0;0;0;LED 65 UN65TU6900GXZS UHD SMART TV;ELECTRONICA MAYOR
17410966;;F;32;CHILENO;;Millenial;N/D;N/D;0;0;0;0;0;0;0;0;0;LED 55 UN55NU7095GXZS SMART TV TV 4K;ELECTRONICA MAYOR
11230494;;M;54;CHILENO;;X;SAN BERNARDO                  ;METROPOLITANA;0;0;0;0;0;0;0;0;0;LED 32 32LK540 HD SMART;ELECTRONICA MAYOR
11599242;;F;52;CHILENO;;X;COIHAIQUE                     ;AYSEN;0;0;0;0;0;0;0;0;0;LED 55 UN55NU7095GXZS SMART TV TV 4K;ELECTRONICA MAYOR
20137220;;M;23;CHILENO;;Millenial;N/D;N/D;0;0;0;0;0;0;0;0;0;PARLANTE ULTRAMAGIC;ELECTRONICA MAYOR
12895726;;M;48;CHILENO;;X;PADRE LAS CASAS               ;ARAUCANIA;0;0;0;0;0;0;0;0;0;LED 58 58PUD6513/44 SMART TV UHD;ELECTRONICA MAYOR
8826872;;F;59;CHILENO;;Boomers;COLINA                        ;METROPOLITANA;0;0;0;0;0;0;0;0;0;MINICOMPONENTE RN7;ELECTRONICA MAYOR
12698314;;F;48;CHILENO;;X;CANETE                        ;BIO BIO;0;0;0;0;0;0;0;0;0;LED 32 UN32T4300AGXZS HD SMART TV;ELECTRONICA MAYOR
11564540;Soltero;M;53;CHILENO;;X;RENCA                         ;METROPOLITANA;0;0;0;0;0;0;0;0;0;LED 32 UN32T4300AGXZS HD SMART TV;ELECTRONICA MAYOR
9211485;;M;61;CHILENO;;Boomers;PROVIDENCIA                   ;METROPOLITANA;0;0;0;0;0;0;0;0;0;LED 43 43NU7090 SMART TV 4K UHD;ELECTRONICA MAYOR
7319883;;M;64;CHILENO;;Boomers;LA LIGUA                      ;VALPARAISO;0;0;0;0;0;0;0;0;0;KARAOKE RHYTHM CHARGER 12 MIC CABLE 8890;ELECTRONICA MAYOR
4303029;;F;82;CHILENO;;Silencioso;RETIRO                        ;MAULE;0;0;0;0;0;0;0;0;0;LED 43 UN43J5202AGXZS SMART TV FHD;ELECTRONICA MAYOR
15449807;;M;40;CHILENO;;X;N/D;N/D;0;0;0;0;0;0;0;0;0;MINICOMPONENTE MHC-V02 ALL IN ONE;ELECTRONICA MAYOR
17776501;;M;32;CHILENO;;Millenial;PROVIDENCIA                   ;METROPOLITANA;0;0;0;0;0;0;0;0;0;LED 43 43LM6300PSB SMART TV HD;ELECTRONICA MAYOR
10896169;;F;55;CHILENO;;Boomers;LOS ANGELES                   ;BIO BIO;0;0;0;0;0;0;0;0;0;LED 43 UN43J5202AGXZS SMART TV FHD;ELECTRONICA MAYOR
13938694;Casado;M;42;CHILENO;;X;RENCA                         ;METROPOLITANA;0;0;0;0;0;0;0;0;0;LED 32 32D3000 HD DIGITAL DAILY LINE;ELECTRONICA MAYOR
17016757;;M;33;CHILENO;;Millenial;LA SERENA                     ;COQUIMBO;0;0;0;0;0;0;0;0;0;LED 49 49UN7100 UHD SMART TV;ELECTRONICA MAYOR
9620446;Casado;F;60;CHILENO;;Boomers;RENCA                         ;METROPOLITANA;0;0;0;0;0;0;0;0;0;LED 49 49LJ5100 FHD;ELECTRONICA MAYOR
25360481;;M;40;HAITIANO;;Extranjero;"";"";0;0;0;0;0;0;0;0;0;LED 43 UN43J5202AGXZS SMART TV FHD;ELECTRONICA MAYOR
23843172;;F;49;PERUANO;;Extranjero;SANTIAGO                      ;METROPOLITANA;0;0;0;0;0;0;0;0;0;LED 55 UN55NU7095GXZS SMART TV TV 4K;ELECTRONICA MAYOR
11939185;;M;50;CHILENO;;X;RENCA                         ;METROPOLITANA;0;0;0;0;0;0;0;0;0;LED 55 55UM7100 SMART TV UHD;ELECTRONICA MAYOR
16473598;;F;35;CHILENO;;Millenial;PROVIDENCIA                   ;METROPOLITANA;0;0;0;0;0;0;0;0;0;LED 43 43UN7300 UHD SMART TV 4K;ELECTRONICA MAYOR
6062044;;M;73;CHILENO;;Silencioso;RENCA                         ;METROPOLITANA;0;0;0;0;0;0;0;0;0;LED 43 43S5295 SMART TV FHD;ELECTRONICA MAYOR
10600394;;F;60;CHILENO;;Boomers;N/D;N/D;0;0;0;0;0;0;0;0;0;PARLANTE CITY MIC WIRELESS GREEN 8710;ELECTRONICA MAYOR
16455403;;F;35;CHILENO;;Millenial;TALCA                         ;MAULE;0;0;0;0;0;0;0;0;0;LED 32 32PHD5813 SMART TV HD;ELECTRONICA MAYOR
15191369;;M;35;CHILENO;;Millenial;TALCAHUANO                    ;BIO BIO;0;0;0;0;0;0;0;0;0;LED 50 UN50TU7090GXZS UHD SMART TV;ELECTRONICA MAYOR
12759948;;M;47;CHILENO;;X;QUEMCHI                       ;LOS LAGOS;0;0;0;0;0;0;0;0;0;KARAOKE BLACK PHANTER II;ELECTRONICA MAYOR
10183426;;F;57;CHILENO;;Boomers;N/D;N/D;0;0;0;0;0;0;0;0;0;PARLANTE CITY MIC WIRELESS GREEN 8710;ELECTRONICA MAYOR
17714824;;F;31;CHILENO;;Millenial;ANCUD                         ;LOS LAGOS;0;0;0;0;0;0;0;0;0;LED 55 UN55NU7095GXZS SMART TV TV 4K;ELECTRONICA MAYOR
18454068;;F;29;CHILENO;;Millenial;N/D;N/D;0;0;0;0;0;0;0;0;0;LED KIOTO 32 MI3228 SMART TV;ELECTRONICA MAYOR
13985171;;F;41;CHILENO;;X;MAIPU                         ;METROPOLITANA;0;0;0;0;0;0;0;0;0;LED 32 CS32S1 SMART TV HD NEGRO;ELECTRONICA MAYOR
8159532;;F;57;CHILENO;;Boomers;TOME                          ;BIO BIO;0;0;0;0;0;0;0;0;0;LED 65 UN65TU7100GXZS UHD 4K CRYSTAL;ELECTRONICA MAYOR
9835154;Soltero;F;58;CHILENO;;Boomers;PROVIDENCIA                   ;METROPOLITANA;0;0;0;0;0;0;0;0;0;MINICOMPONENTE OL45;ELECTRONICA MAYOR
12545101;Soltero;M;48;CHILENO;;X;RENCA                         ;METROPOLITANA;0;0;0;0;0;0;0;0;0;PARLANTE ULTRAFORCE-I;ELECTRONICA MAYOR
17633137;;M;31;CHILENO;;Millenial;ANCUD                         ;LOS LAGOS;0;0;0;0;0;0;0;0;0;LED 43 UN43J5202AGXZS SMART TV FHD;ELECTRONICA MAYOR
18788265;Casado;M;25;CHILENO;;Z;ALTO HOSPICIO;TARAPACA;0;0;0;0;0;0;0;0;0;LED 50 UN50TU7090GXZS UHD SMART TV;ELECTRONICA MAYOR
6916307;;F;68;CHILENO;;Silencioso;ARICA                         ;ARICA Y PARINACOTA;0;0;0;0;0;0;0;0;0;LED 32 32S5295 SMART TV HD;ELECTRONICA MAYOR
18865425;;F;26;CHILENO;;Z;PROVIDENCIA                   ;METROPOLITANA;0;0;0;0;0;0;0;0;0;LED 32 32PHD5813 SMART TV HD;ELECTRONICA MAYOR
11738942;;F;51;CHILENO;;X;COLINA                        ;METROPOLITANA;0;0;0;0;0;0;0;0;0;LED 43 MI4328 SMART TV;ELECTRONICA MAYOR
17091132;;F;33;CHILENO;;Millenial;RETIRO                        ;MAULE;0;0;0;0;0;0;0;0;0;LED 43 MI4328 SMART TV;ELECTRONICA MAYOR
16667575;;M;34;CHILENO;;Millenial;EL BOSQUE                     ;METROPOLITANA;0;0;0;0;0;0;0;0;0;LED 50 MI50291 SMART TV 4K;ELECTRONICA MAYOR
25779738;;F;36;VENEZOLANO;;Extranjero;NUNOA                         ;METROPOLITANA;0;0;0;0;0;0;0;0;0;LED 50 UN50TU7090GXZS UHD SMART TV;ELECTRONICA MAYOR
12793195;;M;47;CHILENO;;X;MAULE                         ;MAULE;0;0;0;0;0;0;0;0;0;LED 32 32PHD5813 SMART TV HD;ELECTRONICA MAYOR
9464792;;M;59;CHILENO;;Boomers;TALCAHUANO                    ;BIO BIO;0;0;0;0;0;0;0;0;0;LED 43 43S5295 SMART TV FHD;ELECTRONICA MAYOR
10255505;;M;53;CHILENO;;X;RENCA                         ;METROPOLITANA;0;0;0;0;0;0;0;0;0;PARLANTE DJ VIBRANIUM;ELECTRONICA MAYOR
15377870;Casado;M;40;CHILENO;PROFESOR;X;PROVIDENCIA                   ;METROPOLITANA;0;0;0;0;0;0;0;0;0;LED 32 32LM630BPSB SMART TV;ELECTRONICA MAYOR
22447166;;M;42;PERUANO;;Extranjero;N/D;N/D;0;0;0;0;0;0;0;0;0;LED 75 UN75TU8200GXZS SMART TV 4K UHD;ELECTRONICA MAYOR
15068408;Soltero;M;40;CHILENO;;X;PROVIDENCIA                   ;METROPOLITANA;0;0;0;0;0;0;0;0;0;LED 43 43UN7300 UHD SMART TV 4K;ELECTRONICA MAYOR
17609799;;F;31;CHILENO;;Millenial;RENCA                         ;METROPOLITANA;0;0;0;0;0;0;0;0;0;LED 50 50UN8000 UHD SMART;ELECTRONICA MAYOR
14704037;Soltero;M;33;PERUANO;INGENIERIA EN MAQUINARIA VEHICULOS AUTOMOTRICES Y SISTEMAS ELECTRONICOS;Millenial;PROVIDENCIA                   ;METROPOLITANA;0;0;0;0;0;0;0;0;0;SOUNDBAR HW-Q70T/ZS;ELECTRONICA MAYOR
11972427;;F;51;CHILENO;;X;FREIRE                        ;ARAUCANIA;0;0;0;0;0;0;0;0;0;KARAOKE ROJO 15 PULGADAS;ELECTRONICA MAYOR
10469632;;M;56;CHILENO;;Boomers;PROVIDENCIA                   ;METROPOLITANA;0;0;0;0;0;0;0;0;0;LED 50 50U6295 SMART TV UHD;ELECTRONICA MAYOR
5537506;;F;74;CHILENO;;Silencioso;RENCA                         ;METROPOLITANA;0;0;0;0;0;0;0;0;0;LED 43 MI4328 SMART TV;ELECTRONICA MAYOR
13049963;;M;46;CHILENO;;X;PROVIDENCIA                   ;METROPOLITANA;0;0;0;0;0;0;0;0;0;LED 32 CS32S1 SMART TV HD NEGRO;ELECTRONICA MAYOR
13614470;Soltero;F;42;CHILENO;;X;RENCA                         ;METROPOLITANA;0;0;0;0;0;0;0;0;0;LED 55 UN55RU7300GXZS SMART TV UHD;ELECTRONICA MAYOR
9000608;;F;61;CHILENO;;Boomers;PROVIDENCIA                   ;METROPOLITANA;0;0;0;0;0;0;0;0;0;LED 32 32LM630BPSB SMART TV;ELECTRONICA MAYOR
12326121;;F;49;CHILENO;;X;LOS ANGELES                   ;BIO BIO;0;0;0;0;0;0;0;0;0;MNICOMPONENTE OM7560;ELECTRONICA MAYOR
6094470;Casado;M;73;CHILENO;;Silencioso;RENCA                         ;METROPOLITANA;0;0;0;0;0;0;0;0;0;LED 43 43LM6300PSB SMART TV HD;ELECTRONICA MAYOR
16375682;;F;35;CHILENO;;Millenial;PROVIDENCIA                   ;METROPOLITANA;0;0;0;0;0;0;0;0;0;LED 43 43LM6300PSB SMART TV HD;ELECTRONICA MAYOR
14074498;;M;41;CHILENO;;X;PROVIDENCIA                   ;METROPOLITANA;0;0;0;0;0;0;0;0;0;LED 43 MI4328 SMART TV;ELECTRONICA MAYOR
22655339;;M;40;PERUANO;;Extranjero;SANTIAGO                      ;METROPOLITANA;0;0;0;0;0;0;0;0;0;LED 50 UN50TU7090GXZS UHD SMART TV;ELECTRONICA MAYOR
24089858;;F;28;COLOMBIANO;;Extranjero;ANTOFAGASTA                   ;ANTOFAGASTA;0;0;0;0;0;0;0;0;0;KARAOKE STREET3 8 CON MICROFONO ORANGE;ELECTRONICA MAYOR
15146845;;M;39;CHILENO;;X;PELLUHUE                      ;MAULE;0;0;0;0;0;0;0;0;0;MINICOMPONENTE MHC-V02 ALL IN ONE;ELECTRONICA MAYOR
