CUSTOMER_ID;ESTADO_CIVIL;SEXO;EDAD;NACIONALIDAD;PROFESION;GENERACION_CLIENTE;COMUNA_CLIENTE;CIUDAD_CLIENTE;SUMA_INGRESOS_12;CANTIDAD_PRODUCTOS_12;SUMA_BOLETAS_12;CANTIDAD_UNIDADES_ECOMMERCE_12;SUMA_BOLETAS_ECOMMERCE_12;SUMA_INGRESOS_ECOMMERCE_12;CANTIDAD_UNIDADES_TIENDA_12;SUMA_BOLETAS_TIENDA_12;SUMA_INGRESOS_TIENDA_12;ULTIMO_PRODUCTO_COMPRADO;LINEA_ULTIMO_PRODUCTO_COMPRDO
14732590;;F;62;CHILENO;;Boomers;ISLA DE MAIPO                 ;METROPOLITANA;834320;6;2;0;0;0;6;2;834320;Lavadora WT16DSBP 16Kg Silver;LINEA BLANCA
8015643;;M;64;CHILENO;;Boomers;RENCA                         ;METROPOLITANA;196980;2;1;0;0;0;2;1;196980;Lavadora 9,5Kg BZG Blanca;LINEA BLANCA
12059241;;M;53;CHILENO;;X;SANTIAGO                      ;METROPOLITANA;189980;2;1;2;1;189980;0;0;0;Lavadora WA80H4200SW1ZS 8Kg Blanca;LINEA BLANCA
13400240;;F;44;CHILENO;;X;PANGUIPULLI                   ;LOS LAGOS;1233730;11;7;0;0;0;11;7;1233730;Lavadora Efficace SZG 17,5Kg Silver;LINEA BLANCA
18220846;;M;30;CHILENO;;Millenial;N/D;N/D;843950;11;3;0;0;0;11;3;843950;Lavadora WT19DSBP 19Kg Silver;LINEA BLANCA
7069523;;F;69;CHILENO;;Silencioso;IQUIQUE                       ;TARAPACA;199980;2;2;0;0;0;2;2;199980;Lavadora Semiautomatica LC-6550 6,5Kg;LINEA BLANCA
10049694;;F;58;CHILENO;;Boomers;"";"";218620;4;1;0;0;0;4;1;218620;Lavadora MLS-090GE04N 9Kg Gris;LINEA BLANCA
17143722;;F;33;CHILENO;;Millenial;PROVIDENCIA                   ;METROPOLITANA;1315940;9;3;9;3;1315940;0;0;0;Lavadora Efficace SZG 17,5Kg Silver;LINEA BLANCA
6604249;Casado;F;70;CHILENO;;Silencioso;PROVIDENCIA                   ;METROPOLITANA;333980;2;1;0;0;0;2;1;333980;Lavadora Efficace SZG 19,5Kg Silver;LINEA BLANCA
6107314;;M;73;CHILENO;;Silencioso;RENCA                         ;METROPOLITANA;266980;2;1;0;0;0;2;1;266980;Lavadora Efficace SZG 17,5Kg Silver;LINEA BLANCA
16195848;;F;36;CHILENO;;Millenial;GORBEA;ARAUCANIA;256960;4;2;4;2;256960;0;0;0;Horno Elect Empotrable 66Lts M SPAZIO 110 A Negr;LINEA BLANCA
7012216;;M;65;CHILENO;;Boomers;LAMPA                         ;METROPOLITANA;199883;5;3;0;0;0;5;3;199883;Calefont 10Lts GL Essenetial ECO;LINEA BLANCA
13368945;;M;43;CHILENO;;X;RENCA                         ;METROPOLITANA;339980;2;2;0;0;0;2;2;339980;Lavadora MLS-090GE04N 9Kg Gris;LINEA BLANCA
12218709;;M;50;CHILENO;;X;COPIAPO                       ;ATACAMA;502950;7;2;7;2;502950;0;0;0;Lavadora Efficace SZG 17,5Kg Silver;LINEA BLANCA
12742099;;F;47;CHILENO;;X;N/D;N/D;845080;8;7;0;0;0;8;7;845080;Freezer 145 Lts FDHM150BY0 Horizontal;LINEA BLANCA
17282378;;F;32;CHILENO;;Millenial;BUIN                          ;METROPOLITANA;609970;3;2;0;0;0;3;2;609970;Cocina MCG-4QI24NS 4P;LINEA BLANCA
19848808;;F;24;CHILENO;;Z;TALAGANTE;METROPOLITANA;1107920;7;5;7;5;1107920;0;0;0;Secadora Ropa MSC-90 9K Blanca Condensacion;LINEA BLANCA
7479635;;F;66;CHILENO;;Boomers;PROVIDENCIA                   ;METROPOLITANA;833960;4;2;0;0;0;4;2;833960;Refrigerador 527Lts Side by Side MRSBS5300G689WE;LINEA BLANCA
14020370;;F;41;CHILENO;;X;SAN JAVIER                    ;MAULE;1563777;14;5;0;0;0;14;5;1563777;Lavadora Efficace SZG 17,5Kg Silver;LINEA BLANCA
17238570;;M;34;CHILENO;;Millenial;"";"";584150;9;3;0;0;0;9;3;584150;Secadora 7Kg 7D BZG Ventilacion Blanca;LINEA BLANCA
15508665;;F;38;CHILENO;;Millenial;N/D;N/D;1920990;17;7;0;0;0;17;7;1920990;Refrigerador 527Lts Side by Side MRSBS5300G689WE;LINEA BLANCA
15147636;Soltero;F;40;CHILENO;;X;RENCA                         ;METROPOLITANA;196980;2;1;0;0;0;2;1;196980;Lavadora Semiautomatica Twister 5300 4Kg;LINEA BLANCA
11603807;;F;54;CHILENO;;X;PROVIDENCIA                   ;METROPOLITANA;191790;2;1;0;0;0;2;1;191790;Freezer 99Lts MFH-1000B131CN Horizontal;LINEA BLANCA
13798350;;M;45;CHILENO;;X;N/D;N/D;531900;11;7;6;3;427940;5;4;103960;Freezer 160 Lts MFV-1600B208FN vertical;LINEA BLANCA
5471530;;M;74;CHILENO;;Silencioso;RENCA                         ;METROPOLITANA;310280;3;1;0;0;0;3;1;310280;Lavadora Efficace SZG 17,5Kg Silver;LINEA BLANCA
7329889;;F;66;CHILENO;;Boomers;PROVIDENCIA                   ;METROPOLITANA;249972;3;3;2;1;209980;1;2;39992;Freezer Vertical 157Lts FF-211VSM Silver;LINEA BLANCA
13282701;;M;44;CHILENO;;X;"";"";279990;1;1;0;0;0;1;1;279990;Refrigerador 290LTS No Frost RMB302PXLRS0;LINEA BLANCA
16766287;Soltero;F;34;CHILENO;PROFESOR;Millenial;PROVIDENCIA                   ;METROPOLITANA;138980;2;1;2;1;138980;0;0;0;Centrifuga Primma 5B 5,5Kilos;LINEA BLANCA
18451612;;M;29;CHILENO;;Millenial;N/D;N/D;486930;7;4;2;1;19980;5;3;466950;Cocina MCG-4QI24NS 4P;LINEA BLANCA
12368570;;F;48;CHILENO;;X;PAREDONES                     ;L.G.B.OÂ´HIGGINS;319270;3;1;0;0;0;3;1;319270;Lavadora Efficace SZG 17,5Kg Silver;LINEA BLANCA
18889052;Soltero;F;26;CHILENO;;Z;PROVIDENCIA                   ;METROPOLITANA;159990;1;1;1;1;159990;0;0;0;Secadora 7Kg 7D BZG Ventilacion Blanca;LINEA BLANCA
22336818;;F;40;CHILENO;;Extranjero;"";"";2850150;19;9;11;4;1474880;8;5;1375270;Lavadora 9,5Kg BZG Blanca;LINEA BLANCA
11647221;;F;51;CHILENO;;X;RENCA                         ;METROPOLITANA;542950;5;3;0;0;0;5;3;542950;Lavadora WA80H4200SW1ZS 8Kg Blanca;LINEA BLANCA
5768629;Casado;M;71;CHILENO;;Silencioso;RENCA                         ;METROPOLITANA;289990;1;1;0;0;0;1;1;289990;Lavadora WA13T5260BW/ZS 13Kg Blanca;LINEA BLANCA
9159345;;F;56;CHILENO;;Boomers;RENCA                         ;METROPOLITANA;273970;3;1;3;1;273970;0;0;0;Lavadora Efficace SZG 17,5Kg Silver;LINEA BLANCA
16449278;;F;35;CHILENO;;Millenial;CASTRO                        ;LOS LAGOS;1975280;11;6;0;0;0;11;6;1975280;Refrigerador 244Lts Frio Directo Progress 3100;LINEA BLANCA
19712800;;F;23;CHILENO;;X;PROVIDENCIA                   ;METROPOLITANA;340370;2;1;0;0;0;2;1;340370;Refrigerador 260Lts BF Frio Direc MRFI2660SR346W;LINEA BLANCA
13157071;;F;45;CHILENO;;X;TEMUCO                        ;ARAUCANIA;374970;3;2;0;0;0;3;2;374970;Refrigerador 250 Lts No Frost RMA255PYUU;LINEA BLANCA
17780011;;F;31;CHILENO;;Millenial;PROVIDENCIA                   ;METROPOLITANA;389980;2;1;2;1;389980;0;0;0;Refrigerador 468L No Frost RGE-X49DF C/ Disp Neg;LINEA BLANCA
7825510;;F;64;CHILENO;;Boomers;SANTIAGO                      ;METROPOLITANA;429511;4;4;2;1;289980;2;3;139531;Refrigerador 290LTS No Frost RMB302PXLRS0;LINEA BLANCA
16761876;Soltero;F;34;CHILENO;PROFESOR;Millenial;PROVIDENCIA                   ;METROPOLITANA;467980;2;1;0;0;0;2;1;467980;Refrigerador 341Lts BF No Frost GB37MPD;LINEA BLANCA
25848454;Casado;F;30;VENEZOLANO;;Millenial;PROVIDENCIA                   ;METROPOLITANA;389980;2;1;2;1;389980;0;0;0;Lavadora Secadora MLSF-13510SC01I 13,5Kg/10Kg Gr;LINEA BLANCA
13492162;;F;44;CHILENO;;X;PUENTE ALTO                   ;METROPOLITANA;1341890;11;5;0;0;0;11;5;1341890;Refrigerador 244Lts Frio Directo Progress 3100;LINEA BLANCA
6900901;;M;80;CHILENO;;Silencioso;HUALPEN;BIO BIO;518170;6;2;0;0;0;6;2;518170;Lavadora Efficace BZG 11,5Kg Blanca;LINEA BLANCA
15188757;;M;40;CHILENO;;X;CHILLAN                       ;BIO BIO;269990;1;1;0;0;0;1;1;269990;Lavadora Efficace SZG 17,5Kg Silver;LINEA BLANCA
11937597;;M;50;CHILENO;;X;N/D;N/D;589450;5;3;0;0;0;5;3;589450;Lavadora Efficace SZG 19,5Kg Silver;LINEA BLANCA
7270321;;M;69;CHILENO;;Silencioso;PUENTE ALTO                   ;METROPOLITANA;330360;3;1;0;0;0;3;1;330360;Refrigerador 252Lts No Frost MRFS-2700G333FW;LINEA BLANCA
19801464;;M;24;CHILENO;;Silencioso;PROVIDENCIA                   ;METROPOLITANA;299980;2;1;0;0;0;2;1;299980;Refrigerador 244Lts Frio Directo Progress 3100;LINEA BLANCA
18331147;;F;28;CHILENO;;Millenial;CONSTITUCION                  ;MAULE;424980;2;2;0;0;0;2;2;424980;Refrigerador 254Lts No Frost GT29WPPDC;LINEA BLANCA
8637732;;M;64;CHILENO;;Boomers;EL BOSQUE;METROPOLITANA;279980;2;1;2;1;279980;0;0;0;Lavadora Secadora MF100D110B/T 11Kg/8KG Gris;LINEA BLANCA
12989302;;F;47;CHILENO;;X;PROVIDENCIA                   ;METROPOLITANA;272970;3;3;0;0;0;3;3;272970;Calefont 8Lts GL Essenetial ECO;LINEA BLANCA
16292737;;F;36;CHILENO;;Millenial;CAUQUENES                     ;MAULE;1266620;13;7;0;0;0;13;7;1266620;Lavadora MLS-090GE04N 9Kg Gris;LINEA BLANCA
19939317;;F;23;CHILENO;;Z;CAUQUENES                     ;MAULE;1354880;12;4;0;0;0;12;4;1354880;Cocina M 920 T 5P Silver;LINEA BLANCA
18965458;;F;27;CHILENO;;Z;N/D;N/D;1276140;21;9;4;2;702960;17;7;573180;Refrigerador 432Lts Side by Side MDRS619FGE46;LINEA BLANCA
15947644;;F;37;CHILENO;;Millenial;ARICA                         ;TARAPACA;191380;2;1;0;0;0;2;1;191380;Lavadora Semiautomatica Twister 5100 4Kg;LINEA BLANCA
6224685;;F;67;CHILENO;;Boomers;QUINCHAO                      ;LOS LAGOS;461960;4;3;0;0;0;4;3;461960;Refrigerador 300Lts No Frost RT29K500JS8/ZS;LINEA BLANCA
15730132;;F;48;CHILENO;;X;QUILICURA                     ;METROPOLITANA;289980;2;1;0;0;0;2;1;289980;Refrigerador MDRB424FGE46 302 Lts No Frost;LINEA BLANCA
15042566;;M;38;CHILENO;;Millenial;PROVIDENCIA                   ;METROPOLITANA;361790;5;4;1;1;189990;4;3;171800;Lavadora Semiautomatica Twister 5300 4Kg;LINEA BLANCA
24822463;;M;29;HAITIANO;;Extranjero;SANTIAGO                      ;METROPOLITANA;189980;2;1;2;1;189980;0;0;0;Refrigerador 167Lts Frio Directo 1700-S;LINEA BLANCA
13365259;;M;44;CHILENO;;X;CALERA                        ;VALPARAISO;1094950;5;4;0;0;0;5;4;1094950;Lavadora MLS-190GC03N 19Kg Gris;LINEA BLANCA
17300356;;F;32;CHILENO;;Millenial;N/D;N/D;234000;0;3;-1;2;4010;1;1;229990;Refrigerador 180Lts BF Frio Directo MDRB275FGF42;LINEA BLANCA
5672667;;F;77;CHILENO;;Silencioso;RENCA                         ;METROPOLITANA;179990;1;1;0;0;0;1;1;179990;Secadora 7Kg 7D BZG Ventilacion Blanca;LINEA BLANCA
18676672;;M;31;CHILENO;;Millenial;CARTAGENA                     ;VALPARAISO;379990;4;2;2;1;129990;2;1;250000;Calefont 10Lts GL Essenetial ECO;LINEA BLANCA
12400958;;F;48;CHILENO;;X;SANTA MARIA                   ;VALPARAISO;234980;2;1;0;0;0;2;1;234980;Secadora 9 Kg 9D BZG Ventilacion Blanca;LINEA BLANCA
17918067;;F;30;CHILENO;;Millenial;"";"";259990;1;1;0;0;0;1;1;259990;Lavadora MLS-160BSC03T 16Kg Blanca;LINEA BLANCA
19478496;;F;25;CHILENO;;Millenial;N/D;N/D;174980;2;1;0;0;0;2;1;174980;Secadora Ropa MD100A90/W 9Kg Ventilacion Blanca;LINEA BLANCA
16444946;;F;36;CHILENO;;Millenial;PROVIDENCIA                   ;METROPOLITANA;157130;2;1;0;0;0;2;1;157130;CENTRIFUGA C-752;LINEA BLANCA
16457022;;F;35;CHILENO;;Millenial;TALCA                         ;MAULE;1162920;6;3;0;0;0;6;3;1162920;Cocina MCG-5QI30NS 5P;LINEA BLANCA
8738529;;M;59;CHILENO;;Boomers;LANCO                         ;LOS RIOS;699830;7;2;0;0;0;7;2;699830;Freezer Horizontal M 150 142Lts;LINEA BLANCA
12566738;;F;48;CHILENO;;X;TOCOPILLA                     ;ANTOFAGASTA;3057950;16;7;2;1;485980;14;6;2571970;Cocina M 775 ST 4P Silver;LINEA BLANCA
12737592;Soltero;F;47;CHILENO;;X;TRAIGUEN                      ;ARAUCANIA;479990;1;1;0;0;0;1;1;479990;Lavadora Superior WA19T6260BW/ZS 19Kg;LINEA BLANCA
25933055;Soltero;M;33;VENEZOLANO;;Extranjero;INDEPENDENCIA                 ;METROPOLITANA;149980;2;1;0;0;0;2;1;149980;Lavadora MLS-090GE04N 9Kg Gris;LINEA BLANCA
17831989;;F;31;CHILENO;;Millenial;PROVIDENCIA                   ;METROPOLITANA;295960;5;3;0;0;0;5;3;295960;Refrigerador 210Lts Rojo Frio Dir MRFS2100R273FN;LINEA BLANCA
6306169;;F;73;CHILENO;;Silencioso;CAUQUENES                     ;MAULE;309990;2;2;0;0;0;2;2;309990;Refrigerador 255Lts No Frost RT25FARADS8/ZS;LINEA BLANCA
18915178;;M;27;CHILENO;;Millenial;PROVIDENCIA                   ;METROPOLITANA;71980;2;1;2;1;71980;0;0;0;SECADORA SR-10 8KG GRIS SINDELEN;LINEA BLANCA
13595445;;F;43;CHILENO;;X;BUIN                          ;METROPOLITANA;349970;3;1;0;0;0;3;1;349970;Freezer horizontal 142Lts lfh-151 blanco;LINEA BLANCA
16632021;;M;35;CHILENO;;Millenial;TEMUCO;ARAUCANIA;201830;3;1;0;0;0;3;1;201830;Lavadora MLS-090GE04N 9Kg Gris;LINEA BLANCA
18401967;Soltero;M;28;CHILENO;;Millenial;PROVIDENCIA                   ;METROPOLITANA;259990;1;1;0;0;0;1;1;259990;Lavadora Efficace SZG 17,5Kg Silver;LINEA BLANCA
15199265;;F;39;CHILENO;;X;LEBU                          ;BIO BIO;326970;3;2;2;1;313980;1;1;12990;Secadora 9 Kg Premium Care Pro 9D;LINEA BLANCA
13750072;;M;42;CHILENO;;X;PROVIDENCIA                   ;METROPOLITANA;495940;6;3;0;0;0;6;3;495940;Calefon 13Lts GL ATMD;LINEA BLANCA
6608441;;F;72;CHILENO;;Silencioso;VINA DEL MAR                  ;VALPARAISO;129990;1;1;0;0;0;1;1;129990;Centrifuga Primma 5B 5,5Kilos;LINEA BLANCA
17712113;;F;31;CHILENO;;Millenial;N/D;N/D;179990;2;1;2;1;179990;0;0;0;Lavadora WA90H4400SW1ZS 9Kg Blanca;LINEA BLANCA
9567424;;M;67;CHILENO;;Boomers;QUINTA DE TILCOCO             ;L.G.B.OÂ´HIGGINS;354300;4;2;0;0;0;4;2;354300;Secadora Ropa MD100A90/W 9Kg Ventilacion Blanca;LINEA BLANCA
25757822;Soltero;M;44;EXTRANJERO - NO INFORMA NACIONALIDAD;;Extranjero;QUINTA NORMAL                 ;METROPOLITANA;69980;2;1;2;1;69980;0;0;0;SECADORA SR-10 8KG GRIS SINDELEN;LINEA BLANCA
13788823;;F;41;CHILENO;;X;N/D;N/D;549960;6;6;0;0;0;6;6;549960;Secadora Ropa MD100A90/W 9Kg Ventilacion Blanca;LINEA BLANCA
5553419;;F;72;CHILENO;;Silencioso;MULCHEN                       ;BIO BIO;419980;2;1;0;0;0;2;1;419980;Refrigerador 306 Lts No frost BF GB33BPT;LINEA BLANCA
26305384;Soltero;F;31;VENEZOLANO;;Extranjero;N/D;N/D;189980;2;1;2;1;189980;0;0;0;Refrigerador 167Lts Frio Directo 1700-S;LINEA BLANCA
8452072;;F;51;CHILENO;;X;PADRE HURTADO                 ;METROPOLITANA;169990;1;1;0;0;0;1;1;169990;Lavadora MLS-090GE04N 9Kg Gris;LINEA BLANCA
8024290;;F;65;CHILENO;;Boomers;TALCA                         ;MAULE;477000;4;2;0;0;0;4;2;477000;Cocina MCG-5QI30NS 5P;LINEA BLANCA
12043342;;M;53;CHILENO;;X;PUENTE ALTO                   ;METROPOLITANA;136980;2;1;0;0;0;2;1;136980;Calefon ionizado 7 litros GL AS0;LINEA BLANCA
17586186;;M;31;CHILENO;;Millenial;PROVIDENCIA                   ;METROPOLITANA;179990;1;1;1;1;179990;0;0;0;Lavadora WA90H4400SW1ZS 9Kg Blanca;LINEA BLANCA
9031475;;F;62;CHILENO;;Boomers;LA LIGUA                      ;VALPARAISO;277980;2;2;0;0;0;2;2;277980;Lavadora Efficace SZG 17,5Kg Silver;LINEA BLANCA
19717206;;F;24;CHILENO;;Extranjero;LOS ANGELES                   ;BIO BIO;201980;2;1;2;1;201980;0;0;0;Lavadora WA90H4400SW1ZS 9Kg Blanca;LINEA BLANCA
18103361;;M;30;CHILENO;;Millenial;N/D;N/D;1758920;8;5;7;4;1418930;1;1;339990;Secadora 9 Kg 9D BZG Ventilacion Blanca;LINEA BLANCA
16014561;;M;37;CHILENO;;Millenial;N/D;N/D;59980;2;1;2;1;59980;0;0;0;SECADORA SR-10 8KG GRIS SINDELEN;LINEA BLANCA
7889238;;M;65;CHILENO;;Boomers;RENCA                         ;METROPOLITANA;231820;2;1;0;0;0;2;1;231820;Secadora Ropa MD100A90/W 9Kg Ventilacion Blanca;LINEA BLANCA
12086826;;M;54;CHILENO;;X;ANGOL                         ;ARAUCANIA;289990;1;1;0;0;0;1;1;289990;Lavadora Efficace SZG 19,5Kg Silver;LINEA BLANCA
17563296;;F;32;CHILENO;;Millenial;SAN BERNARDO                  ;METROPOLITANA;279980;2;1;2;1;279980;0;0;0;Refrigerador MDRB424FGE46 302 Lts No Frost;LINEA BLANCA
14189663;;F;40;CHILENO;;Millenial;"";"";518360;4;2;0;0;0;4;2;518360;Refrigerador 255Lts No Frost RT25FARADS8/ZS;LINEA BLANCA
19504508;;M;25;CHILENO;;Extranjero;PROVIDENCIA                   ;METROPOLITANA;279980;2;1;2;1;279980;0;0;0;Cocina CH-9855NG 5P;LINEA BLANCA
6740042;;M;70;CHILENO;;Silencioso;PROVIDENCIA                   ;METROPOLITANA;190980;2;1;0;0;0;2;1;190980;Freezer 142Lts MFH-1430B186C Horizontal;LINEA BLANCA
17191779;;M;33;CHILENO;;Millenial;CURICO                        ;MAULE;339990;3;1;0;0;0;3;1;339990;Lavadora MLS-090GE04N 9Kg Gris;LINEA BLANCA
26809059;Soltero;M;35;CUBANO;;Extranjero;N/D;N/D;257960;4;2;0;0;0;4;2;257960;Lavadora MLS-090GE04N 9Kg Gris;LINEA BLANCA
19155184;;F;26;CHILENO;;Z;NUNOA                         ;METROPOLITANA;139990;2;1;2;1;139990;0;0;0;Lavadora MLS-080BE04N 8Kg Blanca;LINEA BLANCA
13911643;;M;42;CHILENO;;X;COLBUN                        ;MAULE;431850;5;2;0;0;0;5;2;431850;Refrigerador 260Lts BF Frio Direc MRFI2660SR346W;LINEA BLANCA
11368332;;M;52;CHILENO;;X;PALMILLA                      ;L.G.B.OÂ´HIGGINS;353370;3;1;0;0;0;3;1;353370;Lavadora Premium Care 20SZ 20Kg Silver;LINEA BLANCA
8270842;Viudo;F;53;CHILENO;MEDICO CIRUJANO;X;PROVIDENCIA                   ;METROPOLITANA;583930;7;3;7;3;583930;0;0;0;Lavadora WA90H4400SW1ZS 9Kg Blanca;LINEA BLANCA
18203127;Soltero;F;30;CHILENO;;Millenial;COIHAIQUE                     ;AYSEN;969970;3;1;0;0;0;3;1;969970;Refrigerador 341Lts BF No Frost GB37MPD;LINEA BLANCA
11719401;;M;51;CHILENO;;X;N/D;N/D;538610;5;3;4;2;473620;1;1;64990;Freezer 160 Lts MFV-1600B208FN vertical;LINEA BLANCA
5493363;;F;79;CHILENO;;Silencioso;"";"";136980;2;1;2;1;136980;0;0;0;Calefon ionizado 7 litros GL AS0;LINEA BLANCA
17171136;Casado;M;33;CHILENO;;Millenial;PROVIDENCIA                   ;METROPOLITANA;282880;2;1;0;0;0;2;1;282880;Lavadora Efficace SZG 17,5Kg Silver;LINEA BLANCA
16219720;;F;37;CHILENO;;Millenial;"";"";237980;2;9;2;9;237980;0;0;0;Cocina CH-7400 4P;LINEA BLANCA
15658173;;F;40;CHILENO;;X;N/D;N/D;914930;7;5;0;0;0;7;5;914930;Lavadora WA15T5260BW/ZS 15Kg Blanca;LINEA BLANCA
20093100;;F;23;CHILENO;;Z;N/D;N/D;268260;3;2;0;0;0;3;2;268260;Calefont 10Lts GL Essenetial ECO;LINEA BLANCA
20294240;;F;22;CHILENO;;Z;PELLUHUE                      ;MAULE;214660;3;1;0;0;0;3;1;214660;Cocina CMC20AXX 4P Inox;LINEA BLANCA
12715225;;F;48;CHILENO;;X;NATALES                       ;MAGALLANES;287470;3;2;0;0;0;3;2;287470;Freezer 145 Lts FDHM150BY0 Horizontal;LINEA BLANCA
13291069;;F;45;CHILENO;;X;EL BOSQUE                     ;METROPOLITANA;323520;4;1;0;0;0;4;1;323520;Lavadora Premium Care Pro 16Kg Silver;LINEA BLANCA
10359019;Soltero;M;56;CHILENO;TECNICO EN ELECTROMECANICA;Boomers;RENCA                         ;METROPOLITANA;149990;1;1;0;0;0;1;1;149990;Calefont 8Lts GL Essenetial ECO;LINEA BLANCA
17711834;;F;31;CHILENO;;Millenial;PUNITAQUI                     ;COQUIMBO;211980;2;1;0;0;0;2;1;211980;Refrigerador 167Lts Frio Directo 1700-S;LINEA BLANCA
11762090;Soltero;M;50;CHILENO;;X;RENCA                         ;METROPOLITANA;154090;2;1;0;0;0;2;1;154090;Centrifuga Primma 5B 5,5Kilos;LINEA BLANCA
9755798;;F;59;CHILENO;;Boomers;TEMUCO                        ;ARAUCANIA;287400;5;3;0;0;0;5;3;287400;Secadora Ropa MSV-90 9K Blanca Ventilacion;LINEA BLANCA
15493655;;F;39;CHILENO;;X;QUINCHAO                      ;LOS LAGOS;639970;3;1;3;1;639970;0;0;0;Lavadora WA17T6260BW/ZS 17Kg Blanca;LINEA BLANCA
13359385;;F;44;CHILENO;;X;"";"";352980;2;2;0;0;0;2;2;352980;Refrigerador 252Lts No Frost MRFS-2700G333FW;LINEA BLANCA
16119317;;M;37;CHILENO;;Millenial;PROVIDENCIA                   ;METROPOLITANA;467850;4;2;0;0;0;4;2;467850;Refrigerador 303Lts BF Frio Directo Nordik 480;LINEA BLANCA
7321109;;F;71;CHILENO;;Silencioso;PUNTA ARENAS                  ;MAGALLANES;236110;2;1;0;0;0;2;1;236110;Lavadora MLS-090GE04N 9Kg Gris;LINEA BLANCA
6951275;;M;68;CHILENO;;Silencioso;SAN FERNANDO                  ;L.G.B.OÂ´HIGGINS;697380;6;1;0;0;0;6;1;697380;Cocina CH-8700IN 5P;LINEA BLANCA
19726193;;F;24;CHILENO;;Z;CHONCHI                       ;LOS LAGOS;1121320;15;9;0;0;0;15;9;1121320;Lavadora WA15T5260BW/ZS 15Kg Blanca;LINEA BLANCA
9886279;;M;57;CHILENO;;Boomers;"";"";196980;2;1;2;1;196980;0;0;0;Lavadora Efficace BZG 11,5Kg Blanca;LINEA BLANCA
13204290;;F;45;CHILENO;;X;PUENTE ALTO                   ;METROPOLITANA;286080;5;3;0;0;0;5;3;286080;Secadora Ropa MD100A90/W 9Kg Ventilacion Blanca;LINEA BLANCA
6603369;;M;67;CHILENO;;Boomers;RENCA                         ;METROPOLITANA;149990;1;1;0;0;0;1;1;149990;Calefont 8Lts GL Essenetial ECO;LINEA BLANCA
9369551;Casado;M;59;CHILENO;;Boomers;RENCA                         ;METROPOLITANA;190870;2;1;0;0;0;2;1;190870;Lavadora Semiautomatica Twister 5100 4Kg;LINEA BLANCA
11820228;;F;50;CHILENO;;X;VALLENAR;ATACAMA;589980;2;1;0;0;0;2;1;589980;Refrigerador 525Lts Side by Side SFX500;LINEA BLANCA
27043664;;F;41;COLOMBIANO;;Extranjero;N/D;N/D;245960;4;2;2;1;168980;2;1;76980;Secadora Ropa MSV-90 9K Blanca Ventilacion;LINEA BLANCA
19502129;;F;25;CHILENO;;Z;N/D;N/D;1436450;10;5;9;4;1076460;1;1;359990;Lavadora MLS-080BE04N 8Kg Blanca;LINEA BLANCA
13656323;Casado;F;43;CHILENO;;X;CAUQUENES                     ;MAULE;529740;2;1;0;0;0;2;1;529740;Lavadora WT19DSBP 19Kg Silver;LINEA BLANCA
15461579;;F;39;CHILENO;;X;N/D;N/D;532920;8;4;2;1;46980;6;3;485940;Cocina F 2608 T 4P Reflex Silver;LINEA BLANCA
18415678;Casado;F;29;CHILENO;GASTRONOMIA INTERNACIONAL;Millenial;TALCAHUANO                    ;BIO BIO;137980;2;1;2;1;137980;0;0;0;Centrifuga Primma 5B 5,5Kilos;LINEA BLANCA
13781536;Soltero;M;41;CHILENO;;X;PROVIDENCIA                   ;METROPOLITANA;301980;2;1;2;1;301980;0;0;0;Refrigerador 259Lts BF No frost MDRB379FGF02;LINEA BLANCA
12967612;;F;45;CHILENO;;X;COIHUECO                      ;NUBLE;242420;3;1;0;0;0;3;1;242420;Secadora Ropa MD100A90/W 9Kg Ventilacion Blanca;LINEA BLANCA
8390399;;M;64;CHILENO;;Boomers;PAINE                         ;METROPOLITANA;542970;3;2;0;0;0;3;2;542970;Refrigerador 527Lts Side by Side MRSBS5300G689WE;LINEA BLANCA
7090179;;F;66;CHILENO;;Boomers;ARAUCO                        ;BIO BIO;303970;3;2;0;0;0;3;2;303970;Secadora Ropa MSV-90 9K Blanca Ventilacion;LINEA BLANCA
17999297;;M;30;CHILENO;;Millenial;QUELLON                       ;LOS LAGOS;330500;6;3;2;1;108540;4;2;221960;Lavadora WA90H4400SW1ZS 9Kg Blanca;LINEA BLANCA
17626634;;F;31;CHILENO;;Millenial;PROVIDENCIA                   ;METROPOLITANA;550460;4;2;4;2;550460;0;0;0;Refrigerador 166 Lts Frio Directo BF MED165;LINEA BLANCA
9226349;;M;60;CHILENO;;Boomers;N/D;N/D;261960;4;2;4;2;261960;0;0;0;Secadora 9 Kg 9D BZG Ventilacion Blanca;LINEA BLANCA
9736040;;F;58;CHILENO;;Boomers;SAN CARLOS                    ;BIO BIO;209990;1;1;0;0;0;1;1;209990;Cocina CH-7400 4P;LINEA BLANCA
6317539;;M;72;CHILENO;;Silencioso;TILTIL                        ;METROPOLITANA;714290;9;5;0;0;0;9;5;714290;Cocina M 820 T 6P Silver;LINEA BLANCA
8944337;;F;60;CHILENO;;Boomers;PROVIDENCIA                   ;METROPOLITANA;149990;1;1;0;0;0;1;1;149990;Calefont 8Lts GL Essenetial ECO;LINEA BLANCA
14119130;;M;41;CHILENO;;X;PROVIDENCIA                   ;METROPOLITANA;139960;4;2;4;2;139960;0;0;0;Secadora Electrica SEM101BDBY Blanca 10 KG;LINEA BLANCA
10851036;;M;53;CHILENO;;X;LA SERENA                     ;COQUIMBO;284970;3;1;0;0;0;3;1;284970;Lavadora Frontal MLF-085BE08N 8,5Kg Blanca;LINEA BLANCA
10457635;;F;55;CHILENO;;Boomers;N/D;N/D;0;1;2;0;0;0;1;2;0;Lavadora Efficace SZG 19,5Kg Silver;LINEA BLANCA
7425565;;F;66;CHILENO;;Boomers;BUIN                          ;METROPOLITANA;245450;3;1;0;0;0;3;1;245450;Secadora Ropa MSV-90 9K Blanca Ventilacion;LINEA BLANCA
16844856;;M;34;CHILENO;;Millenial;SANTIAGO                      ;METROPOLITANA;729910;9;6;0;0;0;9;6;729910;Lavadora MLS-160BSC03T 16Kg Blanca;LINEA BLANCA
14365706;;M;40;CHILENO;;X;RENCA                         ;METROPOLITANA;387960;4;2;4;2;387960;0;0;0;Secadora 9 Kg 9D SZG Silver;LINEA BLANCA
13945731;;M;41;CHILENO;;Extranjero;DONIHUE                       ;L.G.B.OÂ´HIGGINS;149990;1;1;0;0;0;1;1;149990;Lavadora Semiautomatica Twister 5100 4Kg;LINEA BLANCA
11743361;;F;51;CHILENO;;X;SAN FERNANDO                  ;L.G.B.OÂ´HIGGINS;279990;1;1;0;0;0;1;1;279990;Lavadora MLS-160BSC03T 16Kg Blanca;LINEA BLANCA
18100625;;F;30;CHILENO;;Millenial;PROVIDENCIA                   ;METROPOLITANA;149990;1;1;0;0;0;1;1;149990;Lavadora Semiautomatica Twister 5100 4Kg;LINEA BLANCA
10004731;;M;54;CHILENO;;Boomers;CHILLAN                       ;BIO BIO;786500;9;6;0;0;0;9;6;786500;Refrigerador 303Lts BF Frio Directo Nordik 480;LINEA BLANCA
8776392;;F;62;CHILENO;;Boomers;PROVIDENCIA                   ;METROPOLITANA;369980;2;1;0;0;0;2;1;369980;Cocina MCG-5QI30NS 5P;LINEA BLANCA
16437739;;F;35;CHILENO;;Millenial;VILLA ALEGRE;MAULE;523270;6;4;0;0;0;6;4;523270;Refrigerador 241Lts BF Frio Directo Nordik 415;LINEA BLANCA
14231343;;F;53;CHILENO;;X;MOSTAZAL                      ;L.G.B.OÂ´HIGGINS;910420;9;3;0;0;0;9;3;910420;Secadora 9 Kg 9D BZG Ventilacion Blanca;LINEA BLANCA
13065913;;M;46;CHILENO;;X;RENCA                         ;METROPOLITANA;308930;5;1;5;1;308930;0;0;0;Refrigerador 180Lts BF Frio Directo MDRB275FGF42;LINEA BLANCA
6854426;;F;76;CHILENO;;Z;MELIPILLA                     ;METROPOLITANA;199990;1;1;0;0;0;1;1;199990;Cocina CH-7400 4P;LINEA BLANCA
12806392;;M;46;CHILENO;;X;COQUIMBO                      ;COQUIMBO;473850;4;1;0;0;0;4;1;473850;Cocina M 920 T 5P Silver;LINEA BLANCA
7938960;;F;69;CHILENO;;Silencioso;PANGUIPULLI                   ;LOS LAGOS;151980;2;1;0;0;0;2;1;151980;Centrifuga Primma 5B 5,5Kilos;LINEA BLANCA
14024222;;F;40;CHILENO;;X;EL QUISCO                     ;VALPARAISO;650550;11;4;0;0;0;11;4;650550;Lavadora MLS-160GSC03T 16Kg Gris;LINEA BLANCA
12576296;;M;49;CHILENO;;X;VALLENAR;ATACAMA;1143030;10;6;0;0;0;10;6;1143030;Freezer Horizontal M 150 142Lts;LINEA BLANCA
10087899;;F;57;CHILENO;;Boomers;PUERTO MONTT                  ;LOS LAGOS;262990;3;1;0;0;0;3;1;262990;Secadora 9 Kg 9D BZG Ventilacion Blanca;LINEA BLANCA
9775640;;F;52;CHILENO;;X;RENCA                         ;METROPOLITANA;855960;4;2;0;0;0;4;2;855960;Lavadora WT16DSBP 16Kg Silver;LINEA BLANCA
8586261;Casado;F;63;CHILENO;;Boomers;NUEVA IMPERIAL                ;ARAUCANIA;1330620;8;3;0;0;0;8;3;1330620;Cocina F 5500 T 5P Reflex Silver;LINEA BLANCA
14682198;Soltero;F;46;PERUANO;TECNICO DE NIVEL SUPERIOR EN ODONTOLOGIA;X;PROVIDENCIA                   ;METROPOLITANA;239990;3;1;3;1;239990;0;0;0;Lavadora Efficace SZG 17,5Kg Silver;LINEA BLANCA
18202567;;M;30;CHILENO;;Millenial;N/D;N/D;210980;2;4;0;0;0;2;4;210980;Freezer Horizontal M 150 142Lts;LINEA BLANCA
10028460;;M;51;CHILENO;;X;COIHAIQUE                     ;AYSEN;1079960;4;3;0;0;0;4;3;1079960;COCINA LENA ENLOZADA 82x56;LINEA BLANCA
25530125;;M;41;COLOMBIANO;;Extranjero;LAS CONDES                    ;METROPOLITANA;309970;3;2;0;0;0;3;2;309970;Lavadora Efficace SZG 17,5Kg Silver;LINEA BLANCA
5824787;;M;76;CHILENO;;Silencioso;LOS ANGELES                   ;BIO BIO;176430;5;1;0;0;0;5;1;176430;Calefon ionizado 5 litros GL AS0;LINEA BLANCA
7829766;;F;62;CHILENO;;Boomers;LA PINTANA                    ;METROPOLITANA;726590;6;2;0;0;0;6;2;726590;Secadora 7Kg 7D BZG Ventilacion Blanca;LINEA BLANCA
17283452;;M;32;CHILENO;;Millenial;PROVIDENCIA                   ;METROPOLITANA;317960;4;2;4;2;317960;0;0;0;CENTRIFUGA C-752;LINEA BLANCA
18739253;Soltero;M;28;CHILENO;;Millenial;PROVIDENCIA                   ;METROPOLITANA;379980;2;1;2;1;379980;0;0;0;Cocina F 6500 T 5P Negra;LINEA BLANCA
11655426;;F;52;CHILENO;;X;PUENTE ALTO                   ;METROPOLITANA;623940;6;2;0;0;0;6;2;623940;Lavadora Efficace BZG 11,5Kg Blanca;LINEA BLANCA
10514651;;M;55;CHILENO;;Boomers;VALPARAISO                    ;VALPARAISO;159990;1;1;0;0;0;1;1;159990;Lavadora Semiautomatica Twister 5300 4Kg;LINEA BLANCA
18031349;Soltero;F;29;CHILENO;PROFESOR;Millenial;PROVIDENCIA                   ;METROPOLITANA;445980;3;2;3;2;445980;0;0;0;Refrigerador 241Lts BF Frio Directo Nordik 415;LINEA BLANCA
8319731;;M;63;CHILENO;;Boomers;EL BOSQUE                     ;METROPOLITANA;461930;5;2;4;1;211940;1;1;249990;Calefon 7Lts GL ATMD;LINEA BLANCA
11237353;;M;54;CHILENO;;X;CURANILAHUE                   ;BIO BIO;600950;5;4;0;0;0;5;4;600950;Lavadora WA13T5260BW/ZS 13Kg Blanca;LINEA BLANCA
11528236;;M;52;CHILENO;;X;"";"";1390950;6;5;0;0;0;6;5;1390950;Cocina F 5500 T 5P Reflex Silver;LINEA BLANCA
7650649;Viudo;M;63;CHILENO;;Boomers;ALTO HOSPICIO;TARAPACA;269990;1;1;0;0;0;1;1;269990;Cocina M 775 ST 4P Silver;LINEA BLANCA
16661762;;F;34;CHILENO;;Millenial;SAN MIGUEL;METROPOLITANA;189990;2;1;2;1;189990;0;0;0;Lavadora Frontal MLF-085BE08N 8,5Kg Blanca;LINEA BLANCA
7822944;;F;67;CHILENO;;Boomers;LA CRUZ                       ;VALPARAISO;452050;2;1;0;0;0;2;1;452050;Refrigerador 300Lts No Frost RT29K500JS8/ZS;LINEA BLANCA
17881674;;F;30;CHILENO;;Millenial;NUEVA IMPERIAL                ;ARAUCANIA;328970;3;3;0;0;0;3;3;328970;Lavadora WA90H4400SW1ZS 9Kg Blanca;LINEA BLANCA
9504158;;F;61;CHILENO;;Boomers;PROVIDENCIA                   ;METROPOLITANA;86980;2;1;2;1;86980;0;0;0;ENCIMERA A GAS 4 PLATOS CEG-4600 INOX;LINEA BLANCA
13703341;;F;43;CHILENO;;X;N/D;N/D;874920;8;4;6;3;634940;2;1;239980;Lavadora 9 Kg Carga Superior Blanca;LINEA BLANCA
18821916;Soltero;M;27;CHILENO;;Silencioso;PROVIDENCIA                   ;METROPOLITANA;882640;8;4;8;4;882640;0;0;0;Lavadora WT16DSBP 16Kg Silver;LINEA BLANCA
5556286;;F;79;CHILENO;;Silencioso;TALCA                         ;MAULE;646980;2;1;0;0;0;2;1;646980;COCINA LENA ENLOZADA 82x56;LINEA BLANCA
14099102;;M;43;CHILENO;;X;COPIAPO                       ;ATACAMA;319980;2;1;2;1;319980;0;0;0;Lavadora Premium Care 20SZ 20Kg Silver;LINEA BLANCA
13712549;;M;43;CHILENO;;X;PROVIDENCIA                   ;METROPOLITANA;206980;2;1;2;1;206980;0;0;0;Secadora 9 Kg 9D BZG Ventilacion Blanca;LINEA BLANCA
8185095;;M;61;CHILENO;;Boomers;ZAPALLAR                      ;VALPARAISO;239970;3;2;2;1;189980;1;1;49990;Secadora Ropa MD100A90/W 9Kg Ventilacion Blanca;LINEA BLANCA
14201084;;M;41;CHILENO;;X;RENGO;O HIGGINS;141980;2;1;2;1;141980;0;0;0;Frigobar LFB-101S 85Lts Inox;LINEA BLANCA
5900983;;M;74;CHILENO;;Silencioso;MELIPILLA                     ;METROPOLITANA;473040;3;1;0;0;0;3;1;473040;Refrigerador 322Lts No Frost BF DB60S;LINEA BLANCA
13846911;;M;42;CHILENO;;X;N/D;N/D;199990;1;1;0;0;0;1;1;199990;Cocina CMC20AXX 4P Inox;LINEA BLANCA
15513865;;M;39;CHILENO;;X;"";"";899340;5;2;2;1;269980;3;1;629360;Refrigerador 252Lts No Frost MRFS-2700G333FW;LINEA BLANCA
8548874;Soltero;M;62;CHILENO;;Boomers;NATALES                       ;MAGALLANES;342970;3;2;0;0;0;3;2;342970;Freezer 200 Lts FDHM200BY0 Horizontal;LINEA BLANCA
19631250;;M;25;CHILENO;;Z;PROVIDENCIA                   ;METROPOLITANA;399980;2;1;2;1;399980;0;0;0;Refrigerador DW44S 400Lts Dispen No Frost;LINEA BLANCA
14249794;;F;53;CHILENO;;X;N/D;N/D;279990;1;1;0;0;0;1;1;279990;Cocina F 2608 T 4P Reflex Silver;LINEA BLANCA
7270382;;F;71;CHILENO;;Silencioso;PROVIDENCIA                   ;METROPOLITANA;439970;3;3;3;3;439970;0;0;0;Lavadora WA80H4200SW1ZS 8Kg Blanca;LINEA BLANCA
8827794;;M;62;CHILENO;;Boomers;VILLA ALEMANA                 ;VALPARAISO;271970;4;1;0;0;0;4;1;271970;Lavadora Efficace SZG 15,5Kg Silver;LINEA BLANCA
17287831;;F;32;CHILENO;;Millenial;RENCA                         ;METROPOLITANA;560880;10;2;10;2;560880;0;0;0;Lavadora Efficace SZG 15,5Kg Silver;LINEA BLANCA
12583421;Casado;F;48;CHILENO;;X;PROVIDENCIA                   ;METROPOLITANA;219990;1;1;0;0;0;1;1;219990;Cocina CH-7400 4P;LINEA BLANCA
18103616;Soltero;F;30;CHILENO;;Millenial;PROVIDENCIA                   ;METROPOLITANA;412960;4;2;0;0;0;4;2;412960;Lavadora WT16DSBP 16Kg Silver;LINEA BLANCA
13160786;;M;45;CHILENO;;Silencioso;PROVIDENCIA                   ;METROPOLITANA;484980;2;1;2;1;484980;0;0;0;Refrigerador 525Lts Side by Side SFX500;LINEA BLANCA
12517744;;M;49;CHILENO;;X;RANCAGUA                      ;L.G.B.OÂ´HIGGINS;619940;6;3;0;0;0;6;3;619940;Cocina M 775 ST 4P Silver;LINEA BLANCA
12370632;;F;48;CHILENO;;X;CURICO                        ;MAULE;415930;6;3;0;0;0;6;3;415930;Lavadora MLS-140GSC03T 14Kg Gris;LINEA BLANCA
26909781;;M;24;CHILENO;;Extranjero;"";"";207980;2;1;2;1;207980;0;0;0;Cocina CMC5110AX0 4P Inox;LINEA BLANCA
18433438;;F;29;CHILENO;;Millenial;"";"";1359798;26;21;0;0;0;26;21;1359798;Lavadora WA80H4200SW1ZS 8Kg Blanca;LINEA BLANCA
19001354;;F;26;CHILENO;;Z;TALCA                         ;MAULE;694960;4;3;0;0;0;4;3;694960;Refrigerador 244Lts Frio Directo Progress 3100;LINEA BLANCA
16785277;;M;37;CHILENO;;Millenial;CALAMA                        ;ANTOFAGASTA;225180;3;2;0;0;0;3;2;225180;Lavadora Semiautomatica Twister 5100 4Kg;LINEA BLANCA
10465952;;F;56;CHILENO;;Boomers;N/D;N/D;479360;3;2;0;0;0;3;2;479360;Lavadora Semiautomatica LC-6550 6,5Kg;LINEA BLANCA
11237140;;F;53;CHILENO;;X;INDEPENDENCIA                 ;METROPOLITANA;739960;4;2;2;1;257980;2;1;481980;Secadora 9 Kg Premium Care Pro 9D;LINEA BLANCA
16703993;;F;35;CHILENO;;Millenial;ANTOFAGASTA                   ;ANTOFAGASTA;794960;4;2;0;0;0;4;2;794960;Refrigerador 290Lts BF No Frost RB30N4020S8;LINEA BLANCA
6219745;;M;69;CHILENO;;Silencioso;PAINE                         ;METROPOLITANA;837040;5;2;0;0;0;5;2;837040;Refrigerador 251Lts No Frost Altus 1250;LINEA BLANCA
19611250;;M;24;CHILENO;;Z;CURICO                        ;MAULE;115450;2;1;0;0;0;2;1;115450;Calefon ionizado 5 litros GL AS0;LINEA BLANCA
12568276;;F;48;CHILENO;;X;VALLENAR;ATACAMA;257400;2;1;0;0;0;2;1;257400;Cocina CH-7400 4P;LINEA BLANCA
11750144;;M;51;CHILENO;;X;RENCA                         ;METROPOLITANA;159990;1;1;1;1;159990;0;0;0;Secadora Ropa MSV-90 9K Blanca Ventilacion;LINEA BLANCA
15198822;;F;40;CHILENO;;X;LEBU                          ;BIO BIO;528820;6;4;0;0;0;6;4;528820;Lavadora MLS-090GE04N 9Kg Gris;LINEA BLANCA
17922743;;F;31;CHILENO;;Millenial;SAN RAMON                     ;METROPOLITANA;159980;2;1;2;1;159980;0;0;0;Freezer horizontal 142Lts lfh-151 blanco;LINEA BLANCA
7465099;;F;68;CHILENO;;Silencioso;OSORNO                        ;LOS LAGOS;237980;2;2;0;0;0;2;2;237980;Cocina CH-7400 4P;LINEA BLANCA
26476962;Soltero;M;30;EXTRANJERO - NO INFORMA NACIONALIDAD;;Extranjero;PROVIDENCIA                   ;METROPOLITANA;279980;2;1;2;1;279980;0;0;0;Refrigerador RB27N4020S8/ZS BF 257Lts;LINEA BLANCA
6011991;;M;70;CHILENO;;Silencioso;PROVIDENCIA                   ;METROPOLITANA;199990;1;1;0;0;0;1;1;199990;Lavadora WA80H4200SW1ZS 8Kg Blanca;LINEA BLANCA
12544415;Soltero;F;48;CHILENO;AGRONOMO;X;LINARES                       ;MAULE;229990;1;1;0;0;0;1;1;229990;Refrigerador 244Lts Frio Directo Progress 3100;LINEA BLANCA
8485067;;M;61;CHILENO;;Boomers;VICUNA                        ;COQUIMBO;720949;6;2;0;0;0;6;2;720949;Lavadora Premium Care 20SZ 20Kg Silver;LINEA BLANCA
10745080;;F;50;CHILENO;;X;CHILLAN                       ;BIO BIO;659490;4;3;0;0;0;4;3;659490;Secadora 9 Kg Premium Care Pro 9D;LINEA BLANCA
7556188;;F;68;CHILENO;;Boomers;PEUMO                         ;L.G.B.OÂ´HIGGINS;514950;5;3;4;2;374960;1;1;139990;Secadora 9 Kg 9D BZG Ventilacion Blanca;LINEA BLANCA
9765726;;F;56;CHILENO;;Boomers;PUDAHUEL                      ;METROPOLITANA;173980;2;1;2;1;173980;0;0;0;Calefont 7 Litros GL Tiro Forzado;LINEA BLANCA
7202204;;M;66;CHILENO;;Boomers;PROVIDENCIA                   ;METROPOLITANA;279980;2;1;2;1;279980;0;0;0;Refrigerador 241Lts BF Frio Directo Nordik 415;LINEA BLANCA
9061838;;F;59;CHILENO;;Boomers;PETORCA                       ;VALPARAISO;446970;3;2;2;1;316980;1;1;129990;Lavadora Premium Care Pro 16Kg Silver;LINEA BLANCA
10861035;Casado;M;55;CHILENO;AGROINDUSTRIA;Boomers;SAAVEDRA                      ;ARAUCANIA;384970;4;3;0;0;0;4;3;384970;Secadora 7Kg 7D BZG Ventilacion Blanca;LINEA BLANCA
19847867;;F;24;CHILENO;;Z;N/D;N/D;329970;3;2;2;1;199980;1;1;129990;Secadora 9 Kg 9D BZG Ventilacion Blanca;LINEA BLANCA
8368546;Soltero;F;65;CHILENO;;Boomers;CHILLAN                       ;BIO BIO;359240;3;1;0;0;0;3;1;359240;Lavadora Efficace SZG 17,5Kg Silver;LINEA BLANCA
15535044;;F;39;CHILENO;;X;SAN PEDRO                     ;METROPOLITANA;1703440;10;4;0;0;0;10;4;1703440;Secadora Ropa MD100A90/W 9Kg Ventilacion Blanca;LINEA BLANCA
15766147;;F;38;CHILENO;;X;VINA DEL MAR                  ;VALPARAISO;452490;4;1;0;0;0;4;1;452490;Lavadora Efficace BZG 9,5Kg Blanca;LINEA BLANCA
12223354;;F;50;CHILENO;;Millenial;N/D;N/D;169990;1;1;0;0;0;1;1;169990;Secadora Ropa MD100A90/W 9Kg Ventilacion Blanca;LINEA BLANCA
19773462;;M;24;CHILENO;;Z;PROVIDENCIA                   ;METROPOLITANA;517960;4;2;4;2;517960;0;0;0;Lavadora MLS-160BSC03T 16Kg Blanca;LINEA BLANCA
8393156;Divorciado;F;58;CHILENO;MATRONA;Boomers;PROVIDENCIA                   ;METROPOLITANA;159990;1;1;0;0;0;1;1;159990;Cocina F-2525 4P;LINEA BLANCA
6284279;Soltero;M;69;CHILENO;;Silencioso;RENCA                         ;METROPOLITANA;352990;2;1;0;0;0;2;1;352990;Producto Segunda Seleccion Banda 7;LINEA BLANCA
4627898;;F;79;CHILENO;;Silencioso;CARAHUE                       ;ARAUCANIA;399990;2;1;0;0;0;2;1;399990;Cocina F 5500 T 5P Reflex Silver;LINEA BLANCA
17610140;;F;31;CHILENO;;Millenial;SAN RAMON                     ;METROPOLITANA;246960;4;2;4;2;246960;0;0;0;Secadora 9 Kg 9D BZG Ventilacion Blanca;LINEA BLANCA
5366905;Casado;M;74;CHILENO;;Silencioso;CALAMA                        ;ANTOFAGASTA;318970;3;1;0;0;0;3;1;318970;Cocina Diva 920 5P;LINEA BLANCA
7434556;Casado;M;63;CHILENO;;Boomers;SAN RAMON                     ;METROPOLITANA;302550;2;1;0;0;0;2;1;302550;Lavadora Efficace SZG 17,5Kg Blanca;LINEA BLANCA
26375109;;M;28;VENEZOLANO;;Extranjero;"";"";383960;3;1;3;1;383960;0;0;0;Refrigerador 167Lts Frio Directo 1700-S;LINEA BLANCA
7820478;;F;66;CHILENO;;Boomers;QUILPUE;VALPARAISO;268790;3;1;0;0;0;3;1;268790;Secadora 7Kg 7D BZG Ventilacion Blanca;LINEA BLANCA
13397265;;F;44;CHILENO;;X;NUEVA IMPERIAL                ;ARAUCANIA;374980;2;1;0;0;0;2;1;374980;Lavadora WT16DSBP 16Kg Silver;LINEA BLANCA
12259915;;F;49;CHILENO;;X;TEMUCO                        ;ARAUCANIA;347550;4;1;0;0;0;4;1;347550;Cocina PRO 425 4P Inox - Serie 2 HSG14I21SE;LINEA BLANCA
18571584;;F;29;CHILENO;;Millenial;"";"";163980;2;1;2;1;163980;0;0;0;CALEFON 10 LTS GAS LICUADO SILVER SINDELEN;LINEA BLANCA
12024894;;F;48;CHILENO;;X;NATALES                       ;MAGALLANES;289990;1;1;0;0;0;1;1;289990;Refrigerador 244Lts Frio Directo Progress 3100;LINEA BLANCA
14539449;;M;47;CHILENO;;Extranjero;TALCA                         ;MAULE;364980;2;1;0;0;0;2;1;364980;Cocina Andes60TX4 4P Inox;LINEA BLANCA
6336593;;M;69;CHILENO;;Silencioso;BULNES                        ;BIO BIO;218980;3;1;0;0;0;3;1;218980;Secadora Ropa MD100A90/W 9Kg Ventilacion Blanca;LINEA BLANCA
15191488;;M;34;CHILENO;;Millenial;COLINA                        ;METROPOLITANA;349980;2;1;0;0;0;2;1;349980;Lavadora WT16DSBP 16Kg Silver;LINEA BLANCA
16903589;;F;34;CHILENO;;Millenial;CONCHALI                      ;METROPOLITANA;199980;2;1;2;1;199980;0;0;0;Lavadora WA80H4200SW1ZS 8Kg Blanca;LINEA BLANCA
23536803;;F;39;CHILENO;;Extranjero;QUINTA NORMAL                 ;METROPOLITANA;709960;4;2;0;0;0;4;2;709960;Refrigerador 322Lts No Frost BF DB60S;LINEA BLANCA
13748850;Soltero;M;42;CHILENO;;Silencioso;COMBARBALA                    ;COQUIMBO;323980;2;1;0;0;0;2;1;323980;Cocina CH-8700IN 5P;LINEA BLANCA
18171113;;F;29;CHILENO;;Millenial;N/D;N/D;208980;2;1;0;0;0;2;1;208980;Lavadora WA80H4200SW1ZS 8Kg Blanca;LINEA BLANCA
25831324;;M;38;CHILENO;;Extranjero;SAN MIGUEL                    ;METROPOLITANA;479980;2;1;2;1;479980;0;0;0;Refrigerador 341Lts BF No Frost GB37MPD;LINEA BLANCA
8259089;;F;65;CHILENO;;Boomers;PANGUIPULLI                   ;LOS LAGOS;870340;5;5;0;0;0;5;5;870340;Lavadora Secadora WD95T4046CE/ZS 9,5Kg/6Kg Blanc;LINEA BLANCA
7979113;;M;63;CHILENO;;Boomers;SAN PEDRO DE LA PAZ           ;BIO BIO;225970;3;3;0;0;0;3;3;225970;Cocina CH-9400 4P SILVER;LINEA BLANCA
5574840;;M;78;CHILENO;;Silencioso;SAN BERNARDO                  ;METROPOLITANA;275500;4;2;0;0;0;4;2;275500;Secadora Ropa MD100A90/W 9Kg Ventilacion Blanca;LINEA BLANCA
6748673;;F;76;BOLIVIANO;;Extranjero;ARICA                         ;ARICA Y PARINACOTA;689580;4;2;0;0;0;4;2;689580;Refrigerador 300Lts No Frost RT29K500JS8/ZS;LINEA BLANCA
9322175;;F;59;CHILENO;;Boomers;PROVIDENCIA                   ;METROPOLITANA;521460;4;2;0;0;0;4;2;521460;Refrigerador 251Lts No Frost Altus 1250;LINEA BLANCA
17884566;Soltero;F;30;CHILENO;;Millenial;PROVIDENCIA                   ;METROPOLITANA;204980;2;1;2;1;204980;0;0;0;Cocina MV 110 T 4P Blanca;LINEA BLANCA
16664053;;M;35;CHILENO;;Millenial;MONTE PATRIA                  ;COQUIMBO;282550;2;1;0;0;0;2;1;282550;Lavadora MLS-160BSC03T 16Kg Blanca;LINEA BLANCA
16025386;;M;36;CHILENO;;Millenial;PERALILLO                     ;L.G.B.OÂ´HIGGINS;271980;2;1;2;1;271980;0;0;0;Lavadora Efficace SZG 17,5Kg Silver;LINEA BLANCA
4498747;;M;81;CHILENO;;Silencioso;PENAFLOR                      ;METROPOLITANA;359980;2;1;0;0;0;2;1;359980;Lavadora Premium Care 20SZ 20Kg Silver;LINEA BLANCA
6183508;;F;70;CHILENO;;Silencioso;VALPARAISO                    ;VALPARAISO;215970;3;3;0;0;0;3;3;215970;Cocina CMC20AXX 4P Inox;LINEA BLANCA
15846258;;M;37;CHILENO;;Millenial;N/D;N/D;148980;2;1;2;1;148980;0;0;0;Lavadora Semiautomatica Twister 5100 4Kg;LINEA BLANCA
17743790;;M;31;CHILENO;;Millenial;NACIMIENTO;BIO-BIO;419970;3;3;2;2;249980;1;1;169990;Lavadora Semiautomatica LC-6550 6,5Kg;LINEA BLANCA
18290691;;M;32;CHILENO;;Millenial;N/D;N/D;1071420;8;5;0;0;0;8;5;1071420;Refrigerador 254Lts No Frost GT29WPPDC;LINEA BLANCA
16241759;;F;36;CHILENO;;Millenial;EL MONTE                      ;METROPOLITANA;153400;3;1;0;0;0;3;1;153400;Centrifuga Primma 5B 5,5Kilos;LINEA BLANCA
6849518;;F;68;CHILENO;;Silencioso;PUERTO MONTT                  ;LOS LAGOS;199980;2;1;0;0;0;2;1;199980;Freezer 142Lts MFH-1430B186C Horizontal;LINEA BLANCA
11286858;;M;54;CHILENO;;X;CONSTITUCION                  ;MAULE;593060;3;1;0;0;0;3;1;593060;Refrigerador 527Lts Side by Side MRSBS5300G689WE;LINEA BLANCA
15851853;Soltero;F;37;CHILENO;;Millenial;QUILPUE;VALPARAISO;469980;2;1;0;0;0;2;1;469980;Refrigerador 341Lts BF No Frost GB37MPD;LINEA BLANCA
9294041;;M;60;CHILENO;;Boomers;N/D;N/D;287560;3;2;0;0;0;3;2;287560;Lavadora WA90H4400SW1ZS 9Kg Blanca;LINEA BLANCA
9527721;;M;61;CHILENO;;Boomers;CURICO                        ;MAULE;587960;4;2;0;0;0;4;2;587960;Lavadora Efficace SZG 17,5Kg Blanca;LINEA BLANCA
16261179;Casado;F;36;CHILENO;;Millenial;RENCA                         ;METROPOLITANA;301960;4;1;0;0;0;4;1;301960;Lavadora MLS-160BSC03T 16Kg Blanca;LINEA BLANCA
6068373;Casado;F;70;CHILENO;;Silencioso;RENCA                         ;METROPOLITANA;259990;1;1;0;0;0;1;1;259990;Lavadora MLS-160BSC03T 16Kg Blanca;LINEA BLANCA
4506424;;M;80;CHILENO;;Silencioso;VALLENAR;ATACAMA;437970;3;1;0;0;0;3;1;437970;Cocina MCG-5QI30NS 5P;LINEA BLANCA
7454880;;F;64;CHILENO;;Boomers;PENCO                         ;BIO BIO;153980;2;1;0;0;0;2;1;153980;Freezer 99Lts MFH-1000B131CN Horizontal;LINEA BLANCA
9886000;;F;55;CHILENO;;Boomers;SAN ANTONIO                   ;VALPARAISO;291980;2;1;2;1;291980;0;0;0;Lavadora WT13WSBP 13Kg Blanca;LINEA BLANCA
17547307;;M;30;CHILENO;;Millenial;PROVIDENCIA                   ;METROPOLITANA;245980;2;1;2;1;245980;0;0;0;Beer Cooler MBC-960N125SEN 96Lts;LINEA BLANCA
17886274;;F;31;CHILENO;;Millenial;SAN JAVIER                    ;MAULE;229980;2;1;0;0;0;2;1;229980;Secadora Ropa MD100A90/W 9Kg Ventilacion Blanca;LINEA BLANCA
5683807;;M;73;CHILENO;;Silencioso;LOS LAGOS                     ;LOS RIOS;490960;4;2;0;0;0;4;2;490960;Lavadora Premium Care Pro 16Kg Silver;LINEA BLANCA
12749833;;F;46;CHILENO;;X;VALDIVIA                      ;LOS LAGOS;363970;3;1;0;0;0;3;1;363970;Lavadora WA13T5260BW/ZS 13Kg Blanca;LINEA BLANCA
8701899;;F;64;CHILENO;;Boomers;ANTOFAGASTA                   ;ANTOFAGASTA;1123940;6;1;0;0;0;6;1;1123940;Refrigerador 535Lts Side by Side RS54N3003SL/ZS;LINEA BLANCA
11576975;;F;52;CHILENO;;X;CANETE                        ;BIO BIO;221980;2;1;0;0;0;2;1;221980;Lavadora WA90H4400SW1ZS 9Kg Blanca;LINEA BLANCA
7827110;Casado;M;66;CHILENO;;Boomers;RENCA                         ;METROPOLITANA;269990;1;1;0;0;0;1;1;269990;Lavadora MLS-160BSC03T 16Kg Blanca;LINEA BLANCA
11273707;;F;53;CHILENO;;X;RANCAGUA                      ;L.G.B.OÂ´HIGGINS;438970;3;1;0;0;0;3;1;438970;Lavadora Efficace SZG 19,5Kg Silver;LINEA BLANCA
16924231;;F;34;CHILENO;;Millenial;COPIAPO;ATACAMA;191980;2;1;2;1;191980;0;0;0;Lavadora MLS-090GE04N 9Kg Gris;LINEA BLANCA
7948840;;F;64;CHILENO;;Boomers;SAN BERNARDO                  ;METROPOLITANA;601550;4;2;0;0;0;4;2;601550;Lavadora WT19DSBP 19Kg Silver;LINEA BLANCA
8981345;;F;64;CHILENO;;Boomers;VALDIVIA                      ;LOS LAGOS;206480;2;1;0;0;0;2;1;206480;Cocina CH-9400 4P SILVER;LINEA BLANCA
13281570;;F;45;CHILENO;;X;PENALOLEN                     ;METROPOLITANA;217940;6;3;6;3;217940;0;0;0;Freezer 99Lts MFH-1000B131CN Horizontal;LINEA BLANCA
18342041;;F;29;CHILENO;;Millenial;PROVIDENCIA                   ;METROPOLITANA;233980;2;1;2;1;233980;0;0;0;Cocina CH-9810IN 4P Inox;LINEA BLANCA
14618097;;F;41;CHILENO;;X;ESTACION CENTRAL              ;METROPOLITANA;582950;5;2;0;0;0;5;2;582950;Refrigerador 260Lts BF Frio Direc MRFI2660SR346W;LINEA BLANCA
16711816;;M;34;CHILENO;;Millenial;PROVIDENCIA                   ;METROPOLITANA;179980;2;1;2;1;179980;0;0;0;Refrigerador 167Lts Frio Directo 1700-S;LINEA BLANCA
12178820;;F;50;CHILENO;;X;MELIPILLA                     ;METROPOLITANA;399990;1;1;0;0;0;1;1;399990;Lavadora WT19DSBP 19Kg Silver;LINEA BLANCA
10188682;;M;57;CHILENO;;Boomers;VILLARICA                     ;ARAUCANIA;176980;2;1;0;0;0;2;1;176980;Lavadora WA80H4200SW1ZS 8Kg Blanca;LINEA BLANCA
27177335;;M;30;CHILENO;;Extranjero;"";"";157980;2;1;2;1;157980;0;0;0;Encimera Breit 60 GL 4P;LINEA BLANCA
5086699;;F;79;CHILENO;;Silencioso;LA PINTANA                    ;METROPOLITANA;432960;4;1;0;0;0;4;1;432960;Cocina MCG-4QI24NS 4P;LINEA BLANCA
9562928;;M;59;CHILENO;;Boomers;SAN FELIPE                    ;VALPARAISO;299990;1;1;0;0;0;1;1;299990;Cocina CH-8700IN 5P;LINEA BLANCA
12067740;;M;51;CHILENO;;X;SAN BERNARDO                  ;METROPOLITANA;917407;10;3;2;1;340980;8;2;576427;Refrigerador 254Lts No Frost GT29WPPDC;LINEA BLANCA
17208969;;F;33;CHILENO;;Millenial;N/D;N/D;536970;3;2;0;0;0;3;2;536970;Lavadora Efficace SZG 15,5Kg Silver;LINEA BLANCA
17547569;Soltero;M;32;CHILENO;;Millenial;COLLIPULLI                    ;ARAUCANIA;301980;2;1;0;0;0;2;1;301980;Freezer 196Lts M200 Horizontal;LINEA BLANCA
5590215;;M;72;CHILENO;;Silencioso;N/D;N/D;413960;4;2;4;2;413960;0;0;0;Refrigerador 260Lts BF Frio Direc MRFI2660SR346W;LINEA BLANCA
11323918;;F;54;CHILENO;;Boomers;VALDIVIA                      ;LOS LAGOS;199990;1;1;0;0;0;1;1;199990;Cocina CH-7400 4P;LINEA BLANCA
12766122;;F;47;CHILENO;;X;PROVIDENCIA                   ;METROPOLITANA;367980;2;1;0;0;0;2;1;367980;Cocina Andes60TX4 4P Inox;LINEA BLANCA
7302171;;M;69;CHILENO;;Silencioso;SAN FELIPE                    ;VALPARAISO;504960;4;2;0;0;0;4;2;504960;Refrigerador 252Lts No Frost MRFS-2700G333FW;LINEA BLANCA
20503398;;M;22;CHILENO;;Z;ALTO HOSPICIO;TARAPACA;1067940;6;3;0;0;0;6;3;1067940;Refrigerador 602Lts SBS SAMSUNG RS60T5200S9/ZS;LINEA BLANCA
7944908;;M;64;CHILENO;;Boomers;RENCA                         ;METROPOLITANA;329990;1;1;0;0;0;1;1;329990;Lavadora WT16DSBP 16Kg Silver;LINEA BLANCA
7078953;;M;65;CHILENO;;Millenial;"";"";409950;5;1;5;1;409950;0;0;0;ENCIMERA A GAS 4 PLATOS CEG-4600 INOX;LINEA BLANCA
14189311;;F;40;CHILENO;;X;PROVIDENCIA                   ;METROPOLITANA;139980;2;1;2;1;139980;0;0;0;FRIGOBAR 93 LTS MFB-930S121LN;LINEA BLANCA
10002908;;F;56;CHILENO;;Boomers;PROVIDENCIA                   ;METROPOLITANA;219980;2;1;0;0;0;2;1;219980;Refrigerador 210Lts Rojo Frio Dir MRFS2100R273FN;LINEA BLANCA
16828805;;F;34;CHILENO;;Millenial;SANTA CRUZ;O HIGGINS;414950;5;2;2;1;185980;3;1;228970;Secadora Ropa MD100A90/W 9Kg Ventilacion Blanca;LINEA BLANCA
13450599;;F;44;CHILENO;;X;"";"";352980;4;1;0;0;0;4;1;352980;Cocina CH-8700IN 5P;LINEA BLANCA
23445606;;F;33;ARGENTINO;;Extranjero;CALLE LARGA                   ;VALPARAISO;219980;2;1;2;1;219980;0;0;0;Secadora Electrica SEM101BDBY Blanca 10 KG;LINEA BLANCA
10297095;Soltero;M;57;CHILENO;;Boomers;PROVIDENCIA                   ;METROPOLITANA;251970;3;1;0;0;0;3;1;251970;Refrigerador 167Lts Frio Directo 1700-S;LINEA BLANCA
16949588;;F;33;CHILENO;;Millenial;PROVIDENCIA                   ;METROPOLITANA;344950;6;3;0;0;0;6;3;344950;Freezer 142Lts MFH-1430B186C Horizontal;LINEA BLANCA
19128060;;F;25;CHILENO;;Z;N/D;N/D;962409;9;4;4;2;334460;5;2;627949;Secadora Ropa MD100A90/W 9Kg Ventilacion Blanca;LINEA BLANCA
5446227;;F;76;CHILENO;;Silencioso;PENAFLOR                      ;METROPOLITANA;707950;5;2;0;0;0;5;2;707950;Cocina F-5500 Premium 5P;LINEA BLANCA
8198347;;F;60;CHILENO;;Boomers;RENCA                         ;METROPOLITANA;469980;2;1;2;1;469980;0;0;0;Refrigerador 341Lts BF No Frost GB37MPD;LINEA BLANCA
10749085;;F;49;CHILENO;;X;YUMBEL                        ;BIO BIO;153980;2;1;0;0;0;2;1;153980;Freezer 99Lts MFH-1000B131CN Horizontal;LINEA BLANCA
18051642;Soltero;F;30;CHILENO;;Millenial;BUIN                          ;METROPOLITANA;129980;2;1;2;1;129980;0;0;0;FRIGOBAR 93 LTS MFB-930S121LN;LINEA BLANCA
6885949;;F;76;CHILENO;;Silencioso;PROVIDENCIA                   ;METROPOLITANA;331980;2;1;0;0;0;2;1;331980;Lavadora Efficace SZG 17,5Kg Blanca;LINEA BLANCA
6525990;Casado;F;68;CHILENO;;Silencioso;VALDIVIA                      ;LOS LAGOS;186980;2;1;0;0;0;2;1;186980;Freezer 142Lts MFH-1430B186C Horizontal;LINEA BLANCA
19853816;;F;23;CHILENO;;Z;RANCAGUA                      ;L.G.B.OÂ´HIGGINS;336970;3;1;0;0;0;3;1;336970;Lavadora WA17T6260BW/ZS 17Kg Blanca;LINEA BLANCA
17185082;;F;33;CHILENO;;Millenial;N/D;N/D;346970;3;2;0;0;0;3;2;346970;Cocina Andes60TX4 4P Inox;LINEA BLANCA
12725157;;M;46;CHILENO;;X;BUIN                          ;METROPOLITANA;519970;3;2;0;0;0;3;2;519970;Cocina F-5500 Premium 5P;LINEA BLANCA
19544096;;F;25;CHILENO;;Millenial;"";"";189980;2;1;2;1;189980;0;0;0;Cocina CH-9400 4P SILVER;LINEA BLANCA
18580635;;F;28;CHILENO;;Millenial;SALAMANCA                     ;COQUIMBO;135980;2;1;2;1;135980;0;0;0;FRIGOBAR 93 LTS MFB-930S121LN;LINEA BLANCA
4319388;;M;84;CHILENO;;Silencioso;PUERTO MONTT                  ;LOS LAGOS;699930;7;3;0;0;0;7;3;699930;Lavadora Efficace SZG 19,5Kg Silver;LINEA BLANCA
7299663;;F;65;CHILENO;;Boomers;SAN ANTONIO                   ;VALPARAISO;189990;1;1;0;0;0;1;1;189990;Cocina CMC20AXX 4P Inox;LINEA BLANCA
7180439;;F;70;CHILENO;;Silencioso;LA SERENA                     ;COQUIMBO;299990;1;3;0;0;0;1;3;299990;Lavadora WT13WSBP 13Kg Blanca;LINEA BLANCA
26707026;;F;54;VENEZOLANO;;Extranjero;N/D;N/D;424520;4;2;4;2;424520;0;0;0;Lavadora LMA0920WGCL0 9,5Kg Gris;LINEA BLANCA
9550257;;M;60;CHILENO;;Boomers;MELIPILLA                     ;METROPOLITANA;284970;3;2;0;0;0;3;2;284970;Freezer 142Lts EFC14A5MNW Horizontal;LINEA BLANCA
5746681;;F;73;CHILENO;;Silencioso;SAN MIGUEL                    ;METROPOLITANA;429970;3;2;0;0;0;3;2;429970;Lavadora WA17T6260BW/ZS 17Kg Blanca;LINEA BLANCA
9092611;;M;57;CHILENO;;Boomers;QUILICURA                     ;METROPOLITANA;369980;2;1;0;0;0;2;1;369980;Refrigerador 260Lts BF Frio Direc MRFI2660SR346W;LINEA BLANCA
19494899;;F;24;CHILENO;;Z;ARICA                         ;TARAPACA;384440;6;3;0;0;0;6;3;384440;Cocina CH-7400 4P;LINEA BLANCA
5030977;Soltero;M;74;CHILENO;;Silencioso;CONCEPCION                    ;BIO BIO;149990;1;1;0;0;0;1;1;149990;Calefon 11Lts GL Master;LINEA BLANCA
16101577;;F;37;CHILENO;;Millenial;QUELLON                       ;LOS LAGOS;952920;7;2;2;1;245980;5;1;706940;Cocina CH-9600RJ 4P;LINEA BLANCA
18786777;;M;28;CHILENO;;Millenial;SAN FERNANDO                  ;L.G.B.OÂ´HIGGINS;211970;3;1;0;0;0;3;1;211970;Cocina CMC20AXX 4P Inox;LINEA BLANCA
18788993;;M;28;CHILENO;;Millenial;RANCAGUA                      ;L.G.B.OÂ´HIGGINS;135980;2;1;2;1;135980;0;0;0;FRIGOBAR 93 LTS MFB-930S121LN;LINEA BLANCA
16008520;;M;36;CHILENO;;Millenial;N/D;N/D;417960;4;1;0;0;0;4;1;417960;Lavadora WA15T5260BW/ZS 15Kg Blanca;LINEA BLANCA
5630826;;F;77;CHILENO;;Silencioso;CALERA                        ;VALPARAISO;212980;2;1;0;0;0;2;1;212980;Lavadora Semiautomatica LC-6550 6,5Kg;LINEA BLANCA
20238725;;F;23;CHILENO;;Z;"";"";469920;8;6;4;2;414960;4;4;54960;Cocina CH-7400 4P;LINEA BLANCA
18190852;;M;29;CHILENO;;Millenial;LA PINTANA                    ;METROPOLITANA;466920;6;1;6;1;466920;0;0;0;Refrigerador 250 Lts No Frost RMA250PHUG1;LINEA BLANCA
17200827;;F;33;CHILENO;;Millenial;LOS LAGOS                     ;LOS RIOS;256980;2;1;0;0;0;2;1;256980;Lavadora MLS-160BSC03T 16Kg Blanca;LINEA BLANCA
10075908;Casado;F;59;CHILENO;;Boomers;NUEVA IMPERIAL                ;ARAUCANIA;139990;1;1;0;0;0;1;1;139990;Freezer 99Lts MFH-1000B131CN Horizontal;LINEA BLANCA
13666744;;M;42;CHILENO;;X;EL QUISCO                     ;VALPARAISO;255840;15;2;15;2;255840;0;0;0;Encimera Breit FF GL 2P;LINEA BLANCA
9737167;;F;61;CHILENO;;Boomers;CHIMBARONGO                   ;L.G.B.OÂ´HIGGINS;416940;6;3;0;0;0;6;3;416940;Refrigerador 256Lts No Frost Advantage 5200;LINEA BLANCA
10171039;Casado;M;58;CHILENO;;Boomers;RENCA                         ;METROPOLITANA;260980;2;1;0;0;0;2;1;260980;Freezer 200 Lts FDHM200BY0 Horizontal;LINEA BLANCA
16533911;;F;35;CHILENO;;Millenial;N/D;N/D;723980;2;1;2;1;723980;0;0;0;Refrigerador French Door MDRF631FGE02 475 Lts;LINEA BLANCA
13946136;;F;44;CHILENO;;X;RANCAGUA                      ;L.G.B.OÂ´HIGGINS;390980;2;1;0;0;0;2;1;390980;Refrigerador 290Lts BF No Frost RB30N4020S8;LINEA BLANCA
6969987;Viudo;F;69;CHILENO;;Silencioso;PROVIDENCIA                   ;METROPOLITANA;549970;3;1;0;0;0;3;1;549970;Refrigerador 241Lts BF Frio Directo Nordik 415;LINEA BLANCA
6135775;;M;72;CHILENO;;Silencioso;BUIN                          ;METROPOLITANA;359980;2;1;0;0;0;2;1;359980;Lavadora WT16DSBP 16Kg Silver;LINEA BLANCA
11816317;;F;50;CHILENO;;X;IQUIQUE                       ;TARAPACA;435980;2;1;0;0;0;2;1;435980;Lavadora WT19DSBP 19Kg Silver;LINEA BLANCA
9261778;;M;61;CHILENO;;Boomers;COLBUN                        ;MAULE;451970;3;2;0;0;0;3;2;451970;Refrigerador 241Lts BF Frio Directo Nordik 415;LINEA BLANCA
5947208;;M;72;CHILENO;;Silencioso;NOGALES                       ;VALPARAISO;329990;1;1;0;0;0;1;1;329990;REFRIGERADOR TOP MOUNT GT29BPPK NO FROST 254 Lt;LINEA BLANCA
16532993;;F;34;CHILENO;;Millenial;N/D;N/D;298980;2;1;0;0;0;2;1;298980;Lavadora WA17T6260BW/ZS 17Kg Blanca;LINEA BLANCA
12492354;;F;49;CHILENO;;X;COLBUN                        ;MAULE;725970;3;1;0;0;0;3;1;725970;Refrigerador 535Lts Side by Side RS54N3003SL/ZS;LINEA BLANCA
13104510;Divorciado;F;45;CHILENO;INGENIERO EN ADMINISTRACION DE EMPRESAS;Silencioso;"";"";123980;2;1;2;1;123980;0;0;0;ENCIMERA BREIT 2P ALBIN TROTTER;LINEA BLANCA
19215541;;F;26;CHILENO;;Z;TALCA                         ;MAULE;391980;2;1;2;1;391980;0;0;0;Refrigerador 322Lts No Frost BF DB60S;LINEA BLANCA
11661250;;M;51;CHILENO;;X;PUENTE ALTO                   ;METROPOLITANA;169990;1;1;0;0;0;1;1;169990;Lavadora MLS-090GE04N 9Kg Gris;LINEA BLANCA
11441696;;F;52;CHILENO;;X;N/D;N/D;768940;6;3;0;0;0;6;3;768940;Cocina CH-8700IN 5P;LINEA BLANCA
17830891;;F;31;CHILENO;;Millenial;ARICA;TARAPACA;295980;2;1;2;1;295980;0;0;0;Refrigerador 252Lts No Frost MRFS-2700G333FW;LINEA BLANCA
16091752;;M;37;CHILENO;;Millenial;PICHIDEGUA                    ;L.G.B.OÂ´HIGGINS;381960;4;1;0;0;0;4;1;381960;Freezer 142Lts MFH-1430B186C Horizontal;LINEA BLANCA
6664848;Soltero;M;65;CHILENO;;Boomers;CALERA                        ;VALPARAISO;133970;3;2;0;0;0;3;2;133970;Centrifuga Primma 5B 5,5Kilos;LINEA BLANCA
19232082;;F;25;CHILENO;;Z;N/D;N/D;109990;1;1;0;0;0;1;1;109990;Calefont 5Lts GL Essenetial ECO;LINEA BLANCA
15920258;;M;38;CHILENO;;Millenial;COLBUN                        ;MAULE;321980;2;1;0;0;0;2;1;321980;Lavadora WA13T5260BW/ZS 13Kg Blanca;LINEA BLANCA
6125508;;F;72;CHILENO;;Silencioso;LOTA                          ;BIO BIO;270960;4;2;0;0;0;4;2;270960;Cocina CH-7400 4P;LINEA BLANCA
7096983;;F;63;CHILENO;;Boomers;ARICA                         ;ARICA Y PARINACOTA;524470;3;1;0;0;0;3;1;524470;Refrigerador 322Lts No Frost BF DB60S;LINEA BLANCA
10115385;;F;58;CHILENO;;Boomers;RENCA                         ;METROPOLITANA;144980;2;1;2;1;144980;0;0;0;Lavadora Semiautomatica LC-6550 6,5Kg;LINEA BLANCA
8101516;;F;61;CHILENO;;Boomers;RANCAGUA                      ;L.G.B.OÂ´HIGGINS;390970;3;2;0;0;0;3;2;390970;Cocina Andes76HG0 6P Inox;LINEA BLANCA
16224695;;M;36;CHILENO;;Millenial;"";"";389990;1;1;0;0;0;1;1;389990;Lavadora WT16DSBP 16Kg Silver;LINEA BLANCA
7688920;;M;62;CHILENO;;Z;SAN BERNARDO                  ;METROPOLITANA;129990;1;1;0;0;0;1;1;129990;Lavadora WA90H4400SW/ZS 9Kg Blanca;LINEA BLANCA
6194450;;F;69;CHILENO;;Silencioso;LAMPA                         ;METROPOLITANA;554950;5;3;0;0;0;5;3;554950;Lavadora WA15T5260BW/ZS 15Kg Blanca;LINEA BLANCA
7305217;;F;65;CHILENO;;Boomers;PENAFLOR                      ;METROPOLITANA;494960;4;2;0;0;0;4;2;494960;Lavadora WA15T5260BW/ZS 15Kg Blanca;LINEA BLANCA
6692569;;M;68;CHILENO;;Silencioso;PUDAHUEL                      ;METROPOLITANA;810920;8;4;0;0;0;8;4;810920;Cocina CH-9050SI 4P;LINEA BLANCA
8057850;;M;64;CHILENO;;Boomers;CORONEL                       ;BIO BIO;914150;11;5;0;0;0;11;5;914150;Lavadora MLS-090GE04N 9Kg Gris;LINEA BLANCA
7619674;;F;68;CHILENO;;Boomers;LOS ANGELES                   ;BIO BIO;1142750;7;4;0;0;0;7;4;1142750;Cocina Andes7650FX 5P Inox;LINEA BLANCA
14600460;;M;41;CHILENO;;X;CALAMA                        ;ANTOFAGASTA;537970;3;1;0;0;0;3;1;537970;Lavadora Efficace SZG 19,5Kg Silver;LINEA BLANCA
26475800;;F;28;EXTRANJERO - NO INFORMA NACIONALIDAD;;Extranjero;"";"";309980;2;1;0;0;0;2;1;309980;Cocina Andes60TX4 4P Inox;LINEA BLANCA
5537943;;M;76;CHILENO;;Silencioso;VALDIVIA                      ;LOS RIOS;393970;3;1;0;0;0;3;1;393970;Freezer 162 Lts SFV-205 SI Vertical;LINEA BLANCA
12790734;Casado;M;53;CHILENO;;X;LINARES                       ;MAULE;187980;2;1;0;0;0;2;1;187980;Lavadora Semiautomatica LC-6550 6,5Kg;LINEA BLANCA
8751353;Casado;M;70;CHILENO;;Silencioso;PARRAL                        ;MAULE;593940;6;1;0;0;0;6;1;593940;Lavadora MLS-160BSC03T 16Kg Blanca;LINEA BLANCA
6295588;;F;69;CHILENO;;Silencioso;CORONEL                       ;BIO BIO;166980;2;1;0;0;0;2;1;166980;Freezer 99Lts MFH-1000B131CN Horizontal;LINEA BLANCA
7525299;;F;69;CHILENO;;Silencioso;PROVIDENCIA                   ;METROPOLITANA;379990;1;1;0;0;0;1;1;379990;Refrigerador 290Lts BF No Frost RB30N4020S8;LINEA BLANCA
26395667;;M;37;VENEZOLANO;;Extranjero;N/D;N/D;469960;4;2;2;1;359980;2;1;109980;Cocina CH-8900IN 5P;LINEA BLANCA
8083287;;F;62;CHILENO;;Boomers;SANTA MARIA                   ;VALPARAISO;329990;1;1;0;0;0;1;1;329990;Cocina F-5500 Premium 5P;LINEA BLANCA
7725517;;M;66;CHILENO;;Boomers;SAN PEDRO DE ATACAMA          ;ANTOFAGASTA;174980;2;4;0;0;0;2;4;174980;Cocina CH-9500 NG 4P;LINEA BLANCA
17204055;;M;32;CHILENO;;Millenial;N/D;N/D;779940;6;2;0;0;0;6;2;779940;Lavadora Efficace SZG 19,5Kg Silver;LINEA BLANCA
11814463;;F;51;CHILENO;;X;ARICA                         ;ARICA Y PARINACOTA;249970;3;1;0;0;0;3;1;249970;Cocina CH-7400 4P;LINEA BLANCA
8693652;;F;64;CHILENO;;Boomers;PUDAHUEL                      ;METROPOLITANA;229980;2;1;0;0;0;2;1;229980;Lavadora 9 Kg Carga Superior Blanca;LINEA BLANCA
11903003;;F;50;CHILENO;;X;RENCA                         ;METROPOLITANA;125840;2;1;2;1;125840;0;0;0;FRIGOBAR 93 LTS MFB-930S121LN;LINEA BLANCA
8996544;;F;61;CHILENO;;Boomers;ANTOFAGASTA                   ;ANTOFAGASTA;305970;3;1;0;0;0;3;1;305970;Refrigerador 260Lts BF Frio Direc MRFI2660SR346W;LINEA BLANCA
19797571;;F;24;CHILENO;;Z;TEMUCO;ARAUCANIA;234980;2;1;2;1;234980;0;0;0;COCINA SINDELEN CH-6200IN 4P;LINEA BLANCA
6551989;;M;67;CHILENO;;Boomers;EL BOSQUE                     ;METROPOLITANA;249990;1;1;0;0;0;1;1;249990;Refrigerador 260Lts BF Frio Direc MRFI2660SR346W;LINEA BLANCA
6986638;;F;65;CHILENO;;Boomers;CURICO                        ;MAULE;369970;3;1;0;0;0;3;1;369970;Refrigerador 244Lts Frio Directo Progress 3100;LINEA BLANCA
11915450;;F;49;CHILENO;;X;LOS ALAMOS                    ;BIO BIO;791450;5;1;0;0;0;5;1;791450;Cocina F-5500 Premium 5P;LINEA BLANCA
9201791;;M;61;CHILENO;;Boomers;CURANILAHUE                   ;BIO BIO;437980;2;1;0;0;0;2;1;437980;Lavadora WT19DSBP 19Kg Silver;LINEA BLANCA
7722551;;F;63;CHILENO;;Boomers;TRAIGUEN                      ;ARAUCANIA;511940;6;4;0;0;0;6;4;511940;Cocina F-2808 4P;LINEA BLANCA
17865151;;F;31;CHILENO;;Millenial;"";"";456970;3;1;0;0;0;3;1;456970;Lavadora Premium Care 20SZ 20Kg Silver;LINEA BLANCA
6355273;;F;72;CHILENO;;Silencioso;PUENTE ALTO                   ;METROPOLITANA;559980;2;1;2;1;559980;0;0;0;Refrigerador 468Lts Side by Side MRTT-4790S312FW;LINEA BLANCA
11424129;;F;52;CHILENO;;X;RENCA                         ;METROPOLITANA;341980;2;1;0;0;0;2;1;341980;Refrigerador 262Lts No Frost MRFI-2760S349RW-DA;LINEA BLANCA
11383665;;F;54;CHILENO;;X;RENCA                         ;METROPOLITANA;199990;1;1;0;0;0;1;1;199990;Cocina CH-7400 4P;LINEA BLANCA
16177675;;F;54;CHILENO;;Boomers;NUEVA IMPERIAL                ;ARAUCANIA;521980;2;1;0;0;0;2;1;521980;Refrigerador 341Lts BF No Frost GB37MPD;LINEA BLANCA
16293764;;F;36;CHILENO;;Millenial;PELLUHUE                      ;MAULE;202980;2;2;0;0;0;2;2;202980;Lavadora LMA0920WGCL0 9,5Kg Gris;LINEA BLANCA
17153396;;F;39;CHILENO;;X;VICTORIA                      ;ARAUCANIA;691970;3;1;0;0;0;3;1;691970;Refrigerador 525Lts Side by Side SFX500;LINEA BLANCA
12279442;;F;51;CHILENO;;X;PUENTE ALTO;METROPOLITANA;189980;2;1;2;1;189980;0;0;0;Cocina CMC20AXX 4P Inox;LINEA BLANCA
8839801;;F;64;CHILENO;;Boomers;OVALLE                        ;COQUIMBO;359970;3;1;0;0;0;3;1;359970;Lavadora Efficace SZG 17,5Kg Silver;LINEA BLANCA
6918312;;F;71;CHILENO;;Silencioso;PROVIDENCIA                   ;METROPOLITANA;169990;1;1;0;0;0;1;1;169990;Freezer 142Lts MFH-1430B186C Horizontal;LINEA BLANCA
18900919;;F;27;CHILENO;;Millenial;PROVIDENCIA                   ;METROPOLITANA;197970;3;2;2;1;174980;1;1;22990;Lavadora MLS-090GE04N 9Kg Gris;LINEA BLANCA
16923569;;M;34;CHILENO;;Millenial;PROVIDENCIA                   ;METROPOLITANA;319980;2;1;2;1;319980;0;0;0;Refrigerador GT32BPPDC 312Lts No Frost;LINEA BLANCA
26054292;;M;25;PERUANO;;Extranjero;LA PINTANA                    ;METROPOLITANA;742950;5;2;0;0;0;5;2;742950;Freezer 200 Lts FDHM200BY0 Horizontal;LINEA BLANCA
6430845;;F;74;CHILENO;;Silencioso;LONCOCHE                      ;ARAUCANIA;189990;1;1;0;0;0;1;1;189990;Cocina CH-7400 4P;LINEA BLANCA
7193276;;F;71;CHILENO;;Silencioso;LOS ANDES                     ;VALPARAISO;286970;3;2;0;0;0;3;2;286970;Lavadora MLS-160GSC03T 16Kg Gris;LINEA BLANCA
9613191;;F;62;CHILENO;;Boomers;SAN BERNARDO                  ;METROPOLITANA;539970;3;2;0;0;0;3;2;539970;Refrigerador 255Lts No Frost RT25FARADS8/ZS;LINEA BLANCA
13371672;;M;44;CHILENO;;X;VILLA ALEGRE                  ;MAULE;159990;1;1;0;0;0;1;1;159990;Freezer 142Lts MFH-1430B186C Horizontal;LINEA BLANCA
6844131;;M;66;CHILENO;;Boomers;CALAMA                        ;ANTOFAGASTA;189990;1;1;0;0;0;1;1;189990;Refrigerador 167Lts Frio Directo 1700-S;LINEA BLANCA
19376655;;F;26;CHILENO;;Z;ESTACION CENTRAL              ;METROPOLITANA;165840;2;1;2;1;165840;0;0;0;Lavadora LMA0920WGCL0 9,5Kg Gris;LINEA BLANCA
8329721;;M;61;CHILENO;;Boomers;PROVIDENCIA                   ;METROPOLITANA;245480;2;1;2;1;245480;0;0;0;Encimera a Gas F GC75V A 5P;LINEA BLANCA
10669823;;F;54;CHILENO;;X;COPIAPO                       ;ATACAMA;301970;3;1;0;0;0;3;1;301970;Refrigerador 260Lts BF Frio Direc MRFI2660SR346W;LINEA BLANCA
4108630;;F;80;CHILENO;;Silencioso;LA CISTERNA                   ;METROPOLITANA;214980;5;1;0;0;0;5;1;214980;Cocina CH-7400 4P;LINEA BLANCA
10758366;;M;53;CHILENO;;X;COQUIMBO;COQUIMBO;395070;5;2;5;2;395070;0;0;0;Cocina CH-7400 4P;LINEA BLANCA
11176295;;F;54;CHILENO;;Boomers;PUENTE ALTO                   ;METROPOLITANA;460970;3;2;0;0;0;3;2;460970;Cocina F-5500 Premium 5P;LINEA BLANCA
15320661;;M;41;CHILENO;;X;ANTOFAGASTA                   ;ANTOFAGASTA;369980;2;1;2;1;369980;0;0;0;Lavadora Secadora WD95T4046CE/ZS 9,5Kg/6Kg Blanc;LINEA BLANCA
26904962;;F;30;EXTRANJERO - NO INFORMA NACIONALIDAD;;Extranjero;BUIN                          ;METROPOLITANA;259980;2;1;0;0;0;2;1;259980;Cocina CH-7400 4P;LINEA BLANCA
18344758;;F;29;CHILENO;;Millenial;LOS ANGELES                   ;BIO BIO;233370;2;1;0;0;0;2;1;233370;Freezer 200 Lts FDHM200BY0 Horizontal;LINEA BLANCA
17901284;;M;30;CHILENO;;Millenial;CONSTITUCION                  ;MAULE;337980;2;3;0;0;0;2;3;337980;Lavadora Efficace SZG 15,5Kg Silver;LINEA BLANCA
19052495;;F;26;CHILENO;;Z;LOS ANGELES                   ;BIO BIO;197370;2;1;0;0;0;2;1;197370;Freezer horizontal 142Lts lfh-151 blanco;LINEA BLANCA
9285714;;M;59;CHILENO;;Boomers;RENCA                         ;METROPOLITANA;219980;2;1;0;0;0;2;1;219980;Refrigerador 167Lts MRFI-1700R234RN F.Direc Rojo;LINEA BLANCA
21106770;;F;25;CHILENO;;Extranjero;CORONEL                       ;BIO BIO;197220;4;3;0;0;0;4;3;197220;Freezer 142Lts MFH-1430B186C Horizontal;LINEA BLANCA
13140894;;M;44;CHILENO;;X;"";"";185470;2;1;0;0;0;2;1;185470;Freezer 99Lts MFH-1000B131CN Horizontal;LINEA BLANCA
8232339;;F;60;CHILENO;;Boomers;PROVIDENCIA                   ;METROPOLITANA;533980;2;1;2;1;533980;0;0;0;Refrigerador Bottom No Frost con Dispensador 336;LINEA BLANCA
12401846;;M;49;CHILENO;;X;CONCON                        ;VALPARAISO;308970;3;1;0;0;0;3;1;308970;Refrigerador 260Lts BF Frio Direc MRFI2660SR346W;LINEA BLANCA
20269330;;F;22;CHILENO;;Z;"";"";229990;1;1;0;0;0;1;1;229990;Refrigerador 252Lts No Frost MRFS-2700G333FW;LINEA BLANCA
12377772;;F;48;CHILENO;;X;CHILLAN                       ;BIO BIO;316450;5;5;0;0;0;5;5;316450;FREEZER Z200 196LTS HORIZONTAL FENSA;LINEA BLANCA
13400453;;M;44;CHILENO;;X;PANGUIPULLI                   ;LOS LAGOS;448520;4;2;3;1;268530;1;1;179990;Cocina CH-7400 4P;LINEA BLANCA
12202838;;F;49;CHILENO;;X;ANCUD                         ;LOS LAGOS;307080;4;2;4;2;307080;0;0;0;Lavadora MLS-090GE04N 9Kg Gris;LINEA BLANCA
11522418;;F;52;CHILENO;;X;SAN ANTONIO                   ;VALPARAISO;487970;3;2;0;0;0;3;2;487970;Lavadora Secadora WD11TA046BX/ZS 11Kg/7Kg Inox;LINEA BLANCA
9726552;;M;58;CHILENO;;Boomers;N/D;N/D;316360;3;1;0;0;0;3;1;316360;Cocina Andes60TX4 4P Inox;LINEA BLANCA
14355910;;F;42;CHILENO;;X;LOS ANGELES                   ;BIO BIO;196470;3;1;0;0;0;3;1;196470;Lavadora MLS-090GE04N 9Kg Gris;LINEA BLANCA
17954021;Soltero;M;30;CHILENO;INGENIERO COMERCIAL;Millenial;PROVIDENCIA                   ;METROPOLITANA;301980;2;1;2;1;301980;0;0;0;Freezer Horizontal FFH Z300 291Lts;LINEA BLANCA
12987528;;F;47;CHILENO;;X;CARAHUE                       ;ARAUCANIA;313970;3;2;0;0;0;3;2;313970;Refrigerador 167Lts MRFI-1700R234RN F.Direc Rojo;LINEA BLANCA
17804320;;M;31;CHILENO;;Millenial;ANTOFAGASTA                   ;ANTOFAGASTA;77540;2;1;2;1;77540;0;0;0;Encimera CE2-435I 2P Inox;LINEA BLANCA
10162141;;M;55;CHILENO;;Boomers;NUEVA IMPERIAL                ;ARAUCANIA;169990;1;1;0;0;0;1;1;169990;Freezer horizontal 142Lts lfh-151 blanco;LINEA BLANCA
8118808;;M;61;CHILENO;;Boomers;SAN RAMON                     ;METROPOLITANA;379980;2;1;0;0;0;2;1;379980;Refrigerador 322Lts No Frost BF DB60S;LINEA BLANCA
9961697;;F;59;CHILENO;;Boomers;MAIPU                         ;METROPOLITANA;199990;1;1;0;0;0;1;1;199990;Freezer 145 Lts FDHM150BY0 Horizontal;LINEA BLANCA
12821040;Soltero;M;46;CHILENO;;X;RENCA                         ;METROPOLITANA;337980;2;1;0;0;0;2;1;337980;Lavadora Efficace SZG 15,5Kg Silver;LINEA BLANCA
5195822;;F;78;CHILENO;;Silencioso;RENCA                         ;METROPOLITANA;159990;1;1;0;0;0;1;1;159990;Lavadora Semiautomatica LC-6550 6,5Kg;LINEA BLANCA
6897360;;M;70;CHILENO;;Silencioso;VILLARICA                     ;ARAUCANIA;324980;2;2;0;0;0;2;2;324980;Cocina 775X 4P;LINEA BLANCA
15889472;;F;37;CHILENO;;Millenial;N/D;N/D;468940;6;3;2;1;63980;4;2;404960;Lavadora MLS-160BSC03T 16Kg Blanca;LINEA BLANCA
11780018;;F;51;CHILENO;;X;ANGOL                         ;ARAUCANIA;426980;2;1;0;0;0;2;1;426980;Refrigerador 300Lts No Frost RT29K500JS8/ZS;LINEA BLANCA
6424043;;M;67;CHILENO;;Boomers;PUTAENDO                      ;VALPARAISO;295970;4;1;0;0;0;4;1;295970;Freezer 145 Lts FDHM150BY0 Horizontal;LINEA BLANCA
26577862;;M;33;EXTRANJERO - NO INFORMA NACIONALIDAD;;Extranjero;CURICO                        ;MAULE;350970;3;1;0;0;0;3;1;350970;Freezer 200 Lts FDHM200BY0 Horizontal;LINEA BLANCA
14595461;;M;41;CHILENO;;X;COQUIMBO                      ;COQUIMBO;399960;4;1;0;0;0;4;1;399960;Cocina CH-7400 4P;LINEA BLANCA
7284216;;F;58;CHILENO;;Boomers;PROVIDENCIA                   ;METROPOLITANA;259960;4;2;4;2;259960;0;0;0;Lavadora 9 Kg Carga Superior Blanca;LINEA BLANCA
23712968;;F;42;COLOMBIANO;;Extranjero;N/D;N/D;730310;8;2;0;0;0;8;2;730310;Lavadora Efficace SZG 15,5Kg Silver;LINEA BLANCA
18323346;;F;31;CHILENO;;Millenial;CARAHUE                       ;ARAUCANIA;689970;3;1;0;0;0;3;1;689970;Refrigerador 527Lts Side by Side MRSBS5300G689WE;LINEA BLANCA
13553963;;F;43;CHILENO;;X;PROVIDENCIA                   ;METROPOLITANA;319980;2;1;2;1;319980;0;0;0;Lavadora Premium Care 20SZ 20Kg Silver;LINEA BLANCA
7530497;;M;69;CHILENO;;Silencioso;TALCAHUANO                    ;BIO BIO;424850;4;3;0;0;0;4;3;424850;Cocina F-2808 4P;LINEA BLANCA
13489856;;F;44;CHILENO;;X;SAN RAMON                     ;METROPOLITANA;293970;3;2;3;2;293970;0;0;0;ENCIMERA CE4-600 INOX 4P SINDELEN;LINEA BLANCA
8159920;;M;63;CHILENO;;Boomers;RENCA                         ;METROPOLITANA;289370;2;1;0;0;0;2;1;289370;Lavadora MLS-160BSC03T 16Kg Blanca;LINEA BLANCA
14048847;;M;40;CHILENO;;X;PROVIDENCIA                   ;METROPOLITANA;395470;2;1;0;0;0;2;1;395470;Lavadora WA17T6260BW/ZS 17Kg Blanca;LINEA BLANCA
18346512;;M;29;CHILENO;;Millenial;PAINE                         ;METROPOLITANA;473960;4;2;2;1;83980;2;1;389980;Lavadora MLS-190GC03N 19Kg Gris;LINEA BLANCA
16340384;;F;36;CHILENO;;Millenial;N/D;N/D;291970;3;1;0;0;0;3;1;291970;Refrigerador 244Lts Frio Directo Progress 3100;LINEA BLANCA
18901863;Soltero;M;27;CHILENO;;Z;PROVIDENCIA                   ;METROPOLITANA;389990;1;1;0;0;0;1;1;389990;Cocina Andes60TX4 4P Inox;LINEA BLANCA
10710598;;M;53;CHILENO;;X;VILLA ALEMANA                 ;VALPARAISO;221980;2;1;0;0;0;2;1;221980;Freezer 142Lts EFC14A5MNW Horizontal;LINEA BLANCA
13603000;;F;42;CHILENO;;X;RENCA                         ;METROPOLITANA;461680;4;2;4;2;461680;0;0;0;Cocina CH-9950NG-1 6P Negro;LINEA BLANCA
10118595;;F;58;CHILENO;;Boomers;N/D;N/D;179990;1;1;0;0;0;1;1;179990;Cocina CH-9050SI 4P;LINEA BLANCA
12965432;;M;45;CHILENO;;X;RENCA                         ;METROPOLITANA;669990;1;1;0;0;0;1;1;669990;Refrigerador 525Lts Side by Side SFX500;LINEA BLANCA
6528631;;M;70;CHILENO;;Silencioso;BULNES                        ;BIO BIO;137650;4;2;0;0;0;4;2;137650;CAMPANA ESSENTIAL 601 INOX ALBIN TROTTER;LINEA BLANCA
7427456;;M;67;CHILENO;;Boomers;MACHALI                       ;L.G.B.OÂ´HIGGINS;264970;3;2;0;0;0;3;2;264970;Lavadora Efficace BZG 9,5Kg Blanca;LINEA BLANCA
6811416;Soltero;M;68;CHILENO;;Silencioso;RENCA                         ;METROPOLITANA;309990;1;1;0;0;0;1;1;309990;Cocina F-2808 4P;LINEA BLANCA
11206542;;F;54;CHILENO;;Boomers;N/D;N/D;163980;2;1;2;1;163980;0;0;0;Cocina CMC20AXX 4P Inox;LINEA BLANCA
8181946;;M;65;CHILENO;;Boomers;ESTACION CENTRAL              ;METROPOLITANA;229980;2;1;0;0;0;2;1;229980;Cocina CH-9600RJ 4P;LINEA BLANCA
17720521;;M;28;CHILENO;;Millenial;PROVIDENCIA                   ;METROPOLITANA;269990;1;1;0;0;0;1;1;269990;Lavadora Efficace SZG 15,5Kg Silver;LINEA BLANCA
17388088;;M;32;CHILENO;;Millenial;CALERA                        ;VALPARAISO;289980;2;1;2;1;289980;0;0;0;Lavadora MLS-190GC03N 19Kg Gris;LINEA BLANCA
11279700;;F;53;CHILENO;;X;N/D;N/D;169990;1;1;0;0;0;1;1;169990;Freezer 145 Lts FDHM150BY0 Horizontal;LINEA BLANCA
5333543;;F;77;CHILENO;;Silencioso;PROVIDENCIA                   ;METROPOLITANA;117370;2;1;0;0;0;2;1;117370;Calefon 5Lts GL Master;LINEA BLANCA
6859187;;F;69;CHILENO;;Silencioso;VILLA ALEMANA                 ;VALPARAISO;299550;4;1;0;0;0;4;1;299550;Refrigerador 210Lts Rojo Frio Dir MRFS2100R273FN;LINEA BLANCA
8010195;;F;62;CHILENO;;Boomers;RANCAGUA                      ;L.G.B.OÂ´HIGGINS;269980;2;1;0;0;0;2;1;269980;Cocina 775X 4P;LINEA BLANCA
22242274;;F;49;PERUANO;;Extranjero;RENCA                         ;METROPOLITANA;372760;3;1;0;0;0;3;1;372760;Lavadora WA17T6260BW/ZS 17Kg Blanca;LINEA BLANCA
8415016;Casado;M;64;CHILENO;AGRONOMO;Boomers;SAN CARLOS                    ;BIO BIO;265860;3;1;0;0;0;3;1;265860;Refrigerador 252Lts No Frost MRFS-2700G333FW;LINEA BLANCA
17254249;Soltero;F;32;CHILENO;ADMINISTRADOR GASTRONOMICO;Millenial;PROVIDENCIA                   ;METROPOLITANA;163980;2;1;2;1;163980;0;0;0;Calefon 11Lts GL Master;LINEA BLANCA
16912926;;F;33;CHILENO;;Millenial;PROVIDENCIA                   ;METROPOLITANA;229980;2;1;2;1;229980;0;0;0;Refrigerador 260Lts BF Frio Direc MRFI2660SR346W;LINEA BLANCA
4928892;;F;74;CHILENO;;Silencioso;OVALLE                        ;COQUIMBO;209990;1;1;0;0;0;1;1;209990;Freezer FDHM150BY1 150Lts Horizontal;LINEA BLANCA
17209890;;M;33;CHILENO;;Millenial;N/D;N/D;184980;2;1;2;1;184980;0;0;0;Lavadora MLS-090GE04N 9Kg Gris;LINEA BLANCA
4849848;Divorciado;M;75;CHILENO;;Silencioso;RENCA                         ;METROPOLITANA;109990;1;1;0;0;0;1;1;109990;Calefon 7Lts GL Master;LINEA BLANCA
6071632;;F;71;CHILENO;;Silencioso;VINA DEL MAR                  ;VALPARAISO;89990;1;1;0;0;0;1;1;89990;Calefon 5Lts GL Master;LINEA BLANCA
17290037;Casado;F;33;CHILENO;;Millenial;PROVIDENCIA                   ;METROPOLITANA;146980;2;1;2;1;146980;0;0;0;Lavadora Semiautomatica Twister 5100 4Kg;LINEA BLANCA
17988105;Soltero;M;30;CHILENO;;Millenial;NIQUEN                        ;BIO BIO;377360;3;2;0;0;0;3;2;377360;Lavadora WA90H4400SW/ZS 9Kg Blanca;LINEA BLANCA
13337764;;M;44;CHILENO;;X;N/D;N/D;327960;4;2;0;0;0;4;2;327960;Cocina MV 120 4 Platos;LINEA BLANCA
11552891;;F;52;CHILENO;;X;SAN JOSE DE MAIPO             ;METROPOLITANA;249980;2;1;2;1;249980;0;0;0;Refrigerador 260Lts BF Frio Direc MRFI2660SR346W;LINEA BLANCA
15680806;;M;37;CHILENO;;Millenial;N/D;N/D;1086530;6;1;0;0;0;6;1;1086530;Lavadora WA13T5260BW/ZS 13Kg Blanca;LINEA BLANCA
14220040;;F;42;CHILENO;;X;PROVIDENCIA                   ;METROPOLITANA;309990;2;1;2;1;309990;0;0;0;Lavadora Premium Care 20SZ 20Kg Silver;LINEA BLANCA
9598084;;F;59;CHILENO;;Boomers;PROVIDENCIA                   ;METROPOLITANA;317980;2;1;0;0;0;2;1;317980;Lavadora Secadora MLSF-1108BN05N 11Kg/8Kg Blanca;LINEA BLANCA
13508646;;F;44;CHILENO;;X;N/D;N/D;189990;1;1;0;0;0;1;1;189990;Cocina CH-7400 4P;LINEA BLANCA
16218516;;F;36;CHILENO;;Millenial;CHILLAN                       ;BIO BIO;323960;4;3;4;3;323960;0;0;0;Lavadora WT13WSBP 13Kg Blanca;LINEA BLANCA
18017025;;M;29;CHILENO;;Silencioso;PROVIDENCIA                   ;METROPOLITANA;439980;2;1;2;1;439980;0;0;0;Refrigerador 341Lts BF No Frost GB37MPD;LINEA BLANCA
8994928;;F;62;CHILENO;;Boomers;CHANARAL                      ;ATACAMA;348440;5;2;0;0;0;5;2;348440;Lavadora WT13WSBP 13Kg Blanca;LINEA BLANCA
17236209;;F;32;CHILENO;;Millenial;ANTOFAGASTA                   ;ANTOFAGASTA;299370;2;1;0;0;0;2;1;299370;Refrigerador 252Lts No Frost MRFS-2700G333FW;LINEA BLANCA
13418813;;F;44;CHILENO;;X;QUINTERO                      ;VALPARAISO;384560;3;1;0;0;0;3;1;384560;Refrigerador 303Lts BF Frio Directo Nordik 480;LINEA BLANCA
14372811;;M;47;CHILENO;;X;PROVIDENCIA                   ;METROPOLITANA;173980;2;1;2;1;173980;0;0;0;Freezer Horizontal MFH-1990B258CN 198Lts;LINEA BLANCA
15790747;;M;37;CHILENO;;Millenial;PROVIDENCIA                   ;METROPOLITANA;297960;3;1;3;1;297960;0;0;0;Lavadora MLS-090GE04N 9Kg Gris;LINEA BLANCA
19962643;;M;24;CHILENO;;Z;PROVIDENCIA                   ;METROPOLITANA;215980;2;1;2;1;215980;0;0;0;Lavadora superior MLS-110GE04N 11Kg;LINEA BLANCA
13377266;;F;44;CHILENO;;X;CHILLAN                       ;BIO BIO;729360;3;1;0;0;0;3;1;729360;Refrigerador 525Lts Side by Side SFX500;LINEA BLANCA
15346806;;M;40;CHILENO;;X;SAN BERNARDO                  ;METROPOLITANA;339980;2;1;0;0;0;2;1;339980;Lavadora MLS-190GC03N 19Kg Gris;LINEA BLANCA
8336113;;F;64;CHILENO;;Boomers;LA CISTERNA                   ;METROPOLITANA;445460;3;1;0;0;0;3;1;445460;Lavadora WT19DSBP 19Kg Silver;LINEA BLANCA
15020618;;F;40;CHILENO;;X;"";"";415980;2;1;2;1;415980;0;0;0;Refrigerador LB33MPP 306Lts Bottom No Frost;LINEA BLANCA
20031514;;M;23;CHILENO;;Z;COIHAIQUE                     ;AYSEN;335470;2;1;0;0;0;2;1;335470;Lavadora Efficace SZG 15,5Kg Silver;LINEA BLANCA
9963899;;F;59;CHILENO;;Boomers;PADRE LAS CASAS               ;ARAUCANIA;393460;3;1;0;0;0;3;1;393460;Cocina Andes76HG0 6P Inox;LINEA BLANCA
18370778;;F;28;CHILENO;;Millenial;CALAMA                        ;ANTOFAGASTA;269640;2;1;2;1;269640;0;0;0;Refrigerador 249Lts No Frost RMA250PHUG;LINEA BLANCA
19465392;;F;25;CHILENO;;Z;PROVIDENCIA                   ;METROPOLITANA;708640;2;1;2;1;708640;0;0;0;Lavadora secadora WD14BVC2S6 14kg/8kg Negra;LINEA BLANCA
8852247;;F;63;CHILENO;;Boomers;N/D;N/D;510460;3;1;0;0;0;3;1;510460;Refrigerador 322Lts No Frost BF DB60S;LINEA BLANCA
6248461;;M;71;CHILENO;;Silencioso;SAN FERNANDO                  ;L.G.B.OÂ´HIGGINS;957040;5;2;0;0;0;5;2;957040;Refrigerador 331Lts No Frost BF RB34T632FSA/ZS;LINEA BLANCA
8725138;;F;61;CHILENO;;Boomers;PROVIDENCIA                   ;METROPOLITANA;274860;3;1;0;0;0;3;1;274860;Cocina MV 220 4P;LINEA BLANCA
12711677;;M;48;CHILENO;;X;TEMUCO                        ;ARAUCANIA;353460;3;1;0;0;0;3;1;353460;Refrigerador 260Lts BF Frio Direc MRFI2660SR346W;LINEA BLANCA
10306749;;F;57;CHILENO;;Boomers;RENCA                         ;METROPOLITANA;144540;2;1;2;1;144540;0;0;0;Lavadora WA80H4200SW/ZS 8Kg Blanca;LINEA BLANCA
7317021;;M;67;CHILENO;;Boomers;ALTO HOSPICIO;TARAPACA;209990;1;1;0;0;0;1;1;209990;Freezer 142Lts EFC14A5MNW Horizontal;LINEA BLANCA
17378141;Soltero;M;32;CHILENO;;Millenial;PROVIDENCIA                   ;METROPOLITANA;149990;1;1;0;0;0;1;1;149990;Cocina CMC20AXX 4P Inox;LINEA BLANCA
17883897;Soltero;F;30;CHILENO;;Millenial;RENCA                         ;METROPOLITANA;225480;2;1;2;1;225480;0;0;0;Cocina 755 S 4P;LINEA BLANCA
7120170;;M;67;CHILENO;;Boomers;EL MONTE                      ;METROPOLITANA;94990;1;1;0;0;0;1;1;94990;Calefon 7Lts GL Master;LINEA BLANCA
18861238;;F;27;CHILENO;;Silencioso;PROVIDENCIA                   ;METROPOLITANA;147540;2;1;2;1;147540;0;0;0;Lavadora WA80H4200SW/ZS 8Kg Blanca;LINEA BLANCA
10788842;;F;56;CHILENO;;Boomers;MELIPILLA                     ;METROPOLITANA;638050;4;1;0;0;0;4;1;638050;Refrigerador DW44S 400Lts Dispen No Frost;LINEA BLANCA
23546845;;F;23;COLOMBIANO;;Extranjero;PROVIDENCIA                   ;METROPOLITANA;175980;2;1;2;1;175980;0;0;0;Cocina CMC5515GCH-1 4P;LINEA BLANCA
17421924;;M;32;CHILENO;;Millenial;PROVIDENCIA                   ;METROPOLITANA;254980;2;1;2;1;254980;0;0;0;Refrigerador 241Lts BF Frio Directo Nordik 415;LINEA BLANCA
11594121;;M;52;CHILENO;;Silencioso;PROVIDENCIA                   ;METROPOLITANA;348540;2;1;2;1;348540;0;0;0;Refrigerador 300Lts No Frost RT29K500JS8/ZS;LINEA BLANCA
16397319;;M;36;CHILENO;;Millenial;LUMACO;ARAUCANIA;186980;2;1;2;1;186980;0;0;0;Cocina MV 120 4 Platos;LINEA BLANCA
10423975;;M;56;CHILENO;;Boomers;PROVIDENCIA                   ;METROPOLITANA;294980;2;1;0;0;0;2;1;294980;Lavadora WT16WPB 16 KG Blanca;LINEA BLANCA
15138564;;M;39;CHILENO;;X;N/D;N/D;469980;3;2;2;1;399990;1;1;69990;Refrigerador 318Lts No Frost RT32K5730SL/ZS;LINEA BLANCA
18814902;;F;27;CHILENO;;Millenial;SAN PEDRO DE LA PAZ           ;BIO BIO;205840;2;1;2;1;205840;0;0;0;Secadora Ropa Solare 9100 9K Ventilacion;LINEA BLANCA
17662994;;M;31;CHILENO;;Silencioso;PROVIDENCIA                   ;METROPOLITANA;213980;2;1;2;1;213980;0;0;0;HORNO EMPOTRABLE HE-7200 INOX 2250W 57L SINDELEN;LINEA BLANCA
18856512;;F;27;CHILENO;;Silencioso;PROVIDENCIA                   ;METROPOLITANA;363980;2;1;2;1;363980;0;0;0;Lavadora WT19DSBP 19Kg Silver;LINEA BLANCA
8946436;;M;61;CHILENO;;Boomers;N/D;N/D;639960;4;2;4;2;639960;0;0;0;Lavadora WT16WPB 16 KG Blanca;LINEA BLANCA
10447501;;M;57;CHILENO;;Boomers;OVALLE                        ;COQUIMBO;451070;2;1;0;0;0;2;1;451070;Lavadora WT19DSBP 19Kg Silver;LINEA BLANCA
18408290;;M;28;CHILENO;;Millenial;HUECHURABA                    ;METROPOLITANA;259980;2;1;2;1;259980;0;0;0;Refrigerador 241Lts BF Frio Directo Nordik 415;LINEA BLANCA
18491593;;F;28;CHILENO;;Millenial;OSORNO                        ;LOS LAGOS;220980;2;1;0;0;0;2;1;220980;Lavadora 9 Kg Carga Superior Blanca;LINEA BLANCA
11545189;;F;52;CHILENO;;X;RENCA                         ;METROPOLITANA;404020;3;1;3;1;404020;0;0;0;Refrigerador 300Lts No Frost RT29K500JS8/ZS;LINEA BLANCA
16571752;;F;34;CHILENO;;Millenial;SAN BERNARDO                  ;METROPOLITANA;324980;2;1;0;0;0;2;1;324980;Lavadora Efficace SZG 15,5Kg Silver;LINEA BLANCA
9957242;Casado;M;58;CHILENO;;Boomers;LAS CABRAS                    ;L.G.B.OÂ´HIGGINS;319990;1;1;0;0;0;1;1;319990;Refrigerador 255Lts No Frost RT25FARADS8/ZS;LINEA BLANCA
15682193;;F;38;CHILENO;;Millenial;N/D;N/D;204980;2;1;2;1;204980;0;0;0;Freezer Horizontal MFH-1990B258CN 198Lts;LINEA BLANCA
9510805;;F;60;CHILENO;;Boomers;VILLA ALEMANA                 ;VALPARAISO;343350;4;1;0;0;0;4;1;343350;Lavadora MLS-140GSC03T 14Kg Gris;LINEA BLANCA
5762057;;M;72;CHILENO;;Silencioso;TALCA                         ;MAULE;397360;3;1;0;0;0;3;1;397360;Cocina MV 110 4 Platos;LINEA BLANCA
26704592;;F;33;VENEZOLANO;;Extranjero;LOS ANGELES                   ;BIO BIO;339970;3;1;0;0;0;3;1;339970;Cocina CMC20AXX 4P Inox;LINEA BLANCA
9323790;;F;57;CHILENO;;Boomers;RENCA                         ;METROPOLITANA;326980;2;1;0;0;0;2;1;326980;Cocina F-2808 4P;LINEA BLANCA
17627146;;F;32;CHILENO;;Millenial;TALCA                         ;MAULE;151980;2;1;2;1;151980;0;0;0;Lavadora Semiautomatica Twister 5100 4Kg;LINEA BLANCA
18944084;;F;30;CHILENO;;Millenial;PROVIDENCIA                   ;METROPOLITANA;193980;2;1;2;1;193980;0;0;0;Cocina MV 120 4 Platos;LINEA BLANCA
8760006;;F;57;CHILENO;;Boomers;ILLAPEL                       ;COQUIMBO;161270;2;1;0;0;0;2;1;161270;Calefont 8Lts GL Essenetial ECO;LINEA BLANCA
5179193;;F;80;CHILENO;;Silencioso;PUNTA ARENAS                  ;MAGALLANES;359982;2;2;0;0;0;2;2;359982;Refrigerador 252Lts No Frost MRFS-2700G333FW;LINEA BLANCA
12791970;;F;46;CHILENO;;X;LONGAVI                       ;MAULE;273360;3;1;0;0;0;3;1;273360;Cocina CH-9600RJ 4P;LINEA BLANCA
6104349;;F;81;CHILENO;;Silencioso;NUEVA IMPERIAL                ;ARAUCANIA;281860;3;1;0;0;0;3;1;281860;Cocina CH-7400 4P;LINEA BLANCA
6544169;;M;68;CHILENO;;Boomers;CASTRO                        ;LOS LAGOS;54580;1;2;0;0;0;1;2;54580;Lavadora LMA0920WGCL0 9,5Kg Gris;LINEA BLANCA
13017954;;F;46;CHILENO;;X;SANTA CRUZ                    ;L.G.B.OÂ´HIGGINS;288980;2;1;2;1;288980;0;0;0;Lavadora WT13WSBP 13Kg Blanca;LINEA BLANCA
11218086;;F;54;CHILENO;;Boomers;NATALES                       ;MAGALLANES;401980;2;1;0;0;0;2;1;401980;Cocina Diva 920 5P;LINEA BLANCA
17046082;;M;33;CHILENO;;Silencioso;PROVIDENCIA                   ;METROPOLITANA;445980;2;1;2;1;445980;0;0;0;Lavadora Secadora WD10WVC4S6 10,5/6Kg Blanca;LINEA BLANCA
5201268;;F;76;CHILENO;;Silencioso;SANTIAGO                      ;METROPOLITANA;218370;2;1;0;0;0;2;1;218370;Freezer FDHM150BY1 150Lts Horizontal;LINEA BLANCA
7564835;;F;67;CHILENO;;Boomers;CONCEPCION                    ;BIO BIO;332460;3;1;0;0;0;3;1;332460;Lavadora MLS-160BSC03T 16Kg Blanca;LINEA BLANCA
7112790;;F;68;CHILENO;;Boomers;CORONEL                       ;BIO BIO;268360;3;1;0;0;0;3;1;268360;Freezer FDHM150BY1 150Lts Horizontal;LINEA BLANCA
10910787;;F;46;CHILENO;;X;COIHAIQUE                     ;AYSEN;439970;3;2;0;0;0;3;2;439970;Lavadora MLS-090GE04N 9Kg Gris;LINEA BLANCA
12290134;;F;49;CHILENO;;X;RENCA                         ;METROPOLITANA;133980;2;1;2;1;133980;0;0;0;TERMO ELECTRICO 80 LITROS (SPLENDID);LINEA BLANCA
14296363;Divorciado;F;46;CHILENO;;X;RENCA                         ;METROPOLITANA;188980;2;1;2;1;188980;0;0;0;Freezer 142Lts MFH-1430B186C Horizontal;LINEA BLANCA
19369364;;F;25;CHILENO;;Z;PROVIDENCIA                   ;METROPOLITANA;199990;2;1;2;1;199990;0;0;0;Lavadora WA90H4400SW/ZS 9Kg Blanca;LINEA BLANCA
16566972;;M;35;CHILENO;;Millenial;"";"";233980;2;1;2;1;233980;0;0;0;Lavadora 9 Kg Carga Superior Blanca;LINEA BLANCA
15652095;;F;39;CHILENO;;X;TEMUCO                        ;ARAUCANIA;224980;2;1;2;1;224980;0;0;0;Freezer Horizontal M 150 142Lts;LINEA BLANCA
24888775;;M;30;PERUANO;;Extranjero;N/D;N/D;199980;2;1;0;0;0;2;1;199980;Lavadora MLS-090GE04N 9Kg Gris;LINEA BLANCA
18592159;;F;28;CHILENO;;Millenial;PUNTA ARENAS                  ;MAGALLANES;299990;1;1;0;0;0;1;1;299990;Refrigerador 260Lts BF Frio Direc MRFI2660SR346W;LINEA BLANCA
18161553;Soltero;F;30;CHILENO;;Millenial;SAN ANTONIO                   ;VALPARAISO;320980;2;1;0;0;0;2;1;320980;Lavadora Efficace SZG 15,5Kg Silver;LINEA BLANCA
11715610;;M;50;CHILENO;;Silencioso;NATALES                       ;MAGALLANES;385460;3;1;0;0;0;3;1;385460;Refrigerador 244Lts Frio Directo Progress 3100;LINEA BLANCA
12418622;;F;49;CHILENO;;X;N/D;N/D;208360;3;2;0;0;0;3;2;208360;Lavadora Semiautomatica LC-6550 6,5Kg;LINEA BLANCA
7694869;;M;66;CHILENO;;Boomers;RENCA                         ;METROPOLITANA;103890;2;1;2;1;103890;0;0;0;CENTRIFUGA C-752;LINEA BLANCA
18944540;;F;26;CHILENO;;Z;N/D;N/D;0;0;0;0;0;0;0;0;0;Lavadora LMA0920WGCL0 9,5Kg Gris;LINEA BLANCA
18914449;;M;28;CHILENO;;Millenial;VALPARAISO                    ;VALPARAISO;0;0;0;0;0;0;0;0;0;Lavadora WA80H4200SW/ZS 8Kg Blanca;LINEA BLANCA
5957061;;M;74;CHILENO;;Silencioso;ERCILLA                       ;ARAUCANIA;0;0;0;0;0;0;0;0;0;Refrigerador 252Lts No Frost MRFS-2700G333FW;LINEA BLANCA
8150469;;F;64;CHILENO;;Boomers;PROVIDENCIA                   ;METROPOLITANA;0;0;0;0;0;0;0;0;0;Calefon 7Lts GL Master;LINEA BLANCA
9398900;;F;64;CHILENO;;Boomers;CANETE                        ;BIO BIO;0;0;0;0;0;0;0;0;0;Lavadora WA13T5260BW/ZS 13Kg Blanca;LINEA BLANCA
18937468;;F;28;CHILENO;;Millenial;N/D;N/D;0;0;0;0;0;0;0;0;0;Lavadora WA80H4200SW/ZS 8Kg Blanca;LINEA BLANCA
12058186;;F;59;CHILENO;;Boomers;SAN BERNARDO                  ;METROPOLITANA;0;0;0;0;0;0;0;0;0;Calefont 10Lts GL Essenetial ECO;LINEA BLANCA
9507108;;F;60;CHILENO;;Boomers;PROVIDENCIA                   ;METROPOLITANA;0;0;0;0;0;0;0;0;0;Lavadora MLS-140GSC03T 14Kg Gris;LINEA BLANCA
15115151;;M;39;CHILENO;;X;SANTA CRUZ                    ;L.G.B.OÂ´HIGGINS;0;0;0;0;0;0;0;0;0;Lavadora Brilliant SG 15Kg Silver;LINEA BLANCA
10116177;Casado;F;57;CHILENO;PROFESOR;Boomers;SANTIAGO                      ;METROPOLITANA;0;0;0;0;0;0;0;0;0;Cocina CH-9500 NG 4P;LINEA BLANCA
7751173;Divorciado;F;66;CHILENO;;Silencioso;PROVIDENCIA                   ;METROPOLITANA;0;0;0;0;0;0;0;0;0;Cocina MV 110 4 Platos;LINEA BLANCA
17341721;;F;32;CHILENO;;Silencioso;PROVIDENCIA                   ;METROPOLITANA;0;0;0;0;0;0;0;0;0;Calefon 11Lts GL Master;LINEA BLANCA
12779180;;F;47;CHILENO;;Silencioso;PROVIDENCIA                   ;METROPOLITANA;0;0;0;0;0;0;0;0;0;Cocina CH-8900IN 5P;LINEA BLANCA
14336476;;M;47;CHILENO;;X;N/D;N/D;0;0;0;0;0;0;0;0;0;REFRIGERADOR 234Lt TMF RT22FARADS8/ZS;LINEA BLANCA
17934954;;F;30;CHILENO;;Millenial;CURICO                        ;MAULE;0;0;0;0;0;0;0;0;0;Lavadora Semiautomatica Twister 5100 4Kg;LINEA BLANCA
14086812;Casado;F;42;CHILENO;;X;ANCUD                         ;LOS LAGOS;0;0;0;0;0;0;0;0;0;Lavadora MLS-160BSC03T 16Kg Blanca;LINEA BLANCA
5782711;;F;71;CHILENO;;Silencioso;PROVIDENCIA                   ;METROPOLITANA;0;0;0;0;0;0;0;0;0;Refrigerador 252Lts No Frost MRFS-2700G333FW;LINEA BLANCA
8658558;;F;65;CHILENO;;Boomers;PROVIDENCIA                   ;METROPOLITANA;0;0;0;0;0;0;0;0;0;Cocina MV 110 4 Platos;LINEA BLANCA
18268519;;F;30;CHILENO;;Millenial;VALPARAISO                    ;VALPARAISO;0;0;0;0;0;0;0;0;0;Lavadora MLS-090GE04N 9Kg Gris;LINEA BLANCA
12640215;;M;48;CHILENO;;X;N/D;N/D;0;0;0;0;0;0;0;0;0;Cocina F-2608 4P Inox;LINEA BLANCA
8018415;;F;66;CHILENO;;Boomers;CASTRO                        ;LOS LAGOS;0;0;0;0;0;0;0;0;0;Cocina CMC20AXX 4P Inox;LINEA BLANCA
18453900;;F;29;CHILENO;;Millenial;PROVIDENCIA                   ;METROPOLITANA;0;0;0;0;0;0;0;0;0;Cocina CH-9950NG-1 6P Negro;LINEA BLANCA
6251205;;F;77;CHILENO;;Silencioso;RENCA                         ;METROPOLITANA;0;0;0;0;0;0;0;0;0;Lavadora WT19DSBP 19Kg Silver;LINEA BLANCA
8416252;;F;62;CHILENO;;Boomers;SAN ESTEBAN                   ;VALPARAISO;0;0;0;0;0;0;0;0;0;Refrigerador 252Lts No Frost MRFS-2700G333FW;LINEA BLANCA
9166885;Casado;F;65;CHILENO;;Boomers;PROVIDENCIA                   ;METROPOLITANA;0;0;0;0;0;0;0;0;0;CAMPANA AT-MD RETRACTA N19 60;LINEA BLANCA
5956551;Casado;M;72;CHILENO;;Silencioso;BUIN                          ;METROPOLITANA;0;0;0;0;0;0;0;0;0;Lavadora Premium Care 20SZ 20Kg Silver;LINEA BLANCA
15678334;Soltero;F;38;CHILENO;QUIMICO FARMACEUTICO;Millenial;PROVIDENCIA                   ;METROPOLITANA;0;0;0;0;0;0;0;0;0;Freezer Vertical MFV-2400S312FW 227Lts;LINEA BLANCA
7537046;;F;67;CHILENO;;Boomers;CONSTITUCION                  ;MAULE;0;0;0;0;0;0;0;0;0;Lavadora WA17T6260BW/ZS 17Kg Blanca;LINEA BLANCA
19035021;;F;27;CHILENO;;Z;"";"";0;0;0;0;0;0;0;0;0;Lavadora MLS-090GE04N 9Kg Gris;LINEA BLANCA
17324737;;F;33;CHILENO;;Millenial;ALGARROBO                     ;VALPARAISO;0;0;0;0;0;0;0;0;0;Freezer 196Lts M200 Horizontal;LINEA BLANCA
15759769;;F;48;CHILENO;;X;VALDIVIA                      ;LOS LAGOS;0;0;0;0;0;0;0;0;0;Lavadora Efficace SZG 17,5Kg Silver;LINEA BLANCA
12165491;;F;66;CHILENO;;Boomers;N/D;N/D;0;0;0;0;0;0;0;0;0;Lavadora Efficace SZG 15,5Kg Silver;LINEA BLANCA
7733223;;M;63;CHILENO;;Boomers;ANGOL                         ;ARAUCANIA;0;0;0;0;0;0;0;0;0;Campana Cocina FXU6160 60CM;LINEA BLANCA
16901359;;F;34;CHILENO;;Millenial;VALLENAR;ATACAMA;0;0;0;0;0;0;0;0;0;Cocina CH-7400 4P;LINEA BLANCA
12869309;;F;47;CHILENO;;Silencioso;PROVIDENCIA                   ;METROPOLITANA;0;0;0;0;0;0;0;0;0;Encimera FDV Vitro 2 Black;LINEA BLANCA
16694378;;F;34;CHILENO;;Silencioso;PROVIDENCIA                   ;METROPOLITANA;0;0;0;0;0;0;0;0;0;Lavadora LMA0920WGCL0 9,5Kg Gris;LINEA BLANCA
18341081;;F;29;CHILENO;;Millenial;HUALANE                       ;MAULE;0;0;0;0;0;0;0;0;0;Secadora Ropa MSV-90 9K Blanca Ventilacion;LINEA BLANCA
8584592;;F;63;CHILENO;;Boomers;SAN FERNANDO                  ;L.G.B.OÂ´HIGGINS;0;0;0;0;0;0;0;0;0;Lavadora MLS-160BSC03T 16Kg Blanca;LINEA BLANCA
8270878;;F;60;CHILENO;;Boomers;CAUQUENES                     ;MAULE;0;0;0;0;0;0;0;0;0;Refrigerador 260Lts BF Frio Direc MRFI2660SR346W;LINEA BLANCA
20050993;;F;23;CHILENO;;Z;PROVIDENCIA                   ;METROPOLITANA;0;0;0;0;0;0;0;0;0;HORNO EMPOTRABLE HE-7200 INOX 2250W 57L SINDELEN;LINEA BLANCA
15887781;;F;38;CHILENO;;Millenial;"";"";0;0;0;0;0;0;0;0;0;Cocina F-2808 4P;LINEA BLANCA
7920711;;M;63;CHILENO;;Boomers;PICHILEMU                     ;L.G.B.OÂ´HIGGINS;0;0;0;0;0;0;0;0;0;Cocina Diva 820 6P;LINEA BLANCA
18100992;;F;30;CHILENO;;Millenial;LOS ANGELES                   ;BIO BIO;0;0;0;0;0;0;0;0;0;Secadora Ropa MSC-90 9K Blanca Condensacion;LINEA BLANCA
9370970;;F;60;CHILENO;;Silencioso;PROVIDENCIA                   ;METROPOLITANA;0;0;0;0;0;0;0;0;0;Freezer Vertical MFV-2400S312FW 227Lts;LINEA BLANCA
16793149;;M;35;CHILENO;;Millenial;PROVIDENCIA                   ;METROPOLITANA;0;0;0;0;0;0;0;0;0;Campana Cocina FXU6160 60CM;LINEA BLANCA
20419979;;M;22;CHILENO;;Millenial;N/D;N/D;0;0;0;0;0;0;0;0;0;Cocina CH-9900SI 6P Silver;LINEA BLANCA
11195623;;F;54;CHILENO;;Boomers;LLAILLAY                      ;VALPARAISO;0;0;0;0;0;0;0;0;0;Lavadora Efficace SZG 15,5Kg Silver;LINEA BLANCA
9646998;Casado;M;58;CHILENO;;Boomers;YERBAS BUENAS                 ;MAULE;0;0;0;0;0;0;0;0;0;Lavadora WT19DSBP 19Kg Silver;LINEA BLANCA
16129859;;F;36;CHILENO;;Millenial;PROVIDENCIA                   ;METROPOLITANA;0;0;0;0;0;0;0;0;0;Freezer Horizonal SFH-101BL 99Lts;LINEA BLANCA
14289945;;M;47;CHILENO;;X;LINARES                       ;MAULE;0;0;0;0;0;0;0;0;0;Calefont 10Lts GL Essenetial ECO;LINEA BLANCA
10336846;;F;55;CHILENO;;Boomers;COPIAPO                       ;ATACAMA;0;0;0;0;0;0;0;0;0;Cocina CH-7400 4P;LINEA BLANCA
6959423;;M;62;CHILENO;;Boomers;ARICA                         ;ARICA Y PARINACOTA;0;0;0;0;0;0;0;0;0;Lavadora WA90H4400SW/ZS 9Kg Blanca;LINEA BLANCA
19063373;Soltero;F;27;CHILENO;;Z;PROVIDENCIA                   ;METROPOLITANA;0;0;0;0;0;0;0;0;0;COCINA SINDELEN CH-5050NG 4P;LINEA BLANCA
10826160;;M;55;CHILENO;;Boomers;RENCA                         ;METROPOLITANA;0;0;0;0;0;0;0;0;0;Lavadora WA13T5260BW/ZS 13Kg Blanca;LINEA BLANCA
13737195;;M;49;CHILENO;;X;PUERTO MONTT                  ;LOS LAGOS;0;0;0;0;0;0;0;0;0;Lavadora Efficace BZG 9,5Kg Blanca;LINEA BLANCA
18774648;Soltero;M;28;CHILENO;;Millenial;PROVIDENCIA                   ;METROPOLITANA;0;0;0;0;0;0;0;0;0;Lavadora MLS-090GE04N 9Kg Gris;LINEA BLANCA
18507175;;M;28;CHILENO;;Millenial;PROVIDENCIA                   ;METROPOLITANA;0;0;0;0;0;0;0;0;0;Lavadora Secadora WD10WVC4S6 10,5/6Kg Blanca;LINEA BLANCA
9852333;Casado;M;58;CHILENO;;Boomers;PROVIDENCIA                   ;METROPOLITANA;0;0;0;0;0;0;0;0;0;Campana FDV Prime 60;LINEA BLANCA
12720032;;M;46;CHILENO;;X;PROVIDENCIA                   ;METROPOLITANA;0;0;0;0;0;0;0;0;0;HORNO EMPOTRABLE HE-7200 INOX 2250W 57L SINDELEN;LINEA BLANCA
12355329;Casado;F;49;CHILENO;;X;PAREDONES                     ;L.G.B.OÂ´HIGGINS;0;0;0;0;0;0;0;0;0;Refrigerador 400Lts No Frost RMP400FZUC Dispen;LINEA BLANCA
14376791;Casado;M;47;CHILENO;;X;RENCA                         ;METROPOLITANA;0;0;0;0;0;0;0;0;0;Refrigerador 252Lts No Frost MRFS-2700G333FW;LINEA BLANCA
10304038;;F;56;CHILENO;;Boomers;RENCA                         ;METROPOLITANA;0;0;0;0;0;0;0;0;0;Cocina CH-9400 4P SILVER;LINEA BLANCA
7857213;;M;63;CHILENO;;Boomers;CASTRO                        ;LOS LAGOS;0;0;0;0;0;0;0;0;0;Calefont 10Lts GL Essenetial ECO;LINEA BLANCA
25172448;;M;60;PERUANO;;Extranjero;N/D;N/D;0;0;0;0;0;0;0;0;0;Lavadora MLS-140GSC03T 14Kg Gris;LINEA BLANCA
14393125;;F;43;CHILENO;;X;RENCA                         ;METROPOLITANA;0;0;0;0;0;0;0;0;0;CENTRIFUGA C-752;LINEA BLANCA
7826078;;F;67;CHILENO;;Boomers;VALLENAR;ATACAMA;0;0;0;0;0;0;0;0;0;Refrigerador 252Lts No Frost MRFS-2700G333FW;LINEA BLANCA
13150574;;F;45;CHILENO;;X;CERRILLOS                     ;METROPOLITANA;0;0;0;0;0;0;0;0;0;COCINA CH-5490NI 4P;LINEA BLANCA
24350877;;F;58;BOLIVIANO;;Extranjero;CALAMA                        ;ANTOFAGASTA;0;0;0;0;0;0;0;0;0;Lavadora MLS-160BSC03T 16Kg Blanca;LINEA BLANCA
14553298;;F;46;CHILENO;;X;TALCA                         ;MAULE;0;0;0;0;0;0;0;0;0;Secadora Ropa MSV-90 9K Blanca Ventilacion;LINEA BLANCA
13526359;;F;44;CHILENO;;X;PROVIDENCIA                   ;METROPOLITANA;0;0;0;0;0;0;0;0;0;Refrigerador 2260-S 222Lts Frio Directo;LINEA BLANCA
14426054;;F;52;CHILENO;;X;RENCA                         ;METROPOLITANA;0;0;0;0;0;0;0;0;0;Refrigerador Advantage 5300E 320Lts No Frost;LINEA BLANCA
26986434;;M;36;VENEZOLANO;;Extranjero;N/D;N/D;0;0;0;0;0;0;0;0;0;Cocina Andes60TX4 4P Inox;LINEA BLANCA
12769502;;F;47;CHILENO;;X;N/D;N/D;0;0;0;0;0;0;0;0;0;Freezer 142Lts MFH-1430B186C Horizontal;LINEA BLANCA
6631789;;F;69;CHILENO;;Silencioso;TALCAHUANO                    ;BIO BIO;0;0;0;0;0;0;0;0;0;Cocina F-2808 4P;LINEA BLANCA
7597156;;F;70;CHILENO;;Silencioso;TALAGANTE                     ;METROPOLITANA;0;0;0;0;0;0;0;0;0;Cocina 785FX 4P;LINEA BLANCA
14068570;;F;41;CHILENO;;X;LOS ANGELES                   ;BIO BIO;0;0;0;0;0;0;0;0;0;Lavadora Efficace SZG 15,5Kg Silver;LINEA BLANCA
8348394;;F;63;CHILENO;;Boomers;PROVIDENCIA                   ;METROPOLITANA;0;0;0;0;0;0;0;0;0;ENCIMERA PROFESSIONAL 60 GL 4P ALBIN TROTTER;LINEA BLANCA
26030527;Soltero;F;38;EXTRANJERO - NO INFORMA NACIONALIDAD;;Extranjero;PROVIDENCIA                   ;METROPOLITANA;0;0;0;0;0;0;0;0;0;Refrigerador 341Lts BF No Frost GB37MPD;LINEA BLANCA
26593863;;F;41;CHILENO;;Extranjero;HUALPEN;BIO BIO;0;0;0;0;0;0;0;0;0;Lavadora WA17T6260BW/ZS 17Kg Blanca;LINEA BLANCA
13577371;;F;43;CHILENO;;X;SAN CARLOS                    ;BIO BIO;0;0;0;0;0;0;0;0;0;Cocina CH-7400 4P;LINEA BLANCA
12512882;;F;48;CHILENO;;X;PROVIDENCIA                   ;METROPOLITANA;0;0;0;0;0;0;0;0;0;Lavadora 9 Kg Carga Superior Blanca;LINEA BLANCA
10445332;;F;57;CHILENO;;Boomers;RANCAGUA                      ;L.G.B.OÂ´HIGGINS;0;0;0;0;0;0;0;0;0;Secadora Ropa Reverplus 6470 7Kg Gris Ventilacio;LINEA BLANCA
16475228;Casado;M;35;CHILENO;;Silencioso;PROVIDENCIA                   ;METROPOLITANA;0;0;0;0;0;0;0;0;0;REFRIGERADOR SIDE BY SIDE LSBS-560NFIW;LINEA BLANCA
10189274;;F;58;CHILENO;;Boomers;LOLOL                         ;L.G.B.OÂ´HIGGINS;0;0;0;0;0;0;0;0;0;Lavadora WA90H4400SW/ZS 9Kg Blanca;LINEA BLANCA
13666795;;M;42;CHILENO;;Millenial;PROVIDENCIA                   ;METROPOLITANA;0;0;0;0;0;0;0;0;0;Secadora Ropa Solare 7100 7K Ventilacion;LINEA BLANCA
13396187;Casado;M;44;CHILENO;;X;PROVIDENCIA                   ;METROPOLITANA;0;0;0;0;0;0;0;0;0;FREEZER SFH-150 14OL BLANCO SINDELEN;LINEA BLANCA
5000079;;M;75;CHILENO;;Silencioso;VINA DEL MAR                  ;VALPARAISO;0;0;0;0;0;0;0;0;0;Campana Cocina FXU6160 60CM;LINEA BLANCA
6127065;;F;70;CHILENO;;Silencioso;RENCA                         ;METROPOLITANA;0;0;0;0;0;0;0;0;0;CENTRIFUGA C-752;LINEA BLANCA
19476299;Soltero;M;26;CHILENO;KINESIOLOGO;Z;PROVIDENCIA                   ;METROPOLITANA;0;0;0;0;0;0;0;0;0;Refrigerador MRFI1800S234RN 180Lts BF Frio Direc;LINEA BLANCA
15467817;;F;40;CHILENO;;X;PROVIDENCIA                   ;METROPOLITANA;0;0;0;0;0;0;0;0;0;COCINA CH-5700SI 4P;LINEA BLANCA
8483844;;M;61;CHILENO;;Boomers;RENCA                         ;METROPOLITANA;0;0;0;0;0;0;0;0;0;Lavadora Efficace SZG 9,5Kg Silver;LINEA BLANCA
13559078;;M;43;CHILENO;;Silencioso;MELIPILLA                     ;METROPOLITANA;0;0;0;0;0;0;0;0;0;Lavadora MLS-090GE04N 9Kg Gris;LINEA BLANCA
16515865;;M;34;CHILENO;;Millenial;N/D;N/D;0;0;0;0;0;0;0;0;0;Refrigerador 252Lts No Frost MRFS-2700G333FW;LINEA BLANCA
17262512;;F;33;CHILENO;;Millenial;PROVIDENCIA                   ;METROPOLITANA;0;0;0;0;0;0;0;0;0;Lavadora Brilliant SG 11,5Kg Silver;LINEA BLANCA
6434069;Casado;M;71;CHILENO;CONTADOR AUDITOR;Silencioso;PROVIDENCIA                   ;METROPOLITANA;0;0;0;0;0;0;0;0;0;CENTRIFUGA C-752;LINEA BLANCA
16833411;;M;34;CHILENO;;Silencioso;PROVIDENCIA                   ;METROPOLITANA;0;0;0;0;0;0;0;0;0;Refrigerador 244Lts Frio Directo Progress 3100;LINEA BLANCA
14072758;;F;40;CHILENO;;X;LOS ANGELES                   ;BIO BIO;0;0;0;0;0;0;0;0;0;Lavadora MLS-160BSC03T 16Kg Blanca;LINEA BLANCA
10658833;;M;56;CHILENO;;Boomers;SAN VICENTE                   ;L.G.B.OÂ´HIGGINS;0;0;0;0;0;0;0;0;0;Calefont 5Lts GL Essenetial ECO;LINEA BLANCA
17179527;;F;33;CHILENO;;Millenial;N/D;N/D;0;0;0;0;0;0;0;0;0;Secadora Ropa Solare 9100 9K Ventilacion;LINEA BLANCA
18407105;;F;29;CHILENO;;Millenial;RETIRO                        ;MAULE;0;0;0;0;0;0;0;0;0;Lavadora MLS-090GE04N 9Kg Gris;LINEA BLANCA
11529015;;F;51;CHILENO;;X;RENGO                         ;L.G.B.OÂ´HIGGINS;0;0;0;0;0;0;0;0;0;Cocina CMC20AXX 4P Inox;LINEA BLANCA
17765792;Soltero;F;30;CHILENO;;Millenial;PROVIDENCIA                   ;METROPOLITANA;0;0;0;0;0;0;0;0;0;Freezer Horizontal M100 99Lts;LINEA BLANCA
18893027;Soltero;M;27;CHILENO;;Z;PROVIDENCIA                   ;METROPOLITANA;0;0;0;0;0;0;0;0;0;Cocina CMC20AXX 4P Inox;LINEA BLANCA
25490183;;F;36;VENEZOLANO;;Extranjero;EL BOSQUE                     ;METROPOLITANA;0;0;0;0;0;0;0;0;0;Lavadora WA13T5260BW/ZS 13Kg Blanca;LINEA BLANCA
13119388;Soltero;F;47;CHILENO;ASISTENTE SOCIAL;X;RENCA                         ;METROPOLITANA;0;0;0;0;0;0;0;0;0;Lavadora MLS-080BE04N 8Kg Blanca;LINEA BLANCA
9630014;;M;59;CHILENO;;Boomers;PROVIDENCIA                   ;METROPOLITANA;0;0;0;0;0;0;0;0;0;Lavadora MLS-140GSC03T 14Kg Gris;LINEA BLANCA
22041707;;M;66;PERUANO;;Extranjero;N/D;N/D;0;0;0;0;0;0;0;0;0;Lavadora Premium Care Pro 16Kg Silver;LINEA BLANCA
9691786;;F;59;CHILENO;;Boomers;PROVIDENCIA                   ;METROPOLITANA;0;0;0;0;0;0;0;0;0;Secadora Ropa Solare 9100 9K Ventilacion;LINEA BLANCA
9911286;;M;56;CHILENO;;Boomers;N/D;N/D;0;0;0;0;0;0;0;0;0;Cocina CH-9400 4P SILVER;LINEA BLANCA
15720179;Soltero;F;38;CHILENO;KINESIOLOGA;Silencioso;PROVIDENCIA                   ;METROPOLITANA;0;0;0;0;0;0;0;0;0;Cocina F-2808 4P;LINEA BLANCA
12243391;Soltero;F;50;CHILENO;;X;PROVIDENCIA                   ;METROPOLITANA;0;0;0;0;0;0;0;0;0;Lavadora WA80H4200SW/ZS 8Kg Blanca;LINEA BLANCA
23001649;;M;35;PERUANO;;Extranjero;QUINTA NORMAL                 ;METROPOLITANA;0;0;0;0;0;0;0;0;0;Lavadora MLS-090GE04N 9Kg Gris;LINEA BLANCA
15630141;;F;39;CHILENO;;X;SANTIAGO;METROPOLITANA;0;0;0;0;0;0;0;0;0;Cocina CMC20AXX 4P Inox;LINEA BLANCA
17254154;;F;32;CHILENO;;Millenial;N/D;N/D;0;0;0;0;0;0;0;0;0;Lavadora WA13T5260BW/ZS 13Kg Blanca;LINEA BLANCA
8231558;;M;64;CHILENO;;Boomers;RANCAGUA                      ;L.G.B.OÂ´HIGGINS;0;0;0;0;0;0;0;0;0;Lavadora Efficace SZG 17,5Kg Silver;LINEA BLANCA
19653911;;M;24;CHILENO;;Silencioso;PROVIDENCIA                   ;METROPOLITANA;0;0;0;0;0;0;0;0;0;Refrigerador Altus 1350W 342Lts No Frost;LINEA BLANCA
13851106;Soltero;M;42;CHILENO;;X;PROVIDENCIA                   ;METROPOLITANA;0;0;0;0;0;0;0;0;0;Lavadora MLS-140GSC03T 14Kg Gris;LINEA BLANCA
5643675;Casado;F;73;CHILENO;;Silencioso;RENCA                         ;METROPOLITANA;0;0;0;0;0;0;0;0;0;Cocina MCG-5QI30AME5 5P Inox;LINEA BLANCA
7952554;;F;66;CHILENO;;Boomers;ANTOFAGASTA                   ;ANTOFAGASTA;0;0;0;0;0;0;0;0;0;Lavadora WA17T6260BW/ZS 17Kg Blanca;LINEA BLANCA
13676927;;F;42;CHILENO;;X;RENCA                         ;METROPOLITANA;0;0;0;0;0;0;0;0;0;Refrigerador No Frost BMF 284 Lts c/disp;LINEA BLANCA
8311419;;M;61;CHILENO;;Boomers;MAIPU                         ;METROPOLITANA;0;0;0;0;0;0;0;0;0;COCINA CH-5490NI 4P;LINEA BLANCA
12526554;;M;49;CHILENO;;X;CONCEPCION                    ;BIO BIO;0;0;0;0;0;0;0;0;0;Cocina CMC5515GCH-1 4P;LINEA BLANCA
12655891;;M;48;CHILENO;;X;N/D;N/D;0;0;0;0;0;0;0;0;0;Lavadora Secadora WD12N64FR2X/ZS 12/7Kg Silver;LINEA BLANCA
16571553;;M;35;CHILENO;;Millenial;PUENTE ALTO                   ;METROPOLITANA;0;0;0;0;0;0;0;0;0;Refrigerador 525Lts Side by Side SFX500;LINEA BLANCA
13844147;;M;42;CHILENO;;X;PROVIDENCIA                   ;METROPOLITANA;0;0;0;0;0;0;0;0;0;Refrigerador 602Lts SBS SAMSUNG RS60T5200S9/ZS;LINEA BLANCA
17080689;;F;33;CHILENO;;Millenial;SAN ANTONIO                   ;VALPARAISO;0;0;0;0;0;0;0;0;0;Refrigerador 322Lts No Frost BF DB60S;LINEA BLANCA
17658583;;F;31;CHILENO;;Millenial;CURICO                        ;MAULE;0;0;0;0;0;0;0;0;0;Secadora 9Kg Solare 9200 Ventilacion;LINEA BLANCA
16846866;;M;34;CHILENO;;Millenial;N/D;N/D;0;0;0;0;0;0;0;0;0;Refrigerador 241Lts BF Frio Directo Nordik 415;LINEA BLANCA
19008685;Soltero;F;26;CHILENO;;Z;PROVIDENCIA                   ;METROPOLITANA;0;0;0;0;0;0;0;0;0;Freezer Horizontal 248 Lts Blanco FF-255;LINEA BLANCA
10311359;Divorciado;F;58;CHILENO;AUXILIAR PARAMEDICO DE SEDILE;Boomers;RENCA                         ;METROPOLITANA;0;0;0;0;0;0;0;0;0;Cocina 775X 4P;LINEA BLANCA
26646822;;M;30;VENEZOLANO;;Extranjero;"";"";0;0;0;0;0;0;0;0;0;Lavadora WD10J6410AX/ZS 10,5Kg;LINEA BLANCA
18778711;;M;27;CHILENO;;Z;MELIPILLA                     ;METROPOLITANA;0;0;0;0;0;0;0;0;0;Lavadora Efficace SZG 17,5Kg Silver;LINEA BLANCA
9452307;;M;59;CHILENO;;Boomers;TALCAHUANO                    ;BIO BIO;0;0;0;0;0;0;0;0;0;Lavadora Efficace SZG 15,5Kg Silver;LINEA BLANCA
5886299;;F;74;CHILENO;;Silencioso;CONSTITUCION                  ;MAULE;0;0;0;0;0;0;0;0;0;Refrigerador Side by Side RS65R5411M9/ZS 617Lts;LINEA BLANCA
7646425;;F;64;CHILENO;;Boomers;SAN VICENTE                   ;L.G.B.OÂ´HIGGINS;0;0;0;0;0;0;0;0;0;Lavadora WT13WSBP 13Kg Blanca;LINEA BLANCA
11082453;;F;55;CHILENO;;Boomers;CASTRO                        ;LOS LAGOS;0;0;0;0;0;0;0;0;0;Refrigerador 244Lts Frio Directo Progress 3100;LINEA BLANCA
19980868;;F;24;CHILENO;;Z;CALERA                        ;VALPARAISO;0;0;0;0;0;0;0;0;0;Lavadora WA17T6260BW/ZS 17Kg Blanca;LINEA BLANCA
18610930;;F;28;CHILENO;;Millenial;MELIPILLA                     ;METROPOLITANA;0;0;0;0;0;0;0;0;0;Lavadora Secadora WD90M4453JW/ZS 9/5Kg Blanca;LINEA BLANCA
7109853;Soltero;F;64;CHILENO;ENFERMERA MATRONA;Boomers;PROVIDENCIA                   ;METROPOLITANA;0;0;0;0;0;0;0;0;0;Lavadora Efficace SZG 9,5Kg Silver;LINEA BLANCA
16016132;;F;37;CHILENO;;Millenial;PROVIDENCIA                   ;METROPOLITANA;0;0;0;0;0;0;0;0;0;Refrigerador MRFI1800S234RN 180Lts BF Frio Direc;LINEA BLANCA
13393396;;M;45;CHILENO;;X;CONCEPCION                    ;BIO BIO;0;0;0;0;0;0;0;0;0;Cocina 76DXR Doble Horno;LINEA BLANCA
17723080;;M;31;CHILENO;;Millenial;COQUIMBO                      ;COQUIMBO;0;0;0;0;0;0;0;0;0;Refrigerador 322Lts No Frost BF DB60S;LINEA BLANCA
16387171;;M;35;CHILENO;;Millenial;PROVIDENCIA                   ;METROPOLITANA;0;0;0;0;0;0;0;0;0;Secadora Ropa Solare 7100 7K Ventilacion;LINEA BLANCA
8918222;;M;61;CHILENO;;Boomers;LLAILLAY                      ;VALPARAISO;0;0;0;0;0;0;0;0;0;Calefont 5Lts GL Essenetial ECO;LINEA BLANCA
6898949;;F;70;CHILENO;;Silencioso;TALCAHUANO                    ;BIO BIO;0;0;0;0;0;0;0;0;0;Cocina Diva 920 5P;LINEA BLANCA
11514500;Casado;F;54;CHILENO;;Silencioso;PROVIDENCIA                   ;METROPOLITANA;0;0;0;0;0;0;0;0;0;Lavadora MLS-160BSC03T 16Kg Blanca;LINEA BLANCA
15784306;;F;38;CHILENO;;Millenial;PROVIDENCIA                   ;METROPOLITANA;0;0;0;0;0;0;0;0;0;Refrigerador 602Lts SBS SAMSUNG RS60T5200S9/ZS;LINEA BLANCA
18762450;Soltero;M;28;CHILENO;;Silencioso;PROVIDENCIA                   ;METROPOLITANA;0;0;0;0;0;0;0;0;0;Lavadora Semiautomatica LS-6100 6Kg Gris;LINEA BLANCA
16008503;Casado;M;36;CHILENO;TERAPEUTA OCUPACIONAL;Millenial;PROVIDENCIA                   ;METROPOLITANA;0;0;0;0;0;0;0;0;0;Cocina Andes60TX4 4P Inox;LINEA BLANCA
8014523;;F;64;CHILENO;;Boomers;IQUIQUE                       ;TARAPACA;0;0;0;0;0;0;0;0;0;Refrigerador 303Lts BF Frio Directo Nordik 480;LINEA BLANCA
11737236;Casado;M;51;CHILENO;AGRONOMO;X;SANTO DOMINGO                 ;VALPARAISO;0;0;0;0;0;0;0;0;0;Refrigerador 311Lts Frio Direct Nordik Inox 3900;LINEA BLANCA
14507166;;M;48;CHILENO;;X;ANCUD                         ;LOS LAGOS;0;0;0;0;0;0;0;0;0;Lavadora Superior WA19T6260BY/ZS 19Kg;LINEA BLANCA
15678022;;F;38;CHILENO;;Millenial;PROVIDENCIA                   ;METROPOLITANA;0;0;0;0;0;0;0;0;0;Refrigerador 241Lts BF Frio Directo Nordik 415;LINEA BLANCA
18929861;Soltero;M;27;CHILENO;;Millenial;PROVIDENCIA                   ;METROPOLITANA;0;0;0;0;0;0;0;0;0;Lavadora MLS-190GC03N 19Kg Gris;LINEA BLANCA
19641087;;F;25;CHILENO;;Silencioso;COPIAPO                       ;ATACAMA;0;0;0;0;0;0;0;0;0;Lavadora MLS-090GE04N 9Kg Gris;LINEA BLANCA
13900446;Soltero;M;41;CHILENO;DISENADOR INDUSTRIAL;X;RENCA                         ;METROPOLITANA;0;0;0;0;0;0;0;0;0;Secadora Electrica SEM101BDBY Blanca 10 KG;LINEA BLANCA
13662326;;F;43;CHILENO;;X;ANCUD                         ;LOS LAGOS;0;0;0;0;0;0;0;0;0;Refrigerador 244Lts Frio Directo Progress 3100;LINEA BLANCA
7488049;;F;67;CHILENO;;Boomers;MARIA ELENA                   ;ANTOFAGASTA;0;0;0;0;0;0;0;0;0;Lavadora WA17T6260BW/ZS 17Kg Blanca;LINEA BLANCA
9007933;;M;58;CHILENO;;Boomers;PROVIDENCIA                   ;METROPOLITANA;0;0;0;0;0;0;0;0;0;FREEZERSFV-200 SILVER 183L SINDELEN;LINEA BLANCA
20310739;;F;22;CHILENO;;Z;N/D;N/D;0;0;0;0;0;0;0;0;0;Secadora Electrica SEM101BDBY Blanca 10 KG;LINEA BLANCA
9972331;;F;55;CHILENO;;Boomers;SAN BERNARDO                  ;METROPOLITANA;0;0;0;0;0;0;0;0;0;Lavadora Efficace SZG 17,5Kg Silver;LINEA BLANCA
16232029;;M;36;CHILENO;;Millenial;VALPARAISO                    ;VALPARAISO;0;0;0;0;0;0;0;0;0;Refrigerador 244Lts Frio Directo Progress 3100;LINEA BLANCA
19998877;;M;23;CHILENO;;Silencioso;PROVIDENCIA                   ;METROPOLITANA;0;0;0;0;0;0;0;0;0;Lavadora Efficace SZG 19,5Kg Silver;LINEA BLANCA
16291915;;F;36;CHILENO;;Millenial;MELIPILLA                     ;METROPOLITANA;0;0;0;0;0;0;0;0;0;Secadora Ropa Solare 7100 7K Ventilacion;LINEA BLANCA
8580824;;F;48;CHILENO;;X;PROVIDENCIA                   ;METROPOLITANA;0;0;0;0;0;0;0;0;0;Secadora Ropa MSV-90 9K Blanca Ventilacion;LINEA BLANCA
7239608;;M;67;CHILENO;;Boomers;SAN MIGUEL                    ;METROPOLITANA;0;0;0;0;0;0;0;0;0;Cocina F-5500 Premium 5P;LINEA BLANCA
11432253;;F;53;CHILENO;;X;ANCUD                         ;LOS LAGOS;0;0;0;0;0;0;0;0;0;Refrigerador 244Lts Frio Directo Progress 3100;LINEA BLANCA
13730702;;F;43;CHILENO;;X;RENCA                         ;METROPOLITANA;0;0;0;0;0;0;0;0;0;Lavadora Frontal MLF-085BE08N 8,5Kg Blanca;LINEA BLANCA
18204943;;F;29;CHILENO;;Millenial;PROVIDENCIA                   ;METROPOLITANA;0;0;0;0;0;0;0;0;0;Cocina MV 220 4P;LINEA BLANCA
25208192;Casado;M;32;COLOMBIANO;;Extranjero;N/D;N/D;0;0;0;0;0;0;0;0;0;Refrigerador 2260-S 222Lts Frio Directo;LINEA BLANCA
7131854;;F;68;CHILENO;;Silencioso;LA SERENA                     ;COQUIMBO;0;0;0;0;0;0;0;0;0;Centrifuga Primma 5B 5,5Kilos;LINEA BLANCA
18838171;Soltero;F;27;CHILENO;TECNICO DE NIVEL MEDIO EN ALIMENTACION;Millenial;TOME                          ;BIO BIO;0;0;0;0;0;0;0;0;0;Secadora Ropa MSC-90 9K Blanca Condensacion;LINEA BLANCA
11620375;;F;52;CHILENO;;X;N/D;N/D;0;0;0;0;0;0;0;0;0;Lavadora Secadora WD10WVC4S6 10,5/6Kg Blanca;LINEA BLANCA
19239222;Soltero;F;26;CHILENO;;Silencioso;PROVIDENCIA                   ;METROPOLITANA;0;0;0;0;0;0;0;0;0;Cocina CH-9050SI 4P;LINEA BLANCA
18695484;;F;28;CHILENO;;Millenial;SAN BERNARDO                  ;METROPOLITANA;0;0;0;0;0;0;0;0;0;Cocina 775X 4P;LINEA BLANCA
18275095;;F;29;CHILENO;;Millenial;PUERTO VARAS                  ;LOS LAGOS;0;0;0;0;0;0;0;0;0;SECADORA SR-10 8KG GRIS SINDELEN;LINEA BLANCA
17325697;Soltero;F;32;CHILENO;PROFESOR;Millenial;PROVIDENCIA                   ;METROPOLITANA;0;0;0;0;0;0;0;0;0;Lavadora WA90H4400SW/ZS 9Kg Blanca;LINEA BLANCA
13594795;;F;43;CHILENO;;X;PROVIDENCIA                   ;METROPOLITANA;0;0;0;0;0;0;0;0;0;Cocina Nova CH9850NG 6P;LINEA BLANCA
8575150;;M;63;CHILENO;;Boomers;CORONEL                       ;BIO BIO;0;0;0;0;0;0;0;0;0;SECADORA CONDENSACION UT CDM 9K15P;LINEA BLANCA
15667082;;M;38;CHILENO;;Millenial;N/D;N/D;0;0;0;0;0;0;0;0;0;FRIGOBAR 93 LTS MFB-930S121LN;LINEA BLANCA
8146297;;F;64;CHILENO;;Boomers;PENALOLEN                     ;METROPOLITANA;0;0;0;0;0;0;0;0;0;Secadora Ropa MSV-90 9K Blanca Ventilacion;LINEA BLANCA
10687879;;M;55;CHILENO;;Boomers;CASTRO                        ;LOS LAGOS;0;0;0;0;0;0;0;0;0;Lavadora WA17T6260BW/ZS 17Kg Blanca;LINEA BLANCA
7806652;;M;66;CHILENO;;Boomers;PROVIDENCIA                   ;METROPOLITANA;0;0;0;0;0;0;0;0;0;Refrigerador 210Lts Rojo Frio Dir MRFS2100R273FN;LINEA BLANCA
13984818;;F;40;CHILENO;;X;PROVIDENCIA                   ;METROPOLITANA;0;0;0;0;0;0;0;0;0;Minibar MMB91S 94Lts;LINEA BLANCA
6417403;;M;68;CHILENO;;Boomers;"";"";0;0;0;0;0;0;0;0;0;Calefon 10Lts GL ATMD;LINEA BLANCA
16149513;;F;37;CHILENO;;Millenial;PROVIDENCIA                   ;METROPOLITANA;0;0;0;0;0;0;0;0;0;Lavadora MLS-190GC03N 19Kg Gris;LINEA BLANCA
10585464;Casado;F;51;CHILENO;TECNICO EN ENFERMERIA DE NIVEL SUPERIOR;X;RENCA                         ;METROPOLITANA;0;0;0;0;0;0;0;0;0;Refrigerador RT22FARADSP/ZS 236Lts No Frost;LINEA BLANCA
26210984;;M;33;HAITIANO;;Extranjero;OSORNO                        ;LOS LAGOS;0;0;0;0;0;0;0;0;0;Lavadora Efficace SZG 17,5Kg Silver;LINEA BLANCA
13888764;;F;41;CHILENO;;Silencioso;PROVIDENCIA                   ;METROPOLITANA;0;0;0;0;0;0;0;0;0;ENCIMERA EXCLUSIVE 60 GL 4P ALBIN TROTTER;LINEA BLANCA
18281044;Soltero;M;29;CHILENO;PEDAGOGIA EN MATEMATICAS;Millenial;PROVIDENCIA                   ;METROPOLITANA;0;0;0;0;0;0;0;0;0;Cocina CH-7400 4P;LINEA BLANCA
12868051;;F;49;CHILENO;;X;N/D;N/D;0;0;0;0;0;0;0;0;0;Cocina MCG-5QI30AME5 5P Inox;LINEA BLANCA
15815214;;M;37;CHILENO;;Millenial;LA LIGUA                      ;VALPARAISO;0;0;0;0;0;0;0;0;0;Freezer Horizontal FFH Z300 291Lts;LINEA BLANCA
8161620;;F;70;CHILENO;;Silencioso;LOS ALAMOS                    ;BIO BIO;0;0;0;0;0;0;0;0;0;Lavadora Efficace SZG 15,5Kg Silver;LINEA BLANCA
11468996;;F;53;CHILENO;;X;PROVIDENCIA                   ;METROPOLITANA;0;0;0;0;0;0;0;0;0;ENCIMERA QUADRA 75 GL 5P ALBIN TROTTER;LINEA BLANCA
19544068;Soltero;F;25;CHILENO;;Z;PROVIDENCIA                   ;METROPOLITANA;0;0;0;0;0;0;0;0;0;Freezer 80Lts LFV-100I Vertical Inox;LINEA BLANCA
16754857;;M;34;CHILENO;;Silencioso;PROVIDENCIA                   ;METROPOLITANA;0;0;0;0;0;0;0;0;0;Refrigerador 241Lts BF Frio Directo Nordik 415;LINEA BLANCA
17623092;;F;32;CHILENO;;Millenial;PROVIDENCIA                   ;METROPOLITANA;0;0;0;0;0;0;0;0;0;Refrigerador BFX70 454Lts No Frost;LINEA BLANCA
16732711;;F;34;CHILENO;;Millenial;SANTIAGO                      ;METROPOLITANA;0;0;0;0;0;0;0;0;0;Lavadora 9 Kg Carga Superior Blanca;LINEA BLANCA
14157861;Soltero;M;41;CHILENO;;Silencioso;PROVIDENCIA                   ;METROPOLITANA;0;0;0;0;0;0;0;0;0;Freezer 142Lts EFC14A5MNW Horizontal;LINEA BLANCA
10397205;;F;57;CHILENO;;Boomers;PAINE                         ;METROPOLITANA;0;0;0;0;0;0;0;0;0;Lavadora Semiautomatica LC-6550 6,5Kg;LINEA BLANCA
15592489;;F;39;CHILENO;;X;N/D;N/D;0;0;0;0;0;0;0;0;0;Lavadora Secadora MLSF-1108BN05N 11Kg/8Kg Blanca;LINEA BLANCA
20124980;;M;23;CHILENO;;Silencioso;PROVIDENCIA                   ;METROPOLITANA;0;0;0;0;0;0;0;0;0;Secadora Ropa Solare 7100 7K Ventilacion;LINEA BLANCA
19945223;;F;24;CHILENO;;Z;PROVIDENCIA                   ;METROPOLITANA;0;0;0;0;0;0;0;0;0;CAMPANA ESSENTIAL 601 INOX ALBIN TROTTER;LINEA BLANCA
19167221;;F;27;CHILENO;;Millenial;N/D;N/D;0;0;0;0;0;0;0;0;0;Refrigerador 241Lts BF Frio Directo Nordik 415;LINEA BLANCA
15828589;;M;38;CHILENO;;Millenial;RENCA                         ;METROPOLITANA;0;0;0;0;0;0;0;0;0;HORNO EMPOTRABLE 2250W 57LTS HE-7220R NEGRO;LINEA BLANCA
18523848;Soltero;M;29;CHILENO;;Silencioso;PROVIDENCIA                   ;METROPOLITANA;0;0;0;0;0;0;0;0;0;Lavadora Secadora Frontal 10.5 / 6Kg Inox Titan;LINEA BLANCA
12028516;;M;42;CHILENO;;X;RENCA                         ;METROPOLITANA;0;0;0;0;0;0;0;0;0;Refrigerador LB37MPGK 341Lts No Frost;LINEA BLANCA
12117250;;F;57;CHILENO;;Boomers;PEDRO AGUIRRE CERDA           ;METROPOLITANA;0;0;0;0;0;0;0;0;0;Refrigerador 252Lts No Frost MRFS-2700G333FW;LINEA BLANCA
7729154;Casado;M;69;CHILENO;;Silencioso;PROVIDENCIA                   ;METROPOLITANA;0;0;0;0;0;0;0;0;0;Freezer FDHM150BY1 150Lts Horizontal;LINEA BLANCA
9848546;Casado;M;56;CHILENO;;Boomers;PROVIDENCIA                   ;METROPOLITANA;0;0;0;0;0;0;0;0;0;Cocina 785FX 4P;LINEA BLANCA
19779758;;M;23;CHILENO;;Z;N/D;N/D;0;0;0;0;0;0;0;0;0;Refrigerador 300Lts No Frost RT29K500JS8/ZS;LINEA BLANCA
11700230;;F;50;CHILENO;;X;LOS ALAMOS                    ;BIO BIO;0;0;0;0;0;0;0;0;0;Lavadora LMA8120WGCL0 18Kg Gris;LINEA BLANCA
17212575;;M;33;CHILENO;;Millenial;PROVIDENCIA                   ;METROPOLITANA;0;0;0;0;0;0;0;0;0;Lavadora WT19DSBP 19Kg Silver;LINEA BLANCA
7039183;Casado;F;64;CHILENO;CONTADOR AUDITOR;Boomers;DIEGO DE ALMAGRO              ;ATACAMA;0;0;0;0;0;0;0;0;0;Refrigerador 244Lts Frio Directo Progress 3100;LINEA BLANCA
13004270;;M;45;CHILENO;;X;MACHALI                       ;L.G.B.OÂ´HIGGINS;0;0;0;0;0;0;0;0;0;COCINA CH-6700IN 4P;LINEA BLANCA
13965411;;M;46;CHILENO;;X;N/D;N/D;0;0;0;0;0;0;0;0;0;Secadora 9Kg Solare 9200 Ventilacion;LINEA BLANCA
9292188;;M;59;CHILENO;;Boomers;ARICA                         ;ARICA Y PARINACOTA;0;0;0;0;0;0;0;0;0;Cocina 785FX 4P;LINEA BLANCA
5370956;;M;77;CHILENO;;Silencioso;PROVIDENCIA                   ;METROPOLITANA;0;0;0;0;0;0;0;0;0;Cocina CMC20AXX 4P Inox;LINEA BLANCA
19746154;;F;24;CHILENO;;Z;LA PINTANA                    ;METROPOLITANA;0;0;0;0;0;0;0;0;0;CAMPANA ESSENTIAL 601 INOX ALBIN TROTTER;LINEA BLANCA
19867534;;F;23;CHILENO;;Silencioso;PROVIDENCIA                   ;METROPOLITANA;0;0;0;0;0;0;0;0;0;Freezer Horizontal M100 99Lts;LINEA BLANCA
18036050;Casado;F;30;CHILENO;;Millenial;PROVIDENCIA                   ;METROPOLITANA;0;0;0;0;0;0;0;0;0;Lavadora Semiautomatica LC-6550 6,5Kg;LINEA BLANCA
15237243;;M;54;CHILENO;;X;NUEVA IMPERIAL                ;ARAUCANIA;0;0;0;0;0;0;0;0;0;Freezer Horizontal M 150 142Lts;LINEA BLANCA
4887412;;F;78;CHILENO;;Silencioso;EL QUISCO                     ;VALPARAISO;0;0;0;0;0;0;0;0;0;Refrigerador RB31K3210S9/ZS 311 LTRS No Frost;LINEA BLANCA
16908496;;F;34;CHILENO;;Millenial;TALCA                         ;MAULE;0;0;0;0;0;0;0;0;0;Lavadora MLS-160BSC03T 16Kg Blanca;LINEA BLANCA
7979658;;M;67;CHILENO;;Boomers;LOS SAUCES                    ;ARAUCANIA;0;0;0;0;0;0;0;0;0;Lavadora MLS-140GSC03T 14Kg Gris;LINEA BLANCA
9648271;;M;58;CHILENO;;Boomers;VILLA ALEMANA                 ;VALPARAISO;0;0;0;0;0;0;0;0;0;Lavadora WT13WSBP 13Kg Blanca;LINEA BLANCA
6746766;Viudo;F;69;CHILENO;PROFESOR;Silencioso;RENCA                         ;METROPOLITANA;0;0;0;0;0;0;0;0;0;Freezer FDHM200BY1 200Lts Horizontal;LINEA BLANCA
11483290;Casado;M;52;CHILENO;TECNICO EN AUTOMATIZACION Y CONTROL INDUSTRIAL;X;PROVIDENCIA                   ;METROPOLITANA;0;0;0;0;0;0;0;0;0;Lavadora Secadora WD12N64FR 12/7Kg;LINEA BLANCA
11466604;;F;53;CHILENO;;Silencioso;ARICA                         ;TARAPACA;0;0;0;0;0;0;0;0;0;Refrigerador 260Lts BF Frio Direc MRFI2660SR346W;LINEA BLANCA
12727279;;M;47;CHILENO;;X;"";"";0;0;0;0;0;0;0;0;0;Refrigerador 535Lts Side by Side RS54N3003SL/ZS;LINEA BLANCA
16154836;;F;36;CHILENO;;Millenial;RENCA                         ;METROPOLITANA;0;0;0;0;0;0;0;0;0;Refrigerador 322Lts No Frost BF DB60S;LINEA BLANCA
16765040;Soltero;F;34;CHILENO;MEDICO CIRUJANO;Silencioso;PROVIDENCIA                   ;METROPOLITANA;0;0;0;0;0;0;0;0;0;Lavadora Secadora WD12N64FR2X/ZS 12/7Kg Silver;LINEA BLANCA
9374413;;M;59;CHILENO;;Boomers;EL BOSQUE                     ;METROPOLITANA;0;0;0;0;0;0;0;0;0;Lavadora Efficace SZG 15,5Kg Silver;LINEA BLANCA
16838167;Soltero;F;33;CHILENO;;Millenial;PROVIDENCIA                   ;METROPOLITANA;0;0;0;0;0;0;0;0;0;Centrifuga Primma 5B 5,5Kilos;LINEA BLANCA
11777292;;F;51;CHILENO;;Silencioso;LOS ANGELES                   ;BIO BIO;0;0;0;0;0;0;0;0;0;Lavadora MLS-160BSC03T 16Kg Blanca;LINEA BLANCA
8767201;;F;63;CHILENO;;Boomers;SAN FERNANDO                  ;L.G.B.OÂ´HIGGINS;0;0;0;0;0;0;0;0;0;Lavadora WA13T5260BW/ZS 13Kg Blanca;LINEA BLANCA
6274640;;F;74;CHILENO;;Silencioso;PUNTA ARENAS                  ;MAGALLANES;0;0;0;0;0;0;0;0;0;Lavadora MLS-160BSC03T 16Kg Blanca;LINEA BLANCA
12966796;;F;45;CHILENO;;X;PARRAL                        ;MAULE;0;0;0;0;0;0;0;0;0;Lavadora WT16DSBP 16Kg Silver;LINEA BLANCA
18965550;Soltero;M;27;CHILENO;;Z;PROVIDENCIA                   ;METROPOLITANA;0;0;0;0;0;0;0;0;0;Lavadora Efficace SZG 17,5Kg Silver;LINEA BLANCA
19256150;;F;26;CHILENO;;Z;N/D;N/D;0;0;0;0;0;0;0;0;0;Refrigerador 210Lts Rojo Frio Dir MRFS2100R273FN;LINEA BLANCA
16585469;;F;35;CHILENO;;Millenial;BUIN                          ;METROPOLITANA;0;0;0;0;0;0;0;0;0;Lavadora Semiautomatica Twister 5100 4Kg;LINEA BLANCA
14552897;;F;47;CHILENO;;X;N/D;N/D;0;0;0;0;0;0;0;0;0;Lavadora MLS-160BSC03T 16Kg Blanca;LINEA BLANCA
5527148;;M;77;CHILENO;;Silencioso;CALERA                        ;VALPARAISO;0;0;0;0;0;0;0;0;0;Refrigerador 260Lts BF Frio Direc MRFI2660SR346W;LINEA BLANCA
17500990;;M;32;CHILENO;;Millenial;PIRQUE                        ;METROPOLITANA;0;0;0;0;0;0;0;0;0;Calefon Neckar 10 litros GL;LINEA BLANCA
16509044;;F;35;CHILENO;;Millenial;PROVIDENCIA                   ;METROPOLITANA;0;0;0;0;0;0;0;0;0;Lavadora MLS-090GE04N 9Kg Gris;LINEA BLANCA
18870843;Soltero;F;27;CHILENO;;Silencioso;PROVIDENCIA                   ;METROPOLITANA;0;0;0;0;0;0;0;0;0;Cocina CH-7400 4P;LINEA BLANCA
13526506;;F;46;CHILENO;;X;RENCA                         ;METROPOLITANA;0;0;0;0;0;0;0;0;0;Refrigerador 210Lts Rojo Frio Dir MRFS2100R273FN;LINEA BLANCA
15205626;;M;40;CHILENO;;X;RENCA                         ;METROPOLITANA;0;0;0;0;0;0;0;0;0;HORNO EMPOTRABLE HE-7200 INOX 2250W 57L SINDELEN;LINEA BLANCA
16065857;Casado;M;37;CHILENO;CIRUJANO DENTISTA;Silencioso;PROVIDENCIA                   ;METROPOLITANA;0;0;0;0;0;0;0;0;0;Freezer Horizontal M 150 142Lts;LINEA BLANCA
12517824;;F;48;CHILENO;;X;RANCAGUA                      ;L.G.B.OÂ´HIGGINS;0;0;0;0;0;0;0;0;0;Lavadora Efficace SZG 15,5Kg Silver;LINEA BLANCA
15840990;;M;37;CHILENO;;Millenial;MAIPU                         ;METROPOLITANA;0;0;0;0;0;0;0;0;0;Lavadora MLS-090GE04N 9Kg Gris;LINEA BLANCA
26610461;;M;38;COLOMBIANO;;Extranjero;CHIGUAYANTE                   ;BIO BIO;0;0;0;0;0;0;0;0;0;Lavadora LMA0920WGCL0 9,5Kg Gris;LINEA BLANCA
15178219;;M;39;CHILENO;;Millenial;PROVIDENCIA                   ;METROPOLITANA;0;0;0;0;0;0;0;0;0;Secadora Ropa MSV-90 9K Blanca Ventilacion;LINEA BLANCA
9268299;;M;60;CHILENO;;Boomers;PANGUIPULLI                   ;LOS RIOS;0;0;0;0;0;0;0;0;0;Refrigerador 241Lts BF Frio Directo Nordik 415;LINEA BLANCA
12086176;Divorciado;F;54;CHILENO;;Boomers;LA CISTERNA                   ;METROPOLITANA;0;0;0;0;0;0;0;0;0;Refrigerador 260Lts BF Frio Direc MRFI2660SR346W;LINEA BLANCA
17805331;Viudo;F;31;CHILENO;;Millenial;VALPARAISO                    ;VALPARAISO;0;0;0;0;0;0;0;0;0;Lavadora WA80H4200SW/ZS 8Kg Blanca;LINEA BLANCA
16809384;;F;34;CHILENO;;Silencioso;PROVIDENCIA                   ;METROPOLITANA;0;0;0;0;0;0;0;0;0;Lavadora WT13WSBP 13Kg Blanca;LINEA BLANCA
16483217;;F;55;CHILENO;;Boomers;N/D;N/D;0;0;0;0;0;0;0;0;0;Cocina MCG-4QI24AME4 4P Inox;LINEA BLANCA
18889148;;M;26;CHILENO;;Z;VALDIVIA                      ;LOS LAGOS;0;0;0;0;0;0;0;0;0;Lavadora MLS-090GE04N 9Kg Gris;LINEA BLANCA
26983204;;F;25;VENEZOLANO;;Extranjero;LOS ANGELES                   ;BIO BIO;0;0;0;0;0;0;0;0;0;Refrigerador MRFI1800S234RN 180Lts BF Frio Direc;LINEA BLANCA
6004336;;M;73;CHILENO;;Silencioso;PROVIDENCIA                   ;METROPOLITANA;0;0;0;0;0;0;0;0;0;Cocina CH-7400 4P;LINEA BLANCA
13102672;;M;45;CHILENO;;X;N/D;N/D;0;0;0;0;0;0;0;0;0;Cocina F-2808 4P;LINEA BLANCA
6000138;Viudo;F;72;CHILENO;;Silencioso;PROVIDENCIA                   ;METROPOLITANA;0;0;0;0;0;0;0;0;0;Lavadora MLS-160BSC03T 16Kg Blanca;LINEA BLANCA
10512606;;F;56;CHILENO;;Boomers;VINA DEL MAR                  ;VALPARAISO;0;0;0;0;0;0;0;0;0;Freezer 99Lts MFH-1000B131CN Horizontal;LINEA BLANCA
9374943;Soltero;M;60;CHILENO;;Boomers;RENCA                         ;METROPOLITANA;0;0;0;0;0;0;0;0;0;Lavadora Efficace BZG 9,5Kg Blanca;LINEA BLANCA
18206112;;M;31;CHILENO;;Millenial;N/D;N/D;0;0;0;0;0;0;0;0;0;Freezer Horizonal SFH-101BL 99Lts;LINEA BLANCA
18296699;;F;29;CHILENO;;Millenial;PROVIDENCIA                   ;METROPOLITANA;0;0;0;0;0;0;0;0;0;Cocina 755 S 4P;LINEA BLANCA
12013168;;M;51;CHILENO;;Silencioso;PROVIDENCIA                   ;METROPOLITANA;0;0;0;0;0;0;0;0;0;Lavadora WA90H4400SW/ZS 9Kg Blanca;LINEA BLANCA
17346742;;F;32;CHILENO;;Millenial;PROVIDENCIA                   ;METROPOLITANA;0;0;0;0;0;0;0;0;0;Lavadora WA80H4200SW/ZS 8Kg Blanca;LINEA BLANCA
10291511;Soltero;F;56;CHILENO;;Boomers;PROVIDENCIA                   ;METROPOLITANA;0;0;0;0;0;0;0;0;0;ENCIMERA MCE 435E MADEMSA;LINEA BLANCA
18008862;;F;30;CHILENO;;Millenial;ANGOL                         ;ARAUCANIA;0;0;0;0;0;0;0;0;0;Lavadora Superior WA19T6260BW/ZS 19Kg;LINEA BLANCA
19788717;;M;24;CHILENO;;Z;PROVIDENCIA                   ;METROPOLITANA;0;0;0;0;0;0;0;0;0;Secadora Ropa MSV-90 9K Blanca Ventilacion;LINEA BLANCA
9191859;;M;61;CHILENO;;Boomers;OSORNO                        ;LOS LAGOS;0;0;0;0;0;0;0;0;0;Refrigerador 244Lts Frio Directo Progress 3100;LINEA BLANCA
11897152;;M;51;CHILENO;;X;ANTOFAGASTA                   ;ANTOFAGASTA;0;0;0;0;0;0;0;0;0;Freezer FDHM150BY1 150Lts Horizontal;LINEA BLANCA
13847021;;F;42;CHILENO;;X;PROVIDENCIA                   ;METROPOLITANA;0;0;0;0;0;0;0;0;0;Lavadora WT9WPB2 9K Blanca;LINEA BLANCA
12132676;;F;51;CHILENO;;X;RIO NEGRO                     ;LOS LAGOS;0;0;0;0;0;0;0;0;0;Cocina 775X 4P;LINEA BLANCA
10197042;;M;58;CHILENO;;Boomers;RENCA                         ;METROPOLITANA;0;0;0;0;0;0;0;0;0;Cocina CH-8700IN 5P;LINEA BLANCA
18702504;;F;28;CHILENO;;Millenial;LO PRADO                      ;METROPOLITANA;0;0;0;0;0;0;0;0;0;Refrigerador 260Lts BF Frio Direc MRFI2660SR346W;LINEA BLANCA
17250537;;M;33;CHILENO;;Millenial;RENCA                         ;METROPOLITANA;0;0;0;0;0;0;0;0;0;Freezer FDHM150BY1 150Lts Horizontal;LINEA BLANCA
19102211;;F;27;CHILENO;;Z;ANTOFAGASTA                   ;ANTOFAGASTA;0;0;0;0;0;0;0;0;0;FRIGOBAR 93 LTS MFB-930S121LN;LINEA BLANCA
5748233;;F;70;CHILENO;;Silencioso;PROVIDENCIA                   ;METROPOLITANA;0;0;0;0;0;0;0;0;0;Refrigerador 2260-S 222Lts Frio Directo;LINEA BLANCA
9870211;;F;60;CHILENO;;Boomers;TALCA                         ;MAULE;0;0;0;0;0;0;0;0;0;Cocina PRO445 4P Inox;LINEA BLANCA
19844271;;F;24;CHILENO;;Z;PROVIDENCIA                   ;METROPOLITANA;0;0;0;0;0;0;0;0;0;Cocina Diva 920 5P;LINEA BLANCA
11580739;;F;52;CHILENO;;X;COLINA                        ;METROPOLITANA;0;0;0;0;0;0;0;0;0;Refrigerador 241Lts BF Frio Directo Nordik 415;LINEA BLANCA
5833951;;M;75;CHILENO;;Silencioso;TEMUCO                        ;ARAUCANIA;0;0;0;0;0;0;0;0;0;Refrigerador 260Lts BF Frio Direc MRFI2660SR346W;LINEA BLANCA
18795948;;M;28;CHILENO;;Millenial;N/D;N/D;0;0;0;0;0;0;0;0;0;Freezer 142Lts MFH-1430B186C Horizontal;LINEA BLANCA
16214210;Soltero;F;36;CHILENO;TECNICO EN ALIMENTOS;Millenial;VILLARICA                     ;ARAUCANIA;0;0;0;0;0;0;0;0;0;Lavadora WT19DSBP 19Kg Silver;LINEA BLANCA
10665706;;M;55;CHILENO;;Boomers;PROVIDENCIA                   ;METROPOLITANA;0;0;0;0;0;0;0;0;0;Cocina CH-9950NG-1 6P Negro;LINEA BLANCA
17917967;Soltero;M;30;CHILENO;BIOQUIMICO;Millenial;PROVIDENCIA                   ;METROPOLITANA;0;0;0;0;0;0;0;0;0;Lavadora MLS-090GE04N 9Kg Gris;LINEA BLANCA
17318304;;M;32;CHILENO;;Millenial;PROVIDENCIA                   ;METROPOLITANA;0;0;0;0;0;0;0;0;0;Secadora SMG26N5MNBCL1 20 Kg Gas;LINEA BLANCA
15816187;;F;38;CHILENO;;Millenial;"";"";0;0;0;0;0;0;0;0;0;Refrigerador 241Lts BF Frio Directo Nordik 415;LINEA BLANCA
9313955;;M;59;CHILENO;;Boomers;RENCA                         ;METROPOLITANA;0;0;0;0;0;0;0;0;0;Lavadora WA90H4400SW/ZS 9Kg Blanca;LINEA BLANCA
5616548;;F;72;CHILENO;;Silencioso;VILLA ALEMANA                 ;VALPARAISO;0;0;0;0;0;0;0;0;0;Lavadora WA90H4400SW/ZS 9Kg Blanca;LINEA BLANCA
22776944;;M;40;PERUANO;;Extranjero;MARIA ELENA                   ;ANTOFAGASTA;0;0;0;0;0;0;0;0;0;Cocina CMC20AXX 4P Inox;LINEA BLANCA
16418470;Casado;M;35;CHILENO;;Millenial;PROVIDENCIA                   ;METROPOLITANA;0;0;0;0;0;0;0;0;0;Refrigerador 527Lts Side by Side MRSBS5300G689WE;LINEA BLANCA
11692428;;M;52;CHILENO;;X;COIHAIQUE                     ;AYSEN;0;0;0;0;0;0;0;0;0;Lavadora Efficace SZG 19,5Kg Silver;LINEA BLANCA
7502355;;M;60;CHILENO;;Boomers;SAN JOAQUIN                   ;METROPOLITANA;0;0;0;0;0;0;0;0;0;Lavadora WD10J6410AX/ZS 10,5Kg;LINEA BLANCA
9014568;;M;60;CHILENO;;Boomers;PROVIDENCIA                   ;METROPOLITANA;0;0;0;0;0;0;0;0;0;Frigobar FB-90 Blanco 90Lts;LINEA BLANCA
13792283;;M;41;CHILENO;;X;CORONEL                       ;BIO BIO;0;0;0;0;0;0;0;0;0;Cocina CMC20AXX 4P Inox;LINEA BLANCA
19348342;;M;26;CHILENO;;Z;LA SERENA                     ;COQUIMBO;0;0;0;0;0;0;0;0;0;Refrigerador 290Lts BF No Frost RB30N4020S8;LINEA BLANCA
17633944;;F;32;CHILENO;;Millenial;CALERA                        ;VALPARAISO;0;0;0;0;0;0;0;0;0;Cocina CH-9900SI 6P Silver;LINEA BLANCA
16823258;;M;44;CHILENO;;X;RENCA                         ;METROPOLITANA;0;0;0;0;0;0;0;0;0;ENCIMERA A GAS 4 PLATOS CEG-4650 INOX;LINEA BLANCA
4931433;;F;84;CHILENO;;Silencioso;VALDIVIA                      ;LOS LAGOS;0;0;0;0;0;0;0;0;0;Cocina 775X 4P;LINEA BLANCA
16486998;;M;35;CHILENO;;Millenial;N/D;N/D;0;0;0;0;0;0;0;0;0;Lavadora MLS-090GE04N 9Kg Gris;LINEA BLANCA
9246036;Casado;F;59;CHILENO;;Boomers;RENCA                         ;METROPOLITANA;0;0;0;0;0;0;0;0;0;Cocina CMC20AXX 4P Inox;LINEA BLANCA
11483229;Soltero;F;52;CHILENO;ASISTENTE SOCIAL;X;PROVIDENCIA                   ;METROPOLITANA;0;0;0;0;0;0;0;0;0;Refrigerador KGN36XI35 324Lts BF No Frost;LINEA BLANCA
8451360;;F;65;CHILENO;;Boomers;VILLA ALEMANA                 ;VALPARAISO;0;0;0;0;0;0;0;0;0;Refrigerador 260Lts BF Frio Direc MRFI2660SR346W;LINEA BLANCA
14715985;;F;41;PERUANO;;Extranjero;CERRILLOS                     ;METROPOLITANA;0;0;0;0;0;0;0;0;0;Cocina Andes7650FX 5P Inox;LINEA BLANCA
12162269;;F;52;CHILENO;;X;PROVIDENCIA                   ;METROPOLITANA;0;0;0;0;0;0;0;0;0;Secadora Ropa MSV-90 9K Blanca Ventilacion;LINEA BLANCA
17936365;;F;31;CHILENO;;Millenial;PROVIDENCIA                   ;METROPOLITANA;0;0;0;0;0;0;0;0;0;Refrigerador 249Lts No Frost RMA250PHUG;LINEA BLANCA
17749325;;M;31;CHILENO;;Millenial;PROVIDENCIA                   ;METROPOLITANA;0;0;0;0;0;0;0;0;0;Lavadora/Centrifuga LC4550 4,5Kg Blanca;LINEA BLANCA
18639283;;M;28;CHILENO;;Millenial;ANTOFAGASTA                   ;ANTOFAGASTA;0;0;0;0;0;0;0;0;0;SECADORA VENT UT VD 8K7P;LINEA BLANCA
14206688;;M;41;CHILENO;;X;RENCA                         ;METROPOLITANA;0;0;0;0;0;0;0;0;0;Lavadora WA90H4400SW/ZS 9Kg Blanca;LINEA BLANCA
10893420;;M;55;CHILENO;;Boomers;CAUQUENES                     ;MAULE;0;0;0;0;0;0;0;0;0;Refrigerador 241Lts BF Frio Directo Nordik 415;LINEA BLANCA
9955357;Casado;F;59;CHILENO;;Boomers;RENCA                         ;METROPOLITANA;0;0;0;0;0;0;0;0;0;Freezer FDHM200BY1 200Lts Horizontal;LINEA BLANCA
15401902;;F;40;CHILENO;;X;PROVIDENCIA                   ;METROPOLITANA;0;0;0;0;0;0;0;0;0;Refrigerador 252Lts No Frost MRFS-2700G333FW;LINEA BLANCA
13360684;;F;43;CHILENO;;X;SALAMANCA                     ;COQUIMBO;0;0;0;0;0;0;0;0;0;Lavadora WA17F7L6DD 17Kg Blanca;LINEA BLANCA
16186029;Casado;F;36;CHILENO;PROFESOR;Millenial;PROVIDENCIA                   ;METROPOLITANA;0;0;0;0;0;0;0;0;0;Refrigerador 290LTS No Frost RMB302PXLRS0;LINEA BLANCA
19015355;;F;27;CHILENO;;Z;VALPARAISO                    ;VALPARAISO;0;0;0;0;0;0;0;0;0;Lavadora MLS-090GE04N 9Kg Gris;LINEA BLANCA
17384895;;F;32;CHILENO;;Millenial;YERBAS BUENAS                 ;MAULE;0;0;0;0;0;0;0;0;0;Refrigerador 290LTS No Frost RMB302PXLRS0;LINEA BLANCA
10328606;;M;55;CHILENO;;Boomers;QUILPUE                       ;VALPARAISO;0;0;0;0;0;0;0;0;0;Refrigerador 244Lts Frio Directo Progress 3100;LINEA BLANCA
5182824;;M;75;CHILENO;;Silencioso;CARTAGENA                     ;VALPARAISO;0;0;0;0;0;0;0;0;0;Cocina Andes60TX4 4P Inox;LINEA BLANCA
15406673;;M;40;CHILENO;;X;BUIN                          ;METROPOLITANA;0;0;0;0;0;0;0;0;0;Lavadora WT16DSBP 16Kg Silver;LINEA BLANCA
9651222;;F;62;CHILENO;;Boomers;PROVIDENCIA                   ;METROPOLITANA;0;0;0;0;0;0;0;0;0;Refrigerador MBF60X 322Lts BF No Frost;LINEA BLANCA
13432322;;F;43;CHILENO;;X;VALPARAISO                    ;VALPARAISO;0;0;0;0;0;0;0;0;0;Refrigerador 251Lts No Frost Altus 1250;LINEA BLANCA
27210050;;M;35;EXTRANJERO - NO INFORMA NACIONALIDAD;;Extranjero;ESTACION CENTRAL              ;METROPOLITANA;0;0;0;0;0;0;0;0;0;Lavadora MLS-090GE04N 9Kg Gris;LINEA BLANCA
8341874;;F;65;CHILENO;;Boomers;LO ESPEJO                     ;METROPOLITANA;0;0;0;0;0;0;0;0;0;Lavadora Brilliant SG 11,5Kg Silver;LINEA BLANCA
8394999;;F;65;CHILENO;;Boomers;BUIN                          ;METROPOLITANA;0;0;0;0;0;0;0;0;0;Cocina CH-9050SI 4P;LINEA BLANCA
19301583;;M;26;CHILENO;;Z;PROVIDENCIA                   ;METROPOLITANA;0;0;0;0;0;0;0;0;0;Frigobar LFB-90N 98Lts Retro Design;LINEA BLANCA
12969298;;F;46;CHILENO;;X;OLIVAR                        ;L.G.B.OÂ´HIGGINS;0;0;0;0;0;0;0;0;0;Lavadora WA17T6260BW/ZS 17Kg Blanca;LINEA BLANCA
16579540;;M;35;CHILENO;;Millenial;VICTORIA                      ;ARAUCANIA;0;0;0;0;0;0;0;0;0;Refrigerador 244Lts Frio Directo Progress 3100;LINEA BLANCA
9685670;Casado;F;59;CHILENO;;Boomers;BUIN                          ;METROPOLITANA;0;0;0;0;0;0;0;0;0;Refrigerador 260Lts BF Frio Direc MRFI2660SR346W;LINEA BLANCA
16045918;;F;36;CHILENO;;Millenial;RIO BUENO                     ;LOS RIOS;0;0;0;0;0;0;0;0;0;Cocina Lena Antonella Blanca;LINEA BLANCA
9325578;;M;60;CHILENO;;Boomers;"";"";0;0;0;0;0;0;0;0;0;Cocina Diva 920 5P;LINEA BLANCA
17756018;;F;31;CHILENO;;Millenial;PROVIDENCIA                   ;METROPOLITANA;0;0;0;0;0;0;0;0;0;Lavadora superior MLS-110GE04N 11Kg;LINEA BLANCA
15675724;Soltero;M;38;CHILENO;;X;PROVIDENCIA                   ;METROPOLITANA;0;0;0;0;0;0;0;0;0;Lavadora Efficace SZG 15,5Kg Silver;LINEA BLANCA
10371705;;F;68;CHILENO;;Boomers;MAIPU                         ;METROPOLITANA;0;0;0;0;0;0;0;0;0;Lavadora Semiautomatica Twister 5100 4Kg;LINEA BLANCA
17818780;;M;31;CHILENO;;Millenial;LOS ANDES                     ;VALPARAISO;0;0;0;0;0;0;0;0;0;Refrigerador 167Lts Frio Directo 1700-S;LINEA BLANCA
10761275;;M;54;CHILENO;;Boomers;PROVIDENCIA                   ;METROPOLITANA;0;0;0;0;0;0;0;0;0;Lavadora Efficace SZG 17,5Kg Silver;LINEA BLANCA
6180715;;M;73;CHILENO;;Silencioso;SAN ANTONIO                   ;VALPARAISO;0;0;0;0;0;0;0;0;0;Lavadora Efficace SZG 17,5Kg Silver;LINEA BLANCA
4061571;;M;81;CHILENO;;Silencioso;VILLA ALEMANA                 ;VALPARAISO;0;0;0;0;0;0;0;0;0;Refrigerador 241Lts BF Frio Directo Nordik 415;LINEA BLANCA
5775267;;M;74;CHILENO;;Silencioso;CONSTITUCION                  ;MAULE;0;0;0;0;0;0;0;0;0;Freezer 196Lts M200 Horizontal;LINEA BLANCA
9662597;;F;56;CHILENO;;Boomers;PROVIDENCIA                   ;METROPOLITANA;0;0;0;0;0;0;0;0;0;Lavadora Semiautomatica Twister 5300 4Kg;LINEA BLANCA
15172471;;F;38;CHILENO;;Millenial;PROVIDENCIA                   ;METROPOLITANA;0;0;0;0;0;0;0;0;0;Cocina Diva 920 5P;LINEA BLANCA
14713604;;F;44;PERUANO;;Extranjero;SANTIAGO                      ;METROPOLITANA;0;0;0;0;0;0;0;0;0;Lavadora WT19DSBP 19Kg Silver;LINEA BLANCA
11760505;;F;51;CHILENO;;X;LAMPA                         ;METROPOLITANA;0;0;0;0;0;0;0;0;0;Lavadora Efficace SZG 19,5Kg Silver;LINEA BLANCA
6638243;;F;71;CHILENO;;Silencioso;RENCA                         ;METROPOLITANA;0;0;0;0;0;0;0;0;0;Lavadora WA80H4200SW/ZS 8Kg Blanca;LINEA BLANCA
19286861;;F;26;CHILENO;;Z;NACIMIENTO                    ;BIO BIO;0;0;0;0;0;0;0;0;0;Lavadora Efficace SZG 15,5Kg Silver;LINEA BLANCA
11416972;;F;52;CHILENO;;X;TUCAPEL                       ;BIO BIO;0;0;0;0;0;0;0;0;0;Lavadora WA13T5260BW/ZS 13Kg Blanca;LINEA BLANCA
10250384;;M;57;CHILENO;;Boomers;LA GRANJA                     ;METROPOLITANA;0;0;0;0;0;0;0;0;0;Lavadora Efficace SZG 17,5Kg Silver;LINEA BLANCA
12328611;;F;52;CHILENO;;X;RENCA                         ;METROPOLITANA;0;0;0;0;0;0;0;0;0;Lavadora WA13R5260BW/ZS 13Kg Blanca;LINEA BLANCA
7016797;Casado;M;53;CHILENO;;X;PROVIDENCIA                   ;METROPOLITANA;0;0;0;0;0;0;0;0;0;Campana Cocina CA-610EBL 60Cms Blanca;LINEA BLANCA
6957425;Casado;M;68;CHILENO;;Silencioso;RENCA                         ;METROPOLITANA;0;0;0;0;0;0;0;0;0;Lavadora Semiautomatica Twister 5300 4Kg;LINEA BLANCA
8390850;;M;66;CHILENO;;Boomers;RENCA                         ;METROPOLITANA;0;0;0;0;0;0;0;0;0;Lavadora MLS-160BSC03T 16Kg Blanca;LINEA BLANCA
8082039;;M;65;CHILENO;;Boomers;RENCA                         ;METROPOLITANA;0;0;0;0;0;0;0;0;0;Refrigerador 244Lts Frio Directo Progress 3100;LINEA BLANCA
10988463;;F;48;CHILENO;;X;ANTOFAGASTA                   ;ANTOFAGASTA;0;0;0;0;0;0;0;0;0;Lavadora Efficace SZG 15,5Kg Silver;LINEA BLANCA
16288647;Soltero;M;36;CHILENO;;Millenial;RENCA                         ;METROPOLITANA;0;0;0;0;0;0;0;0;0;Lavadora WT19DSBP 19Kg Silver;LINEA BLANCA
12755306;;F;50;CHILENO;;X;PUERTO MONTT                  ;LOS LAGOS;0;0;0;0;0;0;0;0;0;Cocina Enlozada Lena 60x90;LINEA BLANCA
8038106;;F;65;CHILENO;;Boomers;N/D;N/D;0;0;0;0;0;0;0;0;0;Lavadora Efficace SZG 17,5Kg Silver;LINEA BLANCA
10268522;;M;57;CHILENO;;Boomers;PEDRO AGUIRRE CERDA           ;METROPOLITANA;0;0;0;0;0;0;0;0;0;Refrigerador 249Lts No Frost RMA250PHUG;LINEA BLANCA
12835360;;F;47;CHILENO;;X;PROVIDENCIA                   ;METROPOLITANA;0;0;0;0;0;0;0;0;0;Lavadora Semiautomatica Twister 5100 4Kg;LINEA BLANCA
15468894;;M;40;CHILENO;;X;PROVIDENCIA                   ;METROPOLITANA;0;0;0;0;0;0;0;0;0;Cava de vino Winecool12 12Botellas;LINEA BLANCA
4450355;;F;81;CHILENO;;Silencioso;QUILPUE                       ;VALPARAISO;0;0;0;0;0;0;0;0;0;Cocina F-2608 4P Inox;LINEA BLANCA
9440751;;F;61;CHILENO;;Boomers;PUENTE ALTO                   ;METROPOLITANA;0;0;0;0;0;0;0;0;0;Refrigerador LB37MPGK 341Lts No Frost;LINEA BLANCA
16880196;;F;34;CHILENO;;Millenial;DONIHUE                       ;L.G.B.OÂ´HIGGINS;0;0;0;0;0;0;0;0;0;Freezer FDHM200BY1 200Lts Horizontal;LINEA BLANCA
7996580;;F;66;CHILENO;;Boomers;RENCA                         ;METROPOLITANA;0;0;0;0;0;0;0;0;0;Cocina 775X 4P;LINEA BLANCA
8921500;Soltero;F;63;CHILENO;;Boomers;QUILPUE                       ;VALPARAISO;0;0;0;0;0;0;0;0;0;Freezer 142Lts EFC14A5MNW Horizontal;LINEA BLANCA
14559123;;M;46;CHILENO;;X;PROVIDENCIA                   ;METROPOLITANA;0;0;0;0;0;0;0;0;0;Lavadora Efficace SZG 15,5Kg Silver;LINEA BLANCA
15704373;;M;38;CHILENO;;Millenial;SAN BERNARDO                  ;METROPOLITANA;0;0;0;0;0;0;0;0;0;Cocina F-2808 4P;LINEA BLANCA
6909794;;F;67;CHILENO;;Boomers;EL MONTE                      ;METROPOLITANA;0;0;0;0;0;0;0;0;0;Calefon Vitality G/L 8Lts;LINEA BLANCA
16575826;;M;34;CHILENO;;Millenial;PROVIDENCIA                   ;METROPOLITANA;0;0;0;0;0;0;0;0;0;Cocina CMC20AXX 4P Inox;LINEA BLANCA
18221309;Casado;M;30;CHILENO;;Millenial;PROVIDENCIA                   ;METROPOLITANA;0;0;0;0;0;0;0;0;0;Freezer 142Lts MFH-1430B186C Horizontal;LINEA BLANCA
13709414;;F;43;CHILENO;;X;RENCA                         ;METROPOLITANA;0;0;0;0;0;0;0;0;0;Freezer 142Lts MFH-1430B186C Horizontal;LINEA BLANCA
10896203;Viudo;F;72;CHILENO;;Silencioso;TEODORO SCHMIDT               ;ARAUCANIA;0;0;0;0;0;0;0;0;0;Lavadora Efficace SZG 17,5Kg Silver;LINEA BLANCA
11214940;;F;55;CHILENO;;Boomers;PROVIDENCIA                   ;METROPOLITANA;0;0;0;0;0;0;0;0;0;Secadora Ropa SEM81BDBY 9Kg Blanca Ventilacion;LINEA BLANCA
17221658;;F;33;CHILENO;;Millenial;PROVIDENCIA                   ;METROPOLITANA;0;0;0;0;0;0;0;0;0;Lavadora MLS-090GE04N 9Kg Gris;LINEA BLANCA
7991994;;M;64;CHILENO;;Boomers;LIMACHE                       ;VALPARAISO;0;0;0;0;0;0;0;0;0;Lavadora WA90H4400SW/ZS 9Kg Blanca;LINEA BLANCA
10155370;Casado;F;59;CHILENO;;Boomers;RENCA                         ;METROPOLITANA;0;0;0;0;0;0;0;0;0;Refrigerador 290Lts BF No Frost RB30N4020S8;LINEA BLANCA
15301655;;F;40;CHILENO;;X;PROVIDENCIA                   ;METROPOLITANA;0;0;0;0;0;0;0;0;0;Lavadora WT16DSBP 16Kg Silver;LINEA BLANCA
17454412;;F;32;CHILENO;;Millenial;PROVIDENCIA                   ;METROPOLITANA;0;0;0;0;0;0;0;0;0;COCINA CH-5490NI 4P;LINEA BLANCA
5985230;;M;75;CHILENO;;Silencioso;"";"";1334850;14;6;12;5;1093870;2;1;240980;LED 32 32PHD6825 HD SMART TV;ELECTRONICA MAYOR
5037458;;F;82;CHILENO;;Silencioso;QUINTA DE TILCOCO             ;L.G.B.OÂ´HIGGINS;273770;4;2;0;0;0;4;2;273770;MINICOMPONENTE OL45;ELECTRONICA MAYOR
9410469;;M;59;CHILENO;;Boomers;RENCA                         ;METROPOLITANA;458980;2;1;2;1;458980;0;0;0;QLED 55 QN55Q60AAGXZS 4K UHD SMART TV;ELECTRONICA MAYOR
17415349;;F;32;CHILENO;;Millenial;PROVIDENCIA                   ;METROPOLITANA;108980;2;1;2;1;108980;0;0;0;LED 32 32PHD6825 HD SMART TV;ELECTRONICA MAYOR
9893585;;M;59;CHILENO;;Boomers;MONTE PATRIA                  ;COQUIMBO;1313192;15;4;0;0;0;15;4;1313192;LED SAMSUNG 43 UN43AU7090GXZS SMART TV UHD 4K;ELECTRONICA MAYOR
5687245;;F;80;CHILENO;;Silencioso;NATALES                       ;MAGALLANES;188972;3;1;0;0;0;3;1;188972;LED 40 KEHD4020 SMART TV;ELECTRONICA MAYOR
7537695;;M;67;CHILENO;;Boomers;CORONEL                       ;BIO BIO;149990;1;1;0;0;0;1;1;149990;MONITOR 24 24TL520S SMART TV HD;ELECTRONICA MAYOR
9403141;Casado;F;60;CHILENO;;Boomers;PROVIDENCIA                   ;METROPOLITANA;303980;3;1;3;1;303980;0;0;0;LED 40 KEHD4020 SMART TV;ELECTRONICA MAYOR
17387020;;M;32;CHILENO;;Millenial;ANCUD                         ;LOS LAGOS;148474;3;3;0;0;0;3;3;148474;PARLANTE SCREAMER 4;ELECTRONICA MAYOR
12141628;;M;52;CHILENO;;X;PUENTE ALTO                   ;METROPOLITANA;673320;4;2;0;0;0;4;2;673320;PARLANTE ULTRABUZZ;ELECTRONICA MAYOR
12971063;;M;46;CHILENO;;X;PINTO                         ;BIO BIO;0;0;2;0;0;0;0;2;0;LED 42 42S6500 ANDROID TV FHD;ELECTRONICA MAYOR
18541738;;F;29;CHILENO;;Millenial;N/D;N/D;561980;3;1;3;1;561980;0;0;0;LED SAMSUNG 50 AU7090 CRYSTAL UHD 4K SMART TV 20;ELECTRONICA MAYOR
16198703;;F;36;CHILENO;;Millenial;"";"";116980;2;1;2;1;116980;0;0;0;LED 32 32PHD6825 HD SMART TV;ELECTRONICA MAYOR
11632674;;F;52;CHILENO;;X;LA CISTERNA                   ;METROPOLITANA;299980;2;1;2;1;299980;0;0;0;LED SAMSUNG 50 AU7090 CRYSTAL UHD 4K SMART TV 20;ELECTRONICA MAYOR
14516539;;F;42;CHILENO;;X;EL TABO                       ;VALPARAISO;285970;3;2;0;0;0;3;2;285970;LED 32 AOC ROKU TV HD 32S5195;ELECTRONICA MAYOR
15145007;;M;40;CHILENO;;X;N/D;N/D;736930;7;5;0;0;0;7;5;736930;LED 43 43S5195 ROKU TV FHD;ELECTRONICA MAYOR
8591106;;F;62;CHILENO;;Boomers;SAN ANTONIO                   ;VALPARAISO;1575880;12;6;0;0;0;12;6;1575880;LED 43 43S5195 ROKU TV FHD;ELECTRONICA MAYOR
19248081;;F;26;CHILENO;;Z;PROVIDENCIA                   ;METROPOLITANA;379980;2;2;2;2;379980;0;0;0;LED 50 KEUH50 SMART TV UHD;ELECTRONICA MAYOR
13447861;;M;43;CHILENO;;X;PUENTE ALTO                   ;METROPOLITANA;201090;2;1;0;0;0;2;1;201090;PARLANTE KARAOKE K3421;ELECTRONICA MAYOR
12489320;;M;49;CHILENO;;X;N/D;N/D;1015950;5;2;5;2;1015950;0;0;0;LED SAMSUNG 50 AU7090 CRYSTAL UHD 4K SMART TV 20;ELECTRONICA MAYOR
16560873;;M;35;CHILENO;;Extranjero;N/D;N/D;382160;2;1;0;0;0;2;1;382160;LED LG 50 50UQ7500PSF.AWH UHD TV;ELECTRONICA MAYOR
12532248;;F;48;CHILENO;;X;PROVIDENCIA                   ;METROPOLITANA;586942;6;5;1;1;39990;5;4;546952;LED 42 KHFH4221 SMART TV;ELECTRONICA MAYOR
8780984;;M;62;CHILENO;;Boomers;PUCHUNCAVI                    ;VALPARAISO;154473;3;3;0;0;0;3;3;154473;PARLANTE SCREAMER 3;ELECTRONICA MAYOR
19191896;;F;26;CHILENO;;Millenial;N/D;N/D;331440;2;1;0;0;0;2;1;331440;LED 50 CS50S1USM UHD SMART TV NEGRO;ELECTRONICA MAYOR
8053200;;F;65;CHILENO;;Boomers;PADRE LAS CASAS               ;ARAUCANIA;922930;8;6;0;0;0;8;6;922930;MINICOMPONENTE RN5;ELECTRONICA MAYOR
15202561;;F;43;CHILENO;;X;CANETE                        ;BIO BIO;217490;4;1;0;0;0;4;1;217490;LED 40 KEHD4020 SMART TV;ELECTRONICA MAYOR
18335823;;F;30;CHILENO;;Millenial;CERRILLOS                     ;METROPOLITANA;189990;1;1;0;0;0;1;1;189990;LED 43 43S5195 ROKU TV FHD;ELECTRONICA MAYOR
14016353;;F;44;CHILENO;;X;PERALILLO                     ;L.G.B.OÂ´HIGGINS;560950;5;4;0;0;0;5;4;560950;LED 40 KEHD4020 SMART TV;ELECTRONICA MAYOR
15981760;;F;37;CHILENO;;Millenial;ARICA                         ;TARAPACA;244362;3;2;0;0;0;3;2;244362;LED 55 KEUH5521 SMART TV UHD;ELECTRONICA MAYOR
9846071;;F;58;CHILENO;;Boomers;TIRUA                         ;BIO BIO;546340;5;2;0;0;0;5;2;546340;LED 43 UN43T5202AGXZS FHD SMART TV;ELECTRONICA MAYOR
16131338;;F;36;CHILENO;;Millenial;N/D;N/D;109970;3;3;0;0;0;3;3;109970;PARLANTE SENSEIGTH K3175;ELECTRONICA MAYOR
18242366;;M;30;CHILENO;;Millenial;N/D;N/D;113980;2;1;2;1;113980;0;0;0;LED 32 32PHD6825 HD SMART TV;ELECTRONICA MAYOR
13659712;;M;46;CHILENO;;X;SAN ANTONIO                   ;VALPARAISO;35990;1;1;0;0;0;1;1;35990;MLAB KARAOKE 8 CITY SET MICROFONO INALAMBRICO AT;ELECTRONICA MAYOR
19962881;;M;23;CHILENO;;Z;FRUTILLAR                     ;LOS LAGOS;204990;1;1;0;0;0;1;1;204990;PARLANTE ULTRASENSATION;ELECTRONICA MAYOR
10194348;;F;54;CHILENO;;Boomers;CHILE CHICO                   ;AYSEN;394889;3;1;0;0;0;3;1;394889;LED SAMSUNG 43 UN43AU7090GXZS SMART TV UHD 4K;ELECTRONICA MAYOR
16221716;;F;36;CHILENO;;Millenial;PROVIDENCIA                   ;METROPOLITANA;197980;2;1;2;1;197980;0;0;0;LED 42 KHFH4221 SMART TV;ELECTRONICA MAYOR
13979231;;M;41;CHILENO;;X;"";"";349980;2;2;1;1;179990;1;1;169990;LED 32 UN32T4300AGXZS HD SMART TV;ELECTRONICA MAYOR
9308672;Casado;M;59;CHILENO;;Boomers;RENCA                         ;METROPOLITANA;181980;2;1;2;1;181980;0;0;0;MINICOMPONENTE RN7;ELECTRONICA MAYOR
16028699;;M;37;CHILENO;;Millenial;PROVIDENCIA                   ;METROPOLITANA;289970;3;2;3;2;289970;0;0;0;LED 32 32S60-32P ANDROID TV SMART LINE HD;ELECTRONICA MAYOR
10874909;;F;56;CHILENO;;Boomers;PUENTE ALTO                   ;METROPOLITANA;239713;3;2;0;0;0;3;2;239713;PARLANTE ULTRA BOOSTER Z2;ELECTRONICA MAYOR
10376920;;F;57;CHILENO;;Boomers;CERRO NAVIA                   ;METROPOLITANA;44990;1;1;0;0;0;1;1;44990;PARLANTE SPBYF7 PORTATIL;ELECTRONICA MAYOR
15695517;;M;38;CHILENO;;Millenial;PROVIDENCIA                   ;METROPOLITANA;45330;4;1;0;0;0;4;1;45330;PARLANTE SCREAMER 3;ELECTRONICA MAYOR
9294603;;M;59;CHILENO;;Boomers;PROVIDENCIA                   ;METROPOLITANA;152140;2;1;0;0;0;2;1;152140;PARLANTE ULTRAMEGA;ELECTRONICA MAYOR
15011983;;F;38;CHILENO;;Millenial;TOCOPILLA                     ;ANTOFAGASTA;1566930;7;6;0;0;0;7;6;1566930;LED SAMSUNG 65 4K UHD SMART TV AU7090 CRYSTAL;ELECTRONICA MAYOR
5747858;Casado;F;73;CHILENO;;Silencioso;PROVIDENCIA                   ;METROPOLITANA;395650;4;2;0;0;0;4;2;395650;LED LG 50 50UQ7500PSF.AWH UHD TV;ELECTRONICA MAYOR
15551707;Soltero;M;36;CHILENO;;Millenial;N/D;N/D;209990;1;1;1;1;209990;0;0;0;LED 40 UN40T5290AGXZS FHD SMART TV;ELECTRONICA MAYOR
18996675;;M;27;CHILENO;;Z;VINA DEL MAR                  ;VALPARAISO;477160;6;3;0;0;0;6;3;477160;LED 32 AOC ROKU TV HD 32S5195;ELECTRONICA MAYOR
23836607;;F;41;BOLIVIANO;;Extranjero;N/D;N/D;2140921;18;3;0;0;0;18;3;2140921;LED 58 UN58AU7000GXZS UHD 4K SMART TV;ELECTRONICA MAYOR
6621757;;F;73;CHILENO;;Silencioso;SAN ANTONIO                   ;VALPARAISO;1160360;10;5;0;0;0;10;5;1160360;LED SAMSUNG 50 AU7090 CRYSTAL UHD 4K SMART TV 20;ELECTRONICA MAYOR
18214744;;M;30;CHILENO;;Millenial;PROVIDENCIA                   ;METROPOLITANA;32980;2;1;2;1;32980;0;0;0;MAGIC REMOTE MR21G;ELECTRONICA MAYOR
9358147;;F;61;CHILENO;;Boomers;EL TABO                       ;VALPARAISO;464270;6;3;0;0;0;6;3;464270;LED 42 42S6500 ANDROID TV FHD;ELECTRONICA MAYOR
6539105;;F;70;CHILENO;;Silencioso;VALLENAR;ATACAMA;269990;1;1;0;0;0;1;1;269990;LED 50 50P615-50P ANDROID TV PASSION LINE UHD 4K;ELECTRONICA MAYOR
8080790;;M;63;CHILENO;;Boomers;RENCA                         ;METROPOLITANA;350930;2;1;0;0;0;2;1;350930;LED 55 55P615 UHD ANDROID TV 4K;ELECTRONICA MAYOR
17075625;;M;33;CHILENO;;Millenial;SAN ANTONIO                   ;VALPARAISO;309990;1;1;1;1;309990;0;0;0;LED 55 55P615 UHD ANDROID TV 4K;ELECTRONICA MAYOR
12732539;;M;46;CHILENO;;X;ARAUCO                        ;BIO BIO;430990;2;1;0;0;0;2;1;430990;LED 55UP7500 UHD SMART;ELECTRONICA MAYOR
11829806;;M;51;CHILENO;;X;RENCA                         ;METROPOLITANA;296980;2;1;2;1;296980;0;0;0;LED 55 55P615 UHD ANDROID TV 4K;ELECTRONICA MAYOR
17005584;;M;33;CHILENO;;Millenial;PUENTE ALTO;METROPOLITANA;93980;2;1;2;1;93980;0;0;0;LED 32 32PHD6825 HD SMART TV;ELECTRONICA MAYOR
11492219;;M;53;CHILENO;;X;PICHIDEGUA                    ;L.G.B.OÂ´HIGGINS;694920;8;7;0;0;0;8;7;694920;PARLANTE SCREAMER 4;ELECTRONICA MAYOR
25973041;;M;25;HAITIANO;;Extranjero;N/D;N/D;374920;5;3;0;0;0;5;3;374920;PARLANTE SENSEIGTH K3175;ELECTRONICA MAYOR
8845523;;F;64;CHILENO;;Boomers;TALCAHUANO                    ;BIO BIO;389580;6;5;0;0;0;6;5;389580;LED 32 UN32T4300AGXZS HD SMART TV;ELECTRONICA MAYOR
15632619;;M;38;CHILENO;;Millenial;MOLINA                        ;MAULE;99990;1;1;1;1;99990;0;0;0;LED 32 32PHD6825 HD SMART TV;ELECTRONICA MAYOR
18890509;Soltero;M;27;CHILENO;INGENIERO CIVIL INDUSTRIAL;Extranjero;PROVIDENCIA                   ;N/D;299980;2;1;2;1;299980;0;0;0;LED SAMSUNG 50 AU7090 CRYSTAL UHD 4K SMART TV 20;ELECTRONICA MAYOR
17497365;;M;31;CHILENO;;Millenial;VALPARAISO;VALPARAISO;33980;2;1;2;1;33980;0;0;0;PARLANTE SCREAMER 3;ELECTRONICA MAYOR
5187411;;F;77;CHILENO;;Silencioso;N/D;N/D;369980;2;2;0;0;0;2;2;369980;LED LG 32 SMART TV FHD 32LQ630BPSA.AWH;ELECTRONICA MAYOR
11380124;;F;52;CHILENO;;X;FREIRINA                      ;ATACAMA;621040;5;3;1;1;149990;4;2;471050;PARLANTE ULTRA BOOSTER Z2;ELECTRONICA MAYOR
12909235;;M;46;CHILENO;;X;"";"";454541;6;2;0;0;0;6;2;454541;LED 42 42S6500 ANDROID TV FHD;ELECTRONICA MAYOR
10203683;;F;58;CHILENO;;Boomers;N/D;N/D;870320;8;5;0;0;0;8;5;870320;PARLANTE ULTRASENSATION;ELECTRONICA MAYOR
9574494;Casado;F;62;CHILENO;;Boomers;RENCA                         ;METROPOLITANA;202980;2;1;0;0;0;2;1;202980;LED KIOTO 32 MI3228 SMART TV;ELECTRONICA MAYOR
12825670;;F;47;CHILENO;;X;SAN ANTONIO                   ;VALPARAISO;1956040;21;5;0;0;0;21;5;1956040;LED 43 43UP7500 UHD SMART TV;ELECTRONICA MAYOR
9102801;;F;58;CHILENO;;Boomers;LOS ANDES                     ;VALPARAISO;96980;2;2;0;0;0;2;2;96980;PARLANTE SCREAMER 4;ELECTRONICA MAYOR
16243304;;M;36;CHILENO;;Millenial;CALAMA                        ;ANTOFAGASTA;461960;4;3;0;0;0;4;3;461960;PARLANTE KARAOKE 12 FM/BT/USB;ELECTRONICA MAYOR
17713627;Soltero;F;31;CHILENO;;Extranjero;PROVIDENCIA                   ;N/D;211970;3;1;3;1;211970;0;0;0;LED 32 32PHD6825 HD SMART TV;ELECTRONICA MAYOR
7384042;;M;65;CHILENO;;Boomers;COLINA                        ;METROPOLITANA;372980;2;1;0;0;0;2;1;372980;LED 50 50UP7500 UHD SMART TV;ELECTRONICA MAYOR
17205447;;F;33;CHILENO;;Millenial;N/D;N/D;1300840;16;9;0;0;0;16;9;1300840;LED 55 55P615 UHD ANDROID TV 4K;ELECTRONICA MAYOR
16858300;;F;34;CHILENO;;Extranjero;CURICO                        ;MAULE;1096980;2;1;2;1;1096980;0;0;0;LED SAMSUNG 85 BU8000 CRYSTAL UHD 4K SMART TV;ELECTRONICA MAYOR
16372496;;M;36;CHILENO;;Millenial;COLINA                        ;METROPOLITANA;0;0;2;0;0;0;0;2;0;KARAOKE STREET SONG 4 MICÂ CABLEÂ BLACK 8900;ELECTRONICA MAYOR
13680734;;M;43;CHILENO;;Millenial;SAN MIGUEL                    ;METROPOLITANA;264990;1;1;0;0;0;1;1;264990;LED 50 KEUH50 SMART TV UHD;ELECTRONICA MAYOR
25805173;;M;35;VENEZOLANO;;Extranjero;N/D;N/D;855330;3;1;0;0;0;3;1;855330;LED NanoCell 55NANO80 UHD SMART + MAGIC;ELECTRONICA MAYOR
16649296;;M;35;CHILENO;;Millenial;LOS ALAMOS                    ;BIO BIO;330940;6;6;0;0;0;6;6;330940;MINICOMPONENTE RN7;ELECTRONICA MAYOR
10750482;;M;54;CHILENO;;Boomers;RENCA                         ;METROPOLITANA;401540;2;1;0;0;0;2;1;401540;LED SAMSUNG 50 AU7090 CRYSTAL UHD 4K SMART TV 20;ELECTRONICA MAYOR
16068530;;M;37;CHILENO;;Millenial;SAN MIGUEL                    ;METROPOLITANA;184990;1;1;0;0;0;1;1;184990;LED 42 KHFH4221 SMART TV;ELECTRONICA MAYOR
13516320;;M;44;CHILENO;;X;PROVIDENCIA                   ;METROPOLITANA;199990;1;1;0;0;0;1;1;199990;LED 42 KHFH4221 SMART TV;ELECTRONICA MAYOR
8637028;Casado;M;59;CHILENO;;Boomers;RENCA                         ;METROPOLITANA;259990;1;1;0;0;0;1;1;259990;LED 43 43LM6370 SMART TV FHD;ELECTRONICA MAYOR
9411214;;F;61;CHILENO;;Boomers;SAN PEDRO DE LA PAZ           ;BIO BIO;330930;2;1;0;0;0;2;1;330930;LED 43 43UP7500 UHD SMART TV;ELECTRONICA MAYOR
5821505;Soltero;F;71;CHILENO;;Silencioso;RENCA                         ;METROPOLITANA;84390;2;1;0;0;0;2;1;84390;PARLANTE SCREAMER 4;ELECTRONICA MAYOR
16110916;;M;36;CHILENO;;Millenial;N/D;N/D;289990;1;1;0;0;0;1;1;289990;LED 55 55P615 UHD ANDROID TV 4K;ELECTRONICA MAYOR
8655220;;M;62;CHILENO;;Boomers;ERCILLA                       ;ARAUCANIA;146980;2;1;0;0;0;2;1;146980;LED KIOTO 32 MI3228 SMART TV;ELECTRONICA MAYOR
6124369;;F;76;CHILENO;;Silencioso;PUDAHUEL                      ;METROPOLITANA;299990;1;1;0;0;0;1;1;299990;LED SAMSUNG 50 AU7090 CRYSTAL UHD 4K SMART TV 20;ELECTRONICA MAYOR
26901856;;M;42;EXTRANJERO - NO INFORMA NACIONALIDAD;;Extranjero;"";"";103980;2;1;2;1;103980;0;0;0;LED 32 32PHD6825 HD SMART TV;ELECTRONICA MAYOR
13707070;;M;42;CHILENO;;X;LA PINTANA                    ;METROPOLITANA;309980;2;1;2;1;309980;0;0;0;LED 55 55P615 UHD ANDROID TV 4K;ELECTRONICA MAYOR
15975998;;F;37;CHILENO;;Millenial;CHIGUAYANTE;BIO-BIO;149990;1;1;1;1;149990;0;0;0;LED 42 42S6500 ANDROID TV FHD;ELECTRONICA MAYOR
12744149;;F;47;CHILENO;;X;VILLARICA                     ;ARAUCANIA;389980;2;2;0;0;0;2;2;389980;LED 42 KHFH4221 SMART TV;ELECTRONICA MAYOR
10506720;;M;56;CHILENO;;Boomers;VILLARICA                     ;ARAUCANIA;319980;2;2;0;0;0;2;2;319980;LED 32 AOC ROKU TV HD 32S5195;ELECTRONICA MAYOR
26575407;;M;42;VENEZOLANO;;Extranjero;SANTIAGO                      ;METROPOLITANA;269450;5;3;2;1;38980;3;2;230470;PARLANTE MGULTRAEXTREME;ELECTRONICA MAYOR
11682621;;F;52;CHILENO;;X;CORONEL                       ;BIO BIO;393920;3;2;0;0;0;3;2;393920;LED 50 50P615-50P ANDROID TV PASSION LINE UHD 4K;ELECTRONICA MAYOR
18384663;;M;29;CHILENO;;Millenial;CALLE LARGA                   ;VALPARAISO;249990;1;1;1;1;249990;0;0;0;LED 55 KEUH5521 SMART TV UHD;ELECTRONICA MAYOR
16327261;;M;36;CHILENO;;Millenial;TALCAHUANO                    ;BIO BIO;127980;2;1;2;1;127980;0;0;0;BARRA DE SONIDO HT-S350;ELECTRONICA MAYOR
17538859;;F;32;CHILENO;;Millenial;PUERTO MONTT;LOS LAGOS;416980;4;2;1;1;279990;3;1;136990;LED 40 KEHD4020 SMART TV;ELECTRONICA MAYOR
11839268;;M;50;CHILENO;;X;PUENTE ALTO                   ;METROPOLITANA;74090;2;1;0;0;0;2;1;74090;PARLANTE KARAOKE 12 FM/BT/USB;ELECTRONICA MAYOR
25606056;;F;33;COLOMBIANO;;Extranjero;NATALES                       ;MAGALLANES;504960;4;3;0;0;0;4;3;504960;LED 43 43S5195 ROKU TV FHD;ELECTRONICA MAYOR
15579428;;F;38;CHILENO;;Millenial;VILLARICA                     ;ARAUCANIA;176980;2;1;0;0;0;2;1;176980;LED 50 KEUH50 SMART TV UHD;ELECTRONICA MAYOR
26509184;Soltero;M;30;EXTRANJERO - NO INFORMA NACIONALIDAD;;Extranjero;PROVIDENCIA                   ;METROPOLITANA;30980;2;1;2;1;30980;0;0;0;MAGIC REMOTE MR21G;ELECTRONICA MAYOR
24711797;;M;22;COLOMBIANO;;Extranjero;PROVIDENCIA                   ;METROPOLITANA;179980;2;1;2;1;179980;0;0;0;LED 50 KEUH50 SMART TV UHD;ELECTRONICA MAYOR
19960404;;M;23;CHILENO;;Z;"";"";169990;1;1;1;1;169990;0;0;0;LED 50 KEUH50 SMART TV UHD;ELECTRONICA MAYOR
8222028;;F;66;CHILENO;;Boomers;ARICA                         ;TARAPACA;2039080;16;5;0;0;0;16;5;2039080;LED 65 KEUH6521 SMART TV UHD;ELECTRONICA MAYOR
5953033;;M;78;CHILENO;;Silencioso;TALCA                         ;MAULE;159992;1;2;0;0;0;1;2;159992;LED 32 32S60-32P ANDROID TV SMART LINE HD;ELECTRONICA MAYOR
17989351;;M;30;CHILENO;;Millenial;PROVIDENCIA                   ;METROPOLITANA;189990;1;1;1;1;189990;0;0;0;LED 55 KEUH5521 SMART TV UHD;ELECTRONICA MAYOR
10771937;;F;54;CHILENO;;Boomers;LAS CABRAS                    ;L.G.B.OÂ´HIGGINS;1674532;10;5;4;2;1123520;6;3;551012;LED 43 UN43T5202AGXZS FHD SMART TV;ELECTRONICA MAYOR
12699473;;F;48;CHILENO;;X;PROVIDENCIA                   ;METROPOLITANA;259980;2;1;2;1;259980;0;0;0;LED 58 KEUH5821 SMART TV UHD;ELECTRONICA MAYOR
8237206;;F;62;CHILENO;;Boomers;LAMPA                         ;METROPOLITANA;311150;4;1;0;0;0;4;1;311150;LED 55 KEUH5521 SMART TV UHD;ELECTRONICA MAYOR
17146960;;M;33;CHILENO;;Millenial;N/D;N/D;191970;3;2;0;0;0;3;2;191970;LED 42 KHFH4221 SMART TV;ELECTRONICA MAYOR
13644665;;F;43;CHILENO;;X;NUNOA                         ;METROPOLITANA;208980;2;1;0;0;0;2;1;208980;LED 43 43S5195 ROKU TV FHD;ELECTRONICA MAYOR
18230886;;F;30;CHILENO;;Millenial;TOCOPILLA                     ;ANTOFAGASTA;148970;3;3;0;0;0;3;3;148970;PARLANTE SCREAMER 5;ELECTRONICA MAYOR
11930418;;M;49;CHILENO;;X;N/D;N/D;229980;2;2;1;1;109990;1;1;119990;LED 32 32S5305 HD HDR10/HLG;ELECTRONICA MAYOR
11271465;;F;54;CHILENO;;X;N/D;N/D;569960;4;2;0;0;0;4;2;569960;LED 40 40S65A-40P ANDROID TV SMART LINE FHD;ELECTRONICA MAYOR
7971084;;M;62;CHILENO;;Boomers;ANTOFAGASTA                   ;ANTOFAGASTA;253410;6;3;0;0;0;6;3;253410;LED KIOTO 32 MI3228 SMART TV;ELECTRONICA MAYOR
8396868;;F;68;CHILENO;;Boomers;"";"";779950;5;4;0;0;0;5;4;779950;LED 50 50NANO75 NanoCell UHD SMART + MAGIC;ELECTRONICA MAYOR
6590498;;F;69;CHILENO;;Silencioso;CERRO NAVIA                   ;METROPOLITANA;680700;9;3;0;0;0;9;3;680700;LED 32 UN32T4300AGXZS HD SMART TV;ELECTRONICA MAYOR
9185455;;F;58;CHILENO;;Boomers;SAN FELIPE                    ;VALPARAISO;493680;3;2;0;0;0;3;2;493680;LED 55UP7500 UHD SMART;ELECTRONICA MAYOR
25535499;;F;25;PERUANO;;Extranjero;ARICA                         ;ARICA Y PARINACOTA;310300;2;1;0;0;0;2;1;310300;LED 43 43UP7500 UHD SMART TV;ELECTRONICA MAYOR
17370993;;M;32;CHILENO;;Millenial;N/D;N/D;268330;3;1;0;0;0;3;1;268330;LED 40 KEHD4020 SMART TV;ELECTRONICA MAYOR
16828083;;F;34;CHILENO;;Millenial;PERALILLO;O HIGGINS;237170;3;1;0;0;0;3;1;237170;LED 55 KEUH5521 SMART TV UHD;ELECTRONICA MAYOR
10864498;Casado;M;51;CHILENO;TECNICO;X;RENCA                         ;METROPOLITANA;279990;1;1;1;1;279990;0;0;0;LED 55 55P615 UHD ANDROID TV 4K;ELECTRONICA MAYOR
9688071;;F;43;CHILENO;;X;NATALES                       ;MAGALLANES;388980;2;2;0;0;0;2;2;388980;LED SAMSUNG 55 4K UHD SMART TV UN55AU7090GXZS;ELECTRONICA MAYOR
18176891;;M;29;CHILENO;;Millenial;LOS ANGELES;BIO-BIO;497220;5;2;0;0;0;5;2;497220;LED 58 KEUH5821 SMART TV UHD;ELECTRONICA MAYOR
19969991;;F;23;CHILENO;;Z;ANTOFAGASTA;ANTOFAGASTA;199990;1;1;0;0;0;1;1;199990;LED 58 KEUH5821 SMART TV UHD;ELECTRONICA MAYOR
7416113;;M;64;CHILENO;;Boomers;MAIPU                         ;METROPOLITANA;799960;4;2;0;0;0;4;2;799960;LED SAMSUNG 55 4K UHD SMART TV UN55AU7090GXZS;ELECTRONICA MAYOR
17080325;;M;33;CHILENO;;Millenial;"";"";473540;4;3;1;1;34990;3;2;438550;PARLANTE SCREAMER 3;ELECTRONICA MAYOR
15983964;;M;37;CHILENO;;Millenial;"";"";156980;2;2;0;0;0;2;2;156980;LED 32 32S5295 SMART TV HD;ELECTRONICA MAYOR
10225185;;M;56;CHILENO;;Boomers;LA GRANJA                     ;METROPOLITANA;349990;1;1;1;1;349990;0;0;0;LED SAMSUNG 55 4K UHD SMART TV UN55AU7090GXZS;ELECTRONICA MAYOR
12678437;;M;47;CHILENO;;X;COLBUN;MAULE;205960;4;3;4;3;205960;0;0;0;LED 40 KEHD4020 SMART TV;ELECTRONICA MAYOR
8422351;;F;62;CHILENO;;Boomers;AISEN                         ;AYSEN;962590;41;2;0;0;0;41;2;962590;LED KIOTO 32 MI3228 SMART TV;ELECTRONICA MAYOR
9426486;;M;60;CHILENO;;Boomers;LONGAVI                       ;MAULE;735929;8;5;0;0;0;8;5;735929;LED 40 KEHD4020 SMART TV;ELECTRONICA MAYOR
11585236;;M;52;CHILENO;;X;NUEVA IMPERIAL                ;ARAUCANIA;408110;3;2;0;0;0;3;2;408110;LED 58 KEUH5821 SMART TV UHD;ELECTRONICA MAYOR
15631308;;M;38;CHILENO;;Millenial;COPIAPO                       ;ATACAMA;321970;3;2;0;0;0;3;2;321970;LED 65 KEUH6521 SMART TV UHD;ELECTRONICA MAYOR
25799257;Soltero;M;30;HAITIANO;;Extranjero;PAINE                         ;METROPOLITANA;347550;3;2;0;0;0;3;2;347550;MLAB KARAOKE DISCO VIBRANIUM 9106;ELECTRONICA MAYOR
12019760;;F;54;CHILENO;;X;LINARES                       ;MAULE;639970;4;5;0;0;0;4;5;639970;LED 58 KEUH5821 SMART TV UHD;ELECTRONICA MAYOR
17554432;;M;30;CHILENO;;Millenial;ARICA                         ;ARICA Y PARINACOTA;189990;1;1;1;1;189990;0;0;0;LED 43 UN43T5202AGXZS FHD SMART TV;ELECTRONICA MAYOR
15678715;;F;38;CHILENO;;X;ANTOFAGASTA;ANTOFAGASTA;299980;2;2;2;2;299980;0;0;0;LED 40 KEHD4020 SMART TV;ELECTRONICA MAYOR
8190178;;M;69;CHILENO;;Silencioso;CURARREHUE                    ;ARAUCANIA;234980;2;2;0;0;0;2;2;234980;MINICOMPONENTE OL45;ELECTRONICA MAYOR
18016360;;F;30;CHILENO;;Millenial;N/D;N/D;736266;29;35;0;0;0;29;35;736266;PARLANTE MEGALUX K2777;ELECTRONICA MAYOR
9599232;;M;59;CHILENO;;Boomers;ARICA                         ;ARICA Y PARINACOTA;222970;3;1;0;0;0;3;1;222970;LED 55 KEUH5521 SMART TV UHD;ELECTRONICA MAYOR
5412607;;M;76;CHILENO;;Silencioso;NATALES                       ;MAGALLANES;486420;4;2;0;0;0;4;2;486420;LED 55 KEUH5521 SMART TV UHD;ELECTRONICA MAYOR
7711540;;F;68;CHILENO;;Silencioso;CASTRO                        ;LOS LAGOS;1561410;9;7;1;1;179990;8;6;1381420;LED 32 UN32T4300AGXZS HD SMART TV;ELECTRONICA MAYOR
13936147;;M;42;CHILENO;;X;LA PINTANA                    ;METROPOLITANA;309470;2;1;0;0;0;2;1;309470;LED 43 43UP7500 UHD SMART TV;ELECTRONICA MAYOR
18348044;;F;29;CHILENO;;Millenial;CASTRO                        ;LOS LAGOS;236960;4;2;0;0;0;4;2;236960;LED 43 UN43T5202AGXZS FHD SMART TV;ELECTRONICA MAYOR
16386535;;M;35;CHILENO;;Millenial;TEMUCO                        ;ARAUCANIA;34990;1;1;0;0;0;1;1;34990;KARAOKE FUNKY DISCO;ELECTRONICA MAYOR
8755358;;F;61;CHILENO;;Boomers;PROVIDENCIA                   ;METROPOLITANA;733960;5;2;0;0;0;5;2;733960;LED KIOTO 32 MI3228 SMART TV;ELECTRONICA MAYOR
15537263;;F;39;CHILENO;;X;"";"";941930;7;4;0;0;0;7;4;941930;LED 50 50P615-50P ANDROID TV PASSION LINE UHD 4K;ELECTRONICA MAYOR
19942442;;F;23;CHILENO;;Z;CASTRO                        ;LOS LAGOS;139990;1;1;1;1;139990;0;0;0;LED 32 32PHD6825 HD SMART TV;ELECTRONICA MAYOR
15289828;;F;40;CHILENO;;X;CASTRO                        ;LOS LAGOS;329470;2;1;0;0;0;2;1;329470;LED 58 KEUH5821 SMART TV UHD;ELECTRONICA MAYOR
15917341;;M;37;CHILENO;;Millenial;LA CISTERNA                   ;METROPOLITANA;144980;2;2;0;0;0;2;2;144980;PARLANTE ULTRAMEGA;ELECTRONICA MAYOR
8751499;;F;65;CHILENO;;Boomers;VALDIVIA                      ;LOS LAGOS;349980;2;2;0;0;0;2;2;349980;LED 55 KEUH5521 SMART TV UHD;ELECTRONICA MAYOR
19238804;Soltero;M;26;CHILENO;;Z;PROVIDENCIA                   ;METROPOLITANA;293980;2;1;2;1;293980;0;0;0;QLED FRAME 32 QN32LS03TBGXZS FHD SMART TV;ELECTRONICA MAYOR
13199533;;F;46;CHILENO;;X;SAN FELIPE                    ;VALPARAISO;591260;5;5;2;1;128980;3;4;462280;LED 40 KEHD4020 SMART TV;ELECTRONICA MAYOR
18580985;;F;28;CHILENO;;Millenial;N/D;N/D;540390;2;1;0;0;0;2;1;540390;LED 55 NanoCell 55NANO75 UHD SMART + MAGIC;ELECTRONICA MAYOR
12894284;;F;47;CHILENO;;X;PUENTE ALTO                   ;METROPOLITANA;176060;2;1;0;0;0;2;1;176060;PARLANTE ULTRAFORCE-I;ELECTRONICA MAYOR
11218614;;M;54;CHILENO;;Boomers;NATALES                       ;MAGALLANES;169990;1;1;0;0;0;1;1;169990;LED 50 KEUH50 SMART TV UHD;ELECTRONICA MAYOR
9249024;;M;60;CHILENO;;Boomers;ARICA                         ;ARICA Y PARINACOTA;281110;2;1;0;0;0;2;1;281110;LED 40 UN40T5290AGXZS FHD SMART TV;ELECTRONICA MAYOR
19117694;;F;26;CHILENO;;Z;SAN BERNARDO                  ;METROPOLITANA;115960;4;2;4;2;115960;0;0;0;PARLANTE MGVIPER;ELECTRONICA MAYOR
8188900;;F;65;CHILENO;;Boomers;OVALLE                        ;COQUIMBO;709722;9;5;0;0;0;9;5;709722;PARLANTE ULTRAMEGA;ELECTRONICA MAYOR
19117318;;M;26;CHILENO;;Z;HUASCO                        ;ATACAMA;383760;3;1;3;1;383760;0;0;0;LED 65 KEUH6521 SMART TV UHD;ELECTRONICA MAYOR
11816080;;M;51;CHILENO;;X;IQUIQUE                       ;TARAPACA;312510;5;2;5;2;312510;0;0;0;BARRA DE SONIDO HT-S350;ELECTRONICA MAYOR
14193009;;F;41;CHILENO;;X;LA UNION                      ;LOS RIOS;372520;4;2;4;2;372520;0;0;0;LED 43 UN43T5202AGXZS FHD SMART TV;ELECTRONICA MAYOR
16618151;;M;34;CHILENO;;Millenial;LO PRADO;METROPOLITANA;153980;2;1;2;1;153980;0;0;0;LED 40 KEHD4020 SMART TV;ELECTRONICA MAYOR
15893866;;M;37;CHILENO;;Millenial;N/D;N/D;234970;3;2;2;1;189980;1;1;44990;PARLANTE KARAOKE PINGUINO PORTATIL NEGRO;ELECTRONICA MAYOR
10850152;;F;56;CHILENO;;Boomers;QUEMCHI                       ;LOS LAGOS;534080;5;3;0;0;0;5;3;534080;LED 43 UN43T5202AGXZS FHD SMART TV;ELECTRONICA MAYOR
16621570;Soltero;M;34;CHILENO;FONOAUDIOLOGO;Z;PROVIDENCIA                   ;METROPOLITANA;133980;2;1;2;1;133980;0;0;0;BARRA DE SONIDO HT-S350;ELECTRONICA MAYOR
13606875;;F;44;CHILENO;;X;NUEVA IMPERIAL                ;ARAUCANIA;279980;2;2;0;0;0;2;2;279980;PARLANTE ULTRAMAGIC;ELECTRONICA MAYOR
18058925;;M;30;CHILENO;;Millenial;LA PINTANA                    ;METROPOLITANA;537810;2;1;0;0;0;2;1;537810;LED 50 NanoCell 50NANO80 UHD SMART + MAGIC;ELECTRONICA MAYOR
25418097;Soltero;M;58;COLOMBIANO;;Extranjero;NATALES                       ;MAGALLANES;129990;1;1;0;0;0;1;1;129990;PARLANTE ULTRAMAGIC;ELECTRONICA MAYOR
18526211;Soltero;F;28;CHILENO;ENFERMERA;Millenial;PROVIDENCIA                   ;METROPOLITANA;269990;1;1;0;0;0;1;1;269990;LED 43 43UP7500 UHD SMART TV;ELECTRONICA MAYOR
8987512;Soltero;M;61;CHILENO;;Boomers;RENCA                         ;METROPOLITANA;209960;4;2;0;0;0;4;2;209960;LED 32 32S5305 HD HDR10/HLG;ELECTRONICA MAYOR
16986813;;F;33;CHILENO;;Millenial;PEDRO AGUIRRE CERDA;METROPOLITANA;123980;2;1;2;1;123980;0;0;0;LED 40 KEHD4020 SMART TV;ELECTRONICA MAYOR
18190801;;M;29;CHILENO;;Millenial;PROVIDENCIA                   ;METROPOLITANA;173980;2;1;2;1;173980;0;0;0;LED 32 32LM33765 ANDROID SMART TV UHD;ELECTRONICA MAYOR
6580285;;M;69;CHILENO;;Silencioso;LA LIGUA                      ;VALPARAISO;494960;4;2;0;0;0;4;2;494960;LED 40 KEHD4020 SMART TV;ELECTRONICA MAYOR
11663809;;M;52;CHILENO;;X;RENCA                         ;METROPOLITANA;172960;3;1;3;1;172960;0;0;0;MINICOMPONENTE CJ45;ELECTRONICA MAYOR
10276347;;M;57;CHILENO;;Boomers;PICHIDEGUA                    ;L.G.B.OÂ´HIGGINS;696740;5;3;0;0;0;5;3;696740;LED 50 UN50TU7090GXZS UHD SMART TV;ELECTRONICA MAYOR
9632621;;F;63;CHILENO;;Boomers;NATALES                       ;MAGALLANES;814960;4;4;0;0;0;4;4;814960;LED NanoCell 55NANO80 UHD SMART + MAGIC;ELECTRONICA MAYOR
10760092;;M;56;CHILENO;;Boomers;EL BOSQUE                     ;METROPOLITANA;1246150;15;6;0;0;0;15;6;1246150;LED 42 KHFH4221 SMART TV;ELECTRONICA MAYOR
10077901;;F;58;CHILENO;;Boomers;COLINA                        ;METROPOLITANA;1323850;11;4;0;0;0;11;4;1323850;LED 65 KEUH6521 SMART TV UHD;ELECTRONICA MAYOR
17791606;;F;31;CHILENO;;Millenial;N/D;N/D;206980;2;1;2;1;206980;0;0;0;LED 55 KEUH5521 SMART TV UHD;ELECTRONICA MAYOR
10710054;;F;54;CHILENO;;X;MOSTAZAL                      ;L.G.B.OÂ´HIGGINS;920110;8;6;0;0;0;8;6;920110;LED 40 40S65A-40P ANDROID TV SMART LINE FHD;ELECTRONICA MAYOR
17555317;;F;30;CHILENO;;Millenial;ARICA                         ;ARICA Y PARINACOTA;442550;4;2;4;2;442550;0;0;0;LED 43 UN43T5202AGXZS FHD SMART TV;ELECTRONICA MAYOR
19119966;;F;27;CHILENO;;Z;LEBU                          ;BIO BIO;214290;4;2;0;0;0;4;2;214290;LED KIOTO 32 MI3228 SMART TV;ELECTRONICA MAYOR
4354729;;M;81;CHILENO;;Silencioso;LOS SAUCES                    ;ARAUCANIA;129990;1;1;0;0;0;1;1;129990;LED KIOTO 32 MI3228 SMART TV;ELECTRONICA MAYOR
8287707;;M;64;CHILENO;;Boomers;LOS ANGELES                   ;BIO BIO;749861;6;6;0;0;0;6;6;749861;LED 43 UN43T5202AGXZS FHD SMART TV;ELECTRONICA MAYOR
17750904;;M;31;CHILENO;;Millenial;CANETE                        ;BIO BIO;492930;7;6;1;1;99990;6;5;392940;LED KIOTO 32 MI3228 SMART TV;ELECTRONICA MAYOR
6115728;;F;71;CHILENO;;Silencioso;ARICA                         ;TARAPACA;319990;1;1;0;0;0;1;1;319990;LED 50 50UP7500 UHD SMART TV;ELECTRONICA MAYOR
11934173;;M;50;CHILENO;;X;VALLENAR;ATACAMA;339470;2;1;0;0;0;2;1;339470;LED 50 50P615-50P ANDROID TV PASSION LINE UHD 4K;ELECTRONICA MAYOR
12718403;;F;47;CHILENO;;X;ILLAPEL                       ;COQUIMBO;1009750;4;3;0;0;0;4;3;1009750;LED 55 55P615 UHD ANDROID TV 4K;ELECTRONICA MAYOR
15204953;;F;40;CHILENO;;X;LOS ANGELES;BIO-BIO;420590;11;2;0;0;0;11;2;420590;LED 50 KEUH50 SMART TV UHD;ELECTRONICA MAYOR
9783937;;F;58;CHILENO;;Boomers;CAUQUENES                     ;MAULE;234960;4;3;0;0;0;4;3;234960;LED 55 KEUH5521 SMART TV UHD;ELECTRONICA MAYOR
16225844;;F;37;CHILENO;;Millenial;PROVIDENCIA                   ;METROPOLITANA;568590;7;3;0;0;0;7;3;568590;LED KIOTO 32 MI3228 SMART TV;ELECTRONICA MAYOR
6973440;;F;62;CHILENO;;Boomers;PROVIDENCIA                   ;METROPOLITANA;133980;2;1;2;1;133980;0;0;0;MINICOMPONENTE OL45;ELECTRONICA MAYOR
15813394;;M;38;CHILENO;;Millenial;CALAMA;ANTOFAGASTA;139990;1;1;1;1;139990;0;0;0;LED 40 KEHD4020 SMART TV;ELECTRONICA MAYOR
19334869;;F;34;CHILENO;;Millenial;SAN PEDRO DE LA PAZ;BIO-BIO;270390;2;1;0;0;0;2;1;270390;MINICOMPONENTE RN7;ELECTRONICA MAYOR
12591247;Soltero;M;48;CHILENO;;X;RENCA                         ;METROPOLITANA;24990;1;1;0;0;0;1;1;24990;PARLANTE MG TWISTER;ELECTRONICA MAYOR
16428318;;F;35;CHILENO;;Millenial;RECOLETA                      ;METROPOLITANA;782600;9;4;0;0;0;9;4;782600;LED 65 KEUH6521 SMART TV UHD;ELECTRONICA MAYOR
9260902;;F;57;CHILENO;;Boomers;VILLARICA                     ;ARAUCANIA;249980;2;2;0;0;0;2;2;249980;MINICOMPONENTE OL45;ELECTRONICA MAYOR
14329701;;F;45;CHILENO;;X;RANCAGUA                      ;L.G.B.OÂ´HIGGINS;979950;5;3;0;0;0;5;3;979950;MINICOMPONENTE MX-T70/ZS ALL IN ONE;ELECTRONICA MAYOR
9327417;;F;61;CHILENO;;Boomers;FUTRONO                       ;LOS LAGOS;842580;7;3;0;0;0;7;3;842580;LED 58 58PUD7625 BORDES ULTRA DELGADOS 4K UHD;ELECTRONICA MAYOR
16177076;;M;36;CHILENO;;Millenial;RIO IBANEZ;AYSEN;226800;2;1;0;0;0;2;1;226800;PARLANTE MGULTRAEXTREME;ELECTRONICA MAYOR
9274367;;F;57;CHILENO;;Boomers;ANCUD                         ;LOS LAGOS;265960;4;2;0;0;0;4;2;265960;LED 32 32PHD6825 HD SMART TV;ELECTRONICA MAYOR
10208820;;F;54;CHILENO;;Boomers;ARICA                         ;ARICA Y PARINACOTA;221580;4;2;0;0;0;4;2;221580;PARLANTE ULTRAFORCE-I;ELECTRONICA MAYOR
19388484;;F;25;CHILENO;;Z;PROVIDENCIA                   ;METROPOLITANA;349990;1;1;0;0;0;1;1;349990;LED 58 58PUD7625 BORDES ULTRA DELGADOS 4K UHD;ELECTRONICA MAYOR
19130034;;F;27;CHILENO;;Z;SANTA MARIA                   ;VALPARAISO;184760;2;1;0;0;0;2;1;184760;PARLANTE ULTRAFORCE-I;ELECTRONICA MAYOR
15995274;;M;37;CHILENO;;Millenial;N/D;N/D;558540;3;2;3;2;558540;0;0;0;MINICOMPONENTE MX-T40/ZS ALL IN ONE;ELECTRONICA MAYOR
11921997;;F;50;CHILENO;;X;TEMUCO                        ;ARAUCANIA;258960;4;3;0;0;0;4;3;258960;SOUNDBAR XTS-801 Negro 40W;ELECTRONICA MAYOR
7083115;;F;64;CHILENO;;Boomers;VILLARICA                     ;ARAUCANIA;589270;5;2;0;0;0;5;2;589270;LED 43 UN43T5202AGXZS FHD SMART TV;ELECTRONICA MAYOR
6476851;;F;71;CHILENO;;Silencioso;PUNTA ARENAS                  ;MAGALLANES;789940;6;4;0;0;0;6;4;789940;MINICOMPONENTE CJ45;ELECTRONICA MAYOR
6998818;;M;62;CHILENO;;Boomers;CASTRO                        ;LOS LAGOS;549990;1;1;0;0;0;1;1;549990;LED NanoCell 55NANO80 UHD SMART + MAGIC;ELECTRONICA MAYOR
9011326;;M;62;CHILENO;;Boomers;N/D;N/D;129990;1;1;0;0;0;1;1;129990;PARLANTE ULTRAMEGA;ELECTRONICA MAYOR
9443196;;F;66;CHILENO;;Boomers;EL TABO                       ;VALPARAISO;319980;2;2;0;0;0;2;2;319980;PARLANTE MGULTRAEXTREME;ELECTRONICA MAYOR
5217263;;M;76;CHILENO;;Silencioso;LA PINTANA                    ;METROPOLITANA;428180;2;1;0;0;0;2;1;428180;LED 55UP7500 UHD SMART;ELECTRONICA MAYOR
11240356;;F;54;CHILENO;;X;"";"";119990;1;1;0;0;0;1;1;119990;PARLANTE ULTRAMEGA;ELECTRONICA MAYOR
5527543;;F;72;CHILENO;;Silencioso;CARTAGENA                     ;VALPARAISO;124990;1;1;0;0;0;1;1;124990;LED 40 KEHD4020 SMART TV;ELECTRONICA MAYOR
12160058;;M;68;CHILENO;;Boomers;ARICA                         ;ARICA Y PARINACOTA;1205250;6;3;0;0;0;6;3;1205250;LED NanoCell 55NANO80 UHD SMART + MAGIC;ELECTRONICA MAYOR
10676052;;M;55;CHILENO;;Boomers;COLLIPULLI                    ;ARAUCANIA;348950;5;4;0;0;0;5;4;348950;MINICOMPONENTE MHC-V02 ALL IN ONE;ELECTRONICA MAYOR
19424029;;M;25;CHILENO;;Z;N/D;N/D;210980;2;2;0;0;0;2;2;210980;LED 43 UN43T5202AGXZS FHD SMART TV;ELECTRONICA MAYOR
5094725;;M;79;CHILENO;;Silencioso;CAUQUENES                     ;MAULE;99990;1;1;0;0;0;1;1;99990;LED KIOTO 32 MI3228 SMART TV;ELECTRONICA MAYOR
9844815;;F;59;CHILENO;;Boomers;COBQUECURA                    ;BIO BIO;305970;3;2;0;0;0;3;2;305970;LED 43 43UP7500 UHD SMART TV;ELECTRONICA MAYOR
16393548;;F;35;CHILENO;;Millenial;PUDAHUEL                      ;METROPOLITANA;192980;2;1;2;1;192980;0;0;0;LED 43 UN43T5202AGXZS FHD SMART TV;ELECTRONICA MAYOR
13368590;;F;44;CHILENO;;X;MOLINA                        ;MAULE;227752;3;2;0;0;0;3;2;227752;MINICOMPONENTE RN5;ELECTRONICA MAYOR
7057607;;F;65;CHILENO;;Boomers;FREIRINA                      ;ATACAMA;304980;2;1;0;0;0;2;1;304980;LED 43 UN43TU7090GXZS UHD SMART TV;ELECTRONICA MAYOR
11296343;;F;54;CHILENO;;X;DONIHUE                       ;L.G.B.OÂ´HIGGINS;752430;9;4;0;0;0;9;4;752430;LED 32 32S5305 HD HDR10/HLG;ELECTRONICA MAYOR
10189397;;M;54;CHILENO;;X;"";"";379980;4;2;0;0;0;4;2;379980;LED 42 KHFH4221 SMART TV;ELECTRONICA MAYOR
18346118;;M;29;CHILENO;;Millenial;PROVIDENCIA                   ;METROPOLITANA;316970;3;1;0;0;0;3;1;316970;LED 43 43LM6370 SMART TV FHD;ELECTRONICA MAYOR
9985033;;M;58;CHILENO;;Boomers;RENCA                         ;METROPOLITANA;299990;1;1;0;0;0;1;1;299990;LED 55 KEUH5521 SMART TV UHD;ELECTRONICA MAYOR
17032972;Soltero;M;33;CHILENO;INTERPRETE DE IDIOMAS;Millenial;SAN MIGUEL                    ;METROPOLITANA;1503970;5;1;5;1;1503970;0;0;0;QLED 50 QN50Q60AAGXZS 4K UHD SMART TV;ELECTRONICA MAYOR
18506213;;M;30;CHILENO;;Millenial;TALCA                         ;MAULE;79990;1;1;0;0;0;1;1;79990;KARAOKE SP-101BT ALL IN ONE PORTATIL 60W;ELECTRONICA MAYOR
15548140;;M;39;CHILENO;;X;VALDIVIA                      ;LOS RIOS;427960;4;1;0;0;0;4;1;427960;LED 58 58PUD7625 BORDES ULTRA DELGADOS 4K UHD;ELECTRONICA MAYOR
15868680;;F;37;CHILENO;;Millenial;ANGOL                         ;ARAUCANIA;239980;2;4;0;0;0;2;4;239980;LED 40 UN40T5290AGXZS FHD SMART TV;ELECTRONICA MAYOR
18321305;;M;29;CHILENO;;Millenial;N/D;N/D;169980;3;3;0;0;0;3;3;169980;2a ELECTRONICA MAYOR;ELECTRONICA MAYOR
25772890;;M;35;HAITIANO;;Extranjero;RENGO                         ;L.G.B.OÂ´HIGGINS;357980;2;1;0;0;0;2;1;357980;LED 55 55P615 UHD ANDROID TV 4K;ELECTRONICA MAYOR
12984345;;M;46;CHILENO;;X;PUREN                         ;ARAUCANIA;279990;1;1;0;0;0;1;1;279990;LED 50 KEUH50 SMART TV UHD;ELECTRONICA MAYOR
10665433;;M;54;CHILENO;;X;LOS LAGOS;LOS LAGOS;234980;3;1;0;0;0;3;1;234980;LED 42 KHFH4221 SMART TV;ELECTRONICA MAYOR
12455605;;M;48;CHILENO;;X;ANCUD                         ;LOS LAGOS;711910;9;3;0;0;0;9;3;711910;LED NanoCell 55NANO80 UHD SMART + MAGIC;ELECTRONICA MAYOR
11972487;;F;50;CHILENO;;X;RENCA                         ;METROPOLITANA;513960;4;2;0;0;0;4;2;513960;LED 65 KEUH6521 SMART TV UHD;ELECTRONICA MAYOR
19231587;Soltero;M;26;CHILENO;;Z;PROVIDENCIA                   ;METROPOLITANA;389990;1;1;0;0;0;1;1;389990;LED 58 UN58AU7000GXZS UHD 4K SMART TV;ELECTRONICA MAYOR
9121454;;M;55;CHILENO;;Boomers;PROVIDENCIA                   ;METROPOLITANA;202980;2;1;0;0;0;2;1;202980;LED 32LM637B HD SMART;ELECTRONICA MAYOR
22648937;;F;53;PERUANO;;Extranjero;PUDAHUEL                      ;METROPOLITANA;255970;3;2;0;0;0;3;2;255970;LED 42 KHFH4221 SMART TV;ELECTRONICA MAYOR
18843785;;F;27;CHILENO;;Millenial;PROVIDENCIA                   ;METROPOLITANA;286980;2;1;2;1;286980;0;0;0;LED 50 UN50TU7090GXZS UHD SMART TV;ELECTRONICA MAYOR
11561461;;F;52;CHILENO;;X;TALCA                         ;MAULE;286980;2;1;2;1;286980;0;0;0;LED 55 UN55TU7090GXZS SMART TV UHD;ELECTRONICA MAYOR
13278995;;F;45;CHILENO;;X;TALCA                         ;MAULE;474970;3;3;0;0;0;3;3;474970;LED 55 KEUH5521 SMART TV UHD;ELECTRONICA MAYOR
17320568;Casado;F;32;CHILENO;TECNICO SUPERIOR DE ENFERMERIA;Silencioso;PROVIDENCIA                   ;METROPOLITANA;159990;1;1;1;1;159990;0;0;0;LED 32 UN32T4300AGXZS HD SMART TV;ELECTRONICA MAYOR
16372678;;M;40;CHILENO;;X;CONCHALI;METROPOLITANA;386970;3;3;0;0;0;3;3;386970;LED 50 50PUD7625 SMART TV ULTRA HD 4K;ELECTRONICA MAYOR
15341958;;F;39;CHILENO;;X;N/D;N/D;1141820;17;8;15;6;836840;2;2;304980;LED KIOTO 32 MI3228 SMART TV;ELECTRONICA MAYOR
8018106;;M;79;CHILENO;;Silencioso;PROVIDENCIA                   ;METROPOLITANA;442960;4;2;0;0;0;4;2;442960;LED 50 50UP7500 UHD SMART TV;ELECTRONICA MAYOR
19598484;;F;25;CHILENO;;Z;PROVIDENCIA                   ;METROPOLITANA;159990;1;1;1;1;159990;0;0;0;LED 32 UN32T4300AGXZS HD SMART TV;ELECTRONICA MAYOR
13012952;;M;45;CHILENO;;X;ANTOFAGASTA                   ;ANTOFAGASTA;29980;2;1;0;0;0;2;1;29980;PARLANTE KARAOKE 8 MAXEIGHT;ELECTRONICA MAYOR
9508686;;M;59;CHILENO;;Boomers;COIHAIQUE                     ;AYSEN;159990;1;1;0;0;0;1;1;159990;LED 32 UN32T4300AGXZS HD SMART TV;ELECTRONICA MAYOR
12687860;;M;47;CHILENO;;X;RENCA                         ;METROPOLITANA;416960;3;1;3;1;416960;0;0;0;LED 58 UN58AU7000GXZS UHD 4K SMART TV;ELECTRONICA MAYOR
17263084;;F;36;CHILENO;;Millenial;"";"";286970;3;2;2;1;86980;1;1;199990;LED 40 UN40T5290AGXZS FHD SMART TV;ELECTRONICA MAYOR
19693113;;F;24;CHILENO;;Z;PROVIDENCIA                   ;METROPOLITANA;349990;1;1;1;1;349990;0;0;0;LED 55UP7500 UHD SMART;ELECTRONICA MAYOR
12824375;;M;46;CHILENO;;X;PROVIDENCIA                   ;METROPOLITANA;149990;1;1;0;0;0;1;1;149990;MINICOMPONENTE RN5;ELECTRONICA MAYOR
18548287;Soltero;F;28;CHILENO;;Millenial;PROVIDENCIA                   ;METROPOLITANA;159990;2;1;2;1;159990;0;0;0;LED 32 UN32T4300AGXZS HD SMART TV;ELECTRONICA MAYOR
16694304;;M;34;CHILENO;;Millenial;N/D;N/D;237970;3;2;2;1;184980;1;1;52990;LED 40 KEHD4020 SMART TV;ELECTRONICA MAYOR
15305632;;F;44;CHILENO;;X;COIHAIQUE                     ;AYSEN;389990;1;1;0;0;0;1;1;389990;LED 55 55UP7750 UHD SMART + MAGIC;ELECTRONICA MAYOR
14223773;;M;47;CHILENO;;X;"";"";237970;3;2;0;0;0;3;2;237970;LED 42 KHFH4221 SMART TV;ELECTRONICA MAYOR
13190229;Soltero;F;45;CHILENO;;X;RENCA                         ;METROPOLITANA;249990;1;1;1;1;249990;0;0;0;LED 50 50PUD7625 SMART TV ULTRA HD 4K;ELECTRONICA MAYOR
11532881;;F;51;CHILENO;;X;CAUQUENES                     ;MAULE;252969;3;2;0;0;0;3;2;252969;LED 32 UN32T4300AGXZS HD SMART TV;ELECTRONICA MAYOR
17493713;;F;31;CHILENO;;Millenial;"";"";582390;11;6;11;6;582390;0;0;0;LED KIOTO 32 MI3228 SMART TV;ELECTRONICA MAYOR
17399104;;M;32;CHILENO;;Millenial;MELIPILLA                     ;METROPOLITANA;159990;1;1;0;0;0;1;1;159990;LED 32 UN32T4300AGXZS HD SMART TV;ELECTRONICA MAYOR
17933736;;M;30;CHILENO;;Millenial;PROVIDENCIA                   ;METROPOLITANA;154980;2;1;0;0;0;2;1;154980;LED KIOTO 32 MI3228 SMART TV;ELECTRONICA MAYOR
6143361;;F;76;CHILENO;;Silencioso;PROVIDENCIA                   ;METROPOLITANA;359961;5;3;0;0;0;5;3;359961;LED 43 UN43T5202AGXZS FHD SMART TV;ELECTRONICA MAYOR
11423280;;M;53;CHILENO;;X;PUTAENDO                      ;VALPARAISO;385970;3;2;2;1;135980;1;1;249990;LED 43 43UP7500 UHD SMART TV;ELECTRONICA MAYOR
17533728;Soltero;M;32;CHILENO;;Millenial;COCHRANE                      ;AYSEN;247980;2;1;0;0;0;2;1;247980;MINICOMPONENTE MX-T50/ZS ALL IN ONE;ELECTRONICA MAYOR
6848622;;F;71;CHILENO;;Silencioso;QUILLOTA                      ;VALPARAISO;862910;10;7;2;1;424980;8;6;437930;LED 40 KEHD4020 SMART TV;ELECTRONICA MAYOR
5345908;;F;73;CHILENO;;Silencioso;ARICA                         ;ARICA Y PARINACOTA;617940;6;3;0;0;0;6;3;617940;LED 43 43LM6370 SMART TV FHD;ELECTRONICA MAYOR
18000929;;F;30;CHILENO;;Millenial;N/D;N/D;309980;2;2;1;1;189990;1;1;119990;PARLANTE ULTRABUZZ;ELECTRONICA MAYOR
14073311;;M;41;CHILENO;;X;CURANILAHUE                   ;BIO BIO;210980;2;1;0;0;0;2;1;210980;LED 50 KEUH50 SMART TV UHD;ELECTRONICA MAYOR
8554950;;F;51;CHILENO;;X;COPIAPO                       ;ATACAMA;899970;3;3;0;0;0;3;3;899970;LED 65 KEUH6521 SMART TV UHD;ELECTRONICA MAYOR
10872531;;F;44;CHILENO;;X;PROVIDENCIA                   ;METROPOLITANA;319980;2;2;0;0;0;2;2;319980;MONITOR 24 24TL520S SMART TV HD;ELECTRONICA MAYOR
16199247;;F;36;CHILENO;;Millenial;"";"";252980;2;2;0;0;0;2;2;252980;LED 50 KEUH50 SMART TV UHD;ELECTRONICA MAYOR
9299117;;F;60;CHILENO;;Boomers;LA FLORIDA                    ;METROPOLITANA;187980;2;2;0;0;0;2;2;187980;LED 40 KEHD4020 SMART TV;ELECTRONICA MAYOR
11549714;;M;52;CHILENO;;X;RENCA                         ;METROPOLITANA;224980;2;1;0;0;0;2;1;224980;LED 43 CS43S1USM UHD SMART TV NEGRO;ELECTRONICA MAYOR
14206519;Soltero;F;41;CHILENO;PROFESOR;Silencioso;PROVIDENCIA                   ;METROPOLITANA;485970;3;2;3;2;485970;0;0;0;LED 40 UN40T5290AGXZS FHD SMART TV;ELECTRONICA MAYOR
8988485;;M;60;CHILENO;;Boomers;ANCUD                         ;LOS LAGOS;563950;5;2;0;0;0;5;2;563950;LED 50 50UP7500 UHD SMART TV;ELECTRONICA MAYOR
8054420;;F;63;CHILENO;;Boomers;ANGOL                         ;ARAUCANIA;241970;3;1;0;0;0;3;1;241970;LED 43 43S5295 SMART TV FHD;ELECTRONICA MAYOR
23969799;Soltero;F;28;BOLIVIANO;;Extranjero;ARICA                         ;TARAPACA;408990;3;1;0;0;0;3;1;408990;LED 55 UN55TU7090GXZS SMART TV UHD;ELECTRONICA MAYOR
13347752;;M;43;CHILENO;;X;SAN FERNANDO                  ;L.G.B.OÂ´HIGGINS;199990;1;1;0;0;0;1;1;199990;LED 50 KEUH50 SMART TV UHD;ELECTRONICA MAYOR
10134988;;F;58;CHILENO;;Boomers;SAN CARLOS                    ;BIO BIO;493950;5;4;0;0;0;5;4;493950;LED 32 UN32T4300AGXZS HD SMART TV;ELECTRONICA MAYOR
7628757;Casado;F;61;CHILENO;;Boomers;CERRILLOS                     ;METROPOLITANA;459990;1;1;0;0;0;1;1;459990;LED 55 NanoCell 55NANO75 UHD SMART + MAGIC;ELECTRONICA MAYOR
7850993;;F;59;CHILENO;;Boomers;ARICA                         ;ARICA Y PARINACOTA;517960;4;4;0;0;0;4;4;517960;LED 50 UN50TU7090GXZS UHD SMART TV;ELECTRONICA MAYOR
10486827;;M;54;CHILENO;;X;SAN RAFAEL                    ;MAULE;184980;2;1;0;0;0;2;1;184980;LED 32 UN32T4300AGXZS HD SMART TV;ELECTRONICA MAYOR
5488934;;F;76;CHILENO;;Silencioso;CASTRO                        ;LOS LAGOS;223980;2;1;0;0;0;2;1;223980;LED 32 UN32T4300AGXZS HD SMART TV;ELECTRONICA MAYOR
19363619;;F;25;CHILENO;;Z;LINARES                       ;MAULE;771960;4;3;0;0;0;4;3;771960;LED 40 UN40T5290AGXZS FHD SMART TV;ELECTRONICA MAYOR
11574170;;F;52;CHILENO;;X;N/D;N/D;186950;6;2;0;0;0;6;2;186950;KARAOKE PORTATIL TWO-EIGHT 8860;ELECTRONICA MAYOR
27050857;;F;35;VENEZOLANO;;Extranjero;COPIAPO                       ;ATACAMA;509940;6;2;0;0;0;6;2;509940;LED 50 50U6305 SMART TV ULTRA HD;ELECTRONICA MAYOR
18726342;;M;28;CHILENO;;Millenial;SAN PEDRO                     ;METROPOLITANA;267700;3;1;0;0;0;3;1;267700;PARLANTE ULTRAFORCE-I;ELECTRONICA MAYOR
8310675;;F;65;CHILENO;;X;PROVIDENCIA                   ;METROPOLITANA;292980;2;1;0;0;0;2;1;292980;LED 43 UN43TU7090GXZS UHD SMART TV;ELECTRONICA MAYOR
15253427;;M;38;CHILENO;;X;SAN FELIPE                    ;VALPARAISO;44990;1;1;0;0;0;1;1;44990;PARLANTE SPBYF7 PORTATIL;ELECTRONICA MAYOR
15302099;;F;39;CHILENO;;X;PROVIDENCIA                   ;METROPOLITANA;34990;1;1;0;0;0;1;1;34990;MLAB KARAOKE 8 CITY SET MICROFONO INALAMBRICO AT;ELECTRONICA MAYOR
17045760;;F;33;CHILENO;;Millenial;ARAUCO                        ;BIO BIO;169990;1;1;0;0;0;1;1;169990;LED 32 UN32T4300AGXZS HD SMART TV;ELECTRONICA MAYOR
11466958;;M;53;CHILENO;;X;MEJILLONES                    ;ANTOFAGASTA;129980;2;1;0;0;0;2;1;129980;PARLANTE ULTRAMAGIC;ELECTRONICA MAYOR
12042849;;M;53;CHILENO;;X;QUILLOTA                      ;VALPARAISO;464960;4;3;0;0;0;4;3;464960;LED 55UP7500 UHD SMART;ELECTRONICA MAYOR
17440643;;F;31;CHILENO;;Millenial;VILLARICA                     ;ARAUCANIA;272970;3;2;0;0;0;3;2;272970;LED 50 KEUH50 SMART TV UHD;ELECTRONICA MAYOR
15047019;;F;39;CHILENO;;X;N/D;N/D;545080;3;1;3;1;545080;0;0;0;LED 50 50PUD7625 SMART TV ULTRA HD 4K;ELECTRONICA MAYOR
9043570;;F;67;CHILENO;;Boomers;RENCA                         ;METROPOLITANA;199990;1;1;0;0;0;1;1;199990;LED 32 UN32T4300AGXZS HD SMART TV;ELECTRONICA MAYOR
6949484;;M;70;CHILENO;;Silencioso;ANTUCO                        ;BIO BIO;436550;4;1;0;0;0;4;1;436550;LED 40 UN40T5290AGXZS FHD SMART TV;ELECTRONICA MAYOR
8758328;;M;60;CHILENO;;Boomers;QUILLOTA                      ;VALPARAISO;134980;2;1;0;0;0;2;1;134980;PARLANTE ULTRAMAGIC;ELECTRONICA MAYOR
12331347;;F;49;CHILENO;;X;PROVIDENCIA                   ;METROPOLITANA;209980;2;1;0;0;0;2;1;209980;LED 42 KHFH4221 SMART TV;ELECTRONICA MAYOR
20292257;;F;22;CHILENO;;Z;PROVIDENCIA                   ;METROPOLITANA;24990;1;2;0;0;0;1;2;24990;KARAOKE STREET SONG 4 MICÂ CABLEÂ BLACK 8900;ELECTRONICA MAYOR
23362818;;M;43;PERUANO;;Extranjero;N/D;N/D;918970;3;4;0;0;0;3;4;918970;LED 70 UN70AU7000GXZS UHD;ELECTRONICA MAYOR
14585391;;M;41;CHILENO;;Silencioso;PROVIDENCIA                   ;METROPOLITANA;213980;2;1;2;1;213980;0;0;0;LED 40 UN40T5290AGXZS FHD SMART TV;ELECTRONICA MAYOR
13637256;;M;43;CHILENO;;X;ARICA                         ;TARAPACA;193980;2;1;0;0;0;2;1;193980;LED 40 KEHD4020 SMART TV;ELECTRONICA MAYOR
15669121;;F;38;CHILENO;;Millenial;CABILDO                       ;VALPARAISO;285980;2;1;0;0;0;2;1;285980;LED 50 50U6305 SMART TV ULTRA HD;ELECTRONICA MAYOR
18444797;Soltero;M;28;CHILENO;;Millenial;PROVIDENCIA                   ;METROPOLITANA;183980;2;1;2;1;183980;0;0;0;LED 32 UN32T4300AGXZS HD SMART TV;ELECTRONICA MAYOR
12816873;Soltero;M;47;CHILENO;;Silencioso;LA LIGUA                      ;VALPARAISO;449101;7;3;0;0;0;7;3;449101;PARLANTE ULTRASENSATION;ELECTRONICA MAYOR
12957372;;M;45;CHILENO;;X;PETORCA                       ;VALPARAISO;162970;3;1;0;0;0;3;1;162970;LED 32 CS32S1 SMART TV HD NEGRO;ELECTRONICA MAYOR
7028183;;F;71;CHILENO;;Silencioso;SANTA CRUZ                    ;L.G.B.OÂ´HIGGINS;129990;1;1;0;0;0;1;1;129990;LED 32 CS32S1 SMART TV HD NEGRO;ELECTRONICA MAYOR
16781596;;F;34;CHILENO;;Millenial;FUTRONO                       ;LOS LAGOS;779950;5;3;0;0;0;5;3;779950;LED 58 UN58AU7000GXZS UHD 4K SMART TV;ELECTRONICA MAYOR
9345788;Casado;M;58;CHILENO;PERIODISTA;Boomers;RENCA                         ;METROPOLITANA;309990;1;1;0;0;0;1;1;309990;LED 50 50P615-50P ANDROID TV PASSION LINE UHD 4K;ELECTRONICA MAYOR
16779986;;F;33;CHILENO;;Millenial;ANCUD                         ;LOS LAGOS;635970;3;2;0;0;0;3;2;635970;LED 58 58PUD7625 BORDES ULTRA DELGADOS 4K UHD;ELECTRONICA MAYOR
10525672;;M;56;CHILENO;;Boomers;PROVIDENCIA                   ;METROPOLITANA;29990;1;1;0;0;0;1;1;29990;PARLANTE KARAOKE 8 MAXEIGHT;ELECTRONICA MAYOR
13560603;;F;44;CHILENO;;X;"";"";319990;1;1;0;0;0;1;1;319990;LED 58 KEUH5821 SMART TV UHD;ELECTRONICA MAYOR
12305251;;M;50;CHILENO;;X;MACUL                         ;METROPOLITANA;299990;1;1;0;0;0;1;1;299990;LED 55 55P615 UHD ANDROID TV 4K;ELECTRONICA MAYOR
8008955;;F;63;CHILENO;;Boomers;PUENTE ALTO                   ;METROPOLITANA;837951;5;7;0;0;0;5;7;837951;LED 58 58PUD7625 BORDES ULTRA DELGADOS 4K UHD;ELECTRONICA MAYOR
9502111;;M;60;CHILENO;;Boomers;LONCOCHE                      ;ARAUCANIA;327980;2;1;0;0;0;2;1;327980;LED 43 UN43TU7090GXZS UHD SMART TV;ELECTRONICA MAYOR
24222759;;M;38;COLOMBIANO;;Extranjero;IQUIQUE                       ;TARAPACA;44990;1;1;0;0;0;1;1;44990;PARLANTE COBRA;ELECTRONICA MAYOR
15172269;;M;38;CHILENO;;X;ARICA                         ;TARAPACA;309990;1;1;0;0;0;1;1;309990;LED 50 UN50TU7090GXZS UHD SMART TV;ELECTRONICA MAYOR
25979311;;M;42;HAITIANO;;Extranjero;N/D;N/D;181980;2;1;0;0;0;2;1;181980;LED KIOTO 32 MI3228 SMART TV;ELECTRONICA MAYOR
8018487;Soltero;M;64;CHILENO;;Boomers;CATEMU                        ;VALPARAISO;332960;4;1;0;0;0;4;1;332960;PARLANTE ULTRABUZZ;ELECTRONICA MAYOR
18959058;;F;27;CHILENO;;Millenial;VILLARICA                     ;ARAUCANIA;233980;2;1;0;0;0;2;1;233980;LED 42 KHFH4221 SMART TV;ELECTRONICA MAYOR
18894678;;M;27;CHILENO;;Millenial;CONSTITUCION                  ;MAULE;24990;1;1;0;0;0;1;1;24990;PARLANTE KARAOKE 8 MAXEIGHT;ELECTRONICA MAYOR
16405062;;M;28;CHILENO;;Millenial;"";"";179990;1;1;0;0;0;1;1;179990;LED 40 KEHD4020 SMART TV;ELECTRONICA MAYOR
13506231;;F;43;CHILENO;;X;SAN BERNARDO                  ;METROPOLITANA;308980;2;2;2;2;308980;0;0;0;LED 50 50UP7500 UHD SMART TV;ELECTRONICA MAYOR
13294890;;M;45;CHILENO;;X;PROVIDENCIA                   ;METROPOLITANA;1210100;7;2;0;0;0;7;2;1210100;LED 55 UN55TU7090GXZS SMART TV UHD;ELECTRONICA MAYOR
25275478;;M;30;VENEZOLANO;;Extranjero;"";"";192980;2;2;0;0;0;2;2;192980;LED KIOTO 32 MI3228 SMART TV;ELECTRONICA MAYOR
12472402;Casado;M;49;CHILENO;INGENIERO INFORMATICO;X;PROVIDENCIA                   ;METROPOLITANA;273970;3;1;0;0;0;3;1;273970;LED 40 UN40T5290AGXZS FHD SMART TV;ELECTRONICA MAYOR
7534812;;M;67;CHILENO;;Boomers;QUELLON                       ;LOS LAGOS;233980;2;1;0;0;0;2;1;233980;LED 32 UN32T4300AGXZS HD SMART TV;ELECTRONICA MAYOR
12008669;;M;45;CHILENO;;X;CURICO                        ;MAULE;36990;1;3;0;0;0;1;3;36990;PARLANTE SPBYF7 PORTATIL;ELECTRONICA MAYOR
12719738;;F;47;CHILENO;;X;VILLA ALEMANA                 ;VALPARAISO;191980;2;1;0;0;0;2;1;191980;LED 32 32S5295 SMART TV HD;ELECTRONICA MAYOR
5098634;;M;79;CHILENO;;Silencioso;RENCA                         ;METROPOLITANA;451980;2;1;0;0;0;2;1;451980;LED 55 UN55TU7090GXZS SMART TV UHD;ELECTRONICA MAYOR
14522355;;M;41;CHILENO;;X;N/D;N/D;139990;1;1;0;0;0;1;1;139990;LED KIOTO 32 MI3228 SMART TV;ELECTRONICA MAYOR
26729249;;M;31;VENEZOLANO;;Extranjero;N/D;N/D;631950;5;5;0;0;0;5;5;631950;LED 55 UN55TU7090GXZS SMART TV UHD;ELECTRONICA MAYOR
12082829;;F;53;CHILENO;;X;VALLENAR;ATACAMA;218970;3;2;0;0;0;3;2;218970;PARLANTE KARAOKE PINGUINO PORTATIL NEGRO;ELECTRONICA MAYOR
19387015;;F;26;CHILENO;;Z;N/D;N/D;399470;3;2;0;0;0;3;2;399470;PARLANTE ULTRAFORCE-I;ELECTRONICA MAYOR
17098329;;F;33;CHILENO;;Millenial;PUENTE ALTO;METROPOLITANA;199990;1;1;0;0;0;1;1;199990;LED 42 KHFH4221 SMART TV;ELECTRONICA MAYOR
15199603;;F;43;CHILENO;;X;LEBU                          ;BIO BIO;622970;3;2;0;0;0;3;2;622970;LED 43 Full HD Smart TV 43PFD6825;ELECTRONICA MAYOR
20320070;;F;22;CHILENO;;Z;N/D;N/D;279980;2;2;0;0;0;2;2;279980;LED 50 KEUH50 SMART TV UHD;ELECTRONICA MAYOR
25953570;;M;38;EXTRANJERO - NO INFORMA NACIONALIDAD;;Extranjero;"";"";279990;1;1;1;1;279990;0;0;0;LED 50 50UP7500 UHD SMART TV;ELECTRONICA MAYOR
12583337;Casado;M;47;CHILENO;;X;RENCA                         ;METROPOLITANA;49990;1;1;0;0;0;1;1;49990;PARLANTE KARAOKE PINGUINO PORTATIL NEGRO;ELECTRONICA MAYOR
12277637;;M;50;CHILENO;;X;N/D;N/D;144980;2;1;2;1;144980;0;0;0;LED 32 CS32S1 SMART TV HD NEGRO;ELECTRONICA MAYOR
9186308;Soltero;M;59;CHILENO;;Boomers;MELIPILLA                     ;METROPOLITANA;99990;1;1;0;0;0;1;1;99990;PARLANTE ULTRAMAGIC;ELECTRONICA MAYOR
8248849;;M;63;CHILENO;;Boomers;OVALLE                        ;COQUIMBO;19992;1;1;0;0;0;1;1;19992;KARAOKE EXTRA SAVAGE MICÂ CABLEÂ BLACK 8902;ELECTRONICA MAYOR
11607226;;M;52;CHILENO;;X;N/D;N/D;158980;2;1;2;1;158980;0;0;0;TOCADISCOS PS-LX310BT BT;ELECTRONICA MAYOR
11839368;Casado;M;50;CHILENO;;X;QUINTA NORMAL                 ;METROPOLITANA;129990;1;1;0;0;0;1;1;129990;PARLANTE ULTRAMAGIC;ELECTRONICA MAYOR
15004177;;M;39;CHILENO;;Extranjero;N/D;N/D;692970;3;2;0;0;0;3;2;692970;LED 50 UN50TU7090GXZS UHD SMART TV;ELECTRONICA MAYOR
15389898;;F;38;CHILENO;;X;"";"";258980;2;1;2;1;258980;0;0;0;LED 43 UN43TU7090GXZS UHD SMART TV;ELECTRONICA MAYOR
16288328;;M;36;CHILENO;;Millenial;NOGALES                       ;VALPARAISO;425980;2;3;0;0;0;2;3;425980;LED 65 KEUH6521 SMART TV UHD;ELECTRONICA MAYOR
15883250;;M;38;CHILENO;;Millenial;RENCA                         ;METROPOLITANA;189990;1;1;0;0;0;1;1;189990;LED 40 KEHD4020 SMART TV;ELECTRONICA MAYOR
18726249;;M;28;CHILENO;;Millenial;N/D;N/D;34990;1;1;0;0;0;1;1;34990;KARAOKE FUNKY DISCO;ELECTRONICA MAYOR
10012588;;F;58;CHILENO;;Boomers;N/D;N/D;129990;1;1;0;0;0;1;1;129990;LED 32 KHHD3221 SMART TV;ELECTRONICA MAYOR
19856703;;F;24;CHILENO;;Z;N/D;N/D;129990;1;1;0;0;0;1;1;129990;PARLANTE ULTRAFUSION;ELECTRONICA MAYOR
7890118;Casado;M;63;CHILENO;;Silencioso;PROVIDENCIA                   ;METROPOLITANA;36980;2;1;0;0;0;2;1;36980;KARAOKE STREET SONG 4 MICÂ CABLEÂ BLACK 8900;ELECTRONICA MAYOR
20002683;;M;26;CHILENO;;Z;"";"";54990;1;1;0;0;0;1;1;54990;PARLANTE KARAOKE PINGUINO PORTATIL NEGRO;ELECTRONICA MAYOR
12064071;Divorciado;F;52;CHILENO;;X;SAN FELIPE                    ;VALPARAISO;54980;2;1;0;0;0;2;1;54980;MLAB KARAOKE 8 CITY SET MICROFONO INALAMBRICO AT;ELECTRONICA MAYOR
6525593;;F;69;CHILENO;;Silencioso;SAN PEDRO DE LA PAZ           ;BIO BIO;99990;1;1;0;0;0;1;1;99990;PARLANTE ULTRAMAGIC;ELECTRONICA MAYOR
13643439;;F;43;CHILENO;;Millenial;ANTOFAGASTA                   ;ANTOFAGASTA;169990;1;1;1;1;169990;0;0;0;LED 32 UN32T4300AGXZS HD SMART TV;ELECTRONICA MAYOR
10471971;;F;59;CHILENO;;Boomers;N/D;N/D;398950;5;3;2;1;143980;3;2;254970;PARLANTE ULTRASENSATION;ELECTRONICA MAYOR
17011890;;F;33;CHILENO;;Millenial;ARICA                         ;ARICA Y PARINACOTA;567520;4;2;2;1;141540;2;1;425980;LED 55UP7500 UHD SMART;ELECTRONICA MAYOR
18420262;;M;29;CHILENO;;Millenial;PROVIDENCIA                   ;METROPOLITANA;536960;4;2;2;1;113980;2;1;422980;LED 55UP7500 UHD SMART;ELECTRONICA MAYOR
18526177;;F;28;CHILENO;;Millenial;PROVIDENCIA                   ;METROPOLITANA;869970;3;1;0;0;0;3;1;869970;LED 65 KEUH6521 SMART TV UHD;ELECTRONICA MAYOR
16578042;;F;34;CHILENO;;Millenial;SAN JAVIER                    ;MAULE;169990;1;1;0;0;0;1;1;169990;LED 32 UN32T4300AGXZS HD SMART TV;ELECTRONICA MAYOR
13999568;;M;41;CHILENO;;Millenial;"";"";209990;1;1;0;0;0;1;1;209990;LED 40 UN40T5290AGXZS FHD SMART TV;ELECTRONICA MAYOR
15595253;;F;38;CHILENO;;X;CERRO NAVIA                   ;METROPOLITANA;149990;1;1;0;0;0;1;1;149990;PARLANTE ULTRAFUSION;ELECTRONICA MAYOR
26118659;;F;45;VENEZOLANO;;Extranjero;"";"";85970;3;2;0;0;0;3;2;85970;PARLANTE SENSEIGTH K3175;ELECTRONICA MAYOR
14046474;;F;41;CHILENO;;X;PROVIDENCIA                   ;METROPOLITANA;169980;2;1;0;0;0;2;1;169980;LED 32 32S5295 SMART TV HD;ELECTRONICA MAYOR
7439604;Casado;F;66;CHILENO;PROFESOR;Boomers;INDEPENDENCIA                 ;METROPOLITANA;44990;1;1;0;0;0;1;1;44990;PARLANTE COBRA;ELECTRONICA MAYOR
5896407;;M;67;CHILENO;;Boomers;N/D;N/D;299950;5;2;0;0;0;5;2;299950;LED 43 Full HD Smart TV 43PFD6825;ELECTRONICA MAYOR
16201912;;M;36;CHILENO;;Millenial;CHILLAN                       ;BIO BIO;279980;2;4;1;1;69990;1;3;209990;PARLANTE ULTRASENSATION;ELECTRONICA MAYOR
9200608;;M;60;CHILENO;;Boomers;LO ESPEJO                     ;METROPOLITANA;219970;3;2;0;0;0;3;2;219970;MINICOMPONENTE OL45;ELECTRONICA MAYOR
9551451;;M;56;CHILENO;;Boomers;ARAUCO                        ;BIO BIO;60980;2;1;0;0;0;2;1;60980;PARLANTE KARAOKE SPB8B;ELECTRONICA MAYOR
10539412;;F;57;CHILENO;;Boomers;COLINA                        ;METROPOLITANA;34990;1;1;0;0;0;1;1;34990;KARAOKE FUNKY DISCO;ELECTRONICA MAYOR
8449860;;M;61;CHILENO;;Boomers;PUERTO MONTT                  ;LOS LAGOS;169990;1;1;0;0;0;1;1;169990;LED 32 UN32T4300AGXZS HD SMART TV;ELECTRONICA MAYOR
18360073;;M;29;CHILENO;;Millenial;"";"";320970;3;1;3;1;320970;0;0;0;LED 50 50PUD7625 SMART TV ULTRA HD 4K;ELECTRONICA MAYOR
12687093;;F;48;CHILENO;;X;ALTO HOSPICIO;TARAPACA;167970;3;2;1;1;32990;2;1;134980;PARLANTE ULTRAMAGIC;ELECTRONICA MAYOR
8443350;;F;62;CHILENO;;Boomers;SALAMANCA                     ;COQUIMBO;171980;2;1;0;0;0;2;1;171980;LED 32 KHHD3221 SMART TV;ELECTRONICA MAYOR
10571693;;M;57;CHILENO;;Boomers;RENCA                         ;METROPOLITANA;342980;2;1;0;0;0;2;1;342980;LED 50 50PUD7625 SMART TV ULTRA HD 4K;ELECTRONICA MAYOR
15251570;;M;39;CHILENO;;X;TEODORO SCHMIDT               ;ARAUCANIA;207969;3;1;0;0;0;3;1;207969;LED 40 UN40T5290AGXZS FHD SMART TV;ELECTRONICA MAYOR
13408846;;M;44;CHILENO;;X;ESTACION CENTRAL              ;METROPOLITANA;888809;8;2;0;0;0;8;2;888809;LED 58 58PUD7625 BORDES ULTRA DELGADOS 4K UHD;ELECTRONICA MAYOR
14238294;;M;48;CHILENO;;X;"";"";322970;3;1;0;0;0;3;1;322970;LED 40 UN40T5290AGXZS FHD SMART TV;ELECTRONICA MAYOR
13613835;;F;43;CHILENO;;X;N/D;N/D;293061;4;3;0;0;0;4;3;293061;PARLANTE ULTRAFUSION;ELECTRONICA MAYOR
13175444;;M;46;CHILENO;;X;VALLENAR;ATACAMA;572940;6;2;0;0;0;6;2;572940;LED 43 43S5305 SMART TV FULL HD;ELECTRONICA MAYOR
6760972;Viudo;M;71;CHILENO;;Silencioso;RENCA                         ;METROPOLITANA;59980;2;1;0;0;0;2;1;59980;PARLANTE SPBYF7 PORTATIL;ELECTRONICA MAYOR
11966529;;M;54;CHILENO;;Boomers;PUREN                         ;ARAUCANIA;349990;1;1;0;0;0;1;1;349990;LED 55UP7500 UHD SMART;ELECTRONICA MAYOR
7978747;;M;66;CHILENO;;Boomers;RENCA                         ;METROPOLITANA;199990;1;1;0;0;0;1;1;199990;PARLANTE ULTRAFORCE-I;ELECTRONICA MAYOR
8189039;;M;59;CHILENO;;Boomers;PUENTE ALTO                   ;METROPOLITANA;767960;4;2;0;0;0;4;2;767960;LED 60 UN60AU8000GXZS UHD SMART TV;ELECTRONICA MAYOR
12830575;;M;47;CHILENO;;X;N/D;N/D;399990;1;1;0;0;0;1;1;399990;LED 58 UN58AU7000GXZS UHD 4K SMART TV;ELECTRONICA MAYOR
26850367;;F;34;EXTRANJERO - NO INFORMA NACIONALIDAD;;Extranjero;PROVIDENCIA                   ;METROPOLITANA;189990;1;1;0;0;0;1;1;189990;LED 32LM637B HD SMART;ELECTRONICA MAYOR
17080553;;F;33;CHILENO;;Millenial;PROVIDENCIA                   ;METROPOLITANA;187980;2;1;0;0;0;2;1;187980;LED 32 UN32T4300AGXZS HD SMART TV;ELECTRONICA MAYOR
11175971;;F;54;CHILENO;;Boomers;LINARES                       ;MAULE;54990;1;1;0;0;0;1;1;54990;PARLANTE SENSEIGTH K3175;ELECTRONICA MAYOR
12985990;;M;46;CHILENO;;X;VICTORIA                      ;ARAUCANIA;319980;2;1;0;0;0;2;1;319980;PARLANTE ULTRASENSATION;ELECTRONICA MAYOR
20055780;;F;23;CHILENO;;Z;PROVIDENCIA                   ;METROPOLITANA;258980;2;1;2;1;258980;0;0;0;LED 43 UN43TU7090GXZS UHD SMART TV;ELECTRONICA MAYOR
16689747;;M;35;CHILENO;;Millenial;CORONEL                       ;BIO BIO;54990;1;1;0;0;0;1;1;54990;PARLANTE KARAOKE 12 FM/BT/USB;ELECTRONICA MAYOR
7609104;;M;63;CHILENO;;Boomers;RENCA                         ;METROPOLITANA;255970;3;1;0;0;0;3;1;255970;LED 42 KHFH4221 SMART TV;ELECTRONICA MAYOR
7229349;;M;65;CHILENO;;Boomers;TOCOPILLA                     ;ANTOFAGASTA;234980;2;2;0;0;0;2;2;234980;LED 42 KHFH4221 SMART TV;ELECTRONICA MAYOR
17916963;;F;30;CHILENO;;Millenial;PADRE LAS CASAS               ;ARAUCANIA;226970;3;1;3;1;226970;0;0;0;PARLANTE ULTRAFORCE-I;ELECTRONICA MAYOR
17514732;;F;32;CHILENO;;Millenial;PROVIDENCIA                   ;METROPOLITANA;-143970;-2;2;1;1;209990;-3;1;-353960;LED 40 UN40T5290AGXZS FHD SMART TV;ELECTRONICA MAYOR
18358230;Soltero;F;29;CHILENO;INGENIERO EN PREVENCION DE RIESGOS;Millenial;PROVIDENCIA                   ;METROPOLITANA;239990;2;1;2;1;239990;0;0;0;LED 43 Full HD Smart TV 43PFD6825;ELECTRONICA MAYOR
16077441;;M;37;CHILENO;;Millenial;RENCA                         ;METROPOLITANA;179990;1;1;0;0;0;1;1;179990;LED 42 KHFH4221 SMART TV;ELECTRONICA MAYOR
12084858;;F;52;CHILENO;;X;PENAFLOR                      ;METROPOLITANA;164990;1;1;0;0;0;1;1;164990;LED 42 KHFH4221 SMART TV;ELECTRONICA MAYOR
12736433;;M;53;CHILENO;;X;RENCA                         ;METROPOLITANA;459990;1;1;0;0;0;1;1;459990;LED 60UP7750 UHD SMART + MAGIC;ELECTRONICA MAYOR
4484540;;M;79;CHILENO;;Silencioso;TALCA                         ;MAULE;179990;1;1;0;0;0;1;1;179990;LED 42 KHFH4221 SMART TV;ELECTRONICA MAYOR
8436920;;M;64;CHILENO;;Boomers;PUENTE ALTO                   ;METROPOLITANA;404550;4;1;0;0;0;4;1;404550;LED 32 UN32T4300AGXZS HD SMART TV;ELECTRONICA MAYOR
11728300;;F;55;CHILENO;;Boomers;LA LIGUA                      ;VALPARAISO;298980;2;1;0;0;0;2;1;298980;LED 43 UN43TU7090GXZS UHD SMART TV;ELECTRONICA MAYOR
18210217;;F;30;CHILENO;;Millenial;PROVIDENCIA                   ;METROPOLITANA;286000;1;1;1;1;286000;0;0;0;LED 50 50UP7500 UHD SMART TV;ELECTRONICA MAYOR
15636354;Casado;M;39;CHILENO;ABOGADO;X;PROVIDENCIA                   ;METROPOLITANA;249990;2;1;2;1;249990;0;0;0;LED 43 UN43TU7090GXZS UHD SMART TV;ELECTRONICA MAYOR
12377574;;M;49;CHILENO;;X;N/D;N/D;279720;2;1;0;0;0;2;1;279720;LED 40 UN40T5290AGXZS FHD SMART TV;ELECTRONICA MAYOR
10022457;;F;56;CHILENO;;Boomers;CORONEL                       ;BIO BIO;382840;4;1;0;0;0;4;1;382840;LED 40 UN40T5290AGXZS FHD SMART TV;ELECTRONICA MAYOR
16996201;;F;41;CHILENO;;X;TEMUCO                        ;ARAUCANIA;199990;1;1;1;1;199990;0;0;0;LED 32LM637B HD SMART;ELECTRONICA MAYOR
7486231;;M;66;CHILENO;;Boomers;PROVIDENCIA                   ;METROPOLITANA;242980;2;1;0;0;0;2;1;242980;KARAOKE TRUE WIRELESS DUAL 10 PULGADAS LIGHT SHO;ELECTRONICA MAYOR
14142167;;M;40;CHILENO;;X;PUDAHUEL;METROPOLITANA;162470;2;1;0;0;0;2;1;162470;PARLANTE ULTRAFUSION;ELECTRONICA MAYOR
15303317;;F;40;CHILENO;;X;AISEN                         ;AYSEN;145670;2;1;0;0;0;2;1;145670;PARLANTE ULTRAFUSION;ELECTRONICA MAYOR
15111155;;F;38;CHILENO;;Millenial;SAN VICENTE                   ;L.G.B.OÂ´HIGGINS;169990;1;1;0;0;0;1;1;169990;LED 42 KHFH4221 SMART TV;ELECTRONICA MAYOR
9566624;;F;61;CHILENO;;Boomers;N/D;N/D;209980;2;1;0;0;0;2;1;209980;LED 32 UN32T4300AGXZS HD SMART TV;ELECTRONICA MAYOR
14182988;;M;41;CHILENO;;X;MAIPU                         ;METROPOLITANA;429960;4;2;0;0;0;4;2;429960;LED 42 KHFH4221 SMART TV;ELECTRONICA MAYOR
13076685;;M;45;CHILENO;;X;PUENTE ALTO                   ;METROPOLITANA;187980;2;2;0;0;0;2;2;187980;LED 42 KHFH4221 SMART TV;ELECTRONICA MAYOR
4276020;;M;82;CHILENO;;Silencioso;LA FLORIDA                    ;METROPOLITANA;243570;2;1;0;0;0;2;1;243570;LED 32LM637B HD SMART;ELECTRONICA MAYOR
18812736;;M;28;CHILENO;;Silencioso;"";"";376970;3;2;3;2;376970;0;0;0;LED 42 KHFH4221 SMART TV;ELECTRONICA MAYOR
10708392;;F;55;CHILENO;;Boomers;N/D;N/D;868370;7;3;0;0;0;7;3;868370;LED 32LM637B HD SMART;ELECTRONICA MAYOR
13450998;;M;44;CHILENO;;X;RENCA                         ;METROPOLITANA;79990;1;1;0;0;0;1;1;79990;SOUNDBAR HW-T400/ZS;ELECTRONICA MAYOR
16847081;Soltero;F;35;CHILENO;;Millenial;PROVIDENCIA                   ;METROPOLITANA;259990;1;1;0;0;0;1;1;259990;LED 40 UN40T5290AGXZS FHD SMART TV;ELECTRONICA MAYOR
13272667;;M;44;CHILENO;;X;LAS CONDES;METROPOLITANA;879990;2;1;2;1;879990;0;0;0;QLED 65 QN65Q80AAGXZS;ELECTRONICA MAYOR
5453372;;F;76;CHILENO;;Silencioso;RENCA                         ;METROPOLITANA;139980;2;1;0;0;0;2;1;139980;PARLANTE ULTRAFUSION;ELECTRONICA MAYOR
7313651;;M;64;CHILENO;;Boomers;TALAGANTE                     ;METROPOLITANA;137370;2;1;0;0;0;2;1;137370;PARLANTE ULTRAFUSION;ELECTRONICA MAYOR
14736639;;F;45;PERUANO;;Extranjero;N/D;N/D;1207750;5;2;0;0;0;5;2;1207750;LED 43 UN43TU7090GXZS UHD SMART TV;ELECTRONICA MAYOR
13912178;;F;42;CHILENO;;X;LA CISTERNA                   ;METROPOLITANA;44990;1;1;0;0;0;1;1;44990;KARAOKE RHYTHM CHARGER 12 MIC CABLE 8890;ELECTRONICA MAYOR
10304671;;F;57;CHILENO;;Boomers;EL BOSQUE                     ;METROPOLITANA;263570;2;1;0;0;0;2;1;263570;LED 40 UN40T5290AGXZS FHD SMART TV;ELECTRONICA MAYOR
15128771;;F;43;CHILENO;;X;ROMERAL                       ;MAULE;357870;2;2;0;0;0;2;2;357870;LED 50 50PUD7625 SMART TV ULTRA HD 4K;ELECTRONICA MAYOR
14017353;;M;40;CHILENO;;X;MAULE                         ;MAULE;396970;3;1;0;0;0;3;1;396970;LED 55UP7500 UHD SMART;ELECTRONICA MAYOR
14087258;;F;42;CHILENO;;X;RENCA                         ;METROPOLITANA;256980;2;1;0;0;0;2;1;256980;LED 40 UN40T5290AGXZS FHD SMART TV;ELECTRONICA MAYOR
3664532;;M;88;CHILENO;;Silencioso;ANCUD                         ;LOS LAGOS;246860;4;1;0;0;0;4;1;246860;LED 42 KHFH4221 SMART TV;ELECTRONICA MAYOR
15571921;;M;39;CHILENO;;X;MONTE PATRIA                  ;COQUIMBO;559809;4;1;0;0;0;4;1;559809;LED 50 UN50TU7090GXZS UHD SMART TV;ELECTRONICA MAYOR
7209814;;M;66;CHILENO;;Boomers;LA GRANJA                     ;METROPOLITANA;189990;1;1;0;0;0;1;1;189990;LED 42 KHFH4221 SMART TV;ELECTRONICA MAYOR
26537202;;M;35;EXTRANJERO - NO INFORMA NACIONALIDAD;;Extranjero;N/D;N/D;283980;2;1;2;1;283980;0;0;0;LED 43 UN43TU7090GXZS UHD SMART TV;ELECTRONICA MAYOR
19021181;;M;26;CHILENO;;Z;PROVIDENCIA                   ;METROPOLITANA;479080;4;2;4;2;479080;0;0;0;LED 58 UN58AU7000GXZS UHD 4K SMART TV;ELECTRONICA MAYOR
19896521;;F;23;CHILENO;;Silencioso;PROVIDENCIA                   ;METROPOLITANA;239990;1;1;1;1;239990;0;0;0;LED 40 UN40T5290AGXZS FHD SMART TV;ELECTRONICA MAYOR
26735022;;M;31;HAITIANO;;Extranjero;N/D;N/D;309980;2;1;0;0;0;2;1;309980;LED 43 UN43TU7090GXZS UHD SMART TV;ELECTRONICA MAYOR
20009582;;M;24;CHILENO;;Z;CASTRO                        ;LOS LAGOS;0;10;2;0;0;0;10;2;0;LED 43 43S5305 SMART TV FULL HD;ELECTRONICA MAYOR
19059658;;M;25;CHILENO;;Z;PROVIDENCIA                   ;METROPOLITANA;193980;2;1;2;1;193980;0;0;0;LED 32LM637B HD SMART;ELECTRONICA MAYOR
19824581;;M;24;CHILENO;;Z;CALAMA                        ;ANTOFAGASTA;1439260;6;4;5;3;1389270;1;1;49990;QLED 50 QN50Q60AAGXZS 4K UHD SMART TV;ELECTRONICA MAYOR
16800538;;F;34;CHILENO;;Millenial;N/D;N/D;129990;1;1;0;0;0;1;1;129990;SOUNDBAR SJ2;ELECTRONICA MAYOR
24450537;;F;69;COLOMBIANO;;Extranjero;ANTOFAGASTA                   ;ANTOFAGASTA;713340;4;2;0;0;0;4;2;713340;LED 50 UN50TU7090GXZS UHD SMART TV;ELECTRONICA MAYOR
14194361;;F;41;CHILENO;;X;N/D;N/D;197980;2;2;0;0;0;2;2;197980;LED 42 KHFH4221 SMART TV;ELECTRONICA MAYOR
13627648;;M;43;CHILENO;;X;LOS ALAMOS                    ;BIO BIO;295840;2;1;2;1;295840;0;0;0;LED 43 UN43TU7090GXZS UHD SMART TV;ELECTRONICA MAYOR
19166232;;F;26;CHILENO;;Z;"";"";239720;2;1;0;0;0;2;1;239720;LED 32 32S5295 SMART TV HD;ELECTRONICA MAYOR
18721206;;M;27;CHILENO;;Silencioso;PROVIDENCIA                   ;METROPOLITANA;383980;2;1;2;1;383980;0;0;0;LED 55UP7500 UHD SMART;ELECTRONICA MAYOR
13331688;;M;44;CHILENO;;X;RENCA                         ;METROPOLITANA;79990;1;1;0;0;0;1;1;79990;PARLANTE KARAOKE MGROKR NEGRO;ELECTRONICA MAYOR
16473168;;F;35;CHILENO;;Silencioso;PROVIDENCIA                   ;METROPOLITANA;541940;4;1;4;1;541940;0;0;0;LED 50 NanoCell 50NANO80 UHD SMART + MAGIC;ELECTRONICA MAYOR
20248739;;F;22;CHILENO;;Silencioso;PROVIDENCIA                   ;METROPOLITANA;519850;4;2;0;0;0;4;2;519850;LED 50 50UP7500 UHD SMART TV;ELECTRONICA MAYOR
8953974;;F;47;CHILENO;;Silencioso;PROVIDENCIA                   ;METROPOLITANA;313980;2;1;2;1;313980;0;0;0;LED 49 49UN7100 UHD SMART TV;ELECTRONICA MAYOR
13049331;;F;46;CHILENO;;X;GORBEA                        ;ARAUCANIA;224980;2;2;0;0;0;2;2;224980;PARLANTE MG TWISTER;ELECTRONICA MAYOR
10426500;;F;53;CHILENO;;X;SANTO DOMINGO                 ;VALPARAISO;21990;1;1;0;0;0;1;1;21990;KARAOKE STREET SONG 4 MICÂ CABLEÂ BLACK 8900;ELECTRONICA MAYOR
18645422;;F;28;CHILENO;;Millenial;N/D;N/D;184540;2;1;2;1;184540;0;0;0;LED 32 UN32T4300AGXZS HD SMART TV;ELECTRONICA MAYOR
26520375;;F;26;CHILENO;;Extranjero;N/D;N/D;169990;1;1;0;0;0;1;1;169990;LED 42 KHFH4221 SMART TV;ELECTRONICA MAYOR
12296357;Casado;F;50;CHILENO;;X;RENCA                         ;METROPOLITANA;179990;1;1;1;1;179990;0;0;0;LED 32 UN32T4300AGXZS HD SMART TV;ELECTRONICA MAYOR
13318757;;M;45;CHILENO;;X;PADRE LAS CASAS               ;ARAUCANIA;237910;2;1;0;0;0;2;1;237910;MINICOMPONENTE RN7;ELECTRONICA MAYOR
18775991;;F;27;CHILENO;;Silencioso;PROVIDENCIA                   ;METROPOLITANA;243980;2;1;2;1;243980;0;0;0;LED 40 UN40T5290AGXZS FHD SMART TV;ELECTRONICA MAYOR
16909933;;F;34;CHILENO;;Millenial;N/D;N/D;173980;2;1;2;1;173980;0;0;0;LED 32 UN32T4300AGXZS HD SMART TV;ELECTRONICA MAYOR
13600426;;F;42;CHILENO;;X;LINARES                       ;MAULE;225470;3;2;3;2;225470;0;0;0;LED 43 43S5305 SMART TV FULL HD;ELECTRONICA MAYOR
11155910;;F;54;CHILENO;;Boomers;LOS ANGELES                   ;BIO BIO;275830;3;2;3;2;275830;0;0;0;LED 32 KHHD3221 SMART TV;ELECTRONICA MAYOR
15117457;;M;39;CHILENO;;X;SAN FERNANDO                  ;L.G.B.OÂ´HIGGINS;179990;1;1;0;0;0;1;1;179990;LED 42 KHFH4221 SMART TV;ELECTRONICA MAYOR
20090766;;M;23;CHILENO;;Z;PROVIDENCIA                   ;METROPOLITANA;197540;2;1;2;1;197540;0;0;0;LED 42 KHFH4221 SMART TV;ELECTRONICA MAYOR
10569381;;F;53;CHILENO;;X;N/D;N/D;54990;1;1;0;0;0;1;1;54990;PARLANTE KARAOKE 12 FM/BT/USB;ELECTRONICA MAYOR
15750901;;F;38;CHILENO;;X;VALPARAISO                    ;VALPARAISO;139980;2;1;2;1;139980;0;0;0;LED 32 CS32S1 SMART TV HD NEGRO;ELECTRONICA MAYOR
17058509;;F;34;CHILENO;;Millenial;N/D;N/D;169990;1;1;0;0;0;1;1;169990;LED 42 KHFH4221 SMART TV;ELECTRONICA MAYOR
12087359;;M;57;CHILENO;;Boomers;CURICO                        ;MAULE;312560;3;1;0;0;0;3;1;312560;LED 43 43S5305 SMART TV FULL HD;ELECTRONICA MAYOR
9605464;Soltero;M;57;CHILENO;;Boomers;PROVIDENCIA                   ;METROPOLITANA;457870;2;1;0;0;0;2;1;457870;LED 55 UN55TU7090GXZS SMART TV UHD;ELECTRONICA MAYOR
19242236;Soltero;M;26;CHILENO;;Z;PROVIDENCIA                   ;METROPOLITANA;119990;1;1;0;0;0;1;1;119990;MINICOMPONENTE OL45;ELECTRONICA MAYOR
6017154;;F;73;CHILENO;;Silencioso;RENCA                         ;METROPOLITANA;397870;2;1;0;0;0;2;1;397870;LED 50 UN50TU7090GXZS UHD SMART TV;ELECTRONICA MAYOR
15845085;;F;37;CHILENO;;Millenial;PROVIDENCIA                   ;METROPOLITANA;219990;2;1;2;1;219990;0;0;0;LED 43 43S5305 SMART TV FULL HD;ELECTRONICA MAYOR
9394760;;M;59;CHILENO;;Boomers;RENCA                         ;METROPOLITANA;600870;2;1;0;0;0;2;1;600870;LED 60UP7750 UHD SMART + MAGIC;ELECTRONICA MAYOR
18046255;;F;30;CHILENO;;Millenial;PROVIDENCIA                   ;METROPOLITANA;143980;2;1;2;1;143980;0;0;0;LED 32 KHHD3221 SMART TV;ELECTRONICA MAYOR
16228975;;M;37;CHILENO;;Millenial;N/D;N/D;585830;3;2;2;1;295840;1;1;289990;LED 43 UN43TU7090GXZS UHD SMART TV;ELECTRONICA MAYOR
18235061;Soltero;F;29;CHILENO;;Millenial;PROVIDENCIA                   ;METROPOLITANA;313980;2;1;2;1;313980;0;0;0;LED 43 43UP7500 UHD SMART TV;ELECTRONICA MAYOR
17876288;;M;31;CHILENO;;Silencioso;PROVIDENCIA                   ;METROPOLITANA;168980;2;1;2;1;168980;0;0;0;LED 32 32S60-32P ANDROID TV SMART LINE HD;ELECTRONICA MAYOR
20410206;;M;22;CHILENO;;Z;PROVIDENCIA                   ;METROPOLITANA;308640;2;1;2;1;308640;0;0;0;LED 50 50PUD6513/44 SMART TV UHD 4K;ELECTRONICA MAYOR
19509933;;M;25;CHILENO;;Z;N/D;N/D;319990;1;1;0;0;0;1;1;319990;LED 50 50U6305 SMART TV ULTRA HD;ELECTRONICA MAYOR
17230821;;F;40;CHILENO;;X;INDEPENDENCIA                 ;METROPOLITANA;368820;3;1;0;0;0;3;1;368820;LED 40 UN40T5290AGXZS FHD SMART TV;ELECTRONICA MAYOR
4901950;;M;80;CHILENO;;Silencioso;RENCA                         ;METROPOLITANA;297870;2;1;0;0;0;2;1;297870;LED 43 43S5305 SMART TV FULL HD;ELECTRONICA MAYOR
12525082;;M;49;CHILENO;;X;PROVIDENCIA                   ;METROPOLITANA;159670;2;1;0;0;0;2;1;159670;KARAOKE SP-101BT ALL IN ONE PORTATIL 60W;ELECTRONICA MAYOR
7387921;;M;65;CHILENO;;Boomers;RENCA                         ;METROPOLITANA;247910;2;1;0;0;0;2;1;247910;MINICOMPONENTE RN7;ELECTRONICA MAYOR
13205841;;M;44;CHILENO;;X;PROVIDENCIA                   ;METROPOLITANA;339990;1;1;0;0;0;1;1;339990;LED 49 49UN7100 UHD SMART TV;ELECTRONICA MAYOR
17952228;;M;30;CHILENO;;Millenial;PROVIDENCIA                   ;METROPOLITANA;343980;2;1;2;1;343980;0;0;0;LED 50 UN50TU7090GXZS UHD SMART TV;ELECTRONICA MAYOR
12067926;;M;52;CHILENO;;X;PROVIDENCIA                   ;METROPOLITANA;797210;2;1;0;0;0;2;1;797210;LED 70 70PUD7625 SMART TV ULTRA HD;ELECTRONICA MAYOR
6762351;Casado;F;66;CHILENO;;Boomers;RENCA                         ;METROPOLITANA;383770;2;1;0;0;0;2;1;383770;LED 49 49UN7100 UHD SMART TV;ELECTRONICA MAYOR
7265799;;F;69;CHILENO;;Silencioso;TALCAHUANO                    ;BIO BIO;381550;4;1;0;0;0;4;1;381550;LED 32LM637B HD SMART;ELECTRONICA MAYOR
5261179;;M;77;CHILENO;;Silencioso;LO ESPEJO                     ;METROPOLITANA;304570;2;1;0;0;0;2;1;304570;LED 40 UN40T5290AGXZS FHD SMART TV;ELECTRONICA MAYOR
12713903;;F;48;CHILENO;;Silencioso;PROVIDENCIA                   ;METROPOLITANA;223470;2;1;0;0;0;2;1;223470;MINICOMPONENTE RN7;ELECTRONICA MAYOR
13016015;;M;45;CHILENO;;Silencioso;PROVIDENCIA                   ;METROPOLITANA;269990;1;1;0;0;0;1;1;269990;LED 40 UN40T5290AGXZS FHD SMART TV;ELECTRONICA MAYOR
10749260;;F;56;CHILENO;;Boomers;PANGUIPULLI                   ;LOS RIOS;153060;3;1;0;0;0;3;1;153060;LED 32 KHHD3221 SMART TV;ELECTRONICA MAYOR
13277751;;M;45;CHILENO;;X;CERRO NAVIA                   ;METROPOLITANA;89990;1;1;0;0;0;1;1;89990;PARLANTE ULTRAMEGA;ELECTRONICA MAYOR
8050681;Soltero;F;68;CHILENO;;Boomers;RENCA                         ;METROPOLITANA;552960;3;1;0;0;0;3;1;552960;LED 55 55UP7750 UHD SMART + MAGIC;ELECTRONICA MAYOR
13965444;;M;41;CHILENO;;Millenial;N/D;N/D;719990;1;1;0;0;0;1;1;719990;OLED 55 A1 UHD SMART + MAGIC;ELECTRONICA MAYOR
7472223;;M;65;CHILENO;;Boomers;PROVIDENCIA                   ;METROPOLITANA;209990;1;1;0;0;0;1;1;209990;LED 32LM637B HD SMART;ELECTRONICA MAYOR
17360878;;F;31;CHILENO;;Millenial;LA ESTRELLA                   ;L.G.B.OÂ´HIGGINS;46980;2;2;0;0;0;2;2;46980;KARAOKE RHYTHM CHARGER 12 MIC CABLE 8890;ELECTRONICA MAYOR
18970957;;F;26;CHILENO;;Z;N/D;N/D;421980;2;1;2;1;421980;0;0;0;LED 55 55UP7750 UHD SMART + MAGIC;ELECTRONICA MAYOR
15835176;;M;38;CHILENO;;Millenial;CONSTITUCION                  ;MAULE;119990;1;1;0;0;0;1;1;119990;SOUNDBAR SJ2;ELECTRONICA MAYOR
25830679;;F;36;EXTRANJERO - NO INFORMA NACIONALIDAD;;Extranjero;SANTIAGO                      ;METROPOLITANA;491870;2;3;0;0;0;2;3;491870;LED 50 50NANO75 NanoCell UHD SMART + MAGIC;ELECTRONICA MAYOR
8989718;Casado;M;61;CHILENO;;Boomers;LOTA                          ;BIO BIO;126770;2;1;0;0;0;2;1;126770;PARLANTE KARAOKE MGROKR NEGRO;ELECTRONICA MAYOR
9631719;;F;60;CHILENO;;Boomers;ERCILLA                       ;ARAUCANIA;355970;4;2;0;0;0;4;2;355970;LED 32 KHHD3221 SMART TV;ELECTRONICA MAYOR
14221156;;F;41;CHILENO;;X;FREIRE                        ;ARAUCANIA;447870;2;1;0;0;0;2;1;447870;LED 55UP7500 UHD SMART;ELECTRONICA MAYOR
6687622;;F;73;CHILENO;;Silencioso;SAN FERNANDO                  ;L.G.B.OÂ´HIGGINS;162470;2;1;0;0;0;2;1;162470;MINICOMPONENTE MHC-V02 ALL IN ONE;ELECTRONICA MAYOR
10327123;;M;56;CHILENO;;Boomers;RENGO                         ;L.G.B.OÂ´HIGGINS;74990;1;1;0;0;0;1;1;74990;SOUNDBAR XTS-801 Negro 40W;ELECTRONICA MAYOR
15985048;;F;37;CHILENO;;Millenial;VALDIVIA                      ;LOS RIOS;268540;2;1;2;1;268540;0;0;0;LED 40 UN40T5290AGXZS FHD SMART TV;ELECTRONICA MAYOR
14036542;;F;41;CHILENO;;X;N/D;N/D;79990;1;1;0;0;0;1;1;79990;PARLANTE ULTRAMAGIC;ELECTRONICA MAYOR
12303978;;M;49;CHILENO;;X;TOME                          ;BIO BIO;195840;2;1;2;1;195840;0;0;0;LED 32 UN32T4300AGXZS HD SMART TV;ELECTRONICA MAYOR
6825833;;M;70;CHILENO;;Silencioso;ANCUD                         ;LOS LAGOS;213470;2;1;0;0;0;2;1;213470;MINICOMPONENTE RN7;ELECTRONICA MAYOR
4145070;;M;84;CHILENO;;Silencioso;ANGOL                         ;ARAUCANIA;309980;2;1;0;0;0;2;1;309980;LED 43 UN43TU7090GXZS UHD SMART TV;ELECTRONICA MAYOR
16460776;Casado;F;35;CHILENO;;Millenial;RENCA                         ;METROPOLITANA;267870;2;1;0;0;0;2;1;267870;LED 43 CS43F2 SMART TV FHD NEGRO;ELECTRONICA MAYOR
13768091;;M;42;CHILENO;;X;SAN ANTONIO                   ;VALPARAISO;127370;2;1;0;0;0;2;1;127370;PARLANTE ULTRAMEGA;ELECTRONICA MAYOR
10594174;;F;54;CHILENO;;X;PUREN                         ;ARAUCANIA;95960;4;3;0;0;0;4;3;95960;MINICOMPONENTE RN7;ELECTRONICA MAYOR
15087581;;M;40;CHILENO;;X;PROVIDENCIA                   ;METROPOLITANA;169990;1;1;0;0;0;1;1;169990;LED 32 KHHD3221 SMART TV;ELECTRONICA MAYOR
15141249;;F;39;CHILENO;;X;SAN CLEMENTE                  ;MAULE;159750;5;1;0;0;0;5;1;159750;LED 32 KHHD3221 SMART TV;ELECTRONICA MAYOR
7767357;;M;65;CHILENO;;Boomers;VALPARAISO                    ;VALPARAISO;134980;2;1;2;1;134980;0;0;0;LED 32 KHHD3221 SMART TV;ELECTRONICA MAYOR
6774424;;F;73;CHILENO;;Silencioso;COPIAPO                       ;ATACAMA;429990;2;1;0;0;0;2;1;429990;LED 55 55P615 UHD ANDROID TV 4K;ELECTRONICA MAYOR
12616522;;M;47;CHILENO;;X;RENCA                         ;METROPOLITANA;139990;1;1;0;0;0;1;1;139990;MINICOMPONENTE CJ45;ELECTRONICA MAYOR
17860143;;F;30;CHILENO;;Millenial;PROVIDENCIA                   ;METROPOLITANA;209990;1;1;0;0;0;1;1;209990;LED 32LM637B HD SMART;ELECTRONICA MAYOR
14563039;;F;48;CHILENO;;X;N/D;N/D;44990;1;1;0;0;0;1;1;44990;KARAOKE RHYTHM CHARGER 12 MIC CABLE 8890;ELECTRONICA MAYOR
16051797;;F;37;CHILENO;;Millenial;VICTORIA                      ;ARAUCANIA;179570;2;1;0;0;0;2;1;179570;LED 32 KHHD3221 SMART TV;ELECTRONICA MAYOR
10663191;;F;56;CHILENO;;Boomers;COIHAIQUE                     ;AYSEN;339990;1;1;0;0;0;1;1;339990;LED 50 UN50TU7090GXZS UHD SMART TV;ELECTRONICA MAYOR
16331681;;F;35;CHILENO;;Millenial;PROVIDENCIA                   ;METROPOLITANA;659980;2;1;2;1;659980;0;0;0;LED 70 UN70AU7000GXZS UHD;ELECTRONICA MAYOR
8502188;Casado;F;51;CHILENO;INGENIERO;X;PROVIDENCIA                   ;METROPOLITANA;354170;2;1;0;0;0;2;1;354170;LED 40 UN40T5290AGXZS FHD SMART TV;ELECTRONICA MAYOR
10282685;;F;58;CHILENO;;Boomers;OVALLE                        ;COQUIMBO;59990;1;1;0;0;0;1;1;59990;SISTEMA DE SONIDO CM1560;ELECTRONICA MAYOR
17233391;;M;36;CHILENO;;Millenial;COIHAIQUE                     ;AYSEN;0;0;2;0;0;0;0;2;0;SOUNDBAR HT-S100F;ELECTRONICA MAYOR
15495845;Soltero;F;38;CHILENO;;X;PROVIDENCIA                   ;METROPOLITANA;0;0;0;0;0;0;0;0;0;KARAOKE PORTATIL TWO-EIGHT 8860;ELECTRONICA MAYOR
8942727;;M;61;CHILENO;;Boomers;RENCA                         ;METROPOLITANA;0;0;0;0;0;0;0;0;0;MINICOMPONENTE OL45;ELECTRONICA MAYOR
17799948;Soltero;M;31;CHILENO;;Millenial;PROVIDENCIA                   ;METROPOLITANA;0;0;0;0;0;0;0;0;0;MAGIC REMOTE MR20GA;ELECTRONICA MAYOR
8932480;Casado;M;60;CHILENO;MANTENIMIENTO INDUSTRIAL;Boomers;CASTRO                        ;LOS LAGOS;0;0;0;0;0;0;0;0;0;LED 50 50U6305 SMART TV ULTRA HD;ELECTRONICA MAYOR
23872318;;F;44;DOMINICANO;;Extranjero;N/D;N/D;0;0;0;0;0;0;0;0;0;LED 43 Full HD Smart TV 43PFD6825;ELECTRONICA MAYOR
8773507;;M;62;CHILENO;;Boomers;PICHILEMU                     ;L.G.B.OÂ´HIGGINS;0;0;0;0;0;0;0;0;0;MINICOMPONENTE CJ45;ELECTRONICA MAYOR
15202394;;M;41;CHILENO;;X;TIRUA                         ;BIO BIO;0;0;0;0;0;0;0;0;0;LED 40 UN40T5290AGXZS FHD SMART TV;ELECTRONICA MAYOR
5554861;;M;74;CHILENO;;Silencioso;PUENTE ALTO                   ;METROPOLITANA;0;0;0;0;0;0;0;0;0;LED 43 43UP7500 UHD SMART TV;ELECTRONICA MAYOR
16826719;;M;34;CHILENO;;Silencioso;CURICO                        ;MAULE;0;0;0;0;0;0;0;0;0;LED 32 CS32S1 SMART TV HD NEGRO;ELECTRONICA MAYOR
10649889;Casado;F;57;CHILENO;;Boomers;PROVIDENCIA                   ;METROPOLITANA;0;0;0;0;0;0;0;0;0;LED 40 UN40T5290AGXZS FHD SMART TV;ELECTRONICA MAYOR
4889865;;F;83;CHILENO;;Silencioso;MAIPU                         ;METROPOLITANA;0;0;0;0;0;0;0;0;0;MINICOMPONENTE OL45;ELECTRONICA MAYOR
9336068;;F;57;CHILENO;;Boomers;N/D;N/D;0;0;0;0;0;0;0;0;0;LED 55 UN55TU7090GXZS SMART TV UHD;ELECTRONICA MAYOR
5287217;Casado;M;74;CHILENO;PROFESOR;Silencioso;CHILLAN                       ;BIO BIO;0;0;0;0;0;0;0;0;0;MONITOR 24 24TL520S SMART TV HD;ELECTRONICA MAYOR
20095042;;M;23;CHILENO;;Silencioso;PROVIDENCIA                   ;METROPOLITANA;0;0;0;0;0;0;0;0;0;KARAOKE PORTATIL TWO-EIGHT 8860;ELECTRONICA MAYOR
9457265;;M;59;CHILENO;;Boomers;GRANEROS                      ;L.G.B.OÂ´HIGGINS;0;0;0;0;0;0;0;0;0;SOUNDBAR SK1D;ELECTRONICA MAYOR
14469395;;M;47;CHILENO;;X;CORONEL                       ;BIO BIO;0;0;0;0;0;0;0;0;0;MINICOMPONENTE OL45;ELECTRONICA MAYOR
15766475;;F;37;CHILENO;;Millenial;QUINTERO                      ;VALPARAISO;0;0;0;0;0;0;0;0;0;MINICOMPONENTE MX-T50/ZS ALL IN ONE;ELECTRONICA MAYOR
17469120;Soltero;M;32;CHILENO;INGENIERO EN MAQUINARIA;Millenial;PROVIDENCIA                   ;METROPOLITANA;0;0;0;0;0;0;0;0;0;SOUNDBAR HW-T450/ZS;ELECTRONICA MAYOR
9411196;Casado;F;61;CHILENO;;Boomers;RENCA                         ;METROPOLITANA;0;0;0;0;0;0;0;0;0;MINICOMPONENTE OL45;ELECTRONICA MAYOR
26394456;;M;35;VENEZOLANO;;Extranjero;N/D;N/D;0;0;0;0;0;0;0;0;0;LED 40 UN40T5290AGXZS FHD SMART TV;ELECTRONICA MAYOR
12120103;;M;50;CHILENO;;X;PADRE HURTADO                 ;METROPOLITANA;0;0;0;0;0;0;0;0;0;LED 43 CS43F2 SMART TV FHD NEGRO;ELECTRONICA MAYOR
8838314;;F;67;CHILENO;;Boomers;CONTULMO                      ;BIO BIO;0;0;0;0;0;0;0;0;0;LED 50 UN50TU7090GXZS UHD SMART TV;ELECTRONICA MAYOR
13372459;;M;44;CHILENO;;X;RENCA                         ;METROPOLITANA;0;0;0;0;0;0;0;0;0;MINICOMPONENTE RN7;ELECTRONICA MAYOR
7163186;;M;65;CHILENO;;Silencioso;PROVIDENCIA                   ;METROPOLITANA;0;0;0;0;0;0;0;0;0;MINICOMPONENTE RN9;ELECTRONICA MAYOR
10395112;;F;58;CHILENO;;Boomers;CERRO NAVIA                   ;METROPOLITANA;0;0;0;0;0;0;0;0;0;LED 55UP7500 UHD SMART;ELECTRONICA MAYOR
12941067;;M;46;CHILENO;;X;RENCA                         ;METROPOLITANA;0;0;0;0;0;0;0;0;0;LED 42 42S6500 ANDROID TV FHD;ELECTRONICA MAYOR
13726286;;M;43;CHILENO;;X;PROVIDENCIA                   ;METROPOLITANA;0;0;0;0;0;0;0;0;0;SOUNDBAR HT-S100F;ELECTRONICA MAYOR
13169137;;M;45;CHILENO;;X;QUEMCHI                       ;LOS LAGOS;0;0;0;0;0;0;0;0;0;LED 50 50U6295 SMART TV UHD;ELECTRONICA MAYOR
16575283;;F;34;CHILENO;;Millenial;"";"";0;0;0;0;0;0;0;0;0;MAGIC REMOTE MR20GA;ELECTRONICA MAYOR
14157338;;M;41;CHILENO;;X;SAN BERNARDO                  ;METROPOLITANA;0;0;0;0;0;0;0;0;0;LED 55 UN55TU7090GXZS SMART TV UHD;ELECTRONICA MAYOR
19330535;;M;26;CHILENO;;Z;N/D;N/D;0;0;0;0;0;0;0;0;0;LED 50 50U6305 SMART TV ULTRA HD;ELECTRONICA MAYOR
15257227;;F;40;CHILENO;;X;LONCOCHE                      ;ARAUCANIA;0;0;0;0;0;0;0;0;0;LED 32 CS32S1 SMART TV HD NEGRO;ELECTRONICA MAYOR
19868756;;F;24;CHILENO;;Z;N/D;N/D;0;0;0;0;0;0;0;0;0;LED 60 UN60AU8000GXZS UHD SMART TV;ELECTRONICA MAYOR
11939316;Soltero;M;50;CHILENO;;X;N/D;N/D;0;0;0;0;0;0;0;0;0;LED 50 KEUH50 SMART TV UHD;ELECTRONICA MAYOR
17660011;Soltero;F;30;CHILENO;;Millenial;PROVIDENCIA                   ;METROPOLITANA;0;0;0;0;0;0;0;0;0;LED 43 Full HD Smart TV 43PFD6825;ELECTRONICA MAYOR
7191431;;M;68;CHILENO;;Silencioso;SAN RAMON                     ;METROPOLITANA;0;0;0;0;0;0;0;0;0;LED 43 43UP7500 UHD SMART TV;ELECTRONICA MAYOR
6708171;;M;69;CHILENO;;Silencioso;PROVIDENCIA                   ;METROPOLITANA;0;0;0;0;0;0;0;0;0;MINICOMPONENTE OL45;ELECTRONICA MAYOR
9500461;;M;59;CHILENO;;Boomers;NANCAGUA                      ;L.G.B.OÂ´HIGGINS;0;0;0;0;0;0;0;0;0;LED 40 KEHD4020 SMART TV;ELECTRONICA MAYOR
16497445;;F;35;CHILENO;;Millenial;PROVIDENCIA                   ;METROPOLITANA;0;0;0;0;0;0;0;0;0;LED 60 UN60AU8000GXZS UHD SMART TV;ELECTRONICA MAYOR
17445649;;F;31;CHILENO;;Silencioso;PROVIDENCIA                   ;METROPOLITANA;0;0;0;0;0;0;0;0;0;PARLANTE ULTRASENSATION;ELECTRONICA MAYOR
15542018;Soltero;M;38;CHILENO;;X;PROVIDENCIA                   ;METROPOLITANA;0;0;0;0;0;0;0;0;0;LED 50 50U6305 SMART TV ULTRA HD;ELECTRONICA MAYOR
18265583;;F;28;CHILENO;;Millenial;IQUIQUE                       ;TARAPACA;0;0;0;0;0;0;0;0;0;LED KIOTO 32 MI3228 SMART TV;ELECTRONICA MAYOR
16427905;;F;35;CHILENO;;Millenial;PROVIDENCIA                   ;METROPOLITANA;0;0;0;0;0;0;0;0;0;LED 32LM637B HD SMART;ELECTRONICA MAYOR
11042446;;M;56;CHILENO;;Boomers;PROVIDENCIA                   ;METROPOLITANA;0;0;0;0;0;0;0;0;0;PARLANTE ULTRAFORCE-I;ELECTRONICA MAYOR
16087636;Soltero;M;36;CHILENO;ADMINISTRADOR PUBLICO;Millenial;PROVIDENCIA                   ;METROPOLITANA;0;0;0;0;0;0;0;0;0;LED 50 UN50TU7090GXZS UHD SMART TV;ELECTRONICA MAYOR
26221692;;M;55;EXTRANJERO - NO INFORMA NACIONALIDAD;;Extranjero;COLINA                        ;METROPOLITANA;0;0;0;0;0;0;0;0;0;LED 32 UN32T4300AGXZS HD SMART TV;ELECTRONICA MAYOR
18665948;;M;28;CHILENO;;Silencioso;PUENTE ALTO                   ;METROPOLITANA;0;0;0;0;0;0;0;0;0;QLED 50 QN50Q60AAGXZS 4K UHD SMART TV;ELECTRONICA MAYOR
9708861;;M;58;CHILENO;;Boomers;PROVIDENCIA                   ;METROPOLITANA;0;0;0;0;0;0;0;0;0;LED 43 UN43T5202AGXZS FHD SMART TV;ELECTRONICA MAYOR
10533312;;M;56;CHILENO;;Boomers;SANTIAGO                      ;METROPOLITANA;0;0;0;0;0;0;0;0;0;SISTEMA DE SONIDO CM1560;ELECTRONICA MAYOR
19122146;;M;26;CHILENO;;Z;CALERA DE TANGO               ;METROPOLITANA;0;0;0;0;0;0;0;0;0;LED 49 49UN7100 UHD SMART TV;ELECTRONICA MAYOR
14041814;;F;40;CHILENO;;X;ANCUD                         ;LOS LAGOS;0;0;0;0;0;0;0;0;0;LED 43 43S5295 SMART TV FHD;ELECTRONICA MAYOR
17795625;;F;31;CHILENO;;Millenial;CURICO                        ;MAULE;0;0;0;0;0;0;0;0;0;LED 40 KEHD4020 SMART TV;ELECTRONICA MAYOR
16768010;;F;34;CHILENO;;Millenial;"";"";0;0;0;0;0;0;0;0;0;PARLANTE ULTRAMAGIC;ELECTRONICA MAYOR
10763534;;F;59;CHILENO;;Boomers;RENCA                         ;METROPOLITANA;0;0;0;0;0;0;0;0;0;LED 50 UN50TU7090GXZS UHD SMART TV;ELECTRONICA MAYOR
11880796;;F;51;CHILENO;;X;RENCA                         ;METROPOLITANA;0;0;0;0;0;0;0;0;0;LED 50 UN50TU7090GXZS UHD SMART TV;ELECTRONICA MAYOR
9539577;;F;60;CHILENO;;Boomers;RENCA                         ;METROPOLITANA;0;0;0;0;0;0;0;0;0;LED KIOTO 32 MI3228 SMART TV;ELECTRONICA MAYOR
10109093;;M;57;CHILENO;;Boomers;TIERRA AMARILLA               ;ATACAMA;0;0;0;0;0;0;0;0;0;PARLANTE ULTRASENSATION;ELECTRONICA MAYOR
26662569;Soltero;F;43;VENEZOLANO;;Extranjero;ANTOFAGASTA;ANTOFAGASTA;0;0;0;0;0;0;0;0;0;LED 50 UN50TU7090GXZS UHD SMART TV;ELECTRONICA MAYOR
11334666;;F;55;CHILENO;;Boomers;PARRAL                        ;MAULE;0;0;0;0;0;0;0;0;0;LED 50 KEUH50 SMART TV UHD;ELECTRONICA MAYOR
16028088;;M;37;CHILENO;;Silencioso;PROVIDENCIA                   ;METROPOLITANA;0;0;0;0;0;0;0;0;0;LED 40 KEHD4020 SMART TV;ELECTRONICA MAYOR
7926849;;M;63;CHILENO;;Boomers;RENCA                         ;METROPOLITANA;0;0;0;0;0;0;0;0;0;LED 40 KEHD4020 SMART TV;ELECTRONICA MAYOR
16436194;;F;36;CHILENO;;Millenial;PROVIDENCIA                   ;METROPOLITANA;0;0;0;0;0;0;0;0;0;PARLANTE ULTRAFORCE-I;ELECTRONICA MAYOR
17426244;Soltero;M;32;CHILENO;;Millenial;PROVIDENCIA                   ;METROPOLITANA;0;0;0;0;0;0;0;0;0;LED 50 UN50TU7090GXZS UHD SMART TV;ELECTRONICA MAYOR
7952496;;M;64;CHILENO;;Boomers;PROVIDENCIA                   ;METROPOLITANA;0;0;0;0;0;0;0;0;0;KARAOKE STREET SONG 4 MICÂ CABLEÂ BLACK 8900;ELECTRONICA MAYOR
16468114;Casado;F;35;CHILENO;PROFESOR;Millenial;ARICA                         ;ARICA Y PARINACOTA;0;0;0;0;0;0;0;0;0;LED 70 UN70AU7000GXZS UHD;ELECTRONICA MAYOR
16991207;;M;33;CHILENO;;Millenial;LOS ANDES                     ;VALPARAISO;0;0;0;0;0;0;0;0;0;MINICOMPONENTE OL45;ELECTRONICA MAYOR
7807067;;M;58;CHILENO;;Silencioso;PROVIDENCIA                   ;METROPOLITANA;0;0;0;0;0;0;0;0;0;MINICOMPONENTE MX-T40/ZS ALL IN ONE;ELECTRONICA MAYOR
14472451;;M;46;CHILENO;;X;CORONEL                       ;BIO BIO;0;0;0;0;0;0;0;0;0;MINICOMPONENTE RN7;ELECTRONICA MAYOR
13295521;;F;45;CHILENO;;X;BUIN                          ;METROPOLITANA;0;0;0;0;0;0;0;0;0;LED KIOTO 32 MI3228 SMART TV;ELECTRONICA MAYOR
13693551;;F;43;CHILENO;;X;RENCA                         ;METROPOLITANA;0;0;0;0;0;0;0;0;0;LED 43 43PFD5813 SMART TV FULL HD;ELECTRONICA MAYOR
15324449;;F;40;CHILENO;;X;PUENTE ALTO                   ;METROPOLITANA;0;0;0;0;0;0;0;0;0;LED 50 UN50TU7090GXZS UHD SMART TV;ELECTRONICA MAYOR
10941957;;M;55;CHILENO;;Boomers;N/D;N/D;0;0;0;0;0;0;0;0;0;PARLANTE ULTRASENSATION;ELECTRONICA MAYOR
18333816;Soltero;M;29;CHILENO;PROFESOR;Millenial;RENCA                         ;METROPOLITANA;0;0;0;0;0;0;0;0;0;LED 32LM637B HD SMART;ELECTRONICA MAYOR
17115828;;F;33;CHILENO;;Millenial;VILLARRICA;ARAUCANIA;0;0;0;0;0;0;0;0;0;LED 50 UN50TU7090GXZS UHD SMART TV;ELECTRONICA MAYOR
11985694;;F;50;CHILENO;;X;PENCO                         ;BIO BIO;0;0;0;0;0;0;0;0;0;LED 55 55UP7750 UHD SMART + MAGIC;ELECTRONICA MAYOR
12543472;;M;47;CHILENO;;X;SAN CLEMENTE                  ;MAULE;0;0;0;0;0;0;0;0;0;LED 50 50P615-50P ANDROID TV PASSION LINE UHD 4K;ELECTRONICA MAYOR
16042797;;F;37;CHILENO;;Silencioso;PROVIDENCIA                   ;METROPOLITANA;0;0;0;0;0;0;0;0;0;LED 50 UN50TU7090GXZS UHD SMART TV;ELECTRONICA MAYOR
9809947;Soltero;M;56;CHILENO;;Boomers;RENCA                         ;METROPOLITANA;0;0;0;0;0;0;0;0;0;LED 32 CS32S1 SMART TV HD NEGRO;ELECTRONICA MAYOR
10163002;Casado;F;53;CHILENO;;X;PROVIDENCIA                   ;METROPOLITANA;0;0;0;0;0;0;0;0;0;LED 50 UN50TU7090GXZS UHD SMART TV;ELECTRONICA MAYOR
6714764;;M;70;CHILENO;;Silencioso;CONTULMO                      ;BIO BIO;0;0;0;0;0;0;0;0;0;LED 55 55P615 UHD ANDROID TV 4K;ELECTRONICA MAYOR
12826202;;M;47;CHILENO;;X;N/D;N/D;0;0;0;0;0;0;0;0;0;LED KIOTO 32 MI3228 SMART TV;ELECTRONICA MAYOR
11837136;;M;51;CHILENO;;X;N/D;N/D;0;0;0;0;0;0;0;0;0;LED 40 KEHD4020 SMART TV;ELECTRONICA MAYOR
16514290;;F;35;CHILENO;;Millenial;SAN PEDRO DE LA PAZ           ;BIO BIO;0;0;0;0;0;0;0;0;0;KARAOKE BLACK PHANTER II;ELECTRONICA MAYOR
12583221;Casado;F;49;CHILENO;;X;RENCA                         ;METROPOLITANA;0;0;0;0;0;0;0;0;0;LED 50 KEUH50 SMART TV UHD;ELECTRONICA MAYOR
9121279;;M;59;CHILENO;;Boomers;PROVIDENCIA                   ;METROPOLITANA;0;0;0;0;0;0;0;0;0;LED 55 55UN7100 UHD SMART TV;ELECTRONICA MAYOR
19413322;;M;26;CHILENO;;Z;N/D;N/D;0;0;0;0;0;0;0;0;0;SOUNDBAR HW-T450/ZS;ELECTRONICA MAYOR
18457728;Soltero;M;28;CHILENO;;Millenial;PROVIDENCIA                   ;METROPOLITANA;0;0;0;0;0;0;0;0;0;LED 43 UN43TU7090GXZS UHD SMART TV;ELECTRONICA MAYOR
17477408;;M;32;CHILENO;;Millenial;RANCAGUA;O HIGGINS;0;0;0;0;0;0;0;0;0;LED 49 49UN7100 UHD SMART TV;ELECTRONICA MAYOR
19343303;Soltero;M;26;CHILENO;;Silencioso;PROVIDENCIA                   ;METROPOLITANA;0;0;0;0;0;0;0;0;0;LED 50 50NANO75 NanoCell UHD SMART + MAGIC;ELECTRONICA MAYOR
10652365;;F;48;CHILENO;;X;PROVIDENCIA                   ;METROPOLITANA;0;0;0;0;0;0;0;0;0;LED 49 49UN7100 UHD SMART TV;ELECTRONICA MAYOR
15045922;;F;39;CHILENO;;X;PROVIDENCIA                   ;METROPOLITANA;0;0;0;0;0;0;0;0;0;LED 32 UN32T4300AGXZS HD SMART TV;ELECTRONICA MAYOR
22080286;;F;55;PERUANO;;Extranjero;NATALES                       ;MAGALLANES;0;0;0;0;0;0;0;0;0;LED 49 49UN7100 UHD SMART TV;ELECTRONICA MAYOR
14160287;;F;41;CHILENO;;X;QUINTA NORMAL                 ;METROPOLITANA;0;0;0;0;0;0;0;0;0;LED 32 32LM630BPSB SMART TV;ELECTRONICA MAYOR
19379586;;F;24;CHILENO;;Z;PROVIDENCIA                   ;METROPOLITANA;0;0;0;0;0;0;0;0;0;LED 43 Full HD Smart TV 43PFD6825;ELECTRONICA MAYOR
13356307;Soltero;M;43;CHILENO;INGENIERO AGRICOLA;X;PROVIDENCIA                   ;METROPOLITANA;0;0;0;0;0;0;0;0;0;LED KIOTO 32 MI3228 SMART TV;ELECTRONICA MAYOR
10519996;;F;54;CHILENO;;Boomers;PROVIDENCIA                   ;METROPOLITANA;0;0;0;0;0;0;0;0;0;MINICOMPONENTE MX-T40/ZS ALL IN ONE;ELECTRONICA MAYOR
19453481;;F;41;CHILENO;;X;PELLUHUE                      ;MAULE;0;0;0;0;0;0;0;0;0;LED 50 50PUD6513/44 SMART TV UHD 4K;ELECTRONICA MAYOR
17649496;;M;31;CHILENO;;Millenial;CURACO DE VELEZ               ;LOS LAGOS;0;0;0;0;0;0;0;0;0;MINICOMPONENTE MX-T50/ZS ALL IN ONE;ELECTRONICA MAYOR
12944013;Soltero;F;45;CHILENO;;X;SANTIAGO                      ;METROPOLITANA;0;0;0;0;0;0;0;0;0;LED 43 43LM6300PSB SMART TV HD;ELECTRONICA MAYOR
19027245;;F;27;CHILENO;;Z;PROVIDENCIA                   ;METROPOLITANA;0;0;0;0;0;0;0;0;0;LED 50 UN50TU7090GXZS UHD SMART TV;ELECTRONICA MAYOR
10859826;;M;54;CHILENO;;Silencioso;PROVIDENCIA                   ;METROPOLITANA;0;0;0;0;0;0;0;0;0;LED NanoCell 55NANO80 UHD SMART + MAGIC;ELECTRONICA MAYOR
17421026;;F;32;CHILENO;;Millenial;RENCA                         ;METROPOLITANA;0;0;0;0;0;0;0;0;0;LED 50 UN50TU7090GXZS UHD SMART TV;ELECTRONICA MAYOR
8967181;;F;66;CHILENO;;Boomers;PROVIDENCIA                   ;METROPOLITANA;0;0;0;0;0;0;0;0;0;MINICOMPONENTE RN5;ELECTRONICA MAYOR
18586625;Soltero;F;29;CHILENO;ENFERMERA;Millenial;VICTORIA                      ;ARAUCANIA;0;0;0;0;0;0;0;0;0;LED 32 UN32T4300AGXZS HD SMART TV;ELECTRONICA MAYOR
18025516;Soltero;M;29;CHILENO;INGENIERO INFORMATICO;Silencioso;PROVIDENCIA                   ;METROPOLITANA;0;0;0;0;0;0;0;0;0;MONITOR 24 24TL520S SMART TV HD;ELECTRONICA MAYOR
9842648;Casado;M;45;CHILENO;INGENIERO COMERCIAL;X;PROVIDENCIA                   ;METROPOLITANA;0;0;0;0;0;0;0;0;0;LED 32 32LM630BPSB SMART TV;ELECTRONICA MAYOR
18792081;;M;27;CHILENO;;Millenial;PROVIDENCIA                   ;METROPOLITANA;0;0;0;0;0;0;0;0;0;LED 40 KEHD4020 SMART TV;ELECTRONICA MAYOR
16769971;;F;34;CHILENO;;Millenial;N/D;N/D;0;0;0;0;0;0;0;0;0;LED KIOTO 32 MI3228 SMART TV;ELECTRONICA MAYOR
11062498;;F;55;CHILENO;;Boomers;TOME                          ;BIO BIO;0;0;0;0;0;0;0;0;0;PARLANTE BOLA DISCO CON MICROFONO INAL;ELECTRONICA MAYOR
24769839;;M;23;PERUANO;;Extranjero;N/D;N/D;0;0;0;0;0;0;0;0;0;LED 32 UN32T4300AGXZS HD SMART TV;ELECTRONICA MAYOR
18604686;Soltero;F;28;CHILENO;;Millenial;PROVIDENCIA                   ;METROPOLITANA;0;0;0;0;0;0;0;0;0;LED KIOTO 32 MI3228 SMART TV;ELECTRONICA MAYOR
15218379;;F;39;CHILENO;;X;PROVIDENCIA                   ;METROPOLITANA;0;0;0;0;0;0;0;0;0;LED KIOTO 32 MI3228 SMART TV;ELECTRONICA MAYOR
10598241;Casado;F;52;CHILENO;;Silencioso;PROVIDENCIA                   ;METROPOLITANA;0;0;0;0;0;0;0;0;0;LED 43 UN43T5202AGXZS FHD SMART TV;ELECTRONICA MAYOR
17602353;;M;31;CHILENO;;Millenial;N/D;N/D;0;0;0;0;0;0;0;0;0;SOUNDBAR HW-A450/ZS;ELECTRONICA MAYOR
13169634;;M;45;CHILENO;;X;CASTRO                        ;LOS LAGOS;0;0;0;0;0;0;0;0;0;PARLANTE COBRA;ELECTRONICA MAYOR
17311327;Soltero;M;32;CHILENO;;Silencioso;PROVIDENCIA                   ;METROPOLITANA;0;0;0;0;0;0;0;0;0;LED KIOTO 32 MI3228 SMART TV;ELECTRONICA MAYOR
25649476;;F;30;COLOMBIANO;;Extranjero;N/D;N/D;0;0;0;0;0;0;0;0;0;MAGIC REMOTE MR20GA;ELECTRONICA MAYOR
19090924;Soltero;F;26;CHILENO;;Silencioso;PROVIDENCIA                   ;METROPOLITANA;0;0;0;0;0;0;0;0;0;LED 50 UN50TU7090GXZS UHD SMART TV;ELECTRONICA MAYOR
7752025;Soltero;M;62;CHILENO;;Silencioso;PROVIDENCIA                   ;METROPOLITANA;0;0;0;0;0;0;0;0;0;LED KIOTO 32 MI3228 SMART TV;ELECTRONICA MAYOR
9624853;;F;60;CHILENO;;Boomers;RETIRO                        ;MAULE;0;0;0;0;0;0;0;0;0;LED 40 KEHD4020 SMART TV;ELECTRONICA MAYOR
14162215;;F;40;CHILENO;;X;PROVIDENCIA                   ;METROPOLITANA;0;0;0;0;0;0;0;0;0;LED 43 43LM6300PSB SMART TV HD;ELECTRONICA MAYOR
17338952;Casado;F;32;CHILENO;;Millenial;PROVIDENCIA                   ;METROPOLITANA;0;0;0;0;0;0;0;0;0;LED 49 49UN7100 UHD SMART TV;ELECTRONICA MAYOR
9880520;;F;54;CHILENO;;Boomers;LA FLORIDA                    ;METROPOLITANA;0;0;0;0;0;0;0;0;0;LED 40 KEHD4020 SMART TV;ELECTRONICA MAYOR
8813845;;M;68;CHILENO;;Silencioso;COPIAPO                       ;ATACAMA;0;0;0;0;0;0;0;0;0;MONITOR 24 24TL520S SMART TV HD;ELECTRONICA MAYOR
18109058;;M;30;CHILENO;;Silencioso;PROVIDENCIA                   ;METROPOLITANA;0;0;0;0;0;0;0;0;0;LED 50 50NANO75 NanoCell UHD SMART + MAGIC;ELECTRONICA MAYOR
18854697;;F;28;CHILENO;;Millenial;PROVIDENCIA                   ;METROPOLITANA;0;0;0;0;0;0;0;0;0;LED KIOTO 32 MI3228 SMART TV;ELECTRONICA MAYOR
16909202;Soltero;M;34;CHILENO;;Silencioso;PROVIDENCIA                   ;METROPOLITANA;0;0;0;0;0;0;0;0;0;LED 60UP7750 UHD SMART + MAGIC;ELECTRONICA MAYOR
15186719;;M;38;CHILENO;;X;AISEN                         ;AYSEN;0;0;0;0;0;0;0;0;0;LED 43 UN43TU7090GXZS UHD SMART TV;ELECTRONICA MAYOR
4687394;;M;81;CHILENO;;Silencioso;CASTRO                        ;LOS LAGOS;0;0;0;0;0;0;0;0;0;LED KIOTO 32 MI3228 SMART TV;ELECTRONICA MAYOR
18663758;Soltero;M;28;CHILENO;;Silencioso;PROVIDENCIA                   ;METROPOLITANA;0;0;0;0;0;0;0;0;0;LED 55 UN55TU7090GXZS SMART TV UHD;ELECTRONICA MAYOR
17423896;;M;32;CHILENO;;Silencioso;PROVIDENCIA                   ;METROPOLITANA;0;0;0;0;0;0;0;0;0;LED 43 UN43TU7090GXZS UHD SMART TV;ELECTRONICA MAYOR
16059992;;M;36;CHILENO;;Millenial;ILLAPEL                       ;COQUIMBO;0;0;0;0;0;0;0;0;0;LED 43 Full HD Smart TV 43PFD6825;ELECTRONICA MAYOR
8245607;;F;62;CHILENO;;Boomers;TOCOPILLA                     ;ANTOFAGASTA;0;0;0;0;0;0;0;0;0;LED 40 KEHD4020 SMART TV;ELECTRONICA MAYOR
11902642;Casado;F;51;CHILENO;;X;"";"";0;0;0;0;0;0;0;0;0;LED 32 32LM630BPSB SMART TV;ELECTRONICA MAYOR
8231201;;M;62;CHILENO;;Boomers;CALAMA                        ;ANTOFAGASTA;0;0;0;0;0;0;0;0;0;LED 32 32S5295 SMART TV HD;ELECTRONICA MAYOR
11233545;;M;53;CHILENO;;X;PROVIDENCIA                   ;METROPOLITANA;0;0;0;0;0;0;0;0;0;MONITOR 24 24TL520S SMART TV HD;ELECTRONICA MAYOR
19230242;;M;26;CHILENO;;Z;PROVIDENCIA                   ;METROPOLITANA;0;0;0;0;0;0;0;0;0;LED 32 UN32T4300AGXZS HD SMART TV;ELECTRONICA MAYOR
10150368;;M;57;CHILENO;;Boomers;LA FLORIDA                    ;METROPOLITANA;0;0;0;0;0;0;0;0;0;LED 50 KEUH50 SMART TV UHD;ELECTRONICA MAYOR
16518924;;M;35;CHILENO;;Millenial;SAN BERNARDO                  ;METROPOLITANA;0;0;0;0;0;0;0;0;0;LED 32 UN32T4300AGXZS HD SMART TV;ELECTRONICA MAYOR
14023299;Casado;M;41;CHILENO;;X;RENCA                         ;METROPOLITANA;0;0;0;0;0;0;0;0;0;LED 40 KEHD4020 SMART TV;ELECTRONICA MAYOR
17448052;;M;32;CHILENO;;Millenial;RENCA                         ;METROPOLITANA;0;0;0;0;0;0;0;0;0;LED 32 32PHD5813 SMART TV HD;ELECTRONICA MAYOR
12159212;Soltero;M;47;CHILENO;INGENIERO CIVIL INDUSTRIAL;Silencioso;PROVIDENCIA                   ;METROPOLITANA;0;0;0;0;0;0;0;0;0;LED 32 32LM630BPSB SMART TV;ELECTRONICA MAYOR
19603329;;M;25;CHILENO;;Z;PROVIDENCIA                   ;METROPOLITANA;0;0;0;0;0;0;0;0;0;LED 40 KEHD4020 SMART TV;ELECTRONICA MAYOR
18399385;;F;28;CHILENO;;Millenial;PROVIDENCIA                   ;METROPOLITANA;0;0;0;0;0;0;0;0;0;LED 50 KEUH50 SMART TV UHD;ELECTRONICA MAYOR
19205278;;M;26;CHILENO;;Z;N/D;N/D;0;0;0;0;0;0;0;0;0;LED 43 CS43S1USM UHD SMART TV NEGRO;ELECTRONICA MAYOR
15045761;;F;39;CHILENO;;X;LA LIGUA                      ;VALPARAISO;0;0;0;0;0;0;0;0;0;LED 40 KEHD4020 SMART TV;ELECTRONICA MAYOR
10665358;;F;54;CHILENO;;X;PUENTE ALTO                   ;METROPOLITANA;0;0;0;0;0;0;0;0;0;LED 40 KEHD4020 SMART TV;ELECTRONICA MAYOR
10484198;Soltero;F;54;CHILENO;ASISTENTE SOCIAL;Boomers;SAN JAVIER                    ;MAULE;0;0;0;0;0;0;0;0;0;LED 49 49UN7100 UHD SMART TV;ELECTRONICA MAYOR
17716451;;F;31;CHILENO;;Millenial;PALMILLA;O HIGGINS;0;0;0;0;0;0;0;0;0;LED 40 KEHD4020 SMART TV;ELECTRONICA MAYOR
5997469;;F;72;CHILENO;;Silencioso;PUDAHUEL                      ;METROPOLITANA;0;0;0;0;0;0;0;0;0;LED 43 CS43S1USM UHD SMART TV NEGRO;ELECTRONICA MAYOR
9508818;;M;59;CHILENO;;Boomers;RENGO                         ;L.G.B.OÂ´HIGGINS;0;0;0;0;0;0;0;0;0;LED 50 UN50TU7090GXZS UHD SMART TV;ELECTRONICA MAYOR
19619301;;F;24;CHILENO;;Z;LA CRUZ                       ;VALPARAISO;0;0;0;0;0;0;0;0;0;LED 50 UN50TU7090GXZS UHD SMART TV;ELECTRONICA MAYOR
26532929;;F;31;VENEZOLANO;;Extranjero;TALCA                         ;MAULE;0;0;0;0;0;0;0;0;0;LED KIOTO 32 MI3228 SMART TV;ELECTRONICA MAYOR
13627674;;F;43;CHILENO;;X;IQUIQUE                       ;TARAPACA;0;0;0;0;0;0;0;0;0;LED 49 49UN7100 UHD SMART TV;ELECTRONICA MAYOR
18573403;Soltero;M;28;CHILENO;;Millenial;IQUIQUE                       ;TARAPACA;0;0;0;0;0;0;0;0;0;SOUNDBAR HW-T400/ZS;ELECTRONICA MAYOR
15142401;Soltero;F;40;CHILENO;;X;PROVIDENCIA                   ;METROPOLITANA;0;0;0;0;0;0;0;0;0;LED 32 UN32T4300AGXZS HD SMART TV;ELECTRONICA MAYOR
19290153;;M;26;CHILENO;;Silencioso;PROVIDENCIA                   ;METROPOLITANA;0;0;0;0;0;0;0;0;0;LED 43 43LM6300PSB SMART TV HD;ELECTRONICA MAYOR
25764490;;F;30;EXTRANJERO - NO INFORMA NACIONALIDAD;;Extranjero;N/D;N/D;0;0;0;0;0;0;0;0;0;LED 50 UN50TU7090GXZS UHD SMART TV;ELECTRONICA MAYOR
11745472;;M;51;CHILENO;;Silencioso;PROVIDENCIA                   ;METROPOLITANA;0;0;0;0;0;0;0;0;0;MINICOMPONENTE CM4360;ELECTRONICA MAYOR
12639866;;M;48;CHILENO;;X;PROVIDENCIA                   ;METROPOLITANA;0;0;0;0;0;0;0;0;0;LED 43 43UN7300 UHD SMART TV 4K;ELECTRONICA MAYOR
6291474;;F;67;CHILENO;;Silencioso;N/D;N/D;0;0;0;0;0;0;0;0;0;LED 50 UN50TU7090GXZS UHD SMART TV;ELECTRONICA MAYOR
5965188;;M;73;CHILENO;;Silencioso;LA LIGUA                      ;VALPARAISO;0;0;0;0;0;0;0;0;0;MONITOR 24 24TL520S SMART TV HD;ELECTRONICA MAYOR
16735396;;M;34;CHILENO;;Millenial;PROVIDENCIA                   ;METROPOLITANA;0;0;0;0;0;0;0;0;0;LED 40 KEHD4020 SMART TV;ELECTRONICA MAYOR
11413209;;F;52;CHILENO;;X;PURRANQUE                     ;LOS LAGOS;0;0;0;0;0;0;0;0;0;LED 50 KEUH50 SMART TV UHD;ELECTRONICA MAYOR
15515607;Soltero;F;39;CHILENO;;Silencioso;PROVIDENCIA                   ;METROPOLITANA;0;0;0;0;0;0;0;0;0;LED KIOTO 32 MI3228 SMART TV;ELECTRONICA MAYOR
11380303;Soltero;M;53;CHILENO;;X;PROVIDENCIA                   ;METROPOLITANA;0;0;0;0;0;0;0;0;0;LED 32 UN32T4300AGXZS HD SMART TV;ELECTRONICA MAYOR
17815299;;M;31;CHILENO;;Millenial;RENCA                         ;METROPOLITANA;0;0;0;0;0;0;0;0;0;LED 43 UN43TU7090GXZS UHD SMART TV;ELECTRONICA MAYOR
12678013;;F;48;CHILENO;;X;LAS CABRAS                    ;L.G.B.OÂ´HIGGINS;0;0;0;0;0;0;0;0;0;LED 50 KEUH50 SMART TV UHD;ELECTRONICA MAYOR
5433059;;M;75;CHILENO;;Silencioso;LA PINTANA                    ;METROPOLITANA;0;0;0;0;0;0;0;0;0;LED 40 KEHD4020 SMART TV;ELECTRONICA MAYOR
17748717;;M;31;CHILENO;;Millenial;SANTIAGO                      ;METROPOLITANA;0;0;0;0;0;0;0;0;0;LED 50 UN50TU7090GXZS UHD SMART TV;ELECTRONICA MAYOR
16427539;Soltero;M;35;CHILENO;;Silencioso;PROVIDENCIA                   ;METROPOLITANA;0;0;0;0;0;0;0;0;0;LED 32 UN32T4300AGXZS HD SMART TV;ELECTRONICA MAYOR
19255695;Soltero;F;25;CHILENO;;Z;PROVIDENCIA                   ;METROPOLITANA;0;0;0;0;0;0;0;0;0;LED 32 32LM630BPSB SMART TV;ELECTRONICA MAYOR
7345908;Viudo;F;69;CHILENO;;Silencioso;TALCAHUANO                    ;BIO BIO;0;0;0;0;0;0;0;0;0;LED 43 UN43TU7090GXZS UHD SMART TV;ELECTRONICA MAYOR
18022179;Soltero;M;30;CHILENO;;Silencioso;N/D;N/D;0;0;0;0;0;0;0;0;0;LED 50 UN50TU7090GXZS UHD SMART TV;ELECTRONICA MAYOR
15451276;;F;40;CHILENO;;X;PROVIDENCIA                   ;METROPOLITANA;0;0;0;0;0;0;0;0;0;LED 32 UN32T4300AGXZS HD SMART TV;ELECTRONICA MAYOR
14047688;;M;41;CHILENO;;X;PROVIDENCIA                   ;METROPOLITANA;0;0;0;0;0;0;0;0;0;LED 50 50PUD6513/44 SMART TV UHD 4K;ELECTRONICA MAYOR
18314822;;F;29;CHILENO;;Millenial;RENCA                         ;METROPOLITANA;0;0;0;0;0;0;0;0;0;LED 43 43S5295 SMART TV FHD;ELECTRONICA MAYOR
20112237;;M;23;CHILENO;;Silencioso;"";"";0;0;0;0;0;0;0;0;0;LED 55 UN55TU8300GXZS UHD SMART TV CURVO;ELECTRONICA MAYOR
10588656;;F;59;CHILENO;;Boomers;OVALLE                        ;COQUIMBO;0;0;0;0;0;0;0;0;0;LED KIOTO 32 MI3228 SMART TV;ELECTRONICA MAYOR
19560090;;M;25;CHILENO;;Z;PUDAHUEL                      ;METROPOLITANA;0;0;0;0;0;0;0;0;0;PARLANTE ULTRABUZZ;ELECTRONICA MAYOR
15229238;;M;41;CHILENO;;X;PROVIDENCIA                   ;METROPOLITANA;0;0;0;0;0;0;0;0;0;LED 40 KEHD4020 SMART TV;ELECTRONICA MAYOR
18850227;Soltero;M;27;CHILENO;;Millenial;PROVIDENCIA                   ;METROPOLITANA;0;0;0;0;0;0;0;0;0;LED KIOTO 32 MI3228 SMART TV;ELECTRONICA MAYOR
17459398;Soltero;M;32;CHILENO;ELECTRONICA INDUSTRIAL;Millenial;PROVIDENCIA                   ;METROPOLITANA;0;0;0;0;0;0;0;0;0;LED 50 UN50TU7090GXZS UHD SMART TV;ELECTRONICA MAYOR
25669465;;M;34;VENEZOLANO;;Extranjero;RECOLETA                      ;METROPOLITANA;0;0;0;0;0;0;0;0;0;LED 40 KEHD4020 SMART TV;ELECTRONICA MAYOR
16009489;Soltero;M;37;CHILENO;;Silencioso;PROVIDENCIA                   ;METROPOLITANA;0;0;0;0;0;0;0;0;0;LED 32 32S5295 SMART TV HD;ELECTRONICA MAYOR
17265460;;M;33;CHILENO;;Silencioso;PROVIDENCIA                   ;METROPOLITANA;0;0;0;0;0;0;0;0;0;LED 43 43UN7300 UHD SMART TV 4K;ELECTRONICA MAYOR
7874136;;F;64;CHILENO;;Boomers;LA SERENA                     ;COQUIMBO;0;0;0;0;0;0;0;0;0;LED 58 KUHK5820 UHD SMART TV;ELECTRONICA MAYOR
17180007;;F;33;CHILENO;;Millenial;PELLUHUE                      ;MAULE;0;0;0;0;0;0;0;0;0;LED 40 KEHD4020 SMART TV;ELECTRONICA MAYOR
12898896;;M;46;CHILENO;;X;RENCA                         ;METROPOLITANA;0;0;0;0;0;0;0;0;0;LED 55 UN55TU7090GXZS SMART TV UHD;ELECTRONICA MAYOR
15783778;;F;38;CHILENO;;Millenial;PROVIDENCIA                   ;METROPOLITANA;0;0;0;0;0;0;0;0;0;LED 50 UN50TU7090GXZS UHD SMART TV;ELECTRONICA MAYOR
11195442;;M;55;CHILENO;;Millenial;LLAILLAY                      ;VALPARAISO;0;0;0;0;0;0;0;0;0;LED 32 UN32T4300AGXZS HD SMART TV;ELECTRONICA MAYOR
8437176;Casado;M;62;CHILENO;;Silencioso;PROVIDENCIA                   ;METROPOLITANA;0;0;0;0;0;0;0;0;0;LED 43 UN43T5202AGXZS FHD SMART TV;ELECTRONICA MAYOR
10065329;;F;56;CHILENO;;Boomers;"";"";0;0;0;0;0;0;0;0;0;LED 43 43LM6300PSB SMART TV HD;ELECTRONICA MAYOR
19220156;;F;26;CHILENO;;Z;"";"";0;0;0;0;0;0;0;0;0;LED 43 43UN7300 UHD SMART TV 4K;ELECTRONICA MAYOR
15491430;Soltero;M;39;CHILENO;;X;PROVIDENCIA                   ;METROPOLITANA;0;0;0;0;0;0;0;0;0;LED 43 UN43TU7090GXZS UHD SMART TV;ELECTRONICA MAYOR
19786597;;M;24;CHILENO;;Silencioso;PROVIDENCIA                   ;METROPOLITANA;0;0;0;0;0;0;0;0;0;LED 40 KEHD4020 SMART TV;ELECTRONICA MAYOR
15259787;Divorciado;F;39;CHILENO;;X;PROVIDENCIA                   ;METROPOLITANA;0;0;0;0;0;0;0;0;0;LED 55 UN55TU7090GXZS SMART TV UHD;ELECTRONICA MAYOR
9036253;;M;55;CHILENO;;Boomers;LO PRADO                      ;METROPOLITANA;0;0;0;0;0;0;0;0;0;LED KIOTO 32 MI3228 SMART TV;ELECTRONICA MAYOR
25657665;;M;33;HAITIANO;;Extranjero;"";"";0;0;0;0;0;0;0;0;0;LED 50 50PUD6654 SMART TV UHD BL BT SILVER;ELECTRONICA MAYOR
18100212;;F;30;CHILENO;;Millenial;"";"";0;0;0;0;0;0;0;0;0;LED 43 UN43T5202AGXZS FHD SMART TV;ELECTRONICA MAYOR
16438154;;F;35;CHILENO;;Millenial;PROVIDENCIA                   ;METROPOLITANA;0;0;0;0;0;0;0;0;0;PARLANTE BOLA DISCO CON MICROFONO INAL;ELECTRONICA MAYOR
11537594;;M;51;CHILENO;;X;TOME                          ;BIO BIO;0;0;0;0;0;0;0;0;0;LED KIOTO 32 MI3228 SMART TV;ELECTRONICA MAYOR
14046363;;F;41;CHILENO;;X;"";"";0;0;0;0;0;0;0;0;0;LED 43 UN43TU7090GXZS UHD SMART TV;ELECTRONICA MAYOR
15632729;Casado;M;39;CHILENO;INGENIERO DE EJECUCION INDUSTRIAL;Silencioso;PROVIDENCIA                   ;METROPOLITANA;0;0;0;0;0;0;0;0;0;LED 32 32LM630BPSB SMART TV;ELECTRONICA MAYOR
17123097;;F;33;CHILENO;;Millenial;CALERA DE TANGO               ;METROPOLITANA;0;0;0;0;0;0;0;0;0;LED 43 43LM6300PSB SMART TV HD;ELECTRONICA MAYOR
15893535;;F;37;CHILENO;;Millenial;PROVIDENCIA                   ;METROPOLITANA;0;0;0;0;0;0;0;0;0;LED 55 UN55TU7090GXZS SMART TV UHD;ELECTRONICA MAYOR
5356190;;M;76;CHILENO;;Silencioso;RENCA                         ;METROPOLITANA;0;0;0;0;0;0;0;0;0;KARAOKE FUNKY DISCO;ELECTRONICA MAYOR
15194283;;F;49;CHILENO;;X;CABRERO                       ;BIO BIO;0;0;0;0;0;0;0;0;0;LED 32 32S5295 SMART TV HD;ELECTRONICA MAYOR
12653456;;F;48;CHILENO;;X;RENCA                         ;METROPOLITANA;0;0;0;0;0;0;0;0;0;LED 32 UN32T4300AGXZS HD SMART TV;ELECTRONICA MAYOR
13894524;;M;42;CHILENO;;X;PROVIDENCIA                   ;METROPOLITANA;0;0;0;0;0;0;0;0;0;MAGIC REMOTE MR20GA;ELECTRONICA MAYOR
20303580;;M;21;CHILENO;;Millenial;N/D;N/D;0;0;0;0;0;0;0;0;0;LED 55 UN55TU7090GXZS SMART TV UHD;ELECTRONICA MAYOR
19294304;;M;26;CHILENO;;Z;PROVIDENCIA                   ;METROPOLITANA;0;0;0;0;0;0;0;0;0;SOUNDBAR SN6Y;ELECTRONICA MAYOR
18152358;;F;30;CHILENO;;Millenial;PROVIDENCIA                   ;METROPOLITANA;0;0;0;0;0;0;0;0;0;LED KIOTO 32 MI3228 SMART TV;ELECTRONICA MAYOR
9216334;;F;60;CHILENO;;Silencioso;PROVIDENCIA                   ;METROPOLITANA;0;0;0;0;0;0;0;0;0;LED 50 CS50S1USM UHD SMART TV NEGRO;ELECTRONICA MAYOR
13984602;Soltero;M;40;CHILENO;;X;RENCA                         ;METROPOLITANA;0;0;0;0;0;0;0;0;0;PARLANTE GBASS GOLIAT;ELECTRONICA MAYOR
11533790;;F;52;CHILENO;;X;RENCA                         ;METROPOLITANA;0;0;0;0;0;0;0;0;0;MAGIC REMOTE MR20GA;ELECTRONICA MAYOR
19938788;;M;24;CHILENO;;Z;PROVIDENCIA                   ;METROPOLITANA;0;0;0;0;0;0;0;0;0;LED 58 KUHK5820 UHD SMART TV;ELECTRONICA MAYOR
8308147;;F;63;CHILENO;;Boomers;N/D;N/D;0;0;0;0;0;0;0;0;0;LED 50 UN50TU7090GXZS UHD SMART TV;ELECTRONICA MAYOR
9221092;Casado;M;50;CHILENO;TECNICO MECANICO;X;RENCA                         ;METROPOLITANA;0;0;0;0;0;0;0;0;0;LED 50 50P615-50P ANDROID TV PASSION LINE UHD 4K;ELECTRONICA MAYOR
9975933;;M;58;CHILENO;;Boomers;PROVIDENCIA                   ;METROPOLITANA;0;0;0;0;0;0;0;0;0;LED KIOTO 32 MI3228 SMART TV;ELECTRONICA MAYOR
14090713;;M;41;CHILENO;;X;SAN BERNARDO                  ;METROPOLITANA;0;0;0;0;0;0;0;0;0;LED 55 UN55TU8300GXZS UHD SMART TV CURVO;ELECTRONICA MAYOR
10989741;;M;46;CHILENO;;X;PROVIDENCIA                   ;METROPOLITANA;0;0;0;0;0;0;0;0;0;MINICOMPONENTE CJ45;ELECTRONICA MAYOR
14021869;;M;41;CHILENO;;X;N/D;N/D;0;0;0;0;0;0;0;0;0;LED 32 32LM630BPSB SMART TV;ELECTRONICA MAYOR
12004203;;M;40;CHILENO;;Silencioso;PROVIDENCIA                   ;METROPOLITANA;0;0;0;0;0;0;0;0;0;LED 50 50UN8000 UHD SMART;ELECTRONICA MAYOR
13539715;Soltero;F;43;CHILENO;ENFERMERA;X;CALLE LARGA                   ;VALPARAISO;0;0;0;0;0;0;0;0;0;SISTEMA DE SONIDO CM1560;ELECTRONICA MAYOR
10690753;;M;49;CHILENO;;X;TALCAHUANO                    ;BIO BIO;0;0;0;0;0;0;0;0;0;LED 50 50PUD6513/44 SMART TV UHD 4K;ELECTRONICA MAYOR
10232702;;F;57;CHILENO;;Boomers;LA SERENA                     ;COQUIMBO;0;0;0;0;0;0;0;0;0;LED 55 UN55TU8300GXZS UHD SMART TV CURVO;ELECTRONICA MAYOR
10881876;Casado;M;50;CHILENO;;X;PROVIDENCIA                   ;METROPOLITANA;0;0;0;0;0;0;0;0;0;LED 50 UN50TU7090GXZS UHD SMART TV;ELECTRONICA MAYOR
18458619;;F;29;CHILENO;;Millenial;CHONCHI                       ;LOS LAGOS;0;0;0;0;0;0;0;0;0;LED 50 UN50TU7090GXZS UHD SMART TV;ELECTRONICA MAYOR
13917139;;F;41;CHILENO;;X;PROVIDENCIA                   ;METROPOLITANA;0;0;0;0;0;0;0;0;0;MINICOMPONENTE MHC-V43D ALL IN ONE;ELECTRONICA MAYOR
13949947;;F;42;CHILENO;;X;PROVIDENCIA                   ;METROPOLITANA;0;0;0;0;0;0;0;0;0;LED 43 43LM6300PSB SMART TV HD;ELECTRONICA MAYOR
4674319;;F;81;CHILENO;;Silencioso;NUEVA IMPERIAL                ;ARAUCANIA;0;0;0;0;0;0;0;0;0;LED 43 UN43T5202AGXZS FHD SMART TV;ELECTRONICA MAYOR
12380080;;M;49;CHILENO;;X;PROVIDENCIA                   ;METROPOLITANA;0;0;0;0;0;0;0;0;0;LED KIOTO 32 MI3228 SMART TV;ELECTRONICA MAYOR
18836166;;M;28;CHILENO;;Millenial;PROVIDENCIA                   ;METROPOLITANA;0;0;0;0;0;0;0;0;0;LED 32 32S5295 SMART TV HD;ELECTRONICA MAYOR
19468259;;F;24;CHILENO;;Z;COPIAPO                       ;ATACAMA;0;0;0;0;0;0;0;0;0;MINICOMPONENTE RN7;ELECTRONICA MAYOR
12563610;;M;47;CHILENO;;X;RENCA                         ;METROPOLITANA;0;0;0;0;0;0;0;0;0;LED 55 UN55TU7090GXZS SMART TV UHD;ELECTRONICA MAYOR
8176139;;F;65;CHILENO;;Boomers;TALAGANTE                     ;METROPOLITANA;0;0;0;0;0;0;0;0;0;LED 50 KEUH50 SMART TV UHD;ELECTRONICA MAYOR
13368703;;F;44;CHILENO;;X;EL QUISCO                     ;VALPARAISO;0;0;0;0;0;0;0;0;0;LED 55 UN55TU7090GXZS SMART TV UHD;ELECTRONICA MAYOR
10577402;;M;50;CHILENO;;X;N/D;N/D;0;0;0;0;0;0;0;0;0;PARLANTE ULTRAFUSION;ELECTRONICA MAYOR
16260035;;F;36;CHILENO;;Millenial;PROVIDENCIA                   ;METROPOLITANA;0;0;0;0;0;0;0;0;0;LED KIOTO 32 MI3228 SMART TV;ELECTRONICA MAYOR
18414197;Soltero;F;29;CHILENO;ENFERMERA;Millenial;PROVIDENCIA                   ;METROPOLITANA;0;0;0;0;0;0;0;0;0;LED 32 UN32T4300AGXZS HD SMART TV;ELECTRONICA MAYOR
5967439;;M;75;CHILENO;;Silencioso;CATEMU                        ;VALPARAISO;0;0;0;0;0;0;0;0;0;MONITOR 24 24TL520S SMART TV HD;ELECTRONICA MAYOR
9097242;;M;51;CHILENO;;X;LOS ANDES                     ;VALPARAISO;0;0;0;0;0;0;0;0;0;SOUNDBAR HW-T400/ZS;ELECTRONICA MAYOR
17905314;;M;31;CHILENO;;Silencioso;PROVIDENCIA                   ;METROPOLITANA;0;0;0;0;0;0;0;0;0;LED KIOTO 32 MI3228 SMART TV;ELECTRONICA MAYOR
7230131;Casado;F;65;CHILENO;;Boomers;COQUIMBO                      ;COQUIMBO;0;0;0;0;0;0;0;0;0;SISTEMA DE SONIDO LK72B;ELECTRONICA MAYOR
10686854;;F;54;CHILENO;;X;TEMUCO                        ;ARAUCANIA;0;0;0;0;0;0;0;0;0;LED 55 UN55TU7090GXZS SMART TV UHD;ELECTRONICA MAYOR
16879589;Soltero;M;34;CHILENO;;Millenial;PROVIDENCIA                   ;METROPOLITANA;0;0;0;0;0;0;0;0;0;LED 43 UN43T5202AGXZS FHD SMART TV;ELECTRONICA MAYOR
12367361;;F;49;CHILENO;;X;COLTAUCO                      ;L.G.B.OÂ´HIGGINS;0;0;0;0;0;0;0;0;0;LED KIOTO 32 MI3228 SMART TV;ELECTRONICA MAYOR
10409993;;M;56;CHILENO;;Boomers;PROVIDENCIA                   ;METROPOLITANA;0;0;0;0;0;0;0;0;0;MINICOMPONENTE RN9;ELECTRONICA MAYOR
8180953;;F;64;CHILENO;;Boomers;COPIAPO                       ;ATACAMA;0;0;0;0;0;0;0;0;0;LED 50 UN50TU7090GXZS UHD SMART TV;ELECTRONICA MAYOR
26027633;;M;34;VENEZOLANO;;Extranjero;N/D;N/D;0;0;0;0;0;0;0;0;0;LED 32 32LM630BPSB SMART TV;ELECTRONICA MAYOR
19604794;;M;24;CHILENO;;Z;SAN FERNANDO                  ;L.G.B.OÂ´HIGGINS;0;0;0;0;0;0;0;0;0;MINICOMPONENTE CM4360;ELECTRONICA MAYOR
19441318;;F;26;CHILENO;;Z;"";"";0;0;0;0;0;0;0;0;0;LED 55 UN55TU8300GXZS UHD SMART TV CURVO;ELECTRONICA MAYOR
17322157;;F;32;CHILENO;;Millenial;RENCA                         ;METROPOLITANA;0;0;0;0;0;0;0;0;0;LED 50 KEUH50 SMART TV UHD;ELECTRONICA MAYOR
14618776;Casado;F;40;CHILENO;;X;PROVIDENCIA                   ;METROPOLITANA;0;0;0;0;0;0;0;0;0;LED 32 32S5295 SMART TV HD;ELECTRONICA MAYOR
17772007;;F;31;CHILENO;;Millenial;"";"";0;0;0;0;0;0;0;0;0;SOUNDBAR HW-T400/ZS;ELECTRONICA MAYOR
15330626;;F;40;CHILENO;;X;SAN MIGUEL                    ;METROPOLITANA;0;0;0;0;0;0;0;0;0;LED 40 KEHD4020 SMART TV;ELECTRONICA MAYOR
7768434;;F;69;CHILENO;;Silencioso;LOS ANGELES                   ;BIO BIO;0;0;0;0;0;0;0;0;0;LED 32 UN32T4300AGXZS HD SMART TV;ELECTRONICA MAYOR
16058958;;F;36;CHILENO;;Millenial;LA CRUZ                       ;VALPARAISO;0;0;0;0;0;0;0;0;0;SISTEMA DE SONIDO CM1560;ELECTRONICA MAYOR
9444570;;F;61;CHILENO;;Boomers;ARICA                         ;ARICA Y PARINACOTA;0;0;0;0;0;0;0;0;0;LED 50 KEUH50 SMART TV UHD;ELECTRONICA MAYOR
26250998;;F;36;VENEZOLANO;;Extranjero;"";"";0;0;0;0;0;0;0;0;0;LED 43 CS43S1USM UHD SMART TV NEGRO;ELECTRONICA MAYOR
12205675;;M;51;CHILENO;;X;LAUTARO                       ;ARAUCANIA;0;0;0;0;0;0;0;0;0;LED 58 58PUD6513/44 SMART TV UHD;ELECTRONICA MAYOR
15814923;;M;38;CHILENO;;Millenial;N/D;N/D;0;0;0;0;0;0;0;0;0;LED 50 KEUH50 SMART TV UHD;ELECTRONICA MAYOR
13549775;Soltero;M;43;CHILENO;;Silencioso;PROVIDENCIA                   ;METROPOLITANA;0;0;0;0;0;0;0;0;0;LED 43 UN43T5202AGXZS FHD SMART TV;ELECTRONICA MAYOR
17539603;;M;32;CHILENO;;Millenial;PROVIDENCIA                   ;METROPOLITANA;0;0;0;0;0;0;0;0;0;LED 43 UN43T5202AGXZS FHD SMART TV;ELECTRONICA MAYOR
12004499;Casado;F;44;CHILENO;ADMINISTRADOR HOTELERO;X;PROVIDENCIA                   ;METROPOLITANA;0;0;0;0;0;0;0;0;0;PARLANTE SPBYF7 PORTATIL;ELECTRONICA MAYOR
7264693;;M;69;CHILENO;;Silencioso;RENCA                         ;METROPOLITANA;0;0;0;0;0;0;0;0;0;LED 43 UN43T5202AGXZS FHD SMART TV;ELECTRONICA MAYOR
7364393;;M;62;CHILENO;;Boomers;QUIRIHUE                      ;BIO BIO;0;0;0;0;0;0;0;0;0;LED KIOTO 32 MI3228 SMART TV;ELECTRONICA MAYOR
12403910;;F;49;CHILENO;;X;RENCA                         ;METROPOLITANA;0;0;0;0;0;0;0;0;0;LED 43 UN43T5202AGXZS FHD SMART TV;ELECTRONICA MAYOR
15816325;;F;37;CHILENO;;Millenial;BUIN                          ;METROPOLITANA;0;0;0;0;0;0;0;0;0;LED 50 KEUH50 SMART TV UHD;ELECTRONICA MAYOR
18657438;;F;27;CHILENO;;Millenial;CALAMA                        ;ANTOFAGASTA;0;0;0;0;0;0;0;0;0;LED 50 UN50TU7090GXZS UHD SMART TV;ELECTRONICA MAYOR
14200553;;M;41;CHILENO;;Silencioso;PROVIDENCIA                   ;METROPOLITANA;0;0;0;0;0;0;0;0;0;LED 55 UN55TU7090GXZS SMART TV UHD;ELECTRONICA MAYOR
15243738;Casado;M;54;CHILENO;AGROINDUSTRIA;Silencioso;PROVIDENCIA                   ;METROPOLITANA;0;0;0;0;0;0;0;0;0;LED 43 43LM6300PSB SMART TV HD;ELECTRONICA MAYOR
8978163;;M;61;CHILENO;;Boomers;CURICO                        ;MAULE;0;0;0;0;0;0;0;0;0;MONITOR 24 24TL520S SMART TV HD;ELECTRONICA MAYOR
18187389;;M;30;CHILENO;;Millenial;PROVIDENCIA                   ;METROPOLITANA;0;0;0;0;0;0;0;0;0;LED 75 UN75TU6900GXZS UHD SMART TV;ELECTRONICA MAYOR
10992952;;M;51;CHILENO;;X;VILLA ALEMANA                 ;VALPARAISO;0;0;0;0;0;0;0;0;0;MONITOR 24 24TL520S SMART TV HD;ELECTRONICA MAYOR
10850714;Soltero;M;51;CHILENO;;X;RENCA                         ;METROPOLITANA;0;0;0;0;0;0;0;0;0;LED 32 UN32T4300AGXZS HD SMART TV;ELECTRONICA MAYOR
18745921;;F;27;CHILENO;;Millenial;LOTA                          ;BIO BIO;0;0;0;0;0;0;0;0;0;LED 65 65UN7100 UHD SMART TV;ELECTRONICA MAYOR
18314825;Soltero;M;29;CHILENO;;Millenial;PROVIDENCIA                   ;METROPOLITANA;0;0;0;0;0;0;0;0;0;LED 43 43LM6300PSB SMART TV HD;ELECTRONICA MAYOR
16798272;;F;34;CHILENO;;Millenial;COLINA                        ;METROPOLITANA;0;0;0;0;0;0;0;0;0;LED 43 43LM6300PSB SMART TV HD;ELECTRONICA MAYOR
17928380;;F;30;CHILENO;;Millenial;PUERTO MONTT                  ;LOS LAGOS;0;0;0;0;0;0;0;0;0;LED 40 KEHD4020 SMART TV;ELECTRONICA MAYOR
6948858;Casado;M;62;CHILENO;;Boomers;RENCA                         ;METROPOLITANA;0;0;0;0;0;0;0;0;0;LED 43 UN43TU7090GXZS UHD SMART TV;ELECTRONICA MAYOR
19425936;;F;26;CHILENO;;Z;PROVIDENCIA                   ;METROPOLITANA;0;0;0;0;0;0;0;0;0;LED 43 UN43T5202AGXZS FHD SMART TV;ELECTRONICA MAYOR
10816686;;F;58;CHILENO;;Boomers;CHIMBARONGO                   ;L.G.B.OÂ´HIGGINS;0;0;0;0;0;0;0;0;0;LED KIOTO 32 MI3228 SMART TV;ELECTRONICA MAYOR
7853863;;M;63;CHILENO;;Boomers;SANTA CRUZ                    ;L.G.B.OÂ´HIGGINS;0;0;0;0;0;0;0;0;0;LED 32 32LM630BPSB SMART TV;ELECTRONICA MAYOR
15553121;;F;35;CHILENO;;Millenial;LONCOCHE                      ;ARAUCANIA;0;0;0;0;0;0;0;0;0;PARLANTE KARAOKE RM1 8 PULGADAS;ELECTRONICA MAYOR
12541556;;M;48;CHILENO;;X;PUNTA ARENAS                  ;MAGALLANES;0;0;0;0;0;0;0;0;0;LED 49 49LJ5100 FHD;ELECTRONICA MAYOR
17625779;;F;31;CHILENO;;Millenial;LA SERENA;COQUIMBO;0;0;0;0;0;0;0;0;0;LED 32 UN32T4300AGXZS HD SMART TV;ELECTRONICA MAYOR
18455238;;M;29;CHILENO;;Millenial;CARTAGENA                     ;VALPARAISO;0;0;0;0;0;0;0;0;0;LED 55 UN55TU8300GXZS UHD SMART TV CURVO;ELECTRONICA MAYOR
13490272;;F;43;CHILENO;;Silencioso;PROVIDENCIA                   ;METROPOLITANA;0;0;0;0;0;0;0;0;0;LED 43 UN43T5202AGXZS FHD SMART TV;ELECTRONICA MAYOR
13554855;;M;43;CHILENO;;X;"";"";0;0;0;0;0;0;0;0;0;LED 40 KEHD4020 SMART TV;ELECTRONICA MAYOR
14472928;;M;48;CHILENO;;X;RENCA                         ;METROPOLITANA;0;0;0;0;0;0;0;0;0;LED 32 UN32T4300AGXZS HD SMART TV;ELECTRONICA MAYOR
16942592;Soltero;M;33;CHILENO;INGENIERO CIVIL MECANICO;Silencioso;PROVIDENCIA                   ;METROPOLITANA;0;0;0;0;0;0;0;0;0;LED 32 UN32T4300AGXZS HD SMART TV;ELECTRONICA MAYOR
13034142;;M;45;CHILENO;;X;QUINTA NORMAL                 ;METROPOLITANA;0;0;0;0;0;0;0;0;0;LED 43 43UN7300 UHD SMART TV 4K;ELECTRONICA MAYOR
11330013;;F;54;CHILENO;;X;RENCA                         ;METROPOLITANA;0;0;0;0;0;0;0;0;0;LED 40 KEHD4020 SMART TV;ELECTRONICA MAYOR
17346415;;M;32;CHILENO;;Millenial;PROVIDENCIA                   ;METROPOLITANA;0;0;0;0;0;0;0;0;0;LED 43 UN43T5202AGXZS FHD SMART TV;ELECTRONICA MAYOR
18593177;;F;28;CHILENO;;Silencioso;PROVIDENCIA                   ;METROPOLITANA;0;0;0;0;0;0;0;0;0;LED 40 KEHD4020 SMART TV;ELECTRONICA MAYOR
11759378;;F;50;CHILENO;;X;"";"";0;0;0;0;0;0;0;0;0;KARAOKE 8 CITY SET MIC WIRELESS ATRIL SILVER;ELECTRONICA MAYOR
25866296;;F;40;CHILENO;;Extranjero;INDEPENDENCIA                 ;METROPOLITANA;0;0;0;0;0;0;0;0;0;LED 55 55UN7100 UHD SMART TV;ELECTRONICA MAYOR
8495607;;M;76;CHILENO;;Silencioso;SAN BERNARDO                  ;METROPOLITANA;0;0;0;0;0;0;0;0;0;LED 43 UN43T5202AGXZS FHD SMART TV;ELECTRONICA MAYOR
18783375;;F;27;CHILENO;;Millenial;N/D;N/D;0;0;0;0;0;0;0;0;0;MONITOR 24 24TL520S SMART TV HD;ELECTRONICA MAYOR
14728937;;F;51;EXTRANJERO - NO INFORMA NACIONALIDAD;;Extranjero;PROVIDENCIA                   ;METROPOLITANA;0;0;0;0;0;0;0;0;0;LED 43 UN43TU7090GXZS UHD SMART TV;ELECTRONICA MAYOR
12593881;;F;48;CHILENO;;X;RIO BUENO                     ;LOS RIOS;0;0;0;0;0;0;0;0;0;PARLANTE ULTRAMEGA;ELECTRONICA MAYOR
11774663;;F;50;CHILENO;;X;PENCO                         ;BIO BIO;0;0;0;0;0;0;0;0;0;LED 50 UN50TU7090GXZS UHD SMART TV;ELECTRONICA MAYOR
16754999;Soltero;M;34;CHILENO;;Millenial;PROVIDENCIA                   ;METROPOLITANA;0;0;0;0;0;0;0;0;0;LED 50 UN50TU7090GXZS UHD SMART TV;ELECTRONICA MAYOR
17937713;;M;30;CHILENO;;Millenial;N/D;N/D;0;0;0;0;0;0;0;0;0;LED 32 CS32S1 SMART TV HD NEGRO;ELECTRONICA MAYOR
18648962;Casado;M;27;CHILENO;;Millenial;PROVIDENCIA                   ;METROPOLITANA;0;0;0;0;0;0;0;0;0;LED KIOTO 32 MI3228 SMART TV;ELECTRONICA MAYOR
13893289;;M;42;CHILENO;;X;QUILPUE                       ;VALPARAISO;0;0;0;0;0;0;0;0;0;LED 32 32LK540 HD SMART;ELECTRONICA MAYOR
26015749;;F;31;VENEZOLANO;;Extranjero;N/D;N/D;0;0;0;0;0;0;0;0;0;LED 50 UN50TU7090GXZS UHD SMART TV;ELECTRONICA MAYOR
6007316;;F;72;CHILENO;;Silencioso;SAN BERNARDO                  ;METROPOLITANA;0;0;0;0;0;0;0;0;0;MINICOMPONENTE CJ45;ELECTRONICA MAYOR
12009832;;M;46;CHILENO;;X;N/D;N/D;0;0;0;0;0;0;0;0;0;LED 32 32S60-32P ANDROID TV SMART LINE HD;ELECTRONICA MAYOR
17123982;;M;33;CHILENO;;Millenial;ANCUD                         ;LOS LAGOS;0;0;0;0;0;0;0;0;0;LED 32 32PHD5813 SMART TV HD;ELECTRONICA MAYOR
12852058;;F;47;CHILENO;;X;LA SERENA                     ;COQUIMBO;0;0;0;0;0;0;0;0;0;LED 32 32S60-32P ANDROID TV SMART LINE HD;ELECTRONICA MAYOR
8697807;;M;62;CHILENO;;Boomers;N/D;N/D;0;0;0;0;0;0;0;0;0;LED 32 CS32S1 SMART TV HD NEGRO;ELECTRONICA MAYOR
8611105;;M;62;CHILENO;;Boomers;ANCUD                         ;LOS LAGOS;0;0;0;0;0;0;0;0;0;LED KIOTO 32 MI3228 SMART TV;ELECTRONICA MAYOR
12323135;;M;49;CHILENO;;X;RENCA                         ;METROPOLITANA;0;0;0;0;0;0;0;0;0;MINICOMPONENTE RN7;ELECTRONICA MAYOR
17865346;;M;31;CHILENO;;Millenial;VALLENAR;ATACAMA;0;0;0;0;0;0;0;0;0;PARLANTE KARAOKE RM2 15 PULGADAS;ELECTRONICA MAYOR
9924055;;F;56;CHILENO;;Boomers;PELLUHUE                      ;MAULE;0;0;0;0;0;0;0;0;0;LED 32 32LK540 HD SMART;ELECTRONICA MAYOR
13582666;;M;43;CHILENO;;X;PROVIDENCIA                   ;METROPOLITANA;0;0;0;0;0;0;0;0;0;LED 43 UN43J5202AGXZS SMART TV FHD;ELECTRONICA MAYOR
13861555;;F;41;CHILENO;;X;ARAUCO                        ;BIO BIO;0;0;0;0;0;0;0;0;0;LED 49 49UN7100 UHD SMART TV;ELECTRONICA MAYOR
19211472;Soltero;F;26;CHILENO;;Z;PROVIDENCIA                   ;METROPOLITANA;0;0;0;0;0;0;0;0;0;MINICOMPONENTE CJ45;ELECTRONICA MAYOR
7829206;Casado;M;63;CHILENO;PROFESOR;Boomers;RENCA                         ;METROPOLITANA;0;0;0;0;0;0;0;0;0;LED KIOTO 32 MI3228 SMART TV;ELECTRONICA MAYOR
8505055;Soltero;F;62;CHILENO;;Boomers;RENCA                         ;METROPOLITANA;0;0;0;0;0;0;0;0;0;LED 32 32PHD5813 SMART TV HD;ELECTRONICA MAYOR
18068118;;F;30;CHILENO;;Millenial;CONCEPCION                    ;BIO BIO;0;0;0;0;0;0;0;0;0;LED 32 32LM630BPSB SMART TV;ELECTRONICA MAYOR
23878274;;M;28;PERUANO;;Extranjero;PENALOLEN                     ;METROPOLITANA;0;0;0;0;0;0;0;0;0;MINICOMPONENTE MX-T50/ZS ALL IN ONE;ELECTRONICA MAYOR
13993761;;F;40;CHILENO;;X;ALTO HOSPICIO;TARAPACA;0;0;0;0;0;0;0;0;0;LED KIOTO 32 MI3228 SMART TV;ELECTRONICA MAYOR
18811294;Soltero;M;27;CHILENO;;Millenial;PROVIDENCIA                   ;METROPOLITANA;0;0;0;0;0;0;0;0;0;LED 55 UN55TU7090GXZS SMART TV UHD;ELECTRONICA MAYOR
14450322;;F;47;CHILENO;;X;PROVIDENCIA                   ;METROPOLITANA;0;0;0;0;0;0;0;0;0;LED 49 49LJ5100 FHD;ELECTRONICA MAYOR
7844042;;M;64;CHILENO;;Boomers;PEDRO AGUIRRE CERDA           ;METROPOLITANA;0;0;0;0;0;0;0;0;0;LED 58 58PUD6513/44 SMART TV UHD;ELECTRONICA MAYOR
19845928;;F;23;CHILENO;;Z;PROVIDENCIA                   ;METROPOLITANA;0;0;0;0;0;0;0;0;0;LED 70 UN70TU6900GXZS UHD SMART TV;ELECTRONICA MAYOR
12206545;;F;50;CHILENO;;X;PROVIDENCIA                   ;METROPOLITANA;0;0;0;0;0;0;0;0;0;LED 49 49LJ5100 FHD;ELECTRONICA MAYOR
11577450;;F;51;CHILENO;;X;PROVIDENCIA                   ;METROPOLITANA;0;0;0;0;0;0;0;0;0;LED 32 CS32S1 SMART TV HD NEGRO;ELECTRONICA MAYOR
15138326;Casado;M;39;CHILENO;INGENIERO CIVIL INFORMATICO;X;PROVIDENCIA                   ;METROPOLITANA;0;0;0;0;0;0;0;0;0;LED 43 43LM6300PSB SMART TV HD;ELECTRONICA MAYOR
14437031;;M;47;CHILENO;;X;RENCA                         ;METROPOLITANA;0;0;0;0;0;0;0;0;0;LED 32 32S5295 SMART TV HD;ELECTRONICA MAYOR
17873856;;M;31;CHILENO;;Millenial;ARAUCO                        ;BIO BIO;0;0;0;0;0;0;0;0;0;LED 32 32S60-32P ANDROID TV SMART LINE HD;ELECTRONICA MAYOR
9943259;Casado;M;57;CHILENO;;Boomers;RENCA                         ;METROPOLITANA;0;0;0;0;0;0;0;0;0;LED 50 50PUD6513/44 SMART TV UHD 4K;ELECTRONICA MAYOR
12874390;;F;47;CHILENO;;X;PROVIDENCIA                   ;METROPOLITANA;0;0;0;0;0;0;0;0;0;LED 55 UN55NU7095GXZS SMART TV TV 4K;ELECTRONICA MAYOR
10421416;;F;56;CHILENO;;Boomers;PROVIDENCIA                   ;METROPOLITANA;0;0;0;0;0;0;0;0;0;PARLANTE ULTRAMAGIC;ELECTRONICA MAYOR
7380379;;M;69;CHILENO;;Silencioso;COIHAIQUE                     ;AYSEN;0;0;0;0;0;0;0;0;0;LED 43 43PFD5813 SMART TV FULL HD;ELECTRONICA MAYOR
23755804;;M;32;PERUANO;;Extranjero;QUINTA NORMAL                 ;METROPOLITANA;0;0;0;0;0;0;0;0;0;MINICOMPONENTE MX-T50/ZS ALL IN ONE;ELECTRONICA MAYOR
13752014;;M;42;CHILENO;;X;RENCA                         ;METROPOLITANA;0;0;0;0;0;0;0;0;0;LED 32 UN32T4300AGXZS HD SMART TV;ELECTRONICA MAYOR
17369612;;F;32;CHILENO;;Millenial;ARICA                         ;TARAPACA;0;0;0;0;0;0;0;0;0;LED 43 MI4328 SMART TV;ELECTRONICA MAYOR
10251711;;M;57;CHILENO;;Boomers;PROVIDENCIA                   ;METROPOLITANA;0;0;0;0;0;0;0;0;0;PARLANTE ULTRASENSATION;ELECTRONICA MAYOR
13291026;;M;45;CHILENO;;X;PADRE HURTADO                 ;METROPOLITANA;0;0;0;0;0;0;0;0;0;PARLANTE ULTRAMAGIC;ELECTRONICA MAYOR
26147283;;M;30;VENEZOLANO;;Extranjero;"";"";0;0;0;0;0;0;0;0;0;LED 32 32LM630BPSB SMART TV;ELECTRONICA MAYOR
17814896;;F;31;CHILENO;;Millenial;PROVIDENCIA                   ;METROPOLITANA;0;0;0;0;0;0;0;0;0;LED 43 43LM6300PSB SMART TV HD;ELECTRONICA MAYOR
7344756;;F;72;CHILENO;;Silencioso;CHILLAN                       ;BIO BIO;0;0;0;0;0;0;0;0;0;LED 32 32LK540 HD SMART;ELECTRONICA MAYOR
15864823;;F;37;CHILENO;;Millenial;PROVIDENCIA                   ;METROPOLITANA;0;0;0;0;0;0;0;0;0;MINICOMPONENTE RN5;ELECTRONICA MAYOR
12262277;;F;49;CHILENO;;X;INDEPENDENCIA                 ;METROPOLITANA;0;0;0;0;0;0;0;0;0;LED 58 58PUD6513/44 SMART TV UHD;ELECTRONICA MAYOR
17953872;;M;30;CHILENO;;Millenial;PUDAHUEL                      ;METROPOLITANA;0;0;0;0;0;0;0;0;0;EQUIPO SONIDO HCD-SHAKE X70;ELECTRONICA MAYOR
17582007;Soltero;F;32;CHILENO;;Millenial;PROVIDENCIA                   ;METROPOLITANA;0;0;0;0;0;0;0;0;0;PARLANTE ULTRAMEGA;ELECTRONICA MAYOR
16610312;Soltero;M;34;CHILENO;ABOGADO;Millenial;PROVIDENCIA                   ;METROPOLITANA;0;0;0;0;0;0;0;0;0;PARLANTE ULTRAMEGA;ELECTRONICA MAYOR
19040147;;M;27;CHILENO;;Z;PENAFLOR                      ;METROPOLITANA;0;0;0;0;0;0;0;0;0;PARLANTE ULTRAFORCE-I;ELECTRONICA MAYOR
17443959;Casado;F;31;CHILENO;;Millenial;PROVIDENCIA                   ;METROPOLITANA;0;0;0;0;0;0;0;0;0;LED 32 32LK540 HD SMART;ELECTRONICA MAYOR
11601354;Casado;M;52;CHILENO;;X;PROVIDENCIA                   ;METROPOLITANA;0;0;0;0;0;0;0;0;0;LED 43 43S5295 SMART TV FHD;ELECTRONICA MAYOR
12946336;;F;46;CHILENO;;X;RENCA                         ;METROPOLITANA;0;0;0;0;0;0;0;0;0;MINICOMPONENTE OL45;ELECTRONICA MAYOR
12613700;;M;48;CHILENO;;X;ANTOFAGASTA                   ;ANTOFAGASTA;0;0;0;0;0;0;0;0;0;LED 55 UN55NU7095GXZS SMART TV TV 4K;ELECTRONICA MAYOR
9607990;Casado;M;57;CHILENO;INGENIERO;Boomers;PROVIDENCIA                   ;METROPOLITANA;0;0;0;0;0;0;0;0;0;LED 70 70PUD6774 UHD SMART TV 4K;ELECTRONICA MAYOR
17968537;;F;29;CHILENO;;Millenial;PEUMO                         ;L.G.B.OÂ´HIGGINS;0;0;0;0;0;0;0;0;0;LED 49 49UN7100 UHD SMART TV;ELECTRONICA MAYOR
18052115;;M;30;CHILENO;;Millenial;LA PINTANA                    ;METROPOLITANA;0;0;0;0;0;0;0;0;0;LED 32 32LK540 HD SMART;ELECTRONICA MAYOR
25574718;;M;43;COLOMBIANO;;Extranjero;N/D;N/D;0;0;0;0;0;0;0;0;0;PARLANTE ULTRASENSATION;ELECTRONICA MAYOR
12107821;;M;44;CHILENO;;X;MONTE PATRIA                  ;COQUIMBO;0;0;0;0;0;0;0;0;0;LED 49 49UN7100 UHD SMART TV;ELECTRONICA MAYOR
12287262;;F;50;CHILENO;;X;SAN BERNARDO                  ;METROPOLITANA;0;0;0;0;0;0;0;0;0;LED 49 49LJ5100 FHD;ELECTRONICA MAYOR
12897341;;M;47;CHILENO;;X;LA PINTANA                    ;METROPOLITANA;0;0;0;0;0;0;0;0;0;LED 43 CS43S1USM UHD SMART TV NEGRO;ELECTRONICA MAYOR
6310231;;F;73;CHILENO;;Silencioso;PROVIDENCIA                   ;METROPOLITANA;0;0;0;0;0;0;0;0;0;MINICOMPONENTE OL45;ELECTRONICA MAYOR
8309550;;M;63;CHILENO;;Boomers;PROVIDENCIA                   ;METROPOLITANA;0;0;0;0;0;0;0;0;0;LED 50 UN50TU7090GXZS UHD SMART TV;ELECTRONICA MAYOR
7888577;;F;62;CHILENO;;Boomers;ARICA                         ;ARICA Y PARINACOTA;0;0;0;0;0;0;0;0;0;KARAOKE STREET3 8 CON MICROFONO ORANGE;ELECTRONICA MAYOR
9786118;;M;59;CHILENO;;Boomers;LA FLORIDA                    ;METROPOLITANA;0;0;0;0;0;0;0;0;0;MINICOMPONENTE OL45;ELECTRONICA MAYOR
10215371;;M;58;CHILENO;;Boomers;RENCA                         ;METROPOLITANA;0;0;0;0;0;0;0;0;0;LED 55 UN55TU8300GXZS UHD SMART TV CURVO;ELECTRONICA MAYOR
9358018;;F;61;CHILENO;;Boomers;RENCA                         ;METROPOLITANA;0;0;0;0;0;0;0;0;0;PARLANTE ULTRAFORCE-I;ELECTRONICA MAYOR
9799759;Casado;F;59;CHILENO;;Boomers;RENCA                         ;METROPOLITANA;0;0;0;0;0;0;0;0;0;LED 32 UN32T4300AGXZS HD SMART TV;ELECTRONICA MAYOR
11911591;Casado;M;51;CHILENO;;X;PROVIDENCIA                   ;METROPOLITANA;0;0;0;0;0;0;0;0;0;MONITOR 24 24TL520S SMART TV HD;ELECTRONICA MAYOR
6828757;;F;69;CHILENO;;Silencioso;PANQUEHUE                     ;VALPARAISO;0;0;0;0;0;0;0;0;0;LED 32 UN32T4300AGXZS HD SMART TV;ELECTRONICA MAYOR
11943251;;F;50;CHILENO;;X;N/D;N/D;0;0;0;0;0;0;0;0;0;KARAOKE RHYTHM CHARGER 12 MIC CABLE 8890;ELECTRONICA MAYOR
5954569;Casado;M;74;CHILENO;;Silencioso;LOTA                          ;BIO BIO;0;0;0;0;0;0;0;0;0;LED 32 32LK540 HD SMART;ELECTRONICA MAYOR
7863517;;M;64;CHILENO;;Boomers;RENCA                         ;METROPOLITANA;0;0;0;0;0;0;0;0;0;LED 43 UN43TU7090GXZS UHD SMART TV;ELECTRONICA MAYOR
12824390;;M;46;CHILENO;;X;VINA DEL MAR                  ;VALPARAISO;0;0;0;0;0;0;0;0;0;MINICOMPONENTE MHC-M40D/C;ELECTRONICA MAYOR
9949186;;F;61;CHILENO;;Boomers;PROVIDENCIA                   ;METROPOLITANA;0;0;0;0;0;0;0;0;0;MINICOMPONENTE MHC-V02 ALL IN ONE;ELECTRONICA MAYOR
6877908;;M;68;CHILENO;;Silencioso;COLINA                        ;METROPOLITANA;0;0;0;0;0;0;0;0;0;MINICOMPONENTE OL45;ELECTRONICA MAYOR
13055346;;M;46;CHILENO;;X;PROVIDENCIA                   ;METROPOLITANA;0;0;0;0;0;0;0;0;0;LED 32 32LM630BPSB SMART TV;ELECTRONICA MAYOR
25978806;;M;32;VENEZOLANO;;Extranjero;SANTIAGO                      ;METROPOLITANA;0;0;0;0;0;0;0;0;0;LED 50 UN50TU7090GXZS UHD SMART TV;ELECTRONICA MAYOR
14442279;;M;47;CHILENO;;X;N/D;N/D;0;0;0;0;0;0;0;0;0;LED 43 43PFD5813 SMART TV FULL HD;ELECTRONICA MAYOR
16529661;;F;35;CHILENO;;Millenial;PROVIDENCIA                   ;METROPOLITANA;0;0;0;0;0;0;0;0;0;LED 55 UN55NU7095GXZS SMART TV TV 4K;ELECTRONICA MAYOR
17220599;Soltero;F;32;CHILENO;;Millenial;RENCA                         ;METROPOLITANA;0;0;0;0;0;0;0;0;0;KARAOKE SP-101BT ALL IN ONE PORTATIL 60W;ELECTRONICA MAYOR
16348919;;M;35;CHILENO;;Millenial;CALAMA                        ;ANTOFAGASTA;0;0;0;0;0;0;0;0;0;KARAOKE PORTATIL TWO-EIGHT 8860;ELECTRONICA MAYOR
7889174;;F;65;CHILENO;;Boomers;N/D;N/D;0;0;0;0;0;0;0;0;0;LED 32 UN32T4300AGXZS HD SMART TV;ELECTRONICA MAYOR
19970300;;F;24;CHILENO;;Z;N/D;N/D;0;0;0;0;0;0;0;0;0;LED 43 UN43TU7090GXZS UHD SMART TV;ELECTRONICA MAYOR
13975678;;M;41;CHILENO;;X;PROVIDENCIA                   ;METROPOLITANA;0;0;0;0;0;0;0;0;0;PARLANTE BOLA DISCO CON MICROFONO INAL;ELECTRONICA MAYOR
13384755;;M;43;CHILENO;;X;ARAUCO                        ;BIO BIO;0;0;0;0;0;0;0;0;0;LED 43 MI4328 SMART TV;ELECTRONICA MAYOR
12407511;;M;49;CHILENO;;X;PUENTE ALTO                   ;METROPOLITANA;0;0;0;0;0;0;0;0;0;LED 43 MI4328 SMART TV;ELECTRONICA MAYOR
15758311;;M;38;CHILENO;;X;"";"";0;0;0;0;0;0;0;0;0;LED 40 SSM40291 SMART TV;ELECTRONICA MAYOR
15798045;;M;38;CHILENO;;Millenial;PICHIDEGUA                    ;L.G.B.OÂ´HIGGINS;0;0;0;0;0;0;0;0;0;MINICOMPONENTE RN5;ELECTRONICA MAYOR
16592891;;M;35;CHILENO;;Millenial;N/D;N/D;0;0;0;0;0;0;0;0;0;SOUNDBAR HW-Q70T/ZS;ELECTRONICA MAYOR
13035510;Casado;M;46;CHILENO;INGENIERO EN ADMINISTRACION DE EMPRESAS;X;PROVIDENCIA                   ;METROPOLITANA;0;0;0;0;0;0;0;0;0;LED 55 UN55TU7100GXZS SMART TV;ELECTRONICA MAYOR
4771165;;M;74;CHILENO;;Silencioso;PROVIDENCIA                   ;METROPOLITANA;0;0;0;0;0;0;0;0;0;LED 43 43LM6300PSB SMART TV HD;ELECTRONICA MAYOR
12022969;;F;49;CHILENO;;X;PROVIDENCIA                   ;METROPOLITANA;0;0;0;0;0;0;0;0;0;KARAOKE RHYTHM CHARGER 12 MIC CABLE 8890;ELECTRONICA MAYOR
8694907;;M;62;CHILENO;;Boomers;PROVIDENCIA                   ;METROPOLITANA;0;0;0;0;0;0;0;0;0;LED 50 UN50TU7090GXZS UHD SMART TV;ELECTRONICA MAYOR
19254807;;F;26;CHILENO;;Extranjero;MOSTAZAL                      ;L.G.B.OÂ´HIGGINS;0;0;0;0;0;0;0;0;0;LED 32 32PHD5813 SMART TV HD;ELECTRONICA MAYOR
10250265;;M;56;CHILENO;;Boomers;N/D;N/D;0;0;0;0;0;0;0;0;0;LED 32 32S5295 SMART TV HD;ELECTRONICA MAYOR
17492406;;F;32;CHILENO;;Millenial;N/D;N/D;0;0;0;0;0;0;0;0;0;LED 32 32S5295 SMART TV HD;ELECTRONICA MAYOR
19211935;;F;26;CHILENO;;Z;PROVIDENCIA                   ;METROPOLITANA;0;0;0;0;0;0;0;0;0;LED KIOTO 32 MI3228 SMART TV;ELECTRONICA MAYOR
14147442;;M;40;CHILENO;;X;SANTIAGO                      ;METROPOLITANA;0;0;0;0;0;0;0;0;0;LED 32 32S5295 SMART TV HD;ELECTRONICA MAYOR
4486011;;M;85;CHILENO;;Silencioso;SAN ANTONIO                   ;VALPARAISO;0;0;0;0;0;0;0;0;0;MINICOMPONENTE MHC-V13 ALL IN ONE;ELECTRONICA MAYOR
17787368;;M;31;CHILENO;;Millenial;LAJA                          ;BIO BIO;0;0;0;0;0;0;0;0;0;PARLANTE DJ VIBRANIUM;ELECTRONICA MAYOR
16307371;;F;36;CHILENO;;Millenial;PROVIDENCIA                   ;METROPOLITANA;0;0;0;0;0;0;0;0;0;LED KIOTO 32 MI3228 SMART TV;ELECTRONICA MAYOR
13840129;;F;41;CHILENO;;X;LA FLORIDA                    ;METROPOLITANA;0;0;0;0;0;0;0;0;0;KARAOKE STREET3 8 CON MICROFONO RED;ELECTRONICA MAYOR
9365936;;M;60;CHILENO;;Boomers;VILLA ALEGRE                  ;MAULE;0;0;0;0;0;0;0;0;0;SOUNDBAR HW-T450/ZS;ELECTRONICA MAYOR
13339439;;F;43;CHILENO;;X;N/D;N/D;0;0;0;0;0;0;0;0;0;LED 32 UN32T4300AGXZS HD SMART TV;ELECTRONICA MAYOR
16434995;;F;35;CHILENO;;Millenial;RENCA                         ;METROPOLITANA;0;0;0;0;0;0;0;0;0;KARAOKE FUNKY DISCO;ELECTRONICA MAYOR
18524612;Soltero;M;28;CHILENO;;Millenial;PROVIDENCIA                   ;METROPOLITANA;0;0;0;0;0;0;0;0;0;LED 32 32S5295 SMART TV HD;ELECTRONICA MAYOR
11555343;;F;51;CHILENO;;X;PROVIDENCIA                   ;METROPOLITANA;0;0;0;0;0;0;0;0;0;LED 43 43UN7300 UHD SMART TV 4K;ELECTRONICA MAYOR
11815176;Divorciado;M;50;CHILENO;;X;RENCA                         ;METROPOLITANA;0;0;0;0;0;0;0;0;0;QLED 55 QN55Q60TAGXZS SMART TV;ELECTRONICA MAYOR
10867762;;F;56;CHILENO;;Boomers;SAN FERNANDO                  ;L.G.B.OÂ´HIGGINS;0;0;0;0;0;0;0;0;0;LED 58 58PUD6513/44 SMART TV UHD;ELECTRONICA MAYOR
19460366;;M;24;CHILENO;;Z;PROVIDENCIA                   ;METROPOLITANA;0;0;0;0;0;0;0;0;0;LED 32 CS32S1 SMART TV HD NEGRO;ELECTRONICA MAYOR
8940218;Casado;F;62;CHILENO;;Boomers;PROVIDENCIA                   ;METROPOLITANA;0;0;0;0;0;0;0;0;0;LED 32 32HD740 HD DTV NEGRO;ELECTRONICA MAYOR
11550495;;M;52;CHILENO;;X;PROVIDENCIA                   ;METROPOLITANA;0;0;0;0;0;0;0;0;0;LED 32 UN32T4300AGXZS HD SMART TV;ELECTRONICA MAYOR
25635645;;M;39;VENEZOLANO;;Extranjero;SAN MIGUEL                    ;METROPOLITANA;0;0;0;0;0;0;0;0;0;LED 43 43S6500 SMART TV TV FHD;ELECTRONICA MAYOR
5081582;;F;75;CHILENO;;Silencioso;ANCUD                         ;LOS LAGOS;0;0;0;0;0;0;0;0;0;LED KIOTO 32 MI3228 SMART TV;ELECTRONICA MAYOR
18573415;;F;28;CHILENO;;Millenial;PROVIDENCIA                   ;METROPOLITANA;0;0;0;0;0;0;0;0;0;LED 43 MI4328 SMART TV;ELECTRONICA MAYOR
10020458;;M;56;CHILENO;;Boomers;VINA DEL MAR                  ;VALPARAISO;257980;2;1;2;1;257980;0;0;0;BICICLETA VISION BRASS ARO 27,5 ALUMINIO 18V.;BICICLETAS
26511532;;M;39;NO INFORMA NACIONALIDAD;;X;INDEPENDENCIA;METROPOLITANA;118990;1;1;0;0;0;1;1;118990;V-MTB ARO 16 HOMBRE AVENGERS GRIS;BICICLETAS
6806100;;F;67;CHILENO;;Boomers;LOS ANDES                     ;VALPARAISO;1048620;11;6;0;0;0;11;6;1048620;BICI ALLEYCAT BLAN/ROSA 28 FITZER;BICICLETAS
7367815;;M;64;CHILENO;;Boomers;SAN FERNANDO                  ;L.G.B.OÂ´HIGGINS;599261;8;4;0;0;0;8;4;599261;BICI ALLEYCAT NEGRA/TURQUESA 28 FITZER;BICICLETAS
12866141;;M;47;CHILENO;;Silencioso;N/D;N/D;173970;4;2;4;2;173970;0;0;0;CASCO SUNPEED NEGRO L;BICICLETAS
18111977;;M;29;CHILENO;;Millenial;CORONEL                       ;BIO BIO;459240;3;2;0;0;0;3;2;459240;BICI VIGOR NEGRA 24 V-BRAKE;BICICLETAS
6904917;;F;68;CHILENO;;Boomers;N/D;N/D;1456060;12;7;0;0;0;12;7;1456060;BICICLETA MONKEL 29 ALUMINIO AZUL;BICICLETAS
15565787;;F;38;CHILENO;;X;SANTIAGO;METROPOLITANA;231970;3;1;3;1;231970;0;0;0;BICI ALLEYCAT NEGRA 28 FITZER;BICICLETAS
17593758;;M;31;CHILENO;;Millenial;PROVIDENCIA                   ;METROPOLITANA;182980;2;1;2;1;182980;0;0;0;BICI VIGORPLUS NEGRA 27,5 V-BRAKE;BICICLETAS
14335677;Soltero;M;45;CHILENO;;X;PENCAHUE                      ;MAULE;305780;2;1;0;0;0;2;1;305780;BICICLETA MONKEL 29 ALUMINIO GRIS;BICICLETAS
19139656;Soltero;F;26;CHILENO;;Z;PROVIDENCIA                   ;METROPOLITANA;150980;2;1;2;1;150980;0;0;0;BICI ALLEYCAT NEGRA/TURQUESA 28 FITZER;BICICLETAS
18213136;;M;29;CHILENO;;Millenial;PROVIDENCIA                   ;METROPOLITANA;1051920;7;3;7;3;1051920;0;0;0;BC XTS MTB ALU MAVERICK 29 VEL DISCO NARANJO;BICICLETAS
10197766;;M;53;CHILENO;;X;RENCA                         ;METROPOLITANA;259990;1;1;0;0;0;1;1;259990;MODELO SUNPEED ZERO ARO 29 GRAFITO M;BICICLETAS
18888157;;M;27;CHILENO;;Z;PANGUIPULLI                   ;LOS RIOS;70480;2;1;0;0;0;2;1;70480;BICICLETA INFANTIL ARO 12 ROSADA;BICICLETAS
16823974;Soltero;M;34;CHILENO;;Millenial;N/D;N/D;219990;1;1;0;0;0;1;1;219990;BICI STRIKER AMARILLA 29 V-BRAKE;BICICLETAS
17634966;;M;31;CHILENO;;Millenial;QUILLOTA;VALPARAISO;259970;3;2;2;1;219980;1;1;39990;BC XTS MTB ALU STRIKER 29 21VEL DISCO NEGRO;BICICLETAS
11464758;;M;53;CHILENO;;X;ARICA                         ;ARICA Y PARINACOTA;249990;1;1;0;0;0;1;1;249990;V-BICICLETA MTB XT-9001 ARO 26;BICICLETAS
9698644;;F;56;CHILENO;;Boomers;ANCUD                         ;LOS LAGOS;101980;2;1;2;1;101980;0;0;0;BICICLETA INFANTIL ARO 20 ROSADA;BICICLETAS
8868570;;M;62;CHILENO;;Boomers;PROVIDENCIA                   ;METROPOLITANA;11980;2;1;0;0;0;2;1;11980;PRODUCTO 2A BICICLETAS BANDA 2;BICICLETAS
8172770;;M;61;CHILENO;;Boomers;MELIPILLA                     ;METROPOLITANA;89990;1;1;0;0;0;1;1;89990;MOTOBIKE NARANJA ARO 16;BICICLETAS
15922246;;M;37;CHILENO;;Millenial;PROVIDENCIA                   ;METROPOLITANA;129990;1;1;1;1;129990;0;0;0;BICI RETROPLUS ROSADA 26 V-BRAKE;BICICLETAS
19985569;;F;23;CHILENO;;Z;PROVIDENCIA                   ;METROPOLITANA;119980;2;1;2;1;119980;0;0;0;BICI ALLEYCAT NEGRA/TURQUESA 28 FITZER;BICICLETAS
19763453;;M;24;CHILENO;;Z;PROVIDENCIA                   ;METROPOLITANA;124980;2;1;2;1;124980;0;0;0;BICI ALLEYCAT NEGRA/TURQUESA 28 FITZER;BICICLETAS
14301597;;F;46;CHILENO;;X;CANETE                        ;BIO BIO;189990;1;1;0;0;0;1;1;189990;BICI VIGORPLUS NEGRA 27,5 V-BRAKE;BICICLETAS
20097965;;M;23;CHILENO;;Z;N/D;N/D;379980;2;2;0;0;0;2;2;379980;BICI VIGORPLUS NEGRA 27,5 V-BRAKE;BICICLETAS
16122642;;M;37;CHILENO;;Millenial;N/D;N/D;79990;1;1;0;0;0;1;1;79990;BICICLETA INFANTIL ARO 16 AZUL;BICICLETAS
18150276;;F;29;CHILENO;;Millenial;N/D;N/D;488800;6;5;2;1;295840;4;4;192960;BIANCHI ADVANTAGE 27,5 SX GRIS OSCURO SEMI MATTE;BICICLETAS
11609510;;M;51;CHILENO;;X;PAINE                         ;METROPOLITANA;224970;3;2;0;0;0;3;2;224970;HOTWHEELS 20 ROJO;BICICLETAS
14552313;;F;46;CHILENO;;X;MOLINA                        ;MAULE;568940;6;3;0;0;0;6;3;568940;BICICLETA VISION KRYPTON ALUMINIO (NEGRO / NARAN;BICICLETAS
17252716;;F;32;CHILENO;;Millenial;LA FLORIDA                    ;METROPOLITANA;87540;2;1;2;1;87540;0;0;0;MOTOBIKE INFANTIL ROJA ARO 12;BICICLETAS
16706976;;F;35;CHILENO;;Millenial;N/D;N/D;315830;3;2;2;1;65840;1;1;249990;BICICLETA MONKEL 29 ALUMINIO AZUL;BICICLETAS
6095763;Casado;M;72;CHILENO;;Silencioso;PROVIDENCIA                   ;METROPOLITANA;289980;2;2;0;0;0;2;2;289980;BICI RETROPLUS VERDE 26 V-BRAKE;BICICLETAS
12955629;;M;46;CHILENO;;X;VALLENAR;ATACAMA;89990;1;1;0;0;0;1;1;89990;BICICLETA INFANTIL ARO 16 ROSADA;BICICLETAS
11278067;;F;54;CHILENO;;Boomers;SAN ANTONIO                   ;VALPARAISO;99990;1;1;0;0;0;1;1;99990;V-MTB ARO 16 HOMBRE AVENGERS GRIS;BICICLETAS
9685113;;F;57;CHILENO;;Boomers;ARICA                         ;ARICA Y PARINACOTA;279990;1;1;0;0;0;1;1;279990;BICICLETA MTB VERMONT ARO 27,5 VIOLETA;BICICLETAS
17193918;;F;33;CHILENO;;Millenial;N/D;N/D;340620;4;2;4;2;340620;0;0;0;BICICLETA INFANTIL ARO 16 NEGRA;BICICLETAS
18995105;;M;27;CHILENO;;Millenial;"";"";534980;2;1;0;0;0;2;1;534980;V-BICICLETA MTB XT-9003 ARO 27.5;BICICLETAS
16026653;;M;37;CHILENO;;Millenial;RANCAGUA                      ;L.G.B.OÂ´HIGGINS;69990;1;1;0;0;0;1;1;69990;BICICLETA INFANTIL ARO 12 ROSADA;BICICLETAS
18140525;;F;30;CHILENO;;Millenial;PROVIDENCIA                   ;METROPOLITANA;118640;2;1;2;1;118640;0;0;0;BICICLETA INFANTIL ARO 20 AMARILLA;BICICLETAS
17604812;;F;31;CHILENO;;Millenial;FRUTILLAR                     ;LOS LAGOS;227080;4;2;4;2;227080;0;0;0;BICICLETA INFANTIL ARO 20 AMARILLA;BICICLETAS
17392066;Soltero;F;33;CHILENO;;Millenial;PROVIDENCIA                   ;METROPOLITANA;89640;2;1;2;1;89640;0;0;0;BICICLETA INFANTIL ARO 16 AZUL;BICICLETAS
11812438;;M;51;CHILENO;;X;SANTA CRUZ                    ;L.G.B.OÂ´HIGGINS;341980;2;1;0;0;0;2;1;341980;BIANCHI STONE MOUNTAIN 29 SX ALLOY SIZE L CELEST;BICICLETAS
6152891;Casado;M;74;CHILENO;;Silencioso;RENCA                         ;METROPOLITANA;84990;1;1;0;0;0;1;1;84990;BICICLETA INFANTIL ARO 12 AMARILLA;BICICLETAS
17987168;;F;30;CHILENO;;Millenial;MELIPILLA                     ;METROPOLITANA;89990;1;1;0;0;0;1;1;89990;MOTOBIKE NARANJA ARO 16;BICICLETAS
13947394;Casado;M;42;CHILENO;TECNICO JURIDICO;X;RENCA                         ;METROPOLITANA;103980;2;1;2;1;103980;0;0;0;BICICLETA INFANTIL ARO 16 ROSADA;BICICLETAS
11493286;;M;52;CHILENO;;X;RENCA                         ;METROPOLITANA;125840;2;1;2;1;125840;0;0;0;BICICLETA INFANTIL ARO 20 NEGRA;BICICLETAS
5525461;;F;74;CHILENO;;Silencioso;RENCA                         ;METROPOLITANA;123980;2;1;2;1;123980;0;0;0;V-MTB ARO 16 HULK VERDE;BICICLETAS
13858090;;M;41;CHILENO;;X;PROVIDENCIA                   ;METROPOLITANA;93980;2;1;2;1;93980;0;0;0;BICICLETA INFANTIL ARO 20 AMARILLA;BICICLETAS
9849359;;F;57;CHILENO;;Boomers;LA SERENA                     ;COQUIMBO;139990;1;1;0;0;0;1;1;139990;V-MTB ARO 16 HOMBRE AVENGERS GRIS;BICICLETAS
15216448;;F;40;CHILENO;;X;N/D;N/D;198980;2;1;2;1;198980;0;0;0;BICI RETROPLUS VERDE 26 V-BRAKE;BICICLETAS
5072067;;M;71;CHILENO;;Silencioso;PROVIDENCIA                   ;METROPOLITANA;194980;2;1;2;1;194980;0;0;0;BICI RETROPLUS VERDE 26 V-BRAKE;BICICLETAS
16832890;;F;34;CHILENO;;Millenial;RENCA                         ;METROPOLITANA;98640;2;1;2;1;98640;0;0;0;BICICLETA INFANTIL ARO 20 NEGRA;BICICLETAS
13627070;;F;43;CHILENO;;X;LEBU                          ;BIO BIO;332380;2;1;0;0;0;2;1;332380;BICICLETA MONKEL 29 ALUMINIO GRIS;BICICLETAS
19063884;Soltero;M;26;CHILENO;;Silencioso;PROVIDENCIA                   ;METROPOLITANA;0;0;0;0;0;0;0;0;0;BICICLETA VISION KRYPTON ALUMINIO (NEGRO / VERDE;BICICLETAS
11559311;;M;51;CHILENO;;X;CURICO                        ;MAULE;0;0;0;0;0;0;0;0;0;BICI STRIKER NEGRA 29 FRENO DISCO;BICICLETAS
10562596;;F;49;CHILENO;;X;RENCA                         ;METROPOLITANA;0;0;0;0;0;0;0;0;0;MODELO SUNPEED STELLA ARO 27.5 MORADA S;BICICLETAS
13878569;;M;42;CHILENO;;X;VALPARAISO                    ;VALPARAISO;0;0;0;0;0;0;0;0;0;MTB EXPLORER BICYSTAR ARO 29 PLOMO NARANJO;BICICLETAS
17187461;;F;32;CHILENO;;Millenial;N/D;N/D;0;0;0;0;0;0;0;0;0;MTB EXPLORER BICYSTAR ARO 29 AZUL-AMARILLO;BICICLETAS
16361667;;F;35;CHILENO;;Millenial;TALAGANTE                     ;METROPOLITANA;0;0;0;0;0;0;0;0;0;BICICLETA INFANTIL ARO 12 AMARILLA;BICICLETAS
17783048;;M;31;CHILENO;;Millenial;PROVIDENCIA                   ;METROPOLITANA;0;0;0;0;0;0;0;0;0;MODELO UPLAND 380 DISCO ARO 28 HIBRIDO GRIS;BICICLETAS
15947908;;M;37;CHILENO;;Millenial;ANTOFAGASTA                   ;ANTOFAGASTA;0;0;0;0;0;0;0;0;0;BICI METROPOLE GRIS 28 CITYBIKE;BICICLETAS
12851347;;F;46;CHILENO;;X;PROVIDENCIA                   ;METROPOLITANA;0;0;0;0;0;0;0;0;0;BICI RETROPLUS VERDE 26 V-BRAKE;BICICLETAS
17201397;Casado;F;33;CHILENO;;Millenial;PROVIDENCIA                   ;METROPOLITANA;0;0;0;0;0;0;0;0;0;BICICLETA INFANTIL ARO 20 NEGRA;BICICLETAS
7436288;;M;68;CHILENO;;Boomers;ESTACION CENTRAL              ;METROPOLITANA;0;0;0;0;0;0;0;0;0;BICI OX 27 LUNA 18V MORADO/LILA;BICICLETAS
11641003;Casado;F;51;CHILENO;INGENIERO COMERCIAL;X;RENCA                         ;METROPOLITANA;0;0;0;0;0;0;0;0;0;BICICLETA INFANTIL ARO 20 ROSADA;BICICLETAS
16627052;;F;34;CHILENO;;Millenial;LITUECHE                      ;L.G.B.OÂ´HIGGINS;0;0;0;0;0;0;0;0;0;BICI CITYPETITE VERDE 24 V-BRAKE;BICICLETAS
13988836;;F;40;CHILENO;;X;VILLA ALEMANA                 ;VALPARAISO;0;0;0;0;0;0;0;0;0;CASCO TOY STORY 4 BUZZ 3D LIGHTYEAR;BICICLETAS
6857842;;F;67;CHILENO;;Boomers;NOGALES                       ;VALPARAISO;0;0;0;0;0;0;0;0;0;BICI VIGORPLUS NEGRA 27,5 V-BRAKE;BICICLETAS
17527239;;F;31;CHILENO;;Millenial;N/D;N/D;0;0;0;0;0;0;0;0;0;BICI VIGORPLUS VERDE 27,5 V-BRAKE;BICICLETAS
10076633;;M;57;CHILENO;;Boomers;VICTORIA                      ;ARAUCANIA;0;0;0;0;0;0;0;0;0;BICI BMX FREESTYLE ARO 20 AZUL;BICICLETAS
16803203;;F;35;CHILENO;;Millenial;PROVIDENCIA                   ;METROPOLITANA;0;0;0;0;0;0;0;0;0;BICICLETA BARBIE ARO12 BLANCO;BICICLETAS
18986689;;F;26;CHILENO;;Z;OVALLE                        ;COQUIMBO;0;0;0;0;0;0;0;0;0;BICI BMX FREESTYLE ARO 20 AZUL;BICICLETAS
16059354;;F;36;CHILENO;;Millenial;CALERA                        ;VALPARAISO;0;0;0;0;0;0;0;0;0;BICI VIGORPLUS NEGRA 27,5 V-BRAKE;BICICLETAS
10449510;;F;55;CHILENO;;Boomers;RENCA                         ;METROPOLITANA;0;0;0;0;0;0;0;0;0;BICI VIGORPLUS VERDE 27,5 V-BRAKE;BICICLETAS
13077894;;M;46;CHILENO;;X;MAIPU;METROPOLITANA;0;0;0;0;0;0;0;0;0;BICICLETA INFANTIL ARO 16 ROSADA;BICICLETAS
11381537;Soltero;M;52;CHILENO;;X;RENCA                         ;METROPOLITANA;0;0;0;0;0;0;0;0;0;BICI BMX JUMP PRO ARO 20 PLATEADA;BICICLETAS
12974231;;M;45;CHILENO;;X;PROVIDENCIA                   ;METROPOLITANA;0;0;0;0;0;0;0;0;0;BICICLETA INFANTIL ARO 16 ROSADA;BICICLETAS
16605018;;M;35;CHILENO;;Millenial;PROVIDENCIA                   ;METROPOLITANA;0;0;0;0;0;0;0;0;0;BICICLETA INFANTIL ARO 12 ROJA;BICICLETAS
16990386;;M;34;CHILENO;;Millenial;CONCON                        ;VALPARAISO;0;0;0;0;0;0;0;0;0;BICICLETA APRENDIZAJE CON CASCO RED;BICICLETAS
15070512;;M;38;CHILENO;;X;QUILPUE                       ;VALPARAISO;0;0;0;0;0;0;0;0;0;BICICLETA INFANTIL ARO 20 BLANCA;BICICLETAS
9739345;;F;45;CHILENO;;X;RENCA                         ;METROPOLITANA;0;0;0;0;0;0;0;0;0;BIANCHI MTB-26 PRO ST AZUL;BICICLETAS
11947843;Casado;F;50;CHILENO;;X;PROVIDENCIA                   ;METROPOLITANA;0;0;0;0;0;0;0;0;0;BICI BMX FREESTYLE ARO 20 NEGRA;BICICLETAS
17222769;;F;32;CHILENO;;Millenial;PROVIDENCIA                   ;METROPOLITANA;0;0;0;0;0;0;0;0;0;BICICLETA FORZA BAMBINO NN-BKRE;BICICLETAS
20094028;;M;23;CHILENO;;Z;PROVIDENCIA                   ;METROPOLITANA;62980;2;1;2;1;62980;0;0;0;MI PRIMER TRAMPOLIN 140CM GAMEPOWER AZUL/AMARILL;OUTDOOR
18795237;Soltero;M;28;CHILENO;;Millenial;BUIN;METROPOLITANA;99990;1;1;1;1;99990;0;0;0;CAMA ELASTICA (3,05M) CON MALLA GAMEPOWER AZUL;OUTDOOR
18269560;Soltero;M;30;CHILENO;INGENIERO DE EJECUCION MECANICO;Millenial;PUCHUNCAVI                    ;VALPARAISO;19980;2;1;2;1;19980;0;0;0;Scooter Peluche Dinosaurio y Luces Led KeyRiders;OUTDOOR
19754433;;F;24;CHILENO;;Z;PITRUFQUEN;ARAUCANIA;54980;2;1;2;1;54980;0;0;0;MINI TRAMPOLIN 38 GAMEPOWER AZUL;OUTDOOR
12910355;;M;47;CHILENO;;X;IQUIQUE                       ;TARAPACA;464680;6;5;0;0;0;6;5;464680;CAMA ELASTICA (1,83M) CON MALLA GAMEPOWER AZUL;OUTDOOR
19973117;;F;23;CHILENO;;Z;PROVIDENCIA                   ;METROPOLITANA;89990;1;1;0;0;0;1;1;89990;GO-KART PEDALES NEGRO;OUTDOOR
14041532;;F;41;CHILENO;;Silencioso;PROVIDENCIA                   ;METROPOLITANA;64990;1;1;0;0;0;1;1;64990;CAMA ELASTICA (1,83M) CON MALLA GAMEPOWER AZUL;OUTDOOR
7294587;;F;65;CHILENO;;Boomers;SANTA CRUZ                    ;L.G.B.OÂ´HIGGINS;775540;7;5;0;0;0;7;5;775540;GO-KART PEDALES ROJO;OUTDOOR
17201935;Soltero;F;33;CHILENO;MEDICO VETERINARIO;Millenial;PROVIDENCIA                   ;METROPOLITANA;54980;2;1;2;1;54980;0;0;0;MI PRIMER TRAMPOLIN 140CM GAMEPOWER AZUL/AMARILL;OUTDOOR
13554829;;F;43;CHILENO;;X;PROVIDENCIA                   ;METROPOLITANA;38980;2;1;2;1;38980;0;0;0;MINI TRAMPOLIN 38 GAMEPOWER AZUL;OUTDOOR
8998429;;M;57;CHILENO;;Boomers;PROVIDENCIA                   ;METROPOLITANA;137980;2;1;2;1;137980;0;0;0;Auto Electrico Descapotable Coupe Rojo;OUTDOOR
18801527;;F;28;CHILENO;;Millenial;ANCUD;LOS LAGOS;218510;5;3;4;2;186520;1;1;31990;Cuatrimoto Electrica Force Rosada;OUTDOOR
12351648;;M;49;CHILENO;;X;HIJUELAS                      ;VALPARAISO;129990;1;1;0;0;0;1;1;129990;CAMA ELASTICA (1,83M) CON MALLA GAMEPOWER AZUL;OUTDOOR
15778600;;M;38;CHILENO;;Millenial;RENCA                         ;METROPOLITANA;53980;2;1;2;1;53980;0;0;0;MI PRIMER TRAMPOLIN 140CM GAMEPOWER AZUL/AMARILL;OUTDOOR
15890225;;F;37;CHILENO;;Silencioso;"";"";58980;2;1;2;1;58980;0;0;0;MI PRIMER TRAMPOLIN 140CM GAMEPOWER AZUL/AMARILL;OUTDOOR
18654224;;F;28;CHILENO;;Millenial;CHIMBARONGO                   ;L.G.B.OÂ´HIGGINS;129990;1;1;0;0;0;1;1;129990;Auto Electrico 4x4 Descapotable Verde Militar;OUTDOOR
11002889;;F;56;CHILENO;;Boomers;"";"";201970;5;2;2;1;53980;3;1;147990;Centro Juegos 2en1 Juego De Bloques Y Escritorio;OUTDOOR
17569964;;M;32;CHILENO;;Millenial;PROVIDENCIA                   ;METROPOLITANA;137980;2;1;2;1;137980;0;0;0;Auto Electrico 4x4 Descapotable Verde Militar;OUTDOOR
15601020;;M;39;CHILENO;;X;PROVIDENCIA                   ;METROPOLITANA;137980;2;1;2;1;137980;0;0;0;Auto Electrico 4x4 Descapotable Verde Militar;OUTDOOR
16705279;;M;34;CHILENO;;Millenial;RENCA                         ;METROPOLITANA;142480;2;1;2;1;142480;0;0;0;Auto Electrico 4x4 Descapotable Verde Militar;OUTDOOR
16811676;;M;34;CHILENO;;Millenial;NATALES                       ;MAGALLANES;463920;8;4;0;0;0;8;4;463920;CAMA ELASTICA (2,44M) CON MALLA GAMEPOWER AZUL;OUTDOOR
17157849;;M;33;CHILENO;;Millenial;FLORIDA;BIO-BIO;289980;2;4;2;1;100840;0;3;189140;Auto Electrico Descapotable Coupe Rojo;OUTDOOR
13607473;Soltero;M;43;CHILENO;INGENIERO EN MAQUINARIA;X;RENCA                         ;METROPOLITANA;35980;2;1;0;0;0;2;1;35980;Juego de Mesa Camcorro 10 en 1;OUTDOOR
9709977;;M;59;CHILENO;;Boomers;N/D;N/D;191940;6;2;0;0;0;6;2;191940;Set De Ollas - Sarten Outback;OUTDOOR
15924078;Casado;M;38;CHILENO;PROFESOR;Millenial;RENCA                         ;METROPOLITANA;216980;2;2;1;1;16990;1;1;199990;Juego de Mesa Camcorro 10 en 1;OUTDOOR
15616989;;F;38;CHILENO;;Millenial;PROVIDENCIA                   ;METROPOLITANA;15990;1;1;0;0;0;1;1;15990;COLCHON 2 PZA 203X152X22 CM;OUTDOOR
15717375;;F;38;CHILENO;;X;PROVIDENCIA                   ;METROPOLITANA;15990;1;1;1;1;15990;0;0;0;COLCHON 2 PZA 203X152X22 CM;OUTDOOR
16319973;;F;36;CHILENO;;Millenial;"";"";120490;3;1;0;0;0;3;1;120490;Auto Electrico 4x4 Descapotable Verde Militar;OUTDOOR
16813144;;F;34;CHILENO;;Millenial;CASTRO                        ;LOS LAGOS;176980;2;2;0;0;0;2;2;176980;PISCINA CIRCULAR STEEL PRO 6473 L;OUTDOOR
10939083;;F;55;CHILENO;;Boomers;YERBAS BUENAS                 ;MAULE;394350;4;2;0;0;0;4;2;394350;PISCINA STEEL PRO 300X201X66CM;OUTDOOR
16156283;;F;35;CHILENO;;Millenial;N/D;N/D;85840;2;1;2;1;85840;0;0;0;PISCINA STEEL PRO 300X201X66CM;OUTDOOR
20090874;;F;24;CHILENO;;Z;PROVIDENCIA                   ;METROPOLITANA;141060;6;2;6;2;141060;0;0;0;V-SACO DE DORMIR MUMMY AZUL;OUTDOOR
15441347;;F;39;CHILENO;;X;VALLENAR;ATACAMA;359960;4;5;3;2;339970;1;3;19990;Scooter Peluche Flamenco y Luces Led KeyRiders;OUTDOOR
13638307;;M;43;CHILENO;;X;RENCA                         ;METROPOLITANA;40540;2;1;2;1;40540;0;0;0;V-BOLSO PORTA EQUIPAJE MEDIANO NAT GEO S17;OUTDOOR
13574173;Soltero;M;43;CHILENO;INGENIERO EN INFORMATICA;X;PROVIDENCIA                   ;METROPOLITANA;65480;2;1;2;1;65480;0;0;0;V-CARPA 4 PERSONAS TORONTO NAT GEO S17;OUTDOOR
18297128;;F;29;CHILENO;;Millenial;TEMUCO                        ;ARAUCANIA;66650;5;1;5;1;66650;0;0;0;V-QUITASOL AZUL NAT GEO S17;OUTDOOR
20620085;;F;21;CHILENO;;Z;N/D;N/D;85840;2;1;2;1;85840;0;0;0;PISCINA STEEL PRO 300X201X66CM;OUTDOOR
15797881;;M;38;CHILENO;;Millenial;PROVIDENCIA                   ;METROPOLITANA;29950;5;1;5;1;29950;0;0;0;V-SACO DORMIR ENVELOPE VERDE OUTBACK;OUTDOOR
17671354;;F;31;CHILENO;;Millenial;PROVIDENCIA                   ;METROPOLITANA;137950;4;1;4;1;137950;0;0;0;V-CARPA 6 PERSONAS TORONTO NAT GEO S17;OUTDOOR
18644801;;F;28;CHILENO;;Millenial;PROVIDENCIA                   ;METROPOLITANA;119990;1;1;0;0;0;1;1;119990;PISCINA CIRCULAR STEEL PRO;OUTDOOR
17606748;;F;30;CHILENO;;Millenial;"";"";24990;1;1;0;0;0;1;1;24990;Scooter con Burbujas KeyRiders;OUTDOOR
21305441;;F;44;ECUATORIANO;;Extranjero;N/D;N/D;109980;2;1;0;0;0;2;1;109980;PISCINA STEEL PRO 300X201X66CM;OUTDOOR
17179064;;M;37;CHILENO;;Millenial;PROVIDENCIA                   ;METROPOLITANA;119990;1;1;1;1;119990;0;0;0;PISCINA CIRCULAR STEEL PRO;OUTDOOR
18829227;;M;28;CHILENO;;Millenial;PROVIDENCIA                   ;METROPOLITANA;123980;2;1;2;1;123980;0;0;0;PISCINA CIRCULAR STEEL PRO;OUTDOOR
16186118;;F;37;CHILENO;;Millenial;PROVIDENCIA                   ;METROPOLITANA;15980;2;1;0;0;0;2;1;15980;BALON LANZA AGUA;OUTDOOR
16457124;;F;35;CHILENO;;Millenial;TALCA                         ;MAULE;59990;1;1;0;0;0;1;1;59990;TACA TACA MADERA EVER GROUP;OUTDOOR
14537509;;F;45;CHILENO;;X;SAN BERNARDO                  ;METROPOLITANA;69990;1;1;0;0;0;1;1;69990;PISCINA RECTANGULAR 150CM BESTWAY AZUL;OUTDOOR
8446517;;F;65;CHILENO;;Boomers;PARRAL                        ;MAULE;179990;1;1;0;0;0;1;1;179990;PISCINA RECTANGULAR 211CM BESTWAY AZUL;OUTDOOR
18906446;Soltero;F;27;CHILENO;;Millenial;PROVIDENCIA                   ;METROPOLITANA;153980;2;1;2;1;153980;0;0;0;PISCINA CIRCULAR STEEL PRO 6473 L;OUTDOOR
10052728;Soltero;M;57;CHILENO;;Boomers;PROVIDENCIA                   ;METROPOLITANA;29990;1;1;0;0;0;1;1;29990;Scooter Lanza Agua hasta 5 mts KeyRiders;OUTDOOR
10986632;;F;41;CHILENO;;Millenial;N/D;N/D;93980;2;1;2;1;93980;0;0;0;GO-KART PEDALES ROJO;OUTDOOR
8369234;;F;70;CHILENO;;Boomers;LANCO                         ;LOS RIOS;89990;1;1;0;0;0;1;1;89990;PISCINA STEEL PRO 300X201X66CM;OUTDOOR
17497116;Casado;M;31;CHILENO;PROFESOR;Millenial;PROVIDENCIA                   ;METROPOLITANA;125480;2;1;2;1;125480;0;0;0;PISCINA CIRCULAR STEEL PRO;OUTDOOR
21635408;;F;31;CHILENO;;Extranjero;NATALES                       ;MAGALLANES;79990;1;1;0;0;0;1;1;79990;PISCINA STEEL PRO 300X201X66CM;OUTDOOR
19713312;;F;24;CHILENO;;Z;N/D;N/D;220970;3;3;1;1;189990;2;2;30980;Scooter Lanza Agua hasta 5 mts KeyRiders;OUTDOOR
13195489;;M;44;CHILENO;;X;RENCA                         ;METROPOLITANA;119990;1;1;0;0;0;1;1;119990;SCOOTER ELECTRICO CERO EKIDS NEGRO;OUTDOOR
12516175;;M;49;CHILENO;;X;N/D;N/D;72990;1;1;0;0;0;1;1;72990;PISCINA RECTANGULAR 150CM BESTWAY AZUL;OUTDOOR
19567996;;F;25;CHILENO;;Extranjero;LOS LAGOS                     ;LOS LAGOS;229980;2;2;0;0;0;2;2;229980;CAMA ELASTICA (1,83M) CON MALLA GAMEPOWER AZUL;OUTDOOR
10032147;;F;59;CHILENO;;Boomers;RENCA                         ;METROPOLITANA;21990;1;1;0;0;0;1;1;21990;Juego de Mesa Camcorro 10 en 1;OUTDOOR
16181765;;M;36;CHILENO;;Millenial;TALAGANTE                     ;METROPOLITANA;0;0;2;0;0;0;0;2;0;Scooter Vapor Hot Wheels;OUTDOOR
17859615;Soltero;F;31;CHILENO;;Millenial;PROVIDENCIA                   ;METROPOLITANA;84980;2;1;2;1;84980;0;0;0;PISCINA STEEL PRO 300X201X66CM;OUTDOOR
12180816;;F;50;CHILENO;;X;RENCA                         ;METROPOLITANA;311680;4;2;4;2;311680;0;0;0;PISCINA CIRCULAR STEEL PRO 6473 L;OUTDOOR
21023352;;M;20;CHILENO;;Z;N/D;N/D;37960;4;2;0;0;0;4;2;37960;Juego de Mesa Camcorro 10 en 1;OUTDOOR
17717186;;F;31;CHILENO;;Millenial;N/D;N/D;585445;5;6;2;1;305480;3;5;279965;TACA TACA MADERA EVER GROUP;OUTDOOR
17566126;;M;31;CHILENO;;Millenial;PROVIDENCIA                   ;METROPOLITANA;123970;3;1;3;1;123970;0;0;0;V-CARPA 4 PERSONAS TORONTO NAT GEO S17;OUTDOOR
13611624;;F;43;CHILENO;;X;TALCA                         ;MAULE;89990;1;1;0;0;0;1;1;89990;PISCINA STEEL PRO 300X201X66CM;OUTDOOR
7342225;;M;67;CHILENO;;Boomers;LINARES                       ;MAULE;472450;5;3;2;1;135480;3;2;336970;MESA DE PING PONG GAMEPOWER AZUL;OUTDOOR
7707679;Soltero;M;66;CHILENO;INGENIERO;Boomers;RENCA                         ;METROPOLITANA;189990;1;1;0;0;0;1;1;189990;PISCINA RECTANGULAR 211CM BESTWAY AZUL;OUTDOOR
15214314;;M;39;CHILENO;;X;PROVIDENCIA                   ;METROPOLITANA;19980;2;1;2;1;19980;0;0;0;V-QUITASOL AZUL NAT GEO S17;OUTDOOR
7609834;;M;66;CHILENO;;Boomers;SAN PEDRO DE LA PAZ           ;BIO BIO;259970;3;1;0;0;0;3;1;259970;PISCINA RECTANGULAR 211CM BESTWAY AZUL;OUTDOOR
17493923;;F;32;CHILENO;;Millenial;TALCA                         ;MAULE;89990;1;1;0;0;0;1;1;89990;PISCINA STEEL PRO 300X201X66CM;OUTDOOR
18589082;;M;28;CHILENO;;Millenial;N/D;N/D;179970;3;2;0;0;0;3;2;179970;TACA TACA MADERA EVER GROUP;OUTDOOR
8136067;;M;62;CHILENO;;Boomers;COPIAPO                       ;ATACAMA;99990;1;1;0;0;0;1;1;99990;PISCINA STEEL PRO 300X201X66CM;OUTDOOR
15230795;;F;40;CHILENO;;X;LAUTARO                       ;ARAUCANIA;386980;2;1;2;1;386980;0;0;0;PISCINA STEEL PRO C/ESCALERA Y COBERTOR;OUTDOOR
12858935;;F;47;CHILENO;;X;SANTIAGO                      ;METROPOLITANA;27990;1;3;0;0;0;1;3;27990;GO-KART PEDALES ROJO;OUTDOOR
15070741;;F;38;CHILENO;;X;VALPARAISO                    ;VALPARAISO;23980;2;1;2;1;23980;0;0;0;Scooter Peluche Tiburon y Luces Led KeyRiders;OUTDOOR
19698128;;F;25;CHILENO;;Z;VICUNA                        ;COQUIMBO;69990;1;1;0;0;0;1;1;69990;TACA TACA MADERA EVER GROUP;OUTDOOR
11820960;;M;50;CHILENO;;X;N/D;N/D;21990;1;1;0;0;0;1;1;21990;Juego de Mesa Camcorro 10 en 1;OUTDOOR
16442730;;F;35;CHILENO;;Millenial;LA SERENA                     ;COQUIMBO;39980;2;1;0;0;0;2;1;39980;COLCHON 2 PZA 203X152X22 CM;OUTDOOR
13452874;;F;43;CHILENO;;X;RANCAGUA                      ;L.G.B.OÂ´HIGGINS;89990;1;1;0;0;0;1;1;89990;PISCINA STEEL PRO 300X201X66CM;OUTDOOR
17123878;;F;33;CHILENO;;Millenial;N/D;N/D;59980;2;1;0;0;0;2;1;59980;Scooter Peluche Unicornio y Luces Led KeyRiders;OUTDOOR
14160987;;M;41;CHILENO;;X;PENALOLEN;METROPOLITANA;123980;2;1;2;1;123980;0;0;0;PISCINA CIRCULAR STEEL PRO;OUTDOOR
15997847;;F;37;CHILENO;;Millenial;MOLINA                        ;MAULE;265480;2;1;2;1;265480;0;0;0;PISCINA STEEL PRO MAXÂ¿ 56709 BESTWAY DISENO RATT;OUTDOOR
18052106;;M;30;CHILENO;;Millenial;RENCA                         ;METROPOLITANA;385840;2;1;2;1;385840;0;0;0;PISCINA STEEL PRO MAXÂ¿ 56709 BESTWAY DISENO RATT;OUTDOOR
15253127;;F;39;CHILENO;;X;LONCOCHE                      ;ARAUCANIA;126980;2;1;2;1;126980;0;0;0;PISCINA CIRCULAR STEEL PRO;OUTDOOR
20321362;;F;22;CHILENO;;Millenial;LOS ANGELES                   ;BIO BIO;69990;1;1;0;0;0;1;1;69990;TACA TACA MADERA EVER GROUP;OUTDOOR
13968097;Soltero;F;42;CHILENO;ENFERMERA;X;RENCA                         ;METROPOLITANA;139980;2;2;0;0;0;2;2;139980;PISCINA RECTANGULAR 150CM BESTWAY AZUL;OUTDOOR
16274138;;F;36;CHILENO;;Millenial;N/D;N/D;349990;1;1;1;1;349990;0;0;0;PISCINA STEEL PRO C/ESCALERA Y COBERTOR;OUTDOOR
15792969;Soltero;M;38;CHILENO;TECNICO EN ADMINISTRACION DE EMPRESAS;Millenial;PROVIDENCIA                   ;METROPOLITANA;113980;2;1;2;1;113980;0;0;0;V-PISCINA ESTRUCTURAL BESTWAY STEEL PRO 3.05M X;OUTDOOR
18380926;;F;29;CHILENO;;Millenial;N/D;N/D;179980;2;1;0;0;0;2;1;179980;PISCINA STEEL PRO 300X201X66CM;OUTDOOR
14299837;Casado;F;46;CHILENO;NUTRICIONISTA;X;PROVIDENCIA                   ;METROPOLITANA;125840;2;1;2;1;125840;0;0;0;PISCINA CIRCULAR STEEL PRO;OUTDOOR
19019921;;F;26;CHILENO;;Z;DONIHUE                       ;L.G.B.OÂ´HIGGINS;192312;4;2;2;1;104540;2;1;87772;PISCINA CIRCULAR STEEL PRO;OUTDOOR
15570122;;F;38;CHILENO;;X;LINARES                       ;MAULE;119990;1;1;0;0;0;1;1;119990;PISCINA CIRCULAR STEEL PRO;OUTDOOR
15868506;;F;37;CHILENO;;Millenial;LOS ANGELES                   ;BIO BIO;179990;1;1;0;0;0;1;1;179990;PISCINA RECTANGULAR 211CM BESTWAY AZUL;OUTDOOR
8709846;;F;56;CHILENO;;Boomers;CONCEPCION                    ;BIO BIO;199980;2;2;0;0;0;2;2;199980;Scooter con Burbujas KeyRiders;OUTDOOR
19422169;;F;25;CHILENO;;Z;PROVIDENCIA                   ;METROPOLITANA;483980;2;1;2;1;483980;0;0;0;Piscina Power Steel Swim Vista Series Oval 4.8x3;OUTDOOR
18080370;;M;30;CHILENO;;Millenial;"";"";759980;2;1;2;1;759980;0;0;0;PISCINA POWER STEEL RECTANGULAR;OUTDOOR
14166619;;F;41;CHILENO;;X;"";"";19990;1;1;0;0;0;1;1;19990;Juego de Mesa Camcorro 10 en 1;OUTDOOR
7243116;;F;62;CHILENO;;Boomers;RENCA                         ;METROPOLITANA;30960;3;1;3;1;30960;0;0;0;V-CASTILLO DE NINO 105 X 125 CM;OUTDOOR
15276506;;M;38;CHILENO;;Millenial;PROVIDENCIA                   ;METROPOLITANA;108540;2;1;2;1;108540;0;0;0;V-PISCINA ESTRUCTURAL BESTWAY STEEL PRO 3.05M X;OUTDOOR
15272819;Casado;M;40;CHILENO;ADMINISTRADOR PUBLICO;X;PROVIDENCIA                   ;METROPOLITANA;110070;4;1;4;1;110070;0;0;0;V-CARPA 4 PERSONAS TORONTO NAT GEO S17;OUTDOOR
16988249;Casado;M;33;CHILENO;;Silencioso;PROVIDENCIA                   ;METROPOLITANA;125840;2;1;2;1;125840;0;0;0;PISCINA CIRCULAR STEEL PRO;OUTDOOR
16794671;;F;34;CHILENO;;Millenial;PROVIDENCIA                   ;METROPOLITANA;76980;2;1;2;1;76980;0;0;0;PISCINA RECTANGULAR 150CM BESTWAY AZUL;OUTDOOR
19288422;Soltero;F;26;CHILENO;TECNICO EN ADMINISTRACION DE EMPRESAS;Z;PROVIDENCIA                   ;METROPOLITANA;16980;2;1;2;1;16980;0;0;0;Caja Vanity 14 Rimax Verde/Lila;OUTDOOR
18153167;;F;29;CHILENO;;Silencioso;PROVIDENCIA                   ;METROPOLITANA;13980;2;1;2;1;13980;0;0;0;Casco 3D con Funda Peluche Dinosaurio Keyriders;OUTDOOR
27364399;;F;30;VENEZOLANO;;Extranjero;N/D;N/D;223980;2;1;2;1;223980;0;0;0;Scooter Electrico Cero E6 Negro;OUTDOOR
13256578;;F;45;CHILENO;;X;TALAGANTE                     ;METROPOLITANA;69980;2;1;2;1;69980;0;0;0;TACA TACA MADERA EVER GROUP;OUTDOOR
18115973;;F;30;CHILENO;;Millenial;PROVIDENCIA                   ;METROPOLITANA;9990;1;1;0;0;0;1;1;9990;ALMOHADA FULL COMPACT AZUL NATIONAL GEOGRAPHIC;OUTDOOR
6845979;;F;69;CHILENO;;Silencioso;RENCA                         ;METROPOLITANA;59990;1;1;1;1;59990;0;0;0;TACA TACA MADERA EVER GROUP;OUTDOOR
18102075;;F;29;CHILENO;;Millenial;LOS ANGELES                   ;BIO BIO;0;0;0;0;0;0;0;0;0;Triciclo 360 Desmontable Bebesit;OUTDOOR
14382161;;F;42;CHILENO;;X;RENCA                         ;METROPOLITANA;0;0;0;0;0;0;0;0;0;Triciclo 360 Desmontable Bebesit;OUTDOOR
14154881;Casado;M;41;CHILENO;TECNICO INFORMATICO;X;PROVIDENCIA                   ;METROPOLITANA;0;0;0;0;0;0;0;0;0;Triciclo 360 Desmontable Bebesit;OUTDOOR
14156244;;F;41;CHILENO;;X;PROVIDENCIA                   ;METROPOLITANA;0;0;0;0;0;0;0;0;0;Triciclo 360 Desmontable Bebesit;OUTDOOR
13473807;;F;43;CHILENO;;Silencioso;PROVIDENCIA                   ;METROPOLITANA;0;0;0;0;0;0;0;0;0;Triciclo 360 Desmontable Bebesit;OUTDOOR
17300475;Soltero;F;32;CHILENO;;Millenial;PROVIDENCIA                   ;METROPOLITANA;0;0;0;0;0;0;0;0;0;CENTRO JUEGOS 3EN1 RESBALIN+COLUMPIO+AROBASQ;OUTDOOR
15776073;Casado;F;38;CHILENO;SOCIOLOGO;Silencioso;PROVIDENCIA                   ;METROPOLITANA;0;0;0;0;0;0;0;0;0;CENTRO JUEGOS 3EN1 RESBALIN+COLUMPIO+AROBASQ;OUTDOOR
15164890;;F;39;CHILENO;;X;BULNES                        ;BIO BIO;0;0;0;0;0;0;0;0;0;TACA TACA MADERA EVER GROUP;OUTDOOR
19749281;;F;25;CHILENO;;Z;PROVIDENCIA                   ;METROPOLITANA;0;0;0;0;0;0;0;0;0;Triciclo 360 Desmontable Bebesit;OUTDOOR
25767760;;F;32;VENEZOLANO;;Extranjero;HUALPEN;BIO BIO;0;0;0;0;0;0;0;0;0;PATINES EN LINEA T 28-31 COMIC;OUTDOOR
18785134;;F;27;CHILENO;;Z;N/D;N/D;0;0;0;0;0;0;0;0;0;Triciclo 360 Desmontable Bebesit;OUTDOOR
17517189;;F;31;CHILENO;;Millenial;MACUL                         ;METROPOLITANA;0;0;0;0;0;0;0;0;0;TUNEL DE JUEGO 46X180 CM;OUTDOOR
18275450;;M;29;CHILENO;;Millenial;TALCA                         ;MAULE;0;0;0;0;0;0;0;0;0;CENTRO JUEGOS 3EN1 RESBALIN+COLUMPIO+AROBASQ;OUTDOOR
15969416;;F;37;CHILENO;;Millenial;VICUNA                        ;COQUIMBO;0;0;0;0;0;0;0;0;0;COLCHON 2 PZA 203X152X22 CM;OUTDOOR
17160183;Soltero;F;33;CHILENO;;Silencioso;PROVIDENCIA                   ;METROPOLITANA;0;0;0;0;0;0;0;0;0;Mini Trampolin Kids 3 Pies Con Mango Plegable;OUTDOOR
13742438;;F;42;CHILENO;;X;IQUIQUE                       ;TARAPACA;0;0;0;0;0;0;0;0;0;SCOOTER PLEGABLE BIA;OUTDOOR
15556739;;M;39;CHILENO;;X;VALPARAISO                    ;VALPARAISO;0;0;0;0;0;0;0;0;0;TUNEL DE JUEGO 46X180 CM;OUTDOOR
14543574;Casado;F;40;CHILENO;MEDICO CIRUJANO;Silencioso;PROVIDENCIA                   ;METROPOLITANA;0;0;0;0;0;0;0;0;0;V-BOLSO PORTA EQUIPAJE MEDIANO NAT GEO S17;OUTDOOR
9465302;;F;61;CHILENO;;Boomers;COLBUN                        ;MAULE;0;0;0;0;0;0;0;0;0;V-CARPA MONTANA 4 PERSONAS OUTBACK;OUTDOOR
16587013;;F;34;CHILENO;;Millenial;N/D;N/D;0;0;0;0;0;0;0;0;0;V-ARCO DE FUTBOL 300X205X120 GAME POWER;OUTDOOR
19384217;;F;26;CHILENO;;Z;PUENTE ALTO                   ;METROPOLITANA;0;0;0;0;0;0;0;0;0;Silla Plegable Outback Con Apoyo De Brazos Gris;OUTDOOR
12115431;;F;41;CHILENO;;X;QUILICURA                     ;METROPOLITANA;0;0;0;0;0;0;0;0;0;COLCHON 2 PZA 203X152X22 CM;OUTDOOR
10723506;Soltero;F;46;CHILENO;;X;PROVIDENCIA                   ;METROPOLITANA;0;0;0;0;0;0;0;0;0;V-PISCINA INFLABLE LAGUNA AZUL 262x157x46CM;OUTDOOR
17856863;;F;30;CHILENO;;Millenial;SANTIAGO                      ;METROPOLITANA;0;0;0;0;0;0;0;0;0;V-SACO DORMIR CLIMB AMARILLO NAT GEO S17;OUTDOOR
17603119;Soltero;F;31;CHILENO;PROFESOR;Silencioso;PROVIDENCIA                   ;METROPOLITANA;0;0;0;0;0;0;0;0;0;V-SACO DORMIR CLIMB ROJO NAT GEO S17;OUTDOOR
25306504;;M;27;PERUANO;;Extranjero;COPIAPO                       ;ATACAMA;0;0;0;0;0;0;0;0;0;ALFOMBRA DE JUEGO ALFABETO 26PC;OUTDOOR
5959150;;F;68;CHILENO;;Silencioso;RENCA                         ;METROPOLITANA;0;0;0;0;0;0;0;0;0;Piscina Kids 228 X 159 X 42Cm;OUTDOOR
17053584;;M;33;CHILENO;;Millenial;N/D;N/D;0;0;0;0;0;0;0;0;0;PISCINA ESTRUCTURAL STEEL PRO 5700LT;OUTDOOR
13535414;;M;42;CHILENO;;X;CALAMA;ANTOFAGASTA;0;0;0;0;0;0;0;0;0;PATINES C/LUCES+BLUETOOTH 333 SHS;OUTDOOR
17635440;Soltero;M;31;CHILENO;;Millenial;"";"";0;0;0;0;0;0;0;0;0;CAMIONETA ELECTRICA TODO TERRENO BLANCO;OUTDOOR
17717490;;F;31;CHILENO;;Millenial;PROVIDENCIA                   ;METROPOLITANA;0;0;0;0;0;0;0;0;0;Piscina Redonda Power Steel Frame Pool Set 4.27M;OUTDOOR
9308829;;M;44;CHILENO;;X;LA FLORIDA                    ;METROPOLITANA;0;0;0;0;0;0;0;0;0;GO-KART PEDALES NEGRO;OUTDOOR
10810837;Casado;F;51;CHILENO;ARQUITECTO;X;PROVIDENCIA                   ;METROPOLITANA;0;0;0;0;0;0;0;0;0;PISCINA STEEL PRO 300X201X66CM;OUTDOOR
18708876;Soltero;F;27;CHILENO;;Z;YUNGAY                        ;BIO BIO;0;0;0;0;0;0;0;0;0;PATINES EN LINEA T 32-34 ALPACA;OUTDOOR
6082085;;F;73;CHILENO;;Silencioso;PROVIDENCIA                   ;METROPOLITANA;0;0;0;0;0;0;0;0;0;CASA DE PIEDRA AZUL;OUTDOOR
12469047;Casado;F;48;CHILENO;MATRONA;X;PROVIDENCIA                   ;METROPOLITANA;0;0;0;0;0;0;0;0;0;PISCINA ESTRUCTURAL STEEL PRO 5700LT;OUTDOOR
18011821;;F;30;CHILENO;;Millenial;PROVIDENCIA                   ;METROPOLITANA;0;0;0;0;0;0;0;0;0;COLCHON 2 PZA 203X152X22 CM;OUTDOOR
15990579;;F;32;CHILENO;;Millenial;PROVIDENCIA                   ;METROPOLITANA;0;0;0;0;0;0;0;0;0;PISCINA STEEL PRO 300X201X66CM;OUTDOOR
12836257;Casado;F;46;CHILENO;;X;PROVIDENCIA                   ;METROPOLITANA;0;0;0;0;0;0;0;0;0;GO-KART PEDALES NEGRO;OUTDOOR
18191270;;M;29;CHILENO;;Millenial;N/D;N/D;0;0;0;0;0;0;0;0;0;PISCINA RECTANGULAR 150CM BESTWAY AZUL;OUTDOOR
5797597;;M;73;CHILENO;;Silencioso;CHILLAN                       ;BIO BIO;0;0;0;0;0;0;0;0;0;PISCINA CIRCULAR STEEL PRO;OUTDOOR
19673950;;F;25;CHILENO;;Z;PUERTO MONTT                  ;LOS LAGOS;0;0;0;0;0;0;0;0;0;AUTO ELECTRICO ROJO;OUTDOOR
17529113;;M;31;CHILENO;;Millenial;PROVIDENCIA                   ;METROPOLITANA;0;0;0;0;0;0;0;0;0;PISCINA RECTANGULAR 211CM BESTWAY AZUL;OUTDOOR
22113541;;M;38;BOLIVIANO;;Extranjero;ALTO HOSPICIO;TARAPACA;0;0;0;0;0;0;0;0;0;PISCINA CIRCULAR STEEL PRO 6473 L;OUTDOOR
15259786;;F;40;CHILENO;;X;PROVIDENCIA                   ;METROPOLITANA;0;0;0;0;0;0;0;0;0;PISCINA CIRCULAR STEEL PRO 6473 L;OUTDOOR
16679128;;M;35;CHILENO;;X;N/D;N/D;0;0;0;0;0;0;0;0;0;V-PISCINA ESTRUCTURAL BESTWAY STEEL PRO 3.05M X;OUTDOOR
15965469;;M;38;CHILENO;;Millenial;TEMUCO                        ;ARAUCANIA;0;0;0;0;0;0;0;0;0;PATINES C/LUCES 255 SHS;OUTDOOR
13457793;Casado;F;43;CHILENO;PSICOLOGO;X;PROVIDENCIA                   ;METROPOLITANA;0;0;0;0;0;0;0;0;0;PISCINA STEEL PRO 300X201X66CM;OUTDOOR
12983700;;F;46;CHILENO;;X;LOS ANGELES                   ;BIO BIO;0;0;0;0;0;0;0;0;0;PISCINA RECTANGULAR 150CM BESTWAY AZUL;OUTDOOR
12398880;;F;49;CHILENO;;X;CANELA                        ;COQUIMBO;0;0;0;0;0;0;0;0;0;COLCHON 2 PZA 203X152X22 CM;OUTDOOR
17717912;Soltero;M;31;CHILENO;;Millenial;PROVIDENCIA                   ;METROPOLITANA;0;0;0;0;0;0;0;0;0;TACA TACA MADERA EVER GROUP;OUTDOOR
18447649;;F;29;CHILENO;;Millenial;QUILPUE                       ;VALPARAISO;0;0;0;0;0;0;0;0;0;PISCINA CIRCULAR STEEL PRO 6473 L;OUTDOOR
17930247;;F;32;CHILENO;;Millenial;PROVIDENCIA                   ;METROPOLITANA;0;0;0;0;0;0;0;0;0;TACA TACA MADERA EVER GROUP;OUTDOOR
18588280;Soltero;F;28;CHILENO;;Millenial;PROVIDENCIA                   ;METROPOLITANA;0;0;0;0;0;0;0;0;0;Piscina Kids 228 X 159 X 42Cm;OUTDOOR
17869553;;F;31;CHILENO;;Millenial;RENCA                         ;METROPOLITANA;0;0;0;0;0;0;0;0;0;PISCINA CIRCULAR STEEL PRO;OUTDOOR
16000821;;F;36;CHILENO;;Millenial;N/D;N/D;0;0;0;0;0;0;0;0;0;PISCINA RECTANGULAR 211CM BESTWAY AZUL;OUTDOOR
18612665;;F;28;CHILENO;;Millenial;PROVIDENCIA                   ;METROPOLITANA;0;0;0;0;0;0;0;0;0;PISCINA STEEL PRO C/ESCALERA Y COBERTOR;OUTDOOR
15596782;Soltero;M;39;CHILENO;PSICOLOGO;X;PROVIDENCIA                   ;METROPOLITANA;0;0;0;0;0;0;0;0;0;BUGGY ELECTRICO POLARIS BLANCO;OUTDOOR
15381857;;M;39;CHILENO;;X;PROVIDENCIA                   ;METROPOLITANA;0;0;0;0;0;0;0;0;0;CAMA ELASTICA (2,44M) CON MALLA GAMEPOWER AZUL;OUTDOOR
16242043;;F;36;CHILENO;;Millenial;PROVIDENCIA                   ;METROPOLITANA;0;0;0;0;0;0;0;0;0;MI PRIMER TRAMPOLIN 140CM GAMEPOWER AZUL/AMARILL;OUTDOOR
9955819;;M;57;CHILENO;;Boomers;PROVIDENCIA                   ;METROPOLITANA;0;0;0;0;0;0;0;0;0;CAMA ELASTICA (2,44M) CON MALLA GAMEPOWER AZUL;OUTDOOR
18493176;Soltero;F;27;CHILENO;;Millenial;PROVIDENCIA                   ;METROPOLITANA;0;0;0;0;0;0;0;0;0;SCOOTER ELECTRICO XIAOMI M365;OUTDOOR
6406479;;F;74;CHILENO;;Silencioso;SAN FELIPE                    ;VALPARAISO;0;0;0;0;0;0;0;0;0;TACA TACA MADERA EVER GROUP;OUTDOOR
12917079;;F;50;CHILENO;;X;CONCEPCION                    ;BIO BIO;0;0;0;0;0;0;0;0;0;PISCINA RECTANGULAR 150CM BESTWAY AZUL;OUTDOOR
15230771;;F;40;CHILENO;;X;RENCA                         ;METROPOLITANA;0;0;0;0;0;0;0;0;0;FLOTADOR ANILLO 56 CM;OUTDOOR
17988963;;F;32;CHILENO;;Millenial;N/D;N/D;0;0;0;0;0;0;0;0;0;MINI TRAMPOLIN 38 GAMEPOWER AZUL;OUTDOOR
16058687;;F;37;CHILENO;;Millenial;HIJUELAS                      ;VALPARAISO;0;0;0;0;0;0;0;0;0;TRACTOR ELECTRICO CON PALA AMARILLO 6V;OUTDOOR
18077645;;F;32;CHILENO;;Millenial;N/D;N/D;0;0;0;0;0;0;0;0;0;PISCINA STEEL PRO C/ESCALERA Y COBERTOR;OUTDOOR
18058891;;F;30;CHILENO;;Millenial;LA CISTERNA                   ;METROPOLITANA;0;0;0;0;0;0;0;0;0;SET DE PLAZA 9 PIEZAS NARANJO;OUTDOOR
14544889;;M;48;CHILENO;;X;PROVIDENCIA                   ;METROPOLITANA;0;0;0;0;0;0;0;0;0;CASA DE PIEDRA AZUL;OUTDOOR
9063478;;F;61;CHILENO;;Boomers;RENCA                         ;METROPOLITANA;0;0;0;0;0;0;0;0;0;GO-KART PEDALES ROJO;OUTDOOR
16998208;;F;33;CHILENO;;Millenial;PROVIDENCIA                   ;METROPOLITANA;0;0;0;0;0;0;0;0;0;TACA TACA 10 JUEGOS;OUTDOOR
11291088;Casado;F;54;CHILENO;AUXILIAR PARAMEDICO DE FARMACIA;X;RENCA                         ;METROPOLITANA;9990;1;1;0;0;0;1;1;9990;ESTUFA CUARZO KIOTO 800W KTE-011A;CLIMATIZACION
20262928;;M;22;CHILENO;;Z;PROVIDENCIA                   ;METROPOLITANA;29990;1;1;1;1;29990;0;0;0;CALIENTACAMA KIOTO DIGITAL 2 PLAZAS KTC-1006;CLIMATIZACION
19259757;;F;25;CHILENO;;Z;CERRO NAVIA;METROPOLITANA;49960;4;2;4;2;49960;0;0;0;CALIENTACAMA KIOTO DIGITAL 2 PLAZAS KTC-1006;CLIMATIZACION
8935905;;F;65;CHILENO;;Boomers;LA SERENA                     ;COQUIMBO;6490;1;1;0;0;0;1;1;6490;ESTUFA CUARZO KIOTO 800W KTE-011A;CLIMATIZACION
17138071;;M;33;CHILENO;;Millenial;N/D;N/D;12980;2;1;0;0;0;2;1;12980;ESTUFA CUARZO KIOTO 800W KTE-011A;CLIMATIZACION
6649454;;F;71;CHILENO;;Silencioso;CORONEL                       ;BIO BIO;15990;1;1;1;1;15990;0;0;0;CALIENTACAMA KIOTO DIGITAL 1 PLAZA KTC-1005;CLIMATIZACION
5058582;;F;79;CHILENO;;Silencioso;IQUIQUE                       ;TARAPACA;6990;1;1;0;0;0;1;1;6990;ESTUFA CUARZO KIOTO 800W KTE-011A;CLIMATIZACION
14374702;;M;46;CHILENO;;X;N/D;N/D;271460;5;3;0;0;0;5;3;271460;ESTUFA CUARZO KIOTO 800W KTE-011A;CLIMATIZACION
17502559;;F;32;CHILENO;;Millenial;N/D;N/D;518940;7;5;0;0;0;7;5;518940;ESTUFA CUARZO KIOTO 800W KTE-011A;CLIMATIZACION
17901282;Soltero;M;30;CHILENO;;Millenial;PROVIDENCIA                   ;METROPOLITANA;9990;1;1;1;1;9990;0;0;0;ESTUFA CUARZO KIOTO 800W KTE-011A;CLIMATIZACION
13888486;;F;41;CHILENO;;X;CARTAGENA                     ;VALPARAISO;220210;5;3;0;0;0;5;3;220210;ESTUFA CUARZO KIOTO 800W KTE-011A;CLIMATIZACION
15198895;;F;40;CHILENO;;X;"";"";148980;2;2;0;0;0;2;2;148980;ESTUFA ELEC. INFRAROJA TH-IR61 NG 900W - 1800W;CLIMATIZACION
19388508;;F;25;CHILENO;;Z;"";"";10980;2;2;0;0;0;2;2;10980;ESTUFA CUARZO KIOTO 800W KTE-011A;CLIMATIZACION
13739832;;F;44;CHILENO;;X;"";"";275970;3;3;0;0;0;3;3;275970;ESTUFA CUARZO KIOTO 800W KTE-011A;CLIMATIZACION
15777133;;M;38;CHILENO;;Millenial;MAIPU                         ;METROPOLITANA;6490;1;1;1;1;6490;0;0;0;ESTUFA CUARZO KIOTO 800W KTE-011A;CLIMATIZACION
11768465;;M;50;CHILENO;;X;PARRAL                        ;MAULE;79990;1;1;0;0;0;1;1;79990;ESTUFA INFRARROJA ELECTRICA KIOTO 1500W KTE-1045;CLIMATIZACION
16711186;;M;34;CHILENO;;Millenial;N/D;N/D;278450;5;4;5;4;278450;0;0;0;ESTUFA CUARZO KIOTO 800W KTE-011A;CLIMATIZACION
9966385;Casado;M;55;CHILENO;DISENADOR;Boomers;PROVIDENCIA                   ;METROPOLITANA;55960;4;2;4;2;55960;0;0;0;CALIENTACAMA KIOTO DIGITAL 2 PLAZAS KTC-1006;CLIMATIZACION
19044419;;M;26;CHILENO;;Z;N/D;N/D;18980;2;2;0;0;0;2;2;18980;ESTUFA CUARZO KIOTO 800W KTE-011A;CLIMATIZACION
15198852;;M;40;CHILENO;;X;PROVIDENCIA                   ;METROPOLITANA;439960;5;4;0;0;0;5;4;439960;CALIENTACAMA KIOTO ANALOGO 1 PLAZA KTC-1004;CLIMATIZACION
15760477;;F;38;CHILENO;;Millenial;SAN MIGUEL;METROPOLITANA;4893;1;1;1;1;4893;0;0;0;TERMOVENTILADOR KIOTO BLANCO 2000W KTE-1028B;CLIMATIZACION
20460822;;F;21;CHILENO;;Z;ANGOL;ARAUCANIA;119980;2;1;2;1;119980;0;0;0;CALEFACTOR INFRAROJO GR2800 R NEGRO;CLIMATIZACION
24422381;;F;38;COLOMBIANO;;Extranjero;CERRO NAVIA                   ;METROPOLITANA;207350;4;2;0;0;0;4;2;207350;TERMOVENTILADOR KIOTO NEGRO 2000W KTE-1028N;CLIMATIZACION
18071388;;F;30;CHILENO;;Millenial;LA PINTANA;METROPOLITANA;23980;2;2;0;0;0;2;2;23980;ESTUFA CUARZO KIOTO 800W KTE-011A;CLIMATIZACION
18620439;;F;28;CHILENO;;Millenial;PROVIDENCIA                   ;METROPOLITANA;83980;2;1;2;1;83980;0;0;0;CONVECTOR ELECTRICO UT MD-20 D;CLIMATIZACION
7419921;;M;53;CHILENO;;X;PROVIDENCIA                   ;METROPOLITANA;20230;3;3;0;0;0;3;3;20230;ESTUFA CUARZO KIOTO 800W KTE-011A;CLIMATIZACION
10660993;;F;49;CHILENO;;X;EL BOSQUE                     ;METROPOLITANA;264160;5;2;0;0;0;5;2;264160;CALIENTACAMA KIOTO DIGITAL 2 PLAZAS KTC-1006;CLIMATIZACION
19920473;;F;23;CHILENO;;Z;PROVIDENCIA                   ;METROPOLITANA;14980;2;1;2;1;14980;0;0;0;CALIENTACAMA KIOTO ANALOGO 1 PLAZA KTC-1004;CLIMATIZACION
11728180;Soltero;F;51;CHILENO;;X;CANELA                        ;COQUIMBO;85150;2;1;0;0;0;2;1;85150;TERMOVENTILADOR CALMA IPX1 T2000;CLIMATIZACION
18320329;;F;29;CHILENO;;Millenial;PROVIDENCIA                   ;METROPOLITANA;10990;1;1;1;1;10990;0;0;0;CALIENTACAMA KIOTO ANALOGO 1 PLAZA KTC-1004;CLIMATIZACION
10427406;;F;58;CHILENO;;Boomers;MAULE                         ;MAULE;7240;2;1;0;0;0;2;1;7240;ESTUFA CUARZO KIOTO 800W KTE-011A;CLIMATIZACION
19757210;;M;24;CHILENO;;Z;N/D;N/D;62910;4;2;0;0;0;4;2;62910;TERMOVENTILADOR KIOTO NEGRO 2000W KTE-1028N;CLIMATIZACION
20166539;;F;22;CHILENO;;Z;PROVIDENCIA                   ;METROPOLITANA;16980;2;2;1;1;7990;1;1;8990;TERMOVENTILADOR KIOTO BLANCO 2000W KTE-1028B;CLIMATIZACION
18663048;;F;28;CHILENO;;Millenial;N/D;N/D;11980;2;1;2;1;11980;0;0;0;TERMOVENTILADOR KIOTO NEGRO 2000W KTE-1028N;CLIMATIZACION
20279928;;M;22;CHILENO;;Z;PROVIDENCIA                   ;METROPOLITANA;10990;1;1;1;1;10990;0;0;0;CALIENTACAMA KIOTO ANALOGO 1 PLAZA KTC-1004;CLIMATIZACION
16616295;;F;35;CHILENO;;Millenial;COQUIMBO                      ;COQUIMBO;7990;1;1;1;1;7990;0;0;0;TERMOVENTILADOR KIOTO BLANCO 2000W KTE-1028B;CLIMATIZACION
19578925;;F;26;CHILENO;;Z;N/D;N/D;200980;2;2;0;0;0;2;2;200980;TERMOVENTILADOR KIOTO BLANCO 2000W KTE-1028B;CLIMATIZACION
26133893;Soltero;M;36;VENEZOLANO;;Extranjero;PROVIDENCIA                   ;METROPOLITANA;11980;2;1;2;1;11980;0;0;0;TERMOVENTILADOR KIOTO NEGRO 2000W KTE-1028N;CLIMATIZACION
16274257;;F;36;CHILENO;;Millenial;RENCA                         ;METROPOLITANA;64980;2;2;0;0;0;2;2;64980;TERMOVENTILADOR KIOTO BLANCO 2000W KTE-1028B;CLIMATIZACION
10872258;;F;56;CHILENO;;Z;RANCAGUA                      ;L.G.B.OÂ´HIGGINS;6990;1;1;0;0;0;1;1;6990;ESTUFA CUARZO KIOTO 800W KTE-011A;CLIMATIZACION
4451677;;M;83;CHILENO;;Silencioso;LOS VILOS                     ;COQUIMBO;10990;1;1;0;0;0;1;1;10990;ESTUFA CUARZO KIOTO 800W KTE-011A;CLIMATIZACION
10619938;;M;52;CHILENO;;X;PROVIDENCIA                   ;METROPOLITANA;59990;1;1;0;0;0;1;1;59990;CALIENTACAMAS ANALOGO BASICO 2 PL;CLIMATIZACION
7487271;;M;68;CHILENO;;Boomers;SAN ANTONIO                   ;VALPARAISO;39992;1;1;0;0;0;1;1;39992;CHIMENEA ELECTRICA KIOTO 2000W KTE-1101;CLIMATIZACION
17180722;;F;34;CHILENO;;Millenial;"";"";223972;3;2;0;0;0;3;2;223972;CALIENTACAMA KIOTO DIGITAL 2 PLAZAS KTC-1006;CLIMATIZACION
16708347;;M;34;CHILENO;;Millenial;LOLOL                         ;L.G.B.OÂ´HIGGINS;99971;4;2;0;0;0;4;2;99971;ESTUFA CUARZO KIOTO 800W KTE-011A;CLIMATIZACION
20109667;;F;23;CHILENO;;Z;SAN JOSE DE MAIPO             ;METROPOLITANA;375182;42;4;0;2;0;42;2;375182;ESTUFA ELECTRICA CUARZO KIOTO 1200W KTE 1033;CLIMATIZACION
10660440;;M;56;CHILENO;;Boomers;RANCAGUA                      ;L.G.B.OÂ´HIGGINS;49990;1;1;0;0;0;1;1;49990;CHIMENEA ELECTRICA KIOTO 2000W KTE-1101;CLIMATIZACION
12472622;;F;49;CHILENO;;X;"";"";403960;4;4;2;3;53980;2;1;349980;TERMOVENTILADOR VINTAGE HT RETRO 2000N;CLIMATIZACION
16505999;Soltero;F;34;CHILENO;ABOGADO;Millenial;PROVIDENCIA                   ;METROPOLITANA;11980;2;1;0;0;0;2;1;11980;ESTUFA CUARZO KIOTO 800W KTE-011A;CLIMATIZACION
19680609;;F;25;CHILENO;;Z;PROVIDENCIA                   ;METROPOLITANA;6990;1;1;1;1;6990;0;0;0;ESTUFA CUARZO KIOTO 800W KTE-011A;CLIMATIZACION
19940470;;F;24;CHILENO;;Extranjero;PROVIDENCIA                   ;N/D;9990;1;1;0;0;0;1;1;9990;ESTUFA CUARZO KIOTO 800W KTE-011A;CLIMATIZACION
19050325;;F;27;CHILENO;;Z;"";"";102960;4;5;3;2;65970;1;3;36990;TERMOVENTILADOR KIOTO BLANCO 2000W KTE-1028B;CLIMATIZACION
15004557;;M;39;CHILENO;;X;RENCA                         ;METROPOLITANA;654970;3;3;1;1;34990;2;2;619980;ESTUFA VITTALE-40 15K;CLIMATIZACION
8898585;Casado;F;61;CHILENO;AUXILIAR DE ENFERMERIA;Boomers;RENCA                         ;METROPOLITANA;31990;1;1;0;0;0;1;1;31990;CALIENTACAMA KIOTO DIGITAL 2 PLAZAS KTC-1006;CLIMATIZACION
14444461;;F;63;CHILENO;;Boomers;CANETE                        ;BIO BIO;203190;7;6;0;0;0;7;6;203190;CALEFACTOR CUARZO VERTICAL 800 W HQ 80 AIROLITE;CLIMATIZACION
17149046;;F;33;CHILENO;;Millenial;LAMPA                         ;METROPOLITANA;9990;1;1;0;0;0;1;1;9990;ESTUFA CUARZO KIOTO 800W KTE-011A;CLIMATIZACION
12144956;;F;54;CHILENO;;X;PROVIDENCIA                   ;METROPOLITANA;6990;1;1;0;0;0;1;1;6990;ESTUFA CUARZO KIOTO 800W KTE-011A;CLIMATIZACION
18188543;;F;30;CHILENO;;Millenial;"";"";17982;2;2;0;0;0;2;2;17982;ESTUFA CUARZO KIOTO 800W KTE-011A;CLIMATIZACION
9941078;;F;58;CHILENO;;Boomers;PROVIDENCIA                   ;METROPOLITANA;46980;3;2;0;0;0;3;2;46980;ESTUFA ELECTRICA CUARZO KIOTO 1200W KTE 1033;CLIMATIZACION
18841792;;F;28;CHILENO;;Millenial;QUILPUE                       ;VALPARAISO;7990;1;1;1;1;7990;0;0;0;TERMOVENTILADOR KIOTO NEGRO 2000W KTE-1028N;CLIMATIZACION
19590374;;M;25;CHILENO;;Z;N/D;N/D;13980;2;1;0;0;0;2;1;13980;ESTUFA CUARZO KIOTO 800W KTE-011A;CLIMATIZACION
17851731;Soltero;M;31;CHILENO;;Millenial;SAN BERNARDO                  ;METROPOLITANA;0;0;2;0;2;0;0;0;0;TERMOVENTILADOR KIOTO BLANCO 2000W KTE-1028B;CLIMATIZACION
9470532;;F;60;CHILENO;;Boomers;SANTIAGO                      ;METROPOLITANA;39992;1;1;0;0;0;1;1;39992;CHIMENEA ELECTRICA KIOTO 2000W KTE-1101;CLIMATIZACION
27224887;Soltero;F;29;EXTRANJERO - NO INFORMA NACIONALIDAD;;Extranjero;"";"";1585840;216;47;216;47;1585840;0;0;0;TERMOVENTILADOR KIOTO BLANCO 2000W KTE-1028B;CLIMATIZACION
13579623;;F;42;CHILENO;;X;CANETE                        ;BIO BIO;0;0;2;0;2;0;0;0;0;TERMOVENTILADOR KIOTO BLANCO 2000W KTE-1028B;CLIMATIZACION
9958110;;F;58;CHILENO;;Boomers;CANETE                        ;BIO BIO;66267;4;3;0;0;0;4;3;66267;MINI OLEOELECTRICA KIOTO 500W NEGRO KTE-1081N;CLIMATIZACION
15730994;;M;38;CHILENO;;X;ARICA                         ;TARAPACA;229980;2;2;0;0;0;2;2;229980;TERMOVENTILADOR KIOTO BLANCO 2000W KTE-1028B;CLIMATIZACION
5206654;;M;76;CHILENO;;Silencioso;RENCA                         ;METROPOLITANA;43970;3;3;0;0;0;3;3;43970;ESTUFA ELECTRICA CUARZO KIOTO 1200W KTE 1033;CLIMATIZACION
11666985;;M;52;CHILENO;;X;PAINE                         ;METROPOLITANA;106980;2;2;0;0;0;2;2;106980;ESTUFA CUARZO KIOTO 800W KTE-011A;CLIMATIZACION
12451718;;M;49;CHILENO;;X;PROVIDENCIA                   ;METROPOLITANA;24990;1;1;0;0;0;1;1;24990;MINI OLEOELECTRICA KIOTO 500W BLANCO KTE-1081B;CLIMATIZACION
8553998;Casado;F;51;CHILENO;;Silencioso;PROVIDENCIA                   ;METROPOLITANA;7990;1;1;1;1;7990;0;0;0;TERMOVENTILADOR KIOTO BLANCO 2000W KTE-1028B;CLIMATIZACION
9983389;Soltero;M;57;CHILENO;;Boomers;RENCA                         ;METROPOLITANA;9990;1;1;0;0;0;1;1;9990;ESTUFA CUARZO KIOTO 800W KTE-011A;CLIMATIZACION
8693351;;F;63;CHILENO;;Boomers;CALBUCO                       ;LOS LAGOS;872820;8;3;0;0;0;8;3;872820;Estufa a gas Kaly 15;CLIMATIZACION
14427498;;F;49;CHILENO;;X;SAN MIGUEL                    ;METROPOLITANA;7240;2;1;0;0;0;2;1;7240;ESTUFA CUARZO KIOTO 800W KTE-011A;CLIMATIZACION
26505264;;M;37;CHILENO;;Extranjero;CALAMA                        ;ANTOFAGASTA;26590;2;1;0;0;0;2;1;26590;ESTUFA ELECTRICA CUARZO KIOTO 1200W KTE 1033;CLIMATIZACION
16588627;;F;35;CHILENO;;Millenial;COPIAPO;ATACAMA;29990;1;1;0;0;0;1;1;29990;CALIENTACAMA KIOTO DIGITAL 2 PLAZAS KTC-1006;CLIMATIZACION
11425777;;F;53;CHILENO;;X;VALDIVIA                      ;LOS LAGOS;14990;1;1;0;0;0;1;1;14990;CALIENTACAMA KIOTO ANALOGO 1 PLAZA KTC-1004;CLIMATIZACION
18281717;;F;29;CHILENO;;Millenial;PROVIDENCIA                   ;METROPOLITANA;9990;1;1;0;0;0;1;1;9990;ESTUFA CUARZO KIOTO 800W KTE-011A;CLIMATIZACION
12346248;;M;48;CHILENO;;X;DALCAHUE                      ;LOS LAGOS;6990;1;1;0;0;0;1;1;6990;ESTUFA CUARZO KIOTO 800W KTE-011A;CLIMATIZACION
13289596;;F;44;CHILENO;;X;PROVIDENCIA                   ;METROPOLITANA;51960;4;2;4;2;51960;0;0;0;ESTUFA ELECTRICA CUARZO KIOTO 1200W KTE 1033;CLIMATIZACION
7605659;;F;69;CHILENO;;Silencioso;SAN CARLOS                    ;BIO BIO;242990;2;1;0;0;0;2;1;242990;ESTUFA VITTALE-40 15K;CLIMATIZACION
7573618;;F;71;CHILENO;;Silencioso;PICHIDEGUA                    ;L.G.B.OÂ´HIGGINS;29990;1;1;0;0;0;1;1;29990;CALIENTACAMA KIOTO DIGITAL 2 PLAZAS KTC-1006;CLIMATIZACION
5392629;Casado;M;73;CHILENO;;Silencioso;RENCA                         ;METROPOLITANA;232960;4;2;4;2;232960;0;0;0;ESTUFA CUARZO KIOTO 800W KTE-011A;CLIMATIZACION
10318693;;F;56;CHILENO;;Boomers;VICTORIA                      ;ARAUCANIA;720900;10;8;0;0;0;10;8;720900;CALIENTACAMA KIOTO DIGITAL 2 PLAZAS KTC-1006;CLIMATIZACION
13183455;;F;45;CHILENO;;X;N/D;N/D;166980;2;2;0;0;0;2;2;166980;ESTUFA A GAS UT GRX-4200 15 KILOS;CLIMATIZACION
27369242;;M;30;"";;Extranjero;PROVIDENCIA                   ;METROPOLITANA;21980;2;1;2;1;21980;0;0;0;ESTUFA ELECTRICA CUARZO KIOTO 1200W KTE 1033;CLIMATIZACION
19540715;Soltero;M;25;CHILENO;;Z;VALPARAISO;VALPARAISO;69990;1;1;1;1;69990;0;0;0;ESTUFA INFRARROJA ELECTRICA KIOTO 1500W KTE-1045;CLIMATIZACION
7524681;;M;67;CHILENO;;Boomers;CORONEL                       ;BIO BIO;128391;4;2;0;0;0;4;2;128391;CHIMENEA ELECTRICA KIOTO 2000W KTE-1101;CLIMATIZACION
14461650;Casado;M;48;CHILENO;OFICIAL DE RECLUTAMIO;X;RENCA                         ;METROPOLITANA;1380930;7;4;6;3;1369940;1;1;10990;TERMOVENTILADOR KIOTO BLANCO 2000W KTE-1028B;CLIMATIZACION
19473777;;F;25;CHILENO;;Z;PROVIDENCIA                   ;METROPOLITANA;77970;3;2;3;2;77970;0;0;0;TERMOVENTILADOR KIOTO NEGRO 2000W KTE-1028N;CLIMATIZACION
8603950;;M;66;CHILENO;;Boomers;TALCAHUANO                    ;BIO BIO;326970;3;3;0;0;0;3;3;326970;ESTUFA A GAS UT GRX-4200 15 KILOS;CLIMATIZACION
17498048;;M;34;CHILENO;;Millenial;CURICO                        ;MAULE;569940;9;5;0;0;0;9;5;569940;CHIMENEA ELECTRICA KIOTO 2000W KTE-1101;CLIMATIZACION
19097422;Soltero;F;27;CHILENO;TECNICO EN ENFERMERIA DE NIVEL SUPERIOR;Z;PROVIDENCIA                   ;METROPOLITANA;31980;2;1;0;0;0;2;1;31980;ESTUFA ELECTRICA CUARZO KIOTO 1200W KTE 1033;CLIMATIZACION
17947052;;M;32;CHILENO;;Millenial;N/D;N/D;140880;4;2;0;0;0;4;2;140880;CHIMENEA ELECTRICA KIOTO 2000W KTE-1101;CLIMATIZACION
16535559;;M;35;CHILENO;;Millenial;SAN BERNARDO;METROPOLITANA;47980;2;1;0;0;0;2;1;47980;CALIENTACAMA KIOTO DIGITAL 2 PLAZAS KTC-1006;CLIMATIZACION
17512458;Soltero;M;32;CHILENO;;Silencioso;PROVIDENCIA                   ;METROPOLITANA;19970;3;1;3;1;19970;0;0;0;ESTUFA CUARZO KIOTO 800W KTE-011A;CLIMATIZACION
18106287;;M;30;CHILENO;;Millenial;SAN PEDRO DE LA PAZ;BIO-BIO;0;0;2;0;2;0;0;0;0;TERMOVENTILADOR KIOTO BLANCO 2000W KTE-1028B;CLIMATIZACION
26332615;;M;36;EXTRANJERO - NO INFORMA NACIONALIDAD;;Extranjero;MELIPILLA                     ;METROPOLITANA;453930;7;5;3;2;20970;4;3;432960;TERMOVENTILADOR KIOTO BLANCO 2000W KTE-1028B;CLIMATIZACION
9583643;;F;61;CHILENO;;Boomers;LO BARNECHEA                  ;METROPOLITANA;98470;3;2;2;1;76480;1;1;21990;CALIENTACAMA KIOTO DIGITAL 1 PLAZA KTC-1005;CLIMATIZACION
12807436;;F;47;CHILENO;;X;MONTE PATRIA                  ;COQUIMBO;84980;2;1;0;0;0;2;1;84980;CONVECTOR UT N10;CLIMATIZACION
19267518;;F;26;CHILENO;;Millenial;"";"";29990;1;1;0;0;0;1;1;29990;CALIENTACAMA KIOTO DIGITAL 2 PLAZAS KTC-1006;CLIMATIZACION
19281769;;M;26;CHILENO;;Z;QUILICURA                     ;METROPOLITANA;6990;1;1;0;0;0;1;1;6990;ESTUFA CUARZO KIOTO 800W KTE-011A;CLIMATIZACION
6121170;;F;68;CHILENO;;Boomers;ARAUCO                        ;BIO BIO;137680;6;4;0;0;0;6;4;137680;CHIMENEA ELECTRICA KIOTO 2000W KTE-1101;CLIMATIZACION
13565004;;M;43;CHILENO;;X;N/D;N/D;133970;3;2;1;1;119990;2;1;13980;ESTUFA CUARZO KIOTO 800W KTE-011A;CLIMATIZACION
12466802;;M;49;CHILENO;;X;N/D;N/D;350960;4;2;1;1;319990;3;1;30970;TERMOVENTILADOR KIOTO BLANCO 2000W KTE-1028B;CLIMATIZACION
18657559;Soltero;M;28;CHILENO;;Millenial;PROVIDENCIA                   ;METROPOLITANA;27960;4;1;4;1;27960;0;0;0;ESTUFA CUARZO KIOTO 800W KTE-011A;CLIMATIZACION
19817836;;F;24;CHILENO;;Z;PROVIDENCIA                   ;METROPOLITANA;10990;1;1;1;1;10990;0;0;0;CALIENTACAMA KIOTO ANALOGO 1 PLAZA KTC-1004;CLIMATIZACION
16339528;Soltero;M;36;CHILENO;;Millenial;PROVIDENCIA                   ;METROPOLITANA;10990;1;1;1;1;10990;0;0;0;CALIENTACAMA KIOTO ANALOGO 1 PLAZA KTC-1004;CLIMATIZACION
9529672;;F;60;CHILENO;;Boomers;PROVIDENCIA                   ;METROPOLITANA;10990;1;1;0;0;0;1;1;10990;TERMOVENTILADOR KIOTO BLANCO 2000W KTE-1028B;CLIMATIZACION
26593368;Soltero;M;44;CHILENO;;Extranjero;PROVIDENCIA                   ;METROPOLITANA;0;0;2;0;2;0;0;0;0;TERMOVENTILADOR KIOTO BLANCO 2000W KTE-1028B;CLIMATIZACION
8335964;;M;63;CHILENO;;Boomers;PROVIDENCIA                   ;METROPOLITANA;46980;2;2;0;0;0;2;2;46980;TERMOVENTILADOR KIOTO BLANCO 2000W KTE-1028B;CLIMATIZACION
4556415;;M;78;CHILENO;;Silencioso;RENCA                         ;METROPOLITANA;15980;2;1;2;1;15980;0;0;0;ESTUFA CUARZO KIOTO 800W KTE-011A;CLIMATIZACION
20556158;;F;21;CHILENO;;Z;PROVIDENCIA                   ;METROPOLITANA;0;0;2;0;2;0;0;0;0;TERMOVENTILADOR KIOTO BLANCO 2000W KTE-1028B;CLIMATIZACION
13498184;;M;43;CHILENO;;X;PROVIDENCIA                   ;METROPOLITANA;54980;2;2;0;0;0;2;2;54980;CALIENTACAMA KIOTO DIGITAL 1 PLAZA KTC-1005;CLIMATIZACION
20508183;;F;21;CHILENO;;Silencioso;PROVIDENCIA                   ;METROPOLITANA;18990;1;3;1;3;18990;0;0;0;TERMOVENTILADOR KIOTO BLANCO 2000W KTE-1028B;CLIMATIZACION
17187592;;F;33;CHILENO;;Millenial;PROVIDENCIA                   ;METROPOLITANA;49990;1;1;1;1;49990;0;0;0;CHIMENEA ELECTRICA KIOTO 2000W KTE-1101;CLIMATIZACION
6619848;;M;69;CHILENO;;Silencioso;RENCA                         ;METROPOLITANA;29990;1;1;0;0;0;1;1;29990;CALIENTACAMA KIOTO DIGITAL 2 PLAZAS KTC-1006;CLIMATIZACION
18370619;;F;28;CHILENO;;Millenial;ALTO HOSPICIO;TARAPACA;7990;1;1;1;1;7990;0;0;0;ESTUFA CUARZO KIOTO 800W KTE-011A;CLIMATIZACION
17686327;;M;31;CHILENO;;Millenial;NACIMIENTO                    ;BIO BIO;39960;4;1;0;0;0;4;1;39960;TERMOVENTILADOR KIOTO BLANCO 2000W KTE-1028B;CLIMATIZACION
20604317;;F;21;CHILENO;;Z;PROVIDENCIA                   ;METROPOLITANA;23980;2;1;2;1;23980;0;0;0;CALIENTACAMA KIOTO ANALOGO 1 PLAZA KTC-1004;CLIMATIZACION
10256984;Casado;M;54;CHILENO;;X;PROVIDENCIA                   ;METROPOLITANA;21970;3;1;3;1;21970;0;0;0;TERMOVENTILADOR KIOTO BLANCO 2000W KTE-1028B;CLIMATIZACION
9575405;;F;63;CHILENO;;Millenial;PROVIDENCIA                   ;METROPOLITANA;9990;1;1;0;0;0;1;1;9990;TERMOVENTILADOR KIOTO NEGRO 2000W KTE-1028N;CLIMATIZACION
6364527;;M;72;CHILENO;;Silencioso;LEBU                          ;BIO BIO;35980;2;2;0;0;0;2;2;35980;TERMOVENTILADOR KIOTO BLANCO 2000W KTE-1028B;CLIMATIZACION
16050856;;M;37;CHILENO;;Millenial;YERBAS BUENAS                 ;MAULE;12990;1;1;0;0;0;1;1;12990;CALIENTACAMA KIOTO ANALOGO 1 PLAZA KTC-1004;CLIMATIZACION
8220710;Casado;F;65;CHILENO;;Boomers;RENCA                         ;METROPOLITANA;8990;1;1;0;0;0;1;1;8990;TERMOVENTILADOR KIOTO BLANCO 2000W KTE-1028B;CLIMATIZACION
16209980;;F;36;CHILENO;;Millenial;RENCA                         ;METROPOLITANA;7990;1;1;1;1;7990;0;0;0;ESTUFA CUARZO KIOTO 800W KTE-011A;CLIMATIZACION
6603209;;F;69;CHILENO;;Silencioso;PROVIDENCIA                   ;METROPOLITANA;689760;9;5;0;0;0;9;5;689760;CHIMENEA ELECTRICA KIOTO 2000W KTE-1101;CLIMATIZACION
27228885;;M;34;CHILENO;;Extranjero;"";"";47660;2;1;0;0;0;2;1;47660;TERMOVENTILADOR TH-FH31 BLANCO 1000W-2000W;CLIMATIZACION
15049688;;M;35;CHILENO;;Millenial;PROVIDENCIA                   ;METROPOLITANA;309760;6;3;4;2;298520;2;1;11240;TERMOVENTILADOR KIOTO BLANCO 2000W KTE-1028B;CLIMATIZACION
17999314;Soltero;F;30;CHILENO;PSICOPEDAGOGO;Millenial;PROVIDENCIA                   ;METROPOLITANA;8990;1;1;1;1;8990;0;0;0;ESTUFA CUARZO KIOTO 800W KTE-011A;CLIMATIZACION
10610319;;F;56;CHILENO;;Boomers;PITRUFQUEN                    ;ARAUCANIA;76972;3;2;0;0;0;3;2;76972;CALIENTACAMA KIOTO ANALOGO 1 PLAZA KTC-1004;CLIMATIZACION
18265172;Soltero;F;29;CHILENO;ENFERMERA;Millenial;PROVIDENCIA                   ;METROPOLITANA;8990;1;1;1;1;8990;0;0;0;TERMOVENTILADOR KIOTO NEGRO 2000W KTE-1028N;CLIMATIZACION
26309182;Soltero;M;40;EXTRANJERO - NO INFORMA NACIONALIDAD;;Extranjero;PROVIDENCIA                   ;METROPOLITANA;289970;4;3;4;3;289970;0;0;0;TERMOVENTILADOR KIOTO BLANCO 2000W KTE-1028B;CLIMATIZACION
9090811;;F;62;CHILENO;;Boomers;RECOLETA                      ;METROPOLITANA;30240;2;1;0;0;0;2;1;30240;CALIENTACAMA KIOTO DIGITAL 2 PLAZAS KTC-1006;CLIMATIZACION
6815171;Viudo;F;73;CHILENO;;Silencioso;PROVIDENCIA                   ;METROPOLITANA;27990;1;1;0;0;0;1;1;27990;CALIENTACAMA KIOTO DIGITAL 2 PLAZAS KTC-1006;CLIMATIZACION
20305110;;F;22;CHILENO;;Z;TALCA;MAULE;113470;3;2;3;2;113470;0;0;0;TERMOVENTILADOR KIOTO BLANCO 2000W KTE-1028B;CLIMATIZACION
27234456;;M;31;CHILENO;;Extranjero;N/D;N/D;62970;3;2;2;1;17980;1;1;44990;TERMOVENTILADOR KIOTO NEGRO 2000W KTE-1028N;CLIMATIZACION
8951387;;F;57;CHILENO;;Boomers;SAN FERNANDO                  ;L.G.B.OÂ´HIGGINS;34980;2;1;0;0;0;2;1;34980;CALIENTACAMA KIOTO DIGITAL 2 PLAZAS KTC-1006;CLIMATIZACION
16714351;;M;35;CHILENO;;Millenial;N/D;N/D;39970;3;2;1;1;9990;2;1;29980;TERMOVENTILADOR KIOTO BLANCO 2000W KTE-1028B;CLIMATIZACION
3028313;;M;89;CHILENO;;Silencioso;TALAGANTE                     ;METROPOLITANA;259980;2;2;0;0;0;2;2;259980;ESTUFA A GAS SINDELEN SR-5250NG;CLIMATIZACION
6584099;;F;73;CHILENO;;Silencioso;PARRAL                        ;MAULE;20990;1;1;0;0;0;1;1;20990;Termoventilador 2000W Ht 2018;CLIMATIZACION
25120901;;M;27;COLOMBIANO;;Extranjero;CONCEPCION                    ;BIO BIO;27990;1;1;1;1;27990;0;0;0;CALIENTACAMA KIOTO DIGITAL 2 PLAZAS KTC-1006;CLIMATIZACION
13367981;;F;45;CHILENO;;X;PROVIDENCIA                   ;METROPOLITANA;12990;1;1;0;0;0;1;1;12990;CALIENTACAMA KIOTO ANALOGO 1 PLAZA KTC-1004;CLIMATIZACION
7509987;;F;65;CHILENO;;Boomers;BUIN                          ;METROPOLITANA;762610;8;5;0;0;0;8;5;762610;ESTUFA ELECTRICA CUARZO KIOTO 1200W KTE 1033;CLIMATIZACION
19116753;;F;28;CHILENO;;Millenial;SAN BERNARDO;METROPOLITANA;54990;1;1;1;1;54990;0;0;0;CHIMENEA ELECTRICA KIOTO 2000W KTE-1101;CLIMATIZACION
10561966;;F;56;CHILENO;;Boomers;TALCA                         ;MAULE;149990;1;1;0;0;0;1;1;149990;ESTUFA INFRAROJA TH-IR60;CLIMATIZACION
17172181;Soltero;F;33;CHILENO;TECNICO DE NIVEL SUPERIOR EN ENFERMERIA;Millenial;CERRO NAVIA                   ;METROPOLITANA;18230;3;2;0;0;0;3;2;18230;TERMOVENTILADOR KIOTO NEGRO 2000W KTE-1028N;CLIMATIZACION
18196320;;M;30;CHILENO;;Millenial;"";"";12990;1;1;1;1;12990;0;0;0;CALIENTACAMA KIOTO ANALOGO 1 PLAZA KTC-1004;CLIMATIZACION
14333860;;F;44;CHILENO;;X;CASTRO                        ;LOS LAGOS;239980;3;2;0;0;0;3;2;239980;TERMOVENTILADOR KIOTO BLANCO 2000W KTE-1028B;CLIMATIZACION
15502045;;M;39;CHILENO;;Millenial;N/D;N/D;417810;10;4;10;4;417810;0;0;0;CALIENTACAMA KIOTO ANALOGO 1 PLAZA KTC-1004;CLIMATIZACION
16543886;;M;35;CHILENO;;Millenial;N/D;N/D;41970;3;2;0;0;0;3;2;41970;CALIENTACAMA KIOTO ANALOGO 1 PLAZA KTC-1004;CLIMATIZACION
6026859;;M;73;CHILENO;;Silencioso;MAIPU                         ;METROPOLITANA;237160;2;1;0;0;0;2;1;237160;ESTUFA A GAS CALMA 15 KG HELIUS;CLIMATIZACION
16979844;;F;34;CHILENO;;Millenial;CANETE;BIO-BIO;27990;1;1;0;0;0;1;1;27990;CALEFACTOR CUARZO VERTICAL 800 W HQ 80 AIROLITE;CLIMATIZACION
9555047;;F;61;CHILENO;;Boomers;PROVIDENCIA                   ;METROPOLITANA;11990;1;1;0;0;0;1;1;11990;CALIENTACAMA KIOTO ANALOGO 1 PLAZA KTC-1004;CLIMATIZACION
17664523;;F;31;CHILENO;;Millenial;PROVIDENCIA                   ;METROPOLITANA;9990;1;1;1;1;9990;0;0;0;TERMOVENTILADOR KIOTO NEGRO 2000W KTE-1028N;CLIMATIZACION
13818752;;F;41;CHILENO;;X;TEMUCO                        ;ARAUCANIA;17980;2;1;2;1;17980;0;0;0;TERMOVENTILADOR KIOTO BLANCO 2000W KTE-1028B;CLIMATIZACION
11554694;;F;51;CHILENO;;X;RENGO                         ;L.G.B.OÂ´HIGGINS;8990;1;1;0;0;0;1;1;8990;TERMOVENTILADOR KIOTO NEGRO 2000W KTE-1028N;CLIMATIZACION
12280199;;F;49;CHILENO;;X;PUENTE ALTO                   ;METROPOLITANA;12990;1;1;1;1;12990;0;0;0;CALIENTACAMA KIOTO ANALOGO 1 PLAZA KTC-1004;CLIMATIZACION
19067442;Soltero;F;26;CHILENO;;Z;BUIN                          ;METROPOLITANA;30970;3;2;0;0;0;3;2;30970;TERMOVENTILADOR KIOTO NEGRO 2000W KTE-1028N;CLIMATIZACION
13745218;;F;42;CHILENO;;X;HUASCO                        ;ATACAMA;27990;1;1;0;0;0;1;1;27990;CALIENTACAMA KIOTO DIGITAL 2 PLAZAS KTC-1006;CLIMATIZACION
5639432;;F;75;CHILENO;;Silencioso;RENCA                         ;METROPOLITANA;173980;2;1;2;1;173980;0;0;0;CALEFACTOR INFRAROJO GR2800 R NEGRO;CLIMATIZACION
11746076;;F;51;CHILENO;;X;BUIN                          ;METROPOLITANA;252910;8;5;0;0;0;8;5;252910;TERMOVENTILADOR KIOTO BLANCO 2000W KTE-1028B;CLIMATIZACION
11567846;Casado;F;52;CHILENO;TECNICO EN CONTABILIDAD;X;RENCA                         ;METROPOLITANA;9990;1;1;1;1;9990;0;0;0;TERMOVENTILADOR KIOTO BLANCO 2000W KTE-1028B;CLIMATIZACION
4730558;;M;76;CHILENO;;Silencioso;LICANTEN                      ;MAULE;1467095;16;6;0;0;0;16;6;1467095;ESTUFA ELECTRICA CUARZO KIOTO 1200W KTE 1033;CLIMATIZACION
14386007;;F;43;CHILENO;;X;COQUIMBO;COQUIMBO;694230;6;3;0;0;0;6;3;694230;CHIMENEA ELECTRICA KIOTO 2000W KTE-1101;CLIMATIZACION
16598281;;M;35;CHILENO;;Millenial;PROVIDENCIA                   ;METROPOLITANA;11990;1;1;1;1;11990;0;0;0;CALIENTACAMA KIOTO ANALOGO 1 PLAZA KTC-1004;CLIMATIZACION
17816816;;F;30;CHILENO;;Millenial;PROVIDENCIA                   ;METROPOLITANA;42960;4;1;4;1;42960;0;0;0;CALIENTACAMA KIOTO ANALOGO 1 PLAZA KTC-1004;CLIMATIZACION
13940277;;F;42;CHILENO;;Silencioso;PROVIDENCIA                   ;METROPOLITANA;8990;1;1;0;0;0;1;1;8990;TERMOVENTILADOR KIOTO BLANCO 2000W KTE-1028B;CLIMATIZACION
15447428;;F;39;CHILENO;;X;N/D;N/D;479960;4;3;2;1;239980;2;2;239980;ESTUFA A GAS SINDELEN SR-5250NG;CLIMATIZACION
13295338;;F;45;CHILENO;;X;LO ESPEJO                     ;METROPOLITANA;102950;5;1;0;0;0;5;1;102950;CHIMENEA ELECTRICA KIOTO 2000W KTE-1101;CLIMATIZACION
17009251;;F;33;CHILENO;;Millenial;LA GRANJA                     ;METROPOLITANA;191910;2;1;0;0;0;2;1;191910;ESTUFA KEROSENE 720+;CLIMATIZACION
12791451;;F;54;CHILENO;;X;N/D;N/D;342950;5;5;0;0;0;5;5;342950;CALIENTACAMA KIOTO ANALOGO 1 PLAZA KTC-1004;CLIMATIZACION
9998287;;M;56;CHILENO;;Boomers;LA SERENA                     ;COQUIMBO;169970;3;3;3;3;169970;0;0;0;TERMOVENTILADOR KIOTO BLANCO 2000W KTE-1028B;CLIMATIZACION
11686411;;M;52;CHILENO;;X;NUEVA IMPERIAL                ;ARAUCANIA;34560;2;1;0;0;0;2;1;34560;ESTUFA ELECTRICA CUARZO KIOTO 1200W KTE 1033;CLIMATIZACION
13331027;;F;43;CHILENO;;X;LOS ANDES                     ;VALPARAISO;239980;2;2;0;0;0;2;2;239980;CHIMENEA ELECTRICA KIOTO 2000W KTE-1101;CLIMATIZACION
6301027;;M;73;CHILENO;;Silencioso;RENCA                         ;METROPOLITANA;8990;1;1;0;0;0;1;1;8990;TERMOVENTILADOR KIOTO BLANCO 2000W KTE-1028B;CLIMATIZACION
9754110;;M;59;CHILENO;;Boomers;PANGUIPULLI                   ;LOS LAGOS;739980;2;2;1;1;159990;1;1;579990;Calefactor Bosca a Lena Limit 480;CLIMATIZACION
26644538;;F;31;VENEZOLANO;;Extranjero;PROVIDENCIA                   ;METROPOLITANA;7990;1;1;1;1;7990;0;0;0;TERMOVENTILADOR KIOTO BLANCO 2000W KTE-1028B;CLIMATIZACION
11715918;;F;51;CHILENO;;X;PROVIDENCIA                   ;METROPOLITANA;59990;1;1;0;0;0;1;1;59990;CALIENTACAMAS ANALOGO BASICO 2 PL;CLIMATIZACION
26482685;;M;29;EXTRANJERO - NO INFORMA NACIONALIDAD;;Extranjero;"";"";11980;2;3;2;1;11980;0;2;0;TERMOVENTILADOR KIOTO BLANCO 2000W KTE-1028B;CLIMATIZACION
14221939;;M;40;CHILENO;;X;PROVIDENCIA                   ;METROPOLITANA;149990;1;1;0;0;0;1;1;149990;ESTUFA INFRAROJA TH-IR60;CLIMATIZACION
8146737;;F;60;CHILENO;;Boomers;PANGUIPULLI                   ;LOS RIOS;900400;16;5;0;0;0;16;5;900400;ESTUFA ELECTRICA CUARZO KIOTO 1200W KTE 1033;CLIMATIZACION
5521939;;M;76;CHILENO;;Silencioso;PROVIDENCIA                   ;METROPOLITANA;13980;2;1;2;1;13980;0;0;0;ESTUFA ELECTRICA CUARZO KIOTO 1200W KTE 1033;CLIMATIZACION
12949530;;M;46;CHILENO;;X;PROVIDENCIA                   ;METROPOLITANA;29990;1;1;0;0;0;1;1;29990;CALIENTACAMA KIOTO DIGITAL 2 PLAZAS KTC-1006;CLIMATIZACION
12237581;;F;49;CHILENO;;X;QUILICURA                     ;METROPOLITANA;389960;4;2;0;0;0;4;2;389960;CALIENTACAMA KIOTO DIGITAL 2 PLAZAS KTC-1006;CLIMATIZACION
15645320;Soltero;M;38;CHILENO;;X;CASTRO                        ;LOS LAGOS;74990;1;1;0;0;0;1;1;74990;TERMOVENTILADOR CALMA PTC DIGITAL T3000;CLIMATIZACION
13541753;;F;42;CHILENO;;X;LLAILLAY                      ;VALPARAISO;318360;3;2;1;1;299990;2;1;18370;TERMOVENTILADOR KIOTO BLANCO 2000W KTE-1028B;CLIMATIZACION
10694637;;F;53;CHILENO;;Silencioso;SAN CARLOS                    ;BIO BIO;216851;4;3;0;0;0;4;3;216851;ESTUFA ELECTRICA CUARZO KIOTO 1200W KTE 1033;CLIMATIZACION
17184458;;F;33;CHILENO;;Millenial;TALCA                         ;MAULE;181980;2;2;0;0;0;2;2;181980;CALIENTACAMA KIOTO ANALOGO 1 PLAZA KTC-1004;CLIMATIZACION
17915235;;F;31;CHILENO;;Millenial;N/D;N/D;34970;3;2;3;2;34970;0;0;0;TERMOVENTILADOR KIOTO NEGRO 2000W KTE-1028N;CLIMATIZACION
14108440;;F;40;CHILENO;;X;LA SERENA                     ;COQUIMBO;17990;1;1;0;0;0;1;1;17990;ESTUFA ELECTRICA CUARZO KIOTO 1200W KTE 1033;CLIMATIZACION
15750895;;F;38;CHILENO;;X;VALPARAISO                    ;VALPARAISO;27990;1;1;0;0;0;1;1;27990;CALIENTACAMA KIOTO DIGITAL 2 PLAZAS KTC-1006;CLIMATIZACION
18886974;;F;27;CHILENO;;Millenial;VALDIVIA                      ;LOS LAGOS;67980;2;1;0;0;0;2;1;67980;ESTUFA ELECTRICA CUARZO KC 220 ROJA;CLIMATIZACION
9238789;;M;57;CHILENO;;Boomers;TALCA                         ;MAULE;72090;2;2;0;0;0;2;2;72090;ESTUFA ELEC. RADIADOR TH-RFC50 800W-1600W-2000W;CLIMATIZACION
19651523;;F;24;CHILENO;;Z;PROVIDENCIA                   ;METROPOLITANA;19980;2;1;2;1;19980;0;0;0;ESTUFA ELECTRICA CUARZO KIOTO 1200W KTE 1033;CLIMATIZACION
15932482;;F;39;CHILENO;;X;SANTIAGO                      ;METROPOLITANA;202990;3;1;0;0;0;3;1;202990;ESTUFA INFRAROJA TH-IR60;CLIMATIZACION
11611936;;M;51;CHILENO;;X;RENCA                         ;METROPOLITANA;38970;3;2;0;0;0;3;2;38970;TERMOVENTILADOR KIOTO BLANCO 2000W KTE-1028B;CLIMATIZACION
10190907;;M;55;CHILENO;;Boomers;COIHAIQUE                     ;AYSEN;297980;2;2;1;1;279990;1;1;17990;CALIENTACAMA KIOTO DIGITAL 1 PLAZA KTC-1005;CLIMATIZACION
8687573;Casado;F;61;CHILENO;;Boomers;LOTA                          ;BIO BIO;28460;2;1;0;0;0;2;1;28460;ESTUFA ELECTRICA CUARZO KIOTO 1200W KTE 1033;CLIMATIZACION
14185479;;F;41;CHILENO;;X;RECOLETA;METROPOLITANA;666940;6;4;6;4;666940;0;0;0;ESTUFA CUARZO KIOTO 800W KTE-011A;CLIMATIZACION
13680183;;M;43;CHILENO;;Millenial;PROVIDENCIA                   ;METROPOLITANA;802009;8;3;0;0;0;8;3;802009;CALIENTACAMA KIOTO ANALOGO 1 PLAZA KTC-1004;CLIMATIZACION
6609223;;M;68;CHILENO;;Boomers;MACHALI                       ;L.G.B.OÂ´HIGGINS;19990;1;1;0;0;0;1;1;19990;TERMOVENTILADOR TH-FH30 BLANCO 1000W-2000W;CLIMATIZACION
19458001;;F;24;CHILENO;;Z;PROVIDENCIA                   ;METROPOLITANA;9990;1;1;1;1;9990;0;0;0;TERMOVENTILADOR KIOTO BLANCO 2000W KTE-1028B;CLIMATIZACION
17730931;;F;31;CHILENO;;Millenial;PROVIDENCIA                   ;METROPOLITANA;19970;3;1;3;1;19970;0;0;0;TERMOVENTILADOR KIOTO BLANCO 2000W KTE-1028B;CLIMATIZACION
17225759;;M;32;CHILENO;;Millenial;N/D;N/D;17990;1;1;0;0;0;1;1;17990;CALIENTACAMA KIOTO DIGITAL 1 PLAZA KTC-1005;CLIMATIZACION
12953340;;M;46;CHILENO;;X;LIMACHE                       ;VALPARAISO;29990;1;1;1;1;29990;0;0;0;CALEFACTOR CARBONO 800W EEC-3000 NEGRO;CLIMATIZACION
10486765;;M;47;CHILENO;;X;PUCON                         ;ARAUCANIA;417950;5;3;0;0;0;5;3;417950;ESTUFA ELECTRICA CUARZO KIOTO 1200W KTE 1033;CLIMATIZACION
17690991;;M;31;CHILENO;;Millenial;N/D;N/D;424980;3;2;2;1;399990;1;1;24990;MINI OLEOELECTRICA KIOTO 500W NEGRO KTE-1081N;CLIMATIZACION
6631604;;F;69;CHILENO;;Silencioso;CALAMA                        ;ANTOFAGASTA;266960;4;2;0;0;0;4;2;266960;CALIENTACAMA KIOTO DIGITAL 1 PLAZA KTC-1005;CLIMATIZACION
8613379;Casado;F;61;CHILENO;;Boomers;LOS LAGOS                     ;LOS LAGOS;75000;2;3;0;0;0;2;3;75000;ESTUFA GAS EH2500 5K NEGRO;CLIMATIZACION
11570844;;F;51;CHILENO;;X;PROVIDENCIA                   ;METROPOLITANA;8990;1;1;1;1;8990;0;0;0;TERMOVENTILADOR KIOTO NEGRO 2000W KTE-1028N;CLIMATIZACION
11786337;;M;50;CHILENO;;X;ISLA DE MAIPO                 ;METROPOLITANA;17990;1;1;0;0;0;1;1;17990;ESTUFA ELECTRICA CUARZO KIOTO 1200W KTE 1033;CLIMATIZACION
6677920;Casado;M;70;CHILENO;;Silencioso;RENCA                         ;METROPOLITANA;19990;1;1;0;0;0;1;1;19990;ESTUFA ELECTRICA CUARZO KIOTO 1200W KTE 1033;CLIMATIZACION
19315389;;F;26;CHILENO;;Z;PROVIDENCIA                   ;METROPOLITANA;24230;3;4;2;3;23980;1;1;250;CALIENTACAMA KIOTO ANALOGO 1 PLAZA KTC-1004;CLIMATIZACION
7328361;;F;67;CHILENO;;Boomers;RANCAGUA                      ;L.G.B.OÂ´HIGGINS;9990;1;1;0;0;0;1;1;9990;ESTUFA CUARZO KIOTO 800W KTE-011A;CLIMATIZACION
20089898;;M;23;CHILENO;;Z;N/D;N/D;240960;4;3;0;0;0;4;3;240960;TERMOVENTILADOR KIOTO NEGRO 2000W KTE-1028N;CLIMATIZACION
13626695;;F;43;CHILENO;;X;CAUQUENES                     ;MAULE;17990;1;1;0;0;0;1;1;17990;CALIENTACAMA KIOTO DIGITAL 1 PLAZA KTC-1005;CLIMATIZACION
13311100;Casado;M;45;CHILENO;INGENIERO COMERCIAL;X;RENCA                         ;METROPOLITANA;158980;2;1;2;1;158980;0;0;0;KIT INSTALACION PLUS 5PULGADAS ACERO;CLIMATIZACION
27519284;;M;29;CHILENO;;Extranjero;"";"";10000;2;1;0;0;0;2;1;10000;TERMOVENTILADOR KIOTO BLANCO 2000W KTE-1028B;CLIMATIZACION
6938275;;M;69;CHILENO;;Silencioso;ISLA DE MAIPO                 ;METROPOLITANA;259970;4;3;0;0;0;4;3;259970;ESTUFA FOGUITA PRO;CLIMATIZACION
8649053;;F;64;CHILENO;;Boomers;PUENTE ALTO                   ;METROPOLITANA;9990;1;1;0;0;0;1;1;9990;ESTUFA CUARZO KIOTO 800W KTE-011A;CLIMATIZACION
16078431;;F;32;CHILENO;;Millenial;CASTRO                        ;LOS LAGOS;8990;1;1;0;0;0;1;1;8990;TERMOVENTILADOR KIOTO NEGRO 2000W KTE-1028N;CLIMATIZACION
11115317;Soltero;F;54;CHILENO;;Silencioso;PROVIDENCIA                   ;METROPOLITANA;8990;1;1;0;0;0;1;1;8990;TERMOVENTILADOR KIOTO NEGRO 2000W KTE-1028N;CLIMATIZACION
6581527;;M;66;CHILENO;;Boomers;PANGUIPULLI                   ;LOS RIOS;234970;3;5;0;0;0;3;5;234970;CALIENTACAMA KIOTO DIGITAL 1 PLAZA KTC-1005;CLIMATIZACION
6916045;;M;65;CHILENO;;Boomers;LOS ANDES                     ;VALPARAISO;278150;4;2;0;0;0;4;2;278150;ESTUFA A GAS UT GRX-6200 ET ROJA 15 KILOS;CLIMATIZACION
19441363;;F;25;CHILENO;;Z;"";"";83950;5;3;0;0;0;5;3;83950;ESTUFA FIBRA DE CARBONO KFB 90;CLIMATIZACION
6948080;;F;68;CHILENO;;Silencioso;CALBUCO                       ;LOS LAGOS;129990;1;1;0;0;0;1;1;129990;ESTUFA A GAS CALMA 5 KG COMPAK;CLIMATIZACION
9334168;;M;60;CHILENO;;Boomers;CURICO                        ;MAULE;301910;10;6;2;1;125480;8;5;176430;ESTUFA ELECTRICA CUARZO KIOTO 1200W KTE 1033;CLIMATIZACION
6041379;;F;79;CHILENO;;Silencioso;MELIPILLA                     ;METROPOLITANA;19990;1;1;0;0;0;1;1;19990;ESTUFA ELECTRICA CUARZO KIOTO 1200W KTE 1033;CLIMATIZACION
19212899;;F;26;CHILENO;;Z;N/D;N/D;56990;1;1;0;0;0;1;1;56990;CALIENTACAMAS MANUAL 3N SG-5011 2PL;CLIMATIZACION
14168310;;F;40;CHILENO;;X;PROVIDENCIA                   ;METROPOLITANA;12990;1;1;0;0;0;1;1;12990;CALIENTACAMA KIOTO ANALOGO 1 PLAZA KTC-1004;CLIMATIZACION
10542343;Casado;M;54;CHILENO;ASISTENTE SOCIAL;X;RENCA                         ;METROPOLITANA;54990;1;1;0;0;0;1;1;54990;ESTUFA FIBRA DE CARBONO KFC 90 - NEGRA ROJA;CLIMATIZACION
7680727;;M;66;CHILENO;;Boomers;TALCAHUANO                    ;BIO BIO;54990;1;1;0;0;0;1;1;54990;CHIMENEA ELECTRICA KIOTO 2000W KTE-1101;CLIMATIZACION
10575376;;F;54;CHILENO;;Boomers;COIHAIQUE                     ;AYSEN;373960;4;3;0;0;0;4;3;373960;CALIENTACAMA KIOTO DIGITAL 1 PLAZA KTC-1005;CLIMATIZACION
25068546;;M;32;BOLIVIANO;;Extranjero;N/D;N/D;9990;1;1;0;0;0;1;1;9990;TERMOVENTILADOR KIOTO BLANCO 2000W KTE-1028B;CLIMATIZACION
12870998;Divorciado;F;47;CHILENO;TECNICO EN ADMINISTRACION DE EMPRESAS;X;RENCA                         ;METROPOLITANA;39990;1;1;1;1;39990;0;0;0;ESTUFA FIBRA DE CARBONO KFB 90;CLIMATIZACION
11234342;;F;54;CHILENO;;X;PROVIDENCIA                   ;METROPOLITANA;21290;2;1;0;0;0;2;1;21290;TERMOVENTILADOR KIOTO NEGRO 2000W KTE-1028N;CLIMATIZACION
13203777;;M;45;CHILENO;;X;RENCA                         ;METROPOLITANA;451210;2;1;0;0;0;2;1;451210;CALEFACTOR BOSCA LIMIT 360;CLIMATIZACION
8814708;;M;60;CHILENO;;X;PROVIDENCIA                   ;METROPOLITANA;139990;1;1;0;0;0;1;1;139990;ESTUFA KEROSENE F 1120+;CLIMATIZACION
14008075;;F;40;CHILENO;;X;MELIPILLA                     ;METROPOLITANA;626950;5;5;0;0;0;5;5;626950;TERMOVENTILADOR KIOTO NEGRO 2000W KTE-1028N;CLIMATIZACION
8694173;;F;59;CHILENO;;Boomers;RENCA                         ;METROPOLITANA;25980;2;1;2;1;25980;0;0;0;TERMOVENTILADOR KIOTO NEGRO 2000W KTE-1028N;CLIMATIZACION
18259106;Soltero;M;29;CHILENO;;Millenial;N/D;N/D;69990;1;1;0;0;0;1;1;69990;CHIMENEA ELECTRICA KIOTO 2000W KTE-1101;CLIMATIZACION
17287147;Soltero;F;32;CHILENO;PROFESOR;Millenial;PROVIDENCIA                   ;METROPOLITANA;27990;1;1;1;1;27990;0;0;0;CALIENTACAMA KIOTO DIGITAL 2 PLAZAS KTC-1006;CLIMATIZACION
10306348;;F;41;CHILENO;;Millenial;"";"";14990;1;1;1;1;14990;0;0;0;CALIENTACAMA KIOTO ANALOGO 1 PLAZA KTC-1004;CLIMATIZACION
8985789;;M;61;CHILENO;;Boomers;N/D;N/D;8990;1;1;0;0;0;1;1;8990;TERMOVENTILADOR KIOTO BLANCO 2000W KTE-1028B;CLIMATIZACION
14274567;;F;49;CHILENO;;X;PROVIDENCIA                   ;METROPOLITANA;71970;3;3;1;1;19990;2;2;51980;ESTUFA ELECTRICA CUARZO KIOTO 1200W KTE 1033;CLIMATIZACION
10291429;Soltero;F;45;CHILENO;;X;RENCA                         ;METROPOLITANA;69980;2;2;1;1;29990;1;1;39990;CALIENTACAMA KIOTO DIGITAL 2 PLAZAS KTC-1006;CLIMATIZACION
16562367;;M;36;CHILENO;;Millenial;N/D;N/D;710230;7;2;0;0;0;7;2;710230;TERMOVENTILADOR KIOTO NEGRO 2000W KTE-1028N;CLIMATIZACION
16246648;;F;37;CHILENO;;Millenial;N/D;N/D;408930;8;4;6;3;266940;2;1;141990;TERMOVENTILADOR KIOTO NEGRO 2000W KTE-1028N;CLIMATIZACION
8776108;Soltero;M;59;CHILENO;DISENADOR;Boomers;PROVIDENCIA                   ;METROPOLITANA;12980;2;1;2;1;12980;0;0;0;TERMOVENTILADOR KIOTO NEGRO 2000W KTE-1028N;CLIMATIZACION
6535834;;M;70;CHILENO;;Silencioso;PADRE LAS CASAS               ;ARAUCANIA;470580;8;4;0;0;0;8;4;470580;ESTUFA FIAMMA PRO;CLIMATIZACION
15212496;;M;39;CHILENO;;X;PROVIDENCIA                   ;METROPOLITANA;54970;3;1;3;1;54970;0;0;0;CALIENTACAMA KIOTO DIGITAL 2 PLAZAS KTC-1006;CLIMATIZACION
7862532;;F;73;CHILENO;;Silencioso;QUILLOTA                      ;VALPARAISO;289610;7;1;0;0;0;7;1;289610;ESTUFA GAS KGQ15N 15K NEGRO EUROPEA;CLIMATIZACION
9942476;;M;58;CHILENO;;Boomers;ARAUCO                        ;BIO BIO;15393;1;1;0;0;0;1;1;15393;ESTUFA ELECTRICA CUARZO KIOTO 1200W KTE 1033;CLIMATIZACION
17306220;;M;32;CHILENO;;Millenial;N/D;N/D;193830;4;3;2;2;44980;2;1;148850;ESTUFA FIAMMA PRO;CLIMATIZACION
11255341;;M;54;CHILENO;;X;MALLOA                        ;L.G.B.OÂ´HIGGINS;391750;3;2;0;0;0;3;2;391750;TERMOVENTILADOR KIOTO NEGRO 2000W KTE-1028N;CLIMATIZACION
18525251;Soltero;M;28;CHILENO;;Millenial;PROVIDENCIA                   ;METROPOLITANA;9990;1;1;1;1;9990;0;0;0;TERMOVENTILADOR KIOTO NEGRO 2000W KTE-1028N;CLIMATIZACION
9460319;;M;57;CHILENO;;Boomers;RENCA                         ;METROPOLITANA;198980;2;2;1;1;188990;1;1;9990;TERMOVENTILADOR KIOTO BLANCO 2000W KTE-1028B;CLIMATIZACION
20079865;;F;23;CHILENO;;Z;"";"";12990;1;1;1;1;12990;0;0;0;CALIENTACAMA KIOTO ANALOGO 1 PLAZA KTC-1004;CLIMATIZACION
19588558;;M;27;CHILENO;;Z;MARIA PINTO                   ;METROPOLITANA;73960;4;3;0;0;0;4;3;73960;TERMOVENTILADOR TH-FH30 BLANCO 1000W-2000W;CLIMATIZACION
6550824;;M;68;CHILENO;;Silencioso;PROVIDENCIA                   ;METROPOLITANA;19980;2;2;0;0;0;2;2;19980;TERMOVENTILADOR KIOTO BLANCO 2000W KTE-1028B;CLIMATIZACION
15663655;;F;38;CHILENO;;X;"";"";53650;5;2;0;0;0;5;2;53650;CALIENTACAMA KIOTO ANALOGO 1 PLAZA KTC-1004;CLIMATIZACION
9931773;;F;56;CHILENO;;Boomers;CHILLAN                       ;BIO BIO;533190;5;3;0;0;0;5;3;533190;TERMOVENTILADOR CERAMICO DIGITAL 2000 W HTC-2022;CLIMATIZACION
14044858;;F;41;CHILENO;;X;CAUQUENES                     ;MAULE;178970;3;2;2;1;148980;1;1;29990;CONVECTOR ELECTRICO UT MC -20 WIFI;CLIMATIZACION
10447870;;M;54;CHILENO;;X;N/D;N/D;733030;6;4;3;2;194970;3;2;538060;CHIMENEA ELECTRICA KIOTO 2000W KTE-1101;CLIMATIZACION
11532620;;M;51;CHILENO;;X;CAUQUENES                     ;MAULE;8990;1;1;0;0;0;1;1;8990;TERMOVENTILADOR KIOTO BLANCO 2000W KTE-1028B;CLIMATIZACION
6252972;Divorciado;M;69;CHILENO;;Silencioso;PROVIDENCIA                   ;METROPOLITANA;109560;3;2;0;0;0;3;2;109560;ESTUFA ELECTRICA CUARZO KIOTO 1200W KTE 1033;CLIMATIZACION
21728058;;F;40;CHILENO;;X;PROVIDENCIA                   ;METROPOLITANA;109970;3;2;0;0;0;3;2;109970;ESTUFA FIBRA DE CARBONO KFC 90 - NEGRA ROJA;CLIMATIZACION
17951169;;M;31;CHILENO;;Millenial;"";"";98960;4;3;0;0;0;4;3;98960;CALIENTACAMA KIOTO DIGITAL 1 PLAZA KTC-1005;CLIMATIZACION
7644767;;F;68;CHILENO;;Boomers;N/D;N/D;62990;1;1;0;0;0;1;1;62990;CALIENTACAMAS ANALOGO BASICO 2 PL;CLIMATIZACION
12370168;;F;49;CHILENO;;X;CURICO                        ;MAULE;17990;1;1;0;0;0;1;1;17990;CALIENTACAMA KIOTO DIGITAL 1 PLAZA KTC-1005;CLIMATIZACION
16729256;Soltero;F;34;CHILENO;CONSTRUCTOR CIVIL;Millenial;PROVIDENCIA                   ;METROPOLITANA;9990;1;1;1;1;9990;0;0;0;TERMOVENTILADOR KIOTO BLANCO 2000W KTE-1028B;CLIMATIZACION
8020957;;F;64;CHILENO;;Boomers;CARAHUE                       ;ARAUCANIA;339320;5;2;0;0;0;5;2;339320;ESTUFA A GAS UT GRX-6200 ET ROJA 15 KILOS;CLIMATIZACION
15263367;;M;37;CHILENO;;Millenial;VALDIVIA                      ;LOS RIOS;149970;3;2;0;0;0;3;2;149970;CALIENTACAMAS DIGITAL TIMER SG-5151 2PL;CLIMATIZACION
11907423;;F;51;CHILENO;;X;PARRAL                        ;MAULE;486880;4;3;0;0;0;4;3;486880;ESTUFA ELECTRICA CUARZO KIOTO 1200W KTE 1033;CLIMATIZACION
8918855;;F;62;CHILENO;;Boomers;COLLIPULLI                    ;ARAUCANIA;9990;1;1;0;0;0;1;1;9990;ESTUFA CUARZO KIOTO 800W KTE-011A;CLIMATIZACION
15592858;;M;38;CHILENO;;X;SAN PEDRO DE LA PAZ           ;BIO BIO;19990;1;1;0;0;0;1;1;19990;ESTUFA ELECTRICA CUARZO KIOTO 1200W KTE 1033;CLIMATIZACION
17204386;;M;33;CHILENO;;Millenial;N/D;N/D;214970;3;2;0;0;0;3;2;214970;CONVECTOR TH-CV51 BL 750W - 1250W - 2000W;CLIMATIZACION
17696376;;M;31;CHILENO;;Millenial;RENCA                         ;METROPOLITANA;21290;2;1;0;0;0;2;1;21290;TERMOVENTILADOR KIOTO NEGRO 2000W KTE-1028N;CLIMATIZACION
5569652;;F;74;CHILENO;;Silencioso;CANETE                        ;BIO BIO;24990;1;1;0;0;0;1;1;24990;CALEFACTOR CUARZO VERTICAL 800 W HQ 80 AIROLITE;CLIMATIZACION
18348163;Soltero;F;29;CHILENO;TECNICO DE NIVEL MEDIO EN ATENCION DE ENFERMERIA;Millenial;DALCAHUE                      ;LOS LAGOS;29990;1;1;0;0;0;1;1;29990;CALIENTACAMA KIOTO DIGITAL 2 PLAZAS KTC-1006;CLIMATIZACION
6081708;;F;75;CHILENO;;Silencioso;MAIPU                         ;METROPOLITANA;48982;2;2;0;0;0;2;2;48982;MINI OLEOELECTRICA KIOTO 500W BLANCO KTE-1081B;CLIMATIZACION
8373639;;F;52;CHILENO;;X;RENCA                         ;METROPOLITANA;27990;1;1;1;1;27990;0;0;0;CALIENTACAMA KIOTO DIGITAL 2 PLAZAS KTC-1006;CLIMATIZACION
9577174;;F;59;CHILENO;;Boomers;QUINTA NORMAL                 ;METROPOLITANA;13980;2;1;2;1;13980;0;0;0;TERMOVENTILADOR KIOTO NEGRO 2000W KTE-1028N;CLIMATIZACION
12432944;;F;49;CHILENO;;X;N/D;N/D;9990;1;1;0;0;0;1;1;9990;ESTUFA CUARZO KIOTO 800W KTE-011A;CLIMATIZACION
18624350;;F;28;CHILENO;;Millenial;PROVIDENCIA                   ;METROPOLITANA;9990;1;1;0;0;0;1;1;9990;TERMOVENTILADOR KIOTO BLANCO 2000W KTE-1028B;CLIMATIZACION
18963182;;F;27;CHILENO;;Millenial;N/D;N/D;59970;3;1;0;0;0;3;1;59970;CALIENTACAMA KIOTO DIGITAL 2 PLAZAS KTC-1006;CLIMATIZACION
19110291;Soltero;F;26;CHILENO;;Z;PROVIDENCIA                   ;METROPOLITANA;39980;2;1;2;1;39980;0;0;0;CALIENTACAMA KIOTO DIGITAL 1 PLAZA KTC-1005;CLIMATIZACION
18599916;Soltero;F;28;CHILENO;;Millenial;N/D;N/D;102970;4;2;3;1;74980;1;1;27990;VENTILADOR POWER BREEZE (160T);CLIMATIZACION
7137035;;F;71;CHILENO;;Silencioso;ANCUD                         ;LOS LAGOS;1141650;9;5;0;0;0;9;5;1141650;CALIENTACAMAS DIGITAL TIMER SG-5151 2PL;CLIMATIZACION
15958748;;F;36;CHILENO;;Millenial;EMPEDRADO                     ;MAULE;20990;1;1;0;0;0;1;1;20990;ESTUFA ELECTRICA CUARZO KIOTO 1200W KTE 1033;CLIMATIZACION
17854087;;F;30;CHILENO;;Millenial;VILLA ALEGRE                  ;MAULE;342350;4;2;0;0;0;4;2;342350;CALIENTACAMA KIOTO DIGITAL 1 PLAZA KTC-1005;CLIMATIZACION
18249130;Soltero;F;29;CHILENO;;Millenial;CANETE                        ;BIO BIO;243950;6;4;3;2;214970;3;2;28980;TERMOVENTILADOR KIOTO BLANCO 2000W KTE-1028B;CLIMATIZACION
18322295;Soltero;F;30;CHILENO;;Millenial;PROVIDENCIA                   ;METROPOLITANA;29990;1;1;0;0;0;1;1;29990;CALIENTACAMA KIOTO DIGITAL 2 PLAZAS KTC-1006;CLIMATIZACION
9691141;;M;63;CHILENO;;Boomers;LOS ANDES                     ;VALPARAISO;29990;1;1;0;0;0;1;1;29990;CALEFACTOR CUARZO 1600W EEH-1300 NEGRO;CLIMATIZACION
18697564;;M;28;CHILENO;;Millenial;N/D;N/D;218930;7;3;7;3;218930;0;0;0;CALIENTACAMA KIOTO ANALOGO 1 PLAZA KTC-1004;CLIMATIZACION
10145263;;F;57;CHILENO;;Boomers;CONSTITUCION                  ;MAULE;20391;1;1;0;0;0;1;1;20391;TERMOVENTILADOR OSCILANTE FH-120S BL;CLIMATIZACION
15066688;;F;38;CHILENO;;X;N/D;N/D;210960;4;3;0;0;0;4;3;210960;ESTUFA ELEC. FIBRA DE CARBONO NSB120K5 ROJA;CLIMATIZACION
9728081;;F;59;CHILENO;;Boomers;MELIPILLA                     ;METROPOLITANA;92980;2;2;0;0;0;2;2;92980;CALIENTACAMAS MANUAL 2N SG-5121D4 2PL;CLIMATIZACION
13687299;Casado;F;43;CHILENO;;X;PROVIDENCIA                   ;METROPOLITANA;165000;2;1;0;0;0;2;1;165000;ESTUFA KEROSENE F 1120+;CLIMATIZACION
17977317;;F;31;CHILENO;;Millenial;PROVIDENCIA                   ;METROPOLITANA;118980;2;1;2;1;118980;0;0;0;ESTUFA ELEC. RADIADOR TH-RFC50 800W-1600W-2000W;CLIMATIZACION
15487701;;F;41;CHILENO;;X;CURARREHUE                    ;ARAUCANIA;36990;1;1;0;0;0;1;1;36990;TERMOVENTILADOR TH-FH31 BLANCO 1000W-2000W;CLIMATIZACION
18452102;;F;28;CHILENO;;Millenial;PROVIDENCIA                   ;METROPOLITANA;268950;5;4;0;0;0;5;4;268950;ESTUFA ELEC. INFRAROJA TH-IR61 NG 900W - 1800W;CLIMATIZACION
11532579;;M;52;CHILENO;;X;RENCA                         ;METROPOLITANA;39980;2;1;0;0;0;2;1;39980;TERMOVENTILADOR KFH-18 BL 2000W;CLIMATIZACION
8942918;;F;62;CHILENO;;Boomers;FREIRE                        ;ARAUCANIA;28882;2;1;0;0;0;2;1;28882;TERMOVENTILADOR TH-FH31 BLANCO 1000W-2000W;CLIMATIZACION
10386886;;F;57;CHILENO;;Boomers;LOS LAGOS                     ;LOS LAGOS;259980;2;2;0;0;0;2;2;259980;ESTUFA KEROSENE 720+;CLIMATIZACION
13277592;;F;45;CHILENO;;X;PUDAHUEL;METROPOLITANA;58473;3;2;3;2;58473;0;0;0;CALIENTACAMA KIOTO DIGITAL 1 PLAZA KTC-1005;CLIMATIZACION
5376897;;F;74;CHILENO;;Silencioso;"";"";2144360;14;5;9;3;1714910;5;2;429450;Calefactor Halogeno Ha-10T 1000W;CLIMATIZACION
7015341;;M;64;CHILENO;;Boomers;IQUIQUE                       ;TARAPACA;24990;1;1;0;0;0;1;1;24990;TERMOVENTILADOR TH-FH30 BLANCO 1000W-2000W;CLIMATIZACION
18571466;;M;29;CHILENO;;Millenial;MAULE                         ;MAULE;619450;4;2;0;0;0;4;2;619450;ESTUFA A GAS SINDELEN SR-5250NG;CLIMATIZACION
14529098;;M;46;CHILENO;;X;PROVIDENCIA                   ;METROPOLITANA;159990;1;1;0;0;0;1;1;159990;ESTUFA KEROSENE 720+;CLIMATIZACION
18845811;Soltero;M;27;CHILENO;;Silencioso;PROVIDENCIA                   ;METROPOLITANA;94060;4;2;0;0;0;4;2;94060;Termoventilador Ht 2014 R;CLIMATIZACION
15120197;;M;38;CHILENO;;Millenial;PROVIDENCIA                   ;METROPOLITANA;16990;1;1;0;0;0;1;1;16990;CALIENTACAMA KIOTO DIGITAL 1 PLAZA KTC-1005;CLIMATIZACION
11838049;;F;50;CHILENO;;X;PENAFLOR                      ;METROPOLITANA;169990;1;1;0;0;0;1;1;169990;ESTUFA GAS SR-6250NG;CLIMATIZACION
5856901;;M;74;CHILENO;;Silencioso;CONSTITUCION                  ;MAULE;54990;1;1;0;0;0;1;1;54990;TERMOVENTILADOR CERAMICO TH-CH41 NG 1000W-2000W;CLIMATIZACION
17696436;Soltero;M;31;CHILENO;PROFESOR;Millenial;PROVIDENCIA                   ;METROPOLITANA;69990;1;1;1;1;69990;0;0;0;CALEFACTOR CARBONO EEC-6000NW;CLIMATIZACION
7943548;;F;63;CHILENO;;Boomers;PARRAL                        ;MAULE;460654;5;3;0;0;0;5;3;460654;ESTUFA HIBRIDA SR-6300NG;CLIMATIZACION
7244425;;M;66;CHILENO;;Boomers;RENGO                         ;L.G.B.OÂ´HIGGINS;161210;2;1;0;0;0;2;1;161210;ESTUFA GAS KG5 5K NEGRO EUROPEA;CLIMATIZACION
10374274;;F;54;CHILENO;;Boomers;BUIN                          ;METROPOLITANA;109980;2;2;0;0;0;2;2;109980;TURBO CALEFACTOR VERT. TC-2100V BLANCO;CLIMATIZACION
13124588;;F;45;CHILENO;;X;PROVIDENCIA                   ;METROPOLITANA;58240;2;1;0;0;0;2;1;58240;CALIENTACAMAS ANALOGO BASICO 2 PL;CLIMATIZACION
7153902;;F;67;CHILENO;;Boomers;PENALOLEN                     ;METROPOLITANA;61980;2;1;2;1;61980;0;0;0;CALIENTACAMAS ANALOGO BASICO 2 PL;CLIMATIZACION
19187228;;M;26;CHILENO;;Z;PROVIDENCIA                   ;METROPOLITANA;109950;5;4;4;3;87960;1;1;21990;CALIENTACAMA KIOTO DIGITAL 1 PLAZA KTC-1005;CLIMATIZACION
8385587;;F;65;CHILENO;;Boomers;QUINCHAO                      ;LOS LAGOS;831901;10;5;2;1;215980;8;4;615921;ESTUFA GAS EH5200 15K GRAFITO;CLIMATIZACION
7498034;;F;78;CHILENO;;Silencioso;SAN PEDRO DE LA PAZ           ;BIO BIO;166980;2;1;0;0;0;2;1;166980;ESTUFA GAS EH2500 5K NEGRO;CLIMATIZACION
25627227;Casado;F;51;COLOMBIANO;;Extranjero;PROVIDENCIA                   ;METROPOLITANA;20990;1;1;0;0;0;1;1;20990;TERMOVENTILADOR NICROM VFH300 BL 1800W;CLIMATIZACION
18794802;Casado;F;28;CHILENO;;Millenial;PROVIDENCIA                   ;METROPOLITANA;19990;1;1;0;0;0;1;1;19990;Termoventilador Ht 2014 R;CLIMATIZACION
18260968;;M;29;CHILENO;;Millenial;CHILLAN                       ;BIO BIO;204980;2;2;1;1;169990;1;1;34990;TERMOVENTILADOR CURVE BLACK;CLIMATIZACION
10974513;Casado;F;52;CHILENO;;X;RENCA                         ;METROPOLITANA;24990;1;1;0;0;0;1;1;24990;VENTILADOR PEDESTAL KTP-1015;CLIMATIZACION
13208348;;F;44;CHILENO;;X;CHILLAN                       ;BIO BIO;271980;3;2;0;0;0;3;2;271980;VENTILADOR PEDESTAL KTP-1015;CLIMATIZACION
18950696;;M;26;CHILENO;;Z;CHIMBARONGO                   ;L.G.B.OÂ´HIGGINS;77972;3;3;0;0;0;3;3;77972;VENTILADOR PEDESTAL KTP-1015;CLIMATIZACION
15286547;;M;40;CHILENO;;X;"";"";104970;3;3;0;0;0;3;3;104970;VENTILADOR PEDESTAL KTP-1015;CLIMATIZACION
15231735;;M;39;CHILENO;;X;VICTORIA                      ;ARAUCANIA;38990;1;1;0;0;0;1;1;38990;VENTILADOR PEDESTAL KTP-1015;CLIMATIZACION
12759075;;F;47;CHILENO;;X;CALBUCO                       ;LOS LAGOS;312970;3;2;0;0;0;3;2;312970;VENTILADOR PEDESTAL KTP-1016;CLIMATIZACION
9544548;;M;60;CHILENO;;Boomers;N/D;N/D;29990;1;1;0;0;0;1;1;29990;VENTILADOR PEDESTAL KTP-1015;CLIMATIZACION
8948713;;F;61;CHILENO;;Boomers;N/D;N/D;38990;1;1;0;0;0;1;1;38990;VENTILADOR PEDESTAL KTP-1015;CLIMATIZACION
26465326;;M;43;VENEZOLANO;;Extranjero;CONCHALI;METROPOLITANA;29990;1;1;0;0;0;1;1;29990;VENTILADOR PEDESTAL KTP-1015;CLIMATIZACION
6797176;;F;72;CHILENO;;Silencioso;TENO                          ;MAULE;111970;3;4;0;0;0;3;4;111970;VENTILADOR TURBO BREEZE (1400);CLIMATIZACION
11382783;;M;53;CHILENO;;X;RENCA                         ;METROPOLITANA;34990;1;1;0;0;0;1;1;34990;VENTILADOR PEDESTAL KTP-1015;CLIMATIZACION
8941702;;M;61;CHILENO;;Boomers;CHILLAN                       ;BIO BIO;64990;1;1;0;0;0;1;1;64990;VENTILADOR 18 PLG CP 18 GUN METAL C/ SOPORTE;CLIMATIZACION
16119331;;F;37;CHILENO;;Millenial;PARRAL                        ;MAULE;54990;1;1;0;0;0;1;1;54990;Ventilador BOX 20 Metalico FE-45 20Â¿;CLIMATIZACION
17967936;;M;30;CHILENO;;Millenial;PROVIDENCIA                   ;METROPOLITANA;537970;3;2;0;0;0;3;2;537970;V-AIRE PORTATIL MIDEA MPPD-12KHRN1;CLIMATIZACION
10968959;;F;53;CHILENO;;X;SAN BERNARDO                  ;METROPOLITANA;805980;10;6;0;0;0;10;6;805980;VENTILADOR THOMAS TH-16CP Pedestal 16;CLIMATIZACION
8932979;;F;61;CHILENO;;Boomers;PAILLACO                      ;LOS RIOS;0;0;2;0;0;0;0;2;0;VENTILADOR WIND BREEZE PRO 2 EN 1;CLIMATIZACION
15453670;;M;40;CHILENO;;X;N/D;N/D;29990;1;1;0;0;0;1;1;29990;VENTILADOR INDUSTRIAL KTI-1013;CLIMATIZACION
11957515;;M;52;CHILENO;;X;CHILLAN                       ;BIO BIO;196970;4;2;0;0;0;4;2;196970;VENTILADOR BOX 16 PLASTIC;CLIMATIZACION
9875005;;F;58;CHILENO;;Boomers;PENAFLOR                      ;METROPOLITANA;1265590;9;5;0;0;0;9;5;1265590;VENTILADOR INDUSTRIAL PEDESTAL 20;CLIMATIZACION
16448031;;M;35;CHILENO;;Millenial;PEUMO                         ;L.G.B.OÂ´HIGGINS;354540;2;1;2;1;354540;0;0;0;A/C FRIO/CALOR PORTATIL 12000BTU;CLIMATIZACION
26948362;;M;65;EXTRANJERO - NO INFORMA NACIONALIDAD;;Extranjero;CONCEPCION                    ;BIO BIO;159970;4;2;0;0;0;4;2;159970;VENTILADOR PEDESTAL16 PLG MODELO CPE 160 3 EN 1;CLIMATIZACION
14262509;Soltero;F;48;CHILENO;;X;PROVIDENCIA                   ;METROPOLITANA;17990;1;1;0;0;0;1;1;17990;Ventilador BOX 12 Plastico KF-12B3;CLIMATIZACION
5079384;;F;81;CHILENO;;Silencioso;CURICO                        ;MAULE;22990;1;1;0;0;0;1;1;22990;Ventilador BOX 12 Plastico KF-12B3;CLIMATIZACION
13208373;;F;44;CHILENO;;X;RENCA                         ;METROPOLITANA;29990;1;1;0;0;0;1;1;29990;VENTILADOR PEDESTAL KTP-1016;CLIMATIZACION
10800223;;F;51;CHILENO;;X;CALBUCO                       ;LOS LAGOS;54980;2;1;0;0;0;2;1;54980;VENTILADOR PEDESTAL KTP-1015;CLIMATIZACION
11426485;;M;52;CHILENO;;X;VALDIVIA                      ;LOS RIOS;229990;1;2;0;0;0;1;2;229990;AC PORTATIL AIER III 7000;CLIMATIZACION
26198404;;F;47;HAITIANO;;Extranjero;LINARES                       ;MAULE;24990;1;1;0;0;0;1;1;24990;VENTILADOR PEDESTAL KF-16P;CLIMATIZACION
6350585;;F;71;CHILENO;;Silencioso;NATALES                       ;MAGALLANES;3990;1;1;0;0;0;1;1;3990;ESTUFA CUARZO KIOTO 800W KTE-011A;CLIMATIZACION
16239210;;F;36;CHILENO;;Millenial;PENCO                         ;BIO BIO;305840;2;1;2;1;305840;0;0;0;AIRE AC. PORTATIL 10000BTU TCL-10CHPA;CLIMATIZACION
26446457;;M;36;EXTRANJERO - NO INFORMA NACIONALIDAD;;Extranjero;PADRE HURTADO;METROPOLITANA;43990;1;1;0;0;0;1;1;43990;VENTILADOR DE TORRE 361E;CLIMATIZACION
25118852;;F;35;BOLIVIANO;;Extranjero;N/D;N/D;24990;1;1;0;0;0;1;1;24990;VENTILADOR PEDESTAL KTP-1016;CLIMATIZACION
16451636;;M;36;CHILENO;;Millenial;PROVIDENCIA                   ;METROPOLITANA;49990;1;1;0;0;0;1;1;49990;Ventilador BOX 20 Metalico FE-45 20Â¿;CLIMATIZACION
20064854;;F;24;CHILENO;;Silencioso;PROVIDENCIA                   ;METROPOLITANA;345980;2;1;2;1;345980;0;0;0;CALEFACTOR LENA SCANTEK360 GRIS CHARCOAL;CLIMATIZACION
26558801;;M;44;EXTRANJERO - NO INFORMA NACIONALIDAD;;Extranjero;TALAGANTE                     ;METROPOLITANA;24990;1;1;0;0;0;1;1;24990;VENTILADOR PEDESTAL KTP-1015;CLIMATIZACION
15757571;;M;38;CHILENO;;Millenial;PROVIDENCIA                   ;METROPOLITANA;12990;1;1;1;1;12990;0;0;0;CALIENTACAMA KIOTO DIGITAL 1 PLAZA KTC-1005;CLIMATIZACION
13961584;;F;43;CHILENO;;X;RENCA                         ;METROPOLITANA;-16990;-1;1;-1;1;-16990;0;0;0;MINI OLEOELECTRICA KIOTO 500W NEGRO KTE-1081N;CLIMATIZACION
17444584;;M;32;CHILENO;;Millenial;CORONEL                       ;BIO BIO;97990;1;1;0;0;0;1;1;97990;KIT INSTALACION VERTICAL 6X4MTS ACERO;CLIMATIZACION
15437028;;F;40;CHILENO;;Silencioso;N/D;N/D;23980;2;1;2;1;23980;0;0;0;Ventilador BOX 12 Plastico KF-12B3;CLIMATIZACION
8345792;;F;54;CHILENO;;Boomers;PELARCO                       ;MAULE;0;0;0;0;0;0;0;0;0;CONVECTOR TH-CV51 BL 750W - 1250W - 2000W;CLIMATIZACION
18748079;;F;28;CHILENO;;Silencioso;PROVIDENCIA                   ;METROPOLITANA;0;0;0;0;0;0;0;0;0;CALIENTACAMA KIOTO DIGITAL 2 PLAZAS KTC-1006;CLIMATIZACION
7041999;;F;68;CHILENO;;Boomers;PROVIDENCIA                   ;METROPOLITANA;0;0;0;0;0;0;0;0;0;CONVECTOR ELECTRICO UT MD-20 D;CLIMATIZACION
7113448;;F;71;CHILENO;;Silencioso;COIHAIQUE                     ;AYSEN;0;0;0;0;0;0;0;0;0;ESTUFA CUARZO KC-1200;CLIMATIZACION
12757524;;M;46;CHILENO;;X;TEMUCO                        ;ARAUCANIA;0;0;0;0;0;0;0;0;0;ESTUFA INFRARROJA THOR AIR 1500;CLIMATIZACION
8012722;;M;52;CHILENO;;X;COIHAIQUE                     ;AYSEN;0;0;0;0;0;0;0;0;0;MINI OLEOELECTRICA KIOTO 500W BLANCO KTE-1081B;CLIMATIZACION
13298199;;F;44;CHILENO;;X;RENCA                         ;METROPOLITANA;0;0;0;0;0;0;0;0;0;ESTUFA GAS EH5200 15K GRAFITO;CLIMATIZACION
16310544;;F;35;CHILENO;;Millenial;PROVIDENCIA                   ;METROPOLITANA;0;0;0;0;0;0;0;0;0;KIT INSTALACION PLUS 5PULGADAS ACERO;CLIMATIZACION
8808612;;F;46;CHILENO;;X;DALCAHUE                      ;LOS LAGOS;0;0;0;0;0;0;0;0;0;TERMOVENTILADOR VINTAGE HT RETRO 2000N;CLIMATIZACION
13806596;;F;41;CHILENO;;X;N/D;N/D;0;0;0;0;0;0;0;0;0;CALIENTACAMA KIOTO DIGITAL 2 PLAZAS KTC-1006;CLIMATIZACION
14428162;;F;51;CHILENO;;X;PROVIDENCIA                   ;METROPOLITANA;0;0;0;0;0;0;0;0;0;CHIMENEA ELECTRICA ROBLE NEGRA;CLIMATIZACION
16140906;;M;36;CHILENO;;Millenial;RENCA                         ;METROPOLITANA;0;0;0;0;0;0;0;0;0;ESTUFA INFRAROJA TH-IR60;CLIMATIZACION
16756327;;F;34;CHILENO;;Millenial;CALERA                        ;VALPARAISO;0;0;0;0;0;0;0;0;0;CALIENTACAMA KIOTO DIGITAL 2 PLAZAS KTC-1006;CLIMATIZACION
13439553;;M;44;CHILENO;;Silencioso;PROVIDENCIA                   ;METROPOLITANA;0;0;0;0;0;0;0;0;0;CHIMENEA ELECTRICA KIOTO 2000W KTE-1101;CLIMATIZACION
13991625;Casado;M;41;CHILENO;;X;PROVIDENCIA                   ;METROPOLITANA;0;0;0;0;0;0;0;0;0;ESTUFA CUARZO KIOTO 800W KTE-011A;CLIMATIZACION
12265990;;M;50;CHILENO;;Silencioso;PROVIDENCIA                   ;METROPOLITANA;0;0;0;0;0;0;0;0;0;CALEFACTOR CARBONO 800W EEC-3000 NEGRO;CLIMATIZACION
25287814;;F;38;COLOMBIANO;;Extranjero;SANTIAGO                      ;METROPOLITANA;0;0;0;0;0;0;0;0;0;TERMOVENTILADOR NICROM VFH500 BL 2000W;CLIMATIZACION
17051945;;F;33;CHILENO;;Millenial;N/D;N/D;0;0;0;0;0;0;0;0;0;TERMOVENTILADOR KIOTO BLANCO 2000W KTE-1028B;CLIMATIZACION
6932080;Casado;M;67;CHILENO;;Boomers;CHILLAN                       ;BIO BIO;0;0;0;0;0;0;0;0;0;CHIMENEA ELECTRICA KIOTO 2000W KTE-1101;CLIMATIZACION
18246338;;F;29;CHILENO;;Millenial;PROVIDENCIA                   ;METROPOLITANA;0;0;0;0;0;0;0;0;0;CHIMENEA ELECTRICA KIOTO 2000W KTE-1101;CLIMATIZACION
17919548;;F;31;CHILENO;;Silencioso;PROVIDENCIA                   ;METROPOLITANA;0;0;0;0;0;0;0;0;0;ESTUFA A GAS UT GRX-6200 ET ROJA 15 KILOS;CLIMATIZACION
19068901;;F;26;CHILENO;;Z;MELIPILLA                     ;METROPOLITANA;0;0;0;0;0;0;0;0;0;CALIENTACAMA KIOTO DIGITAL 2 PLAZAS KTC-1006;CLIMATIZACION
17989436;;F;30;CHILENO;;Millenial;PROVIDENCIA                   ;METROPOLITANA;0;0;0;0;0;0;0;0;0;CALIENTACAMAS ANALOGO BASICO 2 PL;CLIMATIZACION
11442994;Casado;F;52;CHILENO;;X;RENCA                         ;METROPOLITANA;0;0;0;0;0;0;0;0;0;ESTUFA CUARZO KIOTO 800W KTE-011A;CLIMATIZACION
10856279;;F;53;CHILENO;;X;CALBUCO                       ;LOS LAGOS;0;0;0;0;0;0;0;0;0;ESTUFA CUARZO KIOTO 800W KTE-011A;CLIMATIZACION
16637308;;M;35;CHILENO;;Millenial;PROVIDENCIA                   ;METROPOLITANA;0;0;0;0;0;0;0;0;0;ESTUFA CUARZO KC-1200;CLIMATIZACION
12212272;;F;50;CHILENO;;X;N/D;N/D;0;0;0;0;0;0;0;0;0;ESTUFA CUARZO KIOTO 800W KTE-011A;CLIMATIZACION
5995658;Casado;F;68;CHILENO;;Silencioso;PROVIDENCIA                   ;METROPOLITANA;0;0;0;0;0;0;0;0;0;CALEFACTOR CARBONO 800W EEC-3000 NEGRO;CLIMATIZACION
18095440;;M;31;CHILENO;;Silencioso;PROVIDENCIA                   ;METROPOLITANA;0;0;0;0;0;0;0;0;0;ESTUFA CUARZO KIOTO 800W KTE-011A;CLIMATIZACION
12281447;;M;50;CHILENO;;Silencioso;PROVIDENCIA                   ;METROPOLITANA;0;0;0;0;0;0;0;0;0;ESTUFA ELECTRICA CUARZO KIOTO 1200W KTE 1033;CLIMATIZACION
20309440;;F;22;CHILENO;;Z;PROVIDENCIA                   ;METROPOLITANA;0;0;0;0;0;0;0;0;0;TERMOVENTILADOR KIOTO BLANCO 2000W KTE-1028B;CLIMATIZACION
15143402;;F;39;CHILENO;;X;MOLINA                        ;MAULE;0;0;0;0;0;0;0;0;0;ESTUFA ELECTRICA CUARZO KIOTO 1200W KTE 1033;CLIMATIZACION
18656335;;F;28;CHILENO;;Millenial;LINARES                       ;MAULE;0;0;0;0;0;0;0;0;0;CALIENTACAMA KIOTO DIGITAL 2 PLAZAS KTC-1006;CLIMATIZACION
8134883;;F;61;CHILENO;;Boomers;PROVIDENCIA                   ;METROPOLITANA;0;0;0;0;0;0;0;0;0;ESTUFA A GAS UT GRX-6200 ET ROJA 15 KILOS;CLIMATIZACION
18477175;Soltero;F;29;CHILENO;;Millenial;N/D;N/D;0;0;0;0;0;0;0;0;0;CHIMENEA ELECTRICA KIOTO 2000W KTE-1101;CLIMATIZACION
11319277;;M;54;CHILENO;;X;RANCAGUA                      ;L.G.B.OÂ´HIGGINS;0;0;0;0;0;0;0;0;0;ESTUFA CUARZO KIOTO 800W KTE-011A;CLIMATIZACION
9249550;;M;56;CHILENO;;Boomers;CORONEL                       ;BIO BIO;0;0;0;0;0;0;0;0;0;ESTUFA FIBRA DE CARBONO KFC 90 - NEGRA ROJA;CLIMATIZACION
12481892;;F;49;CHILENO;;X;RECOLETA                      ;METROPOLITANA;0;0;0;0;0;0;0;0;0;CHIMENEA ELECTRICA KIOTO 2000W KTE-1101;CLIMATIZACION
6971506;;M;68;CHILENO;;Silencioso;N/D;N/D;0;0;0;0;0;0;0;0;0;CALIENTACAMA KIOTO DIGITAL 1 PLAZA KTC-1005;CLIMATIZACION
17412022;;F;32;CHILENO;;Silencioso;PROVIDENCIA                   ;METROPOLITANA;0;0;0;0;0;0;0;0;0;ESTUFA A GAS UT GRX-6200 ET ROJA 15 KILOS;CLIMATIZACION
12591633;Casado;M;47;CHILENO;;Silencioso;PROVIDENCIA                   ;METROPOLITANA;0;0;0;0;0;0;0;0;0;TERMOVENTILADOR VERTICAL SUN05 CELES.;CLIMATIZACION
19660488;;M;25;CHILENO;;Z;PROVIDENCIA                   ;METROPOLITANA;0;0;0;0;0;0;0;0;0;CALIENTACAMA KIOTO DIGITAL 2 PLAZAS KTC-1006;CLIMATIZACION
9467272;Soltero;F;56;CHILENO;;Boomers;RENCA                         ;METROPOLITANA;0;0;0;0;0;0;0;0;0;TERMOVENTILADOR KIOTO BLANCO 2000W KTE-1028B;CLIMATIZACION
18558273;;M;28;CHILENO;;Millenial;PROVIDENCIA                   ;METROPOLITANA;0;0;0;0;0;0;0;0;0;CHIMENEA ELECTRICA ROBLE NEGRA;CLIMATIZACION
16010371;;M;37;CHILENO;;Millenial;TALCAHUANO                    ;BIO BIO;0;0;0;0;0;0;0;0;0;TERMOVENTILADOR TH-FH30 BLANCO 1000W-2000W;CLIMATIZACION
17919913;;F;30;CHILENO;;Millenial;PROVIDENCIA                   ;METROPOLITANA;0;0;0;0;0;0;0;0;0;CALIENTACAMA KIOTO ANALOGO 1 PLAZA KTC-1004;CLIMATIZACION
18464518;Soltero;F;28;CHILENO;PROFESOR;Millenial;PROVIDENCIA                   ;METROPOLITANA;0;0;0;0;0;0;0;0;0;TERMOVENTILADOR KIOTO BLANCO 2000W KTE-1028B;CLIMATIZACION
9757762;;F;59;CHILENO;;Boomers;TALCA                         ;MAULE;0;0;0;0;0;0;0;0;0;CALIENTACAMA KIOTO DIGITAL 2 PLAZAS KTC-1006;CLIMATIZACION
19496842;;M;25;CHILENO;;Z;PROVIDENCIA                   ;METROPOLITANA;0;0;0;0;0;0;0;0;0;ESTUFA INFRARROJA ELECTRICA KIOTO 1500W KTE-1045;CLIMATIZACION
10186807;;F;58;CHILENO;;Boomers;PROVIDENCIA                   ;METROPOLITANA;0;0;0;0;0;0;0;0;0;CALIENTACAMA KIOTO ANALOGO 1 PLAZA KTC-1004;CLIMATIZACION
18009876;;M;30;CHILENO;;Millenial;N/D;N/D;0;0;0;0;0;0;0;0;0;CONVECTOR KCH 2010F BL 2000W;CLIMATIZACION
19886123;;F;23;CHILENO;;Z;PROVIDENCIA                   ;METROPOLITANA;0;0;0;0;0;0;0;0;0;ESTUFA A GAS UT GRX-4200 15 KILOS;CLIMATIZACION
16340479;;M;36;CHILENO;;Millenial;PROVIDENCIA                   ;METROPOLITANA;0;0;0;0;0;0;0;0;0;ESTUFA HIBRIDA SR-6300NG;CLIMATIZACION
18895322;;F;27;CHILENO;;Z;EMPEDRADO                     ;MAULE;0;0;0;0;0;0;0;0;0;ESTUFA ELECTRICA CUARZO KIOTO 1200W KTE 1033;CLIMATIZACION
12639974;;M;48;CHILENO;;Silencioso;PROVIDENCIA                   ;METROPOLITANA;0;0;0;0;0;0;0;0;0;CALIENTACAMA KIOTO ANALOGO 1 PLAZA KTC-1004;CLIMATIZACION
13431360;;F;43;CHILENO;;X;VALPARAISO                    ;VALPARAISO;0;0;0;0;0;0;0;0;0;CALIENTACAMA KIOTO DIGITAL 1 PLAZA KTC-1005;CLIMATIZACION
9835083;;F;59;CHILENO;;Boomers;PROVIDENCIA                   ;METROPOLITANA;0;0;0;0;0;0;0;0;0;TERMOVENTILADOR KIOTO BLANCO 2000W KTE-1028B;CLIMATIZACION
12507492;;F;49;CHILENO;;X;PUENTE ALTO                   ;METROPOLITANA;0;0;0;0;0;0;0;0;0;ESTUFA INFRARROJA UT-IRH-S1500;CLIMATIZACION
19392279;;F;25;CHILENO;;Z;PROVIDENCIA                   ;METROPOLITANA;0;0;0;0;0;0;0;0;0;TERMOVENTILADOR KIOTO BLANCO 2000W KTE-1028B;CLIMATIZACION
7247175;;F;66;CHILENO;;Boomers;SAN PEDRO                     ;METROPOLITANA;0;0;0;0;0;0;0;0;0;CALIENTACAMAS DIGITAL TIMER SG-5350 1PL;CLIMATIZACION
12860348;;M;46;CHILENO;;X;PROVIDENCIA                   ;METROPOLITANA;0;0;0;0;0;0;0;0;0;ESTUFA ELEC. INFRAROJO KPH96T NG;CLIMATIZACION
8741780;;M;62;CHILENO;;Boomers;PROVIDENCIA                   ;METROPOLITANA;0;0;0;0;0;0;0;0;0;CALIENTACAMA KIOTO DIGITAL 2 PLAZAS KTC-1006;CLIMATIZACION
6195829;Casado;F;71;CHILENO;;Silencioso;PROVIDENCIA                   ;METROPOLITANA;0;0;0;0;0;0;0;0;0;CALIENTACAMA KIOTO ANALOGO 1 PLAZA KTC-1004;CLIMATIZACION
6515027;;F;71;CHILENO;;Silencioso;SAN FERNANDO                  ;L.G.B.OÂ´HIGGINS;0;0;0;0;0;0;0;0;0;CALIENTACAMA KIOTO ANALOGO 1 PLAZA KTC-1004;CLIMATIZACION
11812822;;M;50;CHILENO;;X;SANTA CRUZ                    ;L.G.B.OÂ´HIGGINS;0;0;0;0;0;0;0;0;0;CONVECTOR TURBO KCH 2000 BL;CLIMATIZACION
5099973;;M;77;CHILENO;;Silencioso;RENGO                         ;L.G.B.OÂ´HIGGINS;0;0;0;0;0;0;0;0;0;TERMOVENTILADOR KIOTO NEGRO 2000W KTE-1028N;CLIMATIZACION
10562983;;F;56;CHILENO;;Boomers;RENCA                         ;METROPOLITANA;0;0;0;0;0;0;0;0;0;ESTUFA CUARZO KIOTO 800W KTE-011A;CLIMATIZACION
17292833;;F;32;CHILENO;;Millenial;N/D;N/D;0;0;0;0;0;0;0;0;0;CALEFACTOR OLEOELECTRICO 2000W EEO-2100 NEGRO;CLIMATIZACION
9278719;;M;59;CHILENO;;Boomers;CURICO                        ;MAULE;0;0;0;0;0;0;0;0;0;CHIMENEA ELECTRICA KIOTO 2000W KTE-1101;CLIMATIZACION
16837157;;F;34;CHILENO;;Millenial;PROVIDENCIA                   ;METROPOLITANA;0;0;0;0;0;0;0;0;0;TERMOVENTILADOR KIOTO BLANCO 2000W KTE-1028B;CLIMATIZACION
18558968;;F;28;CHILENO;;Silencioso;PROVIDENCIA                   ;METROPOLITANA;0;0;0;0;0;0;0;0;0;MINI OLEOELECTRICA KIOTO 500W BLANCO KTE-1081B;CLIMATIZACION
15235575;;F;45;CHILENO;;X;LOS ANGELES                   ;BIO BIO;0;0;0;0;0;0;0;0;0;CALIENTACAMA KIOTO ANALOGO 1 PLAZA KTC-1004;CLIMATIZACION
18619789;;F;28;CHILENO;;Millenial;ISLA DE MAIPO                 ;METROPOLITANA;0;0;0;0;0;0;0;0;0;ESTUFA A GAS UT GRX-6200 ET ROJA 15 KILOS;CLIMATIZACION
17908781;Soltero;F;30;CHILENO;;Millenial;PROVIDENCIA                   ;METROPOLITANA;0;0;0;0;0;0;0;0;0;ESTUFA INFRARROJA ELECTRICA KIOTO 1500W KTE-1045;CLIMATIZACION
9581651;;F;58;CHILENO;;Boomers;MOLINA                        ;MAULE;0;0;0;0;0;0;0;0;0;CALIENTACAMA KIOTO DIGITAL 2 PLAZAS KTC-1006;CLIMATIZACION
8844270;Divorciado;M;61;CHILENO;INGENIERO;Silencioso;PROVIDENCIA                   ;METROPOLITANA;0;0;0;0;0;0;0;0;0;CALIENTACAMAS ANALOGO 2 PL;CLIMATIZACION
16353990;;F;35;CHILENO;;Millenial;PROVIDENCIA                   ;METROPOLITANA;0;0;0;0;0;0;0;0;0;ESTUFA INFRARROJA ELECTRICA KIOTO 1500W KTE-1045;CLIMATIZACION
14052795;;F;41;CHILENO;;X;PROVIDENCIA                   ;METROPOLITANA;0;0;0;0;0;0;0;0;0;TERMOVENTILADOR VERTICAL SUN05 CELES.;CLIMATIZACION
11889060;;M;51;CHILENO;;X;RANCAGUA                      ;L.G.B.OÂ´HIGGINS;0;0;0;0;0;0;0;0;0;ESTUFA ELECTRICA CUARZO KIOTO 1200W KTE 1033;CLIMATIZACION
19849832;;F;24;CHILENO;;Z;RANCAGUA                      ;L.G.B.OÂ´HIGGINS;0;0;0;0;0;0;0;0;0;CHIMENEA ELECTRICA KIOTO 2000W KTE-1101;CLIMATIZACION
7523464;Casado;M;65;CHILENO;;Boomers;RENCA                         ;METROPOLITANA;0;0;0;0;0;0;0;0;0;CALIENTACAMA KIOTO ANALOGO 1 PLAZA KTC-1004;CLIMATIZACION
18756356;;F;28;CHILENO;;Millenial;N/D;N/D;0;0;0;0;0;0;0;0;0;ESTUFA INFRARROJA UT-IRH-S1500;CLIMATIZACION
9439046;Casado;F;54;CHILENO;;X;RENCA                         ;METROPOLITANA;0;0;0;0;0;0;0;0;0;ESTUFA A GAS UT GRX-4200 15 KILOS;CLIMATIZACION
16965564;;M;34;CHILENO;;Millenial;PROVIDENCIA                   ;METROPOLITANA;0;0;0;0;0;0;0;0;0;ESTUFA ELECTRICA PORTATIL EEP-2200BLBLANCA;CLIMATIZACION
12470317;;F;48;CHILENO;;X;PROVIDENCIA                   ;METROPOLITANA;0;0;0;0;0;0;0;0;0;TERMOVENTILADOR KIOTO NEGRO 2000W KTE-1028N;CLIMATIZACION
16390566;;M;36;CHILENO;;Extranjero;COLINA                        ;METROPOLITANA;0;0;0;0;0;0;0;0;0;CALIENTACAMA KIOTO ANALOGO 1 PLAZA KTC-1004;CLIMATIZACION
18150236;Soltero;F;29;CHILENO;TECNICO SUPERIOR DE ENFERMERIA;Millenial;PROVIDENCIA                   ;METROPOLITANA;0;0;0;0;0;0;0;0;0;CALIENTACAMA KIOTO ANALOGO 1 PLAZA KTC-1004;CLIMATIZACION
17117828;;M;33;CHILENO;;Millenial;PROVIDENCIA                   ;METROPOLITANA;0;0;0;0;0;0;0;0;0;ESTUFA VITTALE-40 15K;CLIMATIZACION
18792089;;F;27;CHILENO;;Silencioso;PROVIDENCIA                   ;METROPOLITANA;0;0;0;0;0;0;0;0;0;TERMOVENTILADOR KIOTO NEGRO 2000W KTE-1028N;CLIMATIZACION
12948142;;M;46;CHILENO;;X;VINA DEL MAR                  ;VALPARAISO;0;0;0;0;0;0;0;0;0;ESTUFA HIBRIDA SR-6300NG;CLIMATIZACION
26049872;;F;24;EXTRANJERO - NO INFORMA NACIONALIDAD;;Extranjero;"";"";0;0;0;0;0;0;0;0;0;CALIENTACAMA KIOTO DIGITAL 1 PLAZA KTC-1005;CLIMATIZACION
12827575;;M;47;CHILENO;;X;N/D;N/D;0;0;0;0;0;0;0;0;0;ESTUFA ELECTRICA PORTATIL EEP-2200BLBLANCA;CLIMATIZACION
17620797;Soltero;M;28;CHILENO;INGENIERIA EN ADMINISTRACION DE EMPRESAS MENCION FINANZAS;Millenial;PROVIDENCIA                   ;METROPOLITANA;0;0;0;0;0;0;0;0;0;ESTUFA VITTALE-40 15K;CLIMATIZACION
12515448;;M;49;CHILENO;;X;RENGO                         ;L.G.B.OÂ´HIGGINS;0;0;0;0;0;0;0;0;0;ESTUFA INFRARROJA UT-IRH-S1500;CLIMATIZACION
18789300;Soltero;M;27;CHILENO;;Silencioso;PROVIDENCIA                   ;METROPOLITANA;0;0;0;0;0;0;0;0;0;CHIMENEA ELECTRICA KIOTO 2000W KTE-1101;CLIMATIZACION
19410496;;F;26;CHILENO;;Z;N/D;N/D;0;0;0;0;0;0;0;0;0;TERMOVENTILADOR KIOTO BLANCO 2000W KTE-1028B;CLIMATIZACION
16340559;Casado;F;36;CHILENO;;Millenial;PROVIDENCIA                   ;METROPOLITANA;0;0;0;0;0;0;0;0;0;CALIENTACAMA KIOTO DIGITAL 2 PLAZAS KTC-1006;CLIMATIZACION
9921194;;F;60;CHILENO;;Boomers;COPIAPO                       ;ATACAMA;0;0;0;0;0;0;0;0;0;ESTUFA CUARZO KIOTO 800W KTE-011A;CLIMATIZACION
19268724;;F;26;CHILENO;;Z;N/D;N/D;0;0;0;0;0;0;0;0;0;ESTUFA INFRAROJA TH-IR60;CLIMATIZACION
18694762;;M;28;CHILENO;;Millenial;LA CISTERNA                   ;METROPOLITANA;0;0;0;0;0;0;0;0;0;CALIENTACAMA KIOTO ANALOGO 1 PLAZA KTC-1004;CLIMATIZACION
15941716;;M;37;CHILENO;;Millenial;PUDAHUEL                      ;METROPOLITANA;0;0;0;0;0;0;0;0;0;CHIMENEA ELECTRICA KIOTO 2000W KTE-1101;CLIMATIZACION
17263753;;F;32;CHILENO;;Millenial;VILCUN                        ;ARAUCANIA;0;0;0;0;0;0;0;0;0;ESTUFA ELEC. FIBRA DE CARBONO NSB120K5 ROJA;CLIMATIZACION
19067266;;M;26;CHILENO;;Silencioso;PROVIDENCIA                   ;METROPOLITANA;0;0;0;0;0;0;0;0;0;Calefactor Halogeno Ha-10T 1000W;CLIMATIZACION
16447191;;F;35;CHILENO;;Millenial;CHILLAN                       ;BIO BIO;0;0;0;0;0;0;0;0;0;MINI OLEOELECTRICA KIOTO 500W NEGRO KTE-1081N;CLIMATIZACION
16892585;;F;34;CHILENO;;Millenial;PROVIDENCIA                   ;METROPOLITANA;0;0;0;0;0;0;0;0;0;ESTUFA ELEC. CHIMENEA TH-FP70 NG 1000W-2000W;CLIMATIZACION
16014867;Soltero;F;37;CHILENO;PSICOLOGA;Silencioso;PROVIDENCIA                   ;METROPOLITANA;0;0;0;0;0;0;0;0;0;TERMOVENTILADOR KIOTO NEGRO 2000W KTE-1028N;CLIMATIZACION
17487833;;F;31;CHILENO;;Millenial;PROVIDENCIA                   ;METROPOLITANA;0;0;0;0;0;0;0;0;0;CHIMENEA ELECTRICA KIOTO 2000W KTE-1101;CLIMATIZACION
20219149;;F;23;CHILENO;;Z;PROVIDENCIA                   ;METROPOLITANA;0;0;0;0;0;0;0;0;0;TERMOVENTILADOR KIOTO BLANCO 2000W KTE-1028B;CLIMATIZACION
18886500;;F;28;CHILENO;;Millenial;VALDIVIA                      ;LOS LAGOS;0;0;0;0;0;0;0;0;0;TERMOVENTILADOR KIOTO NEGRO 2000W KTE-1028N;CLIMATIZACION
15116999;;F;40;CHILENO;;X;PROVIDENCIA                   ;METROPOLITANA;0;0;0;0;0;0;0;0;0;CALIENTACAMA KIOTO ANALOGO 1 PLAZA KTC-1004;CLIMATIZACION
7724764;;F;66;CHILENO;;Boomers;PROVIDENCIA                   ;METROPOLITANA;0;0;0;0;0;0;0;0;0;TERMOVENTILADOR KIOTO NEGRO 2000W KTE-1028N;CLIMATIZACION
7503027;Divorciado;F;62;CHILENO;PROFESOR;Boomers;RENCA                         ;METROPOLITANA;0;0;0;0;0;0;0;0;0;CALIENTACAMAS DIGITAL SUBLIME MAXI 1.5PL;CLIMATIZACION
19725893;;F;24;CHILENO;;Silencioso;PROVIDENCIA                   ;METROPOLITANA;0;0;0;0;0;0;0;0;0;CALIENTACAMAS MANUAL 2N SG-5121D4 2PL;CLIMATIZACION
16228748;Soltero;M;35;CHILENO;CIRUJANO DENTISTA;Millenial;RENCA                         ;METROPOLITANA;0;0;0;0;0;0;0;0;0;TERMOVENTILADOR OSCILANTE FH-120S BL;CLIMATIZACION
11786906;Soltero;F;50;CHILENO;PROFESOR;X;PROVIDENCIA                   ;METROPOLITANA;0;0;0;0;0;0;0;0;0;Termoventilador PTC Design Heater (PTC150);CLIMATIZACION
13692333;;F;43;CHILENO;;Millenial;LA FLORIDA                    ;METROPOLITANA;0;0;0;0;0;0;0;0;0;MINI OLEOELECTRICA KIOTO 500W NEGRO KTE-1081N;CLIMATIZACION
19326633;Soltero;F;25;CHILENO;;Millenial;PROVIDENCIA                   ;METROPOLITANA;0;0;0;0;0;0;0;0;0;ESTUFA CUARZO KIOTO 800W KTE-011A;CLIMATIZACION
16027495;;M;36;CHILENO;;Millenial;PROVIDENCIA                   ;METROPOLITANA;0;0;0;0;0;0;0;0;0;ESTUFA ELECTRICA CUARZO KIOTO 1200W KTE 1033;CLIMATIZACION
13379605;;M;44;CHILENO;;X;RENCA                         ;METROPOLITANA;0;0;0;0;0;0;0;0;0;ESTUFA FAN HEATER MFHK 540 PLUS;CLIMATIZACION
15189408;;F;39;CHILENO;;X;CORONEL                       ;BIO BIO;0;0;0;0;0;0;0;0;0;TERMOVENTILADOR KIOTO BLANCO 2000W KTE-1028B;CLIMATIZACION
17474178;Soltero;F;32;CHILENO;PSICOPEDAGOGO;Millenial;PROVIDENCIA                   ;METROPOLITANA;0;0;0;0;0;0;0;0;0;Radiador Oleoelectrico 2000W Rb2209Tp;CLIMATIZACION
16772416;;F;34;CHILENO;;Silencioso;PROVIDENCIA                   ;METROPOLITANA;0;0;0;0;0;0;0;0;0;CONVECTOR ELECT. UT HMC-2000;CLIMATIZACION
18076454;;M;31;CHILENO;;Extranjero;"";"";0;0;0;0;0;0;0;0;0;ESTUFA ELECTRICA CUARZO KIOTO 1200W KTE 1033;CLIMATIZACION
19970226;;F;24;CHILENO;;Z;PROVIDENCIA                   ;METROPOLITANA;0;0;0;0;0;0;0;0;0;ESTUFA FIAMMA PRO;CLIMATIZACION
18609065;Soltero;M;28;CHILENO;;Millenial;PROVIDENCIA                   ;METROPOLITANA;0;0;0;0;0;0;0;0;0;ESTUFA GAS KG5 5K NEGRO EUROPEA;CLIMATIZACION
16471745;;F;35;CHILENO;;Millenial;PROVIDENCIA                   ;METROPOLITANA;0;0;0;0;0;0;0;0;0;ESTUFA CUARZO KIOTO 800W KTE-011A;CLIMATIZACION
9637301;;F;58;CHILENO;;Boomers;CONSTITUCION                  ;MAULE;0;0;0;0;0;0;0;0;0;TERMOVENTILADOR NICROM VFH500 BL 2000W;CLIMATIZACION
18597638;;M;29;CHILENO;;Millenial;PROVIDENCIA                   ;METROPOLITANA;0;0;0;0;0;0;0;0;0;ESTUFA FOGUITA PRO;CLIMATIZACION
5885967;;M;72;CHILENO;;Silencioso;RENCA                         ;METROPOLITANA;0;0;0;0;0;0;0;0;0;ESTUFA A GAS UT GRX-4200 15 KILOS;CLIMATIZACION
19381766;Soltero;F;26;CHILENO;;Millenial;"";"";0;0;0;0;0;0;0;0;0;A/C FRIO/CALOR PORTATIL 12000BTU;CLIMATIZACION
15403956;;M;41;CHILENO;;X;PROVIDENCIA                   ;METROPOLITANA;0;0;0;0;0;0;0;0;0;ESTUFA ELECTRICA CUARZO KIOTO 1200W KTE 1033;CLIMATIZACION
13455487;;F;47;CHILENO;;X;SANTIAGO                      ;METROPOLITANA;0;0;0;0;0;0;0;0;0;TERMOVENTILADOR KIOTO NEGRO 2000W KTE-1028N;CLIMATIZACION
9366368;;F;46;CHILENO;;X;PAINE                         ;METROPOLITANA;0;0;0;0;0;0;0;0;0;CALIENTACAMAS ANALOGO BASICO 2 PL;CLIMATIZACION
11109273;;F;55;CHILENO;;Boomers;PROVIDENCIA                   ;METROPOLITANA;0;0;0;0;0;0;0;0;0;CONVECTOR TH-CV51 BL 750W - 1250W - 2000W;CLIMATIZACION
18147055;;M;29;CHILENO;;Millenial;PROVIDENCIA                   ;METROPOLITANA;0;0;0;0;0;0;0;0;0;TERMOVENTILADOR KIOTO NEGRO 2000W KTE-1028N;CLIMATIZACION
15973084;;F;37;CHILENO;;Millenial;N/D;N/D;0;0;0;0;0;0;0;0;0;TURBO CALEFACTOR VERT. TC-2070V BLANCO;CLIMATIZACION
10500928;Casado;F;58;CHILENO;EDUCADOR DE PARVULO;Boomers;RENCA                         ;METROPOLITANA;0;0;0;0;0;0;0;0;0;PRODUCTO 2A CLIMATIZACION BANDA 6;CLIMATIZACION
10188762;;M;52;CHILENO;;X;RENCA                         ;METROPOLITANA;0;0;0;0;0;0;0;0;0;ESTUFA VITTALE-40 15K;CLIMATIZACION
11673103;;M;51;CHILENO;;Silencioso;PROVIDENCIA                   ;METROPOLITANA;0;0;0;0;0;0;0;0;0;TERMOVENTILADOR TH-FH31 BLANCO 1000W-2000W;CLIMATIZACION
17290536;;F;33;CHILENO;;Millenial;SANTIAGO                      ;METROPOLITANA;0;0;0;0;0;0;0;0;0;TERMOVENTILADOR KIOTO BLANCO 2000W KTE-1028B;CLIMATIZACION
8038410;;F;49;CHILENO;;X;RENCA                         ;METROPOLITANA;0;0;0;0;0;0;0;0;0;CONVECTOR VC 1800 1750 WATT GRIS/BLANCO;CLIMATIZACION
15218207;;M;39;CHILENO;;X;PROVIDENCIA                   ;METROPOLITANA;0;0;0;0;0;0;0;0;0;CALEFACTOR LENA LIMIT350 CHARCOAL;CLIMATIZACION
12095058;;F;53;CHILENO;;X;BUIN                          ;METROPOLITANA;0;0;0;0;0;0;0;0;0;TERMOVENTILADOR KIOTO BLANCO 2000W KTE-1028B;CLIMATIZACION
10011443;;M;54;CHILENO;;X;RENCA                         ;METROPOLITANA;0;0;0;0;0;0;0;0;0;ESTUFA KEROSENE F 1120+;CLIMATIZACION
12399393;;M;48;CHILENO;;X;CABILDO                       ;VALPARAISO;0;0;0;0;0;0;0;0;0;ESTUFA GAS KGQ15N 15K NEGRO EUROPEA;CLIMATIZACION
13127315;;F;44;CHILENO;;X;PROVIDENCIA                   ;METROPOLITANA;0;0;0;0;0;0;0;0;0;CHIMENEA ELECTRICA KIOTO 2000W KTE-1101;CLIMATIZACION
18864822;;M;26;CHILENO;;Z;PROVIDENCIA                   ;METROPOLITANA;0;0;0;0;0;0;0;0;0;Termoconvector Black Glass Max;CLIMATIZACION
19188935;Soltero;F;26;CHILENO;;Z;PROVIDENCIA                   ;METROPOLITANA;0;0;0;0;0;0;0;0;0;ESTUFA CUARZO KIOTO 800W KTE-011A;CLIMATIZACION
11234409;;M;54;CHILENO;;X;QUILICURA                     ;METROPOLITANA;0;0;0;0;0;0;0;0;0;CALIENTACAMAS UFESA MATRIMONIAL CONFORTÂ  CMNÂ ;CLIMATIZACION
19026706;Soltero;F;27;CHILENO;TECNICO EN ANALISIS QUIMICO;Silencioso;PROVIDENCIA                   ;METROPOLITANA;0;0;0;0;0;0;0;0;0;ESTUFA ELEC. CHIMENEA TH-FP70 NG 1000W-2000W;CLIMATIZACION
16073351;Casado;F;36;CHILENO;QUIMICO FARMACEUTICO;Millenial;PROVIDENCIA                   ;METROPOLITANA;0;0;0;0;0;0;0;0;0;ESTUFA ELECTRICA CUARZO KIOTO 1200W KTE 1033;CLIMATIZACION
8236390;Casado;M;63;CHILENO;;Boomers;PROVIDENCIA                   ;METROPOLITANA;0;0;0;0;0;0;0;0;0;TERMOVENTILADOR KIOTO NEGRO 2000W KTE-1028N;CLIMATIZACION
7376186;;M;62;CHILENO;;Boomers;PROVIDENCIA                   ;METROPOLITANA;0;0;0;0;0;0;0;0;0;CALEFACTOR BOSCA LIMIT 360;CLIMATIZACION
17455812;Soltero;F;32;CHILENO;;Millenial;PROVIDENCIA                   ;METROPOLITANA;0;0;0;0;0;0;0;0;0;ESTUFA KEROSENE 720+;CLIMATIZACION
12857507;Casado;M;47;CHILENO;INGENIERO CIVIL EN OBRAS CIVILES;Silencioso;PROVIDENCIA                   ;METROPOLITANA;0;0;0;0;0;0;0;0;0;ESTUFA ELECTRICA CUARZO KIOTO 1200W KTE 1033;CLIMATIZACION
12353423;;F;49;CHILENO;;X;"";"";0;0;0;0;0;0;0;0;0;TERMOVENTILADOR PTC VILN18 BL 2000W;CLIMATIZACION
16506204;Casado;F;35;CHILENO;;Silencioso;PROVIDENCIA                   ;METROPOLITANA;0;0;0;0;0;0;0;0;0;KIT INSTALACION PLUS 6PULGADAS ACERO;CLIMATIZACION
10727742;;F;58;CHILENO;;Silencioso;PROVIDENCIA                   ;METROPOLITANA;0;0;0;0;0;0;0;0;0;CALIENTACAMAS DIGITAL TIMER SG-5151 2PL;CLIMATIZACION
16028036;;F;37;CHILENO;;Millenial;N/D;N/D;0;0;0;0;0;0;0;0;0;A/C FRIO/CALOR PORTATIL 12000BTU;CLIMATIZACION
17641253;;M;31;CHILENO;;Millenial;CORONEL                       ;BIO BIO;0;0;0;0;0;0;0;0;0;ESTUFA ELEC. INFRAROJA TH-IR61 NG 900W - 1800W;CLIMATIZACION
15596722;;F;39;CHILENO;;X;TALCA                         ;MAULE;0;0;0;0;0;0;0;0;0;ESTUFA ELECTRICA CUARZO KIOTO 1200W KTE 1033;CLIMATIZACION
6540455;Casado;M;71;CHILENO;;Silencioso;PROVIDENCIA                   ;METROPOLITANA;0;0;0;0;0;0;0;0;0;CALIENTACAMAS ANALOGO BASICO 2 PL;CLIMATIZACION
18119175;;M;30;CHILENO;;Millenial;N/D;N/D;0;0;0;0;0;0;0;0;0;ESTUFA ELECTRICA CUARZO KIOTO 1200W KTE 1033;CLIMATIZACION
18572156;;F;28;CHILENO;;Millenial;MAULE                         ;MAULE;0;0;0;0;0;0;0;0;0;ESTUFA GAS EH5300 15K BURDEOS;CLIMATIZACION
5677011;;F;75;CHILENO;;Silencioso;PROVIDENCIA                   ;METROPOLITANA;0;0;0;0;0;0;0;0;0;ESTUFA VITTALE-40 15K;CLIMATIZACION
16679314;;M;35;CHILENO;;Millenial;PROVIDENCIA                   ;METROPOLITANA;0;0;0;0;0;0;0;0;0;ESTUFA A GAS UT GRX-4200 15 KILOS;CLIMATIZACION
11304423;;F;53;CHILENO;;X;RENCA                         ;METROPOLITANA;0;0;0;0;0;0;0;0;0;Calefactor Bosca a Lena Gold 500 Burdeo CERT.;CLIMATIZACION
11251294;;F;54;CHILENO;;X;RENCA                         ;METROPOLITANA;0;0;0;0;0;0;0;0;0;TERMOVENTILADOR CERAMICO TH-CH40;CLIMATIZACION
24417771;;M;37;COLOMBIANO;;Extranjero;LA CISTERNA                   ;METROPOLITANA;0;0;0;0;0;0;0;0;0;A/C FRIO/CALOR PORTATIL 12000BTU;CLIMATIZACION
18278126;Soltero;F;29;CHILENO;;Silencioso;PROVIDENCIA                   ;METROPOLITANA;0;0;0;0;0;0;0;0;0;ESTUFA POTENZA;CLIMATIZACION
19172133;Soltero;F;26;CHILENO;;Z;PROVIDENCIA                   ;METROPOLITANA;0;0;0;0;0;0;0;0;0;VENTILADOR PEDESTAL KTP-1015;CLIMATIZACION
9658442;;F;59;CHILENO;;Boomers;RENCA                         ;METROPOLITANA;0;0;0;0;0;0;0;0;0;TERMOVENTILADOR TH-FH31 BLANCO 1000W-2000W;CLIMATIZACION
14322335;;F;46;CHILENO;;X;VILLARICA                     ;ARAUCANIA;0;0;0;0;0;0;0;0;0;VENTILADOR PEDESTAL KF-16P;CLIMATIZACION
9232797;Soltero;F;61;CHILENO;;Boomers;PROVIDENCIA                   ;METROPOLITANA;0;0;0;0;0;0;0;0;0;Ventilador BOX 12 Plastico KF-12B3;CLIMATIZACION
5669425;;F;78;CHILENO;;Silencioso;RENCA                         ;METROPOLITANA;0;0;0;0;0;0;0;0;0;CHIMENEA ELECTRICA KIOTO 2000W KTE-1101;CLIMATIZACION
15237055;;F;40;CHILENO;;X;PROVIDENCIA                   ;METROPOLITANA;0;0;0;0;0;0;0;0;0;ENFRIADOR DE AIRE EEA-350;CLIMATIZACION
15210645;;M;40;CHILENO;;X;PROVIDENCIA                   ;METROPOLITANA;0;0;0;0;0;0;0;0;0;VENTILADOR INDUSTRIAL KTI-1013;CLIMATIZACION
18130016;;F;30;CHILENO;;Millenial;OSORNO                        ;LOS LAGOS;0;0;0;0;0;0;0;0;0;CALEFACTOR INFRAROJO GR2800 R NEGRO;CLIMATIZACION
14078499;;M;41;CHILENO;;X;VILLARICA                     ;ARAUCANIA;0;0;0;0;0;0;0;0;0;VENTILADOR PEDESTAL KTP-1015;CLIMATIZACION
18921178;;F;27;CHILENO;;Millenial;N/D;N/D;0;0;0;0;0;0;0;0;0;AIRE AC. PORTATIL FRIO 7000BTU/H GRIS;CLIMATIZACION
27236509;;M;35;VENEZOLANO;;Extranjero;MELIPILLA;METROPOLITANA;0;0;0;0;0;0;0;0;0;VENTILADOR PEDESTAL KTP-1015;CLIMATIZACION
11200531;;M;54;CHILENO;;Boomers;N/D;N/D;0;0;0;0;0;0;0;0;0;VENTILADOR INDUSTRIAL KTI-1013;CLIMATIZACION
12912073;;F;47;CHILENO;;X;MACHALI                       ;L.G.B.OÂ´HIGGINS;0;0;0;0;0;0;0;0;0;A/C FRIO/CALOR PORTATI 9000BTU;CLIMATIZACION
26833708;;F;36;EXTRANJERO - NO INFORMA NACIONALIDAD;;Extranjero;CHILLAN                       ;BIO BIO;0;0;0;0;0;0;0;0;0;VENTILADOR WIND BREEZE (160S);CLIMATIZACION
9484155;;F;59;CHILENO;;Boomers;RENCA                         ;METROPOLITANA;0;0;0;0;0;0;0;0;0;VENTILADOR TURBO BREEZE (1400);CLIMATIZACION
18516561;;F;28;CHILENO;;Millenial;SAN FERNANDO                  ;L.G.B.OÂ´HIGGINS;0;0;0;0;0;0;0;0;0;VENTILADOR THOMAS TH-16CM Sobre Mesa 16;CLIMATIZACION
9332859;;M;60;CHILENO;;Boomers;MELIPILLA                     ;METROPOLITANA;0;0;0;0;0;0;0;0;0;VENTILADOR INDUSTRIAL KTI-1013;CLIMATIZACION
12238683;;M;49;CHILENO;;X;RENCA                         ;METROPOLITANA;0;0;0;0;0;0;0;0;0;Ventilador BOX 20 Metalico FE-45 20Â¿;CLIMATIZACION
12092904;;F;52;CHILENO;;X;RANCAGUA                      ;L.G.B.OÂ´HIGGINS;0;0;0;0;0;0;0;0;0;VENTILADOR POWER BREEZE (120T);CLIMATIZACION
26224338;;M;28;VENEZOLANO;;Extranjero;PUDAHUEL                      ;METROPOLITANA;0;0;0;0;0;0;0;0;0;ENFRIADOR DE AIRE KFL-1702;CLIMATIZACION
9082216;;F;56;CHILENO;;Boomers;RENCA                         ;METROPOLITANA;0;0;0;0;0;0;0;0;0;CALIENTACAMA KIOTO DIGITAL 2 PLAZAS KTC-1006;CLIMATIZACION
7446071;Soltero;M;64;CHILENO;;Boomers;PROVIDENCIA                   ;METROPOLITANA;0;0;0;0;0;0;0;0;0;ENFRIADOR Y HUMIFICADOR THOMAS Blanco/Negro;CLIMATIZACION
14397831;;F;44;CHILENO;;X;TALCA                         ;MAULE;0;0;0;0;0;0;0;0;0;TERMOVENTILADOR KIOTO NEGRO 2000W KTE-1028N;CLIMATIZACION
9727077;;M;57;CHILENO;;Boomers;VALDIVIA                      ;LOS RIOS;0;0;0;0;0;0;0;0;0;TERMOVENTILADOR KIOTO BLANCO 2000W KTE-1028B;CLIMATIZACION
18319004;;F;29;CHILENO;;Millenial;PROVIDENCIA                   ;METROPOLITANA;0;0;0;0;0;0;0;0;0;TERMOVENTILADOR KIOTO BLANCO 2000W KTE-1028B;CLIMATIZACION
17921626;;M;31;CHILENO;;Millenial;LOS LAGOS                     ;LOS LAGOS;0;0;0;0;0;0;0;0;0;CALIENTACAMA KIOTO DIGITAL 1 PLAZA KTC-1005;CLIMATIZACION
7398416;;F;68;CHILENO;;Boomers;RENCA                         ;METROPOLITANA;19990;1;1;0;0;0;1;1;19990;Batidora Manual 3532;ELECTRODOMESTICOS
8521052;;F;65;CHILENO;;Boomers;VILLARICA                     ;ARAUCANIA;11893;1;1;0;0;0;1;1;11893;TOSTADOR OLDEMBURGO 2 REBANADAS;ELECTRODOMESTICOS
9207613;;M;60;CHILENO;;Boomers;TOCOPILLA                     ;ANTOFAGASTA;2638680;32;10;4;2;449960;28;8;2188720;Hervidor Electrico 3101 1,7Lts Negro;ELECTRODOMESTICOS
9047942;Casado;F;61;CHILENO;;Boomers;RENCA                         ;METROPOLITANA;88980;2;2;0;0;0;2;2;88980;Horno Microonda Columba 1700;ELECTRODOMESTICOS
17195983;;M;32;CHILENO;;Millenial;N/D;N/D;553041;4;2;0;0;0;4;2;553041;Horno Microondas Digital UT-CLASSY720 20Lts;ELECTRODOMESTICOS
11732902;;F;50;CHILENO;;X;IQUIQUE                       ;TARAPACA;399960;4;2;2;1;214980;2;1;184980;Horno Microondas Digital MS23K3513AK/ZS 23Lts;ELECTRODOMESTICOS
19003386;Soltero;M;28;CHILENO;;Millenial;"";"";75690;3;2;0;0;0;3;2;75690;Hervidor Inox One Midea;ELECTRODOMESTICOS
12947135;;F;45;CHILENO;;X;COQUIMBO                      ;COQUIMBO;213011;4;3;0;0;0;4;3;213011;Parrilla Electrica Chef Grill;ELECTRODOMESTICOS
15613449;;F;38;CHILENO;;X;PROVIDENCIA                   ;METROPOLITANA;60980;2;2;0;0;0;2;2;60980;Horno Microondas Mecanico Fancy 20Lts;ELECTRODOMESTICOS
6738454;;F;69;CHILENO;;Silencioso;RENGO                         ;L.G.B.OÂ´HIGGINS;105980;2;1;0;0;0;2;1;105980;Freidora de Aire Digital 40D;ELECTRODOMESTICOS
9115036;;F;61;CHILENO;;Boomers;RENGO                         ;L.G.B.OÂ´HIGGINS;1075900;13;8;0;0;0;13;8;1075900;Licuadora Personal TH-300PB;ELECTRODOMESTICOS
18162902;;M;29;CHILENO;;Millenial;SAN ANTONIO                   ;VALPARAISO;74980;2;2;0;0;0;2;2;74980;Licuadora Oster Clasica Azul 4134 1,25 lt;ELECTRODOMESTICOS
14580721;;M;43;CHILENO;;X;RENCA                         ;METROPOLITANA;39990;1;1;0;0;0;1;1;39990;HORNO ELECTRICO BREMEN 23 LITROS;ELECTRODOMESTICOS
12092269;;F;53;CHILENO;;X;N/D;N/D;75980;2;2;0;0;0;2;2;75980;Exprimidor de Jugo TH-1215 1,5Lts;ELECTRODOMESTICOS
5915537;;F;73;CHILENO;;Silencioso;VILLA ALEMANA                 ;VALPARAISO;479440;5;3;0;0;0;5;3;479440;PICADORA 123 SILHQUETTE;ELECTRODOMESTICOS
15999122;;F;37;CHILENO;;Millenial;N/D;N/D;313820;4;3;2;1;265840;2;2;47980;Exprimidor Fauna 500 cc;ELECTRODOMESTICOS
6949693;;F;66;CHILENO;;Boomers;ISLA DE MAIPO                 ;METROPOLITANA;139990;1;1;0;0;0;1;1;139990;CAFETERA PRIMA LATTE 6603 ROJA;ELECTRODOMESTICOS
6976381;;F;68;CHILENO;;Silencioso;PROVIDENCIA                   ;METROPOLITANA;251120;4;2;0;0;0;4;2;251120;Horno Electrico TH-100i 100Lts;ELECTRODOMESTICOS
11073130;Soltero;F;55;CHILENO;;Boomers;RENCA                         ;METROPOLITANA;430290;3;2;0;0;0;3;2;430290;Horno Electrico TH62I 60Lts;ELECTRODOMESTICOS
15461801;;F;39;CHILENO;;X;EL BOSQUE                     ;METROPOLITANA;117950;5;4;0;0;0;5;4;117950;Combo Licuadora + Batidora;ELECTRODOMESTICOS
15148042;;F;40;CHILENO;;X;CAUQUENES                     ;MAULE;660412;5;3;2;1;296980;3;2;363432;BATIDORA PEDESTAL RENANIA 5 LITROS;ELECTRODOMESTICOS
9166101;;M;58;CHILENO;;Boomers;LOS ALAMOS                    ;BIO BIO;212970;3;2;0;0;0;3;2;212970;HORNO 10 LITROS OSTER ROJO;ELECTRODOMESTICOS
17433354;;F;32;CHILENO;;Millenial;MEJILLONES;ANTOFAGASTA;19990;1;1;0;0;0;1;1;19990;Hervidor Electrico UT-DUNKEL17P 2Lts Negro;ELECTRODOMESTICOS
16279534;;F;36;CHILENO;;Millenial;QUELLON                       ;LOS LAGOS;1990560;21;8;17;6;1590600;4;2;399960;Maquina de Coser JS-2135CL Calipso;ELECTRODOMESTICOS
11937458;;F;50;CHILENO;;X;OVALLE                        ;COQUIMBO;229230;3;2;0;0;0;3;2;229230;Licuadora Berry Blender Roja 1400 Vaso Vidrio;ELECTRODOMESTICOS
15798731;Soltero;F;38;CHILENO;;Millenial;PROVIDENCIA                   ;METROPOLITANA;37980;2;4;0;0;0;2;4;37980;Licuadora Personal TH-300PB;ELECTRODOMESTICOS
16181635;Casado;F;37;CHILENO;;Millenial;PROVIDENCIA                   ;METROPOLITANA;41980;2;1;0;0;0;2;1;41980;Plancha TH-7052 2000Watts Base Inox;ELECTRODOMESTICOS
17205381;;M;33;CHILENO;;Millenial;TOCOPILLA                     ;ANTOFAGASTA;2024370;13;10;0;0;0;13;10;2024370;Hervidor Electrico TH-4515N 2Lts Negro;ELECTRODOMESTICOS
5794455;;F;77;CHILENO;;Silencioso;VICTORIA                      ;ARAUCANIA;30990;1;1;0;0;0;1;1;30990;Licuadora L2000VNG 1,5Lts Vaso Vidrio;ELECTRODOMESTICOS
19123181;;F;26;CHILENO;;Z;HUALPEN;BIO-BIO;18893;1;1;1;1;18893;0;0;0;Licuadora Personal TH-300PB;ELECTRODOMESTICOS
13180987;;M;45;CHILENO;;X;ILLAPEL                       ;COQUIMBO;449970;3;3;0;0;0;3;3;449970;FREIDORA DE AIRE THOMAS TH-AF60Mi;ELECTRODOMESTICOS
19000145;;M;27;CHILENO;;Z;N/D;N/D;88980;2;4;0;0;0;2;4;88980;Hervidor Electrico HA-3300 2,5Lts Blanco;ELECTRODOMESTICOS
13283414;;F;45;CHILENO;;X;SANTIAGO                      ;METROPOLITANA;14990;1;3;0;0;0;1;3;14990;Hervidor Electrico HA-3300 2,5Lts Blanco;ELECTRODOMESTICOS
11943360;;M;50;CHILENO;;X;N/D;N/D;43970;3;2;0;0;0;3;2;43970;Plancha a Vapor 5001;ELECTRODOMESTICOS
15353810;;F;41;CHILENO;;Silencioso;PROVIDENCIA                   ;METROPOLITANA;64990;1;1;0;0;0;1;1;64990;Horno Microondas Mecanico UT-SYDNEY18 18Lts;ELECTRODOMESTICOS
19385791;;F;25;CHILENO;;Z;VALDIVIA                      ;LOS LAGOS;322940;7;4;7;4;322940;0;0;0;FREIDORA DE AIRE HESSIA 2,0 LITROS;ELECTRODOMESTICOS
9087511;;F;68;CHILENO;;Silencioso;NUEVA IMPERIAL                ;ARAUCANIA;1293580;13;6;0;0;0;13;6;1293580;FREIDORA DE AIRE THOMAS TH-AF60Mi;ELECTRODOMESTICOS
5029868;;M;72;CHILENO;;Silencioso;PROVIDENCIA                   ;METROPOLITANA;29980;2;2;0;0;0;2;2;29980;Hervidor Electrico TH-4212N 1,7Lts Negro;ELECTRODOMESTICOS
10456832;;F;54;CHILENO;;X;LO PRADO                      ;METROPOLITANA;69671;4;3;0;0;0;4;3;69671;HERVIDOR TH-4340;ELECTRODOMESTICOS
13203571;;M;44;CHILENO;;X;SANTA CRUZ;O HIGGINS;51980;2;1;2;1;51980;0;0;0;Licuadora BS 4950 Opal Titanium;ELECTRODOMESTICOS
15327800;;F;40;CHILENO;;X;PROVIDENCIA                   ;METROPOLITANA;194970;4;2;4;2;194970;0;0;0;Licuadora Berry Blender Roja 1400 Vaso Vidrio;ELECTRODOMESTICOS
5539749;;F;73;CHILENO;;Silencioso;LINARES                       ;MAULE;224970;3;3;0;0;0;3;3;224970;Hervidor Inox One Midea;ELECTRODOMESTICOS
14535232;;M;45;CHILENO;;X;SAN BERNARDO;METROPOLITANA;434960;4;3;3;2;369970;1;1;64990;Aspiradora VCC4190V3E/XZS Arrastre 2000Watts;ELECTRODOMESTICOS
8150314;;M;62;CHILENO;;Boomers;PROVIDENCIA                   ;METROPOLITANA;36970;3;2;0;0;0;3;2;36970;Plancha a Vapor 5001;ELECTRODOMESTICOS
8147923;;F;62;CHILENO;;Boomers;N/D;N/D;206960;4;3;2;1;53980;2;2;152980;FREIDORA DE AIRE THOMAS TH-AF60Mi;ELECTRODOMESTICOS
16196828;;M;36;CHILENO;;Millenial;CUREPTO                       ;MAULE;653920;11;5;7;3;457950;4;2;195970;Horno Electrico UT-BACKOFEN38 38Lts;ELECTRODOMESTICOS
6711227;;F;58;CHILENO;;Boomers;SAN JAVIER                    ;MAULE;61990;3;2;0;0;0;3;2;61990;Hervidor Electrico TH-4515N 2Lts Negro;ELECTRODOMESTICOS
9111363;;F;62;CHILENO;;Boomers;ALTO HOSPICIO;TARAPACA;480280;6;3;0;0;0;6;3;480280;Batidora de Mano y Pedestal 3612;ELECTRODOMESTICOS
10353559;Casado;M;56;CHILENO;;Boomers;CORONEL                       ;BIO BIO;222940;6;4;0;0;0;6;4;222940;Tostador de Pan TP-1400 4 Rebanadas Inox;ELECTRODOMESTICOS
17623738;;M;31;CHILENO;;Millenial;COLINA                        ;METROPOLITANA;99970;3;2;1;1;69990;2;1;29980;Combo Hervidor + Batidora;ELECTRODOMESTICOS
11421845;;F;53;CHILENO;;X;ILLAPEL                       ;COQUIMBO;1131900;11;9;0;0;0;11;9;1131900;Plancha UT-SHANGRILA Inalambrica 2200Watss;ELECTRODOMESTICOS
10736307;;M;56;CHILENO;;Boomers;NUEVA IMPERIAL                ;ARAUCANIA;693190;7;2;0;0;0;7;2;693190;Batidora Vertical Stick Mixer 2609;ELECTRODOMESTICOS
7867768;;F;63;CHILENO;;Boomers;CABILDO                       ;VALPARAISO;152870;5;4;0;0;0;5;4;152870;Hervidor Inox One Midea;ELECTRODOMESTICOS
15645172;;F;38;CHILENO;;X;CASTRO                        ;LOS LAGOS;1017770;9;7;0;0;0;9;7;1017770;HORNO ELECTRICO BREMEN 23 LITROS;ELECTRODOMESTICOS
10891003;;M;55;CHILENO;;Boomers;PROVIDENCIA                   ;N/D;13990;1;1;0;0;0;1;1;13990;HERVIDOR TH-4340;ELECTRODOMESTICOS
15109579;;F;38;CHILENO;;Millenial;PEUMO                         ;L.G.B.OÂ´HIGGINS;1194880;12;8;4;2;226960;8;6;967920;Batidora Manual BM-490IN Multi Accesorios;ELECTRODOMESTICOS
12201514;;F;50;CHILENO;;X;N/D;N/D;81362;4;2;0;0;0;4;2;81362;Aspiradora TH1407 Arrastre 1400Watts;ELECTRODOMESTICOS
14532026;;F;45;CHILENO;;Millenial;N/D;N/D;95480;2;5;2;1;95480;0;4;0;Horno Electrico TH-80i 80Lts;ELECTRODOMESTICOS
25456021;;M;28;BOLIVIANO;;Extranjero;N/D;N/D;18186;2;1;0;0;0;2;1;18186;HERVIDOR COLONIA 1,7 LITROS;ELECTRODOMESTICOS
13558226;;F;43;CHILENO;;X;TALAGANTE                     ;METROPOLITANA;187500;2;1;0;0;0;2;1;187500;Maquina de Coser VX1445 con 14 puntadas;ELECTRODOMESTICOS
12449960;;F;48;CHILENO;;X;N/D;N/D;29990;1;1;1;1;29990;0;0;0;Batidora de Mano y Pedestal 3612;ELECTRODOMESTICOS
8289743;;F;67;CHILENO;;Boomers;CASTRO                        ;LOS LAGOS;363120;4;2;0;0;0;4;2;363120;Batidora Pedestal UT-KLEIN700;ELECTRODOMESTICOS
19985077;;F;24;CHILENO;;Z;MELIPILLA;METROPOLITANA;58970;3;1;0;0;0;3;1;58970;Batidora Vertical Minipimer UT-KLOT400P;ELECTRODOMESTICOS
19581058;;F;24;CHILENO;;Z;SAAVEDRA                      ;ARAUCANIA;38072;5;1;0;0;0;5;1;38072;Hervidor Electrico TH-4515N 2Lts Negro;ELECTRODOMESTICOS
16024533;;F;37;CHILENO;;Millenial;QUILPUE                       ;VALPARAISO;37980;2;1;0;0;0;2;1;37980;Exprimidor de Jugo TH-1215 1,5Lts;ELECTRODOMESTICOS
10934343;;F;54;CHILENO;;X;TALCAHUANO                    ;BIO BIO;29990;1;1;0;0;0;1;1;29990;Picadora UT-PETRUS320 1Lts Vaso Vidrio;ELECTRODOMESTICOS
10009069;;F;58;CHILENO;;Boomers;RENCA                         ;METROPOLITANA;29990;1;1;0;0;0;1;1;29990;BATIDORA MANUAL 260R;ELECTRODOMESTICOS
18291106;;F;29;CHILENO;;Millenial;N/D;N/D;20990;1;1;0;0;0;1;1;20990;Plancha UT-DUNST 2200Watts Base Ceramica;ELECTRODOMESTICOS
11760318;;M;51;CHILENO;;X;SANTA CRUZ                    ;L.G.B.OÂ´HIGGINS;109990;1;1;0;0;0;1;1;109990;Horno Electrico UT-BACKOFEN60 60Lts;ELECTRODOMESTICOS
9298166;;M;54;CHILENO;;Boomers;N/D;N/D;1182910;9;6;0;0;0;9;6;1182910;Hervidor Electrico HA-3300 2,5Lts Blanco;ELECTRODOMESTICOS
7387687;;F;65;CHILENO;;Boomers;LINARES                       ;MAULE;239950;5;4;0;0;0;5;4;239950;FREIDORA DE AIRE THOMAS TH-AF60Mi;ELECTRODOMESTICOS
16935198;;F;33;CHILENO;;Millenial;PROVIDENCIA                   ;METROPOLITANA;694490;7;4;6;3;679500;1;1;14990;FREIDORA DE AIRE CKSTAF55 1700W;ELECTRODOMESTICOS
10680977;;F;56;CHILENO;;Boomers;NOGALES                       ;VALPARAISO;14990;1;1;0;0;0;1;1;14990;HERVIDOR COLONIA 1,7 LITROS;ELECTRODOMESTICOS
13715553;;F;42;CHILENO;;X;SAN BERNARDO                  ;METROPOLITANA;164980;2;2;0;0;0;2;2;164980;Hervidor Electrico Tetera TH-6505RT 1,7Lts Rojo;ELECTRODOMESTICOS
11642528;;F;52;CHILENO;;X;PUENTE ALTO                   ;METROPOLITANA;34970;3;3;0;0;0;3;3;34970;Hervidor Electrico TH-4212N 1,7Lts Negro;ELECTRODOMESTICOS
27141423;;M;23;CHILENO;;Extranjero;N/D;N/D;39990;1;1;0;0;0;1;1;39990;Licuadora Kaliman Negra con Teclas;ELECTRODOMESTICOS
18001574;;F;31;CHILENO;;Millenial;N/D;N/D;29990;1;1;1;1;29990;0;0;0;FREIDORA DE AIRE HESSIA 2,0 LITROS;ELECTRODOMESTICOS
19900119;;M;23;CHILENO;;Z;PROVIDENCIA                   ;METROPOLITANA;77980;2;1;2;1;77980;0;0;0;HORNO ELECTRICO MUNICH 60 LITROS;ELECTRODOMESTICOS
8640963;;M;65;CHILENO;;Boomers;VALDIVIA                      ;LOS RIOS;19990;1;1;0;0;0;1;1;19990;Batidora Manual TH-8830;ELECTRODOMESTICOS
17965529;;M;31;CHILENO;;Millenial;SALAMANCA                     ;COQUIMBO;20990;1;1;0;0;0;1;1;20990;Batidora Manual TH-8830;ELECTRODOMESTICOS
6000466;;F;76;CHILENO;;Silencioso;VILLARICA                     ;ARAUCANIA;562910;5;3;0;0;0;5;3;562910;Aspiradora TH1407 Arrastre 1400Watts;ELECTRODOMESTICOS
15199015;Soltero;M;40;CHILENO;;X;PROVIDENCIA                   ;METROPOLITANA;18990;1;1;0;0;0;1;1;18990;HERVIDOR TH-4340;ELECTRODOMESTICOS
7207920;;M;67;CHILENO;;Boomers;N/D;N/D;1447740;15;9;0;0;0;15;9;1447740;Hervidor Electrico Tetera TH-6505RT 1,7Lts Rojo;ELECTRODOMESTICOS
9050170;;M;59;CHILENO;;Boomers;PROVIDENCIA                   ;METROPOLITANA;14990;1;1;0;0;0;1;1;14990;Hervidor Electrico TH-4212N 1,7Lts Negro;ELECTRODOMESTICOS
15779571;;M;37;CHILENO;;Millenial;PROVIDENCIA                   ;METROPOLITANA;444940;6;5;0;0;0;6;5;444940;Hervidor Electrico TH-5407i 2Lts;ELECTRODOMESTICOS
11531466;;M;52;CHILENO;;X;SAN JAVIER                    ;MAULE;94940;6;3;0;0;0;6;3;94940;HERVIDOR HAMBURGO 2,0 LITROS;ELECTRODOMESTICOS
15180587;;M;40;CHILENO;;X;CORONEL                       ;BIO BIO;144980;2;1;0;0;0;2;1;144980;MICROONDAS ME83X/XZS SAMSUNG MIRROR;ELECTRODOMESTICOS
9693073;;F;58;CHILENO;;Boomers;CONSTITUCION                  ;MAULE;17493;1;1;0;0;0;1;1;17493;Licuadora Personal TH-300PB;ELECTRODOMESTICOS
6483833;;F;75;CHILENO;;Silencioso;TALCAHUANO                    ;BIO BIO;245030;6;3;0;0;0;6;3;245030;Horno Electrico TH-48N 48Lts;ELECTRODOMESTICOS
11522462;;F;51;CHILENO;;X;PROVIDENCIA                   ;METROPOLITANA;116970;3;3;0;0;0;3;3;116970;Horno Microondas Mecanico UT-SYDNEY18 18Lts;ELECTRODOMESTICOS
17432167;;F;32;CHILENO;;Millenial;IQUIQUE                       ;TARAPACA;27230;3;2;0;0;0;3;2;27230;Batidora Vertical Stick Mixer 2609;ELECTRODOMESTICOS
11411565;;F;53;CHILENO;;X;SAN PABLO                     ;LOS LAGOS;69979;2;1;0;0;0;2;1;69979;Horno Electrico UT-BACKOFEN26 26Lts;ELECTRODOMESTICOS
18939811;;F;27;CHILENO;;Millenial;N/D;N/D;32990;1;1;0;0;0;1;1;32990;Batidora Vertical Multimixer TH-8720;ELECTRODOMESTICOS
11088464;;F;55;CHILENO;;Silencioso;PROVIDENCIA                   ;METROPOLITANA;54980;2;2;0;0;0;2;2;54980;Licuadora TH-320 Roja/Negro 1,5 Lts Vaso Vidrio;ELECTRODOMESTICOS
19510628;;M;25;CHILENO;;Z;FLORIDA                       ;BIO BIO;13990;1;1;0;0;0;1;1;13990;HERVIDOR TH-4340;ELECTRODOMESTICOS
17874291;;F;28;CHILENO;;Millenial;CHEPICA                       ;L.G.B.OÂ´HIGGINS;150742;6;3;0;0;0;6;3;150742;Picadora UT-PETRUS320 1Lts Vaso Vidrio;ELECTRODOMESTICOS
12329209;Casado;F;48;CHILENO;TECNICO EN VENTAS;X;RENCA                         ;METROPOLITANA;48980;2;2;0;0;0;2;2;48980;Licuadora Roja 550W 1,5Lts Vaso Vidrio;ELECTRODOMESTICOS
19970673;;F;23;CHILENO;;Z;PROVIDENCIA                   ;METROPOLITANA;28980;2;1;0;0;0;2;1;28980;Sandwichera TH-952 2 Panes Blanca;ELECTRODOMESTICOS
5744948;;M;75;CHILENO;;Silencioso;PEDRO AGUIRRE CERDA           ;METROPOLITANA;446130;3;2;0;0;0;3;2;446130;FREIDORA DE AIRE THOMAS TH-AF60Mi;ELECTRODOMESTICOS
18803963;;F;32;CHILENO;;Millenial;LOS ANGELES;BIO-BIO;82980;2;2;0;0;0;2;2;82980;Horno Microondas Mecanico M-2020NG 20Lts;ELECTRODOMESTICOS
7506308;;F;65;CHILENO;;Boomers;CALBUCO                       ;LOS LAGOS;173123;6;4;0;0;0;6;4;173123;FREIDORA DE AIRE HESSIA 2,0 LITROS;ELECTRODOMESTICOS
13740198;Casado;F;43;CHILENO;TECNICO DE NIVEL SUPERIOR EN ENFERMERIA;X;PROVIDENCIA                   ;METROPOLITANA;382960;4;1;0;0;0;4;1;382960;SUPER FREIDORA DE AIRE OV3;ELECTRODOMESTICOS
6246681;;F;76;CHILENO;;Silencioso;RENCA                         ;METROPOLITANA;124970;3;2;0;0;0;3;2;124970;Hervidor Electrico Tetera TH-6505RT 1,7Lts Rojo;ELECTRODOMESTICOS
18559888;Soltero;F;28;CHILENO;;Millenial;PROVIDENCIA                   ;METROPOLITANA;20990;1;1;0;0;0;1;1;20990;Tostador de PanTH-120R 2 Rebanadas Rojo;ELECTRODOMESTICOS
14342683;;M;46;CHILENO;;X;TALAGANTE                     ;METROPOLITANA;30980;2;2;0;0;0;2;2;30980;Hervidor Electrico HA-3300 2,5Lts Blanco;ELECTRODOMESTICOS
4423357;;M;81;CHILENO;;Silencioso;N/D;N/D;2196920;12;7;0;0;0;12;7;2196920;HORNO ELECTRICO BREMEN 23 LITROS;ELECTRODOMESTICOS
18629861;;F;28;CHILENO;;Millenial;BUIN;METROPOLITANA;34990;1;1;0;0;0;1;1;34990;Aspiradora Handy Clean Black 1400;ELECTRODOMESTICOS
10474920;;M;57;CHILENO;;Boomers;VALDIVIA                      ;LOS LAGOS;54990;1;1;0;0;0;1;1;54990;Licuadora Oster Clasica Azul 4134 1,25 lt;ELECTRODOMESTICOS
12737190;;M;47;CHILENO;;X;RENCA                         ;METROPOLITANA;39990;1;1;0;0;0;1;1;39990;Horno Electrico TH-25N01 25Lts;ELECTRODOMESTICOS
9967864;;F;58;CHILENO;;Boomers;"";"";155950;5;3;4;2;100960;1;1;54990;Horno Microondas Mecanico Easy Wave 20Lts;ELECTRODOMESTICOS
11265456;;M;53;CHILENO;;X;LA CISTERNA                   ;METROPOLITANA;858960;5;3;5;3;858960;0;0;0;Horno Electrico TH-48N 48Lts;ELECTRODOMESTICOS
7871275;;M;66;CHILENO;;Boomers;NANCAGUA                      ;L.G.B.OÂ´HIGGINS;364980;2;2;0;0;0;2;2;364980;Horno Microondas Digital L UT-25KROMM 25Lts;ELECTRODOMESTICOS
19398903;;F;25;CHILENO;;Z;N/D;N/D;23990;1;3;0;0;0;1;3;23990;Olla Arrocera OA-400NG 1,8Lts;ELECTRODOMESTICOS
9368720;;M;58;CHILENO;;Boomers;TALCA                         ;MAULE;84990;1;1;0;0;0;1;1;84990;Batidora Pedestal TH910PN 4,6Lts 1300Watts;ELECTRODOMESTICOS
6428422;;F;71;CHILENO;;Silencioso;LA SERENA                     ;COQUIMBO;389950;5;3;0;0;0;5;3;389950;Horno Microondas Digital TH-20S01 20Lts;ELECTRODOMESTICOS
7380582;;F;57;CHILENO;;Boomers;LINARES                       ;MAULE;361020;6;2;0;0;0;6;2;361020;ASPIRADORA ROBOT THOMAS TH-1060SC;ELECTRODOMESTICOS
26275619;;F;36;EXTRANJERO - NO INFORMA NACIONALIDAD;;Extranjero;"";"";58980;2;2;0;0;0;2;2;58980;HORNO ELECTRICO 16N01 16LTS NEGRO;ELECTRODOMESTICOS
9902396;;M;55;CHILENO;;Boomers;PAINE                         ;METROPOLITANA;155880;4;2;0;0;0;4;2;155880;Horno Microonda Columba 1700;ELECTRODOMESTICOS
14308355;;F;46;CHILENO;;X;ANTOFAGASTA                   ;ANTOFAGASTA;44990;1;1;0;0;0;1;1;44990;Aspiradora VCC4190V3E/XZS Arrastre 2000Watts;ELECTRODOMESTICOS
14034797;;F;41;CHILENO;;X;TEMUCO                        ;ARAUCANIA;22990;1;1;0;0;0;1;1;22990;Licuadora Berry Blender Roja 1400 Vaso Vidrio;ELECTRODOMESTICOS
16614218;;F;34;CHILENO;;Millenial;TOCOPILLA                     ;ANTOFAGASTA;1046730;11;7;0;0;0;11;7;1046730;HORNO ELECTRICO BREMEN 23 LITROS;ELECTRODOMESTICOS
18255576;Soltero;M;30;CHILENO;INGENIERO EN PREVENCION DE RIESGOS;Millenial;PROVIDENCIA                   ;METROPOLITANA;17990;1;1;0;0;0;1;1;17990;Hervidor Family Kettle HE500;ELECTRODOMESTICOS
5341214;;M;77;CHILENO;;Silencioso;RENCA                         ;METROPOLITANA;111980;2;1;0;0;0;2;1;111980;Horno Microondas Mecanico M-2020NG 20Lts;ELECTRODOMESTICOS
8413315;;F;62;CHILENO;;Boomers;PUERTO MONTT                  ;LOS LAGOS;94453;5;4;0;0;0;5;4;94453;HORNO 10 LITROS OSTER ROJO;ELECTRODOMESTICOS
20302630;;F;22;CHILENO;;Extranjero;SAN BERNARDO                  ;METROPOLITANA;39990;1;1;0;0;0;1;1;39990;Horno Electrico TH-25N01 25Lts;ELECTRODOMESTICOS
15681804;;F;38;CHILENO;;X;TEMUCO                        ;ARAUCANIA;33980;2;2;0;0;0;2;2;33980;HERVIDOR TH-4340;ELECTRODOMESTICOS
8250632;;F;65;CHILENO;;Boomers;PROVIDENCIA                   ;METROPOLITANA;64990;1;1;0;0;0;1;1;64990;ASPIRADORA VCC4580V3K/XZS SAMSUNG BLACK;ELECTRODOMESTICOS
12200239;;F;50;CHILENO;;X;PROVIDENCIA                   ;METROPOLITANA;12990;1;1;0;0;0;1;1;12990;HERVIDOR BERLIN 1,7 LITROS;ELECTRODOMESTICOS
13410699;;F;44;CHILENO;;X;COIHAIQUE                     ;AYSEN;173970;3;3;1;1;19990;2;2;153980;Licuadora Berry Blender Roja 1400 Vaso Vidrio;ELECTRODOMESTICOS
18616236;;M;29;CHILENO;;Millenial;COIHAIQUE                     ;AYSEN;83650;4;3;0;0;0;4;3;83650;Hervidor Electrico TH-4515N 2Lts Negro;ELECTRODOMESTICOS
15999501;Soltero;F;37;CHILENO;PROFESOR;Millenial;PROVIDENCIA                   ;METROPOLITANA;14990;1;1;0;0;0;1;1;14990;Plancha Easy Steam (PV4500);ELECTRODOMESTICOS
11369035;;F;53;CHILENO;;X;TENO                          ;MAULE;513681;7;4;0;0;0;7;4;513681;Hervidor Electrico Tetera TH-6505RT 1,7Lts Rojo;ELECTRODOMESTICOS
11716020;Soltero;M;51;CHILENO;INGENIERO;X;PROVIDENCIA                   ;METROPOLITANA;39990;1;1;1;1;39990;0;0;0;Aspiradora AP1700 Arrastre 1700Watts;ELECTRODOMESTICOS
18247336;;F;29;CHILENO;;Millenial;PENALOLEN;METROPOLITANA;43980;2;1;2;1;43980;0;0;0;ASPIRADORA THOMAS TH-1022C;ELECTRODOMESTICOS
13146188;;M;45;CHILENO;;X;N/D;N/D;196970;3;3;0;0;0;3;3;196970;HERVIDOR TH-4340;ELECTRODOMESTICOS
7428154;;M;68;CHILENO;;Boomers;VILLARICA                     ;ARAUCANIA;229380;3;2;0;0;0;3;2;229380;Maquina de coser Singer 1605;ELECTRODOMESTICOS
5471987;;F;75;CHILENO;;Silencioso;ARICA                         ;ARICA Y PARINACOTA;54980;2;2;0;0;0;2;2;54980;Hervidor Electrico 3101 1,7Lts Negro;ELECTRODOMESTICOS
6716273;Divorciado;F;70;CHILENO;PROFESOR;Silencioso;RENCA                         ;METROPOLITANA;14990;1;1;0;0;0;1;1;14990;TOSTADOR OLDEMBURGO 2 REBANADAS;ELECTRODOMESTICOS
17470832;;F;32;CHILENO;;Millenial;PROVIDENCIA                   ;METROPOLITANA;109990;1;1;1;1;109990;0;0;0;Horno Electrico UT-BACKOFEN60 60Lts;ELECTRODOMESTICOS
18499961;;M;28;CHILENO;;Millenial;PROVIDENCIA                   ;METROPOLITANA;39990;1;1;0;0;0;1;1;39990;Licuadora Kaliman Negra con Teclas;ELECTRODOMESTICOS
10960877;;F;56;CHILENO;;Boomers;"";"";51980;2;1;0;0;0;2;1;51980;Licuadora TH-401V Roja 1,75Lts Vaso Vidrio;ELECTRODOMESTICOS
10252710;;M;55;CHILENO;;Extranjero;ARICA                         ;ARICA Y PARINACOTA;17990;1;1;0;0;0;1;1;17990;Hervidor Family Kettle HE500;ELECTRODOMESTICOS
14658179;;F;57;VENEZOLANO;;Extranjero;SANTIAGO                      ;METROPOLITANA;793910;8;4;7;3;740920;1;1;52990;HORNO ELECTRICO MUNICH 60 LITROS;ELECTRODOMESTICOS
11897905;;M;51;CHILENO;;X;RENCA                         ;METROPOLITANA;24990;1;1;0;0;0;1;1;24990;Tostador de PanTH-120R 2 Rebanadas Rojo;ELECTRODOMESTICOS
9920607;;M;57;CHILENO;;Boomers;CURACAVI                      ;METROPOLITANA;111700;6;1;0;0;0;6;1;111700;HORNO ELECTRICO MUNICH 60 LITROS;ELECTRODOMESTICOS
7860455;;F;69;CHILENO;;Silencioso;TEMUCO                        ;ARAUCANIA;64990;1;1;0;0;0;1;1;64990;ASPIRADORA THOMAS TH-1640;ELECTRODOMESTICOS
14381235;;F;42;CHILENO;;X;SAN BERNARDO                  ;METROPOLITANA;852890;11;6;8;4;651920;3;2;200970;Hervidor Family Kettle HE500;ELECTRODOMESTICOS
9277145;;F;60;CHILENO;;Boomers;PROVIDENCIA                   ;METROPOLITANA;15240;2;2;0;0;0;2;2;15240;Exprimidor Fauna 500 cc;ELECTRODOMESTICOS
25382017;;M;49;HAITIANO;;Extranjero;SAN ANTONIO                   ;VALPARAISO;24990;1;1;0;0;0;1;1;24990;Hervidor Electrico UT-REIN17SS;ELECTRODOMESTICOS
11976253;;M;49;CHILENO;;X;PROVIDENCIA                   ;METROPOLITANA;34990;1;1;0;0;0;1;1;34990;Aspiradora Handy Clean Black 1400;ELECTRODOMESTICOS
4719170;;F;79;CHILENO;;Silencioso;ARICA                         ;ARICA Y PARINACOTA;776460;4;3;0;0;0;4;3;776460;Hervidor Family Kettle HE500;ELECTRODOMESTICOS
16855244;;M;34;CHILENO;;Millenial;PROVIDENCIA                   ;METROPOLITANA;16990;1;1;0;0;0;1;1;16990;HERVIDOR BERLIN 1,7 LITROS;ELECTRODOMESTICOS
16112432;;F;37;CHILENO;;Millenial;"";"";24990;1;1;0;0;0;1;1;24990;Plancha TH-7052 2000Watts Base Inox;ELECTRODOMESTICOS
18131160;;F;29;CHILENO;;Millenial;N/D;N/D;616960;5;4;5;4;616960;0;0;0;FREIDORA DE AIRE THOMAS TH-AF60Mi;ELECTRODOMESTICOS
26053821;;M;37;HAITIANO;;Extranjero;CHIMBARONGO                   ;L.G.B.OÂ´HIGGINS;360061;3;2;0;0;0;3;2;360061;Licuadora TH-320 Roja/Negro 1,5 Lts Vaso Vidrio;ELECTRODOMESTICOS
26270770;;M;32;COLOMBIANO;;Extranjero;"";"";50980;2;1;0;0;0;2;1;50980;Cafetera TH-138i;ELECTRODOMESTICOS
8810156;;F;60;CHILENO;;Boomers;CHILLAN                       ;BIO BIO;18990;1;1;0;0;0;1;1;18990;Batidora Manual UT-TEKLA300;ELECTRODOMESTICOS
9767726;;F;59;CHILENO;;Boomers;PROVIDENCIA                   ;METROPOLITANA;19990;1;1;0;0;0;1;1;19990;LICUADORA HANOVER 1,5 LITROS;ELECTRODOMESTICOS
9893274;Soltero;M;57;CHILENO;;Boomers;PROVIDENCIA                   ;METROPOLITANA;18990;1;1;0;0;0;1;1;18990;Cafetera TH-130;ELECTRODOMESTICOS
16387088;;F;35;CHILENO;;Millenial;PROVIDENCIA                   ;N/D;32990;1;1;0;0;0;1;1;32990;Combo Juguera + Hervidor;ELECTRODOMESTICOS
17201725;;M;32;CHILENO;;Millenial;N/D;N/D;15990;1;1;0;0;0;1;1;15990;Hervidor Electrico UT-MANLY17 1,7Lts Negro;ELECTRODOMESTICOS
12826947;;F;46;CHILENO;;X;SAN ANTONIO                   ;VALPARAISO;279960;4;4;0;0;0;4;4;279960;Horno Microondas Digital L UT-25KROMM 25Lts;ELECTRODOMESTICOS
5531095;;F;77;CHILENO;;Silencioso;CERRO NAVIA                   ;METROPOLITANA;113160;3;2;0;0;0;3;2;113160;Hervidor Electrico TH-5407i 2Lts;ELECTRODOMESTICOS
7551667;;M;64;CHILENO;;Boomers;VINA DEL MAR                  ;VALPARAISO;49980;2;2;0;0;0;2;2;49980;Cafetera TH-138i;ELECTRODOMESTICOS
18329857;;F;29;CHILENO;;Millenial;N/D;N/D;758970;8;5;0;0;0;8;5;758970;Aspiradora TH1870 Arrastre 1800Watts Gris;ELECTRODOMESTICOS
7643935;Soltero;M;66;CHILENO;AUXILIAR DE ENFERMERIA;Boomers;RENCA                         ;METROPOLITANA;81890;3;1;0;0;0;3;1;81890;Aspiradora UT-SILENT1603 Arrastre 1600Watts;ELECTRODOMESTICOS
9527769;Soltero;M;58;CHILENO;PROFESOR;Boomers;RENCA                         ;METROPOLITANA;444970;3;2;2;1;284980;1;1;159990;Horno Electrico TH-80i 80Lts;ELECTRODOMESTICOS
11788903;;F;51;CHILENO;;X;LOS ALAMOS                    ;BIO BIO;245681;7;4;0;0;0;7;4;245681;Licuadora TH-320 Roja/Negro 1,5 Lts Vaso Vidrio;ELECTRODOMESTICOS
21214072;;F;47;PERUANO;;Extranjero;ARICA                         ;TARAPACA;421360;5;2;0;0;0;5;2;421360;Horno Electrico UT-BACKOFEN60 60Lts;ELECTRODOMESTICOS
17991999;;M;30;CHILENO;;Millenial;PLACILLA                      ;L.G.B.OÂ´HIGGINS;190950;5;3;2;1;16980;3;2;173970;MULTIMIXER THOMAS TH- 8706;ELECTRODOMESTICOS
16992276;;M;33;CHILENO;;Millenial;BULNES                        ;BIO BIO;14990;1;1;0;0;0;1;1;14990;Exprimidor Fauna 500 cc;ELECTRODOMESTICOS
10936645;;F;51;CHILENO;;X;MACHALI                       ;L.G.B.OÂ´HIGGINS;69980;2;2;0;0;0;2;2;69980;HERVIDOR TH-4340;ELECTRODOMESTICOS
10060819;;F;54;CHILENO;;Boomers;RENGO                         ;L.G.B.OÂ´HIGGINS;303420;4;2;0;0;0;4;2;303420;Hervidor Electrico TH-4212N 1,7Lts Negro;ELECTRODOMESTICOS
12973747;;M;46;CHILENO;;X;TALCAHUANO                    ;BIO BIO;53230;3;2;0;0;0;3;2;53230;Combo Hervidor + Batidora;ELECTRODOMESTICOS
16070935;;F;37;CHILENO;;Millenial;PROVIDENCIA                   ;METROPOLITANA;16240;2;1;0;0;0;2;1;16240;Hervidor Electrico UT-MANLY17 1,7Lts Negro;ELECTRODOMESTICOS
20256889;;M;23;CHILENO;;Z;N/D;N/D;108820;4;3;0;0;0;4;3;108820;Cafetera UT-KAFFEEKLASSIK;ELECTRODOMESTICOS
6570516;;F;63;CHILENO;;Boomers;PROVIDENCIA                   ;METROPOLITANA;28980;2;1;2;1;28980;0;0;0;HORNO 10 LITROS OSTER ROJO;ELECTRODOMESTICOS
11181135;;M;55;CHILENO;;Boomers;COPIAPO                       ;ATACAMA;24990;1;1;0;0;0;1;1;24990;HORNO 10 LITROS OSTER ROJO;ELECTRODOMESTICOS
5024840;;F;76;CHILENO;;Silencioso;PROVIDENCIA                   ;METROPOLITANA;52990;1;1;0;0;0;1;1;52990;Horno Electrico TH-25N01 25Lts;ELECTRODOMESTICOS
12837421;;F;49;CHILENO;;X;ANTOFAGASTA                   ;ANTOFAGASTA;32990;1;1;0;0;0;1;1;32990;Licuadora Personal TH-300PB;ELECTRODOMESTICOS
15463330;;M;39;CHILENO;;X;CONCHALI                      ;METROPOLITANA;214941;6;3;0;0;0;6;3;214941;Hervidor Electrico TH-4515N 2Lts Negro;ELECTRODOMESTICOS
10457073;;F;57;CHILENO;;Boomers;VALDIVIA                      ;LOS LAGOS;13293;1;1;0;0;0;1;1;13293;MULTIMIXER THOMAS TH- 8706;ELECTRODOMESTICOS
7306972;;F;65;CHILENO;;Boomers;VILLA ALEMANA                 ;VALPARAISO;461320;9;5;0;0;0;9;5;461320;SUPER FREIDORA DE AIRE OV3;ELECTRODOMESTICOS
16997168;;M;33;CHILENO;;Millenial;TEMUCO                        ;ARAUCANIA;317940;6;4;0;0;0;6;4;317940;Hervidor Electrico Tetera HA-4100 4Lts Iox;ELECTRODOMESTICOS
8458854;;M;49;CHILENO;;X;MAIPU;METROPOLITANA;38980;2;1;2;1;38980;0;0;0;TERMOHERVIDOR BA-6928 NEGRO 2,8LTS;ELECTRODOMESTICOS
20029840;;F;23;CHILENO;;Millenial;"";"";15990;1;1;0;0;0;1;1;15990;Hervidor Electrico Tetera UT-LECKER18R 1,8Lts;ELECTRODOMESTICOS
15361559;;M;37;CHILENO;;Silencioso;PROVIDENCIA                   ;METROPOLITANA;53980;2;1;2;1;53980;0;0;0;Aspiradora UT-ZYKLON1402 Arrastre 1400Watts;ELECTRODOMESTICOS
11968042;;F;50;CHILENO;;X;TEMUCO                        ;ARAUCANIA;33970;3;3;2;2;20980;1;1;12990;HERVIDOR BERLIN 1,7 LITROS;ELECTRODOMESTICOS
9453681;Soltero;M;66;CHILENO;PROFESOR;Boomers;PROVIDENCIA                   ;METROPOLITANA;94210;4;3;0;0;0;4;3;94210;HERVIDOR BERLIN 1,7 LITROS;ELECTRODOMESTICOS
24013246;;M;49;COLOMBIANO;;Extranjero;ANTOFAGASTA                   ;ANTOFAGASTA;89990;1;1;0;0;0;1;1;89990;Olla Multiuso 6801 5,7Lts;ELECTRODOMESTICOS
6536485;;F;71;CHILENO;;Silencioso;CONSTITUCION                  ;MAULE;884321;8;6;2;2;23980;6;4;860341;Hervidor Electrico TH-4212N 1,7Lts Negro;ELECTRODOMESTICOS
18861182;;F;27;CHILENO;;Z;ARICA;TARAPACA;213930;7;4;5;3;153950;2;1;59980;Horno Electrico TH-25N01 25Lts;ELECTRODOMESTICOS
7111369;;M;65;CHILENO;;Boomers;LOS VILOS                     ;COQUIMBO;1252100;8;5;0;0;0;8;5;1252100;HERVIDOR BERLIN 1,7 LITROS;ELECTRODOMESTICOS
16827302;;F;34;CHILENO;;Millenial;PARRAL                        ;MAULE;144980;2;2;0;0;0;2;2;144980;HORNO ELECTRICO MUNICH 60 LITROS;ELECTRODOMESTICOS
5445526;;F;75;CHILENO;;Silencioso;TRAIGUEN                      ;ARAUCANIA;136890;3;2;0;0;0;3;2;136890;FREIDORA DE AIRE THOMAS TH-AF60Mi;ELECTRODOMESTICOS
12479145;Casado;M;49;CHILENO;;X;RENCA                         ;METROPOLITANA;54990;1;1;1;1;54990;0;0;0;HORNO ELECTRICO DORTMUND 45 LITROS;ELECTRODOMESTICOS
24318629;;F;44;BOLIVIANO;;Extranjero;N/D;N/D;42491;1;1;0;0;0;1;1;42491;Licuadora Oster Clasica Azul 4134 1,25 lt;ELECTRODOMESTICOS
4396054;;F;86;CHILENO;;Silencioso;SAN ANTONIO                   ;VALPARAISO;178210;5;4;0;0;0;5;4;178210;Batidora Pedestal TH910PN 4,6Lts 1300Watts;ELECTRODOMESTICOS
13276925;;F;45;CHILENO;;X;PROVIDENCIA                   ;METROPOLITANA;225910;10;5;10;5;225910;0;0;0;Licuadora L1000 Inox 1,7LtsVaso Vidrio;ELECTRODOMESTICOS
12649470;;F;48;CHILENO;;X;OVALLE                        ;COQUIMBO;12990;1;1;0;0;0;1;1;12990;HERVIDOR BERLIN 1,7 LITROS;ELECTRODOMESTICOS
19164545;;F;27;CHILENO;;Z;PROVIDENCIA                   ;METROPOLITANA;69990;1;1;0;0;0;1;1;69990;HORNO ELECTRICO MUNICH 60 LITROS;ELECTRODOMESTICOS
15288861;;F;38;CHILENO;;Millenial;ANCUD                         ;LOS LAGOS;54990;1;1;0;0;0;1;1;54990;Aspiradora TH1407 Arrastre 1400Watts;ELECTRODOMESTICOS
17189202;;M;33;CHILENO;;Extranjero;N/D;N/D;144980;2;1;0;0;0;2;1;144980;Horno Microondas Digital ME0113MB1/XZS 32Lts;ELECTRODOMESTICOS
10513647;;M;55;CHILENO;;Boomers;RENCA                         ;METROPOLITANA;41980;2;1;0;0;0;2;1;41980;Licuadora Berry Blender Roja 1400 Vaso Vidrio;ELECTRODOMESTICOS
16591700;;F;35;CHILENO;;Millenial;"";"";102980;2;1;0;0;0;2;1;102980;Horno Electrico TH-25N01 25Lts;ELECTRODOMESTICOS
8687281;;F;63;CHILENO;;Boomers;LA FLORIDA;METROPOLITANA;48980;2;1;2;1;48980;0;0;0;Horno Microondas Mecanico Fancy 20Lts;ELECTRODOMESTICOS
13739658;;M;43;CHILENO;;X;COIHAIQUE                     ;AYSEN;981910;8;5;8;5;981910;0;0;0;Horno Electrico TH62I 60Lts;ELECTRODOMESTICOS
14065391;;F;41;CHILENO;;X;PROVIDENCIA                   ;METROPOLITANA;89200;3;1;0;0;0;3;1;89200;Horno Microondas Mecanico Easy Wave 20Lts;ELECTRODOMESTICOS
7513860;;M;65;CHILENO;;Boomers;LO ESPEJO                     ;METROPOLITANA;27980;2;2;0;0;0;2;2;27980;Batidora Vertical Stick Mixer 2609;ELECTRODOMESTICOS
23730638;;F;34;ECUATORIANO;;Extranjero;COLINA                        ;METROPOLITANA;1010930;7;6;0;0;0;7;6;1010930;Licuadora Oster Clasica Azul 4134 1,25 lt;ELECTRODOMESTICOS
10259163;;F;57;CHILENO;;Boomers;"";"";120510;5;3;3;1;35530;2;2;84980;BATIDORA INMERSION S MIX 2616;ELECTRODOMESTICOS
13705608;;M;42;CHILENO;;X;LA PINTANA                    ;METROPOLITANA;24990;1;1;0;0;0;1;1;24990;Picadora 1-2-3 AD6011CL 750W;ELECTRODOMESTICOS
17396513;;M;32;CHILENO;;Millenial;N/D;N/D;436602;6;3;3;2;395830;3;1;40772;Hervidor Electrico UT-DUNKEL17P 2Lts Negro;ELECTRODOMESTICOS
18743787;;M;39;CHILENO;;X;SAN FERNANDO                  ;L.G.B.OÂ´HIGGINS;257873;3;3;0;0;0;3;3;257873;Hervidor Electrico TH-4212N 1,7Lts Negro;ELECTRODOMESTICOS
17485706;;M;32;CHILENO;;Millenial;PEDRO AGUIRRE CERDA;METROPOLITANA;235920;8;4;8;4;235920;0;0;0;Hervidor Termo BA-6928 Inox 2,8Lts;ELECTRODOMESTICOS
19718587;;F;24;CHILENO;;Z;PROVIDENCIA                   ;METROPOLITANA;89990;1;1;0;0;0;1;1;89990;Batidora Pedestal TH910PN 4,6Lts 1300Watts;ELECTRODOMESTICOS
18261184;;F;30;CHILENO;;Millenial;N/D;N/D;633950;7;4;2;1;143980;5;3;489970;Aspiradora TH1870 Arrastre 1800Watts Gris;ELECTRODOMESTICOS
11407269;;F;53;CHILENO;;X;HUALPEN;BIO BIO;36990;1;1;0;0;0;1;1;36990;Procesador TH-9010 Multimixer 1,5Lts Vaso Vidrio;ELECTRODOMESTICOS
5399196;Viudo;F;73;CHILENO;;Silencioso;RENCA                         ;METROPOLITANA;28990;1;1;0;0;0;1;1;28990;Plancha UT-KERAMIKTOP 2200Watts Base Ceramica;ELECTRODOMESTICOS
23349413;;F;43;PERUANO;;Extranjero;SANTIAGO                      ;METROPOLITANA;39990;1;1;0;0;0;1;1;39990;Batidora de Mano y Pedestal 3612;ELECTRODOMESTICOS
11748127;;F;51;CHILENO;;X;CASTRO                        ;LOS LAGOS;31990;1;1;0;0;0;1;1;31990;Tostador de Pan TH-126 4 Rebanadas Negro;ELECTRODOMESTICOS
17518610;;F;32;CHILENO;;Millenial;ISLA DE MAIPO                 ;METROPOLITANA;7240;2;1;0;0;0;2;1;7240;Hervidor Electrico HA-2650NG;ELECTRODOMESTICOS
10748417;;F;61;CHILENO;;Boomers;CORONEL                       ;BIO BIO;28990;1;1;0;0;0;1;1;28990;Licuadora L2000VNG 1,5Lts Vaso Vidrio;ELECTRODOMESTICOS
18901617;;F;27;CHILENO;;Z;TEMUCO                        ;ARAUCANIA;39990;1;1;0;0;0;1;1;39990;LICUADORA CROMADA CON TECLAS PLUS;ELECTRODOMESTICOS
12617633;;M;49;CHILENO;;X;CALDERA;ATACAMA;100710;2;1;0;0;0;2;1;100710;Horno Microondas Digital MS23K3513AK/ZS 23Lts;ELECTRODOMESTICOS
10962856;;M;50;CHILENO;;Millenial;LOTA                          ;BIO BIO;628950;5;3;4;2;601960;1;1;26990;HORNO 10 LITROS OSTER ROJO;ELECTRODOMESTICOS
6208512;;F;68;CHILENO;;Silencioso;N/D;N/D;394230;4;3;0;0;0;4;3;394230;Horno Microondas Digital TH-25DM 25Lts;ELECTRODOMESTICOS
17082100;Soltero;M;33;CHILENO;;Millenial;PROVIDENCIA                   ;METROPOLITANA;100970;3;2;0;0;0;3;2;100970;Horno Electrico TH-38N 38Lts;ELECTRODOMESTICOS
9343794;;F;61;CHILENO;;Boomers;PROVIDENCIA                   ;METROPOLITANA;193980;2;2;0;0;0;2;2;193980;Licuadora Sport Blender BSE10;ELECTRODOMESTICOS
25781701;;M;34;BOLIVIANO;;Extranjero;ARICA                         ;ARICA Y PARINACOTA;229910;6;3;0;0;0;6;3;229910;Horno Electrico TH-48N 48Lts;ELECTRODOMESTICOS
8034145;;M;64;CHILENO;;Boomers;PROVIDENCIA                   ;METROPOLITANA;14990;1;1;0;0;0;1;1;14990;HERVIDOR HAMBURGO 2,0 LITROS;ELECTRODOMESTICOS
7662953;;M;67;CHILENO;;Boomers;BUIN                          ;METROPOLITANA;323560;3;3;0;0;0;3;3;323560;HORNO ELECTRICO HE-600IN INOX SINDELEN;ELECTRODOMESTICOS
11730253;;F;50;CHILENO;;X;N/D;N/D;228950;5;5;0;0;0;5;5;228950;Combo Hervidor + Batidora;ELECTRODOMESTICOS
17419151;;M;32;CHILENO;;Millenial;PROVIDENCIA                   ;METROPOLITANA;39990;1;1;1;1;39990;0;0;0;Batidora de Mano y Pedestal 3612;ELECTRODOMESTICOS
11360670;;M;52;CHILENO;;X;EL TABO                       ;VALPARAISO;122970;3;3;2;2;109980;1;1;12990;HORNO ELECTRICO MUNICH 60 LITROS;ELECTRODOMESTICOS
11611251;;F;52;CHILENO;;X;ARICA                         ;ARICA Y PARINACOTA;54990;1;1;0;0;0;1;1;54990;Licuadora L-25000NG;ELECTRODOMESTICOS
16265065;;M;36;CHILENO;;Millenial;N/D;N/D;86960;4;2;3;1;73970;1;1;12990;HERVIDOR COLONIA 1,7 LITROS;ELECTRODOMESTICOS
19758932;;M;25;CHILENO;;Z;N/D;N/D;1042960;5;3;0;0;0;5;3;1042960;Aspiradora TH1870 Arrastre 1800Watts Gris;ELECTRODOMESTICOS
17027236;Soltero;F;33;CHILENO;INGENIERO CIVIL;Millenial;PROVIDENCIA                   ;METROPOLITANA;53980;2;1;2;1;53980;0;0;0;Freidora electrica Ut-KeramikAir;ELECTRODOMESTICOS
15522306;;M;37;CHILENO;;Millenial;PUNTA ARENAS                  ;MAGALLANES;104962;4;3;0;0;0;4;3;104962;Batidora Vertical Minipimer UT-KLOT800SS;ELECTRODOMESTICOS
13797736;;M;41;CHILENO;;X;PARRAL                        ;MAULE;349560;3;2;0;0;0;3;2;349560;Horno Electrico TH-80i 80Lts;ELECTRODOMESTICOS
6955072;;M;63;CHILENO;;Boomers;ALGARROBO                     ;VALPARAISO;748020;7;4;0;0;0;7;4;748020;Horno Electrico TH62I 60Lts;ELECTRODOMESTICOS
26886317;;F;24;NO INFORMA NACIONALIDAD;;Extranjero;"";"";33980;2;1;2;1;33980;0;0;0;Licuadora Roja 550W 1,5Lts Vaso Vidrio;ELECTRODOMESTICOS
12082350;;F;58;CHILENO;;Boomers;CHILLAN                       ;BIO BIO;982640;5;2;0;0;0;5;2;982640;Horno Electrico UT-BACKOFEN60 60Lts;ELECTRODOMESTICOS
23771941;;M;29;PERUANO;;Extranjero;PROVIDENCIA                   ;METROPOLITANA;79990;1;1;1;1;79990;0;0;0;FREIDORA DE AIRE THOMAS TH-AF60Mi;ELECTRODOMESTICOS
11511933;;F;52;CHILENO;;X;TEMUCO                        ;ARAUCANIA;47980;2;2;0;0;0;2;2;47980;Hervidor Electrico UT-KLAR20PW 2Lts Blanco;ELECTRODOMESTICOS
7231983;Casado;M;66;CHILENO;;Boomers;CONSTITUCION                  ;MAULE;116980;2;1;2;1;116980;0;0;0;Maquina de Coser 3008 Janome Blanco;ELECTRODOMESTICOS
16505774;;M;42;CHILENO;;X;SAN JAVIER                    ;MAULE;149990;1;1;0;0;0;1;1;149990;Horno Electrico TH-100i 100Lts;ELECTRODOMESTICOS
9537736;;M;60;CHILENO;;Boomers;OVALLE                        ;COQUIMBO;12990;1;1;0;0;0;1;1;12990;Hervidor Electrico TH-4212N 1,7Lts Negro;ELECTRODOMESTICOS
12947988;;F;45;CHILENO;;X;LA LIGUA                      ;VALPARAISO;1045920;8;5;6;3;945940;2;2;99980;Licuadora TH-501V 1,5Lts Vaso Vidrio;ELECTRODOMESTICOS
9627477;;F;61;CHILENO;;Boomers;RENCA                         ;METROPOLITANA;44990;1;1;0;0;0;1;1;44990;Horno Electrico TH-25N01 25Lts;ELECTRODOMESTICOS
17874549;;M;31;CHILENO;;Millenial;N/D;N/D;1299060;5;3;3;1;1239080;2;2;59980;Plancha Paninis 2880;ELECTRODOMESTICOS
16824002;;M;34;CHILENO;;Millenial;NUEVA IMPERIAL                ;ARAUCANIA;89980;2;2;0;0;0;2;2;89980;Horno Electrico TH-25N01 25Lts;ELECTRODOMESTICOS
15733757;;M;38;CHILENO;;X;ILLAPEL                       ;COQUIMBO;392471;3;3;0;0;0;3;3;392471;Horno Electrico TH-100i 100Lts;ELECTRODOMESTICOS
19796854;;F;24;CHILENO;;Z;ILLAPEL                       ;COQUIMBO;116960;4;2;0;0;0;4;2;116960;ASPIRADORA THOMAS TH-1640;ELECTRODOMESTICOS
14437416;;M;47;CHILENO;;X;RENCA                         ;METROPOLITANA;18990;1;1;1;1;18990;0;0;0;Licuadora Berry Blender Roja 1400 Vaso Vidrio;ELECTRODOMESTICOS
10152383;Casado;F;58;CHILENO;;Boomers;PROVIDENCIA                   ;METROPOLITANA;14990;1;1;0;0;0;1;1;14990;Hervidor Inox One Midea;ELECTRODOMESTICOS
10533675;;M;53;CHILENO;;X;N/D;N/D;206930;4;2;2;1;125980;2;1;80950;HORNO ELECTRICO DORTMUND 45 LITROS;ELECTRODOMESTICOS
5335489;;F;77;CHILENO;;Silencioso;RENCA                         ;METROPOLITANA;11990;1;1;0;0;0;1;1;11990;Plancha a Vapor 5001;ELECTRODOMESTICOS
11856526;;M;51;CHILENO;;X;RENCA                         ;METROPOLITANA;93980;2;1;2;1;93980;0;0;0;Multiolla Bioceramic Oster;ELECTRODOMESTICOS
4122192;;M;84;CHILENO;;Silencioso;SAN FERNANDO                  ;L.G.B.OÂ´HIGGINS;19990;1;1;0;0;0;1;1;19990;Hervidor Electrico TH-4515N 2Lts Negro;ELECTRODOMESTICOS
15624710;;F;38;CHILENO;;Millenial;MAIPU                         ;METROPOLITANA;79990;1;1;0;0;0;1;1;79990;Horno Microondas Digital UT-CLASSY720 20Lts;ELECTRODOMESTICOS
7717334;;M;66;CHILENO;;Boomers;LOS ALAMOS                    ;BIO BIO;200080;4;3;0;0;0;4;3;200080;Exprimidor de Jugo 407W 1Lts;ELECTRODOMESTICOS
18400721;;M;29;CHILENO;;Millenial;MOSTAZAL;O HIGGINS;328970;3;2;3;2;328970;0;0;0;Horno con Air Fryer 35Lt;ELECTRODOMESTICOS
25627866;;M;36;VENEZOLANO;;Extranjero;CALLE LARGA                   ;VALPARAISO;766940;6;4;2;1;219980;4;3;546960;Hervidor Electrico TH-4515N 2Lts Negro;ELECTRODOMESTICOS
8192268;;F;65;CHILENO;;Boomers;LA LIGUA                      ;VALPARAISO;597820;7;3;0;0;0;7;3;597820;Hervidor Electrico TH-4515N 2Lts Negro;ELECTRODOMESTICOS
25312429;;M;25;PERUANO;;Extranjero;CONCHALI                      ;METROPOLITANA;43980;2;2;0;0;0;2;2;43980;Hervidor Electrico TH-4212N 1,7Lts Negro;ELECTRODOMESTICOS
8588540;;F;64;CHILENO;;Boomers;CHILLAN                       ;BIO BIO;106980;2;2;0;0;0;2;2;106980;Hervidor Electrico UT-REIN17SS;ELECTRODOMESTICOS
17875595;;F;31;CHILENO;;Millenial;PROVIDENCIA                   ;METROPOLITANA;59990;1;1;1;1;59990;0;0;0;Batidora Pedestal UT-KLEIN700;ELECTRODOMESTICOS
15137287;;M;41;CHILENO;;X;PROVIDENCIA                   ;METROPOLITANA;109990;1;1;1;1;109990;0;0;0;Horno Electrico TH-80i 80Lts;ELECTRODOMESTICOS
19570649;Soltero;F;25;CHILENO;;Z;LA PINTANA                    ;METROPOLITANA;63970;3;2;0;0;0;3;2;63970;Aspiradora TH1407 Arrastre 1400Watts;ELECTRODOMESTICOS
14412099;;F;42;CHILENO;;X;LANCO                         ;LOS LAGOS;830920;8;6;2;1;180980;6;5;649940;Tostador de Pan TH-116 2 Rebanadas Negro;ELECTRODOMESTICOS
8612108;;M;57;CHILENO;;Boomers;QUILPUE                       ;VALPARAISO;52721;3;2;0;0;0;3;2;52721;Licuadora L2000VNG 1,5Lts Vaso Vidrio;ELECTRODOMESTICOS
13910012;;M;41;CHILENO;;X;PALMILLA;O HIGGINS;354150;11;5;0;0;0;11;5;354150;Horno Microondas Mecanico TH-18B05 18Lts;ELECTRODOMESTICOS
16821716;;M;34;CHILENO;;Silencioso;PROVIDENCIA                   ;METROPOLITANA;854970;3;2;3;2;854970;0;0;0;CAFETERA PRIMA LATTE 6603 ROJA;ELECTRODOMESTICOS
6493008;;M;69;CHILENO;;Silencioso;PARRAL                        ;MAULE;352460;4;3;0;0;0;4;3;352460;Freidora de Aire 18M Oster;ELECTRODOMESTICOS
13482663;;M;44;CHILENO;;X;RENCA;METROPOLITANA;144980;3;2;2;1;119990;1;1;24990;Cafetera TH-138i;ELECTRODOMESTICOS
7565741;;M;64;CHILENO;;Boomers;"";"";69990;1;1;0;0;0;1;1;69990;Horno Microondas Digital UT-CLASSY720 20Lts;ELECTRODOMESTICOS
18017380;;M;30;CHILENO;;Millenial;SAN BERNARDO                  ;METROPOLITANA;103980;2;1;2;1;103980;0;0;0;CAFETERA PRIMA LATTE 6603 ROJA;ELECTRODOMESTICOS
11221791;;M;54;CHILENO;;X;SAN FELIPE                    ;VALPARAISO;254980;2;2;0;0;0;2;2;254980;Horno Electrico TH62I 60Lts;ELECTRODOMESTICOS
12369217;;F;49;CHILENO;;X;PROVIDENCIA                   ;METROPOLITANA;84980;2;1;2;1;84980;0;0;0;Aspiradora Trapeadora Robot Ut-Excellenza (B);ELECTRODOMESTICOS
22649250;;M;26;CHILENO;;Extranjero;SAN BERNARDO                  ;METROPOLITANA;160910;8;3;8;3;160910;0;0;0;Horno Microondas Mecanico C1700N 17Lts Blanco;ELECTRODOMESTICOS
20267719;;M;22;CHILENO;;Silencioso;PROVIDENCIA                   ;METROPOLITANA;149980;2;2;2;2;149980;0;0;0;Horno Electrico TH-80i 80Lts;ELECTRODOMESTICOS
5515603;;F;75;CHILENO;;Silencioso;CALAMA                        ;ANTOFAGASTA;14990;1;1;0;0;0;1;1;14990;HERVIDOR HAMBURGO 2,0 LITROS;ELECTRODOMESTICOS
11678837;;F;52;CHILENO;;X;PROVIDENCIA                   ;METROPOLITANA;34990;1;1;0;0;0;1;1;34990;Licuadora Kaliman Negra con Teclas;ELECTRODOMESTICOS
13294452;;F;45;CHILENO;;Millenial;"";"";163980;2;1;2;1;163980;0;0;0;Maquina de Coser Janome Easy Jeans;ELECTRODOMESTICOS
16388118;;F;35;CHILENO;;Millenial;N/D;N/D;64990;1;1;0;0;0;1;1;64990;Aspiradora VCC4190V3E/XZS Arrastre 2000Watts;ELECTRODOMESTICOS
17152420;;F;33;CHILENO;;Millenial;N/D;N/D;106959;4;3;1;1;10990;3;2;95969;HERVIDOR COLONIA 1,7 LITROS;ELECTRODOMESTICOS
9550303;;F;59;CHILENO;;Boomers;RENCA                         ;METROPOLITANA;315960;4;2;0;0;0;4;2;315960;Hervidor Electrico Tetera HA-4100 4Lts Iox;ELECTRODOMESTICOS
5485690;;F;76;CHILENO;;Silencioso;LOS ANDES                     ;VALPARAISO;280340;5;3;0;0;0;5;3;280340;Batidora Vertical Stick Mixer 2609;ELECTRODOMESTICOS
17301008;;F;32;CHILENO;;Millenial;SAN FELIPE                    ;VALPARAISO;27980;2;1;0;0;0;2;1;27980;HERVIDOR HAMBURGO 2,0 LITROS;ELECTRODOMESTICOS
8912844;;M;62;CHILENO;;Boomers;SANTA BARBARA                 ;BIO BIO;69990;1;1;0;0;0;1;1;69990;Aspiradora UT-SILENT1804 Arrastre 1800Watts;ELECTRODOMESTICOS
11657782;;M;52;CHILENO;;X;PUENTE ALTO                   ;METROPOLITANA;36990;1;1;0;0;0;1;1;36990;HORNO ELECTRICO 16N01 16LTS NEGRO;ELECTRODOMESTICOS
19303980;;M;26;CHILENO;;Z;N/D;N/D;202950;5;3;2;1;62980;3;2;139970;Freidora electrica uno AF215D10 1470W;ELECTRODOMESTICOS
14511890;;M;42;CHILENO;;X;"";"";31990;1;1;0;0;0;1;1;31990;Wafflera time blanca WJ170112 700W;ELECTRODOMESTICOS
12958904;;F;46;CHILENO;;X;CURACAVI                      ;METROPOLITANA;106420;3;1;0;0;0;3;1;106420;Aspiradora TH1870 Arrastre 1800Watts Gris;ELECTRODOMESTICOS
9638291;;F;60;CHILENO;;Boomers;MELIPILLA                     ;METROPOLITANA;451300;6;5;0;0;0;6;5;451300;Horno Microondas Digital L UT-25KROMM 25Lts;ELECTRODOMESTICOS
18048837;;F;30;CHILENO;;Millenial;TRAIGUEN;ARAUCANIA;282552;5;4;0;0;0;5;4;282552;Batidora Vertical Multimixer TH-8720;ELECTRODOMESTICOS
16676866;;F;35;CHILENO;;Millenial;N/D;N/D;12990;1;1;0;0;0;1;1;12990;Hervidor Electrico TH-4212N 1,7Lts Negro;ELECTRODOMESTICOS
16635740;;M;35;CHILENO;;Millenial;PROVIDENCIA                   ;METROPOLITANA;279980;2;1;2;1;279980;0;0;0;Robot aspirador Roomba E5;ELECTRODOMESTICOS
26101361;;M;46;HAITIANO;;Extranjero;LAS CABRAS                    ;L.G.B.OÂ´HIGGINS;19990;1;1;0;0;0;1;1;19990;Hervidor Electrico UT-DUNKEL17P 2Lts Negro;ELECTRODOMESTICOS
11940427;;F;50;CHILENO;;X;ILLAPEL                       ;COQUIMBO;364970;3;3;0;0;0;3;3;364970;Batidora Pedestal TH910PN 4,6Lts 1300Watts;ELECTRODOMESTICOS
9031141;;F;60;CHILENO;;Boomers;INDEPENDENCIA                 ;METROPOLITANA;355690;4;3;0;0;0;4;3;355690;Horno Microondas Digital TH-25DM 25Lts;ELECTRODOMESTICOS
16460382;;F;35;CHILENO;;Millenial;BUIN                          ;METROPOLITANA;19990;1;1;0;0;0;1;1;19990;Licuadora Berry Blender Roja 1400 Vaso Vidrio;ELECTRODOMESTICOS
6686899;;M;67;CHILENO;;Boomers;TALCAHUANO                    ;BIO BIO;1001340;7;4;0;0;0;7;4;1001340;Licuadora Oster Clasica Azul 4134 1,25 lt;ELECTRODOMESTICOS
14143448;;M;41;CHILENO;;X;LA FLORIDA;METROPOLITANA;128940;6;3;6;3;128940;0;0;0;Horno Microondas Digital MMP-20GC3D 20Lts;ELECTRODOMESTICOS
19722832;;F;24;CHILENO;;Z;"";"";1469261;20;20;0;0;0;20;20;1469261;Horno Electrico UT-BACKOFEN26 26Lts;ELECTRODOMESTICOS
8177052;;F;63;CHILENO;;Boomers;PALMILLA                      ;L.G.B.OÂ´HIGGINS;357022;8;4;0;0;0;8;4;357022;SUPER FREIDORA DE AIRE OV3;ELECTRODOMESTICOS
12599461;;F;47;CHILENO;;X;PUTAENDO                      ;VALPARAISO;58211;2;1;0;0;0;2;1;58211;Aspiradora VCC4190V3E/XZS Arrastre 2000Watts;ELECTRODOMESTICOS
11558584;;M;51;CHILENO;;X;CURICO                        ;MAULE;742931;8;4;0;0;0;8;4;742931;FREIDORA DE AIRE THOMAS TH-AF60Mi;ELECTRODOMESTICOS
7709225;;F;67;CHILENO;;Boomers;CORONEL                       ;BIO BIO;37990;1;1;1;1;37990;0;0;0;Horno Electrico TH-25N01 25Lts;ELECTRODOMESTICOS
7227789;Casado;F;65;CHILENO;;Boomers;MAIPU                         ;METROPOLITANA;119990;2;1;0;0;0;2;1;119990;Maquina de coser Singer 1605;ELECTRODOMESTICOS
18794467;;M;28;CHILENO;;Millenial;EL BOSQUE                     ;METROPOLITANA;32990;1;1;0;0;0;1;1;32990;Combo Juguera + Hervidor;ELECTRODOMESTICOS
10268953;;F;54;CHILENO;;Boomers;"";"";44990;1;1;0;0;0;1;1;44990;HERVIDOR TETERA RELOJ 900R 2,5L ROJO;ELECTRODOMESTICOS
9446832;;M;59;CHILENO;;Boomers;RENCA                         ;METROPOLITANA;87960;3;1;3;1;87960;0;0;0;ASPIRADORA THOMAS TH-1022C;ELECTRODOMESTICOS
17067177;;M;33;CHILENO;;Millenial;VALDIVIA                      ;LOS LAGOS;12990;1;1;0;0;0;1;1;12990;Exprimidor Fauna 500 cc;ELECTRODOMESTICOS
13531629;;M;43;CHILENO;;X;PROVIDENCIA                   ;METROPOLITANA;21990;1;1;0;0;0;1;1;21990;Hervidor Electrico TH-5407i 2Lts;ELECTRODOMESTICOS
17435494;;F;33;CHILENO;;Millenial;PROVIDENCIA                   ;METROPOLITANA;352460;4;2;2;1;52480;2;1;299980;Horno Microondas Mecanico C1700N 17Lts Blanco;ELECTRODOMESTICOS
14587576;;M;40;CHILENO;;X;MACUL;METROPOLITANA;143980;2;1;2;1;143980;0;0;0;CAFETERA PRIMA LATTE 6603 ROJA;ELECTRODOMESTICOS
23951455;;M;49;VENEZOLANO;;Extranjero;PROVIDENCIA                   ;METROPOLITANA;63980;2;1;2;1;63980;0;0;0;Aspiradora Mi Robot Vacuum-Mop Essential;ELECTRODOMESTICOS
19394766;;F;25;CHILENO;;Z;LA LIGUA;VALPARAISO;126190;7;5;2;1;59980;5;4;66210;HERVIDOR HAMBURGO 2,0 LITROS;ELECTRODOMESTICOS
20588978;;F;21;CHILENO;;Z;PROVIDENCIA                   ;METROPOLITANA;112980;2;2;1;1;79990;1;1;32990;FREIDORA DE AIRE THOMAS TH-AF60Mi;ELECTRODOMESTICOS
15024577;;F;40;CHILENO;;X;PROVIDENCIA                   ;METROPOLITANA;30980;2;1;0;0;0;2;1;30980;Tostador de Pan TH-116 2 Rebanadas Negro;ELECTRODOMESTICOS
18561316;;M;29;CHILENO;;Millenial;MAIPU                         ;METROPOLITANA;65450;2;1;0;0;0;2;1;65450;Horno Microondas Mecanico Easy Wave 20Lts;ELECTRODOMESTICOS
19707768;;F;24;CHILENO;;Extranjero;COLINA                        ;METROPOLITANA;129990;1;1;0;0;0;1;1;129990;SUPER FREIDORA DE AIRE OV3;ELECTRODOMESTICOS
18542346;;F;28;CHILENO;;Millenial;PELLUHUE                      ;MAULE;117980;2;2;0;0;0;2;2;117980;Horno Electrico TH-25N01 25Lts;ELECTRODOMESTICOS
18571484;;F;29;CHILENO;;Millenial;"";"";44990;1;1;0;0;0;1;1;44990;Horno Electrico TH-25N01 25Lts;ELECTRODOMESTICOS
18140888;;F;30;CHILENO;;Millenial;CALDERA                       ;ATACAMA;36990;1;2;0;0;0;1;2;36990;Combo Hervidor + Tostador + Sandwichera;ELECTRODOMESTICOS
12392603;;F;51;CHILENO;;X;RENCA                         ;METROPOLITANA;113980;2;1;2;1;113980;0;0;0;SUPER FREIDORA DE AIRE OV3;ELECTRODOMESTICOS
13571927;;F;46;CHILENO;;X;SANTA CRUZ                    ;L.G.B.OÂ´HIGGINS;39990;1;1;0;0;0;1;1;39990;Freidora de Aire 18M Oster;ELECTRODOMESTICOS
6538056;Soltero;F;72;CHILENO;;Silencioso;RENCA                         ;METROPOLITANA;64980;2;2;0;0;0;2;2;64980;Batidora Vertical Multimixer TH-8720;ELECTRODOMESTICOS
8688990;;M;62;CHILENO;;Boomers;RENCA                         ;METROPOLITANA;69980;2;2;0;0;0;2;2;69980;Hervidor Electrico Tetera TH-6505RT 1,7Lts Rojo;ELECTRODOMESTICOS
19569657;;M;25;CHILENO;;Z;EL BOSQUE                     ;METROPOLITANA;1321940;6;3;6;3;1321940;0;0;0;SUPER FREIDORA DE AIRE OV3;ELECTRODOMESTICOS
5881690;;F;74;CHILENO;;Silencioso;N/D;N/D;47960;4;1;0;0;0;4;1;47960;Batidora Manual UT-TEKLA300;ELECTRODOMESTICOS
16364747;;F;35;CHILENO;;Millenial;COIHAIQUE                     ;AYSEN;105600;2;1;0;0;0;2;1;105600;Horno Microondas Mecanico M-2020NG 20Lts;ELECTRODOMESTICOS
19511941;;M;24;CHILENO;;Z;N/D;N/D;149970;3;2;0;0;0;3;2;149970;Horno electrico Black Oven 42lts;ELECTRODOMESTICOS
24779760;;M;41;PERUANO;;Extranjero;N/D;N/D;82980;2;2;0;0;0;2;2;82980;Licuadora Oster Clasica Azul 4134 1,25 lt;ELECTRODOMESTICOS
19146195;Soltero;F;27;CHILENO;;Z;N/D;N/D;49990;1;1;1;1;49990;0;0;0;FREIDORA DE AIRE BAVIERA 3,8 LITROS;ELECTRODOMESTICOS
24692843;;M;26;BOLIVIANO;;Extranjero;N/D;N/D;259250;4;2;0;0;0;4;2;259250;Licuadora Kaliman Negra con Teclas;ELECTRODOMESTICOS
13098861;;M;45;CHILENO;;X;RENCA                         ;METROPOLITANA;283680;3;1;0;0;0;3;1;283680;Aspiradora Trapeadora Robot Ut-Excellenza (B);ELECTRODOMESTICOS
5385525;;M;73;CHILENO;;Silencioso;RENCA                         ;METROPOLITANA;24990;1;1;0;0;0;1;1;24990;HORNO 10 LITROS OSTER ROJO;ELECTRODOMESTICOS
10921570;;F;47;CHILENO;;X;RIO IBANEZ                    ;AYSEN;145900;3;2;0;0;0;3;2;145900;Maquina de coser Singer 1605;ELECTRODOMESTICOS
11764602;;F;51;CHILENO;;X;SAN JAVIER                    ;MAULE;12420;0;2;0;0;0;0;2;12420;HORNO ELECTRICO HE-600IN INOX SINDELEN;ELECTRODOMESTICOS
8564408;;F;64;CHILENO;;Boomers;LA PINTANA                    ;METROPOLITANA;1126150;12;8;6;3;443950;6;5;682200;Picadora TH-9020V Vaso Vidrio 2Lts;ELECTRODOMESTICOS
3947841;;M;83;CHILENO;;Silencioso;CALAMA                        ;ANTOFAGASTA;149990;1;1;0;0;0;1;1;149990;Maquina de Coser VX1445 con 14 puntadas;ELECTRODOMESTICOS
11515031;;M;53;CHILENO;;X;N/D;N/D;24990;1;1;0;0;0;1;1;24990;LICUADORA HANOVER 1,5 LITROS;ELECTRODOMESTICOS
9711180;;F;60;CHILENO;;Boomers;RENCA                         ;METROPOLITANA;142680;3;1;0;0;0;3;1;142680;HORNO ELECTRICO HE-600IN INOX SINDELEN;ELECTRODOMESTICOS
7903342;;F;62;CHILENO;;Boomers;PUERTO MONTT                  ;LOS LAGOS;34990;1;1;1;1;34990;0;0;0;Aspiradora AP1700 Arrastre 1700Watts;ELECTRODOMESTICOS
15523909;;F;39;CHILENO;;X;PROVIDENCIA                   ;METROPOLITANA;34990;1;1;0;0;0;1;1;34990;Licuadora BL1500 Silver 1,75Lts Vaso Vidrio;ELECTRODOMESTICOS
18733839;Soltero;F;31;CHILENO;;Millenial;PROVIDENCIA                   ;METROPOLITANA;129990;1;1;0;0;0;1;1;129990;SUPER FREIDORA DE AIRE OV3;ELECTRODOMESTICOS
19337054;;M;26;CHILENO;;Millenial;N/D;N/D;24990;1;1;0;0;0;1;1;24990;HORNO 10 LITROS OSTER ROJO;ELECTRODOMESTICOS
12411354;;M;48;CHILENO;;X;CERRO NAVIA                   ;METROPOLITANA;1528360;9;3;0;0;0;9;3;1528360;MICROONDAS ME83X/XZS SAMSUNG MIRROR;ELECTRODOMESTICOS
18639023;Soltero;M;28;CHILENO;;Silencioso;PROVIDENCIA                   ;METROPOLITANA;2305845;14;6;14;6;2305845;0;0;0;Robot aspirador Roomba 675;ELECTRODOMESTICOS
14545398;Casado;M;41;CHILENO;;X;RENCA                         ;METROPOLITANA;179990;1;1;0;0;0;1;1;179990;Horno Electrico TH-100i 100Lts;ELECTRODOMESTICOS
18838000;;F;27;CHILENO;;Millenial;PROVIDENCIA                   ;METROPOLITANA;299460;4;2;2;1;92480;2;1;206980;Horno Electrico TH-48N 48Lts;ELECTRODOMESTICOS
25727951;Soltero;M;31;PERUANO;;Extranjero;COLINA;METROPOLITANA;63980;2;1;2;1;63980;0;0;0;Licuadora Reversible Roja;ELECTRODOMESTICOS
11541562;Soltero;M;52;CHILENO;;X;PROVIDENCIA                   ;METROPOLITANA;19990;1;1;0;0;0;1;1;19990;Hervidor Electrico TH-4515N 2Lts Negro;ELECTRODOMESTICOS
20211435;;M;22;CHILENO;;Silencioso;PROVIDENCIA                   ;METROPOLITANA;49990;1;1;0;0;0;1;1;49990;Aspiradora Tambor APA1000 1000Watts;ELECTRODOMESTICOS
8170897;;F;60;CHILENO;;Boomers;SAN VICENTE                   ;L.G.B.OÂ´HIGGINS;36990;1;1;0;0;0;1;1;36990;Licuadora TH-401V Roja 1,75Lts Vaso Vidrio;ELECTRODOMESTICOS
11714553;;M;50;CHILENO;;X;PUERTO MONTT                  ;LOS LAGOS;49990;1;1;0;0;0;1;1;49990;FREIDORA DE AIRE BAVIERA 3,8 LITROS;ELECTRODOMESTICOS
10288057;;F;50;CHILENO;;X;LINARES                       ;MAULE;1512700;22;17;0;0;0;22;17;1512700;LICUADORA CROMADA CON TECLAS PLUS;ELECTRODOMESTICOS
16615948;;F;35;CHILENO;;Millenial;FREIRE;ARAUCANIA;54970;3;1;3;1;54970;0;0;0;Combo Hervidor + Tostador + Sandwichera;ELECTRODOMESTICOS
13811884;;M;43;CHILENO;;X;MAIPU;METROPOLITANA;153430;5;1;0;0;0;5;1;153430;Horno Microondas Digital MS23K3513AK/ZS 23Lts;ELECTRODOMESTICOS
16582945;;M;35;CHILENO;;Millenial;"";"";179460;4;2;4;2;179460;0;0;0;Horno Microondas Digital Deli (2017 DM) 20Lts;ELECTRODOMESTICOS
13308477;;M;45;CHILENO;;X;N/D;N/D;44990;1;1;0;0;0;1;1;44990;HERVIDOR TETERA RELOJ 900R 2,5L ROJO;ELECTRODOMESTICOS
11727096;;M;50;CHILENO;;X;N/D;N/D;513940;6;4;3;2;275970;3;2;237970;FREIDORA DE AIRE HESSIA 2,0 LITROS;ELECTRODOMESTICOS
26501838;;M;35;VENEZOLANO;;Extranjero;N/D;N/D;43980;2;1;2;1;43980;0;0;0;Horno Microondas Mecanico C1700N 17Lts Blanco;ELECTRODOMESTICOS
7903141;;M;67;CHILENO;;Boomers;PUENTE ALTO                   ;METROPOLITANA;508960;4;4;0;0;0;4;4;508960;HERVIDOR TH-4340;ELECTRODOMESTICOS
8529851;;M;55;CHILENO;;Boomers;OVALLE                        ;COQUIMBO;432350;9;4;0;0;0;9;4;432350;HORNO ELECTRICO BREMEN 23 LITROS;ELECTRODOMESTICOS
9765800;;F;59;CHILENO;;Boomers;RENCA                         ;METROPOLITANA;19990;1;1;0;0;0;1;1;19990;Hervidor Electrico TH-4515N 2Lts Negro;ELECTRODOMESTICOS
16858021;;F;34;CHILENO;;Millenial;PROVIDENCIA                   ;METROPOLITANA;33970;3;1;0;0;0;3;1;33970;Hervidor Electrico TH-4212N 1,7Lts Negro;ELECTRODOMESTICOS
26491836;;F;27;NO INFORMA NACIONALIDAD;;Extranjero;ARICA                         ;TARAPACA;39990;1;1;1;1;39990;0;0;0;Batidora de Mano y Pedestal 3612;ELECTRODOMESTICOS
22637985;;F;40;CHILENO;;Extranjero;POZO ALMONTE                  ;TARAPACA;33991;1;1;0;0;0;1;1;33991;LICUADORA CROMADA CON TECLAS PLUS;ELECTRODOMESTICOS
12573077;;F;48;CHILENO;;X;RENCA                         ;METROPOLITANA;31990;1;1;0;0;0;1;1;31990;Extractor de Jugo EX800 1,4Lts;ELECTRODOMESTICOS
26797859;;F;37;EXTRANJERO - NO INFORMA NACIONALIDAD;;Extranjero;"";"";99990;1;1;0;0;0;1;1;99990;FREIDORA DE AIRE THOMAS TH-AF60Mi;ELECTRODOMESTICOS
8310944;;M;59;CHILENO;;Boomers;RENCA                         ;METROPOLITANA;44990;1;1;0;0;0;1;1;44990;Horno Electrico TH-25N01 25Lts;ELECTRODOMESTICOS
17595776;Soltero;F;30;CHILENO;TECNICO;Millenial;PROVIDENCIA                   ;METROPOLITANA;98970;3;2;0;0;0;3;2;98970;Horno Electrico UT-BACKOFEN26 26Lts;ELECTRODOMESTICOS
18415233;;F;29;CHILENO;;Millenial;PROVIDENCIA                   ;METROPOLITANA;9990;1;1;1;1;9990;0;0;0;Exprimidor de Jugo CJ-2000 1Lts;ELECTRODOMESTICOS
8837346;Casado;F;65;CHILENO;;Boomers;RENCA                         ;METROPOLITANA;54990;1;1;0;0;0;1;1;54990;Horno Microondas Mecanico Easy Wave 20Lts;ELECTRODOMESTICOS
15529555;;M;38;CHILENO;;Millenial;CORONEL                       ;BIO BIO;19990;1;1;0;0;0;1;1;19990;Batidora Manual TH-8830;ELECTRODOMESTICOS
20141784;;F;22;CHILENO;;Z;"";"";99970;3;1;0;0;0;3;1;99970;Licuadora Kaliman Negra con Teclas;ELECTRODOMESTICOS
13903421;Casado;M;42;CHILENO;;X;PROVIDENCIA                   ;METROPOLITANA;44990;1;1;1;1;44990;0;0;0;Horno Microondas Mecanico Fancy 20Lts;ELECTRODOMESTICOS
9398569;;M;59;CHILENO;;Boomers;LA LIGUA                      ;VALPARAISO;17990;1;1;0;0;0;1;1;17990;HERVIDOR TH-4340;ELECTRODOMESTICOS
7383949;Viudo;M;68;CHILENO;;Boomers;CORONEL                       ;BIO BIO;28990;1;1;0;0;0;1;1;28990;Hervidor Electrico Tetera UT-LECKER18R 1,8Lts;ELECTRODOMESTICOS
6825991;;M;70;CHILENO;;Silencioso;GRANEROS                      ;L.G.B.OÂ´HIGGINS;807930;7;4;0;0;0;7;4;807930;Batidora Vertical Minipimer UT-KLOT400P;ELECTRODOMESTICOS
9646389;;F;57;CHILENO;;Boomers;QUILPUE                       ;VALPARAISO;99960;4;2;0;0;0;4;2;99960;Hervidor Electrico Tetera TH-6505RT 1,7Lts Rojo;ELECTRODOMESTICOS
7516006;;M;63;CHILENO;;Boomers;VINA DEL MAR                  ;VALPARAISO;20000;2;1;0;0;0;2;1;20000;Hervidor Electrico UT-DUNKEL17P 2Lts Negro;ELECTRODOMESTICOS
8556008;;F;52;CHILENO;;X;N/D;N/D;182970;3;3;0;0;0;3;3;182970;Hervidor Electrico TH-5407i 2Lts;ELECTRODOMESTICOS
12140199;;M;42;CHILENO;;X;PROVIDENCIA                   ;METROPOLITANA;27990;1;1;0;0;0;1;1;27990;Plancha THOMAS TH-7170 2200Watts Base Ceramica;ELECTRODOMESTICOS
14055125;;M;41;CHILENO;;X;TALCA                         ;MAULE;62980;2;1;0;0;0;2;1;62980;Licuadora TH-501V 1,5Lts Vaso Vidrio;ELECTRODOMESTICOS
11783658;;F;50;CHILENO;;X;N/D;N/D;191860;3;2;2;1;143980;1;1;47880;CAFETERA PRIMA LATTE 6603 ROJA;ELECTRODOMESTICOS
9136520;Soltero;M;58;CHILENO;;Boomers;RENCA                         ;METROPOLITANA;346960;4;3;3;2;324970;1;1;21990;Aspiradora Trapeadora Robot Ut-Excellenza (B);ELECTRODOMESTICOS
16612059;Soltero;M;33;CHILENO;INGENIERO EN ADMINISTRACION DE EMPRESAS;Silencioso;PROVIDENCIA                   ;METROPOLITANA;143980;2;1;2;1;143980;0;0;0;Cafetera De Longhi Dedica Roja EC 685 R;ELECTRODOMESTICOS
13451350;;F;44;CHILENO;;X;PROVIDENCIA                   ;METROPOLITANA;17990;1;1;0;0;0;1;1;17990;Batidora Manual 3532;ELECTRODOMESTICOS
8599744;Casado;F;63;CHILENO;;Boomers;SAN JAVIER                    ;MAULE;54980;2;1;0;0;0;2;1;54980;Hervidor Electrico Tetera TH-6505RT 1,7Lts Rojo;ELECTRODOMESTICOS
7798041;;M;65;CHILENO;;Boomers;COIHAIQUE                     ;AYSEN;57201;2;1;0;0;0;2;1;57201;Aspiradora TH1415 Arrastre 1500Watts;ELECTRODOMESTICOS
17735972;;M;31;CHILENO;;Millenial;PROVIDENCIA                   ;METROPOLITANA;23990;1;1;0;0;0;1;1;23990;Olla Arrocera OA-400NG 1,8Lts;ELECTRODOMESTICOS
13811236;Soltero;M;45;CHILENO;;X;NUEVA IMPERIAL                ;ARAUCANIA;15990;1;1;0;0;0;1;1;15990;Hervidor Electrico TH-4212N 1,7Lts Negro;ELECTRODOMESTICOS
19384637;;F;25;CHILENO;;Z;PROVIDENCIA                   ;METROPOLITANA;85950;5;3;4;1;35960;1;2;49990;Horno Microondas Mecanico Easy Wave 20Lts;ELECTRODOMESTICOS
16123235;Soltero;M;37;CHILENO;ABOGADO;Silencioso;PROVIDENCIA                   ;METROPOLITANA;83980;2;1;2;1;83980;0;0;0;Batidora Berry Mixer (KM3000) 1300 watts;ELECTRODOMESTICOS
26520757;;M;34;HAITIANO;;Extranjero;EL MONTE                      ;METROPOLITANA;387850;5;6;0;0;0;5;6;387850;HERVIDOR BERLIN 1,7 LITROS;ELECTRODOMESTICOS
13422683;;F;45;CHILENO;;X;TIERRA AMARILLA               ;ATACAMA;661920;7;5;0;0;0;7;5;661920;Batidora Vertical Stick Mixer 2609;ELECTRODOMESTICOS
19201527;;M;45;CHILENO;;X;VINA DEL MAR                  ;VALPARAISO;39990;1;1;0;0;0;1;1;39990;Licuadora Osterizer 4112/72 1,25Lts Vaso Vidrio;ELECTRODOMESTICOS
18390771;;F;29;CHILENO;;Silencioso;PROVIDENCIA                   ;METROPOLITANA;253980;2;1;2;1;253980;0;0;0;Mi Vacuum Cleaner G10 - 28671;ELECTRODOMESTICOS
7462376;;M;66;CHILENO;;Boomers;PADRE LAS CASAS               ;ARAUCANIA;547360;5;3;0;0;0;5;3;547360;HORNO ELECTRICO BREMEN 23 LITROS;ELECTRODOMESTICOS
17140986;;F;33;CHILENO;;Millenial;VALPARAISO                    ;VALPARAISO;125972;3;4;0;0;0;3;4;125972;Hervidor Electrico TH-4515N 2Lts Negro;ELECTRODOMESTICOS
5118225;;F;77;CHILENO;;Silencioso;RENCA                         ;METROPOLITANA;61980;2;1;0;0;0;2;1;61980;Horno Electrico TH-25N01 25Lts;ELECTRODOMESTICOS
9073827;;M;79;CHILENO;;Silencioso;COPIAPO                       ;ATACAMA;14990;1;1;0;0;0;1;1;14990;HERVIDOR HAMBURGO 2,0 LITROS;ELECTRODOMESTICOS
24863612;;F;38;ECUATORIANO;;Extranjero;N/D;N/D;213150;4;2;0;0;0;4;2;213150;FREIDORA DE AIRE THOMAS TH-AF60Mi;ELECTRODOMESTICOS
10653477;;F;56;CHILENO;;Boomers;BUIN                          ;METROPOLITANA;25980;2;2;0;0;0;2;2;25980;TOSTADOR OLDEMBURGO 2 REBANADAS;ELECTRODOMESTICOS
6835628;;F;70;CHILENO;;Silencioso;LA CISTERNA                   ;METROPOLITANA;505670;11;5;0;0;0;11;5;505670;Hervidor Family Kettle HE500;ELECTRODOMESTICOS
12001342;;F;56;CHILENO;;Boomers;ILLAPEL                       ;COQUIMBO;181463;3;2;0;0;0;3;2;181463;HERVIDOR BERLIN 1,7 LITROS;ELECTRODOMESTICOS
18552406;;M;29;CHILENO;;Millenial;QUILPUE                       ;VALPARAISO;85980;2;1;2;1;85980;0;0;0;Batidora Berry Mixer (KM3000) 1300 watts;ELECTRODOMESTICOS
18152871;;F;30;CHILENO;;Millenial;COLINA;METROPOLITANA;129990;1;1;0;0;0;1;1;129990;Maquina de Coser VX1445 con 14 puntadas;ELECTRODOMESTICOS
5980458;;F;71;CHILENO;;Silencioso;ANGOL                         ;ARAUCANIA;49990;1;1;0;0;0;1;1;49990;Aspiradora TH1415 Arrastre 1500Watts;ELECTRODOMESTICOS
19971715;;F;23;CHILENO;;Z;N/D;N/D;322542;5;4;0;0;0;5;4;322542;Batidora Pedestal TH910PN 4,6Lts 1300Watts;ELECTRODOMESTICOS
11542797;;M;53;CHILENO;;X;OSORNO                        ;LOS LAGOS;94990;1;1;0;0;0;1;1;94990;Horno Electrico TH62I 60Lts;ELECTRODOMESTICOS
7912269;;M;65;CHILENO;;Boomers;RENCA                         ;METROPOLITANA;47990;1;1;0;0;0;1;1;47990;Picadora TH-9020V Vaso Vidrio 2Lts;ELECTRODOMESTICOS
7134438;;F;68;CHILENO;;Boomers;LA SERENA                     ;COQUIMBO;44980;2;2;0;0;0;2;2;44980;Extractor de Jugo EX800 1,4Lts;ELECTRODOMESTICOS
8262915;;F;62;CHILENO;;Boomers;TALAGANTE                     ;METROPOLITANA;90970;3;1;0;0;0;3;1;90970;Freidora electrica Ut-KeramikAir;ELECTRODOMESTICOS
11961239;;M;50;CHILENO;;X;VILLARICA                     ;ARAUCANIA;0;0;2;0;0;0;0;2;0;Horno Electrico TH-48N 48Lts;ELECTRODOMESTICOS
16287036;;F;35;CHILENO;;Millenial;"";"";104200;6;4;0;0;0;6;4;104200;HERVIDOR HAMBURGO 2,0 LITROS;ELECTRODOMESTICOS
10981404;Soltero;M;52;CHILENO;;X;SAN CARLOS                    ;BIO BIO;54990;1;1;0;0;0;1;1;54990;Horno Electrico TH-38N 38Lts;ELECTRODOMESTICOS
15288998;;M;40;CHILENO;;X;ANCUD                         ;LOS LAGOS;914410;13;5;0;0;0;13;5;914410;Parrilla Electrica TH-224;ELECTRODOMESTICOS
18975581;;F;27;CHILENO;;Millenial;N/D;N/D;110940;6;3;2;1;20980;4;2;89960;Hervidor Family Kettle HE500;ELECTRODOMESTICOS
26555297;;M;28;VENEZOLANO;;Extranjero;N/D;N/D;358530;3;2;2;1;308540;1;1;49990;Aspiradora VCC4190V3E/XZS Arrastre 2000Watts;ELECTRODOMESTICOS
15156928;;M;40;CHILENO;;X;N/D;N/D;82950;5;1;0;0;0;5;1;82950;Licuadora L-1630V Negra 1,5Lts Vaso Vidrio;ELECTRODOMESTICOS
25533059;;M;42;PERUANO;;Extranjero;ILLAPEL                       ;COQUIMBO;429900;4;2;0;0;0;4;2;429900;Licuadora Roja 550W 1,5Lts Vaso Vidrio;ELECTRODOMESTICOS
13836803;;F;42;CHILENO;;X;PROVIDENCIA                   ;METROPOLITANA;14990;1;1;0;0;0;1;1;14990;Batidora Vertical Stick Mixer 2609;ELECTRODOMESTICOS
14272078;;F;48;CHILENO;;X;RANCAGUA                      ;L.G.B.OÂ´HIGGINS;49990;1;1;0;0;0;1;1;49990;Horno Microondas Mecanico Easy Wave 20Lts;ELECTRODOMESTICOS
7857702;Casado;F;64;CHILENO;CONTADOR GENERAL;Boomers;PROVIDENCIA                   ;METROPOLITANA;14990;1;1;0;0;0;1;1;14990;Batidora Vertical Stick Mixer 2609;ELECTRODOMESTICOS
16983628;;F;33;CHILENO;;Millenial;PROVIDENCIA                   ;METROPOLITANA;179980;2;2;0;0;0;2;2;179980;Horno Microondas Digital TH-25DM 25Lts;ELECTRODOMESTICOS
16820260;Soltero;F;34;CHILENO;TECNICO EN ADMINISTRACION DE EMPRESAS;Millenial;PROVIDENCIA                   ;METROPOLITANA;24980;2;2;0;0;0;2;2;24980;Hervidor Electrico 3101 1,7Lts Negro;ELECTRODOMESTICOS
7374864;;F;69;CHILENO;;Silencioso;MELIPILLA                     ;METROPOLITANA;19980;2;1;0;0;0;2;1;19980;Sandwichera TH-952 2 Panes Blanca;ELECTRODOMESTICOS
16008348;;M;37;CHILENO;;Millenial;NATALES                       ;MAGALLANES;10990;1;1;0;0;0;1;1;10990;Exprimidor de Jugo CJ-2000 1Lts;ELECTRODOMESTICOS
17130342;;F;33;CHILENO;;Millenial;N/D;N/D;145600;2;1;0;0;0;2;1;145600;Maquina de coser Singer 1605;ELECTRODOMESTICOS
16535445;Casado;F;35;CHILENO;ENFERMERA;Millenial;PROVIDENCIA                   ;METROPOLITANA;47990;1;1;0;0;0;1;1;47990;HERVIDOR TETERA RELOJ 900R 2,5L ROJO;ELECTRODOMESTICOS
9200030;;F;57;CHILENO;;Boomers;QUILPUE                       ;VALPARAISO;139990;1;1;0;0;0;1;1;139990;SUPER FREIDORA DE AIRE OV3;ELECTRODOMESTICOS
8301585;;F;50;CHILENO;;X;RENCA                         ;METROPOLITANA;54230;2;1;0;0;0;2;1;54230;Licuadora TH-501V 1,5Lts Vaso Vidrio;ELECTRODOMESTICOS
7643176;;M;63;CHILENO;;Boomers;N/D;N/D;102382;2;2;0;0;0;2;2;102382;Horno Microondas Digital TH-25DM 25Lts;ELECTRODOMESTICOS
8327275;;F;62;CHILENO;;Boomers;LOS ANDES                     ;VALPARAISO;12990;1;1;0;0;0;1;1;12990;Plancha Easy Steam (PV4500);ELECTRODOMESTICOS
13199160;;F;45;CHILENO;;X;RENCA                         ;METROPOLITANA;13240;2;1;0;0;0;2;1;13240;TOSTADOR OLDEMBURGO 2 REBANADAS;ELECTRODOMESTICOS
10489264;;F;58;CHILENO;;Boomers;RENCA                         ;METROPOLITANA;89980;2;2;0;0;0;2;2;89980;Horno Microondas Mecanico UT-SYDNEY18 18Lts;ELECTRODOMESTICOS
14059928;;F;41;CHILENO;;X;CORONEL                       ;BIO BIO;425803;3;2;0;0;0;3;2;425803;Hervidor Electrico Tetera UT-LECKER18R 1,8Lts;ELECTRODOMESTICOS
8246854;;M;63;CHILENO;;Boomers;PROVIDENCIA                   ;METROPOLITANA;16990;1;1;0;0;0;1;1;16990;Hervidor Electrico HA-3300 2,5Lts Blanco;ELECTRODOMESTICOS
20563327;;M;21;CHILENO;;Millenial;N/D;N/D;75250;4;1;0;0;0;4;1;75250;HERVIDOR TETERA RELOJ 900R 2,5L ROJO;ELECTRODOMESTICOS
15611964;;M;38;CHILENO;;Millenial;VINA DEL MAR                  ;VALPARAISO;34990;1;1;0;0;0;1;1;34990;Batidora Vertical Minipimer UT-KLOT400P;ELECTRODOMESTICOS
10649469;;F;57;CHILENO;;Boomers;RENCA                         ;METROPOLITANA;16990;1;1;0;0;0;1;1;16990;HERVIDOR TH-4340;ELECTRODOMESTICOS
14051266;;F;41;CHILENO;;X;CURICO                        ;MAULE;59990;1;1;0;0;0;1;1;59990;Horno electrico Black Oven 42lts;ELECTRODOMESTICOS
16701022;;F;34;CHILENO;;Millenial;LA LIGUA                      ;VALPARAISO;15990;1;1;0;0;0;1;1;15990;Batidora Vertical Stick Mixer 2609;ELECTRODOMESTICOS
13756233;;M;42;CHILENO;;X;PROVIDENCIA;METROPOLITANA;89960;4;2;4;2;89960;0;0;0;FREIDORA DE AIRE BAVIERA 3,8 LITROS;ELECTRODOMESTICOS
11176181;;F;55;CHILENO;;Silencioso;LINARES                       ;MAULE;464960;4;3;0;0;0;4;3;464960;Horno Electrico TH-100i 100Lts;ELECTRODOMESTICOS
17402685;;M;32;CHILENO;;Millenial;PROVIDENCIA                   ;METROPOLITANA;218960;4;1;4;1;218960;0;0;0;MICROONDAS ME83X/XZS SAMSUNG MIRROR;ELECTRODOMESTICOS
8813645;;M;54;CHILENO;;X;CONSTITUCION                  ;MAULE;255600;5;2;0;0;0;5;2;255600;Horno Microondas Digital L UT-25KROMM 25Lts;ELECTRODOMESTICOS
16052608;;F;36;CHILENO;;Millenial;ERCILLA                       ;ARAUCANIA;734720;5;4;0;0;0;5;4;734720;Hervidor Electrico Tetera UT-LECKER18R 1,8Lts;ELECTRODOMESTICOS
26044147;;M;41;EXTRANJERO - NO INFORMA NACIONALIDAD;;Extranjero;SAN BERNARDO                  ;METROPOLITANA;320240;3;2;0;0;0;3;2;320240;Horno Microondas Mecanico M-2020NG 20Lts;ELECTRODOMESTICOS
6654045;;M;68;CHILENO;;Silencioso;PROVIDENCIA                   ;METROPOLITANA;65250;2;1;0;0;0;2;1;65250;Aspiradora Tambor APA1000 1000Watts;ELECTRODOMESTICOS
10943822;;F;54;CHILENO;;X;RANCAGUA                      ;L.G.B.OÂ´HIGGINS;422970;3;3;0;0;0;3;3;422970;Plancha THOMAS TH-7170 2200Watts Base Ceramica;ELECTRODOMESTICOS
9335389;;F;61;CHILENO;;Boomers;RENCA                         ;METROPOLITANA;19990;1;1;0;0;0;1;1;19990;Hervidor Electrico Tetera UT-LECKER18R 1,8Lts;ELECTRODOMESTICOS
12261403;;F;50;CHILENO;;X;PROVIDENCIA                   ;METROPOLITANA;20240;2;1;0;0;0;2;1;20240;Licuadora Berry Blender Roja 1400 Vaso Vidrio;ELECTRODOMESTICOS
12393417;;M;49;CHILENO;;Silencioso;PROVIDENCIA                   ;METROPOLITANA;103960;4;2;3;1;83970;1;1;19990;Horno Electrico TH-25N01 25Lts;ELECTRODOMESTICOS
14101394;;F;40;CHILENO;;X;PUREN                         ;ARAUCANIA;16990;1;1;0;0;0;1;1;16990;Hervidor Family Kettle HE500;ELECTRODOMESTICOS
13159346;;F;45;CHILENO;;X;"";"";96520;4;2;4;2;96520;0;0;0;Combo Juguera + Hervidor;ELECTRODOMESTICOS
10005704;;F;56;CHILENO;;Boomers;N/D;N/D;179990;1;1;0;0;0;1;1;179990;Horno Electrico TH-100i 100Lts;ELECTRODOMESTICOS
13218769;;M;45;CHILENO;;X;TOCOPILLA                     ;ANTOFAGASTA;683950;5;5;0;0;0;5;5;683950;Licuadora TH-501V 1,5Lts Vaso Vidrio;ELECTRODOMESTICOS
9604173;;M;59;CHILENO;;Boomers;LA PINTANA                    ;METROPOLITANA;402960;4;2;0;0;0;4;2;402960;Picadora UT-PETRUS320 1Lts Vaso Vidrio;ELECTRODOMESTICOS
12836187;;M;48;CHILENO;;X;IQUIQUE                       ;TARAPACA;49990;1;1;0;0;0;1;1;49990;FREIDORA DE AIRE BAVIERA 3,8 LITROS;ELECTRODOMESTICOS
9454511;;F;60;CHILENO;;Boomers;LOS ANDES                     ;VALPARAISO;11240;2;1;0;0;0;2;1;11240;Exprimidor de Jugo CJ-2000 1Lts;ELECTRODOMESTICOS
25454963;;M;29;HAITIANO;;Extranjero;N/D;N/D;89970;3;3;0;0;0;3;3;89970;Licuadora TH-501V 1,5Lts Vaso Vidrio;ELECTRODOMESTICOS
12013571;;F;54;CHILENO;;X;ILLAPEL                       ;COQUIMBO;544960;4;5;0;0;0;4;5;544960;Parrilla Electrica TH-224;ELECTRODOMESTICOS
16418509;Soltero;F;35;CHILENO;;Millenial;PROVIDENCIA                   ;METROPOLITANA;54990;1;1;0;0;0;1;1;54990;Horno Microondas Mecanico Easy Wave 20Lts;ELECTRODOMESTICOS
17994994;;M;30;CHILENO;;Millenial;QUILPUE                       ;VALPARAISO;79990;1;1;0;0;0;1;1;79990;Horno Microondas Digital TH-25DM 25Lts;ELECTRODOMESTICOS
6922781;;F;72;CHILENO;;Silencioso;SAN JOAQUIN                   ;METROPOLITANA;29990;1;1;0;0;0;1;1;29990;Licuadora BL1500 Silver 1,75Lts Vaso Vidrio;ELECTRODOMESTICOS
18769489;;M;27;CHILENO;;Millenial;EL BOSQUE                     ;METROPOLITANA;39980;2;2;0;0;0;2;2;39980;Hervidor Electrico TH-5407i 2Lts;ELECTRODOMESTICOS
7152624;;F;73;CHILENO;;Silencioso;SAN FERNANDO                  ;L.G.B.OÂ´HIGGINS;29990;1;1;0;0;0;1;1;29990;Hervidor Electrico Tetera HA-4100 4Lts Iox;ELECTRODOMESTICOS
13772622;;F;42;CHILENO;;X;MELIPILLA                     ;METROPOLITANA;96091;2;1;0;0;0;2;1;96091;Horno Microondas Digital MS23K3513AK/ZS 23Lts;ELECTRODOMESTICOS
6263690;;M;67;CHILENO;;Boomers;BUIN                          ;METROPOLITANA;17990;1;1;0;0;0;1;1;17990;Hervidor Electrico UT-MANLY17 1,7Lts Negro;ELECTRODOMESTICOS
14711690;;F;43;NO INFORMA NACIONALIDAD;;Extranjero;QUILICURA                     ;METROPOLITANA;65250;2;1;0;0;0;2;1;65250;Licuadora Osterizer 4112/72 1,25Lts Vaso Vidrio;ELECTRODOMESTICOS
7909640;;F;66;CHILENO;;Boomers;RENGO                         ;L.G.B.OÂ´HIGGINS;60250;2;1;0;0;0;2;1;60250;Horno electrico Black Oven 42lts;ELECTRODOMESTICOS
4514177;;M;79;CHILENO;;Silencioso;CORONEL                       ;BIO BIO;47990;1;1;0;0;0;1;1;47990;Horno Electrico TH-25N01 25Lts;ELECTRODOMESTICOS
15108571;;F;38;CHILENO;;Millenial;CODEGUA                       ;L.G.B.OÂ´HIGGINS;556930;6;3;0;0;0;6;3;556930;Licuadora TH-501V 1,5Lts Vaso Vidrio;ELECTRODOMESTICOS
8044776;;M;64;CHILENO;;Boomers;BUIN                          ;METROPOLITANA;29990;1;1;0;0;0;1;1;29990;Procesador TH-9010 Multimixer 1,5Lts Vaso Vidrio;ELECTRODOMESTICOS
25784712;;M;26;ECUATORIANO;;Extranjero;ESTACION CENTRAL              ;METROPOLITANA;13990;1;1;0;0;0;1;1;13990;Hervidor Electrico 3101 1,7Lts Negro;ELECTRODOMESTICOS
12787823;;F;49;CHILENO;;X;RENCA                         ;METROPOLITANA;19990;1;1;0;0;0;1;1;19990;Hervidor Electrico Tetera UT-LECKER18R 1,8Lts;ELECTRODOMESTICOS
20106168;;F;23;CHILENO;;Z;VICTORIA                      ;ARAUCANIA;168970;3;2;1;1;99990;2;1;68980;Maquina de coser Singer 1605;ELECTRODOMESTICOS
19900125;;M;23;CHILENO;;Z;"";"";363660;5;3;0;0;0;5;3;363660;Batidora Pedestal TH910PN 4,6Lts 1300Watts;ELECTRODOMESTICOS
18368515;Soltero;F;29;CHILENO;;Millenial;PROVIDENCIA                   ;METROPOLITANA;38990;1;1;0;0;0;1;1;38990;Licuadora L1000 Inox 1,7LtsVaso Vidrio;ELECTRODOMESTICOS
8017326;Casado;M;68;CHILENO;;Silencioso;RENCA                         ;METROPOLITANA;111980;2;2;0;0;0;2;2;111980;Tostador de Pan TH-116 2 Rebanadas Negro;ELECTRODOMESTICOS
25659273;;F;40;PERUANO;;Extranjero;MAIPU                         ;METROPOLITANA;54410;2;1;0;0;0;2;1;54410;Freidora de Aire 18M Oster;ELECTRODOMESTICOS
9354254;;M;57;CHILENO;;Boomers;N/D;N/D;363950;5;3;0;0;0;5;3;363950;Batidora Pedestal TH910PN 4,6Lts 1300Watts;ELECTRODOMESTICOS
7180364;;F;69;CHILENO;;Silencioso;SAN FELIPE                    ;VALPARAISO;31990;1;1;0;0;0;1;1;31990;Extractor de Jugo EX800 1,4Lts;ELECTRODOMESTICOS
12164998;;F;48;CHILENO;;X;RENCA                         ;METROPOLITANA;91980;2;1;0;0;0;2;1;91980;Horno Microondas Digital TH-20S01 20Lts;ELECTRODOMESTICOS
8353401;;F;60;CHILENO;;Boomers;PROVIDENCIA                   ;METROPOLITANA;21990;1;1;0;0;0;1;1;21990;Licuadora L-1630V Negra 1,5Lts Vaso Vidrio;ELECTRODOMESTICOS
7168687;;M;69;CHILENO;;Silencioso;LINARES                       ;MAULE;14990;1;1;0;0;0;1;1;14990;Hervidor Electrico TH-4212N 1,7Lts Negro;ELECTRODOMESTICOS
7994666;;M;62;CHILENO;;Boomers;CONCEPCION                    ;BIO BIO;21990;1;1;0;0;0;1;1;21990;Licuadora L-1630V Negra 1,5Lts Vaso Vidrio;ELECTRODOMESTICOS
11546477;;F;52;CHILENO;;X;VINA DEL MAR                  ;VALPARAISO;54990;1;1;0;0;0;1;1;54990;Horno Microondas Mecanico UT-SYDNEY18 18Lts;ELECTRODOMESTICOS
11398795;Soltero;F;52;CHILENO;;X;RENCA                         ;METROPOLITANA;59980;2;1;0;0;0;2;1;59980;Tostador de Pan TH-126 4 Rebanadas Negro;ELECTRODOMESTICOS
9154529;;M;61;CHILENO;;Boomers;N/D;N/D;625030;6;4;0;0;0;6;4;625030;Horno Microondas Digital TH20DM 20Lts Espejado;ELECTRODOMESTICOS
10350572;;M;54;CHILENO;;X;SANTA CRUZ                    ;L.G.B.OÂ´HIGGINS;159980;2;2;0;0;0;2;2;159980;HORNO ELECTRICO 16N01 16LTS NEGRO;ELECTRODOMESTICOS
4967687;;F;79;CHILENO;;Silencioso;AISEN                         ;AYSEN;53230;2;1;0;0;0;2;1;53230;Licuadora L1000 Inox 1,7LtsVaso Vidrio;ELECTRODOMESTICOS
26237330;Soltero;M;50;VENEZOLANO;;Extranjero;CONSTITUCION;MAULE;399970;3;2;3;2;399970;0;0;0;Aspiradora AP3400 Arrastre 2000Watts;ELECTRODOMESTICOS
15136944;;M;39;CHILENO;;X;TALCA;MAULE;26240;2;1;0;0;0;2;1;26240;Plancha UT-KERAMIKTOP 2200Watts Base Ceramica;ELECTRODOMESTICOS
12664488;Casado;F;48;CHILENO;TECNICO EN TURISMO;X;PROVIDENCIA                   ;METROPOLITANA;14990;1;1;0;0;0;1;1;14990;Batidora Vertical Stick Mixer 2609;ELECTRODOMESTICOS
11105081;;F;55;CHILENO;;Boomers;TEMUCO                        ;ARAUCANIA;49980;2;2;0;0;0;2;2;49980;Batidora Manual TH-8830;ELECTRODOMESTICOS
4863970;;M;78;CHILENO;;Silencioso;PROVIDENCIA                   ;METROPOLITANA;20990;1;1;0;0;0;1;1;20990;Hervidor Electrico TH-4515N 2Lts Negro;ELECTRODOMESTICOS
17470056;;M;32;CHILENO;;Millenial;CONSTITUCION                  ;MAULE;49990;1;1;0;0;0;1;1;49990;FREIDORA DE AIRE BAVIERA 3,8 LITROS;ELECTRODOMESTICOS
13786328;;F;41;CHILENO;;X;LINARES                       ;MAULE;286970;3;3;0;0;0;3;3;286970;Aspiradora TH1407 Arrastre 1400Watts;ELECTRODOMESTICOS
16022101;;M;37;CHILENO;;Millenial;CABRERO                       ;BIO BIO;63960;3;1;3;1;63960;0;0;0;Hervidor Electrico Tetera UT-LECKER18R 1,8Lts;ELECTRODOMESTICOS
16304554;Soltero;F;36;CHILENO;;Millenial;RENCA                         ;METROPOLITANA;28990;1;1;0;0;0;1;1;28990;Plancha UT-KERAMIKTOP 2200Watts Base Ceramica;ELECTRODOMESTICOS
15665089;;F;38;CHILENO;;X;PROVIDENCIA                   ;METROPOLITANA;29990;1;1;1;1;29990;0;0;0;HORNO ELECTRICO 16N01 16LTS NEGRO;ELECTRODOMESTICOS
11040559;;F;56;CHILENO;;Boomers;LOS ALAMOS                    ;BIO BIO;736940;6;3;0;0;0;6;3;736940;Hervidor Electrico TH-4515N 2Lts Negro;ELECTRODOMESTICOS
17293784;;F;37;CHILENO;;Millenial;LA SERENA                     ;COQUIMBO;59990;1;1;0;0;0;1;1;59990;Horno Electrico UT-LEIF36 36Lts;ELECTRODOMESTICOS
8804355;;F;65;CHILENO;;Boomers;PROVIDENCIA                   ;METROPOLITANA;27990;1;1;0;0;0;1;1;27990;Plancha THOMAS TH-7170 2200Watts Base Ceramica;ELECTRODOMESTICOS
13875381;;F;42;CHILENO;;X; LA SERENA;COQUIMBO;79990;1;1;0;0;0;1;1;79990;Batidora Pedestal TH910PN 4,6Lts 1300Watts;ELECTRODOMESTICOS
19701847;;F;24;CHILENO;;Z;MEJILLONES                    ;ANTOFAGASTA;37980;2;2;0;0;0;2;2;37980;Licuadora Berry Blender Roja 1400 Vaso Vidrio;ELECTRODOMESTICOS
18099087;;F;30;CHILENO;;Millenial;LOS ANGELES                   ;BIO BIO;40480;2;1;2;1;40480;0;0;0;Aspiradora AP1700 Arrastre 1700Watts;ELECTRODOMESTICOS
20140483;;F;23;CHILENO;;Z;"";"";199980;2;2;0;0;0;2;2;199980;Licuadora Roja 550W 1,5Lts Vaso Vidrio;ELECTRODOMESTICOS
14087876;;F;41;CHILENO;;X;QUEMCHI                       ;LOS LAGOS;13990;1;1;0;0;0;1;1;13990;Hervidor Inox One Midea;ELECTRODOMESTICOS
15934188;;M;36;CHILENO;;Millenial;COLINA                        ;METROPOLITANA;17000;2;1;0;0;0;2;1;17000;Batidora Manual 3532;ELECTRODOMESTICOS
17827467;;F;30;CHILENO;;X;PROVIDENCIA                   ;METROPOLITANA;27980;2;1;0;0;0;2;1;27980;Batidora Vertical Stick Mixer 2609;ELECTRODOMESTICOS
10243048;;M;57;CHILENO;;Boomers;HUASCO                        ;ATACAMA;19980;2;1;0;0;0;2;1;19980;Hervidor Electrico TH-4212N 1,7Lts Negro;ELECTRODOMESTICOS
18114871;Casado;F;30;CHILENO;ABOGADO;Silencioso;PROVIDENCIA                   ;METROPOLITANA;79980;2;2;2;2;79980;0;0;0;ASPIRADORA ROBOT WIFI FIDDLER HOME BLANCA;ELECTRODOMESTICOS
15904267;;M;37;CHILENO;;Millenial;PUERTO MONTT                  ;LOS LAGOS;149990;1;1;0;0;0;1;1;149990;CAFETERA PRIMA LATTE 6603 ROJA;ELECTRODOMESTICOS
16005859;;M;37;CHILENO;;Millenial;N/D;N/D;69270;2;1;0;0;0;2;1;69270;Horno Microondas Mecanico M-2030 NG 20Lts;ELECTRODOMESTICOS
14403484;;M;51;CHILENO;;X;TALCAHUANO                    ;BIO BIO;31990;1;1;0;0;0;1;1;31990;Tostador de Pan TP-1400 4 Rebanadas Inox;ELECTRODOMESTICOS
16995746;;M;33;CHILENO;;Millenial;COMBARBALA                    ;COQUIMBO;20990;1;1;0;0;0;1;1;20990;Hervidor Electrico UT-DUNKEL17P 2Lts Negro;ELECTRODOMESTICOS
11742161;;F;51;CHILENO;;X;SAN RAMON                     ;METROPOLITANA;56980;2;2;0;0;0;2;2;56980;Cafetera UT-KAFFEEKLASSIK;ELECTRODOMESTICOS
11890379;;F;50;CHILENO;;X;QUILPUE                       ;VALPARAISO;66980;2;1;0;0;0;2;1;66980;Horno Microondas Mecanico Easy Wave 20Lts;ELECTRODOMESTICOS
15472353;;F;39;CHILENO;;X;CARTAGENA                     ;VALPARAISO;174970;3;2;0;0;0;3;2;174970;CAFETERA PRIMA LATTE 6603 ROJA;ELECTRODOMESTICOS
11885256;;M;51;CHILENO;;X;PROVIDENCIA                   ;METROPOLITANA;81930;7;2;7;2;81930;0;0;0;PLANCHA A VAPOR 4070 SUELA CERAMICA 2500W;ELECTRODOMESTICOS
13525010;Casado;M;44;CHILENO;CONTADOR AUDITOR;X;PROVIDENCIA                   ;METROPOLITANA;31990;1;1;0;0;0;1;1;31990;Licuadora TH-320 Roja/Negro 1,5 Lts Vaso Vidrio;ELECTRODOMESTICOS
12604440;;F;48;CHILENO;;X;SAN ANTONIO                   ;VALPARAISO;658940;6;5;0;0;0;6;5;658940;TERMOHERVIDOR ELECTRON 3,1 LTS BA-6932 RG;ELECTRODOMESTICOS
9501011;;F;60;CHILENO;;Boomers;ARICA                         ;ARICA Y PARINACOTA;29990;1;1;0;0;0;1;1;29990;PLANCHA A VAPOR 6953 BASE AEROCERAMICA AUTAPA.22;ELECTRODOMESTICOS
19897712;;F;24;CHILENO;;Z;PROVIDENCIA                   ;METROPOLITANA;0;0;2;0;0;0;0;2;0;Exprimidor de Jugo CJ-2000 1Lts;ELECTRODOMESTICOS
26097966;;F;48;EXTRANJERO - NO INFORMA NACIONALIDAD;;Extranjero;N/D;N/D;374330;6;4;2;1;33980;4;3;340350;Hervidor Electrico Tetera TH-6505RT 1,7Lts Rojo;ELECTRODOMESTICOS
18997727;Soltero;M;27;CHILENO;;Z;PROVIDENCIA                   ;METROPOLITANA;29990;1;1;1;1;29990;0;0;0;Hervidor Electrico Tetera HA-4100 4Lts Iox;ELECTRODOMESTICOS
9210548;;F;47;CHILENO;;X;N/D;N/D;179980;3;2;0;0;0;3;2;179980;HORNO ELECTRICO HE-600IN INOX SINDELEN;ELECTRODOMESTICOS
18095322;;F;30;CHILENO;;Millenial;PROVIDENCIA                   ;METROPOLITANA;59990;1;1;1;1;59990;0;0;0;Horno Electrico TH-48N 48Lts;ELECTRODOMESTICOS
19885949;;F;23;CHILENO;;Z;N/D;N/D;96210;7;3;2;1;53980;5;2;42230;Batidora Vertical Stick Mixer 2609;ELECTRODOMESTICOS
8033788;Casado;M;62;CHILENO;;Boomers;RENCA                         ;METROPOLITANA;21990;1;1;0;0;0;1;1;21990;Batidora Pedestal B5300 Inox;ELECTRODOMESTICOS
11476263;;F;52;CHILENO;;X;PROVIDENCIA                   ;METROPOLITANA;9990;1;1;0;0;0;1;1;9990;Plancha a Vapor Oster 3803;ELECTRODOMESTICOS
10561795;;F;57;CHILENO;;Boomers;TOCOPILLA                     ;ANTOFAGASTA;352920;8;3;0;0;0;8;3;352920;Batidora Vertical Multimixer TH-8720;ELECTRODOMESTICOS
17275941;Soltero;M;32;CHILENO;;Millenial;RENCA                         ;METROPOLITANA;566960;4;2;2;1;497980;2;1;68980;Horno Microondas Mecanico Easy Wave 20Lts;ELECTRODOMESTICOS
13202918;;F;45;CHILENO;;X;N/D;N/D;99980;2;1;0;0;0;2;1;99980;Horno Microondas Mecanico TH-18B05 18Lts;ELECTRODOMESTICOS
26668601;;M;33;VENEZOLANO;;Extranjero;LOS ANGELES                   ;BIO BIO;24990;1;1;0;0;0;1;1;24990;Licuadora L2000VNG 1,5Lts Vaso Vidrio;ELECTRODOMESTICOS
4620440;;M;77;CHILENO;;Silencioso;NUNOA                         ;METROPOLITANA;48980;2;1;0;0;0;2;1;48980;Aspiradora AP1700 Arrastre 1700Watts;ELECTRODOMESTICOS
26515003;;F;55;CHILENO;;Extranjero;PROVIDENCIA                   ;METROPOLITANA;48980;2;1;2;1;48980;0;0;0;Freidora de Aire 18M Oster;ELECTRODOMESTICOS
10648956;;M;55;CHILENO;;Boomers;RENCA                         ;METROPOLITANA;16980;2;1;2;1;16980;0;0;0;Cafetera TH-130;ELECTRODOMESTICOS
12392164;;F;48;CHILENO;;X;LLAILLAY                      ;VALPARAISO;69990;1;1;0;0;0;1;1;69990;Batidora Pedestal UT-KLEIN700;ELECTRODOMESTICOS
8269386;Casado;F;63;CHILENO;;Boomers;TALAGANTE                     ;METROPOLITANA;178960;4;4;0;0;0;4;4;178960;HORNO ELECTRICO MUNICH 60 LITROS;ELECTRODOMESTICOS
8154955;Casado;M;66;CHILENO;;Boomers;PAINE                         ;METROPOLITANA;201960;4;2;0;0;0;4;2;201960;Licuadora L-25000NG;ELECTRODOMESTICOS
9712437;;F;61;CHILENO;;Boomers;MONTE PATRIA                  ;COQUIMBO;0;0;2;0;0;0;0;2;0;Licuadora L2000VNG 1,5Lts Vaso Vidrio;ELECTRODOMESTICOS
13502693;;F;43;CHILENO;;X;RANCAGUA                      ;L.G.B.OÂ´HIGGINS;29990;1;1;0;0;0;1;1;29990;Combo Juguera + Hervidor;ELECTRODOMESTICOS
17969075;;M;30;CHILENO;;Millenial;ILLAPEL                       ;COQUIMBO;89990;1;1;0;0;0;1;1;89990;FREIDORA DE AIRE THOMAS TH-AF60Mi;ELECTRODOMESTICOS
8675334;;M;64;CHILENO;;Boomers;MARIA PINTO                   ;METROPOLITANA;148850;4;4;0;0;0;4;4;148850;Hervidor Electrico TH-5407i 2Lts;ELECTRODOMESTICOS
13938580;Soltero;F;42;CHILENO;;X;PROVIDENCIA                   ;METROPOLITANA;34990;1;1;0;0;0;1;1;34990;Batidora Vertical Minipimer UT-KLOT400P;ELECTRODOMESTICOS
18431366;;M;28;CHILENO;;Millenial;PROVIDENCIA                   ;METROPOLITANA;-236990;-1;2;-1;2;-236990;0;0;0;PLANCHA A VAPOR 4070 SUELA CERAMICA 2500W;ELECTRODOMESTICOS
7913656;Casado;M;65;CHILENO;CONTADOR AUDITOR;Boomers;PROVIDENCIA                   ;METROPOLITANA;29990;1;1;0;0;0;1;1;29990;Hervidor Electrico Tetera HA-4100 4Lts Iox;ELECTRODOMESTICOS
5606510;;M;78;CHILENO;;Silencioso;RENCA                         ;METROPOLITANA;48980;2;1;0;0;0;2;1;48980;Plancha UT-SHANGRILA Inalambrica 2200Watss;ELECTRODOMESTICOS
17274395;;F;33;CHILENO;;Millenial;N/D;N/D;51980;2;2;0;0;0;2;2;51980;Freidora de Aire 18M Oster;ELECTRODOMESTICOS
10238844;;M;55;CHILENO;;Boomers;COLBUN                        ;MAULE;449970;3;3;0;0;0;3;3;449970;Horno Electrico TH-100i 100Lts;ELECTRODOMESTICOS
14342558;;F;47;CHILENO;;X;TALAGANTE                     ;METROPOLITANA;25990;1;1;0;0;0;1;1;25990;Plancha UT-KERAMIKTOP 2200Watts Base Ceramica;ELECTRODOMESTICOS
13681111;;M;43;CHILENO;;X;PENAFLOR                      ;METROPOLITANA;12990;1;1;1;1;12990;0;0;0;PLANCHA A VAPOR 4070 SUELA CERAMICA 2500W;ELECTRODOMESTICOS
17681049;;F;30;CHILENO;;Millenial;N/D;N/D;26980;2;1;0;0;0;2;1;26980;Sandwichera TH-952 2 Panes Blanca;ELECTRODOMESTICOS
19363869;;F;25;CHILENO;;Z;SAN JAVIER;MAULE;834940;6;4;6;4;834940;0;0;0;Horno Electrico TH-25N01 25Lts;ELECTRODOMESTICOS
7326412;;F;65;CHILENO;;Boomers;TALCA                         ;MAULE;640920;8;3;0;0;0;8;3;640920;Horno Electrico UT-BACKOFEN60 60Lts;ELECTRODOMESTICOS
13710476;;F;43;CHILENO;;X;SAN ANTONIO                   ;VALPARAISO;19990;1;1;0;0;0;1;1;19990;Set Hervidor Valory VK330 Blanco + Tostador de;ELECTRODOMESTICOS
17500140;;F;32;CHILENO;;Silencioso;PROVIDENCIA                   ;METROPOLITANA;59990;1;1;1;1;59990;0;0;0;Horno Microondas Digital UT-CLASSY720 20Lts;ELECTRODOMESTICOS
15263845;;F;40;CHILENO;;X;"";"";169970;3;4;0;0;0;3;4;169970;Horno Electrico TH62I 60Lts;ELECTRODOMESTICOS
8184824;;F;60;CHILENO;;Boomers;PROVIDENCIA                   ;METROPOLITANA;16990;1;1;0;0;0;1;1;16990;HERVIDOR BERLIN 1,7 LITROS;ELECTRODOMESTICOS
6803273;Soltero;F;71;CHILENO;;Silencioso;PROVIDENCIA                   ;METROPOLITANA;24990;1;1;0;0;0;1;1;24990;Licuadora L2000VNG 1,5Lts Vaso Vidrio;ELECTRODOMESTICOS
17884581;;M;30;CHILENO;;Millenial;PROVIDENCIA                   ;METROPOLITANA;49990;1;1;0;0;0;1;1;49990;Parrilla Electrica Chef Grill;ELECTRODOMESTICOS
7948705;;F;65;CHILENO;;Boomers;N/D;N/D;67980;2;2;0;0;0;2;2;67980;Batidora Vertical Stick Mixer 2609;ELECTRODOMESTICOS
10585459;;F;56;CHILENO;;Boomers;RENCA                         ;METROPOLITANA;119990;1;1;0;0;0;1;1;119990;FREIDORA DE AIRE THOMAS TH-AF60Mi;ELECTRODOMESTICOS
19608408;;M;24;CHILENO;;Z;VILLARICA                     ;ARAUCANIA;12990;1;1;0;0;0;1;1;12990;HERVIDOR COLONIA 1,7 LITROS;ELECTRODOMESTICOS
9287714;;F;59;CHILENO;;Boomers;CHEPICA                       ;L.G.B.OÂ´HIGGINS;23990;1;1;0;0;0;1;1;23990;Olla Arrocera OA-400NG 1,8Lts;ELECTRODOMESTICOS
6305082;;F;77;CHILENO;;Silencioso;PROVIDENCIA                   ;METROPOLITANA;79990;1;1;0;0;0;1;1;79990;Horno Electrico TH-48N 48Lts;ELECTRODOMESTICOS
10043431;;M;58;CHILENO;;Boomers;RENCA                         ;METROPOLITANA;33990;1;1;0;0;0;1;1;33990;Extractor de Jugo EX800 1,4Lts;ELECTRODOMESTICOS
20276675;;F;22;CHILENO;;Z;PROVIDENCIA                   ;METROPOLITANA;266500;5;2;5;2;266500;0;0;0;Combo Licuadora + Batidora;ELECTRODOMESTICOS
14554314;;F;48;CHILENO;;X;PADRE LAS CASAS               ;ARAUCANIA;54990;1;1;0;0;0;1;1;54990;Aspiradora UT-SILENT1804 Arrastre 1800Watts;ELECTRODOMESTICOS
12989301;;F;46;CHILENO;;X;FREIRE                        ;ARAUCANIA;79990;1;1;0;0;0;1;1;79990;Batidora Pedestal TH910PN 4,6Lts 1300Watts;ELECTRODOMESTICOS
12973591;;F;46;CHILENO;;X;SAN ANTONIO                   ;VALPARAISO;127980;2;1;2;1;127980;0;0;0;SUPER FREIDORA DE AIRE OV3;ELECTRODOMESTICOS
16050551;;M;36;CHILENO;;Millenial;"";"";39990;1;1;0;0;0;1;1;39990;Licuadora Kaliman Negra con Teclas;ELECTRODOMESTICOS
19537006;;F;25;CHILENO;;Z;PROVIDENCIA                   ;METROPOLITANA;34990;1;1;0;0;0;1;1;34990;Combo Hervidor + Tostador + Sandwichera;ELECTRODOMESTICOS
11566625;;F;52;CHILENO;;X;PARRAL                        ;MAULE;9990;1;1;0;0;0;1;1;9990;Batidora Vertical Stick Mixer 2609;ELECTRODOMESTICOS
14079579;;F;40;CHILENO;;X;PROVIDENCIA                   ;METROPOLITANA;29990;1;1;0;0;0;1;1;29990;Tostador de Pan TH-126 4 Rebanadas Negro;ELECTRODOMESTICOS
19652182;;M;25;CHILENO;;Z;PROVIDENCIA                   ;METROPOLITANA;12990;1;1;1;1;12990;0;0;0;PLANCHA A VAPOR 4070 SUELA CERAMICA 2500W;ELECTRODOMESTICOS
12207190;;M;50;CHILENO;;X;LONGAVI                       ;MAULE;1831351;14;6;0;0;0;14;6;1831351;Maquina de Coser VX1445 con 14 puntadas;ELECTRODOMESTICOS
19263421;Soltero;M;26;CHILENO;;Z;PROVIDENCIA                   ;METROPOLITANA;61980;2;2;0;0;0;2;2;61980;Licuadora Berry Blender Roja 1400 Vaso Vidrio;ELECTRODOMESTICOS
11629539;;M;51;CHILENO;;X;PROVIDENCIA                   ;METROPOLITANA;49990;1;1;0;0;0;1;1;49990;Horno Microondas Mecanico Easy Wave 20Lts;ELECTRODOMESTICOS
8441010;;F;64;CHILENO;;Boomers;CASTRO                        ;LOS LAGOS;96980;2;1;0;0;0;2;1;96980;ASPIRADORA THOMAS TH-1640;ELECTRODOMESTICOS
13914714;;F;42;CHILENO;;X;LA FLORIDA                    ;METROPOLITANA;53980;2;1;2;1;53980;0;0;0;H MICROONDA MMP-23GABV 23L;ELECTRODOMESTICOS
17130363;;F;39;CHILENO;;X;PROVIDENCIA                   ;METROPOLITANA;473958;6;3;0;0;0;6;3;473958;Aspiradora AP3400 Arrastre 2000Watts;ELECTRODOMESTICOS
11221582;;F;54;CHILENO;;Boomers;RENCA                         ;METROPOLITANA;154980;2;2;0;0;0;2;2;154980;Aspiradora UT-SILENT1804 Arrastre 1800Watts;ELECTRODOMESTICOS
7927735;;F;63;CHILENO;;Boomers;PROVIDENCIA                   ;METROPOLITANA;8990;1;1;0;0;0;1;1;8990;Plancha a Vapor Oster 3803;ELECTRODOMESTICOS
14349997;;F;43;CHILENO;;Millenial;N/D;N/D;24990;1;1;0;0;0;1;1;24990;Tostador de Pan TH-126 4 Rebanadas Negro;ELECTRODOMESTICOS
18581231;;M;29;CHILENO;;Silencioso;PROVIDENCIA                   ;METROPOLITANA;76980;2;1;2;1;76980;0;0;0;Olla Multiuso 6801 5,7Lts;ELECTRODOMESTICOS
7616115;;F;67;CHILENO;;Boomers;VILLA ALEMANA                 ;VALPARAISO;59990;1;1;0;0;0;1;1;59990;Aspiradora TH1870 Arrastre 1800Watts Gris;ELECTRODOMESTICOS
5623560;;M;73;CHILENO;;Silencioso;RENCA                         ;METROPOLITANA;16990;1;1;0;0;0;1;1;16990;HERVIDOR TH-4340;ELECTRODOMESTICOS
14322640;;F;45;CHILENO;;X;VILLARICA                     ;ARAUCANIA;10990;1;1;0;0;0;1;1;10990;Exprimidor Fauna 500 cc;ELECTRODOMESTICOS
11767200;;F;51;CHILENO;;X;VILLA ALEGRE                  ;MAULE;202980;2;2;0;0;0;2;2;202980;Horno Electrico TH-100i 100Lts;ELECTRODOMESTICOS
19293444;;F;27;CHILENO;;Millenial;LOS ANGELES                   ;BIO BIO;400846;5;3;0;0;0;5;3;400846;Plancha UT-PLATTEISEN 2000Watts Base Ceramica;ELECTRODOMESTICOS
9889534;;F;59;CHILENO;;Boomers;LINARES                       ;MAULE;27990;1;1;0;0;0;1;1;27990;Plancha UT-PLATTEISEN 2000Watts Base Ceramica;ELECTRODOMESTICOS
7147102;;F;67;CHILENO;;Boomers;VINA DEL MAR                  ;VALPARAISO;33980;2;2;0;0;0;2;2;33980;MULTIMIXER THOMAS TH- 8706;ELECTRODOMESTICOS
19389068;;M;26;CHILENO;;Silencioso;PROVIDENCIA                   ;METROPOLITANA;31970;3;1;3;1;31970;0;0;0;PLANCHA A VAPOR 4070 SUELA CERAMICA 2500W;ELECTRODOMESTICOS
7768468;Casado;F;67;CHILENO;PROFESOR;Boomers;RENCA                         ;METROPOLITANA;74970;3;1;0;0;0;3;1;74970;Aspiradora TH1415 Arrastre 1500Watts;ELECTRODOMESTICOS
13115155;Casado;M;45;CHILENO;;X;LOS SAUCES                    ;ARAUCANIA;159980;2;1;0;0;0;2;1;159980;Horno Electrico TH-80i 80Lts;ELECTRODOMESTICOS
16265104;;M;36;CHILENO;;Millenial;LAMPA;METROPOLITANA;27990;1;1;0;0;0;1;1;27990;Picadora UT-PETRUS320 1Lts Vaso Vidrio;ELECTRODOMESTICOS
25469097;;F;33;VENEZOLANO;;Extranjero;SANTIAGO                      ;METROPOLITANA;265970;3;2;0;0;0;3;2;265970;Aspiradora UT-EXCELLENZA2000 0,5 litros 2600 MAH;ELECTRODOMESTICOS
8468444;;F;63;CHILENO;;Boomers;PROVIDENCIA                   ;METROPOLITANA;31240;2;1;0;0;0;2;1;31240;Plancha UT-PLATTEISEN 2000Watts Base Ceramica;ELECTRODOMESTICOS
16851819;;F;34;CHILENO;;Millenial;PROVIDENCIA                   ;METROPOLITANA;14990;1;1;0;0;0;1;1;14990;HERVIDOR TH-4340;ELECTRODOMESTICOS
13782509;;M;41;CHILENO;;X;N/D;N/D;39990;1;1;1;1;39990;0;0;0;Freidora de Aire 18M Oster;ELECTRODOMESTICOS
8942547;;F;59;CHILENO;;Boomers;RENCA                         ;METROPOLITANA;21990;1;1;0;0;0;1;1;21990;Licuadora L-1630V Negra 1,5Lts Vaso Vidrio;ELECTRODOMESTICOS
8247602;;F;64;CHILENO;;Boomers;OVALLE                        ;COQUIMBO;374950;5;3;0;0;0;5;3;374950;Horno Electrico UT-LEIF36 36Lts;ELECTRODOMESTICOS
13207539;;F;45;CHILENO;;X;BUIN                          ;METROPOLITANA;49990;1;1;0;0;0;1;1;49990;Horno Microondas Digital TH-20S01 20Lts;ELECTRODOMESTICOS
16197548;;M;37;CHILENO;;Millenial;PADRE HURTADO;METROPOLITANA;73980;2;1;2;1;73980;0;0;0;Olla Multiuso 6801 5,7Lts;ELECTRODOMESTICOS
6781323;Casado;F;74;CHILENO;ABOGADO;Silencioso;RENCA                         ;METROPOLITANA;19990;1;1;0;0;0;1;1;19990;Licuadora Berry Blender Roja 1400 Vaso Vidrio;ELECTRODOMESTICOS
17720697;;M;28;CHILENO;;Millenial;PROVIDENCIA                   ;METROPOLITANA;19990;1;1;0;0;0;1;1;19990;Tostador de PanTH-120R 2 Rebanadas Rojo;ELECTRODOMESTICOS
12477220;;F;48;CHILENO;;X;"";"";203970;3;1;0;0;0;3;1;203970;SUPER FREIDORA DE AIRE OV3;ELECTRODOMESTICOS
20103367;;F;23;CHILENO;;Millenial;PROVIDENCIA                   ;METROPOLITANA;36980;2;2;1;1;11990;1;1;24990;Hervidor Electrico 3101 1,7Lts Negro;ELECTRODOMESTICOS
13584101;Casado;F;43;CHILENO;;Silencioso;ANGOL                         ;ARAUCANIA;14990;1;1;0;0;0;1;1;14990;Hervidor Inox One Midea;ELECTRODOMESTICOS
26793055;;F;24;VENEZOLANO;;Extranjero;ESTACION CENTRAL              ;METROPOLITANA;68980;2;1;2;1;68980;0;0;0;Licuadora Reversible Roja;ELECTRODOMESTICOS
10334737;;F;54;CHILENO;;Boomers;MAIPU                         ;METROPOLITANA;27980;2;1;0;0;0;2;1;27980;HERVIDOR HAMBURGO 2,0 LITROS;ELECTRODOMESTICOS
19369284;Soltero;M;27;CHILENO;;Z;ANTOFAGASTA                   ;ANTOFAGASTA;30990;1;1;0;0;0;1;1;30990;Plancha UT-PLATTEISEN 2000Watts Base Ceramica;ELECTRODOMESTICOS
25170301;;F;34;BOLIVIANO;;Extranjero;N/D;N/D;14990;1;1;0;0;0;1;1;14990;Batidora Manual TH-8830;ELECTRODOMESTICOS
16363256;;F;35;CHILENO;;Millenial;PUNTA ARENAS                  ;MAGALLANES;14990;1;1;0;0;0;1;1;14990;PLANCHA A VAPOR 4070 SUELA CERAMICA 2500W;ELECTRODOMESTICOS
9118868;;F;63;CHILENO;;Boomers;LOS ANGELES                   ;BIO BIO;44990;1;1;0;0;0;1;1;44990;Horno Electrico UT-BACKOFEN26 26Lts;ELECTRODOMESTICOS
13370578;;F;44;CHILENO;;X;PROVIDENCIA                   ;METROPOLITANA;16990;1;1;0;0;0;1;1;16990;Tostador de Pan TH-116 2 Rebanadas Negro;ELECTRODOMESTICOS
12762610;;M;47;CHILENO;;X;N/D;N/D;64990;1;1;0;0;0;1;1;64990;Aspiradora TH1870 Arrastre 1800Watts Gris;ELECTRODOMESTICOS
25504663;;M;55;VENEZOLANO;;Extranjero;N/D;N/D;99990;1;1;0;0;0;1;1;99990;SUPER FREIDORA DE AIRE OV3;ELECTRODOMESTICOS
11398382;;F;53;CHILENO;;X;RENGO                         ;L.G.B.OÂ´HIGGINS;151960;4;4;0;0;0;4;4;151960;Horno Electrico TH-48N 48Lts;ELECTRODOMESTICOS
13762863;;F;45;CHILENO;;X;N/D;N/D;39990;1;1;0;0;0;1;1;39990;Horno Electrico TH-25N01 25Lts;ELECTRODOMESTICOS
6216779;;F;72;CHILENO;;Silencioso;VALLENAR;ATACAMA;314970;3;2;0;0;0;3;2;314970;Licuadora Kaliman Negra con Teclas;ELECTRODOMESTICOS
8119882;;M;64;CHILENO;;Boomers;LA FLORIDA                    ;METROPOLITANA;35000;2;1;0;0;0;2;1;35000;Aspiradora AP1700 Arrastre 1700Watts;ELECTRODOMESTICOS
9646124;;F;59;CHILENO;;Boomers;N/D;N/D;29990;1;1;0;0;0;1;1;29990;Licuadora L-5500IN 1,5Lts;ELECTRODOMESTICOS
7329778;;M;63;CHILENO;;Boomers;N/D;N/D;98980;2;1;0;0;0;2;1;98980;Batidora Pedestal TH910PN 4,6Lts 1300Watts;ELECTRODOMESTICOS
17716773;;F;31;CHILENO;;Millenial;N/D;N/D;819900;10;6;8;4;776920;2;2;42980;Hervidor Electrico UT-REIN17SS;ELECTRODOMESTICOS
14163201;;M;40;CHILENO;;X;SALAMANCA                     ;COQUIMBO;58980;2;2;0;0;0;2;2;58980;Licuadora L-1630V Negra 1,5Lts Vaso Vidrio;ELECTRODOMESTICOS
6415861;;F;70;CHILENO;;Silencioso;PELARCO                       ;MAULE;61980;2;1;0;0;0;2;1;61980;Horno Microondas Mecanico UT-SYDNEY18 18Lts;ELECTRODOMESTICOS
13475058;Casado;M;50;CHILENO;INGENIERIA EN ADMINISTRACION DE EMPRESAS MENCION FINANZAS;X;ARICA                         ;TARAPACA;129990;1;1;0;0;0;1;1;129990;Horno Electrico TH-80i 80Lts;ELECTRODOMESTICOS
6639042;;M;67;CHILENO;;Boomers;SAN ANTONIO                   ;VALPARAISO;566720;7;4;0;0;0;7;4;566720;Hervidor Electrico UT-MANLY17 1,7Lts Negro;ELECTRODOMESTICOS
24154597;;M;54;COLOMBIANO;;Extranjero;SANTIAGO                      ;METROPOLITANA;16990;1;1;0;0;0;1;1;16990;HERVIDOR BERLIN 1,7 LITROS;ELECTRODOMESTICOS
12799019;;F;48;CHILENO;;X;PROVIDENCIA                   ;METROPOLITANA;19990;1;1;0;0;0;1;1;19990;Licuadora Berry Blender Roja 1400 Vaso Vidrio;ELECTRODOMESTICOS
17817449;;F;31;CHILENO;;Millenial;CALBUCO                       ;LOS LAGOS;59970;3;3;0;0;0;3;3;59970;Licuadora L2000VNG 1,5Lts Vaso Vidrio;ELECTRODOMESTICOS
19283208;Soltero;M;26;CHILENO;;Z;PROVIDENCIA                   ;METROPOLITANA;34990;1;1;0;0;0;1;1;34990;Licuadora Kaliman Negra con Teclas;ELECTRODOMESTICOS
11601203;;M;52;CHILENO;;X;VILLA ALEMANA                 ;VALPARAISO;29990;1;1;0;0;0;1;1;29990;Hervidor Electrico Tetera HA-4100 4Lts Iox;ELECTRODOMESTICOS
9269978;;F;61;CHILENO;;Boomers;CONCEPCION                    ;BIO BIO;147970;3;2;0;0;0;3;2;147970;Hervidor Electrico UT-KLAR20PW 2Lts Blanco;ELECTRODOMESTICOS
11692680;;F;52;CHILENO;;X;PROVIDENCIA                   ;METROPOLITANA;71980;2;1;0;0;0;2;1;71980;Combo Hervidor + Tostador + Sandwichera;ELECTRODOMESTICOS
5759368;;F;71;CHILENO;;Silencioso;QUILLOTA                      ;VALPARAISO;34990;1;1;0;0;0;1;1;34990;Licuadora Kaliman Negra con Teclas;ELECTRODOMESTICOS
11568576;;F;53;CHILENO;;X;PINTO                         ;BIO BIO;67550;4;2;0;0;0;4;2;67550;Aspiradora AP1700 Arrastre 1700Watts;ELECTRODOMESTICOS
18630731;;F;27;CHILENO;;Millenial;N/D;N/D;30000;2;1;0;0;0;2;1;30000;Licuadora TH-320 Roja/Negro 1,5 Lts Vaso Vidrio;ELECTRODOMESTICOS
11141135;Divorciado;M;55;CHILENO;;Boomers;RENCA                         ;METROPOLITANA;31990;1;1;0;0;0;1;1;31990;Hervidor Electrico Tetera TH-6505RT 1,7Lts Rojo;ELECTRODOMESTICOS
5913084;;M;74;CHILENO;;Silencioso;OSORNO                        ;LOS LAGOS;62980;2;1;0;0;0;2;1;62980;PROCESADOR DE ALIMENTOS UT-PROCESSOR750;ELECTRODOMESTICOS
5648054;;F;75;CHILENO;;Silencioso;TEMUCO                        ;ARAUCANIA;62980;2;2;0;0;0;2;2;62980;PROCESADOR DE ALIMENTOS UT-PROCESSOR750;ELECTRODOMESTICOS
10153422;;M;56;CHILENO;;Boomers;BULNES                        ;BIO BIO;35000;2;1;0;0;0;2;1;35000;Aspiradora AP1700 Arrastre 1700Watts;ELECTRODOMESTICOS
10277234;;M;54;CHILENO;;Boomers;ARICA                         ;ARICA Y PARINACOTA;152980;2;1;0;0;0;2;1;152980;SUPER FREIDORA DE AIRE OV3;ELECTRODOMESTICOS
26163416;Casado;M;43;PERUANO;;Extranjero;VITACURA                      ;METROPOLITANA;49990;1;1;0;0;0;1;1;49990;Licuadora Osterizer 4112/72 1,25Lts Vaso Vidrio;ELECTRODOMESTICOS
13608472;;F;42;CHILENO;;X;PROVIDENCIA                   ;METROPOLITANA;53980;2;1;0;0;0;2;1;53980;Aspiradora TH1415 Arrastre 1500Watts;ELECTRODOMESTICOS
7496113;;F;71;CHILENO;;Silencioso;TALCAHUANO                    ;BIO BIO;89980;2;1;0;0;0;2;1;89980;Aspiradora UT-MEINER1803 Arrastre 1800Watts;ELECTRODOMESTICOS
17667318;;F;31;CHILENO;;Millenial;PEDRO AGUIRRE CERDA;METROPOLITANA;207960;4;2;4;2;207960;0;0;0;Licuadora Oster Clasica Roja 4126R 1,25 lt;ELECTRODOMESTICOS
13977181;;F;41;CHILENO;;Millenial;PROVIDENCIA                   ;METROPOLITANA;629530;3;2;2;1;597540;1;1;31990;Hervidor Electrico Tetera HA-4100 4Lts Iox;ELECTRODOMESTICOS
8628530;;M;63;CHILENO;;Silencioso;PROVIDENCIA                   ;METROPOLITANA;19980;2;2;0;0;0;2;2;19980;Hervidor Inox One Midea;ELECTRODOMESTICOS
18680015;;F;28;CHILENO;;Millenial;LOS ANDES                     ;VALPARAISO;59990;1;1;0;0;0;1;1;59990;Horno Microondas Digital TH-20S01 20Lts;ELECTRODOMESTICOS
14499271;;F;48;CHILENO;;X;RENCA                         ;METROPOLITANA;17990;1;1;0;0;0;1;1;17990;Hervidor Electrico UT-MANLY17 1,7Lts Negro;ELECTRODOMESTICOS
12250160;;M;50;CHILENO;;Extranjero;ANTOFAGASTA                   ;ANTOFAGASTA;26990;1;1;0;0;0;1;1;26990;Hervidor Electrico UT-REIN17SS;ELECTRODOMESTICOS
11987181;;F;56;CHILENO;;Boomers;RENGO                         ;L.G.B.OÂ´HIGGINS;28990;1;1;0;0;0;1;1;28990;Hervidor Electrico Tetera UT-LECKER18R 1,8Lts;ELECTRODOMESTICOS
21514722;;F;31;CHILENO;;Extranjero;LOS ANDES                     ;VALPARAISO;64990;1;1;1;1;64990;0;0;0;Horno Microondas Digital TH-20S01 20Lts;ELECTRODOMESTICOS
7118193;;M;67;CHILENO;;Boomers;LONCOCHE                      ;ARAUCANIA;111960;4;1;0;0;0;4;1;111960;Horno Microondas Mecanico TH-18B05 18Lts;ELECTRODOMESTICOS
12932097;;F;51;CHILENO;;X;PADRE LAS CASAS               ;ARAUCANIA;74980;2;1;0;0;0;2;1;74980;Horno Electrico TH-38N 38Lts;ELECTRODOMESTICOS
17615060;;M;31;CHILENO;;Millenial;N/D;N/D;34990;1;1;0;0;0;1;1;34990;Aspiradora AP1700 Arrastre 1700Watts;ELECTRODOMESTICOS
20308507;;F;22;CHILENO;;Z;PROVIDENCIA                   ;METROPOLITANA;39990;1;1;1;1;39990;0;0;0;LICUADORA CROMADA CON TECLAS PLUS;ELECTRODOMESTICOS
6261435;;F;75;CHILENO;;Silencioso;TALAGANTE                     ;METROPOLITANA;61980;2;2;0;0;0;2;2;61980;Exprimidor de Jugo CJ-2000 1Lts;ELECTRODOMESTICOS
18471064;Soltero;F;28;CHILENO;KINESIOLOGA;Millenial;PROVIDENCIA                   ;METROPOLITANA;283950;5;4;3;3;269970;2;1;13980;HORNO ELECTRICO 16N01 16LTS NEGRO;ELECTRODOMESTICOS
15599961;;F;59;CHILENO;;Boomers;MAIPU                         ;METROPOLITANA;59990;1;1;0;0;0;1;1;59990;Parrilla Electrica TH-224;ELECTRODOMESTICOS
16155010;;M;36;CHILENO;;Millenial;N/D;N/D;119990;1;1;0;0;0;1;1;119990;Horno Electrico TH-80i 80Lts;ELECTRODOMESTICOS
9162480;;F;60;CHILENO;;Boomers;SAN FERNANDO                  ;L.G.B.OÂ´HIGGINS;21990;1;1;0;0;0;1;1;21990;Licuadora L-1630V Negra 1,5Lts Vaso Vidrio;ELECTRODOMESTICOS
7624824;;F;63;CHILENO;;Boomers;MAIPU                         ;METROPOLITANA;74990;1;1;0;0;0;1;1;74990;Aspiradora UT-MEINER1803 Arrastre 1800Watts;ELECTRODOMESTICOS
9812786;;M;58;CHILENO;;Boomers;LINARES                       ;MAULE;27990;1;1;0;0;0;1;1;27990;Plancha THOMAS TH-7170 2200Watts Base Ceramica;ELECTRODOMESTICOS
10689380;;F;53;CHILENO;;X;VINA DEL MAR                  ;VALPARAISO;39970;3;1;0;0;0;3;1;39970;Batidora Manual TH-8830;ELECTRODOMESTICOS
13708555;;F;43;CHILENO;;X;PROVIDENCIA                   ;METROPOLITANA;94970;5;2;2;1;42980;3;1;51990;Picadora TH-9020V Vaso Vidrio 2Lts;ELECTRODOMESTICOS
11171074;;F;55;CHILENO;;Boomers;RENCA                         ;METROPOLITANA;164980;2;2;0;0;0;2;2;164980;Horno Electrico TH-80i 80Lts;ELECTRODOMESTICOS
14188249;;F;40;CHILENO;;X;PUENTE ALTO                   ;METROPOLITANA;29990;1;1;0;0;0;1;1;29990;Licuadora TH-320 Roja/Negro 1,5 Lts Vaso Vidrio;ELECTRODOMESTICOS
13586821;;F;43;CHILENO;;Millenial;"";"";154990;1;1;0;0;0;1;1;154990;Horno Electrico TH-80i 80Lts;ELECTRODOMESTICOS
9169458;;F;62;CHILENO;;Boomers;"";"";149980;2;2;0;0;0;2;2;149980;Licuadora TH-320 Roja/Negro 1,5 Lts Vaso Vidrio;ELECTRODOMESTICOS
11416255;Casado;F;54;CHILENO;;X;PROVIDENCIA                   ;METROPOLITANA;34990;1;1;0;0;0;1;1;34990;Licuadora Roja 550W 1,5Lts Vaso Vidrio;ELECTRODOMESTICOS
16798395;;M;34;CHILENO;;Millenial;N/D;N/D;74990;1;1;0;0;0;1;1;74990;Aspiradora UT-MEINER1803 Arrastre 1800Watts;ELECTRODOMESTICOS
6393042;;M;73;CHILENO;;Silencioso;ANCUD                         ;LOS LAGOS;18990;1;1;0;0;0;1;1;18990;Hervidor Electrico UT-KLAR20PW 2Lts Blanco;ELECTRODOMESTICOS
18577930;;F;28;CHILENO;;Millenial;PANGUIPULLI                   ;LOS RIOS;27990;1;1;0;0;0;1;1;27990;Batidora Pedestal B5300 Inox;ELECTRODOMESTICOS
13959002;;F;42;CHILENO;;X;ARAUCO                        ;BIO BIO;43990;1;1;0;0;0;1;1;43990;Aspiradora Handy Clean Black 1400;ELECTRODOMESTICOS
15851735;Soltero;M;38;CHILENO;INGENIERO COMERCIAL;Millenial;PROVIDENCIA                   ;METROPOLITANA;103980;2;1;2;1;103980;0;0;0;ASPIRADORA ROBOT THOMAS TH-1060SC;ELECTRODOMESTICOS
14060883;;F;41;CHILENO;;X;PINTO                         ;BIO BIO;16990;1;1;0;0;0;1;1;16990;Plancha Easy Steam (PV4500);ELECTRODOMESTICOS
11685131;;M;51;CHILENO;;X;LOTA                          ;BIO BIO;24990;1;1;0;0;0;1;1;24990;Licuadora TH-320 Roja/Negro 1,5 Lts Vaso Vidrio;ELECTRODOMESTICOS
9657733;;M;59;CHILENO;;Boomers;RANCAGUA                      ;L.G.B.OÂ´HIGGINS;44990;1;1;0;0;0;1;1;44990;Picadora TH-9020V Vaso Vidrio 2Lts;ELECTRODOMESTICOS
17895991;;F;31;CHILENO;;Millenial;LEBU                          ;BIO BIO;244970;3;3;0;0;0;3;3;244970;Plancha TH-7052 2000Watts Base Inox;ELECTRODOMESTICOS
15287599;Casado;F;40;CHILENO;;X;N/D;N/D;16990;1;1;0;0;0;1;1;16990;Hervidor Electrico TH-4212N 1,7Lts Negro;ELECTRODOMESTICOS
7165509;;F;68;CHILENO;;Silencioso;LA GRANJA                     ;METROPOLITANA;67980;2;2;0;0;0;2;2;67980;PLANCHA A VAPOR 4070 SUELA CERAMICA 2500W;ELECTRODOMESTICOS
24721101;;M;37;BOLIVIANO;;Extranjero;CALAMA                        ;ANTOFAGASTA;24990;1;1;0;0;0;1;1;24990;Licuadora TH-320 Roja/Negro 1,5 Lts Vaso Vidrio;ELECTRODOMESTICOS
15115376;;F;39;CHILENO;;X;PROVIDENCIA                   ;METROPOLITANA;49980;2;2;0;0;0;2;2;49980;Procesador TH-9010 Multimixer 1,5Lts Vaso Vidrio;ELECTRODOMESTICOS
8303541;Casado;M;61;CHILENO;ADMINISTRADOR PUBLICO;Boomers;RENCA                         ;METROPOLITANA;48980;2;2;0;0;0;2;2;48980;Licuadora TH-401V Roja 1,75Lts Vaso Vidrio;ELECTRODOMESTICOS
15276828;;M;36;CHILENO;;Millenial;PROVIDENCIA                   ;METROPOLITANA;14990;1;1;0;0;0;1;1;14990;Hervidor Electrico UT-MANLY17 1,7Lts Negro;ELECTRODOMESTICOS
15189639;;M;39;CHILENO;;X;CORONEL                       ;BIO BIO;12990;1;1;0;0;0;1;1;12990;PLANCHA A VAPOR 4070 SUELA CERAMICA 2500W;ELECTRODOMESTICOS
13785843;;F;42;CHILENO;;X;CONSTITUCION                  ;MAULE;28990;1;1;0;0;0;1;1;28990;PICADORA 123 SILHQUETTE;ELECTRODOMESTICOS
10325516;;F;57;CHILENO;;Boomers;COIHAIQUE                     ;AYSEN;77970;3;2;0;0;0;3;2;77970;Plancha THOMAS TH-7170 2200Watts Base Ceramica;ELECTRODOMESTICOS
18785554;Soltero;M;28;CHILENO;;Millenial;PROVIDENCIA                   ;METROPOLITANA;49990;1;1;0;0;0;1;1;49990;Aspiradora Tambor APA1000 1000Watts;ELECTRODOMESTICOS
15359234;;F;39;CHILENO;;X;MAIPU                         ;METROPOLITANA;592970;3;2;0;0;0;3;2;592970;PROCESADOR DE ALIMENTOS UT-PROCESSOR750;ELECTRODOMESTICOS
12296638;;F;50;CHILENO;;X;PROVIDENCIA                   ;METROPOLITANA;34990;1;1;0;0;0;1;1;34990;Licuadora UT-METALLEK505P 1,5Lts Vaso Vidrio;ELECTRODOMESTICOS
11145886;;F;55;CHILENO;;Boomers;CANETE                        ;BIO BIO;26990;1;1;0;0;0;1;1;26990;PICADORA 123 SILHQUETTE;ELECTRODOMESTICOS
10244995;;F;57;CHILENO;;Boomers;MELIPILLA                     ;METROPOLITANA;12990;1;1;0;0;0;1;1;12990;Exprimidor de Jugo CJ-2000 1Lts;ELECTRODOMESTICOS
3258889;;M;87;CHILENO;;Silencioso;QUILLOTA                      ;VALPARAISO;49990;1;1;0;0;0;1;1;49990;Horno Electrico UT-BACKOFEN26 26Lts;ELECTRODOMESTICOS
18326137;;F;29;CHILENO;;Millenial;CERRO NAVIA                   ;METROPOLITANA;24990;1;1;0;0;0;1;1;24990;Tostador de Pan TP-1400 4 Rebanadas Inox;ELECTRODOMESTICOS
19050619;;F;27;CHILENO;;Z;SANTA BARBARA                 ;BIO BIO;16990;1;1;0;0;0;1;1;16990;Sandwichera TH-952 2 Panes Blanca;ELECTRODOMESTICOS
13112320;;F;53;CHILENO;;X;NUEVA IMPERIAL                ;ARAUCANIA;268970;3;2;0;0;0;3;2;268970;Batidora Vertical Stick Mixer 2609;ELECTRODOMESTICOS
19632929;;F;25;CHILENO;;Z;LINARES                       ;MAULE;389970;3;2;0;0;0;3;2;389970;Aspiradora UT-SILENT1603 Arrastre 1600Watts;ELECTRODOMESTICOS
15292205;;M;39;CHILENO;;X;N/D;N/D;19990;1;1;0;0;0;1;1;19990;Hervidor Electrico UT-DUNKEL17P 2Lts Negro;ELECTRODOMESTICOS
7887129;;M;62;CHILENO;;Boomers;LOS VILOS                     ;COQUIMBO;419959;4;2;0;0;0;4;2;419959;Horno Electrico TH-100i 100Lts;ELECTRODOMESTICOS
13158072;Casado;F;45;CHILENO;;X;RENCA                         ;METROPOLITANA;109990;1;1;0;0;0;1;1;109990;Horno Electrico TH62I 60Lts;ELECTRODOMESTICOS
14184940;;M;41;CHILENO;;X;PROVIDENCIA                   ;METROPOLITANA;34990;1;1;0;0;0;1;1;34990;Plancha UT-SHANGRILA Inalambrica 2200Watss;ELECTRODOMESTICOS
13784333;;M;42;CHILENO;;X;LICANTEN                      ;MAULE;145480;2;1;2;1;145480;0;0;0;CAFETERA PRIMA LATTE 6603 NEGRA;ELECTRODOMESTICOS
19266260;;F;26;CHILENO;;Z;PROVIDENCIA                   ;METROPOLITANA;29970;3;1;3;1;29970;0;0;0;PLANCHA A VAPOR 4070 SUELA CERAMICA 2500W;ELECTRODOMESTICOS
9232157;Divorciado;M;58;CHILENO;;Boomers;PROVIDENCIA                   ;METROPOLITANA;32990;1;1;0;0;0;1;1;32990;Licuadora Personal TH-300PB;ELECTRODOMESTICOS
8677249;;F;51;CHILENO;;X;PROVIDENCIA                   ;METROPOLITANA;42980;2;2;0;0;0;2;2;42980;Tostador de PanTH-120R 2 Rebanadas Rojo;ELECTRODOMESTICOS
8168673;;F;63;CHILENO;;Boomers;PROVIDENCIA                   ;METROPOLITANA;79990;1;1;0;0;0;1;1;79990;Horno Electrico TH-38N 38Lts;ELECTRODOMESTICOS
12762094;Casado;M;46;CHILENO;;X;RENCA                         ;METROPOLITANA;109990;1;1;1;1;109990;0;0;0;Horno Electrico UT-BACKOFEN60 60Lts;ELECTRODOMESTICOS
16120239;;M;36;CHILENO;;Millenial;PROVIDENCIA                   ;METROPOLITANA;174970;3;1;0;0;0;3;1;174970;Horno Electrico TH62I 60Lts;ELECTRODOMESTICOS
14307714;;F;46;CHILENO;;X;PENAFLOR                      ;METROPOLITANA;29990;1;1;0;0;0;1;1;29990;Combo Juguera + Hervidor;ELECTRODOMESTICOS
18894538;;M;27;CHILENO;;Millenial;IQUIQUE                       ;TARAPACA;89990;1;1;0;0;0;1;1;89990;Horno Electrico TH-48N 48Lts;ELECTRODOMESTICOS
19507514;;F;25;CHILENO;;Z;"";"";19990;1;1;0;0;0;1;1;19990;Combo Hervidor + Batidora;ELECTRODOMESTICOS
10359305;;F;58;CHILENO;;Boomers;LA GRANJA                     ;METROPOLITANA;89970;3;1;0;0;0;3;1;89970;Licuadora UT-METALLEK505P 1,5Lts Vaso Vidrio;ELECTRODOMESTICOS
9232481;;F;57;CHILENO;;Boomers;QUILLOTA                      ;VALPARAISO;114990;1;1;0;0;0;1;1;114990;Horno Electrico UT-BACKOFEN60 60Lts;ELECTRODOMESTICOS
13331324;;M;44;CHILENO;;X;N/D;N/D;67980;2;2;0;0;0;2;2;67980;Aspiradora AP1700 Arrastre 1700Watts;ELECTRODOMESTICOS
16032783;;M;37;CHILENO;;Millenial;EL BOSQUE                     ;METROPOLITANA;349960;4;2;4;2;349960;0;0;0;Robot aspirador Roomba E5;ELECTRODOMESTICOS
26184168;;M;39;COLOMBIANO;;Extranjero;"";"";729980;2;2;0;0;0;2;2;729980;Cafetera TH-138i;ELECTRODOMESTICOS
17710709;;F;29;CHILENO;;Millenial;"";"";14990;1;1;0;0;0;1;1;14990;Batidora Manual 3532;ELECTRODOMESTICOS
5160330;;F;81;CHILENO;;Silencioso;TALCA                         ;MAULE;780210;8;3;0;0;0;8;3;780210;PROCESADOR DE ALIMENTOS UT-PROCESSOR750;ELECTRODOMESTICOS
18344634;;F;29;CHILENO;;Millenial;PROVIDENCIA                   ;METROPOLITANA;54980;2;2;2;2;54980;0;0;0;Exprimidor de Jugo TH-1215 1,5Lts;ELECTRODOMESTICOS
17991869;;F;30;CHILENO;;Millenial;SANTA CRUZ                    ;L.G.B.OÂ´HIGGINS;25980;2;1;2;1;25980;0;0;0;PLANCHA A VAPOR 4070 SUELA CERAMICA 2500W;ELECTRODOMESTICOS
8240690;;F;62;CHILENO;;Boomers;COQUIMBO                      ;COQUIMBO;21990;1;1;0;0;0;1;1;21990;Hervidor Electrico TH-4515N 2Lts Negro;ELECTRODOMESTICOS
14214732;;M;41;CHILENO;;X;LOTA                          ;BIO BIO;45980;2;1;0;0;0;2;1;45980;Hervidor Electrico Tetera HA-4100 4Lts Iox;ELECTRODOMESTICOS
7572356;;M;64;CHILENO;;Boomers;SAN JOAQUIN                   ;METROPOLITANA;41980;2;1;0;0;0;2;1;41980;Set Hervidor Valory VK330 Blanco + Tostador de;ELECTRODOMESTICOS
15214646;;M;39;CHILENO;;X;PROVIDENCIA                   ;METROPOLITANA;34990;1;1;0;0;0;1;1;34990;Licuadora UT-METALLEK505P 1,5Lts Vaso Vidrio;ELECTRODOMESTICOS
12577946;Soltero;M;49;CHILENO;;X;RENCA                         ;METROPOLITANA;26990;1;1;0;0;0;1;1;26990;Hervidor Electrico Tetera TH-6505RT 1,7Lts Rojo;ELECTRODOMESTICOS
5739329;Soltero;M;71;CHILENO;AGRONOMO;Silencioso;PAINE                         ;METROPOLITANA;229980;2;2;0;0;0;2;2;229980;HORNO ELECTRICO 16N01 16LTS NEGRO;ELECTRODOMESTICOS
13565045;;M;43;CHILENO;;X;PROVIDENCIA                   ;METROPOLITANA;84990;1;1;0;0;0;1;1;84990;Horno Electrico UT-BACKOFEN38 38Lts;ELECTRODOMESTICOS
11287239;;F;53;CHILENO;;X;LA PINTANA                    ;METROPOLITANA;24990;1;1;0;0;0;1;1;24990;Licuadora L2000VNG 1,5Lts Vaso Vidrio;ELECTRODOMESTICOS
19202226;;F;33;CHILENO;;Millenial;QUILPUE                       ;VALPARAISO;14990;1;1;0;0;0;1;1;14990;Hervidor Electrico UT-MANLY17 1,7Lts Negro;ELECTRODOMESTICOS
5356235;;F;76;CHILENO;;Silencioso;VILLA ALEMANA                 ;VALPARAISO;84990;1;1;0;0;0;1;1;84990;Batidora Pedestal UT-KLEIN700;ELECTRODOMESTICOS
7179499;;F;65;CHILENO;;Boomers;N/D;N/D;820310;8;5;0;0;0;8;5;820310;Plancha TH-7052 2000Watts Base Inox;ELECTRODOMESTICOS
15302467;;M;39;CHILENO;;X;N/D;N/D;310960;4;4;0;0;0;4;4;310960;Maquina de Coser Remington J011;ELECTRODOMESTICOS
11944564;;M;50;CHILENO;;X;RENCA                         ;METROPOLITANA;39990;1;1;0;0;0;1;1;39990;LICUADORA CROMADA CON TECLAS PLUS;ELECTRODOMESTICOS
25982779;Casado;M;25;HAITIANO;;Extranjero;PEDRO AGUIRRE CERDA           ;METROPOLITANA;11990;1;1;0;0;0;1;1;11990;Hervidor Electrico 3101 1,7Lts Negro;ELECTRODOMESTICOS
6786448;Casado;F;72;CHILENO;;Silencioso;RENCA                         ;METROPOLITANA;109990;1;1;0;0;0;1;1;109990;Horno Electrico TH62I 60Lts;ELECTRODOMESTICOS
13770975;;F;42;CHILENO;;X;TALAGANTE                     ;METROPOLITANA;37980;2;2;0;0;0;2;2;37980;Procesador TH-9010 Multimixer 1,5Lts Vaso Vidrio;ELECTRODOMESTICOS
18352685;;F;29;CHILENO;;Millenial;MONTE PATRIA                  ;COQUIMBO;765440;6;3;0;0;0;6;3;765440;Batidora Vertical Minipimer UT-KLOT400P;ELECTRODOMESTICOS
8450838;;F;64;CHILENO;;Boomers;PROVIDENCIA                   ;METROPOLITANA;84990;1;1;0;0;0;1;1;84990;Horno Electrico UT-BACKOFEN48 48Lts;ELECTRODOMESTICOS
7721552;;F;64;CHILENO;;Boomers;TEMUCO                        ;ARAUCANIA;327940;6;4;0;0;0;6;4;327940;Plancha TH-7052 2000Watts Base Inox;ELECTRODOMESTICOS
9170688;;F;61;CHILENO;;Boomers;PUERTO MONTT                  ;LOS LAGOS;19990;1;1;0;0;0;1;1;19990;Licuadora L-1630V Negra 1,5Lts Vaso Vidrio;ELECTRODOMESTICOS
14231029;;M;53;CHILENO;;X;LOTA                          ;BIO BIO;495960;4;3;0;0;0;4;3;495960;Hervidor Electrico UT-KLAR20PW 2Lts Blanco;ELECTRODOMESTICOS
11561308;;M;51;CHILENO;;X;CONSTITUCION                  ;MAULE;20990;1;1;0;0;0;1;1;20990;Hervidor Electrico UT-DUNKEL17P 2Lts Negro;ELECTRODOMESTICOS
11937217;Casado;F;49;CHILENO;;X;PROVIDENCIA                   ;METROPOLITANA;19990;1;1;0;0;0;1;1;19990;Combo Hervidor + Batidora;ELECTRODOMESTICOS
6316243;Casado;M;73;CHILENO;;Silencioso;RENCA                         ;METROPOLITANA;184980;2;1;0;0;0;2;1;184980;Maquina de Coser ME9100;ELECTRODOMESTICOS
11692252;;M;51;CHILENO;;X;COIHAIQUE                     ;AYSEN;29980;2;1;0;0;0;2;1;29980;Hervidor Electrico UT-KLAR20PW 2Lts Blanco;ELECTRODOMESTICOS
15985042;Soltero;M;37;CHILENO;;Millenial;ANGOL                         ;ARAUCANIA;12990;1;1;0;0;0;1;1;12990;Hervidor Electrico 3101 1,7Lts Negro;ELECTRODOMESTICOS
7116123;Divorciado;F;64;CHILENO;PROFESOR;Boomers;ANCUD                         ;LOS LAGOS;18990;1;1;0;0;0;1;1;18990;Plancha Easy Steam (PV4500);ELECTRODOMESTICOS
15192198;;F;39;CHILENO;;X;LOTA                          ;BIO BIO;36990;1;1;0;0;0;1;1;36990;Licuadora TH-501V 1,5Lts Vaso Vidrio;ELECTRODOMESTICOS
12788877;;F;46;CHILENO;;X;PROVIDENCIA                   ;METROPOLITANA;24990;1;1;0;0;0;1;1;24990;Licuadora L-1630V Negra 1,5Lts Vaso Vidrio;ELECTRODOMESTICOS
7179091;;F;69;CHILENO;;Silencioso;N/D;N/D;77980;2;1;0;0;0;2;1;77980;Aspiradora TH1870 Arrastre 1800Watts Gris;ELECTRODOMESTICOS
15056366;;F;40;CHILENO;;X;LA LIGUA                      ;VALPARAISO;19990;1;1;0;0;0;1;1;19990;Plancha UT-DUNST 2200Watts Base Ceramica;ELECTRODOMESTICOS
13546495;;M;42;CHILENO;;X;SAN ANTONIO                   ;VALPARAISO;84990;1;1;0;0;0;1;1;84990;Batidora Pedestal TH910PN 4,6Lts 1300Watts;ELECTRODOMESTICOS
13857602;;M;42;CHILENO;;X;N/D;N/D;19990;1;1;0;0;0;1;1;19990;Licuadora Sport Blender BSE10;ELECTRODOMESTICOS
13150050;;M;45;CHILENO;;X;ANGOL                         ;ARAUCANIA;78980;2;2;0;0;0;2;2;78980;Parrilla Electrica TH-224;ELECTRODOMESTICOS
17401165;;M;32;CHILENO;;Millenial;"";"";79990;1;1;1;1;79990;0;0;0;Batidora Pedestal UT-KLEIN700;ELECTRODOMESTICOS
6122035;;M;73;CHILENO;;Silencioso;PANGUIPULLI                   ;LOS LAGOS;124970;3;1;0;0;0;3;1;124970;Picadora TH-9020V Vaso Vidrio 2Lts;ELECTRODOMESTICOS
8282046;;F;62;CHILENO;;Boomers;PROVIDENCIA                   ;METROPOLITANA;53980;2;1;2;1;53980;0;0;0;Molinillo de Cafe Delonghi KG89;ELECTRODOMESTICOS
14008478;Casado;F;40;CHILENO;;X;PROVIDENCIA                   ;METROPOLITANA;34990;1;1;0;0;0;1;1;34990;Plancha Paninis 2880;ELECTRODOMESTICOS
19550369;Soltero;F;25;CHILENO;;Z;PROVIDENCIA                   ;METROPOLITANA;26990;1;1;0;0;0;1;1;26990;Licuadora L2000VNG 1,5Lts Vaso Vidrio;ELECTRODOMESTICOS
12560825;;F;47;CHILENO;;X;CURANILAHUE                   ;BIO BIO;21990;1;1;0;0;0;1;1;21990;Licuadora TH-320 Roja/Negro 1,5 Lts Vaso Vidrio;ELECTRODOMESTICOS
20151092;;F;23;CHILENO;;Z;CASTRO                        ;LOS LAGOS;159990;4;1;0;0;0;4;1;159990;Aspiradora AP3400 Arrastre 2000Watts;ELECTRODOMESTICOS
18527844;;M;29;CHILENO;;Silencioso;PROVIDENCIA                   ;METROPOLITANA;68980;2;1;2;1;68980;0;0;0;Horno Microondas Digital MS23K3513AK/ZS 23Lts;ELECTRODOMESTICOS
9550845;;M;59;CHILENO;;Boomers;QUILPUE                       ;VALPARAISO;84990;1;1;0;0;0;1;1;84990;Batidora Pedestal TH910PN 4,6Lts 1300Watts;ELECTRODOMESTICOS
15251824;;M;38;CHILENO;;X;TOLTEN                        ;ARAUCANIA;34990;1;1;0;0;0;1;1;34990;Licuadora TH-401V Roja 1,75Lts Vaso Vidrio;ELECTRODOMESTICOS
18443768;;F;29;CHILENO;;Millenial;N/D;N/D;89970;3;2;0;0;0;3;2;89970;Horno Microondas Mecanico Easy Wave 20Lts;ELECTRODOMESTICOS
15627337;;M;45;CHILENO;;X;CABRERO                       ;BIO BIO;39990;1;1;0;0;0;1;1;39990;Horno Electrico UT-BACKOFEN26 26Lts;ELECTRODOMESTICOS
11815359;;M;50;CHILENO;;X;N/D;N/D;149990;1;1;0;0;0;1;1;149990;Maquina de Coser ME9100;ELECTRODOMESTICOS
18656841;Soltero;F;28;CHILENO;KINESIOLOGO;Millenial;LINARES                       ;MAULE;69990;1;1;1;1;69990;0;0;0;Horno Electrico TH-48N 48Lts;ELECTRODOMESTICOS
11746040;;F;54;CHILENO;;Boomers;LINARES                       ;MAULE;80970;3;3;0;0;0;3;3;80970;Horno Microondas Mecanico TH-18B05 18Lts;ELECTRODOMESTICOS
17536869;;M;33;CHILENO;;Millenial;ANTOFAGASTA;ANTOFAGASTA;219980;2;1;0;0;0;2;1;219980;Maquina de Coser 311;ELECTRODOMESTICOS
26396488;;M;44;VENEZOLANO;;Extranjero;N/D;N/D;54970;3;2;0;0;0;3;2;54970;Licuadora TH-320 Roja/Negro 1,5 Lts Vaso Vidrio;ELECTRODOMESTICOS
24360106;;M;44;BOLIVIANO;;Extranjero;N/D;N/D;109970;3;1;0;0;0;3;1;109970;Licuadora Reversible Roja;ELECTRODOMESTICOS
6279344;;F;74;CHILENO;;Silencioso;RENCA                         ;METROPOLITANA;18990;1;1;0;0;0;1;1;18990;Batidora Manual TH-8830;ELECTRODOMESTICOS
4894277;;M;76;CHILENO;;Silencioso;SAN FERNANDO                  ;L.G.B.OÂ´HIGGINS;54990;1;1;0;0;0;1;1;54990;Batidora Vertical Minipimer UT-KLOT800SS;ELECTRODOMESTICOS
19497510;Soltero;F;25;CHILENO;;Z;PROVIDENCIA                   ;METROPOLITANA;43980;2;1;2;1;43980;0;0;0;Aspiradora TH1407 Arrastre 1400Watts;ELECTRODOMESTICOS
12632003;;M;48;CHILENO;;X;RENCA                         ;METROPOLITANA;34990;1;1;0;0;0;1;1;34990;Licuadora TH-501V 1,5Lts Vaso Vidrio;ELECTRODOMESTICOS
10220832;;M;58;CHILENO;;Boomers;PROVIDENCIA                   ;METROPOLITANA;73970;3;1;0;0;0;3;1;73970;Horno Electrico TH-38N 38Lts;ELECTRODOMESTICOS
9117692;;F;62;CHILENO;;Boomers;EL BOSQUE                     ;METROPOLITANA;99990;1;1;0;0;0;1;1;99990;Horno Electrico TH62I 60Lts;ELECTRODOMESTICOS
19047712;;F;27;CHILENO;;Z;QUILLOTA;VALPARAISO;42980;2;1;0;0;0;2;1;42980;Licuadora Osterizer 4112/72 1,25Lts Vaso Vidrio;ELECTRODOMESTICOS
7911610;;F;62;CHILENO;;Boomers;SAN CARLOS                    ;BIO BIO;412370;3;2;0;0;0;3;2;412370;Hervidor Electrico Tetera TH-6505RT 1,7Lts Rojo;ELECTRODOMESTICOS
12546395;;F;48;CHILENO;;X;PUENTE ALTO                   ;METROPOLITANA;48980;2;1;0;0;0;2;1;48980;Cafetera UT-KAFFEEKLASSIK;ELECTRODOMESTICOS
18722751;;M;28;CHILENO;;Millenial;HUASCO                        ;ATACAMA;109970;3;1;0;0;0;3;1;109970;Horno electrico Black Oven 42lts;ELECTRODOMESTICOS
17642707;;M;31;CHILENO;;Millenial;PROVIDENCIA                   ;METROPOLITANA;318960;4;3;1;1;209990;3;2;108970;Horno Electrico TH-48N 48Lts;ELECTRODOMESTICOS
10342087;;F;58;CHILENO;;Boomers;TEMUCO                        ;ARAUCANIA;74990;1;1;0;0;0;1;1;74990;Batidora Pedestal TH910PN 4,6Lts 1300Watts;ELECTRODOMESTICOS
9142773;;F;56;CHILENO;;Boomers;ANCUD                         ;LOS LAGOS;1059980;3;2;0;0;0;3;2;1059980;Horno Electrico TH62I 60Lts;ELECTRODOMESTICOS
12900923;;F;46;CHILENO;;X;PUENTE ALTO                   ;METROPOLITANA;139980;2;1;0;0;0;2;1;139980;Horno Electrico UT-BACKOFEN48 48Lts;ELECTRODOMESTICOS
15083571;;M;39;CHILENO;;X;N/D;N/D;134970;3;1;3;1;134970;0;0;0;FREIDORA DE AIRE CKSTAF18D 1000W;ELECTRODOMESTICOS
20114609;;M;23;CHILENO;;Z;LOS ANGELES                   ;BIO BIO;68170;2;1;0;0;0;2;1;68170;Aspiradora VCC4190V3E/XZS Arrastre 2000Watts;ELECTRODOMESTICOS
9904470;;F;57;CHILENO;;Boomers;SAN FERNANDO                  ;L.G.B.OÂ´HIGGINS;57220;4;4;0;0;0;4;4;57220;Licuadora L2000VNG 1,5Lts Vaso Vidrio;ELECTRODOMESTICOS
18012300;;F;30;CHILENO;;Millenial;PROVIDENCIA                   ;METROPOLITANA;99990;1;1;0;0;0;1;1;99990;Horno Electrico UT-BACKOFEN60 60Lts;ELECTRODOMESTICOS
19286336;Soltero;F;26;CHILENO;;Z;PROVIDENCIA                   ;METROPOLITANA;59995;1;3;1;1;89990;0;2;-29995;Horno Electrico UT-BACKOFEN60 60Lts;ELECTRODOMESTICOS
25801817;;F;38;PERUANO;;Extranjero;ANTOFAGASTA                   ;ANTOFAGASTA;24990;1;1;0;0;0;1;1;24990;BATIDORA INMERSION S MIX 2616;ELECTRODOMESTICOS
12760198;;F;46;CHILENO;;X;DALCAHUE                      ;LOS LAGOS;49990;1;3;0;0;0;1;3;49990;Horno Microondas Mecanico TH-18B05 18Lts;ELECTRODOMESTICOS
14014235;;F;40;CHILENO;;X;N/D;N/D;350970;3;2;1;1;179990;2;1;170980;Maquina de Coser 311;ELECTRODOMESTICOS
6394392;;F;74;CHILENO;;Silencioso;RENCA                         ;METROPOLITANA;34990;1;1;0;0;0;1;1;34990;Batidora Vertical Minipimer UT-KLOT400P;ELECTRODOMESTICOS
9677654;;F;59;CHILENO;;Boomers;EL TABO                       ;VALPARAISO;27990;1;1;0;0;0;1;1;27990;Picadora UT-PETRUS320 1Lts Vaso Vidrio;ELECTRODOMESTICOS
14077102;;M;41;CHILENO;;X;CUNCO                         ;ARAUCANIA;44990;1;1;0;0;0;1;1;44990;Horno Electrico TH-25N01 25Lts;ELECTRODOMESTICOS
11563039;;F;52;CHILENO;;X;SAN JAVIER                    ;MAULE;18990;1;1;0;0;0;1;1;18990;Batidora Manual TH-8830;ELECTRODOMESTICOS
15667886;Soltero;F;38;CHILENO;PSICOPEDAGOGO;Millenial;PROVIDENCIA                   ;METROPOLITANA;39990;1;1;1;1;39990;0;0;0;Horno Electrico TH-25N01 25Lts;ELECTRODOMESTICOS
16144426;;F;37;CHILENO;;Millenial;PROVIDENCIA                   ;METROPOLITANA;62980;2;1;0;0;0;2;1;62980;Licuadora L-5500IN 1,5Lts;ELECTRODOMESTICOS
15147634;;M;40;CHILENO;;X;N/D;N/D;194970;3;1;0;0;0;3;1;194970;Horno Microondas Digital L UT-25KROMM 25Lts;ELECTRODOMESTICOS
18240312;;M;33;CHILENO;;Millenial;ARICA                         ;ARICA Y PARINACOTA;21990;1;1;0;0;0;1;1;21990;Licuadora TH-320 Roja/Negro 1,5 Lts Vaso Vidrio;ELECTRODOMESTICOS
18087263;;M;30;CHILENO;;Millenial;PROVIDENCIA                   ;METROPOLITANA;84990;1;1;0;0;0;1;1;84990;FREIDORA DE AIRE THOMAS TH-AF60Mi;ELECTRODOMESTICOS
16982486;;F;34;CHILENO;;Millenial;LOS ANGELES                   ;BIO BIO;30240;2;1;0;0;0;2;1;30240;Licuadora L-5500IN 1,5Lts;ELECTRODOMESTICOS
4615411;;F;72;CHILENO;;Silencioso;BUIN                          ;METROPOLITANA;114980;2;2;0;0;0;2;2;114980;Horno Microondas Mecanico TH-18B05 18Lts;ELECTRODOMESTICOS
7594464;;M;67;CHILENO;;Boomers;VALDIVIA                      ;LOS LAGOS;394970;3;3;0;0;0;3;3;394970;Horno Microondas Digital TH-25DM 25Lts;ELECTRODOMESTICOS
7712610;;F;66;CHILENO;;Boomers;TALCA                         ;MAULE;114980;2;1;0;0;0;2;1;114980;Batidora Pedestal TH910PN 4,6Lts 1300Watts;ELECTRODOMESTICOS
17801610;;F;31;CHILENO;;Millenial;SAN ANTONIO                   ;VALPARAISO;49990;1;1;0;0;0;1;1;49990;Horno Microondas Mecanico Easy Wave 20Lts;ELECTRODOMESTICOS
8699575;;F;60;CHILENO;;Boomers;LOS ANGELES                   ;BIO BIO;34990;1;1;0;0;0;1;1;34990;Licuadora TH-501V 1,5Lts Vaso Vidrio;ELECTRODOMESTICOS
20240218;;M;23;CHILENO;;Silencioso;PROVIDENCIA                   ;METROPOLITANA;-8990;-1;2;0;0;0;-1;2;-8990;Parrilla Electrica Chef Grill;ELECTRODOMESTICOS
10532533;;M;55;CHILENO;;Boomers;PEMUCO                        ;BIO BIO;1274960;4;2;0;0;0;4;2;1274960;Horno Electrico UT-BACKOFEN48 48Lts;ELECTRODOMESTICOS
7912309;;M;65;CHILENO;;Boomers;DIEGO DE ALMAGRO              ;ATACAMA;79990;1;1;0;0;0;1;1;79990;Batidora Pedestal UT-KLEIN700;ELECTRODOMESTICOS
9063581;;F;56;CHILENO;;Boomers;"";"";34990;1;1;0;0;0;1;1;34990;Combo Hervidor + Tostador + Sandwichera;ELECTRODOMESTICOS
12574811;;M;48;CHILENO;;X;RENCA                         ;METROPOLITANA;19990;1;1;0;0;0;1;1;19990;Hervidor Electrico UT-DUNKEL17P 2Lts Negro;ELECTRODOMESTICOS
10113055;;F;54;CHILENO;;X;CALERA                        ;VALPARAISO;335940;6;5;0;0;0;6;5;335940;Licuadora Personal TH-300PB;ELECTRODOMESTICOS
17395934;Soltero;F;32;CHILENO;;Millenial;PROVIDENCIA                   ;METROPOLITANA;39990;1;1;0;0;0;1;1;39990;Parrilla Electrica M18W;ELECTRODOMESTICOS
10615901;Casado;M;45;CHILENO;ABOGADO;X;RENCA                         ;METROPOLITANA;27990;1;1;0;0;0;1;1;27990;Hervidor Electrico Tetera UT-LECKER18R 1,8Lts;ELECTRODOMESTICOS
12031056;;F;57;CHILENO;;Boomers;PUENTE ALTO                   ;METROPOLITANA;99990;1;1;0;0;0;1;1;99990;Horno Electrico TH62I 60Lts;ELECTRODOMESTICOS
5300030;;M;78;CHILENO;;Silencioso;COPIAPO                       ;ATACAMA;262890;11;2;0;0;0;11;2;262890;Olla Arrocera OA-400NG 1,8Lts;ELECTRODOMESTICOS
14012876;;F;40;CHILENO;;X;RENGO                         ;L.G.B.OÂ´HIGGINS;25240;2;1;0;0;0;2;1;25240;HERVIDOR ELECTRICO UT-STARK18;ELECTRODOMESTICOS
18136846;;F;30;CHILENO;;Millenial;PROVIDENCIA                   ;METROPOLITANA;18990;1;1;0;0;0;1;1;18990;Hervidor Electrico TH-4515N 2Lts Negro;ELECTRODOMESTICOS
12131712;Casado;F;49;CHILENO;CIRUJANO DENTISTA;X;PROVIDENCIA                   ;METROPOLITANA;60840;2;1;2;1;60840;0;0;0;Batidora Vertical Minipimer UT-KLOT800SS;ELECTRODOMESTICOS
8458142;Casado;M;64;CHILENO;CONTADOR GENERAL;Boomers;RENCA                         ;METROPOLITANA;19990;1;1;0;0;0;1;1;19990;Batidora Manual BA-5010 Inox;ELECTRODOMESTICOS
7523555;;F;69;CHILENO;;Silencioso;COIHAIQUE                     ;AYSEN;93170;2;1;0;0;0;2;1;93170;Cafetera P65 Silver;ELECTRODOMESTICOS
17968726;;F;51;CHILENO;;X;ILLAPEL;COQUIMBO;47980;2;2;0;0;0;2;2;47980;Batidora Manual TH-8830;ELECTRODOMESTICOS
23440059;;M;33;BOLIVIANO;;Extranjero;ANTOFAGASTA                   ;ANTOFAGASTA;34990;1;1;0;0;0;1;1;34990;Licuadora TH-401V Roja 1,75Lts Vaso Vidrio;ELECTRODOMESTICOS
11757901;Soltero;F;50;CHILENO;;X;LAS CABRAS                    ;L.G.B.OÂ´HIGGINS;151270;2;1;0;0;0;2;1;151270;Horno Electrico TH-80i 80Lts;ELECTRODOMESTICOS
15670593;;F;44;CHILENO;;X;PROVIDENCIA                   ;METROPOLITANA;18990;1;1;0;0;0;1;1;18990;Batidora Manual TH-8830;ELECTRODOMESTICOS
12855649;;F;47;CHILENO;;X;N/D;N/D;29990;1;1;0;0;0;1;1;29990;HORNO ELECTRICO 16N01 16LTS NEGRO;ELECTRODOMESTICOS
7877877;;M;63;CHILENO;;Boomers;LOS ANGELES                   ;BIO BIO;39990;1;1;0;0;0;1;1;39990;Aspiradora AP1700 Arrastre 1700Watts;ELECTRODOMESTICOS
9999923;;M;54;CHILENO;;X;CORONEL                       ;BIO BIO;45910;9;2;0;0;0;9;2;45910;Batidora Vertical Minipimer UT-KLOT800SS;ELECTRODOMESTICOS
9203630;;F;62;CHILENO;;Boomers;RENCA                         ;METROPOLITANA;10990;1;1;0;0;0;1;1;10990;Exprimidor de Jugo CJ-2000 1Lts;ELECTRODOMESTICOS
19876357;;F;23;CHILENO;;Silencioso;PROVIDENCIA                   ;METROPOLITANA;169990;1;1;1;1;169990;0;0;0;Horno Electrico TH-100i 100Lts;ELECTRODOMESTICOS
26755714;;M;36;VENEZOLANO;;Extranjero;TALCA                         ;MAULE;59990;1;1;0;0;0;1;1;59990;Horno Electrico TH-38N 38Lts;ELECTRODOMESTICOS
12781325;;F;47;CHILENO;;X;SAN VICENTE                   ;L.G.B.OÂ´HIGGINS;34990;1;1;0;0;0;1;1;34990;Licuadora TH-401V Roja 1,75Lts Vaso Vidrio;ELECTRODOMESTICOS
6533329;;F;70;CHILENO;;Silencioso;N/D;N/D;271630;3;2;2;1;218640;1;1;52990;Mi Vacuum Cleaner G10 - 28671;ELECTRODOMESTICOS
6634784;;M;70;CHILENO;;Silencioso;SAN BERNARDO                  ;METROPOLITANA;14990;1;1;0;0;0;1;1;14990;Batidora Manual 3532;ELECTRODOMESTICOS
16574927;;M;35;CHILENO;;Millenial;NANCAGUA                      ;L.G.B.OÂ´HIGGINS;59990;1;1;0;0;0;1;1;59990;Aspiradora TH1870 Arrastre 1800Watts Gris;ELECTRODOMESTICOS
9670916;;M;57;CHILENO;;Boomers;RENCA                         ;METROPOLITANA;64990;1;1;0;0;0;1;1;64990;Aspiradora TH1870 Arrastre 1800Watts Gris;ELECTRODOMESTICOS
6109978;;M;69;CHILENO;;Silencioso;RENCA                         ;METROPOLITANA;12990;1;1;0;0;0;1;1;12990;Batidora Vertical Stick Mixer 2609;ELECTRODOMESTICOS
16567236;;F;35;CHILENO;;Millenial;ARAUCO                        ;BIO BIO;30990;1;3;0;0;0;1;3;30990;Hervidor Electrico Tetera TH-6505RT 1,7Lts Rojo;ELECTRODOMESTICOS
10943352;;M;55;CHILENO;;Boomers;N/D;N/D;89990;1;1;0;0;0;1;1;89990;Horno Electrico TH62I 60Lts;ELECTRODOMESTICOS
18400289;;M;29;CHILENO;;Millenial;PROVIDENCIA                   ;METROPOLITANA;344980;2;2;0;0;0;2;2;344980;Sandwichera TH-952 2 Panes Blanca;ELECTRODOMESTICOS
11397667;;F;52;CHILENO;;X;MOSTAZAL                      ;L.G.B.OÂ´HIGGINS;19990;1;1;0;0;0;1;1;19990;Plancha TH-7052 2000Watts Base Inox;ELECTRODOMESTICOS
18348052;Soltero;F;29;CHILENO;;Millenial;PROVIDENCIA                   ;METROPOLITANA;39990;1;1;0;0;0;1;1;39990;Horno Electrico UT-BACKOFEN26 26Lts;ELECTRODOMESTICOS
17214677;;F;33;CHILENO;;Millenial;TALCA                         ;MAULE;89990;1;1;0;0;0;1;1;89990;Horno Microondas Digital L UT-25KROMM 25Lts;ELECTRODOMESTICOS
18677645;;F;26;CHILENO;;Z;CATEMU                        ;VALPARAISO;26980;2;1;0;0;0;2;1;26980;Combo Hervidor + Batidora;ELECTRODOMESTICOS
14687877;;M;68;CHILENO;;Extranjero;ARICA                         ;ARICA Y PARINACOTA;54990;1;1;0;0;0;1;1;54990;Horno Microondas Mecanico UT-SYDNEY18 18Lts;ELECTRODOMESTICOS
10757097;;F;53;CHILENO;;X;TOCOPILLA                     ;ANTOFAGASTA;161979;2;1;0;0;0;2;1;161979;Horno Electrico TH-80i 80Lts;ELECTRODOMESTICOS
8957633;;M;56;CHILENO;;Boomers;QUINTA NORMAL                 ;METROPOLITANA;26990;1;1;0;0;0;1;1;26990;Licuadora L2000VNG 1,5Lts Vaso Vidrio;ELECTRODOMESTICOS
17758120;;M;31;CHILENO;;Millenial;LINARES                       ;MAULE;10990;1;1;0;0;0;1;1;10990;Exprimidor de Jugo CJ-2000 1Lts;ELECTRODOMESTICOS
13298113;;F;44;CHILENO;;X;N/D;N/D;59990;1;1;0;0;0;1;1;59990;Horno Microondas Mecanico M-2030 NG 20Lts;ELECTRODOMESTICOS
8494854;Casado;F;62;CHILENO;;Boomers;RENCA                         ;METROPOLITANA;64990;1;1;0;0;0;1;1;64990;Horno Electrico TH-38N 38Lts;ELECTRODOMESTICOS
7005535;;F;64;CHILENO;;Boomers;PROVIDENCIA                   ;METROPOLITANA;24990;1;1;0;0;0;1;1;24990;Licuadora Roja 550W 1,5Lts Vaso Vidrio;ELECTRODOMESTICOS
14427996;;F;50;CHILENO;;X;PAINE                         ;METROPOLITANA;12990;1;1;0;0;0;1;1;12990;Batidora Vertical Stick Mixer 2609;ELECTRODOMESTICOS
15165453;;F;38;CHILENO;;X;BULNES                        ;BIO BIO;24990;1;1;0;0;0;1;1;24990;Licuadora L2000VNG 1,5Lts Vaso Vidrio;ELECTRODOMESTICOS
18671456;;F;28;CHILENO;;Millenial;N/D;N/D;53940;6;2;0;0;0;6;2;53940;Combo Juguera + Hervidor;ELECTRODOMESTICOS
18484326;;F;29;CHILENO;;Millenial;N/D;N/D;18990;1;1;0;0;0;1;1;18990;MULTIMIXER THOMAS TH- 8706;ELECTRODOMESTICOS
4470600;;M;80;CHILENO;;Silencioso;VALDIVIA                      ;LOS RIOS;28990;1;1;0;0;0;1;1;28990;PICADORA 123 SILHQUETTE;ELECTRODOMESTICOS
5808045;;M;73;CHILENO;;Silencioso;PROVIDENCIA                   ;METROPOLITANA;24990;1;1;0;0;0;1;1;24990;Licuadora Roja 550W 1,5Lts Vaso Vidrio;ELECTRODOMESTICOS
8595598;;F;65;CHILENO;;Boomers;RENCA                         ;METROPOLITANA;38990;1;1;0;0;0;1;1;38990;Aspiradora Handy Clean Black 1400;ELECTRODOMESTICOS
13703265;;M;43;CHILENO;;X;LA FLORIDA                    ;METROPOLITANA;28980;2;1;0;0;0;2;1;28980;Plancha UT-KERAMIK1 2200Watts Base Ceramica;ELECTRODOMESTICOS
15914112;;F;36;CHILENO;;Millenial;N/D;N/D;59990;1;1;0;0;0;1;1;59990;Aspiradora TH1870 Arrastre 1800Watts Gris;ELECTRODOMESTICOS
20147492;;M;22;CHILENO;;Z;N/D;N/D;179970;3;2;0;0;0;3;2;179970;HERVIDOR TH-4340;ELECTRODOMESTICOS
12040274;Casado;F;53;CHILENO;;X;RENCA                         ;METROPOLITANA;30980;2;1;2;1;30980;0;0;0;Hervidor Electrico Tetera HA-4100 4Lts Iox;ELECTRODOMESTICOS
26996210;;F;36;VENEZOLANO;;Extranjero;LOS ANDES;VALPARAISO;14990;1;1;0;0;0;1;1;14990;Sandwichera TH-952 2 Panes Blanca;ELECTRODOMESTICOS
10900342;;M;56;CHILENO;;Millenial;LOS ANGELES                   ;BIO BIO;49990;1;1;0;0;0;1;1;49990;Horno Microondas Mecanico Easy Wave 20Lts;ELECTRODOMESTICOS
18650298;;F;27;CHILENO;;Millenial;PROVIDENCIA                   ;METROPOLITANA;99990;1;1;0;0;0;1;1;99990;Horno Electrico TH62I 60Lts;ELECTRODOMESTICOS
8890631;;F;62;CHILENO;;Boomers;OVALLE                        ;COQUIMBO;14990;1;3;0;0;0;1;3;14990;Batidora Manual 3532;ELECTRODOMESTICOS
20476803;;F;22;CHILENO;;Z;VALPARAISO                    ;VALPARAISO;12990;1;1;1;1;12990;0;0;0;Exprimidor de Jugo CJ-2000 1Lts;ELECTRODOMESTICOS
24443663;;F;39;CHILENO;;X;MAIPU                         ;METROPOLITANA;29990;1;1;1;1;29990;0;0;0;Olla Arrocera Multiuso Oster 7129S;ELECTRODOMESTICOS
14477952;;F;51;CHILENO;;X;RENCA                         ;METROPOLITANA;29980;2;1;0;0;0;2;1;29980;HERVIDOR TH-4340;ELECTRODOMESTICOS
25739088;;F;42;VENEZOLANO;;Extranjero;N/D;N/D;49990;1;1;0;0;0;1;1;49990;Horno Microondas Mecanico Easy Wave 20Lts;ELECTRODOMESTICOS
11644857;;F;52;CHILENO;;X;CALBUCO                       ;LOS LAGOS;34990;1;1;0;0;0;1;1;34990;Licuadora TH-401V Roja 1,75Lts Vaso Vidrio;ELECTRODOMESTICOS
14431909;;F;52;CHILENO;;X;TENO                          ;MAULE;69990;1;1;0;0;0;1;1;69990;Aspiradora UT-SILENT1804 Arrastre 1800Watts;ELECTRODOMESTICOS
13045774;;F;45;CHILENO;;X;PENAFLOR                      ;METROPOLITANA;94990;1;1;0;0;0;1;1;94990;Horno Electrico UT-BACKOFEN60 60Lts;ELECTRODOMESTICOS
8017119;Casado;M;65;CHILENO;;Boomers;RENCA                         ;METROPOLITANA;107970;3;1;0;0;0;3;1;107970;Horno Electrico TH-25N01 25Lts;ELECTRODOMESTICOS
9792030;;F;56;CHILENO;;Boomers;RENCA                         ;METROPOLITANA;27990;1;1;0;0;0;1;1;27990;Picadora UT-PETRUS320 1Lts Vaso Vidrio;ELECTRODOMESTICOS
10272109;;F;57;CHILENO;;Boomers;N/D;N/D;32990;1;1;0;0;0;1;1;32990;Batidora Pedestal B5300 Inox;ELECTRODOMESTICOS
8728632;;F;63;CHILENO;;Boomers;PROVIDENCIA                   ;METROPOLITANA;11990;1;1;0;0;0;1;1;11990;Batidora Vertical Multimixer TH-8720;ELECTRODOMESTICOS
11117685;;F;54;CHILENO;;Boomers;ANCUD                         ;LOS LAGOS;77980;2;1;0;0;0;2;1;77980;Licuadora TH-401V Roja 1,75Lts Vaso Vidrio;ELECTRODOMESTICOS
19056487;Soltero;F;27;CHILENO;;Z;PROVIDENCIA                   ;METROPOLITANA;0;0;2;0;0;0;0;2;0;Horno Electrico TH-48N 48Lts;ELECTRODOMESTICOS
14455298;Casado;M;48;CHILENO;;X;RENCA                         ;METROPOLITANA;27990;1;1;0;0;0;1;1;27990;Picadora UT-PETRUS320 1Lts Vaso Vidrio;ELECTRODOMESTICOS
11076207;;F;56;CHILENO;;Boomers;RENCA                         ;METROPOLITANA;59990;1;1;0;0;0;1;1;59990;Horno Microondas Mecanico UT-SYDNEY18 18Lts;ELECTRODOMESTICOS
25899624;;F;46;CHILENO;;Extranjero;N/D;N/D;254250;4;1;0;0;0;4;1;254250;Maquina de Coser Remington J011;ELECTRODOMESTICOS
15712226;;F;41;CHILENO;;X;N/D;N/D;9990;1;1;0;0;0;1;1;9990;Plancha a Vapor Oster 3803;ELECTRODOMESTICOS
5351073;;M;75;CHILENO;;Silencioso;COPIAPO                       ;ATACAMA;73990;3;1;0;0;0;3;1;73990;Horno Electrico TH-25N01 25Lts;ELECTRODOMESTICOS
19706289;;F;25;CHILENO;;Z;PROVIDENCIA                   ;METROPOLITANA;43980;2;1;0;0;0;2;1;43980;Licuadora Roja 550W 1,5Lts Vaso Vidrio;ELECTRODOMESTICOS
26826042;;F;31;VENEZOLANO;;Extranjero;CONCEPCION                    ;BIO BIO;103820;4;2;2;1;85840;2;1;17980;FREIDORA DE AIRE THOMAS TH-AF60Mi;ELECTRODOMESTICOS
9037475;Casado;M;61;CHILENO;;Boomers;TALAGANTE                     ;METROPOLITANA;14990;1;1;0;0;0;1;1;14990;Exprimidor de Jugo 407W 1Lts;ELECTRODOMESTICOS
7080549;;M;67;CHILENO;;Boomers;LINARES                       ;MAULE;0;0;2;0;0;0;0;2;0;Tostador de Pan TH-126 4 Rebanadas Negro;ELECTRODOMESTICOS
19644184;;M;25;CHILENO;;Extranjero;N/D;N/D;434350;4;2;0;0;0;4;2;434350;Aspiradora UT-KRAFT(DIG) Arrastre 2200Watts;ELECTRODOMESTICOS
12419115;;F;49;CHILENO;;X;CONSTITUCION                  ;MAULE;114990;1;3;0;0;0;1;3;114990;Horno Electrico TH-80i 80Lts;ELECTRODOMESTICOS
20349910;;F;21;CHILENO;;Z;CONSTITUCION                  ;MAULE;74990;1;1;0;0;0;1;1;74990;Horno Microondas Digital TH-20S01 20Lts;ELECTRODOMESTICOS
16850287;;M;38;CHILENO;;Millenial;PROVIDENCIA                   ;METROPOLITANA;19990;1;1;0;0;0;1;1;19990;Hervidor Electrico UT-DUNKEL17P 2Lts Negro;ELECTRODOMESTICOS
14569243;;F;46;CHILENO;;X;N/D;N/D;74990;1;1;0;0;0;1;1;74990;MICROONDAS ME83X/XZS SAMSUNG MIRROR;ELECTRODOMESTICOS
16783724;;M;34;CHILENO;;Silencioso;PROVIDENCIA                   ;METROPOLITANA;29990;1;1;1;1;29990;0;0;0;Licuadora L1000 Inox 1,7LtsVaso Vidrio;ELECTRODOMESTICOS
12537414;;M;48;CHILENO;;X;NUEVA IMPERIAL                ;ARAUCANIA;250970;3;3;0;0;0;3;3;250970;Picadora UT-PETRUS320 1Lts Vaso Vidrio;ELECTRODOMESTICOS
19002847;;F;27;CHILENO;;Z;PUENTE ALTO                   ;METROPOLITANA;34990;1;1;0;0;0;1;1;34990;Plancha UT-SHANGRILA Inalambrica 2200Watss;ELECTRODOMESTICOS
13449363;;F;43;CHILENO;;Millenial;RIO CLARO                     ;MAULE;29990;1;1;0;0;0;1;1;29990;Licuadora Kaliman Negra con Teclas;ELECTRODOMESTICOS
8233390;;M;51;CHILENO;;X;PROVIDENCIA                   ;METROPOLITANA;27990;1;1;0;0;0;1;1;27990;Plancha THOMAS TH-7170 2200Watts Base Ceramica;ELECTRODOMESTICOS
19297841;;F;25;CHILENO;;Z;PROVIDENCIA                   ;METROPOLITANA;23990;1;1;0;0;0;1;1;23990;Batidora Manual BA-5010 Inox;ELECTRODOMESTICOS
18024066;;F;29;CHILENO;;Silencioso;PROVIDENCIA                   ;METROPOLITANA;185840;2;1;2;1;185840;0;0;0;Robot aspirador Roomba 614;ELECTRODOMESTICOS
26210691;;M;30;EXTRANJERO - NO INFORMA NACIONALIDAD;;Extranjero;N/D;N/D;44990;1;1;0;0;0;1;1;44990;Aspiradora Handy Clean Black 1400;ELECTRODOMESTICOS
6154686;;M;67;CHILENO;;Boomers;RENCA                         ;METROPOLITANA;36990;1;1;0;0;0;1;1;36990;Aspiradora AP1700 Arrastre 1700Watts;ELECTRODOMESTICOS
14139286;Soltero;F;41;CHILENO;;X;PROVIDENCIA                   ;METROPOLITANA;13990;1;1;0;0;0;1;1;13990;Batidora Vertical Stick Mixer 2609;ELECTRODOMESTICOS
7456275;;M;65;CHILENO;;Boomers;CALAMA                        ;ANTOFAGASTA;47990;1;1;0;0;0;1;1;47990;PROCESADOR THOMAS TH-9160;ELECTRODOMESTICOS
13302415;;M;44;CHILENO;;X;COINCO                        ;L.G.B.OÂ´HIGGINS;124540;2;1;2;1;124540;0;0;0;Maquina de coser computarizada SH7700;ELECTRODOMESTICOS
10945009;;F;50;CHILENO;;X;PROVIDENCIA                   ;METROPOLITANA;133980;2;1;2;1;133980;0;0;0;Maquina de Coser JS-2135CL Calipso;ELECTRODOMESTICOS
9437651;;F;60;CHILENO;;Boomers;N/D;N/D;26990;1;1;0;0;0;1;1;26990;Tostador de Pan TP-1400 4 Rebanadas Inox;ELECTRODOMESTICOS
19698737;;F;26;CHILENO;;Z;PROVIDENCIA                   ;METROPOLITANA;34990;1;1;1;1;34990;0;0;0;Aspiradora TH1407 Arrastre 1400Watts;ELECTRODOMESTICOS
15132566;;F;38;CHILENO;;Millenial;CURICO                        ;MAULE;22392;1;1;0;0;0;1;1;22392;Plancha THOMAS TH-7170 2200Watts Base Ceramica;ELECTRODOMESTICOS
10807673;;M;56;CHILENO;;Boomers;EL QUISCO                     ;VALPARAISO;79990;1;1;0;0;0;1;1;79990;Horno Electrico TH62I 60Lts;ELECTRODOMESTICOS
12528007;;F;48;CHILENO;;X;QUILPUE                       ;VALPARAISO;12593;1;1;0;0;0;1;1;12593;Hervidor Electrico TH-4515N 2Lts Negro;ELECTRODOMESTICOS
18677338;;F;27;CHILENO;;Millenial;N/D;N/D;142940;6;1;6;1;142940;0;0;0;Set Picador KP-123BL 1,2Lts;ELECTRODOMESTICOS
16856186;;F;34;CHILENO;;Millenial;RENCA                         ;METROPOLITANA;22990;1;1;1;1;22990;0;0;0;Batidora Manual BA-5010 Inox;ELECTRODOMESTICOS
4233638;;M;81;CHILENO;;Silencioso;RANCAGUA                      ;L.G.B.OÂ´HIGGINS;79990;1;1;0;0;0;1;1;79990;Horno Electrico TH-48N 48Lts;ELECTRODOMESTICOS
10129856;;F;57;CHILENO;;Boomers;SAN PEDRO DE ATACAMA          ;ANTOFAGASTA;54990;1;1;0;0;0;1;1;54990;Horno Microondas Mecanico TH-18B05 18Lts;ELECTRODOMESTICOS
14000995;;F;41;CHILENO;;X;QUILPUE                       ;VALPARAISO;44990;1;1;0;0;0;1;1;44990;Horno Electrico TH-25N01 25Lts;ELECTRODOMESTICOS
6557762;;F;68;CHILENO;;Silencioso;PENAFLOR                      ;METROPOLITANA;69990;3;1;0;0;0;3;1;69990;Horno Electrico TH-25N01 25Lts;ELECTRODOMESTICOS
12710298;;F;47;CHILENO;;X;RENGO                         ;L.G.B.OÂ´HIGGINS;207980;2;2;0;0;0;2;2;207980;Hervidor Electrico Tetera TH-6505RT 1,7Lts Rojo;ELECTRODOMESTICOS
9140846;;M;60;CHILENO;;Boomers;PROVIDENCIA                   ;METROPOLITANA;0;0;2;0;0;0;0;2;0;Horno Electrico TH62I 60Lts;ELECTRODOMESTICOS
15115355;;F;39;CHILENO;;X;MELIPILLA                     ;METROPOLITANA;43980;2;2;0;0;0;2;2;43980;Tostador de Pan TH-116 2 Rebanadas Negro;ELECTRODOMESTICOS
17317119;;F;32;CHILENO;;Millenial;PROVIDENCIA                   ;METROPOLITANA;147960;4;2;4;2;147960;0;0;0;Freidora de Aire Oster 40M;ELECTRODOMESTICOS
16977596;;F;33;CHILENO;;Silencioso;PROVIDENCIA                   ;METROPOLITANA;33980;2;1;2;1;33980;0;0;0;Aspiradora Polvo AP-700 GR;ELECTRODOMESTICOS
11558338;;M;52;CHILENO;;X;RENCA                         ;METROPOLITANA;17990;1;1;0;0;0;1;1;17990;Hervidor Electrico TH-4515N 2Lts Negro;ELECTRODOMESTICOS
20094638;;F;23;CHILENO;;Z;PROVIDENCIA                   ;METROPOLITANA;24990;1;1;0;0;0;1;1;24990;BATIDORA MANUAL 260R;ELECTRODOMESTICOS
16155939;Soltero;M;36;CHILENO;;Silencioso;PROVIDENCIA                   ;METROPOLITANA;139680;3;1;3;1;139680;0;0;0;Freidora electrica Ut-KeramikAir;ELECTRODOMESTICOS
8529250;;F;61;CHILENO;;Boomers;LOS ANGELES                   ;BIO BIO;44990;1;2;0;0;0;1;2;44990;Horno Electrico TH-25N01 25Lts;ELECTRODOMESTICOS
16162572;;F;36;CHILENO;;Millenial;LOS ANDES                     ;VALPARAISO;27990;1;1;0;0;0;1;1;27990;Hervidor Electrico Tetera TH-6505RT 1,7Lts Rojo;ELECTRODOMESTICOS
18944239;;F;27;CHILENO;;Millenial;PROVIDENCIA                   ;METROPOLITANA;199990;3;1;0;0;0;3;1;199990;Horno Electrico TH-100i 100Lts;ELECTRODOMESTICOS
16271990;;M;34;CHILENO;;Millenial;N/D;N/D;98000;9;1;0;0;0;9;1;98000;Licuadora Kaliman Negra con Teclas;ELECTRODOMESTICOS
26054184;;M;40;EXTRANJERO - NO INFORMA NACIONALIDAD;;Extranjero;SAN BERNARDO                  ;METROPOLITANA;219860;3;2;0;0;0;3;2;219860;Licuadora TH-320 Roja/Negro 1,5 Lts Vaso Vidrio;ELECTRODOMESTICOS
17213305;;M;32;CHILENO;;Millenial;PURRANQUE                     ;LOS LAGOS;196850;4;1;0;0;0;4;1;196850;Horno Electrico TH62I 60Lts;ELECTRODOMESTICOS
26440671;;M;58;CHILENO;;Extranjero;HUALPEN;BIO BIO;59990;1;1;0;0;0;1;1;59990;ASPIRADORA ROBOT WIFI FIDDLER HOME BLANCA;ELECTRODOMESTICOS
17625935;;F;31;CHILENO;;Silencioso;PROVIDENCIA                   ;METROPOLITANA;144980;2;1;2;1;144980;0;0;0;Maquina de Coser 311;ELECTRODOMESTICOS
10006894;Casado;F;58;CHILENO;;Boomers;PROVIDENCIA                   ;METROPOLITANA;24990;1;1;0;0;0;1;1;24990;Licuadora Berry Blender Roja 1400 Vaso Vidrio;ELECTRODOMESTICOS
4283538;;M;79;CHILENO;;Silencioso;TALAGANTE                     ;METROPOLITANA;468850;4;2;0;0;0;4;2;468850;Horno Microondas Digital TH-25DM 25Lts;ELECTRODOMESTICOS
19968147;;F;23;CHILENO;;Z;ANTOFAGASTA                   ;ANTOFAGASTA;13990;1;1;0;0;0;1;1;13990;Batidora Vertical Stick Mixer 2609;ELECTRODOMESTICOS
18166481;;M;30;CHILENO;;Silencioso;PROVIDENCIA                   ;METROPOLITANA;29990;1;1;1;1;29990;0;0;0;Horno Electrico TH-25N01 25Lts;ELECTRODOMESTICOS
3871572;;F;77;CHILENO;;Silencioso;PROVIDENCIA                   ;METROPOLITANA;27990;1;1;0;0;0;1;1;27990;Hervidor Electrico Tetera TH-6505RT 1,7Lts Rojo;ELECTRODOMESTICOS
13901607;;M;42;CHILENO;;X;PROVIDENCIA                   ;METROPOLITANA;49990;2;1;2;1;49990;0;0;0;Cafetera P65 Silver;ELECTRODOMESTICOS
12544912;;F;50;CHILENO;;X;CAUQUENES                     ;MAULE;47990;1;1;0;0;0;1;1;47990;Horno Electrico TH-25N01 25Lts;ELECTRODOMESTICOS
17196888;;F;29;CHILENO;;Millenial;QUELLON;LOS LAGOS;119980;2;2;2;2;119980;0;0;0;Batidora Pedestal TH910PN 4,6Lts 1300Watts;ELECTRODOMESTICOS
16352232;Soltero;F;36;CHILENO;;Millenial;RENCA                         ;METROPOLITANA;12990;1;1;0;0;0;1;1;12990;Hervidor Electrico TH-4212N 1,7Lts Negro;ELECTRODOMESTICOS
8097104;;F;60;CHILENO;;Boomers;LA SERENA                     ;COQUIMBO;36990;1;1;0;0;0;1;1;36990;Aspiradora AP1700 Arrastre 1700Watts;ELECTRODOMESTICOS
12190560;;F;55;CHILENO;;Boomers;VICTORIA                      ;ARAUCANIA;27990;1;1;0;0;0;1;1;27990;Licuadora TH-320 Roja/Negro 1,5 Lts Vaso Vidrio;ELECTRODOMESTICOS
18786755;;M;28;CHILENO;;Millenial;VILLA ALEMANA                 ;VALPARAISO;874970;3;2;3;2;874970;0;0;0;Aspiradora TH1407 Arrastre 1400Watts;ELECTRODOMESTICOS
13201810;Soltero;M;44;CHILENO;;X;PROVIDENCIA                   ;METROPOLITANA;39990;1;1;0;0;0;1;1;39990;HERVIDOR TETERA RELOJ 900R 2,5L ROJO;ELECTRODOMESTICOS
9042251;;F;61;CHILENO;;Boomers;RENCA                         ;METROPOLITANA;16990;1;1;0;0;0;1;1;16990;Hervidor Electrico HA-3300 2,5Lts Blanco;ELECTRODOMESTICOS
12816104;;F;46;CHILENO;;X;SALAMANCA                     ;COQUIMBO;49990;1;1;1;1;49990;0;0;0;Batidora Vertical Minipimer UT-KLOT800SS;ELECTRODOMESTICOS
3544871;;M;84;CHILENO;;Silencioso;RENCA                         ;METROPOLITANA;64990;1;1;0;0;0;1;1;64990;Aspiradora TH1870 Arrastre 1800Watts Gris;ELECTRODOMESTICOS
9983019;;M;55;CHILENO;;Boomers;RENCA                         ;METROPOLITANA;14990;1;1;0;0;0;1;1;14990;Exprimidor de Jugo 407W 1Lts;ELECTRODOMESTICOS
12408846;;F;49;CHILENO;;X;COLINA                        ;METROPOLITANA;44980;2;2;0;0;0;2;2;44980;Licuadora L2000VNG 1,5Lts Vaso Vidrio;ELECTRODOMESTICOS
11388542;;M;53;CHILENO;;X;PROVIDENCIA                   ;METROPOLITANA;16990;1;1;0;0;0;1;1;16990;Batidora Manual TH-8830;ELECTRODOMESTICOS
12064056;;F;52;CHILENO;;X;PROVIDENCIA                   ;METROPOLITANA;27990;1;1;0;0;0;1;1;27990;Plancha THOMAS TH-7170 2200Watts Base Ceramica;ELECTRODOMESTICOS
7904310;;F;60;CHILENO;;Boomers;CASTRO                        ;LOS LAGOS;27990;1;1;0;0;0;1;1;27990;Plancha THOMAS TH-7170 2200Watts Base Ceramica;ELECTRODOMESTICOS
17056469;;F;33;CHILENO;;Millenial;QUELLON                       ;LOS LAGOS;59990;1;1;0;0;0;1;1;59990;Horno Microondas Mecanico Easy Wave 20Lts;ELECTRODOMESTICOS
19007280;;F;27;CHILENO;;Z;PROVIDENCIA                   ;METROPOLITANA;14990;1;1;0;0;0;1;1;14990;Tostador de Pan TH-116 2 Rebanadas Negro;ELECTRODOMESTICOS
6484999;;F;71;CHILENO;;Silencioso;PROVIDENCIA                   ;METROPOLITANA;59990;1;1;0;0;0;1;1;59990;Horno Microondas Mecanico UT-SYDNEY18 18Lts;ELECTRODOMESTICOS
17696110;;M;31;CHILENO;;Millenial;SAN CARLOS                    ;BIO BIO;27990;1;1;0;0;0;1;1;27990;Plancha UT-PLATTEISEN 2000Watts Base Ceramica;ELECTRODOMESTICOS
18296694;;M;29;CHILENO;;Millenial;N/D;N/D;93170;2;1;0;0;0;2;1;93170;MICROONDAS ME83X/XZS SAMSUNG MIRROR;ELECTRODOMESTICOS
18410974;;M;28;CHILENO;;Silencioso;PROVIDENCIA                   ;METROPOLITANA;96980;2;1;2;1;96980;0;0;0;Horno Microondas Digital MS28F303TAS/ZS 28Lts;ELECTRODOMESTICOS
10713455;;F;52;CHILENO;;X;RENCA                         ;METROPOLITANA;134980;2;1;0;0;0;2;1;134980;Batidora Pedestal TH910PN 4,6Lts 1300Watts;ELECTRODOMESTICOS
13808288;;M;42;CHILENO;;Silencioso;TRAIGUEN                      ;ARAUCANIA;47670;2;1;0;0;0;2;1;47670;LICUADORA CROMADA CON TECLAS PLUS;ELECTRODOMESTICOS
7663926;;F;69;CHILENO;;Silencioso;LA CISTERNA                   ;METROPOLITANA;118160;3;1;0;0;0;3;1;118160;Horno Microondas Mecanico TH-18B05 18Lts;ELECTRODOMESTICOS
12363254;;M;48;CHILENO;;X;LOS ALAMOS                    ;BIO BIO;670460;4;2;0;0;0;4;2;670460;Hervidor Electrico Tetera TH-6505RT 1,7Lts Rojo;ELECTRODOMESTICOS
19056259;Soltero;F;27;CHILENO;;Z;"";"";17990;1;1;0;0;0;1;1;17990;Hervidor Electrico TH-4515N 2Lts Negro;ELECTRODOMESTICOS
6673485;;F;71;CHILENO;;Silencioso;N/D;N/D;81660;3;1;0;0;0;3;1;81660;Horno Microondas Mecanico Easy Wave 20Lts;ELECTRODOMESTICOS
6524190;;F;70;CHILENO;;Silencioso;PEDRO AGUIRRE CERDA           ;METROPOLITANA;59990;1;1;1;1;59990;0;0;0;Batidora Pedestal TH910PN 4,6Lts 1300Watts;ELECTRODOMESTICOS
15120296;;F;37;CHILENO;;Millenial;CHIMBARONGO                   ;L.G.B.OÂ´HIGGINS;399980;2;2;0;0;0;2;2;399980;Enceradora EA-5000;ELECTRODOMESTICOS
17304933;;F;32;CHILENO;;Millenial;PUDAHUEL                      ;METROPOLITANA;38980;2;1;2;1;38980;0;0;0;ASPIRADORA THOMAS TH-1640;ELECTRODOMESTICOS
17065796;;F;33;CHILENO;;Millenial;"";"";63980;2;1;2;1;63980;0;0;0;Horno Electrico TH-38N 38Lts;ELECTRODOMESTICOS
8621477;;F;64;CHILENO;;Boomers;PROVIDENCIA                   ;METROPOLITANA;40840;2;1;2;1;40840;0;0;0;ASPIRADORA THOMAS TH-1640;ELECTRODOMESTICOS
9434864;;F;57;CHILENO;;Silencioso;PROVIDENCIA                   ;METROPOLITANA;40840;2;1;2;1;40840;0;0;0;ASPIRADORA THOMAS TH-1640;ELECTRODOMESTICOS
19580626;;F;25;CHILENO;;Z;PROVIDENCIA                   ;METROPOLITANA;19990;1;1;0;0;0;1;1;19990;Hervidor Electrico UT-DUNKEL17P 2Lts Negro;ELECTRODOMESTICOS
7482848;;M;66;CHILENO;;Boomers;N/D;N/D;19593;1;1;0;0;0;1;1;19593;Hervidor Electrico Tetera TH-6505RT 1,7Lts Rojo;ELECTRODOMESTICOS
17827016;;F;31;CHILENO;;Millenial;PROVIDENCIA                   ;METROPOLITANA;27990;1;1;0;0;0;1;1;27990;Hervidor Electrico Tetera TH-6505RT 1,7Lts Rojo;ELECTRODOMESTICOS
9696757;;M;57;CHILENO;;Boomers;N/D;N/D;24990;1;1;0;0;0;1;1;24990;Plancha UT-KERAMIK1 2200Watts Base Ceramica;ELECTRODOMESTICOS
8244214;;M;62;CHILENO;;Boomers;ANTOFAGASTA                   ;ANTOFAGASTA;107650;4;1;0;0;0;4;1;107650;Plancha UT-SHANGRILA Inalambrica 2200Watss;ELECTRODOMESTICOS
7137858;Soltero;F;63;CHILENO;;Boomers;ESTACION CENTRAL              ;METROPOLITANA;13990;1;1;0;0;0;1;1;13990;Batidora Vertical Stick Mixer 2609;ELECTRODOMESTICOS
27016168;;M;31;VENEZOLANO;;Extranjero;N/D;N/D;14990;1;1;0;0;0;1;1;14990;Batidora Manual 3532;ELECTRODOMESTICOS
8458470;;F;57;CHILENO;;Boomers;PROVIDENCIA                   ;METROPOLITANA;54990;1;1;0;0;0;1;1;54990;Horno Electrico UT-BACKOFEN26 26Lts;ELECTRODOMESTICOS
15313990;;M;39;CHILENO;;Millenial;N/D;N/D;73980;2;1;2;1;73980;0;0;0;Horno Microondas Digital Deli (2017 DM) 20Lts;ELECTRODOMESTICOS
20033641;;M;23;CHILENO;;Z;N/D;N/D;12990;1;1;0;0;0;1;1;12990;Hervidor Electrico 3101 1,7Lts Negro;ELECTRODOMESTICOS
11705270;;F;50;CHILENO;;X;PROVIDENCIA                   ;METROPOLITANA;34990;1;1;0;0;0;1;1;34990;HORNO ELECTRICO 16N01 16LTS NEGRO;ELECTRODOMESTICOS
10772773;;F;50;CHILENO;;X;LOTA                          ;BIO BIO;47980;2;1;0;0;0;2;1;47980;Hervidor Electrico Tetera HA-4100 4Lts Iox;ELECTRODOMESTICOS
15610027;;F;37;CHILENO;;Millenial;PENCO                         ;BIO BIO;17992;1;2;0;0;0;1;2;17992;Licuadora TH-501V 1,5Lts Vaso Vidrio;ELECTRODOMESTICOS
6045051;;M;68;CHILENO;;Silencioso;LOTA                          ;BIO BIO;14990;1;1;0;0;0;1;1;14990;Tostador de Pan TH-116 2 Rebanadas Negro;ELECTRODOMESTICOS
9699765;;F;56;CHILENO;;Boomers;TALCA                         ;MAULE;16990;1;1;0;0;0;1;1;16990;Batidora Manual TH-8830;ELECTRODOMESTICOS
15768983;Casado;M;38;CHILENO;INGENIERO CIVIL INFORMATICO;Millenial;PROVIDENCIA                   ;METROPOLITANA;88980;2;1;2;1;88980;0;0;0;ASPIRADORA THOMAS TH-2230;ELECTRODOMESTICOS
18723616;Soltero;M;27;CHILENO;TECNICO DEPORTIVO;Millenial;PROVIDENCIA                   ;METROPOLITANA;0;0;2;0;0;0;0;2;0;BATIDORA INMERSION S MIX 2616;ELECTRODOMESTICOS
17863175;;M;35;CHILENO;;Millenial;CHIGUAYANTE                   ;BIO BIO;0;0;2;0;2;0;0;0;0;Horno Microondas Digital TH-20S01 20Lts;ELECTRODOMESTICOS
10611570;;F;55;CHILENO;;Boomers;TEMUCO                        ;ARAUCANIA;159980;2;1;0;0;0;2;1;159980;Horno Electrico UT-BACKOFEN38 38Lts;ELECTRODOMESTICOS
7850825;;M;64;CHILENO;;Boomers;LA SERENA                     ;COQUIMBO;93270;2;1;0;0;0;2;1;93270;Enceradora EA-5000;ELECTRODOMESTICOS
6941708;;F;69;CHILENO;;Silencioso;CALAMA                        ;ANTOFAGASTA;272010;6;1;0;0;0;6;1;272010;Maquina de Coser BM-3850CL Lila;ELECTRODOMESTICOS
18469998;Soltero;F;29;CHILENO;CIRUJANO DENTISTA;Millenial;COIHAIQUE                     ;AYSEN;43990;1;1;0;0;0;1;1;43990;Aspiradora TH1407 Arrastre 1400Watts;ELECTRODOMESTICOS
19598656;;F;25;CHILENO;;Z;CONCEPCION                    ;BIO BIO;40670;2;1;0;0;0;2;1;40670;Licuadora Roja 550W 1,5Lts Vaso Vidrio;ELECTRODOMESTICOS
6854717;;F;70;CHILENO;;Silencioso;CALAMA                        ;ANTOFAGASTA;39670;2;1;0;0;0;2;1;39670;PICADORA 123 SILHQUETTE;ELECTRODOMESTICOS
9630009;;M;59;CHILENO;;Boomers;N/D;N/D;25990;1;1;0;0;0;1;1;25990;Plancha UT-KERAMIKTOP 2200Watts Base Ceramica;ELECTRODOMESTICOS
7512643;;M;63;CHILENO;;Boomers;ANGOL                         ;ARAUCANIA;16990;1;1;0;0;0;1;1;16990;Hervidor Electrico UT-MANLY17 1,7Lts Negro;ELECTRODOMESTICOS
12361702;;F;51;CHILENO;;X;N/D;N/D;34990;1;1;0;0;0;1;1;34990;Plancha UT-SHANGRILA Inalambrica 2200Watss;ELECTRODOMESTICOS
16806769;;F;34;CHILENO;;Millenial;VALDIVIA                      ;LOS RIOS;16990;1;1;0;0;0;1;1;16990;Batidora Manual 3532;ELECTRODOMESTICOS
8449110;;F;64;CHILENO;;Boomers;RENCA                         ;METROPOLITANA;31990;1;1;0;0;0;1;1;31990;Extractor de Jugo EX800 1,4Lts;ELECTRODOMESTICOS
10193519;;M;55;CHILENO;;Boomers;N/D;N/D;24990;1;1;0;0;0;1;1;24990;Licuadora L2000VNG 1,5Lts Vaso Vidrio;ELECTRODOMESTICOS
11627481;;F;52;CHILENO;;X;RANCAGUA                      ;L.G.B.OÂ´HIGGINS;39990;1;1;0;0;0;1;1;39990;Batidora Pedestal Bowl 300 Inox;ELECTRODOMESTICOS
9692579;;F;58;CHILENO;;Boomers;N/D;N/D;34990;1;1;0;0;0;1;1;34990;Plancha UT-SHANGRILA Inalambrica 2200Watss;ELECTRODOMESTICOS
11313417;;F;53;CHILENO;;X;TALAGANTE                     ;METROPOLITANA;27990;1;1;0;0;0;1;1;27990;Picadora UT-PETRUS320 1Lts Vaso Vidrio;ELECTRODOMESTICOS
15213905;;F;40;CHILENO;;X;PROVIDENCIA                   ;METROPOLITANA;13990;1;1;0;0;0;1;1;13990;Batidora Vertical Stick Mixer 2609;ELECTRODOMESTICOS
10874150;;F;52;CHILENO;;X;LINARES                       ;MAULE;79990;1;1;0;0;0;1;1;79990;Horno electrico Black Oven 42lts;ELECTRODOMESTICOS
14295344;;F;47;CHILENO;;X;PROVIDENCIA                   ;METROPOLITANA;24990;1;1;0;0;0;1;1;24990;Licuadora TH-320 Roja/Negro 1,5 Lts Vaso Vidrio;ELECTRODOMESTICOS
18212979;Soltero;F;30;CHILENO;;Millenial;PROVIDENCIA                   ;METROPOLITANA;17990;1;1;0;0;0;1;1;17990;Hervidor Electrico UT-KLAR20PW 2Lts Blanco;ELECTRODOMESTICOS
15456644;;M;40;CHILENO;;Silencioso;PROVIDENCIA                   ;METROPOLITANA;51670;2;1;0;0;0;2;1;51670;FREIDORA DE AIRE CKSTAF15B 1850W;ELECTRODOMESTICOS
9034337;;M;61;CHILENO;;Boomers;RENCA                         ;METROPOLITANA;12990;1;1;0;0;0;1;1;12990;Hervidor Electrico TH-4212N 1,7Lts Negro;ELECTRODOMESTICOS
7614115;;M;66;CHILENO;;Boomers;ARICA                         ;TARAPACA;53980;2;1;0;0;0;2;1;53980;Aspiradora TH1407 Arrastre 1400Watts;ELECTRODOMESTICOS
7701257;;F;65;CHILENO;;Boomers;SAN FERNANDO                  ;L.G.B.OÂ´HIGGINS;109980;2;1;0;0;0;2;1;109980;Horno Microondas Digital TH-25DM 25Lts;ELECTRODOMESTICOS
19936451;Soltero;M;29;CHILENO;;Millenial;RENCA                         ;METROPOLITANA;80980;2;1;0;0;0;2;1;80980;Horno Electrico TH-38N 38Lts;ELECTRODOMESTICOS
10240858;;F;56;CHILENO;;Boomers;COPIAPO                       ;ATACAMA;24990;1;1;0;0;0;1;1;24990;Licuadora L2000VNG 1,5Lts Vaso Vidrio;ELECTRODOMESTICOS
5058590;;M;77;CHILENO;;Silencioso;PROVIDENCIA                   ;METROPOLITANA;31980;2;1;0;0;0;2;1;31980;Hervidor Electrico HA-3300 2,5Lts Blanco;ELECTRODOMESTICOS
18543204;;M;28;CHILENO;;Millenial;PROVIDENCIA                   ;METROPOLITANA;49990;1;1;0;0;0;1;1;49990;Aspiradora TH1415 Arrastre 1500Watts;ELECTRODOMESTICOS
12498837;Casado;F;49;CHILENO;;X;PUENTE ALTO                   ;METROPOLITANA;63980;2;1;0;0;0;2;1;63980;PROCESADOR THOMAS TH-9160;ELECTRODOMESTICOS
9556390;;F;60;CHILENO;;Boomers;LINARES                       ;MAULE;89990;1;1;0;0;0;1;1;89990;Batidora Pedestal TH910PN 4,6Lts 1300Watts;ELECTRODOMESTICOS
5447518;;F;76;CHILENO;;Silencioso;RENCA                         ;METROPOLITANA;56670;2;1;0;0;0;2;1;56670;Aspiradora Tambor APA1000 1000Watts;ELECTRODOMESTICOS
8077161;;F;66;CHILENO;;Boomers;RENCA                         ;METROPOLITANA;57670;2;1;0;0;0;2;1;57670;Horno Electrico TH-25N01 25Lts;ELECTRODOMESTICOS
12223804;;F;50;CHILENO;;X;VINA DEL MAR                  ;VALPARAISO;17668;2;1;0;0;0;2;1;17668;BATIDORA INMERSION S MIX 2616;ELECTRODOMESTICOS
12717301;;M;52;CHILENO;;X;ANTOFAGASTA                   ;ANTOFAGASTA;29990;1;1;0;0;0;1;1;29990;Hervidor Electrico Tetera HA-4100 4Lts Iox;ELECTRODOMESTICOS
17279707;;M;32;CHILENO;;Silencioso;PROVIDENCIA                   ;METROPOLITANA;42990;1;1;0;0;0;1;1;42990;Aspiradora Tambor APA1000 1000Watts;ELECTRODOMESTICOS
8549456;;F;62;CHILENO;;Boomers;MOSTAZAL                      ;L.G.B.OÂ´HIGGINS;23570;2;1;0;0;0;2;1;23570;Licuadora L-1630V Negra 1,5Lts Vaso Vidrio;ELECTRODOMESTICOS
18709348;;F;28;CHILENO;;Millenial;N/D;N/D;13990;1;1;0;0;0;1;1;13990;Exprimidor de Jugo CJ-2000 1Lts;ELECTRODOMESTICOS
6701998;;M;70;CHILENO;;Silencioso;CURANILAHUE                   ;BIO BIO;139990;1;1;0;0;0;1;1;139990;Horno Electrico TH-80i 80Lts;ELECTRODOMESTICOS
5290717;;F;79;CHILENO;;Silencioso;N/D;N/D;26570;2;1;0;0;0;2;1;26570;Hervidor Electrico UT-KLAR20PW 2Lts Blanco;ELECTRODOMESTICOS
8797288;;F;63;CHILENO;;Boomers;EL BOSQUE                     ;METROPOLITANA;34990;2;1;0;0;0;2;1;34990;PICADORA 123 SILHQUETTE;ELECTRODOMESTICOS
13769888;;F;41;CHILENO;;X;PROVIDENCIA                   ;METROPOLITANA;27990;1;1;0;0;0;1;1;27990;Picadora UT-PETRUS320 1Lts Vaso Vidrio;ELECTRODOMESTICOS
9912842;;F;55;CHILENO;;Boomers;RENCA                         ;METROPOLITANA;0;0;2;0;0;0;0;2;0;Horno Microondas Digital TH20DM 20Lts Espejado;ELECTRODOMESTICOS
16454495;;M;35;CHILENO;;Millenial;RENCA                         ;METROPOLITANA;27990;1;1;1;1;27990;0;0;0;Combo Juguera + Hervidor;ELECTRODOMESTICOS
17790437;;M;35;CHILENO;;Millenial;N/D;N/D;12990;1;1;0;0;0;1;1;12990;Hervidor Electrico 3101 1,7Lts Negro;ELECTRODOMESTICOS
8527778;;M;60;CHILENO;;Extranjero;LAJA                          ;BIO BIO;24990;1;1;0;0;0;1;1;24990;Licuadora L2000VNG 1,5Lts Vaso Vidrio;ELECTRODOMESTICOS
18756170;Soltero;M;28;CHILENO;;Silencioso;PROVIDENCIA                   ;METROPOLITANA;47980;2;2;0;0;0;2;2;47980;Plancha UT-PLATTEISEN 2000Watts Base Ceramica;ELECTRODOMESTICOS
16809389;;F;34;CHILENO;;Millenial;EL BOSQUE                     ;METROPOLITANA;15240;2;1;0;0;0;2;1;15240;Exprimidor de Jugo 407W 1Lts;ELECTRODOMESTICOS
10587462;;F;57;CHILENO;;Boomers;RENCA                         ;METROPOLITANA;28990;1;1;0;0;0;1;1;28990;Plancha Vertical UT-TURBOSTEAMER 1400Watts;ELECTRODOMESTICOS
10321813;;F;58;CHILENO;;Boomers;PROVIDENCIA                   ;METROPOLITANA;16240;2;1;0;0;0;2;1;16240;Hervidor Electrico HA-3300 2,5Lts Blanco;ELECTRODOMESTICOS
9017123;Casado;M;60;CHILENO;;Boomers;RENCA                         ;METROPOLITANA;20000;2;1;0;0;0;2;1;20000;Licuadora TH-320 Roja/Negro 1,5 Lts Vaso Vidrio;ELECTRODOMESTICOS
8904152;;M;61;CHILENO;;Boomers;TEMUCO                        ;ARAUCANIA;18990;1;1;0;0;0;1;1;18990;Plancha UT-DUNST 2200Watts Base Ceramica;ELECTRODOMESTICOS
13408465;;F;43;CHILENO;;X;N/D;N/D;0;0;0;0;0;0;0;0;0;Hervidor Electrico TH-4212N 1,7Lts Negro;ELECTRODOMESTICOS
15920550;;F;38;CHILENO;;Millenial;LONGAVI                       ;MAULE;0;0;0;0;0;0;0;0;0;Plancha TH-7052 2000Watts Base Inox;ELECTRODOMESTICOS
6155370;Viudo;M;69;CHILENO;;Silencioso;RENCA                         ;METROPOLITANA;0;0;0;0;0;0;0;0;0;Combo Licuadora + Batidora;ELECTRODOMESTICOS
12982693;;M;46;CHILENO;;X;N/D;N/D;0;0;0;0;0;0;0;0;0;Aspiradora TH1407 Arrastre 1400Watts;ELECTRODOMESTICOS
20232226;;M;22;CHILENO;;Z;N/D;N/D;0;0;0;0;0;0;0;0;0;Licuadora Personal TH-300PB;ELECTRODOMESTICOS
16261635;;M;36;CHILENO;;Millenial;PROVIDENCIA                   ;METROPOLITANA;0;0;0;0;0;0;0;0;0;Horno Electrico TH62I 60Lts;ELECTRODOMESTICOS
4059389;;F;84;CHILENO;;Silencioso;ARICA                         ;ARICA Y PARINACOTA;0;0;0;0;0;0;0;0;0;Licuadora TH-501V 1,5Lts Vaso Vidrio;ELECTRODOMESTICOS
19467519;;F;25;CHILENO;;Z;N/D;N/D;0;0;0;0;0;0;0;0;0;Horno Electrico TH-80i 80Lts;ELECTRODOMESTICOS
9849642;;M;59;CHILENO;;Boomers;LAJA                          ;BIO BIO;0;0;0;0;0;0;0;0;0;Aspiradora Tambor APA1000 1000Watts;ELECTRODOMESTICOS
7708914;;F;65;CHILENO;;Boomers;RENCA                         ;METROPOLITANA;0;0;0;0;0;0;0;0;0;Sandwichera TH-952 2 Panes Blanca;ELECTRODOMESTICOS
8265764;;F;62;CHILENO;;Silencioso;PROVIDENCIA                   ;METROPOLITANA;0;0;0;0;0;0;0;0;0;Horno Microondas Digital ME0113MB1/XZS 32Lts;ELECTRODOMESTICOS
5416620;;F;76;CHILENO;;Silencioso;COIHAIQUE                     ;AYSEN;0;0;0;0;0;0;0;0;0;Combo Juguera + Hervidor;ELECTRODOMESTICOS
13733158;;M;42;CHILENO;;X;PADRE LAS CASAS               ;ARAUCANIA;0;0;0;0;0;0;0;0;0;Plancha a Vapor Oster 3803;ELECTRODOMESTICOS
13015419;;F;46;CHILENO;;Silencioso;PROVIDENCIA                   ;METROPOLITANA;0;0;0;0;0;0;0;0;0;Combo Licuadora + Batidora;ELECTRODOMESTICOS
5138832;;F;77;CHILENO;;Silencioso;RENCA                         ;METROPOLITANA;0;0;0;0;0;0;0;0;0;Batidora Vertical Stick Mixer 2609;ELECTRODOMESTICOS
14491978;Casado;F;45;CHILENO;;X;RENCA                         ;METROPOLITANA;0;0;0;0;0;0;0;0;0;Aspiradora TH1407 Arrastre 1400Watts;ELECTRODOMESTICOS
20403098;;F;22;CHILENO;;Z;CERRILLOS;METROPOLITANA;0;0;0;0;0;0;0;0;0;Licuadora Personal TH-300PB;ELECTRODOMESTICOS
11455941;;F;53;CHILENO;;X;CURICO                        ;MAULE;0;0;0;0;0;0;0;0;0;Horno Electrico TH-25N01 25Lts;ELECTRODOMESTICOS
12779438;;M;47;CHILENO;;X;SAN FERNANDO                  ;L.G.B.OÂ´HIGGINS;0;0;0;0;0;0;0;0;0;Horno Electrico TH-100i 100Lts;ELECTRODOMESTICOS
15160432;;F;40;CHILENO;;X;EL BOSQUE                     ;METROPOLITANA;0;0;0;0;0;0;0;0;0;Batidora Pedestal B5300 Inox;ELECTRODOMESTICOS
15652904;;F;38;CHILENO;;X;LONCOCHE                      ;ARAUCANIA;0;0;0;0;0;0;0;0;0;Aspiradora UT-SILENT1603 Arrastre 1600Watts;ELECTRODOMESTICOS
8683636;;F;63;CHILENO;;Silencioso;PROVIDENCIA                   ;METROPOLITANA;0;0;0;0;0;0;0;0;0;Hervidor Electrico HA-2650NG;ELECTRODOMESTICOS
18371809;;F;28;CHILENO;;Millenial;IQUIQUE                       ;TARAPACA;0;0;0;0;0;0;0;0;0;Plancha TH-7052 2000Watts Base Inox;ELECTRODOMESTICOS
5461881;;M;73;CHILENO;;Silencioso;CORONEL                       ;BIO BIO;0;0;0;0;0;0;0;0;0;Horno Microondas Mecanico TH-18B05 18Lts;ELECTRODOMESTICOS
12313008;;F;49;CHILENO;;X;RENCA                         ;METROPOLITANA;0;0;0;0;0;0;0;0;0;Horno Electrico TH-80i 80Lts;ELECTRODOMESTICOS
11794010;;F;51;CHILENO;;X;LOS ANGELES                   ;BIO BIO;0;0;0;0;0;0;0;0;0;Licuadora TH-320 Roja/Negro 1,5 Lts Vaso Vidrio;ELECTRODOMESTICOS
9625683;;F;65;CHILENO;;Boomers;RENCA                         ;METROPOLITANA;0;0;0;0;0;0;0;0;0;Hervidor Electrico UT-REIN17SS;ELECTRODOMESTICOS
19336639;;F;26;CHILENO;;Z;PROVIDENCIA                   ;METROPOLITANA;0;0;0;0;0;0;0;0;0;Hervidor Family Kettle HE500;ELECTRODOMESTICOS
12060616;;F;48;CHILENO;;X;SAN VICENTE                   ;L.G.B.OÂ´HIGGINS;0;0;0;0;0;0;0;0;0;MICROONDAS ME83X/XZS SAMSUNG MIRROR;ELECTRODOMESTICOS
10427873;Soltero;F;58;CHILENO;;Boomers;RENCA                         ;METROPOLITANA;0;0;0;0;0;0;0;0;0;Horno Electrico TH-38N 38Lts;ELECTRODOMESTICOS
12315264;;F;49;CHILENO;;X;PROVIDENCIA                   ;METROPOLITANA;0;0;0;0;0;0;0;0;0;Combo Licuadora + Batidora;ELECTRODOMESTICOS
20794656;;M;20;CHILENO;;Z;RENCA                         ;METROPOLITANA;0;0;0;0;0;0;0;0;0;Aspiradora AP1700 Arrastre 1700Watts;ELECTRODOMESTICOS
26018015;;M;28;VENEZOLANO;;Extranjero;N/D;N/D;0;0;0;0;0;0;0;0;0;Parrilla Electrica M18W;ELECTRODOMESTICOS
12799312;;M;47;CHILENO;;X;MELIPILLA                     ;METROPOLITANA;0;0;0;0;0;0;0;0;0;Horno Electrico TH-38N 38Lts;ELECTRODOMESTICOS
24802046;;F;46;PERUANO;;Extranjero;N/D;N/D;0;0;0;0;0;0;0;0;0;Hervidor Electrico TH-4515N 2Lts Negro;ELECTRODOMESTICOS
14262609;;F;48;CHILENO;;Silencioso;PROVIDENCIA                   ;METROPOLITANA;0;0;0;0;0;0;0;0;0;Horno Electrico UT-LEIF36 36Lts;ELECTRODOMESTICOS
24850529;;M;23;COLOMBIANO;;Extranjero;TOCOPILLA                     ;ANTOFAGASTA;0;0;0;0;0;0;0;0;0;Horno Microondas Digital ME0113MB1/XZS 32Lts;ELECTRODOMESTICOS
16849368;;F;34;CHILENO;;Millenial;N/D;N/D;0;0;0;0;0;0;0;0;0;Licuadora TH-501V 1,5Lts Vaso Vidrio;ELECTRODOMESTICOS
17049543;;F;33;CHILENO;;Millenial;SAN JOAQUIN                   ;METROPOLITANA;0;0;0;0;0;0;0;0;0;Horno Microondas Mecanico UT-SYDNEY18 18Lts;ELECTRODOMESTICOS
8913482;;F;63;CHILENO;;Boomers;PROVIDENCIA                   ;METROPOLITANA;0;0;0;0;0;0;0;0;0;Aspiradora UT-SILENT1603 Arrastre 1600Watts;ELECTRODOMESTICOS
8240765;;F;67;CHILENO;;Boomers;CURICO                        ;MAULE;0;0;0;0;0;0;0;0;0;Enceradora EA-5000;ELECTRODOMESTICOS
16883552;;F;34;CHILENO;;Millenial;N/D;N/D;0;0;0;0;0;0;0;0;0;Enceradora EA-5000;ELECTRODOMESTICOS
12962301;;M;46;CHILENO;;X;N/D;N/D;0;0;0;0;0;0;0;0;0;Horno Microondas Digital ME0113MB1/XZS 32Lts;ELECTRODOMESTICOS
9769055;;F;59;CHILENO;;Boomers;PEDRO AGUIRRE CERDA           ;METROPOLITANA;0;0;0;0;0;0;0;0;0;Exprimidor Fauna 500 cc;ELECTRODOMESTICOS
10933469;;F;52;CHILENO;;X;PUERTO MONTT                  ;LOS LAGOS;0;0;0;0;0;0;0;0;0;Licuadora Personal TH-300PB;ELECTRODOMESTICOS
16892173;;F;34;CHILENO;;Millenial;PROVIDENCIA                   ;METROPOLITANA;0;0;0;0;0;0;0;0;0;Parrilla Electrica M18W;ELECTRODOMESTICOS
11435449;;M;53;CHILENO;;X;RENCA                         ;METROPOLITANA;0;0;0;0;0;0;0;0;0;Horno Microondas Digital TH20DM 20Lts Espejado;ELECTRODOMESTICOS
17572358;;F;32;CHILENO;;Millenial;SAN PEDRO DE LA PAZ           ;BIO BIO;0;0;0;0;0;0;0;0;0;LICUADORA CROMADA CON TECLAS PLUS;ELECTRODOMESTICOS
8387450;;F;66;CHILENO;;Boomers;VILLARICA                     ;ARAUCANIA;0;0;0;0;0;0;0;0;0;Batidora Pedestal TH910PN 4,6Lts 1300Watts;ELECTRODOMESTICOS
9057039;;M;61;CHILENO;;Boomers;LINARES                       ;MAULE;0;0;0;0;0;0;0;0;0;CAFETERA CF-4600 NG;ELECTRODOMESTICOS
8681076;Casado;F;63;CHILENO;;Boomers;RENGO                         ;L.G.B.OÂ´HIGGINS;0;0;0;0;0;0;0;0;0;Horno Electrico UT-LEIF36 36Lts;ELECTRODOMESTICOS
7661933;;F;68;CHILENO;;Silencioso;ANTOFAGASTA                   ;ANTOFAGASTA;0;0;0;0;0;0;0;0;0;Aspiradora TH1415 Arrastre 1500Watts;ELECTRODOMESTICOS
12799481;;M;47;CHILENO;;X;MARIA PINTO                   ;METROPOLITANA;0;0;0;0;0;0;0;0;0;Hervidor Electrico UT-KLAR20PW 2Lts Blanco;ELECTRODOMESTICOS
16515207;;M;35;CHILENO;;Millenial;QUIRIHUE                      ;BIO BIO;0;0;0;0;0;0;0;0;0;Horno Electrico UT-BACKOFEN48 48Lts;ELECTRODOMESTICOS
18768663;;F;28;CHILENO;;Millenial;PROVIDENCIA                   ;METROPOLITANA;0;0;0;0;0;0;0;0;0;Sistema de nutricion Xpert Series 7001;ELECTRODOMESTICOS
11367817;Casado;M;52;CHILENO;;X;RENCA                         ;METROPOLITANA;0;0;0;0;0;0;0;0;0;Horno Electrico TH-48N 48Lts;ELECTRODOMESTICOS
19922723;;M;22;CHILENO;;Z;LA SERENA;COQUIMBO;0;0;0;0;0;0;0;0;0;Plancha TH-7052 2000Watts Base Inox;ELECTRODOMESTICOS
11279140;;F;54;CHILENO;;X;TALAGANTE                     ;METROPOLITANA;0;0;0;0;0;0;0;0;0;Horno Electrico UT-LEIF36 36Lts;ELECTRODOMESTICOS
7680806;;F;67;CHILENO;;Boomers;OSORNO                        ;LOS LAGOS;0;0;0;0;0;0;0;0;0;PICADORA 123 SILHQUETTE;ELECTRODOMESTICOS
9836809;;F;57;CHILENO;;Silencioso;PROVIDENCIA                   ;METROPOLITANA;0;0;0;0;0;0;0;0;0;Horno Microondas Digital ME0113MB1/XZS 32Lts;ELECTRODOMESTICOS
5332597;;M;77;CHILENO;;Silencioso;SAN JAVIER                    ;MAULE;0;0;0;0;0;0;0;0;0;Hervidor Electrico Tetera UT-LECKER18R 1,8Lts;ELECTRODOMESTICOS
19990469;;M;23;CHILENO;;Millenial;N/D;N/D;0;0;0;0;0;0;0;0;0;Plancha a vapor 6052 Oster;ELECTRODOMESTICOS
15121786;Soltero;F;40;CHILENO;;Silencioso;PROVIDENCIA                   ;METROPOLITANA;0;0;0;0;0;0;0;0;0;Batidora Vertical Stick Mixer 2609;ELECTRODOMESTICOS
7732477;;F;64;CHILENO;;Boomers;CISNES                        ;AYSEN;0;0;0;0;0;0;0;0;0;Aspiradora Trapeadora Robot Ut-Excellenza (B);ELECTRODOMESTICOS
18722946;;F;28;CHILENO;;Millenial;N/D;N/D;0;0;0;0;0;0;0;0;0;Licuadora UT-METALLEK805R 1,75Lts Vaso Vidrio;ELECTRODOMESTICOS
19600350;;F;24;CHILENO;;Z;N/D;N/D;0;0;0;0;0;0;0;0;0;Licuadora L-5500IN 1,5Lts;ELECTRODOMESTICOS
8917703;;F;63;CHILENO;;Silencioso;PROVIDENCIA                   ;METROPOLITANA;0;0;0;0;0;0;0;0;0;Hervidor Electrico TH-5407i 2Lts;ELECTRODOMESTICOS
11736693;;F;51;CHILENO;;X;VILLA ALEMANA                 ;VALPARAISO;0;0;0;0;0;0;0;0;0;Horno Microondas Digital TH-25DM 25Lts;ELECTRODOMESTICOS
4649996;;F;81;CHILENO;;Silencioso;LAUTARO                       ;ARAUCANIA;0;0;0;0;0;0;0;0;0;Batidora Manual TH-8830;ELECTRODOMESTICOS
9060085;Soltero;M;61;CHILENO;;Boomers;PROVIDENCIA                   ;METROPOLITANA;0;0;0;0;0;0;0;0;0;Horno Electrico TH-25N01 25Lts;ELECTRODOMESTICOS
10760059;;F;56;CHILENO;;Boomers;EL BOSQUE                     ;METROPOLITANA;0;0;0;0;0;0;0;0;0;Licuadora Osterizer 4112/72 1,25Lts Vaso Vidrio;ELECTRODOMESTICOS
6409586;;F;71;CHILENO;;Silencioso;MELIPILLA                     ;METROPOLITANA;0;0;0;0;0;0;0;0;0;Hervidor Electrico TH-4212N 1,7Lts Negro;ELECTRODOMESTICOS
14532357;;M;48;CHILENO;;Silencioso;PROVIDENCIA                   ;METROPOLITANA;0;0;0;0;0;0;0;0;0;Licuadora Berry Blender Roja 1400 Vaso Vidrio;ELECTRODOMESTICOS
25799214;;M;40;VENEZOLANO;;Extranjero;N/D;N/D;0;0;0;0;0;0;0;0;0;Plancha UT-KERAMIKTOP 2200Watts Base Ceramica;ELECTRODOMESTICOS
6156682;;M;73;CHILENO;;Silencioso;PROVIDENCIA                   ;METROPOLITANA;0;0;0;0;0;0;0;0;0;Horno Microondas Mecanico Easy Wave 20Lts;ELECTRODOMESTICOS
11717358;;M;50;CHILENO;;X;PROVIDENCIA                   ;METROPOLITANA;0;0;0;0;0;0;0;0;0;Aspiradora UT-SILENT1804 Arrastre 1800Watts;ELECTRODOMESTICOS
16961969;Soltero;M;34;CHILENO;PROFESOR;Silencioso;PROVIDENCIA                   ;METROPOLITANA;0;0;0;0;0;0;0;0;0;Licuadora Kaliman Negra con Teclas;ELECTRODOMESTICOS
7616320;;F;68;CHILENO;;Boomers;PROVIDENCIA                   ;METROPOLITANA;0;0;0;0;0;0;0;0;0;Horno Electrico TH-100i 100Lts;ELECTRODOMESTICOS
6174605;;M;73;CHILENO;;Silencioso;PROVIDENCIA                   ;METROPOLITANA;0;0;0;0;0;0;0;0;0;Aspiradora UT-SILENT1603 Arrastre 1600Watts;ELECTRODOMESTICOS
12947612;Soltero;M;46;CHILENO;;X;RENCA                         ;METROPOLITANA;0;0;0;0;0;0;0;0;0;Aspiradora UT-SILENT1603 Arrastre 1600Watts;ELECTRODOMESTICOS
26179163;;M;41;VENEZOLANO;;Extranjero;N/D;N/D;0;0;0;0;0;0;0;0;0;CAFETERA PRIMA LATTE 6603 NEGRA;ELECTRODOMESTICOS
11690624;Soltero;M;52;CHILENO;;X;RENCA                         ;METROPOLITANA;0;0;0;0;0;0;0;0;0;Combo Licuadora + Batidora;ELECTRODOMESTICOS
14314479;;F;45;CHILENO;;X;PROVIDENCIA                   ;METROPOLITANA;0;0;0;0;0;0;0;0;0;Plancha a Vapor Oster 3803;ELECTRODOMESTICOS
16214038;;F;36;CHILENO;;Millenial;N/D;N/D;0;0;0;0;0;0;0;0;0;Hervidor Electrico Tetera TH-6505RT 1,7Lts Rojo;ELECTRODOMESTICOS
15215456;;F;40;CHILENO;;X;CHILLAN                       ;BIO BIO;0;0;0;0;0;0;0;0;0;Aspiradora AP1700 Arrastre 1700Watts;ELECTRODOMESTICOS
10192191;Casado;M;58;CHILENO;;Boomers;RENCA                         ;METROPOLITANA;0;0;0;0;0;0;0;0;0;Aspiradora Handy Clean Black 1400;ELECTRODOMESTICOS
17780084;;F;31;CHILENO;;Millenial;CAUQUENES                     ;MAULE;0;0;0;0;0;0;0;0;0;Aspiradora UT-SILENT1603 Arrastre 1600Watts;ELECTRODOMESTICOS
19115568;;F;27;CHILENO;;Silencioso;PROVIDENCIA                   ;METROPOLITANA;0;0;0;0;0;0;0;0;0;Aspiradora Polvo AP-700 GR;ELECTRODOMESTICOS
13748246;Casado;F;43;CHILENO;;X;PROVIDENCIA                   ;METROPOLITANA;0;0;0;0;0;0;0;0;0;Hervidor Electrico TH-4515N 2Lts Negro;ELECTRODOMESTICOS
19298911;;F;26;CHILENO;;Z;N/D;N/D;0;0;0;0;0;0;0;0;0;Horno Electrico UT-LEIF36 36Lts;ELECTRODOMESTICOS
12964350;;F;50;CHILENO;;X;PROVIDENCIA                   ;METROPOLITANA;0;0;0;0;0;0;0;0;0;Aspiradora TH1407 Arrastre 1400Watts;ELECTRODOMESTICOS
17112146;;F;33;CHILENO;;Millenial;PROVIDENCIA                   ;METROPOLITANA;0;0;0;0;0;0;0;0;0;Hervidor Electrico TH-5407i 2Lts;ELECTRODOMESTICOS
9591930;;F;60;CHILENO;;Boomers;SAN CARLOS                    ;BIO BIO;0;0;0;0;0;0;0;0;0;Aspiradora TH1870 Arrastre 1800Watts Gris;ELECTRODOMESTICOS
18965911;;M;26;CHILENO;;Z;N/D;N/D;0;0;0;0;0;0;0;0;0;HERVIDOR ELECTRICO UT-STARK18;ELECTRODOMESTICOS
10449759;;F;56;CHILENO;;Boomers;N/D;N/D;0;0;0;0;0;0;0;0;0;Maquina de coser Singer 024;ELECTRODOMESTICOS
8162212;Divorciado;F;63;CHILENO;;Boomers;PROVIDENCIA                   ;METROPOLITANA;0;0;0;0;0;0;0;0;0;Batidora Manual TH-8830;ELECTRODOMESTICOS
17519795;;M;31;CHILENO;;Millenial;PROVIDENCIA                   ;METROPOLITANA;0;0;0;0;0;0;0;0;0;Horno Microondas Mecanico UT-SYDNEY18 18Lts;ELECTRODOMESTICOS
9333316;;M;58;CHILENO;;Boomers;ARICA                         ;ARICA Y PARINACOTA;0;0;0;0;0;0;0;0;0;Hervidor Electrico HA-2650NG;ELECTRODOMESTICOS
13718420;;F;43;CHILENO;;X;RENCA                         ;METROPOLITANA;0;0;0;0;0;0;0;0;0;Hervidor Electrico Tetera HA-4100 4Lts Iox;ELECTRODOMESTICOS
7850155;Casado;M;66;CHILENO;;Boomers;RENCA                         ;METROPOLITANA;0;0;0;0;0;0;0;0;0;Tostador de Pan TH-116 2 Rebanadas Negro;ELECTRODOMESTICOS
14311356;;F;46;CHILENO;;X;TALCAHUANO                    ;BIO BIO;0;0;0;0;0;0;0;0;0;Horno Electrico TH-48N 48Lts;ELECTRODOMESTICOS
18695216;;F;28;CHILENO;;Millenial;LA CISTERNA                   ;METROPOLITANA;0;0;0;0;0;0;0;0;0;Licuadora TH-320 Roja/Negro 1,5 Lts Vaso Vidrio;ELECTRODOMESTICOS
13398304;;M;43;CHILENO;;Silencioso;PROVIDENCIA                   ;METROPOLITANA;0;0;0;0;0;0;0;0;0;Hervidor Electrico TH-4515N 2Lts Negro;ELECTRODOMESTICOS
15289665;;F;23;CHILENO;;Z;PROVIDENCIA                   ;METROPOLITANA;0;0;0;0;0;0;0;0;0;Hervidor Electrico Tetera TH-6505RT 1,7Lts Rojo;ELECTRODOMESTICOS
8211435;;M;63;CHILENO;;Boomers;PROVIDENCIA                   ;METROPOLITANA;0;0;0;0;0;0;0;0;0;HERVIDOR TH-4340;ELECTRODOMESTICOS
7213323;Viudo;F;68;CHILENO;;Boomers;PROVIDENCIA                   ;METROPOLITANA;0;0;0;0;0;0;0;0;0;Hervidor Electrico TH-5407i 2Lts;ELECTRODOMESTICOS
5286675;;M;74;CHILENO;;Silencioso;ARICA                         ;ARICA Y PARINACOTA;0;0;0;0;0;0;0;0;0;PLANCHA A VAPOR 6953 BASE AEROCERAMICA AUTAPA.22;ELECTRODOMESTICOS
7155888;Casado;F;68;CHILENO;;Boomers;PROVIDENCIA                   ;METROPOLITANA;0;0;0;0;0;0;0;0;0;Batidora Vertical Stick Mixer 2609;ELECTRODOMESTICOS
18528389;;M;29;CHILENO;;Silencioso;PROVIDENCIA                   ;METROPOLITANA;0;0;0;0;0;0;0;0;0;Licuadora UT-METALLEK605P 1,55Lts;ELECTRODOMESTICOS
8143917;;F;62;CHILENO;;Silencioso;PROVIDENCIA                   ;METROPOLITANA;0;0;0;0;0;0;0;0;0;Aspiradora UT-KRAFT(DIG) Arrastre 2200Watts;ELECTRODOMESTICOS
7882982;;M;63;CHILENO;;Boomers;COMBARBALA                    ;COQUIMBO;0;0;0;0;0;0;0;0;0;Horno Electrico TH-25N01 25Lts;ELECTRODOMESTICOS
11886545;;F;51;CHILENO;;X;N/D;N/D;0;0;0;0;0;0;0;0;0;Aspiradora TH1415 Arrastre 1500Watts;ELECTRODOMESTICOS
9170691;;F;57;CHILENO;;Boomers;PROVIDENCIA                   ;METROPOLITANA;0;0;0;0;0;0;0;0;0;Olla Arrocera OA-400NG 1,8Lts;ELECTRODOMESTICOS
18375939;;F;29;CHILENO;;Millenial;SAN FERNANDO                  ;L.G.B.OÂ´HIGGINS;0;0;0;0;0;0;0;0;0;Horno Electrico UT-BACKOFEN26 26Lts;ELECTRODOMESTICOS
16328768;;M;35;CHILENO;;Millenial;TOME                          ;BIO BIO;0;0;0;0;0;0;0;0;0;Batidora Manual UT-TEKLA300;ELECTRODOMESTICOS
11179563;Soltero;F;54;CHILENO;;Boomers;RENCA                         ;METROPOLITANA;0;0;0;0;0;0;0;0;0;Plancha OSTER 4801T 1200Watts Base Ceramica;ELECTRODOMESTICOS
10434087;;F;57;CHILENO;;Boomers;N/D;N/D;0;0;0;0;0;0;0;0;0;Maquina de Coser BM-3850CL Lila;ELECTRODOMESTICOS
7473405;;F;66;CHILENO;;Boomers;SAN BERNARDO                  ;METROPOLITANA;0;0;0;0;0;0;0;0;0;Picadora UT-PETRUS320 1Lts Vaso Vidrio;ELECTRODOMESTICOS
17399207;Soltero;F;32;CHILENO;;Millenial;PROVIDENCIA                   ;METROPOLITANA;0;0;0;0;0;0;0;0;0;Licuadora Kaliman Negra con Teclas;ELECTRODOMESTICOS
20139034;;M;23;CHILENO;;X;PROVIDENCIA                   ;METROPOLITANA;0;0;0;0;0;0;0;0;0;Parrilla Electrica TH-180;ELECTRODOMESTICOS
12128307;Soltero;F;52;CHILENO;;X;SAN CARLOS                    ;BIO BIO;0;0;0;0;0;0;0;0;0;HERVIDOR TH-4340;ELECTRODOMESTICOS
16550835;Soltero;M;35;CHILENO;;Millenial;PROVIDENCIA                   ;METROPOLITANA;0;0;0;0;0;0;0;0;0;MULTIMIXER THOMAS TH- 8706;ELECTRODOMESTICOS
18655307;;F;28;CHILENO;;Silencioso;PROVIDENCIA                   ;METROPOLITANA;0;0;0;0;0;0;0;0;0;CAFETERA PRIMA LATTE 6603 NEGRA;ELECTRODOMESTICOS
13253556;Soltero;F;44;CHILENO;TECNICO EN COMERCIO INTERNACIONAL;X;PROVIDENCIA                   ;METROPOLITANA;0;0;0;0;0;0;0;0;0;Licuadora Kaliman Negra con Teclas;ELECTRODOMESTICOS
15707623;;M;39;CHILENO;;X;PROVIDENCIA                   ;METROPOLITANA;0;0;0;0;0;0;0;0;0;Batidora Vertical Minipimer UT-KLOT400P;ELECTRODOMESTICOS
12759001;;M;47;CHILENO;;X;PROVIDENCIA                   ;METROPOLITANA;0;0;0;0;0;0;0;0;0;Hervidor Electrico TH-4515N 2Lts Negro;ELECTRODOMESTICOS
14289523;;F;48;CHILENO;;X;LINARES                       ;MAULE;0;0;0;0;0;0;0;0;0;Licuadora TH-320 Roja/Negro 1,5 Lts Vaso Vidrio;ELECTRODOMESTICOS
19486055;;F;25;CHILENO;;Z;LA REINA                      ;METROPOLITANA;0;0;0;0;0;0;0;0;0;Horno Microondas Digital MMP-20GC3D 20Lts;ELECTRODOMESTICOS
19372562;;F;25;CHILENO;;Z;PROVIDENCIA                   ;METROPOLITANA;0;0;0;0;0;0;0;0;0;Horno Microondas Digital TH20DM 20Lts Espejado;ELECTRODOMESTICOS
11281779;;F;54;CHILENO;;X;CHIMBARONGO                   ;L.G.B.OÂ´HIGGINS;0;0;0;0;0;0;0;0;0;ASPIRADORA THOMAS TH-1640;ELECTRODOMESTICOS
15042093;;M;39;CHILENO;;X;OVALLE                        ;COQUIMBO;0;0;0;0;0;0;0;0;0;Freidora de Aire 18M Oster;ELECTRODOMESTICOS
10103932;Casado;M;58;CHILENO;TECNICO EN ELECTROMECANICA;Boomers;CONSTITUCION                  ;MAULE;0;0;0;0;0;0;0;0;0;Licuadora L-1630V Negra 1,5Lts Vaso Vidrio;ELECTRODOMESTICOS
10203609;;M;58;CHILENO;;Boomers;LA FLORIDA                    ;METROPOLITANA;0;0;0;0;0;0;0;0;0;Freidora de Aire 18M Oster;ELECTRODOMESTICOS
18837656;;F;28;CHILENO;;Millenial;PROVIDENCIA                   ;METROPOLITANA;0;0;0;0;0;0;0;0;0;Hervidor Electrico UT-MANLY17 1,7Lts Negro;ELECTRODOMESTICOS
18411178;;F;35;CHILENO;;Millenial;N/D;N/D;0;0;0;0;0;0;0;0;0;Tostador de Pan TP-1400 4 Rebanadas Inox;ELECTRODOMESTICOS
14144670;;M;41;CHILENO;;X;PROVIDENCIA                   ;METROPOLITANA;0;0;0;0;0;0;0;0;0;Plancha a Vapor 8202 Verde;ELECTRODOMESTICOS
15601450;;F;39;CHILENO;;X;PROVIDENCIA                   ;METROPOLITANA;0;0;0;0;0;0;0;0;0;LICUADORA CROMADA CON TECLAS PLUS;ELECTRODOMESTICOS
16771902;;F;34;CHILENO;;Millenial;N/D;N/D;0;0;0;0;0;0;0;0;0;Batidora Manual TH-8830;ELECTRODOMESTICOS
7495346;;F;69;CHILENO;;Silencioso;RENCA                         ;METROPOLITANA;0;0;0;0;0;0;0;0;0;Licuadora L-1630V Negra 1,5Lts Vaso Vidrio;ELECTRODOMESTICOS
17581462;;F;32;CHILENO;;Silencioso;PROVIDENCIA                   ;METROPOLITANA;0;0;0;0;0;0;0;0;0;MICROONDAS 40L MG402MADXBB/ZS SAMSUNG;ELECTRODOMESTICOS
17236011;;F;32;CHILENO;;Millenial;LA SERENA                     ;COQUIMBO;0;0;0;0;0;0;0;0;0;Horno Electrico TH62I 60Lts;ELECTRODOMESTICOS
11047443;;F;56;CHILENO;;Boomers;CERRO NAVIA                   ;METROPOLITANA;0;0;0;0;0;0;0;0;0;Hervidor Electrico TH-4212N 1,7Lts Negro;ELECTRODOMESTICOS
13627808;;F;44;CHILENO;;Silencioso;PROVIDENCIA                   ;METROPOLITANA;0;0;0;0;0;0;0;0;0;Batidora Vertical Minipimer UT-KLOT400P;ELECTRODOMESTICOS
21250030;;F;23;CHILENO;;Extranjero;PROVIDENCIA                   ;METROPOLITANA;0;0;0;0;0;0;0;0;0;Hervidor Electrico HE420 2lts Negro;ELECTRODOMESTICOS
7017113;;M;67;CHILENO;;Boomers;CANELA                        ;COQUIMBO;0;0;0;0;0;0;0;0;0;Horno Microondas Mecanico TH-18B05 18Lts;ELECTRODOMESTICOS
12744335;;M;47;CHILENO;;X;CASTRO                        ;LOS LAGOS;0;0;0;0;0;0;0;0;0;Horno Microondas Digital TH-20S01 20Lts;ELECTRODOMESTICOS
9569569;;M;59;CHILENO;;Boomers;LA SERENA                     ;COQUIMBO;0;0;0;0;0;0;0;0;0;Horno Microondas Mecanico UT-SYDNEY18 18Lts;ELECTRODOMESTICOS
19555225;;M;25;CHILENO;;Z;N/D;N/D;0;0;0;0;0;0;0;0;0;Plancha Vertical UT-TURBOSTEAMER 1400Watts;ELECTRODOMESTICOS
9989447;;F;58;CHILENO;;Boomers;N/D;N/D;0;0;0;0;0;0;0;0;0;Aspiradora AP1700 Arrastre 1700Watts;ELECTRODOMESTICOS
16577433;Soltero;F;33;CHILENO;;Millenial;PROVIDENCIA                   ;METROPOLITANA;0;0;0;0;0;0;0;0;0;HORNO ELECTRICO 16N01 16LTS NEGRO;ELECTRODOMESTICOS
19702404;;F;24;CHILENO;;Z;CERRO NAVIA;METROPOLITANA;0;0;0;0;0;0;0;0;0;Hervidor Electrico 3100 1,7Lts Negro;ELECTRODOMESTICOS
7302394;;F;65;CHILENO;;Boomers;PERQUENCO                     ;ARAUCANIA;0;0;0;0;0;0;0;0;0;Horno Microondas Digital L UT-25KROMM 25Lts;ELECTRODOMESTICOS
12548745;;M;47;CHILENO;;X;COELEMU                       ;BIO BIO;0;0;0;0;0;0;0;0;0;Horno Microondas Mecanico M-2030 NG 20Lts;ELECTRODOMESTICOS
7708467;;M;66;CHILENO;;Boomers;MELIPILLA                     ;METROPOLITANA;0;0;0;0;0;0;0;0;0;Hervidor Electrico TH-5407i 2Lts;ELECTRODOMESTICOS
19264344;Soltero;F;25;CHILENO;TERAPEUTA OCUPACIONAL;Silencioso;PROVIDENCIA                   ;METROPOLITANA;0;0;0;0;0;0;0;0;0;Enceradora EA-5000;ELECTRODOMESTICOS
12905376;;M;47;CHILENO;;Silencioso;PROVIDENCIA                   ;METROPOLITANA;0;0;0;0;0;0;0;0;0;Hervidor Electrico UT-DUNKEL17P 2Lts Negro;ELECTRODOMESTICOS
13768359;Soltero;M;42;CHILENO;;X;SAN ANTONIO                   ;VALPARAISO;0;0;0;0;0;0;0;0;0;Hervidor Electrico TH-4212N 1,7Lts Negro;ELECTRODOMESTICOS
19822969;;F;23;CHILENO;;Z;PROVIDENCIA                   ;METROPOLITANA;0;0;0;0;0;0;0;0;0;Batidora Vertical Minipimer UT-KLOT400P;ELECTRODOMESTICOS
9026338;;F;61;CHILENO;;Boomers;LEBU                          ;BIO BIO;0;0;0;0;0;0;0;0;0;Plancha a Vapor 8202 Verde;ELECTRODOMESTICOS
17416135;;F;32;CHILENO;;Millenial;LO BARNECHEA                  ;METROPOLITANA;0;0;0;0;0;0;0;0;0;Aspiradora TH1407 Arrastre 1400Watts;ELECTRODOMESTICOS
16906984;;F;49;CHILENO;;X;PUNTA ARENAS                  ;MAGALLANES;0;0;0;0;0;0;0;0;0;Horno Microondas Digital TH-25DM 25Lts;ELECTRODOMESTICOS
16609083;;M;34;CHILENO;;Silencioso;PROVIDENCIA                   ;METROPOLITANA;0;0;0;0;0;0;0;0;0;Horno Electrico UT-BACKOFEN26 26Lts;ELECTRODOMESTICOS
12985133;;M;45;CHILENO;;Millenial;PROVIDENCIA                   ;METROPOLITANA;0;0;0;0;0;0;0;0;0;Plancha UT-KERAMIK1 2200Watts Base Ceramica;ELECTRODOMESTICOS
16576061;;M;34;CHILENO;;Silencioso;PROVIDENCIA                   ;METROPOLITANA;0;0;0;0;0;0;0;0;0;FREIDORA DE AIRE THOMAS TH-AF60Mi;ELECTRODOMESTICOS
8546715;;M;56;CHILENO;;Boomers;PROVIDENCIA                   ;METROPOLITANA;0;0;0;0;0;0;0;0;0;Horno Microondas Digital MS28F303TAS/ZS 28Lts;ELECTRODOMESTICOS
17026095;;F;33;CHILENO;;Millenial;N/D;N/D;0;0;0;0;0;0;0;0;0;Horno Electrico UT-LEIF36 36Lts;ELECTRODOMESTICOS
10817385;Casado;F;54;CHILENO;MATRONA;X;PROVIDENCIA                   ;METROPOLITANA;0;0;0;0;0;0;0;0;0;Batidora Vertical Multimixer TH-8735I;ELECTRODOMESTICOS
22603464;;F;38;CHILENO;;Millenial;ANTOFAGASTA                   ;ANTOFAGASTA;0;0;0;0;0;0;0;0;0;LICUADORA CROMADA CON TECLAS PLUS;ELECTRODOMESTICOS
17715817;;F;31;CHILENO;;Millenial;PALMILLA                      ;L.G.B.OÂ´HIGGINS;0;0;0;0;0;0;0;0;0;Hervidor Electrico Tetera TH-6505RT 1,7Lts Rojo;ELECTRODOMESTICOS
8220877;;F;61;CHILENO;;Boomers;RENCA                         ;METROPOLITANA;0;0;0;0;0;0;0;0;0;Hervidor Electrico TH-4515N 2Lts Negro;ELECTRODOMESTICOS
17310425;;F;32;CHILENO;;Silencioso;PROVIDENCIA                   ;METROPOLITANA;0;0;0;0;0;0;0;0;0;MICROONDAS ME83X/XZS SAMSUNG MIRROR;ELECTRODOMESTICOS
19832814;;M;24;CHILENO;;Z;PROVIDENCIA                   ;METROPOLITANA;0;0;0;0;0;0;0;0;0;Horno Electrico UT-BACKOFEN48 48Lts;ELECTRODOMESTICOS
14398050;Casado;F;44;CHILENO;PSICOLOGO;X;RENCA                         ;METROPOLITANA;0;0;0;0;0;0;0;0;0;Horno Microondas Mecanico Fancy 20Lts;ELECTRODOMESTICOS
15160975;;M;40;CHILENO;;X;N/D;N/D;0;0;0;0;0;0;0;0;0;Plancha TH-7052 2000Watts Base Inox;ELECTRODOMESTICOS
15408530;;M;39;CHILENO;;X;"";"";0;0;0;0;0;0;0;0;0;Aspiradora UT-SILENT1603 Arrastre 1600Watts;ELECTRODOMESTICOS
11680907;;F;51;CHILENO;;X;HUALPEN;BIO BIO;0;0;0;0;0;0;0;0;0;LICUADORA CROMADA CON TECLAS PLUS;ELECTRODOMESTICOS
15799168;;F;38;CHILENO;;Millenial;PROVIDENCIA                   ;METROPOLITANA;0;0;0;0;0;0;0;0;0;ARROCERA ROJA 4723;ELECTRODOMESTICOS
6578168;Casado;M;69;CHILENO;INGENIERO;Silencioso;PROVIDENCIA                   ;METROPOLITANA;0;0;0;0;0;0;0;0;0;Horno Electrico UT-BACKOFEN26 26Lts;ELECTRODOMESTICOS
16304915;;M;35;CHILENO;;Millenial;ARAUCO                        ;BIO BIO;0;0;0;0;0;0;0;0;0;Picadora TH-9020V Vaso Vidrio 2Lts;ELECTRODOMESTICOS
18161307;Casado;F;31;CHILENO;;Millenial;PROVIDENCIA                   ;METROPOLITANA;0;0;0;0;0;0;0;0;0;Horno Electrico UT-BACKOFEN38 38Lts;ELECTRODOMESTICOS
7400154;;M;68;CHILENO;;Silencioso;SAN BERNARDO                  ;METROPOLITANA;0;0;0;0;0;0;0;0;0;Parrilla Electrica TH-224;ELECTRODOMESTICOS
17975533;;F;29;CHILENO;;Millenial;N/D;N/D;0;0;0;0;0;0;0;0;0;Parrilla Electrica TH-224;ELECTRODOMESTICOS
18789269;;F;27;CHILENO;;Millenial;SAN CARLOS                    ;BIO BIO;0;0;0;0;0;0;0;0;0;Tostador de Pan TH-126 4 Rebanadas Negro;ELECTRODOMESTICOS
19955298;;F;24;CHILENO;;Silencioso;PROVIDENCIA                   ;METROPOLITANA;0;0;0;0;0;0;0;0;0;Horno Microondas Digital MMP-20GC3D 20Lts;ELECTRODOMESTICOS
9834710;;F;59;CHILENO;;Boomers;RENCA                         ;METROPOLITANA;0;0;0;0;0;0;0;0;0;Plancha UT-DUNST 2200Watts Base Ceramica;ELECTRODOMESTICOS
14575938;;M;43;CHILENO;;X;PROVIDENCIA                   ;METROPOLITANA;0;0;0;0;0;0;0;0;0;Aspiradora VCC4190V3E/XZS Arrastre 2000Watts;ELECTRODOMESTICOS
17769500;Soltero;F;31;CHILENO;PROFESOR;Silencioso;PROVIDENCIA                   ;METROPOLITANA;0;0;0;0;0;0;0;0;0;Hervidor Electrico TH-5407i 2Lts;ELECTRODOMESTICOS
12452811;;M;49;CHILENO;;Silencioso;PROVIDENCIA                   ;METROPOLITANA;0;0;0;0;0;0;0;0;0;Horno Electrico TH-16N 16Lts;ELECTRODOMESTICOS
16408976;;M;36;CHILENO;;Millenial;QUINTA NORMAL                 ;METROPOLITANA;0;0;0;0;0;0;0;0;0;Batidora Pedestal UT-KLEIN700;ELECTRODOMESTICOS
22621186;;M;39;PERUANO;;Extranjero;RENCA                         ;METROPOLITANA;0;0;0;0;0;0;0;0;0;Hervidor Electrico UT-KLAR20PW 2Lts Blanco;ELECTRODOMESTICOS
7512033;Casado;M;64;CHILENO;PROFESOR;Boomers;CASTRO;LOS LAGOS;0;0;0;0;0;0;0;0;0;Maquina de Coser Overlock MY8002D;ELECTRODOMESTICOS
19195223;;M;26;CHILENO;;Z;TEMUCO                        ;ARAUCANIA;0;0;0;0;0;0;0;0;0;Horno Electrico TH-48N 48Lts;ELECTRODOMESTICOS
17820124;;M;31;CHILENO;;Millenial;MOLINA                        ;MAULE;0;0;0;0;0;0;0;0;0;Batidora Vertical Minipimer UT-KLOT800SS;ELECTRODOMESTICOS
5778871;;F;73;CHILENO;;Silencioso;"";"";0;0;0;0;0;0;0;0;0;Maquina de Coser ME9100;ELECTRODOMESTICOS
20748327;;F;30;CHILENO;;Millenial;N/D;N/D;0;0;0;0;0;0;0;0;0;PROCESADOR DE ALIMENTOS UT-PROCESSOR750;ELECTRODOMESTICOS
12355608;;M;49;CHILENO;;X;PROVIDENCIA                   ;METROPOLITANA;0;0;0;0;0;0;0;0;0;Maquina de Coser JS-2135CL Calipso;ELECTRODOMESTICOS
25792582;Casado;F;26;COLOMBIANO;;Extranjero;"";"";0;0;0;0;0;0;0;0;0;Freidora electrica Ut-KeramikAir;ELECTRODOMESTICOS
5970594;Casado;F;72;CHILENO;;Silencioso;PROVIDENCIA                   ;METROPOLITANA;0;0;0;0;0;0;0;0;0;Horno Electrico UT-LEIF36 36Lts;ELECTRODOMESTICOS
14275760;;F;48;CHILENO;;X;PROVIDENCIA                   ;METROPOLITANA;0;0;0;0;0;0;0;0;0;Maquina de Coser Overlock MY8002D;ELECTRODOMESTICOS
8136021;;F;63;CHILENO;;Boomers;TALCAHUANO                    ;BIO BIO;0;0;0;0;0;0;0;0;0;Licuadora L1000 Inox 1,7LtsVaso Vidrio;ELECTRODOMESTICOS
14521822;Casado;M;46;CHILENO;;X;RENCA                         ;METROPOLITANA;0;0;0;0;0;0;0;0;0;Horno Electrico UT-BACKOFEN26 26Lts;ELECTRODOMESTICOS
12805941;;F;47;CHILENO;;Millenial;COQUIMBO                      ;COQUIMBO;0;0;0;0;0;0;0;0;0;BATIDORA PEDESTAL THOMAS TH-910PB;ELECTRODOMESTICOS
10225827;;F;52;CHILENO;;X;TALCAHUANO                    ;BIO BIO;0;0;0;0;0;0;0;0;0;Aspiradora TH1870 Arrastre 1800Watts Gris;ELECTRODOMESTICOS
25730153;;F;51;COLOMBIANO;;Extranjero;"";"";0;0;0;0;0;0;0;0;0;LICUADORA CROMADA CON TECLAS PLUS;ELECTRODOMESTICOS
18190484;Soltero;F;29;CHILENO;;Millenial;PROVIDENCIA                   ;METROPOLITANA;0;0;0;0;0;0;0;0;0;H. Microondas Fancy (2000rd);ELECTRODOMESTICOS
26542279;;F;38;VENEZOLANO;;Extranjero;N/D;N/D;0;0;0;0;0;0;0;0;0;Plancha UT-KERAMIK1 2200Watts Base Ceramica;ELECTRODOMESTICOS
18724296;Soltero;F;28;CHILENO;;Millenial;PROVIDENCIA                   ;METROPOLITANA;0;0;0;0;0;0;0;0;0;Tostador de PanTH-120R 2 Rebanadas Rojo;ELECTRODOMESTICOS
15150770;;F;40;CHILENO;;X;LOS LAGOS;LOS LAGOS;0;0;0;0;0;0;0;0;0;Maquina de coser Singer 024;ELECTRODOMESTICOS
16709811;;F;35;CHILENO;;Millenial;LOS ANDES                     ;VALPARAISO;0;0;0;0;0;0;0;0;0;Batidora Manual 2532;ELECTRODOMESTICOS
20380546;;F;22;CHILENO;;Z;PROVIDENCIA                   ;METROPOLITANA;0;0;0;0;0;0;0;0;0;Hervidor Electrico Tetera TH-6505RT 1,7Lts Rojo;ELECTRODOMESTICOS
12094948;;M;64;CHILENO;;Boomers;PENALOLEN                     ;METROPOLITANA;0;0;0;0;0;0;0;0;0;HERVIDOR TH-4340;ELECTRODOMESTICOS
18296094;;F;29;CHILENO;;Millenial;N/D;N/D;0;0;0;0;0;0;0;0;0;Hervidor Electrico TH-4515N 2Lts Negro;ELECTRODOMESTICOS
18721932;;M;28;CHILENO;;Millenial;N/D;N/D;0;0;0;0;0;0;0;0;0;Hervidor Electrico HA-2650NG;ELECTRODOMESTICOS
19561436;Soltero;F;31;CHILENO;;Millenial;PROVIDENCIA                   ;METROPOLITANA;0;0;0;0;0;0;0;0;0;Licuadora Roja 550W 1,5Lts Vaso Vidrio;ELECTRODOMESTICOS
18229570;;F;30;CHILENO;;Millenial;PROVIDENCIA                   ;METROPOLITANA;0;0;0;0;0;0;0;0;0;Cafetera TH-138i;ELECTRODOMESTICOS
13508293;Casado;F;43;CHILENO;ENFERMERA;X;PROVIDENCIA                   ;METROPOLITANA;0;0;0;0;0;0;0;0;0;Horno Electrico TH-16N 16Lts;ELECTRODOMESTICOS
6713097;;F;66;CHILENO;;Boomers;VILLA ALEMANA                 ;VALPARAISO;0;0;0;0;0;0;0;0;0;Aspiradora Trapeadora Robot Ut-Excellenza (B);ELECTRODOMESTICOS
18963467;;F;27;CHILENO;;Z;PROVIDENCIA                   ;METROPOLITANA;0;0;0;0;0;0;0;0;0;Horno Electrico TH-25N01 25Lts;ELECTRODOMESTICOS
15161801;;F;40;CHILENO;;X;RENCA                         ;METROPOLITANA;0;0;0;0;0;0;0;0;0;Plancha UT-KERAMIKTOP 2200Watts Base Ceramica;ELECTRODOMESTICOS
15918877;Soltero;M;37;CHILENO;;Silencioso;PROVIDENCIA                   ;METROPOLITANA;0;0;0;0;0;0;0;0;0;Horno Electrico TH-38N 38Lts;ELECTRODOMESTICOS
13863872;;F;41;CHILENO;;X;ARICA                         ;TARAPACA;0;0;0;0;0;0;0;0;0;Maquina de Coser Remington J011;ELECTRODOMESTICOS
17378947;;M;32;CHILENO;;Millenial;PROVIDENCIA                   ;METROPOLITANA;0;0;0;0;0;0;0;0;0;Picadora TH-9020V Vaso Vidrio 2Lts;ELECTRODOMESTICOS
10835202;;M;52;CHILENO;;X;PROVIDENCIA                   ;METROPOLITANA;0;0;0;0;0;0;0;0;0;Horno Microondas Digital L UT-25KROMM 25Lts;ELECTRODOMESTICOS
22649287;;M;39;COLOMBIANO;;Extranjero;N/D;N/D;0;0;0;0;0;0;0;0;0;LICUADORA CROMADA CON TECLAS PLUS;ELECTRODOMESTICOS
6231545;;F;72;CHILENO;;Silencioso;TALCAHUANO                    ;BIO BIO;0;0;0;0;0;0;0;0;0;Cafetera TH-138i;ELECTRODOMESTICOS
14434780;;F;51;CHILENO;;X;RENCA                         ;METROPOLITANA;0;0;0;0;0;0;0;0;0;Tostador de Pan TH-116 2 Rebanadas Negro;ELECTRODOMESTICOS
12753002;;F;52;CHILENO;;X;N/D;N/D;0;0;0;0;0;0;0;0;0;Hervidor Electrico TH-5407i 2Lts;ELECTRODOMESTICOS
9101362;;M;59;CHILENO;;Boomers;CALERA                        ;VALPARAISO;0;0;0;0;0;0;0;0;0;Aspiradora TH1870 Arrastre 1800Watts Gris;ELECTRODOMESTICOS
19013716;Soltero;F;26;CHILENO;;Silencioso;PROVIDENCIA                   ;METROPOLITANA;0;0;0;0;0;0;0;0;0;Aspiradora VCC4190V3E/XZS Arrastre 2000Watts;ELECTRODOMESTICOS
15600061;;M;42;CHILENO;;X;PANGUIPULLI                   ;LOS RIOS;0;0;0;0;0;0;0;0;0;Licuadora TH-501V 1,5Lts Vaso Vidrio;ELECTRODOMESTICOS
9218897;;M;57;CHILENO;;Boomers;PROVIDENCIA                   ;METROPOLITANA;0;0;0;0;0;0;0;0;0;Horno Electrico UT-BACKOFEN26 26Lts;ELECTRODOMESTICOS
15106986;Casado;F;39;CHILENO;;X;PROVIDENCIA                   ;METROPOLITANA;0;0;0;0;0;0;0;0;0;Freidora electrica Ut-KeramikAir;ELECTRODOMESTICOS
10370388;;M;53;CHILENO;;X;RENCA                         ;METROPOLITANA;0;0;0;0;0;0;0;0;0;Hervidor Electrico TH-5407i 2Lts;ELECTRODOMESTICOS
18767105;Soltero;F;28;CHILENO;;Silencioso;PROVIDENCIA                   ;METROPOLITANA;0;0;0;0;0;0;0;0;0;Batidora Vertical Minipimer UT-KLOT400P;ELECTRODOMESTICOS
19067545;;F;26;CHILENO;;Z;N/D;N/D;0;0;0;0;0;0;0;0;0;Batidora Vertical Minipimer UT-KLOT400P;ELECTRODOMESTICOS
10519203;;M;54;CHILENO;;Boomers;PROVIDENCIA                   ;METROPOLITANA;0;0;0;0;0;0;0;0;0;Horno Microondas Digital MS23K3513AK/ZS 23Lts;ELECTRODOMESTICOS
15640702;Soltero;F;38;CHILENO;TERAPEUTA ARTISTICO;Silencioso;PROVIDENCIA                   ;METROPOLITANA;0;0;0;0;0;0;0;0;0;Batidora Vertical Multimixer TH-8720;ELECTRODOMESTICOS
6549521;;M;71;CHILENO;;Silencioso;PETORCA                       ;VALPARAISO;0;0;0;0;0;0;0;0;0;Licuadora L-5500IN 1,5Lts;ELECTRODOMESTICOS
5938276;;M;72;CHILENO;;Silencioso;EL BOSQUE                     ;METROPOLITANA;0;0;0;0;0;0;0;0;0;BATIDORA INMERSION S MIX 2616;ELECTRODOMESTICOS
17002460;Soltero;M;34;CHILENO;;Millenial;PROVIDENCIA                   ;METROPOLITANA;0;0;0;0;0;0;0;0;0;LICUADORA MULTIFUNCION LCM-18000 GF;ELECTRODOMESTICOS
13922322;;F;42;CHILENO;;Silencioso;PROVIDENCIA                   ;METROPOLITANA;0;0;0;0;0;0;0;0;0;ASPIRADORA VC21K5130VB/ZS SAMSUNG BLUE;ELECTRODOMESTICOS
19482015;;F;25;CHILENO;;Z;PROVIDENCIA                   ;METROPOLITANA;0;0;0;0;0;0;0;0;0;Freidora FE-2510 BL 3Lts;ELECTRODOMESTICOS
7201739;;F;67;CHILENO;;Boomers;PUENTE ALTO                   ;METROPOLITANA;0;0;0;0;0;0;0;0;0;Aspiradora Tambor APA1000 1000Watts;ELECTRODOMESTICOS
18112392;;M;30;CHILENO;;Millenial;PROVIDENCIA                   ;METROPOLITANA;0;0;0;0;0;0;0;0;0;Aspiradora AP1700 Arrastre 1700Watts;ELECTRODOMESTICOS
25282068;;F;54;BOLIVIANO;;Extranjero;IQUIQUE                       ;TARAPACA;0;0;0;0;0;0;0;0;0;MAQUINA COSER COPUTARIZADA MERRITT ME 7500;ELECTRODOMESTICOS
17098677;;M;33;CHILENO;;Millenial;ANGOL                         ;ARAUCANIA;0;0;0;0;0;0;0;0;0;Horno Electrico TH-25N01 25Lts;ELECTRODOMESTICOS
12002382;;M;48;CHILENO;;X;RENCA                         ;METROPOLITANA;0;0;0;0;0;0;0;0;0;Horno Electrico TH-25N01 25Lts;ELECTRODOMESTICOS
13780105;;F;42;CHILENO;;X;CONSTITUCION                  ;MAULE;0;0;0;0;0;0;0;0;0;Licuadora L2000VNG 1,5Lts Vaso Vidrio;ELECTRODOMESTICOS
6508175;;M;65;CHILENO;;Boomers;PROVIDENCIA                   ;METROPOLITANA;0;0;0;0;0;0;0;0;0;BATIDORA INMERSION S MIX 2616;ELECTRODOMESTICOS
7141649;;F;67;CHILENO;;Boomers;RENCA                         ;METROPOLITANA;0;0;0;0;0;0;0;0;0;Horno Electrico UT-BACKOFEN26 26Lts;ELECTRODOMESTICOS
10221266;;M;57;CHILENO;;Boomers;PROVIDENCIA                   ;METROPOLITANA;0;0;0;0;0;0;0;0;0;PLANCHA A VAPOR 6953 BASE AEROCERAMICA AUTAPA.22;ELECTRODOMESTICOS
7313509;;F;55;CHILENO;;Silencioso;PROVIDENCIA                   ;METROPOLITANA;0;0;0;0;0;0;0;0;0;Horno Microondas Mecanico Easy Wave 20Lts;ELECTRODOMESTICOS
11940311;;F;50;CHILENO;;X;ILLAPEL                       ;COQUIMBO;0;0;0;0;0;0;0;0;0;Horno Microondas Mecanico C1700N 17Lts Blanco;ELECTRODOMESTICOS
15639458;Casado;F;38;CHILENO;MEDICO CIRUJANO;Silencioso;PROVIDENCIA                   ;METROPOLITANA;0;0;0;0;0;0;0;0;0;Robot aspirador Roomba E5;ELECTRODOMESTICOS
15253762;;M;40;CHILENO;;X;PROVIDENCIA                   ;METROPOLITANA;0;0;0;0;0;0;0;0;0;Batidora Vertical Multimixer TH-8720;ELECTRODOMESTICOS
16268897;;F;36;CHILENO;;Millenial;N/D;N/D;0;0;0;0;0;0;0;0;0;Horno Electrico TH-100i 100Lts;ELECTRODOMESTICOS
19500180;;F;25;CHILENO;;Z;PROVIDENCIA                   ;METROPOLITANA;0;0;0;0;0;0;0;0;0;Horno Electrico TH-25N01 25Lts;ELECTRODOMESTICOS
15447407;;M;39;CHILENO;;X;PEDRO AGUIRRE CERDA           ;METROPOLITANA;0;0;0;0;0;0;0;0;0;MAQUINA PLOTER DE CORTE SCANNCUT SDX125CL;ELECTRODOMESTICOS
6787703;Viudo;F;74;CHILENO;;Silencioso;RENCA                         ;METROPOLITANA;0;0;0;0;0;0;0;0;0;Hervidor Electrico UT-MANLY17 1,7Lts Negro;ELECTRODOMESTICOS
19653926;;F;24;CHILENO;;Z;PROVIDENCIA                   ;METROPOLITANA;0;0;0;0;0;0;0;0;0;Horno Electrico UT-BACKOFEN60 60Lts;ELECTRODOMESTICOS
18312810;;M;29;CHILENO;;Millenial;PROVIDENCIA                   ;METROPOLITANA;0;0;0;0;0;0;0;0;0;Horno Microondas Mecanico Easy Wave 20Lts;ELECTRODOMESTICOS
22911985;Soltero;M;51;PERUANO;;Extranjero;PROVIDENCIA                   ;METROPOLITANA;0;0;0;0;0;0;0;0;0;Horno Microondas Digital MMP-20GC3D 20Lts;ELECTRODOMESTICOS
13675461;;F;43;CHILENO;;X;PROVIDENCIA                   ;METROPOLITANA;0;0;0;0;0;0;0;0;0;Horno Electrico TH-100i 100Lts;ELECTRODOMESTICOS
10652572;;F;53;CHILENO;;X;RENCA                         ;METROPOLITANA;0;0;0;0;0;0;0;0;0;Horno Electrico UT-BACKOFEN60 60Lts;ELECTRODOMESTICOS
9556987;;F;60;CHILENO;;Boomers;VALDIVIA                      ;LOS RIOS;0;0;0;0;0;0;0;0;0;Olla Arrocera TH38IF 1,8Lts;ELECTRODOMESTICOS
11778351;Casado;F;51;CHILENO;;X;RENCA                         ;METROPOLITANA;0;0;0;0;0;0;0;0;0;Licuadora L-5500IN 1,5Lts;ELECTRODOMESTICOS
10927445;;F;54;CHILENO;;Boomers;PUENTE ALTO                   ;METROPOLITANA;0;0;0;0;0;0;0;0;0;Horno Electrico TH-25N01 25Lts;ELECTRODOMESTICOS
7411719;;F;66;CHILENO;;Boomers;SANTIAGO                      ;METROPOLITANA;0;0;0;0;0;0;0;0;0;Hervidor Electrico UT-DUNKEL17P 2Lts Negro;ELECTRODOMESTICOS
19362007;;F;25;CHILENO;;Z;PROVIDENCIA                   ;METROPOLITANA;0;0;0;0;0;0;0;0;0;Hervidor Electrico UT-KLAR20PW 2Lts Blanco;ELECTRODOMESTICOS
14354170;;M;43;CHILENO;;X;PROVIDENCIA                   ;METROPOLITANA;0;0;0;0;0;0;0;0;0;Horno Electrico TH-25N01 25Lts;ELECTRODOMESTICOS
19431188;Soltero;F;25;CHILENO;;Z;PROVIDENCIA                   ;METROPOLITANA;0;0;0;0;0;0;0;0;0;Maquina de Coser 3223;ELECTRODOMESTICOS
12200550;;M;50;CHILENO;;X;VALDIVIA                      ;LOS LAGOS;0;0;0;0;0;0;0;0;0;Horno Microondas Digital L UT-25KROMM 25Lts;ELECTRODOMESTICOS
15605489;;F;38;CHILENO;;Silencioso;PROVIDENCIA                   ;METROPOLITANA;0;0;0;0;0;0;0;0;0;Horno Microondas Digital MMP-20GC3D 20Lts;ELECTRODOMESTICOS
16216683;;F;36;CHILENO;;Millenial;CASABLANCA                    ;VALPARAISO;0;0;0;0;0;0;0;0;0;Licuadora Roja 550W 1,5Lts Vaso Vidrio;ELECTRODOMESTICOS
13492124;;F;44;CHILENO;;X;PROVIDENCIA                   ;METROPOLITANA;0;0;0;0;0;0;0;0;0;Parrilla Electrica TH-224;ELECTRODOMESTICOS
6805158;Casado;F;69;CHILENO;;Silencioso;PROVIDENCIA                   ;METROPOLITANA;0;0;0;0;0;0;0;0;0;Tostador de PanTH-120R 2 Rebanadas Rojo;ELECTRODOMESTICOS
19361212;Soltero;M;25;CHILENO;;Silencioso;PROVIDENCIA                   ;METROPOLITANA;0;0;0;0;0;0;0;0;0;Horno Microondas Digital MMP-20GC3D 20Lts;ELECTRODOMESTICOS
20150169;;F;22;CHILENO;;Z;PROVIDENCIA                   ;METROPOLITANA;0;0;0;0;0;0;0;0;0;Licuadora TH-320 Roja/Negro 1,5 Lts Vaso Vidrio;ELECTRODOMESTICOS
8194427;Soltero;F;66;CHILENO;;Boomers;CAUQUENES                     ;MAULE;0;0;0;0;0;0;0;0;0;Horno Electrico UT-BACKOFEN26 26Lts;ELECTRODOMESTICOS
24729341;;F;42;BOLIVIANO;;Extranjero;PROVIDENCIA                   ;METROPOLITANA;0;0;0;0;0;0;0;0;0;Plancha OSTER 4801T 1200Watts Base Ceramica;ELECTRODOMESTICOS
13099023;Soltero;M;45;CHILENO;;Silencioso;PROVIDENCIA                   ;METROPOLITANA;0;0;0;0;0;0;0;0;0;Aspiradora UT-SILENT1603 Arrastre 1600Watts;ELECTRODOMESTICOS
16662635;Soltero;F;34;CHILENO;;Silencioso;PROVIDENCIA                   ;METROPOLITANA;0;0;0;0;0;0;0;0;0;Aspiradora AP1700 Arrastre 1700Watts;ELECTRODOMESTICOS
19917625;;F;24;CHILENO;;Z;PROVIDENCIA                   ;METROPOLITANA;0;0;0;0;0;0;0;0;0;Licuadora L1000 Inox 1,7LtsVaso Vidrio;ELECTRODOMESTICOS
17176529;;F;34;CHILENO;;Silencioso;PROVIDENCIA                   ;METROPOLITANA;0;0;0;0;0;0;0;0;0;Aspiradora TH1407 Arrastre 1400Watts;ELECTRODOMESTICOS
15741719;;F;38;CHILENO;;X;PROVIDENCIA                   ;METROPOLITANA;0;0;0;0;0;0;0;0;0;Parrilla Electrica TH-180;ELECTRODOMESTICOS
9137514;;F;59;CHILENO;;Boomers;TALCA                         ;MAULE;0;0;0;0;0;0;0;0;0;Batidora Vertical Multimixer TH-8720;ELECTRODOMESTICOS
25033653;;M;66;PERUANO;;Extranjero;SAN BERNARDO                  ;METROPOLITANA;0;0;0;0;0;0;0;0;0;Licuadora Roja 550W 1,5Lts Vaso Vidrio;ELECTRODOMESTICOS
7471264;;F;66;CHILENO;;Boomers;SAN ANTONIO                   ;VALPARAISO;0;0;0;0;0;0;0;0;0;Aspiradora UT-MEINER1803 Arrastre 1800Watts;ELECTRODOMESTICOS
16754959;Soltero;F;34;CHILENO;;Millenial;PROVIDENCIA                   ;METROPOLITANA;0;0;0;0;0;0;0;0;0;Batidora Vertical BM-450 Negra;ELECTRODOMESTICOS
11952143;;F;50;CHILENO;;X;RENCA                         ;METROPOLITANA;0;0;0;0;0;0;0;0;0;Procesador TH-9010 Multimixer 1,5Lts Vaso Vidrio;ELECTRODOMESTICOS
19392239;;F;25;CHILENO;;Silencioso;PROVIDENCIA                   ;METROPOLITANA;0;0;0;0;0;0;0;0;0;Aspiradora UT-ZYKLON1402 Arrastre 1400Watts;ELECTRODOMESTICOS
16355167;;M;36;CHILENO;;Millenial;SAN BERNARDO                  ;METROPOLITANA;0;0;0;0;0;0;0;0;0;Plancha THOMAS TH-7170 2200Watts Base Ceramica;ELECTRODOMESTICOS
6450185;;M;69;CHILENO;;Silencioso;N/D;N/D;0;0;0;0;0;0;0;0;0;Licuadora TH-501V 1,5Lts Vaso Vidrio;ELECTRODOMESTICOS
17580134;;F;31;CHILENO;;Millenial;N/D;N/D;0;0;0;0;0;0;0;0;0;Hervidor Electrico HA-2650NG;ELECTRODOMESTICOS
11418643;Soltero;F;53;CHILENO;;X;RENCA                         ;METROPOLITANA;0;0;0;0;0;0;0;0;0;Horno Microondas Digital MS28F303TAS/ZS 28Lts;ELECTRODOMESTICOS
18195434;;F;30;CHILENO;;Millenial;PROVIDENCIA                   ;METROPOLITANA;0;0;0;0;0;0;0;0;0;Maquina de coser computarizada SH7700;ELECTRODOMESTICOS
10718692;;M;53;CHILENO;;X;N/D;N/D;0;0;0;0;0;0;0;0;0;Tostador de Pan TP-1400 4 Rebanadas Inox;ELECTRODOMESTICOS
17133649;;F;32;CHILENO;;Millenial;ANTOFAGASTA                   ;ANTOFAGASTA;0;0;0;0;0;0;0;0;0;Tostador de PanTH-120R 2 Rebanadas Rojo;ELECTRODOMESTICOS
17902962;;F;31;CHILENO;;Millenial;ARICA                         ;ARICA Y PARINACOTA;0;0;0;0;0;0;0;0;0;PROCESADOR THOMAS TH-9160;ELECTRODOMESTICOS
15618583;;F;38;CHILENO;;Silencioso;PROVIDENCIA                   ;METROPOLITANA;0;0;0;0;0;0;0;0;0;Horno Electrico UT-BACKOFEN26 26Lts;ELECTRODOMESTICOS
13145372;Casado;F;45;CHILENO;;X;RENCA                         ;METROPOLITANA;0;0;0;0;0;0;0;0;0;Aspiradora TH1407 Arrastre 1400Watts;ELECTRODOMESTICOS
13432635;;M;45;CHILENO;;X;VALPARAISO                    ;VALPARAISO;0;0;0;0;0;0;0;0;0;Horno Electrico TH-25N01 25Lts;ELECTRODOMESTICOS
8878078;Casado;M;62;CHILENO;;Silencioso;PROVIDENCIA                   ;METROPOLITANA;0;0;0;0;0;0;0;0;0;Hervidor Electrico TH-4800 2Lts Negro Azul;ELECTRODOMESTICOS
15396254;;F;40;CHILENO;;X;SAN FERNANDO                  ;L.G.B.OÂ´HIGGINS;0;0;0;0;0;0;0;0;0;Picadora TH-9020V Vaso Vidrio 2Lts;ELECTRODOMESTICOS
5222421;;F;79;CHILENO;;Silencioso;PAINE                         ;METROPOLITANA;0;0;0;0;0;0;0;0;0;Licuadora Personal TH-300PB;ELECTRODOMESTICOS
7746210;;M;66;CHILENO;;Boomers;RENCA                         ;METROPOLITANA;0;0;0;0;0;0;0;0;0;Licuadora L-25000NG;ELECTRODOMESTICOS
12355435;;F;49;CHILENO;;X;RENCA                         ;METROPOLITANA;0;0;0;0;0;0;0;0;0;Horno Electrico TH-25N01 25Lts;ELECTRODOMESTICOS
14560128;;F;42;CHILENO;;X;SAN PEDRO DE LA PAZ           ;BIO BIO;0;0;0;0;0;0;0;0;0;Aspiradora Polvo AP-700 GR;ELECTRODOMESTICOS
12296750;;F;49;CHILENO;;X;TALCA                         ;MAULE;0;0;0;0;0;0;0;0;0;Batidora Vertical Multimixer TH-8720;ELECTRODOMESTICOS
20470212;;F;22;CHILENO;;Silencioso;PROVIDENCIA                   ;METROPOLITANA;0;0;0;0;0;0;0;0;0;Cafetera UT-KAFFEEKLASSIK;ELECTRODOMESTICOS
4824000;;F;82;CHILENO;;Silencioso;TALAGANTE                     ;METROPOLITANA;0;0;0;0;0;0;0;0;0;Horno Electrico UT-BACKOFEN48 48Lts;ELECTRODOMESTICOS
17088670;Soltero;F;33;CHILENO;ABOGADO;Silencioso;PROVIDENCIA                   ;METROPOLITANA;0;0;0;0;0;0;0;0;0;MOPA A VAPOR SINDELEN MV-1305 GR;ELECTRODOMESTICOS
13871576;;M;41;CHILENO;;X;ARICA                         ;ARICA Y PARINACOTA;0;0;0;0;0;0;0;0;0;Procesador TH-9010 Multimixer 1,5Lts Vaso Vidrio;ELECTRODOMESTICOS
19786640;;F;24;CHILENO;;Z;PROVIDENCIA                   ;METROPOLITANA;0;0;0;0;0;0;0;0;0;Aspiradora TH1415 Arrastre 1500Watts;ELECTRODOMESTICOS
8477900;;M;64;CHILENO;;Boomers;ANGOL                         ;ARAUCANIA;0;0;0;0;0;0;0;0;0;Maquina para Hacer Pan MPP-600 BL;ELECTRODOMESTICOS
26038551;Soltero;F;34;VENEZOLANO;;Extranjero;PROVIDENCIA                   ;METROPOLITANA;0;0;0;0;0;0;0;0;0;Horno Microondas Digital UT-CLASSY720 20Lts;ELECTRODOMESTICOS
10313849;;F;52;CHILENO;;X;LA REINA                      ;METROPOLITANA;0;0;0;0;0;0;0;0;0;Aspiradora TH1870 Arrastre 1800Watts Gris;ELECTRODOMESTICOS
10391551;;M;55;CHILENO;;Boomers;RENCA                         ;METROPOLITANA;0;0;0;0;0;0;0;0;0;Horno Microondas Mecanico Easy Wave 20Lts;ELECTRODOMESTICOS
9346900;;M;57;CHILENO;;Boomers;VALPARAISO                    ;VALPARAISO;0;0;0;0;0;0;0;0;0;Horno Electrico UT-BACKOFEN26 26Lts;ELECTRODOMESTICOS
14026374;;F;41;CHILENO;;Millenial;N/D;N/D;0;0;0;0;0;0;0;0;0;Aspiradora UT-KRAFT(DIG) Arrastre 2200Watts;ELECTRODOMESTICOS
25568412;;F;41;VENEZOLANO;;Extranjero;SANTIAGO                      ;METROPOLITANA;0;0;0;0;0;0;0;0;0;Freidora de Aire 18M Oster;ELECTRODOMESTICOS
21694200;;F;41;ECUATORIANO;;Extranjero;INDEPENDENCIA                 ;METROPOLITANA;0;0;0;0;0;0;0;0;0;Horno Microondas Mecanico UT-SYDNEY18 18Lts;ELECTRODOMESTICOS
18121495;Soltero;M;30;CHILENO;KINESIOLOGO;Millenial;PROVIDENCIA                   ;METROPOLITANA;0;0;0;0;0;0;0;0;0;BATIDORA VERTICAL MA-4110;ELECTRODOMESTICOS
11519684;;M;52;CHILENO;;X;CATEMU                        ;VALPARAISO;0;0;0;0;0;0;0;0;0;Horno Microondas Mecanico TH-18B05 18Lts;ELECTRODOMESTICOS
6253701;;F;69;CHILENO;;Silencioso;PROVIDENCIA                   ;METROPOLITANA;0;0;0;0;0;0;0;0;0;Maquina para Hacer Pan MPP-600 BL;ELECTRODOMESTICOS
9427278;;F;57;CHILENO;;Boomers;RENCA                         ;METROPOLITANA;0;0;0;0;0;0;0;0;0;Horno Electrico TH62I 60Lts;ELECTRODOMESTICOS
22604576;;M;30;CHILENO;;Millenial;SANTIAGO                      ;METROPOLITANA;0;0;0;0;0;0;0;0;0;Horno Microondas Mecanico Easy Wave 20Lts;ELECTRODOMESTICOS
7317680;;F;64;CHILENO;;Boomers;LA CISTERNA                   ;METROPOLITANA;0;0;0;0;0;0;0;0;0;Horno Electrico UT-BACKOFEN26 26Lts;ELECTRODOMESTICOS
7832629;;F;66;CHILENO;;Boomers;VALDIVIA                      ;LOS RIOS;0;0;0;0;0;0;0;0;0;Tostador de Pan TP-1400 4 Rebanadas Inox;ELECTRODOMESTICOS
9336754;;M;59;CHILENO;;Boomers;CONSTITUCION                  ;MAULE;0;0;0;0;0;0;0;0;0;Parrilla Electrica TH-224;ELECTRODOMESTICOS
6680982;Casado;M;71;CHILENO;;Silencioso;PROVIDENCIA                   ;METROPOLITANA;0;0;0;0;0;0;0;0;0;Aspiradora UT-SILENT1603 Arrastre 1600Watts;ELECTRODOMESTICOS
14082268;;F;41;CHILENO;;X;SAN BERNARDO                  ;METROPOLITANA;0;0;0;0;0;0;0;0;0;Horno Electrico TH-80i 80Lts;ELECTRODOMESTICOS
10885095;;F;53;CHILENO;;X;PROVIDENCIA                   ;METROPOLITANA;0;0;0;0;0;0;0;0;0;Licuadora Roja 550W 1,5Lts Vaso Vidrio;ELECTRODOMESTICOS
9200508;;F;61;CHILENO;;Boomers;RENCA                         ;METROPOLITANA;0;0;0;0;0;0;0;0;0;Licuadora L-5500IN 1,5Lts;ELECTRODOMESTICOS
17254834;Soltero;M;32;CHILENO;;Millenial;PROVIDENCIA                   ;METROPOLITANA;0;0;0;0;0;0;0;0;0;Batidora Vertical Minipimer UT-KLOT400P;ELECTRODOMESTICOS
10340215;;M;47;CHILENO;;X;RENCA                         ;METROPOLITANA;0;0;0;0;0;0;0;0;0;PLANCHA A VAPOR 6003 BASE ANTIADHERENTE 1600W;ELECTRODOMESTICOS
19758609;;F;24;CHILENO;;Z;PROVIDENCIA                   ;METROPOLITANA;0;0;0;0;0;0;0;0;0;Aspiradora UT-SILENT1603 Arrastre 1600Watts;ELECTRODOMESTICOS
19697126;;M;24;CHILENO;;Z;PROVIDENCIA                   ;METROPOLITANA;0;0;0;0;0;0;0;0;0;Licuadora TH-320 Roja/Negro 1,5 Lts Vaso Vidrio;ELECTRODOMESTICOS
13478908;;F;44;CHILENO;;X;PUENTE ALTO                   ;METROPOLITANA;0;0;0;0;0;0;0;0;0;Horno Electrico UT-BACKOFEN26 26Lts;ELECTRODOMESTICOS
16010054;;F;37;CHILENO;;Millenial;N/D;N/D;0;0;0;0;0;0;0;0;0;Batidora Manual TH-8830;ELECTRODOMESTICOS
6133353;;F;75;CHILENO;;Silencioso;RENCA                         ;METROPOLITANA;0;0;0;0;0;0;0;0;0;Plancha UT-DUNST 2200Watts Base Ceramica;ELECTRODOMESTICOS
15915083;;M;37;CHILENO;;Millenial;LOS ALAMOS                    ;BIO BIO;0;0;0;0;0;0;0;0;0;Aspiradora TH1407 Arrastre 1400Watts;ELECTRODOMESTICOS
11738931;;F;51;CHILENO;;X;COLINA                        ;METROPOLITANA;0;0;0;0;0;0;0;0;0;Extractor de Jugo EX800 1,4Lts;ELECTRODOMESTICOS
20143771;;F;23;CHILENO;;Z;PROVIDENCIA                   ;METROPOLITANA;0;0;0;0;0;0;0;0;0;Hervidor Electrico Tetera TH-6505RT 1,7Lts Rojo;ELECTRODOMESTICOS
12081610;;M;51;CHILENO;;X;N/D;N/D;0;0;0;0;0;0;0;0;0;Horno Electrico UT-LEIF36 36Lts;ELECTRODOMESTICOS
7062642;Casado;M;66;CHILENO;PROFESOR;Boomers;PROVIDENCIA                   ;METROPOLITANA;0;0;0;0;0;0;0;0;0;Hervidor Electrico Tetera TH-6505RT 1,7Lts Rojo;ELECTRODOMESTICOS
8912348;Casado;M;59;CHILENO;;Boomers;RENCA                         ;METROPOLITANA;0;0;0;0;0;0;0;0;0;Horno Electrico TH-16N 16Lts;ELECTRODOMESTICOS
16465599;;F;35;CHILENO;;Millenial;RENCA                         ;METROPOLITANA;0;0;0;0;0;0;0;0;0;Licuadora L-5500IN 1,5Lts;ELECTRODOMESTICOS
16207811;Soltero;F;36;CHILENO;;Silencioso;PROVIDENCIA                   ;METROPOLITANA;0;0;0;0;0;0;0;0;0;Horno Electrico UT-BACKOFEN48 48Lts;ELECTRODOMESTICOS
9789782;;M;56;CHILENO;;Boomers;SANTA CRUZ                    ;L.G.B.OÂ´HIGGINS;0;0;0;0;0;0;0;0;0;HERVIDOR TH-4340;ELECTRODOMESTICOS
16080270;;M;37;CHILENO;;Silencioso;PROVIDENCIA                   ;METROPOLITANA;0;0;0;0;0;0;0;0;0;ASPIRADORA POLVO Y AGUA APA-1150 IN;ELECTRODOMESTICOS
22735714;;F;35;PERUANO;;Extranjero;SAN MIGUEL                    ;METROPOLITANA;0;0;0;0;0;0;0;0;0;PANINI/WAFLERA TH-965;ELECTRODOMESTICOS
11703315;Casado;F;52;CHILENO;;X;RENCA                         ;METROPOLITANA;0;0;0;0;0;0;0;0;0;Plancha TH-7052 2000Watts Base Inox;ELECTRODOMESTICOS
23982279;;F;41;BOLIVIANO;;Extranjero;ANTOFAGASTA                   ;ANTOFAGASTA;0;0;0;0;0;0;0;0;0;Licuadora L-5500IN 1,5Lts;ELECTRODOMESTICOS
19426240;;F;25;CHILENO;;Z;ALHUE                         ;METROPOLITANA;0;0;0;0;0;0;0;0;0;Combo Hervidor + Batidora;ELECTRODOMESTICOS
24667568;Soltero;M;41;COLOMBIANO;;Extranjero;PROVIDENCIA                   ;METROPOLITANA;0;0;0;0;0;0;0;0;0;Horno Electrico UT-LEIF36 36Lts;ELECTRODOMESTICOS
11672837;;M;51;CHILENO;;X;N/D;N/D;0;0;0;0;0;0;0;0;0;Maquina para Hacer Pan MPP-600 BL;ELECTRODOMESTICOS
8802395;;M;61;CHILENO;;Boomers;PROVIDENCIA                   ;METROPOLITANA;0;0;0;0;0;0;0;0;0;BATIDORA PEDESTAL THOMAS TH-910PB;ELECTRODOMESTICOS
10408301;;M;56;CHILENO;;Boomers;SANTIAGO                      ;METROPOLITANA;0;0;0;0;0;0;0;0;0;Plancha UT-KERAMIK1 2200Watts Base Ceramica;ELECTRODOMESTICOS
18355382;Soltero;M;29;CHILENO;;Millenial;PROVIDENCIA                   ;METROPOLITANA;0;0;0;0;0;0;0;0;0;ASPIRADORA POLVO Y AGUA APA-1150 IN;ELECTRODOMESTICOS
18090150;Soltero;F;30;CHILENO;;Millenial;PROVIDENCIA                   ;METROPOLITANA;0;0;0;0;0;0;0;0;0;Batidora Manual BA-5010 Inox;ELECTRODOMESTICOS
17340277;Soltero;F;32;CHILENO;;Millenial;PROVIDENCIA                   ;METROPOLITANA;0;0;0;0;0;0;0;0;0;HORNO ELECTRICO HE-850IN INOX SINDELEN;ELECTRODOMESTICOS
15384711;Casado;F;39;CHILENO;;Silencioso;PROVIDENCIA                   ;METROPOLITANA;0;0;0;0;0;0;0;0;0;Horno Electrico TH-48N 48Lts;ELECTRODOMESTICOS
16473880;;F;35;CHILENO;;Millenial;PROVIDENCIA                   ;METROPOLITANA;0;0;0;0;0;0;0;0;0;Licuadora L-5500IN 1,5Lts;ELECTRODOMESTICOS
20057531;;M;23;CHILENO;;Silencioso;PROVIDENCIA                   ;METROPOLITANA;0;0;0;0;0;0;0;0;0;Horno Electrico TH-48N 48Lts;ELECTRODOMESTICOS
8464004;Soltero;F;66;CHILENO;;Boomers;RENCA                         ;METROPOLITANA;0;0;0;0;0;0;0;0;0;Horno Microondas Mecanico Easy Wave 20Lts;ELECTRODOMESTICOS
17100269;;F;33;CHILENO;;Millenial;LA FLORIDA                    ;METROPOLITANA;0;0;0;0;0;0;0;0;0;Horno Microondas Digital ME0113MB1/XZS 32Lts;ELECTRODOMESTICOS
8916858;Casado;F;66;CHILENO;;Silencioso;PROVIDENCIA                   ;METROPOLITANA;0;0;0;0;0;0;0;0;0;HORNO ELECTRICO HE-600IN INOX SINDELEN;ELECTRODOMESTICOS
12415928;;F;49;CHILENO;;X;PROVIDENCIA                   ;METROPOLITANA;0;0;0;0;0;0;0;0;0;Licuadora TH-501V 1,5Lts Vaso Vidrio;ELECTRODOMESTICOS
10424927;;F;57;CHILENO;;Boomers;RENCA                         ;METROPOLITANA;0;0;0;0;0;0;0;0;0;Aspiradora UT-KRAFT(DIG) Arrastre 2200Watts;ELECTRODOMESTICOS
6308856;Soltero;M;70;CHILENO;;Silencioso;RENCA                         ;METROPOLITANA;0;0;0;0;0;0;0;0;0;Batidora Manual 2532;ELECTRODOMESTICOS
19943003;;F;23;CHILENO;;Z;PROVIDENCIA                   ;METROPOLITANA;0;0;0;0;0;0;0;0;0;HERVIDOR TH-4340;ELECTRODOMESTICOS
16281627;Casado;F;35;CHILENO;INGENIERO COMERCIAL;Millenial;PROVIDENCIA                   ;METROPOLITANA;0;0;0;0;0;0;0;0;0;Horno Microondas Digital Deli (2017 DM) 20Lts;ELECTRODOMESTICOS
17713203;Soltero;F;31;CHILENO;;Millenial;PROVIDENCIA                   ;METROPOLITANA;0;0;0;0;0;0;0;0;0;Batidora Manual TH-8830;ELECTRODOMESTICOS
7461940;;F;67;CHILENO;;Boomers;VALDIVIA                      ;LOS LAGOS;0;0;0;0;0;0;0;0;0;Horno Electrico TH-48N 48Lts;ELECTRODOMESTICOS
6095479;Viudo;F;74;CHILENO;;Silencioso;RENCA                         ;METROPOLITANA;0;0;0;0;0;0;0;0;0;Batidora Vertical Multimixer TH-8720;ELECTRODOMESTICOS
5344848;;M;76;CHILENO;;Silencioso;PROVIDENCIA                   ;METROPOLITANA;0;0;0;0;0;0;0;0;0;Procesador TH-9010 Multimixer 1,5Lts Vaso Vidrio;ELECTRODOMESTICOS
17838084;;F;31;CHILENO;;Millenial;NUNOA                         ;METROPOLITANA;0;0;0;0;0;0;0;0;0;Aspiradora Polvo AP-700 GR;ELECTRODOMESTICOS
18541379;;F;28;CHILENO;;Silencioso;PROVIDENCIA                   ;METROPOLITANA;0;0;0;0;0;0;0;0;0;Horno Microondas Mecanico Easy Wave 20Lts;ELECTRODOMESTICOS
17718575;;M;31;CHILENO;;Millenial;PROVIDENCIA                   ;METROPOLITANA;0;0;0;0;0;0;0;0;0;PROCESADOR THOMAS TH-9160;ELECTRODOMESTICOS
14357674;Casado;F;43;CHILENO;;X;RENCA                         ;METROPOLITANA;0;0;0;0;0;0;0;0;0;Batidora Manual BA-5010 Inox;ELECTRODOMESTICOS
16967340;;F;33;CHILENO;;Millenial;LLANQUIHUE                    ;LOS LAGOS;0;0;0;0;0;0;0;0;0;Batidora Pedestal B5300 Inox;ELECTRODOMESTICOS
16044288;;M;37;CHILENO;;Millenial;N/D;N/D;0;0;0;0;0;0;0;0;0;Extractor de Jugo TH-2551 2Lts;ELECTRODOMESTICOS
8872468;;F;61;CHILENO;;Boomers;RENCA                         ;METROPOLITANA;0;0;0;0;0;0;0;0;0;Licuadora L2000VNG 1,5Lts Vaso Vidrio;ELECTRODOMESTICOS
15457847;;M;39;CHILENO;;X;PROVIDENCIA                   ;METROPOLITANA;0;0;0;0;0;0;0;0;0;Maquina de Coser 1412;ELECTRODOMESTICOS
15418076;Casado;F;39;CHILENO;;X;PROVIDENCIA                   ;METROPOLITANA;0;0;0;0;0;0;0;0;0;Horno Microondas Digital MS23K3513AK/ZS 23Lts;ELECTRODOMESTICOS
15369976;;F;39;CHILENO;;Millenial;PROVIDENCIA                   ;METROPOLITANA;0;0;0;0;0;0;0;0;0;Aspiradora UT-MEINER1803 Arrastre 1800Watts;ELECTRODOMESTICOS
16239038;;F;36;CHILENO;;Millenial;RANCAGUA                      ;L.G.B.OÂ´HIGGINS;0;0;0;0;0;0;0;0;0;Horno Electrico TH-48N 48Lts;ELECTRODOMESTICOS
10204449;;F;56;CHILENO;;Boomers;N/D;N/D;0;0;0;0;0;0;0;0;0;Hervidor Electrico UT-KLAR20PW 2Lts Blanco;ELECTRODOMESTICOS
9360498;;M;57;CHILENO;;Boomers;PROVIDENCIA                   ;METROPOLITANA;0;0;0;0;0;0;0;0;0;Plancha OSTER 4801T 1200Watts Base Ceramica;ELECTRODOMESTICOS
15401925;;F;40;CHILENO;;X;PROVIDENCIA                   ;METROPOLITANA;0;0;0;0;0;0;0;0;0;Plancha UT-KERAMIK1 2200Watts Base Ceramica;ELECTRODOMESTICOS
10706973;;F;42;CHILENO;;X;RENCA                         ;METROPOLITANA;0;0;0;0;0;0;0;0;0;Combo Hervidor + Tostador + Sandwichera;ELECTRODOMESTICOS
15044228;;M;41;CHILENO;;X;HIJUELAS                      ;VALPARAISO;0;0;0;0;0;0;0;0;0;Horno Microondas Mecanico TH-18B05 18Lts;ELECTRODOMESTICOS
8307064;;M;62;CHILENO;;Boomers;RENCA                         ;METROPOLITANA;0;0;0;0;0;0;0;0;0;Maquina de Coser Overlock MY8002D;ELECTRODOMESTICOS
11514836;Casado;M;51;CHILENO;;X;RENCA                         ;METROPOLITANA;0;0;0;0;0;0;0;0;0;Horno Electrico TH-38N 38Lts;ELECTRODOMESTICOS
6583952;Viudo;F;68;CHILENO;;Boomers;N/D;N/D;0;0;0;0;0;0;0;0;0;Licuadora L-1630V Negra 1,5Lts Vaso Vidrio;ELECTRODOMESTICOS
13275676;;F;45;CHILENO;;X;PROVIDENCIA                   ;METROPOLITANA;0;0;0;0;0;0;0;0;0;Hervidor Electrico UT-MANLY17 1,7Lts Negro;ELECTRODOMESTICOS
8503056;;M;60;CHILENO;;Boomers;PAINE                         ;METROPOLITANA;0;0;0;0;0;0;0;0;0;Aspiradora TH1870 Arrastre 1800Watts Gris;ELECTRODOMESTICOS
12503192;;M;49;CHILENO;;Silencioso;PROVIDENCIA                   ;METROPOLITANA;0;0;0;0;0;0;0;0;0;PROCESADOR THOMAS TH-9160;ELECTRODOMESTICOS
16686071;;F;35;CHILENO;;Millenial;PROVIDENCIA                   ;METROPOLITANA;0;0;0;0;0;0;0;0;0;Procesador TH-9010 Multimixer 1,5Lts Vaso Vidrio;ELECTRODOMESTICOS
18038647;;F;29;CHILENO;;Millenial;PROVIDENCIA                   ;METROPOLITANA;0;0;0;0;0;0;0;0;0;Set Picador KP-123BL 1,2Lts;ELECTRODOMESTICOS
10493140;;M;53;CHILENO;;X;VICTORIA                      ;ARAUCANIA;0;0;0;0;0;0;0;0;0;Plancha THOMAS TH-7170 2200Watts Base Ceramica;ELECTRODOMESTICOS
6070817;;F;75;CHILENO;;Silencioso;PROVIDENCIA                   ;METROPOLITANA;0;0;0;0;0;0;0;0;0;Horno Electrico TH-48N 48Lts;ELECTRODOMESTICOS
18522612;Soltero;F;27;CHILENO;ADMINISTRADOR HOTELERO;Millenial;PROVIDENCIA                   ;METROPOLITANA;0;0;0;0;0;0;0;0;0;Licuadora TH-320 Roja/Negro 1,5 Lts Vaso Vidrio;ELECTRODOMESTICOS
8156710;Soltero;F;51;CHILENO;;X;PROVIDENCIA                   ;METROPOLITANA;0;0;0;0;0;0;0;0;0;Hervidor Electrico UT-MANLY17 1,7Lts Negro;ELECTRODOMESTICOS
22403763;Casado;M;40;PERUANO;;Extranjero;PROVIDENCIA                   ;METROPOLITANA;0;0;0;0;0;0;0;0;0;Licuadora Roja 550W 1,5Lts Vaso Vidrio;ELECTRODOMESTICOS
9217551;;F;64;CHILENO;;Boomers;PROVIDENCIA                   ;METROPOLITANA;0;0;0;0;0;0;0;0;0;Horno Electrico TH-48N 48Lts;ELECTRODOMESTICOS
10682370;;F;56;CHILENO;;Silencioso;PROVIDENCIA                   ;METROPOLITANA;0;0;0;0;0;0;0;0;0;BATIDORA PLANETARIA BP-4500 BL;ELECTRODOMESTICOS
16785899;;F;34;CHILENO;;Millenial;PROVIDENCIA                   ;METROPOLITANA;0;0;0;0;0;0;0;0;0;Hervidor Electrico 388R Rojo;ELECTRODOMESTICOS
16786497;;M;34;CHILENO;;Millenial;PROVIDENCIA                   ;METROPOLITANA;0;0;0;0;0;0;0;0;0;Plancha UT-PLATTEISEN 2000Watts Base Ceramica;ELECTRODOMESTICOS
17294436;;F;32;CHILENO;;Millenial;PROVIDENCIA                   ;METROPOLITANA;0;0;0;0;0;0;0;0;0;Hervidor Electrico UT-MANLY17 1,7Lts Negro;ELECTRODOMESTICOS
14901898;Casado;M;40;CHILENO;;Silencioso;PROVIDENCIA                   ;METROPOLITANA;0;0;0;0;0;0;0;0;0;Horno Electrico TH-100i 100Lts;ELECTRODOMESTICOS
9676812;;F;57;CHILENO;;Boomers;RENCA                         ;METROPOLITANA;0;0;0;0;0;0;0;0;0;Licuadora L2000VNG 1,5Lts Vaso Vidrio;ELECTRODOMESTICOS
6972841;;F;55;CHILENO;;Boomers;VITACURA                      ;METROPOLITANA;0;0;0;0;0;0;0;0;0;Hervidor Electrico Tetera UT-LECKER18R 1,8Lts;ELECTRODOMESTICOS
7206287;;F;51;CHILENO;;X;NUNOA                         ;METROPOLITANA;0;0;0;0;0;0;0;0;0;ASPIRADORA VCC4580V3K/XZS SAMSUNG BLACK;ELECTRODOMESTICOS
13532441;;M;43;CHILENO;;X;VALLENAR;ATACAMA;0;0;0;0;0;0;0;0;0;Horno Microondas Mecanico C1700N 17Lts Blanco;ELECTRODOMESTICOS
25940137;;F;49;PERUANO;;Extranjero;RECOLETA                      ;METROPOLITANA;0;0;0;0;0;0;0;0;0;Licuadora Roja 550W 1,5Lts Vaso Vidrio;ELECTRODOMESTICOS
7263519;;M;69;CHILENO;;Silencioso;PROVIDENCIA                   ;METROPOLITANA;0;0;0;0;0;0;0;0;0;Licuadora Roja 550W 1,5Lts Vaso Vidrio;ELECTRODOMESTICOS
13630784;;F;42;CHILENO;;X;RENCA                         ;METROPOLITANA;0;0;0;0;0;0;0;0;0;Plancha UT-DUNST 2200Watts Base Ceramica;ELECTRODOMESTICOS
10800266;Casado;M;52;CHILENO;CONTADOR GENERAL;Silencioso;PROVIDENCIA                   ;METROPOLITANA;0;0;0;0;0;0;0;0;0;Aspiradora Roomba 621;ELECTRODOMESTICOS
26382838;;M;34;EXTRANJERO - NO INFORMA NACIONALIDAD;;Extranjero;N/D;N/D;0;0;0;0;0;0;0;0;0;Licuadora Roja 550W 1,5Lts Vaso Vidrio;ELECTRODOMESTICOS
7401078;;M;69;CHILENO;;Silencioso;DALCAHUE                      ;LOS LAGOS;0;0;0;0;0;0;0;0;0;Aspiradora TH1870 Arrastre 1800Watts Gris;ELECTRODOMESTICOS
17398230;;F;32;CHILENO;;Millenial;PROVIDENCIA                   ;METROPOLITANA;0;0;0;0;0;0;0;0;0;Horno Electrico TH-38N 38Lts;ELECTRODOMESTICOS
18311220;Soltero;M;29;CHILENO;;Millenial;ANTOFAGASTA                   ;ANTOFAGASTA;0;0;0;0;0;0;0;0;0;Cafetera TH-141Di;ELECTRODOMESTICOS
16666569;Soltero;M;35;CHILENO;;Silencioso;PROVIDENCIA                   ;METROPOLITANA;0;0;0;0;0;0;0;0;0;Combo Licuadora + Batidora;ELECTRODOMESTICOS
26556440;;F;49;VENEZOLANO;;Extranjero;QUILLOTA                      ;VALPARAISO;0;0;0;0;0;0;0;0;0;Aspiradora AP1700 Arrastre 1700Watts;ELECTRODOMESTICOS
18255440;;F;29;CHILENO;;Millenial;PROVIDENCIA                   ;METROPOLITANA;0;0;0;0;0;0;0;0;0;Horno Electrico TH-48N 48Lts;ELECTRODOMESTICOS
17433941;Soltero;M;32;CHILENO;GAS E INSTALACIONES SANITARIAS;Millenial;RENCA                         ;METROPOLITANA;0;0;0;0;0;0;0;0;0;Horno Microondas Digital TH-25DM 25Lts;ELECTRODOMESTICOS
10937891;Casado;F;54;CHILENO;;Boomers;RENCA                         ;METROPOLITANA;0;0;0;0;0;0;0;0;0;Licuadora UT-METALLEK705 1,75Lts Vaso Vidrio;ELECTRODOMESTICOS
19426535;;F;24;CHILENO;;Z;PROVIDENCIA                   ;METROPOLITANA;0;0;0;0;0;0;0;0;0;Horno Microondas Digital TH-20S01 20Lts;ELECTRODOMESTICOS
16074424;;F;36;CHILENO;;Millenial;PUENTE ALTO;METROPOLITANA;0;0;0;0;0;0;0;0;0;Cafetera TH-138i;ELECTRODOMESTICOS
12045084;Soltero;M;55;CHILENO;;Boomers;PROVIDENCIA                   ;METROPOLITANA;0;0;0;0;0;0;0;0;0;Horno Electrico TH-25N01 25Lts;ELECTRODOMESTICOS
7891068;;F;69;CHILENO;;Silencioso;PROVIDENCIA                   ;METROPOLITANA;0;0;0;0;0;0;0;0;0;Producto Segunda Seleccion Banda 7;ELECTRODOMESTICOS
5782457;;F;76;CHILENO;;Silencioso;CARTAGENA                     ;VALPARAISO;0;0;0;0;0;0;0;0;0;Licuadora TH-320 Roja/Negro 1,5 Lts Vaso Vidrio;ELECTRODOMESTICOS
19301105;;F;26;CHILENO;;Z;OVALLE                        ;COQUIMBO;0;0;0;0;0;0;0;0;0;Parrilla Electrica TH-180;ELECTRODOMESTICOS
8328955;;F;65;CHILENO;;Boomers;LA FLORIDA                    ;METROPOLITANA;0;0;0;0;0;0;0;0;0;Batidora Vertical Minipimer UT-KLOT400P;ELECTRODOMESTICOS
5707978;Casado;F;74;CHILENO;;Silencioso;PROVIDENCIA                   ;METROPOLITANA;0;0;0;0;0;0;0;0;0;Horno Electrico UT-BACKOFEN38 38Lts;ELECTRODOMESTICOS
18450773;;M;55;CHILENO;;Boomers;RENCA                         ;METROPOLITANA;0;0;0;0;0;0;0;0;0;Horno Electrico UT-LEIF36 36Lts;ELECTRODOMESTICOS
5445204;;F;71;CHILENO;;Silencioso;SANTO DOMINGO                 ;VALPARAISO;0;0;0;0;0;0;0;0;0;PLANCHA A VAPOR 2501 BASE CERAMICA 2200w;ELECTRODOMESTICOS
6349522;Viudo;F;68;CHILENO;PROFESOR;Boomers;RENCA                         ;METROPOLITANA;0;0;0;0;0;0;0;0;0;PROCESADOR THOMAS TH-9160;ELECTRODOMESTICOS
5818365;Casado;M;70;CHILENO;;Millenial;PROVIDENCIA                   ;METROPOLITANA;0;0;0;0;0;0;0;0;0;Licuadora L1000 Inox 1,7LtsVaso Vidrio;ELECTRODOMESTICOS
6538138;;F;69;CHILENO;;Silencioso;MELIPILLA                     ;METROPOLITANA;0;0;0;0;0;0;0;0;0;Horno Microondas Digital TH-20S01 20Lts;ELECTRODOMESTICOS
17066647;;M;33;CHILENO;;Millenial;HUASCO                        ;ATACAMA;0;0;0;0;0;0;0;0;0;Hervidor Electrico UT-DUNKEL17P 2Lts Negro;ELECTRODOMESTICOS
15124517;;M;40;CHILENO;;X;MACHALI                       ;L.G.B.OÂ´HIGGINS;0;0;0;0;0;0;0;0;0;Cafetera UT-KAFFEEKLASSIK;ELECTRODOMESTICOS
17186061;;F;33;CHILENO;;Millenial;MAULE                         ;MAULE;0;0;0;0;0;0;0;0;0;Aspiradora UT-KRAFT(DIG) Arrastre 2200Watts;ELECTRODOMESTICOS
7725451;Casado;M;59;CHILENO;;Boomers;RENCA                         ;METROPOLITANA;0;0;0;0;0;0;0;0;0;Procesador TH-9010 Multimixer 1,5Lts Vaso Vidrio;ELECTRODOMESTICOS
12475648;Soltero;M;50;CHILENO;;X;CERRO NAVIA                   ;METROPOLITANA;0;0;0;0;0;0;0;0;0;Licuadora L2000VNG 1,5Lts Vaso Vidrio;ELECTRODOMESTICOS
22923784;;M;52;BOLIVIANO;;Extranjero;MELIPILLA                     ;METROPOLITANA;0;0;0;0;0;0;0;0;0;Licuadora TH-501V 1,5Lts Vaso Vidrio;ELECTRODOMESTICOS
10347336;Soltero;F;48;CHILENO;ADMINISTRADOR TURISTICO;X;PROVIDENCIA                   ;METROPOLITANA;0;0;0;0;0;0;0;0;0;Horno Electrico TH-25N01 25Lts;ELECTRODOMESTICOS
17065711;Casado;M;33;CHILENO;;Millenial;PROVIDENCIA                   ;METROPOLITANA;0;0;0;0;0;0;0;0;0;Licuadora Personal TH-300PB;ELECTRODOMESTICOS
3414471;;M;86;CHILENO;;Silencioso;RENCA                         ;METROPOLITANA;0;0;0;0;0;0;0;0;0;Hervidor Electrico UT-MANLY17 1,7Lts Negro;ELECTRODOMESTICOS
17050656;;F;33;CHILENO;;Millenial;PROVIDENCIA                   ;METROPOLITANA;0;0;0;0;0;0;0;0;0;Horno Microondas Digital L UT-25KROMM 25Lts;ELECTRODOMESTICOS
10322779;Divorciado;F;56;CHILENO;ABOGADO;Boomers;RENCA                         ;METROPOLITANA;0;0;0;0;0;0;0;0;0;Horno Electrico TH-25N01 25Lts;ELECTRODOMESTICOS
7829596;;M;65;CHILENO;;Boomers;RENCA                         ;METROPOLITANA;0;0;0;0;0;0;0;0;0;Hervidor Electrico UT-KLAR20PW 2Lts Blanco;ELECTRODOMESTICOS
17819308;;M;31;CHILENO;;Millenial;CAUQUENES                     ;MAULE;0;0;0;0;0;0;0;0;0;Horno Electrico TH-38N 38Lts;ELECTRODOMESTICOS
8468091;;F;63;CHILENO;;Silencioso;PROVIDENCIA                   ;METROPOLITANA;0;0;0;0;0;0;0;0;0;Aspiradora Cyclonic Adventage roja CA4000N;ELECTRODOMESTICOS
12638172;;F;47;CHILENO;;X;PROVIDENCIA                   ;METROPOLITANA;0;0;0;0;0;0;0;0;0;Hervidor Electrico UT-DUNKEL17P 2Lts Negro;ELECTRODOMESTICOS
16770349;Soltero;F;34;CHILENO;EDUCADOR DE PARVULO;Millenial;RENCA                         ;METROPOLITANA;0;0;0;0;0;0;0;0;0;Licuadora L2000VNG 1,5Lts Vaso Vidrio;ELECTRODOMESTICOS
16573599;Soltero;M;35;CHILENO;;Millenial;PROVIDENCIA                   ;METROPOLITANA;0;0;0;0;0;0;0;0;0;Freidora electrica Ut-KeramikAir;ELECTRODOMESTICOS
11124478;;F;54;CHILENO;;Boomers;PROVIDENCIA                   ;METROPOLITANA;0;0;0;0;0;0;0;0;0;Horno Microondas Mecanico TH-18B05 18Lts;ELECTRODOMESTICOS
19180952;;F;26;CHILENO;;Z;ALTO HOSPICIO;TARAPACA;0;0;0;0;0;0;0;0;0;Hervidor Electrico UT-MANLY17 1,7Lts Negro;ELECTRODOMESTICOS
8248777;;M;64;CHILENO;;Boomers;PROVIDENCIA                   ;METROPOLITANA;0;0;0;0;0;0;0;0;0;Batidora Vertical BM-450 Negra;ELECTRODOMESTICOS
15190369;Soltero;F;40;CHILENO;;X;RENCA                         ;METROPOLITANA;0;0;0;0;0;0;0;0;0;Licuadora TH-320 Roja/Negro 1,5 Lts Vaso Vidrio;ELECTRODOMESTICOS
11929891;;F;50;CHILENO;;X;TOCOPILLA                     ;ANTOFAGASTA;0;0;0;0;0;0;0;0;0;Hervidor Electrico TH-5407i 2Lts;ELECTRODOMESTICOS
15045163;;F;37;CHILENO;;Millenial;PROVIDENCIA                   ;METROPOLITANA;0;0;0;0;0;0;0;0;0;Licuadora TH-320 Roja/Negro 1,5 Lts Vaso Vidrio;ELECTRODOMESTICOS
19385001;;F;25;CHILENO;;Z;PUENTE ALTO                   ;METROPOLITANA;0;0;0;0;0;0;0;0;0;Batidora Manual BA-5010 Inox;ELECTRODOMESTICOS
7844026;;F;66;CHILENO;;Silencioso;PROVIDENCIA                   ;METROPOLITANA;0;0;0;0;0;0;0;0;0;Horno Microondas Digital TH-20S01 20Lts;ELECTRODOMESTICOS
16459606;;F;35;CHILENO;;Millenial;PROVIDENCIA                   ;METROPOLITANA;0;0;0;0;0;0;0;0;0;Horno Microondas Digital TH-25DGM 25Lts;ELECTRODOMESTICOS
8068513;Casado;F;63;CHILENO;;Boomers;PROVIDENCIA                   ;METROPOLITANA;0;0;0;0;0;0;0;0;0;Licuadora TH-401V Roja 1,75Lts Vaso Vidrio;ELECTRODOMESTICOS
16527784;;F;35;CHILENO;;Millenial;PROVIDENCIA                   ;METROPOLITANA;0;0;0;0;0;0;0;0;0;Licuadora TH-320 Roja/Negro 1,5 Lts Vaso Vidrio;ELECTRODOMESTICOS
7368498;;M;65;CHILENO;;Boomers;PADRE HURTADO                 ;METROPOLITANA;0;0;0;0;0;0;0;0;0;Procesador TH-9010 Multimixer 1,5Lts Vaso Vidrio;ELECTRODOMESTICOS
8479936;;F;68;CHILENO;;Boomers;ARAUCO                        ;BIO BIO;0;0;0;0;0;0;0;0;0;Picadora P-123TOPBL 1,5Lts;ELECTRODOMESTICOS
11277172;;F;54;CHILENO;;X;PROVIDENCIA                   ;METROPOLITANA;0;0;0;0;0;0;0;0;0;Picadora TH-9020V Vaso Vidrio 2Lts;ELECTRODOMESTICOS
10337867;Casado;M;55;CHILENO;PROFESOR;Boomers;RENCA                         ;METROPOLITANA;0;0;0;0;0;0;0;0;0;Hervidor Electrico UT-DUNKEL17P 2Lts Negro;ELECTRODOMESTICOS
11345805;;F;53;CHILENO;;X;RENCA                         ;METROPOLITANA;0;0;0;0;0;0;0;0;0;Licuadora TH-401V Roja 1,75Lts Vaso Vidrio;ELECTRODOMESTICOS
8483378;;M;63;CHILENO;;Boomers;PROVIDENCIA                   ;METROPOLITANA;0;0;0;0;0;0;0;0;0;Licuadora Roja 550W 1,5Lts Vaso Vidrio;ELECTRODOMESTICOS
9783207;;M;56;CHILENO;;Boomers;PAINE                         ;METROPOLITANA;0;0;0;0;0;0;0;0;0;PLANCHA A VAPOR 6003 BASE ANTIADHERENTE 1600W;ELECTRODOMESTICOS
12005519;;F;45;CHILENO;;X;PUNTA ARENAS                  ;MAGALLANES;0;0;0;0;0;0;0;0;0;Hervidor Electrico TH-5407i 2Lts;ELECTRODOMESTICOS
19261939;;F;26;CHILENO;;Extranjero;SANTIAGO                      ;METROPOLITANA;0;0;0;0;0;0;0;0;0;Licuadora Roja 550W 1,5Lts Vaso Vidrio;ELECTRODOMESTICOS
18465680;Soltero;M;29;CHILENO;;Millenial;PROVIDENCIA                   ;METROPOLITANA;0;0;0;0;0;0;0;0;0;ASPIRADORA POLVO Y AGUA APA-1150 IN;ELECTRODOMESTICOS
10518415;Casado;M;56;CHILENO;;Silencioso;PROVIDENCIA                   ;METROPOLITANA;0;0;0;0;0;0;0;0;0;Licuadora Personal TH-300PB;ELECTRODOMESTICOS
26496417;;M;33;EXTRANJERO - NO INFORMA NACIONALIDAD;;Extranjero;SAN MIGUEL                    ;METROPOLITANA;0;0;0;0;0;0;0;0;0;Licuadora L2000VNG 1,5Lts Vaso Vidrio;ELECTRODOMESTICOS
6191791;;F;73;CHILENO;;Silencioso;N/D;N/D;0;0;0;0;0;0;0;0;0;BATIDORA INMERSION S MIX 2616;ELECTRODOMESTICOS
10865292;;F;55;CHILENO;;Boomers;ZAPALLAR                      ;VALPARAISO;0;0;0;0;0;0;0;0;0;Licuadora Personal TH-300PB;ELECTRODOMESTICOS
11923184;;F;50;CHILENO;;Millenial;N/D;N/D;0;0;0;0;0;0;0;0;0;Plancha TH-7052 2000Watts Base Inox;ELECTRODOMESTICOS
25559375;;F;38;BOLIVIANO;;Extranjero;VITACURA                      ;METROPOLITANA;0;0;0;0;0;0;0;0;0;Hervidor Electrico UT-MANLY17 1,7Lts Negro;ELECTRODOMESTICOS
7287313;;F;63;CHILENO;;Boomers;VILLA ALEMANA                 ;VALPARAISO;0;0;0;0;0;0;0;0;0;Combo Licuadora + Batidora;ELECTRODOMESTICOS
18187815;Soltero;F;30;CHILENO;;Millenial;PROVIDENCIA                   ;METROPOLITANA;0;0;0;0;0;0;0;0;0;Aspiradora AP1700 Arrastre 1700Watts;ELECTRODOMESTICOS
13979297;;F;41;CHILENO;;X;N/D;N/D;0;0;0;0;0;0;0;0;0;Hervidor Electrico TH-4515N 2Lts Negro;ELECTRODOMESTICOS
17052661;;M;33;CHILENO;;Millenial;PROVIDENCIA                   ;METROPOLITANA;0;0;0;0;0;0;0;0;0;Batidora Vertical Minipimer UT-KLOT400P;ELECTRODOMESTICOS
15829203;;M;37;CHILENO;;Millenial;PROVIDENCIA                   ;METROPOLITANA;0;0;0;0;0;0;0;0;0;Parrilla Electrica PE2650;ELECTRODOMESTICOS
16688535;;F;34;CHILENO;;Millenial;N/D;N/D;0;0;0;0;0;0;0;0;0;Tostador de PanTH-120R 2 Rebanadas Rojo;ELECTRODOMESTICOS
10188760;;F;57;CHILENO;;Boomers;PROVIDENCIA                   ;METROPOLITANA;0;0;0;0;0;0;0;0;0;Licuadora L-1630V Negra 1,5Lts Vaso Vidrio;ELECTRODOMESTICOS
18627683;;M;28;CHILENO;;Millenial;ILLAPEL;COQUIMBO;0;0;0;0;0;0;0;0;0;Aspiradora Handy Clean Black 1400;ELECTRODOMESTICOS
16468814;Casado;M;35;CHILENO;KINESIOLOGO;Millenial;PROVIDENCIA                   ;METROPOLITANA;0;0;0;0;0;0;0;0;0;Aspiradora TH1415 Arrastre 1500Watts;ELECTRODOMESTICOS
16303862;;F;35;CHILENO;;Millenial;PROVIDENCIA                   ;METROPOLITANA;0;0;0;0;0;0;0;0;0;Aspiradora TH1870 Arrastre 1800Watts Gris;ELECTRODOMESTICOS
9969999;;F;56;CHILENO;;Boomers;CONCHALI                      ;METROPOLITANA;0;0;0;0;0;0;0;0;0;Licuadora TH-501V 1,5Lts Vaso Vidrio;ELECTRODOMESTICOS
7040056;Casado;M;63;CHILENO;INGENIERO;Boomers;PROVIDENCIA                   ;METROPOLITANA;0;0;0;0;0;0;0;0;0;MICROONDAS ME83X/XZS SAMSUNG MIRROR;ELECTRODOMESTICOS
8624989;;M;61;CHILENO;;Boomers;RENCA                         ;METROPOLITANA;0;0;0;0;0;0;0;0;0;Horno Microondas Digital TH-25DM 25Lts;ELECTRODOMESTICOS
6043273;Viudo;F;71;CHILENO;;Silencioso;PROVIDENCIA                   ;METROPOLITANA;0;0;0;0;0;0;0;0;0;Hervidor Termo TH-5440TK 1,5Lts Inox;ELECTRODOMESTICOS
7280436;;M;68;CHILENO;;Silencioso;PAREDONES                     ;L.G.B.OÂ´HIGGINS;0;0;0;0;0;0;0;0;0;Horno Microondas Mecanico TH-18B05 18Lts;ELECTRODOMESTICOS
8753566;;F;58;CHILENO;;Boomers;PROVIDENCIA                   ;METROPOLITANA;0;0;0;0;0;0;0;0;0;Plancha TH-7052 2000Watts Base Inox;ELECTRODOMESTICOS
17234266;;F;32;CHILENO;;Millenial;"";"";0;0;0;0;0;0;0;0;0;Aspiradora Polvo AP-700 GR;ELECTRODOMESTICOS
18863879;Soltero;F;27;CHILENO;;Z;PROVIDENCIA                   ;METROPOLITANA;0;0;0;0;0;0;0;0;0;BATIDORA INMERSION S MIX 2616;ELECTRODOMESTICOS
6971667;;F;63;CHILENO;;Millenial;PROVIDENCIA                   ;METROPOLITANA;0;0;0;0;0;0;0;0;0;Aspiradora UT-SILENT1603 Arrastre 1600Watts;ELECTRODOMESTICOS
12545117;;F;48;CHILENO;;X;CAUQUENES                     ;MAULE;0;0;0;0;0;0;0;0;0;Plancha GSTBS 5854 1600Watts Base Ceramica;ELECTRODOMESTICOS
13198728;;F;45;CHILENO;;X;PROVIDENCIA                   ;METROPOLITANA;0;0;0;0;0;0;0;0;0;FREIDORA DE AIRE CKSTAF18D 1000W;ELECTRODOMESTICOS
6306000;;M;70;CHILENO;;Silencioso;RENCA                         ;METROPOLITANA;0;0;0;0;0;0;0;0;0;Hervidor Electrico UT-KLAR20PW 2Lts Blanco;ELECTRODOMESTICOS
11387279;;M;53;CHILENO;;X;HIJUELAS                      ;VALPARAISO;0;0;0;0;0;0;0;0;0;Licuadora TH-501V 1,5Lts Vaso Vidrio;ELECTRODOMESTICOS
6050986;;F;74;CHILENO;;Silencioso;RENCA                         ;METROPOLITANA;0;0;0;0;0;0;0;0;0;Horno Electrico TH-25N01 25Lts;ELECTRODOMESTICOS
13557967;;M;43;CHILENO;;X;EL MONTE                      ;METROPOLITANA;0;0;0;0;0;0;0;0;0;Horno Electrico UT-BACKOFEN60 60Lts;ELECTRODOMESTICOS
16295391;Soltero;F;36;CHILENO;KINESIOLOGO;Millenial;CANETE                        ;BIO BIO;0;0;0;0;0;0;0;0;0;Horno Electrico TH-48N 48Lts;ELECTRODOMESTICOS
19993806;;M;23;CHILENO;;Z;PROVIDENCIA                   ;METROPOLITANA;0;0;0;0;0;0;0;0;0;Batidora Pedestal UT-KLEIN700;ELECTRODOMESTICOS
17206735;Casado;M;33;CHILENO;CIRUJANO DENTISTA;Millenial;PROVIDENCIA                   ;METROPOLITANA;0;0;0;0;0;0;0;0;0;LICUADORA BLANCA CON ROTOR 1,5LTS;ELECTRODOMESTICOS
7276986;;F;67;CHILENO;;Boomers;SAN RAMON                     ;METROPOLITANA;0;0;0;0;0;0;0;0;0;Horno Microondas Digital TH-20S01 20Lts;ELECTRODOMESTICOS
26554171;;M;29;VENEZOLANO;;Extranjero;"";"";0;0;0;0;0;0;0;0;0;Batidora Manual UT-TEKLA300;ELECTRODOMESTICOS
9932225;;M;57;CHILENO;;Boomers;VICTORIA                      ;ARAUCANIA;0;0;0;0;0;0;0;0;0;Plancha THOMAS TH-7170 2200Watts Base Ceramica;ELECTRODOMESTICOS
16206507;;F;36;CHILENO;;Millenial;PROVIDENCIA                   ;METROPOLITANA;0;0;0;0;0;0;0;0;0;Picadora TH-9020V Vaso Vidrio 2Lts;ELECTRODOMESTICOS
7535349;;F;72;CHILENO;;Silencioso;VALDIVIA                      ;LOS RIOS;0;0;0;0;0;0;0;0;0;MAQ. DE COSER REMINGTON STF16;ELECTRODOMESTICOS
9844561;;F;59;CHILENO;;Boomers;HUASCO                        ;ATACAMA;0;0;0;0;0;0;0;0;0;PLANCHA A VAPOR 6003 BASE ANTIADHERENTE 1600W;ELECTRODOMESTICOS
16461162;;F;35;CHILENO;;Millenial;PROVIDENCIA                   ;METROPOLITANA;0;0;0;0;0;0;0;0;0;Licuadora UT-METALLEK705 1,75Lts Vaso Vidrio;ELECTRODOMESTICOS
17352167;;F;32;CHILENO;;Millenial;PROVIDENCIA                   ;METROPOLITANA;0;0;0;0;0;0;0;0;0;Licuadora TH-401V Roja 1,75Lts Vaso Vidrio;ELECTRODOMESTICOS
17696661;Casado;F;31;CHILENO;;Millenial;RENCA                         ;METROPOLITANA;0;0;0;0;0;0;0;0;0;Batidora Vertical Multimixer TH-8720;ELECTRODOMESTICOS
14334659;;M;44;CHILENO;;X;PLACILLA                      ;L.G.B.OÂ´HIGGINS;0;0;0;0;0;0;0;0;0;Horno Electrico TH62I 60Lts;ELECTRODOMESTICOS
5630839;Casado;F;74;CHILENO;KINESIOLOGO;Millenial;PROVIDENCIA                   ;METROPOLITANA;0;0;0;0;0;0;0;0;0;Aspiradora TH1870 Arrastre 1800Watts Gris;ELECTRODOMESTICOS
11719697;Casado;M;51;CHILENO;INGENIERO EN AUTOMATIZACION Y CONTROL INDUSTRIAL;X;RENCA                         ;METROPOLITANA;0;0;0;0;0;0;0;0;0;Extractor de Jugo EX800 1,4Lts;ELECTRODOMESTICOS
5612162;;M;75;CHILENO;;Silencioso;RENCA                         ;METROPOLITANA;0;0;0;0;0;0;0;0;0;Licuadora TH-320 Roja/Negro 1,5 Lts Vaso Vidrio;ELECTRODOMESTICOS
10313744;Soltero;F;56;CHILENO;;Boomers;RENCA                         ;METROPOLITANA;0;0;0;0;0;0;0;0;0;Olla Arrocera OA-400NG 1,8Lts;ELECTRODOMESTICOS
15715425;Casado;F;38;CHILENO;;Silencioso;PROVIDENCIA                   ;METROPOLITANA;0;0;0;0;0;0;0;0;0;Horno Electrico TH-48N 48Lts;ELECTRODOMESTICOS
14907469;;F;41;CHILENO;;X;"";"";0;0;0;0;0;0;0;0;0;Horno Microondas Mecanico UT-SYDNEY18 18Lts;ELECTRODOMESTICOS
8789427;;M;62;CHILENO;;Boomers;SALAMANCA                     ;COQUIMBO;0;0;0;0;0;0;0;0;0;Horno Electrico TH62I 60Lts;ELECTRODOMESTICOS
13739160;;F;42;CHILENO;;X;PROVIDENCIA                   ;METROPOLITANA;0;0;0;0;0;0;0;0;0;Aspiradora AP3400 Arrastre 2000Watts;ELECTRODOMESTICOS
14573639;;F;46;CHILENO;;X;SAN FABIAN                    ;BIO BIO;0;0;0;0;0;0;0;0;0;Licuadora TH-401V Roja 1,75Lts Vaso Vidrio;ELECTRODOMESTICOS
22758301;;F;34;BOLIVIANO;;Extranjero;ARICA                         ;TARAPACA;0;0;0;0;0;0;0;0;0;Licuadora TH-501V 1,5Lts Vaso Vidrio;ELECTRODOMESTICOS
8687356;;M;62;CHILENO;;Boomers;COIHAIQUE                     ;AYSEN;0;0;0;0;0;0;0;0;0;Aspiradora UT-MEINER1803 Arrastre 1800Watts;ELECTRODOMESTICOS
10556234;;F;52;CHILENO;;X;RENCA                         ;METROPOLITANA;0;0;0;0;0;0;0;0;0;Licuadora UT-METALLEK605P 1,55Lts;ELECTRODOMESTICOS
10045049;;F;48;CHILENO;;X;CHONCHI                       ;LOS LAGOS;0;0;0;0;0;0;0;0;0;Licuadora TH-501V 1,5Lts Vaso Vidrio;ELECTRODOMESTICOS
11631577;Soltero;M;51;CHILENO;;Silencioso;PROVIDENCIA                   ;METROPOLITANA;0;0;0;0;0;0;0;0;0;LICUADORA BLANCA CON ROTOR 1,5LTS;ELECTRODOMESTICOS
17562503;Soltero;M;32;CHILENO;TECNICO EN ADMINISTRACION DE EMPRESAS;Millenial;PROVIDENCIA                   ;METROPOLITANA;0;0;0;0;0;0;0;0;0;Horno Microondas Mecanico UT-SYDNEY18 18Lts;ELECTRODOMESTICOS
13158688;;M;52;CHILENO;;X;PROVIDENCIA                   ;METROPOLITANA;0;0;0;0;0;0;0;0;0;PICADORA 123 SILHQUETTE;ELECTRODOMESTICOS
18070835;;M;30;CHILENO;;Millenial;RENCA                         ;METROPOLITANA;0;0;0;0;0;0;0;0;0;Aspiradora UT-SILENT1804 Arrastre 1800Watts;ELECTRODOMESTICOS
11288484;;F;53;CHILENO;;X;RENCA                         ;METROPOLITANA;0;0;0;0;0;0;0;0;0;Hervidor Electrico TH-4212N 1,7Lts Negro;ELECTRODOMESTICOS
12117701;;F;48;CHILENO;;X;PROVIDENCIA                   ;METROPOLITANA;0;0;0;0;0;0;0;0;0;Aspiradora UT-SILENT1603 Arrastre 1600Watts;ELECTRODOMESTICOS
12730353;;F;47;CHILENO;;X;SAN IGNACIO                   ;BIO BIO;0;0;0;0;0;0;0;0;0;Horno Electrico TH62I 60Lts;ELECTRODOMESTICOS
8123146;Soltero;M;62;CHILENO;;Boomers;RENCA                         ;METROPOLITANA;0;0;0;0;0;0;0;0;0;Maquina para Hacer Pan MPP-600 BL;ELECTRODOMESTICOS
13729387;;F;43;CHILENO;;X;N/D;N/D;0;0;0;0;0;0;0;0;0;Tostador de Pan TH-126 4 Rebanadas Negro;ELECTRODOMESTICOS
20312110;;F;23;CHILENO;;Z;PUERTO MONTT                  ;LOS LAGOS;0;0;0;0;0;0;0;0;0;Batidora Vertical Multimixer TH-8720;ELECTRODOMESTICOS
6457846;;F;74;CHILENO;;Silencioso;RENCA                         ;METROPOLITANA;0;0;0;0;0;0;0;0;0;Horno Electrico TH-38N 38Lts;ELECTRODOMESTICOS
7377864;;M;64;CHILENO;;Boomers;PROVIDENCIA                   ;METROPOLITANA;0;0;0;0;0;0;0;0;0;Horno Electrico TH-38N 38Lts;ELECTRODOMESTICOS
8636817;Casado;F;64;CHILENO;;Boomers;PROVIDENCIA                   ;METROPOLITANA;0;0;0;0;0;0;0;0;0;Horno Electrico TH-38N 38Lts;ELECTRODOMESTICOS
17543212;;F;32;CHILENO;;Millenial;PROVIDENCIA                   ;METROPOLITANA;0;0;0;0;0;0;0;0;0;Hervidor Electrico UT-DUNKEL17P 2Lts Negro;ELECTRODOMESTICOS
7033338;;M;64;CHILENO;;Boomers;VILLA ALEMANA                 ;VALPARAISO;0;0;0;0;0;0;0;0;0;Aspiradora TH1415 Arrastre 1500Watts;ELECTRODOMESTICOS
18297098;;F;37;CHILENO;;Millenial;"";"";0;0;0;0;0;0;0;0;0;Aspiradora TH1407 Arrastre 1400Watts;ELECTRODOMESTICOS
5960503;;M;75;CHILENO;;Silencioso;PUERTO MONTT                  ;LOS LAGOS;0;0;0;0;0;0;0;0;0;ASPIRADORA THOMAS TH-1640;ELECTRODOMESTICOS
9934007;;M;58;CHILENO;;Boomers;RENCA                         ;METROPOLITANA;0;0;0;0;0;0;0;0;0;Hervidor Electrico TH-5407i 2Lts;ELECTRODOMESTICOS
5906614;;F;76;CHILENO;;Silencioso;CALAMA                        ;ANTOFAGASTA;0;0;0;0;0;0;0;0;0;Batidora Manual UT-TEKLA300;ELECTRODOMESTICOS
6282445;;M;72;CHILENO;;Silencioso;SAN BERNARDO                  ;METROPOLITANA;0;0;0;0;0;0;0;0;0;Horno Microondas Mecanico UT-SYDNEY18 18Lts;ELECTRODOMESTICOS
9114939;Casado;F;55;CHILENO;;Boomers;RENCA                         ;METROPOLITANA;0;0;0;0;0;0;0;0;0;Hervidor Electrico HA-3300 2,5Lts Blanco;ELECTRODOMESTICOS
15188899;;M;40;CHILENO;;X;RENCA                         ;METROPOLITANA;0;0;0;0;0;0;0;0;0;Horno Microondas Mecanico TH-18B05 18Lts;ELECTRODOMESTICOS
12947526;Casado;F;46;CHILENO;;X;PROVIDENCIA                   ;METROPOLITANA;0;0;0;0;0;0;0;0;0;Hervidor Electrico HA-3300 2,5Lts Blanco;ELECTRODOMESTICOS
18492219;;F;28;CHILENO;;Millenial;OSORNO                        ;LOS LAGOS;0;0;0;0;0;0;0;0;0;Batidora Manual 2532;ELECTRODOMESTICOS
17511595;;F;32;CHILENO;;Millenial;PROVIDENCIA                   ;METROPOLITANA;0;0;0;0;0;0;0;0;0;CAFETERA ELECTRICA UT-KAFFEE20BAR;ELECTRODOMESTICOS
8175752;Casado;F;63;CHILENO;;Boomers;RENCA                         ;METROPOLITANA;0;0;0;0;0;0;0;0;0;Licuadora Berry Blender Roja 1400 Vaso Vidrio;ELECTRODOMESTICOS
15277783;;M;38;CHILENO;;Millenial;PROVIDENCIA                   ;METROPOLITANA;0;0;0;0;0;0;0;0;0;Aspiradora UT-SILENT1603 Arrastre 1600Watts;ELECTRODOMESTICOS
11361563;Casado;F;52;CHILENO;;X;SAN MIGUEL                    ;METROPOLITANA;0;0;0;0;0;0;0;0;0;Cafetera P65 Silver;ELECTRODOMESTICOS
10636841;;M;52;CHILENO;;X;N/D;N/D;0;0;0;0;0;0;0;0;0;Extractor de Jugo EX800 1,4Lts;ELECTRODOMESTICOS
17789554;;M;31;CHILENO;;Millenial;PROVIDENCIA                   ;METROPOLITANA;0;0;0;0;0;0;0;0;0;Hervidor Electrico UT-REIN17SS;ELECTRODOMESTICOS
7954234;;F;64;CHILENO;;Boomers;CABILDO                       ;VALPARAISO;0;0;0;0;0;0;0;0;0;Enceradora EA-5000;ELECTRODOMESTICOS
22209129;;M;37;PERUANO;;Extranjero;RANCAGUA                      ;L.G.B.OÂ´HIGGINS;0;0;0;0;0;0;0;0;0;Maquina de Coser ME9100;ELECTRODOMESTICOS
17213980;;M;31;CHILENO;;Millenial;PROVIDENCIA                   ;METROPOLITANA;0;0;0;0;0;0;0;0;0;Horno Electrico UT-BACKOFEN26 26Lts;ELECTRODOMESTICOS
15942864;;F;37;CHILENO;;Millenial;CURICO;MAULE;0;0;0;0;0;0;0;0;0;Horno Microondas Mecanico C1700N 17Lts Blanco;ELECTRODOMESTICOS
14675807;Soltero;M;53;PERUANO;;Extranjero;CONCHALI                      ;METROPOLITANA;0;0;0;0;0;0;0;0;0;PLANCHA A VAPOR 2501 BASE CERAMICA 2200w;ELECTRODOMESTICOS
6466730;Casado;M;70;CHILENO;;Silencioso;PROVIDENCIA                   ;METROPOLITANA;0;0;0;0;0;0;0;0;0;Hervidor Electrico Tetera TH-6505RT 1,7Lts Rojo;ELECTRODOMESTICOS
4307146;;M;83;CHILENO;;Silencioso;COPIAPO                       ;ATACAMA;0;0;0;0;0;0;0;0;0;Licuadora L-1630V Negra 1,5Lts Vaso Vidrio;ELECTRODOMESTICOS
4949443;;M;77;CHILENO;;Silencioso;CHIMBARONGO                   ;L.G.B.OÂ´HIGGINS;0;0;0;0;0;0;0;0;0;Horno Electrico TH-25N01 25Lts;ELECTRODOMESTICOS
12439741;;F;48;CHILENO;;X;PROVIDENCIA                   ;METROPOLITANA;0;0;0;0;0;0;0;0;0;Horno Microondas Digital UT-CLASSY720 20Lts;ELECTRODOMESTICOS
15069190;Soltero;M;39;CHILENO;ABOGADO;X;PROVIDENCIA                   ;METROPOLITANA;0;0;0;0;0;0;0;0;0;Aspiradora Trapeadora Robot Ut-Excellenza (B);ELECTRODOMESTICOS
15215838;;F;40;CHILENO;;X;CHILLAN                       ;BIO BIO;0;0;0;0;0;0;0;0;0;Horno Electrico UT-BACKOFEN38 38Lts;ELECTRODOMESTICOS
14367036;Casado;F;48;CHILENO;;X;VINA DEL MAR                  ;VALPARAISO;0;0;0;0;0;0;0;0;0;Hervidor Electrico UT-MANLY17 1,7Lts Negro;ELECTRODOMESTICOS
18420561;;M;28;CHILENO;;Millenial;N/D;N/D;0;0;0;0;0;0;0;0;0;Licuadora TH-501V 1,5Lts Vaso Vidrio;ELECTRODOMESTICOS
25528635;;M;29;BOLIVIANO;;Extranjero;ANTOFAGASTA                   ;ANTOFAGASTA;0;0;0;0;0;0;0;0;0;Horno Electrico TH62I 60Lts;ELECTRODOMESTICOS
18524510;;F;28;CHILENO;;Millenial;PROVIDENCIA                   ;METROPOLITANA;0;0;0;0;0;0;0;0;0;Hervidor Electrico Tetera TH-6505RT 1,7Lts Rojo;ELECTRODOMESTICOS
7375345;Casado;F;69;CHILENO;;Silencioso;MONTE PATRIA                  ;COQUIMBO;0;0;0;0;0;0;0;0;0;Horno Electrico TH-25N01 25Lts;ELECTRODOMESTICOS
18607376;Soltero;M;28;CHILENO;;Millenial;PROVIDENCIA                   ;METROPOLITANA;0;0;0;0;0;0;0;0;0;Licuadora Personal TH-300PB;ELECTRODOMESTICOS
17616585;;M;30;CHILENO;;Millenial;PROVIDENCIA                   ;METROPOLITANA;0;0;0;0;0;0;0;0;0;Hervidor 41020-CL 1,7Lts Inox;ELECTRODOMESTICOS
16514492;;F;35;CHILENO;;Millenial;SAN PEDRO DE LA PAZ           ;BIO BIO;0;0;0;0;0;0;0;0;0;Horno Electrico TH-38N 38Lts;ELECTRODOMESTICOS
17909534;;M;30;CHILENO;;Millenial;PROVIDENCIA                   ;METROPOLITANA;0;0;0;0;0;0;0;0;0;Horno Microondas Digital L UT-25KROMM 25Lts;ELECTRODOMESTICOS
15914091;;F;36;CHILENO;;Millenial;RENCA                         ;METROPOLITANA;0;0;0;0;0;0;0;0;0;Hervidor Termo TH-5440TK 1,5Lts Inox;ELECTRODOMESTICOS
6289478;Soltero;M;69;CHILENO;;Silencioso;RENCA                         ;METROPOLITANA;0;0;0;0;0;0;0;0;0;Plancha UT-KERAMIKTOP 2200Watts Base Ceramica;ELECTRODOMESTICOS
17300535;;M;32;CHILENO;;Millenial;PROVIDENCIA                   ;METROPOLITANA;0;0;0;0;0;0;0;0;0;Maquina de Coser ST-371HD Heavy Duty;ELECTRODOMESTICOS
12511731;Soltero;F;49;CHILENO;CONTADOR GENERAL;X;RENCA                         ;METROPOLITANA;0;0;0;0;0;0;0;0;0;Olla Arrocera OA-400NG 1,8Lts;ELECTRODOMESTICOS
7317419;;F;64;CHILENO;;Boomers;EL BOSQUE                     ;METROPOLITANA;0;0;0;0;0;0;0;0;0;Enceradora EA-5000;ELECTRODOMESTICOS
5508158;;F;79;CHILENO;;Silencioso;RENCA                         ;METROPOLITANA;0;0;0;0;0;0;0;0;0;Horno Electrico TH62I 60Lts;ELECTRODOMESTICOS
16142743;Soltero;M;36;CHILENO;ABOGADO;Millenial;PROVIDENCIA                   ;METROPOLITANA;0;0;0;0;0;0;0;0;0;Licuadora TH-501V 1,5Lts Vaso Vidrio;ELECTRODOMESTICOS
18973759;;F;27;CHILENO;;Z;SAN ESTEBAN                   ;VALPARAISO;0;0;0;0;0;0;0;0;0;Procesador TH-9010 Multimixer 1,5Lts Vaso Vidrio;ELECTRODOMESTICOS
16976446;;M;34;CHILENO;;Millenial;PROVIDENCIA                   ;METROPOLITANA;0;0;0;0;0;0;0;0;0;Batidora Pedestal TH910PN 4,6Lts 1300Watts;ELECTRODOMESTICOS
9763207;Casado;F;59;CHILENO;;Boomers;RENCA                         ;METROPOLITANA;0;0;0;0;0;0;0;0;0;Licuadora Negra 550W 1,5Lts Vaso Vidrio;ELECTRODOMESTICOS
11868309;;F;51;CHILENO;;X;RECOLETA                      ;METROPOLITANA;0;0;0;0;0;0;0;0;0;Batidora Manual 2532;ELECTRODOMESTICOS
7803259;;F;78;CHILENO;;Silencioso;PROVIDENCIA                   ;METROPOLITANA;0;0;0;0;0;0;0;0;0;Procesador TH-9010 Multimixer 1,5Lts Vaso Vidrio;ELECTRODOMESTICOS
12181573;Casado;M;50;CHILENO;;X;PROVIDENCIA                   ;METROPOLITANA;0;0;0;0;0;0;0;0;0;Licuadora Personal TH-300PB;ELECTRODOMESTICOS
16469920;;F;36;CHILENO;;Millenial;PROVIDENCIA                   ;METROPOLITANA;0;0;0;0;0;0;0;0;0;Licuadora L-1630V Negra 1,5Lts Vaso Vidrio;ELECTRODOMESTICOS
13594740;Soltero;F;43;CHILENO;PROFESOR;X;RENCA                         ;METROPOLITANA;0;0;0;0;0;0;0;0;0;Horno Electrico TH-80i 80Lts;ELECTRODOMESTICOS
19722913;;F;24;CHILENO;;Z;PROVIDENCIA                   ;METROPOLITANA;0;0;0;0;0;0;0;0;0;Aspiradora Trapeadora Robot Ut-Excellenza (B);ELECTRODOMESTICOS
13808566;Casado;F;41;CHILENO;TECNICO DE NIVEL SUPERIOR EN ENFERMERIA;X;PROVIDENCIA                   ;METROPOLITANA;0;0;0;0;0;0;0;0;0;Horno Electrico TH-25N01 25Lts;ELECTRODOMESTICOS
17871511;;F;31;CHILENO;;Millenial;PROVIDENCIA                   ;METROPOLITANA;0;0;0;0;0;0;0;0;0;Cafetera UT-KAFFEEKLASSIK;ELECTRODOMESTICOS
14252600;Soltero;M;48;CHILENO;;X;QUILPUE                       ;VALPARAISO;0;0;0;0;0;0;0;0;0;Horno Electrico TH-25N01 25Lts;ELECTRODOMESTICOS
9457674;;F;63;CHILENO;;Boomers;SAN FELIPE                    ;VALPARAISO;0;0;0;0;0;0;0;0;0;Aspiradora Cyclonic Adventage roja CA4000N;ELECTRODOMESTICOS
16270621;;F;36;CHILENO;;Millenial;TALCA                         ;MAULE;0;0;0;0;0;0;0;0;0;TERMOHERVIDOR ELECTRON 3,1 LTS BA-6932 RG;ELECTRODOMESTICOS
13608101;;F;43;CHILENO;;X;VILLARICA                     ;ARAUCANIA;0;0;0;0;0;0;0;0;0;Batidora Manual UT-TEKLA300;ELECTRODOMESTICOS
19970258;;F;24;CHILENO;;Z;VALDIVIA                      ;LOS LAGOS;0;0;0;0;0;0;0;0;0;Horno Microondas Digital TH-20S01 20Lts;ELECTRODOMESTICOS
10628402;Soltero;M;51;CHILENO;PROFESOR;X;RENCA                         ;METROPOLITANA;0;0;0;0;0;0;0;0;0;Batidora Vertical BM-450 Negra;ELECTRODOMESTICOS
6609125;;F;68;CHILENO;;Silencioso;PROVIDENCIA                   ;METROPOLITANA;0;0;0;0;0;0;0;0;0;Licuadora L1000 Inox 1,7LtsVaso Vidrio;ELECTRODOMESTICOS
19756643;;M;25;CHILENO;;Z;PROVIDENCIA                   ;METROPOLITANA;0;0;0;0;0;0;0;0;0;Horno Microondas Digital TH-20S01 20Lts;ELECTRODOMESTICOS
18989096;;F;27;CHILENO;;Z;PROVIDENCIA                   ;METROPOLITANA;0;0;0;0;0;0;0;0;0;Hervidor Electrico UT-KLAR20PW 2Lts Blanco;ELECTRODOMESTICOS
8637011;Soltero;M;63;CHILENO;;Boomers;PROVIDENCIA                   ;METROPOLITANA;0;0;0;0;0;0;0;0;0;PLANCHA A VAPOR 6003 BASE ANTIADHERENTE 1600W;ELECTRODOMESTICOS
14758016;;M;49;PERUANO;;Extranjero;PROVIDENCIA                   ;METROPOLITANA;0;0;0;0;0;0;0;0;0;Plancha 6201 2200Watts Base Ceramica;ELECTRODOMESTICOS
18078957;;F;30;CHILENO;;Millenial;BUIN                          ;METROPOLITANA;0;0;0;0;0;0;0;0;0;Horno Electrico TH-80i 80Lts;ELECTRODOMESTICOS
19300232;Soltero;F;25;CHILENO;;Z;PROVIDENCIA                   ;METROPOLITANA;0;0;0;0;0;0;0;0;0;Licuadora TH-501V 1,5Lts Vaso Vidrio;ELECTRODOMESTICOS
5705350;;M;72;CHILENO;;Silencioso;QUILLOTA                      ;VALPARAISO;0;0;0;0;0;0;0;0;0;Batidora Pedestal TH910PN 4,6Lts 1300Watts;ELECTRODOMESTICOS
11328532;;F;54;CHILENO;;X;CALAMA                        ;ANTOFAGASTA;0;0;0;0;0;0;0;0;0;Plancha Paninis 2880;ELECTRODOMESTICOS
10857585;;F;55;CHILENO;;Boomers;CHILLAN VIEJO                 ;BIO BIO;0;0;0;0;0;0;0;0;0;Licuadora Berry Blender Roja 1400 Vaso Vidrio;ELECTRODOMESTICOS
17411874;Soltero;M;32;CHILENO;;Millenial;PROVIDENCIA                   ;METROPOLITANA;0;0;0;0;0;0;0;0;0;Aspiradora Polvo AP-700 GR;ELECTRODOMESTICOS
26996386;;M;43;VENEZOLANO;;Extranjero;PROVIDENCIA                   ;METROPOLITANA;0;0;0;0;0;0;0;0;0;Hervidor Electrico TH-4212N 1,7Lts Negro;ELECTRODOMESTICOS
12713891;;M;48;CHILENO;;X;PROVIDENCIA                   ;METROPOLITANA;0;0;0;0;0;0;0;0;0;Horno Microondas Mecanico Easy Wave 20Lts;ELECTRODOMESTICOS
15498351;;F;39;CHILENO;;X;PETORCA                       ;VALPARAISO;0;0;0;0;0;0;0;0;0;Hervidor Electrico TH-5407i 2Lts;ELECTRODOMESTICOS
13711093;;F;43;CHILENO;;X;EL BOSQUE                     ;METROPOLITANA;0;0;0;0;0;0;0;0;0;Plancha UT-PLATTEISEN 2000Watts Base Ceramica;ELECTRODOMESTICOS
19879641;;F;24;CHILENO;;Z;PROVIDENCIA                   ;METROPOLITANA;0;0;0;0;0;0;0;0;0;Horno Microondas Mecanico TH-18B05 18Lts;ELECTRODOMESTICOS
14068850;;F;41;CHILENO;;X;RENCA                         ;METROPOLITANA;0;0;0;0;0;0;0;0;0;Hervidor Electrico Tetera UT-LECKER18R 1,8Lts;ELECTRODOMESTICOS
10300827;;F;58;CHILENO;;Extranjero;FLORIDA                       ;BIO BIO;0;0;0;0;0;0;0;0;0;Horno Electrico UT-BACKOFEN38 38Lts;ELECTRODOMESTICOS
10063821;;F;57;CHILENO;;Boomers;RENCA                         ;METROPOLITANA;0;0;0;0;0;0;0;0;0;HERVIDOR ELECTRICO UT-STARK18;ELECTRODOMESTICOS
14051741;;F;41;CHILENO;;X;PROVIDENCIA                   ;METROPOLITANA;0;0;0;0;0;0;0;0;0;Horno Electrico TH-25N01 25Lts;ELECTRODOMESTICOS
14625272;;F;41;CHILENO;;X;LINARES                       ;MAULE;0;0;0;0;0;0;0;0;0;Licuadora TH-501V 1,5Lts Vaso Vidrio;ELECTRODOMESTICOS
16177739;;F;37;CHILENO;;Millenial;PROVIDENCIA                   ;METROPOLITANA;0;0;0;0;0;0;0;0;0;Hervidor Electrico UT-MANLY17 1,7Lts Negro;ELECTRODOMESTICOS
13386340;Casado;F;45;CHILENO;;X;PROVIDENCIA                   ;METROPOLITANA;0;0;0;0;0;0;0;0;0;PROCESADOR THOMAS TH-9160;ELECTRODOMESTICOS
12314861;;M;49;CHILENO;;X;PROVIDENCIA                   ;METROPOLITANA;0;0;0;0;0;0;0;0;0;Exprimidor de Jugo 407W 1Lts;ELECTRODOMESTICOS
10247539;;F;55;CHILENO;;Boomers;GRANEROS                      ;L.G.B.OÂ´HIGGINS;0;0;0;0;0;0;0;0;0;Batidora Vertical BM-450 Negra;ELECTRODOMESTICOS
17554122;;F;30;CHILENO;;Millenial;ALTO HOSPICIO;TARAPACA;0;0;0;0;0;0;0;0;0;Combo Juguera + Hervidor;ELECTRODOMESTICOS
12163553;;M;51;CHILENO;;X;LA PINTANA                    ;METROPOLITANA;0;0;0;0;0;0;0;0;0;Hervidor Electrico Tetera UT-LECKER18R 1,8Lts;ELECTRODOMESTICOS
10336048;;M;55;CHILENO;;Boomers;PELLUHUE                      ;MAULE;0;0;0;0;0;0;0;0;0;Horno Microondas Digital TH-20S01 20Lts;ELECTRODOMESTICOS
8109954;;F;60;CHILENO;;Boomers;SAN ANTONIO                   ;VALPARAISO;0;0;0;0;0;0;0;0;0;Batidora Vertical Multimixer TH-8720;ELECTRODOMESTICOS
13197908;Casado;M;45;CHILENO;INGENIERO DE EJECUCION EN INFORMATICA;X;N/D;N/D;0;0;0;0;0;0;0;0;0;Horno Microondas Mecanico TH-18B05 18Lts;ELECTRODOMESTICOS
19025376;;M;27;CHILENO;;Z;PUENTE ALTO                   ;METROPOLITANA;0;0;0;0;0;0;0;0;0;Tostador de Pan TH-126 4 Rebanadas Negro;ELECTRODOMESTICOS
15901670;;F;40;CHILENO;;X;PROVIDENCIA                   ;METROPOLITANA;0;0;0;0;0;0;0;0;0;Hervidor Electrico UT-DUNKEL17P 2Lts Negro;ELECTRODOMESTICOS
19553402;;F;25;CHILENO;;Z;PUERTO MONTT                  ;LOS LAGOS;0;0;0;0;0;0;0;0;0;Aspiradora VCC4190V3E/XZS Arrastre 2000Watts;ELECTRODOMESTICOS
10772779;;F;52;CHILENO;;X;RENCA                         ;METROPOLITANA;0;0;0;0;0;0;0;0;0;Aspiradora TH1407 Arrastre 1400Watts;ELECTRODOMESTICOS
17080055;Soltero;M;33;CHILENO;;Millenial;PROVIDENCIA                   ;METROPOLITANA;0;0;0;0;0;0;0;0;0;MAQUINA DE COSER OVERLOCK 14SH754;ELECTRODOMESTICOS
10052972;;F;58;CHILENO;;Boomers;RENCA                         ;METROPOLITANA;0;0;0;0;0;0;0;0;0;Aspiradora UT-ZYKLON1402 Arrastre 1400Watts;ELECTRODOMESTICOS
10267033;Casado;M;55;CHILENO;;Boomers;RENCA                         ;METROPOLITANA;0;0;0;0;0;0;0;0;0;Combo Plancha Batidora Secador de Pelo;ELECTRODOMESTICOS
13100684;;F;45;CHILENO;;X;PROVIDENCIA                   ;METROPOLITANA;0;0;0;0;0;0;0;0;0;Horno Electrico TH62I 60Lts;ELECTRODOMESTICOS
11569780;;M;52;CHILENO;;X;TALCAHUANO                    ;BIO BIO;0;0;0;0;0;0;0;0;0;Batidora Pedestal TH910PN 4,6Lts 1300Watts;ELECTRODOMESTICOS
7767982;;F;66;CHILENO;;Boomers;RENCA                         ;METROPOLITANA;0;0;0;0;0;0;0;0;0;Licuadora Berry Blender Roja 1400 Vaso Vidrio;ELECTRODOMESTICOS
26911537;;M;27;VENEZOLANO;;Extranjero;N/D;N/D;0;0;0;0;0;0;0;0;0;Horno Microondas Digital L UT-25KROMM 25Lts;ELECTRODOMESTICOS
8605385;;F;62;CHILENO;;Boomers;TOME                          ;BIO BIO;0;0;0;0;0;0;0;0;0;Licuadora L2000VNG 1,5Lts Vaso Vidrio;ELECTRODOMESTICOS
16309340;Soltero;F;36;CHILENO;PSICOLOGA;Millenial;SANTA CRUZ                    ;L.G.B.OÂ´HIGGINS;0;0;0;0;0;0;0;0;0;Enceradora EA-5000;ELECTRODOMESTICOS
5503523;;F;73;CHILENO;;Silencioso;VILLA ALEMANA                 ;VALPARAISO;0;0;0;0;0;0;0;0;0;Hervidor Electrico TH-4515N 2Lts Negro;ELECTRODOMESTICOS
10316740;;F;55;CHILENO;;Boomers;RENCA                         ;METROPOLITANA;0;0;0;0;0;0;0;0;0;Horno Electrico TH-25N01 25Lts;ELECTRODOMESTICOS
13567548;;F;43;CHILENO;;X;RENCA                         ;METROPOLITANA;0;0;0;0;0;0;0;0;0;Hervidor Electrico HE420 2lts Negro;ELECTRODOMESTICOS
19494354;;F;24;CHILENO;;Z;PROVIDENCIA                   ;METROPOLITANA;0;0;0;0;0;0;0;0;0;Batidora Manual 2532;ELECTRODOMESTICOS
11857739;;F;51;CHILENO;;X;N/D;N/D;0;0;0;0;0;0;0;0;0;Hervidor Electrico Tetera HA-4100 4Lts Iox;ELECTRODOMESTICOS
11923339;;M;50;CHILENO;;X;VINA DEL MAR                  ;VALPARAISO;0;0;0;0;0;0;0;0;0;Aspiradora TH1870 Arrastre 1800Watts Gris;ELECTRODOMESTICOS
11447987;;F;53;CHILENO;;X;PANGUIPULLI                   ;LOS LAGOS;0;0;0;0;0;0;0;0;0;Horno Microondas Mecanico M-2030 NG 20Lts;ELECTRODOMESTICOS
14135692;Casado;F;40;CHILENO;PROFESOR;X;PROVIDENCIA                   ;METROPOLITANA;0;0;0;0;0;0;0;0;0;PARRILLA ELECTRICA UT-ECOKERAMIK;ELECTRODOMESTICOS
13538515;;F;42;CHILENO;;X;NOGALES                       ;VALPARAISO;0;0;0;0;0;0;0;0;0;Licuadora UT-METALLEK505P 1,5Lts Vaso Vidrio;ELECTRODOMESTICOS
11717432;;M;54;CHILENO;;Boomers;DALCAHUE                      ;LOS LAGOS;0;0;0;0;0;0;0;0;0;Licuadora L2000VNG 1,5Lts Vaso Vidrio;ELECTRODOMESTICOS
8622794;Viudo;F;63;CHILENO;;Boomers;RENCA                         ;METROPOLITANA;0;0;0;0;0;0;0;0;0;Hervidor Electrico TH-4212N 1,7Lts Negro;ELECTRODOMESTICOS
14450194;;F;42;CHILENO;;X;PROVIDENCIA                   ;METROPOLITANA;0;0;0;0;0;0;0;0;0;HERVIDOR THOMAS TH-4720V;ELECTRODOMESTICOS
8935610;;F;63;CHILENO;;Boomers;RENCA                         ;METROPOLITANA;0;0;0;0;0;0;0;0;0;Aspiradora UT-ZYKLON1402 Arrastre 1400Watts;ELECTRODOMESTICOS
12980225;;F;47;CHILENO;;X;PANGUIPULLI                   ;LOS RIOS;0;0;0;0;0;0;0;0;0;Aspiradora AP1700 Arrastre 1700Watts;ELECTRODOMESTICOS
6566704;;F;79;CHILENO;;Silencioso;BUIN                          ;METROPOLITANA;0;0;0;0;0;0;0;0;0;Licuadora 4661B-052 Negra 1,5Lts Vaso Vidrio;ELECTRODOMESTICOS
17591208;;M;32;CHILENO;;Millenial;LOS ANGELES                   ;BIO BIO;0;0;0;0;0;0;0;0;0;Horno Microondas Mecanico M-2030 NG 20Lts;ELECTRODOMESTICOS
17386337;Soltero;F;32;CHILENO;;Millenial;PROVIDENCIA                   ;METROPOLITANA;0;0;0;0;0;0;0;0;0;Horno Microondas Digital TH-20S01 20Lts;ELECTRODOMESTICOS
17441543;;F;32;CHILENO;;Millenial;PROVIDENCIA                   ;METROPOLITANA;0;0;0;0;0;0;0;0;0;Horno Electrico TH-25N01 25Lts;ELECTRODOMESTICOS
8019948;;M;69;CHILENO;;Silencioso;PROVIDENCIA                   ;METROPOLITANA;0;0;0;0;0;0;0;0;0;Horno Microondas Mecanico TH-18B05 18Lts;ELECTRODOMESTICOS
18919260;;M;27;CHILENO;;Z;N/D;N/D;0;0;0;0;0;0;0;0;0;Plancha UT-SHANGRILA Inalambrica 2200Watss;ELECTRODOMESTICOS
20305503;;M;22;CHILENO;;Z;PROVIDENCIA                   ;METROPOLITANA;0;0;0;0;0;0;0;0;0;Licuadora TH-320 Roja/Negro 1,5 Lts Vaso Vidrio;ELECTRODOMESTICOS
15704452;;M;37;CHILENO;;Millenial;PROVIDENCIA                   ;METROPOLITANA;0;0;0;0;0;0;0;0;0;Licuadora UT-METALLEK505P 1,5Lts Vaso Vidrio;ELECTRODOMESTICOS
12398983;Casado;F;49;CHILENO;;X;CABILDO                       ;VALPARAISO;0;0;0;0;0;0;0;0;0;Plancha GSTBS 5854 1600Watts Base Ceramica;ELECTRODOMESTICOS
7431785;;M;66;CHILENO;;Boomers;SANTA MARIA                   ;VALPARAISO;0;0;0;0;0;0;0;0;0;Maquina de Coser ST-371HD Heavy Duty;ELECTRODOMESTICOS
16694570;;F;34;CHILENO;;Millenial;"";"";0;0;0;0;0;0;0;0;0;Hervidor Electrico TH-4515N 2Lts Negro;ELECTRODOMESTICOS
7852739;;M;64;CHILENO;;Boomers;TALAGANTE                     ;METROPOLITANA;0;0;0;0;0;0;0;0;0;Picadora TH-9020V Vaso Vidrio 2Lts;ELECTRODOMESTICOS
16131159;Casado;M;36;CHILENO;INGENIERO EN MAQUINARIA;Millenial;PROVIDENCIA                   ;METROPOLITANA;0;0;0;0;0;0;0;0;0;Hervidor Electrico UT-DUNKEL17P 2Lts Negro;ELECTRODOMESTICOS
7597317;;F;67;CHILENO;;Boomers;LAUTARO                       ;ARAUCANIA;0;0;0;0;0;0;0;0;0;Licuadora UT-METALLEK805R 1,75Lts Vaso Vidrio;ELECTRODOMESTICOS
6656887;Soltero;F;68;CHILENO;MEDICO CIRUJANO;Silencioso;RENCA                         ;METROPOLITANA;0;0;0;0;0;0;0;0;0;Horno Electrico TH-25N01 25Lts;ELECTRODOMESTICOS
17447276;;M;32;CHILENO;;Millenial;N/D;N/D;0;0;0;0;0;0;0;0;0;Tostador de PanTH-120R 2 Rebanadas Rojo;ELECTRODOMESTICOS
14261780;;M;47;CHILENO;;X;SAN FERNANDO                  ;L.G.B.OÂ´HIGGINS;0;0;0;0;0;0;0;0;0;Hervidor Electrico TH-4212N 1,7Lts Negro;ELECTRODOMESTICOS
16206104;;F;37;CHILENO;;Millenial;CONCEPCION                    ;BIO BIO;0;0;0;0;0;0;0;0;0;Combo Licuadora + Batidora;ELECTRODOMESTICOS
9189086;;F;60;CHILENO;;Boomers;PROVIDENCIA                   ;METROPOLITANA;0;0;0;0;0;0;0;0;0;MOPA A VAPOR SINDELEN MV-1305 GR;ELECTRODOMESTICOS
18678585;;F;28;CHILENO;;Millenial;PROVIDENCIA                   ;METROPOLITANA;0;0;0;0;0;0;0;0;0;Hervidor Electrico UT-DUNKEL17P 2Lts Negro;ELECTRODOMESTICOS
14539778;;F;44;CHILENO;;X;PROVIDENCIA                   ;METROPOLITANA;0;0;0;0;0;0;0;0;0;OVERLOCK TOYOTA SL 3335;ELECTRODOMESTICOS
11706521;;F;51;CHILENO;;X;ALGARROBO;VALPARAISO;0;0;0;0;0;0;0;0;0;Tostador de Pan TH-116 2 Rebanadas Negro;ELECTRODOMESTICOS
5481871;;F;73;CHILENO;;Silencioso;RENCA                         ;METROPOLITANA;0;0;0;0;0;0;0;0;0;Plancha TH-7052 2000Watts Base Inox;ELECTRODOMESTICOS
19192674;Soltero;F;26;CHILENO;TECNICO DE NIVEL MEDIO EN ALIMENTACION;Z;QUILPUE                       ;VALPARAISO;0;0;0;0;0;0;0;0;0;Tostador de Pan TH-116 2 Rebanadas Negro;ELECTRODOMESTICOS
8707122;Divorciado;F;63;CHILENO;;Boomers;RENCA                         ;METROPOLITANA;0;0;0;0;0;0;0;0;0;Tostador de PanTH-120R 2 Rebanadas Rojo;ELECTRODOMESTICOS
16337096;;F;35;CHILENO;;Millenial;N/D;N/D;0;0;0;0;0;0;0;0;0;Hervidor Electrico TH-4515N 2Lts Negro;ELECTRODOMESTICOS
18901384;;M;27;CHILENO;;Extranjero;TEMUCO                        ;ARAUCANIA;0;0;0;0;0;0;0;0;0;Aspiradora Handy Clean Black 1400;ELECTRODOMESTICOS
9048911;;M;61;CHILENO;;Boomers;PROVIDENCIA                   ;METROPOLITANA;0;0;0;0;0;0;0;0;0;Hervidor Electrico HA-3300 2,5Lts Blanco;ELECTRODOMESTICOS
14300812;;F;46;CHILENO;;X;RENCA                         ;METROPOLITANA;0;0;0;0;0;0;0;0;0;Licuadora TH-501V 1,5Lts Vaso Vidrio;ELECTRODOMESTICOS
8644654;Casado;M;59;CHILENO;;Boomers;RENCA                         ;METROPOLITANA;0;0;0;0;0;0;0;0;0;Horno Electrico UT-BACKOFEN48 48Lts;ELECTRODOMESTICOS
5901940;Casado;M;73;CHILENO;;Silencioso;PROVIDENCIA                   ;METROPOLITANA;0;0;0;0;0;0;0;0;0;Horno Microondas Mecanico TH-18B05 18Lts;ELECTRODOMESTICOS
6699912;;F;71;CHILENO;;Silencioso;VALDIVIA                      ;LOS RIOS;0;0;0;0;0;0;0;0;0;Horno Electrico TH62I 60Lts;ELECTRODOMESTICOS
16027183;;M;37;CHILENO;;Millenial;PROVIDENCIA                   ;METROPOLITANA;0;0;0;0;0;0;0;0;0;Hervidor Electrico TH-4515N 2Lts Negro;ELECTRODOMESTICOS
26483262;;M;24;COLOMBIANO;;Extranjero;ANTOFAGASTA                   ;ANTOFAGASTA;0;0;0;0;0;0;0;0;0;Horno Microondas Mecanico TH-18B05 18Lts;ELECTRODOMESTICOS
6215232;;F;67;CHILENO;;Boomers;RENCA                         ;METROPOLITANA;0;0;0;0;0;0;0;0;0;Tostador de Pan TP-1400 4 Rebanadas Inox;ELECTRODOMESTICOS
17901403;;M;30;CHILENO;;Millenial;CONSTITUCION                  ;MAULE;0;0;0;0;0;0;0;0;0;Combo Plancha Batidora Secador de Pelo;ELECTRODOMESTICOS
5018691;;M;78;CHILENO;;Silencioso;PROVIDENCIA                   ;METROPOLITANA;0;0;0;0;0;0;0;0;0;Hervidor Electrico Tetera UT-LECKER18R 1,8Lts;ELECTRODOMESTICOS
15453454;;F;40;CHILENO;;X;PROVIDENCIA                   ;METROPOLITANA;0;0;0;0;0;0;0;0;0;Parrilla Electrica UT-ECOKERAMIK(RED);ELECTRODOMESTICOS
7988250;;F;64;CHILENO;;Boomers;PAINE                         ;METROPOLITANA;0;0;0;0;0;0;0;0;0;Hervidor Electrico UT-KLAR20PW 2Lts Blanco;ELECTRODOMESTICOS
19630653;;F;25;CHILENO;;Z;PROVIDENCIA                   ;METROPOLITANA;0;0;0;0;0;0;0;0;0;Licuadora TH-320 Roja/Negro 1,5 Lts Vaso Vidrio;ELECTRODOMESTICOS
11728771;Casado;F;50;CHILENO;;X;RENCA                         ;METROPOLITANA;0;0;0;0;0;0;0;0;0;Licuadora TH-320 Roja/Negro 1,5 Lts Vaso Vidrio;ELECTRODOMESTICOS
19154098;;F;26;CHILENO;;Millenial;N/D;N/D;0;0;0;0;0;0;0;0;0;Aspiradora UT-SILENT1603 Arrastre 1600Watts;ELECTRODOMESTICOS
22668590;;M;40;PERUANO;;Extranjero;LO PRADO                      ;METROPOLITANA;0;0;0;0;0;0;0;0;0;Horno Microondas Mecanico Easy Wave 20Lts;ELECTRODOMESTICOS
6123922;Casado;F;72;CHILENO;;Silencioso;RENCA                         ;METROPOLITANA;0;0;0;0;0;0;0;0;0;Horno Electrico TH-25N01 25Lts;ELECTRODOMESTICOS
18560914;;F;28;CHILENO;;Millenial;N/D;N/D;0;0;0;0;0;0;0;0;0;Hervidor Electrico TH-4515N 2Lts Negro;ELECTRODOMESTICOS
12826545;;F;46;CHILENO;;X;N/D;N/D;0;0;0;0;0;0;0;0;0;Parrilla Electrica TH-180;ELECTRODOMESTICOS
10986341;;M;55;CHILENO;;Boomers;COIHAIQUE                     ;AYSEN;0;0;0;0;0;0;0;0;0;Aspiradora UT-KRAFT(DIG) Arrastre 2200Watts;ELECTRODOMESTICOS
11402057;;F;52;CHILENO;;X;N/D;N/D;0;0;0;0;0;0;0;0;0;Horno Electrico UT-BACKOFEN60 60Lts;ELECTRODOMESTICOS
19191792;;F;26;CHILENO;;Z;VALPARAISO                    ;VALPARAISO;0;0;0;0;0;0;0;0;0;Licuadora Osterizer 4112/72 1,25Lts Vaso Vidrio;ELECTRODOMESTICOS
19569218;;F;25;CHILENO;;Z;N/D;N/D;0;0;0;0;0;0;0;0;0;Hervidor Electrico TH-4515N 2Lts Negro;ELECTRODOMESTICOS
4891617;;F;78;CHILENO;;Silencioso;PROVIDENCIA                   ;METROPOLITANA;0;0;0;0;0;0;0;0;0;Hervidor Electrico UT-DUNKEL17P 2Lts Negro;ELECTRODOMESTICOS
10337350;;F;57;CHILENO;;Boomers;RENCA                         ;METROPOLITANA;0;0;0;0;0;0;0;0;0;Licuadora TH-320 Roja/Negro 1,5 Lts Vaso Vidrio;ELECTRODOMESTICOS
15539544;;F;38;CHILENO;;X;N/D;N/D;0;0;0;0;0;0;0;0;0;Batidora Manual TH-8830;ELECTRODOMESTICOS
16457749;;F;36;CHILENO;;Millenial;LA CRUZ                       ;VALPARAISO;0;0;0;0;0;0;0;0;0;Hervidor Electrico TH-4515N 2Lts Negro;ELECTRODOMESTICOS
6642091;;F;72;CHILENO;;Silencioso;PROVIDENCIA                   ;METROPOLITANA;0;0;0;0;0;0;0;0;0;Aspiradora UT-SILENT1804 Arrastre 1800Watts;ELECTRODOMESTICOS
20051259;;F;23;CHILENO;;Z;N/D;N/D;0;0;0;0;0;0;0;0;0;Tostador de Pan TH-126 4 Rebanadas Negro;ELECTRODOMESTICOS
17788567;Soltero;M;31;CHILENO;;Millenial;PROVIDENCIA                   ;METROPOLITANA;0;0;0;0;0;0;0;0;0;Batidora Pedestal Desmontable 64650-CL;ELECTRODOMESTICOS
8906129;;M;60;CHILENO;;Boomers;PUERTO MONTT                  ;LOS LAGOS;0;0;0;0;0;0;0;0;0;Aspiradora UT-SILENT1603 Arrastre 1600Watts;ELECTRODOMESTICOS
11454017;;F;55;CHILENO;;Boomers;PROVIDENCIA                   ;METROPOLITANA;0;0;0;0;0;0;0;0;0;Horno Electrico TH-25N01 25Lts;ELECTRODOMESTICOS
14141106;Soltero;F;40;CHILENO;;X;PROVIDENCIA                   ;METROPOLITANA;0;0;0;0;0;0;0;0;0;Cafetera Dolce Gusto Piccolo Red Nescafe;ELECTRODOMESTICOS
20086095;;F;36;CHILENO;;Millenial;N/D;N/D;0;0;0;0;0;0;0;0;0;Horno Electrico UT-LEIF36 36Lts;ELECTRODOMESTICOS
16055943;;F;37;CHILENO;;Millenial;N/D;N/D;0;0;0;0;0;0;0;0;0;Horno Electrico UT-BACKOFEN60 60Lts;ELECTRODOMESTICOS
18241763;;F;30;CHILENO;;Millenial;QUELLON                       ;LOS LAGOS;0;0;0;0;0;0;0;0;0;Batidora Manual TH-8830;ELECTRODOMESTICOS
19719841;;M;24;CHILENO;;Z;COLLIPULLI                    ;ARAUCANIA;0;0;0;0;0;0;0;0;0;Licuadora 4134 Cromada Azul 1,25Lts Vaso Vidrio;ELECTRODOMESTICOS
19036659;;F;27;CHILENO;;Z;SANTIAGO;METROPOLITANA;0;0;0;0;0;0;0;0;0;Batidora Manual UT-TEKLA300;ELECTRODOMESTICOS
18760352;;F;28;CHILENO;;Extranjero;ALGARROBO                     ;VALPARAISO;0;0;0;0;0;0;0;0;0;Horno Electrico TH-25N01 25Lts;ELECTRODOMESTICOS
13206876;Soltero;F;45;CHILENO;;X;RENCA                         ;METROPOLITANA;0;0;0;0;0;0;0;0;0;Hervidor Electrico TH-4212N 1,7Lts Negro;ELECTRODOMESTICOS
26443485;;M;30;CHILENO;;Extranjero;CONCEPCION                    ;BIO BIO;254970;3;2;2;1;219980;1;1;34990;BOX AM NEW ENTREE 2.0 PL;DORMITORIO
15752846;;F;38;CHILENO;;Millenial;VALPARAISO                    ;VALPARAISO;346970;3;2;2;1;206980;1;1;139990;CLOSET MANILA Z-120 5P - DUNA /BLANCO;DORMITORIO
13724021;;F;43;CHILENO;;X;LEBU                          ;BIO BIO;2652450;18;12;11;6;1735750;7;6;916700;CAMAROTE TRIPLE CARISMA 1P;DORMITORIO
8711231;;F;64;CHILENO;;Boomers;PROVIDENCIA                   ;METROPOLITANA;9990;1;1;0;0;0;1;1;9990;PACK 2 ALMOHADAS C+L;DORMITORIO
15739401;;F;38;CHILENO;;X;PROVIDENCIA                   ;METROPOLITANA;594460;4;2;4;2;594460;0;0;0;Cama Europea Terapeutic 2PBN + Resp + 2 Vel Vill;DORMITORIO
13112629;;M;46;CHILENO;;X;NUEVA IMPERIAL                ;ARAUCANIA;39980;2;1;0;0;0;2;1;39980;ALMOHADA DA SOFT SLEEP 50 X 70;DORMITORIO
26646320;;F;27;EXTRANJERO - NO INFORMA NACIONALIDAD;;Z;"";"";19980;2;1;0;0;0;2;1;19980;Almohadas Isidora Soft 50x70 cm;DORMITORIO
4738325;;M;80;CHILENO;;Silencioso;SAN FELIPE                    ;VALPARAISO;273580;2;1;0;0;0;2;1;273580;COLCHON BAMBOO 2P FIBRAS BAMBOO;DORMITORIO
7594399;;F;64;CHILENO;;Boomers;PROVIDENCIA                   ;METROPOLITANA;9990;1;1;0;0;0;1;1;9990;PACK 2 ALMOHADAS C+L;DORMITORIO
16207705;;M;36;CHILENO;;Millenial;LAS CONDES                    ;METROPOLITANA;33980;2;1;2;1;33980;0;0;0;SET RESPALDO BENITO 1,5 PLAZAS + 1 VELADOR;DORMITORIO
7600402;;M;66;CHILENO;;Boomers;MELIPILLA                     ;METROPOLITANA;234980;2;2;0;0;0;2;2;234980;COLCHON BAMBOO 2P FIBRAS BAMBOO;DORMITORIO
17080033;;M;33;CHILENO;;Millenial;N/D;N/D;263970;3;1;0;0;0;3;1;263970;COLCHON THERAPEDIC 2P;DORMITORIO
17783410;;M;31;CHILENO;;Millenial;N/D;N/D;585940;5;2;5;2;585940;0;0;0;CAMA EUROPEA IBIZA 2 PL BD;DORMITORIO
11291393;;F;53;CHILENO;;X;PROVIDENCIA                   ;METROPOLITANA;551940;5;3;5;3;551940;0;0;0;BASE AMERICANA SPRING VI 1.5 PL;DORMITORIO
12909387;;F;46;CHILENO;;X;VILLARICA                     ;ARAUCANIA;271961;5;6;0;0;0;5;6;271961;CE EVOLUTION BLACK 1,5P + RESPALDO CASTILLA;DORMITORIO
5487603;;F;75;CHILENO;;Silencioso;VILLA ALEGRE                  ;MAULE;673750;6;3;0;0;0;6;3;673750;COLCHON IBIZA 2P;DORMITORIO
6414708;;F;73;CHILENO;;Silencioso;DIEGO DE ALMAGRO              ;ATACAMA;2140390;17;7;2;1;351980;15;6;1788410;COLCHON BAMBOO 2P FIBRAS BAMBOO;DORMITORIO
6503472;Casado;M;70;CHILENO;;Silencioso;RENCA                         ;METROPOLITANA;282980;2;1;0;0;0;2;1;282980;COLCHON BAMBOO 2P FIBRAS BAMBOO;DORMITORIO
19971521;;F;23;CHILENO;;Z;PROVIDENCIA                   ;METROPOLITANA;212980;2;2;0;0;0;2;2;212980;CE EVOLUTION BLACK 1,5P + RESPALDO CASTILLA;DORMITORIO
6941812;;F;66;CHILENO;;Boomers;CONSTITUCION                  ;MAULE;10980;2;1;0;0;0;2;1;10980;Almohada Imperial Soft 50x70 cm;DORMITORIO
18314401;;M;29;CHILENO;;Millenial;N/D;N/D;377980;2;2;0;0;0;2;2;377980;Almohada Bamboo Classic 70x40;DORMITORIO
19337157;;F;26;CHILENO;;Extranjero;N/D;N/D;266980;2;1;2;1;266980;0;0;0;CAMAROTE TRIPLE MARI 1.5P;DORMITORIO
19352944;;M;26;CHILENO;;Z;COPIAPO;ATACAMA;14970;3;1;0;0;0;3;1;14970;PACK 2 ALMOHADAS C+L;DORMITORIO
16702756;;M;34;CHILENO;;Millenial;PUTAENDO                      ;VALPARAISO;354980;2;1;0;0;0;2;1;354980;Cama Europea Terapeutic 2PBN;DORMITORIO
10832785;;M;46;CHILENO;;X;PROVIDENCIA                   ;METROPOLITANA;0;0;2;0;0;0;0;2;0;BA BEAT 2P 2MTS BN;DORMITORIO
15951189;;M;37;CHILENO;;Millenial;VINA DEL MAR                  ;VALPARAISO;416980;4;2;2;1;316980;2;1;100000;CAMA NIDO EVOLUTION BLACK 1,5P;DORMITORIO
5982764;;M;72;CHILENO;;Silencioso;EL BOSQUE                     ;METROPOLITANA;759990;5;3;0;0;0;5;3;759990;COLCHON IBIZA 2P;DORMITORIO
17805591;;M;31;CHILENO;;Millenial;N/D;N/D;920890;11;5;11;5;920890;0;0;0;COLCHON SPRING VI 1P;DORMITORIO
14358679;;F;50;CHILENO;;X;CASTRO                        ;LOS LAGOS;52950;5;3;0;0;0;5;3;52950;PACK 2 ALMOHADAS C+L;DORMITORIO
11364211;;M;52;CHILENO;;X;MELIPILLA                     ;METROPOLITANA;2083810;4;2;0;0;0;4;2;2083810;CE EVOLUTION BLACK 1,5P + RESPALDO CASTILLA;DORMITORIO
12398796;;F;52;CHILENO;;X;LA LIGUA                      ;VALPARAISO;890860;6;3;0;0;0;6;3;890860;COLCHON DRIVEN 1.50X2.00;DORMITORIO
9363465;;F;60;CHILENO;;Boomers;MACUL                         ;METROPOLITANA;228810;2;1;0;0;0;2;1;228810;COLCHON NEW ORTOPEDIC 1,5P;DORMITORIO
24834365;;M;24;EXTRANJERO - NO INFORMA NACIONALIDAD;;Extranjero;"";"";5490;1;1;0;0;0;1;1;5490;Almohada Imperial Soft 50x70 cm;DORMITORIO
15721089;;F;38;CHILENO;;X;LAS CONDES                    ;METROPOLITANA;451950;5;3;2;1;126980;3;2;324970;CLOSET 3P 2C MOD Y443 - BICOLOR AT;DORMITORIO
8691315;;F;63;CHILENO;;Boomers;SAN BERNARDO                  ;METROPOLITANA;665930;7;3;0;0;0;7;3;665930;CE EVOLUTION BLACK 2P BN DUAL SIDE;DORMITORIO
11238295;;F;53;CHILENO;;X;CALAMA                        ;ANTOFAGASTA;230970;3;1;0;0;0;3;1;230970;CE EVOLUTION BLACK 1,5P BN RESP+VEL;DORMITORIO
16239763;;M;36;CHILENO;;Millenial;TALCAHUANO                    ;BIO BIO;109990;1;1;0;0;0;1;1;109990;COLCHON SPRING III 1P;DORMITORIO
26020633;;M;47;VENEZOLANO;;Extranjero;BUIN                          ;METROPOLITANA;10980;2;1;0;0;0;2;1;10980;Almohada Imperial Soft 50x70 cm;DORMITORIO
5428271;;F;71;CHILENO;;Silencioso;LOS ANDES                     ;VALPARAISO;374890;8;5;0;0;0;8;5;374890;PACK 2 ALMOHADAS C+L;DORMITORIO
20228095;;F;22;CHILENO;;Z;TALCA                         ;MAULE;1958990;24;7;4;2;277460;20;5;1681530;COLCHON BAMBOO 2P FIBRAS BAMBOO;DORMITORIO
6453586;;M;71;CHILENO;;Silencioso;ILLAPEL                       ;COQUIMBO;307508;5;2;2;1;92540;3;1;214968;COLCHON BAMBOO 2P FIBRAS BAMBOO;DORMITORIO
18859519;Soltero;M;26;CHILENO;TECNICO MECANICO;Z;PROVIDENCIA                   ;METROPOLITANA;129990;1;1;1;1;129990;0;0;0;COLCHON NEW ORTOPEDIC 1,5P;DORMITORIO
13704804;;M;43;CHILENO;;X;SAN BERNARDO                  ;METROPOLITANA;1050770;12;8;2;1;69990;10;7;980780;COLCHON TERAPEUTIC 2P PILLOW TOP;DORMITORIO
5755742;;M;73;CHILENO;;Silencioso;QUEMCHI                       ;LOS LAGOS;1126292;10;7;0;0;0;10;7;1126292;CAMA EUROPEA GRIS NEW ENTREE 1,5P;DORMITORIO
18599967;Soltero;F;28;CHILENO;;Millenial;PROVIDENCIA                   ;METROPOLITANA;91980;2;1;2;1;91980;0;0;0;BASE AMERICANA SPRING VI 2.0 PL;DORMITORIO
19214329;;F;26;CHILENO;;Z;PROVIDENCIA                   ;METROPOLITANA;9980;2;1;2;1;9980;0;0;0;PACK 2 ALMOHADAS C+L;DORMITORIO
18181500;;F;29;CHILENO;;Millenial;SAN VICENTE                   ;L.G.B.OÂ´HIGGINS;14970;3;2;3;2;14970;0;0;0;PACK 2 ALMOHADAS C+L;DORMITORIO
13038113;;F;45;CHILENO;;X;LA SERENA;COQUIMBO;5000;2;1;0;0;0;2;1;5000;PACK 2 ALMOHADAS C+L;DORMITORIO
6324526;;F;71;CHILENO;;Silencioso;LOS ALAMOS                    ;BIO BIO;803360;6;2;0;0;0;6;2;803360;COLCHON IBIZA 2P;DORMITORIO
20425468;;M;21;CHILENO;;Z;N/D;N/D;392340;5;2;2;1;349980;3;1;42360;Almohada ViscoGel Cobre 70x40x13 cm;DORMITORIO
15672107;;F;39;CHILENO;;X;OVALLE                        ;COQUIMBO;252960;4;2;0;0;0;4;2;252960;COLCHON TERAPEUTIC 1,5P PILLOW TOP;DORMITORIO
7513857;;F;67;CHILENO;;Boomers;MELIPILLA                     ;METROPOLITANA;167580;3;1;0;0;0;3;1;167580;COLCHON NEW ENTREE 1,5P;DORMITORIO
11512437;;M;52;CHILENO;;X;RIO HURTADO                   ;COQUIMBO;443500;6;4;0;0;0;6;4;443500;COLCHON BAMBOO 1,5P FIBRAS BAMBOO;DORMITORIO
17058934;Soltero;M;33;CHILENO;;Millenial;PROVIDENCIA                   ;METROPOLITANA;211920;8;3;8;3;211920;0;0;0;PACK 2 ALMOHADAS C+L;DORMITORIO
7573517;;F;66;CHILENO;;Boomers;EL BOSQUE                     ;METROPOLITANA;499970;3;2;0;0;0;3;2;499970;COLCHON ERGO T 1,5P;DORMITORIO
24791287;Soltero;M;36;VENEZOLANO;;Extranjero;PROVIDENCIA                   ;METROPOLITANA;8980;2;1;2;1;8980;0;0;0;PACK 2 ALMOHADAS C+L;DORMITORIO
18365586;Soltero;M;29;CHILENO;;Millenial;PROVIDENCIA                   ;METROPOLITANA;173980;2;1;2;1;173980;0;0;0;COLCHON NEW STYLE 2 2P;DORMITORIO
15508142;;F;35;CHILENO;;Millenial;CURACAUTIN                    ;ARAUCANIA;199980;2;1;2;1;199980;0;0;0;Colchon DANUBIO 2P x2m Comprimido;DORMITORIO
10657637;;F;49;CHILENO;;Millenial;N/D;N/D;1389920;6;4;6;4;1389920;0;0;0;CAMA EURO NEGRA MAXIMO CARBONO SUP-KING ALM VISC;DORMITORIO
15284574;;F;40;CHILENO;;X;PUERTO MONTT                  ;LOS LAGOS;498950;5;5;0;0;0;5;5;498950;PACK 2 ALMOHADAS C+L;DORMITORIO
17573835;;F;31;CHILENO;;Millenial;PROVIDENCIA                   ;METROPOLITANA;107980;2;1;2;1;107980;0;0;0;COMODA POLUX 8CJNS CEREZO;DORMITORIO
5615808;;F;71;CHILENO;;Silencioso;VILLA ALEMANA                 ;VALPARAISO;166980;2;1;0;0;0;2;1;166980;COLCHON BAMBOO 1,5P FIBRAS BAMBOO;DORMITORIO
18391193;;M;29;CHILENO;;Millenial;PROVIDENCIA                   ;METROPOLITANA;481960;4;2;4;2;481960;0;0;0;DIVAN CAMA ERGO T 1,5P 2 MTS;DORMITORIO
26361854;;F;46;VENEZOLANO;;Extranjero;N/D;N/D;486940;6;3;5;2;469950;1;1;16990;COLCHON WAVE 1.50X1.90;DORMITORIO
7409268;;M;68;CHILENO;;Silencioso;PADRE HURTADO                 ;METROPOLITANA;394920;4;1;0;0;0;4;1;394920;COLCHON TERAPEUTIC 2P PILLOW TOP;DORMITORIO
18826075;Soltero;F;28;CHILENO;INGENIERIA EN PREVENCION DE RIESGOS CALIDAD Y AMBIENTE;Millenial;PROVIDENCIA                   ;METROPOLITANA;261980;2;1;2;1;261980;0;0;0;CAMA AMERICANA SPRING VI 1.5 PL + ASTURIAS;DORMITORIO
5139272;;M;75;CHILENO;;Silencioso;ARICA                         ;ARICA Y PARINACOTA;507820;6;3;4;1;359950;2;2;147870;COLCHON SPRING III 1P;DORMITORIO
14211525;;M;40;CHILENO;;X;PROVIDENCIA                   ;METROPOLITANA;183970;3;1;3;1;183970;0;0;0;RESPALDO SICILIA 1 1/2PL;DORMITORIO
20211925;;M;23;CHILENO;;Z;PROVIDENCIA                   ;METROPOLITANA;4990;1;1;1;1;4990;0;0;0;PACK 2 ALMOHADAS C+L;DORMITORIO
17550737;;F;35;CHILENO;;Millenial;PAINE                         ;METROPOLITANA;430960;4;3;0;0;0;4;3;430960;PACK ALMOHADA VISCO ELASTICA CANNABIS 60X40CM;DORMITORIO
7993210;;M;63;CHILENO;;Boomers;VICTORIA                      ;ARAUCANIA;1021200;9;4;0;0;0;9;4;1021200;BOX AMERICANO MIRAGE 2PBN;DORMITORIO
7473679;;F;71;CHILENO;;Silencioso;EL BOSQUE                     ;METROPOLITANA;429970;3;2;0;0;0;3;2;429970;COLCHON ERGO T 1P;DORMITORIO
17603680;;F;31;CHILENO;;Silencioso;PROVIDENCIA                   ;METROPOLITANA;473960;4;2;4;2;473960;0;0;0;CAMA EUROPEA THERAPEDIC MAS FULL;DORMITORIO
10334287;;M;51;CHILENO;;Silencioso;PROVIDENCIA                   ;METROPOLITANA;616950;5;3;5;3;616950;0;0;0;COLCHON SUPER PREMIUM 2P X 2 MTS;DORMITORIO
25186110;Casado;M;36;HAITIANO;;Extranjero;PROVIDENCIA                   ;METROPOLITANA;379980;2;1;2;1;379980;0;0;0;BS NEW ORTOPEDIC B5BLACK 2PBN+RESP+2VEL LEGNO;DORMITORIO
15209382;;M;39;CHILENO;;X;COIHAIQUE                     ;AYSEN;219990;1;1;0;0;0;1;1;219990;COLCHON BAMBOO 2P FIBRAS BAMBOO;DORMITORIO
9069391;;M;61;CHILENO;;Boomers;PROVIDENCIA                   ;METROPOLITANA;4990;1;1;0;0;0;1;1;4990;PACK 2 ALMOHADAS C+L;DORMITORIO
16528297;;F;34;CHILENO;;Millenial;QUELLON                       ;LOS LAGOS;9980;2;1;0;0;0;2;1;9980;PACK 2 ALMOHADAS C+L;DORMITORIO
10686289;;F;53;CHILENO;;X;ANCUD                         ;LOS LAGOS;469960;5;2;0;0;0;5;2;469960;COLCHON NEW ORTOPEDIC 2P;DORMITORIO
18128785;;F;29;CHILENO;;Millenial;PROVIDENCIA                   ;METROPOLITANA;211980;2;1;2;1;211980;0;0;0;CE CURVE NEW ORTOPEDIC 2P;DORMITORIO
7488369;;F;66;CHILENO;;Boomers;ANTOFAGASTA                   ;ANTOFAGASTA;528520;10;4;0;0;0;10;4;528520;CE EVOLUTION BLACK 1,5P + RESPALDO CASTILLA;DORMITORIO
17310772;;M;32;CHILENO;;Millenial;PROVIDENCIA                   ;METROPOLITANA;281980;2;1;2;1;281980;0;0;0;BOX SPRING NEOSENSE FULL BLACK;DORMITORIO
18208951;;F;29;CHILENO;;Millenial;NATALES                       ;MAGALLANES;219990;1;3;0;0;0;1;3;219990;COLCHON ORTOPEDIC ADVANCE 2P;DORMITORIO
14501008;;F;45;CHILENO;;X;CHILLAN                       ;BIO BIO;152250;2;1;0;0;0;2;1;152250;COLCHON EVOLUTION BLACK 1P DUAL SIDE;DORMITORIO
10353098;;F;48;CHILENO;;X;CASTRO                        ;LOS LAGOS;302250;7;3;2;1;246980;5;2;55270;CAMA AMERICANA SPRING VI 2.0 PL B/D;DORMITORIO
7516227;;F;64;CHILENO;;Boomers;PROVIDENCIA                   ;METROPOLITANA;379980;2;1;2;1;379980;0;0;0;COLCHON SUPER PREMIUM 2P X 2 MTS;DORMITORIO
16446345;;M;36;CHILENO;;Millenial;PORTEZUELO                    ;BIO BIO;321970;3;1;0;0;0;3;1;321970;CE EVOLUTION BLACK 1,5P + RESPALDO CASTILLA;DORMITORIO
6477812;;M;71;CHILENO;;Silencioso;TALCAHUANO                    ;BIO BIO;1764220;16;4;0;0;0;16;4;1764220;BOX BAMBOO + Respaldo + 2 Veladores ALICANTE;DORMITORIO
16618814;;F;34;CHILENO;;Millenial;N/D;N/D;1088600;11;4;11;4;1088600;0;0;0;BS ORTO ADVANCE B5BK KING+RESP+2VEL NW TORINO;DORMITORIO
16463621;;F;35;CHILENO;;Millenial;COQUIMBO                      ;COQUIMBO;455960;4;2;4;2;455960;0;0;0;CLOSET CAJONERA NEW BELGICA M-398-NW;DORMITORIO
20015856;;M;22;CHILENO;;Z;PROVIDENCIA                   ;METROPOLITANA;189980;2;1;2;1;189980;0;0;0;BOX AMERICANO BEAT 1P;DORMITORIO
7094608;;F;73;CHILENO;;Silencioso;PUERTO MONTT                  ;LOS LAGOS;12990;1;1;0;0;0;1;1;12990;ALMOHADA VISCO ELASTICA BAMBOO 60X40 CM;DORMITORIO
20125333;;F;23;CHILENO;;Z;CORONEL;BIO-BIO;972290;13;6;12;5;926300;1;1;45990;CLOSET M-701 6 PUERTAS 2 CAJONES ALTO 1,82 COLOR;DORMITORIO
21855874;;M;49;PERUANO;;Extranjero;INDEPENDENCIA                 ;METROPOLITANA;379960;4;3;2;1;319980;2;2;59980;CAMA EURO GRIS NEW ENTREE-D 2.0 PL B/D ASTURIAS;DORMITORIO
19365369;;F;25;CHILENO;;Z;N/D;N/D;223980;2;1;2;1;223980;0;0;0;BOX AMERICANO EXCELLENCE FULL PLAZA +2ALM+PLU;DORMITORIO
12636002;;F;47;CHILENO;;X;PALMILLA;O HIGGINS;111980;2;1;2;1;111980;0;0;0;CLOSET NIZA 6P+2C;DORMITORIO
12076219;;M;52;CHILENO;;X;QUILLOTA                      ;VALPARAISO;271520;2;1;0;0;0;2;1;271520;BOX AMERICANO MIRAGE 2PBN;DORMITORIO
15116528;;F;21;CHILENO;;Z;PROVIDENCIA                   ;METROPOLITANA;201980;2;1;2;1;201980;0;0;0;Closet MAIPO 6PT 4CJ 180 CM CEREZO;DORMITORIO
13322384;;F;45;CHILENO;;X;COIHAIQUE                     ;AYSEN;247399;2;2;0;0;0;2;2;247399;CE EVOLUTION BLACK 1,5P + RESPALDO CASTILLA;DORMITORIO
12537691;;F;48;CHILENO;;X;TEMUCO                        ;ARAUCANIA;324980;2;1;2;1;324980;0;0;0;COLCHON SUPER PREMIUM 1,5P;DORMITORIO
19138855;Soltero;M;25;CHILENO;;Z;"";"";4990;1;1;0;0;0;1;1;4990;PACK 2 ALMOHADAS C+L;DORMITORIO
18530633;;M;28;CHILENO;;Millenial;"";"";353980;2;1;2;1;353980;0;0;0;CE EXCELLENCE PLUS 2P BD+RESP+2VEL NEW MUNICH;DORMITORIO
26842045;Soltero;F;37;CHILENO;;Extranjero;PROVIDENCIA                   ;METROPOLITANA;199980;2;1;2;1;199980;0;0;0;CE EVOLUTION BLACK 1,5P BN RESP+VEL;DORMITORIO
12112667;;F;47;CHILENO;;X;PROVIDENCIA                   ;METROPOLITANA;303960;4;2;4;2;303960;0;0;0;CAMA BIRO JULIA;DORMITORIO
15875499;;F;37;CHILENO;;Millenial;N/D;N/D;1190420;8;5;0;0;0;8;5;1190420;BA EXCEL PLUS 2P BN +RESP+2VEL NEW VILLARRICA;DORMITORIO
17474556;Soltero;F;32;CHILENO;;Millenial;PROVIDENCIA                   ;METROPOLITANA;208980;2;1;2;1;208980;0;0;0;CLOSET ALLEGRO 4P 2C - CONAC / BLANCO;DORMITORIO
5336221;;F;76;CHILENO;;Silencioso;N/D;N/D;49980;2;1;0;0;0;2;1;49980;ALMOHADA MEMORY MAX BASIC AMERICANA;DORMITORIO
16865318;;M;34;CHILENO;;Millenial;N/D;N/D;299980;2;1;0;0;0;2;1;299980;COLCHON BAMBOO 1,5P FIBRAS BAMBOO;DORMITORIO
13592728;Casado;F;42;CHILENO;;X;ANCUD                         ;LOS LAGOS;314940;6;2;0;0;0;6;2;314940;CE EVOLUTION BLACK 1,5P BN RESP+VEL;DORMITORIO
10854457;;M;55;CHILENO;;Boomers;RENCA                         ;METROPOLITANA;7990;1;1;0;0;0;1;1;7990;Almohadas Isidora Soft 50x90 cm;DORMITORIO
10217190;;M;57;CHILENO;;Boomers;EL MONTE                      ;METROPOLITANA;1796610;12;5;0;0;0;12;5;1796610;COLCHON BAMBOO 1P FIBRAS BAMBOO;DORMITORIO
17466310;;F;32;CHILENO;;Millenial;PUQUELDON                     ;LOS LAGOS;115470;3;2;0;0;0;3;2;115470;Almohada Imperial Soft 50x70 cm;DORMITORIO
7521070;;F;68;CHILENO;;Boomers;CHIMBARONGO                   ;L.G.B.OÂ´HIGGINS;119990;1;1;0;0;0;1;1;119990;COLCHON EVOLUTION BLACK 1,5P DUAL SIDE;DORMITORIO
15978434;;F;35;CHILENO;;Millenial;REQUINOA                      ;L.G.B.OÂ´HIGGINS;495950;5;3;0;0;0;5;3;495950;COLCHON NEW STYLE 2 2P;DORMITORIO
19904231;;F;24;CHILENO;;Z;PROVIDENCIA                   ;METROPOLITANA;309980;2;1;2;1;309980;0;0;0;BS ORTOPEDIC ADVANCE B5 BLACK 2PBD;DORMITORIO
15025267;;F;36;CHILENO;;Millenial;PUNTA ARENAS                  ;MAGALLANES;489980;2;1;0;0;0;2;1;489980;CE ORTOPEDIC ADVANCE 2P BD + ALM;DORMITORIO
18571499;Soltero;F;29;CHILENO;;Millenial;PROVIDENCIA                   ;METROPOLITANA;840130;13;8;0;0;0;13;8;840130;COLCHON BAMBOO 2P FIBRAS BAMBOO;DORMITORIO
7421205;;M;67;CHILENO;;Boomers;CONSTITUCION                  ;MAULE;1612900;9;4;0;0;0;9;4;1612900;COLCHON TERAPEUTIC 2P PILLOW TOP;DORMITORIO
8884571;;M;62;CHILENO;;Boomers;N/D;N/D;4990;1;1;0;0;0;1;1;4990;PACK 2 ALMOHADAS C+L;DORMITORIO
12552290;;M;47;CHILENO;;X;PROVIDENCIA                   ;METROPOLITANA;189990;1;1;1;1;189990;0;0;0;CE EVOLUTION BLACK 1,5P BN RESP+VEL;DORMITORIO
13896045;Soltero;M;42;CHILENO;;X;PROVIDENCIA                   ;METROPOLITANA;239980;2;1;2;1;239980;0;0;0;CE EVOLUTION BLACK 2P BD DUAL SIDE;DORMITORIO
11910939;;F;50;CHILENO;;X;COIHAIQUE                     ;AYSEN;478780;11;7;2;1;143980;9;6;334800;COMODA POLUX 8CJNS OLMO;DORMITORIO
20324474;;M;21;CHILENO;;Z;N/D;N/D;112960;4;3;0;0;0;4;3;112960;Almohada Cooling 65x48 cm;DORMITORIO
11643494;;F;52;CHILENO;;X;TALAGANTE                     ;METROPOLITANA;759900;10;2;0;0;0;10;2;759900;COLCHON BAMBOO 1P FIBRAS BAMBOO;DORMITORIO
13655609;;F;44;CHILENO;;X;PROVIDENCIA                   ;METROPOLITANA;411980;2;1;2;1;411980;0;0;0;Cama Europea Therapedic MAS 2PBD+ Resp + 2Vel As;DORMITORIO
11221054;;F;54;CHILENO;;Boomers;RENCA                         ;METROPOLITANA;219990;1;1;0;0;0;1;1;219990;COLCHON BAMBOO 2P FIBRAS BAMBOO;DORMITORIO
16039053;;F;36;CHILENO;;Millenial;ANGOL                         ;ARAUCANIA;291980;2;1;2;1;291980;0;0;0;DUPLEX SPRING VI 1PL;DORMITORIO
13305212;;F;45;CHILENO;;X;"";"";50000;2;1;0;0;0;2;1;50000;SET 2 ALMOHADAS VISCO MEDIUM 60X40 CM;DORMITORIO
27124228;;F;44;VENEZOLANO;;Extranjero;PROVIDENCIA                   ;METROPOLITANA;19970;3;3;0;0;0;3;3;19970;PACK 2 ALMOHADAS C+L;DORMITORIO
15886837;;F;38;CHILENO;;Millenial;LA FLORIDA;METROPOLITANA;109980;2;1;2;1;109980;0;0;0;CLOSET MARITTIMA 6P+2C;DORMITORIO
8300453;;F;62;CHILENO;;Boomers;"";"";681950;5;2;0;0;0;5;2;681950;COLCHON NEW ORTOPEDIC 2P;DORMITORIO
16799868;;F;34;CHILENO;;Millenial;PROVIDENCIA                   ;METROPOLITANA;35970;3;2;2;1;30980;1;1;4990;PACK 2 ALMOHADAS C+L;DORMITORIO
14099807;;F;41;CHILENO;;X;PROVIDENCIA                   ;METROPOLITANA;153980;2;1;2;1;153980;0;0;0;COLCHON BAMBOO 1,5P FIBRAS BAMBOO;DORMITORIO
19481167;;F;24;CHILENO;;Z;PROVIDENCIA                   ;METROPOLITANA;204980;2;1;2;1;204980;0;0;0;CAMA EUROPEA THERAPEDIC MAS 1,5P;DORMITORIO
18922551;Soltero;M;27;CHILENO;;Millenial;PROVIDENCIA                   ;METROPOLITANA;311620;4;2;4;2;311620;0;0;0;CLOSET 4P 4C MOD S453 - TECA;DORMITORIO
16547182;;M;35;CHILENO;;Millenial;LA FLORIDA                    ;METROPOLITANA;287940;6;3;6;3;287940;0;0;0;COLCHON EXCELLENCE PLUS 1P;DORMITORIO
16700625;;M;35;CHILENO;;Millenial;PROVIDENCIA                   ;METROPOLITANA;278980;2;1;0;0;0;2;1;278980;BOX AMERICANO MIRAGE 2PBN;DORMITORIO
15281450;;F;39;CHILENO;;X;FRESIA                        ;LOS LAGOS;126960;7;3;0;0;0;7;3;126960;Almohadas Isidora Soft 50x70 cm;DORMITORIO
5043611;;F;77;CHILENO;;Silencioso;SAN ANTONIO                   ;VALPARAISO;700980;2;1;0;0;0;2;1;700980;CE EVEREST 2P 2MTS BD HILOS COBRE+RESP+2 VEL;DORMITORIO
22275175;;M;43;PERUANO;;Extranjero;LAS CONDES                    ;METROPOLITANA;103980;2;3;0;0;0;2;3;103980;PACK 2 ALMOHADAS C+L;DORMITORIO
12490653;;F;49;CHILENO;;X;N/D;N/D;178980;2;1;0;0;0;2;1;178980;CE EVOLUTION BLACK 1,5P + RESPALDO CASTILLA;DORMITORIO
18142137;;M;29;CHILENO;;Millenial;PROVIDENCIA                   ;METROPOLITANA;4990;1;1;0;0;0;1;1;4990;PACK 2 ALMOHADAS C+L;DORMITORIO
8246103;;F;57;CHILENO;;Boomers;TEMUCO                        ;ARAUCANIA;488950;5;1;0;0;0;5;1;488950;CE EVOLUTION BLACK 1,5P BN RESP+VEL;DORMITORIO
8923430;;F;60;CHILENO;;Boomers;RENGO                         ;L.G.B.OÂ´HIGGINS;411971;4;2;0;0;0;4;2;411971;CE EVOLUTION BLACK 1,5P BN RESP+VEL;DORMITORIO
12790177;;F;47;CHILENO;;X;LINARES                       ;MAULE;179980;2;1;2;1;179980;0;0;0;CE EVOLUTION BLACK 1,5P + RESPALDO CASTILLA;DORMITORIO
14331024;;F;45;CHILENO;;X;COCHAMO;LOS LAGOS;297970;3;1;3;1;297970;0;0;0;CE EVOLUTION BLACK 1,5P BN RESP+VEL;DORMITORIO
10414397;;M;57;CHILENO;;Boomers;VILLARICA                     ;ARAUCANIA;569980;2;2;0;0;0;2;2;569980;COLCHON NEW ORTOPEDIC 2P;DORMITORIO
19963152;;M;23;CHILENO;;Silencioso;PROVIDENCIA                   ;METROPOLITANA;613960;4;2;4;2;613960;0;0;0;DIVAN CAMA ERGO T 1,5P 2 MTS;DORMITORIO
10608024;;F;54;CHILENO;;Boomers;QUINCHAO                      ;LOS LAGOS;558950;5;3;0;0;0;5;3;558950;CE ERGO T 2P 2MT BD;DORMITORIO
19352226;;F;26;CHILENO;;Millenial;PROVIDENCIA                   ;METROPOLITANA;259980;2;1;2;1;259980;0;0;0;CAMAROTE TRIPLE MARI 1.5P;DORMITORIO
26749858;;F;58;VENEZOLANO;;Extranjero;"";"";39970;3;2;0;0;0;3;2;39970;Almohada Bamboo Classic 70x40;DORMITORIO
11219509;;F;54;CHILENO;;X;ANTOFAGASTA                   ;ANTOFAGASTA;219980;2;1;0;0;0;2;1;219980;COLCHON NEW ORTOPEDIC 2P;DORMITORIO
9419814;;M;59;CHILENO;;Boomers;LA PINTANA                    ;METROPOLITANA;459970;3;1;0;0;0;3;1;459970;COLCHON NEW ORTOPEDIC 1P;DORMITORIO
8982572;Divorciado;F;62;CHILENO;;Boomers;PROVIDENCIA                   ;METROPOLITANA;163980;2;3;0;0;0;2;3;163980;COLCHON BAMBOO 1,5P FIBRAS BAMBOO;DORMITORIO
5658163;Viudo;M;74;CHILENO;;Silencioso;RENCA                         ;METROPOLITANA;6990;1;1;0;0;0;1;1;6990;Almohadas Isidora Soft 50x70 cm;DORMITORIO
16156840;;M;36;CHILENO;;Silencioso;PROVIDENCIA                   ;METROPOLITANA;33980;2;1;0;0;0;2;1;33980;Almohada Bamboo Classic 70x40;DORMITORIO
11603141;;M;51;CHILENO;;X;CANETE                        ;BIO BIO;24970;3;2;0;0;0;3;2;24970;ALMOHADA SOFT MICROGEL;DORMITORIO
13954463;;F;42;CHILENO;;X;CANETE                        ;BIO BIO;11990;1;1;0;0;0;1;1;11990;PLUMON SINGLE 1,5 PZA ANDES;DORMITORIO
13616477;;M;42;CHILENO;;X;PARRAL                        ;MAULE;271970;3;2;2;1;71980;1;1;199990;COLCHON BAMBOO 2P FIBRAS BAMBOO;DORMITORIO
14335481;;F;45;CHILENO;;X;PROVIDENCIA                   ;METROPOLITANA;176980;2;1;2;1;176980;0;0;0;CE EVOLUTION BLACK 1,5P BN RESP+VEL;DORMITORIO
18375296;Soltero;M;29;CHILENO;;Millenial;PROVIDENCIA                   ;METROPOLITANA;118980;2;1;2;1;118980;0;0;0;COLCHON DANUBIO 1,5P COMPRIMIDO;DORMITORIO
9865966;;M;59;CHILENO;;Boomers;QUILICURA                     ;METROPOLITANA;245980;2;1;0;0;0;2;1;245980;COLCHON BAMBOO 2P FIBRAS BAMBOO;DORMITORIO
15451842;;F;41;CHILENO;;X;PROVIDENCIA                   ;METROPOLITANA;119980;2;1;2;1;119980;0;0;0;COLCHON EVOLUTION BLACK 1,5P DUAL SIDE;DORMITORIO
6906992;;M;68;CHILENO;;Silencioso;QUILLOTA                      ;VALPARAISO;258970;3;1;0;0;0;3;1;258970;CE EVOLUTION BLACK 1,5P BN RESP+VEL;DORMITORIO
15881736;;M;37;CHILENO;;Millenial;QUILLON                       ;BIO BIO;384970;3;2;0;0;0;3;2;384970;COLCHON EXCELLENCE PLUS 2P;DORMITORIO
16721415;;F;34;CHILENO;;Millenial;NATALES                       ;MAGALLANES;157970;3;2;0;0;0;3;2;157970;COLCHON NEW ENTREE 1,5P;DORMITORIO
11962266;;F;50;CHILENO;;X;LOS ANGELES                   ;BIO BIO;547910;8;3;6;2;351430;2;1;196480;COLCHON NEW ORTOPEDIC 1 PZA ALM;DORMITORIO
8859837;Casado;M;62;CHILENO;ARGADOA DE AREA O SECDOR DEL NIVEL CRAL;Boomers;PROVIDENCIA                   ;METROPOLITANA;1100980;2;1;2;1;1100980;0;0;0;C.EUROPEA GRAND PREMIUM KING +RESP+2VEL MIRO;DORMITORIO
13342171;;M;43;CHILENO;;X;CHILLAN                       ;BIO BIO;108980;2;2;0;0;0;2;2;108980;COLCHON NEW ENTREE 1,5P;DORMITORIO
5544743;;F;70;CHILENO;;Silencioso;CHANCO                        ;MAULE;311980;2;1;2;1;311980;0;0;0;DIVAN NEW ORTOPEDIC BLACK CUBREC;DORMITORIO
19176122;;F;28;CHILENO;;Millenial;CALBUCO                       ;LOS LAGOS;437960;3;1;0;0;0;3;1;437960;BOX AAMERICANO EXCELLENCE FULL;DORMITORIO
12286278;;F;50;CHILENO;;X;EL BOSQUE                     ;METROPOLITANA;179980;2;1;2;1;179980;0;0;0;CLOSET ROMA 8 PUERTAS EXIT NOGAL 1,77X1,32X0,40;DORMITORIO
9650325;;F;60;CHILENO;;Boomers;MARIA PINTO                   ;METROPOLITANA;193960;4;3;0;0;0;4;3;193960;PACK 2 ALMOHADAS C+L;DORMITORIO
17025162;;F;33;CHILENO;;Millenial;N/D;N/D;290980;2;1;2;1;290980;0;0;0;BS NEW ORTOPEDIC B5 BLACK 1.5P+RESP+VEL LEGNO;DORMITORIO
15441694;Soltero;F;39;CHILENO;;X;PROVIDENCIA                   ;METROPOLITANA;591950;5;2;3;1;373970;2;1;217980;COLCHON CASALINDA CDM 2PL X190;DORMITORIO
5822265;;M;72;CHILENO;;Silencioso;CORONEL                       ;BIO BIO;342970;4;1;0;0;0;4;1;342970;CAMA EUROPEA EXCELLENCE 2 PLAZAS BASE NORMAL;DORMITORIO
19331016;;F;25;CHILENO;;Z;N/D;N/D;365940;5;2;5;2;365940;0;0;0;BA EXCELLENCE 2P BN +RESP+2VEL OLMO +2ALM+PL;DORMITORIO
16751588;;F;34;CHILENO;;Millenial;PROVIDENCIA                   ;METROPOLITANA;9980;2;1;0;0;0;2;1;9980;PACK 2 ALMOHADAS C+L;DORMITORIO
11114467;Casado;M;55;CHILENO;;Boomers;N/D;N/D;667080;4;2;4;2;667080;0;0;0;BOX AMERICANO EXCELLENCE PLUS 2P BD+2ALM ];DORMITORIO
15864764;;M;37;CHILENO;;Millenial;PROVIDENCIA                   ;METROPOLITANA;672960;4;2;0;0;0;4;2;672960;CE NEW STYLE 6 2P 2MT BD;DORMITORIO
15677252;;M;38;CHILENO;;X;CHILLAN;BIO-BIO;14990;1;1;0;0;0;1;1;14990;PLUMON 2PZA ANDES;DORMITORIO
18659035;;M;28;CHILENO;;Millenial;HIJUELAS                      ;VALPARAISO;216970;3;2;2;1;199980;1;1;16990;COLCHON NEW ORTOPEDIC 2P;DORMITORIO
12974229;;F;45;CHILENO;;X;PROVIDENCIA                   ;METROPOLITANA;193980;2;1;2;1;193980;0;0;0;CE EVOLUTION BLACK 1,5P + RESPALDO CASTILLA;DORMITORIO
5535980;;F;72;CHILENO;;Silencioso;CHILLAN                       ;BIO BIO;229460;4;2;0;0;0;4;2;229460;COLCHON EXCELLENCE PLUS 1,5P;DORMITORIO
17127167;;F;33;CHILENO;;Millenial;N/D;N/D;4990;1;1;0;0;0;1;1;4990;PACK 2 ALMOHADAS C+L;DORMITORIO
17066828;Soltero;F;33;CHILENO;TECNICO DENTAL DE NIVEL SUPERIOR;Millenial;PROVIDENCIA                   ;METROPOLITANA;338540;2;1;2;1;338540;0;0;0;CAMA EURO GRIS NEW ENTREE-D 2.0 PL B/D ASTURIAS;DORMITORIO
16392853;;M;35;CHILENO;;Millenial;N/D;N/D;199980;2;1;2;1;199980;0;0;0;CE EVOLUTION BLACK 1,5P + RESPALDO ASTURIAS;DORMITORIO
19914140;;M;24;CHILENO;;Z;"";"";7990;1;1;0;0;0;1;1;7990;ALMOHADA SOFT MICROGEL;DORMITORIO
16565562;;M;35;CHILENO;;Millenial;"";"";4990;1;1;0;0;0;1;1;4990;PACK 2 ALMOHADAS C+L;DORMITORIO
5434253;;M;77;CHILENO;;Silencioso;PROVIDENCIA                   ;METROPOLITANA;132980;2;1;0;0;0;2;1;132980;COLCHON SPRING III 1P;DORMITORIO
20187820;;F;23;CHILENO;;Z;VILLARICA                     ;ARAUCANIA;298960;4;2;0;0;0;4;2;298960;PACK 2 ALMOHADAS C+L;DORMITORIO
7293344;Casado;F;64;CHILENO;;Boomers;QUILLECO                      ;BIO BIO;1045700;9;2;0;0;0;9;2;1045700;Almohadas Isidora Soft 50x90 cm;DORMITORIO
9779779;;F;58;CHILENO;;Boomers;CALBUCO                       ;LOS LAGOS;15980;2;1;0;0;0;2;1;15980;Almohadas Isidora Soft 50x90 cm;DORMITORIO
20599339;;F;21;CHILENO;;Z;PROVIDENCIA                   ;METROPOLITANA;24990;1;1;1;1;24990;0;0;0;PACK 2 ALMOHADAS 100% PLUMA 50 X 70 CM;DORMITORIO
16620814;;F;34;CHILENO;;Millenial;PANGUIPULLI                   ;LOS RIOS;254980;2;1;2;1;254980;0;0;0;CLOSET MAULE 4 PTA CORREDERA 8 CJ CEREZO;DORMITORIO
12437979;;F;48;CHILENO;;X;ARICA                         ;ARICA Y PARINACOTA;17980;2;1;0;0;0;2;1;17980;ALMOHADA SOFT MICROGEL;DORMITORIO
19052304;;M;26;CHILENO;;Z;"";"";436490;9;4;9;4;436490;0;0;0;COLCHON EXCELLENCE PLUS 1.5 PLAZA + ALM;DORMITORIO
9558629;;F;60;CHILENO;;Boomers;PEDRO AGUIRRE CERDA           ;METROPOLITANA;853110;8;2;0;0;0;8;2;853110;COLCHON NEW ORTOPEDIC 2P 150X190 + ALM;DORMITORIO
17281829;;F;32;CHILENO;;Millenial;LO ESPEJO                     ;METROPOLITANA;424980;2;1;2;1;424980;0;0;0;BS NEW ORTOPEDIC B5BLACK KING+RESP+2VEL LEGNO;DORMITORIO
5954780;;F;68;CHILENO;;Silencioso;RENCA                         ;METROPOLITANA;435832;6;4;0;0;0;6;4;435832;COLCHON ERGO T 1,5P;DORMITORIO
12006467;;M;46;CHILENO;;X;RENCA                         ;METROPOLITANA;193980;2;1;2;1;193980;0;0;0;CE EVOLUTION BLACK 1,5P + RESPALDO CASTILLA;DORMITORIO
13884654;;F;42;CHILENO;;X;MAIPU                         ;METROPOLITANA;189980;2;1;2;1;189980;0;0;0;CE EVOLUTION BLACK 1,5P + RESPALDO CASTILLA;DORMITORIO
18240528;;M;29;CHILENO;;Millenial;N/D;N/D;856720;7;3;0;0;0;7;3;856720;CAMA ERGO T 1,5PL TABOR S/TEXTIL;DORMITORIO
19681772;;F;25;CHILENO;;Z;PROVIDENCIA                   ;METROPOLITANA;86980;2;1;2;1;86980;0;0;0;COLCHON SPRING III 1P;DORMITORIO
17334690;;F;32;CHILENO;;Millenial;"";"";341980;2;1;2;1;341980;0;0;0;CAMA ERGO T 1,5PL TABOR S/TEXTIL;DORMITORIO
12115218;;F;40;CHILENO;;X;N/D;N/D;444950;6;3;6;3;444950;0;0;0;CE EVOLUTION BLACK 1,5P + RESPALDO CASTILLA;DORMITORIO
16834283;;F;33;CHILENO;;Millenial;N/D;N/D;675980;2;1;2;1;675980;0;0;0;CE SUPER PREMIUM KING +RESP+2VEL NEW TORINO;DORMITORIO
11812048;;F;50;CHILENO;;X;PENAFLOR                      ;METROPOLITANA;193980;2;1;2;1;193980;0;0;0;COLCHON BAMBOO 2P FIBRAS BAMBOO;DORMITORIO
15575576;;M;38;CHILENO;;X;OVALLE;COQUIMBO;391470;3;1;0;0;0;3;1;391470;BOX AM NEW ENTREE 1,5P+ Resp + 1 Vel ASTURIAS +;DORMITORIO
14219493;;M;41;CHILENO;;X;PROVIDENCIA                   ;METROPOLITANA;41940;6;1;0;0;0;6;1;41940;Almohadas Isidora Soft 50x70 cm;DORMITORIO
19299128;;M;26;CHILENO;;Z;MOLINA;MAULE;277460;4;2;4;2;277460;0;0;0;CAMA EUROPEA EXCELLENCE 1.5 PLAZAS +ALM;DORMITORIO
18235255;;F;29;CHILENO;;Millenial;CALAMA                        ;ANTOFAGASTA;249980;2;1;2;1;249980;0;0;0;Cama Europea Active 2PBN;DORMITORIO
7588203;;M;64;CHILENO;;Boomers;VALLENAR;ATACAMA;304960;4;3;0;0;0;4;3;304960;COLCHON BAMBOO 2P FIBRAS BAMBOO;DORMITORIO
15657360;;M;37;CHILENO;;Millenial;TEMUCO                        ;ARAUCANIA;194980;2;1;2;1;194980;0;0;0;COLCHON NEW ORTOPEDIC 2P;DORMITORIO
13883523;;F;49;CHILENO;;X;CASTRO                        ;LOS LAGOS;219990;1;1;0;0;0;1;1;219990;COLCHON BAMBOO 2P FIBRAS BAMBOO;DORMITORIO
13052991;;F;46;CHILENO;;X;PROVIDENCIA                   ;METROPOLITANA;239980;2;1;2;1;239980;0;0;0;CAMA EROGO T 1P;DORMITORIO
16001313;;M;37;CHILENO;;Millenial;"";"";425980;2;1;2;1;425980;0;0;0;Cama Europea Everest 2PBN + PS2A;DORMITORIO
9910177;;M;54;CHILENO;;Boomers;"";"";349980;2;1;2;1;349980;0;0;0;CE NEW STYLE 2 2P 2MT BD;DORMITORIO
19436778;;F;25;CHILENO;;Z;N/D;N/D;201680;4;2;4;2;201680;0;0;0;ESCRITORIO FAVATEX FEDOR CASTANO;DORMITORIO
15785252;;F;38;CHILENO;;Millenial;ILLAPEL                       ;COQUIMBO;137540;2;1;2;1;137540;0;0;0;COMODA POLUX 8CJNS CEREZO;DORMITORIO
13390481;;F;43;CHILENO;;X;LEBU                          ;BIO BIO;347320;7;3;0;0;0;7;3;347320;ALMOHADA SOFT MICROGEL;DORMITORIO
14347806;Soltero;F;42;CHILENO;;X;ILLAPEL                       ;COQUIMBO;139990;1;2;0;0;0;1;2;139990;COLCHON BAMBOO 1,5P FIBRAS BAMBOO;DORMITORIO
27092862;;F;36;VENEZOLANO;;Extranjero;N/D;N/D;1252390;14;4;7;3;515610;7;1;736780;CLOSET NIZA 6P+2C;DORMITORIO
14381788;;F;42;CHILENO;;X;N/D;N/D;99980;2;1;2;1;99980;0;0;0;COLCHON EVOLUTION BLACK 1,5P DUAL SIDE;DORMITORIO
9129721;;F;62;CHILENO;;Boomers;QUINTA NORMAL                 ;METROPOLITANA;416430;6;2;0;0;0;6;2;416430;COLCHON BAMBOO 1,5P FIBRAS BAMBOO;DORMITORIO
16925350;;M;33;CHILENO;;Millenial;PROVIDENCIA                   ;METROPOLITANA;239990;1;1;0;0;0;1;1;239990;COLCHON BAMBOO 2P FIBRAS BAMBOO;DORMITORIO
18809570;;F;27;CHILENO;;Millenial;CATEMU                        ;VALPARAISO;8490;1;1;0;0;0;1;1;8490;ALMOHADA ROSEN SOFT PLUS AMERICANA;DORMITORIO
10849526;;M;55;CHILENO;;Boomers;MAIPU                         ;METROPOLITANA;239980;2;1;0;0;0;2;1;239980;CE EVOLUTION BLACK 1,5P BN RESP+VEL;DORMITORIO
17720514;Soltero;F;28;CHILENO;PROFESOR;Millenial;PROVIDENCIA                   ;METROPOLITANA;11580;2;1;0;0;0;2;1;11580;Almohada Imperial Soft 50x70 cm;DORMITORIO
8160196;Casado;F;66;CHILENO;;Boomers;RENCA                         ;METROPOLITANA;47980;2;1;0;0;0;2;1;47980;Almohada ViscoGel Cobre 70x40x13 cm;DORMITORIO
18809364;;F;27;CHILENO;;Millenial;PROVIDENCIA                   ;METROPOLITANA;105840;2;1;2;1;105840;0;0;0;CLOSET MARITTIMA 6P+2C;DORMITORIO
19138253;;M;29;CHILENO;;Millenial;N/D;N/D;229980;2;1;0;0;0;2;1;229980;BOX AMERICANO MIRAGE 2PBN;DORMITORIO
19572073;;F;25;CHILENO;;Z;SAN BERNARDO                  ;METROPOLITANA;409980;2;1;2;1;409980;0;0;0;CAMA ERGO T 2PBD + RESP + 2 VEL FERRARA;DORMITORIO
18651436;Soltero;M;28;CHILENO;TECNICO DE NIVEL SUPERIOR EN ODONTOLOGIA;Millenial;PROVIDENCIA                   ;METROPOLITANA;77840;6;3;6;3;77840;0;0;0;ALMOHADA MEMORY MAX BASIC AMERICANA;DORMITORIO
17345856;;M;32;CHILENO;;Millenial;PROVIDENCIA                   ;METROPOLITANA;873980;2;1;2;1;873980;0;0;0;CAMA ART 4 1.80X2.00 DOMENICO;DORMITORIO
17152865;;F;33;CHILENO;;Millenial;PROVIDENCIA                   ;METROPOLITANA;637960;3;1;3;1;637960;0;0;0;DIVAN CAMA ERGO T 1,5P 2MTS+RESP+1 VEL TABOR;DORMITORIO
13017861;Casado;M;46;CHILENO;AGRONOMO;X;RENCA                         ;METROPOLITANA;187540;2;1;2;1;187540;0;0;0;COLCHON BAMBOO 2P FIBRAS BAMBOO;DORMITORIO
9347853;;F;59;CHILENO;;Boomers;PROVIDENCIA                   ;METROPOLITANA;4990;1;1;0;0;0;1;1;4990;PACK 2 ALMOHADAS C+L;DORMITORIO
17492124;;M;32;CHILENO;;Extranjero;"";"";88640;2;1;2;1;88640;0;0;0;COLCHON SPRING III 1P;DORMITORIO
18575418;Soltero;F;28;CHILENO;ADMINISTRACION DE EMPRESAS;Millenial;PROVIDENCIA                   ;METROPOLITANA;146980;2;1;2;1;146980;0;0;0;COMODA POLUX 8CJNS WENGUE;DORMITORIO
11600903;;F;51;CHILENO;;X;OLMUE                         ;VALPARAISO;291980;2;1;0;0;0;2;1;291980;CE ERGO T 2P 2MT BD;DORMITORIO
18655946;;M;28;CHILENO;;Millenial;PROVIDENCIA                   ;METROPOLITANA;307470;3;1;3;1;307470;0;0;0;CE EVOLUTION BLACK 2P BD DUAL SIDE;DORMITORIO
12546831;;M;48;CHILENO;;X;SAN CARLOS                    ;BIO BIO;581459;4;1;0;0;0;4;1;581459;CE EVOLUTION BLACK 1,5P BN RESP+VEL;DORMITORIO
9800628;;F;55;CHILENO;;Boomers;ANTOFAGASTA                   ;ANTOFAGASTA;139980;2;1;2;1;139980;0;0;0;COLCHON BAMBOO 1,5P FIBRAS BAMBOO;DORMITORIO
13326631;;M;44;CHILENO;;X;N/D;N/D;26970;3;1;0;0;0;3;1;26970;ALMOHADA SOFT MICROGEL;DORMITORIO
15385432;;M;39;CHILENO;;X;PROVIDENCIA                   ;METROPOLITANA;144980;2;1;2;1;144980;0;0;0;COLCHON BEAT 1,5P;DORMITORIO
8062912;;F;64;CHILENO;;Boomers;MELIPILLA                     ;METROPOLITANA;60070;2;2;0;0;0;2;2;60070;PACK 2 ALMOHADAS C+L;DORMITORIO
14442401;;M;47;CHILENO;;X;RENCA                         ;METROPOLITANA;304970;3;1;3;1;304970;0;0;0;BOX AMERICANO EXCELLENCE 1.5 PLAZA + ALM;DORMITORIO
15824881;;F;38;CHILENO;;Millenial;N/D;N/D;204980;2;1;2;1;204980;0;0;0;BOX AMERICANO EXCELLENCE FULL PLAZA +2ALM+PLU;DORMITORIO
10131470;;F;57;CHILENO;;Boomers;PROVIDENCIA                   ;METROPOLITANA;73980;2;1;2;1;73980;0;0;0;CLOSET CROACIA BLANCO 4P;DORMITORIO
18825629;Soltero;F;28;CHILENO;;Millenial;PROVIDENCIA                   ;METROPOLITANA;309630;3;1;3;1;309630;0;0;0;BOX AMERICANO EXCELLENCE 1.5 PLAZA + ALM;DORMITORIO
12984579;;M;46;CHILENO;;X;N/D;N/D;119990;1;1;0;0;0;1;1;119990;COLCHON EVOLUTION BLACK 1,5P DUAL SIDE;DORMITORIO
12607650;;M;48;CHILENO;;X;PROVIDENCIA                   ;METROPOLITANA;205980;2;1;2;1;205980;0;0;0;COLCHON NEW ORTOPEDIC 2P;DORMITORIO
12035783;;M;44;CHILENO;;X;VALPARAISO                    ;VALPARAISO;844920;5;1;5;1;844920;0;0;0;COLCHON EVEREST 2P HILOS DE COBRE;DORMITORIO
16489109;;F;35;CHILENO;;Millenial;RENCA                         ;METROPOLITANA;329820;4;2;4;2;329820;0;0;0;CAMA EUROPEA GRIS NEW ENTREE 1,5P;DORMITORIO
18976185;;F;27;CHILENO;;Millenial;PROVIDENCIA                   ;METROPOLITANA;183980;2;1;2;1;183980;0;0;0;CLOSET ROMA 8 PUERTAS EXIT NOGAL 1,77X1,32X0,40;DORMITORIO
7311028;;F;66;CHILENO;;Boomers;SAN ANTONIO                   ;VALPARAISO;634950;5;2;3;1;564970;2;1;69980;CE EVEREST 2P 2MTS BD DUAL SIDE;DORMITORIO
17135973;Soltero;F;33;CHILENO;PROFESOR;Millenial;PROVIDENCIA                   ;METROPOLITANA;488980;2;1;2;1;488980;0;0;0;BS ORTOP ADVA B5BLACK KING+RESP+2VEL ESPRESSO;DORMITORIO
8822066;;M;54;CHILENO;;Silencioso;PROVIDENCIA                   ;METROPOLITANA;83980;2;1;2;1;83980;0;0;0;CLOSET M-803 3P 2C ALTO 1,82 BLANCO NATURAL;DORMITORIO
7037689;;M;63;CHILENO;;Boomers;PROVIDENCIA                   ;METROPOLITANA;409980;2;1;2;1;409980;0;0;0;CAMA ERGO T 2PBD + RESP + 2 VEL FERRARA;DORMITORIO
10052800;;M;49;CHILENO;;X;PUNTA ARENAS                  ;MAGALLANES;346170;2;1;0;0;0;2;1;346170;CE EVOLUTION BLACK 2P BN+RESP+2 VEL;DORMITORIO
19966522;;F;24;CHILENO;;Z;PROVIDENCIA                   ;METROPOLITANA;149640;2;1;2;1;149640;0;0;0;CLOSET M-801 6P+2C ALTO 1,82 BLANCO NATURAL;DORMITORIO
15048647;;M;38;CHILENO;;X;HUECHURABA                    ;METROPOLITANA;198960;4;2;4;2;198960;0;0;0;CE EVOLUTION BLACK 1,5P + RESPALDO CASTILLA;DORMITORIO
9787098;;M;58;CHILENO;;Silencioso;PROVIDENCIA                   ;METROPOLITANA;249980;2;1;2;1;249980;0;0;0;COLCHON ROSEN SWAG 1P 2 MT 0.90X2.00;DORMITORIO
7251254;;F;70;CHILENO;;Silencioso;NUEVA IMPERIAL                ;ARAUCANIA;187870;2;1;0;0;0;2;1;187870;COLCHON BAMBOO 1,5P FIBRAS BAMBOO;DORMITORIO
26528019;;F;43;CHILENO;;Extranjero;PROVIDENCIA                   ;METROPOLITANA;103980;2;1;2;1;103980;0;0;0;CLOSET M-802 4P+2 C ALTO 1,82 BLANCO NATURAL;DORMITORIO
16498800;Soltero;F;35;CHILENO;AUXILIAR PARAMEDICO DE ODONTOLOGIA;Millenial;RENCA                         ;METROPOLITANA;233980;2;1;2;1;233980;0;0;0;COLCHON ORTOPEDIC ADVANCE 2P;DORMITORIO
13371758;;M;44;CHILENO;;X;PROVIDENCIA                   ;METROPOLITANA;3990;1;1;0;0;0;1;1;3990;PACK 2 ALMOHADAS C+L;DORMITORIO
17882682;Soltero;F;30;CHILENO;;Millenial;PROVIDENCIA                   ;METROPOLITANA;459960;4;2;4;2;459960;0;0;0;CAMA EUROPEA CASALINDA CDM 2PL BD;DORMITORIO
12171105;;F;50;CHILENO;;X;COPIAPO                       ;ATACAMA;19960;4;1;0;0;0;4;1;19960;Almohada Imperial Soft 50x70 cm;DORMITORIO
15279882;;M;40;CHILENO;;X;N/D;N/D;95960;4;2;0;0;0;4;2;95960;ALMOHADA VISCO ELASTICA CANNABIS 60X40CM;DORMITORIO
15548462;;F;38;CHILENO;;X;PROVIDENCIA                   ;METROPOLITANA;149990;1;1;0;0;0;1;1;149990;COLCHON EXCELLENCE PLUS 2P;DORMITORIO
26205170;;F;31;CHILENO;;Extranjero;N/D;N/D;51980;2;1;0;0;0;2;1;51980;SET 2 ALMOHADAS VISCO MEDIUM 60X40 CM;DORMITORIO
12376299;Casado;F;49;CHILENO;;X;RENCA                         ;METROPOLITANA;23970;3;1;0;0;0;3;1;23970;ALMOHADA SOFT MICROGEL;DORMITORIO
16670452;;F;34;CHILENO;;Millenial;PROVIDENCIA                   ;METROPOLITANA;243970;3;1;3;1;243970;0;0;0;COLCHON EXCELLENCE PLUS 1P + CUBRECOLCHON;DORMITORIO
6888222;;F;66;CHILENO;;Boomers;EL MONTE                      ;METROPOLITANA;242560;3;1;0;0;0;3;1;242560;COLCHON NEW ORTOPEDIC 2P;DORMITORIO
16031697;;F;37;CHILENO;;Millenial;PROVIDENCIA                   ;METROPOLITANA;229980;2;1;2;1;229980;0;0;0;CE EVOLUTION BLACK 1,5P BN RESP+VEL;DORMITORIO
5556913;;F;71;CHILENO;;Silencioso;PROVIDENCIA                   ;METROPOLITANA;289660;3;1;0;0;0;3;1;289660;BOX AMERICANO MIRAGE 2PBN;DORMITORIO
13809867;;F;42;CHILENO;;X;VICTORIA                      ;ARAUCANIA;281980;2;1;0;0;0;2;1;281980;DIVAN CAMA ERGO T 1,5P 2 MTS;DORMITORIO
10576583;;F;57;CHILENO;;Boomers;PENAFLOR                      ;METROPOLITANA;419990;1;1;0;0;0;1;1;419990;BOX BAMBOO + Respaldo + 2 Veladores ALICANTE;DORMITORIO
17236866;;M;32;CHILENO;;Silencioso;PROVIDENCIA                   ;METROPOLITANA;145980;2;1;2;1;145980;0;0;0;CE EVOLUTION BLACK 1,5P + RESPALDO CASTILLA;DORMITORIO
16204284;;F;36;CHILENO;;Millenial;LOS ANGELES                   ;BIO BIO;145840;2;1;2;1;145840;0;0;0;COLCHON EXCELLENCE PLUS 1.5P + CUBRECOLCHON;DORMITORIO
17744462;;F;31;CHILENO;;Silencioso;PROVIDENCIA                   ;METROPOLITANA;13980;2;1;0;0;0;2;1;13980;ALMOHADA SOFT MICROGEL;DORMITORIO
17159535;;M;33;CHILENO;;Millenial;PROVIDENCIA                   ;METROPOLITANA;383980;2;1;2;1;383980;0;0;0;CE NEW ORTOPEDIC 2PBN +RESP+2VEL NEW VILLARRI;DORMITORIO
14291456;;F;47;CHILENO;;X;PROVIDENCIA                   ;METROPOLITANA;311970;3;2;0;0;0;3;2;311970;COLCHON NEW STYLE 6 2P 150X200;DORMITORIO
18966027;Soltero;F;27;CHILENO;EDUCADOR DE PARVULO;Millenial;PROVIDENCIA                   ;METROPOLITANA;3990;1;1;0;0;0;1;1;3990;PACK 2 ALMOHADAS C+L;DORMITORIO
13670271;;M;43;CHILENO;;X;N/D;N/D;534520;3;1;3;1;534520;0;0;0;CE ORTOPEDIC ADVANCE 2P BD +RESP+2VEL LEGNO;DORMITORIO
8375272;;M;61;CHILENO;;Boomers;SANTA CRUZ                    ;L.G.B.OÂ´HIGGINS;422650;4;1;0;0;0;4;1;422650;CE ERGO T 2P 2MT BD;DORMITORIO
5096955;;F;75;CHILENO;;Silencioso;ANGOL                         ;ARAUCANIA;277870;2;1;0;0;0;2;1;277870;BOX AMERICANO MIRAGE 2PBN;DORMITORIO
7652395;;M;66;CHILENO;;Boomers;SAN FELIPE                    ;VALPARAISO;179980;2;1;0;0;0;2;1;179980;CE EVOLUTION BLACK 1,5P BN RESP+VEL;DORMITORIO
16921508;;M;34;CHILENO;;Millenial;N/D;N/D;26990;1;1;0;0;0;1;1;26990;Almohada Visco Bamboo Classic Pack 60x40 cm;DORMITORIO
9107030;;M;60;CHILENO;;Boomers;N/D;N/D;16990;1;1;0;0;0;1;1;16990;ALMOHADA BAMBOO TECH SERIES 65X45 CM;DORMITORIO
15995304;;M;36;CHILENO;;Millenial;N/D;N/D;37960;4;1;0;0;0;4;1;37960;ALMOHADA ROSEN SOFT PLUS KING;DORMITORIO
16433908;Soltero;M;35;CHILENO;;Millenial;CHEPICA                       ;L.G.B.OÂ´HIGGINS;16980;2;1;0;0;0;2;1;16980;ALMOHADA ROSEN SOFT PLUS AMERICANA;DORMITORIO
5501676;;M;76;CHILENO;;Silencioso;RENCA                         ;METROPOLITANA;179980;2;1;2;1;179980;0;0;0;CE EVOLUTION BLACK 1,5P + RESPALDO ASTURIAS;DORMITORIO
16037910;;F;36;CHILENO;;Millenial;HUALPEN;BIO BIO;243980;2;1;2;1;243980;0;0;0;C.EUROPEA NEW ORTOPEDIC 1.5P +RESP+VEL LEGNO;DORMITORIO
19326993;;M;25;CHILENO;;Z;N/D;N/D;249960;4;2;4;2;249960;0;0;0;CE EVOLUTION BLACK 1,5P BN DUAL SIDE;DORMITORIO
6330591;Casado;F;74;CHILENO;;Silencioso;RENCA                         ;METROPOLITANA;314940;4;1;0;0;0;4;1;314940;COLCHON THERAPEDIC 1,5P;DORMITORIO
10762424;;M;56;CHILENO;;Boomers;LA SERENA                     ;COQUIMBO;17980;2;1;0;0;0;2;1;17980;ALMOHADA SOFT MICROGEL;DORMITORIO
9005497;;F;61;CHILENO;;Boomers;PELLUHUE                      ;MAULE;537450;4;1;4;1;537450;0;0;0;CE EVOLUTION BLACK 1P BN DUAL SIDE;DORMITORIO
20179745;;F;22;CHILENO;;Z;N/D;N/D;521860;3;2;0;0;0;3;2;521860;BOX BAMBOO + Respaldo + 2 Veladores ALICANTE;DORMITORIO
19741693;;F;25;CHILENO;;Silencioso;PROVIDENCIA                   ;METROPOLITANA;259980;2;1;2;1;259980;0;0;0;BS ORTOPEDIC ADVANCE B5 BLACK 1,5P;DORMITORIO
6840526;Soltero;F;69;CHILENO;;Silencioso;TALCAHUANO                    ;BIO BIO;89470;2;2;0;0;0;2;2;89470;COLCHON EVOLUTION BLACK 1,5P DUAL SIDE;DORMITORIO
16447641;;M;35;CHILENO;;Millenial;YUNGAY                        ;BIO BIO;253980;2;1;2;1;253980;0;0;0;BA EXCELLENCE PLUS 2P BN +RESP+VEL OLMO;DORMITORIO
17113671;;F;33;CHILENO;;Millenial;OVALLE                        ;COQUIMBO;0;0;0;0;0;0;0;0;0;ALMOHADA MEMORY MAX BASIC AMERICANA;DORMITORIO
15302549;;M;40;CHILENO;;X;RENCA                         ;METROPOLITANA;0;0;0;0;0;0;0;0;0;CAMAROTE TRIPLE CORINA CAFE CLARO;DORMITORIO
17285327;;F;33;CHILENO;;Silencioso;PROVIDENCIA                   ;METROPOLITANA;0;0;0;0;0;0;0;0;0;SET SABANA MICROFIBRA SAND 1,5P;DORMITORIO
18886747;Soltero;M;27;CHILENO;;Millenial;PROVIDENCIA                   ;METROPOLITANA;0;0;0;0;0;0;0;0;0;COLCHON EXCELLENCE 1,5P;DORMITORIO
6287147;;M;71;CHILENO;;X;SAN BERNARDO                  ;METROPOLITANA;0;0;0;0;0;0;0;0;0;COLCHON NEW ORTOPEDIC 1,5P;DORMITORIO
8608810;;M;58;CHILENO;;Boomers;PROVIDENCIA                   ;METROPOLITANA;0;0;0;0;0;0;0;0;0;COLCHON SPRING III 1P;DORMITORIO
18173044;;M;29;CHILENO;;Millenial;PROVIDENCIA                   ;METROPOLITANA;0;0;0;0;0;0;0;0;0;COLCHON SPRING III 1P;DORMITORIO
19459560;;F;25;CHILENO;;Z;PROVIDENCIA                   ;METROPOLITANA;0;0;0;0;0;0;0;0;0;CLOSET ROMA 8 PUERTAS EXIT NOGAL 1,77X1,32X0,40;DORMITORIO
18673195;;M;28;CHILENO;;Silencioso;PROVIDENCIA                   ;METROPOLITANA;0;0;0;0;0;0;0;0;0;COLCHON NEW ORTOPEDIC 1,5P + ALM+CUBREC;DORMITORIO
26505415;;F;35;EXTRANJERO - NO INFORMA NACIONALIDAD;;Extranjero;N/D;N/D;0;0;0;0;0;0;0;0;0;PACK 2 ALMOHADAS C+L;DORMITORIO
26487109;Soltero;F;37;EXTRANJERO - NO INFORMA NACIONALIDAD;;Extranjero;PROVIDENCIA                   ;METROPOLITANA;0;0;0;0;0;0;0;0;0;ALMOHADA LIGHT 50X70;DORMITORIO
18751623;;F;28;CHILENO;;Millenial;N/D;N/D;0;0;0;0;0;0;0;0;0;Almohada Visco Bamboo Classic Pack 60x40 cm;DORMITORIO
7697442;;F;66;CHILENO;;Boomers;PROVIDENCIA                   ;METROPOLITANA;0;0;0;0;0;0;0;0;0;CLOSET NIZA 6P+2C;DORMITORIO
8900859;;F;62;CHILENO;;Boomers;PROVIDENCIA                   ;METROPOLITANA;0;0;0;0;0;0;0;0;0;COLCHON NEW ORTOPEDIC 1,5P;DORMITORIO
13439165;;M;44;CHILENO;;X;LA FLORIDA                    ;METROPOLITANA;0;0;0;0;0;0;0;0;0;COLCHON SPRING III 1P;DORMITORIO
18327911;;M;29;CHILENO;;Silencioso;PROVIDENCIA                   ;METROPOLITANA;0;0;0;0;0;0;0;0;0;COLCHON BEAT 1,5P;DORMITORIO
19161469;Soltero;M;27;CHILENO;;Z;RENCA                         ;METROPOLITANA;0;0;0;0;0;0;0;0;0;PACK 2 ALMOHADAS C+L;DORMITORIO
12717575;;F;47;CHILENO;;X;RENCA                         ;METROPOLITANA;0;0;0;0;0;0;0;0;0;COLCHON NEW ORTOPEDIC 1,5P;DORMITORIO
7637568;;F;63;CHILENO;;Boomers;PROVIDENCIA                   ;METROPOLITANA;0;0;0;0;0;0;0;0;0;PACK 2 ALMOHADAS C+L;DORMITORIO
5620311;;M;76;CHILENO;;Silencioso;ERCILLA                       ;ARAUCANIA;0;0;0;0;0;0;0;0;0;PACK 2 ALMOHADAS C+L;DORMITORIO
17780237;;M;31;CHILENO;;Silencioso;PROVIDENCIA                   ;METROPOLITANA;0;0;0;0;0;0;0;0;0;ALMOHADA VISCO ELASTICA CANNABIS 60X40CM;DORMITORIO
11376625;;F;53;CHILENO;;X;SALAMANCA                     ;COQUIMBO;0;0;0;0;0;0;0;0;0;CLOSET ROMA 8 PUERTAS EXIT NOGAL 1,77X1,32X0,40;DORMITORIO
11218573;;F;54;CHILENO;;Boomers;PROVIDENCIA                   ;METROPOLITANA;0;0;0;0;0;0;0;0;0;PRODUCTO 2A DORMITORIO BANDA 6;DORMITORIO
8907679;;F;63;CHILENO;;Boomers;PROVIDENCIA                   ;METROPOLITANA;0;0;0;0;0;0;0;0;0;PACK 2 ALMOHADAS C+L;DORMITORIO
20437390;;F;22;CHILENO;;Millenial;N/D;N/D;0;0;0;0;0;0;0;0;0;CLOSET 6 PUERTAS 1 CAJON 1 ZAPATERA BALI BICOLO;DORMITORIO
15216144;;F;40;CHILENO;;X;PROVIDENCIA                   ;METROPOLITANA;0;0;0;0;0;0;0;0;0;Almohada Visco Bamboo Classic Pack 60x40 cm;DORMITORIO
20296546;;F;23;CHILENO;;Z;RETIRO                        ;MAULE;0;0;0;0;0;0;0;0;0;CE ERGO T 2P 2MT BD;DORMITORIO
10496056;;M;54;CHILENO;;Boomers;ARICA                         ;ARICA Y PARINACOTA;0;0;0;0;0;0;0;0;0;ALMOHADA ROSEN SOFT PLUS KING;DORMITORIO
19759953;;M;24;CHILENO;;Z;CASTRO                        ;LOS LAGOS;0;0;0;0;0;0;0;0;0;CLOSET CROACIA CHOCOLATE 4P;DORMITORIO
18421946;;F;29;CHILENO;;Extranjero;"";"";0;0;0;0;0;0;0;0;0;COMODA CIPRES MODELO CP15D, COLOR DEMOLICION, 1;DORMITORIO
18681460;Soltero;F;28;CHILENO;;Silencioso;PROVIDENCIA                   ;METROPOLITANA;0;0;0;0;0;0;0;0;0;CLOSET NIZA 6P+2C;DORMITORIO
11454032;;M;52;CHILENO;;X;QUELLON                       ;LOS LAGOS;0;0;0;0;0;0;0;0;0;COLCHON SPRING III 1P;DORMITORIO
15110498;;M;39;CHILENO;;X;SAN VICENTE                   ;L.G.B.OÂ´HIGGINS;0;0;0;0;0;0;0;0;0;PACK 2 ALMOHADAS C+L;DORMITORIO
6316665;;M;73;CHILENO;;Silencioso;OVALLE                        ;COQUIMBO;0;0;0;0;0;0;0;0;0;COLCHON EVOLUTION BLACK 2P DUAL SIDE;DORMITORIO
8294193;;M;62;CHILENO;;Boomers;RENCA                         ;METROPOLITANA;0;0;0;0;0;0;0;0;0;COLCHON PREMIUM 2P X 2 MTS;DORMITORIO
15500645;;F;39;CHILENO;;X;N/D;N/D;0;0;0;0;0;0;0;0;0;VELADOR FAVATEX FRANK 3C;DORMITORIO
9246562;Divorciado;M;61;CHILENO;;Boomers;RENCA                         ;METROPOLITANA;0;0;0;0;0;0;0;0;0;COLCHON EXCELLENCE 1P;DORMITORIO
15894996;;M;44;CHILENO;;X;CASTRO                        ;LOS LAGOS;0;0;0;0;0;0;0;0;0;ALMOHADA SOFT MICROGEL;DORMITORIO
15472986;;F;39;CHILENO;;X;PROVIDENCIA                   ;METROPOLITANA;0;0;0;0;0;0;0;0;0;ALMOHADA VISCO SLEEP TECH SERIES 65X45 CM;DORMITORIO
17693811;;M;31;CHILENO;;Silencioso;PROVIDENCIA                   ;METROPOLITANA;0;0;0;0;0;0;0;0;0;BOX SPRING NEOSENSE FULL BLACK;DORMITORIO
6214632;;F;74;CHILENO;;Silencioso;VALPARAISO                    ;VALPARAISO;0;0;0;0;0;0;0;0;0;BS ORTOPEDIC ADVANCE B5 BLACK 1,5P;DORMITORIO
6414542;;M;67;CHILENO;;Silencioso;PROVIDENCIA                   ;METROPOLITANA;0;0;0;0;0;0;0;0;0;SET 2 ALMOHADAS VISCO MEDIUM 60X40 CM;DORMITORIO
9868121;Casado;M;56;CHILENO;;Silencioso;PROVIDENCIA                   ;METROPOLITANA;0;0;0;0;0;0;0;0;0;PACK 2 ALMOHADAS C+L;DORMITORIO
27003836;;M;35;CHILENO;;Extranjero;N/D;N/D;0;0;0;0;0;0;0;0;0;SET 2 ALMOHADAS VISCO MEDIUM 60X40 CM;DORMITORIO
15883946;;F;37;CHILENO;;Millenial;VALDIVIA                      ;LOS LAGOS;0;0;0;0;0;0;0;0;0;CE EXCELLENCE PLUS 2P BN+RESP+2VEL NEW MUNICH;DORMITORIO
7476607;;F;66;CHILENO;;Boomers;RENCA                         ;METROPOLITANA;0;0;0;0;0;0;0;0;0;COLCHON PREMIUM 2P;DORMITORIO
18243354;;F;30;CHILENO;;Millenial;N/D;N/D;0;0;0;0;0;0;0;0;0;SET 2 ALMOHADAS VISCO MEDIUM 60X40 CM;DORMITORIO
7435605;Casado;M;62;CHILENO;;Boomers;PROVIDENCIA                   ;METROPOLITANA;0;0;0;0;0;0;0;0;0;COLCHON EXCELLENCE FULL;DORMITORIO
6045894;Casado;M;69;CHILENO;CONTADOR AUDITOR;Silencioso;RENCA                         ;METROPOLITANA;0;0;0;0;0;0;0;0;0;COLCHON NEW ORTOPEDIC 1,5P;DORMITORIO
19187136;Soltero;F;26;CHILENO;;Silencioso;PROVIDENCIA                   ;METROPOLITANA;0;0;0;0;0;0;0;0;0;COLCHON BEAT 1,5P;DORMITORIO
15902533;;M;37;CHILENO;;Millenial;TRAIGUEN                      ;ARAUCANIA;0;0;0;0;0;0;0;0;0;CLOSET ESPANA 6P+4C;DORMITORIO
12715546;;M;48;CHILENO;;X;COIHAIQUE                     ;AYSEN;0;0;0;0;0;0;0;0;0;ALMOHADA ROSEN SOFT PLUS AMERICANA;DORMITORIO
17981793;;F;30;CHILENO;;Millenial;PROVIDENCIA                   ;METROPOLITANA;0;0;0;0;0;0;0;0;0;CE BAMBOO 2P BD FIBRAS BAMBOO DUAL SIDE;DORMITORIO
10162279;;F;58;CHILENO;;Boomers;LA CISTERNA                   ;METROPOLITANA;0;0;0;0;0;0;0;0;0;CE EVOLUTION BLACK 2P BD DUAL SIDE;DORMITORIO
18383474;;F;28;CHILENO;;Millenial;VINA DEL MAR                  ;VALPARAISO;0;0;0;0;0;0;0;0;0;SET SABANA MICROFIBRA ROUGE 2P;DORMITORIO
4663052;;M;80;CHILENO;;Silencioso;SAN BERNARDO                  ;METROPOLITANA;0;0;0;0;0;0;0;0;0;COLCHON TERAPEUTIC 2P PILLOW TOP;DORMITORIO
23680666;;M;27;PERUANO;;Extranjero;"";"";0;0;0;0;0;0;0;0;0;COLCHON SPRING III 1P;DORMITORIO
9585721;;F;56;CHILENO;;Boomers;MAIPU                         ;METROPOLITANA;0;0;0;0;0;0;0;0;0;BOX AMERICANO EXCELLENCE 1.5 PLAZA + ALM;DORMITORIO
11187685;Soltero;F;55;CHILENO;;Silencioso;N/D;N/D;0;0;0;0;0;0;0;0;0;CE EVOLUTION BLACK 2P BD DUAL SIDE;DORMITORIO
10174460;Casado;M;58;CHILENO;INGENIERO INFORMATICO;Boomers;PROVIDENCIA                   ;METROPOLITANA;0;0;0;0;0;0;0;0;0;COLCHON EVOLUTION BLACK 1,5P DUAL SIDE;DORMITORIO
18440594;Casado;M;29;CHILENO;INGENIERO INFORMATICO;Silencioso;PROVIDENCIA                   ;METROPOLITANA;0;0;0;0;0;0;0;0;0;ALMOHADA MEMORI MAX KING;DORMITORIO
14581780;;F;42;CHILENO;;X;VINA DEL MAR                  ;VALPARAISO;0;0;0;0;0;0;0;0;0;BOX AMERICANO EXCELLENCE 1 PLAZA + ALM+PL;DORMITORIO
17239176;Soltero;M;33;CHILENO;;Millenial;PAINE                         ;METROPOLITANA;0;0;0;0;0;0;0;0;0;COLCHON TERAPEUTIC 2P PILLOW TOP;DORMITORIO
14126715;;M;42;CHILENO;;X;CONCHALI                      ;METROPOLITANA;0;0;0;0;0;0;0;0;0;BA EXCELLENCE PLUS 2P BD +RESP+VEL OLMO;DORMITORIO
13468459;;F;44;CHILENO;;X;RENCA                         ;METROPOLITANA;0;0;0;0;0;0;0;0;0;COLCHON EXCELLENCE PLUS 1.5 PLAZA 2M;DORMITORIO
9512717;;M;60;CHILENO;;Boomers;COLINA                        ;METROPOLITANA;0;0;0;0;0;0;0;0;0;BA BEAT 2P 2MTS BN;DORMITORIO
16233881;;M;36;CHILENO;;Millenial;N/D;N/D;0;0;0;0;0;0;0;0;0;COLCHON NEW STYLE 6 2P 150X200;DORMITORIO
19337128;Soltero;F;26;CHILENO;PSICOLOGA;Silencioso;SAN FELIPE                    ;VALPARAISO;0;0;0;0;0;0;0;0;0;COLCHON TERAPEUTIC 1,5P PILLOW TOP;DORMITORIO
6857574;;F;72;CHILENO;;Silencioso;PAINE                         ;METROPOLITANA;0;0;0;0;0;0;0;0;0;CE EVOLUTION BLACK 1,5P + RESPALDO CASTILLA;DORMITORIO
19227008;;M;26;CHILENO;;Z;N/D;N/D;0;0;0;0;0;0;0;0;0;DIVAN NEW ORTOPEDIC + RESP + VEL OLMO;DORMITORIO
10091184;;M;58;CHILENO;;Boomers;SAN BERNARDO                  ;METROPOLITANA;0;0;0;0;0;0;0;0;0;COLCHON NEW ORTOPEDIC 1,5P;DORMITORIO
25991714;;F;29;VENEZOLANO;;Extranjero;SANTIAGO                      ;METROPOLITANA;0;0;0;0;0;0;0;0;0;COLCHON NEW ORTOPEDIC 2P 150X190 + CUBREC;DORMITORIO
26302854;;M;30;VENEZOLANO;;Extranjero;N/D;N/D;0;0;0;0;0;0;0;0;0;ALMOHADA MEMORY MAX BASIC AMERICANA;DORMITORIO
8215267;;F;66;CHILENO;;Boomers;OVALLE                        ;COQUIMBO;0;0;0;0;0;0;0;0;0;PACK 2 ALMOHADAS C+L;DORMITORIO
19390460;;F;25;CHILENO;;Z;N/D;N/D;0;0;0;0;0;0;0;0;0;PACK 2 ALMOHADAS C+L;DORMITORIO
16728329;;F;34;CHILENO;;Millenial;IQUIQUE                       ;TARAPACA;0;0;0;0;0;0;0;0;0;Cama Europea Active 2PBN;DORMITORIO
15929521;;M;36;CHILENO;;Millenial;N/D;N/D;0;0;0;0;0;0;0;0;0;COLCHON TEMPO 2P 150X200;DORMITORIO
16368928;;F;35;CHILENO;;Silencioso;PROVIDENCIA                   ;METROPOLITANA;0;0;0;0;0;0;0;0;0;DUPLEX CE EVOLUTION BLACK 1P + 2 RESP + VEL CAST;DORMITORIO
19223323;;F;26;CHILENO;;Z;PUENTE ALTO                   ;METROPOLITANA;0;0;0;0;0;0;0;0;0;SET SABANA MICROFIBRA BLUE 1,5P;DORMITORIO
16993550;;F;32;CHILENO;;Millenial;PROVIDENCIA                   ;METROPOLITANA;0;0;0;0;0;0;0;0;0;CAMA EUROPEA EXCELLENCE 1.5P +RESP+VEL OLMO;DORMITORIO
10356524;Casado;F;56;CHILENO;AUXILIAR PARAMEDICO DE ENFERMERIA;Boomers;RENCA                         ;METROPOLITANA;0;0;0;0;0;0;0;0;0;CAMA ERGO T 1,5P + RESP + 1 VEL FERRARA;DORMITORIO
26135358;;M;27;VENEZOLANO;;Extranjero;CONCEPCION                    ;BIO BIO;0;0;0;0;0;0;0;0;0;CAMA EUROPEA IBIZA 2 PL BD;DORMITORIO
6762859;;F;66;CHILENO;;Boomers;PROVIDENCIA                   ;METROPOLITANA;0;0;0;0;0;0;0;0;0;COLCHON BEAT 1,5P;DORMITORIO
18035593;;F;30;CHILENO;;Millenial;"";"";0;0;0;0;0;0;0;0;0;ALMOHADA ROSEN SOFT PLUS KING;DORMITORIO
13349425;;F;49;CHILENO;;X;CHEPICA                       ;L.G.B.OÂ´HIGGINS;0;0;0;0;0;0;0;0;0;CE ERGO T 2P 2MT BD;DORMITORIO
16312812;;M;35;CHILENO;;Silencioso;PROVIDENCIA                   ;METROPOLITANA;0;0;0;0;0;0;0;0;0;CE EVOLUTION BLACK 2P BD DUAL SIDE;DORMITORIO
20384693;;F;22;CHILENO;;Z;N/D;N/D;0;0;0;0;0;0;0;0;0;BA BEAT 2P 2MTS BN;DORMITORIO
15569265;;M;39;CHILENO;;X;LA PINTANA                    ;METROPOLITANA;0;0;0;0;0;0;0;0;0;CE BAMBOO 2PBD BAMBOO+RES+2V ALICANTE;DORMITORIO
10974903;;M;47;CHILENO;;X;LO PRADO                      ;METROPOLITANA;0;0;0;0;0;0;0;0;0;ALMOHADA SOFT MICROGEL;DORMITORIO
18422574;;M;29;CHILENO;;Silencioso;PROVIDENCIA                   ;METROPOLITANA;0;0;0;0;0;0;0;0;0;ALMOHADA MEMORY MAX BASIC AMERICANA;DORMITORIO
17496420;;M;32;CHILENO;;Millenial;PROVIDENCIA                   ;METROPOLITANA;0;0;0;0;0;0;0;0;0;CE BLACK EVOLUTION FULL;DORMITORIO
25678791;;F;36;VENEZOLANO;;Extranjero;N/D;N/D;0;0;0;0;0;0;0;0;0;COLCHON EVEREST 2P HILOS DE COBRE;DORMITORIO
10006419;;F;53;CHILENO;;X;RENCA                         ;METROPOLITANA;0;0;0;0;0;0;0;0;0;Almohada Visco Bamboo Classic Pack 60x40 cm;DORMITORIO
15957203;;F;37;CHILENO;;Millenial;CERRO NAVIA                   ;METROPOLITANA;0;0;0;0;0;0;0;0;0;CE EVOLUTION BLACK 1,5P + RESPALDO ASTURIAS;DORMITORIO
19238300;Soltero;F;26;CHILENO;;Silencioso;PROVIDENCIA                   ;METROPOLITANA;0;0;0;0;0;0;0;0;0;CLOSET CROACIA BLANCO 4P;DORMITORIO
16633673;;F;34;CHILENO;;Millenial;GORBEA                        ;ARAUCANIA;0;0;0;0;0;0;0;0;0;SILLA DE ESCRITORIO TURIN;DORMITORIO
19460282;;F;24;CHILENO;;Z;TIERRA AMARILLA;ATACAMA;0;0;0;0;0;0;0;0;0;BS NEW ORTOPEDIC B5BLACK 2PBD+RESP+2VEL LEGNO;DORMITORIO
13796462;;F;41;CHILENO;;X;TOME                          ;BIO BIO;0;0;0;0;0;0;0;0;0;CE BAMBOO 2P BD FIBRAS BAMBOO DUAL SIDE;DORMITORIO
17014757;;F;34;CHILENO;;Millenial;PROVIDENCIA                   ;METROPOLITANA;0;0;0;0;0;0;0;0;0;CE EVOLUTION BLACK 2P BD DUAL SIDE;DORMITORIO
18742011;;F;28;CHILENO;;Millenial;CURACAUTIN                    ;ARAUCANIA;0;0;0;0;0;0;0;0;0;CE BAMBOO 2P BD FIBRAS BAMBOO DUAL SIDE;DORMITORIO
19893932;;F;23;CHILENO;;Z;PROVIDENCIA                   ;METROPOLITANA;0;0;0;0;0;0;0;0;0;COLCHON NEW ORTOPEDIC 1P;DORMITORIO
4535918;;F;84;CHILENO;;Silencioso;PROVIDENCIA                   ;METROPOLITANA;0;0;0;0;0;0;0;0;0;COLCHON TERAPEUTIC 2P PILLOW TOP;DORMITORIO
25213935;;M;28;COLOMBIANO;;Extranjero;"";"";0;0;0;0;0;0;0;0;0;BA BEAT 2P 2MTS BN;DORMITORIO
16464236;;M;35;CHILENO;;Silencioso;PROVIDENCIA                   ;METROPOLITANA;0;0;0;0;0;0;0;0;0;COLCHON SWAG 2P 150 X 190;DORMITORIO
19666608;;F;25;CHILENO;;Z;PROVIDENCIA                   ;METROPOLITANA;0;0;0;0;0;0;0;0;0;CE EVOLUTION BLACK 2P BD DUAL SIDE;DORMITORIO
17302594;;F;32;CHILENO;;Millenial;LA CISTERNA                   ;METROPOLITANA;0;0;0;0;0;0;0;0;0;CE ERGO T 2P 2MT BD;DORMITORIO
11759314;Casado;F;51;CHILENO;PROFESOR;Silencioso;PROVIDENCIA                   ;METROPOLITANA;0;0;0;0;0;0;0;0;0;COLCHON EXCELLENCE PLUS 1.5P + CUBRECOLCHON;DORMITORIO
18987683;Soltero;F;26;CHILENO;;Z;PROVIDENCIA                   ;METROPOLITANA;0;0;0;0;0;0;0;0;0;CE EVOLUTION BLACK 1,5P + RESPALDO ASTURIAS;DORMITORIO
19164207;;F;26;CHILENO;;Z;COLINA                        ;METROPOLITANA;0;0;0;0;0;0;0;0;0;CE EVOLUTION BLACK 1P + RESPALDO ASTURIAS;DORMITORIO
17101872;;F;33;CHILENO;;Millenial;PUDAHUEL                      ;METROPOLITANA;0;0;0;0;0;0;0;0;0;PACK 2 ALMOHADAS C+L;DORMITORIO
19802409;;F;24;CHILENO;;Z;PROVIDENCIA                   ;METROPOLITANA;0;0;0;0;0;0;0;0;0;CLOSET M-802 4P+2 C ALTO 1,82 BLANCO NATURAL;DORMITORIO
16667600;;F;34;CHILENO;;Millenial;LO PRADO                      ;METROPOLITANA;0;0;0;0;0;0;0;0;0;CE EXCELLENCE PLUS 1.5P+RESP+1VEL NEW GALES;DORMITORIO
15128306;;F;49;CHILENO;;X;N/D;N/D;0;0;0;0;0;0;0;0;0;CAMA EURO GRIS NEW ENTREE-D 2PBD;DORMITORIO
11945968;;F;50;CHILENO;;X;SAN ANTONIO                   ;VALPARAISO;0;0;0;0;0;0;0;0;0;CE ERGO T 2P 2MT BD;DORMITORIO
14357556;;M;43;CHILENO;;X;SAN FELIPE                    ;VALPARAISO;0;0;0;0;0;0;0;0;0;COLCHON NEW ORTOPEDIC KING 180X200;DORMITORIO
16145218;;F;37;CHILENO;;Millenial;N/D;N/D;0;0;0;0;0;0;0;0;0;SET SABANA MICROFIBRA BLUE 2P;DORMITORIO
15103985;;F;40;CHILENO;;X;N/D;N/D;0;0;0;0;0;0;0;0;0;COLCHON IBIZA 2P;DORMITORIO
18828751;;M;27;CHILENO;;Z;N/D;N/D;0;0;0;0;0;0;0;0;0;CE CAMA ERGO T 1.50X2.00 BD + RESP FERRARA;DORMITORIO
11415959;;F;52;CHILENO;;X;PROVIDENCIA                   ;METROPOLITANA;0;0;0;0;0;0;0;0;0;COLCHON EXCELLENCE 2 PLAZAS + CUBRECOLCHON;DORMITORIO
9506042;;F;60;CHILENO;;Boomers;ANTOFAGASTA                   ;ANTOFAGASTA;0;0;0;0;0;0;0;0;0;CE EVOLUTION BLACK 1,5P BN RESP+VEL;DORMITORIO
18555576;;M;28;CHILENO;;Millenial;N/D;N/D;0;0;0;0;0;0;0;0;0;COLCHON ALOE VERA KING 2MT FIBRAS ALOE VERA;DORMITORIO
20114346;;F;22;CHILENO;;Z;PROVIDENCIA                   ;METROPOLITANA;0;0;0;0;0;0;0;0;0;COLCHON ORTOPEDIC ADVANCE 1,5P;DORMITORIO
20009956;;F;23;CHILENO;;Z;N/D;N/D;0;0;0;0;0;0;0;0;0;PACK 2 ALMOHADAS C+L;DORMITORIO
15284812;;M;40;CHILENO;;X;LOS MUERMOS                   ;LOS LAGOS;0;0;0;0;0;0;0;0;0;PACK 2 ALMOHADAS C+L;DORMITORIO
5834564;;M;72;CHILENO;;Silencioso;BUIN                          ;METROPOLITANA;0;0;0;0;0;0;0;0;0;Almohada Viscoelastica Bamboo Pack 60x40 cm;DORMITORIO
16355613;;F;36;CHILENO;;Millenial;PUDAHUEL;METROPOLITANA;0;0;0;0;0;0;0;0;0;SET SABANA MICROFIBRA MUSTARD 1,5P;DORMITORIO
16752265;;M;34;CHILENO;;Millenial;PROVIDENCIA                   ;METROPOLITANA;0;0;0;0;0;0;0;0;0;CE EVOLUTION BLACK 2P BD+RESP+2 VEL;DORMITORIO
13766662;;F;42;CHILENO;;X;PROVIDENCIA                   ;METROPOLITANA;0;0;0;0;0;0;0;0;0;CLOSET CONCEPCION TV49 M-402 CASTANO / AVELLANA;DORMITORIO
14618375;Casado;M;41;CHILENO;;X;RENCA                         ;METROPOLITANA;0;0;0;0;0;0;0;0;0;PACK 2 ALMOHADAS C+L;DORMITORIO
16440145;Soltero;F;35;CHILENO;;Millenial;NATALES                       ;MAGALLANES;0;0;0;0;0;0;0;0;0;CE EVOLUTION BLACK 2P BD+RESP+2 VEL;DORMITORIO
17695450;;F;28;CHILENO;;Millenial;LANCO                         ;LOS RIOS;0;0;0;0;0;0;0;0;0;COLCHON EVEREST 2P HILOS DE COBRE;DORMITORIO
20251933;Soltero;M;29;CHILENO;PSICOLOGO;Millenial;PROVIDENCIA                   ;METROPOLITANA;0;0;0;0;0;0;0;0;0;Almohada Visco Bamboo Classic Pack 60x40 cm;DORMITORIO
13341167;Casado;F;43;CHILENO;;X;PROVIDENCIA                   ;METROPOLITANA;0;0;0;0;0;0;0;0;0;CE EVOLUTION BLACK 1,5P + RESPALDO ASTURIAS;DORMITORIO
12310959;;M;49;CHILENO;;X;N/D;N/D;0;0;0;0;0;0;0;0;0;PACK 2 ALMOHADAS C+L;DORMITORIO
10610838;;M;52;CHILENO;;X;PROVIDENCIA                   ;METROPOLITANA;0;0;0;0;0;0;0;0;0;CE CANNABIS 1,5P BN+PILLOW TOP;DORMITORIO
18200181;;M;30;CHILENO;;Millenial;PROVIDENCIA                   ;METROPOLITANA;0;0;0;0;0;0;0;0;0;COLCHON NEW ORTOPEDIC 1,5P;DORMITORIO
13025934;;F;46;CHILENO;;X;RENCA                         ;METROPOLITANA;0;0;0;0;0;0;0;0;0;SET SABANA MICROFIBRA SAND 1,5P;DORMITORIO
20270151;;F;22;CHILENO;;Z;PROVIDENCIA                   ;METROPOLITANA;0;0;0;0;0;0;0;0;0;BOX AMERICANO EXCELLENCE 2P BASE NORMAL+2ALM;DORMITORIO
19497341;;F;25;CHILENO;;Extranjero;N/D;N/D;0;0;0;0;0;0;0;0;0;SET SABANA MICROFIBRA BLUE 1,5P;DORMITORIO
12507577;;M;49;CHILENO;;X;RENCA                         ;METROPOLITANA;0;0;0;0;0;0;0;0;0;ESCRITORIO FAVATEX YATES NEGRO;DORMITORIO
17878727;;F;30;CHILENO;;Millenial;PEDRO AGUIRRE CERDA           ;METROPOLITANA;0;0;0;0;0;0;0;0;0;COLCHON NEW ORTOPEDIC 2P;DORMITORIO
13417878;;M;43;CHILENO;;X;CALAMA                        ;ANTOFAGASTA;0;0;0;0;0;0;0;0;0;COLCHON TERAPEUTIC 2P PILLOW TOP;DORMITORIO
14403391;;F;51;CHILENO;;X;PROVIDENCIA                   ;METROPOLITANA;0;0;0;0;0;0;0;0;0;CLOSET M-803 3P 2C ALTO 1,82 BLANCO NATURAL;DORMITORIO
9108847;;F;58;CHILENO;;Boomers;CONTULMO                      ;BIO BIO;0;0;0;0;0;0;0;0;0;CE NEW STYLE 6 2P 2MT BD;DORMITORIO
14227956;;M;40;CHILENO;;Silencioso;PROVIDENCIA                   ;METROPOLITANA;0;0;0;0;0;0;0;0;0;Almohada Bamboo Classic 70x40;DORMITORIO
9282664;Casado;M;60;CHILENO;;Boomers;RENCA                         ;METROPOLITANA;0;0;0;0;0;0;0;0;0;Almohada Visco Bamboo Classic Pack 60x40 cm;DORMITORIO
18255512;;F;29;CHILENO;;Millenial;PROVIDENCIA                   ;METROPOLITANA;0;0;0;0;0;0;0;0;0;BASE AMERICANA SPRING VI 2.0 PL B/D;DORMITORIO
10078793;;M;56;CHILENO;;Boomers;RENCA                         ;METROPOLITANA;0;0;0;0;0;0;0;0;0;COMODA Z-80 TV32 4 CAJONES - ROVERE / BLANCO;DORMITORIO
6396098;;M;71;CHILENO;;Silencioso;LOS ANDES                     ;VALPARAISO;0;0;0;0;0;0;0;0;0;CAMA EUROPEA IBIZA 2 PL BD;DORMITORIO
16922114;;F;34;CHILENO;;Millenial;SAN PEDRO DE LA PAZ           ;BIO BIO;0;0;0;0;0;0;0;0;0;CE EVOLUTION BLACK 2P BD+RESP+2 VEL;DORMITORIO
15847703;;M;38;CHILENO;;Silencioso;PROVIDENCIA                   ;METROPOLITANA;0;0;0;0;0;0;0;0;0;CLOSET NEWCAPRI M-330 AVELLANA/CARVALHO4P3C+ESPE;DORMITORIO
16752614;;F;35;CHILENO;;Millenial;PROVIDENCIA                   ;METROPOLITANA;0;0;0;0;0;0;0;0;0;CLOSET CAJONERA NEW BELGICA M-398-NW;DORMITORIO
16527000;;M;35;CHILENO;;Millenial;"";"";0;0;0;0;0;0;0;0;0;CE EVOLUTION BLACK 1,5P BN DUAL SIDE;DORMITORIO
18467993;Soltero;M;28;CHILENO;QUIMICO FARMACEUTICO;Silencioso;PROVIDENCIA                   ;METROPOLITANA;0;0;0;0;0;0;0;0;0;CLOSET NEWCAPRI M-330 AVELLANA/CARVALHO4P3C+ESPE;DORMITORIO
17126561;;F;33;CHILENO;;Millenial;LAJA                          ;BIO BIO;0;0;0;0;0;0;0;0;0;BS NEW ORTOPEDIC B5 BLACK 2PBD;DORMITORIO
18401211;Soltero;F;29;CHILENO;;Millenial;PROVIDENCIA                   ;METROPOLITANA;0;0;0;0;0;0;0;0;0;CE BLACK 1,5P EVOLUTION+ALM+CUBRECAMA+SABANA;DORMITORIO
8884899;;F;61;CHILENO;;Boomers;"";"";0;0;0;0;0;0;0;0;0;COLCHON ORTOPEDIC ADVANCE 2P 150X200;DORMITORIO
19008407;;M;26;CHILENO;;Z;CORONEL                       ;BIO BIO;0;0;0;0;0;0;0;0;0;CE BAMBOO 2P BD FIBRAS BAMBOO DUAL SIDE;DORMITORIO
13277539;Soltero;F;45;CHILENO;TECNICO EN COMERCIO INTERNACIONAL;Silencioso;PROVIDENCIA                   ;METROPOLITANA;0;0;0;0;0;0;0;0;0;CE ORTOPEDIC ADVANCE 2PBD +RESPALDO TIGRIS;DORMITORIO
18134348;;M;29;CHILENO;;Millenial;RIO BUENO                     ;LOS RIOS;0;0;0;0;0;0;0;0;0;CAMA EUROPEA CANNABIS 2PBD + RESP + VEL CASTILLA;DORMITORIO
13212618;;M;45;CHILENO;;X;PROVIDENCIA                   ;METROPOLITANA;0;0;0;0;0;0;0;0;0;CAMA EURO GRIS NEW ENTREE-D 2PBD;DORMITORIO
15926678;;M;37;CHILENO;;Millenial;CASTRO                        ;LOS LAGOS;0;0;0;0;0;0;0;0;0;BS NEW ORTOPEDIC B5 BLACK 2PBD;DORMITORIO
16329468;;M;35;CHILENO;;Millenial;FLORIDA                       ;BIO BIO;0;0;0;0;0;0;0;0;0;COLCHON EXCELLENCE PLUS 2 PLAZAS 2M + 2 ALM;DORMITORIO
19461895;;M;25;CHILENO;;Silencioso;PROVIDENCIA                   ;METROPOLITANA;0;0;0;0;0;0;0;0;0;ESCRITORIO JACK CAFE;DORMITORIO
15395656;;F;40;CHILENO;;X;PANGUIPULLI                   ;LOS RIOS;0;0;0;0;0;0;0;0;0;CE ERGO T 2P 2MT BD;DORMITORIO
19353732;Soltero;M;26;CHILENO;;Z;PROVIDENCIA                   ;METROPOLITANA;0;0;0;0;0;0;0;0;0;CLOSET CAJONERA NEW BELGICA M-398-NW;DORMITORIO
8628388;;M;61;CHILENO;;Boomers;CAUQUENES                     ;MAULE;0;0;0;0;0;0;0;0;0;CE EVOLUTION BLACK 1,5P + RESPALDO CASTILLA;DORMITORIO
17067267;;M;33;CHILENO;;Millenial;SAN BERNARDO                  ;METROPOLITANA;0;0;0;0;0;0;0;0;0;CE EVOLUTION BLACK 1,5P BN DUAL SIDE;DORMITORIO
13190991;Casado;M;45;CHILENO;INGENIERO COMERCIAL;Silencioso;PROVIDENCIA                   ;METROPOLITANA;0;0;0;0;0;0;0;0;0;BS SUPER PREMIUM SUPERKING FN;DORMITORIO
17001252;;F;34;CHILENO;;Millenial;PROVIDENCIA                   ;METROPOLITANA;0;0;0;0;0;0;0;0;0;BS ORTOPEDIC ADVANCE B5 BLACK KING;DORMITORIO
6511946;;F;70;CHILENO;;Silencioso;LA CRUZ                       ;VALPARAISO;0;0;0;0;0;0;0;0;0;CE EVEREST 2P 2MTS BD DUAL SIDE;DORMITORIO
19480051;;F;25;CHILENO;;Z;PROVIDENCIA                   ;METROPOLITANA;0;0;0;0;0;0;0;0;0;COLCHON EXCELLENCE 1.5 PLAZA + CUBRECOLCHON;DORMITORIO
16110243;Soltero;F;36;CHILENO;MEDICO CIRUJANO;Silencioso;PROVIDENCIA                   ;METROPOLITANA;0;0;0;0;0;0;0;0;0;BOX AMERICANO EXCELLENCE 1 PLAZA;DORMITORIO
6843501;;F;71;CHILENO;;Silencioso;PROVIDENCIA                   ;METROPOLITANA;0;0;0;0;0;0;0;0;0;BOX 1 1/2 P + RESP +1 VEL;DORMITORIO
6269913;;M;70;CHILENO;;Silencioso;RENCA                         ;METROPOLITANA;0;0;0;0;0;0;0;0;0;CE BAMBOO 2P BD FIBRAS BAMBOO DUAL SIDE;DORMITORIO
26591376;;F;22;EXTRANJERO - NO INFORMA NACIONALIDAD;;Extranjero;VINA DEL MAR                  ;VALPARAISO;0;0;0;0;0;0;0;0;0;PACK 2 ALMOHADAS C+L;DORMITORIO
12214152;Casado;F;50;CHILENO;;X;RENCA                         ;METROPOLITANA;0;0;0;0;0;0;0;0;0;CE EVOLUTION BLACK 2P BD DUAL SIDE;DORMITORIO
17748591;;M;31;CHILENO;;Millenial;CHILLAN                       ;BIO BIO;0;0;0;0;0;0;0;0;0;CLOSET NEW SLIM M-900 CASTANO;DORMITORIO
6893061;;F;73;CHILENO;;Silencioso;CORONEL                       ;BIO BIO;0;0;0;0;0;0;0;0;0;COLCHON NEW STYLE 2 2P;DORMITORIO
12450968;;F;53;CHILENO;;X;PROVIDENCIA                   ;METROPOLITANA;0;0;0;0;0;0;0;0;0;CLOSET NEWCAPRI M-330 AVELLANA/CARVALHO4P3C+ESPE;DORMITORIO
14190755;;F;41;CHILENO;;X;RENCA                         ;METROPOLITANA;0;0;0;0;0;0;0;0;0;CLOSET NIZA 6P+2C;DORMITORIO
13676739;Soltero;M;42;CHILENO;;X;RENCA                         ;METROPOLITANA;0;0;0;0;0;0;0;0;0;ALMOHADA SOFT MICROGEL;DORMITORIO
10051106;;F;57;CHILENO;;Boomers;PROVIDENCIA                   ;METROPOLITANA;0;0;0;0;0;0;0;0;0;Almohada Visco Bamboo Classic Pack 60x40 cm;DORMITORIO
17635688;;M;31;CHILENO;;Millenial;PROVIDENCIA                   ;METROPOLITANA;0;0;0;0;0;0;0;0;0;BOX AMERICANO MIRAGE 2PBN;DORMITORIO
12028307;;M;54;CHILENO;;Boomers;RENCA                         ;METROPOLITANA;0;0;0;0;0;0;0;0;0;COLCHON TERAPEUTIC 2P PILLOW TOP;DORMITORIO
13847590;;F;41;CHILENO;;X;N/D;N/D;0;0;0;0;0;0;0;0;0;CE EVOLUTION BLACK 1,5P BN DUAL SIDE;DORMITORIO
16668953;Soltero;M;34;CHILENO;INGENIERO EN BIOTECNOLOGIA;Millenial;PROVIDENCIA                   ;METROPOLITANA;0;0;0;0;0;0;0;0;0;COMODA POLUX 8CJNS OLMO;DORMITORIO
13872560;;F;42;CHILENO;;X;LA SERENA                     ;COQUIMBO;0;0;0;0;0;0;0;0;0;CE EVOLUTION BLACK 1P + RESPALDO CASTILLA;DORMITORIO
16779483;;M;34;CHILENO;;Millenial;RENCA                         ;METROPOLITANA;0;0;0;0;0;0;0;0;0;CE EVOLUTION BLACK 2P BD DUAL SIDE;DORMITORIO
17651191;;M;31;CHILENO;;Millenial;PROVIDENCIA                   ;METROPOLITANA;0;0;0;0;0;0;0;0;0;Cama Tempo 2PBD + Resp + 2 Vel Grafito;DORMITORIO
16001286;Soltero;M;37;CHILENO;MEDICO CIRUJANO;Millenial;PROVIDENCIA                   ;METROPOLITANA;0;0;0;0;0;0;0;0;0;COLCHON TEMPO 2P 150X190;DORMITORIO
17559161;;M;32;CHILENO;;Millenial;ALHUE                         ;METROPOLITANA;0;0;0;0;0;0;0;0;0;CE SUPER PREMIUM KING +RESP+2VEL NEW TOR CHOC;DORMITORIO
18362455;Soltero;M;29;CHILENO;;Silencioso;PROVIDENCIA                   ;METROPOLITANA;0;0;0;0;0;0;0;0;0;SET 2 ALMOHADAS VISCO MEDIUM 60X40 CM;DORMITORIO
18961303;;F;27;CHILENO;;Z;PROVIDENCIA                   ;METROPOLITANA;0;0;0;0;0;0;0;0;0;COLCHON BAMBOO 2P FIBRAS BAMBOO;DORMITORIO
17601480;Soltero;F;31;CHILENO;TERAPEUTA OCUPACIONAL;Millenial;PROVIDENCIA                   ;METROPOLITANA;0;0;0;0;0;0;0;0;0;DIVAN CAMA ERGO T 1,5P 2 MTS;DORMITORIO
11586754;Divorciado;F;51;CHILENO;;X;CUNCO                         ;ARAUCANIA;0;0;0;0;0;0;0;0;0;COLCHON EXCELLENCE 1,5P;DORMITORIO
14104155;;F;41;CHILENO;;X;ANTOFAGASTA                   ;ANTOFAGASTA;0;0;0;0;0;0;0;0;0;CAMA ART 4 1.50X2.00 BD;DORMITORIO
8044719;Divorciado;F;60;CHILENO;AUXILIAR DE FARMACIA;Boomers;RENCA                         ;METROPOLITANA;0;0;0;0;0;0;0;0;0;COLCHON EXCELLENCE 2P;DORMITORIO
18609893;Soltero;F;28;CHILENO;KINESIOLOGA;Millenial;PROVIDENCIA                   ;METROPOLITANA;0;0;0;0;0;0;0;0;0;RACK BELLINI 50;DORMITORIO
20154342;;M;23;CHILENO;;Silencioso;PROVIDENCIA                   ;METROPOLITANA;0;0;0;0;0;0;0;0;0;CAMAROTE TRIPLE CORINA CAFE OSCURO;DORMITORIO
16944497;;F;31;CHILENO;;Millenial;CHEPICA                       ;L.G.B.OÂ´HIGGINS;0;0;0;0;0;0;0;0;0;BA EXCELL PLUS 1,5P +RESP+1VEL NEW VILLARRICA;DORMITORIO
19504758;;F;25;CHILENO;;Z;RENCA                         ;METROPOLITANA;0;0;0;0;0;0;0;0;0;ESCRITORIO JACK BLANCO;DORMITORIO
12780060;;F;47;CHILENO;;X;SAN FERNANDO                  ;L.G.B.OÂ´HIGGINS;0;0;0;0;0;0;0;0;0;COLCHON TERAPEUTIC 2P PILLOW TOP;DORMITORIO
14354033;Soltero;M;43;CHILENO;;X;PROVIDENCIA                   ;METROPOLITANA;0;0;0;0;0;0;0;0;0;COLCHON BAMBOO 2P FIBRAS BAMBOO;DORMITORIO
13545226;;F;42;CHILENO;;X;QUILPUE                       ;VALPARAISO;0;0;0;0;0;0;0;0;0;CE BALANCE 2P BD;DORMITORIO
26844858;;M;30;EXTRANJERO - NO INFORMA NACIONALIDAD;;Extranjero;N/D;N/D;0;0;0;0;0;0;0;0;0;ALMOHADA SOFT MICROGEL;DORMITORIO
11878395;Casado;M;50;CHILENO;;X;PROVIDENCIA                   ;METROPOLITANA;0;0;0;0;0;0;0;0;0;COLCHON NEW ENTREE 1,5P;DORMITORIO
19698779;;F;24;CHILENO;;Z;PROVIDENCIA                   ;METROPOLITANA;0;0;0;0;0;0;0;0;0;ALMOHADA SOFT MICROGEL;DORMITORIO
6116561;;F;76;CHILENO;;Silencioso;N/D;N/D;0;0;0;0;0;0;0;0;0;COLCHON EXCELLENCE 2P;DORMITORIO
17366714;Soltero;M;32;CHILENO;INGENIERO CIVIL INDUSTRIAL;Millenial;PROVIDENCIA                   ;METROPOLITANA;0;0;0;0;0;0;0;0;0;COLCHON EXCELLENCE 1P;DORMITORIO
15092269;;F;39;CHILENO;;X;SAN FELIPE                    ;VALPARAISO;0;0;0;0;0;0;0;0;0;BOXET ERGO T 2P;DORMITORIO
17808263;;F;31;CHILENO;;Millenial;ANTOFAGASTA                   ;ANTOFAGASTA;0;0;0;0;0;0;0;0;0;PACK 2 ALMOHADAS C+L;DORMITORIO
10091348;;M;55;CHILENO;;Boomers;PROVIDENCIA                   ;METROPOLITANA;0;0;0;0;0;0;0;0;0;DUPLEX CE EVOLUTION BLACK 1P + 2 RESP + VEL ASTU;DORMITORIO
18138102;;F;29;CHILENO;;Millenial;PROVIDENCIA                   ;METROPOLITANA;0;0;0;0;0;0;0;0;0;CE EVOLUTION BLACK 1,5P + RESPALDO CASTILLA;DORMITORIO
12305555;Divorciado;F;49;CHILENO;;X;PROVIDENCIA                   ;METROPOLITANA;0;0;0;0;0;0;0;0;0;COLCHON ERGO T 1P;DORMITORIO
7425573;Soltero;F;68;CHILENO;;Boomers;RENCA                         ;METROPOLITANA;0;0;0;0;0;0;0;0;0;COLCHON NEW ORTOPEDIC 1,5P;DORMITORIO
16767180;Soltero;M;34;CHILENO;MEDICO CIRUJANO;Millenial;PROVIDENCIA                   ;METROPOLITANA;0;0;0;0;0;0;0;0;0;CE EXCELLENCE PLUS 2P BD+RESP+2VEL NEW GALES;DORMITORIO
15522588;;M;36;CHILENO;;Millenial;PROVIDENCIA                   ;METROPOLITANA;0;0;0;0;0;0;0;0;0;BOX AMERICANO MIRAGE 2PBN;DORMITORIO
14260384;;F;47;CHILENO;;X;LAMPA                         ;METROPOLITANA;0;0;0;0;0;0;0;0;0;CE ERGO T 2P 2MT BD;DORMITORIO
9702759;;F;58;CHILENO;;Boomers;RENCA                         ;METROPOLITANA;0;0;0;0;0;0;0;0;0;BOXET ERGO T 2P;DORMITORIO
12442808;;M;48;CHILENO;;X;RENCA                         ;METROPOLITANA;0;0;0;0;0;0;0;0;0;CLOSET ESPANA 6P+4C;DORMITORIO
16167429;;M;36;CHILENO;;Millenial;SALAMANCA                     ;COQUIMBO;0;0;0;0;0;0;0;0;0;CE ERGO T 2P 2MT BD;DORMITORIO
17228515;;M;34;CHILENO;;Millenial;PROVIDENCIA                   ;METROPOLITANA;0;0;0;0;0;0;0;0;0;COLCHON SPRING III 1P;DORMITORIO
17606162;;M;31;CHILENO;;Millenial;PROVIDENCIA                   ;METROPOLITANA;0;0;0;0;0;0;0;0;0;Almohada ViscoGel Cobre 70x40x13 cm;DORMITORIO
11894355;;M;51;CHILENO;;X;PROVIDENCIA                   ;METROPOLITANA;0;0;0;0;0;0;0;0;0;PACK 2 ALMOHADAS C+L;DORMITORIO
17758269;;M;31;CHILENO;;Millenial;PROVIDENCIA                   ;METROPOLITANA;0;0;0;0;0;0;0;0;0;ALMOHADA SOFT MICROGEL;DORMITORIO
15277810;Soltero;F;38;CHILENO;;Millenial;OSORNO                        ;LOS LAGOS;0;0;0;0;0;0;0;0;0;CE ERGO T 2P 2MT BN;DORMITORIO
18269164;Soltero;F;30;CHILENO;;Millenial;PROVIDENCIA                   ;METROPOLITANA;0;0;0;0;0;0;0;0;0;CE EVOLUTION BLACK 1,5P + RESPALDO CASTILLA;DORMITORIO
12779521;;M;47;CHILENO;;X;N/D;N/D;0;0;0;0;0;0;0;0;0;COLCHON SUPER PREMIUM 2P;DORMITORIO
6455978;;M;63;CHILENO;;Boomers;BUIN                          ;METROPOLITANA;0;0;0;0;0;0;0;0;0;COLCHON NEW STYLE 2 2P 150X200;DORMITORIO
15310411;;F;39;CHILENO;;X;MAIPU                         ;METROPOLITANA;0;0;0;0;0;0;0;0;0;CLOSET ARICA TV 32 M302 TEXTURADO;DORMITORIO
16396217;;F;35;CHILENO;;Millenial;N/D;N/D;0;0;0;0;0;0;0;0;0;COLCHON ACTIVE 1,5P DUAL SIDE;DORMITORIO
9263327;;M;57;CHILENO;;Boomers;CHIMBARONGO                   ;L.G.B.OÂ´HIGGINS;0;0;0;0;0;0;0;0;0;CLOSET CAJONERA NEW BELGICA M-398-NW;DORMITORIO
19971353;;F;24;CHILENO;;Extranjero;"";"";0;0;0;0;0;0;0;0;0;CE NEW STYLE 2 2P 2MT BD;DORMITORIO
15816342;;M;37;CHILENO;;Millenial;PROVIDENCIA                   ;METROPOLITANA;0;0;0;0;0;0;0;0;0;CE EVOLUTION BLACK 1,5P + RESPALDO CASTILLA;DORMITORIO
19162499;Soltero;F;27;CHILENO;;Z;PROVIDENCIA                   ;METROPOLITANA;0;0;0;0;0;0;0;0;0;Pack Veladores Italia Cedro/Pinus;DORMITORIO
19251873;Soltero;F;26;CHILENO;;Z;PROVIDENCIA                   ;METROPOLITANA;0;0;0;0;0;0;0;0;0;PACK 2 ALMOHADAS C+L;DORMITORIO
4787448;;F;76;CHILENO;;Silencioso;RENCA                         ;METROPOLITANA;0;0;0;0;0;0;0;0;0;PACK 2 ALMOHADAS C+L;DORMITORIO
14134267;;M;41;CHILENO;;X;TALAGANTE                     ;METROPOLITANA;0;0;0;0;0;0;0;0;0;Colchon Resortes Evolution 1.5P + Almohada Imper;DORMITORIO
13535570;Soltero;F;43;CHILENO;;X;COQUIMBO                      ;COQUIMBO;0;0;0;0;0;0;0;0;0;Closet MAIPO 6PT 6CJ 180 CM CEREZO;DORMITORIO
10016120;;M;57;CHILENO;;Boomers;LAUTARO                       ;ARAUCANIA;0;0;0;0;0;0;0;0;0;COLCHON BAMBOO 1,5P FIBRAS BAMBOO;DORMITORIO
16798310;;F;34;CHILENO;;Millenial;QUILICURA                     ;METROPOLITANA;0;0;0;0;0;0;0;0;0;CE EVOLUTION BLACK 2P BD DUAL SIDE;DORMITORIO
18829146;;F;28;CHILENO;;Millenial;MAIPU                         ;METROPOLITANA;0;0;0;0;0;0;0;0;0;DUPLEX CE EVOLUTION BLACK 1P + 2 RESP + VEL ASTU;DORMITORIO
19435883;;F;25;CHILENO;;Z;N/D;N/D;0;0;0;0;0;0;0;0;0;Closet Austria 2013 6P2C 204x165x0,47;DORMITORIO
15810853;;F;38;CHILENO;;Millenial;N/D;N/D;0;0;0;0;0;0;0;0;0;CE EVOLUTION BLACK 1,5P BN DUAL SIDE;DORMITORIO
16032250;;F;37;CHILENO;;Millenial;PROVIDENCIA                   ;METROPOLITANA;0;0;0;0;0;0;0;0;0;Cama Europea Cannabis 1.5 plazas + Sabanas Imper;DORMITORIO
26364343;;F;37;VENEZOLANO;;Extranjero;TEMUCO                        ;ARAUCANIA;0;0;0;0;0;0;0;0;0;PACK 2 ALMOHADAS C+L;DORMITORIO
16237475;Viudo;F;36;CHILENO;TECNICO EN ENFERMERIA DE NIVEL SUPERIOR;Millenial;CASTRO                        ;LOS LAGOS;0;0;0;0;0;0;0;0;0;PACK 2 ALMOHADAS C+L;DORMITORIO
15434046;;M;39;CHILENO;;X;"";"";0;0;0;0;0;0;0;0;0;COLCHON IBIZA 2P;DORMITORIO
16134692;;M;36;CHILENO;;Millenial;ANTOFAGASTA;ANTOFAGASTA;0;0;0;0;0;0;0;0;0;CE EVOLUTION BLACK 1P + Vel + Resp ASTURIAS;DORMITORIO
14679370;;F;45;CHILENO;;Extranjero;PUDAHUEL                      ;METROPOLITANA;0;0;0;0;0;0;0;0;0;COLCHON SPRING III 1P;DORMITORIO
13085113;;F;45;CHILENO;;X;PUENTE ALTO                   ;METROPOLITANA;0;0;0;0;0;0;0;0;0;COLCHON IBIZA 2P;DORMITORIO
9459271;;M;60;CHILENO;;Boomers;ANGOL                         ;ARAUCANIA;0;0;0;0;0;0;0;0;0;CLOSET MARITTIMA 6P+2C;DORMITORIO
7352686;;M;67;CHILENO;;Boomers;PROVIDENCIA                   ;METROPOLITANA;0;0;0;0;0;0;0;0;0;CLOSET ARICA TV 32 M302 TEXTURADO;DORMITORIO
18231078;;F;30;CHILENO;;Millenial;PROVIDENCIA                   ;METROPOLITANA;0;0;0;0;0;0;0;0;0;RACK FRIZATO;DORMITORIO
15544727;Casado;M;38;CHILENO;;Millenial;NATALES                       ;MAGALLANES;0;0;0;0;0;0;0;0;0;COLCHON NEW ORTOPEDIC 1.80x2 MTS + CUBREC;DORMITORIO
16679339;Soltero;F;35;CHILENO;ENFERMERA;Millenial;PROVIDENCIA                   ;METROPOLITANA;0;0;0;0;0;0;0;0;0;CE EVOLUTION BLACK 1,5P + RESPALDO CASTILLA;DORMITORIO
19756600;;F;25;CHILENO;;Z;SAN ANTONIO                   ;VALPARAISO;0;0;0;0;0;0;0;0;0;Cama Europea Cannabis 1.5 plazas + Sabanas Imper;DORMITORIO
19311302;;M;27;CHILENO;;Millenial;"";"";0;0;0;0;0;0;0;0;0;COLCHON NEW ORTOPEDIC 1.50 x 2 MTS +2ALM;DORMITORIO
17800934;Soltero;M;30;CHILENO;;Millenial;PROVIDENCIA                   ;METROPOLITANA;0;0;0;0;0;0;0;0;0;BOX AMERICANO BEAT 2PBD;DORMITORIO
10993172;;F;43;CHILENO;;X;PROVIDENCIA                   ;METROPOLITANA;0;0;0;0;0;0;0;0;0;CE NEW ORTOPEDIC 2PBD;DORMITORIO
20362546;;F;22;CHILENO;;Z;PROVIDENCIA                   ;METROPOLITANA;0;0;0;0;0;0;0;0;0;Cama Europea Danubio 2P BD Comprimido;DORMITORIO
16563345;;F;35;CHILENO;;Millenial;VALDIVIA                      ;LOS RIOS;0;0;0;0;0;0;0;0;0;CE ORTOPEDIC ADVANCE 2PBN;DORMITORIO
16971859;Soltero;M;33;CHILENO;TECNICO EN INFORMATICA;Millenial;PROVIDENCIA                   ;METROPOLITANA;0;0;0;0;0;0;0;0;0;COLCHON THERAPEDIC 2P;DORMITORIO
19871566;;F;23;CHILENO;;Z;PROVIDENCIA                   ;METROPOLITANA;0;0;0;0;0;0;0;0;0;BOX AAMERICANO EXCELLENCE FULL;DORMITORIO
10727100;;F;54;CHILENO;;X;TALCAHUANO                    ;BIO BIO;0;0;0;0;0;0;0;0;0;COLCHON THERAPEDIC MAS 1,5P;DORMITORIO
16731417;;M;34;CHILENO;;Millenial;RENCA                         ;METROPOLITANA;0;0;0;0;0;0;0;0;0;COLCHON NEW STYLE 4 2P 150X200;DORMITORIO
19309119;;F;26;CHILENO;;Z;CONCHALI                      ;METROPOLITANA;0;0;0;0;0;0;0;0;0;CLOSET CAJONERA NEW BELGICA M-398-NW;DORMITORIO
13931944;;M;42;CHILENO;;X;QUINTA NORMAL                 ;METROPOLITANA;0;0;0;0;0;0;0;0;0;COLCHON EXCELLENCE PLUS 2 PLAZAS 2M + 2 ALM;DORMITORIO
19472720;;M;25;CHILENO;;Z;N/D;N/D;805470;3;2;2;1;405480;1;1;399990;Consola PlayStation 4 500GB;VIDEO JUEGOS
16286752;;M;35;CHILENO;;Millenial;CHILLAN                       ;BIO BIO;59990;1;1;1;1;59990;0;0;0;ACC CONTROL PS4 DUALSHOCK;VIDEO JUEGOS
19857959;;F;24;CHILENO;;Z;PROVIDENCIA                   ;METROPOLITANA;661980;2;1;2;1;661980;0;0;0;Consola PlayStation 5 con Disco;VIDEO JUEGOS
13174983;;M;45;CHILENO;;X;VALLENAR;ATACAMA;908305;11;7;0;0;0;11;7;908305;Consola PlayStation 4 500GB;VIDEO JUEGOS
13251364;;F;44;CHILENO;;X;N/D;N/D;511970;3;2;2;1;131980;1;1;379990;Consola PlayStation 4 500GB;VIDEO JUEGOS
18176266;;M;30;CHILENO;;Millenial;TALCA                         ;MAULE;559980;2;2;0;0;0;2;2;559980;Consola PlayStation 4 500GB;VIDEO JUEGOS
9946180;;F;49;CHILENO;;X;RENGO                         ;L.G.B.OÂ´HIGGINS;1119970;3;3;0;0;0;3;3;1119970;Consola PlayStation 5 con Disco (Internacional);VIDEO JUEGOS
11847306;;F;50;CHILENO;;X;RENCA                         ;METROPOLITANA;33980;2;1;2;1;33980;0;0;0;JUEGO SPIDER-MAN MILES MORALES - LATAM PS4;VIDEO JUEGOS
15868551;;M;37;CHILENO;;Millenial;N/D;N/D;457970;3;2;2;1;387980;1;1;69990;Consola PlayStation 4 500GB;VIDEO JUEGOS
17108829;;M;33;CHILENO;;Millenial;RENCA                         ;METROPOLITANA;33980;2;1;2;1;33980;0;0;0;JUEGO SWITCH Mario Kart 8 Deluxe;VIDEO JUEGOS
16562584;;M;35;CHILENO;;Millenial;N/D;N/D;684620;10;5;10;5;684620;0;0;0;Consola Xbox Series S 512GB;VIDEO JUEGOS
14215719;;F;40;CHILENO;;Millenial;"";"";419990;1;1;0;0;0;1;1;419990;Consola PlayStation 4 500GB;VIDEO JUEGOS
15582375;;M;38;CHILENO;;Millenial;QUELLON                       ;LOS LAGOS;574970;3;1;0;0;0;3;1;574970;Consola PlayStation 4 500GB;VIDEO JUEGOS
19219146;Soltero;M;26;CHILENO;;Z;PUENTE ALTO;METROPOLITANA;89960;4;2;4;2;89960;0;0;0;ACC CONTROL PS4 DUALSHOCK;VIDEO JUEGOS
9067800;;F;61;CHILENO;;Boomers;ESTACION CENTRAL              ;METROPOLITANA;3461460;22;12;0;0;0;22;12;3461460;Consola PlayStation 5 con Disco (Internacional);VIDEO JUEGOS
9822071;;F;58;CHILENO;;Boomers;PENALOLEN                     ;METROPOLITANA;399990;1;1;0;0;0;1;1;399990;Consola PlayStation 4 500GB;VIDEO JUEGOS
13919922;;M;42;CHILENO;;X;PADRE LAS CASAS               ;ARAUCANIA;693960;4;2;3;1;666970;1;1;26990;Consola PlayStation 5 con Disco (Internacional);VIDEO JUEGOS
18736991;;F;28;CHILENO;;Millenial;MAIPU                         ;METROPOLITANA;1545940;5;1;5;1;1545940;0;0;0;Consola PlayStation 5 con Disco;VIDEO JUEGOS
18573091;;F;28;CHILENO;;Millenial;"";"";436980;2;1;2;1;436980;0;0;0;Consola PlayStation 4 500GB;VIDEO JUEGOS
9365087;;F;61;CHILENO;;Boomers;QUILICURA                     ;METROPOLITANA;353980;2;1;2;1;353980;0;0;0;Consola PlayStation 4 500GB;VIDEO JUEGOS
11567293;;F;51;CHILENO;;X;PARRAL                        ;MAULE;47990;1;1;0;0;0;1;1;47990;JUEGO PS4 Spiderman;VIDEO JUEGOS
18263124;Casado;M;29;CHILENO;;Millenial;N/D;N/D;63980;2;1;2;1;63980;0;0;0;PS5 DUALSENSE COSMIC RED LATAM;VIDEO JUEGOS
20401564;;M;22;CHILENO;;Millenial;EL BOSQUE                     ;METROPOLITANA;28980;2;1;2;1;28980;0;0;0;JUEGO PS4 Spiderman;VIDEO JUEGOS
12921300;;F;47;CHILENO;;X;RENCA                         ;METROPOLITANA;479990;1;1;1;1;479990;0;0;0;Consola PlayStation 4 500GB;VIDEO JUEGOS
16703706;;M;35;CHILENO;;Millenial;ANTOFAGASTA                   ;ANTOFAGASTA;1046970;3;2;0;0;0;3;2;1046970;Consola PlayStation 5 con Disco (Internacional);VIDEO JUEGOS
12614179;;M;49;CHILENO;;Extranjero;N/D;N/D;2155940;6;1;0;0;0;6;1;2155940;Consola PlayStation 5 con Disco (Internacional);VIDEO JUEGOS
17321162;;F;32;CHILENO;;Millenial;N/D;N/D;42980;2;1;2;1;42980;0;0;0;JUEGO SWITCH Mario Kart 8 Deluxe;VIDEO JUEGOS
19358351;;F;21;CHILENO;;Z;QUILPUE                       ;VALPARAISO;199990;1;1;0;0;0;1;1;199990;CONSOLA SWITCH LITE TURQUOISE;VIDEO JUEGOS
18113265;;M;30;CHILENO;;Millenial;LOS ANDES;VALPARAISO;55970;3;2;2;1;42980;1;1;12990;JUEGO SW SWITCH POKEMON SHIELD;VIDEO JUEGOS
17769142;;M;31;CHILENO;;Millenial;SAN VICENTE                   ;L.G.B.OÂ´HIGGINS;369990;1;1;0;0;0;1;1;369990;HW SWITCH 1 1 NEON LT2 BUNDLE BLACK FRIDAY;VIDEO JUEGOS
12280720;;F;49;CHILENO;;X;HIJUELAS                      ;VALPARAISO;899990;1;1;0;0;0;1;1;899990;Consola PlayStation 5 con Disco (Internacional);VIDEO JUEGOS
16051224;;M;37;CHILENO;;Millenial;N/D;N/D;397980;2;1;0;0;0;2;1;397980;CONSOLA SWITCH LT2 NEON;VIDEO JUEGOS
13361756;;F;43;CHILENO;;X;N/D;N/D;554970;3;2;3;2;554970;0;0;0;CONSOLA SWITCH LT2 NEON;VIDEO JUEGOS
17336469;;F;32;CHILENO;;Millenial;N/D;N/D;75970;3;1;3;1;75970;0;0;0;SW SWITCH POKEMON BRILLIANT DIAMONT;VIDEO JUEGOS
19842934;;F;24;CHILENO;;Z;PROVIDENCIA                   ;METROPOLITANA;41980;2;1;2;1;41980;0;0;0;JUEGO SWITCH Mario Kart 8 Deluxe;VIDEO JUEGOS
11893543;;F;50;CHILENO;;X;LOS ANGELES                   ;BIO BIO;1175830;3;2;2;1;185840;1;1;989990;Consola PlayStation 5 con Disco (Internacional);VIDEO JUEGOS
18628363;Soltero;M;28;CHILENO;;Millenial;PROVIDENCIA                   ;METROPOLITANA;993980;2;1;2;1;993980;0;0;0;Consola PlayStation 5 con Disco (Internacional);VIDEO JUEGOS
19398118;;F;25;CHILENO;;Z;PROVIDENCIA                   ;METROPOLITANA;989990;1;1;1;1;989990;0;0;0;Consola PlayStation 5 con Disco (Internacional);VIDEO JUEGOS
14041566;;M;41;CHILENO;;X;ANCUD                         ;LOS LAGOS;889780;11;5;0;0;0;11;5;889780;CONSOLA SWITCH LITE TURQUOISE;VIDEO JUEGOS
18725540;;F;28;CHILENO;;Millenial;TALCAHUANO;BIO-BIO;97830;3;1;3;1;97830;0;0;0;PS5 DUALSENSE MIDNIGHT BLACK LATAM;VIDEO JUEGOS
19973498;;M;24;CHILENO;;Z;PROVIDENCIA                   ;METROPOLITANA;18980;2;1;2;1;18980;0;0;0;GRAND THEFT AUTO V PREMIUM EDITION - LATAM PS4;VIDEO JUEGOS
7257877;;F;69;CHILENO;;Silencioso;PROVIDENCIA                   ;METROPOLITANA;69960;3;1;3;1;69960;0;0;0;Control inalambrico Xbox + cable USB-C Negro;VIDEO JUEGOS
26231642;;F;41;COLOMBIANO;;Extranjero;N/D;N/D;293980;2;1;2;1;293980;0;0;0;Consola Xbox Series S 512GB;VIDEO JUEGOS
16913273;;M;33;CHILENO;;Millenial;PROVIDENCIA                   ;METROPOLITANA;25980;2;1;2;1;25980;0;0;0;JUEGO SWITCH FIFA 21;VIDEO JUEGOS
17411741;;M;32;CHILENO;;Millenial;MACUL                         ;METROPOLITANA;127960;3;1;3;1;127960;0;0;0;PS5 DUALSENSE;VIDEO JUEGOS
16448887;;F;35;CHILENO;;Millenial;RENCA                         ;METROPOLITANA;318540;2;1;2;1;318540;0;0;0;Consola Xbox Series S 512GB;VIDEO JUEGOS
17335393;Soltero;F;32;CHILENO;;Millenial;RENCA                         ;METROPOLITANA;27990;1;1;0;0;0;1;1;27990;Estuche protector Switch Folio;VIDEO JUEGOS
17436704;;F;32;CHILENO;;Millenial;PROVIDENCIA                   ;METROPOLITANA;0;0;0;0;0;0;0;0;0;CONSOLA SWITCH LITE + JUEGO ZELDA Link s Awakeni;VIDEO JUEGOS
14345332;;F;44;CHILENO;;Silencioso;PROVIDENCIA                   ;METROPOLITANA;0;0;0;0;0;0;0;0;0;CONSOLA SWITCH LT2 NEON;VIDEO JUEGOS
15964774;;M;37;CHILENO;;Millenial;"";"";0;0;0;0;0;0;0;0;0;JUEGO SW SWITCH LUIGIS MANSION 3;VIDEO JUEGOS
19707803;;M;29;CHILENO;;Silencioso;PROVIDENCIA                   ;METROPOLITANA;0;0;0;0;0;0;0;0;0;Consola PlayStation 5 con Disco;VIDEO JUEGOS
16787375;Soltero;M;34;CHILENO;INGENIERIA EN MAQUINARIA VEHICULOS AUTOMOTRICES Y SISTEMAS ELECTRONICOS;Millenial;PROVIDENCIA                   ;METROPOLITANA;0;0;0;0;0;0;0;0;0;CONSOLA SWITCH LITE YELLOW;VIDEO JUEGOS
9734394;;M;58;CHILENO;;Boomers;RENCA                         ;METROPOLITANA;0;0;0;0;0;0;0;0;0;Consola PlayStation 5 con Disco;VIDEO JUEGOS
13047872;;F;46;CHILENO;;X;PROVIDENCIA                   ;METROPOLITANA;0;0;0;0;0;0;0;0;0;PS4 HW 1TB MEGA 18 - R C, GOT, GOW BNDL;VIDEO JUEGOS
18516878;Soltero;M;29;CHILENO;;Millenial;PROVIDENCIA                   ;METROPOLITANA;0;0;0;0;0;0;0;0;0;Consola Xbox Series S 512GB;VIDEO JUEGOS
18990597;Soltero;M;27;CHILENO;;Silencioso;PROVIDENCIA                   ;METROPOLITANA;0;0;0;0;0;0;0;0;0;PS5 DUALSENSE;VIDEO JUEGOS
15405214;Casado;F;39;CHILENO;;X;PROVIDENCIA                   ;METROPOLITANA;0;0;0;0;0;0;0;0;0;Consola Xbox Series S 512GB;VIDEO JUEGOS
20402148;;M;22;CHILENO;;Silencioso;PROVIDENCIA                   ;METROPOLITANA;0;0;0;0;0;0;0;0;0;ACC CONTROL PS4 DUALSHOCK;VIDEO JUEGOS
12611864;;F;48;CHILENO;;X;IQUIQUE                       ;TARAPACA;0;0;0;0;0;0;0;0;0;ACC CONTROL PS4 DUALSHOCK;VIDEO JUEGOS
20142198;;F;22;CHILENO;;Silencioso;PROVIDENCIA                   ;METROPOLITANA;0;0;0;0;0;0;0;0;0;PS4 HW 1TB MEGA 15 - SPDMN GOTY, R C, HZDCE BNDL;VIDEO JUEGOS
20574505;;F;21;CHILENO;;Z;"";"";0;0;0;0;0;0;0;0;0;CONTROL PS4 Midnight Blue;VIDEO JUEGOS
19812377;;M;24;CHILENO;;Silencioso;PROVIDENCIA                   ;METROPOLITANA;0;0;0;0;0;0;0;0;0;JUEGO THE LAST OF US 2 - LATAM PS4;VIDEO JUEGOS
7573411;;M;65;CHILENO;;Boomers;LO ESPEJO                     ;METROPOLITANA;0;0;0;0;0;0;0;0;0;PS4 HW 1TB MEGA 15 - SPDMN GOTY, R C, HZDCE BNDL;VIDEO JUEGOS
12684176;;F;48;CHILENO;;X;PROVIDENCIA                   ;METROPOLITANA;0;0;0;0;0;0;0;0;0;CONSOLA PS4 HW 1TB MEGA 13 - GTAVPE, DS GOW;VIDEO JUEGOS
14312901;;F;45;CHILENO;;X;RENCA                         ;METROPOLITANA;0;0;0;0;0;0;0;0;0;Consola PlayStation 5 con Disco;VIDEO JUEGOS
7208590;;M;67;CHILENO;;Boomers;N/D;N/D;0;0;0;0;0;0;0;0;0;JUEGO FIFA 21 PS4;VIDEO JUEGOS
9675341;;M;57;CHILENO;;Boomers;RENCA                         ;METROPOLITANA;0;0;0;0;0;0;0;0;0;MINI ARCADE PANTALLA 2,4;VIDEO JUEGOS
18673789;;F;28;CHILENO;;Millenial;PUENTE ALTO                   ;METROPOLITANA;0;0;0;0;0;0;0;0;0;PS4 SLIM 1TB MEGAPACK HIT 13;VIDEO JUEGOS
16858818;;F;34;CHILENO;;Millenial;CURICO                        ;MAULE;0;0;0;0;0;0;0;0;0;PS4 SLIM 1TB MEGAPACK HIT 13;VIDEO JUEGOS
10270584;;M;57;CHILENO;;Boomers;SAN FELIPE                    ;VALPARAISO;0;0;0;0;0;0;0;0;0;PS4 SLIM 1TB MEGAPACK HIT 13;VIDEO JUEGOS
12961786;;M;46;CHILENO;;X;N/D;N/D;0;0;0;0;0;0;0;0;0;JUEGO SWITCH Animal Crossing;VIDEO JUEGOS
17071594;Soltero;M;33;CHILENO;;Millenial;RENCA                         ;METROPOLITANA;0;0;0;0;0;0;0;0;0;Control inalambrico + cable USB-C Negro;VIDEO JUEGOS
17599493;Casado;M;31;CHILENO;;Millenial;PROVIDENCIA                   ;METROPOLITANA;0;0;0;0;0;0;0;0;0;Control Inalambrico Robot White;VIDEO JUEGOS
16328569;Soltero;M;36;CHILENO;;Millenial;PROVIDENCIA                   ;METROPOLITANA;0;0;0;0;0;0;0;0;0;CONSOLA PS4 1TB MEGA 6 3 Juegos 3M PS Plus;VIDEO JUEGOS
17589807;Soltero;M;32;CHILENO;INGENIERO INFORMATICO;Millenial;PROVIDENCIA                   ;METROPOLITANA;0;0;0;0;0;0;0;0;0;JUEGO GHOST OF TSUSHIMA - LATAM PS4;VIDEO JUEGOS
12713386;Casado;M;48;CHILENO;;X;RENCA                         ;METROPOLITANA;0;0;0;0;0;0;0;0;0;CONSOLA PS4 Slim 1TB;VIDEO JUEGOS
18991657;;F;27;CHILENO;;Millenial;PROVIDENCIA                   ;METROPOLITANA;0;0;0;0;0;0;0;0;0;CONSOLA PS4 1TB MEGA 6 3 Juegos 3M PS Plus;VIDEO JUEGOS
17533327;Casado;M;32;CHILENO;INGENIERO CIVIL EN MINAS;Millenial;PROVIDENCIA                   ;METROPOLITANA;0;0;0;0;0;0;0;0;0;JUEGO THE LAST OF US 2 - LATAM PS4;VIDEO JUEGOS
9026441;;F;62;CHILENO;;Boomers;RENCA                         ;METROPOLITANA;0;0;0;0;0;0;0;0;0;ACC CONTROL PS4 DUALSHOCK;VIDEO JUEGOS
13303618;;M;45;CHILENO;;X;RENCA                         ;METROPOLITANA;0;0;0;0;0;0;0;0;0;CONSOLA PS4 1TB MEGA 6 3 Juegos 3M PS Plus;VIDEO JUEGOS
17088287;;F;33;CHILENO;;Z;N/D;N/D;0;0;0;0;0;0;0;0;0;JUEGO SW SWITCH POKEMON SWORD;VIDEO JUEGOS
6770267;Casado;M;67;CHILENO;INGENIERO CIVIL;Boomers;PROVIDENCIA                   ;METROPOLITANA;0;0;0;0;0;0;0;0;0;JUEGO SWITCH Super Mario Party;VIDEO JUEGOS
6195230;Casado;M;73;CHILENO;;Silencioso;RENCA                         ;METROPOLITANA;0;0;0;0;0;0;0;0;0;ACC JOY CON L R NEON PURPLE NEON ORANGE;VIDEO JUEGOS
18456764;;F;29;CHILENO;;Millenial;PUDAHUEL                      ;METROPOLITANA;0;0;0;0;0;0;0;0;0;CONSOLA SWITCH LITE + JUEGO ZELDA Link s Awakeni;VIDEO JUEGOS
17954553;Soltero;F;31;CHILENO;PSICOLOGA;Millenial;PROVIDENCIA                   ;METROPOLITANA;0;0;0;0;0;0;0;0;0;TV VIDEO GAME - WHITE COLOR;VIDEO JUEGOS
26821925;Soltero;F;49;NO INFORMA NACIONALIDAD;;Extranjero;SANTIAGO                      ;METROPOLITANA;0;0;2;0;0;0;0;2;0;Asistencia Salud Integral Familia;GARANTIAS
10037353;;F;56;CHILENO;;Boomers;SAN FELIPE                    ;VALPARAISO;132260;5;3;0;0;0;5;3;132260;Asistencia Programa Domiciliario;GARANTIAS
15934693;;F;37;CHILENO;;Millenial;RENGO                         ;L.G.B.OÂ´HIGGINS;16562;2;1;0;0;0;2;1;16562;GM 1A X CTA SBI;GARANTIAS
14377778;;F;44;CHILENO;;X;GRANEROS                      ;L.G.B.OÂ´HIGGINS;379962;4;5;0;0;0;4;5;379962;Asistencia Salud Integral Familia;GARANTIAS
26206977;;M;37;VENEZOLANO;;Extranjero;VILCUN                        ;ARAUCANIA;52990;1;1;0;0;0;1;1;52990;Asistencia Salud Integral Familia;GARANTIAS
6855843;;F;72;CHILENO;;Silencioso;SANTA CRUZ                    ;L.G.B.OÂ´HIGGINS;105980;2;2;0;0;0;2;2;105980;Asistencia Salud Integral Familia;GARANTIAS
9105862;;F;60;CHILENO;;Boomers;RANCAGUA                      ;L.G.B.OÂ´HIGGINS;715260;10;5;0;0;0;10;5;715260;ASIST. FULL HOGAR Y AUTO INGRAL;GARANTIAS
6233120;;F;77;CHILENO;;Silencioso;N/D;N/D;939430;15;8;12;6;780460;3;2;158970;Asistencia Salud Integral Familia;GARANTIAS
18821650;Soltero;F;27;CHILENO;;Z;N/D;N/D;52990;1;1;0;0;0;1;1;52990;Asistencia Salud Integral Familia;GARANTIAS
8215618;;F;65;CHILENO;;Boomers;QUILLOTA                      ;VALPARAISO;52990;1;1;0;0;0;1;1;52990;ASIST. FULL HOGAR Y AUTO INGRAL;GARANTIAS
6433262;;M;70;CHILENO;;Silencioso;PROVIDENCIA                   ;METROPOLITANA;0;0;2;0;0;0;0;2;0;Asistencia Salud Integral Familia;GARANTIAS
12523188;;M;48;CHILENO;;X;TALCA                         ;MAULE;882370;6;3;0;0;0;6;3;882370;Asistencia Salud Integral Familia;GARANTIAS
14272283;;F;48;CHILENO;;X;SAN PEDRO DE LA PAZ           ;BIO BIO;181930;7;6;0;0;0;7;6;181930;Asistencia Salud Integral Familia;GARANTIAS
8563424;;F;62;CHILENO;;Boomers;PAPUDO                        ;VALPARAISO;239640;5;4;0;0;0;5;4;239640;Asistencia Salud Integral Familia;GARANTIAS
10469037;;F;59;CHILENO;;Boomers;OVALLE                        ;COQUIMBO;238940;6;3;0;0;0;6;3;238940;Asistencia Programa Domiciliario;GARANTIAS
6643076;;F;68;CHILENO;;Boomers;HUALPEN;BIO BIO;105980;2;2;0;0;0;2;2;105980;Asistencia Programa Domiciliario;GARANTIAS
6733836;;F;71;CHILENO;;Silencioso;SAN RAMON                     ;METROPOLITANA;52990;1;1;0;0;0;1;1;52990;Asistencia Programa Domiciliario;GARANTIAS
11431942;;M;52;CHILENO;;X;PROVIDENCIA                   ;METROPOLITANA;103980;2;1;0;0;0;2;1;103980;Asistencia Salud Integral Familia;GARANTIAS
12630079;;F;48;CHILENO;;X;MELIPILLA                     ;METROPOLITANA;141463;6;3;0;0;0;6;3;141463;Asistencia Salud Integral Familia;GARANTIAS
17741549;;F;32;CHILENO;;Millenial;OSORNO                        ;LOS LAGOS;52990;1;1;0;0;0;1;1;52990;Asistencia Salud Integral Familia;GARANTIAS
12261942;;M;50;CHILENO;;X;LAMPA;METROPOLITANA;226960;4;7;1;1;99990;3;6;126970;Asistencia Salud Integral Familia;GARANTIAS
8953924;;F;63;CHILENO;;Boomers;N/D;N/D;877690;10;12;0;0;0;10;12;877690;Asistencia Salud Integral Familia;GARANTIAS
26309939;;M;50;EXTRANJERO - NO INFORMA NACIONALIDAD;;Extranjero;N/D;N/D;352980;2;2;0;0;0;2;2;352980;Asistencia Salud Integral Familia;GARANTIAS
6256250;;F;69;CHILENO;;Silencioso;BUIN                          ;METROPOLITANA;514660;9;5;0;0;0;9;5;514660;Asistencia Salud Integral Familia;GARANTIAS
11761329;;M;51;CHILENO;;X;NANCAGUA                      ;L.G.B.OÂ´HIGGINS;2541170;22;14;0;0;0;22;14;2541170;Asistencia Salud Integral Familia;GARANTIAS
10043818;;F;58;CHILENO;;Boomers;CONCEPCION                    ;BIO BIO;72980;2;2;0;0;0;2;2;72980;Asistencia Salud Integral Familia;GARANTIAS
24419738;;M;31;COLOMBIANO;;Millenial;"";"";52990;1;1;0;0;0;1;1;52990;Asistencia Salud Integral Familia;GARANTIAS
12001558;;F;55;CHILENO;;Boomers;RANCAGUA                      ;L.G.B.OÂ´HIGGINS;539930;7;5;0;0;0;7;5;539930;Asistencia Salud Integral Familia;GARANTIAS
7863703;;F;66;CHILENO;;Boomers;MELIPILLA                     ;METROPOLITANA;317940;6;6;0;0;0;6;6;317940;Asistencia Programa Domiciliario;GARANTIAS
18859883;;M;26;CHILENO;;Z;TILTIL                        ;METROPOLITANA;52990;1;1;0;0;0;1;1;52990;Asistencia Salud Integral Familia;GARANTIAS
27052259;;M;27;VENEZOLANO;;Z;"";"";52990;1;1;0;0;0;1;1;52990;Asistencia Salud Integral Familia;GARANTIAS
13535575;;F;43;CHILENO;;X;OVALLE                        ;COQUIMBO;769001;10;5;0;0;0;10;5;769001;Asistencia Salud Integral Familia;GARANTIAS
16410949;;M;35;CHILENO;;Millenial;LA PINTANA                    ;METROPOLITANA;52990;1;1;0;0;0;1;1;52990;Asistencia Salud Integral Familia;GARANTIAS
7089509;;F;69;CHILENO;;Silencioso;VALDIVIA                      ;LOS LAGOS;328970;3;2;0;0;0;3;2;328970;Asistencia Salud Integral Familia;GARANTIAS
7168386;;F;68;CHILENO;;Silencioso;LAS CABRAS                    ;L.G.B.OÂ´HIGGINS;795579;9;6;0;0;0;9;6;795579;Asistencia Programa Domiciliario;GARANTIAS
22606844;;F;50;PERUANO;;Extranjero;SANTIAGO                      ;METROPOLITANA;211960;4;4;0;0;0;4;4;211960;Asistencia Salud Integral Familia;GARANTIAS
5104852;;F;77;CHILENO;;Silencioso;PROVIDENCIA                   ;METROPOLITANA;86970;3;2;0;0;0;3;2;86970;Asistencia Salud Integral Familia;GARANTIAS
26503901;;F;36;EXTRANJERO - NO INFORMA NACIONALIDAD;;Extranjero;N/D;N/D;124862;3;3;0;0;0;3;3;124862;Asistencia Programa Domiciliario;GARANTIAS
12250988;;F;50;CHILENO;;X;LA GRANJA                     ;METROPOLITANA;52990;1;1;0;0;0;1;1;52990;Asistencia Salud Integral Familia;GARANTIAS
16223034;;M;36;CHILENO;;Millenial;VALPARAISO                    ;VALPARAISO;99990;1;3;1;1;99990;0;2;0;Asistencia Salud Integral Familia;GARANTIAS
11556593;;M;52;CHILENO;;X;CHEPICA                       ;L.G.B.OÂ´HIGGINS;105980;2;1;0;0;0;2;1;105980;Asistencia Salud Integral Familia;GARANTIAS
11378725;;F;53;CHILENO;;X;ANTOFAGASTA                   ;ANTOFAGASTA;255970;3;2;0;0;0;3;2;255970;Asistencia Salud Integral Familia;GARANTIAS
8928449;;F;63;CHILENO;;Boomers;TALCA                         ;MAULE;105980;2;1;0;0;0;2;1;105980;Asistencia Programa Domiciliario;GARANTIAS
11696781;;F;53;CHILENO;;X;MELIPILLA                     ;METROPOLITANA;629910;7;3;0;0;0;7;3;629910;ASIST. FULL HOGAR Y AUTO INGRAL;GARANTIAS
8761421;;F;62;CHILENO;;Boomers;ANTOFAGASTA                   ;ANTOFAGASTA;116970;3;1;0;0;0;3;1;116970;Asistencia Programa Domiciliario;GARANTIAS
10400442;;M;55;CHILENO;;Boomers;VALLENAR;ATACAMA;356920;8;6;0;0;0;8;6;356920;Asistencia Salud Integral Familia;GARANTIAS
9434846;;F;62;CHILENO;;Boomers;N/D;N/D;207980;2;2;0;0;0;2;2;207980;Asistencia Salud Integral Familia;GARANTIAS
24687943;Soltero;F;26;PERUANO;;Extranjero;"";"";52990;1;1;0;0;0;1;1;52990;Asistencia Programa Domiciliario;GARANTIAS
9454360;;F;59;CHILENO;;Boomers;CORONEL                       ;BIO BIO;406960;4;5;0;0;0;4;5;406960;Asistencia Salud Integral Familia;GARANTIAS
22554886;;F;45;PERUANO;;Extranjero;N/D;N/D;732960;4;3;0;0;0;4;3;732960;Asistencia Programa Domiciliario;GARANTIAS
11330209;;M;54;CHILENO;;X;QUILPUE                       ;VALPARAISO;52990;1;1;0;0;0;1;1;52990;Asistencia Salud Integral Familia;GARANTIAS
5512895;;F;78;CHILENO;;Silencioso;N/D;N/D;52990;1;1;0;0;0;1;1;52990;Asistencia Programa Domiciliario;GARANTIAS
18407606;;F;28;CHILENO;;Millenial;CONCHALI                      ;METROPOLITANA;52990;1;1;0;0;0;1;1;52990;Asistencia Salud Integral Familia;GARANTIAS
19509904;;F;25;CHILENO;;Z;"";"";608960;7;7;6;5;608950;1;2;10;Asistencia Salud Integral Familia;GARANTIAS
25932844;;F;30;VENEZOLANO;;Extranjero;"";"";34990;1;3;0;0;0;1;3;34990;Asistencia Salud Integral Familia;GARANTIAS
12556524;;M;47;CHILENO;;Millenial;ARAUCO                        ;BIO BIO;17990;2;1;0;0;0;2;1;17990;GM 1A X CTA SBI;GARANTIAS
13325570;;F;45;CHILENO;;X;NATALES                       ;MAGALLANES;2280370;12;6;0;0;0;12;6;2280370;GM 1A X CTA SBI;GARANTIAS
15919583;;M;37;CHILENO;;Millenial;TALAGANTE                     ;METROPOLITANA;806670;14;3;0;0;0;14;3;806670;Asistencia Salud Integral Familia;GARANTIAS
27073656;;F;25;EXTRANJERO - NO INFORMA NACIONALIDAD;;Extranjero;"";"";52990;1;1;0;0;0;1;1;52990;Asistencia Programa Domiciliario;GARANTIAS
17839305;;F;30;CHILENO;;Millenial;CONTULMO                      ;BIO BIO;97970;3;3;1;1;24990;2;2;72980;Asistencia Salud Integral Familia;GARANTIAS
25021269;;M;28;PERUANO;;Extranjero;N/D;N/D;1288890;13;5;0;0;0;13;5;1288890;Asistencia de Mascotas;GARANTIAS
17167100;;M;33;CHILENO;;Millenial;MAIPU;METROPOLITANA;192970;3;2;2;1;139980;1;1;52990;Asistencia Programa Domiciliario;GARANTIAS
13348652;;F;44;CHILENO;;X;N/D;N/D;268920;6;5;0;0;0;6;5;268920;Asistencia Salud Integral Familia;GARANTIAS
9019403;;M;60;CHILENO;;Boomers;BUIN                          ;METROPOLITANA;52990;1;1;0;0;0;1;1;52990;Asistencia Salud Integral Familia;GARANTIAS
17819114;;F;30;CHILENO;;Millenial;LOS ANDES;VALPARAISO;0;0;2;0;0;0;0;2;0;Asistencia Salud Integral Familia;GARANTIAS
6987957;;M;58;CHILENO;;Boomers;PROVIDENCIA                   ;METROPOLITANA;214560;2;2;1;1;169990;1;1;44570;GM 1A X CTA SBI;GARANTIAS
7994469;;F;67;CHILENO;;Boomers;PENAFLOR                      ;METROPOLITANA;432980;2;4;0;0;0;2;4;432980;Asistencia Programa Domiciliario;GARANTIAS
9501366;;F;60;CHILENO;;Boomers;CERRO NAVIA                   ;METROPOLITANA;187200;6;4;0;0;0;6;4;187200;Asistencia Salud Integral Familia;GARANTIAS
10603771;;M;56;CHILENO;;Boomers;PROVIDENCIA                   ;METROPOLITANA;52990;1;1;0;0;0;1;1;52990;Asistencia Salud Integral Familia;GARANTIAS
17242437;;F;36;CHILENO;;Millenial;PENALOLEN;METROPOLITANA;138940;6;3;5;2;85950;1;1;52990;Asistencia Salud Integral Familia;GARANTIAS
10655182;;F;51;CHILENO;;X;TEMUCO                        ;ARAUCANIA;95800;4;2;0;0;0;4;2;95800;GPL 1A X CTA SBI;GARANTIAS
9566729;;F;61;CHILENO;;Boomers;PUERTO MONTT                  ;LOS LAGOS;105980;2;2;0;0;0;2;2;105980;Asistencia Programa Domiciliario;GARANTIAS
10394231;;F;58;CHILENO;;Boomers;N/D;N/D;345960;4;3;0;0;0;4;3;345960;Asistencia Salud Integral Familia;GARANTIAS
14449189;;F;51;CHILENO;;X;PLACILLA                      ;L.G.B.OÂ´HIGGINS;52990;1;1;0;0;0;1;1;52990;Asistencia Salud Integral Familia;GARANTIAS
7227266;;F;69;CHILENO;;Silencioso;N/D;N/D;52990;1;1;0;0;0;1;1;52990;Asistencia Salud Integral Familia;GARANTIAS
7739507;;M;65;CHILENO;;Boomers;OVALLE                        ;COQUIMBO;52990;1;1;0;0;0;1;1;52990;Asistencia Salud Integral Familia;GARANTIAS
8167922;;F;65;CHILENO;;Boomers;MULCHEN                       ;BIO BIO;884921;9;5;0;0;0;9;5;884921;Asistencia Salud Integral Familia;GARANTIAS
9944537;;F;59;CHILENO;;Boomers;ARICA                         ;ARICA Y PARINACOTA;52990;1;1;0;0;0;1;1;52990;Asistencia Salud Integral Familia;GARANTIAS
3562574;;F;85;CHILENO;;Silencioso;ARICA                         ;TARAPACA;218060;3;3;0;0;0;3;3;218060;Asistencia Salud Integral Familia;GARANTIAS
7296665;;M;69;CHILENO;;Silencioso;N/D;N/D;458960;4;2;0;0;0;4;2;458960;Asistencia Salud Integral Familia;GARANTIAS
6535791;;F;68;CHILENO;;Silencioso;MELIPILLA                     ;METROPOLITANA;52990;1;1;0;0;0;1;1;52990;ASIST. FULL HOGAR Y AUTO INGRAL;GARANTIAS
13620510;;F;43;CHILENO;;X;PROVIDENCIA                   ;METROPOLITANA;62990;3;2;0;0;0;3;2;62990;Asistencia Programa Domiciliario;GARANTIAS
14545394;;F;48;CHILENO;;X;N/D;N/D;45041;1;1;0;0;0;1;1;45041;Asistencia Salud Integral Familia;GARANTIAS
11810273;;M;50;CHILENO;;X;N/D;N/D;502850;4;2;0;0;0;4;2;502850;Asistencia Salud Integral Familia;GARANTIAS
4836197;;F;74;CHILENO;;Silencioso;CORONEL                       ;BIO BIO;52990;1;1;0;0;0;1;1;52990;Asistencia Salud Integral Familia;GARANTIAS
14354681;;F;43;CHILENO;;X;TALCAHUANO                    ;BIO BIO;397970;5;3;0;0;0;5;3;397970;Asistencia Programa Domiciliario;GARANTIAS
12316671;;M;52;CHILENO;;X;CHANCO                        ;MAULE;80970;3;3;0;0;0;3;3;80970;Asistencia Salud Integral Familia;GARANTIAS
8136775;;M;63;CHILENO;;Boomers;CAUQUENES                     ;MAULE;442214;7;4;0;0;0;7;4;442214;GM 1A X CTA SBI;GARANTIAS
18438927;Soltero;F;29;CHILENO;TECNICO DE NIVEL SUPERIOR EN ENFERMERIA;Millenial;PROVIDENCIA                   ;METROPOLITANA;16370;2;1;0;0;0;2;1;16370;GM 1A X CTA SBI;GARANTIAS
11367079;;F;53;CHILENO;;X;SAN FERNANDO                  ;L.G.B.OÂ´HIGGINS;533930;5;4;0;0;0;5;4;533930;Asistencia Salud Integral Familia;GARANTIAS
8329690;;M;62;CHILENO;;Boomers;TALCA                         ;MAULE;792800;9;4;0;0;0;9;4;792800;Asistencia de Mascotas;GARANTIAS
5875539;;M;70;CHILENO;;Silencioso;ROMERAL                       ;MAULE;52990;1;1;0;0;0;1;1;52990;ASIST. FULL HOGAR Y AUTO INGRAL;GARANTIAS
11356836;;M;54;CHILENO;;X;PUERTO MONTT                  ;LOS LAGOS;52990;1;1;0;0;0;1;1;52990;Asistencia Programa Domiciliario;GARANTIAS
9108767;;F;61;CHILENO;;Boomers;ANTOFAGASTA                   ;ANTOFAGASTA;41040;3;1;0;0;0;3;1;41040;GPL 1A X CTA SBI;GARANTIAS
11583958;;F;51;CHILENO;;X;MULCHEN                       ;BIO BIO;718850;4;2;0;0;0;4;2;718850;Asistencia Programa Domiciliario;GARANTIAS
9400931;;F;60;CHILENO;;Boomers;PUENTE ALTO                   ;METROPOLITANA;803930;7;4;0;0;0;7;4;803930;Asistencia de Mascotas;GARANTIAS
9447008;;F;58;CHILENO;;Boomers;LA PINTANA                    ;METROPOLITANA;52990;1;1;0;0;0;1;1;52990;ASIST. FULL HOGAR Y AUTO INGRAL;GARANTIAS
10742162;;F;56;CHILENO;;Boomers;ILLAPEL                       ;COQUIMBO;94990;1;3;0;0;0;1;3;94990;GM 1A X CTA SBI;GARANTIAS
22225004;;M;39;PERUANO;;Extranjero;IQUIQUE                       ;TARAPACA;490970;3;2;0;0;0;3;2;490970;Asistencia Salud Integral Familia;GARANTIAS
10478945;;M;55;CHILENO;;Boomers;PAINE                         ;METROPOLITANA;1045890;11;4;0;0;0;11;4;1045890;Asistencia Salud Integral Familia;GARANTIAS
8650068;;M;60;CHILENO;;Boomers;NATALES                       ;MAGALLANES;1164940;6;4;0;0;0;6;4;1164940;ASIST. FULL HOGAR Y AUTO INGRAL;GARANTIAS
15798238;;M;38;CHILENO;;Millenial;BUIN;METROPOLITANA;52990;1;1;0;0;0;1;1;52990;Asistencia Programa Domiciliario;GARANTIAS
25898048;;F;36;NO INFORMA NACIONALIDAD;;Extranjero;SANTIAGO;METROPOLITANA;575910;6;2;5;1;522920;1;1;52990;Asistencia Programa Domiciliario;GARANTIAS
10856191;;M;55;CHILENO;;Boomers;PARRAL                        ;MAULE;162470;3;2;0;0;0;3;2;162470;Asistencia Salud Integral Familia;GARANTIAS
9297722;;F;60;CHILENO;;Boomers;PUENTE ALTO                   ;METROPOLITANA;372960;4;4;0;0;0;4;4;372960;ASIST. FULL HOGAR Y AUTO INGRAL;GARANTIAS
9803449;;F;58;CHILENO;;Boomers;LA LIGUA                      ;VALPARAISO;915710;7;3;0;0;0;7;3;915710;ASIST. FULL HOGAR Y AUTO INGRAL;GARANTIAS
8228736;;M;63;CHILENO;;Boomers;CURANILAHUE                   ;BIO BIO;751930;7;5;0;0;0;7;5;751930;Asistencia Programa Domiciliario;GARANTIAS
12002691;;M;51;CHILENO;;X;N/D;N/D;52990;1;1;0;0;0;1;1;52990;Asistencia Programa Domiciliario;GARANTIAS
15157381;;M;37;CHILENO;;Millenial;HUECHURABA                    ;METROPOLITANA;52990;1;1;0;0;0;1;1;52990;Asistencia Salud Integral Familia;GARANTIAS
9188114;;F;60;CHILENO;;Boomers;QUILICURA                     ;METROPOLITANA;52990;1;1;0;0;0;1;1;52990;Asistencia Salud Integral Familia;GARANTIAS
18498503;;F;28;CHILENO;;Millenial;PENALOLEN;METROPOLITANA;52990;1;1;0;0;0;1;1;52990;Asistencia Programa Domiciliario;GARANTIAS
22868700;;F;29;CHILENO;;Extranjero;SAN MIGUEL                    ;METROPOLITANA;357470;7;2;0;0;0;7;2;357470;GM 1A X CTA SBI;GARANTIAS
8441537;;M;63;CHILENO;;Boomers;CHIGUAYANTE                   ;BIO BIO;52990;1;1;0;0;0;1;1;52990;Asistencia Salud Integral Familia;GARANTIAS
7672734;;F;66;CHILENO;;Boomers;COPIAPO                       ;ATACAMA;89990;2;3;0;0;0;2;3;89990;GM 1A X CTA SBI;GARANTIAS
9700158;;F;60;CHILENO;;Boomers;SANTA BARBARA                 ;BIO BIO;211960;4;1;0;0;0;4;1;211960;Asistencia Salud Integral Familia;GARANTIAS
16001970;;M;37;CHILENO;;Millenial;N/D;N/D;59980;3;2;0;0;0;3;2;59980;ASIST. FULL HOGAR Y AUTO INGRAL;GARANTIAS
9735541;;F;65;CHILENO;;Boomers;IQUIQUE                       ;TARAPACA;52990;1;1;0;0;0;1;1;52990;Asistencia de Mascotas;GARANTIAS
5115257;;M;77;CHILENO;;Silencioso;RENCA                         ;METROPOLITANA;0;0;2;0;0;0;0;2;0;GM 1A X CTA SBI;GARANTIAS
9556043;;F;60;CHILENO;;Boomers;SAN FELIPE                    ;VALPARAISO;515050;4;3;0;0;0;4;3;515050;Asistencia Salud Integral Familia;GARANTIAS
11699659;;F;50;CHILENO;;X;LOS ANGELES                   ;BIO BIO;165970;3;2;0;0;0;3;2;165970;Asistencia Salud Integral Familia;GARANTIAS
8559556;;M;57;CHILENO;;Boomers;N/D;N/D;111822;5;3;0;0;0;5;3;111822;ASIST. FULL HOGAR Y AUTO INGRAL;GARANTIAS
16438182;;F;40;CHILENO;;X;ANTOFAGASTA                   ;ANTOFAGASTA;52990;1;1;0;0;0;1;1;52990;Asistencia Salud Integral Familia;GARANTIAS
7145155;;M;70;CHILENO;;Silencioso;CHIMBARONGO                   ;L.G.B.OÂ´HIGGINS;211960;4;1;0;0;0;4;1;211960;Asistencia de Mascotas;GARANTIAS
12745834;;F;47;CHILENO;;X;PANGUIPULLI                   ;LOS RIOS;149970;3;2;0;0;0;3;2;149970;Asistencia Salud Integral Familia;GARANTIAS
18047891;;F;30;CHILENO;;Millenial;LAS CONDES;METROPOLITANA;0;0;2;0;0;0;0;2;0;Asistencia Programa Domiciliario;GARANTIAS
14046898;;M;41;CHILENO;;X;EL MONTE                      ;METROPOLITANA;388430;5;3;0;0;0;5;3;388430;Asistencia Programa Domiciliario;GARANTIAS
19295923;;F;26;CHILENO;;Z;PROVIDENCIA                   ;METROPOLITANA;155470;5;2;0;0;0;5;2;155470;GM 1A X CTA SBI;GARANTIAS
11421336;;F;53;CHILENO;;X;PROVIDENCIA                   ;METROPOLITANA;199990;1;3;0;0;0;1;3;199990;Asistencia Salud Integral Familia;GARANTIAS
20077630;;M;23;CHILENO;;Z;CHILLAN                       ;BIO BIO;100870;2;2;0;0;0;2;2;100870;Asistencia Salud Integral Familia;GARANTIAS
15770126;;F;37;CHILENO;;Millenial;"";"";52990;1;1;0;0;0;1;1;52990;Asistencia Programa Domiciliario;GARANTIAS
7994973;;F;63;CHILENO;;Boomers;SAN BERNARDO                  ;METROPOLITANA;52990;1;1;0;0;0;1;1;52990;Asistencia Salud Integral Familia;GARANTIAS
15408138;;F;39;CHILENO;;X;N/D;N/D;497960;4;3;0;0;0;4;3;497960;Asistencia Programa Domiciliario;GARANTIAS
5938793;;F;74;CHILENO;;Silencioso;PUTAENDO                      ;VALPARAISO;52990;1;1;0;0;0;1;1;52990;Asistencia Salud Integral Familia;GARANTIAS
15653991;;F;40;CHILENO;;X;N/D;N/D;52990;1;1;0;0;0;1;1;52990;Asistencia Salud Integral Familia;GARANTIAS
9590114;;M;60;CHILENO;;Boomers;TALCA                         ;MAULE;185970;3;2;0;0;0;3;2;185970;Asistencia Salud Integral Familia;GARANTIAS
6148564;;F;73;CHILENO;;Silencioso;VICUNA                        ;COQUIMBO;363790;4;3;0;0;0;4;3;363790;Asistencia Salud Integral Familia;GARANTIAS
8908382;;F;63;CHILENO;;Boomers;MELIPILLA                     ;METROPOLITANA;52990;1;1;0;0;0;1;1;52990;ASIST. FULL HOGAR Y AUTO INGRAL;GARANTIAS
10586322;;F;56;CHILENO;;Boomers;N/D;N/D;52990;1;1;0;0;0;1;1;52990;Asistencia Salud Integral Familia;GARANTIAS
12054203;;M;54;CHILENO;;X;PUNTA ARENAS;MAGALLANES;52990;1;1;0;0;0;1;1;52990;ASIST. FULL HOGAR Y AUTO INGRAL;GARANTIAS
7318094;;M;68;CHILENO;;Silencioso;SAN BERNARDO                  ;METROPOLITANA;102120;4;3;0;0;0;4;3;102120;Asistencia Salud Integral Familia;GARANTIAS
9131445;;M;61;CHILENO;;Boomers;N/D;N/D;52990;1;1;0;0;0;1;1;52990;Asistencia Programa Domiciliario;GARANTIAS
6750494;;F;70;CHILENO;;Silencioso;LAMPA                         ;METROPOLITANA;52990;1;1;0;0;0;1;1;52990;Asistencia Programa Domiciliario;GARANTIAS
25596433;;M;44;HAITIANO;;Extranjero;SANTIAGO                      ;METROPOLITANA;52990;1;1;0;0;0;1;1;52990;Asistencia Programa Domiciliario;GARANTIAS
10628653;;F;57;CHILENO;;Boomers;VICTORIA                      ;ARAUCANIA;52990;1;1;0;0;0;1;1;52990;Asistencia Salud Integral Familia;GARANTIAS
12392909;;F;49;CHILENO;;X;PAINE                         ;METROPOLITANA;52990;1;1;0;0;0;1;1;52990;Asistencia Salud Integral Familia;GARANTIAS
11517801;;M;51;CHILENO;;X;N/D;N/D;395950;5;4;0;0;0;5;4;395950;Asistencia Salud Integral Familia;GARANTIAS
8065541;;F;65;CHILENO;;Boomers;TEMUCO                        ;ARAUCANIA;25990;3;1;0;0;0;3;1;25990;GPL 1A X CTA SBI;GARANTIAS
6126644;;F;74;CHILENO;;Silencioso;LOS ANGELES                   ;BIO BIO;52990;1;1;0;0;0;1;1;52990;Asistencia Programa Domiciliario;GARANTIAS
8636972;;M;63;CHILENO;;Boomers;SAN ESTEBAN                   ;VALPARAISO;52990;1;1;0;0;0;1;1;52990;Asistencia Salud Integral Familia;GARANTIAS
9611376;;F;60;CHILENO;;Boomers;MAIPU                         ;METROPOLITANA;52990;1;1;0;0;0;1;1;52990;Asistencia Salud Integral Familia;GARANTIAS
17221168;;M;33;CHILENO;;Millenial;N/D;N/D;98950;5;5;0;0;0;5;5;98950;Asistencia Programa Domiciliario;GARANTIAS
6608057;;F;72;CHILENO;;Silencioso;LINARES                       ;MAULE;57980;2;2;0;0;0;2;2;57980;Asistencia Programa Domiciliario;GARANTIAS
5151564;;F;81;CHILENO;;Silencioso;PENAFLOR                      ;METROPOLITANA;52990;1;1;0;0;0;1;1;52990;Asistencia Programa Domiciliario;GARANTIAS
16639110;;F;35;CHILENO;;Millenial;SANTIAGO;METROPOLITANA;52990;1;1;0;0;0;1;1;52990;Asistencia Programa Domiciliario;GARANTIAS
11356821;;M;54;CHILENO;;X;PUERTO MONTT                  ;LOS LAGOS;247850;4;3;0;0;0;4;3;247850;Asistencia Programa Domiciliario;GARANTIAS
9562296;;M;55;CHILENO;;Boomers;HUALPEN;BIO BIO;177960;4;2;0;0;0;4;2;177960;Asistencia Salud Integral Familia;GARANTIAS
15955773;;M;37;CHILENO;;Millenial;PETORCA                       ;VALPARAISO;52990;1;1;0;0;0;1;1;52990;Asistencia Salud Integral Familia;GARANTIAS
7261984;;F;68;CHILENO;;Silencioso;N/D;N/D;52990;1;1;0;0;0;1;1;52990;Asistencia Programa Domiciliario;GARANTIAS
12787378;;M;46;CHILENO;;X;"";"";52990;1;1;0;0;0;1;1;52990;Asistencia Programa Domiciliario;GARANTIAS
20229693;;M;23;CHILENO;;Z;N/D;N/D;52990;1;1;0;0;0;1;1;52990;Asistencia Programa Domiciliario;GARANTIAS
17540650;;F;32;CHILENO;;Millenial;N/D;N/D;52990;1;1;0;0;0;1;1;52990;Asistencia Programa Domiciliario;GARANTIAS
10717557;;F;58;CHILENO;;Boomers;N/D;N/D;252980;2;2;0;0;0;2;2;252980;Asistencia Programa Domiciliario;GARANTIAS
17439047;;M;32;CHILENO;;Millenial;LOS VILOS                     ;COQUIMBO;52990;1;1;0;0;0;1;1;52990;ASIST. FULL HOGAR Y AUTO INGRAL;GARANTIAS
19547186;;F;25;CHILENO;;Z;COLINA                        ;METROPOLITANA;52990;1;1;0;0;0;1;1;52990;Asistencia Salud Integral Familia;GARANTIAS
7553182;;F;70;CHILENO;;Silencioso;RENGO                         ;L.G.B.OÂ´HIGGINS;617230;6;3;0;0;0;6;3;617230;Asistencia Salud Integral Familia;GARANTIAS
14179978;;F;43;CHILENO;;X;COLINA                        ;METROPOLITANA;52990;1;1;0;0;0;1;1;52990;Asistencia Salud Integral Familia;GARANTIAS
10027827;;F;55;CHILENO;;Boomers;TENO                          ;MAULE;100870;2;2;0;0;0;2;2;100870;Asistencia Salud Integral Familia;GARANTIAS
16746788;;M;34;CHILENO;;Millenial;N/D;N/D;52990;1;1;0;0;0;1;1;52990;Asistencia Programa Domiciliario;GARANTIAS
12459935;;F;49;CHILENO;;X;LO PRADO;METROPOLITANA;0;0;2;0;0;0;0;2;0;Asistencia Programa Domiciliario;GARANTIAS
19590957;;M;25;CHILENO;;Z;N/D;N/D;52990;1;1;0;0;0;1;1;52990;Asistencia Salud Integral Familia;GARANTIAS
19444094;;M;26;CHILENO;;Z;ANTOFAGASTA                   ;ANTOFAGASTA;52990;1;1;0;0;0;1;1;52990;Asistencia Programa Domiciliario;GARANTIAS
26372574;;F;29;VENEZOLANO;;Extranjero;N/D;N/D;52990;1;1;0;0;0;1;1;52990;Asistencia Salud Integral Familia;GARANTIAS
12532278;;M;48;CHILENO;;X;CORONEL                       ;BIO BIO;55080;1;1;0;0;0;1;1;55080;Asistencia Programa Domiciliario;GARANTIAS
18633921;;F;27;CHILENO;;Millenial;COQUIMBO                      ;COQUIMBO;52990;1;1;0;0;0;1;1;52990;Asistencia Programa Domiciliario;GARANTIAS
16707278;;F;34;CHILENO;;Millenial;CURANILAHUE                   ;BIO BIO;112980;2;2;0;0;0;2;2;112980;Asistencia Programa Domiciliario;GARANTIAS
16408154;;F;36;CHILENO;;Millenial;N/D;N/D;52990;1;1;0;0;0;1;1;52990;Asistencia Salud Integral Familia;GARANTIAS
18900620;;F;27;CHILENO;;Millenial;PROVIDENCIA                   ;METROPOLITANA;100870;2;2;0;0;0;2;2;100870;ASIST. FULL HOGAR Y AUTO INGRAL;GARANTIAS
15263941;;M;41;CHILENO;;X;LANCO                         ;LOS LAGOS;52990;1;1;0;0;0;1;1;52990;Asistencia Salud Integral Familia;GARANTIAS
8594380;;F;62;CHILENO;;Boomers;FREIRINA                      ;ATACAMA;0;0;2;0;0;0;0;2;0;GM 1A X CTA SBI;GARANTIAS
11244511;;M;53;CHILENO;;X;CANETE                        ;BIO BIO;250860;3;2;0;0;0;3;2;250860;Asistencia Salud Integral Familia;GARANTIAS
5941394;;F;65;CHILENO;;Boomers;LEBU                          ;BIO BIO;52990;1;1;0;0;0;1;1;52990;Asistencia Programa Domiciliario;GARANTIAS
4617967;;F;76;CHILENO;;Silencioso;ARICA                         ;ARICA Y PARINACOTA;52990;1;1;0;0;0;1;1;52990;Asistencia Programa Domiciliario;GARANTIAS
20274367;;M;23;CHILENO;;Z;N/D;N/D;55080;1;1;0;0;0;1;1;55080;Asistencia Programa Domiciliario;GARANTIAS
5374949;;M;75;CHILENO;;Silencioso;BUIN                          ;METROPOLITANA;489050;4;2;0;0;0;4;2;489050;Asistencia Salud Integral Familia;GARANTIAS
7451794;;F;66;CHILENO;;Boomers;ANTOFAGASTA                   ;ANTOFAGASTA;52990;1;1;0;0;0;1;1;52990;Asistencia Programa Domiciliario;GARANTIAS
8609436;;F;61;CHILENO;;Boomers;N/D;N/D;84970;3;2;0;0;0;3;2;84970;Asistencia Salud Integral Familia;GARANTIAS
9448591;;F;61;CHILENO;;Boomers;VALPARAISO                    ;VALPARAISO;52990;1;1;0;0;0;1;1;52990;Asistencia Salud Integral Familia;GARANTIAS
11343657;;F;54;CHILENO;;X;ANTOFAGASTA                   ;ANTOFAGASTA;105980;2;1;0;0;0;2;1;105980;Asistencia Salud Integral Familia;GARANTIAS
11390330;;F;53;CHILENO;;X;COIHAIQUE                     ;AYSEN;100980;2;2;0;0;0;2;2;100980;Asistencia Programa Domiciliario;GARANTIAS
14638682;;M;54;VENEZOLANO;;X;ESTACION CENTRAL;METROPOLITANA;52990;1;1;0;0;0;1;1;52990;Asistencia Programa Domiciliario;GARANTIAS
15180095;;M;39;CHILENO;;X;"";"";52990;1;1;0;0;0;1;1;52990;Asistencia Programa Domiciliario;GARANTIAS
18385143;;M;29;CHILENO;;Millenial;LOS ANDES                     ;VALPARAISO;47880;1;1;0;0;0;1;1;47880;ASIS. SALUD X CTA ASSISTIME;GARANTIAS
26179656;;M;23;HAITIANO;;Extranjero;N/D;N/D;55080;1;1;0;0;0;1;1;55080;Asistencia Programa Domiciliario;GARANTIAS
4942218;;F;79;CHILENO;;Silencioso;N/D;N/D;55080;1;1;0;0;0;1;1;55080;Asistencia Programa Domiciliario;GARANTIAS
25407863;;F;40;COLOMBIANO;;Extranjero;COLINA                        ;METROPOLITANA;47880;1;1;0;0;0;1;1;47880;ASIS. SALUD X CTA ASSISTIME;GARANTIAS
8398628;;M;64;CHILENO;;Boomers;PUREN                         ;ARAUCANIA;348810;8;4;0;0;0;8;4;348810;ASIS. SALUD X CTA ASSISTIME;GARANTIAS
6607520;;F;70;CHILENO;;Silencioso;VICUNA                        ;COQUIMBO;47880;1;1;0;0;0;1;1;47880;ASIS. SALUD X CTA ASSISTIME;GARANTIAS
15732067;;F;38;CHILENO;;Millenial;OVALLE                        ;COQUIMBO;55080;1;1;0;0;0;1;1;55080;Asistencia Programa Domiciliario;GARANTIAS
25508304;;M;47;BOLIVIANO;;Extranjero;ANTOFAGASTA                   ;ANTOFAGASTA;438530;4;3;0;0;0;4;3;438530;ASIS. SALUD X CTA ASSISTIME;GARANTIAS
18992970;;F;27;CHILENO;;Z;N/D;N/D;47880;1;1;0;0;0;1;1;47880;ASIS. SALUD X CTA ASSISTIME;GARANTIAS
4879269;;M;79;CHILENO;;Silencioso;LEBU                          ;BIO BIO;43080;1;1;0;0;0;1;1;43080;ASIST. FULL HOGAR X CTA MOK;GARANTIAS
16891115;;F;27;CHILENO;;Millenial;N/D;N/D;47880;1;1;0;0;0;1;1;47880;ASIS. SALUD X CTA ASSISTIME;GARANTIAS
12591108;;M;47;CHILENO;;X;N/D;N/D;47880;1;1;0;0;0;1;1;47880;ASIS. SALUD X CTA ASSISTIME;GARANTIAS
7063327;;F;67;CHILENO;;Boomers;COINCO                        ;L.G.B.OÂ´HIGGINS;47880;1;1;0;0;0;1;1;47880;ASIS. SALUD X CTA ASSISTIME;GARANTIAS
9953494;;M;58;CHILENO;;Boomers;MELIPILLA                     ;METROPOLITANA;47880;1;1;0;0;0;1;1;47880;ASIS. SALUD X CTA ASSISTIME;GARANTIAS
7507103;;M;66;CHILENO;;Boomers;TALCA                         ;MAULE;47880;1;1;0;0;0;1;1;47880;ASIS. SALUD X CTA ASSISTIME;GARANTIAS
13803463;;F;41;CHILENO;;X;N/D;N/D;114840;1;1;0;0;0;1;1;114840;GPL 1A X CTA SBI;GARANTIAS
12177840;;M;54;CHILENO;;X;MELIPILLA                     ;METROPOLITANA;86860;3;2;0;0;0;3;2;86860;ASIS. SALUD X CTA ASSISTIME;GARANTIAS
7334080;;M;69;CHILENO;;Silencioso;N/D;N/D;47880;1;1;0;0;0;1;1;47880;ASIS. SALUD X CTA ASSISTIME;GARANTIAS
14046103;;M;40;CHILENO;;X;N/D;N/D;463860;3;2;2;1;415980;1;1;47880;ASIS. SALUD X CTA ASSISTIME;GARANTIAS
13948332;;M;42;CHILENO;;X;PICHIDEGUA                    ;L.G.B.OÂ´HIGGINS;47880;1;1;0;0;0;1;1;47880;ASIS. SALUD X CTA ASSISTIME;GARANTIAS
19802489;;F;24;CHILENO;;Z;N/D;N/D;47880;1;1;0;0;0;1;1;47880;ASIS. SALUD X CTA ASSISTIME;GARANTIAS
6985555;;F;69;CHILENO;;Silencioso;PROVIDENCIA                   ;METROPOLITANA;47880;1;1;0;0;0;1;1;47880;ASIS. SALUD X CTA ASSISTIME;GARANTIAS
6526535;;F;75;CHILENO;;Silencioso;PUDAHUEL                      ;METROPOLITANA;0;0;0;0;0;0;0;0;0;ASIS. SALUD X CTA ASSISTIME;GARANTIAS
26486388;;F;44;EXTRANJERO - NO INFORMA NACIONALIDAD;;Extranjero;RECOLETA                      ;METROPOLITANA;0;0;0;0;0;0;0;0;0;ASIS. SALUD X CTA ASSISTIME;GARANTIAS
6950553;;F;72;CHILENO;;Silencioso;ARICA                         ;TARAPACA;0;0;0;0;0;0;0;0;0;ASIS. SALUD X CTA ASSISTIME;GARANTIAS
6607998;;F;73;CHILENO;;Silencioso;CURICO                        ;MAULE;0;0;0;0;0;0;0;0;0;ASIS. SALUD X CTA ASSISTIME;GARANTIAS
18777575;;F;28;CHILENO;;Millenial;N/D;N/D;0;0;0;0;0;0;0;0;0;ASIS. SALUD X CTA ASSISTIME;GARANTIAS
7302252;;M;69;CHILENO;;Silencioso;PUERTO VARAS                  ;LOS LAGOS;0;0;0;0;0;0;0;0;0;ASIS. SALUD X CTA ASSISTIME;GARANTIAS
6048382;;F;74;CHILENO;;Silencioso;ALTO HOSPICIO;TARAPACA;0;0;0;0;0;0;0;0;0;ASIS. SALUD X CTA ASSISTIME;GARANTIAS
11967089;;M;50;CHILENO;;Boomers;LICANTEN                      ;MAULE;0;0;0;0;0;0;0;0;0;ASIS. SALUD X CTA ASSISTIME;GARANTIAS
15613326;;F;38;CHILENO;;X;N/D;N/D;0;0;0;0;0;0;0;0;0;ASIS. SALUD X CTA ASSISTIME;GARANTIAS
15439505;;F;40;CHILENO;;X;FRUTILLAR                     ;LOS LAGOS;0;0;0;0;0;0;0;0;0;ASIS. SALUD X CTA ASSISTIME;GARANTIAS
4335187;;M;81;CHILENO;;Silencioso;SAN FERNANDO                  ;L.G.B.OÂ´HIGGINS;0;0;0;0;0;0;0;0;0;ASIS. SALUD X CTA ASSISTIME;GARANTIAS
7365439;;M;67;CHILENO;;Boomers;RENCA                         ;METROPOLITANA;0;0;0;0;0;0;0;0;0;ASIS. SALUD X CTA ASSISTIME;GARANTIAS
26415473;;M;27;HAITIANO;;Extranjero;N/D;N/D;0;0;0;0;0;0;0;0;0;ASIS. SALUD X CTA ASSISTIME;GARANTIAS
13203251;;F;44;CHILENO;;Millenial;N/D;N/D;0;0;0;0;0;0;0;0;0;ASIS. SALUD X CTA ASSISTIME;GARANTIAS
24198021;;M;69;BOLIVIANO;;Extranjero;ALTO HOSPICIO;TARAPACA;0;0;0;0;0;0;0;0;0;ASIS. SALUD X CTA ASSISTIME;GARANTIAS
10090843;;F;57;CHILENO;;Boomers;N/D;N/D;0;0;0;0;0;0;0;0;0;ASIS. SALUD X CTA ASSISTIME;GARANTIAS
13405087;;M;44;CHILENO;;X;PROVIDENCIA                   ;METROPOLITANA;0;0;0;0;0;0;0;0;0;ASIS. SALUD X CTA ASSISTIME;GARANTIAS
5177457;;M;77;CHILENO;;Silencioso;N/D;N/D;0;0;0;0;0;0;0;0;0;ASIS. SALUD X CTA ASSISTIME;GARANTIAS
9045453;;F;62;CHILENO;;Boomers;MAULE                         ;MAULE;0;0;0;0;0;0;0;0;0;ASIS. SALUD X CTA ASSISTIME;GARANTIAS
26619296;;M;51;EXTRANJERO - NO INFORMA NACIONALIDAD;;Extranjero;PENAFLOR                      ;METROPOLITANA;0;0;0;0;0;0;0;0;0;ASIS. SALUD X CTA ASSISTIME;GARANTIAS
24026688;;M;64;PERUANO;;Extranjero;VALLENAR;ATACAMA;0;0;0;0;0;0;0;0;0;ASIS. SALUD X CTA ASSISTIME;GARANTIAS
24576946;;F;33;BOLIVIANO;;Extranjero;ARICA                         ;ARICA Y PARINACOTA;0;0;0;0;0;0;0;0;0;ASIS. SALUD X CTA ASSISTIME;GARANTIAS
7267492;;F;72;CHILENO;;Silencioso;CANETE                        ;BIO BIO;0;0;0;0;0;0;0;0;0;ASIS. SALUD X CTA ASSISTIME;GARANTIAS
16090315;;M;37;CHILENO;;Millenial;EMPEDRADO                     ;MAULE;0;0;0;0;0;0;0;0;0;ASIS. SALUD X CTA ASSISTIME;GARANTIAS
3723295;;F;85;CHILENO;;Silencioso;SAN FELIPE                    ;VALPARAISO;0;0;0;0;0;0;0;0;0;ASIST. FULL HOGAR X CTA MOK;GARANTIAS
17100965;;F;33;CHILENO;;Millenial;MAIPU                         ;METROPOLITANA;0;0;0;0;0;0;0;0;0;ASIS. SALUD X CTA ASSISTIME;GARANTIAS
24109898;;F;46;COLOMBIANO;;Extranjero;LO BARNECHEA                  ;METROPOLITANA;0;0;0;0;0;0;0;0;0;ASIS. SALUD X CTA ASSISTIME;GARANTIAS
12348750;;M;49;CHILENO;;X;CALAMA                        ;ANTOFAGASTA;0;0;0;0;0;0;0;0;0;ASIS. SALUD X CTA ASSISTIME;GARANTIAS
10623609;;M;53;CHILENO;;X;CONSTITUCION                  ;MAULE;0;0;0;0;0;0;0;0;0;ASIS. SALUD X CTA ASSISTIME;GARANTIAS
17512794;;F;31;CHILENO;;Millenial;N/D;N/D;0;0;0;0;0;0;0;0;0;ASIS. SALUD X CTA ASSISTIME;GARANTIAS
13118080;;F;46;CHILENO;;X;PROVIDENCIA                   ;METROPOLITANA;0;0;0;0;0;0;0;0;0;ASIS. SALUD X CTA ASSISTIME;GARANTIAS
13599199;;F;44;CHILENO;;X;LINARES                       ;MAULE;0;0;0;0;0;0;0;0;0;ASIS. SALUD X CTA ASSISTIME;GARANTIAS
11416718;;F;52;CHILENO;;X;MOSTAZAL                      ;L.G.B.OÂ´HIGGINS;0;0;0;0;0;0;0;0;0;ASIS. SALUD X CTA ASSISTIME;GARANTIAS
12756464;;F;47;CHILENO;;X;"";"";0;0;0;0;0;0;0;0;0;ASIS. SALUD X CTA ASSISTIME;GARANTIAS
14528215;;F;48;CHILENO;;X;MAIPU                         ;METROPOLITANA;0;0;0;0;0;0;0;0;0;ASIS. SALUD X CTA ASSISTIME;GARANTIAS
6603254;;M;70;CHILENO;;Silencioso;QUINTERO                      ;VALPARAISO;0;0;0;0;0;0;0;0;0;ASIS. SALUD X CTA ASSISTIME;GARANTIAS
14540072;;F;56;CHILENO;;Boomers;VALDIVIA                      ;LOS RIOS;0;0;0;0;0;0;0;0;0;ASIS. SALUD X CTA ASSISTIME;GARANTIAS
11240288;;M;54;CHILENO;;X;N/D;N/D;0;0;0;0;0;0;0;0;0;ASIS. SALUD X CTA ASSISTIME;GARANTIAS
25671808;;M;32;COLOMBIANO;;Extranjero;MACHALI                       ;L.G.B.OÂ´HIGGINS;0;0;0;0;0;0;0;0;0;ASIS. SALUD X CTA ASSISTIME;GARANTIAS
10766372;;F;53;CHILENO;;X;PELARCO                       ;MAULE;0;0;0;0;0;0;0;0;0;ASIS. SALUD X CTA ASSISTIME;GARANTIAS
13788832;;F;41;CHILENO;;X;N/D;N/D;0;0;0;0;0;0;0;0;0;ASIS. SALUD X CTA ASSISTIME;GARANTIAS
9131102;;F;63;CHILENO;;Boomers;COPIAPO                       ;ATACAMA;0;0;0;0;0;0;0;0;0;ASIS. SALUD X CTA ASSISTIME;GARANTIAS
26502400;;M;32;EXTRANJERO - NO INFORMA NACIONALIDAD;;Extranjero;ESTACION CENTRAL              ;METROPOLITANA;0;0;0;0;0;0;0;0;0;ASIS. SALUD X CTA ASSISTIME;GARANTIAS
10003044;;F;49;CHILENO;;X;VALDIVIA                      ;LOS LAGOS;0;0;0;0;0;0;0;0;0;ASIS. SALUD X CTA ASSISTIME;GARANTIAS
18323515;;F;36;CHILENO;;Millenial;PERQUENCO                     ;ARAUCANIA;0;0;0;0;0;0;0;0;0;ASIS. SALUD X CTA ASSISTIME;GARANTIAS
7803128;;M;65;CHILENO;;Boomers;LA UNION                      ;LOS RIOS;0;0;0;0;0;0;0;0;0;ASIS. SALUD X CTA ASSISTIME;GARANTIAS
5163019;;F;79;CHILENO;;Silencioso;PROVIDENCIA                   ;METROPOLITANA;0;0;0;0;0;0;0;0;0;GM 1A X CTA SBI;GARANTIAS
6808300;;F;69;CHILENO;;Silencioso;PENCO                         ;BIO BIO;0;0;0;0;0;0;0;0;0;ASIS. SALUD X CTA ASSISTIME;GARANTIAS
8584302;;F;63;CHILENO;;Boomers;MAIPU                         ;METROPOLITANA;0;0;0;0;0;0;0;0;0;ASIS. SALUD X CTA ASSISTIME;GARANTIAS
17260269;;M;33;CHILENO;;Millenial;"";"";0;0;0;0;0;0;0;0;0;GM 1A X CTA SBI;GARANTIAS
10278923;;F;58;CHILENO;;Boomers;QUELLON                       ;LOS LAGOS;0;0;0;0;0;0;0;0;0;ASIS. SALUD X CTA ASSISTIME;GARANTIAS
15866137;;M;38;CHILENO;;Millenial;N/D;N/D;0;0;0;0;0;0;0;0;0;ASIS. SALUD X CTA ASSISTIME;GARANTIAS
12535400;;M;49;CHILENO;;X;VILLARICA                     ;ARAUCANIA;0;0;0;0;0;0;0;0;0;ASIS. SALUD X CTA ASSISTIME;GARANTIAS
25669143;;M;32;HAITIANO;;Extranjero;COLINA                        ;METROPOLITANA;364870;4;2;0;0;0;4;2;364870;Smart Tab M8 2G-32GB 8 IPS HD WiFi + Docking iro;COMPUTACION
19820369;;F;24;CHILENO;;Silencioso;PROVIDENCIA                   ;METROPOLITANA;232860;3;2;0;0;0;3;2;232860;NTBK D330 Celeron N4020/4GB/64GB/10P+OfficeHS;COMPUTACION
12976245;;M;45;CHILENO;;X;CONCEPCION                    ;BIO BIO;244970;3;3;0;0;0;3;3;244970;Monitor UltraGear 23.8P 144Hz Full HD IPS;COMPUTACION
9889365;;M;57;CHILENO;;Boomers;RENCA                         ;METROPOLITANA;91970;3;2;2;1;69980;1;1;21990;TAB MLAB MBX 8 QUAD CORE 1G+16G 8716;COMPUTACION
26946644;;M;33;EXTRANJERO - NO INFORMA NACIONALIDAD;;Extranjero;"";"";4329350;29;11;27;9;4273370;2;2;55980;NTBK Inspiron 3505 Athlon 3050U/12GB/256 SSD/15P;COMPUTACION
24682595;;F;29;BOLIVIANO;;Millenial;PROVIDENCIA                   ;METROPOLITANA;89980;2;2;2;2;89980;0;0;0;TAB 7 PLAY AND LEARN PLUS BLUE 8868;COMPUTACION
11528486;;M;52;CHILENO;;X;SAN BERNARDO                  ;METROPOLITANA;1493900;10;7;0;0;0;10;7;1493900;Multifuncional EcoTank L3210;COMPUTACION
7816961;;M;64;CHILENO;;Boomers;PIRQUE                        ;METROPOLITANA;988440;5;3;0;0;0;5;3;988440;NTBK Aspire 5 R5-3500U/12GB/256SSD GB/15P FHD;COMPUTACION
18294959;;M;29;CHILENO;;Millenial;VILLARICA                     ;ARAUCANIA;1774262;40;45;0;0;0;40;45;1774262;NTBK 15-DY2064LA Ci3-1125G4/8GB/512GB/15P;COMPUTACION
16952200;;F;34;CHILENO;;Millenial;N/D;N/D;332960;4;2;2;1;273980;2;1;58980;TAB 7 PLAY AND LEARN PLUS PURPLE 8867;COMPUTACION
19591159;;M;25;CHILENO;;Z;PROVIDENCIA                   ;N/D;885980;2;1;2;1;885980;0;0;0;NTBK L5i Ci7-10750H/16GB/128SSD+1TB/RTX2060 6GB;COMPUTACION
19740144;;F;25;CHILENO;;Z;PROVIDENCIA                   ;METROPOLITANA;683980;2;1;2;1;683980;0;0;0;NTBK GAMER GF66 Ci5-11400H/8GB/512GB/GTX1650 4GB;COMPUTACION
15110276;;M;39;CHILENO;;X;PROVIDENCIA                   ;METROPOLITANA;319990;1;1;1;1;319990;0;0;0;NTBK 15-ef1015la Ryzen 3-4300U/4GB/256GBSSD/15P;COMPUTACION
13001782;;F;46;CHILENO;;X;"";"";26970;3;1;0;0;0;3;1;26970;TINTA BOTELLA CYAN BT5001C;COMPUTACION
18891993;Soltero;F;27;CHILENO;;Millenial;PENCAHUE                      ;MAULE;79990;1;1;0;0;0;1;1;79990;TAB M8 QC 2GB 32GB 8P Gris;COMPUTACION
17765450;;F;31;CHILENO;;Millenial;PROVIDENCIA                   ;METROPOLITANA;8990;1;1;0;0;0;1;1;8990;TINTA EPSON T504 CYAN BOTELLA C13T03N22A;COMPUTACION
13479591;;M;44;CHILENO;;X;PROVIDENCIA                   ;METROPOLITANA;153980;2;1;2;1;153980;0;0;0;NTBK Inspiron 3502 Celeron/4GB/128GB SSD/+O365;COMPUTACION
5107439;;F;77;CHILENO;;Silencioso;N/D;N/D;208970;3;2;0;0;0;3;2;208970;TINTA 664 NEGRA;COMPUTACION
13407662;;F;50;CHILENO;;X;MAIPU                         ;METROPOLITANA;129990;1;1;1;1;129990;0;0;0;NTBK D330 Celeron N4020/4GB/64GB/10P+OfficeHS;COMPUTACION
16059854;;F;36;CHILENO;;Millenial;ILLAPEL                       ;COQUIMBO;349960;6;3;0;0;0;6;3;349960;Tab M10 Plus FHD 4GB 64GB 10.3P platinum grey;COMPUTACION
18561864;;M;29;CHILENO;;Millenial;"";"";521950;5;4;1;1;129990;4;3;391960;NTBK D330 Celeron N4020/4GB/64GB/10P+OfficeHS;COMPUTACION
18563460;Soltero;F;28;CHILENO;;Millenial;PROVIDENCIA                   ;METROPOLITANA;349990;1;1;1;1;349990;0;0;0;NTBK 245 G8 R5-5500U/8GB/256GB SSD/14P/Win10Pro;COMPUTACION
16925786;;M;33;CHILENO;;Millenial;N/D;N/D;253980;2;1;2;1;253980;0;0;0;TAB S6 Lite (610) 4GB 64GB 10.4P DARK GREY;COMPUTACION
15625416;;F;39;CHILENO;;X;TENO;MAULE;574420;8;4;8;4;574420;0;0;0;NTBK IdeaPad 3 Ryzen 5-4500U/12GB/1TB/15P;COMPUTACION
25015294;Soltero;M;33;PERUANO;;Extranjero;PROVIDENCIA                   ;METROPOLITANA;99990;1;1;0;0;0;1;1;99990;NTBK XH02 Celeron 4GB/64GB eMMC/11P/T+W ingles;COMPUTACION
16006093;Soltero;M;36;CHILENO;;Millenial;"";"";175980;2;1;2;1;175980;0;0;0;Multifuncional DCPT520W Wifi;COMPUTACION
10220839;;F;56;CHILENO;;Boomers;QUILPUE                       ;VALPARAISO;214970;3;3;0;0;0;3;3;214970;Tab M10 Plus FHD 4GB 64GB 10.3P platinum grey;COMPUTACION
12820428;;M;47;CHILENO;;X;PROVIDENCIA                   ;METROPOLITANA;456970;3;2;2;1;276980;1;1;179990;Galaxy Tab S6 Lite + Book Cover (10.4,128GB,Blue;COMPUTACION
17640098;;F;30;CHILENO;;Millenial;TREGUACO                      ;BIO BIO;335780;8;4;8;4;335780;0;0;0;Multifuncional EcoTank L3210;COMPUTACION
10071984;;F;58;CHILENO;;Boomers;PANGUIPULLI                   ;LOS LAGOS;265580;8;4;0;0;0;8;4;265580;TAB MLAB 7 MB4 PLUS 3G 1+16GB WHITE 8762;COMPUTACION
17753316;;F;31;CHILENO;;Millenial;PROVIDENCIA                   ;N/D;249990;1;1;1;1;249990;0;0;0;TAB S6 Lite (610) 4GB 64GB 10.4P PINK;COMPUTACION
19297079;Soltero;M;26;CHILENO;;Z;PROVIDENCIA                   ;METROPOLITANA;927820;4;2;4;2;927820;0;0;0;NTBK L5i Ci7-10750H/16GB/128SSD+1TB/RTX2060 6GB;COMPUTACION
11153680;;F;54;CHILENO;;Boomers;CANETE                        ;BIO BIO;2030570;24;15;2;1;285980;22;14;1744590;Multifuncional EcoTank L3210;COMPUTACION
6438944;;M;72;CHILENO;;Silencioso;NATALES                       ;MAGALLANES;638970;3;3;0;0;0;3;3;638970;NTBK 15-dk1044la C15-10300H/8GB/512GB/1660Ti 6GB;COMPUTACION
16998324;;F;35;CHILENO;;Millenial;RENCA                         ;METROPOLITANA;159990;1;1;1;1;159990;0;0;0;Multifuncional EcoTank L3210;COMPUTACION
20429755;;M;22;CHILENO;;Extranjero;PROVIDENCIA                   ;N/D;523980;2;1;2;1;523980;0;0;0;NTBK Aspire 5 R5-3500U/12GB/256SSD GB/15P FHD;COMPUTACION
15543178;;F;40;CHILENO;;X;SAN BERNARDO                  ;METROPOLITANA;247540;4;3;0;0;0;4;3;247540;NTBK 240 G8 Celeron N4020/4GB/500GB/14P;COMPUTACION
18960016;;F;27;CHILENO;;Millenial;"";"";2271100;25;12;25;12;2271100;0;0;0;Multifuncional DeskJet Ink Advantage 2752 Wifi;COMPUTACION
16329119;;F;36;CHILENO;;Millenial;PEDRO AGUIRRE CERDA;METROPOLITANA;63980;2;1;2;1;63980;0;0;0;Impresora Monocromatica Xerox B210-NDI;COMPUTACION
19034860;Soltero;F;27;CHILENO;;Z;PROVIDENCIA                   ;METROPOLITANA;693980;2;1;2;1;693980;0;0;0;NTBK FX506 Ci5-10300H/8GB/512GB SSD/GTX1650 4GB;COMPUTACION
9466982;;F;57;CHILENO;;Boomers;PROVIDENCIA                   ;METROPOLITANA;349990;1;1;1;1;349990;0;0;0;NTBK IP3 Ryzen 3-5300U/8GB/256GB SSD/14P FHD;COMPUTACION
18104248;Soltero;M;30;CHILENO;PROFESOR;Millenial;PROVIDENCIA                   ;METROPOLITANA;180970;3;2;0;0;0;3;2;180970;Multifuncional EcoTank L3250 Wifi;COMPUTACION
12764286;;F;47;CHILENO;;X;BULNES                        ;BIO BIO;245790;2;1;0;0;0;2;1;245790;Galaxy Tab A8 (10.5, 32GB, WIFI) Gray;COMPUTACION
13670365;;M;43;CHILENO;;X;PROVIDENCIA                   ;METROPOLITANA;355980;2;1;0;0;0;2;1;355980;NTBK IP3 Ryzen 3-5300U/8GB/256GB SSD/14P FHD;COMPUTACION
20233434;;F;23;CHILENO;;Z;DALCAHUE                      ;LOS LAGOS;238620;4;2;0;0;0;4;2;238620;NTBK 240 G8 Celeron N4020/4GB/500GB/14P;COMPUTACION
26375651;;F;26;EXTRANJERO - NO INFORMA NACIONALIDAD;;Extranjero;N/D;N/D;0;0;2;0;2;0;0;0;0;TAB MLAB MBX 8 QUAD CORE 1G+16G 8716;COMPUTACION
11991047;;F;50;CHILENO;;X;PROVIDENCIA                   ;METROPOLITANA;249990;1;1;1;1;249990;0;0;0;TAB S6 Lite (610) 4GB 64GB 10.4P DARK GREY;COMPUTACION
18935371;Soltero;F;27;CHILENO;;Millenial;PROVIDENCIA                   ;METROPOLITANA;887950;5;3;4;2;867960;1;1;19990;NTBK 245 G8 R5-5500U/8GB/256GB SSD/14P/Win10Pro;COMPUTACION
10107470;;M;57;CHILENO;;Boomers;RENCA                         ;METROPOLITANA;293970;4;2;4;2;293970;0;0;0;Tab M10 FHD Plus LTE 10.3IN 2GB 32GB;COMPUTACION
20392483;;F;22;CHILENO;;Z;PROVIDENCIA                   ;METROPOLITANA;249990;1;1;1;1;249990;0;0;0;TAB S6 Lite (610) 4GB 64GB 10.4P DARK GREY;COMPUTACION
17855874;Casado;M;31;CHILENO;KINESIOLOGO;Millenial;PROVIDENCIA                   ;METROPOLITANA;803960;4;2;4;2;803960;0;0;0;NTBK Aspire 5 R5-3500U/12GB/256SSD GB/15P FHD;COMPUTACION
15576852;;M;38;CHILENO;;X;PROVIDENCIA                   ;METROPOLITANA;159990;1;1;1;1;159990;0;0;0;Multifuncional EcoTank L3210;COMPUTACION
15029213;;F;40;CHILENO;;X;COPIAPO;ATACAMA;821950;6;3;6;3;821950;0;0;0;NTBK Inspiron 3501 Ci3-1115G4/4GB/1TB/14P;COMPUTACION
14138323;Soltero;M;41;CHILENO;TECNICO DE NIVEL SUPERIOR EN ENFERMERIA;X;RENCA                         ;METROPOLITANA;433980;2;1;2;1;433980;0;0;0;NTBK M14 Core i5-1155G7/8GB/256GB SSD/14P FHD;COMPUTACION
8625719;;M;62;CHILENO;;Boomers;"";"";729360;2;1;0;0;0;2;1;729360;NTBK 15-eh0006la Ryzen 5-4500U/8GB/512GB/15P;COMPUTACION
18877239;Soltero;F;27;CHILENO;;Z;PROVIDENCIA                   ;METROPOLITANA;179990;1;1;1;1;179990;0;0;0;Multifuncional EcoTank L3250 Wifi;COMPUTACION
12816061;;M;47;CHILENO;;X;SALAMANCA                     ;COQUIMBO;739990;1;1;0;0;0;1;1;739990;NTBK 15-eh0006la Ryzen 5-4500U/8GB/512GB/15P;COMPUTACION
20158798;;M;23;CHILENO;;Extranjero;PROVIDENCIA                   ;N/D;159990;2;1;2;1;159990;0;0;0;Monitor UltraGear 23.8P 144Hz Full HD IPS;COMPUTACION
26919893;Soltero;M;42;NO INFORMA NACIONALIDAD;;Extranjero;PROVIDENCIA                   ;METROPOLITANA;223980;2;1;2;1;223980;0;0;0;NTBK Inspiron 3501 Ci3-1115G4/4GB/1TB/14P;COMPUTACION
14756509;;M;64;COLOMBIANO;;Boomers;CONCEPCION;BIO-BIO;177980;2;1;2;1;177980;0;0;0;Monitor 24 Gaming FHD 144 Hz HDMI/Flat IPS/Blac;COMPUTACION
26912240;;M;28;VENEZOLANO;;Extranjero;SAN JOAQUIN;METROPOLITANA;153980;2;1;2;1;153980;0;0;0;NTBK Inspiron 3502 Celeron/4GB/128GB SSD/+O365;COMPUTACION
16661503;;F;34;CHILENO;;Millenial;PROVIDENCIA                   ;METROPOLITANA;223980;2;1;2;1;223980;0;0;0;NTBK Inspiron 3501 Ci3-1115G4/4GB/1TB/14P;COMPUTACION
17711703;Soltero;F;32;CHILENO;PSICOLOGA;Millenial;PROVIDENCIA                   ;METROPOLITANA;352970;3;2;0;0;0;3;2;352970;NTBK Vivobook Ci3/4GB/128GB SSD/15P W+T Ingl;COMPUTACION
6529836;Casado;M;70;CHILENO;PROFESOR;Silencioso;BULNES                        ;BIO BIO;199990;1;1;0;0;0;1;1;199990;Galaxy Tab A8 (10.5, 32GB, LTE) Gray;COMPUTACION
9732230;;M;57;CHILENO;;Boomers;PARRAL                        ;MAULE;213290;3;2;0;0;0;3;2;213290;Tab M10 Plus FHD 4GB 64GB 10.3P platinum grey;COMPUTACION
13482757;;M;44;CHILENO;;Silencioso;PROVIDENCIA                   ;METROPOLITANA;48980;2;1;2;1;48980;0;0;0;Multifuncional DeskJet Ink Advantage 2775 Wifi;COMPUTACION
25306702;Soltero;M;56;COLOMBIANO;;Extranjero;ANTOFAGASTA;ANTOFAGASTA;230480;2;1;2;1;230480;0;0;0;NTBK Inspiron 3501 Ci3-1115G4/4GB/1TB/14P;COMPUTACION
13864532;;F;41;CHILENO;;X;ARICA                         ;TARAPACA;1053390;9;3;0;0;0;9;3;1053390;Monitor Gamer Redragon Jade 27P 165Hz Full HD;COMPUTACION
19294894;Soltero;M;25;CHILENO;CONTADOR GENERAL;Z;SAN IGNACIO                   ;BIO BIO;177990;3;1;0;0;0;3;1;177990;Multifuncional Smart Tank 515 Wifi;COMPUTACION
5196194;;M;77;CHILENO;;Silencioso;RENCA                         ;METROPOLITANA;139990;1;1;0;0;0;1;1;139990;Multifuncional EcoTank L3210;COMPUTACION
18643715;Soltero;F;28;CHILENO;;Millenial;PROVIDENCIA                   ;METROPOLITANA;149990;1;1;1;1;149990;0;0;0;Multifuncional DCPT220;COMPUTACION
16299798;;F;36;CHILENO;;Millenial;SALAMANCA                     ;COQUIMBO;1593280;14;7;0;0;0;14;7;1593280;NTBK IP3 R5-5500U 8GB/256GB SSD/14P FHD/T+W ingl;COMPUTACION
12566963;Soltero;F;48;CHILENO;;X;TOCOPILLA                     ;ANTOFAGASTA;805700;4;2;0;0;0;4;2;805700;NTBK 15-eh0006la Ryzen 5-4500U/8GB/512GB/15P;COMPUTACION
24277335;;M;28;PERUANO;;Extranjero;N/D;N/D;303980;2;1;2;1;303980;0;0;0;TAB P11 6G-128GB Case + KB + Pen + Wifi +Â  Slate;COMPUTACION
15435037;;M;40;CHILENO;;X;"";"";309980;2;2;0;0;0;2;2;309980;Smart Tab M8 2G-32GB 8 IPS HD WiFi + Docking iro;COMPUTACION
11363474;Soltero;F;53;CHILENO;;X;PROVIDENCIA                   ;METROPOLITANA;169990;1;1;0;0;0;1;1;169990;Multifuncional EcoTank L3210;COMPUTACION
9945644;;F;49;CHILENO;;X;COIHAIQUE                     ;AYSEN;809960;4;4;0;0;0;4;4;809960;Tab M10 Plus FHD 4GB 64GB 10.3P platinum grey;COMPUTACION
18857431;;F;27;CHILENO;;Z;CHILLAN                       ;BIO BIO;149330;4;1;0;0;0;4;1;149330;Tab M8 2G-32GB 8-inch IPS HD Wifi Grey;COMPUTACION
13711729;;F;43;CHILENO;;X;LONGAVI                       ;MAULE;276940;6;5;0;0;0;6;5;276940;Multifuncional Ink Tank 315;COMPUTACION
16575897;;M;34;CHILENO;;Silencioso;N/D;N/D;933960;4;2;4;2;933960;0;0;0;NTBK M14 Core i5-1155G7/8GB/256GB SSD/14P FHD;COMPUTACION
26711193;;F;30;VENEZOLANO;;Extranjero;QUILLOTA                      ;VALPARAISO;580960;7;2;0;0;0;7;2;580960;NTBK Herobook Celeron N4020/8GB/256SSD/14P FHD;COMPUTACION
19824213;;M;23;CHILENO;;Z;CHILLAN                       ;BIO BIO;832980;2;1;0;0;0;2;1;832980;NTBK M3500 R7-5800H/8GB/512GB SSD/RTX 3050 4GB;COMPUTACION
18973702;Soltero;M;27;CHILENO;;Z;SAN ESTEBAN                   ;VALPARAISO;174010;2;1;0;0;0;2;1;174010;Tab M10 Plus FHD 4GB 64GB 10.3P platinum grey;COMPUTACION
15230853;;M;40;CHILENO;;X;PROVIDENCIA                   ;METROPOLITANA;27990;1;1;1;1;27990;0;0;0;TAB 7 MB4 Plus 4Core 1GB 16GB 7 Plata;COMPUTACION
5591170;;F;72;CHILENO;;Silencioso;VILLA ALEMANA                 ;VALPARAISO;146980;2;1;2;1;146980;0;0;0;NTBK 240 G8 Celeron N4020/4GB/500GB/14P;COMPUTACION
25718218;;F;32;COLOMBIANO;;Extranjero;CANETE                        ;BIO BIO;834960;4;3;0;0;0;4;3;834960;TAB Galaxy S7 FE (12.4, 64GB WIFI) BLACK;COMPUTACION
16379535;;M;36;CHILENO;;X;PROVIDENCIA                   ;METROPOLITANA;303980;2;1;2;1;303980;0;0;0;TAB P11 6G-128GB Case + KB + Pen + Wifi +Â  Slate;COMPUTACION
11992337;;M;49;CHILENO;;X;QUILPUE                       ;VALPARAISO;1084950;8;4;0;0;0;8;4;1084950;Multifuncional XP-2101 wifi;COMPUTACION
11240620;;F;54;CHILENO;;Boomers;RENCA                         ;METROPOLITANA;265980;2;1;2;1;265980;0;0;0;NTBK 15-ef1015la Ryzen 3-4300U/4GB/256GBSSD/15P;COMPUTACION
8649297;;M;63;CHILENO;;Boomers;PARRAL                        ;MAULE;1267930;7;9;0;0;0;7;9;1267930;Monitor Gamer Redragon Jade 27P 165Hz Full HD;COMPUTACION
17570240;;F;32;CHILENO;;Millenial;PROVIDENCIA                   ;METROPOLITANA;48980;2;1;2;1;48980;0;0;0;Impresora Laser HL-1202 Monocromatica;COMPUTACION
14708525;;F;45;CHILENO;;Extranjero;ARICA                         ;ARICA Y PARINACOTA;396430;2;1;0;0;0;2;1;396430;NTBK 14-dq2025la Ci3-1115G4/4GB/256GB+16GB/14P;COMPUTACION
15221289;;F;40;CHILENO;;X;N/D;N/D;261962;4;5;0;0;0;4;5;261962;NTBK D330 Celeron N4020/4GB/64GB/10P+OfficeHS;COMPUTACION
13365941;;F;45;CHILENO;;X;CATEMU                        ;VALPARAISO;199990;1;1;1;1;199990;0;0;0;NTBK IP3i Celeron N4020/4G/500GB/14P/Rojo;COMPUTACION
16076888;Casado;F;37;CHILENO;TECNICO DE NIVEL SUPERIOR EN ENFERMERIA;Millenial;PROVIDENCIA                   ;METROPOLITANA;260960;4;2;4;2;260960;0;0;0;Impresora Laser HL-1202 Monocromatica;COMPUTACION
19275917;;F;26;CHILENO;;Z;PUTAENDO                      ;VALPARAISO;80620;2;1;0;0;0;2;1;80620;Multifuncional DeskJet Ink Advantage 2775 Wifi;COMPUTACION
13260637;;F;45;CHILENO;;X;QUILICURA                     ;METROPOLITANA;895939;7;2;0;0;0;7;2;895939;NTBK X415 Core i3-10110U/4GB/256GB SSD/14P FHD;COMPUTACION
18572359;;M;28;CHILENO;;Millenial;N/D;N/D;634240;5;3;0;0;0;5;3;634240;NTBK BR11 Celeron N4500/4GB/64GB eMMC/11P;COMPUTACION
16762895;;F;33;CHILENO;;Extranjero;SAN PEDRO DE LA PAZ           ;BIO BIO;193960;4;2;4;2;193960;0;0;0;NTBK DATACHABLE IDEAPAD D330 N4020 4G 128G W10PR;COMPUTACION
12662941;;M;48;CHILENO;;X;EL BOSQUE                     ;METROPOLITANA;1507820;17;6;5;2;406940;12;4;1100880;Multifuncional EcoTank L4260 Wifi y Duplex;COMPUTACION
19556162;;M;24;CHILENO;;Z;VALDIVIA                      ;LOS RIOS;707860;3;2;0;0;0;3;2;707860;NTBK 15-ef1015la Ryzen 3-4300U/4GB/256GBSSD/15P;COMPUTACION
17793739;;M;31;CHILENO;;Millenial;PEUMO                         ;L.G.B.OÂ´HIGGINS;193280;2;1;0;0;0;2;1;193280;Multifuncional Ink Tank 415 Wifi;COMPUTACION
17685395;Soltero;F;31;CHILENO;;Millenial;PROVIDENCIA                   ;METROPOLITANA;103980;2;1;2;1;103980;0;0;0;TAB Galaxy A7 Lite (8.7, 32GB, WIFI);COMPUTACION
27409125;;M;25;VENEZOLANO;;Extranjero;INDEPENDENCIA;METROPOLITANA;49990;1;1;1;1;49990;0;0;0;Multifuncional DeskJet Ink Advantage 2775 Wifi;COMPUTACION
13537796;;F;45;CHILENO;;X;SALAMANCA                     ;COQUIMBO;810980;2;1;2;1;810980;0;0;0;NTBK FX506 Ci5-10300H/8GB/512GB SSD/GTX1650 4GB;COMPUTACION
13682231;Casado;F;43;CHILENO;INGENIERO;X;PROVIDENCIA                   ;METROPOLITANA;349990;2;1;2;1;349990;0;0;0;NTBK IP3 Ryzen 3-5300U/8GB/256GB SSD/14P FHD;COMPUTACION
11945443;;M;50;CHILENO;;X;RENCA                         ;METROPOLITANA;359980;2;2;2;2;359980;0;0;0;Galaxy Tab A8 (10.5, 64GB, WIFI) Gray;COMPUTACION
16395284;;F;36;CHILENO;;Millenial;"";"";49990;1;1;1;1;49990;0;0;0;Multifuncional Pixma TR4522 Wifi;COMPUTACION
17873808;;F;31;CHILENO;;Millenial;ARAUCO;BIO-BIO;149990;1;1;1;1;149990;0;0;0;Galaxy Tab A8 (10.5, 32GB, WIFI) Silver;COMPUTACION
9359552;;M;57;CHILENO;;Boomers;DALCAHUE;LOS LAGOS;251970;5;3;3;2;241970;2;1;10000;NTBK DATACHABLE IDEAPAD D330 N4020 4G 128G W10PR;COMPUTACION
20519644;;M;21;CHILENO;;Z;N/D;N/D;479980;4;3;1;1;369990;3;2;109990;NTBK 255 G8 Ryzen 5-5500U/8GB/256GB SSD/15P;COMPUTACION
20090912;;F;23;CHILENO;;Z;PROVIDENCIA                   ;METROPOLITANA;189990;1;1;1;1;189990;0;0;0;Galaxy Tab A8 (10.5, 64GB, WIFI) Gray;COMPUTACION
8119536;;F;67;CHILENO;;Boomers;CAUQUENES                     ;MAULE;309980;2;2;2;2;309980;0;0;0;Multifuncional EcoTank L3210;COMPUTACION
16759363;;F;34;CHILENO;;Millenial;COIHAIQUE                     ;AYSEN;822950;5;5;0;0;0;5;5;822950;NTBK IP3 Core i3-1115G4/4GB/512GB SSD/14P FHD;COMPUTACION
10187669;;M;56;CHILENO;;Boomers;LIMACHE                       ;VALPARAISO;387500;3;1;0;0;0;3;1;387500;AIO/Athlon 3050U/4GB/1TB + 256GB/UMA/White;COMPUTACION
10904052;;M;51;CHILENO;;X;ANTOFAGASTA                   ;ANTOFAGASTA;495961;5;4;0;0;0;5;4;495961;Monitor Y25-25 (D19245FY0) 24.5inch-HDMI;COMPUTACION
13620663;;M;43;CHILENO;;X;PENCO                         ;BIO BIO;264970;3;3;0;0;0;3;3;264970;Multifuncional EcoTank L3210;COMPUTACION
10018686;;M;55;CHILENO;;Boomers;ARICA                         ;ARICA Y PARINACOTA;1019970;3;3;0;0;0;3;3;1019970;NTBK M3500 Ryzen 5 -5600H/8GB/512GB SSD/15P FHD;COMPUTACION
17572461;Soltero;M;32;CHILENO;;Millenial;PROVIDENCIA                   ;METROPOLITANA;574380;4;3;0;0;0;4;3;574380;Multifuncional Smart tank 530 WiFi ADF;COMPUTACION
13663441;;F;44;CHILENO;;X;PROVIDENCIA                   ;METROPOLITANA;153980;2;1;2;1;153980;0;0;0;Multifuncional Smart Tank 515 Wifi;COMPUTACION
14537401;Soltero;F;43;CHILENO;INGENIERO;X;RENCA                         ;METROPOLITANA;245830;3;2;3;2;245830;0;0;0;Multifuncional EcoTank L3210;COMPUTACION
12428436;;F;50;CHILENO;;X;N/D;N/D;199980;2;2;2;2;199980;0;0;0;Multifuncional Pixma TR4522 Wifi;COMPUTACION
5688979;;F;80;CHILENO;;Silencioso;PANGUIPULLI                   ;LOS LAGOS;139990;1;1;0;0;0;1;1;139990;Multifuncional EcoTank L3210;COMPUTACION
10065638;;M;59;CHILENO;;Boomers;VALLENAR;ATACAMA;1689331;8;6;0;0;0;8;6;1689331;NTBK M3500 R7-5800H/8GB/512GB SSD/RTX 3050 4GB;COMPUTACION
13111121;;M;46;CHILENO;;X;PAINE                         ;METROPOLITANA;629980;2;2;0;0;0;2;2;629980;NTBK Aspire 5 Ci3-10110U/12GB/512GB SSD/15P FHD;COMPUTACION
4715918;;M;78;CHILENO;;Silencioso;PEUMO                         ;L.G.B.OÂ´HIGGINS;613580;12;7;0;0;0;12;7;613580;TAB Galaxy A7 Lite (8.7, 32GB, WIFI);COMPUTACION
16157438;;M;36;CHILENO;;Millenial;PROVIDENCIA                   ;METROPOLITANA;192970;3;1;0;0;0;3;1;192970;NTBK IP1 AMD 3020e/4GB/64GB eMMC/14P;COMPUTACION
18699064;;M;27;CHILENO;;Z;PROVIDENCIA                   ;METROPOLITANA;259990;1;1;1;1;259990;0;0;0;NTBK 15-ef1015la Ryzen 3-4300U/4GB/256GBSSD/15P;COMPUTACION
8271667;;M;64;CHILENO;;Boomers;PEUMO                         ;L.G.B.OÂ´HIGGINS;1298221;12;6;0;0;0;12;6;1298221;NTBK 15-ef1015la Ryzen 3-4300U/4GB/256GBSSD/15P;COMPUTACION
17220786;;F;33;CHILENO;;Millenial;N/D;N/D;44990;1;1;1;1;44990;0;0;0;Multifuncional DeskJet Ink Advantage 2775 Wifi;COMPUTACION
5469105;;M;76;CHILENO;;Silencioso;RENCA                         ;METROPOLITANA;97980;2;1;2;1;97980;0;0;0;NTBK BR11 Celeron N4500/4GB/64GB eMMC/11P;COMPUTACION
20516486;;F;21;CHILENO;;Millenial;"";"";0;0;2;0;2;0;0;0;0;NTBK 240 G8 Core i3-1005G1/4GB/1TB/14P;COMPUTACION
26713449;;M;30;VENEZOLANO;;Extranjero;N/D;N/D;0;0;2;0;2;0;0;0;0;TAB 7 MB4 Plus 4Core 1GB 16GB 7 Plata;COMPUTACION
13357275;;F;43;CHILENO;;X;CALAMA                        ;ANTOFAGASTA;160980;2;1;2;1;160980;0;0;0;Multifuncional DCPT520W Wifi;COMPUTACION
15559218;;M;38;CHILENO;;X;N/D;N/D;229980;2;2;0;0;0;2;2;229980;TAB Galaxy A7 Lite (8.7, 64GB, WIFI);COMPUTACION
15081184;;F;40;CHILENO;;X;N/D;N/D;399970;4;5;0;0;0;4;5;399970;Smart Tab M8 2G-32GB 8 IPS HD WiFi + Docking iro;COMPUTACION
26742644;;F;47;EXTRANJERO - NO INFORMA NACIONALIDAD;;Extranjero;"";"";503080;3;2;0;0;0;3;2;503080;NTBK Herobook Celeron N4020/8GB/256SSD/14P FHD;COMPUTACION
19699368;;F;25;CHILENO;;Z;PROVIDENCIA                   ;METROPOLITANA;149990;1;1;1;1;149990;0;0;0;Multifuncional DCPT520W Wifi;COMPUTACION
15213189;;M;39;CHILENO;;X;NACIMIENTO                    ;BIO BIO;174990;1;1;0;0;0;1;1;174990;Multifuncional EcoTank L3250 Wifi;COMPUTACION
15575416;;F;28;CHILENO;;Millenial;ILLAPEL                       ;COQUIMBO;761050;6;4;0;0;0;6;4;761050;TAB Galaxy A7 Lite (8.7, 32GB, WIFI);COMPUTACION
19174395;;F;26;CHILENO;;Millenial;"";"";433980;2;1;2;1;433980;0;0;0;TAB Galaxy S7 FE (12.4, 128GB WIFI) SILVER;COMPUTACION
7647461;;M;61;CHILENO;;Boomers;PROVIDENCIA                   ;METROPOLITANA;0;0;2;0;2;0;0;0;0;T544 DYE BLACK INK BOTTLE (65ml);COMPUTACION
10038865;;F;55;CHILENO;;Boomers;ARICA                         ;ARICA Y PARINACOTA;1202520;4;2;4;2;1202520;0;0;0;NTBK D14 Ci5-10210U/8GB/512SSD/14 FHD/ office365;COMPUTACION
20199947;;F;23;CHILENO;;Silencioso;PROVIDENCIA                   ;METROPOLITANA;293980;2;1;2;1;293980;0;0;0;NTBK 15-ef1015la Ryzen 3-4300U/4GB/256GBSSD/15P;COMPUTACION
18342357;;M;29;CHILENO;;Millenial;LINARES                       ;MAULE;534460;2;1;0;0;0;2;1;534460;NTBK D15 Core i3-10110U/8GB/256GB SSD/15P FHD;COMPUTACION
15820822;;F;38;CHILENO;;Millenial;PROVIDENCIA                   ;METROPOLITANA;159990;1;1;0;0;0;1;1;159990;Multifuncional EcoTank L3210;COMPUTACION
9758530;;M;58;CHILENO;;Boomers;BUIN                          ;METROPOLITANA;149990;1;1;0;0;0;1;1;149990;Tab M10 Plus FHD 4GB 64GB 10.3P platinum grey;COMPUTACION
18367990;;M;29;CHILENO;;Millenial;VILLARICA                     ;ARAUCANIA;246970;4;2;0;0;0;4;2;246970;TAB Galaxy A7 Lite (8.7, 32GB, WIFI);COMPUTACION
18952216;;M;27;CHILENO;;Millenial;N/D;N/D;761950;5;4;0;0;0;5;4;761950;TAB Galaxy A7 Lite (8.7, 32GB, WIFI);COMPUTACION
20364191;;F;22;CHILENO;;Z;PROVIDENCIA                   ;METROPOLITANA;21980;2;1;2;1;21980;0;0;0;Tinta PG-243 Negra;COMPUTACION
16819087;Soltero;M;34;CHILENO;;Millenial;QUILLOTA                      ;VALPARAISO;239990;1;1;0;0;0;1;1;239990;Multifuncional EcoTank L4260 Wifi y Duplex;COMPUTACION
26194471;;F;34;CHILENO;;Extranjero;TOCOPILLA                     ;ANTOFAGASTA;1046420;8;4;0;0;0;8;4;1046420;Multifuncional DCPT520W Wifi;COMPUTACION
13512077;;F;44;CHILENO;;X;RENCA                         ;METROPOLITANA;8990;1;1;0;0;0;1;1;8990;TINTA BOTELLA EPSON T664120 NEGRA SERIE L;COMPUTACION
5806338;;F;75;CHILENO;;Silencioso;NUEVA IMPERIAL                ;ARAUCANIA;1394310;12;5;0;0;0;12;5;1394310;TAB Galaxy S7 FE (12.4, 64GB WIFI) LIGHT PINK;COMPUTACION
7690929;;M;64;CHILENO;;Boomers;BULNES                        ;BIO BIO;192730;2;1;0;0;0;2;1;192730;Tab M10 Plus FHD 4GB 64GB 10.3P platinum grey;COMPUTACION
8938840;;F;45;CHILENO;;X;COIHAIQUE                     ;AYSEN;469990;1;1;0;0;0;1;1;469990;NTBK 348 G7 Core i5-10210U/4GB/1TB/14P;COMPUTACION
16102533;;M;36;CHILENO;;Millenial;"";"";179990;1;1;0;0;0;1;1;179990;NTBK D330 Celeron N4020/4GB/64GB/10P+OfficeHS;COMPUTACION
15286775;;F;39;CHILENO;;X;CALBUCO                       ;LOS LAGOS;439990;1;1;0;0;0;1;1;439990;NTBK IP3 Ryzen 3-5300U/8GB/256GB SSD/14P FHD;COMPUTACION
10884308;;M;55;CHILENO;;Boomers;LINARES                       ;MAULE;99990;1;1;0;0;0;1;1;99990;TAB Galaxy A7 Lite (8.7, 32GB, WIFI);COMPUTACION
19864266;;F;24;CHILENO;;Z;COQUIMBO;COQUIMBO;199990;1;1;0;0;0;1;1;199990;Galaxy Tab A8 (10.5, 32GB, WIFI) Pink Gold;COMPUTACION
13581152;;F;42;CHILENO;;X;COLLIPULLI                    ;ARAUCANIA;149990;1;1;0;0;0;1;1;149990;Multifuncional EcoTank L3210;COMPUTACION
17231392;;F;32;CHILENO;;Millenial;PROVIDENCIA                   ;METROPOLITANA;47980;2;2;0;0;0;2;2;47980;TABLET MLAB 7 MB4 PLUS 1+16GB RED;COMPUTACION
11567956;;M;52;CHILENO;;X;N/D;N/D;279981;3;2;0;0;0;3;2;279981;Multifuncional EcoTank L3210;COMPUTACION
12236124;;F;50;CHILENO;;X;PROVIDENCIA                   ;METROPOLITANA;875960;4;3;0;0;0;4;3;875960;NTBK GAMER N5 Ci5-10300H/16GB/512SSD/GTX1650 4GB;COMPUTACION
10838951;;F;57;CHILENO;;Boomers;CALBUCO                       ;LOS LAGOS;119990;1;1;0;0;0;1;1;119990;TAB Galaxy A7 Lite (8.7, 32GB, WIFI + 4G);COMPUTACION
5937507;;F;74;CHILENO;;Silencioso;LA SERENA                     ;COQUIMBO;114990;1;1;0;0;0;1;1;114990;TABLET TCL TAB 10NEO BLACK+ KEYBOARD;COMPUTACION
18337663;;M;29;CHILENO;;Millenial;LA FLORIDA                    ;METROPOLITANA;99990;2;1;2;1;99990;0;0;0;TAB Galaxy A7 Lite (8.7, 32GB, WIFI);COMPUTACION
12592440;Casado;F;48;CHILENO;QUIMICO FARMACEUTICO;X;RENCA                         ;METROPOLITANA;394980;2;1;2;1;394980;0;0;0;TAB Galaxy S7 FE (12.4, 128GB WIFI) BLACK;COMPUTACION
12973996;;F;46;CHILENO;;X;CERRO NAVIA                   ;METROPOLITANA;286980;2;1;2;1;286980;0;0;0;NTBK 15-ef1015la Ryzen 3-4300U/4GB/256GBSSD/15P;COMPUTACION
18804850;;F;28;CHILENO;;Millenial;PROVIDENCIA                   ;METROPOLITANA;399990;1;1;0;0;0;1;1;399990;NTBK IP3 Ryzen 3-3250U/8GB/1TB/15P;COMPUTACION
24459853;;F;51;COLOMBIANO;;Extranjero;N/D;N/D;244840;5;4;0;0;0;5;4;244840;TAB Galaxy A7 Lite (8.7, 32GB, WIFI + 4G);COMPUTACION
19712217;;F;24;CHILENO;;Z;VALLENAR;ATACAMA;977260;6;3;3;1;517290;3;2;459970;Multifuncional EcoTank L3210;COMPUTACION
15058511;;M;39;CHILENO;;X;RENCA                         ;METROPOLITANA;159990;1;1;1;1;159990;0;0;0;Multifuncional DCPT520W Wifi;COMPUTACION
11934472;;M;49;CHILENO;;X;COCHRANE                      ;AYSEN;968988;7;5;0;0;0;7;5;968988;NTBK IP3i Celeron N4020/4G/500GB/14P/Rojo;COMPUTACION
19296131;;M;26;CHILENO;;Z;"";"";539750;4;2;0;0;0;4;2;539750;Multifuncional Ink Tank 315;COMPUTACION
12325231;;F;49;CHILENO;;X;TALCA                         ;MAULE;269140;2;1;0;0;0;2;1;269140;NTBK HT14 Celeron N4020 4GB/128GB SSD/14P;COMPUTACION
19458643;;F;25;CHILENO;;Z;PROVIDENCIA                   ;METROPOLITANA;34990;1;1;0;0;0;1;1;34990;TAB 7 MB4 Plus 4Core 1GB 16GB 7 Negra;COMPUTACION
20712607;;F;21;CHILENO;;Millenial;N/D;N/D;399980;2;1;0;0;0;2;1;399980;NTBK Herobook Celeron N4020/8GB/256SSD/14P FHD;COMPUTACION
11316844;;F;54;CHILENO;;X;PROVIDENCIA                   ;METROPOLITANA;286210;5;2;0;0;0;5;2;286210;Galaxy Tab A8 (10.5, 32GB, WIFI) Gray;COMPUTACION
16585223;;F;35;CHILENO;;Millenial;CASTRO                        ;LOS LAGOS;149990;1;1;0;0;0;1;1;149990;Multifuncional EcoTank L3210;COMPUTACION
8097532;;M;61;CHILENO;;Boomers;CANETE                        ;BIO BIO;159990;1;1;0;0;0;1;1;159990;Multifuncional EcoTank L3210;COMPUTACION
17461040;;M;32;CHILENO;;Millenial;ANGOL                         ;ARAUCANIA;585930;7;5;0;0;0;7;5;585930;NTBK 15-dw1080la Celeron N4020/4GB/1TB/15P;COMPUTACION
10866383;;M;52;CHILENO;;X;RENCA;METROPOLITANA;299990;1;1;1;1;299990;0;0;0;NTBK X415 Core i3-10110U/4GB/256GB SSD/14P FHD;COMPUTACION
17226325;;F;34;CHILENO;;Millenial;PROVIDENCIA                   ;METROPOLITANA;449960;4;2;2;1;183980;2;1;265980;NTBK D330 Celeron N4020/4GB/64GB/10P+OfficeHS;COMPUTACION
11109519;Casado;M;54;CHILENO;;Boomers;CHIMBARONGO                   ;L.G.B.OÂ´HIGGINS;189990;1;1;0;0;0;1;1;189990;NTBK D330 Celeron N4020/4GB/64GB/10P+OfficeHS;COMPUTACION
12170110;;F;50;CHILENO;;X;N/D;N/D;919950;5;2;2;1;345980;3;1;573970;NTBK IP3 Ryzen 3-5300U/8GB/256GB SSD/14P FHD;COMPUTACION
5746758;;F;72;CHILENO;;Silencioso;HUECHURABA                    ;METROPOLITANA;129980;2;1;0;0;0;2;1;129980;TAB Galaxy A7 Lite (8.7, 32GB, WIFI);COMPUTACION
12208427;;M;52;CHILENO;;X;RENCA                         ;METROPOLITANA;86980;2;1;0;0;0;2;1;86980;TAB GAMER 7 QUAD CORE 2G+16G 8715;COMPUTACION
18009076;;F;30;CHILENO;;Millenial;"";"";149990;1;1;0;0;0;1;1;149990;Multifuncional EcoTank L3210;COMPUTACION
19117802;Soltero;F;26;CHILENO;;Silencioso;PROVIDENCIA                   ;METROPOLITANA;203980;2;1;2;1;203980;0;0;0;Multifuncional DCPT720DW Wifi, Duplex y ADF;COMPUTACION
13443654;;F;44;CHILENO;;X;CONCHALI;METROPOLITANA;183980;2;1;2;1;183980;0;0;0;Multifuncional EcoTank L3250 Wifi;COMPUTACION
16579849;;M;35;CHILENO;;Millenial;CURICO                        ;MAULE;158980;2;1;2;1;158980;0;0;0;Multifuncional EcoTank L3210;COMPUTACION
13387730;;F;43;CHILENO;;X;LOS ANGELES;BIO-BIO;205480;2;1;2;1;205480;0;0;0;Multifuncional DCPT720DW Wifi, Duplex y ADF;COMPUTACION
14042923;;M;41;CHILENO;;X;"";"";491960;4;3;0;0;0;4;3;491960;NTBK 15-dw1080la Celeron N4020/4GB/1TB/15P;COMPUTACION
11432372;;F;53;CHILENO;;X;PUERTO MONTT                  ;LOS LAGOS;529990;1;1;0;0;0;1;1;529990;NTBK 255 G8 Ryzen 5-5500U/8GB/256GB SSD/15P;COMPUTACION
15123754;;F;40;CHILENO;;X;RANCAGUA                      ;L.G.B.OÂ´HIGGINS;199990;1;1;0;0;0;1;1;199990;NTBK IP S145 AMD A4-9125/4GB/500GB/14P;COMPUTACION
9352463;;F;58;CHILENO;;Boomers;CARAHUE                       ;ARAUCANIA;240720;2;1;0;0;0;2;1;240720;Multifuncional EcoTank L3210;COMPUTACION
10568160;;M;56;CHILENO;;Boomers;ALTO HOSPICIO;TARAPACA;370951;7;3;0;0;0;7;3;370951;TAB Galaxy A7 Lite (8.7, 32GB, WIFI);COMPUTACION
26539069;Soltero;M;31;EXTRANJERO - NO INFORMA NACIONALIDAD;;Extranjero;COPIAPO;ATACAMA;298630;3;2;3;2;298630;0;0;0;TABLET MLAB 7 MB4 PLUS 1+16GB RED;COMPUTACION
7985971;;F;64;CHILENO;;Boomers;VILLA ALEMANA                 ;VALPARAISO;500630;7;3;0;0;0;7;3;500630;Tab M10 FHD Plus LTE 10.3IN 2GB 32GB;COMPUTACION
17494773;;M;32;CHILENO;;Millenial;"";"";209990;1;1;0;0;0;1;1;209990;NTBK IP S145 AMD A4-9125/4GB/500GB/14P;COMPUTACION
26269034;;M;34;EXTRANJERO - NO INFORMA NACIONALIDAD;;Extranjero;MELIPILLA;METROPOLITANA;188980;2;1;0;0;0;2;1;188980;TAB Galaxy A7 Lite (8.7, 32GB, WIFI);COMPUTACION
15198873;;F;40;CHILENO;;X;N/D;N/D;728960;4;2;0;0;0;4;2;728960;NTBK Aspire 5 Ci3-10110U/12GB/512GB SSD/15P FHD;COMPUTACION
12120111;;F;57;CHILENO;;Boomers;N/D;N/D;168980;2;1;0;0;0;2;1;168980;TAB Galaxy A7 Lite (8.7, 32GB, WIFI + 4G);COMPUTACION
7118368;Viudo;F;69;CHILENO;;Silencioso;NATALES                       ;MAGALLANES;199990;1;1;0;0;0;1;1;199990;NTBK IP S145 AMD A4-9125/4GB/500GB/14P;COMPUTACION
15000650;;M;40;CHILENO;;X;RENCA                         ;METROPOLITANA;404980;2;1;2;1;404980;0;0;0;NTBK IP3 Ryzen 3-5300U/8GB/256GB SSD/14P FHD;COMPUTACION
18869298;Soltero;F;28;CHILENO;TECNOLOGO MEDICO;Millenial;SAN JAVIER                    ;MAULE;979990;1;1;0;0;0;1;1;979990;MBA 13.3 SPG/8C CPU/8C GPU/8GB/512GB-BES;COMPUTACION
18505483;;F;29;CHILENO;;Millenial;CURANILAHUE                   ;BIO BIO;518110;8;7;0;0;0;8;7;518110;TAB Galaxy A7 Lite (8.7, 32GB, WIFI + 4G);COMPUTACION
15044387;;M;39;CHILENO;;X;RENCA                         ;METROPOLITANA;794980;2;1;2;1;794980;0;0;0;Multifuncional Fotografico A3+ L8180;COMPUTACION
8231151;;F;63;CHILENO;;Boomers;LA LIGUA                      ;VALPARAISO;209972;3;2;2;1;185980;1;1;23992;Multifuncional EcoTank L3250 Wifi;COMPUTACION
18362406;;M;29;CHILENO;;Millenial;CALAMA                        ;ANTOFAGASTA;440980;2;1;2;1;440980;0;0;0;TAB Galaxy S7 FE (12.4, 128GB WIFI) LIGHT GREEN;COMPUTACION
17366183;;F;32;CHILENO;;Millenial;PITRUFQUEN                    ;ARAUCANIA;726970;3;3;0;0;0;3;3;726970;NTBK 14-dy0501laCi3-1125G4/8GB/256SSD/FHD/Pen;COMPUTACION
19088177;;F;27;CHILENO;;Z;"";"";349990;1;1;1;1;349990;0;0;0;NTBK 14-dy0501laCi3-1125G4/8GB/256SSD/FHD/Pen;COMPUTACION
7797237;;F;64;CHILENO;;Boomers;LOS ANDES                     ;VALPARAISO;333960;4;2;0;0;0;4;2;333960;NTBK IP3i Celeron N4020/4G/500GB/14P/Rojo;COMPUTACION
9599042;;M;57;CHILENO;;Boomers;RENCA                         ;METROPOLITANA;378980;2;1;2;1;378980;0;0;0;NTBK IP3 Athlon 3050U/8GB/1TB/14P;COMPUTACION
19620183;;F;24;CHILENO;;Millenial;"";"";229970;3;2;1;1;14990;2;1;214980;NTBK IP S145 AMD A4-9125/4GB/500GB/14P;COMPUTACION
18014573;;F;30;CHILENO;;Millenial;PROVIDENCIA                   ;METROPOLITANA;440480;2;1;2;1;440480;0;0;0;TAB Galaxy S7 FE (12.4, 128GB WIFI) LIGHT GREEN;COMPUTACION
8998182;;M;62;CHILENO;;Boomers;PROVIDENCIA                   ;METROPOLITANA;109990;1;1;0;0;0;1;1;109990;TAB Galaxy A7 Lite (8.7, 32GB, WIFI + 4G);COMPUTACION
18509248;;F;28;CHILENO;;Millenial;N/D;N/D;1089980;3;2;1;1;879990;2;1;209990;NTBK GAMER N5 Ci5-10300H/16GB/512SSD/GTX1650 4GB;COMPUTACION
19386434;;M;26;CHILENO;;Z;SAN RAFAEL                    ;MAULE;399990;1;1;1;1;399990;0;0;0;NTBK 14-dy0501laCi3-1125G4/8GB/256SSD/FHD/Pen;COMPUTACION
9775383;;F;58;CHILENO;;Boomers;VALLENAR;ATACAMA;473140;5;2;0;0;0;5;2;473140;NTBK 14-ck2091la i3-10110U 4GB 128GB 14 HD;COMPUTACION
19289169;Soltero;F;26;CHILENO;;Z;PROVIDENCIA                   ;METROPOLITANA;38980;2;1;2;1;38980;0;0;0;TABLET MLAB 7 MB4 PLUS 1+16GB RED;COMPUTACION
10532108;;F;57;CHILENO;;Boomers;VALDIVIA                      ;LOS LAGOS;199990;1;1;0;0;0;1;1;199990;NTBK 240 G8 Celeron N4020/4GB/500GB/14P;COMPUTACION
13617896;;F;42;CHILENO;;X;RENCA                         ;METROPOLITANA;64990;1;1;0;0;0;1;1;64990;Multifuncional DeskJet Ink Advantage 3775 Wifi;COMPUTACION
15201449;;F;40;CHILENO;;X;RENCA                         ;METROPOLITANA;125840;2;1;2;1;125840;0;0;0;Multifuncional Pixma TR4522 Wifi;COMPUTACION
12532115;Casado;M;48;CHILENO;;X;CORONEL                       ;BIO BIO;159990;1;1;0;0;0;1;1;159990;Multifuncional EcoTank L3210;COMPUTACION
19557056;Soltero;M;25;CHILENO;;Z;PUDAHUEL;METROPOLITANA;223980;2;1;2;1;223980;0;0;0;Monitor Emerald 27P 165Hz Full HD;COMPUTACION
8665993;;M;60;CHILENO;;Boomers;RENCA                         ;METROPOLITANA;153980;2;1;2;1;153980;0;0;0;Multifuncional EcoTank L3210;COMPUTACION
17272365;;F;32;CHILENO;;Millenial;LOS ANDES                     ;VALPARAISO;219990;1;1;0;0;0;1;1;219990;NTBK IP3i Celeron N4020/4G/500GB/14P/Rojo;COMPUTACION
17707930;;F;31;CHILENO;;Millenial;PROVIDENCIA                   ;METROPOLITANA;413980;2;1;2;1;413980;0;0;0;NTBK 14-dy0501laCi3-1125G4/8GB/256SSD/FHD/Pen;COMPUTACION
26434696;;M;60;VENEZOLANO;;Extranjero;N/D;N/D;39990;1;1;1;1;39990;0;0;0;TAB MLAB MBX 8 QUAD CORE 1G+16G 8716;COMPUTACION
16200965;;M;36;CHILENO;;Silencioso;PROVIDENCIA                   ;METROPOLITANA;1003980;2;1;2;1;1003980;0;0;0;MBA 13.3 SPG/8C CPU/8C GPU/8GB/512GB-BES;COMPUTACION
15186271;;M;39;CHILENO;;X;PROVIDENCIA                   ;METROPOLITANA;399990;1;1;1;1;399990;0;0;0;NTBK 14-dy0501laCi3-1125G4/8GB/256SSD/FHD/Pen;COMPUTACION
19250232;;M;26;CHILENO;;Z;N/D;N/D;129990;1;1;0;0;0;1;1;129990;Tab M10 HD 2G-32GB 10.1 Iron grey WiFi;COMPUTACION
6742454;Soltero;M;69;CHILENO;;Silencioso;PICHILEMU                     ;L.G.B.OÂ´HIGGINS;916980;2;1;0;0;0;2;1;916980;NTBK GAMER GF63 Ci5-10500H/8GB/512SSD/1650 4GB;COMPUTACION
9572495;;M;57;CHILENO;;Boomers;PELARCO                       ;MAULE;269990;1;1;0;0;0;1;1;269990;NTBK 240 G8 Core i3-1005G1/4GB/1TB/14P;COMPUTACION
8698949;;F;61;CHILENO;;Boomers;CORONEL                       ;BIO BIO;376220;4;1;0;0;0;4;1;376220;NTBK Aspire 3 Athlon 3020e/8GB/256GB SSD/14P;COMPUTACION
9052439;;F;61;CHILENO;;Boomers;CHILLAN                       ;BIO BIO;253960;4;4;0;0;0;4;4;253960;TAB Galaxy A7 Lite (8.7, 32GB, WIFI + 4G);COMPUTACION
10695524;;M;55;CHILENO;;Boomers;PROVIDENCIA                   ;METROPOLITANA;404980;2;2;0;0;0;2;2;404980;NTBK 14-dy0501laCi3-1125G4/8GB/256SSD/FHD/Pen;COMPUTACION
16626600;;F;34;CHILENO;;Millenial;PROVIDENCIA                   ;METROPOLITANA;89990;1;1;0;0;0;1;1;89990;TAB M8 QC 2GB 32GB 8P Gris;COMPUTACION
19064886;;F;26;CHILENO;;Z;PROVIDENCIA                   ;METROPOLITANA;94990;1;3;2;1;38980;-1;2;56010;TAB M8 QC 2GB 32GB 8P Gris;COMPUTACION
15123613;;M;39;CHILENO;;X;PUENTE ALTO;METROPOLITANA;323980;2;1;2;1;323980;0;0;0;TAB Galaxy S7 FE (12.4, 64GB WIFI) BLACK;COMPUTACION
15653038;;F;39;CHILENO;;X;N/D;N/D;769980;2;2;0;0;0;2;2;769980;NTBK Aspire 5 Ci3-10110U/12GB/512GB SSD/15P FHD;COMPUTACION
12905710;;F;47;CHILENO;;X;RENCA                         ;METROPOLITANA;459990;1;1;0;0;0;1;1;459990;NTBK IP3 Ryzen 3-5300U/8GB/256GB SSD/14P FHD;COMPUTACION
17571035;;F;32;CHILENO;;Millenial;N/D;N/D;902980;2;1;0;0;0;2;1;902980;NTBK GAMER N5 Ci5-10300H/16GB/512SSD/GTX1650 4GB;COMPUTACION
15793459;;M;37;CHILENO;;Millenial;LO PRADO;METROPOLITANA;180980;2;1;0;0;0;2;1;180980;Tab M10 FHD Plus LTE 10.3IN 2GB 32GB;COMPUTACION
12999550;;F;45;CHILENO;;X;DALCAHUE                      ;LOS LAGOS;514572;3;3;0;0;0;3;3;514572;NTBK 14-dy0501laCi3-1125G4/8GB/256SSD/FHD/Pen;COMPUTACION
17937030;;M;31;CHILENO;;Millenial;COPIAPO                       ;ATACAMA;255980;2;2;0;0;0;2;2;255980;TAB MLAB MBX 8 QUAD CORE 1G+16G 8716;COMPUTACION
11366783;;M;53;CHILENO;;X;PANQUEHUE                     ;VALPARAISO;733370;2;3;0;0;0;2;3;733370;NTBK 15-dk1043la i5-10300H 8GB512SSD4V W10H;COMPUTACION
16391802;;F;35;CHILENO;;Millenial;LA CISTERNA                   ;METROPOLITANA;630920;8;3;6;2;300940;2;1;329980;NTBK 14-ck2091la i3-10110U 4GB 128GB 14 HD;COMPUTACION
12615821;;F;47;CHILENO;;X;PROVIDENCIA                   ;METROPOLITANA;209640;2;1;2;1;209640;0;0;0;Monitor Emerald 27P 165Hz Full HD;COMPUTACION
17394613;;M;32;CHILENO;;Millenial;CONCEPCION                    ;BIO BIO;323980;2;1;2;1;323980;0;0;0;TAB Galaxy S7 FE (12.4, 64GB WIFI) SILVER;COMPUTACION
9835962;;M;42;CHILENO;;X;PROVIDENCIA                   ;METROPOLITANA;304980;2;1;2;1;304980;0;0;0;TAB P11 6GB128SG Pen Slate Grey;COMPUTACION
17302971;;F;33;CHILENO;;Millenial;MAIPU                         ;METROPOLITANA;139990;1;1;1;1;139990;0;0;0;Tab M10 FHD Plus LTE 10.3IN 2GB 32GB;COMPUTACION
12725403;;F;47;CHILENO;;X;"";"";630950;5;2;0;0;0;5;2;630950;Monitor Y25-25 (D19245FY0) 24.5inch-HDMI;COMPUTACION
16240337;;F;36;CHILENO;;Millenial;PROVIDENCIA                   ;METROPOLITANA;49990;1;1;1;1;49990;0;0;0;TAB 7 PLAY AND LEARN PLUS BLUE 8868;COMPUTACION
25941478;;M;37;VENEZOLANO;;Extranjero;PROVIDENCIA                   ;METROPOLITANA;243960;4;1;4;1;243960;0;0;0;TAB M8 QC 2GB 32GB 8P Gris;COMPUTACION
18494934;Soltero;M;28;CHILENO;;Millenial;PROVIDENCIA                   ;METROPOLITANA;34990;1;1;1;1;34990;0;0;0;TAB 7 MB4 Plus 4Core 1GB 16GB 7 Plata;COMPUTACION
10684246;;M;54;CHILENO;;Boomers;PROVIDENCIA                   ;METROPOLITANA;243980;2;1;2;1;243980;0;0;0;NTBK 14-cf2097la Pentium Gold 6405U/8GB/256GB/14;COMPUTACION
12464715;Soltero;M;48;CHILENO;;Silencioso;CURICO                        ;MAULE;124990;1;1;0;0;0;1;1;124990;TAB Galaxy A 8 + S Pen (8, 32GB, WIFI);COMPUTACION
11668392;;F;51;CHILENO;;X;PROVIDENCIA                   ;METROPOLITANA;189990;1;2;0;0;0;1;2;189990;Galaxy Tab A7 (10.4 ,32GB, WIFI + 4G) Dark Gray;COMPUTACION
18492139;Soltero;F;28;CHILENO;;Silencioso;PROVIDENCIA                   ;METROPOLITANA;34990;1;1;1;1;34990;0;0;0;TAB 7 MB4 Plus 4Core 1GB 16GB 7 Plata;COMPUTACION
25993162;;F;41;VENEZOLANO;;Extranjero;"";"";252980;2;1;0;0;0;2;1;252980;NTBK IP3i Celeron N4020/4G/500GB/14P/Rojo;COMPUTACION
19515235;Soltero;F;25;CHILENO;MATRONA;Z;PROVIDENCIA                   ;METROPOLITANA;273980;2;1;2;1;273980;0;0;0;NTBK IP3 Core i3-1115G4/4GB/512GB SSD/14P FHD;COMPUTACION
19822213;;F;24;CHILENO;;Z;N/D;N/D;118950;5;2;0;0;0;5;2;118950;Multifuncional DeskJet Ink Advantage 3775 Wifi;COMPUTACION
14635686;;F;44;CHILENO;;X;RENCA                         ;METROPOLITANA;87980;2;2;0;0;0;2;2;87980;TAB GAMER 7 QUAD CORE 2G+16G 8715;COMPUTACION
16276049;;F;36;CHILENO;;Millenial;PROVIDENCIA                   ;METROPOLITANA;106980;2;1;0;0;0;2;1;106980;TAB M8 QC 2GB 32GB 8P Gris;COMPUTACION
25485115;;M;33;ECUATORIANO;;Extranjero;N/D;N/D;510930;7;3;0;0;0;7;3;510930;TAB Matepad T8 Wifi 2GB 32GB 8P;COMPUTACION
15367280;;F;41;CHILENO;;X;PENALOLEN;METROPOLITANA;105970;3;1;0;0;0;3;1;105970;TAB MLAB MBX 8 QUAD CORE 1G+16G 8716;COMPUTACION
13896938;;M;42;CHILENO;;X;PUENTE ALTO                   ;METROPOLITANA;1043970;3;1;3;1;1043970;0;0;0;NTBK Aspire 5 Ci3-10110U/12GB/512GB SSD/15P FHD;COMPUTACION
4024161;;F;84;CHILENO;;Silencioso;BUIN                          ;METROPOLITANA;133980;2;1;2;1;133980;0;0;0;Galaxy Tab A7 (10.4 ,32GB, WIFI) Gold;COMPUTACION
17757844;;M;31;CHILENO;;Millenial;COLBUN                        ;MAULE;99990;1;1;0;0;0;1;1;99990;Tab M10 HD 2G-32GB 10.1 Iron grey WiFi;COMPUTACION
7557453;;F;67;CHILENO;;Boomers;SAN FERNANDO                  ;L.G.B.OÂ´HIGGINS;59990;1;1;0;0;0;1;1;59990;Multifuncional DeskJet Ink Advantage 3775 Wifi;COMPUTACION
15124080;;M;39;CHILENO;;X;PROVIDENCIA                   ;METROPOLITANA;139980;2;1;0;0;0;2;1;139980;TAB GAMER 7 QUAD CORE 2G+16G 8715;COMPUTACION
16700170;;M;34;CHILENO;;Millenial;RIO CLARO                     ;MAULE;112980;2;1;0;0;0;2;1;112980;Tablet HMS Matepad T10;COMPUTACION
15052260;;M;39;CHILENO;;X;RENCA                         ;METROPOLITANA;59990;1;1;0;0;0;1;1;59990;TAB GAMER 7 QUAD CORE 2G+16G 8715;COMPUTACION
13190333;;M;44;CHILENO;;X;VINA DEL MAR                  ;VALPARAISO;239990;1;1;0;0;0;1;1;239990;BUNDLE TAB P11 6GB 128SSD Slate Grey;COMPUTACION
26434203;Soltero;F;35;EXTRANJERO - NO INFORMA NACIONALIDAD;;Extranjero;N/D;N/D;38980;2;1;2;1;38980;0;0;0;TABLET MLAB 7 MB4 PLUS 1+16GB RED;COMPUTACION
10012016;;M;51;CHILENO;;X;LOS ANGELES                   ;BIO BIO;298690;2;1;0;0;0;2;1;298690;NTBK 240 G8 Celeron N4020/4GB/500GB/14P;COMPUTACION
11252653;Casado;F;54;CHILENO;;Boomers;DALCAHUE                      ;LOS LAGOS;1002980;2;1;0;0;0;2;1;1002980;NTBK GAMER N5 Ci5-10300H/16GB/512SSD/GTX1650 4GB;COMPUTACION
16650637;;M;34;CHILENO;;Millenial;RENCA                         ;METROPOLITANA;149990;1;1;1;1;149990;0;0;0;Galaxy Tab A7 (10.4 ,32GB, WIFI) Silver;COMPUTACION
18380471;;F;29;CHILENO;;Millenial;N/D;N/D;449960;4;2;2;1;304980;2;1;144980;Tab M10 FHD Plus LTE 10.3IN 2GB 32GB;COMPUTACION
7123954;Casado;M;68;CHILENO;;Boomers;PUENTE ALTO                   ;METROPOLITANA;49990;1;1;0;0;0;1;1;49990;TAB MLAB MBX 8 QUAD CORE 1G+16G 8716;COMPUTACION
25862697;;F;42;VENEZOLANO;;Extranjero;SAN PEDRO DE LA PAZ           ;BIO BIO;89990;1;1;1;1;89990;0;0;0;Tab M8 2G-32GB 8-inch IPS HD Wifi Grey;COMPUTACION
11847058;;M;50;CHILENO;;X;N/D;N/D;664970;4;4;0;0;0;4;4;664970;NTBK IP3 Ryzen 3-3250U/8GB/1TB/15P;COMPUTACION
12543992;;M;47;CHILENO;;X;CAUQUENES                     ;MAULE;99990;1;1;0;0;0;1;1;99990;Tab M10 HD 2G-32GB 10.1 Iron grey WiFi;COMPUTACION
16171856;;F;37;CHILENO;;Millenial;MELIPILLA;METROPOLITANA;249990;1;1;0;0;0;1;1;249990;NTBK IP1 AMD 3020e/4GB/64GB eMMC/14P;COMPUTACION
15406298;;F;40;CHILENO;;X;MARIA PINTO                   ;METROPOLITANA;581150;4;2;0;0;0;4;2;581150;Multifuncional Pixma TR4522 Wifi;COMPUTACION
9113476;;M;59;CHILENO;;Boomers;SAN JAVIER                    ;MAULE;416960;4;3;0;0;0;4;3;416960;IMPRESORA LASER PASHER 3020;COMPUTACION
10939707;;F;52;CHILENO;;X;RENCA                         ;METROPOLITANA;132470;2;1;0;0;0;2;1;132470;Tab M10 HD 2G-32GB 10.1 Iron grey WiFi;COMPUTACION
13006898;;M;46;CHILENO;;X;IQUIQUE                       ;TARAPACA;70980;2;2;0;0;0;2;2;70980;TAB MLAB MBX 8 QUAD CORE 1G+16G 8716;COMPUTACION
10755744;;M;55;CHILENO;;Boomers;RENCA                         ;METROPOLITANA;661610;8;1;0;0;0;8;1;661610;NTBK 240 G8 Celeron N4020/4GB/500GB/14P;COMPUTACION
15345427;;M;39;CHILENO;;Silencioso;PROVIDENCIA                   ;METROPOLITANA;119990;1;3;1;3;119990;0;0;0;TAB Galaxy A 8 + S Pen (8, 32GB, WIFI);COMPUTACION
19579818;;F;25;CHILENO;;Z;PROVIDENCIA                   ;METROPOLITANA;244980;2;1;2;1;244980;0;0;0;TAB S6 Lite (610) 4GB 64GB 10.4P BLUE;COMPUTACION
12999978;;M;46;CHILENO;;X;"";"";217979;2;1;0;0;0;2;1;217979;Tab Yoga Smart;COMPUTACION
11331712;;M;53;CHILENO;;X;N/D;N/D;563970;4;2;4;2;563970;0;0;0;NTBK IP3 Ryzen 3-3250U/8GB/1TB/15P;COMPUTACION
16859923;;M;33;CHILENO;;Millenial;CURICO;MAULE;655480;2;1;2;1;655480;0;0;0;NTBK M14 Core i5-1155G7/8GB/256GB SSD/14P FHD;COMPUTACION
10516089;;F;57;CHILENO;;Boomers;PARRAL                        ;MAULE;1396130;6;3;0;0;0;6;3;1396130;NTBK Aspire 5 Ci3-10110U/12GB/512GB SSD/15P FHD;COMPUTACION
19438857;;F;26;CHILENO;;Millenial;N/D;N/D;132470;2;1;0;0;0;2;1;132470;Tab M10 HD 2G-32GB 10.1 Iron grey WiFi;COMPUTACION
15451591;;F;40;CHILENO;;Silencioso;PROVIDENCIA                   ;METROPOLITANA;103980;2;1;2;1;103980;0;0;0;TAB Galaxy A7 Lite (8.7, 32GB, WIFI);COMPUTACION
8900492;;M;56;CHILENO;;Boomers;N/D;N/D;319990;1;1;0;0;0;1;1;319990;NTBK GemiBook Celeron/12GB/256GB/2K/Tec-Ingles;COMPUTACION
14389501;;F;43;CHILENO;;X;LINARES                       ;MAULE;422980;2;1;0;0;0;2;1;422980;NTBK S145-14IIL I3 10/4G 128SSD/14HD;COMPUTACION
6713234;;F;71;CHILENO;;Silencioso;ANTOFAGASTA                   ;ANTOFAGASTA;335260;2;1;0;0;0;2;1;335260;NTBK 240 G8 Celeron N4020/4GB/500GB/14P;COMPUTACION
8436783;;F;58;CHILENO;;Boomers;PAINE                         ;METROPOLITANA;797050;4;2;0;0;0;4;2;797050;AIO/Athlon 3050U/4GB/1TB + 256GB/UMA/White;COMPUTACION
12004514;;F;54;CHILENO;;Boomers;"";"";104980;2;1;2;1;104980;0;0;0;TAB Galaxy A7 Lite (8.7, 32GB, WIFI);COMPUTACION
14623765;;F;46;CHILENO;;X;PROVIDENCIA                   ;METROPOLITANA;0;0;2;0;2;0;0;0;0;TAB Galaxy Tab A+SPen 8Core 3GB 32GB 8 Gris;COMPUTACION
15605454;;F;38;CHILENO;;Millenial;RENCA                         ;METROPOLITANA;122980;2;1;0;0;0;2;1;122980;Tab M10 HD 2G-32GB 10.1 Iron grey WiFi;COMPUTACION
13767067;;F;41;CHILENO;;X;N/D;N/D;927360;15;3;0;0;0;15;3;927360;TAB Galaxy Tab A+SPen 8Core 3GB 32GB 8 Gris;COMPUTACION
18433773;;M;28;CHILENO;;Millenial;ERCILLA;ARAUCANIA;306980;2;1;2;1;306980;0;0;0;NTKB X415MA-EK490T;COMPUTACION
13342493;;F;43;CHILENO;;X;PAINE                         ;METROPOLITANA;149990;1;1;0;0;0;1;1;149990;Multifuncional Ink Tank 415 Wifi;COMPUTACION
25668397;Casado;M;44;VENEZOLANO;;Extranjero;PROVIDENCIA                   ;METROPOLITANA;865830;3;1;3;1;865830;0;0;0;TAB P11 Pro 6+128GB 11.5 LED;COMPUTACION
15452257;;F;40;CHILENO;;X;PROVIDENCIA                   ;METROPOLITANA;139990;2;1;2;1;139990;0;0;0;TAB-X306X 10-INCH 4G+64G HD WIFI+4G LTE;COMPUTACION
11988297;;F;49;CHILENO;;X;PROVIDENCIA                   ;METROPOLITANA;734830;15;3;15;3;734830;0;0;0;TAB S6 Lite (610) 4GB 64GB 10.4P PINK;COMPUTACION
13025757;;F;46;CHILENO;;X;"";"";180960;4;2;2;1;69980;2;1;110980;Tab M10 HD 2G-32GB 10.1 Iron grey WiFi;COMPUTACION
19842612;;F;24;CHILENO;;Z;N/D;N/D;93980;2;1;2;1;93980;0;0;0;TAB Galaxy A7 Lite (8.7, 32GB, WIFI);COMPUTACION
12117976;;M;63;CHILENO;;Boomers;RENCA                         ;METROPOLITANA;159990;1;1;0;0;0;1;1;159990;Galaxy Tab A7 (10.4 ,32GB, WIFI + 4G) Dark Gray;COMPUTACION
9947907;;M;58;CHILENO;;Boomers;PUREN                         ;ARAUCANIA;759990;1;1;0;0;0;1;1;759990;NTBK G3 3500 Core i5-10300 8GB 256SSD 1650 4GB;COMPUTACION
19269104;;F;26;CHILENO;;Z;N/D;N/D;119990;1;1;0;0;0;1;1;119990;Galaxy Tab A7 (10.4 ,32GB, WIFI) Dark Gray;COMPUTACION
19486078;;F;25;CHILENO;;Z;PROVIDENCIA                   ;METROPOLITANA;143980;2;1;2;1;143980;0;0;0;Multifuncional Ink Tank 415 Wifi;COMPUTACION
12922511;;M;46;CHILENO;;X;PROVIDENCIA                   ;METROPOLITANA;45840;2;1;2;1;45840;0;0;0;Impresora Laser HL-1202 Monocromatica;COMPUTACION
17678353;;F;31;CHILENO;;Millenial;PROVIDENCIA                   ;METROPOLITANA;99990;1;1;0;0;0;1;1;99990;Impresora Monocromatica Xerox B210-NDI;COMPUTACION
16275108;;M;36;CHILENO;;Millenial;PENALOLEN                     ;METROPOLITANA;69990;2;1;2;1;69990;0;0;0;Tablet HMS Matepad T10;COMPUTACION
16010604;;M;37;CHILENO;;Millenial;PUENTE ALTO;METROPOLITANA;163980;2;1;2;1;163980;0;0;0;Galaxy Tab A7 (10.4 ,64GB, WIFI) Dark Gray;COMPUTACION
15052218;;F;40;CHILENO;;X;PROVIDENCIA                   ;METROPOLITANA;257540;2;1;2;1;257540;0;0;0;NTBK 240 G8 Celeron N4020/4GB/500GB/14P;COMPUTACION
14357025;;F;42;CHILENO;;X;N/D;N/D;132470;2;1;0;0;0;2;1;132470;Tab M10 HD 2G-32GB 10.1 Iron grey WiFi;COMPUTACION
16622931;Casado;M;35;CHILENO;TECNICO MECANICO;Millenial;PROVIDENCIA                   ;METROPOLITANA;113980;2;1;2;1;113980;0;0;0;Monitor L24e-30 (C20238FL0) 23.8inch-HDMI;COMPUTACION
25456423;;M;37;HAITIANO;;Extranjero;CERRILLOS                     ;METROPOLITANA;132470;2;1;0;0;0;2;1;132470;Tab M10 HD 2G-32GB 10.1 Iron grey WiFi;COMPUTACION
17888053;;F;30;CHILENO;;Millenial;ESTACION CENTRAL              ;METROPOLITANA;143980;2;1;2;1;143980;0;0;0;Multifuncional DCPT520W Wifi;COMPUTACION
6362191;;M;69;CHILENO;;Millenial;"";"";149990;1;1;0;0;0;1;1;149990;TAB Galaxy A 8 + S Pen (8, 32GB, WIFI);COMPUTACION
15813243;;M;37;CHILENO;;Silencioso;PROVIDENCIA                   ;METROPOLITANA;447070;2;1;0;0;0;2;1;447070;NTBK GemiBook Celeron/12GB/256GB/2K/Tec-Ingles;COMPUTACION
12269187;;M;50;CHILENO;;Silencioso;PROVIDENCIA                   ;METROPOLITANA;779990;2;1;2;1;779990;0;0;0;NTBK GAMER N5 Ci5-10300H/16GB/512SSD/GTX1650 4GB;COMPUTACION
19147297;;F;27;CHILENO;;Z;VALLENAR;ATACAMA;440000;2;1;0;0;0;2;1;440000;NTBK 14-ck2091la i3-10110U 4GB 128GB 14 HD;COMPUTACION
15877094;;F;37;CHILENO;;Millenial;N/D;N/D;329980;2;2;1;1;319990;1;1;9990;NTBK 240G7 CelN4020 14 4GB/500 PC;COMPUTACION
26856961;;M;39;VENEZOLANO;;Extranjero;N/D;N/D;525840;2;1;2;1;525840;0;0;0;TAB Galaxy S7 FE (12.4, 128GB WIFI) LIGHT PINK;COMPUTACION
12016229;;M;53;CHILENO;;X;N/D;N/D;194980;2;1;2;1;194980;0;0;0;Tablet Matepad 10.4;COMPUTACION
25743188;;M;34;HAITIANO;;Extranjero;RANCAGUA                      ;L.G.B.OÂ´HIGGINS;159990;1;1;0;0;0;1;1;159990;TAB Galaxy A7 Lite (8.7, 32GB, WIFI + 4G);COMPUTACION
25872125;;M;52;BOLIVIANO;;Extranjero;"";"";827080;2;1;0;0;0;2;1;827080;NTBK Gaming 3 Ryzen 5 4600H 8GB 512SSD G1650 4GB;COMPUTACION
16526989;;F;35;CHILENO;;Millenial;VICUNA                        ;COQUIMBO;975230;4;1;0;0;0;4;1;975230;NTBK 15-dk1028la Ci5-10300H/8GB/256SSD/1050 3GB;COMPUTACION
15754611;;F;37;CHILENO;;Millenial;PROVIDENCIA                   ;METROPOLITANA;119990;1;1;1;1;119990;0;0;0;TAB Galaxy A7 Lite (8.7, 32GB, WIFI + 4G);COMPUTACION
16456607;;F;35;CHILENO;;Millenial;"";"";89990;2;1;2;1;89990;0;0;0;TAB Galaxy A7 Lite (8.7, 32GB, WIFI);COMPUTACION
17855711;;F;31;CHILENO;;Millenial;N/D;N/D;149990;1;1;1;1;149990;0;0;0;TAB-X306X 10-INCH 4G+64G HD WIFI+4G LTE;COMPUTACION
12435941;;F;49;CHILENO;;X;ALTO HOSPICIO;TARAPACA;879980;2;2;0;0;0;2;2;879980;NTBK 15-dk1043la i5-10300H 8GB512SSD4V W10H;COMPUTACION
13650949;;F;43;CHILENO;;X;N/D;N/D;629970;3;2;0;0;0;3;2;629970;AIO 200 G4 Pentium J5040/4GB/1TB/21.5P Full HD;COMPUTACION
18197573;;F;30;CHILENO;;Millenial;"";"";147470;2;1;0;0;0;2;1;147470;Matepad T10S WIFI 2+32 GB;COMPUTACION
13329158;;M;44;CHILENO;;X;RENCA                         ;METROPOLITANA;89990;1;1;0;0;0;1;1;89990;TAB Galaxy A7 Lite (8.7, 32GB, WIFI);COMPUTACION
14226127;;M;47;CHILENO;;X;PROVIDENCIA                   ;METROPOLITANA;99990;1;1;0;0;0;1;1;99990;TAB Galaxy Tab A 8 4Core 2GB 32GB 8 Gris;COMPUTACION
14481611;;F;47;CHILENO;;X;PROVIDENCIA                   ;METROPOLITANA;149990;1;1;0;0;0;1;1;149990;Multifuncional DCPT520W Wifi;COMPUTACION
10160766;;M;43;CHILENO;;X;SAN FELIPE                    ;VALPARAISO;1369960;3;1;3;1;1369960;0;0;0;TAB Galaxy S7 FE (12.4, 128GB WIFI) SILVER;COMPUTACION
11558503;;M;52;CHILENO;;X;RENCA                         ;METROPOLITANA;403070;2;1;0;0;0;2;1;403070;NTBK 240 G8 Core i3-1005G1/4GB/1TB/14P;COMPUTACION
19720366;;F;25;CHILENO;;Z;N/D;N/D;320370;2;1;0;0;0;2;1;320370;NTBK IP1 AMD 3020e/4GB/64GB eMMC/14P;COMPUTACION
17921173;;F;30;CHILENO;;Silencioso;PROVIDENCIA                   ;METROPOLITANA;153980;2;1;2;1;153980;0;0;0;Multifuncional DCPT520W Wifi;COMPUTACION
5631218;Casado;F;73;CHILENO;;Silencioso;PROVIDENCIA                   ;METROPOLITANA;497220;5;1;0;0;0;5;1;497220;NTBK IP1 AMD 3020e/4GB/64GB eMMC/14P;COMPUTACION
18667394;;M;28;CHILENO;;Millenial;PROVIDENCIA                   ;METROPOLITANA;1053980;2;1;2;1;1053980;0;0;0;NTBK Legion 5 R7 16GB 1TB 128SSD 6V W10H;COMPUTACION
17170656;Soltero;F;33;CHILENO;INGENIERO CIVIL;Millenial;PROVIDENCIA                   ;METROPOLITANA;376980;2;1;2;1;376980;0;0;0;NTBK 240 G8 Core i3-1005G1/4GB/1TB/14P;COMPUTACION
17016747;;F;33;CHILENO;;Millenial;N/D;N/D;109990;1;1;0;0;0;1;1;109990;Tab M10 HD 2G-32GB 10.1 Iron grey WiFi;COMPUTACION
19421378;;F;26;CHILENO;;Z;MAIPU;METROPOLITANA;143980;2;1;2;1;143980;0;0;0;TAB Galaxy A 8 + S Pen (8, 32GB, WIFI);COMPUTACION
14285415;;M;48;CHILENO;;Silencioso;PROVIDENCIA                   ;METROPOLITANA;705480;2;1;2;1;705480;0;0;0;NTBK Gaming 3 Ryzen 5 4600H 8GB 512SSD G1650 4GB;COMPUTACION
11843836;;M;51;CHILENO;;X;PUERTO MONTT                  ;LOS LAGOS;155220;2;1;0;0;0;2;1;155220;TAB Galaxy Tab A+SPen 8Core 3GB 32GB 8 Gris;COMPUTACION
7333582;;M;66;CHILENO;;Boomers;TALCAHUANO                    ;BIO BIO;119990;1;1;0;0;0;1;1;119990;Tab M10 HD 2G-32GB 10.1 Iron grey WiFi;COMPUTACION
8676902;;M;62;CHILENO;;Boomers;TALCAHUANO                    ;BIO BIO;727870;2;1;0;0;0;2;1;727870;NTBK 15-cw1006la Ryzen 7-3700U 8GB 512SSD 15P;COMPUTACION
17848197;;F;31;CHILENO;;Millenial;N/D;N/D;139990;1;1;1;1;139990;0;0;0;Galaxy Tab A7 (10.4 ,32GB, WIFI) Dark Gray;COMPUTACION
26380803;;M;27;EXTRANJERO - NO INFORMA NACIONALIDAD;;Extranjero;N/D;N/D;142720;3;2;0;0;0;3;2;142720;Tab M10 HD 2G-32GB 10.1 Iron grey WiFi;COMPUTACION
8410933;;M;65;CHILENO;;X;RENCA                         ;METROPOLITANA;149990;1;1;0;0;0;1;1;149990;Multifuncional DCPT520W Wifi;COMPUTACION
19635954;;M;25;CHILENO;;Silencioso;PROVIDENCIA                   ;METROPOLITANA;703980;2;1;2;1;703980;0;0;0;NTBK Gaming 3 Ryzen 5 4600H 8GB 512SSD G1650 4GB;COMPUTACION
15566649;;M;38;CHILENO;;Silencioso;PROVIDENCIA                   ;METROPOLITANA;846370;2;1;0;0;0;2;1;846370;NTBK 15-dk1043la i5-10300H 8GB512SSD4V W10H;COMPUTACION
6667008;;F;64;CHILENO;;Boomers;COIHAIQUE                     ;AYSEN;427850;4;1;0;0;0;4;1;427850;NTBK 240 G8 Core i3-1005G1/4GB/1TB/14P;COMPUTACION
12492868;;F;49;CHILENO;;X;PROVIDENCIA                   ;METROPOLITANA;153980;2;1;2;1;153980;0;0;0;Tab M10 Plus FHD 4GB 64GB 10.3P platinum grey;COMPUTACION
17884139;;F;30;CHILENO;;Silencioso;PROVIDENCIA                   ;METROPOLITANA;497070;2;1;0;0;0;2;1;497070;NTBK GemiBook Celeron/12GB/256GB/2K/Tec-Ingles;COMPUTACION
20196935;;F;22;CHILENO;;Z;PROVIDENCIA                   ;METROPOLITANA;334990;2;1;0;0;0;2;1;334990;NTBK 240G7 CelN4020 14 4GB/500 PC;COMPUTACION
19592778;;F;24;CHILENO;;Z;PROVIDENCIA                   ;METROPOLITANA;254540;2;1;2;1;254540;0;0;0;MULTIFUNCIONAL ECOTANK L5190 Wifi/ Fax;COMPUTACION
8719392;Divorciado;F;53;CHILENO;;X;RENCA                         ;METROPOLITANA;0;0;0;0;0;0;0;0;0;NTBK GemiBook Celeron/12GB/256GB/2K/Tec-Ingles;COMPUTACION
19900313;;F;23;CHILENO;;Z;CHILLAN                       ;BIO BIO;0;0;0;0;0;0;0;0;0;MULTIFUNCIONAL ECOTANK L4160 Wifi;COMPUTACION
7018483;;M;67;CHILENO;;Boomers;PANGUIPULLI                   ;LOS LAGOS;0;0;0;0;0;0;0;0;0;Tab M10 HD 2G-32GB 10.1 Iron grey WiFi;COMPUTACION
15047191;;F;39;CHILENO;;X;PROVIDENCIA                   ;METROPOLITANA;0;0;0;0;0;0;0;0;0;TAB S6 Lite (610) 4GB 64GB 10.4P DARK GREY;COMPUTACION
14178437;;F;40;CHILENO;;X;PROVIDENCIA                   ;METROPOLITANA;0;0;0;0;0;0;0;0;0;Galaxy Tab A7 (10.4 ,32GB, WIFI) Dark Gray;COMPUTACION
13612041;;F;43;CHILENO;;X;TALCA                         ;MAULE;0;0;0;0;0;0;0;0;0;NTBK GemiBook Celeron/12GB/256GB/2K/Tec-Ingles;COMPUTACION
19936731;Soltero;M;40;CHILENO;;Silencioso;PROVIDENCIA                   ;METROPOLITANA;0;0;0;0;0;0;0;0;0;TAB S6 Lite (610) 4GB 64GB 10.4P DARK GREY;COMPUTACION
15034099;;F;39;CHILENO;;X;VALLENAR;ATACAMA;0;0;0;0;0;0;0;0;0;NTBK GemiBook Celeron/12GB/256GB/2K/Tec-Ingles;COMPUTACION
17391769;;M;32;CHILENO;;Millenial;SAN MIGUEL                    ;METROPOLITANA;0;0;0;0;0;0;0;0;0;Tab M10 HD 2G-32GB 10.1 Iron grey WiFi;COMPUTACION
13348438;;F;44;CHILENO;;X;PUMANQUE                      ;L.G.B.OÂ´HIGGINS;0;0;0;0;0;0;0;0;0;Tab Yoga Smart;COMPUTACION
15951898;;F;37;CHILENO;;Millenial;"";"";0;0;0;0;0;0;0;0;0;NTBK 14-ck2091la i3-10110U 4GB 128GB 14 HD;COMPUTACION
26439272;;M;35;VENEZOLANO;;Extranjero;N/D;N/D;0;0;0;0;0;0;0;0;0;AIO 20-c421la CeleroN 4 GB 1TB Windows;COMPUTACION
16760067;;M;34;CHILENO;;Millenial;RENCA                         ;METROPOLITANA;0;0;0;0;0;0;0;0;0;TAB S6 Lite (610) 4GB 64GB 10.4P DARK GREY;COMPUTACION
18142126;Soltero;M;29;CHILENO;;Millenial;PROVIDENCIA                   ;METROPOLITANA;0;0;0;0;0;0;0;0;0;TABLET GALAXY S7 (T875) 4G 128GB 11P Negra;COMPUTACION
15117592;;F;40;CHILENO;;X;CHIMBARONGO                   ;L.G.B.OÂ´HIGGINS;0;0;0;0;0;0;0;0;0;NTBK 240 G8 Core i3-1005G1/4GB/1TB/14P;COMPUTACION
12596278;Soltero;F;48;CHILENO;TECNICO AGROPECUARIO;X;RENCA                         ;METROPOLITANA;0;0;0;0;0;0;0;0;0;NTBK 15-dk1043la i5-10300H 8GB512SSD4V W10H;COMPUTACION
17150476;;F;33;CHILENO;;Millenial;PENAFLOR                      ;METROPOLITANA;0;0;0;0;0;0;0;0;0;NTBK GemiBook Celeron/12GB/256GB/2K/Tec-Ingles;COMPUTACION
19703240;;M;25;CHILENO;;Z;PROVIDENCIA                   ;METROPOLITANA;0;0;0;0;0;0;0;0;0;ROUTER AX3 DUAL CORE;COMPUTACION
16846686;;F;34;CHILENO;;Millenial;RENGO                         ;L.G.B.OÂ´HIGGINS;0;0;0;0;0;0;0;0;0;NTBK 348G7 i3-10110U 14 4GB/1T PC WHOME;COMPUTACION
19260721;;F;24;CHILENO;;Silencioso;PROVIDENCIA                   ;METROPOLITANA;0;0;0;0;0;0;0;0;0;Monitor 24 FHD 75Hz HDMI VGA/Flat IPS/White;COMPUTACION
14620403;;M;44;CHILENO;;X;PROVIDENCIA                   ;METROPOLITANA;0;0;0;0;0;0;0;0;0;Tablet Lite 2.0 7 16 GB WIFI + Funda Rosado;COMPUTACION
11908222;;F;51;CHILENO;;X;PROVIDENCIA                   ;METROPOLITANA;0;0;0;0;0;0;0;0;0;Multifuncional Ink Tank 415 Wifi;COMPUTACION
9018240;;M;56;CHILENO;;Boomers;CHILLAN                       ;BIO BIO;0;0;0;0;0;0;0;0;0;Multifuncional Ink Tank 315;COMPUTACION
19204557;;F;27;CHILENO;;Millenial;PROVIDENCIA                   ;METROPOLITANA;0;0;0;0;0;0;0;0;0;MULTIFUNCIONAL ECOTANK L3150 Wifi;COMPUTACION
4585300;;M;81;CHILENO;;Silencioso;PUERTO MONTT                  ;LOS LAGOS;0;0;0;0;0;0;0;0;0;IMPRESORA EPSON L120;COMPUTACION
15459459;;F;39;CHILENO;;X;PROVIDENCIA                   ;METROPOLITANA;0;0;0;0;0;0;0;0;0;NTBK Y11 11.6 Intel Celeron 8GB RAM + 256GB SDD;COMPUTACION
18787666;;F;28;CHILENO;;Silencioso;PROVIDENCIA                   ;METROPOLITANA;0;0;0;0;0;0;0;0;0;MULTIFUNCIONAL ECOTANK L3150 Wifi;COMPUTACION
17075704;;M;33;CHILENO;;Silencioso;PROVIDENCIA                   ;METROPOLITANA;0;0;0;0;0;0;0;0;0;NTBK 15-dk1043la i5-10300H 8GB512SSD4V W10H;COMPUTACION
11978661;;M;50;CHILENO;;X;RENCA                         ;METROPOLITANA;0;0;0;0;0;0;0;0;0;NTBK 14-ck2091la i3-10110U 4GB 128GB 14 HD;COMPUTACION
11842319;;F;50;CHILENO;;X;TALAGANTE                     ;N/D;0;0;0;0;0;0;0;0;0;MULTIFUNCIONAL ECOTANK L3110;COMPUTACION
8940259;;M;60;CHILENO;;Boomers;HIJUELAS                      ;VALPARAISO;0;0;0;0;0;0;0;0;0;TAB Galaxy Tab A 8 4G 4Core 2GB 32GB 8 Gris;COMPUTACION
19864546;;M;23;CHILENO;;Z;COPIAPO                       ;ATACAMA;0;0;0;0;0;0;0;0;0;NTBK 240 G8 Core i3-1005G1/4GB/1TB/14P;COMPUTACION
19083003;;F;26;CHILENO;;Z;CHILLAN VIEJO                 ;BIO BIO;0;0;0;0;0;0;0;0;0;NTBK 14-ck2091la i3-10110U 4GB 128GB 14 HD;COMPUTACION
17881033;;F;30;CHILENO;;Millenial;N/D;N/D;0;0;0;0;0;0;0;0;0;NTBK 240 G8 Core i3-1005G1/4GB/1TB/14P;COMPUTACION
10133833;;F;59;CHILENO;;Boomers;PICHILEMU                     ;L.G.B.OÂ´HIGGINS;0;0;0;0;0;0;0;0;0;NTBK 14-cf2051la i3-10110U 4GB 256GB+16GB 14 HD;COMPUTACION
16135618;;M;36;CHILENO;;Millenial;PROVIDENCIA                   ;METROPOLITANA;0;0;0;0;0;0;0;0;0;NTBK 240 G8 Core i3-1005G1/4GB/1TB/14P;COMPUTACION
17472626;;M;32;CHILENO;;Millenial;PROVIDENCIA                   ;METROPOLITANA;0;0;0;0;0;0;0;0;0;Tab M10 HD 2G-32GB 10.1 Iron grey WiFi;COMPUTACION
18491995;Soltero;M;28;CHILENO;;Millenial;PROVIDENCIA                   ;METROPOLITANA;0;0;0;0;0;0;0;0;0;Tab M10 HD 2G-32GB 10.1 Iron grey WiFi;COMPUTACION
12586683;;F;48;CHILENO;;X;RENCA                         ;METROPOLITANA;0;0;0;0;0;0;0;0;0;Impresora Monocromatica Xerox B210-NDI;COMPUTACION
18500804;;F;28;CHILENO;;Millenial;CORONEL                       ;BIO BIO;0;0;0;0;0;0;0;0;0;Galaxy Tab A7 (10.4 ,32GB, WIFI) Dark Gray;COMPUTACION
12104031;Divorciado;F;57;CHILENO;;Boomers;PROVIDENCIA                   ;METROPOLITANA;0;0;0;0;0;0;0;0;0;NTBK 14-ck2091la i3-10110U 4GB 128GB 14 HD;COMPUTACION
17901967;;M;31;CHILENO;;Millenial;TIERRA AMARILLA               ;ATACAMA;0;0;0;0;0;0;0;0;0;NTBK INSPIRON 15 3505 AMD ATHLON SILVER 8GB 256G;COMPUTACION
18928820;;F;27;CHILENO;;Millenial;LA PINTANA                    ;METROPOLITANA;0;0;0;0;0;0;0;0;0;TABLET 7 KIDS + KID CASE 1+16;COMPUTACION
12257490;;F;50;CHILENO;;X;CONCHALI                      ;METROPOLITANA;0;0;0;0;0;0;0;0;0;Tab M10 HD 2G-32GB 10.1 Iron grey WiFi;COMPUTACION
19002239;Soltero;F;27;CHILENO;FONOAUDIOLOGO;Silencioso;PROVIDENCIA                   ;METROPOLITANA;0;0;0;0;0;0;0;0;0;TAB Galaxy Tab A 8 4Core 2GB 32GB 8 Gris;COMPUTACION
13398515;;F;43;CHILENO;;Millenial;TEMUCO                        ;ARAUCANIA;0;0;0;0;0;0;0;0;0;NTBK 15-dk1028la Ci5-10300H/8GB/256SSD/1050 3GB;COMPUTACION
26119202;;M;39;VENEZOLANO;;Extranjero;VILLA ALEMANA                 ;VALPARAISO;0;0;0;0;0;0;0;0;0;NTBK IP S145 AMD 3020E/4GB/500GB/14P;COMPUTACION
17225008;Casado;M;33;CHILENO;;Silencioso;PROVIDENCIA                   ;METROPOLITANA;0;0;0;0;0;0;0;0;0;Galaxy Tab A7 (10.4 ,32GB, WIFI + 4G) Dark Gray;COMPUTACION
10731811;;M;51;CHILENO;;X;ARICA                         ;ARICA Y PARINACOTA;0;0;0;0;0;0;0;0;0;Impresora Monocromatica Ecotank M1120;COMPUTACION
7539285;;M;65;CHILENO;;Boomers;ANGOL                         ;ARAUCANIA;0;0;0;0;0;0;0;0;0;AIO 21-b0021la Pentium J5040 8GB 1TB;COMPUTACION
18391128;;F;29;CHILENO;;Silencioso;PROVIDENCIA                   ;METROPOLITANA;0;0;0;0;0;0;0;0;0;TAB Galaxy Tab A 8 4Core 2GB 32GB 8 Gris;COMPUTACION
18470811;;M;28;CHILENO;;Millenial;COIHAIQUE                     ;AYSEN;0;0;0;0;0;0;0;0;0;Tab M10 HD 2G-32GB 10.1 Iron grey WiFi;COMPUTACION
19836891;;M;23;CHILENO;;Silencioso;N/D;N/D;0;0;0;0;0;0;0;0;0;TAB S6 Lite (610) 4GB 64GB 10.4P PINK;COMPUTACION
15177664;;F;39;CHILENO;;X;PROVIDENCIA                   ;METROPOLITANA;0;0;0;0;0;0;0;0;0;TAB M7 7 1GB RAM 8 GB ROM Platinum Grey;COMPUTACION
9734725;;M;57;CHILENO;;Boomers;LIMACHE                       ;VALPARAISO;0;0;0;0;0;0;0;0;0;TAB Galaxy Tab A 8 4G 4Core 2GB 32GB 8 Gris;COMPUTACION
19272875;;F;26;CHILENO;;Z;CANETE                        ;BIO BIO;0;0;0;0;0;0;0;0;0;Multifuncional DCPT520W Wifi;COMPUTACION
17931919;;F;31;CHILENO;;Millenial;TALCA                         ;MAULE;0;0;0;0;0;0;0;0;0;Tab M10 HD 2G-32GB 10.1 Iron grey WiFi;COMPUTACION
19145802;;F;26;CHILENO;;Z;N/D;N/D;0;0;0;0;0;0;0;0;0;TAB 7 PLAY AND LEARN PLUS BLUE 8868;COMPUTACION
17057292;;F;33;CHILENO;;Millenial;NUEVA IMPERIAL                ;ARAUCANIA;0;0;0;0;0;0;0;0;0;TINTA 664 TRI COLOR;COMPUTACION
12510840;Soltero;F;49;CHILENO;ENFERMERA;Silencioso;PROVIDENCIA                   ;METROPOLITANA;0;0;0;0;0;0;0;0;0;TAB M7 7 1GB RAM 8 GB ROM Platinum Grey;COMPUTACION
18859614;Soltero;M;26;CHILENO;;Z;PROVIDENCIA                   ;METROPOLITANA;0;0;0;0;0;0;0;0;0;Galaxy Tab A7 (10.4 ,32GB, WIFI) Dark Gray;COMPUTACION
16558474;;F;34;CHILENO;;Silencioso;PROVIDENCIA                   ;METROPOLITANA;0;0;0;0;0;0;0;0;0;TAB Galaxy Tab A 8 4G 4Core 2GB 32GB 8 Gris;COMPUTACION
18240126;;F;29;CHILENO;;Extranjero;PROVIDENCIA                   ;METROPOLITANA;0;0;0;0;0;0;0;0;0;NTBK Core i3/8GB/512SSD;COMPUTACION
19277804;;M;26;CHILENO;;Z;SAN BERNARDO                  ;METROPOLITANA;0;0;0;0;0;0;0;0;0;Multifuncional Smart Tank 515 Wifi;COMPUTACION
17313946;;M;32;CHILENO;;Millenial;PROVIDENCIA                   ;METROPOLITANA;0;0;0;0;0;0;0;0;0;Tab M10 HD 2G-32GB 10.1 Iron grey WiFi;COMPUTACION
22236394;;M;49;PERUANO;;Extranjero;SAN BERNARDO                  ;METROPOLITANA;0;0;0;0;0;0;0;0;0;NTBK 14-ck2091la i3-10110U 4GB 128GB 14 HD;COMPUTACION
13728166;;M;42;CHILENO;;X;CORONEL                       ;BIO BIO;0;0;0;0;0;0;0;0;0;AIO 21-b0021la Pentium J5040 8GB 1TB;COMPUTACION
15741725;;M;38;CHILENO;;Millenial;PROVIDENCIA                   ;METROPOLITANA;0;0;0;0;0;0;0;0;0;NTBK 15-dk1043la i5-10300H 8GB512SSD4V W10H;COMPUTACION
25432611;;F;29;HAITIANO;;Extranjero;ESTACION CENTRAL              ;METROPOLITANA;0;0;0;0;0;0;0;0;0;TAB Galaxy Tab A 8 4G 4Core 2GB 32GB 8 Gris;COMPUTACION
12920247;Casado;F;47;CHILENO;PROFESOR;X;PROVIDENCIA                   ;METROPOLITANA;0;0;0;0;0;0;0;0;0;Tab M10 HD 2G-32GB 10.1 Iron grey WiFi;COMPUTACION
16128416;Soltero;M;36;CHILENO;INTERPRETE DE IDIOMAS;Silencioso;PROVIDENCIA                   ;METROPOLITANA;0;0;0;0;0;0;0;0;0;NTBK X15 15.6 Intel Core 8GB RAM + 256GB SDD;COMPUTACION
20487128;;M;22;CHILENO;;Silencioso;PROVIDENCIA                   ;METROPOLITANA;0;0;0;0;0;0;0;0;0;NTBK 14-cf2051la i3-10110U 4GB 256GB+16GB 14 HD;COMPUTACION
10410771;;M;54;CHILENO;;Boomers;PROVIDENCIA                   ;METROPOLITANA;0;0;0;0;0;0;0;0;0;TAB Galaxy Tab A 8 4Core 2GB 32GB 8 Gris;COMPUTACION
11918911;Casado;M;50;CHILENO;;X;PROVIDENCIA                   ;METROPOLITANA;0;0;0;0;0;0;0;0;0;AIO 21-b0021la Pentium J5040 8GB 1TB;COMPUTACION
14327798;Casado;M;45;CHILENO;INGENIERO;X;RENCA                         ;METROPOLITANA;0;0;0;0;0;0;0;0;0;Tab M10 HD 2G-32GB 10.1 Iron grey WiFi;COMPUTACION
19546696;;M;25;CHILENO;;Silencioso;PROVIDENCIA                   ;METROPOLITANA;0;0;0;0;0;0;0;0;0;NTBK 14-ck2096la CeleronN4020 4GB500GB W10H;COMPUTACION
13581846;;F;42;CHILENO;;X;CURACAUTIN                    ;ARAUCANIA;0;0;0;0;0;0;0;0;0;NTBK 14-ck2091la i3-10110U 4GB 128GB 14 HD;COMPUTACION
19989379;;F;23;CHILENO;;Extranjero;PROVIDENCIA                   ;METROPOLITANA;0;0;0;0;0;0;0;0;0;TAB P11 6GB 128GB Platinium Grey;COMPUTACION
11533160;Casado;M;52;CHILENO;;X;PROVIDENCIA                   ;METROPOLITANA;0;0;0;0;0;0;0;0;0;TAB Matepad 10.4;COMPUTACION
19808554;;F;24;CHILENO;;Z;N/D;N/D;0;0;0;0;0;0;0;0;0;TAB M7 7 1GB RAM 8 GB ROM Platinum Grey;COMPUTACION
10402725;Casado;M;55;CHILENO;;Silencioso;PROVIDENCIA                   ;METROPOLITANA;0;0;0;0;0;0;0;0;0;Galaxy Tab A7 (10.4 ,32GB, WIFI) Dark Gray;COMPUTACION
18456468;Soltero;M;29;CHILENO;ABOGADO;Silencioso;PROVIDENCIA                   ;METROPOLITANA;0;0;0;0;0;0;0;0;0;Multifuncional Laser DCP-1602 Monocromatica;COMPUTACION
18572932;;F;28;CHILENO;;Millenial;PROVIDENCIA                   ;METROPOLITANA;0;0;0;0;0;0;0;0;0;NTBK 14-ck2091la i3-10110U 4GB 128GB 14 HD;COMPUTACION
17169558;Soltero;F;32;CHILENO;PROFESOR;Millenial;RENCA                         ;METROPOLITANA;0;0;0;0;0;0;0;0;0;NTBK 14-dq1004la Core i5-1035G1 8GB 256SSD 14P;COMPUTACION
16240069;Soltero;M;36;CHILENO;MEDICO CIRUJANO;Millenial;RENCA                         ;METROPOLITANA;0;0;0;0;0;0;0;0;0;TINTA HP GT53 90ml Black Original Ink Bottle;COMPUTACION
19698510;;F;24;CHILENO;;Z;PROVIDENCIA                   ;METROPOLITANA;0;0;0;0;0;0;0;0;0;TAB Galaxy Tab A 8 4Core 2GB 32GB 8 Gris;COMPUTACION
19635521;;M;25;CHILENO;;Silencioso;PROVIDENCIA                   ;METROPOLITANA;0;0;0;0;0;0;0;0;0;TAB GALAXY S6 (T860) 6GB 128GB 10.5;COMPUTACION
13781758;;F;42;CHILENO;;X;CHEPICA                       ;L.G.B.OÂ´HIGGINS;0;0;0;0;0;0;0;0;0;Multifuncional DCPT520W Wifi;COMPUTACION
15992924;;F;37;CHILENO;;Millenial;RENGO                         ;L.G.B.OÂ´HIGGINS;0;0;0;0;0;0;0;0;0;MULTIFUNCIONAL ECOTANK L3150 Wifi;COMPUTACION
10930260;;F;55;CHILENO;;Boomers;PROVIDENCIA                   ;METROPOLITANA;0;0;0;0;0;0;0;0;0;MULTIFUNCIONAL ECOTANK L3150 Wifi;COMPUTACION
13596417;;F;43;CHILENO;;X;PROVIDENCIA                   ;METROPOLITANA;0;0;0;0;0;0;0;0;0;Impresora Laser HL-1202 Monocromatica;COMPUTACION
19002940;Soltero;F;27;CHILENO;;Silencioso;PROVIDENCIA                   ;METROPOLITANA;0;0;0;0;0;0;0;0;0;NTBK 15-dy2051la i3-1115G4 8GB 256GB+16GB 15IN S;COMPUTACION
8623908;;F;62;CHILENO;;Boomers;SAGRADA FAMILIA               ;MAULE;0;0;0;0;0;0;0;0;0;TAB Galaxy Tab A+SPen 8Core 3GB 32GB 8 Gris;COMPUTACION
11735107;;M;51;CHILENO;;X;PROVIDENCIA                   ;METROPOLITANA;0;0;0;0;0;0;0;0;0;NTBK 15-dy2051la i3-1115G4 8GB 256GB+16GB 15IN S;COMPUTACION
13180434;;M;45;CHILENO;;X;OVALLE                        ;COQUIMBO;0;0;0;0;0;0;0;0;0;NTBK INSPIRON 3505 AMD R3 3250U 8GB 1TB;COMPUTACION
14047718;;M;41;CHILENO;;X;SAN FERNANDO                  ;L.G.B.OÂ´HIGGINS;0;0;0;0;0;0;0;0;0;TAB Galaxy Tab A 10.1 4G 8Core 2GB 32GB 10 Gold;COMPUTACION
16984135;Soltero;M;33;CHILENO;;Millenial;PROVIDENCIA                   ;METROPOLITANA;0;0;0;0;0;0;0;0;0;NTBK 245 G7 AMD Ryzen 5 3500U 8GB 1TB 14P;COMPUTACION
20277035;;F;28;CHILENO;;Millenial;ANCUD                         ;LOS LAGOS;0;0;0;0;0;0;0;0;0;MULTIFUNCIONAL HP INK ADVANTAGE 3785/3775;COMPUTACION
19670927;;F;25;CHILENO;;Silencioso;PROVIDENCIA                   ;METROPOLITANA;0;0;0;0;0;0;0;0;0;NTBK 15-dk1028la Ci5-10300H/8GB/256SSD/1050 3GB;COMPUTACION
18192971;;F;29;CHILENO;;Millenial;N/D;N/D;0;0;0;0;0;0;0;0;0;TAB Galaxy Tab A 8 4G 4Core 2GB 32GB 8 Gris;COMPUTACION
17117296;;M;33;CHILENO;;Millenial;IQUIQUE                       ;TARAPACA;0;0;0;0;0;0;0;0;0;TAB Galaxy Tab A+SPen 8Core 3GB 32GB 8 Gris;COMPUTACION
9691685;;M;59;CHILENO;;Boomers;RENCA                         ;METROPOLITANA;0;0;0;0;0;0;0;0;0;MULTIFUNCIONAL ECOTANK L3150 Wifi;COMPUTACION
12523158;;M;53;CHILENO;;X;RENCA                         ;METROPOLITANA;0;0;0;0;0;0;0;0;0;NTBK 14-ck2091la i3-10110U 4GB 128GB 14 HD;COMPUTACION
13413060;Soltero;M;44;CHILENO;;X;PROVIDENCIA                   ;METROPOLITANA;0;0;0;0;0;0;0;0;0;NTBK INSPIRON 15 3505 AMD ATHLON SILVER 8GB 256G;COMPUTACION
25297820;;F;35;BOLIVIANO;;Extranjero;RECOLETA                      ;METROPOLITANA;0;0;0;0;0;0;0;0;0;Galaxy Tab A7 (10.4 ,32GB, WIFI) Dark Gray;COMPUTACION
4909199;;M;78;CHILENO;;Silencioso;RENCA                         ;METROPOLITANA;0;0;0;0;0;0;0;0;0;Tab M7 1G-16GB 7 IPS HD LTE/4G;COMPUTACION
19043826;Soltero;F;26;CHILENO;;Z;PROVIDENCIA                   ;METROPOLITANA;0;0;0;0;0;0;0;0;0;MULTIFUNCIONAL ECOTANK L3110;COMPUTACION
9537307;;M;59;CHILENO;;Extranjero;LONGAVI                       ;MAULE;0;0;0;0;0;0;0;0;0;TAB Galaxy Tab A 8 4Core 2GB 32GB 8 Negra;COMPUTACION
16080409;Soltero;M;44;CHILENO;KINESIOLOGO;Silencioso;PROVIDENCIA                   ;METROPOLITANA;0;0;0;0;0;0;0;0;0;TAB Galaxy Tab A 8 4Core 2GB 32GB 8 Negra;COMPUTACION
16523258;Soltero;F;35;CHILENO;;Millenial;PROVIDENCIA                   ;METROPOLITANA;0;0;0;0;0;0;0;0;0;MULTIFUNCIONAL ECOTANK L3110;COMPUTACION
18984562;Soltero;F;27;CHILENO;PSICOPEDAGOGO;Silencioso;PROVIDENCIA                   ;METROPOLITANA;0;0;0;0;0;0;0;0;0;IMPRESORA EPSON L120;COMPUTACION
17201533;;M;32;CHILENO;;Millenial;PAILLACO                      ;LOS RIOS;0;0;0;0;0;0;0;0;0;NTBK 14-ck2091la i3-10110U 4GB 128GB 14 HD;COMPUTACION
18201807;;M;29;CHILENO;;Millenial;PROVIDENCIA                   ;METROPOLITANA;0;0;0;0;0;0;0;0;0;NTBK 15-dy2051la i3-1115G4 8GB 256GB+16GB 15IN S;COMPUTACION
20476182;;F;22;CHILENO;;Z;PROVIDENCIA                   ;METROPOLITANA;0;0;0;0;0;0;0;0;0;TAB S6 Lite (610) 4GB 64GB 10.4P BLUE;COMPUTACION
17561973;;M;31;CHILENO;;Silencioso;PROVIDENCIA                   ;METROPOLITANA;0;0;0;0;0;0;0;0;0;NTBK G3 3500 Core i5-10300 8GB 256SSD 1650 4GB;COMPUTACION
19725492;;F;24;CHILENO;;Z;PROVIDENCIA                   ;METROPOLITANA;0;0;0;0;0;0;0;0;0;TINTA BOTELLA MAGENTA BT5001M;COMPUTACION
20179298;;F;22;CHILENO;;Z;CHIMBARONGO                   ;L.G.B.OÂ´HIGGINS;0;0;0;0;0;0;0;0;0;NTBK 14-ck2096la CeleronN4020 4GB500GB W10H;COMPUTACION
16936744;;M;34;CHILENO;;Silencioso;PROVIDENCIA                   ;METROPOLITANA;0;0;0;0;0;0;0;0;0;IPAD MINI WI-FI 64GB SILVER (MUQX2CI/A);COMPUTACION
12853323;Casado;M;47;CHILENO;;Silencioso;PROVIDENCIA                   ;METROPOLITANA;0;0;0;0;0;0;0;0;0;Router Huawei WS5200 WIFI Dual core;COMPUTACION
17616850;Soltero;F;30;CHILENO;ENFERMERA;Silencioso;PROVIDENCIA                   ;METROPOLITANA;0;0;0;0;0;0;0;0;0;MULTIFUNCIONAL ECOTANK L3150 Wifi;COMPUTACION
18930154;Soltero;F;27;CHILENO;;Z;PROVIDENCIA                   ;METROPOLITANA;0;0;0;0;0;0;0;0;0;TAB S6 Lite (610) 4GB 64GB 10.4P PINK;COMPUTACION
17867827;Soltero;M;30;CHILENO;TECNICO MECANICO;Silencioso;PROVIDENCIA                   ;METROPOLITANA;0;0;0;0;0;0;0;0;0;NTBK 245 G7 AMD Ryzen 5 3500U 8GB 1TB 14P;COMPUTACION
7395123;Casado;M;67;CHILENO;;Boomers;TRAIGUEN                      ;ARAUCANIA;0;0;0;0;0;0;0;0;0;Impresora Laser HL-1202 Monocromatica;COMPUTACION
10597594;;F;52;CHILENO;;X;CALERA                        ;VALPARAISO;0;0;0;0;0;0;0;0;0;TAB Galaxy Tab A 8 4Core 2GB 32GB 8 Gris;COMPUTACION
10497847;;M;57;CHILENO;;Boomers;TALTAL                        ;ANTOFAGASTA;0;0;0;0;0;0;0;0;0;NTBK 15-dk0015 Core i5-9300H 8GB 256SSD 1050 3GB;COMPUTACION
12180582;;F;50;CHILENO;;X;RENCA                         ;METROPOLITANA;0;0;0;0;0;0;0;0;0;Impresora Laser HL-1202 Monocromatica;COMPUTACION
12807199;Soltero;M;46;CHILENO;;X;RENCA                         ;METROPOLITANA;0;0;0;0;0;0;0;0;0;NTBK 14-cf2051la i3-10110U 4GB 256GB+16GB 14 HD;COMPUTACION
15411812;;F;40;CHILENO;;X;PROVIDENCIA                   ;METROPOLITANA;0;0;0;0;0;0;0;0;0;NTBK 245 G7 AMD Ryzen 5 3500U 8GB 1TB 14P;COMPUTACION
13772758;;F;42;CHILENO;;X;MELIPILLA                     ;METROPOLITANA;0;0;0;0;0;0;0;0;0;MULTIFUNCIONAL HP INK ADVANTAGE 3785/3775;COMPUTACION
12350195;Soltero;M;48;CHILENO;PROFESOR;X;PROVIDENCIA                   ;METROPOLITANA;0;0;0;0;0;0;0;0;0;TABLET MLAB 7 MB4 PLUS 1+16GB RED;COMPUTACION
18017090;;F;31;CHILENO;;Millenial;N/D;N/D;0;0;0;0;0;0;0;0;0;MULTIFUNCIONAL HP INK ADVANTAGE 3785/3775;COMPUTACION
19119704;Soltero;M;27;CHILENO;;Silencioso;PROVIDENCIA                   ;METROPOLITANA;0;0;0;0;0;0;0;0;0;NTBK G3 3500 Core i5-10300 8GB 256SSD 1650 4GB;COMPUTACION
16402048;;M;36;CHILENO;;Millenial;RENCA                         ;METROPOLITANA;0;0;0;0;0;0;0;0;0;NTBK 14-dq1004la Core i5-1035G1 8GB 256SSD 14P;COMPUTACION
18683674;;F;28;CHILENO;;Millenial;COLINA                        ;METROPOLITANA;0;0;0;0;0;0;0;0;0;MULTIFUNCIONAL ECOTANK L3110;COMPUTACION
13570808;;F;42;CHILENO;;X;PROVIDENCIA                   ;METROPOLITANA;0;0;0;0;0;0;0;0;0;NTBK 14-dq1004la Core i5-1035G1 8GB 256SSD 14P;COMPUTACION
17721840;Soltero;M;31;CHILENO;;Silencioso;PROVIDENCIA                   ;METROPOLITANA;0;0;0;0;0;0;0;0;0;IPAD WI-FI 32GB GOLD (MYLC2CI/A);COMPUTACION
16702032;Soltero;F;34;CHILENO;;Millenial;PROVIDENCIA                   ;METROPOLITANA;0;0;0;0;0;0;0;0;0;Multifuncional DeskJet Ink Advantage 3775 Wifi;COMPUTACION
5403561;;F;76;CHILENO;;Silencioso;VALPARAISO                    ;VALPARAISO;0;0;0;0;0;0;0;0;0;TAB Galaxy Tab A 8 4Core 2GB 32GB 8 Gris;COMPUTACION
5488796;;F;74;CHILENO;;Silencioso;PUTAENDO                      ;VALPARAISO;0;0;0;0;0;0;0;0;0;NTBK 14-cf2051la i3-10110U 4GB 256GB+16GB 14 HD;COMPUTACION
5591416;;F;70;CHILENO;;Silencioso;ANTOFAGASTA                   ;ANTOFAGASTA;0;0;0;0;0;0;0;0;0;NTBK 14-DQ1001 Core i3-1005G1 4+16 256SSD 14;COMPUTACION
10998116;;F;43;CHILENO;;X;SAN FELIPE                    ;VALPARAISO;0;0;0;0;0;0;0;0;0;NTBK 14-DQ1001 Core i3-1005G1 4+16 256SSD 14;COMPUTACION
20115648;;F;23;CHILENO;;Silencioso;PROVIDENCIA                   ;METROPOLITANA;0;0;0;0;0;0;0;0;0;MULTIFUNCIONAL ECOTANK L3110;COMPUTACION
10165197;;F;58;CHILENO;;Boomers;OVALLE                        ;COQUIMBO;0;0;0;0;0;0;0;0;0;TAB Galaxy Tab A 8 4G 4Core 2GB 32GB 8 Gris;COMPUTACION
8368835;;F;64;CHILENO;;Silencioso;PROVIDENCIA                   ;METROPOLITANA;0;0;0;0;0;0;0;0;0;Tablet HMS Matepad T10;COMPUTACION
10731111;;F;43;CHILENO;;X;CASTRO                        ;LOS LAGOS;0;0;0;0;0;0;0;0;0;TAB M5 Lite Octa Core 32GB 10P FHD;COMPUTACION
19359794;;F;25;CHILENO;;Z;RANCAGUA                      ;L.G.B.OÂ´HIGGINS;0;0;0;0;0;0;0;0;0;TAB Galaxy Tab A 8 4G 4Core 2GB 32GB 8 Gris;COMPUTACION
16781791;;F;34;CHILENO;;Millenial;PURRANQUE                     ;LOS LAGOS;0;0;0;0;0;0;0;0;0;NTBK G7 240 Intel Celeron 4GB 500GB 14;COMPUTACION
5755586;;F;76;CHILENO;;Silencioso;RENCA                         ;METROPOLITANA;0;0;0;0;0;0;0;0;0;TAB MBX Cinema 8866 OctaCore 2GB 32GB 10P;COMPUTACION
25996538;;M;33;CHILENO;;Millenial;TALCA                         ;MAULE;0;0;0;0;0;0;0;0;0;TAB GAMER 7 QUAD CORE 2G+16G 8715;COMPUTACION
7147078;;M;68;CHILENO;;Boomers;CABILDO                       ;VALPARAISO;0;0;0;0;0;0;0;0;0;NTBK IP3 AMD Ryzen 5-4500U 8GB 1TB 15P;COMPUTACION
17712261;;M;31;CHILENO;;Millenial;N/D;N/D;0;0;0;0;0;0;0;0;0;TAB Galaxy Tab A+SPen 8Core 3GB 32GB 8 Gris;COMPUTACION
16029530;;F;37;CHILENO;;Millenial;PROVIDENCIA                   ;METROPOLITANA;0;0;0;0;0;0;0;0;0;NTBK Ideapad S145 Celeron 4GB 500GB 14P;COMPUTACION
17361601;;F;32;CHILENO;;Millenial;NACIMIENTO                    ;BIO BIO;0;0;0;0;0;0;0;0;0;NTBK G7 240 Intel Celeron 4GB 500GB 14;COMPUTACION
15373384;;F;40;CHILENO;;X;PROVIDENCIA                   ;METROPOLITANA;0;0;0;0;0;0;0;0;0;MBA 13.3 SPG/8C CPU/7C GPU/8GB/256GB (MGN63BE/A);COMPUTACION
20256587;;F;22;CHILENO;;Silencioso;PROVIDENCIA                   ;METROPOLITANA;0;0;0;0;0;0;0;0;0;NTBK 240 G7 Core i3-1005G1 4GB 1TB 14P;COMPUTACION
12601277;;M;48;CHILENO;;X;CALERA                        ;VALPARAISO;0;0;0;0;0;0;0;0;0;MULTIFUNCIONAL ECOTANK L3110;COMPUTACION
12296861;;F;49;CHILENO;;X;N/D;N/D;0;0;0;0;0;0;0;0;0;TAB 7 MB4 Plus 4Core 1GB 16GB 7 Plata;COMPUTACION
16850824;Soltero;F;34;CHILENO;;Millenial;PROVIDENCIA                   ;METROPOLITANA;0;0;0;0;0;0;0;0;0;NTBK 245 G7 AMD Ryzen 5 3500U 8GB 1TB 14P;COMPUTACION
9159608;;F;61;CHILENO;;Boomers;PENAFLOR                      ;METROPOLITANA;0;0;0;0;0;0;0;0;0;MULTIFUNCIONAL ECOTANK L3110;COMPUTACION
17100637;;M;33;CHILENO;;Millenial;N/D;N/D;0;0;0;0;0;0;0;0;0;NTBK G7 240 Intel Celeron 4GB 500GB 14;COMPUTACION
10586123;;M;55;CHILENO;;Boomers;MELIPILLA                     ;METROPOLITANA;0;0;0;0;0;0;0;0;0;NTBK IP3 AMD Ryzen 5-4500U 8GB 1TB 15P;COMPUTACION
16373826;;F;36;CHILENO;;Millenial;LAMPA                         ;METROPOLITANA;0;0;0;0;0;0;0;0;0;NTBK G7 240 Intel Celeron 4GB 500GB 14;COMPUTACION
17824615;;F;30;CHILENO;;Millenial;PROVIDENCIA                   ;METROPOLITANA;0;0;0;0;0;0;0;0;0;TAB MBX Cinema 8866 OctaCore 2GB 32GB 10P;COMPUTACION
10037418;;M;54;CHILENO;;X;PUENTE ALTO                   ;METROPOLITANA;0;0;0;0;0;0;0;0;0;NTBK G7 240 Intel Celeron 4GB 500GB 14;COMPUTACION
14263399;;M;52;CHILENO;;X;PROVIDENCIA                   ;METROPOLITANA;0;0;0;0;0;0;0;0;0;NTBK G7 240 Intel Celeron 4GB 500GB 14;COMPUTACION
17400572;;M;32;CHILENO;;Millenial;PROVIDENCIA                   ;METROPOLITANA;0;0;0;0;0;0;0;0;0;NTBK G5 5500 Core i7 10750H 16GB 512SSD 2060 6GB;COMPUTACION
19359445;Soltero;M;25;CHILENO;;Silencioso;PROVIDENCIA                   ;METROPOLITANA;0;0;0;0;0;0;0;0;0;Router Huawei WS5200 WIFI Dual core;COMPUTACION
10071108;;F;57;CHILENO;;Boomers;EL BOSQUE                     ;METROPOLITANA;0;0;0;0;0;0;0;0;0;NTBK Ideapad S145 Celeron 4GB 500GB 14P;COMPUTACION
19029441;Soltero;M;26;CHILENO;;Silencioso;PROVIDENCIA                   ;METROPOLITANA;0;0;0;0;0;0;0;0;0;TAB Mediapad T3 10 4Core 2GB 16GB 9,6 Gris;COMPUTACION
18594420;Soltero;F;28;CHILENO;PSICOLOGO;Millenial;TEMUCO                        ;ARAUCANIA;0;0;0;0;0;0;0;0;0;NTBK IP3 Ryzen 3-3250U/8GB/1TB/15P;COMPUTACION
17295329;;F;32;CHILENO;;Millenial;PROVIDENCIA                   ;METROPOLITANA;0;0;0;0;0;0;0;0;0;MULTIFUNCIONAL ECOTANK L3150 Wifi;COMPUTACION
25281097;;F;52;COLOMBIANO;;Extranjero;PUDAHUEL                      ;METROPOLITANA;0;0;0;0;0;0;0;0;0;NTBK S150 AMD A4-9120e 4GB 64GB eMMc 14P;COMPUTACION
14551806;;M;41;CHILENO;;X;MELIPILLA                     ;METROPOLITANA;0;0;0;0;0;0;0;0;0;NTBK IP3 Ryzen 3-3250U/8GB/1TB/15P;COMPUTACION
18731794;;M;27;CHILENO;;Millenial;"";"";0;0;0;0;0;0;0;0;0;TAB Matepad 10.4;COMPUTACION
9970662;;M;54;CHILENO;;Boomers;RENCA                         ;METROPOLITANA;0;0;0;0;0;0;0;0;0;TAB MBX Cinema 8866 OctaCore 2GB 32GB 10P;COMPUTACION
11687069;;M;52;CHILENO;;X;PITRUFQUEN                    ;ARAUCANIA;0;0;0;0;0;0;0;0;0;NTBK 14-dq1004la Core i5-1035G1 8GB 256SSD 14P;COMPUTACION
14080482;;F;42;CHILENO;;X;PANGUIPULLI                   ;LOS LAGOS;0;0;0;0;0;0;0;0;0;Multifuncional Laser DCP-1602 Monocromatica;COMPUTACION
5080192;;F;78;CHILENO;;Silencioso;PROVIDENCIA                   ;METROPOLITANA;0;0;0;0;0;0;0;0;0;TAB Mediapad T3 10 4Core 2GB 16GB 9,6 Gris;COMPUTACION
16265059;;F;36;CHILENO;;Millenial;N/D;N/D;0;0;0;0;0;0;0;0;0;TAB M8 QC 2GB 32GB 8P Gris;COMPUTACION
13847040;;F;42;CHILENO;;X;VALDIVIA                      ;LOS RIOS;0;0;0;0;0;0;0;0;0;TAB GAMER 7 QUAD CORE 2G+16G 8715;COMPUTACION
18196588;Casado;M;30;CHILENO;TECNICO EN ADMINISTRACION DE EMPRESAS;Millenial;PROVIDENCIA                   ;METROPOLITANA;0;0;0;0;0;0;0;0;0;NTBK 15-dw1051la Core i5-10210U 8GB 256SSD 15P;COMPUTACION
19528458;;M;25;CHILENO;;Millenial;QUILICURA                     ;METROPOLITANA;0;0;0;0;0;0;0;0;0;TABLET GALAXY S7+ (T970) 256GB 12.4P Gris;COMPUTACION
14218243;;F;47;CHILENO;;X;PROVIDENCIA                   ;METROPOLITANA;0;0;0;0;0;0;0;0;0;NTBK 15-dk0015 Core i5-9300H 8GB 256SSD 1050 3GB;COMPUTACION
17866401;Soltero;M;30;CHILENO;;Millenial;PROVIDENCIA                   ;METROPOLITANA;0;0;0;0;0;0;0;0;0;TAB Galaxy Tab A 8 4Core 2GB 32GB 8 Negra;COMPUTACION
12762113;;F;47;CHILENO;;X;COCHRANE                      ;AYSEN;0;0;0;0;0;0;0;0;0;NTBK S150 AMD A4-9120e 4GB 64GB eMMc 14P;COMPUTACION
19184380;;F;27;CHILENO;;Z;RENCA                         ;METROPOLITANA;0;0;0;0;0;0;0;0;0;TABLET MatePad Pro 10.8 + M-Pencil;COMPUTACION
19526623;;F;25;CHILENO;;Silencioso;PROVIDENCIA                   ;METROPOLITANA;0;0;0;0;0;0;0;0;0;TAB M8 QC 2GB 32GB 8P Gris;COMPUTACION
15909911;;F;37;CHILENO;;Millenial;PROVIDENCIA                   ;METROPOLITANA;0;0;0;0;0;0;0;0;0;TINTA HP BOTELLA CYAN GT52;COMPUTACION
15848822;;M;38;CHILENO;;Millenial;TOME                          ;BIO BIO;0;0;0;0;0;0;0;0;0;NTBK IP3 Ryzen 3-3250U/8GB/1TB/15P;COMPUTACION
18487768;;M;29;CHILENO;;Millenial;N/D;N/D;0;0;0;0;0;0;0;0;0;TAB 7 PLAY AND LEARN PLUS PURPLE 8867;COMPUTACION
18869427;;F;28;CHILENO;;Millenial;ARICA                         ;ARICA Y PARINACOTA;0;0;0;0;0;0;0;0;0;NTBK 240 G7 Core i3-1005G1 4GB 1TB 14P;COMPUTACION
13777047;Casado;F;41;CHILENO;;X;RENCA                         ;METROPOLITANA;0;0;0;0;0;0;0;0;0;TAB Galaxy Tab A 10.1 8Core 2GB 32GB 10 Negra;COMPUTACION
16567641;Soltero;M;35;CHILENO;;Millenial;PROVIDENCIA                   ;METROPOLITANA;0;0;0;0;0;0;0;0;0;TAB Galaxy Tab A 8 4Core 2GB 32GB 8 Negra;COMPUTACION
15147330;;M;37;CHILENO;;Millenial;CERRILLOS                     ;METROPOLITANA;0;0;0;0;0;0;0;0;0;NTBK 240 G7 Core i3-1005G1 4GB 1TB 14P;COMPUTACION
17095101;Casado;F;33;CHILENO;;Millenial;PROVIDENCIA                   ;METROPOLITANA;0;0;0;0;0;0;0;0;0;TAB Galaxy Tab A 8 4Core 2GB 32GB 8 Negra;COMPUTACION
18329850;;F;29;CHILENO;;Millenial;PROVIDENCIA                   ;METROPOLITANA;0;0;0;0;0;0;0;0;0;TAB Matepad T8 wifi 2GB 16GB;COMPUTACION
15184856;;F;42;CHILENO;;X;CHIGUAYANTE                   ;BIO BIO;0;0;0;0;0;0;0;0;0;TAB M8 QC 2GB 32GB 8P Gris;COMPUTACION
17292709;;F;36;CHILENO;;Millenial;PADRE HURTADO                 ;METROPOLITANA;0;0;0;0;0;0;0;0;0;NTBK Matebook D14 AMD Ryzen 5 8GB 512SSD 14P;COMPUTACION
4512043;;M;76;CHILENO;;Silencioso;QUILLOTA                      ;VALPARAISO;0;0;0;0;0;0;0;0;0;NTBK IP3 Ryzen 3-3250U/8GB/1TB/15P;COMPUTACION
11994996;Divorciado;F;50;CHILENO;;X;PROVIDENCIA                   ;METROPOLITANA;0;0;0;0;0;0;0;0;0;TAB M7 QC 1GB 8GB 7P Gris;COMPUTACION
15188229;;M;39;CHILENO;;X;PROVIDENCIA                   ;METROPOLITANA;0;0;0;0;0;0;0;0;0;TAB 7 MB4 Plus 4Core 1GB 16GB 7 Plata;COMPUTACION
8603599;Divorciado;F;63;CHILENO;EDUCADOR DE PARVULO;Boomers;RENCA                         ;METROPOLITANA;0;0;0;0;0;0;0;0;0;NTBK 16-a0001 Core i5-10300H 8GB 512SSD 1650 4GB;COMPUTACION
16248333;;M;37;CHILENO;;Millenial;COPIAPO                       ;ATACAMA;0;0;0;0;0;0;0;0;0;TAB 7 PLAY AND LEARN PLUS PURPLE 8867;COMPUTACION
16537187;;M;35;CHILENO;;Millenial;N/D;N/D;0;0;0;0;0;0;0;0;0;TAB Galaxy Tab A+SPen 8Core 3GB 32GB 8 Gris;COMPUTACION
8978382;;F;61;CHILENO;;Boomers;ARICA                         ;ARICA Y PARINACOTA;0;0;0;0;0;0;0;0;0;NTBK AN515-54-59UV-1 Core i5 8GB 1TB 1650 4GB;COMPUTACION
18648340;;F;27;CHILENO;;Millenial;"";"";0;0;0;0;0;0;0;0;0;TAB Galaxy Tab A 10.1 8Core 2GB 32GB 10 Negra;COMPUTACION
6562462;;F;71;CHILENO;;Silencioso;VINA DEL MAR                  ;VALPARAISO;0;0;0;0;0;0;0;0;0;Tab M10 Plus FHD 4GB 64GB 10.3P platinum grey;COMPUTACION
8804534;;M;58;CHILENO;;Boomers;LEBU                          ;BIO BIO;0;0;0;0;0;0;0;0;0;NTBK G7 240 Intel Celeron 4GB 500GB 14;COMPUTACION
18632427;;F;28;CHILENO;;Millenial;PROVIDENCIA                   ;METROPOLITANA;0;0;0;0;0;0;0;0;0;TAB M5 Lite Octa Core 32GB 10P FHD;COMPUTACION
15517374;;M;39;CHILENO;;X;PROVIDENCIA                   ;METROPOLITANA;0;0;0;0;0;0;0;0;0;TAB MBXR 8717 4Core 2GB 16GB 10 Negra;COMPUTACION
12680910;;M;52;CHILENO;;X;N/D;N/D;0;0;0;0;0;0;0;0;0;NTBK IP3 Ryzen 3-3250U/8GB/1TB/15P;COMPUTACION
16285040;;M;35;CHILENO;;Millenial;ARICA                         ;TARAPACA;0;0;0;0;0;0;0;0;0;NTBK A315-42-R0W1-1 Ryzen 7-3700U 8GB 256SSD 15P;COMPUTACION
13666841;;M;42;CHILENO;;X;PROVIDENCIA                   ;METROPOLITANA;0;0;0;0;0;0;0;0;0;TAB Galaxy Tab A 8 4Core 2GB 32GB 8 Negra;COMPUTACION
6675116;Casado;M;69;CHILENO;;Silencioso;RENCA                         ;METROPOLITANA;0;0;0;0;0;0;0;0;0;TAB Galaxy Tab A+SPen 8Core 3GB 32GB 8 Gris;COMPUTACION
8734329;Soltero;F;62;CHILENO;;Boomers;NUNOA                         ;METROPOLITANA;0;0;0;0;0;0;0;0;0;TAB Matepad T8 Wifi 2GB 32GB 8P;COMPUTACION
13532462;Casado;M;42;CHILENO;INGENIERO EN PREVENCION DE RIESGOS;X;RENCA                         ;METROPOLITANA;0;0;0;0;0;0;0;0;0;TAB MLAB MBX 8 QUAD CORE 1G+16G 8716;COMPUTACION
14364945;;F;41;CHILENO;;X;PROVIDENCIA                   ;METROPOLITANA;0;0;0;0;0;0;0;0;0;NTBK IP3 Athlon 3050U/4GB/500GB/15P;COMPUTACION
9876241;;M;59;CHILENO;;Boomers;RENCA                         ;METROPOLITANA;0;0;0;0;0;0;0;0;0;TAB GAMER 7 QUAD CORE 2G+16G 8715;COMPUTACION
18058129;;M;30;CHILENO;;Millenial;PUDAHUEL                      ;METROPOLITANA;0;0;0;0;0;0;0;0;0;TAB Galaxy Tab A+SPen 8Core 3GB 32GB 8 Gris;COMPUTACION
13244150;;M;45;CHILENO;;X;EL BOSQUE                     ;METROPOLITANA;0;0;0;0;0;0;0;0;0;NTBK G7 240 Intel Celeron 4GB 500GB 14;COMPUTACION
15604718;;F;38;CHILENO;;X;COQUIMBO                      ;COQUIMBO;0;0;0;0;0;0;0;0;0;TABLET MLAB 7 MB4 PLUS 1+16GB RED;COMPUTACION
13416061;;M;44;CHILENO;;X;RENCA                         ;METROPOLITANA;0;0;0;0;0;0;0;0;0;IPAD MINI WI-FI 64GB SPACE GRAY (MUQW2CI/A);COMPUTACION
18258527;;F;29;CHILENO;;Millenial;TALCA                         ;MAULE;0;0;0;0;0;0;0;0;0;NTBK IP3 Ryzen 3-3250U/8GB/1TB/15P;COMPUTACION
7996682;Divorciado;F;58;CHILENO;EDUCADOR DE PARVULO;Boomers;RENCA                         ;METROPOLITANA;0;0;0;0;0;0;0;0;0;Tablet HMS Matepad T10;COMPUTACION
8340989;;M;65;CHILENO;;Boomers;PEDRO AGUIRRE CERDA           ;METROPOLITANA;0;0;0;0;0;0;0;0;0;TAB Galaxy Tab A 8 4Core 2GB 32GB 8 Gris;COMPUTACION
15118063;;M;39;CHILENO;;X;PROVIDENCIA                   ;METROPOLITANA;0;0;0;0;0;0;0;0;0;TAB Matepad T8 Wifi 2GB 32GB 8P;COMPUTACION
18501807;;F;28;CHILENO;;Millenial;RENCA                         ;METROPOLITANA;0;0;0;0;0;0;0;0;0;TAB 7 MB4 Plus 4Core 1GB 16GB 7 Plata;COMPUTACION
18789055;;M;27;CHILENO;;Millenial;SAN CARLOS                    ;BIO BIO;0;0;0;0;0;0;0;0;0;TAB Galaxy Tab A 8 4Core 2GB 32GB 8 Negra;COMPUTACION
12212286;;F;50;CHILENO;;X;PROVIDENCIA                   ;METROPOLITANA;0;0;0;0;0;0;0;0;0;NTBK 15-dk0015 Core i5-9300H 8GB 256SSD 1050 3GB;COMPUTACION
17637951;;F;31;CHILENO;;Millenial;RENCA                         ;METROPOLITANA;0;0;0;0;0;0;0;0;0;TAB M8 QC 2GB 32GB 8P Gris;COMPUTACION
17654635;;F;31;CHILENO;;Millenial;"";"";0;0;0;0;0;0;0;0;0;TAB 7 MB4 Plus 4Core 1GB 16GB 7 Plata;COMPUTACION
10696684;;F;55;CHILENO;;Boomers;PROVIDENCIA                   ;METROPOLITANA;0;0;0;0;0;0;0;0;0;NTBK HP 240 G7 Ci5-8250U 4GB 1TB 14P;COMPUTACION
16814144;Casado;M;33;CHILENO;;Millenial;PROVIDENCIA                   ;METROPOLITANA;0;0;0;0;0;0;0;0;0;TAB GALAXY S7 (T870) 256GB 11P Gris;COMPUTACION
17111391;Soltero;M;32;CHILENO;CONSTRUCTOR CIVIL;Millenial;PROVIDENCIA                   ;METROPOLITANA;0;0;0;0;0;0;0;0;0;NTBK IP3 Athlon 3050U/4GB/500GB/15P;COMPUTACION
17013144;;M;33;CHILENO;;Silencioso;PROVIDENCIA                   ;METROPOLITANA;0;0;0;0;0;0;0;0;0;NTBK Matebook 13 AMD Ryzen 5 8GB 512SSD 13P;COMPUTACION
5796502;;M;70;CHILENO;;Silencioso;TALCAHUANO                    ;BIO BIO;0;0;0;0;0;0;0;0;0;TAB Galaxy Tab A 10.1 8Core 2GB 32GB 10 Negra;COMPUTACION
15500565;;F;39;CHILENO;;X;PARRAL                        ;MAULE;0;0;0;0;0;0;0;0;0;TABLET MLAB 7 MB4 PLUS 1+16GB RED;COMPUTACION
10230000;;M;54;CHILENO;;X;ARICA                         ;ARICA Y PARINACOTA;0;0;0;0;0;0;0;0;0;AIO IC Athlon 3050U 4GB 1TB 21.5P;COMPUTACION
7915735;;M;65;CHILENO;;Boomers;FLORIDA                       ;BIO BIO;0;0;0;0;0;0;0;0;0;MULTIFUNCIONAL ECOTANK L3150 Wifi;COMPUTACION
10414101;;M;56;CHILENO;;Boomers;MAULE                         ;MAULE;0;0;0;0;0;0;0;0;0;NTBK IP S340 Core I5-1035G4 4GB 256GB SSD 14P;COMPUTACION
17699520;Soltero;M;31;CHILENO;;Millenial;PROVIDENCIA                   ;METROPOLITANA;0;0;0;0;0;0;0;0;0;NTBK IP3 AMD Ryzen 5-4500U 8GB 1TB 15P;COMPUTACION
17305900;;F;32;CHILENO;;Millenial;QUINTA NORMAL                 ;METROPOLITANA;0;0;0;0;0;0;0;0;0;MULTIFUNCIONAL ECOTANK L4160 Wifi;COMPUTACION
15980963;;M;37;CHILENO;;Millenial;PROVIDENCIA                   ;METROPOLITANA;0;0;0;0;0;0;0;0;0;TAB Matepad 10.4;COMPUTACION
16985271;;F;33;CHILENO;;Millenial;TALAGANTE                     ;METROPOLITANA;0;0;0;0;0;0;0;0;0;NTBK G7 240 Intel Celeron 4GB 500GB 14;COMPUTACION
13107701;;M;45;CHILENO;;X;PROVIDENCIA                   ;METROPOLITANA;0;0;0;0;0;0;0;0;0;NTBK IP3 AMD Ryzen 5-4500U 8GB 1TB 15P;COMPUTACION
16346104;;M;36;CHILENO;;Millenial;PROVIDENCIA                   ;METROPOLITANA;0;0;0;0;0;0;0;0;0;MULTIFUNCIONAL ECOTANK L4160 Wifi;COMPUTACION
18799662;Soltero;F;27;CHILENO;;Z;PROVIDENCIA                   ;METROPOLITANA;0;0;0;0;0;0;0;0;0;TAB Matepad 10.4;COMPUTACION
7444784;;M;67;CHILENO;;Boomers;ANTOFAGASTA                   ;ANTOFAGASTA;0;0;0;0;0;0;0;0;0;NTBK 15-cw1020la Ryzen 5-3500U 8GB 256GB 15P;COMPUTACION
26030759;;M;28;VENEZOLANO;;Extranjero;PENALOLEN                     ;METROPOLITANA;0;0;0;0;0;0;0;0;0;NTBK IP3 Athlon 3050U/4GB/500GB/15P;COMPUTACION
7016432;Casado;M;67;CHILENO;;Boomers;RENCA                         ;METROPOLITANA;0;0;0;0;0;0;0;0;0;TAB M7 QC 1GB 8GB 7P Gris;COMPUTACION
15588181;;F;38;CHILENO;;X;PROVIDENCIA                   ;METROPOLITANA;0;0;0;0;0;0;0;0;0;NTBK Matebook D14 AMD Ryzen 5 8GB 256SSD 14P;COMPUTACION
6421929;;M;71;CHILENO;;Silencioso;MELIPILLA                     ;METROPOLITANA;0;0;0;0;0;0;0;0;0;TAB Galaxy Tab A 8 4Core 2GB 32GB 8 Negra;COMPUTACION
10432523;Soltero;F;55;CHILENO;CONTADOR AUDITOR;Boomers;RENCA                         ;METROPOLITANA;0;0;0;0;0;0;0;0;0;MULTIFUNCIONAL ECOTANK L3110;COMPUTACION
16205449;;M;36;CHILENO;;Millenial;PROVIDENCIA                   ;METROPOLITANA;0;0;0;0;0;0;0;0;0;NTBK G7 240 Intel Celeron 4GB 500GB 14;COMPUTACION
16856226;;M;34;CHILENO;;Millenial;PROVIDENCIA                   ;METROPOLITANA;0;0;0;0;0;0;0;0;0;NTBK Matebook D14 AMD Ryzen 5 8GB 256SSD 14P;COMPUTACION
19838040;;F;24;CHILENO;;Z;PROVIDENCIA                   ;METROPOLITANA;0;0;0;0;0;0;0;0;0;NTBK 15-dw1051la Core i5-10210U 8GB 256SSD 15P;COMPUTACION
17737596;Casado;F;31;CHILENO;;Millenial;RENCA                         ;METROPOLITANA;0;0;0;0;0;0;0;0;0;MULTIFUNCIONAL DCP-T710W Wifi/ ADF;COMPUTACION
18877403;Soltero;F;27;CHILENO;;Millenial;PROVIDENCIA                   ;METROPOLITANA;0;0;0;0;0;0;0;0;0;TAB Matepad T8 4G LTE 2GB 16GB;COMPUTACION
13171574;;F;44;CHILENO;;X;PROVIDENCIA                   ;METROPOLITANA;0;0;0;0;0;0;0;0;0;MULTIFUNCIONAL ECOTANK L3110;COMPUTACION
12626352;;F;47;CHILENO;;X;MAIPU                         ;METROPOLITANA;0;0;0;0;0;0;0;0;0;NTBK HP 15-da0082la Pentium 4GB 500GB 15P;COMPUTACION
15189044;;F;40;CHILENO;;X;PROVIDENCIA                   ;METROPOLITANA;0;0;0;0;0;0;0;0;0;TAB MediaPad T5 10 3GB 32GB 10.1P Azul;COMPUTACION
19059249;Soltero;M;26;CHILENO;;Z;PROVIDENCIA                   ;METROPOLITANA;0;0;0;0;0;0;0;0;0;TAB Mediapad T3 7 4Core 1GB 8GB 7 Gris;COMPUTACION
6986130;;F;66;CHILENO;;Millenial;"";"";0;0;0;0;0;0;0;0;0;TAB Galaxy Tab A 8 4Core 2GB 32GB 8 Gris;COMPUTACION
16000842;;M;36;CHILENO;;Millenial;LA LIGUA                      ;VALPARAISO;0;0;0;0;0;0;0;0;0;NTBK G7 240 Intel Celeron 4GB 500GB 14;COMPUTACION
17070222;Casado;M;33;CHILENO;;Millenial;TILTIL                        ;METROPOLITANA;0;0;0;0;0;0;0;0;0;NTBK 240 G7 Core i3-1005G1 4GB 1TB 14P;COMPUTACION
15530116;;M;38;CHILENO;;Millenial;PROVIDENCIA                   ;METROPOLITANA;0;0;0;0;0;0;0;0;0;NTBK IP S145 AMD A4-9125/4GB/500GB/14P;COMPUTACION
16361708;;F;35;CHILENO;;Millenial;N/D;N/D;0;0;0;0;0;0;0;0;0;AIO 330 A6-9200 4GB 500GB 19,5;COMPUTACION
8512237;Soltero;F;63;CHILENO;;Boomers;RENCA                         ;METROPOLITANA;0;0;0;0;0;0;0;0;0;NTBK G7 240 Intel Celeron 4GB 500GB 14;COMPUTACION
17649982;Soltero;M;31;CHILENO;;Millenial;PROVIDENCIA                   ;METROPOLITANA;0;0;0;0;0;0;0;0;0;NTBK AN515-54-59UV-1 Core i5 8GB 1TB 1650 4GB;COMPUTACION
10462475;;M;55;CHILENO;;Boomers;ANGOL                         ;ARAUCANIA;0;0;0;0;0;0;0;0;0;NTBK G7 240 Intel Celeron 4GB 500GB 14;COMPUTACION
19394460;;F;25;CHILENO;;Z;PROVIDENCIA                   ;METROPOLITANA;0;0;0;0;0;0;0;0;0;TAB Mediapad T3 7 4Core 1GB 8GB 7 Gris;COMPUTACION
8727920;;F;62;CHILENO;;Boomers;RENCA                         ;METROPOLITANA;0;0;0;0;0;0;0;0;0;IPAD 10.2 WiFi 32Â GB Plata 7 Gen;COMPUTACION
11941227;;F;50;CHILENO;;X;SALAMANCA                     ;COQUIMBO;0;0;0;0;0;0;0;0;0;NTBK 240 G7 Core i3-1005G1 4GB 1TB 14P;COMPUTACION
16188269;;F;36;CHILENO;;Millenial;N/D;N/D;0;0;0;0;0;0;0;0;0;Impresora Monocromatica Ecotank M1120;COMPUTACION
14516710;;M;44;CHILENO;;X;N/D;N/D;0;0;0;0;0;0;0;0;0;TAB MediaPad T5 10 3GB 32GB 10.1P Azul;COMPUTACION
13283313;;F;45;CHILENO;;X;LA GRANJA                     ;METROPOLITANA;0;0;0;0;0;0;0;0;0;TAB Galaxy Tab A 8 4G 4Core 2GB 32GB 8 Gris;COMPUTACION
16951698;;M;34;CHILENO;;Millenial;LANCO                         ;LOS RIOS;0;0;0;0;0;0;0;0;0;NTBK IP3 Athlon 3050U/4GB/500GB/15P;COMPUTACION
10962441;Casado;M;53;CHILENO;INGENIERO MECANICO;X;RENCA                         ;METROPOLITANA;0;0;0;0;0;0;0;0;0;NTBK HP 15-da0082la Pentium 4GB 500GB 15P;COMPUTACION
8185276;;M;63;CHILENO;;Silencioso;PROVIDENCIA                   ;METROPOLITANA;0;0;0;0;0;0;0;0;0;NTBK IP3 AMD Ryzen 5-4500U 8GB 1TB 15P;COMPUTACION
9582301;;M;59;CHILENO;;Boomers;LA GRANJA                     ;METROPOLITANA;0;0;0;0;0;0;0;0;0;NTBK IP3 AMD Ryzen 5-4500U 8GB 1TB 15P;COMPUTACION
12368946;;F;49;CHILENO;;X;CHEPICA;O HIGGINS;0;0;0;0;0;0;0;0;0;NTBK 240 G7 Core i3-1005G1 4GB 1TB 14P;COMPUTACION
14429747;Casado;M;51;CHILENO;;X;RENCA                         ;METROPOLITANA;0;0;0;0;0;0;0;0;0;NTBK 240 G7 Core i3-1005G1 4GB 1TB 14P;COMPUTACION
11271232;;M;53;CHILENO;;X;ALTO HOSPICIO;TARAPACA;0;0;0;0;0;0;0;0;0;NTBK LENOVO S340 Ryzen 3 3200U/4GB/ 1TB/14P;COMPUTACION
12737650;;M;47;CHILENO;;X;PERQUENCO                     ;ARAUCANIA;0;0;0;0;0;0;0;0;0;MULTIFUNCIONAL ECOTANK L3110;COMPUTACION
13392554;;F;44;CHILENO;;X;PROVIDENCIA                   ;METROPOLITANA;0;0;0;0;0;0;0;0;0;NTBK 14-ds002la AMD A4 4GB 64GB eMMC 14P;COMPUTACION
4773876;;M;76;CHILENO;;Silencioso;PROVIDENCIA                   ;METROPOLITANA;0;0;0;0;0;0;0;0;0;TAB MediaPad T5 10 3GB 32GB 10.1P Azul;COMPUTACION
8082939;;M;63;CHILENO;;Boomers;CASTRO                        ;LOS LAGOS;0;0;0;0;0;0;0;0;0;MULTIFUNCIONAL ECOTANK L3110;COMPUTACION
19569106;;F;24;CHILENO;;Z;LOS VILOS                     ;COQUIMBO;0;0;0;0;0;0;0;0;0;NTBK LENOVO S540 Ryzen 5 3500U/12GB/256GB SSD/14;COMPUTACION
14388179;;M;44;CHILENO;;X;PROVIDENCIA                   ;METROPOLITANA;0;0;0;0;0;0;0;0;0;NTBK Matebook D15 AMD Ryzen 5 8GB 256SSD 15P;COMPUTACION
18142186;;F;30;CHILENO;;Millenial;HUALPEN;BIO BIO;0;0;0;0;0;0;0;0;0;NTBK IP3 Athlon 3050U/4GB/500GB/15P;COMPUTACION
11053686;;F;55;CHILENO;;Boomers;PROVIDENCIA                   ;METROPOLITANA;0;0;0;0;0;0;0;0;0;TAB 7 MB4 Plus 4Core 1GB 16GB 7 Plata;COMPUTACION
5164663;;F;77;CHILENO;;Silencioso;PROVIDENCIA                   ;METROPOLITANA;0;0;0;0;0;0;0;0;0;Multifuncional Laser DCP-1602 Monocromatica;COMPUTACION
11833726;;F;51;CHILENO;;X;PROVIDENCIA                   ;METROPOLITANA;24990;1;1;1;1;24990;0;0;0;AUDIFONO WH-CH510/BZ UC;ACCESORIOS
14736941;;M;50;PERUANO;;X;N/D;N/D;373960;4;5;0;0;0;4;5;373960;ALTEC LANSING AUDIFONO HEADBAND BLUETOOTH COMFOR;ACCESORIOS
20482776;;F;22;CHILENO;;Z;PROVIDENCIA                   ;METROPOLITANA;54980;2;1;2;1;54980;0;0;0;AUDIFONO SONY WH-CH710N/BZUC;ACCESORIOS
13410721;;F;45;CHILENO;;X;N/D;N/D;1258660;7;5;1;1;299990;6;4;958670;SOPORTE TV 26-56 KTA02 KIOTO FIJO;ACCESORIOS
20179168;;F;22;CHILENO;;Z;SAN FERNANDO                  ;L.G.B.OÂ´HIGGINS;129990;3;2;0;0;0;3;2;129990;GALAXY WATCH ACTIVE4 40 MM LTE GOLD;ACCESORIOS
18377351;;F;28;CHILENO;;Millenial;PROVIDENCIA                   ;METROPOLITANA;29980;2;1;0;0;0;2;1;29980;SAMSUNG TYPE-C EARPHONES BLACK;ACCESORIOS
8664380;;F;48;CHILENO;;X;ANCUD                         ;LOS LAGOS;73980;2;1;0;0;0;2;1;73980;DISCO DURO CANVIO 1TB BASICS BLACK TOSHIBA;ACCESORIOS
19128236;;M;25;CHILENO;;Z;RETIRO;MAULE;24990;1;1;0;0;0;1;1;24990;PARLANTE KARAOKE MGGLADIATOR NEGRO;ACCESORIOS
14408291;;F;48;CHILENO;;X;PUNTA ARENAS                  ;MAGALLANES;369960;4;4;0;0;0;4;4;369960;SAMSUNG TYPE-C EARPHONES BLACK;ACCESORIOS
15170555;;M;40;CHILENO;;X;PROVIDENCIA                   ;METROPOLITANA;139990;1;3;1;3;139990;0;0;0;AMPOLLETA SMAR MULTICOLOR;ACCESORIOS
12430183;;F;49;CHILENO;;X;VALDIVIA;LOS LAGOS;96970;3;2;2;1;89980;1;1;6990;Mousepad Gamer M901;ACCESORIOS
12715522;Casado;F;48;CHILENO;;X;RENCA                         ;METROPOLITANA;21990;1;1;0;0;0;1;1;21990;KIT PREPAGO HD DIRECTV;ACCESORIOS
13203588;;F;45;CHILENO;;X;VICHUQUEN                     ;MAULE;3742040;42;15;42;15;3742040;0;0;0;Funda Con Cierre 15;ACCESORIOS
7668776;;F;64;CHILENO;;Boomers;ANCUD                         ;LOS LAGOS;594820;7;3;0;0;0;7;3;594820;Audifonos Gamer Pro M2022;ACCESORIOS
10235798;;M;57;CHILENO;;Boomers;CORONEL;BIO-BIO;80160;5;3;0;0;0;5;3;80160;SOPORTE TV 32-65 KTA03 KIOTO FIJO;ACCESORIOS
11421999;;M;53;CHILENO;;X;PROVIDENCIA                   ;METROPOLITANA;15990;1;1;0;0;0;1;1;15990;ALTEC LANSING AUDIFONO HEADBAND BLUETOOTH COMFOR;ACCESORIOS
20258543;;M;22;CHILENO;;Z;N/D;N/D;1297120;17;16;0;0;0;17;16;1297120;SAMSUNG TYPE-C EARPHONES WHITE;ACCESORIOS
15053685;;F;39;CHILENO;;X;LA SERENA                     ;COQUIMBO;19990;1;1;0;0;0;1;1;19990;Audifonos Gamer Expert MF6;ACCESORIOS
13426073;Casado;M;44;CHILENO;;X;PROVIDENCIA                   ;METROPOLITANA;19990;1;1;1;1;19990;0;0;0;TECLADO Y MOUSE 300 INALAMBRICO;ACCESORIOS
11927981;;F;50;CHILENO;;X;CALBUCO                       ;LOS LAGOS;12980;2;2;0;0;0;2;2;12980;TRAVEL ADAPTER 15W - FAST CHARGER (TYPE-C CABLE);ACCESORIOS
17161213;;F;33;CHILENO;;Millenial;"";"";347240;4;3;0;0;0;4;3;347240;AUDIFONOS GALAXY BUDS PRO VIOLET;ACCESORIOS
13627709;;F;43;CHILENO;;X;"";"";47831;2;2;0;0;0;2;2;47831;Redmi Buds 3 Lite White;ACCESORIOS
12249347;;M;50;CHILENO;;X;MAIPU                         ;METROPOLITANA;482333;4;3;0;0;0;4;3;482333;AUDIFONO INALAMBRICO ANC 21 FIDDLER;ACCESORIOS
7274349;Viudo;M;68;CHILENO;;Boomers;ILLAPEL                       ;COQUIMBO;786620;6;4;0;0;0;6;4;786620;SOPORTE TV 26-56 KTA02 KIOTO FIJO;ACCESORIOS
26983342;Soltero;M;28;VENEZOLANO;;Extranjero;"";"";185710;3;2;0;0;0;3;2;185710;CAMARA SMART FIJA NEXXT 1080P;ACCESORIOS
16406933;Soltero;M;36;CHILENO;INGENIERO EN MINAS;Millenial;PROVIDENCIA                   ;METROPOLITANA;383970;3;1;3;1;383970;0;0;0;SILLA OMEN CITADEL;ACCESORIOS
9562618;;M;59;CHILENO;;Boomers;N/D;N/D;1027920;9;5;0;0;0;9;5;1027920;ALTEC LANSING AUDIFONO Nano Pods TWS ICE BLUE 89;ACCESORIOS
9772574;;F;59;CHILENO;;Boomers;RETIRO                        ;MAULE;22990;1;1;0;0;0;1;1;22990;SOPORTE TV 14-63 CON BRAZO KT-FM 3L;ACCESORIOS
11272249;;M;54;CHILENO;;X;BUIN                          ;METROPOLITANA;332760;3;2;0;0;0;3;2;332760;Parlante Bluetooth Blik Booster 1;ACCESORIOS
15963120;;M;37;CHILENO;;Millenial;N/D;N/D;25590;2;1;0;0;0;2;1;25590;ALTEC LANSING AUDIFONO HEADBAND BLUETOOTH COMFOR;ACCESORIOS
19099659;Soltero;M;26;CHILENO;;Z;PROVIDENCIA                   ;METROPOLITANA;22990;1;1;0;0;0;1;1;22990;MOUSE MICROSOFT Bluetooth Mobile 3600 Black;ACCESORIOS
18952405;;M;27;CHILENO;;Z;N/D;N/D;88049;6;4;0;0;0;6;4;88049;SAMSUNG TYPE-C EARPHONES BLACK;ACCESORIOS
17559408;;M;31;CHILENO;;Millenial;COQUIMBO                      ;COQUIMBO;84990;1;1;1;1;84990;0;0;0;DISCO DURO CANVIO 4TB BASICS BLACK;ACCESORIOS
20652503;;F;21;CHILENO;;Z;MELIPILLA                     ;METROPOLITANA;1041940;6;4;3;2;983970;3;2;57970;ALTEC LANSING AUDIFONO Nano Pods TWS ICE BLUE 89;ACCESORIOS
18590624;;F;28;CHILENO;;Millenial;N/D;N/D;282970;3;3;0;0;0;3;3;282970;AUDIFONO GALAXY BUDS2 BLACK;ACCESORIOS
20230356;;F;22;CHILENO;;Z;PROVIDENCIA                   ;METROPOLITANA;6990;1;1;0;0;0;1;1;6990;SOPORTE TV 26-56 KTA02 KIOTO FIJO;ACCESORIOS
10748322;;M;43;CHILENO;;X;PROVIDENCIA                   ;METROPOLITANA;268940;6;3;6;3;268940;0;0;0;TRAVEL ADAPTER 15W - FAST CHARGER (TYPE-C CABLE);ACCESORIOS
11491542;;M;53;CHILENO;;X;HUECHURABA                    ;METROPOLITANA;218980;3;2;2;1;209990;1;1;8990;Mouse Wireless M280 Blue;ACCESORIOS
18611715;;F;28;CHILENO;;Millenial;"";"";4990;1;1;0;0;0;1;1;4990;AUDIFONO IN SPORT HS34PC PNS AZUL;ACCESORIOS
19694295;;M;24;CHILENO;;Z;"";"";38980;4;3;0;0;0;4;3;38980;TRAVEL ADAPTER 15W - FAST CHARGER (TYPE-C CABLE);ACCESORIOS
6779785;;M;68;CHILENO;;Boomers;COIHAIQUE                     ;AYSEN;3993110;28;21;0;0;0;28;21;3993110;SOPORTE TV 26-56 KTA02 KIOTO FIJO;ACCESORIOS
10752227;Casado;M;54;CHILENO;;Boomers;RENCA                         ;METROPOLITANA;39990;1;1;1;1;39990;0;0;0;365 Personal Suscripcion Anual QQ2-0008TP;ACCESORIOS
18091365;;F;30;CHILENO;;Millenial;PROVIDENCIA                   ;METROPOLITANA;73980;2;1;2;1;73980;0;0;0;PARLANTES SRS-XB23/BC LA;ACCESORIOS
20271657;;M;22;CHILENO;;Z;"";"";146970;3;2;2;1;143980;1;1;2990;CABLE MGCALIG;ACCESORIOS
25798217;;M;24;DOMINICANO;;Extranjero;N/D;N/D;210930;7;6;0;0;0;7;6;210930;Mouse Gaming G203 Blanco;ACCESORIOS
26792777;;M;49;VENEZOLANO;;Extranjero;QUELLON                       ;LOS LAGOS;49990;1;1;0;0;0;1;1;49990;JBL AUDIFONOS ON-EAR BLUETOOTH TUNE 510BT AZUL;ACCESORIOS
19725090;;M;24;CHILENO;;Z;LAS CONDES                    ;METROPOLITANA;19980;2;3;2;3;19980;0;0;0;TYPE C TO TYPE C CABLE 3A (MAX 60W);ACCESORIOS
17442064;;M;32;CHILENO;;Millenial;PROVIDENCIA                   ;METROPOLITANA;79980;2;1;0;0;0;2;1;79980;REDMI BUDS 3 PRO (GRAPHITE BLACK);ACCESORIOS
17712677;;F;31;CHILENO;;Millenial;MONTE PATRIA                  ;COQUIMBO;166970;3;3;0;0;0;3;3;166970;TRAVEL ADAPTER 15W - FAST CHARGER (TYPE-C CABLE);ACCESORIOS
10100532;;M;57;CHILENO;;Boomers;EL MONTE                      ;METROPOLITANA;45903;3;2;0;0;0;3;2;45903;TYPE C TO TYPE C CABLE 3A (MAX 60W);ACCESORIOS
18210781;;F;30;CHILENO;;Millenial;QUINTA NORMAL                 ;METROPOLITANA;193980;2;1;2;1;193980;0;0;0;APPLE WATCH S3 38MM BLACK;ACCESORIOS
16768465;;F;34;CHILENO;;Millenial;PROVIDENCIA                   ;METROPOLITANA;53980;2;1;2;1;53980;0;0;0;PARLANTE FLIP ESSENTIAL BLUETOOTH;ACCESORIOS
19447506;;M;25;CHILENO;;Z;LA CALERA;VALPARAISO;46980;2;1;2;1;46980;0;0;0;PARLANTE FLIP ESSENTIAL BLUETOOTH;ACCESORIOS
18604342;;M;28;CHILENO;;Millenial;"";"";19990;1;1;0;0;0;1;1;19990;Audifonos Gamer Pro M2022;ACCESORIOS
11958023;;M;50;CHILENO;;X;SAN PEDRO DE LA PAZ           ;BIO BIO;322970;3;2;0;0;0;3;2;322970;Parlante Karaoke Blik Screamer 1;ACCESORIOS
16229867;;M;36;CHILENO;;Millenial;"";"";19990;1;1;0;0;0;1;1;19990;SOPORTE TV 14-42 KTAM02 KIOTO C/ BRAZO MOVIL;ACCESORIOS
16884248;;F;33;CHILENO;;Millenial;RANCAGUA                      ;L.G.B.OÂ´HIGGINS;44970;3;2;0;0;0;3;2;44970;SAMSUNG TYPE-C EARPHONES BLACK;ACCESORIOS
17447054;;F;32;CHILENO;;Millenial;PROVIDENCIA                   ;METROPOLITANA;88110;5;2;0;0;0;5;2;88110;FREEBUDS 4i BLACK HUAWEI;ACCESORIOS
13081202;;F;46;CHILENO;;X;RENCA                         ;METROPOLITANA;19990;1;1;1;1;19990;0;0;0;Mouse G203 LIGHTSYNC Gaming - BLACK;ACCESORIOS
18519537;;M;29;CHILENO;;Millenial;CAUQUENES                     ;MAULE;592321;8;6;1;1;189990;7;5;402331;SOPORTE TV 26-56 KTAT02 KIOTO MOVIL;ACCESORIOS
19209515;Soltero;F;25;CHILENO;;Z;PROVIDENCIA                   ;METROPOLITANA;64970;3;1;3;1;64970;0;0;0;DISCO DURO CANVIO 1TB BASICS BLACK TOSHIBA;ACCESORIOS
19266081;;M;26;CHILENO;;Z;N/D;N/D;1984430;8;4;0;0;0;8;4;1984430;Travel Adapter SFC 25W Type C (w/o Cable);ACCESORIOS
15425782;;M;39;CHILENO;;X;LO PRADO;METROPOLITANA;15000;2;1;0;0;0;2;1;15000;SAMSUNG TYPE-C EARPHONES BLACK;ACCESORIOS
18176729;;M;29;CHILENO;;Millenial;N/D;N/D;368961;5;3;2;1;78980;3;2;289981;Silla Gamer Tyrus Negra;ACCESORIOS
17094153;;M;33;CHILENO;;Millenial;CALAMA;ANTOFAGASTA;82980;2;1;2;1;82980;0;0;0;Silla Gamer Tyrus Negra;ACCESORIOS
5320789;;F;75;CHILENO;;Silencioso;RENCA                         ;METROPOLITANA;12990;1;1;0;0;0;1;1;12990;ARO DE LUZ LED 10 PULGADAS + TRIPODE PEQUENO;ACCESORIOS
6953181;;F;70;CHILENO;;Silencioso;N/D;N/D;43710;3;2;0;0;0;3;2;43710;Parlante Bluetooth Blik Rockwood;ACCESORIOS
14337201;;F;45;CHILENO;;X;RENCA                         ;METROPOLITANA;25460;2;1;0;0;0;2;1;25460;ALTEC LANSING AUDIFONO HEADBAND BLUETOOTH COMFOR;ACCESORIOS
19975023;;M;23;CHILENO;;Z;N/D;N/D;367450;5;2;0;0;0;5;2;367450;AUDIFONOS GALAXY BUDS PRO BLACK;ACCESORIOS
15554411;;M;38;CHILENO;;Millenial;PUCON                         ;ARAUCANIA;22990;1;1;0;0;0;1;1;22990;PARLANTE KARAOKE MGGLADIATOR NEGRO;ACCESORIOS
10822108;;F;54;CHILENO;;Boomers;CONSTITUCION                  ;MAULE;19980;2;2;0;0;0;2;2;19980;AUDIFONO MLAB ON HEADBAND P800 BLACK 7403;ACCESORIOS
16865276;Soltero;M;34;CHILENO;MEDICO CIRUJANO;Millenial;PROVIDENCIA                   ;METROPOLITANA;369960;4;4;0;0;0;4;4;369960;SOPORTE TV 26-56 KTAT02 KIOTO MOVIL;ACCESORIOS
18448185;Soltero;M;28;CHILENO;ADMINISTRACION DE EMPRESAS;Millenial;PROVIDENCIA                   ;METROPOLITANA;39990;1;1;0;0;0;1;1;39990;Redmi Buds 3;ACCESORIOS
16806639;;F;34;CHILENO;;Millenial;VALDIVIA                      ;LOS RIOS;47980;2;2;0;0;0;2;2;47980;PARLANTE EXTREM-BASS BLACK 8907;ACCESORIOS
14071513;;M;40;CHILENO;;X;CURANILAHUE                   ;BIO BIO;11990;1;1;0;0;0;1;1;11990;SOPORTE TV 32-65 KTA03 KIOTO FIJO;ACCESORIOS
7251094;;F;64;CHILENO;;Boomers;PANGUIPULLI                   ;LOS RIOS;128980;2;2;0;0;0;2;2;128980;Silla Gamer Tyrus Negra;ACCESORIOS
11596781;;M;52;CHILENO;;X;PAINE                         ;METROPOLITANA;311990;4;2;0;0;0;4;2;311990;Mi Smart Band 6 Negra Xiaomi;ACCESORIOS
5567337;;M;76;CHILENO;;Silencioso;TEMUCO                        ;ARAUCANIA;377970;3;2;0;0;0;3;2;377970;SOPORTE TV 14-42 KTAM02 KIOTO C/ BRAZO MOVIL;ACCESORIOS
15154808;;F;39;CHILENO;;X;YERBAS BUENAS                 ;MAULE;7693;1;1;0;0;0;1;1;7693;AUDIFONO TEEN FROZEN 2 ELSA+ANNA ALAMBRICO;ACCESORIOS
10150201;;M;57;CHILENO;;Boomers;RENCA                         ;METROPOLITANA;36460;2;1;0;0;0;2;1;36460;PARLANTE KARAOKE MGROCKET NEGRO;ACCESORIOS
18389590;Soltero;M;28;CHILENO;;Silencioso;PROVIDENCIA                   ;METROPOLITANA;195980;2;2;2;2;195980;0;0;0;PAD MOUSE GAMER EXTRA LARGE MP9040;ACCESORIOS
11367247;;F;53;CHILENO;;X;SAN FERNANDO                  ;L.G.B.OÂ´HIGGINS;603950;5;3;0;0;0;5;3;603950;Redmi Buds 3 Lite Black;ACCESORIOS
9651769;;F;61;CHILENO;;Boomers;VALPARAISO                    ;VALPARAISO;18000;2;1;0;0;0;2;1;18000;AUDIFONO BLUETOOTH PANASONIC RP-HJE120B NEGRO;ACCESORIOS
16576581;;M;35;CHILENO;;Millenial;N/D;N/D;5000;2;1;0;0;0;2;1;5000;Mouse Inalambrico Azul;ACCESORIOS
17975982;;F;30;CHILENO;;Millenial;N/D;N/D;6000;2;1;0;0;0;2;1;6000;AUDIFONO IN SAM HS1303C/ MIC BLANCO;ACCESORIOS
18137270;;M;30;CHILENO;;Millenial;PROVIDENCIA                   ;METROPOLITANA;87980;2;1;2;1;87980;0;0;0;Silla Gamer Tyrus Blanco rosadosa;ACCESORIOS
16057685;;M;36;CHILENO;;Millenial;ARICA                         ;TARAPACA;634940;7;5;0;0;0;7;5;634940;GALAXY WATCH4 42 MM SILVER;ACCESORIOS
20624205;;M;21;CHILENO;;Z;PROVIDENCIA                   ;METROPOLITANA;16990;1;3;2;2;39980;-1;1;-22990;SOPORTE TV 14-63 CON BRAZO KT-FM 3L;ACCESORIOS
12780992;;M;46;CHILENO;;X;RENCA                         ;METROPOLITANA;25980;2;2;0;0;0;2;2;25980;SOPORTE TV 14-63 CON BRAZO KT-FM 3L;ACCESORIOS
13207652;;F;45;CHILENO;;X;PARRAL                        ;MAULE;17990;1;1;0;0;0;1;1;17990;AUDIFONO XIAOMI EARBUDS MI TRUE WIRELESS BASIC 2;ACCESORIOS
19992292;;M;23;CHILENO;;Silencioso;PROVIDENCIA                   ;METROPOLITANA;43980;2;1;2;1;43980;0;0;0;HUAWEI FREEBUDS 4i SILVER FROST;ACCESORIOS
14022201;;M;41;CHILENO;;X;RETIRO                        ;MAULE;232980;2;2;1;1;219990;1;1;12990;SOPORTE TV 14-63 CON BRAZO KT-FM 3L;ACCESORIOS
16461161;;M;35;CHILENO;;Millenial;ANCUD                         ;LOS LAGOS;162980;2;6;0;0;0;2;6;162980;Redmi Buds 3 Lite White;ACCESORIOS
15331466;Casado;M;39;CHILENO;;X;RENCA                         ;METROPOLITANA;1247970;3;2;2;1;1239980;1;1;7990;SOPORTE TV 26-56 KTAT02 KIOTO MOVIL;ACCESORIOS
3550112;;M;84;CHILENO;;Silencioso;PUENTE ALTO                   ;METROPOLITANA;13990;1;1;0;0;0;1;1;13990;PARLANTE 6985 MLAB VERTICAL BRITPOP BT;ACCESORIOS
9887517;;M;58;CHILENO;;Boomers;RENCA                         ;METROPOLITANA;7990;1;1;0;0;0;1;1;7990;SOPORTE TV 26-56 KTAT02 KIOTO MOVIL;ACCESORIOS
15343041;;M;38;CHILENO;;Millenial;PROVIDENCIA                   ;METROPOLITANA;179990;2;1;0;0;0;2;1;179990;AUDIFONOS GALAXY BUDS PRO BLACK;ACCESORIOS
16504004;;F;35;CHILENO;;Millenial;PROVIDENCIA                   ;METROPOLITANA;10990;1;1;0;0;0;1;1;10990;Wireless Mobile Mouse 1850 cyan blue;ACCESORIOS
19169088;Soltero;M;26;CHILENO;;Z;NIQUEN                        ;NUBLE;109990;1;1;0;0;0;1;1;109990;Smartwatch GT 2 BLACK;ACCESORIOS
16174475;Soltero;M;36;CHILENO;;Millenial;PROVIDENCIA                   ;METROPOLITANA;37990;1;1;0;0;0;1;1;37990;Headset Pav Gam 400 Grn CAN/ENG;ACCESORIOS
15966646;;M;37;CHILENO;;Millenial;PROVIDENCIA                   ;METROPOLITANA;343970;5;2;5;2;343970;0;0;0;Redmi Buds 3;ACCESORIOS
9859278;;F;58;CHILENO;;Boomers;CERRO NAVIA                   ;METROPOLITANA;146950;5;3;0;0;0;5;3;146950;SOPORTE TV 26-56 KTAT02 KIOTO MOVIL;ACCESORIOS
19357370;;M;25;CHILENO;;Z;ARICA                         ;ARICA Y PARINACOTA;722940;6;3;2;2;439980;4;1;282960;Silla Gamer Ymer RGB Negra;ACCESORIOS
18209699;Soltero;M;29;CHILENO;;Millenial;PROVIDENCIA                   ;METROPOLITANA;39990;1;3;0;0;0;1;3;39990;AUDIFONO MLAN AIR-WIRELESS CHARGE TOUCH RED;ACCESORIOS
9816464;;M;58;CHILENO;;Boomers;N/D;N/D;9990;1;1;0;0;0;1;1;9990;Mouse 200 Silver Wireless;ACCESORIOS
9073852;;M;61;CHILENO;;Boomers;LA SERENA                     ;COQUIMBO;13980;4;2;0;0;0;4;2;13980;SOPORTE TV 14-63 CON BRAZO KT-FM 3L;ACCESORIOS
7057043;;F;69;CHILENO;;Silencioso;PROVIDENCIA                   ;METROPOLITANA;7990;1;1;0;0;0;1;1;7990;SOPORTE TV 26-56 KTAT02 KIOTO MOVIL;ACCESORIOS
17130411;;M;33;CHILENO;;Millenial;CHILLAN                       ;BIO BIO;72950;5;2;0;0;0;5;2;72950;SOPORTE TV 26-56 KTA02 KIOTO FIJO;ACCESORIOS
15775451;;F;38;CHILENO;;Millenial;"";"";10000;2;1;0;0;0;2;1;10000;MINI PARLANTE BT GO2;ACCESORIOS
17169876;;M;32;CHILENO;;Millenial;"";"";17980;2;1;2;1;17980;0;0;0;AUDIFONO BLUETOOTH HYUNDAI WB450;ACCESORIOS
16121277;;M;37;CHILENO;;Millenial;PROVIDENCIA                   ;METROPOLITANA;148170;3;1;3;1;148170;0;0;0;GALAXY WATCH4 42 MM SILVER;ACCESORIOS
20120190;;M;23;CHILENO;;Z;PROVIDENCIA                   ;METROPOLITANA;20990;1;1;1;1;20990;0;0;0;WebCam 300 FHD;ACCESORIOS
19554688;;M;25;CHILENO;;Z;PROVIDENCIA                   ;METROPOLITANA;159990;1;1;0;0;0;1;1;159990;Silla Gamer Tyrus Negra;ACCESORIOS
15473395;;M;39;CHILENO;;X;PENALOLEN;METROPOLITANA;79990;1;1;1;1;79990;0;0;0;Smartwatch GT 2 BLACK;ACCESORIOS
15021777;;F;40;CHILENO;;X;ANTOFAGASTA                   ;ANTOFAGASTA;143950;5;4;0;0;0;5;4;143950;SOPORTE TV 26-56 KTA02 KIOTO FIJO;ACCESORIOS
14291973;Casado;M;47;CHILENO;INGENIERO CIVIL INDUSTRIAL;Silencioso;PROVIDENCIA                   ;METROPOLITANA;184980;2;1;2;1;184980;0;0;0;SILLA GAMER ARMOR S / 3MGC2NXB.0001;ACCESORIOS
19521638;;F;24;CHILENO;;Z;"";"";22140;2;2;0;0;0;2;2;22140;KARAOKE MLAB TOWER OUTDOOR MIC BT BK 8568;ACCESORIOS
19072813;;M;26;CHILENO;;Z;LINARES                       ;MAULE;67990;1;1;0;0;0;1;1;67990;Disco Externo Elements Portable SE 2TB;ACCESORIOS
19052488;Soltero;F;26;CHILENO;;Z;PROVIDENCIA                   ;METROPOLITANA;9990;1;1;0;0;0;1;1;9990;TRAVEL ADAPTER 15W - FAST CHARGER (TYPE-C CABLE);ACCESORIOS
17478852;;M;32;CHILENO;;Millenial;PROVIDENCIA                   ;METROPOLITANA;22990;1;1;0;0;0;1;1;22990;AUDIFONO MOTOROLA BLUETOOTH ESCAPE 220 BLANCO;ACCESORIOS
17815690;Soltero;F;31;CHILENO;GASTRONOMIA INTERNACIONAL;Millenial;PROVIDENCIA                   ;METROPOLITANA;65980;2;1;2;1;65980;0;0;0;DSICO PORTATIL TOSHIBA CANVIO ADVANCE V10 ROJO;ACCESORIOS
27310635;;M;40;CHILENO;;Extranjero;PUERTO MONTT                  ;LOS LAGOS;45980;2;2;0;0;0;2;2;45980;Redmi Buds 3 Lite Black;ACCESORIOS
17053352;;M;33;CHILENO;;Millenial;RENCA                         ;METROPOLITANA;671940;6;3;6;3;671940;0;0;0;TORNAMESA MUSTANG LP ION ROJA;ACCESORIOS
19887071;;F;24;CHILENO;;Z;"";"";8990;1;1;0;0;0;1;1;8990;MINI PODS TOUCH FIDDLER;ACCESORIOS
17305444;;F;32;CHILENO;;Millenial;PROVIDENCIA                   ;METROPOLITANA;517960;5;4;0;0;0;5;4;517960;SOPORTE TV 26-56 KTA02 KIOTO FIJO;ACCESORIOS
18013233;Soltero;M;30;CHILENO;;Millenial;PROVIDENCIA                   ;METROPOLITANA;286970;3;2;3;2;286970;0;0;0;SOPORTE TV 26-56 KTAT02 KIOTO MOVIL;ACCESORIOS
17318212;;M;32;CHILENO;;Millenial;N/D;N/D;173930;7;3;7;3;173930;0;0;0;AUDIFONOS ON-EAR JBL TUNE 500 NEGRO;ACCESORIOS
10588298;;F;55;CHILENO;;Boomers;QUILICURA                     ;METROPOLITANA;6990;1;1;0;0;0;1;1;6990;SOPORTE TV 26-56 KTA02 KIOTO FIJO;ACCESORIOS
19065558;Soltero;M;34;CHILENO;;Millenial;QUEILEN                       ;LOS LAGOS;62830;4;2;0;0;0;4;2;62830;Redmi Buds 3 Lite Black;ACCESORIOS
6757390;;F;66;CHILENO;;Boomers;LO ESPEJO                     ;METROPOLITANA;203970;3;2;0;0;0;3;2;203970;AUDIFONO GALAXY BUDS LIVE NEGRO;ACCESORIOS
20012500;;M;23;CHILENO;;Silencioso;PROVIDENCIA                   ;METROPOLITANA;116980;2;1;2;1;116980;0;0;0;AUDIFONOS GALAXY BUDS PRO SILVER;ACCESORIOS
19735810;;M;24;CHILENO;;Z;IQUIQUE                       ;TARAPACA;114980;3;2;0;0;0;3;2;114980;ALTEC LANSING AUDIFONO HEADBAND BLUETOOTH COMFOR;ACCESORIOS
15520874;;M;39;CHILENO;;X;"";"";22990;1;1;0;0;0;1;1;22990;Redmi Buds 3 Lite Black;ACCESORIOS
16483159;;M;36;CHILENO;;Millenial;"";"";114980;2;1;2;1;114980;0;0;0;AUDIFONOS GALAXY BUDS PRO SILVER;ACCESORIOS
14012292;;M;41;CHILENO;;X;RENGO                         ;L.G.B.OÂ´HIGGINS;14000;2;1;0;0;0;2;1;14000;SAMSUNG TYPE-C EARPHONES BLACK;ACCESORIOS
13494679;;M;44;CHILENO;;X;HUECHURABA;METROPOLITANA;147950;5;3;3;2;116970;2;1;30980;AUDIFONOS IN-EAR TRULY WIRELESS JBL W100 TWS NEG;ACCESORIOS
10933819;;M;53;CHILENO;;X;RENCA                         ;METROPOLITANA;25990;1;1;0;0;0;1;1;25990;SOPORTE TV 14-63 CON BRAZO KT-FM 3L;ACCESORIOS
8971525;;F;63;CHILENO;;Boomers;MAIPU                         ;METROPOLITANA;36980;2;2;0;0;0;2;2;36980;SOPORTE TV 26-56 KTA02 KIOTO FIJO;ACCESORIOS
19349745;;F;25;CHILENO;;Z;PROVIDENCIA                   ;METROPOLITANA;24990;1;1;0;0;0;1;1;24990;Redmi Buds 3 Lite White;ACCESORIOS
17375351;;F;32;CHILENO;;Millenial;PROVIDENCIA                   ;METROPOLITANA;29990;1;1;1;1;29990;0;0;0;365 Personal Suscripcion Anual QQ2-0008TP;ACCESORIOS
10144940;;M;65;CHILENO;;Boomers;PROVIDENCIA                   ;METROPOLITANA;19990;1;1;0;0;0;1;1;19990;CARGADOR CP404;ACCESORIOS
7710182;Soltero;M;67;CHILENO;;Boomers;EL BOSQUE                     ;METROPOLITANA;2262910;9;7;0;0;0;9;7;2262910;Kit 4 en 1 Gamer M501;ACCESORIOS
19391570;Soltero;F;25;CHILENO;;Z;PAINE;METROPOLITANA;9990;1;1;0;0;0;1;1;9990;SOPORTE TV 32-65 KTA03 KIOTO FIJO;ACCESORIOS
17169708;;M;32;CHILENO;;Millenial;PROVIDENCIA                   ;METROPOLITANA;6990;1;1;0;0;0;1;1;6990;AUDIFONO KIDS FROZEN 2 ANNA ALAMBRICO;ACCESORIOS
17754020;;M;31;CHILENO;;Millenial;PROVIDENCIA                   ;METROPOLITANA;12990;1;1;1;1;12990;0;0;0;SAMSUNG TYPE-C EARPHONES WHITE;ACCESORIOS
19256050;Soltero;F;26;CHILENO;ENFERMERA;Z;PROVIDENCIA                   ;METROPOLITANA;12990;1;1;0;0;0;1;1;12990;SAMSUNG TYPE-C EARPHONES BLACK;ACCESORIOS
18300168;;F;29;CHILENO;;Millenial;"";"";3990;1;1;0;0;0;1;1;3990;AUDIFONO MLAB ON HEADBAND P800 BLACK 7403;ACCESORIOS
8024900;;F;64;CHILENO;;Boomers;MAIPU                         ;METROPOLITANA;28240;2;3;0;0;0;2;3;28240;SOPORTE TV 26-56 KTAT02 KIOTO MOVIL;ACCESORIOS
17825092;;M;30;CHILENO;;Millenial;N/D;N/D;99990;1;1;0;0;0;1;1;99990;AUDIFONO GALAXY BUDS LIVE NEGRO;ACCESORIOS
18211744;;M;29;CHILENO;;Millenial;PROVIDENCIA                   ;METROPOLITANA;46980;2;1;2;1;46980;0;0;0;365 Personal Suscripcion Anual QQ2-0008TP;ACCESORIOS
19973799;;F;23;CHILENO;;Z;N/D;N/D;14980;2;1;0;0;0;2;1;14980;MOUSE X200 Inalambrico NEGRO;ACCESORIOS
18678302;;M;28;CHILENO;;Millenial;N/D;N/D;19990;1;1;0;0;0;1;1;19990;Travel Adapter SFC 25W Type C (w/o Cable);ACCESORIOS
11862206;;F;53;CHILENO;;X;N/D;N/D;12990;1;1;0;0;0;1;1;12990;Mouse 530 Wireless (PlatinumGrey);ACCESORIOS
19787062;;F;24;CHILENO;;Z;PROVIDENCIA                   ;METROPOLITANA;22990;1;1;0;0;0;1;1;22990;AUDIFONO XIAOMI EARPHONES MI TRUE WIRELESS 2 BAS;ACCESORIOS
15254177;;M;40;CHILENO;;X;RENCA                         ;METROPOLITANA;49990;1;1;0;0;0;1;1;49990;Mi Smart Band 6 Negra Xiaomi;ACCESORIOS
19592756;;M;24;CHILENO;;Z;N/D;N/D;19990;1;1;0;0;0;1;1;19990;AUDIFONO MLAB TWS FULLY WIRELESSÂ  WHITE 8721;ACCESORIOS
15977227;;M;37;CHILENO;;Millenial;CURACO DE VELEZ               ;LOS LAGOS;54990;1;1;0;0;0;1;1;54990;DISCO DURO CANVIO 1TB BASICS BLACK TOSHIBA;ACCESORIOS
17345421;;M;32;CHILENO;;Millenial;CANETE                        ;BIO BIO;164970;3;3;0;0;0;3;3;164970;PARLANTE GBASS MICRO;ACCESORIOS
12745217;;M;47;CHILENO;;X;PANGUIPULLI                   ;LOS RIOS;237980;2;2;0;0;0;2;2;237980;SOPORTE TV 26-56 KTA02 KIOTO FIJO;ACCESORIOS
9179016;;F;60;CHILENO;;Boomers;PARRAL                        ;MAULE;26990;1;1;0;0;0;1;1;26990;MI Smart Band 6 Negra XIAOMI;ACCESORIOS
19082422;Soltero;M;27;CHILENO;;Z;PROVIDENCIA                   ;METROPOLITANA;22980;2;1;2;1;22980;0;0;0;Micro SD 64GB Extreme;ACCESORIOS
21297477;;M;18;CHILENO;;Extranjero;PROVIDENCIA                   ;METROPOLITANA;32970;3;3;0;0;0;3;3;32970;Mousepad Gamer M905;ACCESORIOS
15864425;;F;37;CHILENO;;Millenial;PROVIDENCIA                   ;METROPOLITANA;14990;1;1;0;0;0;1;1;14990;Travel Adapter SFC 25W Type C (w/o Cable);ACCESORIOS
12719224;;M;47;CHILENO;;X;RENCA                         ;METROPOLITANA;699970;3;2;3;2;699970;0;0;0;Travel Adapter SFC 25W Type C (w/o Cable);ACCESORIOS
13169651;Casado;F;45;CHILENO;;X;RENCA                         ;METROPOLITANA;69990;1;3;0;0;0;1;3;69990;GALAXY WATCH ACTIVE4 40 MM GOLD;ACCESORIOS
19930647;;M;24;CHILENO;;Z;SANTA CRUZ                    ;L.G.B.OÂ´HIGGINS;29990;1;1;0;0;0;1;1;29990;Headset Pav Gam 400 Grn CAN/ENG;ACCESORIOS
16816544;;M;35;CHILENO;;Millenial;PROVIDENCIA                   ;METROPOLITANA;14990;1;1;0;0;0;1;1;14990;Travel Adapter SFC 25W Type C (w/o Cable);ACCESORIOS
26300309;Soltero;M;32;VENEZOLANO;;Extranjero;PROVIDENCIA                   ;METROPOLITANA;7990;1;1;1;1;7990;0;0;0;AUDIFONO MLAB TWS IN-AIR WHITE 8533;ACCESORIOS
17874676;;F;31;CHILENO;;Millenial;N/D;N/D;29980;2;2;0;0;0;2;2;29980;SOPORTE TV 14-63 CON BRAZO KT-FM 3L;ACCESORIOS
8302801;Casado;M;64;CHILENO;LABORES ADMINISTRATIVAS;Boomers;PROVIDENCIA                   ;METROPOLITANA;54990;1;2;0;0;0;1;2;54990;BAND 6 BLACK HUAWEI;ACCESORIOS
7730106;;F;65;CHILENO;;Boomers;RENCA                         ;METROPOLITANA;7990;1;1;0;0;0;1;1;7990;AUDIFONO MOTOROLA EARBUDS M. LIBRES METAL NEGRO;ACCESORIOS
11115190;;F;54;CHILENO;;Boomers;VALDIVIA                      ;LOS RIOS;19982;2;2;0;0;0;2;2;19982;AUDIFONO TEEN SPIDERMAN ALAMBRICO;ACCESORIOS
12348633;;F;48;CHILENO;;Extranjero;FREIRINA                      ;ATACAMA;13460;4;1;0;0;0;4;1;13460;AUDIFONO MOTOROLA EARBUDS M. LIBRES METAL DORADO;ACCESORIOS
15540715;;F;38;CHILENO;;X;N/D;N/D;23980;2;2;0;0;0;2;2;23980;TRAVEL ADAPTER 15W - FAST CHARGER (TYPE-C CABLE);ACCESORIOS
27187441;;F;45;VENEZOLANO;;Extranjero;PENALOLEN;METROPOLITANA;4990;1;1;0;0;0;1;1;4990;AUDIFONO MOTO EARBUDS 2 MANOS LIBRES NEGRO;ACCESORIOS
26229046;Casado;M;34;NO INFORMA NACIONALIDAD;;Extranjero;N/D;N/D;12990;1;1;0;0;0;1;1;12990;MINI PARLANTE BT GO2;ACCESORIOS
18378882;;F;28;CHILENO;;Millenial;RENGO;O HIGGINS;29980;2;1;0;0;0;2;1;29980;AUDIFONO XIAOMI EARBUDS MI TRUE WIRELESS BASIC 2;ACCESORIOS
19415117;Soltero;M;25;CHILENO;;Z;PROVIDENCIA                   ;METROPOLITANA;13990;1;1;0;0;0;1;1;13990;MEMORIA MICROSD CLASE 10 128GB SANDISK;ACCESORIOS
14259765;Casado;M;47;CHILENO;INGENIERO CIVIL INDUSTRIAL;X;PROVIDENCIA                   ;METROPOLITANA;22990;1;1;0;0;0;1;1;22990;AUDIFONO MOTO BUDBS 100 TRUE WIRELESS BLACK;ACCESORIOS
10126281;;F;50;CHILENO;;X;VICUNA                        ;COQUIMBO;49990;1;1;0;0;0;1;1;49990;BAND 6 BLACK HUAWEI;ACCESORIOS
18864562;;F;26;CHILENO;;Z;PROVIDENCIA                   ;METROPOLITANA;12980;2;2;0;0;0;2;2;12980;CABLE MGCATC;ACCESORIOS
15615364;;F;38;CHILENO;;Millenial;PROVIDENCIA                   ;METROPOLITANA;23140;2;1;0;0;0;2;1;23140;AUDIFONO XIAOMI EARPHONES MI TRUE WIRELESS 2 BAS;ACCESORIOS
13101021;;F;46;CHILENO;;X;TALCA                         ;MAULE;231970;3;4;0;0;0;3;4;231970;SOPORTE TV 14-63 CON BRAZO KT-FM 3L;ACCESORIOS
17889733;;F;30;CHILENO;;Millenial;PROVIDENCIA                   ;METROPOLITANA;7990;1;1;0;0;0;1;1;7990;SOPORTE TV 26-56 KTA02 KIOTO FIJO;ACCESORIOS
12724229;;F;47;CHILENO;;X;PAINE                         ;METROPOLITANA;160950;5;4;0;0;0;5;4;160950;Cooler Pad M2072;ACCESORIOS
26814633;;M;31;VENEZOLANO;;Extranjero;N/D;N/D;932930;9;8;4;2;559970;5;6;372960;AUDIFONO XIAOMI EARPHONES MI TRUE WIRELESS 2 BAS;ACCESORIOS
10432216;;M;54;CHILENO;;Boomers;RENCA                         ;METROPOLITANA;29990;1;1;0;0;0;1;1;29990;BAND 4 BLACK;ACCESORIOS
18518460;;M;28;CHILENO;;Millenial;N/D;N/D;724950;5;4;0;0;0;5;4;724950;DISCO DURO CANVIO 2TB BASICS BLACK TOSHIBA;ACCESORIOS
8613439;Casado;F;57;CHILENO;;Boomers;RENCA                         ;METROPOLITANA;12990;1;1;0;0;0;1;1;12990;SOPORTE TV 32-65 KTA03 KIOTO FIJO;ACCESORIOS
6961465;Casado;F;57;CHILENO;;Boomers;SAN FELIPE                    ;VALPARAISO;0;0;2;0;0;0;0;2;0;AUDIFONO SAMSUNG WIRELESS 103B;ACCESORIOS
11346182;;F;53;CHILENO;;X;PROVIDENCIA                   ;METROPOLITANA;7990;1;1;0;0;0;1;1;7990;AUDIFONO MOTOROLA EARBUDS M. LIBRES METAL NEGRO;ACCESORIOS
17865658;;F;31;CHILENO;;Millenial;PROVIDENCIA                   ;METROPOLITANA;354980;3;2;0;0;0;3;2;354980;Silla Gamer Balderi Negra;ACCESORIOS
15173953;;F;39;CHILENO;;X;N/D;N/D;23990;1;1;0;0;0;1;1;23990;AUDIFONO MOTO BUDBS 100 TRUE WIRELESS BLACK;ACCESORIOS
15358757;;M;39;CHILENO;;X;PROVIDENCIA                   ;METROPOLITANA;39980;2;1;0;0;0;2;1;39980;AUDIFONO INALAMBRICO ANC 21 FIDDLER;ACCESORIOS
18216933;;M;29;CHILENO;;Millenial;"";"";14990;1;1;0;0;0;1;1;14990;Kit gamer 3 en 1;ACCESORIOS
15328635;;M;39;CHILENO;;X;PROVIDENCIA                   ;METROPOLITANA;22990;1;1;0;0;0;1;1;22990;AUDIFONO MOTOROLA BLUETOOTH ESCAPE 220 BLANCO;ACCESORIOS
13485683;;M;44;CHILENO;;X;PUENTE ALTO;METROPOLITANA;213980;2;1;2;1;213980;0;0;0;GALAXY WATCH ACTIVE4 40 MM LTE BLACK;ACCESORIOS
15457520;;F;39;CHILENO;;X;REQUINOA                      ;L.G.B.OÂ´HIGGINS;19192;1;1;0;0;0;1;1;19192;AUDIFONO MOTO BUDBS 100 TRUE WIRELESS BLACK;ACCESORIOS
10241405;;M;47;CHILENO;;X;EL BOSQUE                     ;METROPOLITANA;6990;1;1;0;0;0;1;1;6990;SOPORTE TV 26-56 KTAT02 KIOTO MOVIL;ACCESORIOS
13078375;;F;45;CHILENO;;Millenial;"";"";19990;1;1;0;0;0;1;1;19990;AUDIFONO MOTOROLA BLUETOOTH ESCAPE 220 BLANCO;ACCESORIOS
14349900;;F;43;CHILENO;;X;N/D;N/D;4990;1;1;0;0;0;1;1;4990;SOPORTE TV EE-F01 14-42 ENCORE;ACCESORIOS
15705824;;F;38;CHILENO;;Millenial;CAUQUENES                     ;MAULE;19990;1;1;0;0;0;1;1;19990;PARLANTE KARAOKE MGGLADIATOR NEGRO;ACCESORIOS
17225906;;F;32;CHILENO;;Millenial;"";"";215980;2;1;0;0;0;2;1;215980;Galaxy Watch Active4 40 mm Black;ACCESORIOS
18644598;;F;28;CHILENO;;Millenial;PROVIDENCIA                   ;METROPOLITANA;7990;1;1;0;0;0;1;1;7990;AUDIFONO HEADBAND BT BLANCO FIDDLER;ACCESORIOS
5554340;;M;74;CHILENO;;Silencioso;LEBU                          ;BIO BIO;16990;1;1;0;0;0;1;1;16990;SOPORTE TV 14-42 KTAM02 KIOTO C/ BRAZO MOVIL;ACCESORIOS
17861037;;F;30;CHILENO;;Millenial;FREIRINA                      ;ATACAMA;14990;1;1;0;0;0;1;1;14990;ALTEC LANSING AUDIFONO HEADBAND BLUETOOTH COMFOR;ACCESORIOS
17386376;;F;32;CHILENO;;Millenial;SANTIAGO;METROPOLITANA;7990;1;1;1;1;7990;0;0;0;AUDIFONO HEADBAND BT NEGRO;ACCESORIOS
16379212;;F;41;CHILENO;;X;NATALES                       ;MAGALLANES;16990;1;1;0;0;0;1;1;16990;PARLANTE KARAOKE MGPANTERA NEGRO;ACCESORIOS
19910484;;F;24;CHILENO;;Z;N/D;N/D;17990;1;1;0;0;0;1;1;17990;SOPORTE TV 14-63 CON BRAZO KT-FM 3L;ACCESORIOS
16259427;;M;36;CHILENO;;Millenial;N/D;N/D;39990;1;1;0;0;0;1;1;39990;PARLANTE KARAOKE FD-PKBT82 8 LUCES MIC/FM/BT/USB;ACCESORIOS
13340980;;M;43;CHILENO;;X;N/D;N/D;249970;3;2;0;0;0;3;2;249970;MI Smart Band 6 Negra XIAOMI;ACCESORIOS
16250743;;F;36;CHILENO;;Millenial;RANCAGUA                      ;L.G.B.OÂ´HIGGINS;109990;1;1;0;0;0;1;1;109990;Smartwatch GT 2 BLACK;ACCESORIOS
5974562;;F;78;CHILENO;;Silencioso;ANTOFAGASTA                   ;ANTOFAGASTA;124970;3;2;0;0;0;3;2;124970;Silla Gamer Python Roja;ACCESORIOS
15224161;;F;39;CHILENO;;X;N/D;N/D;58960;4;2;0;0;0;4;2;58960;PARLANTE KARAOKE MGGLADIATOR NEGRO;ACCESORIOS
17053307;;F;33;CHILENO;;Millenial;N/D;N/D;244950;6;3;4;2;216970;2;1;27980;PARLANTE KARAOKE MGPANTERA NEGRO;ACCESORIOS
6101184;;M;69;CHILENO;;Silencioso;SAN FELIPE                    ;VALPARAISO;359980;2;2;0;0;0;2;2;359980;GALAXY WATCH4 42 MM BLACK;ACCESORIOS
19236582;;F;26;CHILENO;;Z;LA CISTERNA                   ;METROPOLITANA;17990;1;1;1;1;17990;0;0;0;AUDIFONO XIAOMI EARBUDS MI TRUE WIRELESS BASIC 2;ACCESORIOS
19120436;;M;27;CHILENO;;Z;PROVIDENCIA                   ;METROPOLITANA;15980;2;1;0;0;0;2;1;15980;TRAVEL ADAPTER 15W - FAST CHARGER (TYPE-C CABLE);ACCESORIOS
17258315;;M;32;CHILENO;;Millenial;NAVIDAD                       ;L.G.B.OÂ´HIGGINS;7990;1;1;0;0;0;1;1;7990;AUDIFONO KIDS FROZEN 2 ANNA ALAMBRICO;ACCESORIOS
15870209;;F;37;CHILENO;;Millenial;COPIAPO                       ;ATACAMA;0;0;2;0;0;0;0;2;0;PARLANTE GO 2 BLUETOOTH NEGRO;ACCESORIOS
27186596;;M;32;EXTRANJERO - NO INFORMA NACIONALIDAD;;Extranjero;SAN VICENTE                   ;L.G.B.OÂ´HIGGINS;57970;3;2;0;0;0;3;2;57970;PARLANTE KARAOKE MGROCKET NEGRO;ACCESORIOS
16674242;;M;35;CHILENO;;Millenial;"";"";7990;1;1;0;0;0;1;1;7990;SOPORTE TV 26-56 KTA02 KIOTO FIJO;ACCESORIOS
16214229;;M;36;CHILENO;;Silencioso;PANGUIPULLI                   ;LOS LAGOS;188980;2;2;0;0;0;2;2;188980;PARLANTE KARAOKE MGPANTERA NEGRO;ACCESORIOS
12352404;;F;48;CHILENO;;X;LIMACHE                       ;VALPARAISO;8990;1;1;0;0;0;1;1;8990;PARLANTE 7284 MLAB ZUKABASS NARAN/VERDE BT;ACCESORIOS
19387692;;M;26;CHILENO;;Z;PEUMO                         ;L.G.B.OÂ´HIGGINS;255130;3;3;0;0;0;3;3;255130;Galaxy Watch Active4 40 mm Black;ACCESORIOS
8471674;Casado;F;68;CHILENO;;Boomers;SAN VICENTE                   ;L.G.B.OÂ´HIGGINS;275980;2;2;0;0;0;2;2;275980;SOPORTE TV 32-65 KTA03 KIOTO FIJO;ACCESORIOS
12799989;;M;47;CHILENO;;X;N/D;N/D;29990;1;1;0;0;0;1;1;29990;Multi BT Keyboard Black;ACCESORIOS
13625909;;M;42;CHILENO;;X;RENCA                         ;METROPOLITANA;41980;2;2;0;0;0;2;2;41980;SOPORTE TV 14-42 KTAM02 KIOTO C/ BRAZO MOVIL;ACCESORIOS
18204602;Soltero;F;31;CHILENO;;Millenial;PROVIDENCIA                   ;METROPOLITANA;7990;1;1;0;0;0;1;1;7990;AUDIFONO MOTOROLA EARBUDS M. LIBRES METAL DORADO;ACCESORIOS
10245818;;M;56;CHILENO;;Boomers;SAN FERNANDO                  ;L.G.B.OÂ´HIGGINS;88980;2;1;0;0;0;2;1;88980;HUAWEI FreeBuds Lite Black;ACCESORIOS
16543180;;F;35;CHILENO;;Millenial;PROVIDENCIA                   ;METROPOLITANA;1728600;15;4;12;3;1610630;3;1;117970;Mi Smart Band 6 Negra Xiaomi;ACCESORIOS
17653459;;M;31;CHILENO;;Millenial;N/D;N/D;205950;5;4;0;0;0;5;4;205950;AUDIFONO XIAOMI EARBUDS MI TRUE WIRELESS BASIC 2;ACCESORIOS
17030761;;F;33;CHILENO;;Millenial;RENGO                         ;L.G.B.OÂ´HIGGINS;216980;2;1;0;0;0;2;1;216980;Escritorio Gamer Pro RGB;ACCESORIOS
17455707;;F;34;CHILENO;;Millenial;"";"";12990;1;1;0;0;0;1;1;12990;AUDIFONO MLAN AIR-WIRELESS CHARGE TOUCH RED;ACCESORIOS
13095867;;F;46;CHILENO;;X;PROVIDENCIA                   ;METROPOLITANA;9990;1;1;0;0;0;1;1;9990;AUDIFONO TEEN H AVENGERS IRON MAN ALAMBRICO;ACCESORIOS
11943371;;M;50;CHILENO;;X;ANTOFAGASTA;ANTOFAGASTA;219990;1;1;0;0;0;1;1;219990;Galaxy Watch Active4 44 mm Black;ACCESORIOS
18091055;Soltero;M;30;CHILENO;TECNICO LABORATORISTA DENTAL;Millenial;PROVIDENCIA                   ;METROPOLITANA;103980;2;1;2;1;103980;0;0;0;AUDIFONOS GALAXY BUDS PRO VIOLET;ACCESORIOS
22591574;;M;36;BOLIVIANO;;Extranjero;N/D;N/D;7990;1;1;0;0;0;1;1;7990;SOPORTE TV 26-56 KTA02 KIOTO FIJO;ACCESORIOS
12490315;;M;49;CHILENO;;X;RENCA                         ;METROPOLITANA;79980;2;1;0;0;0;2;1;79980;BAND 6 BLACK HUAWEI;ACCESORIOS
7737456;;M;62;CHILENO;;Boomers;LA GRANJA                     ;METROPOLITANA;36230;3;1;0;0;0;3;1;36230;ALTEC LANSING AUDIFONO IN-EAR BLUETOOTH SPORT RU;ACCESORIOS
19799879;;F;24;CHILENO;;Z;PROVIDENCIA                   ;METROPOLITANA;45840;2;1;2;1;45840;0;0;0;BAND 6 PINK HUAWEI;ACCESORIOS
25291610;;M;30;COLOMBIANO;;Extranjero;PUERTO MONTT                  ;LOS LAGOS;143970;3;2;0;0;0;3;2;143970;Audifonos Orejas De Gato Rosado;ACCESORIOS
15278859;;F;39;CHILENO;;X;N/D;N/D;29990;1;1;0;0;0;1;1;29990;ALTEC LANSING AUDIFONO HEADBAND BLUETOOTH COMFOR;ACCESORIOS
17755143;;F;31;CHILENO;;Millenial;QUILLON                       ;BIO BIO;18990;1;1;1;1;18990;0;0;0;AUDIFONO XIAOMI EARBUDS MI TRUE WIRELESS BASIC 2;ACCESORIOS
10537349;;M;54;CHILENO;;X;"";"";93980;2;1;2;1;93980;0;0;0;PARLANTES SRS-XB23/LC LA;ACCESORIOS
17530265;;F;32;CHILENO;;Millenial;"";"";36970;3;1;0;0;0;3;1;36970;Kit 2-1 Rojo;ACCESORIOS
11379368;;M;53;CHILENO;;X;ALTO HOSPICIO;TARAPACA;5990;1;1;0;0;0;1;1;5990;AUDIFONO IN SAM HS1303C/ MIC NEGRO;ACCESORIOS
19873801;;F;24;CHILENO;;Z;PROVIDENCIA                   ;METROPOLITANA;7990;1;1;0;0;0;1;1;7990;SOPORTE TV 26-56 KTA02 KIOTO FIJO;ACCESORIOS
15519410;;F;36;CHILENO;;Millenial;N/D;N/D;219980;3;2;0;0;0;3;2;219980;BAND 4 BLACK;ACCESORIOS
14207646;;F;40;CHILENO;;X;CALERA                        ;VALPARAISO;19990;1;1;0;0;0;1;1;19990;AUDIFONO XIAOMI EARBUDS MI TRUE WIRELESS BASIC 2;ACCESORIOS
16590231;;M;34;CHILENO;;Millenial;SAGRADA FAMILIA               ;MAULE;19990;1;1;0;0;0;1;1;19990;AUDIFONO XIAOMI EARBUDS MI TRUE WIRELESS BASIC 2;ACCESORIOS
18059741;Soltero;M;30;CHILENO;;Millenial;PROVIDENCIA                   ;METROPOLITANA;44990;1;1;0;0;0;1;1;44990;MI Smart Band 6 Negra XIAOMI;ACCESORIOS
10972034;;F;51;CHILENO;;X;SAN ESTEBAN                   ;VALPARAISO;53980;2;2;0;0;0;2;2;53980;SMARTBAND SAMSUNG GALAXY FIT 2 NEGRO;ACCESORIOS
19454244;Soltero;F;30;CHILENO;;Millenial;PROVIDENCIA                   ;METROPOLITANA;21990;1;1;0;0;0;1;1;21990;AUDIFONO BLUETOOTH RP-HF410BPUA BT 24HRS AZUL;ACCESORIOS
11963724;Casado;F;50;CHILENO;;X;PROVIDENCIA                   ;METROPOLITANA;29990;1;1;0;0;0;1;1;29990;BAND 4 BLACK;ACCESORIOS
8104468;;M;62;CHILENO;;Boomers;RENCA                         ;METROPOLITANA;192160;3;2;0;0;0;3;2;192160;Smartwatch GT 2 BLACK;ACCESORIOS
16226465;;M;36;CHILENO;;Millenial;N/D;N/D;15980;2;1;0;0;0;2;1;15980;CARTERA GOLD GR;ACCESORIOS
27195117;;F;42;EXTRANJERO - NO INFORMA NACIONALIDAD;;Extranjero;N/D;N/D;64970;3;2;2;1;53980;1;1;10990;PARLANTE BT MICRO PINEAPPLE 8647;ACCESORIOS
17298978;;F;32;CHILENO;;Millenial;COIHAIQUE                     ;AYSEN;19990;1;1;0;0;0;1;1;19990;SOPORTE TV 14-42 KTAM02 KIOTO C/ BRAZO MOVIL;ACCESORIOS
12740336;Soltero;M;46;CHILENO;;X;PROVIDENCIA                   ;METROPOLITANA;22990;1;1;0;0;0;1;1;22990;SOPORTE TV 14-63 CON BRAZO KT-FM 3L;ACCESORIOS
17079130;;F;33;CHILENO;;Millenial;CARTAGENA                     ;VALPARAISO;114980;2;1;2;1;114980;0;0;0;SILLA GAMER LEG PURPL;ACCESORIOS
15023141;;F;39;CHILENO;;X;N/D;N/D;386530;6;3;4;2;155960;2;1;230570;AUDIFONO MLAB TWS IN-AIR WHITE 8533;ACCESORIOS
19273423;;M;26;CHILENO;;Z;N/D;N/D;155840;3;1;3;1;155840;0;0;0;Smartwatch GT 2 BLACK;ACCESORIOS
9408542;;F;60;CHILENO;;Boomers;NUNOA                         ;METROPOLITANA;8990;1;1;0;0;0;1;1;8990;Funda Con Cierre 15;ACCESORIOS
19785258;;M;24;CHILENO;;Z;PROVIDENCIA                   ;METROPOLITANA;17990;1;1;0;0;0;1;1;17990;SOPORTE TV 14-63 CON BRAZO KT-FM 3L;ACCESORIOS
17806029;;M;31;CHILENO;;Millenial;N/D;N/D;39990;1;1;0;0;0;1;1;39990;DISCO DURO CANVIO 1TB BASICS BLACK TOSHIBA;ACCESORIOS
17183171;;F;32;CHILENO;;Millenial;N/D;N/D;129990;1;1;0;0;0;1;1;129990;Smartwatch GT 2 BLACK;ACCESORIOS
15246713;;M;36;CHILENO;;Millenial;PADRE LAS CASAS               ;ARAUCANIA;49990;1;1;1;1;49990;0;0;0;DISCO DURO CANVIO 1TB BASICS BLACK TOSHIBA;ACCESORIOS
19985260;;M;23;CHILENO;;Z;N/D;N/D;7990;1;1;0;0;0;1;1;7990;SOPORTE TV 26-56 KTA02 KIOTO FIJO;ACCESORIOS
18149967;;M;30;CHILENO;;Millenial;ARAUCO                        ;BIO BIO;7990;1;1;0;0;0;1;1;7990;AUDIFONO IN EX15AP SONY NEGRO;ACCESORIOS
11007671;;F;57;CHILENO;;Boomers;"";"";8990;1;1;0;0;0;1;1;8990;TRAVEL ADAPTER 15W - FAST CHARGER (TYPE-C CABLE);ACCESORIOS
15115113;;F;39;CHILENO;;X;SANTA CRUZ                    ;L.G.B.OÂ´HIGGINS;29540;2;1;2;1;29540;0;0;0;HUAWEI Sport Bluetooth Headphones Lite Black AM6;ACCESORIOS
18359937;;M;29;CHILENO;;Millenial;SAN JAVIER                    ;MAULE;14990;1;1;0;0;0;1;1;14990;SOPORTE TV 14-42 KTAM02 KIOTO C/ BRAZO MOVIL;ACCESORIOS
15813958;;M;37;CHILENO;;Millenial;ANTOFAGASTA                   ;ANTOFAGASTA;11990;1;1;0;0;0;1;1;11990;Mouse 530 Wireless (PlatinumGrey);ACCESORIOS
10990376;;M;48;CHILENO;;X;IQUIQUE                       ;TARAPACA;8990;1;1;0;0;0;1;1;8990;AUDIFONO IN EX15AP SONY BLANCO;ACCESORIOS
20063059;;M;23;CHILENO;;Silencioso;PROVIDENCIA                   ;METROPOLITANA;14990;1;1;1;1;14990;0;0;0;BATERY PACK TIPO C 10.000 MAH SAMSUNG;ACCESORIOS
20415254;;M;22;CHILENO;;Z;COQUIMBO;COQUIMBO;167540;2;1;2;1;167540;0;0;0;SMARTWATCH GALAXY WATCH 3 41MM MYSTIC BRONCE;ACCESORIOS
10829500;;F;57;CHILENO;;Boomers;OVALLE                        ;COQUIMBO;156980;2;2;0;0;0;2;2;156980;SILLA GAMER RACING PRO - ROSADO;ACCESORIOS
18414816;;F;29;CHILENO;;Millenial;PROVIDENCIA                   ;METROPOLITANA;62990;1;1;0;0;0;1;1;62990;HUAWEI FREEBUDS 3I NEGROS;ACCESORIOS
19546193;;M;25;CHILENO;;Silencioso;PROVIDENCIA                   ;METROPOLITANA;30980;2;1;2;1;30980;0;0;0;EXPRESS MOD 3930 PURPLE;ACCESORIOS
17171133;;F;33;CHILENO;;Millenial;PROVIDENCIA                   ;METROPOLITANA;154980;2;2;1;1;14990;1;1;139990;BATERY PACK TIPO C 10.000 MAH SAMSUNG;ACCESORIOS
18116464;;M;30;CHILENO;;Millenial;BUIN                          ;METROPOLITANA;173980;2;1;2;1;173980;0;0;0;SMARTWATCH GALAXY WATCH 3 41MM MYSTIC BRONCE;ACCESORIOS
12751953;;F;52;CHILENO;;X;SAN JUAN DE LA COSTA          ;LOS LAGOS;42980;2;2;0;0;0;2;2;42980;PARLANTE 8247 MLAB SOUNDLAB BLACK;ACCESORIOS
17387620;;F;33;CHILENO;;Millenial;HIJUELAS                      ;VALPARAISO;13990;1;1;0;0;0;1;1;13990;AUDIFONO SAMSUNG WIRELESS 103B;ACCESORIOS
19226147;Soltero;M;26;CHILENO;;Silencioso;PROVIDENCIA                   ;METROPOLITANA;98980;2;1;2;1;98980;0;0;0;MI WATCH NEGRO XIAOMI;ACCESORIOS
12844518;;M;46;CHILENO;;X;N/D;N/D;59980;2;4;0;0;0;2;4;59980;AUDIFONO SONY MDRZX310APLZUC;ACCESORIOS
19849633;;F;24;CHILENO;;Z;"";"";22990;1;1;0;0;0;1;1;22990;PARLANTE 8247 MLAB SOUNDLAB BLACK;ACCESORIOS
19392233;;F;25;CHILENO;;Z;N/D;N/D;36980;2;1;2;1;36980;0;0;0;AUDIFONO WH-CH510/BZ UC;ACCESORIOS
11686533;;M;52;CHILENO;;X;TEMUCO                        ;ARAUCANIA;19990;1;1;0;0;0;1;1;19990;PARLANTE KARAOKE MGROCKET NEGRO;ACCESORIOS
16670536;;F;34;CHILENO;;Millenial;PROVIDENCIA                   ;METROPOLITANA;26990;1;1;0;0;0;1;1;26990;SMARTWATCH HUAWEI BAND 4E ACTIVE BLACK;ACCESORIOS
19520345;;F;24;CHILENO;;Silencioso;PROVIDENCIA                   ;METROPOLITANA;19990;1;1;0;0;0;1;1;19990;PARLANTE BLUETHOOTH XBOOM GO PM1;ACCESORIOS
18612379;;M;28;CHILENO;;Millenial;"";"";277970;3;1;3;1;277970;0;0;0;Galaxy Watch Active4 44 mm Black;ACCESORIOS
17103629;;M;33;CHILENO;;Millenial;N/D;N/D;5990;1;1;0;0;0;1;1;5990;Mi In-Ear Headphones Basic (Black) XIAOMI;ACCESORIOS
7647483;;F;67;CHILENO;;Boomers;RENCA                         ;METROPOLITANA;17990;1;1;0;0;0;1;1;17990;ITFIT Tripode Selfie Stick;ACCESORIOS
18227300;;M;29;CHILENO;;Millenial;PROVIDENCIA                   ;METROPOLITANA;12990;1;1;0;0;0;1;1;12990;Funda Con Cierre 15;ACCESORIOS
13137166;;M;45;CHILENO;;X;RENCA                         ;METROPOLITANA;7990;1;1;0;0;0;1;1;7990;SOPORTE TV 26-56 KTA02 KIOTO FIJO;ACCESORIOS
12652221;;M;48;CHILENO;;X;PROVIDENCIA                   ;METROPOLITANA;16990;1;1;0;0;0;1;1;16990;PARLANTE KARAOKE MGPANTERA NEGRO;ACCESORIOS
12982659;;F;46;CHILENO;;X;CURANILAHUE                   ;BIO BIO;75970;3;1;0;0;0;3;1;75970;SMARTBAND SAMSUNG GALAXY FIT 2 ROJO;ACCESORIOS
14285648;;F;48;CHILENO;;X;CUREPTO                       ;MAULE;33980;2;1;0;0;0;2;1;33980;AUDIFONO BLUETOOTH PANASONIC RP-HJE120B NEGRO;ACCESORIOS
9026802;;M;61;CHILENO;;Silencioso;PROVIDENCIA                   ;METROPOLITANA;22990;1;1;0;0;0;1;1;22990;PARLANTE 8247 MLAB SOUNDLAB BLACK;ACCESORIOS
5342719;;M;78;CHILENO;;Silencioso;PROVIDENCIA                   ;METROPOLITANA;16990;1;1;0;0;0;1;1;16990;MLAB KARAOKE OUTDOOR FUN GREEN 8564;ACCESORIOS
7510683;Casado;F;67;CHILENO;;Boomers;PROVIDENCIA                   ;METROPOLITANA;12990;1;1;0;0;0;1;1;12990;PARLANTE 8531 MLAB MAX BASS BT;ACCESORIOS
18935117;;M;27;CHILENO;;Millenial;PROVIDENCIA                   ;METROPOLITANA;277970;3;1;3;1;277970;0;0;0;Galaxy Watch Active4 44 mm Black;ACCESORIOS
13308915;;F;45;CHILENO;;Silencioso;PROVIDENCIA                   ;METROPOLITANA;0;0;0;0;0;0;0;0;0;MI WATCH NEGRO XIAOMI;ACCESORIOS
18331603;;M;28;CHILENO;;Millenial;ARICA                         ;TARAPACA;0;0;0;0;0;0;0;0;0;TRAVEL ADAPTER 15W - FAST CHARGER (TYPE-C CABLE);ACCESORIOS
20056338;;M;23;CHILENO;;Z;PROVIDENCIA                   ;METROPOLITANA;0;0;0;0;0;0;0;0;0;BATERY PACK TIPO C 10.000 MAH SAMSUNG;ACCESORIOS
16986914;;F;33;CHILENO;;Millenial;PROVIDENCIA                   ;METROPOLITANA;0;0;0;0;0;0;0;0;0;PARLANTE 7279 MLAB ZUKABASS NEGRO BT;ACCESORIOS
8359608;;M;49;CHILENO;;Millenial;"";"";0;0;0;0;0;0;0;0;0;Silla Gamer Python Azul;ACCESORIOS
19662096;;M;24;CHILENO;;Z;N/D;N/D;0;0;0;0;0;0;0;0;0;Mi True Wireless Earphones 2 Basic XIAOMI;ACCESORIOS
11679840;;M;52;CHILENO;;X;RENCA                         ;METROPOLITANA;0;0;0;0;0;0;0;0;0;MI WATCH LITE NEGRO XIAOMI;ACCESORIOS
20272752;;F;23;CHILENO;;Silencioso;PROVIDENCIA                   ;METROPOLITANA;0;0;0;0;0;0;0;0;0;BAND 4 AMBER SUNRISE;ACCESORIOS
18916371;;F;27;CHILENO;;Millenial;N/D;N/D;0;0;0;0;0;0;0;0;0;AUDIFONOS IN HUAWEI METALICO;ACCESORIOS
16772578;;F;34;CHILENO;;Millenial;PROVIDENCIA                   ;METROPOLITANA;0;0;0;0;0;0;0;0;0;CABLE DE DATOS MICRO HUAWEI USB AP70;ACCESORIOS
7853782;Viudo;F;64;CHILENO;;Boomers;PROVIDENCIA                   ;METROPOLITANA;0;0;0;0;0;0;0;0;0;SILLA GAMER SAMURAI TENGU - NEGRO;ACCESORIOS
26332823;;M;36;VENEZOLANO;;Extranjero;ISLA DE MAIPO                 ;METROPOLITANA;0;0;0;0;0;0;0;0;0;AUDIFONO ON SONY ZX110 BLANCO;ACCESORIOS
16664981;;F;35;CHILENO;;Millenial;PROVIDENCIA                   ;METROPOLITANA;0;0;0;0;0;0;0;0;0;Audifonos Orejas De Gato Rosado;ACCESORIOS
19480535;;F;25;CHILENO;;Z;PROVIDENCIA                   ;METROPOLITANA;0;0;0;0;0;0;0;0;0;SOPORTE TV 26-56 KTA02 KIOTO FIJO;ACCESORIOS
19617678;;M;24;CHILENO;;Z;PROVIDENCIA                   ;METROPOLITANA;0;0;0;0;0;0;0;0;0;AUDIFONO IN EX15AP SONY NEGRO;ACCESORIOS
19936621;Soltero;F;35;CHILENO;INGENIERO COMERCIAL;Millenial;RENCA                         ;METROPOLITANA;0;0;0;0;0;0;0;0;0;MEMORIA MICROSD CLASE 10 64GB SANDISK;ACCESORIOS
15730054;Casado;M;38;CHILENO;;X;N/D;N/D;0;0;0;0;0;0;0;0;0;SOPORTE TV 32-65 KTA03 KIOTO FIJO;ACCESORIOS
19600210;;F;25;CHILENO;;Z;PROVIDENCIA                   ;METROPOLITANA;0;0;0;0;0;0;0;0;0;AUDIFONO SAMSUNG WIRELESS 103B;ACCESORIOS
12755875;;F;47;CHILENO;;X;VALDIVIA                      ;LOS LAGOS;0;0;0;0;0;0;0;0;0;SOPORTE TV 26-56 KTA02 KIOTO FIJO;ACCESORIOS
14468511;;M;48;CHILENO;;X;RENCA                         ;METROPOLITANA;0;0;0;0;0;0;0;0;0;AUDIFONO GALAXY BUDS PLUS NEGRO;ACCESORIOS
8855321;;M;61;CHILENO;;Boomers;N/D;N/D;0;0;0;0;0;0;0;0;0;Funda Con Cierre 15;ACCESORIOS
18549327;;F;29;CHILENO;;Millenial;"";"";0;0;0;0;0;0;0;0;0;SOPORTE TV 26-56 KTA02 KIOTO FIJO;ACCESORIOS
17191953;;M;32;CHILENO;;Silencioso;PROVIDENCIA                   ;METROPOLITANA;0;0;0;0;0;0;0;0;0;Mouse Bluetooth Hdwr Black;ACCESORIOS
26819467;;F;51;EXTRANJERO - NO INFORMA NACIONALIDAD;;Extranjero;N/D;N/D;0;0;0;0;0;0;0;0;0;AUDIFONO PANASONIC IN RP-HV096E-K NEGRO;ACCESORIOS
7080358;Casado;F;65;CHILENO;;Boomers;PROVIDENCIA                   ;METROPOLITANA;0;0;0;0;0;0;0;0;0;BAND 4 AMBER SUNRISE;ACCESORIOS
26114941;;M;41;VENEZOLANO;;Extranjero;N/D;N/D;0;0;0;0;0;0;0;0;0;AUDIFONO BLUETOOTH PANASONIC RP-HJE120B NEGRO;ACCESORIOS
8925069;;F;58;CHILENO;;Boomers;GRANEROS                      ;L.G.B.OÂ´HIGGINS;0;0;0;0;0;0;0;0;0;365 Personal Suscripcion Anual;ACCESORIOS
20311330;;F;22;CHILENO;;Silencioso;PROVIDENCIA                   ;METROPOLITANA;0;0;0;0;0;0;0;0;0;TRAVEL ADAPTER 15W - FAST CHARGER (TYPE-C CABLE);ACCESORIOS
15131942;;M;41;CHILENO;;X;TENO                          ;MAULE;0;0;0;0;0;0;0;0;0;PARLANTE KARAOKE MGROCKET NEGRO;ACCESORIOS
19548879;;M;25;CHILENO;;Millenial;PROVIDENCIA                   ;METROPOLITANA;0;0;0;0;0;0;0;0;0;SOPORTE TV 26-56 KTAT02 KIOTO MOVIL;ACCESORIOS
7794894;;F;65;CHILENO;;Boomers;ANTOFAGASTA                   ;ANTOFAGASTA;0;0;0;0;0;0;0;0;0;SOPORTE TV 26-56 KTA02 KIOTO FIJO;ACCESORIOS
16852747;;F;33;CHILENO;;Millenial;PROVIDENCIA                   ;METROPOLITANA;0;0;0;0;0;0;0;0;0;SOPORTE TV 14-42 KTAM02 KIOTO C/ BRAZO MOVIL;ACCESORIOS
9469090;;M;55;CHILENO;;Boomers;COIHAIQUE                     ;AYSEN;0;0;0;0;0;0;0;0;0;PARLANTE 8247 MLAB SOUNDLAB BLACK;ACCESORIOS
11240762;;F;53;CHILENO;;X;PROVIDENCIA                   ;METROPOLITANA;0;0;0;0;0;0;0;0;0;SOPORTE TV 14-42 KTAM02 KIOTO C/ BRAZO MOVIL;ACCESORIOS
10273307;;F;56;CHILENO;;Boomers;RENCA                         ;METROPOLITANA;0;0;0;0;0;0;0;0;0;SOPORTE TV 26-56 KTA02 KIOTO FIJO;ACCESORIOS
8950920;;F;65;CHILENO;;Boomers;RENCA                         ;METROPOLITANA;0;0;0;0;0;0;0;0;0;AUDIFONO SAMSUNG WIRELESS 103B;ACCESORIOS
14260105;;F;47;CHILENO;;X;QUINTA NORMAL                 ;METROPOLITANA;0;0;0;0;0;0;0;0;0;Silla Gamer Guardian Azul;ACCESORIOS
18896860;;M;28;CHILENO;;Millenial;PROVIDENCIA                   ;METROPOLITANA;0;0;0;0;0;0;0;0;0;AUDIFONO SAMSUNG WIRELESS 103B;ACCESORIOS
17194936;;F;33;CHILENO;;Millenial;"";"";0;0;0;0;0;0;0;0;0;Headset Pav Gam 400 Grn CAN/ENG;ACCESORIOS
17545378;;F;31;CHILENO;;Millenial;PUENTE ALTO                   ;METROPOLITANA;0;0;0;0;0;0;0;0;0;AUDIFONO SAMSUNG WIRELESS A08C;ACCESORIOS
16830080;;F;35;CHILENO;;Millenial;PROVIDENCIA                   ;METROPOLITANA;0;0;0;0;0;0;0;0;0;SOPORTE TV 14-63 CON BRAZO KT-FM 3L;ACCESORIOS
13082951;Soltero;F;46;CHILENO;INGENIERO DE EJECUCION EN ADMINISTRACION DE EMPRESAS;X;PROVIDENCIA                   ;METROPOLITANA;0;0;0;0;0;0;0;0;0;AUDIFONOS HUAWEI MANOS LIBRES TIPO C CM33;ACCESORIOS
5738539;;M;76;CHILENO;;Silencioso;VALDIVIA                      ;LOS RIOS;0;0;0;0;0;0;0;0;0;AUDIFONO ON ZX310AP NEGRO;ACCESORIOS
19781058;;M;24;CHILENO;;Z;PROVIDENCIA                   ;METROPOLITANA;0;0;0;0;0;0;0;0;0;AUDIFONO ON ZX310AP NEGRO;ACCESORIOS
14431668;;M;51;CHILENO;;X;N/D;N/D;0;0;0;0;0;0;0;0;0;AUDIFONO IN SAM HS1303C/ MIC AZUL;ACCESORIOS
19210895;;M;26;CHILENO;;Silencioso;PROVIDENCIA                   ;METROPOLITANA;0;0;0;0;0;0;0;0;0;AUDIFONO ON ZX110 SONY ROSA;ACCESORIOS
17211155;;M;33;CHILENO;;Millenial;PROVIDENCIA                   ;METROPOLITANA;0;0;0;0;0;0;0;0;0;ITFIT Tripode Selfie Stick;ACCESORIOS
19151466;;F;27;CHILENO;;Z;N/D;N/D;0;0;0;0;0;0;0;0;0;AUDIFONO IN SAM HS1303C/ MIC AZUL;ACCESORIOS
12513595;;M;48;CHILENO;;X;PEMUCO                        ;BIO BIO;0;0;0;0;0;0;0;0;0;AUDIFONO PANASONIC IN RP-HV096E-K NEGRO;ACCESORIOS
12154990;;F;48;CHILENO;;X;SAN PEDRO DE LA PAZ           ;BIO BIO;0;0;0;0;0;0;0;0;0;PARLANTE KARAOKE FD-PKBT82 8 LUCES MIC/FM/BT/USB;ACCESORIOS
11067592;Casado;F;55;CHILENO;SECRETARIA;Boomers;PROVIDENCIA                   ;METROPOLITANA;0;0;0;0;0;0;0;0;0;Teclado + Mouse Gamer Negro Retroiluminado;ACCESORIOS
13320676;;F;45;CHILENO;;X;MAIPU                         ;METROPOLITANA;0;0;0;0;0;0;0;0;0;SMARTBAND SAMSUNG GALAXY FIT 2 NEGRO;ACCESORIOS
19921648;;F;23;CHILENO;;Silencioso;PROVIDENCIA                   ;METROPOLITANA;0;0;0;0;0;0;0;0;0;EXPRESS MOD 3930 PURPLE;ACCESORIOS
12801943;;M;46;CHILENO;;X;LA FLORIDA                    ;METROPOLITANA;0;0;0;0;0;0;0;0;0;SMARTWATCH GALAXY WATCH 3 41MM MYSTIC BRONCE;ACCESORIOS
10280812;;F;55;CHILENO;;Boomers;QUINTA NORMAL                 ;METROPOLITANA;0;0;0;0;0;0;0;0;0;AUDIFONO IN SONY BT WI-310 NUDE;ACCESORIOS
16559374;Soltero;F;35;CHILENO;PROFESOR;Millenial;PROVIDENCIA                   ;METROPOLITANA;0;0;0;0;0;0;0;0;0;Silla Gamer Valhalla Pro Negro-Blanco;ACCESORIOS
13560349;;F;42;CHILENO;;X;MELIPILLA                     ;METROPOLITANA;0;0;0;0;0;0;0;0;0;Smartwatch ACTIVE 1 NEGRO;ACCESORIOS
8011551;Casado;M;66;CHILENO;;Silencioso;PROVIDENCIA                   ;METROPOLITANA;0;0;0;0;0;0;0;0;0;SOPORTE TV 26-56 KTAT02 KIOTO MOVIL;ACCESORIOS
18030090;;F;30;CHILENO;;Millenial;PROVIDENCIA                   ;METROPOLITANA;0;0;0;0;0;0;0;0;0;AUDIFONO MLAB TWS IN-AIR WHITE 8533;ACCESORIOS
19204847;;M;26;CHILENO;;Z;CALAMA                        ;ANTOFAGASTA;0;0;0;0;0;0;0;0;0;AUDIFONO IN SAM C/ MIC EG920 BLACK;ACCESORIOS
16713069;;M;35;CHILENO;;Millenial;N/D;N/D;0;0;0;0;0;0;0;0;0;AUDIFONO XIAOMI EARBUDS MI TRUE WIRELESS BASIC 2;ACCESORIOS
17284676;;F;32;CHILENO;;Millenial;CALAMA                        ;ANTOFAGASTA;0;0;0;0;0;0;0;0;0;SOPORTE TV 32-65 KTA03 KIOTO FIJO;ACCESORIOS
10045348;;F;58;CHILENO;;Silencioso;PROVIDENCIA                   ;METROPOLITANA;0;0;0;0;0;0;0;0;0;DISCO DURO CANVIO 1TB BASICS BLACK TOSHIBA;ACCESORIOS
15433610;;F;40;CHILENO;;X;PROVIDENCIA                   ;METROPOLITANA;0;0;0;0;0;0;0;0;0;DISCO DURO CANVIO 1TB BASICS BLACK TOSHIBA;ACCESORIOS
18462665;;M;29;CHILENO;;Millenial;PROVIDENCIA                   ;METROPOLITANA;0;0;0;0;0;0;0;0;0;Kit gamer 3 en 1;ACCESORIOS
18084730;;F;30;CHILENO;;Millenial;CERRILLOS                     ;METROPOLITANA;0;0;0;0;0;0;0;0;0;AUDIFONO XIAOMI EARBUDS MI TRUE WIRELESS BASIC 2;ACCESORIOS
11667000;;M;52;CHILENO;;X;PROVIDENCIA                   ;METROPOLITANA;0;0;0;0;0;0;0;0;0;AUDIFONO BLUETOOTH RP-HF410BPUA BT 24HRS AZUL;ACCESORIOS
19120783;;M;26;CHILENO;;Z;CHIGUAYANTE                   ;BIO BIO;0;0;0;0;0;0;0;0;0;AUDIFONO IN SAM HS1303C/ MIC NEGRO;ACCESORIOS
12231932;Casado;M;50;CHILENO;INGENIERO COMERCIAL;X;PROVIDENCIA                   ;METROPOLITANA;0;0;0;0;0;0;0;0;0;EXPRESS MOD 3930 PURPLE;ACCESORIOS
14581658;;F;40;CHILENO;;X;CABILDO                       ;VALPARAISO;0;0;0;0;0;0;0;0;0;Smartwatch GT 2 BLACK;ACCESORIOS
19138422;;M;26;CHILENO;;Z;CASTRO                        ;LOS LAGOS;0;0;0;0;0;0;0;0;0;AUDIFONO ON ZX110 SONY NEGRO;ACCESORIOS
6761553;;F;66;CHILENO;;Boomers;RENCA                         ;METROPOLITANA;0;0;0;0;0;0;0;0;0;PARLANTE 8531 MLAB MAX BASS BT;ACCESORIOS
18316464;;M;29;CHILENO;;Millenial;N/D;N/D;0;0;0;0;0;0;0;0;0;AUDIFONO IN SAM HS1303C/ MIC NEGRO;ACCESORIOS
10513409;;F;58;CHILENO;;Boomers;COLINA                        ;METROPOLITANA;0;0;0;0;0;0;0;0;0;TRAVEL ADAPTER 15W - FAST CHARGER (TYPE-C CABLE);ACCESORIOS
20026469;;F;24;CHILENO;;Z;REQUINOA                      ;L.G.B.OÂ´HIGGINS;0;0;0;0;0;0;0;0;0;TRAVEL ADAPTER 15W - FAST CHARGER (TYPE-C CABLE);ACCESORIOS
19069027;;M;26;CHILENO;;Z;PROVIDENCIA                   ;METROPOLITANA;0;0;0;0;0;0;0;0;0;SMARTWATCH HUAWEI BAND 4E ACTIVE MINERAL RED;ACCESORIOS
10629896;;M;42;CHILENO;;X;MACUL;METROPOLITANA;0;0;0;0;0;0;0;0;0;Smartwatch GT 2 BLACK;ACCESORIOS
20343850;;M;30;CHILENO;;Millenial;N/D;N/D;0;0;0;0;0;0;0;0;0;Smartwatch GT 2 BLACK;ACCESORIOS
13923175;;F;42;CHILENO;;X;PROVIDENCIA                   ;METROPOLITANA;0;0;0;0;0;0;0;0;0;AUDIFONO XIAOMI EARBUDS MI TRUE WIRELESS BASIC 2;ACCESORIOS
15912887;;F;38;CHILENO;;Silencioso;PROVIDENCIA                   ;METROPOLITANA;0;0;0;0;0;0;0;0;0;BAND 4 AMBER SUNRISE;ACCESORIOS
15266849;;M;43;CHILENO;;X;RENCA                         ;METROPOLITANA;0;0;0;0;0;0;0;0;0;AUDIFONO IN SONY BT WI-C200 BLACK;ACCESORIOS
13942198;;F;42;CHILENO;;X;EL BOSQUE                     ;METROPOLITANA;0;0;0;0;0;0;0;0;0;Repetidor Wifi N300 2 Antenas Internas;ACCESORIOS
16109104;Soltero;F;37;CHILENO;AUXILIAR PARAMEDICO DE FARMACIA;Millenial;PROVIDENCIA                   ;METROPOLITANA;0;0;0;0;0;0;0;0;0;SOPORTE TV 26-56 KTAT02 KIOTO MOVIL;ACCESORIOS
15586216;;M;39;CHILENO;;X;PROVIDENCIA                   ;METROPOLITANA;0;0;0;0;0;0;0;0;0;SMARTBAND SAMSUNG GALAXY FIT 2 NEGRO;ACCESORIOS
18721231;Soltero;M;27;CHILENO;;Millenial;PROVIDENCIA                   ;METROPOLITANA;0;0;0;0;0;0;0;0;0;CABLE HUAWEI TIPO C-USB;ACCESORIOS
18763602;Soltero;F;27;CHILENO;;Millenial;PROVIDENCIA                   ;METROPOLITANA;0;0;0;0;0;0;0;0;0;BAND 4 BLACK;ACCESORIOS
17190801;Soltero;M;32;CHILENO;;Millenial;PROVIDENCIA                   ;METROPOLITANA;0;0;0;0;0;0;0;0;0;AUDIFONO IN SAM C/ MIC EG920 BLACK;ACCESORIOS
13248971;;M;45;CHILENO;;X;PROVIDENCIA                   ;METROPOLITANA;0;0;0;0;0;0;0;0;0;AUDIFONO IN SAM C/ MIC EG920 BLACK;ACCESORIOS
8073803;;M;63;CHILENO;;Boomers;PROVIDENCIA                   ;METROPOLITANA;0;0;0;0;0;0;0;0;0;CARGADOR Flat TA EP-TA20EWSUGCH;ACCESORIOS
18557388;;M;28;CHILENO;;Millenial;PROVIDENCIA                   ;METROPOLITANA;0;0;0;0;0;0;0;0;0;BATERY PACK TIPO C 10.000 MAH SAMSUNG;ACCESORIOS
12522703;;M;48;CHILENO;;X;RANCAGUA                      ;L.G.B.OÂ´HIGGINS;0;0;0;0;0;0;0;0;0;AUDIFONO XIAOMI EARBUDS MI TRUE WIRELESS BASIC 2;ACCESORIOS
10741301;;F;42;CHILENO;;X;PROVIDENCIA                   ;METROPOLITANA;0;0;0;0;0;0;0;0;0;AUDIFONO ON ZX110 SONY NEGRO;ACCESORIOS
11670055;Casado;F;51;CHILENO;;X;RENCA                         ;METROPOLITANA;0;0;0;0;0;0;0;0;0;SMARTBAND SAMSUNG GALAXY FIT 2 NEGRO;ACCESORIOS
13891574;;M;44;CHILENO;;X;COIHAIQUE                     ;AYSEN;0;0;0;0;0;0;0;0;0;SOPORTE TV 26-56 KTAT02 KIOTO MOVIL;ACCESORIOS
11253142;Soltero;M;54;CHILENO;;X;RENCA                         ;METROPOLITANA;0;0;0;0;0;0;0;0;0;SOPORTE TV 26-56 KTA02 KIOTO FIJO;ACCESORIOS
7521932;;M;67;CHILENO;;Boomers;LEBU                          ;BIO BIO;0;0;0;0;0;0;0;0;0;RADIO RETRO MINI WOOGIE 8751;ACCESORIOS
12173415;;F;49;CHILENO;;X;NOGALES                       ;VALPARAISO;0;0;0;0;0;0;0;0;0;DISCO DURO CANVIO 2TB BASICS BLACK TOSHIBA;ACCESORIOS
17311503;;M;32;CHILENO;;Silencioso;PROVIDENCIA                   ;METROPOLITANA;0;0;0;0;0;0;0;0;0;AUDIFONO IN GALAXI BUDS;ACCESORIOS
12957511;;F;45;CHILENO;;X;RENCA                         ;METROPOLITANA;0;0;0;0;0;0;0;0;0;RADIO RETRO MINI WOOGIE 8751;ACCESORIOS
16856812;;M;34;CHILENO;;Millenial;PROVIDENCIA                   ;METROPOLITANA;0;0;0;0;0;0;0;0;0;AUDIFONO MLAB TWS FULLY WIRELESSÂ  WHITE 8721;ACCESORIOS
14217075;Casado;M;46;CHILENO;;X;PROVIDENCIA                   ;METROPOLITANA;0;0;0;0;0;0;0;0;0;AUDIFONO IN SAM HS1303C/ MIC ROSADO;ACCESORIOS
10385595;;F;58;CHILENO;;Boomers;OSORNO                        ;LOS LAGOS;0;0;0;0;0;0;0;0;0;TRAVEL ADAPTER 15W - FAST CHARGER (TYPE-C CABLE);ACCESORIOS
24822312;;M;32;BOLIVIANO;;Extranjero;CALAMA                        ;ANTOFAGASTA;0;0;0;0;0;0;0;0;0;SOPORTE TV 14-63 CON BRAZO KT-FM 3L;ACCESORIOS
20161179;;F;22;CHILENO;;Silencioso;PROVIDENCIA                   ;METROPOLITANA;0;0;0;0;0;0;0;0;0;365 Personal Suscripcion Anual;ACCESORIOS
13248452;;F;45;CHILENO;;Silencioso;PROVIDENCIA                   ;METROPOLITANA;0;0;0;0;0;0;0;0;0;365 Personal Suscripcion Anual;ACCESORIOS
14196995;;F;41;CHILENO;;X;SAN JOAQUIN                   ;METROPOLITANA;0;0;0;0;0;0;0;0;0;AUDIFONO IN EX15LP SONY NEG;ACCESORIOS
12680936;;M;50;CHILENO;;X;PROVIDENCIA                   ;METROPOLITANA;0;0;0;0;0;0;0;0;0;DISCO DURO CANVIO 4TB BASICS BLACK;ACCESORIOS
12505318;;M;48;CHILENO;;Silencioso;PROVIDENCIA                   ;METROPOLITANA;0;0;0;0;0;0;0;0;0;AUDIFONO PANASONIC IN RP-HV096E-K NEGRO;ACCESORIOS
17865583;;F;31;CHILENO;;Millenial;VALLENAR;ATACAMA;0;0;0;0;0;0;0;0;0;HUAWEI FreeBuds 3 White;ACCESORIOS
15734625;;F;46;CHILENO;;X;RANCAGUA                      ;L.G.B.OÂ´HIGGINS;0;0;0;0;0;0;0;0;0;AUDIFONO MLAB AIR-VICTORY WHITE 8725;ACCESORIOS
17269717;Soltero;F;32;CHILENO;PROFESOR;Millenial;PROVIDENCIA                   ;METROPOLITANA;0;0;0;0;0;0;0;0;0;PARLANTE GO 2 BLUETOOTH NEGRO;ACCESORIOS
19047355;;M;27;CHILENO;;Z;CALERA                        ;VALPARAISO;0;0;0;0;0;0;0;0;0;PENDRIVE CRUZERBLADE Z50 SANDISK 32GB;ACCESORIOS
20494320;;M;24;CHILENO;;Z;PROVIDENCIA                   ;METROPOLITANA;0;0;0;0;0;0;0;0;0;AUDIFONO BLUETOOTH PANASONIC RP-HJE120B NEGRO;ACCESORIOS
11388740;;F;52;CHILENO;;X;QUILLOTA                      ;VALPARAISO;0;0;0;0;0;0;0;0;0;AUDIFONO ON ZX110 SONY NEGRO;ACCESORIOS
10620575;;F;52;CHILENO;;X;CURACAVI                      ;METROPOLITANA;0;0;0;0;0;0;0;0;0;Google Chromecast;ACCESORIOS
12225873;;F;50;CHILENO;;X;"";"";0;0;0;0;0;0;0;0;0;SOPORTE TV 26-56 KTAT02 KIOTO MOVIL;ACCESORIOS
14261599;;M;47;CHILENO;;X;PROVIDENCIA                   ;METROPOLITANA;0;0;0;0;0;0;0;0;0;PARLANTE 6985 MLAB VERTICAL BRITPOP BT;ACCESORIOS
18312880;;F;29;CHILENO;;Millenial;"";"";0;0;0;0;0;0;0;0;0;True Wireless Philips SHB2505 5+15 Hrs Negro;ACCESORIOS
10506687;;M;54;CHILENO;;Boomers;PUENTE ALTO                   ;METROPOLITANA;0;0;0;0;0;0;0;0;0;AUDIFONO ON ZX310AP ROJO;ACCESORIOS
16458747;;F;50;CHILENO;;X;PROVIDENCIA                   ;METROPOLITANA;0;0;0;0;0;0;0;0;0;True Wireless Philips TAT1215 6+12 Hrs Negro;ACCESORIOS
18688042;Soltero;M;28;CHILENO;INGENIERO INFORMATICO;Silencioso;PROVIDENCIA                   ;METROPOLITANA;0;0;0;0;0;0;0;0;0;AUDIFONO IN EX15AP SONY NEGRO;ACCESORIOS
14188180;Soltero;M;40;CHILENO;INGENIERO EN CONSTRUCCION;X;PROVIDENCIA                   ;METROPOLITANA;0;0;0;0;0;0;0;0;0;KIT PREPAGO HD DIRECTV;ACCESORIOS
10964613;Casado;F;53;CHILENO;;Silencioso;PROVIDENCIA                   ;METROPOLITANA;0;0;0;0;0;0;0;0;0;AUDIFONO IN SAM HS1303C/ MIC AZUL;ACCESORIOS
19985005;;F;24;CHILENO;;Z;PROVIDENCIA                   ;METROPOLITANA;0;0;0;0;0;0;0;0;0;True Wireless Philips TAT1215 6+12 Hrs Negro;ACCESORIOS
19940326;;F;24;CHILENO;;Z;PROVIDENCIA                   ;METROPOLITANA;0;0;0;0;0;0;0;0;0;AUDIFONO IN SAM C/ MIC EG920 BLACK;ACCESORIOS
15233857;;F;40;CHILENO;;X;PROVIDENCIA                   ;METROPOLITANA;0;0;0;0;0;0;0;0;0;MEMORIA MICROSD CLASE 10 32GB SANDISK;ACCESORIOS
18046681;;F;30;CHILENO;;Silencioso;PROVIDENCIA                   ;METROPOLITANA;0;0;0;0;0;0;0;0;0;365 Personal Suscripcion Anual;ACCESORIOS
17450909;;M;32;CHILENO;;Millenial;N/D;N/D;0;0;0;0;0;0;0;0;0;KIT DIRECTV GO BOX;ACCESORIOS
17121317;;F;33;CHILENO;;Millenial;N/D;N/D;0;0;0;0;0;0;0;0;0;DISCO DURO CANVIO 1TB BASICS BLACK TOSHIBA;ACCESORIOS
26683972;Soltero;M;33;VENEZOLANO;;Extranjero;PROVIDENCIA                   ;METROPOLITANA;0;0;0;0;0;0;0;0;0;CABLE DE DATOS USB TIPO C HUAWEI SUPER CHARGER A;ACCESORIOS
17628763;Soltero;M;49;CHILENO;;X;PROVIDENCIA                   ;METROPOLITANA;0;0;0;0;0;0;0;0;0;TRI PACK PENDRIVE CRUZERBLADE Z50 SANDISC COLORE;ACCESORIOS
16636322;;F;34;CHILENO;;Millenial;N/D;N/D;0;0;0;0;0;0;0;0;0;AUDIFONO PANASONIC BT ON RP-HF410BPUK NEGRO;ACCESORIOS
17531309;;M;32;CHILENO;;Millenial;COIHAIQUE                     ;AYSEN;0;0;0;0;0;0;0;0;0;DISCO DURO CANVIO 1TB BASICS BLACK TOSHIBA;ACCESORIOS
19790918;;M;25;CHILENO;;Z;N/D;N/D;0;0;0;0;0;0;0;0;0;AUDIFONO MLAB TWS FULLY WIRELESSÂ  WHITE 8721;ACCESORIOS
18053700;Soltero;M;30;CHILENO;;Millenial;PROVIDENCIA                   ;METROPOLITANA;0;0;0;0;0;0;0;0;0;True Wireless Philips SHB2505 5+15 Hrs Negro;ACCESORIOS
19448388;Soltero;F;25;CHILENO;;Z;PROVIDENCIA                   ;METROPOLITANA;0;0;0;0;0;0;0;0;0;AUDIFONO IN SAM HS1303C/ MIC AZUL;ACCESORIOS
17140314;;M;33;CHILENO;;Millenial;RENCA                         ;METROPOLITANA;0;0;0;0;0;0;0;0;0;DISCO DURO EXTERNO WD BLACK P10 GAME DRIVE 5TB;ACCESORIOS
20250570;;F;22;CHILENO;;Millenial;PROVIDENCIA                   ;METROPOLITANA;0;0;0;0;0;0;0;0;0;AUDIFONO ON ZX110 SONY ROSA;ACCESORIOS
13342100;;F;43;CHILENO;;X;BUIN                          ;METROPOLITANA;0;0;0;0;0;0;0;0;0;AUDIFONO BLUETOOTH RP-HF410BPUA BT 24HRS AZUL;ACCESORIOS
12257985;;M;50;CHILENO;;X;LAMPA                         ;METROPOLITANA;0;0;0;0;0;0;0;0;0;PARLANTE KARAOKE FD-PKBT82 8 LUCES MIC/FM/BT/USB;ACCESORIOS
17265948;;M;33;CHILENO;;Millenial;PROVIDENCIA                   ;METROPOLITANA;0;0;0;0;0;0;0;0;0;MOUSE MICROSOFT Bluetooth Mobile 3600 Azul;ACCESORIOS
14355099;Casado;F;42;CHILENO;;X;RENCA                         ;METROPOLITANA;0;0;0;0;0;0;0;0;0;MEMORIA MICROSD CLASE 10 32GB SANDISK;ACCESORIOS
17557099;;F;32;CHILENO;;Millenial;ARICA                         ;TARAPACA;0;0;0;0;0;0;0;0;0;SMARTWATCH HUAWEI WATCH FIT BLACK;ACCESORIOS
11755138;;F;52;CHILENO;;X;RENCA                         ;METROPOLITANA;0;0;0;0;0;0;0;0;0;AUDIFONO BLUETOOTH RP-HF410BPUA BT 24HRS AZUL;ACCESORIOS
26693686;;M;38;VENEZOLANO;;Extranjero;N/D;N/D;0;0;0;0;0;0;0;0;0;BUNDLE HUAWEI WATCH FIT BLACK + AM61 RED;ACCESORIOS
15770217;;M;37;CHILENO;;Millenial;PROVIDENCIA                   ;METROPOLITANA;0;0;0;0;0;0;0;0;0;PARLANTE KARAOKE FD-PKBT82 8 LUCES MIC/FM/BT/USB;ACCESORIOS
14538154;Soltero;F;48;CHILENO;;X;RENCA                         ;METROPOLITANA;0;0;0;0;0;0;0;0;0;AUDIFONO MLAB TWS IN-AIR WHITE 8533;ACCESORIOS
11195924;;F;54;CHILENO;;Boomers;QUILLOTA                      ;VALPARAISO;0;0;0;0;0;0;0;0;0;MEMORIA MICROSD CLASE 10 128GB SANDISK;ACCESORIOS
17212128;;F;32;CHILENO;;Millenial;CONSTITUCION                  ;MAULE;0;0;0;0;0;0;0;0;0;RADIO RETRO ANTIQUE 8732;ACCESORIOS
10022012;;M;47;CHILENO;;X;PROVIDENCIA                   ;METROPOLITANA;0;0;0;0;0;0;0;0;0;AUDIFONOS Airpods (MV7N2BE/A);ACCESORIOS
12613848;;M;48;CHILENO;;X;PROVIDENCIA                   ;METROPOLITANA;0;0;0;0;0;0;0;0;0;DISCO DURO CANVIO 2TB BASICS BLACK TOSHIBA;ACCESORIOS
18365530;;M;29;CHILENO;;Millenial;COPIAPO                       ;ATACAMA;0;0;0;0;0;0;0;0;0;PARLANTE ZUKABASS + MICROFONO MLAB BT;ACCESORIOS
7914536;Viudo;F;66;CHILENO;;Boomers;PROVIDENCIA                   ;METROPOLITANA;0;0;0;0;0;0;0;0;0;PARLANTE 7279 MLAB ZUKABASS NEGRO BT;ACCESORIOS
8849919;Casado;M;59;CHILENO;INGENIERO;Boomers;PROVIDENCIA                   ;METROPOLITANA;0;0;0;0;0;0;0;0;0;AUDIFONOS Airpods (MV7N2BE/A);ACCESORIOS
16468943;;F;35;CHILENO;;Millenial;ARICA                         ;ARICA Y PARINACOTA;0;0;0;0;0;0;0;0;0;True Wireless Philips TAT1215 6+12 Hrs Negro;ACCESORIOS
9425561;Casado;F;61;CHILENO;;Boomers;RENCA                         ;METROPOLITANA;0;0;0;0;0;0;0;0;0;AUDIFONO ON SONY ZX110 BLANCO;ACCESORIOS
8230128;;F;64;CHILENO;;Boomers;CERRILLOS                     ;METROPOLITANA;0;0;0;0;0;0;0;0;0;KIT PREPAGO HD DIRECTV;ACCESORIOS
16844867;;M;34;CHILENO;;Millenial;SAN CARLOS                    ;BIO BIO;0;0;0;0;0;0;0;0;0;BAND 4 AMBER SUNRISE;ACCESORIOS
10965248;;M;54;CHILENO;;X;RENCA                         ;METROPOLITANA;0;0;0;0;0;0;0;0;0;DISCO DURO CANVIO 1TB BASICS BLACK TOSHIBA;ACCESORIOS
13138361;;M;44;CHILENO;;X;COIHAIQUE                     ;AYSEN;0;0;0;0;0;0;0;0;0;AUDIFONO IN SAM C/ MIC EG920 BLACK;ACCESORIOS
18556305;;M;28;CHILENO;;Millenial;N/D;N/D;0;0;0;0;0;0;0;0;0;AUDIFONO GALAXY BUDS LIVE NEGRO;ACCESORIOS
15444988;;M;39;CHILENO;;X;PROVIDENCIA                   ;METROPOLITANA;0;0;0;0;0;0;0;0;0;SMARTBAND SAMSUNG GALAXY FIT 2 NEGRO;ACCESORIOS
9861122;;M;56;CHILENO;;Boomers;RENCA                         ;METROPOLITANA;0;0;0;0;0;0;0;0;0;DISCO DURO CANVIO 2TB BASICS BLACK TOSHIBA;ACCESORIOS
15941521;;F;37;CHILENO;;Millenial;RENCA                         ;METROPOLITANA;0;0;0;0;0;0;0;0;0;TECLADO + MOUSE MICROSOFT Wireless Desktop 850;ACCESORIOS
7676329;;F;70;CHILENO;;Silencioso;NUEVA IMPERIAL                ;ARAUCANIA;0;0;0;0;0;0;0;0;0;PARLANTE BT MICRO PINEAPPLE 8647;ACCESORIOS
17200267;Casado;M;33;CHILENO;CIRUJANO DENTISTA;Millenial;PROVIDENCIA                   ;METROPOLITANA;0;0;0;0;0;0;0;0;0;BAND 4 AMBER SUNRISE;ACCESORIOS
17732603;;M;31;CHILENO;;Millenial;PROVIDENCIA                   ;METROPOLITANA;0;0;0;0;0;0;0;0;0;Smartwatch ACTIVE 2 GOLD;ACCESORIOS
16559344;;F;35;CHILENO;;Millenial;COPIAPO;ATACAMA;0;0;0;0;0;0;0;0;0;SMARTBAND SAMSUNG GALAXY FIT 2 ROJO;ACCESORIOS
19712083;;M;24;CHILENO;;Z;N/D;N/D;0;0;0;0;0;0;0;0;0;AUDIFONO IN SAM FIT EG920 BLANCO;ACCESORIOS
10225373;;M;52;CHILENO;;X;N/D;N/D;0;0;0;0;0;0;0;0;0;DISCO DURO CANVIO 1TB BASICS BLACK TOSHIBA;ACCESORIOS
17552302;;M;32;CHILENO;;Millenial;PROVIDENCIA                   ;METROPOLITANA;0;0;0;0;0;0;0;0;0;AUDIFONO PANASONIC BT ON RP-HF410BPUK NEGRO;ACCESORIOS
19220067;Casado;F;26;CHILENO;INGENIERO EN PREVENCION DE RIESGOS;Z;PROVIDENCIA                   ;METROPOLITANA;0;0;0;0;0;0;0;0;0;MEMORIA MICROSD CLASE 10 128GB SANDISK;ACCESORIOS
12556453;;F;48;CHILENO;;X;RENCA                         ;METROPOLITANA;0;0;0;0;0;0;0;0;0;AUDIFONO IN SAM C/ MIC EG920 BLACK;ACCESORIOS
12409761;;M;48;CHILENO;;X;PROVIDENCIA                   ;METROPOLITANA;0;0;0;0;0;0;0;0;0;PARLANTE ZUKABASS + MICROFONO MLAB BT;ACCESORIOS
7734857;Soltero;F;64;CHILENO;;Boomers;RENCA                         ;METROPOLITANA;0;0;0;0;0;0;0;0;0;AUDIFONO IN EX15AP SONY NEGRO;ACCESORIOS
10598177;;M;55;CHILENO;;Boomers;TALCAHUANO                    ;BIO BIO;0;0;0;0;0;0;0;0;0;PENDRIVE CRUZERBLADE Z50 SANDISK 32GB;ACCESORIOS
9771315;;M;59;CHILENO;;Boomers;OSORNO                        ;LOS LAGOS;0;0;0;0;0;0;0;0;0;Smartwatch GT 2E BLACK;ACCESORIOS
13975816;;F;40;CHILENO;;X;OVALLE                        ;COQUIMBO;0;0;0;0;0;0;0;0;0;DISCO DURO CANVIO 1TB BASICS BLACK TOSHIBA;ACCESORIOS
10063932;;M;55;CHILENO;;Boomers;IQUIQUE                       ;TARAPACA;0;0;0;0;0;0;0;0;0;MEMORIA MICROSD CLASE 10 64GB SANDISK;ACCESORIOS
8028170;Casado;M;62;CHILENO;TECNICO EN CONSTRUCCION;Boomers;RENCA                         ;METROPOLITANA;0;0;0;0;0;0;0;0;0;SMARTBAND SAMSUNG GALAXY FIT 2 NEGRO;ACCESORIOS
15288748;;F;38;CHILENO;;X;ANCUD                         ;LOS LAGOS;0;0;0;0;0;0;0;0;0;SOPORTE TV 14-42 KTAM02 KIOTO C/ BRAZO MOVIL;ACCESORIOS
16897200;;M;34;CHILENO;;Millenial;LOS ANGELES                   ;BIO BIO;0;0;0;0;0;0;0;0;0;Smartwatch GT 2E BLACK;ACCESORIOS
7891858;;M;63;CHILENO;;Boomers;PROVIDENCIA                   ;METROPOLITANA;0;0;0;0;0;0;0;0;0;PARLANTE 6984 MLAB VERTICAL ROCK BT;ACCESORIOS
19581044;;M;24;CHILENO;;Z;NUEVA IMPERIAL                ;ARAUCANIA;0;0;0;0;0;0;0;0;0;AUDIFONO IN EX15AP SONY NEGRO;ACCESORIOS
13676484;;F;42;CHILENO;;X;PROVIDENCIA                   ;METROPOLITANA;0;0;0;0;0;0;0;0;0;BAND 4 AMBER SUNRISE;ACCESORIOS
26996318;;M;29;CHILENO;;Extranjero;HUALPEN;BIO BIO;0;0;0;0;0;0;0;0;0;Smartwatch GT 2E BLACK;ACCESORIOS
16980560;Casado;M;33;CHILENO;;Millenial;RENCA                         ;METROPOLITANA;0;0;0;0;0;0;0;0;0;AUDIFONO ON SONY WH-CH500 BLACK;ACCESORIOS
9174445;Casado;F;60;CHILENO;;Boomers;ARICA                         ;ARICA Y PARINACOTA;0;0;0;0;0;0;0;0;0;AUDIFONO IN SAM C/ MIC EG920 BLACK;ACCESORIOS
17692939;;F;32;CHILENO;;Millenial;SAN ANTONIO                   ;VALPARAISO;0;0;0;0;0;0;0;0;0;AUDIFONO JBL T110 BLANCO;ACCESORIOS
8604532;;F;64;CHILENO;;Boomers;PROVIDENCIA                   ;METROPOLITANA;0;0;0;0;0;0;0;0;0;SOPORTE TV 26-56 KTA02 KIOTO FIJO;ACCESORIOS
19700217;;M;24;CHILENO;;Z;PROVIDENCIA                   ;METROPOLITANA;0;0;0;0;0;0;0;0;0;MOUSE 200 Inalambrico NEGRO;ACCESORIOS
15626231;Casado;M;38;CHILENO;CIRUJANO DENTISTA;Millenial;PROVIDENCIA                   ;METROPOLITANA;0;0;0;0;0;0;0;0;0;Smartwatch GT 2E RED;ACCESORIOS
15959733;Casado;M;37;CHILENO;CIRUJANO DENTISTA;Millenial;PROVIDENCIA                   ;METROPOLITANA;0;0;0;0;0;0;0;0;0;AUDIFONOS Airpods 2nd-generation (MRXJ2BE/A);ACCESORIOS
12586018;Casado;F;48;CHILENO;;X;SAN BERNARDO                  ;METROPOLITANA;0;0;0;0;0;0;0;0;0;AUDIFONO EVO Bluetooth Negro;ACCESORIOS
19170716;Casado;F;27;CHILENO;;Z;PROVIDENCIA                   ;METROPOLITANA;0;0;0;0;0;0;0;0;0;365 Personal Suscripcion Anual;ACCESORIOS
17670976;;M;31;CHILENO;;Millenial;PROVIDENCIA                   ;METROPOLITANA;0;0;0;0;0;0;0;0;0;KARAOKE MLAB SUITCASE OUTDOOR MIC BT BK 8566;ACCESORIOS
4971063;Soltero;F;75;CHILENO;;Silencioso;TALCA                         ;MAULE;0;0;0;0;0;0;0;0;0;PARLANTE 8531 MLAB MAX BASS BT;ACCESORIOS
10334375;Casado;M;56;CHILENO;;Boomers;RENCA                         ;METROPOLITANA;0;0;0;0;0;0;0;0;0;AUDIFONO MLAB TWS FULLY WIRELESSÂ  WHITE 8721;ACCESORIOS
17124560;;M;33;CHILENO;;Millenial;RENCA                         ;METROPOLITANA;0;0;0;0;0;0;0;0;0;AUDIFONO GALAXY BUDS PLUS NEGRO;ACCESORIOS
12311040;;F;49;CHILENO;;X;COIHAIQUE                     ;AYSEN;0;0;0;0;0;0;0;0;0;PARLANTE 7284 MLAB ZUKABASS NARAN/VERDE BT;ACCESORIOS
10284210;;F;65;CHILENO;;Boomers;RENCA                         ;METROPOLITANA;0;0;0;0;0;0;0;0;0;KIT PREPAGO HD DIRECTV;ACCESORIOS
6033805;Viudo;F;71;CHILENO;;Silencioso;RENCA                         ;METROPOLITANA;0;0;0;0;0;0;0;0;0;PARLANTE ZUKABASS 4 BT USB/SD/FM CALACAS;ACCESORIOS
18345335;;F;29;CHILENO;;Millenial;PROVIDENCIA                   ;METROPOLITANA;0;0;0;0;0;0;0;0;0;AUDIFONO AIR-VICTORY BLACK 8724;ACCESORIOS
18076005;;F;30;CHILENO;;Extranjero;PUENTE ALTO                   ;METROPOLITANA;0;0;0;0;0;0;0;0;0;AUDIFONO ON ZX110 SONY NEGRO;ACCESORIOS
16664373;;M;34;CHILENO;;Millenial;PROVIDENCIA                   ;METROPOLITANA;0;0;0;0;0;0;0;0;0;PARLANTE ZUKABASS + MICROFONO MLAB BT;ACCESORIOS
15460845;;M;40;CHILENO;;X;PROVIDENCIA                   ;METROPOLITANA;0;0;0;0;0;0;0;0;0;MLAB KARAOKE OUTDOOR FUN GREEN 8564;ACCESORIOS
19656158;;F;37;CHILENO;;Millenial;PROVIDENCIA                   ;METROPOLITANA;0;0;0;0;0;0;0;0;0;Smartwatch GALAXY WATCH GOLD;ACCESORIOS
16160512;;M;36;CHILENO;;Millenial;VALDIVIA                      ;LOS RIOS;0;0;0;0;0;0;0;0;0;AUDIFONO ON SONY WH-CH400 BLACK;ACCESORIOS
11163185;Divorciado;F;54;CHILENO;AUXILIAR PARAMEDICO DE ENFERMERIA;Boomers;RENCA                         ;METROPOLITANA;0;0;0;0;0;0;0;0;0;KIT PREPAGO HD DIRECTV;ACCESORIOS
8727199;;M;70;CHILENO;;Silencioso;RENCA                         ;METROPOLITANA;0;0;0;0;0;0;0;0;0;SOPORTE TV 14-63 CON BRAZO KT-FM 3L;ACCESORIOS
10545778;Soltero;M;56;CHILENO;CONTADOR GENERAL;Boomers;PROVIDENCIA                   ;METROPOLITANA;0;0;0;0;0;0;0;0;0;KIT PREPAGO HD DIRECTV;ACCESORIOS
11994803;Divorciado;F;50;CHILENO;;X;RENCA                         ;METROPOLITANA;0;0;0;0;0;0;0;0;0;MLAB KARAOKE OUTDOOR FUN GREEN 8564;ACCESORIOS
13990337;;M;44;CHILENO;;X;SANTIAGO                      ;METROPOLITANA;0;0;0;0;0;0;0;0;0;Smartwatch GALAXY WATCH SILVER;ACCESORIOS
15227143;;M;40;CHILENO;;X;MELIPILLA                     ;METROPOLITANA;0;0;0;0;0;0;0;0;0;MOUSE HP Z3700 SILVER WIRELESS;ACCESORIOS
9996197;;M;58;CHILENO;;Boomers;PICHIDEGUA                    ;L.G.B.OÂ´HIGGINS;0;0;0;0;0;0;0;0;0;AUDIFONO IN SAM HS1303C/ MIC ROSADO;ACCESORIOS
20041423;;M;23;CHILENO;;Z;"";"";0;0;0;0;0;0;0;0;0;Smartwatch GALAXY WATCH GOLD;ACCESORIOS
25650017;;F;31;COLOMBIANO;;Extranjero;N/D;N/D;0;0;0;0;0;0;0;0;0;Smartwatch ACTIVE 1 NEGRO;ACCESORIOS
15842221;;M;53;CHILENO;;Millenial;N/D;N/D;0;0;0;0;0;0;0;0;0;SOPORTE TV 14-63 CON BRAZO KT-FM 3L;ACCESORIOS
17225147;;F;33;CHILENO;;Millenial;PROVIDENCIA                   ;METROPOLITANA;0;0;0;0;0;0;0;0;0;TRAVEL ADAPTER 15W - FAST CHARGER (TYPE-C CABLE);ACCESORIOS
18337565;;M;29;CHILENO;;Millenial;N/D;N/D;0;0;0;0;0;0;0;0;0;SOPORTE TV 32-65 KTA03 KIOTO FIJO;ACCESORIOS
11768588;;M;51;CHILENO;;X;RENCA                         ;METROPOLITANA;0;0;0;0;0;0;0;0;0;SOPORTE TV 14-63 CON BRAZO KT-FM 3L;ACCESORIOS
14132062;Casado;M;41;CHILENO;DISENADOR GRAFICO;X;PROVIDENCIA                   ;METROPOLITANA;0;0;0;0;0;0;0;0;0;TRAVEL ADAPTER 15W - FAST CHARGER (TYPE-C CABLE);ACCESORIOS
10766499;;F;55;CHILENO;;Boomers;N/D;N/D;0;0;0;0;0;0;0;0;0;MOCHILA XTREM BIKERFOLD 020;ACCESORIOS
17686316;;M;31;CHILENO;;Millenial;PROVIDENCIA                   ;METROPOLITANA;0;0;0;0;0;0;0;0;0;SOPORTE TV 14-63 CON BRAZO KT-FM 3L;ACCESORIOS
19468017;;F;25;CHILENO;;Z;N/D;N/D;0;0;0;0;0;0;0;0;0;AUDIFONO ON SONY WH-CH500 BLACK;ACCESORIOS
16007546;;M;36;CHILENO;;Millenial;PROVIDENCIA                   ;METROPOLITANA;0;0;0;0;0;0;0;0;0;DISCO DURO CANVIO 4TB BASICS BLACK;ACCESORIOS
15518559;;M;38;CHILENO;;Millenial;COIHAIQUE                     ;AYSEN;0;0;0;0;0;0;0;0;0;AUDIFONO PANASONIC BT ON RP-HF410BPUK NEGRO;ACCESORIOS
17913015;;M;30;CHILENO;;Millenial;PROVIDENCIA                   ;METROPOLITANA;0;0;0;0;0;0;0;0;0;AUDIFONO ON ZX110 SONY NEGRO;ACCESORIOS
18747177;;M;28;CHILENO;;Millenial;PROVIDENCIA                   ;METROPOLITANA;150;1;1;0;0;0;1;1;150;Bolsa Papel Abcdin;PROMOCIONES
10557250;;M;56;CHILENO;;Boomers;SAN CARLOS                    ;BIO BIO;150;1;1;0;0;0;1;1;150;Bolsa Papel Abcdin;PROMOCIONES
14296415;;M;47;CHILENO;;Millenial;"";"";980;2;1;0;0;0;2;1;980;FIDGET SPINNER COL. SURTIDOS;PROMOCIONES
19652760;;M;24;CHILENO;;Z;PROVIDENCIA                   ;METROPOLITANA;0;0;0;0;0;0;0;0;0;Bolsa Papel Abcdin;PROMOCIONES
15113255;;M;39;CHILENO;;X;RENCA                         ;METROPOLITANA;340150;4;1;0;0;0;4;1;340150;CELULAR VIVO V21 5G DUSK BLUE 128GB OPEN;TELEFONIA
18845729;;M;28;CHILENO;;Millenial;PENCO                         ;BIO BIO;199991;2;3;0;0;0;2;3;199991;CELULAR REDMI NOTE 10S 128GB ONIX BLACK;TELEFONIA
16495059;;F;35;CHILENO;;Millenial;PROVIDENCIA                   ;METROPOLITANA;494520;4;3;2;1;124540;2;2;369980;CELULAR REDMI NOTE 10S 128GB PEBBLE WHITE;TELEFONIA
8659425;;F;63;CHILENO;;Boomers;TALAGANTE                     ;METROPOLITANA;119290;2;1;0;0;0;2;1;119290;CELULAR GALAXY A03 CORE 2GB 32GB BLUE OPEN;TELEFONIA
6544149;;M;71;CHILENO;;Silencioso;COIHAIQUE                     ;AYSEN;1560870;13;7;0;0;0;13;7;1560870;CELULAR VIVO Y53S AZUL ENTEL;TELEFONIA
23388232;Soltero;M;42;PERUANO;;Extranjero;PROVIDENCIA                   ;METROPOLITANA;614671;6;3;0;0;0;6;3;614671;CELULAR MOTO G60 128GB NEGRO MOVISTAR;TELEFONIA
15697325;;M;38;CHILENO;;Millenial;RETIRO                        ;MAULE;34990;1;1;0;0;0;1;1;34990;Celular SA3 CLARO DIRECTO BLACK;TELEFONIA
10756084;;M;56;CHILENO;;Boomers;TALCA                         ;MAULE;130480;2;1;0;0;0;2;1;130480;CELULAR GALAXY A03 128GB BLACK CLARO;TELEFONIA
15079091;;F;39;CHILENO;;X;VINA DEL MAR                  ;VALPARAISO;1884550;13;5;0;0;0;13;5;1884550;CELULAR VIVO Y53S FANTASTIC AZUL WOM;TELEFONIA
10740864;;F;55;CHILENO;;Boomers;LA REINA                      ;METROPOLITANA;69990;2;1;0;0;0;2;1;69990;CELULAR VIVO Y21S 128GB BLANCO WOM;TELEFONIA
16823983;;F;35;CHILENO;;Millenial;PROVIDENCIA                   ;METROPOLITANA;109990;1;1;0;0;0;1;1;109990;CELULAR GALAXY A03 4+64GB BLUE OPEN;TELEFONIA
13313739;;M;46;CHILENO;;X;N/D;N/D;224970;3;2;0;0;0;3;2;224970;CELULAR GALAXY A03 64GB RED OPEN;TELEFONIA
18112386;;F;30;CHILENO;;Millenial;N/D;N/D;1316900;10;5;8;4;975920;2;1;340980;CELULAR GALAXY A53 5G 6+128GB ORANGE;TELEFONIA
15543185;;M;38;CHILENO;;X;NUNOA                         ;METROPOLITANA;133980;2;1;2;1;133980;0;0;0;CELULAR REDMI 9T 128 GB OCEAN GREEN;TELEFONIA
14478788;;F;48;CHILENO;;X;CHANCO                        ;MAULE;497180;8;6;0;0;0;8;6;497180;CELULAR REDMI 10A US 32GB CHROME SILVER OPEN;TELEFONIA
15547807;;F;40;CHILENO;;X;PROVIDENCIA                   ;METROPOLITANA;252990;5;3;0;0;0;5;3;252990;CELULAR VIVO Y21S 128GB BLANCO WOM;TELEFONIA
17497763;Soltero;M;31;CHILENO;;Millenial;PROVIDENCIA                   ;METROPOLITANA;418610;2;1;0;0;0;2;1;418610;CELULAR GALAXY A53 5G 6+128GB BLACK;TELEFONIA
11785225;;F;51;CHILENO;;X;CABILDO                       ;VALPARAISO;568980;2;1;0;0;0;2;1;568980;CELULAR GALAXY A73 5G 128GB GRAY OPEN;TELEFONIA
17977344;;F;31;CHILENO;;Millenial;"";"";267020;8;4;0;0;0;8;4;267020;CELULAR REDMI 10A US 32GB CHROME SILVER OPEN;TELEFONIA
18553353;;M;28;CHILENO;;Millenial;"";"";980;2;1;0;0;0;2;1;980;CHIP OPEN ENTEL;TELEFONIA
12601568;;F;48;CHILENO;;X;PROVIDENCIA                   ;METROPOLITANA;186980;2;1;2;1;186980;0;0;0;CELULAR HUAWEI NOVA 8i BLUE;TELEFONIA
10831655;;F;51;CHILENO;;X;CANETE                        ;BIO BIO;129290;2;1;0;0;0;2;1;129290;CELULAR SAMSUNG A03 64GB NEGRO WOM;TELEFONIA
13722803;;M;42;CHILENO;;Silencioso;PROVIDENCIA                   ;METROPOLITANA;225010;2;1;0;0;0;2;1;225010;CELULAR GALAXY A23 6+128GB LIGHT BLUE OPEN;TELEFONIA
15273446;;M;39;CHILENO;;X;"";"";980;2;1;0;0;0;2;1;980;CHIP OPEN ENTEL;TELEFONIA
10618278;;F;56;CHILENO;;Boomers;PROVIDENCIA                   ;METROPOLITANA;133980;2;1;2;1;133980;0;0;0;CELULAR GALAXY A13 4+128GB WHITE OPEN;TELEFONIA
14475077;;M;46;CHILENO;;X;PROVIDENCIA                   ;METROPOLITANA;609620;4;2;0;0;0;4;2;609620;CELULAR REDMI 10A US 32GB CHROME SILVER OPEN;TELEFONIA
7824834;;F;63;CHILENO;;Boomers;TOME                          ;BIO BIO;379880;5;2;0;0;0;5;2;379880;CELULAR GALAXY A13 4+128GB BLACK;TELEFONIA
7706330;;F;65;CHILENO;;Boomers;N/D;N/D;259660;2;1;0;0;0;2;1;259660;CELULAR GALAXY A22 5G 4+128GB WHITE;TELEFONIA
19685120;;F;25;CHILENO;;Z;N/D;N/D;327960;4;2;2;1;306980;2;1;20980;CELULAR GALAXY A53 5G 6+128GB ORANGE;TELEFONIA
15053487;;F;39;CHILENO;;X;CANELA                        ;COQUIMBO;712950;5;3;0;0;0;5;3;712950;CELULAR GALAXY A03 4+128GB BLACK OPEN;TELEFONIA
8940161;;F;66;CHILENO;;Boomers;CORONEL                       ;BIO BIO;242862;6;2;0;0;0;6;2;242862;CELULAR MOTO G31 4/128 GB GRIS METEORITO OPEN;TELEFONIA
9703295;;F;59;CHILENO;;Boomers;CONCHALI                      ;METROPOLITANA;353156;7;4;0;0;0;7;4;353156;CELULAR VIVO Y15S BLUE MOVISTAR;TELEFONIA
19783336;;M;24;CHILENO;;Z;PROVIDENCIA                   ;METROPOLITANA;176980;2;1;2;1;176980;0;0;0;CELULAR POCO M4 PRO 128GB COOL BLUE OPEN;TELEFONIA
3771808;;F;88;CHILENO;;Silencioso;CANETE                        ;BIO BIO;621620;6;3;0;0;0;6;3;621620;CELULAR GALAXY A13 4+128GB WHITE OPEN;TELEFONIA
14336232;;M;44;CHILENO;;X;PICHIDEGUA                    ;L.G.B.OÂ´HIGGINS;1361244;10;4;0;0;0;10;4;1361244;CELULAR MOTO G60 4/128 GB SILVER OPEN;TELEFONIA
15126939;;F;40;CHILENO;;X;PARRAL                        ;MAULE;319980;2;1;2;1;319980;0;0;0;CELULAR A32 128 GB BLUE OPEN;TELEFONIA
15405811;;F;39;CHILENO;;X;MELIPILLA                     ;METROPOLITANA;970510;9;4;0;0;0;9;4;970510;CELULAR VIVO Y21s 128GB AZUL CLARO;TELEFONIA
9421595;;F;55;CHILENO;;Boomers;COIHAIQUE                     ;AYSEN;199990;3;1;0;0;0;3;1;199990;CELULAR GALAXY A33 5G 6+128GB BLACK OPEN;TELEFONIA
17591705;;M;32;CHILENO;;Millenial;TALCA                         ;MAULE;808830;3;3;2;1;695840;1;2;112990;IPHONE 12 128GB BLACK CLARO;TELEFONIA
16553332;;F;35;CHILENO;;Millenial;PROVIDENCIA                   ;METROPOLITANA;133980;2;1;2;1;133980;0;0;0;CELULAR GALAXY A13 4+128GB LIGHT BLUE OPEN;TELEFONIA
16275501;;M;36;CHILENO;;Millenial;PROVIDENCIA                   ;METROPOLITANA;235010;3;1;0;0;0;3;1;235010;CELULAR A32 128 GB BLACK OPEN;TELEFONIA
10375969;;M;54;CHILENO;;X;MELIPILLA                     ;METROPOLITANA;410150;5;3;0;0;0;5;3;410150;CELULAR VIVO Y53S FANTASTIC RAINBOW 128GB OPEN;TELEFONIA
8580088;;M;64;CHILENO;;Boomers;RENCA                         ;METROPOLITANA;121070;2;1;0;0;0;2;1;121070;CELULAR XIAOMI REDMI 9A 32GB GRANITE GRAY TRI WO;TELEFONIA
9311542;Casado;F;61;CHILENO;;Boomers;RENCA                         ;METROPOLITANA;189640;2;1;0;0;0;2;1;189640;CELULAR GALAXY A23 6+128GB BLACK OPEN;TELEFONIA
8137826;;F;66;CHILENO;;Boomers;LA SERENA                     ;COQUIMBO;232140;4;1;0;0;0;4;1;232140;CELULAR GALAXY A03 CORE 2GB 32GB BLUE OPEN;TELEFONIA
6955559;;F;78;CHILENO;;Silencioso;PROVIDENCIA                   ;METROPOLITANA;109990;1;1;0;0;0;1;1;109990;CELULAR VIVO Y01 AZUL ZAFIRO OPEN;TELEFONIA
20029595;;F;23;CHILENO;;Z;ILLAPEL;COQUIMBO;270970;3;3;2;2;254980;1;1;15990;CELULAR XIAOMI REDMI 9A 2/32GB GRANITE GRAY;TELEFONIA
17328095;Soltero;M;41;CHILENO;;X;PROVIDENCIA                   ;METROPOLITANA;1654920;8;7;4;2;954960;4;5;699960;CELULAR GALAXY A53 5G BLACK CLARO;TELEFONIA
20620907;;F;21;CHILENO;;Z;LOS ANGELES                   ;BIO BIO;232630;7;2;0;0;0;7;2;232630;CELULAR MOTO G22 64GB AZUL OPEN;TELEFONIA
12156159;;M;61;CHILENO;;Boomers;CARAHUE                       ;ARAUCANIA;109990;1;1;0;0;0;1;1;109990;CELULAR VIVO Y01 AZUL ZAFIRO OPEN;TELEFONIA
10313440;;F;58;CHILENO;;Boomers;NUEVA IMPERIAL                ;ARAUCANIA;445271;8;6;0;0;0;8;6;445271;CELULAR VIVO Y21S MIDNIGHT BLUE 128 GB OPEN;TELEFONIA
12780668;;M;51;CHILENO;;X;RENCA                         ;METROPOLITANA;175980;2;1;2;1;175980;0;0;0;CELULAR POCO M4 PRO 128GB COOL BLUE OPEN;TELEFONIA
19089453;;F;27;CHILENO;;Z;N/D;N/D;147123;4;2;0;0;0;4;2;147123;CELULAR VIVO Y21S MIDNIGHT BLUE 128 GB OPEN;TELEFONIA
16970259;;F;34;CHILENO;;Millenial;QUILPUE;VALPARAISO;279356;4;3;2;2;179980;2;1;99376;CELULAR VIVO Y15S BLUE MOVISTAR;TELEFONIA
11683661;Soltero;F;51;CHILENO;;X;RENCA                         ;METROPOLITANA;159990;1;3;1;3;159990;0;0;0;CELULAR GALAXY A23 6+128GB LIGHT BLUE OPEN;TELEFONIA
6801753;;M;69;CHILENO;;Silencioso;OVALLE                        ;COQUIMBO;1297890;11;6;0;0;0;11;6;1297890;CELULAR VIVO Y53S FANTASTIC RAINBOW 128GB OPEN;TELEFONIA
19903467;;F;24;CHILENO;;Z;N/D;N/D;69990;1;1;0;0;0;1;1;69990;CELULAR SMARTPHONE BMOBIL AX1076 PRO BLACK TRI W;TELEFONIA
19491576;;M;25;CHILENO;;Z;PROVIDENCIA                   ;METROPOLITANA;325970;3;3;2;2;309980;1;1;15990;CELULAR MOTO G22 64GB AZUL OPEN;TELEFONIA
19390628;;F;25;CHILENO;;Z;N/D;N/D;447810;8;6;0;0;0;8;6;447810;CELULAR GALAXY A03 4+128GB BLUE OPEN;TELEFONIA
11698968;;F;50;CHILENO;;X;LOTA                          ;BIO BIO;120130;4;3;0;0;0;4;3;120130;CELULAR VIVO Y01 AZUL ZAFIRO OPEN;TELEFONIA
16357476;Soltero;M;36;CHILENO;;Millenial;RENCA                         ;METROPOLITANA;446970;3;2;2;1;296980;1;1;149990;CELULAR SMARTPHONE A52S 5G LIGHT GREEN 128GB;TELEFONIA
10991108;;F;44;CHILENO;;X;PROVIDENCIA                   ;METROPOLITANA;149640;3;1;0;0;0;3;1;149640;CELULAR GALAXY A03 4+64GB BLACK OPEN;TELEFONIA
19357662;;F;25;CHILENO;;Z;N/D;N/D;650410;9;7;5;3;407450;4;4;242960;CELULAR XIAOMI REDMI 9A 2/32GB GRANITE GRAY;TELEFONIA
5263687;;M;74;CHILENO;;Silencioso;GRANEROS                      ;L.G.B.OÂ´HIGGINS;269660;3;1;0;0;0;3;1;269660;CELULAR GALAXY A23 6+128GB BLACK OPEN;TELEFONIA
8621236;Soltero;M;63;CHILENO;;Boomers;PROVIDENCIA                   ;METROPOLITANA;99990;1;1;0;0;0;1;1;99990;CELULAR GALAXY A03 4+64GB BLACK OPEN;TELEFONIA
690265;;F;69;CHILENO;;Silencioso;ANTOFAGASTA                   ;ANTOFAGASTA;89376;2;1;0;0;0;2;1;89376;CELULAR VIVO Y15S BLUE MOVISTAR;TELEFONIA
11336681;;M;54;CHILENO;;Millenial;N/D;N/D;197770;5;3;0;0;0;5;3;197770;CELULAR VIVO Y01 AZUL ZAFIRO OPEN;TELEFONIA
17684195;;F;31;CHILENO;;Millenial;MELIPILLA                     ;METROPOLITANA;199660;3;1;0;0;0;3;1;199660;CELULAR GALAXY A13 4+128GB LIGHT BLUE OPEN;TELEFONIA
16738739;;F;35;CHILENO;;Millenial;PUENTE ALTO                   ;METROPOLITANA;244930;7;2;0;0;0;7;2;244930;CELULAR REDMI 10A US 32GB CHROME SILVER OPEN;TELEFONIA
13178254;;F;45;CHILENO;;X;PROVIDENCIA                   ;METROPOLITANA;236959;4;2;0;0;0;4;2;236959;CELULAR GALAXY A03 4+128GB BLACK OPEN;TELEFONIA
19265103;Soltero;F;25;CHILENO;;Z;N/D;N/D;186980;2;1;2;1;186980;0;0;0;CELULAR HUAWEI NOVA 8i BLUE;TELEFONIA
15245390;;M;40;CHILENO;;X;TEMUCO                        ;ARAUCANIA;179990;1;1;0;0;0;1;1;179990;CELULAR GALAXY A23 6+128GB LIGHT BLUE OPEN;TELEFONIA
10877196;;M;55;CHILENO;;Boomers;COIHAIQUE                     ;AYSEN;129990;1;1;0;0;0;1;1;129990;CELULAR REDMI 10A US 32GB CHROME SILVER OPEN;TELEFONIA
13685300;;F;43;CHILENO;;X;SAN FERNANDO                  ;L.G.B.OÂ´HIGGINS;967130;12;7;2;2;239980;10;5;727150;CELULAR REDMI 9A 32GB AURORA GREEN OPEN;TELEFONIA
17955434;;M;45;CHILENO;;X;CHIGUAYANTE                   ;BIO BIO;290970;3;2;0;0;0;3;2;290970;CELULAR GALAXY A13 4+128GB LIGHT BLUE OPEN;TELEFONIA
25219373;;F;47;PERUANO;;Extranjero;PROVIDENCIA                   ;METROPOLITANA;299980;2;2;2;2;299980;0;0;0;CELULAR REDMI 10A US 64GB GRAPHITE GRAY OPEN;TELEFONIA
14003714;;M;40;CHILENO;;X;SAN ANTONIO                   ;VALPARAISO;657970;3;2;0;0;0;3;2;657970;CELULAR MOTO G60 4/128 GB NEGRO OPEN;TELEFONIA
12190680;Casado;M;54;CHILENO;TECNICO;X;ERCILLA                       ;ARAUCANIA;159990;1;1;0;0;0;1;1;159990;CELULAR VIVO Y21S 128GB BLANCO WOM;TELEFONIA
20533263;;F;21;CHILENO;;Z;N/D;N/D;432123;4;2;0;0;0;4;2;432123;CELULAR VIVO Y53S AZUL ENTEL;TELEFONIA
5093220;;M;77;CHILENO;;Silencioso;RENCA                         ;METROPOLITANA;34990;1;1;0;0;0;1;1;34990;Celular SA3 CLARO DIRECTO BLACK;TELEFONIA
18901717;;F;27;CHILENO;;Z;NUEVA IMPERIAL                ;ARAUCANIA;362960;4;3;0;0;0;4;3;362960;CELULAR GALAXY A03 4+64GB BLUE OPEN;TELEFONIA
8356433;;M;65;CHILENO;;Boomers;LINARES                       ;MAULE;1600950;20;7;0;0;0;20;7;1600950;CELULAR GALAXY A03 4+64GB BLACK OPEN;TELEFONIA
14476492;;F;46;CHILENO;;X;N/D;N/D;676890;10;4;0;0;0;10;4;676890;CELULAR GALAXY A03 128GB BLACK CLARO;TELEFONIA
10846195;;M;56;CHILENO;;Boomers;N/D;N/D;1173890;7;7;0;0;0;7;7;1173890;CELULAR GALAXY A33 5G 6+128GB ORANGE OPEN;TELEFONIA
19555244;;F;25;CHILENO;;Z;PROVIDENCIA                   ;METROPOLITANA;329990;1;1;0;0;0;1;1;329990;CELULAR REDMI NOTE 11 PRO 128GB WHITE;TELEFONIA
9058867;Casado;F;62;CHILENO;;Boomers;RENCA                         ;METROPOLITANA;139990;1;1;0;0;0;1;1;139990;CELULAR GALAXY A03 128GB BLACK CLARO;TELEFONIA
10525483;Divorciado;M;51;CHILENO;;X;CORONEL                       ;BIO BIO;149980;2;2;0;0;0;2;2;149980;CELULAR MOTOROLA G20 EDICION ESPECIAL VERDE CLAR;TELEFONIA
11287216;;F;53;CHILENO;;X;COLBUN                        ;MAULE;239372;4;1;0;0;0;4;1;239372;CELULAR VIVO Y53S AZUL ENTEL;TELEFONIA
20015332;;F;23;CHILENO;;Z;VALLENAR;ATACAMA;199990;3;2;0;0;0;3;2;199990;Celular P30 LITE LIB OPEN NEGRO;TELEFONIA
17288579;Soltero;F;28;CHILENO;;Millenial;PROVIDENCIA                   ;METROPOLITANA;109990;1;1;0;0;0;1;1;109990;CELULAR MOTOROLA E30 GRIS CLARO;TELEFONIA
19768902;;M;23;CHILENO;;Z;N/D;N/D;179990;1;1;0;0;0;1;1;179990;CELULAR SAMSUNG A23 128GB BLACK CLARO;TELEFONIA
14475279;Soltero;F;46;CHILENO;;X;RENGO                         ;L.G.B.OÂ´HIGGINS;1017161;8;3;0;0;0;8;3;1017161;CELULAR MOTO G100 128GB VERDE BOREAL + HMDI OPEN;TELEFONIA
15132115;;F;39;CHILENO;;X;N/D;N/D;109990;1;1;0;0;0;1;1;109990;CELULAR REDMI 9C 64GB SUNRISE ORANGE;TELEFONIA
17175194;Soltero;F;32;CHILENO;;Millenial;PROVIDENCIA                   ;N/D;301980;2;1;2;1;301980;0;0;0;CELULAR SAMSUNG A52s 128GB BLACK CLARO;TELEFONIA
16467362;;F;36;CHILENO;;Millenial;ARICA                         ;ARICA Y PARINACOTA;707960;5;4;0;0;0;5;4;707960;CELULAR MOTO G22 128GB NEGRO MOVISTAR;TELEFONIA
18679844;;F;28;CHILENO;;Millenial;N/D;N/D;174980;2;2;2;2;174980;0;0;0;CELULAR Moto G20 Rosado WOM;TELEFONIA
20927061;Soltero;M;26;CHILENO;;Z;N/D;N/D;866891;11;7;6;3;292940;5;4;573951;CELULAR MOTO G60S 6/128 GB AZUL;TELEFONIA
4981415;;F;76;CHILENO;;Silencioso;LA SERENA                     ;COQUIMBO;329650;5;1;0;0;0;5;1;329650;CELULAR MI 11 LITE 128GB BOBA BLACK OPEN;TELEFONIA
18370463;;M;28;CHILENO;;Millenial;IQUIQUE                       ;TARAPACA;282980;4;1;0;0;0;4;1;282980;CELULAR REDMI NOTE 11S 6GB+128GB TWILIGHT BLUE O;TELEFONIA
13750327;;M;42;CHILENO;;X;ILLAPEL                       ;COQUIMBO;434639;4;2;0;0;0;4;2;434639;CELULAR GALAXY A22 5G 4+128GB GRAY;TELEFONIA
11700271;;F;50;CHILENO;;X;CANETE                        ;BIO BIO;756134;8;5;0;0;0;8;5;756134;CELULAR GALAXY A13 4+128GB LIGHT BLUE OPEN;TELEFONIA
10065288;;M;57;CHILENO;;Boomers;BUIN                          ;METROPOLITANA;336717;4;2;2;1;283980;2;1;52737;CELULAR VIVO Y15S WAVE GREEN OPEN;TELEFONIA
12096982;;M;59;CHILENO;;Extranjero;ARICA                         ;ARICA Y PARINACOTA;1030930;7;3;0;0;0;7;3;1030930;CELULAR REDMI 10C EU 4GB+128GB GRAPHITE GRAY OPE;TELEFONIA
14057092;;M;40;CHILENO;;X;PROVIDENCIA                   ;METROPOLITANA;229990;1;1;0;0;0;1;1;229990;CELULAR REDMI NOTE 10S 128GB ONIX BLACK;TELEFONIA
7762246;;M;68;CHILENO;;Boomers;ARAUCO                        ;BIO BIO;353970;3;2;0;0;0;3;2;353970;CELULAR GALAXY A53 5G 6+128GB BLACK;TELEFONIA
25784330;;M;35;CHILENO;;Extranjero;SAN PEDRO DE LA PAZ           ;BIO BIO;239980;6;2;0;0;0;6;2;239980;CELULAR GALAXY A13 4+128GB WHITE OPEN;TELEFONIA
11501292;;M;52;CHILENO;;X;MAIPU                         ;METROPOLITANA;249990;1;1;0;0;0;1;1;249990;CELULAR REDMI NOTE 10 5G 4/128GB GRAPHITE GRAY O;TELEFONIA
19835081;;F;24;CHILENO;;Z;SAN PEDRO DE LA PAZ           ;BIO BIO;788910;10;8;3;4;114980;7;4;673930;CELULAR GALAXY A13 4+128GB WHITE OPEN;TELEFONIA
14086149;;F;46;CHILENO;;X;COIHAIQUE                     ;AYSEN;1567740;11;5;5;2;871950;6;3;695790;CELULAR GALAXY S20 FE 5G 128GB LAVENDER OPEN;TELEFONIA
17572994;;M;31;CHILENO;;Millenial;N/D;N/D;111709;6;4;0;0;0;6;4;111709;CELULAR XIAOMI REDMI 9C 64GB GRAY WOM;TELEFONIA
13749046;Soltero;F;42;CHILENO;;X;RENCA                         ;METROPOLITANA;189980;2;1;2;1;189980;0;0;0;CELULAR POCO M4 PRO 128GB COOL BLUE OPEN;TELEFONIA
13407753;;F;44;CHILENO;;X;ANCUD                         ;LOS LAGOS;194560;2;1;0;0;0;2;1;194560;CELULAR GALAXY A22 5G 4+128GB GRAY;TELEFONIA
7491496;;M;67;CHILENO;;Boomers;ILLAPEL                       ;COQUIMBO;786960;4;4;0;0;0;4;4;786960;CELULAR GALAXY A53 5G 6+128GB ORANGE;TELEFONIA
11727306;;M;50;CHILENO;;X;OVALLE                        ;COQUIMBO;478200;6;3;0;0;0;6;3;478200;CELULAR VIVO Y01 AZUL ZAFIRO OPEN;TELEFONIA
10345331;;F;60;CHILENO;;Boomers;CANETE                        ;BIO BIO;1287430;9;7;0;0;0;9;7;1287430;CELULAR GALAXY A22 5G 4+128GB GRAY;TELEFONIA
12113989;;F;50;CHILENO;;X;PADRE LAS CASAS               ;ARAUCANIA;559420;7;3;0;0;0;7;3;559420;CELULAR REDMI NOTE 10 5G 4/128GB GRAPHITE GRAY O;TELEFONIA
15497081;;F;39;CHILENO;;X;N/D;N/D;203110;5;4;1;1;159990;4;3;43120;CELULAR A32 128 GB BLACK OPEN;TELEFONIA
7709366;;F;66;CHILENO;;Boomers;EL BOSQUE                     ;METROPOLITANA;882930;7;8;0;0;0;7;8;882930;CELULAR GALAXY A13 4+128GB BLACK;TELEFONIA
10609726;Soltero;M;54;CHILENO;;Boomers;RENCA                         ;METROPOLITANA;39990;1;1;0;0;0;1;1;39990;CELULAR ALCATEL P1 3080 BLACK MOVISTAR DIRECTO;TELEFONIA
15601078;;M;39;CHILENO;;X;PROVIDENCIA                   ;METROPOLITANA;129990;1;1;1;1;129990;0;0;0;CELULAR MOTO G31 4/128 GB GRIS METEORITO OPEN;TELEFONIA
15035017;;M;40;CHILENO;;X;"";"";134240;4;1;0;0;0;4;1;134240;CELULAR SAMSUNG A03 128GB BLACK CLARO;TELEFONIA
16165636;;F;36;CHILENO;;Millenial;SANTA CRUZ                    ;L.G.B.OÂ´HIGGINS;342460;3;1;0;0;0;3;1;342460;CELULAR REDMI NOTE 11 PRO 128GB WHITE;TELEFONIA
26947492;;M;29;NO INFORMA NACIONALIDAD;;Extranjero;PROVIDENCIA                   ;METROPOLITANA;200480;2;1;2;1;200480;0;0;0;CELULAR A52 128 GB WHITE OPEN;TELEFONIA
17410242;;M;33;CHILENO;;Millenial;CAUQUENES                     ;MAULE;204980;2;2;0;0;0;2;2;204980;CELULAR REDMI 9C 64GB SUNRISE ORANGE;TELEFONIA
13577482;;M;43;CHILENO;;X;PARRAL                        ;MAULE;809890;10;7;0;0;0;10;7;809890;CELULAR GALAXY A22 5G 4+128GB GRAY;TELEFONIA
25440147;;F;29;BOLIVIANO;;Extranjero;CALAMA                        ;ANTOFAGASTA;1815740;21;12;0;0;0;21;12;1815740;CELULAR GALAXY A13 4+128GB LIGHT BLUE OPEN;TELEFONIA
10781622;Casado;M;53;CHILENO;;X;PROVIDENCIA                   ;METROPOLITANA;1762470;9;4;9;4;1762470;0;0;0;CELULAR GALAXY A53 5G 6+128GB BLACK;TELEFONIA
18040947;;F;30;CHILENO;;Millenial;MACHALI                       ;L.G.B.OÂ´HIGGINS;129990;1;1;1;1;129990;0;0;0;CELULAR MOTO G31 4/128 GB GRIS METEORITO OPEN;TELEFONIA
16962413;;M;33;CHILENO;;Millenial;PARRAL                        ;MAULE;49990;2;1;0;0;0;2;1;49990;CELULAR REDMI 9C 64GB SUNRISE ORANGE;TELEFONIA
9643431;;F;61;CHILENO;;Boomers;LA LIGUA                      ;VALPARAISO;59990;2;1;0;0;0;2;1;59990;CELULAR GALAXY A03 4+64GB BLACK OPEN;TELEFONIA
15358202;;M;39;CHILENO;;X;PROVIDENCIA                   ;METROPOLITANA;163980;2;1;2;1;163980;0;0;0;CELULAR A32 128 GB LIGHT VIOLET OPEN;TELEFONIA
26924637;;F;47;VENEZOLANO;;Extranjero;LA CALERA;VALPARAISO;464190;7;5;3;2;232970;4;3;231220;CELULAR GALAXY A13 4+128GB LIGHT BLUE OPEN;TELEFONIA
23310738;;F;58;PERUANO;;Extranjero;ARICA                         ;ARICA Y PARINACOTA;262860;4;2;0;0;0;4;2;262860;CELULAR GALAXY A13 4+128GB LIGHT BLUE OPEN;TELEFONIA
15214904;;M;39;CHILENO;;X;PROVIDENCIA                   ;METROPOLITANA;109990;1;1;0;0;0;1;1;109990;CELULAR VIVO Y11S 32 GB NEBULA BLUE WOM;TELEFONIA
17498248;;F;32;CHILENO;;Millenial;VILLA ALEGRE                  ;MAULE;371950;5;3;0;0;0;5;3;371950;CELULAR REDMI 9C 64GB SUNRISE ORANGE;TELEFONIA
23977711;;M;41;DOMINICANO;;Extranjero;N/D;N/D;339980;2;4;0;0;0;2;4;339980;CELULAR GALAXY A22 5G 4+128GB GRAY;TELEFONIA
6714110;;M;68;CHILENO;;Boomers;RENCA                         ;METROPOLITANA;89990;1;1;0;0;0;1;1;89990;CELULAR Moto E7 Rosado WOM;TELEFONIA
13629548;;F;42;CHILENO;;X;N/D;N/D;699300;9;6;2;1;103980;7;5;595320;CELULAR Moto E7 Rosado WOM;TELEFONIA
14413431;;M;69;ARGENTINO;;Extranjero;SAN FELIPE                    ;VALPARAISO;621940;7;4;0;0;0;7;4;621940;CELULAR GALAXY A33 5G 6+128GB LIGHT BLUE OPEN;TELEFONIA
9996856;;M;43;CHILENO;;X;RENCA                         ;METROPOLITANA;219730;4;2;0;0;0;4;2;219730;CELULAR VIVO Y21S 128GB BLANCO WOM;TELEFONIA
13043671;;F;46;CHILENO;;X;PROVIDENCIA                   ;METROPOLITANA;197847;2;1;0;0;0;2;1;197847;CELULAR VIVO V21 5G 128GB SUNSET DAZZLE OPEN;TELEFONIA
6648057;Viudo;F;67;CHILENO;;Boomers;LEBU                          ;BIO BIO;2346901;11;7;0;0;0;11;7;2346901;CELULAR IPHONE 12 64GB BLACK CLARO;TELEFONIA
11842524;;F;51;CHILENO;;X;NUEVA IMPERIAL                ;ARAUCANIA;135629;3;1;0;0;0;3;1;135629;CELULAR VIVO Y15S WAVE GREEN OPEN;TELEFONIA
7932498;;M;64;CHILENO;;Boomers;N/D;N/D;482950;5;5;0;0;0;5;5;482950;CELULAR REDMI NOTE 11 4/128GB TWILIGHT BLUE OPEN;TELEFONIA
14269962;;M;49;CHILENO;;X;N/D;N/D;280220;5;4;0;0;0;5;4;280220;CELULAR REDMI NOTE 11S 128GB GRAPHITE GRAY;TELEFONIA
8595596;;M;60;CHILENO;;Boomers;PUNITAQUI                     ;COQUIMBO;403760;5;4;0;0;0;5;4;403760;CELULAR GALAXY A03 CORE 2GB 32GB BLUE OPEN;TELEFONIA
5434937;Divorciado;M;75;CHILENO;ARQUITECTO;Extranjero;PROVIDENCIA                   ;N/D;109990;1;1;0;0;0;1;1;109990;CELULAR Moto G20 Blue WOM;TELEFONIA
21714167;;M;50;PERUANO;;Extranjero;PROVIDENCIA                   ;METROPOLITANA;194960;4;2;4;2;194960;0;0;0;CELULAR A32 128 GB BLUE OPEN;TELEFONIA
17192084;;F;33;CHILENO;;Millenial;N/D;N/D;159990;1;1;0;0;0;1;1;159990;CELULAR GALAXY A23 6+128GB BLACK OPEN;TELEFONIA
10852110;;F;51;CHILENO;;X;PROVIDENCIA                   ;METROPOLITANA;789980;2;2;0;0;0;2;2;789980;IPHONE 12 128GB BLACK CLARO;TELEFONIA
12948042;;F;46;CHILENO;;X;N/D;N/D;598270;7;3;0;0;0;7;3;598270;CELULAR GALAXY A22 5G 4+128GB GRAY;TELEFONIA
26905294;;F;38;EXTRANJERO - NO INFORMA NACIONALIDAD;;Extranjero;N/D;N/D;600690;5;5;0;0;0;5;5;600690;CELULAR REDMI NOTE 10S 128GB ONIX BLACK;TELEFONIA
17607731;;M;31;CHILENO;;Millenial;LOS ALAMOS                    ;BIO BIO;323380;4;2;0;0;0;4;2;323380;CELULAR GALAXY A13 4+128GB WHITE OPEN;TELEFONIA
6048712;;F;74;CHILENO;;Silencioso;ANGOL                         ;ARAUCANIA;930196;10;8;0;0;0;10;8;930196;CELULAR POCO X4 PRO 5G EU 8GB+256GB POCO YELLOW;TELEFONIA
18992653;Soltero;F;27;CHILENO;FONOAUDIOLOGA;Z;PROVIDENCIA                   ;METROPOLITANA;99990;1;1;1;1;99990;0;0;0;CELULAR Moto G20 Rosado WOM;TELEFONIA
18486046;Soltero;F;28;CHILENO;TERAPEUTA OCUPACIONAL;Millenial;PROVIDENCIA                   ;METROPOLITANA;169990;1;1;1;1;169990;0;0;0;CELULAR REDMI NOTE 10S 128GB ONIX BLACK;TELEFONIA
4924459;;M;80;CHILENO;;Silencioso;SALAMANCA                     ;COQUIMBO;1823740;7;4;0;0;0;7;4;1823740;CELULAR GALAXY A03 CORE 2GB 32GB BLUE OPEN;TELEFONIA
11145116;;F;54;CHILENO;;Boomers;N/D;N/D;304540;4;3;0;0;0;4;3;304540;CELULAR XIAOMI REDMI 9 MORADO ENTEL;TELEFONIA
8707891;;F;61;CHILENO;;Boomers;CORONEL                       ;BIO BIO;1304050;11;5;0;0;0;11;5;1304050;CELULAR VIVO V21 5G DUSK BLUE 128GB OPEN;TELEFONIA
15207702;;M;39;CHILENO;;X;LOS ANGELES                   ;BIO BIO;395830;3;2;2;1;165840;1;1;229990;CELULAR MOTO G51 5G 4/128 GB AZUL OPEN;TELEFONIA
10887958;;F;70;CHILENO;;Silencioso;PENALOLEN                     ;METROPOLITANA;339550;3;1;0;0;0;3;1;339550;CELULAR GALAXY A22 5G 4+128GB WHITE;TELEFONIA
19553044;Soltero;F;26;CHILENO;;Z;PROVIDENCIA                   ;METROPOLITANA;103536;3;1;0;0;0;3;1;103536;CELULAR VIVO Y15S WAVE GREEN OPEN;TELEFONIA
5788872;Casado;M;72;CHILENO;TECNICO ELECTRICO;Silencioso;RENCA                         ;METROPOLITANA;150140;2;1;0;0;0;2;1;150140;CELULAR VIVO Y21S 128GB BLANCO WOM;TELEFONIA
7893692;;F;64;CHILENO;;Boomers;VILLARICA                     ;ARAUCANIA;171240;2;1;0;0;0;2;1;171240;CELULAR GALAXY A13 4+128GB LIGHT BLUE OPEN;TELEFONIA
6826716;Soltero;F;70;CHILENO;;Silencioso;PROVIDENCIA                   ;METROPOLITANA;199990;1;1;0;0;0;1;1;199990;CELULAR XIAOMI REDMI NOTE 10 PRO 128GB GRIS WOM;TELEFONIA
6907261;;M;66;CHILENO;;Boomers;PROVIDENCIA                   ;N/D;89376;2;1;0;0;0;2;1;89376;CELULAR VIVO Y15S BLUE MOVISTAR;TELEFONIA
12294001;;F;49;CHILENO;;X;PROVIDENCIA                   ;METROPOLITANA;129990;2;1;0;0;0;2;1;129990;CELULAR REDMI NOTE 11 4/128GB TWILIGHT BLUE OPEN;TELEFONIA
13576111;;M;42;CHILENO;;X;TALCA                         ;MAULE;129990;1;1;0;0;0;1;1;129990;CELULAR VIVO Y15S WAVE GREEN OPEN;TELEFONIA
16663903;;F;34;CHILENO;;Millenial;LA SERENA;COQUIMBO;980;2;1;0;0;0;2;1;980;CHIP OPEN ENTEL;TELEFONIA
16551802;;F;37;CHILENO;;Millenial;RENCA                         ;METROPOLITANA;224700;5;2;0;0;0;5;2;224700;CELULAR POCO M4 PRO 128GB COOL BLUE OPEN;TELEFONIA
17719991;;M;28;CHILENO;;Millenial;CASTRO                        ;LOS LAGOS;179990;1;1;0;0;0;1;1;179990;CELULAR GALAXY A23 6+128GB BLACK OPEN;TELEFONIA
12065472;;M;54;CHILENO;;X;SAN FELIPE                    ;VALPARAISO;359970;3;3;1;1;199990;2;2;159980;CELULAR VIVO Y11S NEBULA BLUE 32GB OPEN;TELEFONIA
13925969;;M;42;CHILENO;;X;PROVIDENCIA                   ;METROPOLITANA;251950;4;2;4;2;251950;0;0;0;CELULAR NOKIA 110 BLACK OPEN;TELEFONIA
15006209;;F;42;CHILENO;;X;PROVIDENCIA                   ;METROPOLITANA;393980;2;1;2;1;393980;0;0;0;IPHONE 11 64GB BLACK CLARO;TELEFONIA
17498653;;M;31;CHILENO;;Millenial;SAN JAVIER                    ;MAULE;922090;15;7;0;0;0;15;7;922090;CELULAR VIVO Y01 AZUL ZAFIRO OPEN;TELEFONIA
5654190;;F;77;CHILENO;;Silencioso;PUERTO MONTT                  ;LOS LAGOS;55610;4;2;0;0;0;4;2;55610;CELULAR ALCATEL P1 DIRECTO CLARO BLACK;TELEFONIA
7737331;;M;60;CHILENO;;Boomers;"";"";139990;1;1;0;0;0;1;1;139990;CELULAR VIVO Y15S BLUE MOVISTAR;TELEFONIA
14020315;;F;41;CHILENO;;X;SAN JAVIER                    ;MAULE;119990;1;1;0;0;0;1;1;119990;CELULAR VIVO Y01 AZUL ZAFIRO OPEN;TELEFONIA
10320958;;M;56;CHILENO;;Boomers;GRANEROS                      ;L.G.B.OÂ´HIGGINS;168580;4;1;0;0;0;4;1;168580;CELULAR GALAXY A13 4+128GB BLACK;TELEFONIA
25637010;;F;38;VENEZOLANO;;Extranjero;LAS CONDES                    ;METROPOLITANA;29990;2;1;0;0;0;2;1;29990;CELULAR SAMSUNG A03 64GB NEGRO WOM;TELEFONIA
7131332;Casado;M;66;CHILENO;;Boomers;N/D;N/D;24990;1;1;0;0;0;1;1;24990;CELULAR ALCATEL P1 DIRECTO CLARO BLACK;TELEFONIA
14710011;;F;49;PERUANO;;Extranjero;CERRO NAVIA                   ;METROPOLITANA;1387949;14;7;0;0;0;14;7;1387949;CELULAR A32 128 GB BLACK OPEN;TELEFONIA
8186147;;M;49;CHILENO;;X;FREIRE                        ;ARAUCANIA;339960;4;6;0;0;0;4;6;339960;CELULAR REDMI NOTE 10 5G 4/128GB GRAPHITE GRAY O;TELEFONIA
14033874;;F;41;CHILENO;;X;TOME                          ;BIO BIO;835970;3;2;3;2;835970;0;0;0;CELULAR XIAOMI REDMI NOTE 10 PRO 128GB GRIS WOM;TELEFONIA
18406971;;F;29;CHILENO;;Millenial;COLINA                        ;METROPOLITANA;24990;1;1;1;1;24990;0;0;0;CELULAR ALCATEL P1 DIRECTO CLARO BLACK;TELEFONIA
8759379;;M;62;CHILENO;;Boomers;QUILPUE                       ;VALPARAISO;291100;2;1;0;0;0;2;1;291100;CELULAR A32 128 GB WHITE OPEN;TELEFONIA
4649086;;M;79;CHILENO;;Silencioso;SAN FERNANDO                  ;L.G.B.OÂ´HIGGINS;110760;2;1;0;0;0;2;1;110760;CELULAR GALAXY A03 CORE 2GB 32GB BLUE OPEN;TELEFONIA
8515957;Casado;F;47;CHILENO;;X;PROVIDENCIA                   ;METROPOLITANA;797960;4;2;4;2;797960;0;0;0;IPHONE 11 64GB BLACK CLARO;TELEFONIA
6945086;;M;68;CHILENO;;Boomers;VILLARICA                     ;ARAUCANIA;589970;3;3;0;0;0;3;3;589970;CELULAR REDMI NOTE 10 5G 4/128GB GRAPHITE GRAY O;TELEFONIA
18677718;Soltero;F;28;CHILENO;;Millenial;PROVIDENCIA                   ;METROPOLITANA;269990;1;1;0;0;0;1;1;269990;CELULAR GALAXY A53 5G 6+128GB BLUE;TELEFONIA
11382079;;F;52;CHILENO;;X;COQUIMBO                      ;COQUIMBO;129990;1;1;0;0;0;1;1;129990;XIAOMI REDMI 9T CARBON GRAY 128GB MOVISTAR;TELEFONIA
18965744;;F;27;CHILENO;;Millenial;PROVIDENCIA                   ;METROPOLITANA;426980;2;1;2;1;426980;0;0;0;CELULAR XIAOMI 11T PRO 8/256GB CELESTIAL BLUE OP;TELEFONIA
19594194;;M;24;CHILENO;;Z;N/D;N/D;176240;2;1;0;0;0;2;1;176240;CELULAR XIAOMI REDMI 9C 64GB GRAY WOM;TELEFONIA
23506975;;M;52;HAITIANO;;Extranjero;HUECHURABA                    ;METROPOLITANA;79990;2;1;0;0;0;2;1;79990;CELULAR XIAOMI REDMI 9A 2/32GB GRANITE GRAY;TELEFONIA
9169242;;M;59;CHILENO;;Boomers;SALAMANCA                     ;COQUIMBO;495960;4;3;0;0;0;4;3;495960;CELULAR GALAXY A13 4+128GB BLACK;TELEFONIA
17145406;Soltero;M;33;CHILENO;TECNICO EN INFORMATICA;Millenial;RENCA                         ;METROPOLITANA;864970;3;1;3;1;864970;0;0;0;CELULAR GALAXY S22 ULTRA BLACK 128GB;TELEFONIA
14071013;;F;45;CHILENO;;X;CURANILAHUE                   ;BIO BIO;1305920;11;6;2;1;407980;9;5;897940;IPHONE 11 64GB BLACK CLARO;TELEFONIA
14451380;;M;47;CHILENO;;X;SAN FELIPE                    ;VALPARAISO;74990;2;1;0;0;0;2;1;74990;CELULAR SAMSUNG A03 128GB BLACK CLARO;TELEFONIA
7539379;;M;64;CHILENO;;Boomers;PUQUELDON                     ;LOS LAGOS;125980;2;2;0;0;0;2;2;125980;CELULAR REDMI 10A US 32GB CHROME SILVER OPEN;TELEFONIA
4725830;;F;83;CHILENO;;Silencioso;TALCAHUANO                    ;BIO BIO;356120;4;4;0;0;0;4;4;356120;CELUALAR REDMI NOTE 11 PRO US 6GB+128GB STAR BLU;TELEFONIA
9957800;;M;58;CHILENO;;Boomers;NIQUEN                        ;BIO BIO;243360;4;1;0;0;0;4;1;243360;CELULAR XIAOMI REDMI 9A 32GB VERDE CLARO;TELEFONIA
9782775;;F;59;CHILENO;;Boomers;PORTEZUELO                    ;NUBLE;149980;3;1;0;0;0;3;1;149980;CELULAR RENO5 LITE NEGRO 128GB;TELEFONIA
10866705;Soltero;M;50;CHILENO;;X;RIO IBANEZ                    ;AYSEN;169990;1;1;0;0;0;1;1;169990;CELULAR A32 128 GB BLACK OPEN;TELEFONIA
18860382;;F;26;CHILENO;;Z;LAMPA                         ;METROPOLITANA;467940;6;3;6;3;467940;0;0;0;CELULAR REDMI NOTE 10 5G 4/128GB GRAPHITE GRAY O;TELEFONIA
9621739;;F;63;CHILENO;;Boomers;RENCA                         ;METROPOLITANA;58710;2;1;0;0;0;2;1;58710;CELULAR BMOBILE C40 CRIS OPEN;TELEFONIA
18274455;Soltero;M;29;CHILENO;;Millenial;PROVIDENCIA                   ;METROPOLITANA;212960;4;2;4;2;212960;0;0;0;CELULAR REDMI NOTE 10 5G 4/128GB GRAPHITE GRAY O;TELEFONIA
14347740;;M;42;CHILENO;;X;ILLAPEL                       ;COQUIMBO;216980;3;2;0;0;0;3;2;216980;CELULAR A32 128 GB BLUE OPEN;TELEFONIA
13002226;;M;45;CHILENO;;X;CHONCHI                       ;LOS LAGOS;1357040;7;5;4;2;447070;3;3;909970;CELULAR MI 11 LITE 128GB BOBA BLACK OPEN;TELEFONIA
18382665;Soltero;M;28;CHILENO;;Millenial;LIMACHE                       ;VALPARAISO;866950;5;2;3;1;865970;2;1;980;CELULAR GALAXY S22 ULTRA BURGUNDY 128GB;TELEFONIA
7083043;;M;69;CHILENO;;Silencioso;COIHAIQUE                     ;AYSEN;279980;2;2;0;0;0;2;2;279980;CELULAR GALAXY A23 6+128GB BLACK OPEN;TELEFONIA
8872486;;M;58;CHILENO;;Boomers;RENCA                         ;METROPOLITANA;404960;4;4;3;3;394970;1;1;9990;CELULAR XIAOMI REDMI 9A 32GB VERDE CLARO;TELEFONIA
19604112;;M;25;CHILENO;;Z;PROVIDENCIA                   ;METROPOLITANA;634530;3;2;3;2;634530;0;0;0;CELULAR GALAXY A73 5G 256GB GRAY OPEN;TELEFONIA
13622179;Casado;M;43;CHILENO;;X;PROVIDENCIA                   ;METROPOLITANA;175980;2;1;2;1;175980;0;0;0;CELULAR A52 128 GB LIGHT VIOLET OPEN;TELEFONIA
19249721;;F;26;CHILENO;;Extranjero;"";"";118200;2;1;0;0;0;2;1;118200;CELULAR REDMI 9A 32GB SKY BLUE;TELEFONIA
9371083;;M;58;CHILENO;;Boomers;N/D;N/D;457970;4;3;0;0;0;4;3;457970;CELULAR VIVO Y53S FANTASTIC RAINBOW 128GB OPEN;TELEFONIA
27112525;;M;33;BRASILEÃO;;Extranjero;N/D;N/D;163980;2;1;2;1;163980;0;0;0;CELULAR MOTO G60 4/128 GB SILVER OPEN;TELEFONIA
16881669;;F;34;CHILENO;;Millenial;SAN VICENTE                   ;L.G.B.OÂ´HIGGINS;199980;2;2;1;1;179990;1;1;19990;CELULAR REDMI NOTE 10 PRO 6+128GB GRADIENT BRONZ;TELEFONIA
19679774;;F;29;CHILENO;;Millenial;PROVIDENCIA                   ;METROPOLITANA;179990;2;1;0;0;0;2;1;179990;CELULAR GALAXY A13 4+128GB LIGHT BLUE OPEN;TELEFONIA
5444625;;F;77;CHILENO;;Silencioso;CORONEL                       ;BIO BIO;632950;5;3;5;3;632950;0;0;0;CELULAR A32 128 GB BLUE OPEN;TELEFONIA
9550756;;M;59;CHILENO;;Boomers;ANGOL                         ;ARAUCANIA;100470;3;3;0;0;0;3;3;100470;CELULAR SAMSUNG A03 CORE 32GB BLACK CLARO;TELEFONIA
19276415;;M;26;CHILENO;;Z;N/D;N/D;129990;1;1;0;0;0;1;1;129990;CELULAR VIVO Y01 AZUL ZAFIRO OPEN;TELEFONIA
19167941;;F;26;CHILENO;;Z;PROVIDENCIA                   ;METROPOLITANA;349980;2;2;1;1;189990;1;1;159990;CELULAR A52 128 GB WHITE OPEN;TELEFONIA
10730099;Casado;F;50;CHILENO;;X;LO BARNECHEA;METROPOLITANA;339980;2;2;2;2;339980;0;0;0;CELULAR GALAXY A53 5G 6+128GB BLUE;TELEFONIA
13152620;;F;45;CHILENO;;X;LOS ALAMOS                    ;BIO BIO;188980;2;2;1;1;169990;1;1;18990;CELULAR A52 128 GB LIGHT VIOLET OPEN;TELEFONIA
6317386;;M;72;CHILENO;;Silencioso;ALTO HOSPICIO;TARAPACA;127870;2;2;0;0;0;2;2;127870;CELULAR XIAOMI REDMI 9A 32GB VERDE CLARO;TELEFONIA
15741360;;F;38;CHILENO;;X;PROVIDENCIA                   ;METROPOLITANA;139980;2;2;1;1;89990;1;1;49990;CELULAR XIAOMI REDMI 9C 64GB GRAY WOM;TELEFONIA
13071886;;F;46;CHILENO;;X;EL BOSQUE                     ;METROPOLITANA;307100;4;2;2;1;78980;2;1;228120;SMARTPHONE A22 BLANCO 128GB;TELEFONIA
12764303;Casado;M;47;CHILENO;;X;RENCA                         ;METROPOLITANA;179990;1;1;0;0;0;1;1;179990;CELULAR MOTO G60 4/128 GB NEGRO OPEN;TELEFONIA
9254180;;F;61;CHILENO;;Boomers;PENALOLEN                     ;METROPOLITANA;39990;1;1;0;0;0;1;1;39990;CELULAR BMOBILE SENIORPHONE C40 GRIS WOM;TELEFONIA
6706833;;M;69;CHILENO;;Silencioso;RENCA                         ;METROPOLITANA;169990;1;1;0;0;0;1;1;169990;CELULAR VIVO Y21S MIDNIGHT BLUE 128 GB OPEN;TELEFONIA
15891816;;M;41;CHILENO;;X;RECOLETA;METROPOLITANA;259990;1;1;1;1;259990;0;0;0;CELULAR GALAXY A53 5G 6+128GB BLACK;TELEFONIA
17969554;;F;31;CHILENO;;Millenial;CORONEL                       ;BIO BIO;14990;1;1;1;1;14990;0;0;0;CELULAR AZUMI L4G BLACK CLARO;TELEFONIA
13678603;Soltero;M;43;CHILENO;CONTADOR GENERAL;X;RENCA                         ;METROPOLITANA;243980;2;1;2;1;243980;0;0;0;CELULAR REDMI NOTE 11 PRO 128GB GRAPHITE;TELEFONIA
11320535;Casado;F;53;CHILENO;;X;RENCA                         ;METROPOLITANA;170478;3;2;0;0;0;3;2;170478;CELULAR A54 OPPO NEGRO 128GB;TELEFONIA
17172652;;F;33;CHILENO;;Millenial;CURICO                        ;MAULE;39990;1;1;0;0;0;1;1;39990;CELULAR NOKIA 225 4G BLACK MOVISTAR DIRECTO;TELEFONIA
16234429;;F;36;CHILENO;;Silencioso;PROVIDENCIA                   ;METROPOLITANA;129990;1;1;1;1;129990;0;0;0;CELULAR MOTO G20 EDICION ESPECIAL 4/128 GB AZUL;TELEFONIA
18096988;;M;30;CHILENO;;Silencioso;PROVIDENCIA                   ;METROPOLITANA;569990;1;1;1;1;569990;0;0;0;CELULAR IPHONE 12 64GB BLACK CLARO;TELEFONIA
11925383;;F;50;CHILENO;;X;SAN FELIPE                    ;VALPARAISO;236980;2;2;0;0;0;2;2;236980;CELULAR REDMI NOTE 11 PRO 128GB GRAPHITE;TELEFONIA
18995756;;M;26;CHILENO;;Z;TRAIGUEN                      ;ARAUCANIA;229980;2;4;0;0;0;2;4;229980;CELULAR REDMI NOTE 11 4/128GB TWILIGHT BLUE OPEN;TELEFONIA
14297722;;M;46;CHILENO;;X;LOS ALAMOS                    ;BIO BIO;375650;4;3;0;0;0;4;3;375650;CELULAR A32 128 GB BLACK OPEN;TELEFONIA
11419483;;F;53;CHILENO;;X;CANETE                        ;BIO BIO;681500;6;3;0;0;0;6;3;681500;CELULAR SAMSUNG A03 128GB BLACK CLARO;TELEFONIA
15116766;;M;37;CHILENO;;Millenial;MELIPILLA                     ;METROPOLITANA;198980;2;2;0;0;0;2;2;198980;CELULAR GALAXY A13 4+128GB LIGHT BLUE OPEN;TELEFONIA
18519817;Soltero;M;28;CHILENO;;Millenial;PROVIDENCIA                   ;METROPOLITANA;159990;1;1;1;1;159990;0;0;0;CELULAR REDMI NOTE 10 5G 4/128GB GRAPHITE GRAY O;TELEFONIA
14197854;;F;40;CHILENO;;X;MAIPU;METROPOLITANA;143980;2;1;2;1;143980;0;0;0;CELULAR A32 128 GB LIGHT VIOLET OPEN;TELEFONIA
11447590;;M;53;CHILENO;;X;CHILLAN                       ;BIO BIO;159990;1;1;0;0;0;1;1;159990;CELULAR VIVO Y21S 128GB BLANCO WOM;TELEFONIA
10158809;Casado;F;58;CHILENO;TECNICO EN LABORATORIO CLINICO;Boomers;RENCA                         ;METROPOLITANA;189990;1;1;1;1;189990;0;0;0;CELULAR A52 128 GB BLACK OPEN;TELEFONIA
12301878;;F;49;CHILENO;;X;"";"";159990;1;1;1;1;159990;0;0;0;CELULAR REDMI NOTE 11 4/128GB TWILIGHT BLUE OPEN;TELEFONIA
13584367;;M;42;CHILENO;;X;PROVIDENCIA                   ;METROPOLITANA;303980;2;1;2;1;303980;0;0;0;CELULAR POCO F3 128 GB NIGHT BLACK;TELEFONIA
24974987;;M;40;CUBANO;;Extranjero;SANTIAGO                      ;METROPOLITANA;599980;4;2;0;0;0;4;2;599980;CELULAR SMARTPHONE A52S 5G BLACK 128GB;TELEFONIA
17462481;;F;32;CHILENO;;Millenial;"";"";169990;1;1;0;0;0;1;1;169990;CELULAR GALAXY A13 4+128GB BLACK;TELEFONIA
8210265;;F;60;CHILENO;;Boomers;ARICA                         ;ARICA Y PARINACOTA;857950;6;5;0;0;0;6;5;857950;CELULAR GALAXY S20 FE 5G 128GB BLUE OPEN;TELEFONIA
7008463;;M;68;CHILENO;;Silencioso;TOCOPILLA                     ;ANTOFAGASTA;1018010;9;6;0;0;0;9;6;1018010;CELULAR GALAXY A03 CORE 2GB 32GB BLUE OPEN;TELEFONIA
8799251;;F;58;CHILENO;;Boomers;RENCA                         ;METROPOLITANA;214010;2;1;0;0;0;2;1;214010;CELULAR POCO M3 PRO 5G 128GB COOL BLUE;TELEFONIA
11906360;;M;50;CHILENO;;X;LAUTARO                       ;ARAUCANIA;305530;3;2;0;0;0;3;2;305530;CELULAR MOTOROLA E30 GRIS CLARO;TELEFONIA
16091917;;M;37;CHILENO;;Millenial;HUECHURABA                    ;METROPOLITANA;99990;1;1;0;0;0;1;1;99990;CELULAR REDMI 10A US 32GB CHROME SILVER OPEN;TELEFONIA
25020690;Casado;M;34;CUBANO;;Extranjero;"";"";223980;2;1;2;1;223980;0;0;0;CELULAR SAMSUNG A52s 128GB BLACK CLARO;TELEFONIA
25749202;;M;31;HAITIANO;;Extranjero;N/D;N/D;199990;1;1;0;0;0;1;1;199990;CELULAR REDMI NOTE 11 PRO 128GB WHITE;TELEFONIA
26153348;;M;29;HAITIANO;;Extranjero;N/D;N/D;380970;4;2;0;0;0;4;2;380970;CELULAR A32 128 GB BLACK OPEN;TELEFONIA
19739467;;M;25;CHILENO;;Z;PROVIDENCIA                   ;METROPOLITANA;143980;2;1;2;1;143980;0;0;0;CELULAR A32 128 GB LIGHT VIOLET OPEN;TELEFONIA
15267728;;M;41;CHILENO;;X;PROVIDENCIA                   ;METROPOLITANA;139990;1;1;1;1;139990;0;0;0;CELULAR A32 128 GB BLACK OPEN;TELEFONIA
7580234;Casado;F;68;CHILENO;;Boomers;ARICA                         ;ARICA Y PARINACOTA;24990;1;1;0;0;0;1;1;24990;CELULAR ALCATEL P1 DIRECTO CLARO BLACK;TELEFONIA
18880373;;F;28;CHILENO;;Millenial;PROVIDENCIA                   ;METROPOLITANA;173980;2;1;2;1;173980;0;0;0;CELULAR A52 128 GB BLACK OPEN;TELEFONIA
8674698;Soltero;M;62;CHILENO;;Boomers;PROVIDENCIA                   ;METROPOLITANA;19990;2;1;0;0;0;2;1;19990;CELULAR REDMI 9A 32GB SKY BLUE;TELEFONIA
12173472;;F;49;CHILENO;;X;CALERA                        ;VALPARAISO;202980;3;2;0;0;0;3;2;202980;CELULAR GALAXY A22 5G 4+128GB GRAY;TELEFONIA
7767144;;M;63;CHILENO;;Boomers;CALERA                        ;VALPARAISO;700030;6;3;4;2;456960;2;1;243070;CELULAR VIVO Y01 AZUL ZAFIRO OPEN;TELEFONIA
15772931;;F;38;CHILENO;;X;N/D;N/D;334980;2;2;0;0;0;2;2;334980;VIVO Y53S DEEP SEA BLUE 128GB OPEN;TELEFONIA
15908442;Soltero;M;37;CHILENO;ABOGADO;Millenial;LA SERENA                     ;COQUIMBO;980;2;1;0;0;0;2;1;980;CHIP OPEN ENTEL;TELEFONIA
7506560;;F;64;CHILENO;;Boomers;PAINE                         ;METROPOLITANA;385520;4;2;0;0;0;4;2;385520;CELULAR VIVO Y01 AZUL ZAFIRO OPEN;TELEFONIA
19315282;;F;26;CHILENO;;Z;N/D;N/D;482940;6;3;6;3;482940;0;0;0;CELULAR REDMI NOTE 11 4/128GB GRAPHITE GRAY OPEN;TELEFONIA
11576549;;F;52;CHILENO;;X;PROVIDENCIA                   ;METROPOLITANA;139990;1;1;1;1;139990;0;0;0;CELULAR A32 128 GB BLACK OPEN;TELEFONIA
26151924;;M;26;COLOMBIANO;;Extranjero;"";"";283980;2;1;2;1;283980;0;0;0;CELULAR GALAXY A53 5G 6+128GB BLACK;TELEFONIA
9855235;;F;56;CHILENO;;Boomers;QUILLOTA                      ;VALPARAISO;418527;7;4;0;0;0;7;4;418527;SMARTPHONE A03S NEGRO 32GB;TELEFONIA
11700025;;F;51;CHILENO;;X;LOS ALAMOS                    ;BIO BIO;1037890;11;8;0;0;0;11;8;1037890;CELULAR MOTO G50 AZUL 128 GB OPEN;TELEFONIA
15834587;;F;38;CHILENO;;Millenial;PROVIDENCIA                   ;METROPOLITANA;39990;1;1;1;1;39990;0;0;0;CELULAR BMOBILE SENIORPHONE C40 GRIS WOM;TELEFONIA
14180345;;M;47;CHILENO;;X;PUENTE ALTO                   ;METROPOLITANA;430130;4;2;0;0;0;4;2;430130;CELULAR VIVO Y53S FANTASTIC RAINBOW 128GB OPEN;TELEFONIA
13560091;;F;42;CHILENO;;X;"";"";267950;5;3;4;2;127960;1;1;139990;CELULAR GALAXY A13 4+128GB LIGHT BLUE OPEN;TELEFONIA
5332367;;F;82;CHILENO;;Silencioso;N/D;N/D;1883210;17;7;1;1;34990;16;6;1848220;IPHONE 13 128GB ROSADO CLARO;TELEFONIA
12618545;;M;48;CHILENO;;X;N/D;N/D;921629;9;5;0;0;0;9;5;921629;CELULAR GALAXY A03 64GB BLACK DIRECTO MOVISTAR;TELEFONIA
19195588;;M;26;CHILENO;;Z;SAN PEDRO DE LA PAZ           ;BIO BIO;429990;2;1;0;0;0;2;1;429990;SMARTPHONE RENO 6 STELLAR BLACK 128GB;TELEFONIA
7528076;;F;67;CHILENO;;Boomers;OVALLE                        ;COQUIMBO;169990;1;1;0;0;0;1;1;169990;CELULAR VIVO Y21S 128GB BLANCO WOM;TELEFONIA
11638958;;F;52;CHILENO;;X;PROVIDENCIA                   ;METROPOLITANA;799940;10;5;0;0;0;10;5;799940;CELULAR REDMI NOTE 11 4/128GB TWILIGHT BLUE OPEN;TELEFONIA
15197379;;F;40;CHILENO;;X;CURANILAHUE                   ;BIO BIO;989960;4;3;0;0;0;4;3;989960;CELULAR A52 128 GB BLUE OPEN;TELEFONIA
8350389;Soltero;F;62;CHILENO;;Silencioso;PROVIDENCIA                   ;METROPOLITANA;148770;2;1;0;0;0;2;1;148770;CELULAR REDMI 9C 64GB SUNRISE ORANGE;TELEFONIA
5217564;;M;78;CHILENO;;Silencioso;RENCA                         ;METROPOLITANA;56000;2;1;0;0;0;2;1;56000;Celular SA3 CLARO DIRECTO BLACK;TELEFONIA
21392784;;F;54;PERUANO;;Extranjero;SAN BERNARDO                  ;METROPOLITANA;328520;6;1;0;0;0;6;1;328520;CELULAR A52 128 GB BLACK OPEN;TELEFONIA
15118260;;F;39;CHILENO;;X;SAN FERNANDO                  ;L.G.B.OÂ´HIGGINS;179990;1;1;0;0;0;1;1;179990;CELULAR MOTO G60 4/128 GB NEGRO OPEN;TELEFONIA
12964243;;M;45;CHILENO;;X;SAN JAVIER                    ;MAULE;220410;4;3;0;0;0;4;3;220410;CELULAR REDMI 9C 64GB SUNRISE ORANGE;TELEFONIA
10967184;;F;53;CHILENO;;X;LAJA                          ;BIO BIO;99880;2;1;0;0;0;2;1;99880;CELULAR Moto E7 Rosado WOM;TELEFONIA
13772766;;F;42;CHILENO;;X;SAN PEDRO                     ;METROPOLITANA;351970;3;2;0;0;0;3;2;351970;CELULAR A32 128 GB BLACK OPEN;TELEFONIA
9062293;;M;61;CHILENO;;Boomers;NUEVA IMPERIAL                ;ARAUCANIA;180129;4;3;0;0;0;4;3;180129;CELULAR GALAXY A03 4+128GB BLUE OPEN;TELEFONIA
19504240;;F;25;CHILENO;;Z;TALAGANTE;METROPOLITANA;169990;1;1;0;0;0;1;1;169990;CELULAR A54 OPPO NEGRO 128GB;TELEFONIA
8353655;;M;65;CHILENO;;Boomers;SAN ANTONIO                   ;VALPARAISO;559809;4;2;0;0;0;4;2;559809;CELULAR GALAXY A53 5G 6+128GB BLUE;TELEFONIA
15847366;;F;42;CHILENO;;X;PUERTO MONTT                  ;LOS LAGOS;167410;7;4;0;0;0;7;4;167410;CELULAR SAMSUNG A03 CORE 32GB BLACK CLARO;TELEFONIA
6269545;;F;73;CHILENO;;Silencioso;CURICO                        ;MAULE;469990;2;1;0;0;0;2;1;469990;CELULAR XIAOMI 11T PRO 8/256GB CELESTIAL BLUE OP;TELEFONIA
13395385;;M;48;CHILENO;;X;PROVIDENCIA                   ;METROPOLITANA;139990;1;1;0;0;0;1;1;139990;CELULAR GALAXY A13 4+128GB LIGHT BLUE OPEN;TELEFONIA
20117567;;F;23;CHILENO;;Z;PROVIDENCIA                   ;METROPOLITANA;139990;1;1;1;1;139990;0;0;0;CELULAR A32 128 GB BLACK OPEN;TELEFONIA
18162454;;M;29;CHILENO;;Millenial;SAN ANTONIO                   ;VALPARAISO;360130;3;2;0;0;0;3;2;360130;CELULAR REDMI NOTE 10 5G US 128G NIGHTTIME BLUE;TELEFONIA
12947172;;M;46;CHILENO;;X;N/D;N/D;190970;3;2;0;0;0;3;2;190970;CELULAR REDMI 9A 32GB SKY BLUE;TELEFONIA
15462949;;F;39;CHILENO;;X;PROVIDENCIA                   ;METROPOLITANA;139990;1;1;0;0;0;1;1;139990;CELULAR VIVO Y20S NEBULA 128 GB BLUE OPEN;TELEFONIA
7346879;;M;66;CHILENO;;Boomers;RENCA                         ;METROPOLITANA;33990;1;1;0;0;0;1;1;33990;Celular SA3 CLARO DIRECTO BLACK;TELEFONIA
18571249;Soltero;F;28;CHILENO;;Silencioso;PROVIDENCIA                   ;METROPOLITANA;269980;2;1;2;1;269980;0;0;0;CELULAR GALAXY A53 5G 6+128GB BLUE;TELEFONIA
16379638;;F;36;CHILENO;;Millenial;PICHIDEGUA                    ;L.G.B.OÂ´HIGGINS;519510;5;3;5;3;519510;0;0;0;CELULAR AZUMI L4G BLACK CLARO;TELEFONIA
12794021;;F;46;CHILENO;;X;PROVIDENCIA                   ;METROPOLITANA;459980;2;1;2;1;459980;0;0;0;IPHONE 11 64GB BLACK CLARO;TELEFONIA
7468755;;F;68;CHILENO;;Silencioso;N/D;N/D;30350;2;1;0;0;0;2;1;30350;CELULAR AZUMI L4G BLACK CLARO;TELEFONIA
18708168;Soltero;M;28;CHILENO;PROFESOR;Millenial;PROVIDENCIA                   ;METROPOLITANA;143980;2;1;2;1;143980;0;0;0;CELULAR REDMI NOTE 10 5G 4/128GB GRAPHITE GRAY O;TELEFONIA
13407442;;M;44;CHILENO;;X;CALBUCO                       ;LOS LAGOS;209970;3;1;0;0;0;3;1;209970;CELULAR MOTOROLA E30 GRIS CLARO;TELEFONIA
20357369;;M;21;CHILENO;;Z;TEMUCO                        ;ARAUCANIA;119990;1;1;0;0;0;1;1;119990;CELULAR VIVO Y01 AZUL ZAFIRO OPEN;TELEFONIA
18400968;Soltero;M;29;CHILENO;;Millenial;N/D;N/D;144990;2;1;0;0;0;2;1;144990;CELULAR MOTO G60 4/128 GB SILVER OPEN;TELEFONIA
11743729;Casado;M;51;CHILENO;;X;RENCA                         ;METROPOLITANA;818220;45;14;39;12;668280;6;2;149940;CELULAR NOKIA 110 BLACK OPEN;TELEFONIA
17324013;Soltero;M;32;CHILENO;;Millenial;LOS LAGOS                     ;LOS LAGOS;339980;23;3;0;0;0;23;3;339980;PRODUCTO 2 SELECCION BANDA 2;TELEFONIA
16297818;;F;36;CHILENO;;Millenial;OSORNO;LOS LAGOS;174620;2;1;0;0;0;2;1;174620;CELULAR MOTOROLA MOTO G20 64GB ROSA FLAMINGO;TELEFONIA
13133456;;M;45;CHILENO;;X;PEUMO                         ;L.G.B.OÂ´HIGGINS;169990;1;1;1;1;169990;0;0;0;CELULAR A52 128 GB WHITE OPEN;TELEFONIA
6103675;;F;72;CHILENO;;Silencioso;LA LIGUA                      ;VALPARAISO;252980;2;1;0;0;0;2;1;252980;CELULAR SAMSUN A52 128GB NEGRO WOM;TELEFONIA
16619778;;M;34;CHILENO;;Millenial;PROVIDENCIA                   ;METROPOLITANA;169990;1;1;1;1;169990;0;0;0;CELULAR REDMI NOTE 11 4/128GB TWILIGHT BLUE OPEN;TELEFONIA
20300643;;M;22;CHILENO;;Silencioso;PROVIDENCIA                   ;METROPOLITANA;39990;1;1;1;1;39990;0;0;0;CELULAR BMOBILE C40 CRIS OPEN;TELEFONIA
12630539;Casado;M;48;CHILENO;INGENIERO ELECTRONICO;X;RENCA                         ;METROPOLITANA;389990;1;1;1;1;389990;0;0;0;CELULAR XIAOMI 11T PRO 8/256GB MOON WHITE;TELEFONIA
18623500;;M;28;CHILENO;;Millenial;N/D;N/D;223280;2;1;0;0;0;2;1;223280;CELULAR A52 128 GB WHITE OPEN;TELEFONIA
21701988;;F;43;PERUANO;;Extranjero;RECOLETA                      ;METROPOLITANA;193980;2;1;2;1;193980;0;0;0;CELULAR POCO M4 PRO 128GB POWER BLACK OPEN;TELEFONIA
19872364;;M;23;CHILENO;;Z;ARICA                         ;ARICA Y PARINACOTA;244990;2;1;0;0;0;2;1;244990;CELULAR REDMI NOTE 11 PRO 128GB GRAPHITE;TELEFONIA
17761559;;F;31;CHILENO;;Millenial;PENALOLEN;METROPOLITANA;867950;6;3;6;3;867950;0;0;0;CELULAR GALAXY S20FE 128GB ClOUD NAVY OPEN;TELEFONIA
16077945;;M;36;CHILENO;;Millenial;N/D;N/D;236990;2;1;0;0;0;2;1;236990;CELULAR REDMI NOTE 10 5G 4/128GB GRAPHITE GRAY O;TELEFONIA
15137826;;M;41;CHILENO;;X;HUASCO                        ;ATACAMA;114990;1;1;0;0;0;1;1;114990;CELULAR VIVO Y15S WAVE GREEN OPEN;TELEFONIA
16027266;;F;37;CHILENO;;Millenial;PROVIDENCIA                   ;METROPOLITANA;899990;3;1;3;1;899990;0;0;0;CELULAR GALAXY S22 ULTRA BURGUNDY 128GB;TELEFONIA
6165873;Casado;F;69;CHILENO;;Silencioso;PROVIDENCIA                   ;METROPOLITANA;79990;2;1;0;0;0;2;1;79990;CELULAR XIAOMI REDMI 9A 2/32GB GRANITE GRAY;TELEFONIA
16183596;;M;39;CHILENO;;X;VICUNA                        ;COQUIMBO;990;3;1;0;0;0;3;1;990;CHIP OPEN ENTEL;TELEFONIA
19447422;;F;25;CHILENO;;Z;CALERA                        ;VALPARAISO;688920;9;8;0;0;0;9;8;688920;CELULAR REDMI NOTE 11 4/128GB TWILIGHT BLUE OPEN;TELEFONIA
9475076;Casado;F;48;CHILENO;;X;PROVIDENCIA                   ;METROPOLITANA;143980;2;1;2;1;143980;0;0;0;CELULAR REDMI NOTE 10 5G 4/128GB GRAPHITE GRAY O;TELEFONIA
13964915;;F;41;CHILENO;;X;VILLARICA                     ;ARAUCANIA;159990;1;1;0;0;0;1;1;159990;CELULAR VIVO Y21S MIDNIGHT BLUE 128 GB OPEN;TELEFONIA
15598040;;F;38;CHILENO;;X;N/D;N/D;239981;3;2;0;0;0;3;2;239981;CELULAR GALAXY A03 CORE 2GB 32GB BLACK OPEN;TELEFONIA
25390693;;F;60;COLOMBIANO;;Extranjero;N/D;N/D;406970;7;2;0;0;0;7;2;406970;CELULAR VIVO Y21S PEARL WHITE 128 GB OPEN;TELEFONIA
6494384;;M;68;CHILENO;;Boomers;SAN FELIPE                    ;VALPARAISO;69990;1;1;0;0;0;1;1;69990;CELULAR GALAXY A03 CORE 2GB 32GB BLACK OPEN;TELEFONIA
12963326;;M;46;CHILENO;;X;PARRAL                        ;MAULE;246881;4;2;0;0;0;4;2;246881;CELULAR VIVO Y11S PHANTON BLACK 32GB MOVISTAR;TELEFONIA
14469277;;F;48;CHILENO;;X;RENCA                         ;METROPOLITANA;169990;1;1;1;1;169990;0;0;0;CELULAR GALAXY A22 5G 4+128GB MINT;TELEFONIA
18788933;;M;28;CHILENO;;Millenial;PROVIDENCIA                   ;METROPOLITANA;893960;4;4;4;4;893960;0;0;0;CELULAR REDMI NOTE 11 4/128GB GRAPHITE GRAY OPEN;TELEFONIA
16902019;;F;34;CHILENO;;Millenial;"";"";821590;11;8;0;0;0;11;8;821590;CELULAR BMOBILE C40 CRIS OPEN;TELEFONIA
19085646;;F;26;CHILENO;;Z;PROVIDENCIA                   ;METROPOLITANA;168980;2;1;2;1;168980;0;0;0;CELULAR REDMI NOTE 10 5G 4/128GB GRAPHITE GRAY O;TELEFONIA
10489389;;M;63;CHILENO;;Boomers;N/D;N/D;27993;1;1;0;0;0;1;1;27993;CELULAR BMOBILE C40 CRIS OPEN;TELEFONIA
20621479;;F;21;CHILENO;;Z;"";"";980;2;1;0;0;0;2;1;980;CHIP OPEN ENTEL;TELEFONIA
17931237;;M;31;CHILENO;;Millenial;VILCUN                        ;ARAUCANIA;59880;3;1;0;0;0;3;1;59880;CELULAR XIAOMI REDMI 9A 2/32GB GRANITE GRAY;TELEFONIA
17362927;;M;32;CHILENO;;Millenial;COQUIMBO;COQUIMBO;148868;4;2;0;0;0;4;2;148868;CELULAR MOTO ONE FUSION 128GB AZUL OPEN;TELEFONIA
15842315;;F;37;CHILENO;;Silencioso;PROVIDENCIA                   ;METROPOLITANA;279990;1;1;1;1;279990;0;0;0;CELULAR GALAXY A53 5G 6+128GB BLUE;TELEFONIA
9663985;Casado;M;55;CHILENO;ARQUITECTO;Boomers;PROVIDENCIA                   ;METROPOLITANA;249990;1;1;1;1;249990;0;0;0;CELULAR SMARTPHONE A52S 5G LIGHT GREEN 128GB;TELEFONIA
24891287;Soltero;F;49;COLOMBIANO;;Extranjero;PROVIDENCIA                   ;METROPOLITANA;219990;1;1;1;1;219990;0;0;0;CELULAR SAMSUNG A52s 128GB BLACK CLARO;TELEFONIA
9303235;;M;60;CHILENO;;Boomers;RENCA                         ;METROPOLITANA;856980;2;1;2;1;856980;0;0;0;IPHONE 13 PRO 128GB SILVER CLARO;TELEFONIA
16701211;;M;34;CHILENO;;Millenial;CABILDO                       ;VALPARAISO;119990;2;1;0;0;0;2;1;119990;CELULAR VIVO Y01 AZUL ZAFIRO OPEN;TELEFONIA
10882625;;F;54;CHILENO;;X;N/D;N/D;305970;4;2;0;0;0;4;2;305970;CELULAR GALAXY A22 5G 4+128GB GRAY;TELEFONIA
15659542;;F;38;CHILENO;;Millenial;CURANILAHUE                   ;BIO BIO;109980;2;2;0;0;0;2;2;109980;CELULAR GALAXY A03 CORE 2GB 32GB BLACK OPEN;TELEFONIA
15679215;;M;38;CHILENO;;Millenial;PROVIDENCIA                   ;METROPOLITANA;259990;1;1;1;1;259990;0;0;0;CELULAR GALAXY A53 5G 6+128GB ORANGE;TELEFONIA
11560745;;F;52;CHILENO;;X;PROVIDENCIA                   ;METROPOLITANA;288110;4;2;0;0;0;4;2;288110;CELULAR VIVO Y01 AZUL ZAFIRO OPEN;TELEFONIA
9101745;;F;78;CHILENO;;Silencioso;DALCAHUE                      ;LOS LAGOS;129820;7;2;0;0;0;7;2;129820;CELULAR SAMSUNG A03 CORE 32GB BLACK CLARO;TELEFONIA
16205072;Casado;M;36;CHILENO;;Millenial;PROVIDENCIA                   ;METROPOLITANA;2007930;7;2;7;2;2007930;0;0;0;IPHONE 11 64GB BLACK CLARO;TELEFONIA
10504175;;F;56;CHILENO;;Boomers;PARRAL                        ;MAULE;169990;2;1;0;0;0;2;1;169990;CELULAR REDMI NOTE 11 4/128GB TWILIGHT BLUE OPEN;TELEFONIA
15461656;;F;39;CHILENO;;X;SAN BERNARDO                  ;METROPOLITANA;163860;4;3;0;0;0;4;3;163860;CELULAR XIAOMI REDMI 9A 32GB GRANITE GRAY TRI WO;TELEFONIA
15028942;;M;36;CHILENO;;Millenial;ILLAPEL                       ;COQUIMBO;489990;2;1;0;0;0;2;1;489990;CELULAR SAMSUNG S21 FE 128GB LIGHT GREEN OPEN;TELEFONIA
18793875;Soltero;F;27;CHILENO;;Z;PROVIDENCIA                   ;METROPOLITANA;388980;2;1;2;1;388980;0;0;0;IPHONE 11 64GB BLACK CLARO;TELEFONIA
19575208;;F;25;CHILENO;;Z;N/D;N/D;219990;2;1;0;0;0;2;1;219990;CELULAR XIAOMI 11 LITE 5G NE 6/128GB BUBBLEGUM;TELEFONIA
17244997;Soltero;F;32;CHILENO;;Millenial;PROVIDENCIA                   ;METROPOLITANA;0;0;2;0;0;0;0;2;0;SMARTPHONE A52S 5G WHITE 128GB;TELEFONIA
13428188;Soltero;M;43;CHILENO;;X;PROVIDENCIA                   ;METROPOLITANA;149990;1;1;1;1;149990;0;0;0;CELULAR GALAXY A22 5G 4+128GB WHITE;TELEFONIA
11417681;;F;52;CHILENO;;X;CONCEPCION                    ;BIO BIO;189620;4;2;0;0;0;4;2;189620;SMARTPHONE A03s 64 GB Red DS;TELEFONIA
8871018;;M;62;CHILENO;;Boomers;LOS ALAMOS                    ;BIO BIO;116490;4;2;0;0;0;4;2;116490;CELULAR NOKIA 225 4G BLACK MOVISTAR DIRECTO;TELEFONIA
7530590;;M;67;CHILENO;;Boomers;RENCA                         ;METROPOLITANA;69990;1;1;1;1;69990;0;0;0;CELULAR GALAXY A03 CORE 2GB 32GB BLACK OPEN;TELEFONIA
19076106;;M;27;CHILENO;;Extranjero;QUEILEN                       ;LOS LAGOS;149990;1;1;0;0;0;1;1;149990;CELULAR REDMI NOTE 10 5G 4/128GB GRAPHITE GRAY O;TELEFONIA
26228273;;M;48;EXTRANJERO - NO INFORMA NACIONALIDAD;;Extranjero;SAN FELIPE                    ;VALPARAISO;379970;3;2;0;0;0;3;2;379970;CELULAR GALAXY A03 64GB BLACK DIRECTO MOVISTAR;TELEFONIA
26419040;Soltero;F;33;NO INFORMA NACIONALIDAD;;Extranjero;PROVIDENCIA                   ;METROPOLITANA;159990;1;1;1;1;159990;0;0;0;CELULAR MOTO G60 4/128 GB SILVER OPEN;TELEFONIA
11156760;;M;55;CHILENO;;Boomers;LEBU                          ;BIO BIO;204620;2;1;0;0;0;2;1;204620;CELULAR MOTO G9 POWER 128GB MORADO SONICO OPEN;TELEFONIA
27513925;;M;24;CHILENO;;Extranjero;"";"";169980;2;2;0;0;0;2;2;169980;CELULAR VIVO Y20 BLACK 64GB MOVISTAR;TELEFONIA
5090336;;F;73;CHILENO;;Silencioso;COIHAIQUE                     ;AYSEN;742949;5;4;0;0;0;5;4;742949;CELULAR A32 128 GB BLACK OPEN;TELEFONIA
11121727;;F;54;CHILENO;;Boomers;N/D;N/D;239980;4;1;0;0;0;4;1;239980;SMARTPHONE A22 BLANCO 128GB;TELEFONIA
11317776;;F;54;CHILENO;;X;PROVIDENCIA                   ;METROPOLITANA;203280;2;1;0;0;0;2;1;203280;CELULAR GALAXY A22 5G 4+128GB GRAY;TELEFONIA
12398768;;M;48;CHILENO;;X;ILLAPEL                       ;COQUIMBO;579450;3;2;0;0;0;3;2;579450;CELULAR VIVO Y01 AZUL ZAFIRO OPEN;TELEFONIA
13842072;;F;41;CHILENO;;X;PROVIDENCIA                   ;METROPOLITANA;139990;1;1;1;1;139990;0;0;0;CELULAR A32 128 GB BLUE OPEN;TELEFONIA
13916360;;M;42;CHILENO;;X;RENCA                         ;METROPOLITANA;169990;1;1;1;1;169990;0;0;0;CELULAR A52 128 GB BLUE OPEN;TELEFONIA
14107212;;F;41;CHILENO;;X;N/D;N/D;159990;1;1;1;1;159990;0;0;0;CELULAR A32 128 GB LIGHT VIOLET OPEN;TELEFONIA
18516142;Soltero;M;28;CHILENO;PROFESOR;Millenial;PROVIDENCIA                   ;METROPOLITANA;219990;1;1;1;1;219990;0;0;0;CELULAR POCO X3 PRO 128G PHANTOM BLACK OPEN;TELEFONIA
10858099;;M;55;CHILENO;;Boomers;RENCA                         ;METROPOLITANA;249990;1;1;0;0;0;1;1;249990;CELULAR SMARTPHONE A52S 5G LIGHT GREEN 128GB;TELEFONIA
26856668;;F;40;NO INFORMA NACIONALIDAD;;Extranjero;"";"";199990;1;1;0;0;0;1;1;199990;CELULAR A52 128 GB BLACK OPEN;TELEFONIA
12086160;;M;60;CHILENO;;Boomers;EL MONTE                      ;METROPOLITANA;1803480;10;6;0;0;0;10;6;1803480;CELULAR GALAXY A53 5G 6+128GB BLUE;TELEFONIA
26224858;;F;37;EXTRANJERO - NO INFORMA NACIONALIDAD;ENFERMERAS OS;Extranjero;PROVIDENCIA                   ;METROPOLITANA;173980;2;1;2;1;173980;0;0;0;CELULAR REDMI NOTE 11 4/128GB TWILIGHT BLUE OPEN;TELEFONIA
16461265;Soltero;M;35;CHILENO;;Millenial;RENCA                         ;METROPOLITANA;200980;2;1;2;1;200980;0;0;0;CELULAR HUAWEI Y9A BLACK OPEN;TELEFONIA
17965788;;F;30;CHILENO;;Millenial;N/D;N/D;220000;3;1;0;0;0;3;1;220000;CELULAR A52 128 GB BLUE OPEN;TELEFONIA
11221940;;F;53;CHILENO;;X;SAN FELIPE                    ;VALPARAISO;421960;4;2;0;0;0;4;2;421960;CELULAR XIAOMI REDMI 9A 2/32GB GRANITE GRAY;TELEFONIA
12376659;;M;49;CHILENO;;X;N/D;N/D;274980;3;2;0;0;0;3;2;274980;CELULAR SMARTPHONE A52S 5G LIGHT GREEN 128GB;TELEFONIA
17710804;Casado;F;34;CHILENO;;Millenial;GALVARINO                     ;ARAUCANIA;547040;7;5;0;0;0;7;5;547040;CELULAR VIVO Y20 BLACK 64GB MOVISTAR;TELEFONIA
17594246;;F;32;CHILENO;;Millenial;COIHAIQUE                     ;AYSEN;778230;17;9;17;9;778230;0;0;0;CELULAR A52 128 GB BLUE OPEN;TELEFONIA
13110908;;F;46;CHILENO;;X;N/D;N/D;1784880;12;8;8;5;884920;4;3;899960;CELULAR XIAOMI REDMI 9A 32GB GRANITE GRAY TRI WO;TELEFONIA
13721554;Viudo;F;42;CHILENO;;X;SAN VICENTE                   ;L.G.B.OÂ´HIGGINS;447860;4;2;0;0;0;4;2;447860;CELULAR SAMSUNG GALAXY A03 CORE 32GB NEGRO WOM;TELEFONIA
15204865;;M;40;CHILENO;;X;PROVIDENCIA                   ;METROPOLITANA;289980;2;1;2;1;289980;0;0;0;CELULAR GALAXY A53 5G 6+128GB WHITE;TELEFONIA
7898626;;F;61;CHILENO;;Boomers;PEDRO AGUIRRE CERDA           ;METROPOLITANA;109990;1;1;0;0;0;1;1;109990;SMARTPHONE A03S NEGRO 32GB;TELEFONIA
4701168;;M;78;CHILENO;;Silencioso;RENCA                         ;METROPOLITANA;74990;1;1;0;0;0;1;1;74990;CELULAR XIAOMI REDMI 9A 32GB BLACK DIRECTO CLARO;TELEFONIA
6406153;Casado;M;68;CHILENO;;Boomers;PROVIDENCIA                   ;METROPOLITANA;34990;1;1;0;0;0;1;1;34990;CELULAR NOKIA 225 4G BLACK MOVISTAR DIRECTO;TELEFONIA
19782601;;M;24;CHILENO;;Z;PROVIDENCIA                   ;METROPOLITANA;561380;9;4;3;2;293970;6;2;267410;CELULAR REDMI NOTE 10S 128GB OCEAN BLUE;TELEFONIA
12766747;;M;47;CHILENO;;X;N/D;N/D;24990;1;1;0;0;0;1;1;24990;CELULAR ALCATEL P1 DIRECTO CLARO BLACK;TELEFONIA
19556091;;F;24;CHILENO;;Silencioso;PROVIDENCIA                   ;METROPOLITANA;233970;4;2;4;2;233970;0;0;0;CELULAR A32 128 GB LIGHT VIOLET OPEN;TELEFONIA
16070530;Casado;F;37;CHILENO;;Millenial;PROVIDENCIA                   ;METROPOLITANA;269990;1;1;1;1;269990;0;0;0;CELULAR IPHONE SE 64GB DIRECTO CLARO;TELEFONIA
22835961;;F;73;PERUANO;;Extranjero;SANTIAGO                      ;METROPOLITANA;228970;3;3;0;0;0;3;3;228970;CELULAR A52 128 GB LIGHT VIOLET OPEN;TELEFONIA
11718866;;F;51;CHILENO;;X;CHAITEN                       ;LOS LAGOS;449980;2;2;1;1;149990;1;1;299990;CELULAR REDMI NOTE 11 PRO 128GB GRAPHITE;TELEFONIA
8820956;;M;64;CHILENO;;Boomers;RENCA                         ;METROPOLITANA;96780;2;1;0;0;0;2;1;96780;CELULAR GALAXY A03 CORE 2GB 32GB BLACK OPEN;TELEFONIA
11454163;Soltero;M;54;CHILENO;;X;PROVIDENCIA                   ;METROPOLITANA;303070;2;1;0;0;0;2;1;303070;CELULAR GALAXY A13 4+128GB BLACK;TELEFONIA
12781583;;M;47;CHILENO;;X;SAN VICENTE                   ;L.G.B.OÂ´HIGGINS;199990;1;1;0;0;0;1;1;199990;CELULAR VIVO Y53S FANTASTIC RAINBOW 128GB OPEN;TELEFONIA
19212103;Soltero;M;26;CHILENO;;Z;PROVIDENCIA                   ;METROPOLITANA;1269960;6;3;2;1;299980;4;2;969980;CELULAR REDMI NOTE 11 4/128GB GRAPHITE GRAY OPEN;TELEFONIA
16056508;;M;36;CHILENO;;Millenial;RENCA                         ;METROPOLITANA;187640;2;1;0;0;0;2;1;187640;CELULAR MOTOROLA G20 EDICION ESPECIAL VERDE CLAR;TELEFONIA
18368033;;M;29;CHILENO;;Millenial;N/D;N/D;179990;1;1;0;0;0;1;1;179990;CELULAR A54 OPPO AZUL 128GB;TELEFONIA
18517253;Soltero;M;28;CHILENO;;Silencioso;PROVIDENCIA                   ;METROPOLITANA;18991;2;1;0;0;0;2;1;18991;CELULAR NOKIA 110 BLACK OPEN;TELEFONIA
20315736;;F;22;CHILENO;;Z;PROVIDENCIA                   ;METROPOLITANA;282720;3;2;0;0;0;3;2;282720;CELULAR REDMI NOTE 11 4/128GB TWILIGHT BLUE OPEN;TELEFONIA
12610046;;F;47;CHILENO;;X;IQUIQUE                       ;TARAPACA;498450;7;4;0;0;0;7;4;498450;CELULAR MOTO G20 EDICION ESPECIAL 4/128 GB VERDE;TELEFONIA
11765493;;F;51;CHILENO;;X;MAULE                         ;MAULE;237480;4;2;0;0;0;4;2;237480;CELULAR REDMI 9 64GB CARBON GREY;TELEFONIA
19766965;;M;24;CHILENO;;Z;CAUQUENES                     ;MAULE;651750;3;2;0;0;0;3;2;651750;CELULAR A52 128 GB BLACK OPEN;TELEFONIA
18302792;Soltero;F;32;CHILENO;;Silencioso;PROVIDENCIA                   ;METROPOLITANA;259980;3;2;1;1;209990;2;1;49990;CELULAR GALAXY A03 4+64GB BLUE OPEN;TELEFONIA
13675158;Soltero;F;43;CHILENO;TECNICO;X;RENCA                         ;METROPOLITANA;183980;2;1;2;1;183980;0;0;0;CELULAR REDMI NOTE 11 GRAPHITE GRAY + REDMI BUDS;TELEFONIA
15850416;;M;38;CHILENO;;Millenial;N/D;N/D;199990;1;1;0;0;0;1;1;199990;CELULAR VIVO Y21S PEARL WHITE 128 GB OPEN;TELEFONIA
15436727;;F;40;CHILENO;;X;LA FLORIDA                    ;METROPOLITANA;588970;3;2;2;1;553980;1;1;34990;SMARTPHONE Z FLIP3 GREEN 128GB;TELEFONIA
19145418;;F;26;CHILENO;;Z;PROVIDENCIA                   ;METROPOLITANA;249980;2;1;0;0;0;2;1;249980;CELULAR A52 128 GB LIGHT VIOLET OPEN;TELEFONIA
13589130;;M;43;CHILENO;;X;QUELLON                       ;LOS LAGOS;103980;2;2;0;0;0;2;2;103980;CELULAR VIVO Y11S NEGRO WOM;TELEFONIA
16300444;;F;36;CHILENO;;Millenial;N/D;N/D;206980;2;1;2;1;206980;0;0;0;CELULAR POCO X3 PRO 128G PHANTOM BLACK OPEN;TELEFONIA
15191595;;F;34;CHILENO;;Millenial;"";"";679960;6;5;4;3;499960;2;2;180000;CELULAR VIVO Y15S WAVE GREEN OPEN;TELEFONIA
12464993;;F;48;CHILENO;;X;PROVIDENCIA                   ;METROPOLITANA;115970;3;2;0;0;0;3;2;115970;CELULAR XIAOMI REDMI 9A 2/32GB GRANITE GRAY;TELEFONIA
10267506;;M;56;CHILENO;;Silencioso;PROVIDENCIA                   ;METROPOLITANA;133480;4;2;0;0;0;4;2;133480;CELULAR XIAOMI REDMI 9A 32GB GRANITE GRAY TRI WO;TELEFONIA
25341191;Soltero;M;31;COLOMBIANO;;Extranjero;PROVIDENCIA                   ;METROPOLITANA;339980;2;3;2;3;339980;0;0;0;CELULAR GALAXY A22 5G 4+128GB MINT;TELEFONIA
10299214;;M;53;CHILENO;;X;CONCHALI                      ;METROPOLITANA;110000;2;1;0;0;0;2;1;110000;SMARTPHONE A03S 32 GB ROJO;TELEFONIA
15803498;;F;37;CHILENO;;Millenial;RENCA                         ;METROPOLITANA;109990;1;1;0;0;0;1;1;109990;CELULAR OPPO A15 BLACK 32GB CLARO;TELEFONIA
15448863;;M;39;CHILENO;;X;PROVIDENCIA                   ;METROPOLITANA;143990;1;1;1;1;143990;0;0;0;CELULAR GALAXY A22 5G 4+128GB MINT;TELEFONIA
10597332;Divorciado;F;54;CHILENO;CONTADOR GENERAL;Boomers;PROVIDENCIA                   ;METROPOLITANA;54230;2;1;0;0;0;2;1;54230;CELULAR BMOBILE C40 CRIS OPEN;TELEFONIA
19722518;;F;24;CHILENO;;Z;N/D;N/D;472850;9;4;2;1;108540;7;3;364310;CELULAR VIVO Y20S NEBULA 128 GB BLUE OPEN;TELEFONIA
7328908;;F;66;CHILENO;;Boomers;PUENTE ALTO                   ;METROPOLITANA;1073941;8;3;0;0;0;8;3;1073941;CELULAR VIVO V21 5G DUSK BLUE 128GB OPEN;TELEFONIA
14597558;;M;45;CHILENO;;X;PROVIDENCIA                   ;METROPOLITANA;457700;5;2;0;0;0;5;2;457700;CELULAR VIVO Y21S PEARL WHITE 128 GB OPEN;TELEFONIA
14747408;;F;53;PERUANO;;Extranjero;INDEPENDENCIA                 ;METROPOLITANA;490;1;1;0;0;0;1;1;490;CHIP OPEN ENTEL;TELEFONIA
16637906;Soltero;M;35;CHILENO;;Millenial;RENCA                         ;METROPOLITANA;107640;3;1;0;0;0;3;1;107640;CELULAR MOTO G20 64GB ROSA FLAMINGO OPEN;TELEFONIA
26223455;Soltero;M;35;ECUATORIANO;;Extranjero;"";"";349990;1;1;0;0;0;1;1;349990;CELULAR IPHONE SE 64GB DIRECTO CLARO;TELEFONIA
12186966;;M;53;CHILENO;;X;CHILLAN                       ;BIO BIO;64990;2;1;0;0;0;2;1;64990;CELULAR VIVO Y20S NEBULA 128 GB BLUE OPEN;TELEFONIA
9931802;;M;57;CHILENO;;Boomers;VALLENAR;ATACAMA;680970;3;2;0;0;0;3;2;680970;CELULAR SMARTPHONE A52S 5G LIGHT VIOLET 128GB;TELEFONIA
12387785;;F;51;CHILENO;;X;PROVIDENCIA                   ;METROPOLITANA;85980;2;1;0;0;0;2;1;85980;CELULAR XIAOMI REDMI 9A SE 2/32GB GB PEACOCK GRE;TELEFONIA
10456255;;F;53;CHILENO;;X;CAUQUENES                     ;MAULE;220970;3;2;0;0;0;3;2;220970;CELULAR GALAXY A03 CORE 2GB 32GB BLACK OPEN;TELEFONIA
16499773;;F;35;CHILENO;;Millenial;PROVIDENCIA                   ;METROPOLITANA;199980;2;2;1;1;99990;1;1;99990;CELULAR VIVO Y11S 32 GB NEBULA BLUE WOM;TELEFONIA
10439757;;M;57;CHILENO;;Boomers;CHIMBARONGO                   ;L.G.B.OÂ´HIGGINS;2014920;8;5;0;0;0;8;5;2014920;CELULAR GALAXY A03 64GB BLACK DIRECTO MOVISTAR;TELEFONIA
25363149;;M;25;COLOMBIANO;;Extranjero;ANTOFAGASTA                   ;ANTOFAGASTA;209990;1;1;1;1;209990;0;0;0;CELULAR A52 128 GB BLACK OPEN;TELEFONIA
12305087;;M;50;CHILENO;;X;ARAUCO                        ;BIO BIO;552712;13;5;0;0;0;13;5;552712;CELULAR GALAXY A03 CORE 2GB 32GB BLUE OPEN;TELEFONIA
20353569;;F;22;CHILENO;;Z;ANGOL                         ;ARAUCANIA;91990;2;1;0;0;0;2;1;91990;CELULAR MOTOROLA MOTO G20 64GB ROSA FLAMINGO;TELEFONIA
10095894;;F;57;CHILENO;;Silencioso;LA SERENA                     ;COQUIMBO;60000;3;1;0;0;0;3;1;60000;CELULAR VIVO Y20S NEBULA 128 GB BLUE OPEN;TELEFONIA
20642754;;M;21;CHILENO;;Z;PROVIDENCIA                   ;METROPOLITANA;279990;1;1;0;0;0;1;1;279990;CELULAR SMARTPHONE A52S 5G BLACK 128GB;TELEFONIA
26178153;;M;32;VENEZOLANO;;Extranjero;N/D;N/D;129490;3;1;0;0;0;3;1;129490;CELULAR XIAOMI REDMI 9A 32GB GRANITE GRAY TRI WO;TELEFONIA
7732023;;F;67;CHILENO;;Boomers;"";"";34990;2;1;0;0;0;2;1;34990;CELULAR XIAOMI REDMI 9A 2/32GB GRANITE GRAY;TELEFONIA
26581169;;M;44;VENEZOLANO;;Extranjero;OLMUE                         ;VALPARAISO;86980;2;1;2;1;86980;0;0;0;CELULAR XIAOMI REDMI 9A 2/32GB GRANITE GRAY;TELEFONIA
11474234;;M;53;CHILENO;;X;"";"";1927350;16;9;0;0;0;16;9;1927350;CELULAR XIAOMI REDMI NOTE 10S BLANCO WOM;TELEFONIA
11174799;;M;54;CHILENO;;Boomers;MAIPU                         ;METROPOLITANA;279990;1;1;0;0;0;1;1;279990;CELULAR VIVO V21 5G 128GB SUNSET DAZZLE OPEN;TELEFONIA
15944162;;M;37;CHILENO;;Millenial;SAN PEDRO DE LA PAZ           ;BIO BIO;159990;1;1;1;1;159990;0;0;0;CELULAR REDMI NOTE 11 4/128GB TWILIGHT BLUE OPEN;TELEFONIA
16829998;;M;33;CHILENO;;Millenial;PANGUIPULLI                   ;LOS LAGOS;292720;3;2;0;0;0;3;2;292720;CELULAR REDMI NOTE 11 GRAPHITE GRAY + REDMI BUDS;TELEFONIA
9441989;;F;57;CHILENO;;Boomers;PAINE                         ;METROPOLITANA;120000;2;1;0;0;0;2;1;120000;CELULAR GALAXY A03 4+128GB BLUE OPEN;TELEFONIA
15571633;;F;39;CHILENO;;X;TIERRA AMARILLA;ATACAMA;138210;4;2;0;0;0;4;2;138210;CELULAR BMOBILE C40 CRIS OPEN;TELEFONIA
25579869;;M;31;PERUANO;;Extranjero;LAMPA                         ;METROPOLITANA;318960;4;3;0;0;0;4;3;318960;CELULAR GALAXY A22 5G 4+128GB GRAY;TELEFONIA
17333415;;F;32;CHILENO;;Millenial;"";"";232970;3;3;2;2;92980;1;1;139990;CELULAR XIAOMI REDMI 9A 2/32GB GRANITE GRAY;TELEFONIA
5266325;;F;76;CHILENO;;Silencioso;RENCA                         ;METROPOLITANA;284210;6;3;0;0;0;6;3;284210;CELULAR SMARTPHONE BMOBIL AX1076 PRO BLACK TRI W;TELEFONIA
18717577;;F;28;CHILENO;;Millenial;BUIN;METROPOLITANA;879940;6;3;5;2;867950;1;1;11990;IPHONE X 64GB LIB OPEN SILVER;TELEFONIA
17486484;Soltero;M;32;CHILENO;;Millenial;PROVIDENCIA                   ;METROPOLITANA;219990;1;1;1;1;219990;0;0;0;CELULAR SMARTPHONE A52S 5G LIGHT GREEN 128GB;TELEFONIA
26399122;;M;34;VENEZOLANO;;Extranjero;N/D;N/D;301760;2;1;0;0;0;2;1;301760;CELULAR A52 128 GB BLACK OPEN;TELEFONIA
19121601;Soltero;F;26;CHILENO;;Z;PROVIDENCIA                   ;METROPOLITANA;93980;2;1;2;1;93980;0;0;0;CELULAR MOTOROLA MOTO G20 64GB ROSA FLAMINGO;TELEFONIA
13700985;;M;43;CHILENO;;X;SAN RAMON                     ;METROPOLITANA;147640;2;1;0;0;0;2;1;147640;CELULAR GALAXY A03 4+64GB BLUE OPEN;TELEFONIA
18923044;;M;27;CHILENO;;Millenial;N/D;N/D;269990;1;1;1;1;269990;0;0;0;CELULAR SMARTPHONE A52S 5G BLACK 128GB;TELEFONIA
12646474;;F;47;CHILENO;;X;PROVIDENCIA                   ;METROPOLITANA;83980;2;1;2;1;83980;0;0;0;CELULAR XIAOMI REDMI 9A SE 2/32GB GB PEACOCK GRE;TELEFONIA
19422704;;M;25;CHILENO;;Silencioso;PROVIDENCIA                   ;METROPOLITANA;303980;2;1;2;1;303980;0;0;0;CELULAR IPHONE SE 64GB DIRECTO CLARO;TELEFONIA
9813169;;F;56;CHILENO;;Millenial;N/D;N/D;496450;7;3;0;0;0;7;3;496450;CELULAR CLARO MOTOROLA E7 32GB GRIS;TELEFONIA
12371973;;F;49;CHILENO;;X;VILLA ALEGRE                  ;MAULE;1088920;8;4;0;0;0;8;4;1088920;CELULAR GALAXY A22 5G 4+128GB WHITE;TELEFONIA
14085207;;F;41;CHILENO;;X;PROVIDENCIA                   ;METROPOLITANA;30830;4;1;0;0;0;4;1;30830;CELULAR AZUMI L4G BLACK CLARO;TELEFONIA
18338791;;F;29;CHILENO;;Millenial;TEMUCO                        ;ARAUCANIA;42190;2;1;0;0;0;2;1;42190;CELULAR BMOBILE BS30 BLACK OPEN;TELEFONIA
12864945;;F;47;CHILENO;;X;LA PINTANA                    ;METROPOLITANA;478980;4;2;4;2;478980;0;0;0;CELULAR A52 128 GB BLACK OPEN;TELEFONIA
13355298;;M;43;CHILENO;;X;PROVIDENCIA                   ;METROPOLITANA;299990;1;1;1;1;299990;0;0;0;CELULAR IPHONE SE 64GB DIRECTO CLARO;TELEFONIA
8899825;;F;62;CHILENO;;Boomers;PROVIDENCIA                   ;METROPOLITANA;109990;1;1;0;0;0;1;1;109990;CELULAR REDMI 9C 64GB MIDNIGHT GRAY MOVISTAR;TELEFONIA
16583360;;M;34;CHILENO;;Millenial;CAUQUENES                     ;MAULE;492950;5;3;0;0;0;5;3;492950;CELULAR GALAXY A53 5G 6+128GB WHITE;TELEFONIA
8926936;;F;63;CHILENO;;Boomers;PROVIDENCIA                   ;METROPOLITANA;27990;1;1;0;0;0;1;1;27990;CELULAR BMOBILE BS30 BLACK OPEN;TELEFONIA
24126314;;F;38;COLOMBIANO;;Extranjero;PROVIDENCIA                   ;METROPOLITANA;189990;1;1;1;1;189990;0;0;0;CELULAR POCO X3 PRO 128 GB FROST BLUE;TELEFONIA
8443329;Casado;M;64;CHILENO;;Boomers;RENCA                         ;METROPOLITANA;99991;2;1;0;0;0;2;1;99991;CELULAR VIVO Y20 NEBULA BLUE OPEN;TELEFONIA
8488953;;M;63;CHILENO;;Boomers;N/D;N/D;201310;4;2;0;0;0;4;2;201310;CELULAR VIVO Y11S PHANTON BLACK 32GB MOVISTAR;TELEFONIA
17868849;;M;31;CHILENO;;Millenial;"";"";203980;2;1;2;1;203980;0;0;0;CELULAR A52 128 GB WHITE OPEN;TELEFONIA
15099172;;F;39;CHILENO;;X;VINA DEL MAR;VALPARAISO;409970;3;3;2;2;379980;1;1;29990;CELULAR MOTOROLA MOTO G20 64GB ROSA FLAMINGO;TELEFONIA
17239448;;F;33;CHILENO;;Millenial;BUIN;METROPOLITANA;204980;2;2;1;1;169990;1;1;34990;CELULAR GALAXY A22 5G 4+128GB GRAY;TELEFONIA
8736263;;M;61;CHILENO;;Boomers;TALCA                         ;MAULE;99990;1;1;0;0;0;1;1;99990;CELULAR VIVO Y11S 32GB NEBULA BLUE OPEN;TELEFONIA
5436216;;F;75;CHILENO;;Silencioso;ARICA                         ;ARICA Y PARINACOTA;109990;1;1;0;0;0;1;1;109990;CELULAR REDMI 9C 64GB MIDNIGHT GRAY MOVISTAR;TELEFONIA
15194592;;F;39;CHILENO;;X;YUMBEL                        ;BIO BIO;279984;3;4;0;0;0;3;4;279984;Celular A12 Negro 128GB Tri Entel;TELEFONIA
12071485;;M;52;CHILENO;;X;ARAUCO                        ;BIO BIO;294970;3;2;0;0;0;3;2;294970;CELULAR GALAXY A22 5G 4+128GB GRAY;TELEFONIA
9843808;Casado;M;49;CHILENO;ASISTENTE SOCIAL;X;RENCA                         ;METROPOLITANA;203930;2;2;0;0;0;2;2;203930;CELULAR A12 128GB Azul OPEN;TELEFONIA
8089044;;F;61;CHILENO;;Boomers;PROVIDENCIA                   ;METROPOLITANA;164990;2;1;0;0;0;2;1;164990;CELULAR A52 128 GB BLACK OPEN;TELEFONIA
6670918;;F;67;CHILENO;;Boomers;ALTO HOSPICIO;TARAPACA;109990;1;1;0;0;0;1;1;109990;CELULAR VIVO Y11S PHANTOM BLACK OPEN;TELEFONIA
14150796;;F;41;CHILENO;;X;N/D;N/D;281960;5;3;0;0;0;5;3;281960;CELULAR MOTO G20 64GB ROSA FLAMINGO OPEN;TELEFONIA
18469804;Soltero;F;29;CHILENO;;Millenial;TALAGANTE;METROPOLITANA;106980;2;1;2;1;106980;0;0;0;SMARTPHONE A03s 64 GB Red DS;TELEFONIA
25192692;Soltero;F;49;PERUANO;;Extranjero;PROVIDENCIA                   ;METROPOLITANA;220970;3;2;2;1;203980;1;1;16990;CELULAR POCO X3 PRO 128G PHANTOM BLACK OPEN;TELEFONIA
10287155;;M;56;CHILENO;;Boomers;SAN CARLOS                    ;BIO BIO;232730;2;1;0;0;0;2;1;232730;CELULAR VIVO Y21S MIDNIGHT BLUE 128 GB OPEN;TELEFONIA
15034246;;F;36;CHILENO;;Millenial;VALLENAR;ATACAMA;1336590;7;5;6;4;1106600;1;1;229990;CELULAR XIAOMI 11T 8/256GB METEORITE GRAY OPEN;TELEFONIA
9862259;;M;58;CHILENO;;Boomers;N/D;N/D;49991;3;1;0;0;0;3;1;49991;CELULAR GALAXY A03 CORE 2GB 32GB BLACK OPEN;TELEFONIA
10882054;;M;54;CHILENO;;X;MELIPILLA                     ;METROPOLITANA;2289240;10;3;0;0;0;10;3;2289240;CELULAR XIAOMI 11T 8/256GB CELESTIAL BLUE OPEN;TELEFONIA
6362205;;M;70;CHILENO;;Silencioso;ILLAPEL                       ;COQUIMBO;54230;2;1;0;0;0;2;1;54230;CELULAR BMOBILE C40 CRIS OPEN;TELEFONIA
21824012;;F;42;PERUANO;;Extranjero;ESTACION CENTRAL              ;METROPOLITANA;109991;1;2;0;0;0;1;2;109991;CELULAR REDMI 9C 64GB MIDNIGHT GRAY MOVISTAR;TELEFONIA
10950924;;M;54;CHILENO;;Boomers;PROVIDENCIA                   ;METROPOLITANA;59990;2;1;0;0;0;2;1;59990;CELULAR VIVO Y20S NEBULA 128 GB BLUE OPEN;TELEFONIA
7405604;;F;64;CHILENO;;Boomers;LOS VILOS                     ;COQUIMBO;583920;3;2;0;0;0;3;2;583920;CELULAR A12 128GB Negro OPEN;TELEFONIA
13631948;;M;42;CHILENO;;X;PUCON                         ;ARAUCANIA;110000;3;1;0;0;0;3;1;110000;CELULAR REDMI NOTE 11 4/128GB TWILIGHT BLUE OPEN;TELEFONIA
7030839;;F;66;CHILENO;;Boomers;CAUQUENES                     ;MAULE;302310;5;2;0;0;0;5;2;302310;CELULAR A32 128 GB BLACK OPEN;TELEFONIA
11626320;;M;52;CHILENO;;X;PROVIDENCIA                   ;METROPOLITANA;653980;3;1;3;1;653980;0;0;0;CELULAR SAMSUNG S21 FE 128GB WHITE OPEN;TELEFONIA
8631272;;M;64;CHILENO;;Boomers;ALTO HOSPICIO;TARAPACA;256110;7;1;0;0;0;7;1;256110;CELULAR MOTO E7 32GB GRIS OPEN;TELEFONIA
12001739;;F;51;CHILENO;;X;SANTIAGO                      ;METROPOLITANA;129990;1;1;0;0;0;1;1;129990;CELULAR VIVO Y20 NEBULA BLUE OPEN;TELEFONIA
10541757;;M;57;CHILENO;;Boomers;RENCA                         ;METROPOLITANA;194970;3;1;0;0;0;3;1;194970;CELULAR VIVO Y20S OBSIDIAN BLACK 128GB OPEN;TELEFONIA
5841197;;F;73;CHILENO;;Silencioso;RENCA                         ;METROPOLITANA;89990;1;1;0;0;0;1;1;89990;CELULAR GALAXY A03 CORE 2GB 32GB BLACK OPEN;TELEFONIA
17587029;;F;32;CHILENO;;Millenial;PUNTA ARENAS                  ;MAGALLANES;1054940;6;4;2;1;546980;4;3;507960;CELULAR A12 128GB Azul OPEN;TELEFONIA
25545017;;F;41;VENEZOLANO;;Extranjero;LAS CONDES;METROPOLITANA;199980;2;1;0;0;0;2;1;199980;SMARTPHONE A03S 32 GB ROJO;TELEFONIA
18143511;Soltero;M;30;CHILENO;;Millenial;PROVIDENCIA                   ;METROPOLITANA;159990;2;1;0;0;0;2;1;159990;CELULAR XIAOMI REDMI 9A 2/32GB GRANITE GRAY;TELEFONIA
11990351;;M;50;CHILENO;;X;N/D;N/D;449960;4;3;0;0;0;4;3;449960;CELULAR MOTOROLA G20 64GB BLUE CLARO;TELEFONIA
11556952;;F;52;CHILENO;;X;TENO                          ;MAULE;87870;2;4;0;0;0;2;4;87870;CELULAR NOKIA QUEEN VALUE BLACK CLARO;TELEFONIA
10886936;;F;55;CHILENO;;Boomers;PROVIDENCIA                   ;METROPOLITANA;69990;1;1;0;0;0;1;1;69990;CELULAR AZUMI V60 DUAL OPEN;TELEFONIA
12912006;;M;47;CHILENO;;X;RANCAGUA                      ;L.G.B.OÂ´HIGGINS;787960;4;2;0;0;0;4;2;787960;CELULAR REDMI NOTE 10 5G US 128G NIGHTTIME BLUE;TELEFONIA
18971420;;F;26;CHILENO;;Z;PROVIDENCIA                   ;METROPOLITANA;265980;2;1;0;0;0;2;1;265980;CELULAR MOTO G31 4/128 GB GRIS METEORITO OPEN;TELEFONIA
14594792;;M;46;CHILENO;;X;COLINA                        ;METROPOLITANA;255980;2;1;0;0;0;2;1;255980;CELULAR A22 128GB NEGRO;TELEFONIA
16931406;Soltero;F;34;CHILENO;;Millenial;PROVIDENCIA                   ;METROPOLITANA;21980;2;1;2;1;21980;0;0;0;CELULAR NOKIA 110 BLACK OPEN;TELEFONIA
19001415;;M;26;CHILENO;;Z;N/D;N/D;269990;2;1;0;0;0;2;1;269990;CELULAR XIAOMI 11 LITE 5G NE 6/128GB TRUFFLE BLA;TELEFONIA
15248690;;M;44;CHILENO;;X;PITRUFQUEN                    ;ARAUCANIA;235980;2;1;0;0;0;2;1;235980;CELULAR VIVO Y21S MIDNIGHT BLUE 128 GB OPEN;TELEFONIA
13258154;;F;44;CHILENO;;Silencioso;PROVIDENCIA                   ;METROPOLITANA;503980;2;1;0;0;0;2;1;503980;CELULAR GALAXY S21 FE 8GB 256GB GRAY;TELEFONIA
17055472;Soltero;M;33;CHILENO;;Millenial;PROVIDENCIA                   ;METROPOLITANA;193980;2;1;2;1;193980;0;0;0;CELULAR POCO X3 PRO 128G PHANTOM BLACK OPEN;TELEFONIA
9795816;;F;54;CHILENO;;X;PADRE HURTADO                 ;METROPOLITANA;21980;2;1;2;1;21980;0;0;0;CELULAR NOKIA 110 BLACK OPEN;TELEFONIA
19040902;Soltero;F;27;CHILENO;;Z;PROVIDENCIA                   ;METROPOLITANA;299990;1;1;0;0;0;1;1;299990;SMARTPHONE A52S 5G WHITE 128GB;TELEFONIA
16445358;;F;36;CHILENO;;Millenial;"";"";119990;1;1;0;0;0;1;1;119990;CELULAR VIVO Y20 NEBULA BLUE OPEN;TELEFONIA
6401309;;M;72;CHILENO;;Silencioso;SAN JAVIER                    ;MAULE;126980;2;1;0;0;0;2;1;126980;CELULAR XIAOMI REDMI 9A 2/32GB GRANITE GRAY;TELEFONIA
10100468;;M;56;CHILENO;;Boomers;CALERA                        ;VALPARAISO;99972;4;3;0;0;0;4;3;99972;CELULAR GALAXY A03 CORE 2GB 32GB BLACK OPEN;TELEFONIA
7539609;;M;67;CHILENO;;Boomers;PROVIDENCIA                   ;METROPOLITANA;139990;1;1;0;0;0;1;1;139990;CELULAR MOTO G20 64GB ROSA FLAMINGO OPEN;TELEFONIA
10130133;;M;58;CHILENO;;Boomers;RENCA                         ;METROPOLITANA;129990;1;1;0;0;0;1;1;129990;CELULAR A12 128GB Azul OPEN;TELEFONIA
11312128;;F;54;CHILENO;;X;SAN CLEMENTE                  ;MAULE;505110;5;3;0;0;0;5;3;505110;Celular P40 LITE LIB OPEN GREEN;TELEFONIA
9874477;;M;56;CHILENO;;Boomers;N/D;N/D;303220;6;6;0;0;0;6;6;303220;CELULAR VIVO Y11S PHANTOM BLACK OPEN;TELEFONIA
20396973;;F;22;CHILENO;;Z;CERRILLOS;METROPOLITANA;359980;2;2;0;0;0;2;2;359980;SMARTPHONE A52S 5G WHITE 128GB;TELEFONIA
19233238;Soltero;M;26;CHILENO;;Z;RENCA                         ;METROPOLITANA;151040;7;3;0;0;0;7;3;151040;CELULAR REDMI 9A 32GB PEACOCK GREEN;TELEFONIA
15704699;;F;39;CHILENO;;X;RENCA;METROPOLITANA;73980;2;1;2;1;73980;0;0;0;CELULAR MOTOROLA E7 IPOWER 32GB BLUE CLARO;TELEFONIA
18889424;;F;28;CHILENO;;Millenial;PUNITAQUI                     ;COQUIMBO;937911;10;7;0;0;0;10;7;937911;CELULAR IPHONE SE 64GB DIRECTO CLARO;TELEFONIA
17922386;;F;31;CHILENO;;Millenial;"";"";673970;4;2;2;1;23980;2;1;649990;CELULAR SAMSUNG S21 FE 128GB GRAY OPEN;TELEFONIA
13372419;;M;44;CHILENO;;X;CAUQUENES                     ;MAULE;89990;1;3;0;0;0;1;3;89990;CELULAR MOTO E7 32GB GRIS OPEN;TELEFONIA
19811302;;F;24;CHILENO;;Z;PROVIDENCIA                   ;METROPOLITANA;79990;1;1;0;0;0;1;1;79990;CELULAR REDMI 9A 32GB SKY BLUE;TELEFONIA
17696985;;F;30;CHILENO;;Millenial;N/D;N/D;1000;2;1;0;0;0;2;1;1000;CHIP OPEN ENTEL;TELEFONIA
27084577;;F;42;EXTRANJERO - NO INFORMA NACIONALIDAD;;Extranjero;"";"";161960;4;3;2;1;126980;2;2;34980;CELULAR VIVO Y20S NEBULA 128 GB BLUE OPEN;TELEFONIA
8149908;;F;66;CHILENO;;Boomers;COPIAPO                       ;ATACAMA;79981;3;1;0;0;0;3;1;79981;CELULAR NOKIA C1 PLUS BLUE;TELEFONIA
8159729;;M;66;CHILENO;;Boomers;PROVIDENCIA                   ;METROPOLITANA;429960;4;3;0;0;0;4;3;429960;CELULAR XIAOMI REDMI 9 MORADO ENTEL;TELEFONIA
12522643;;F;48;CHILENO;;X;TALCA                         ;MAULE;309990;1;1;0;0;0;1;1;309990;CELULAR XIAOMI 11 LITE 5G NE 8/128GB TRUFFLE BLA;TELEFONIA
12979961;;M;46;CHILENO;;X;VALLENAR;ATACAMA;32990;1;1;0;0;0;1;1;32990;CELULAR BMOBILE BS30 BLACK OPEN;TELEFONIA
19541967;;F;24;CHILENO;;Z;PROVIDENCIA                   ;METROPOLITANA;139990;1;1;0;0;0;1;1;139990;CELULAR A12 128GB Azul OPEN;TELEFONIA
11813343;Casado;F;51;CHILENO;AUXILIAR PARAMEDICO DE ENFERMERIA;X;RENCA                         ;METROPOLITANA;38990;1;1;0;0;0;1;1;38990;CELULAR BMOBILE C40 CRIS OPEN;TELEFONIA
17125403;;F;33;CHILENO;;Millenial;OSORNO                        ;LOS LAGOS;341980;2;1;0;0;0;2;1;341980;CELULAR A52 128 GB BLACK OPEN;TELEFONIA
12419693;;M;49;CHILENO;;X;VICHUQUEN                     ;MAULE;43971;4;1;0;0;0;4;1;43971;CELULAR BMOBILE BS30 BLACK OPEN;TELEFONIA
7581995;;F;63;CHILENO;;Boomers;SAN PEDRO DE LA PAZ           ;BIO BIO;371630;6;4;0;0;0;6;4;371630;Celular SA3 CLARO DIRECTO BLACK;TELEFONIA
11452094;;F;52;CHILENO;;X;PROVIDENCIA                   ;METROPOLITANA;117980;2;2;0;0;0;2;2;117980;CELULAR MOTO E7 32GB GRIS OPEN;TELEFONIA
19795666;;F;24;CHILENO;;Z;COLLIPULLI                    ;ARAUCANIA;518960;4;3;0;0;0;4;3;518960;CELULAR REDMI NOTE 10S 128GB ONIX BLACK;TELEFONIA
18516701;Soltero;F;28;CHILENO;TECNOLOGO MEDICO;Millenial;PROVIDENCIA                   ;METROPOLITANA;406980;2;1;2;1;406980;0;0;0;CELULAR GALAXY S20FE 128GB CLOUD GREEN OPEN;TELEFONIA
6936435;;M;65;CHILENO;;Boomers;N/D;N/D;1499980;2;3;2;1;1499980;0;2;0;IPHONE 12 128GB BLACK CLARO;TELEFONIA
11714304;Casado;M;50;CHILENO;PROFESOR;X;RENCA                         ;METROPOLITANA;148980;2;1;2;1;148980;0;0;0;CELULAR A54 OPPO NEGRO 128GB;TELEFONIA
13118990;;M;46;CHILENO;;X;TOME                          ;BIO BIO;219990;1;1;1;1;219990;0;0;0;CELULAR A52 128 GB WHITE OPEN;TELEFONIA
7123028;;F;68;CHILENO;;Boomers;SAN CARLOS                    ;BIO BIO;199990;1;1;0;0;0;1;1;199990;CELULAR A32 128 GB WHITE OPEN;TELEFONIA
7660632;;M;68;CHILENO;;Boomers;QUILICURA                     ;METROPOLITANA;39990;2;1;0;0;0;2;1;39990;CELULAR VIVO Y20 NEBULA BLUE OPEN;TELEFONIA
15288845;Casado;M;38;CHILENO;;X;RENCA                         ;METROPOLITANA;249990;1;1;0;0;0;1;1;249990;CELULAR MI 11 LITE 128GB BUBBLEGUM BLUE;TELEFONIA
9774380;;F;54;CHILENO;;X;MELIPILLA                     ;METROPOLITANA;299970;3;2;0;0;0;3;2;299970;CELULAR XIAOMI REDMI 9A 32GB BLACK DIRECTO CLARO;TELEFONIA
19272233;;F;26;CHILENO;;Millenial;PANGUIPULLI                   ;LOS LAGOS;664960;7;4;0;0;0;7;4;664960;CELULAR REDMI NOTE 11 4/128GB TWILIGHT BLUE OPEN;TELEFONIA
10239381;;F;53;CHILENO;;X;LAMPA                         ;METROPOLITANA;390990;3;1;0;0;0;3;1;390990;CELULAR XIAOMI 11 LITE 5G NE 6/128GB BUBBLEGUM;TELEFONIA
13604543;;F;43;CHILENO;;X;CONCEPCION                    ;BIO BIO;110716;14;2;0;0;0;14;2;110716;CELULAR BMOBILE C40 CRIS OPEN;TELEFONIA
8916213;;M;61;CHILENO;;Boomers;CHIGUAYANTE                   ;BIO BIO;559811;6;3;2;1;175840;4;2;383971;Celular Y9 PRIME LIB OPEN VERDE;TELEFONIA
18112898;;F;30;CHILENO;;Millenial;PROVIDENCIA                   ;METROPOLITANA;109990;1;1;0;0;0;1;1;109990;CELULAR VIVO Y11S PHANTON BLACK 32GB MOVISTAR;TELEFONIA
25693288;;F;31;VENEZOLANO;;Extranjero;SANTIAGO                      ;METROPOLITANA;203980;2;1;2;1;203980;0;0;0;CELULAR MOTO G60S 6/128 GB AZUL;TELEFONIA
12552030;;F;47;CHILENO;;X;PROVIDENCIA                   ;METROPOLITANA;199990;1;1;1;1;199990;0;0;0;CELULAR MOTO G60S 6/128 GB AZUL;TELEFONIA
14071257;Casado;M;41;CHILENO;CONTADOR AUDITOR;X;CURANILAHUE                   ;BIO BIO;297980;2;1;2;1;297980;0;0;0;IPHONE X 64GB LIB OPEN SILVER;TELEFONIA
13340266;;M;44;CHILENO;;X;MELIPILLA                     ;METROPOLITANA;175980;3;1;0;0;0;3;1;175980;CELULAR MOTO G20 EDICION ESPECIAL 4/128 GB AZUL;TELEFONIA
19372739;;M;25;CHILENO;;Z;CABRERO                       ;BIO BIO;61990;2;1;0;0;0;2;1;61990;CELULAR VIVO Y11S PHANTON BLACK 32GB MOVISTAR;TELEFONIA
12327791;;M;48;CHILENO;;X;LOS ANGELES                   ;BIO BIO;129990;1;1;0;0;0;1;1;129990;CELULAR REDMI 9 64GB CARBON GREY;TELEFONIA
6801898;;M;71;CHILENO;;Silencioso;PROVIDENCIA                   ;METROPOLITANA;64990;2;1;0;0;0;2;1;64990;CELULAR GALAXY A03 4+64GB BLUE OPEN;TELEFONIA
9193421;;M;61;CHILENO;;Boomers;PROVIDENCIA                   ;METROPOLITANA;99991;2;1;0;0;0;2;1;99991;SMARTPHONE A03S AZUL 32GB;TELEFONIA
16253948;;F;36;CHILENO;;Millenial;N/D;N/D;36990;1;1;0;0;0;1;1;36990;CELULAR ALCATEL P1 DIRECTO CLARO BLACK;TELEFONIA
15057682;;F;38;CHILENO;;Millenial;LA LIGUA                      ;VALPARAISO;127980;2;1;0;0;0;2;1;127980;CELULAR GALAXY A03 CORE 2GB 32GB BLACK OPEN;TELEFONIA
18180656;;M;29;CHILENO;;Millenial;FREIRE                        ;ARAUCANIA;119990;1;1;1;1;119990;0;0;0;CELULAR A12 128GB Azul OPEN;TELEFONIA
11543495;;M;52;CHILENO;;X;RENCA                         ;METROPOLITANA;215960;4;3;0;0;0;4;3;215960;CELULAR AZUMI V60 DUAL OPEN;TELEFONIA
13709145;;F;43;CHILENO;;X;N/D;N/D;2220290;11;5;0;0;0;11;5;2220290;CELULAR GALAXY S22 ULTRA BLACK 128GB;TELEFONIA
11780678;;F;51;CHILENO;;X;LOS SAUCES                    ;ARAUCANIA;396970;3;2;0;0;0;3;2;396970;CELULAR A12 128GB Azul OPEN;TELEFONIA
12821821;;M;47;CHILENO;;X;OLMUE;VALPARAISO;236980;2;1;2;1;236980;0;0;0;POCO X3 PRO 256 GB METAL BRONCE;TELEFONIA
8069020;;M;66;CHILENO;;Boomers;RENCA                         ;METROPOLITANA;52980;2;1;0;0;0;2;1;52980;CELULAR BMOBILE C40 CRIS OPEN;TELEFONIA
17958184;;F;31;CHILENO;;Millenial;LA CRUZ                       ;VALPARAISO;479980;2;2;2;2;479980;0;0;0;CELULAR A52 128 GB BLACK OPEN;TELEFONIA
20440340;;M;22;CHILENO;;Z;N/D;N/D;146980;2;4;0;0;0;2;4;146980;CELULAR XIAOMI REDMI 10 4G 4/64Gb CARBON GRAY;TELEFONIA
9892826;;M;59;CHILENO;;Boomers;PROVIDENCIA                   ;METROPOLITANA;896930;7;4;0;0;0;7;4;896930;CELULAR MOTOROLA MOTO G20 64GB ROSA FLAMINGO;TELEFONIA
20775825;;M;21;CHILENO;;Z;PROVIDENCIA                   ;METROPOLITANA;173970;3;2;2;1;33980;1;1;139990;CELULAR VIVO Y20S NEBULA 128 GB BLUE OPEN;TELEFONIA
7246491;;M;66;CHILENO;;Boomers;LA PINTANA                    ;METROPOLITANA;99990;1;1;0;0;0;1;1;99990;CELULAR VIVO Y11S PHANTOM BLACK OPEN;TELEFONIA
26493478;;F;31;VENEZOLANO;;Extranjero;CARTAGENA                     ;VALPARAISO;169980;3;1;0;0;0;3;1;169980;CELULAR XIAOMI REDMI 9A 2/32GB GRANITE GRAY;TELEFONIA
10121807;;M;58;CHILENO;;Boomers;PROVIDENCIA                   ;METROPOLITANA;174970;3;1;0;0;0;3;1;174970;CELULAR A12 128GB Negro OPEN;TELEFONIA
15757949;Soltero;F;38;CHILENO;;Millenial;RENCA                         ;METROPOLITANA;1033110;10;4;0;0;0;10;4;1033110;CELULAR A12 128GB Rojo OPEN;TELEFONIA
16683520;;F;36;CHILENO;;Millenial;COIHAIQUE                     ;AYSEN;169990;1;1;0;0;0;1;1;169990;CELULAR MOTOROLA G30 GRIS WOM 128 GB;TELEFONIA
18651174;Soltero;M;27;CHILENO;;Silencioso;PROVIDENCIA                   ;METROPOLITANA;205980;2;2;0;0;0;2;2;205980;SMARTPHONE A22 BLANCO 128GB;TELEFONIA
17036073;;F;33;CHILENO;;Millenial;CURANILAHUE                   ;BIO BIO;149990;1;1;0;0;0;1;1;149990;CELULAR A12 128GB Negro OPEN;TELEFONIA
17124489;;M;33;CHILENO;;Millenial;PROVIDENCIA                   ;METROPOLITANA;219990;1;1;0;0;0;1;1;219990;CELULAR MOTO G60S 6/128 GB AZUL;TELEFONIA
14042111;;M;42;CHILENO;;X;RANCAGUA                      ;L.G.B.OÂ´HIGGINS;549991;2;1;0;0;0;2;1;549991;CELULAR XIAOMI 11T PRO 8/256GB METEORITE GRAY;TELEFONIA
17812745;;F;30;CHILENO;;Millenial;TOME                          ;BIO BIO;669981;3;2;0;0;0;3;2;669981;Celular Galaxy S21 Plus Phantom Silver 128GB;TELEFONIA
18773951;;M;27;CHILENO;;Z;PROVIDENCIA                   ;METROPOLITANA;249990;2;1;0;0;0;2;1;249990;CELULAR XIAOMI POCO X3 PRO 128GB PANTHOM BLACK;TELEFONIA
18643288;Soltero;F;27;CHILENO;TECNOLOGO MEDICO;Millenial;PROVIDENCIA                   ;METROPOLITANA;899990;4;1;4;1;899990;0;0;0;CELULAR GALAXY S22 PINK GOLD 128GB;TELEFONIA
13968166;;M;42;CHILENO;;X;PUERTO MONTT                  ;LOS LAGOS;182970;4;1;0;0;0;4;1;182970;CELULAR A12 128GB Azul OPEN;TELEFONIA
8673453;;F;62;CHILENO;;Boomers;PARRAL                        ;MAULE;903970;3;2;0;0;0;3;2;903970;Celular Galaxy S21 Phantom Grey 128GB;TELEFONIA
15158059;;M;43;CHILENO;;X;RENCA                         ;METROPOLITANA;117981;3;1;0;0;0;3;1;117981;CELULAR REDMI 9A 32GB PEACOCK GREEN;TELEFONIA
19580720;;F;25;CHILENO;;Z;N/D;N/D;966960;4;2;0;0;0;4;2;966960;CELULAR XIAOMI POCO X3 PRO 128GB PANTHOM BLACK;TELEFONIA
19016338;;F;26;CHILENO;;Z;"";"";279980;2;3;0;0;0;2;3;279980;SMARTHPHONE REDMI 10 US 64GB SEA BLUE;TELEFONIA
4738244;;M;78;CHILENO;;Silencioso;MAIPU                         ;METROPOLITANA;1049970;4;2;0;0;0;4;2;1049970;CELULAR A12 128GB Negro OPEN;TELEFONIA
9282329;;M;60;CHILENO;;Boomers;ANGOL                         ;ARAUCANIA;119990;1;1;0;0;0;1;1;119990;CELULAR A12 128GB Azul OPEN;TELEFONIA
13394046;;F;43;CHILENO;;X;PELARCO                       ;MAULE;476960;6;3;0;0;0;6;3;476960;CELULAR VIVO Y11S 32GB NEBULA BLUE OPEN;TELEFONIA
14903113;;M;41;CHILENO;;X;PROVIDENCIA                   ;METROPOLITANA;89991;2;1;0;0;0;2;1;89991;CELULAR MOTO E7 32GB GRIS OPEN;TELEFONIA
18623369;;F;28;CHILENO;;Millenial;ISLA DE MAIPO                 ;METROPOLITANA;329990;1;1;0;0;0;1;1;329990;CELULAR VIVO V21 5G 128GB SUNSET DAZZLE OPEN;TELEFONIA
15281956;;M;37;CHILENO;;Millenial;SANTIAGO                      ;METROPOLITANA;259990;2;1;0;0;0;2;1;259990;CELULAR VIVO V21 5G DUSK BLUE 128GB OPEN;TELEFONIA
12317450;;F;49;CHILENO;;X;CAUQUENES                     ;MAULE;911980;2;1;0;0;0;2;1;911980;Celular Galaxy S21 Phantom Grey 128GB;TELEFONIA
15577768;;F;38;CHILENO;;X;COIHUECO                      ;BIO BIO;199990;1;1;0;0;0;1;1;199990;CELULAR A32 128 GB BLACK OPEN;TELEFONIA
18130624;;F;29;CHILENO;;Millenial;N/D;N/D;203980;2;1;2;1;203980;0;0;0;CELULAR HUAWEI Y9A BLACK OPEN;TELEFONIA
17880932;Soltero;F;30;CHILENO;;Millenial;VILLARICA                     ;ARAUCANIA;382760;3;2;0;0;0;3;2;382760;CELULAR POCO X3 PRO 128G PHANTOM BLACK OPEN;TELEFONIA
9198878;;M;60;CHILENO;;Boomers;PROVIDENCIA                   ;METROPOLITANA;205960;5;2;0;0;0;5;2;205960;CELULAR REDMI NOTE 10S 128GB ONIX BLACK;TELEFONIA
20099356;;F;23;CHILENO;;Z;LAS CABRAS                    ;L.G.B.OÂ´HIGGINS;390980;2;1;0;0;0;2;1;390980;CELULAR SMARTPHONE A52S 5G LIGHT GREEN 128GB;TELEFONIA
17714644;;M;31;CHILENO;;Millenial;ANCUD                         ;LOS LAGOS;179990;1;1;0;0;0;1;1;179990;CELULAR MOTO G60S 6/128 GB AZUL;TELEFONIA
26531813;;M;30;VENEZOLANO;;Extranjero;"";"";119990;2;1;0;0;0;2;1;119990;CELULAR MOTOROLA G30 GRIS WOM 128 GB;TELEFONIA
9361072;;F;58;CHILENO;;Boomers;RENCA                         ;METROPOLITANA;990;1;1;0;0;0;1;1;990;CHIP OPEN ENTEL;TELEFONIA
10109449;;F;56;CHILENO;;Boomers;"";"";119990;1;1;0;0;0;1;1;119990;CELULAR MOTO G20 EDICION ESPECIAL 4/128 GB VERDE;TELEFONIA
19147377;;F;27;CHILENO;;Z;ARICA                         ;ARICA Y PARINACOTA;151980;2;1;0;0;0;2;1;151980;SMARTPHONE A03S 32 GB ROJO;TELEFONIA
17287702;;M;34;CHILENO;;Millenial;COLLIPULLI                    ;ARAUCANIA;242740;4;2;0;0;0;4;2;242740;CELULAR MOTOROLA G20 64GB BLUE CLARO;TELEFONIA
16916376;;F;35;CHILENO;;Millenial;ARAUCO                        ;BIO BIO;171980;2;1;0;0;0;2;1;171980;SMARTPHONE A03S 64 GB NEGRO;TELEFONIA
26286969;;F;36;VENEZOLANO;;Extranjero;PROVIDENCIA                   ;METROPOLITANA;336150;5;2;0;0;0;5;2;336150;CELULAR VIVO V21 5G DUSK BLUE 128GB OPEN;TELEFONIA
18386770;;M;29;CHILENO;;Millenial;PROVIDENCIA                   ;METROPOLITANA;259990;1;1;0;0;0;1;1;259990;CELULAR REDMI NOTE 10 PRO 128GB AZUL WOM;TELEFONIA
14331223;Casado;F;45;CHILENO;;X;RENCA                         ;METROPOLITANA;109990;1;1;0;0;0;1;1;109990;CELULAR VIVO Y11S 32GB NEBULA BLUE OPEN;TELEFONIA
17501013;Soltero;M;32;CHILENO;;Millenial;PROVIDENCIA                   ;METROPOLITANA;285980;2;1;0;0;0;2;1;285980;CELULAR A32 128 GB BLUE OPEN;TELEFONIA
18123577;Casado;F;29;CHILENO;;Millenial;PROVIDENCIA                   ;METROPOLITANA;59990;1;1;0;0;0;1;1;59990;CELULAR NOKIA C1 PLUS BLUE;TELEFONIA
18773474;;F;27;CHILENO;;Z;PROVIDENCIA                   ;METROPOLITANA;219990;1;1;0;0;0;1;1;219990;POCO X3 PRO 256 GB PHANTOM BLACK;TELEFONIA
11916252;;F;50;CHILENO;;X;RENCA                         ;METROPOLITANA;39990;1;1;0;0;0;1;1;39990;CELULAR BMOBILE C40 CRIS OPEN;TELEFONIA
13917890;;F;41;CHILENO;;X;MAIPU                         ;METROPOLITANA;149990;2;1;0;0;0;2;1;149990;CELULAR REDMI NOTE 10S 128GB ONIX BLACK;TELEFONIA
9493619;;F;60;CHILENO;;Boomers;PUDAHUEL                      ;METROPOLITANA;828410;8;5;0;0;0;8;5;828410;CELULAR A12 128GB Negro OPEN;TELEFONIA
11955178;;F;49;CHILENO;;X;RENCA                         ;METROPOLITANA;219990;1;1;0;0;0;1;1;219990;CELULAR A32 128 GB LIGHT VIOLET OPEN;TELEFONIA
7215823;;M;66;CHILENO;;Boomers;MELIPILLA                     ;METROPOLITANA;159990;1;1;0;0;0;1;1;159990;CELULAR A54 OPPO AZUL 128GB;TELEFONIA
11702061;;F;50;CHILENO;;X;TIRUA                         ;BIO BIO;503960;4;2;0;0;0;4;2;503960;CELULAR A32 128 GB BLACK OPEN;TELEFONIA
16815269;;M;34;CHILENO;;Millenial;RENCA                         ;METROPOLITANA;309990;1;1;0;0;0;1;1;309990;CELULAR SMARTPHONE A52S 5G BLACK 128GB;TELEFONIA
12034846;;F;56;CHILENO;;Boomers;N/D;N/D;1169900;10;4;0;0;0;10;4;1169900;CELULAR XIAOMI 11T PRO 8/256GB METEORITE GRAY;TELEFONIA
20015080;;M;23;CHILENO;;Z;PROVIDENCIA                   ;METROPOLITANA;209990;1;1;1;1;209990;0;0;0;CELULAR POCO X3 PRO 256 GB FROST BLUE;TELEFONIA
15912852;;M;37;CHILENO;;Millenial;PROVIDENCIA                   ;METROPOLITANA;89990;2;1;0;0;0;2;1;89990;CELULAR A12 128GB Negro OPEN;TELEFONIA
18992951;;F;27;CHILENO;;Z;SAN RAMON                     ;METROPOLITANA;189990;1;1;0;0;0;1;1;189990;CELULAR XIAOMI POCO X3 PRO 128GB PANTHOM BLACK;TELEFONIA
10651222;;M;56;CHILENO;;Boomers;LA SERENA                     ;COQUIMBO;309990;1;1;0;0;0;1;1;309990;CELULAR SMARTPHONE A52S 5G BLACK 128GB;TELEFONIA
20084758;;M;41;CHILENO;;X;PROVIDENCIA                   ;METROPOLITANA;219990;1;1;0;0;0;1;1;219990;CELULAR A32 128 GB WHITE OPEN;TELEFONIA
10245564;;M;55;CHILENO;;Boomers;RENCA                         ;METROPOLITANA;99990;1;1;0;0;0;1;1;99990;SMARTPHONE A03S 32 GB ROJO;TELEFONIA
10807980;;F;65;CHILENO;;Boomers;MONTE PATRIA                  ;COQUIMBO;444920;8;3;0;0;0;8;3;444920;SMARTPHONE A03S AZUL 32GB;TELEFONIA
11475006;Casado;F;53;CHILENO;;X;RENCA                         ;METROPOLITANA;129990;1;1;0;0;0;1;1;129990;CELULAR A12 128GB Azul OPEN;TELEFONIA
13785225;;F;41;CHILENO;;X;RENCA                         ;METROPOLITANA;149990;1;1;0;0;0;1;1;149990;CELULAR A12 128GB Rojo OPEN;TELEFONIA
19713740;;M;24;CHILENO;;Z;"";"";80980;2;1;0;0;0;2;1;80980;CELULAR XIAOMI REDMI 9A 2/32GB GRANITE GRAY;TELEFONIA
14347678;;F;43;CHILENO;;X;N/D;N/D;472960;4;2;0;0;0;4;2;472960;CELULAR A12 128GB Rojo OPEN;TELEFONIA
17292766;;F;32;CHILENO;;Millenial;"";"";129990;1;1;0;0;0;1;1;129990;CELULAR A12 128GB Negro OPEN;TELEFONIA
13787444;Casado;F;42;CHILENO;;X;RENCA                         ;METROPOLITANA;149990;1;1;0;0;0;1;1;149990;CELULAR A12 128GB Azul OPEN;TELEFONIA
17241754;;M;32;CHILENO;;Silencioso;PROVIDENCIA                   ;METROPOLITANA;579990;1;1;0;0;0;1;1;579990;CELULAR IPHONE 12 MINI 64GB BLACK CLARO;TELEFONIA
12245218;;M;50;CHILENO;;X;RENCA                         ;METROPOLITANA;299990;1;1;1;1;299990;0;0;0;CELULAR SMARTPHONE A52S 5G LIGHT GREEN 128GB;TELEFONIA
18116777;Soltero;F;30;CHILENO;CHEF;Millenial;PROVIDENCIA                   ;METROPOLITANA;16990;1;1;0;0;0;1;1;16990;Celular AL3 CLARO DIRECTO NEGRO;TELEFONIA
13261175;Soltero;F;45;CHILENO;;X;PROVIDENCIA                   ;METROPOLITANA;269990;1;1;1;1;269990;0;0;0;CELULAR SMARTPHONE A52S 5G BLACK 128GB;TELEFONIA
12495338;;F;49;CHILENO;;X;SAN MIGUEL                    ;METROPOLITANA;319980;2;1;0;0;0;2;1;319980;CELULAR REDMI 9T 128 GB OCEAN GREEN;TELEFONIA
5050131;;F;79;CHILENO;;Silencioso;PORTEZUELO                    ;BIO BIO;80990;1;1;0;0;0;1;1;80990;CELULAR MOTOROLA E6 PLAY AZUL TRI WOM;TELEFONIA
18489696;Soltero;F;28;CHILENO;;Millenial;PROVIDENCIA                   ;METROPOLITANA;39990;1;1;1;1;39990;0;0;0;CELULAR SMARTPHONE 1B ALCATEL PRIME BLACK;TELEFONIA
9879008;Casado;F;57;CHILENO;;Boomers;PROVIDENCIA                   ;METROPOLITANA;149990;1;1;0;0;0;1;1;149990;SMARTHPHONE SAMSUNG GALAXY A03S 64GB NEGRO;TELEFONIA
26667093;Soltero;M;47;BOLIVIANO;;Extranjero;RENGO                         ;L.G.B.OÂ´HIGGINS;352970;3;2;0;0;0;3;2;352970;CELULAR MOTOROLA G30 GRIS WOM 128 GB;TELEFONIA
4202871;;M;82;CHILENO;;Silencioso;RENCA                         ;METROPOLITANA;18990;1;1;0;0;0;1;1;18990;CELULAR NOKIA 110 BLACK OPEN;TELEFONIA
14414167;;F;47;CHILENO;;X;VILLARICA                     ;ARAUCANIA;159990;1;1;0;0;0;1;1;159990;MOTO G30 LILA PASTEL 128GB MOVISTAR;TELEFONIA
18537491;;M;29;CHILENO;;Millenial;PUENTE ALTO;METROPOLITANA;138950;5;3;2;1;123980;3;2;14970;CHIP MULTIMEDIA CLA;TELEFONIA
16040797;;F;37;CHILENO;;Millenial;TILTIL                        ;METROPOLITANA;539990;1;1;1;1;539990;0;0;0;CELULAR SAMSUNG NOTE 20 MYSTIC BRONZE 256 GB OPE;TELEFONIA
19271272;;F;26;CHILENO;;Z;OVALLE                        ;COQUIMBO;219990;1;1;0;0;0;1;1;219990;CELULAR REDMI NOTE 10S 128GB ONIX BLACK;TELEFONIA
8886769;;F;67;CHILENO;;Boomers;PROVIDENCIA                   ;METROPOLITANA;119990;1;1;0;0;0;1;1;119990;CELULAR VIVO Y11S 32GB NEBULA BLUE OPEN;TELEFONIA
15199242;;M;43;CHILENO;;X;ARAUCO                        ;BIO BIO;119990;1;1;0;0;0;1;1;119990;CELULAR XIAOMI REDMI 9 64GB DIRECTO CLARO MORADO;TELEFONIA
12552000;;M;48;CHILENO;;X;CHILLAN                       ;BIO BIO;65980;2;1;0;0;0;2;1;65980;CELULAR MOTOROLA E6 PLAY AZUL TRI WOM;TELEFONIA
15161094;;M;45;CHILENO;;X;SAN CARLOS                    ;BIO BIO;89990;1;1;0;0;0;1;1;89990;CELULAR REDMI 9A 32GB PEACOCK GREEN;TELEFONIA
15684400;;F;39;CHILENO;;X;N/D;N/D;179990;1;1;0;0;0;1;1;179990;CELULAR MOTO G30 128GB LILA PASTEL OPEN;TELEFONIA
8030360;;F;62;CHILENO;;Boomers;RENCA                         ;METROPOLITANA;189990;1;3;0;0;0;1;3;189990;CELULAR A22 128GB NEGRO;TELEFONIA
7680682;;F;64;CHILENO;;Boomers;ILLAPEL                       ;COQUIMBO;298970;3;2;0;0;0;3;2;298970;POCO X3 PRO 256 GB PHANTOM BLACK;TELEFONIA
12223796;Soltero;M;50;CHILENO;;X;VINA DEL MAR                  ;VALPARAISO;299990;1;1;0;0;0;1;1;299990;CELULAR IPHONE SE 64GB DIRECTO CLARO;TELEFONIA
15623619;;M;38;CHILENO;;X;PROVIDENCIA                   ;METROPOLITANA;744980;3;1;0;0;0;3;1;744980;CELULAR SAMSUNG S21 FE 128GB GRAY OPEN;TELEFONIA
25770058;;M;39;EXTRANJERO - NO INFORMA NACIONALIDAD;;Extranjero;SANTIAGO                      ;METROPOLITANA;935431;7;3;0;0;0;7;3;935431;CELULAR A12 128GB Azul OPEN;TELEFONIA
26692246;;M;22;EXTRANJERO - NO INFORMA NACIONALIDAD;;Extranjero;COLINA                        ;METROPOLITANA;234980;2;1;0;0;0;2;1;234980;CELULAR REDMI NOTE 10S 128GB ONIX BLACK;TELEFONIA
8971258;;M;62;CHILENO;;Boomers;TENO                          ;MAULE;191980;2;1;0;0;0;2;1;191980;CELULAR A12 128GB Negro OPEN;TELEFONIA
13820716;Casado;F;48;CHILENO;;X;SAN CLEMENTE                  ;MAULE;84990;2;1;0;0;0;2;1;84990;CELULAR A12 128GB Rojo OPEN;TELEFONIA
4282570;;M;83;CHILENO;;Silencioso;MELIPILLA                     ;METROPOLITANA;399960;4;2;0;0;0;4;2;399960;CELULAR A22 128GB NEGRO;TELEFONIA
19544951;;M;25;CHILENO;;Z;PROVIDENCIA                   ;METROPOLITANA;135960;4;2;4;2;135960;0;0;0;CELULAR NOKIA 110 BLACK OPEN;TELEFONIA
13221181;;M;45;CHILENO;;X;RENCA                         ;METROPOLITANA;159990;1;1;0;0;0;1;1;159990;CELULAR MOTOROLA G20 EDICION ESPECIAL VERDE CLAR;TELEFONIA
19001928;;F;27;CHILENO;;Millenial;"";"";497950;5;2;5;2;497950;0;0;0;CELULAR HUAWEI Y9A BLACK OPEN;TELEFONIA
9053737;;F;64;CHILENO;;Boomers;COLLIPULLI                    ;ARAUCANIA;196983;4;3;0;0;0;4;3;196983;CELULAR A12 128GB Rojo OPEN;TELEFONIA
19023385;;F;27;CHILENO;;Z;CORONEL                       ;BIO BIO;199991;2;1;0;0;0;2;1;199991;CELULAR VIVO Y21S MIDNIGHT BLUE 128 GB OPEN;TELEFONIA
19170744;;M;27;CHILENO;;Z;PENALOLEN;METROPOLITANA;132980;2;1;0;0;0;2;1;132980;SMARTPHONE A03S AZUL 32GB;TELEFONIA
17902692;;F;30;CHILENO;;Millenial;TALCA;MAULE;232970;3;2;0;0;0;3;2;232970;CELULAR A12 128GB Azul OPEN;TELEFONIA
26082327;;F;34;ECUATORIANO;;Extranjero;N/D;N/D;699990;1;1;0;0;0;1;1;699990;Celular Galaxy S21 Plus Phantom Violet 128GB;TELEFONIA
16725740;;M;35;CHILENO;;Millenial;N/D;N/D;509960;4;5;0;0;0;4;5;509960;CELULAR CLARO MOTOROLA E7 32GB GRIS;TELEFONIA
11457008;;F;53;CHILENO;;X;CONSTITUCION                  ;MAULE;189990;1;1;0;0;0;1;1;189990;CELULAR POCO X3 PRO 128G PHANTOM BLACK OPEN;TELEFONIA
20068061;;F;22;CHILENO;;Z;PROVIDENCIA                   ;METROPOLITANA;109990;1;1;1;1;109990;0;0;0;CELULAR XIAOMI REDMI 9 64GB DIRECTO CLARO MORADO;TELEFONIA
18863585;Soltero;F;27;CHILENO;PROFESOR;Z;PROVIDENCIA                   ;METROPOLITANA;42990;1;1;0;0;0;1;1;42990;CELULAR BMOBILE BS30 BLACK OPEN;TELEFONIA
18397718;;F;29;CHILENO;;Millenial;COPIAPO                       ;ATACAMA;299990;1;1;0;0;0;1;1;299990;CELULAR IPHONE SE 64GB DIRECTO CLARO;TELEFONIA
11073445;;F;55;CHILENO;;Boomers;YERBAS BUENAS                 ;MAULE;821950;5;3;0;0;0;5;3;821950;CELULAR SMARTPHONE A52S 5G LIGHT VIOLET 128GB;TELEFONIA
13169433;Casado;M;45;CHILENO;;X;N/D;N/D;62980;2;1;0;0;0;2;1;62980;CELULAR NOKIA 225 4G BLACK MOVISTAR DIRECTO;TELEFONIA
22706788;;F;48;BOLIVIANO;;Extranjero;IQUIQUE                       ;TARAPACA;607850;4;2;0;0;0;4;2;607850;CELULAR A22 128GB NEGRO;TELEFONIA
19059588;;M;26;CHILENO;;Z;CAUQUENES                     ;MAULE;525960;4;3;0;0;0;4;3;525960;POCO X3 PRO 256 GB PHANTOM BLACK;TELEFONIA
24907793;;F;46;BOLIVIANO;;Extranjero;MEJILLONES                    ;ANTOFAGASTA;199640;2;1;2;1;199640;0;0;0;SMARTPHONE A22 BLANCO 128GB;TELEFONIA
26071688;;M;38;HAITIANO;;Extranjero;CERRO NAVIA                   ;METROPOLITANA;316960;4;2;0;0;0;4;2;316960;POCO X3 PRO 256 GB PHANTOM BLACK;TELEFONIA
16504020;;F;35;CHILENO;;Millenial;SAN PEDRO DE LA PAZ;BIO-BIO;343970;3;2;3;2;343970;0;0;0;CELULAR SMARTPHONE A52S 5G BLACK 128GB;TELEFONIA
18877579;;F;27;CHILENO;;Millenial;PARRAL                        ;MAULE;404970;3;3;0;0;0;3;3;404970;CELULAR VIVO Y11S 32GB NEBULA BLUE OPEN;TELEFONIA
17086755;Soltero;M;33;CHILENO;INGENIERO INDUSTRIAL;Millenial;VINA DEL MAR                  ;VALPARAISO;349990;1;1;0;0;0;1;1;349990;CELULAR XIAOMI 11T 8/256GB METEORITE GRAY OPEN;TELEFONIA
20032579;;M;23;CHILENO;;Z;CONCEPCION                    ;BIO BIO;199990;1;1;0;0;0;1;1;199990;CELULAR VIVO Y21S MIDNIGHT BLUE 128 GB OPEN;TELEFONIA
18930426;;F;27;CHILENO;;Millenial;PROVIDENCIA                   ;METROPOLITANA;19990;1;1;0;0;0;1;1;19990;CELULAR AZUMI L4G BLACK CLARO;TELEFONIA
9011637;Soltero;M;61;CHILENO;;Boomers;PROVIDENCIA                   ;METROPOLITANA;56980;2;2;0;0;0;2;2;56980;CELULAR NOKIA 225 4G BLACK MOVISTAR DIRECTO;TELEFONIA
13051665;;M;45;CHILENO;;Silencioso;PROVIDENCIA                   ;METROPOLITANA;79990;1;1;1;1;79990;0;0;0;CELULAR REDMI 9A 32GB PEACOCK GREEN;TELEFONIA
18559262;;M;28;CHILENO;;Millenial;SAN MIGUEL                    ;METROPOLITANA;1161960;4;3;2;1;853980;2;2;307980;CELULAR IPHONE 12 PRO MAX 128GB AZUL CLARO;TELEFONIA
18581482;Soltero;M;29;CHILENO;;Millenial;PROVIDENCIA                   ;METROPOLITANA;119990;1;1;0;0;0;1;1;119990;SMARTPHONE A03S NEGRO 32GB;TELEFONIA
15754231;;M;38;CHILENO;;X;PROVIDENCIA                   ;METROPOLITANA;2177950;6;2;6;2;2177950;0;0;0;Celular Galaxy S21 Ultra Phantom Black 128GB;TELEFONIA
8872204;;M;62;CHILENO;;Boomers;CHIMBARONGO                   ;L.G.B.OÂ´HIGGINS;104990;2;1;0;0;0;2;1;104990;CELULAR A12 128GB Azul OPEN;TELEFONIA
9736542;Soltero;M;57;CHILENO;;Boomers;RENCA                         ;METROPOLITANA;200980;2;1;0;0;0;2;1;200980;CELULAR SAMSUNG A12 128GB BLACK CLARO;TELEFONIA
18725236;;M;28;CHILENO;;Millenial;"";"";299990;1;1;1;1;299990;0;0;0;CELULAR SMARTPHONE A52S 5G BLACK 128GB;TELEFONIA
6119037;;M;72;CHILENO;;Silencioso;PROVIDENCIA                   ;METROPOLITANA;119991;2;1;0;0;0;2;1;119991;CELULAR VIVO Y11S 32GB NEBULA BLUE OPEN;TELEFONIA
13107853;;F;46;CHILENO;;X;MAIPU                         ;METROPOLITANA;239990;1;1;0;0;0;1;1;239990;CELULAR POCO X3 PRO 256 GB FROST BLUE;TELEFONIA
15092516;;F;39;CHILENO;;X;PROVIDENCIA                   ;METROPOLITANA;17990;1;1;1;1;17990;0;0;0;CELULAR NOKIA 110 BLACK OPEN;TELEFONIA
25231453;;M;36;HAITIANO;;Extranjero;MAIPU                         ;METROPOLITANA;594980;3;2;0;0;0;3;2;594980;CELULAR SMARTPHONE A52S 5G BLACK 128GB;TELEFONIA
26487289;Soltero;M;30;EXTRANJERO - NO INFORMA NACIONALIDAD;;Extranjero;RECOLETA                      ;METROPOLITANA;314970;4;3;0;0;0;4;3;314970;CELULAR MOTOROLA G30 GRIS WOM 128 GB;TELEFONIA
18374454;;M;29;CHILENO;;Millenial;N/D;N/D;122980;2;1;0;0;0;2;1;122980;CELULAR CLARO MOTOROLA E7 32GB GRIS;TELEFONIA
18698406;Soltero;F;28;CHILENO;;Millenial;QUINTA NORMAL;METROPOLITANA;150140;2;2;0;0;0;2;2;150140;CELULAR REDMI 9T 128GB SUNRISE ORANGE MOVISTAR;TELEFONIA
6834793;;F;73;CHILENO;;Silencioso;QUILPUE                       ;VALPARAISO;211970;3;2;0;0;0;3;2;211970;CELULAR VIVO Y11S 32GB NEBULA BLUE OPEN;TELEFONIA
5962491;;M;74;CHILENO;;Silencioso;LONGAVI                       ;MAULE;295981;3;1;0;0;0;3;1;295981;CELULAR XIAOMI POCO X3 PRO 128GB PANTHOM BLACK;TELEFONIA
18253172;Soltero;M;29;CHILENO;;Silencioso;PROVIDENCIA                   ;METROPOLITANA;109990;1;3;1;3;109990;0;0;0;CELULAR MOTOROLA G20 64GB BLUE CLARO;TELEFONIA
15063382;Soltero;M;40;CHILENO;INGENIERO INDUSTRIAL;X;PROVIDENCIA                   ;METROPOLITANA;109990;1;1;1;1;109990;0;0;0;CELULAR XIAOMI REDMI 9 64GB DIRECTO CLARO MORADO;TELEFONIA
13557058;;F;43;CHILENO;;X;CALERA DE TANGO               ;METROPOLITANA;109990;1;1;0;0;0;1;1;109990;CELULAR CLARO MOTOROLA E7 32GB GRIS;TELEFONIA
10893985;;M;55;CHILENO;;Boomers;PROVIDENCIA                   ;METROPOLITANA;69990;2;1;0;0;0;2;1;69990;NOKIA G10 3/64 GB BLUE TRI WOM;TELEFONIA
6820654;;F;71;CHILENO;;Silencioso;VICUNA                        ;COQUIMBO;639010;8;4;0;0;0;8;4;639010;CELULAR XIAOMI REDMI 9A 32GB GRANITE GRAY TRI WO;TELEFONIA
18186577;;M;30;CHILENO;;Millenial;EL BOSQUE                     ;METROPOLITANA;289980;2;2;1;1;89990;1;1;199990;CELULAR POCO X3 PRO 128G PHANTOM BLACK OPEN;TELEFONIA
19590163;Soltero;F;26;CHILENO;;Z;"";"";179980;2;2;0;0;0;2;2;179980;CELULAR A12 128GB Rojo OPEN;TELEFONIA
13833737;;F;43;CHILENO;;X;ARICA                         ;ARICA Y PARINACOTA;119990;1;1;1;1;119990;0;0;0;CELULAR MOTOROLA G9 PLAY 64GB ELECTRIC BLUE OPEN;TELEFONIA
25965750;;F;28;VENEZOLANO;;Extranjero;SANTIAGO                      ;METROPOLITANA;139990;1;1;0;0;0;1;1;139990;CELULAR MOTO ONE FUSION 128GB AZUL OPEN;TELEFONIA
19324931;Soltero;F;26;CHILENO;TECNICO DE NIVEL SUPERIOR EN ENFERMERIA;Z;PROVIDENCIA                   ;METROPOLITANA;84990;1;1;0;0;0;1;1;84990;CELULAR MOTOROLA E7 IPOWER 32GB BLUE CLARO;TELEFONIA
8389492;;M;68;CHILENO;;Silencioso;CANETE                        ;BIO BIO;139990;1;1;0;0;0;1;1;139990;CELULAR A12 128GB Rojo OPEN;TELEFONIA
8539050;;M;63;CHILENO;;Boomers;CHANCO                        ;MAULE;409980;2;2;0;0;0;2;2;409980;POCO X3 PRO 256 GB PHANTOM BLACK;TELEFONIA
13395027;;F;49;CHILENO;;X;TIRUA                         ;BIO BIO;239990;1;1;0;0;0;1;1;239990;CELULAR POCO X3 PRO 256 GB FROST BLUE;TELEFONIA
12742485;;M;46;CHILENO;;X;TEODORO SCHMIDT               ;ARAUCANIA;149990;1;1;0;0;0;1;1;149990;CELULAR A12 128GB Negro OPEN;TELEFONIA
15167429;;F;40;CHILENO;;X;YUNGAY                        ;BIO BIO;198650;4;2;0;0;0;4;2;198650;MOTO G20 AZUL CIELO 64GB MOVISTAR;TELEFONIA
19442103;;F;25;CHILENO;;Z;PROVIDENCIA                   ;METROPOLITANA;399990;1;1;0;0;0;1;1;399990;CELULAR GALAXY S20FE 128GB CLOUD LAVENDER OPEN;TELEFONIA
15367519;;F;53;CHILENO;;X;SAN RAMON                     ;METROPOLITANA;89990;2;1;0;0;0;2;1;89990;SMARTPHONE A03S 64 GB NEGRO;TELEFONIA
12190023;;F;53;CHILENO;;X;COLLIPULLI                    ;ARAUCANIA;441950;5;4;0;0;0;5;4;441950;CELULAR POCO X3 PRO 256 GB FROST BLUE;TELEFONIA
20057528;;F;23;CHILENO;;Z;PROVIDENCIA                   ;METROPOLITANA;1189930;6;3;6;3;1189930;0;0;0;CELULAR A22 128GB NEGRO;TELEFONIA
12721429;;F;47;CHILENO;;X;LA FLORIDA                    ;METROPOLITANA;57980;3;1;0;0;0;3;1;57980;CELULAR SMARTPHONE 1B ALCATEL PRIME BLACK;TELEFONIA
23237587;;F;36;PERUANO;;Extranjero;SANTIAGO                      ;METROPOLITANA;539990;2;1;0;0;0;2;1;539990;IPHONE 11 64GB BLACK CLARO;TELEFONIA
9160179;Casado;F;60;CHILENO;;Boomers;PROVIDENCIA                   ;METROPOLITANA;121990;3;1;0;0;0;3;1;121990;CELULAR REDMI 9T 128GB SUNRISE ORANGE MOVISTAR;TELEFONIA
19987897;;F;23;CHILENO;;Z;MOSTAZAL                      ;L.G.B.OÂ´HIGGINS;259990;1;1;0;0;0;1;1;259990;CELULAR RENO5 LITE NEGRO 128GB;TELEFONIA
18323583;;F;29;CHILENO;;Millenial;N/D;N/D;196970;3;3;0;0;0;3;3;196970;SMARTPHONE A03S AZUL 32GB;TELEFONIA
13151021;;M;45;CHILENO;;X;ANGOL                         ;ARAUCANIA;159990;1;1;0;0;0;1;1;159990;CELULAR A21s 128 GB Rojo;TELEFONIA
9751040;;F;56;CHILENO;;Boomers;N/D;N/D;181980;2;1;0;0;0;2;1;181980;CELULAR Moto G20 Rosado WOM;TELEFONIA
11180770;;M;55;CHILENO;;Boomers;LOS VILOS                     ;COQUIMBO;591952;5;5;0;0;0;5;5;591952;SMARTPHONE A22 BLANCO 128GB;TELEFONIA
19000309;;M;27;CHILENO;;Z;PROVIDENCIA                   ;METROPOLITANA;319990;1;1;0;0;0;1;1;319990;CELULAR SMARTPHONE A52S 5G LIGHT GREEN 128GB;TELEFONIA
10275563;;M;55;CHILENO;;Boomers;TALCAHUANO                    ;BIO BIO;239991;2;1;0;0;0;2;1;239991;CELULAR POCO X3 PRO 256 GB FROST BLUE;TELEFONIA
16733171;;M;34;CHILENO;;Millenial;ALTO DEL CARMEN               ;ATACAMA;140980;2;1;0;0;0;2;1;140980;CELULAR A12 128GB Negro OPEN;TELEFONIA
9802149;Casado;F;59;CHILENO;;Boomers;RENCA                         ;METROPOLITANA;239990;1;1;0;0;0;1;1;239990;POCO X3 PRO 256 GB PHANTOM BLACK;TELEFONIA
12360170;;M;49;CHILENO;;X;LA FLORIDA                    ;METROPOLITANA;119990;1;1;0;0;0;1;1;119990;SMARTPHONE A03S AZUL 32GB;TELEFONIA
13633066;;M;43;CHILENO;;X;CONCEPCION                    ;BIO BIO;279990;1;1;0;0;0;1;1;279990;SMARTPHONE A52S 5G WHITE 128GB;TELEFONIA
16605024;;F;35;CHILENO;;Millenial;PROVIDENCIA                   ;METROPOLITANA;74990;1;1;0;0;0;1;1;74990;CELULAR MOTOROLA E6S GRIS 32GB DIRECTO WOM;TELEFONIA
16783747;;M;34;CHILENO;;Millenial;PROVIDENCIA                   ;METROPOLITANA;701690;3;1;3;1;701690;0;0;0;Celular Galaxy S21 Plus Phantom Silver 128GB;TELEFONIA
17427609;;F;32;CHILENO;;Millenial;N/D;N/D;471930;7;4;6;3;341940;1;1;129990;IPHONE 7 32GB LIB OPEN DORADO;TELEFONIA
20372297;;M;21;CHILENO;;Z;PROVIDENCIA                   ;METROPOLITANA;279990;1;1;1;1;279990;0;0;0;CELULAR SMARTPHONE A52S 5G BLACK 128GB;TELEFONIA
17889727;;F;30;CHILENO;;Millenial;N/D;N/D;199990;1;1;0;0;0;1;1;199990;CELULAR POCO X3 PRO 128G PHANTOM BLACK OPEN;TELEFONIA
17791257;;M;31;CHILENO;;Millenial;QUINTA NORMAL;METROPOLITANA;634980;2;1;2;1;634980;0;0;0;Celular Galaxy S21 Phantom Pink 128GB;TELEFONIA
15059863;;M;40;CHILENO;;X;"";"";213980;2;1;2;1;213980;0;0;0;CELULAR REDMI NOTE 10S 128GB OCEAN BLUE;TELEFONIA
11233944;;F;54;CHILENO;;X;N/D;N/D;662970;3;2;0;0;0;3;2;662970;IPHONE XR 64GB LIB OPEN BLANCO;TELEFONIA
18527976;;F;29;CHILENO;;Millenial;PROVIDENCIA                   ;METROPOLITANA;149990;1;1;0;0;0;1;1;149990;CELULAR MOTO G30 128GB GRIS TORNASOL OPEN;TELEFONIA
15496517;;M;40;CHILENO;;X;SAAVEDRA                      ;ARAUCANIA;344980;2;2;0;0;0;2;2;344980;CELULAR A32 128 GB BLACK OPEN;TELEFONIA
12027744;;F;55;CHILENO;;Boomers;PUENTE ALTO                   ;METROPOLITANA;109990;1;1;0;0;0;1;1;109990;CELULAR XIAOMI REDMI 9C 32GB AZUL WOM;TELEFONIA
14170663;;M;42;CHILENO;;X;LA FLORIDA                    ;METROPOLITANA;117980;2;1;0;0;0;2;1;117980;CELULAR VIVO Y11S PHANTON BLACK 32GB MOVISTAR;TELEFONIA
10746492;;M;53;CHILENO;;X;PROVIDENCIA                   ;METROPOLITANA;283980;2;1;2;1;283980;0;0;0;CELULAR SMARTPHONE A52S 5G BLACK 128GB;TELEFONIA
11443906;;F;53;CHILENO;;X;SAN FABIAN                    ;BIO BIO;125470;3;1;0;0;0;3;1;125470;CELULAR XIAOMI REDMI 9 64GB DIRECTO CLARO MORADO;TELEFONIA
6519316;;F;72;CHILENO;;Silencioso;SAN FELIPE                    ;VALPARAISO;349980;4;1;0;0;0;4;1;349980;CELULAR VIVO Y53S FANTASTIC RAINBOW 128GB OPEN;TELEFONIA
10950872;;M;54;CHILENO;;Boomers;RENCA                         ;METROPOLITANA;109980;3;1;0;0;0;3;1;109980;CELULAR XIAOMI REDMI 9C 32GB AZUL WOM;TELEFONIA
17319618;;F;31;CHILENO;;Millenial;SAN FERNANDO                  ;L.G.B.OÂ´HIGGINS;423960;4;4;2;2;409980;2;2;13980;SMARTPHONE A03S 64 GB NEGRO;TELEFONIA
15928689;;M;37;CHILENO;;Millenial;PROVIDENCIA                   ;METROPOLITANA;99991;2;1;0;0;0;2;1;99991;CELULAR VIVO Y11S 32GB NEBULA BLUE OPEN;TELEFONIA
18506575;;M;29;CHILENO;;Millenial;N/D;N/D;199980;2;1;2;1;199980;0;0;0;CELULAR MOTOROLA G20 64GB BLUE CLARO;TELEFONIA
10221454;Casado;F;57;CHILENO;;Boomers;RENCA                         ;METROPOLITANA;36990;1;1;0;0;0;1;1;36990;CELULAR NOKIA 225 4G BLACK MOVISTAR DIRECTO;TELEFONIA
15196492;;M;39;CHILENO;;X;ARAUCO                        ;BIO BIO;199980;2;2;0;0;0;2;2;199980;CELULAR A32 128 GB BLUE OPEN;TELEFONIA
12509536;;F;49;CHILENO;;X;BUIN                          ;METROPOLITANA;189990;1;1;0;0;0;1;1;189990;REDMI 10 US 128GB Carbon Gray;TELEFONIA
18950713;;F;27;CHILENO;;Millenial;N/D;N/D;449970;3;4;0;0;0;3;4;449970;CELULAR MOTO G30 128GB LILA PASTEL OPEN;TELEFONIA
18443963;;F;28;CHILENO;;Millenial;PUENTE ALTO                   ;METROPOLITANA;113980;2;1;2;1;113980;0;0;0;CELULAR SAMSUNG A02S DIRECTO CLARO BLACK;TELEFONIA
14204534;;F;42;CHILENO;;X;PICHIDEGUA                    ;L.G.B.OÂ´HIGGINS;411970;3;2;0;0;0;3;2;411970;CELULAR REDMI 9T 128 GB OCEAN GREEN;TELEFONIA
16152647;;F;36;CHILENO;;Millenial;PROVIDENCIA                   ;METROPOLITANA;285840;2;1;2;1;285840;0;0;0;CELULAR SMARTPHONE A52S 5G BLACK 128GB;TELEFONIA
14055371;;F;41;CHILENO;;X;SAN CLEMENTE                  ;MAULE;139991;2;1;0;0;0;2;1;139991;CELULAR VIVO Y20S NEBULA 128 GB BLUE OPEN;TELEFONIA
8197178;;F;64;CHILENO;;Boomers;ANGOL                         ;ARAUCANIA;359970;3;1;0;0;0;3;1;359970;CELULAR MOTO G60S 6/128 GB AZUL;TELEFONIA
14047318;;M;41;CHILENO;;X;SAN ANTONIO                   ;VALPARAISO;190140;2;1;0;0;0;2;1;190140;REDMI 10 US 128GB Carbon Gray;TELEFONIA
19345439;;M;26;CHILENO;;Z;LINARES                       ;MAULE;354980;3;2;0;0;0;3;2;354980;CELULAR REDMI NOTE 8 2021 64GB NEPTUNE BLUE;TELEFONIA
14253470;;M;47;CHILENO;;X;PROVIDENCIA                   ;METROPOLITANA;124980;2;1;2;1;124980;0;0;0;CELULAR MOTO G20 64GB ROSA FLAMINGO OPEN;TELEFONIA
19887944;;M;24;CHILENO;;Z;LOS ANDES                     ;VALPARAISO;990;1;1;0;0;0;1;1;990;CHIP OPEN ENTEL;TELEFONIA
9631463;;F;61;CHILENO;;Boomers;RETIRO                        ;MAULE;461960;4;2;0;0;0;4;2;461960;CELULAR Moto One Fusion 128GB Blue WOM;TELEFONIA
11274934;;M;54;CHILENO;;X;ESTACION CENTRAL              ;METROPOLITANA;349540;5;3;0;0;0;5;3;349540;POCO X3 PRO 256 GB PHANTOM BLACK;TELEFONIA
12005015;Soltero;M;50;CHILENO;ABOGADO;X;"";"";99990;1;1;1;1;99990;0;0;0;CELULAR NOKIA 5.3 CHARCOAL TRI ENTEL;TELEFONIA
16349203;;F;36;CHILENO;;Millenial;VILLARICA                     ;ARAUCANIA;225980;2;1;0;0;0;2;1;225980;CELULAR A32 128 GB LIGHT VIOLET OPEN;TELEFONIA
18494230;;F;29;CHILENO;;Millenial;LA SERENA                     ;COQUIMBO;122970;4;2;0;0;0;4;2;122970;XIAOMI REDMI 9T GRIS WOM 128 GB;TELEFONIA
10822592;;M;53;CHILENO;;X;ARICA                         ;TARAPACA;614980;2;2;0;0;0;2;2;614980;Celular Galaxy S21 Phantom Grey 128GB;TELEFONIA
18877610;Soltero;F;27;CHILENO;;Millenial;PROVIDENCIA                   ;METROPOLITANA;99990;1;1;0;0;0;1;1;99990;CELULAR VIVO Y11s PHANTOM BLACK ENTEL DIRECTO;TELEFONIA
25821034;;M;47;EXTRANJERO - NO INFORMA NACIONALIDAD;;Extranjero;PUDAHUEL                      ;METROPOLITANA;230980;2;1;0;0;0;2;1;230980;CELULAR A22 128GB NEGRO;TELEFONIA
16398585;;M;35;CHILENO;;Millenial;N/D;N/D;229990;1;1;1;1;229990;0;0;0;CELULAR POCO X3 PRO 256 GB FROST BLUE;TELEFONIA
19155828;;F;26;CHILENO;;Z;PROVIDENCIA                   ;METROPOLITANA;219990;1;1;0;0;0;1;1;219990;CELULAR HUAWEI Y9A BLACK OPEN;TELEFONIA
23546126;;F;53;DOMINICANO;;Extranjero;RECOLETA                      ;METROPOLITANA;220980;2;1;0;0;0;2;1;220980;CELULAR A22 128GB NEGRO;TELEFONIA
10735317;;F;55;CHILENO;;Boomers;SAN BERNARDO                  ;METROPOLITANA;94990;1;1;0;0;0;1;1;94990;CELULAR CLARO MOTOROLA E7 32GB GRIS;TELEFONIA
16779747;Soltero;F;34;CHILENO;PROFESOR;Millenial;PROVIDENCIA                   ;METROPOLITANA;229990;1;1;1;1;229990;0;0;0;POCO X3 PRO 256 GB PHANTOM BLACK;TELEFONIA
10014515;;M;56;CHILENO;;Boomers;RENCA                         ;METROPOLITANA;239991;2;1;0;0;0;2;1;239991;CELULAR POCO X3 PRO 256 GB FROST BLUE;TELEFONIA
9221923;;M;60;CHILENO;;Silencioso;PROVIDENCIA                   ;METROPOLITANA;319970;4;2;0;0;0;4;2;319970;CELULAR A12 128GB Negro OPEN;TELEFONIA
10240931;;F;54;CHILENO;;Boomers;CONCEPCION                    ;N/D;265961;5;2;0;0;0;5;2;265961;CELULAR XIAOMI POCO X3 PRO 128GB PANTHOM BLACK;TELEFONIA
14014939;;M;42;CHILENO;;X;TENO                          ;MAULE;274990;1;1;0;0;0;1;1;274990;CELULAR SMARTPHONE A52S 5G BLACK 128GB;TELEFONIA
13366440;;F;44;CHILENO;;X;CATEMU                        ;VALPARAISO;564980;2;1;0;0;0;2;1;564980;CELULAR XIAOMI 11T 8/256GB CELESTIAL BLUE KIT;TELEFONIA
9561733;;M;59;CHILENO;;Boomers;ILLAPEL                       ;COQUIMBO;135980;2;1;0;0;0;2;1;135980;CELULAR MOTO E7 GRIS MINERAL MOVISTAR;TELEFONIA
12683292;;F;48;CHILENO;;X;SAN RAMON                     ;METROPOLITANA;289990;1;1;0;0;0;1;1;289990;CELULAR SMARTPHONE A52S 5G LIGHT VIOLET 128GB;TELEFONIA
4053186;;F;82;CHILENO;;Silencioso;TALCA                         ;MAULE;99991;2;1;0;0;0;2;1;99991;CELULAR VIVO Y11S 32GB NEBULA BLUE OPEN;TELEFONIA
15404648;;M;40;CHILENO;;X;N/D;N/D;213960;4;2;0;0;0;4;2;213960;CELULAR MOTO G9 POWER 128GB MORADO SONICO OPEN;TELEFONIA
11784737;;F;51;CHILENO;;X;ILLAPEL                       ;COQUIMBO;119990;1;1;0;0;0;1;1;119990;SMARTPHONE A03S NEGRO 32GB;TELEFONIA
8850759;;F;58;CHILENO;;Boomers;N/D;N/D;546960;4;3;0;0;0;4;3;546960;SMARTPHONE A03S AZUL 32GB;TELEFONIA
15326908;;F;40;CHILENO;;X;ISLA DE MAIPO                 ;METROPOLITANA;69990;1;1;0;0;0;1;1;69990;CELULAR A02 ROJO 32GB OPEN;TELEFONIA
14320138;;F;46;CHILENO;;X;SAN CARLOS                    ;BIO BIO;99990;1;1;0;0;0;1;1;99990;CELULAR VIVO Y11S 32GB NEBULA BLUE OPEN;TELEFONIA
16470394;;F;35;CHILENO;;Millenial;N/D;N/D;183980;2;1;2;1;183980;0;0;0;IPHONE 7 32GB LIB OPEN DORADO;TELEFONIA
10521286;;M;56;CHILENO;;Boomers;VALLENAR;ATACAMA;129991;2;1;0;0;0;2;1;129991;CELULAR MOTOROLA G9 PLAY 64GB ELECTRIC BLUE OPEN;TELEFONIA
14056903;;M;40;CHILENO;;Millenial;CHANCO                        ;MAULE;369980;3;2;0;0;0;3;2;369980;XIAOMI REDMI 9T GRIS WOM 128 GB;TELEFONIA
14322745;;F;45;CHILENO;;X;N/D;N/D;249980;2;2;0;0;0;2;2;249980;CELULAR XIAOMI REDMI 9T 128GB VERDE CLARO;TELEFONIA
17536031;;F;41;CHILENO;;X;PROVIDENCIA                   ;METROPOLITANA;149990;1;1;0;0;0;1;1;149990;CELULAR XIAOMI REDMI 9T 128GB BLACK CLARO;TELEFONIA
11410429;Soltero;M;53;CHILENO;;X;RENCA                         ;METROPOLITANA;129990;2;1;0;0;0;2;1;129990;SMARTPHONE A22 VERDE 128GB;TELEFONIA
16017709;;F;37;CHILENO;;Millenial;PROVIDENCIA                   ;METROPOLITANA;879990;1;1;1;1;879990;0;0;0;Celular Galaxy S21 Ultra Phantom Black 128GB;TELEFONIA
12715903;;F;47;CHILENO;;X;RENCA                         ;METROPOLITANA;191980;2;1;0;0;0;2;1;191980;Celular XIAOMI REDMI 9 64 GB DIRECTO CLARO NEGRO;TELEFONIA
19364280;;F;25;CHILENO;;Z;PROVIDENCIA                   ;METROPOLITANA;104680;4;2;4;2;104680;0;0;0;IPHONE 5S 16GB DORADO OPEN;TELEFONIA
8759123;;F;62;CHILENO;;Boomers;SAGRADA FAMILIA               ;MAULE;429980;3;2;0;0;0;3;2;429980;CELULAR POCO X3 PRO 256 GB FROST BLUE;TELEFONIA
14495676;;F;46;CHILENO;;X;LOTA                          ;BIO BIO;485830;3;2;2;1;325840;1;1;159990;CELULAR SAMSUNG A12 128GB BLACK CLARO;TELEFONIA
13013982;;F;46;CHILENO;;X;PROVIDENCIA                   ;METROPOLITANA;253980;2;1;0;0;0;2;1;253980;CELULAR A32 128 GB LIGHT VIOLET OPEN;TELEFONIA
6449220;Divorciado;F;71;CHILENO;;Silencioso;PROVIDENCIA                   ;METROPOLITANA;127981;3;1;0;0;0;3;1;127981;CELULAR VIVO Y11S 32GB NEBULA BLUE OPEN;TELEFONIA
19496997;;F;24;CHILENO;;Z;IQUIQUE                       ;TARAPACA;119990;1;1;1;1;119990;0;0;0;CELULAR MOTO G20 64GB ROSA FLAMINGO OPEN;TELEFONIA
23413365;;F;49;ARGENTINO;;Extranjero;N/D;N/D;129990;1;1;0;0;0;1;1;129990;SMARTPHONE A03S AZUL 32GB;TELEFONIA
15254376;;M;40;CHILENO;;X;BUIN                          ;METROPOLITANA;704950;5;4;0;0;0;5;4;704950;Celular XIAOMI REDMI 9 64 GB DIRECTO CLARO NEGRO;TELEFONIA
6526066;;M;71;CHILENO;;Silencioso;PUREN                         ;ARAUCANIA;306960;4;1;0;0;0;4;1;306960;Celular XIAOMI REDMI 9 64 GB DIRECTO CLARO NEGRO;TELEFONIA
19967839;;F;23;CHILENO;;Z;"";"";394970;3;2;0;0;0;3;2;394970;CELULAR IPHONE SE 64GB DIRECTO CLARO;TELEFONIA
24433396;;M;34;COLOMBIANO;;Extranjero;N/D;N/D;749990;1;1;0;0;0;1;1;749990;Celular Galaxy S21 Plus Phantom Violet 128GB;TELEFONIA
16197621;;F;37;CHILENO;;Millenial;CERRO NAVIA;METROPOLITANA;119990;1;1;1;1;119990;0;0;0;CELULAR MOTO ONE FUSION 128GB AZUL OPEN;TELEFONIA
7647841;;M;64;CHILENO;;Boomers;COIHAIQUE                     ;AYSEN;464960;4;2;0;0;0;4;2;464960;CELULAR Moto G20 Blue WOM;TELEFONIA
13580495;;F;42;CHILENO;;X;ANGOL                         ;ARAUCANIA;209990;1;1;0;0;0;1;1;209990;CELULAR POCO X3 PRO 128 GB FROST BLUE;TELEFONIA
7454517;;M;67;CHILENO;;Boomers;LO ESPEJO                     ;METROPOLITANA;289990;1;1;0;0;0;1;1;289990;CELULAR SMARTPHONE A52S 5G LIGHT GREEN 128GB;TELEFONIA
11926263;;F;50;CHILENO;;X;FRESIA                        ;LOS LAGOS;214970;3;1;0;0;0;3;1;214970;CELULAR A12 128GB Azul OPEN;TELEFONIA
15573616;;M;38;CHILENO;;Millenial;MONTE PATRIA                  ;COQUIMBO;151960;4;1;0;0;0;4;1;151960;CELULAR VIVO Y11S 32GB NEBULA BLUE OPEN;TELEFONIA
10038022;;M;58;CHILENO;;Boomers;RENCA                         ;METROPOLITANA;359990;1;1;0;0;0;1;1;359990;CELULAR XIAOMI 11 LITE 5G NE 8/128GB TRUFFLE BLA;TELEFONIA
14402984;;M;51;CHILENO;;X;HUALPEN;BIO BIO;328980;2;1;0;0;0;2;1;328980;CELULAR POCO X3 PRO 256 GB FROST BLUE;TELEFONIA
11383534;;M;52;CHILENO;;X;PUNITAQUI                     ;COQUIMBO;752981;3;2;0;0;0;3;2;752981;Celular Galaxy S21 Plus Phantom Violet 128GB;TELEFONIA
10878485;;M;55;CHILENO;;Boomers;RENCA                         ;METROPOLITANA;239990;1;1;1;1;239990;0;0;0;CELULAR MI 11 LITE 128GB BOBA BLACK OPEN;TELEFONIA
16768001;;F;34;CHILENO;;Millenial;PROVIDENCIA                   ;METROPOLITANA;46990;3;1;0;0;0;3;1;46990;CELULAR VIVO Y11S PHANTON BLACK 32GB MOVISTAR;TELEFONIA
10929557;Casado;M;52;CHILENO;INGENIERO MECANICO;X;RENCA                         ;METROPOLITANA;181980;2;1;0;0;0;2;1;181980;SMARTPHONE A03S AZUL 32GB;TELEFONIA
10578383;;F;55;CHILENO;;Boomers;RENCA                         ;METROPOLITANA;279982;4;1;0;0;0;4;1;279982;CELULAR MOTO G20 64GB ROSA FLAMINGO OPEN;TELEFONIA
19896468;;F;23;CHILENO;;Z;N/D;N/D;189990;1;1;1;1;189990;0;0;0;CELULAR A32 128 GB BLUE OPEN;TELEFONIA
18843996;;F;27;CHILENO;;Z;N/D;N/D;109990;1;1;1;1;109990;0;0;0;CELULAR MOTOROLA G20 64GB BLUE CLARO;TELEFONIA
6755725;Casado;F;71;CHILENO;;Silencioso;SAN PEDRO DE LA PAZ           ;BIO BIO;453800;6;3;6;3;453800;0;0;0;POCO X3 PRO 256 GB PHANTOM BLACK;TELEFONIA
14425465;;M;50;CHILENO;;X;PROVIDENCIA                   ;METROPOLITANA;219980;2;1;2;1;219980;0;0;0;CELULAR HUAWEI Y7P NEGRO ENTEL;TELEFONIA
15202141;;F;39;CHILENO;;X;COLINA                        ;METROPOLITANA;438960;4;3;2;1;209980;2;2;228980;CELULAR XIAOMI POCO X3 PRO 128GB PANTHOM BLACK;TELEFONIA
12652308;;M;48;CHILENO;;X;PROVIDENCIA                   ;METROPOLITANA;279990;1;1;1;1;279990;0;0;0;CELULAR SMARTPHONE A52S 5G LIGHT VIOLET 128GB;TELEFONIA
11019032;;F;56;CHILENO;;Boomers;VILLARICA                     ;ARAUCANIA;299990;1;1;0;0;0;1;1;299990;CELULAR SMARTPHONE A52S 5G BLACK 128GB;TELEFONIA
13412290;;F;44;CHILENO;;X;PROVIDENCIA                   ;METROPOLITANA;54990;2;1;0;0;0;2;1;54990;Celular NOKIA 4.2 ENTEL DIRECTO NEGRO;TELEFONIA
14756544;;M;52;SIRIO;;X;PROVIDENCIA                   ;METROPOLITANA;153980;2;1;2;1;153980;0;0;0;CELULAR MOTO G30 128GB GRIS TORNASOL OPEN;TELEFONIA
12023165;;F;54;CHILENO;;Boomers;LOS VILOS                     ;COQUIMBO;219990;1;1;0;0;0;1;1;219990;CELULAR REDMI NOTE 10S 128GB PEBBLE WHITE;TELEFONIA
14017095;;M;43;CHILENO;;X;"";"";599990;1;1;0;0;0;1;1;599990;Celular Galaxy S21 Phantom Grey 128GB;TELEFONIA
15748513;;F;38;CHILENO;;Millenial;SAN BERNARDO                  ;METROPOLITANA;279980;2;1;0;0;0;2;1;279980;CELULAR MOTO G20 64GB AZUL OPEN;TELEFONIA
15223700;;M;39;CHILENO;;X;SAN FELIPE                    ;VALPARAISO;139990;1;1;0;0;0;1;1;139990;CELULAR MOTO G20 64GB ROSA FLAMINGO OPEN;TELEFONIA
10568727;;F;54;CHILENO;;X;RENCA                         ;METROPOLITANA;240980;2;1;0;0;0;2;1;240980;CELULAR A32 128 GB BLACK OPEN;TELEFONIA
19111950;;M;27;CHILENO;;Z;N/D;N/D;139990;1;1;0;0;0;1;1;139990;CELULAR MOTO G30 128GB GRIS TORNASOL OPEN;TELEFONIA
10518658;;M;55;CHILENO;;Boomers;RENCA                         ;METROPOLITANA;139990;1;1;0;0;0;1;1;139990;CELULAR A12 128GB Azul OPEN;TELEFONIA
19356295;Soltero;F;25;CHILENO;;Z;PROVIDENCIA                   ;METROPOLITANA;214980;2;1;2;1;214980;0;0;0;POCO X3 PRO 256 GB PHANTOM BLACK;TELEFONIA
19218453;Soltero;M;26;CHILENO;ABOGADO;Z;N/D;N/D;213980;2;1;2;1;213980;0;0;0;POCO X3 PRO 256 GB PHANTOM BLACK;TELEFONIA
8908249;;M;61;CHILENO;;Millenial;PROVIDENCIA                   ;METROPOLITANA;24990;1;1;0;0;0;1;1;24990;CELULAR AZUMI L4G BLACK CLARO;TELEFONIA
14020332;;M;41;CHILENO;;X;SAN JAVIER                    ;MAULE;219980;2;2;0;0;0;2;2;219980;CELULAR MOTOROLA G9 PLAY 64GB ELECTRIC BLUE OPEN;TELEFONIA
11628117;Soltero;M;52;CHILENO;QUIMICO FARMACEUTICO;X;RENCA                         ;METROPOLITANA;1367920;8;2;8;2;1367920;0;0;0;CELULAR POCO X3 PRO 128 GB FROST BLUE;TELEFONIA
12473707;;M;49;CHILENO;;X;SAN RAMON;METROPOLITANA;103980;2;1;2;1;103980;0;0;0;Celular Y7P LIB OPEN NEGRO;TELEFONIA
7728834;;F;81;CHILENO;;Silencioso;CORONEL                       ;BIO BIO;119480;2;1;0;0;0;2;1;119480;CELULAR VIVO Y11S PHANTON BLACK 32GB MOVISTAR;TELEFONIA
15241137;;F;62;CHILENO;;Boomers;SAAVEDRA                      ;ARAUCANIA;376960;3;2;0;0;0;3;2;376960;CELULAR POCO M3 128GB POWER BLACK;TELEFONIA
15694822;;F;38;CHILENO;;Millenial;ARICA                         ;ARICA Y PARINACOTA;88990;1;1;0;0;0;1;1;88990;CELULAR VIVO Y11s PHANTOM BLACK ENTEL DIRECTO;TELEFONIA
26441248;;F;44;NO INFORMA NACIONALIDAD;;Extranjero;"";"";69990;1;1;1;1;69990;0;0;0;CELULAR MOTOROLA E7 IPOWER 32GB BLUE CLARO;TELEFONIA
17634284;Casado;F;32;CHILENO;PROFESOR;Millenial;PROVIDENCIA                   ;METROPOLITANA;99990;1;1;1;1;99990;0;0;0;CELULAR REDMI 9C 64GB SUNRISE ORANGE;TELEFONIA
17000771;;F;32;CHILENO;;Millenial;CORONEL                       ;BIO BIO;36990;1;3;0;0;0;1;3;36990;CELULAR NOKIA 225 4G BLACK MOVISTAR DIRECTO;TELEFONIA
18178822;;F;30;CHILENO;;Millenial;N/D;N/D;548970;3;3;0;0;0;3;3;548970;CELULAR A12 128GB Azul OPEN;TELEFONIA
9364550;;M;60;CHILENO;;Boomers;CONTULMO                      ;BIO BIO;179980;2;1;0;0;0;2;1;179980;CELULAR A12 128GB Negro OPEN;TELEFONIA
25098609;;M;27;CHILENO;;Extranjero;LO PRADO                      ;METROPOLITANA;267960;4;2;4;2;267960;0;0;0;CELULAR REDMI 9 64GB SUNSET PURPLE TRI WOM;TELEFONIA
9720701;;F;59;CHILENO;;Boomers;PARRAL                        ;MAULE;129480;2;1;0;0;0;2;1;129480;CELULAR VIVO Y11S NEBULA BLUE 32GB OPEN;TELEFONIA
14247519;;M;47;CHILENO;;X;SAN VICENTE                   ;L.G.B.OÂ´HIGGINS;149990;1;1;0;0;0;1;1;149990;CELULAR Moto One Fusion 128GB Blue WOM;TELEFONIA
17458436;;F;32;CHILENO;;Millenial;CHILLAN;BIO-BIO;189990;2;1;0;0;0;2;1;189990;CELULAR POCO X3 PRO 128G PHANTOM BLACK OPEN;TELEFONIA
10888361;;F;56;CHILENO;;Boomers;NUEVA IMPERIAL                ;ARAUCANIA;199990;1;1;0;0;0;1;1;199990;POCO X3 PRO US 128G METAL BRONZE;TELEFONIA
12966599;;M;45;CHILENO;;X;PARRAL                        ;MAULE;89990;1;1;0;0;0;1;1;89990;CELULAR REDMI 9A 32GB PEACOCO GREEN DIREC MOVIST;TELEFONIA
26293623;;M;42;COLOMBIANO;;Extranjero;CALERA DE TANGO               ;METROPOLITANA;219990;1;1;0;0;0;1;1;219990;CELULAR POCO X3 PRO 128 GB FROST BLUE;TELEFONIA
15209334;;F;40;CHILENO;;X;SANTA BARBARA                 ;BIO BIO;249990;1;1;0;0;0;1;1;249990;POCO X3 PRO 256 GB PHANTOM BLACK;TELEFONIA
12562285;;M;47;CHILENO;;X;RENCA                         ;METROPOLITANA;179980;2;1;0;0;0;2;1;179980;CELULAR A12 128GB Azul OPEN;TELEFONIA
17988091;Soltero;F;30;CHILENO;;Millenial;PARRAL                        ;MAULE;179990;1;1;0;0;0;1;1;179990;SMARTPHONE A22 VERDE 128GB;TELEFONIA
17090666;;M;33;CHILENO;;Millenial;PARRAL                        ;MAULE;274980;2;1;0;0;0;2;1;274980;CELULAR POCO X3 PRO 128G PHANTOM BLACK OPEN;TELEFONIA
16086962;;F;36;CHILENO;;Silencioso;PROVIDENCIA                   ;METROPOLITANA;96480;2;1;0;0;0;2;1;96480;CELULAR MOTOROLA E7 IPOWER 32GB BLUE CLARO;TELEFONIA
14550241;;F;42;CHILENO;;X;RENCA                         ;METROPOLITANA;139990;1;1;1;1;139990;0;0;0;CELULAR Moto One Fusion 128GB Blue WOM;TELEFONIA
5394623;;M;70;CHILENO;;Silencioso;RENCA                         ;METROPOLITANA;149990;1;1;0;0;0;1;1;149990;CELULAR A12 128GB Azul OPEN;TELEFONIA
11698060;;M;51;CHILENO;;X;ISLA DE MAIPO                 ;METROPOLITANA;404970;3;2;0;0;0;3;2;404970;VIVO Y53S DEEP SEA BLUE 128GB OPEN;TELEFONIA
16448742;Soltero;F;35;CHILENO;PROFESOR;Millenial;CASTRO                        ;LOS LAGOS;141980;2;2;0;0;0;2;2;141980;CELULAR MOTOROLA G20 64GB BLUE CLARO;TELEFONIA
15240895;;F;41;CHILENO;;X;SAAVEDRA                      ;ARAUCANIA;179990;1;1;0;0;0;1;1;179990;SMARTPHONE A22 VERDE 128GB;TELEFONIA
11514457;;F;52;CHILENO;;X;PROVIDENCIA                   ;METROPOLITANA;712980;2;1;0;0;0;2;1;712980;IPHONE 11 128GB BLACK CLARO;TELEFONIA
10259422;;F;55;CHILENO;;Boomers;MELIPILLA                     ;METROPOLITANA;134990;1;1;0;0;0;1;1;134990;CELULAR XIAOMI REDMI 9T 128GB BLACK CLARO;TELEFONIA
13882530;;M;42;CHILENO;;Millenial;PROVIDENCIA                   ;METROPOLITANA;127960;4;2;4;2;127960;0;0;0;Celular ZTE A3 2020 ENTEL DIRECTO GRIS;TELEFONIA
19278625;Soltero;M;26;CHILENO;TECNICO EN AUTOMATIZACION Y CONTROL INDUSTRIAL;Z;PROVIDENCIA                   ;METROPOLITANA;183980;2;1;2;1;183980;0;0;0;CELULAR A32 128 GB LIGHT VIOLET OPEN;TELEFONIA
5998779;Casado;F;69;CHILENO;;Silencioso;RENCA                         ;METROPOLITANA;119990;1;1;1;1;119990;0;0;0;CELULAR A12 128GB Negro OPEN;TELEFONIA
9710786;;F;60;CHILENO;;Boomers;PUTAENDO                      ;VALPARAISO;99990;1;1;0;0;0;1;1;99990;CELULAR MOTO E7 GRIS MINERAL MOVISTAR;TELEFONIA
25275306;;F;41;HAITIANO;;Extranjero;SAN JOAQUIN                   ;METROPOLITANA;149980;2;1;0;0;0;2;1;149980;CELULAR MOTOROLA G20 64GB BLUE CLARO;TELEFONIA
7392818;;F;67;CHILENO;;Boomers;SAN ANTONIO                   ;VALPARAISO;677080;2;1;0;0;0;2;1;677080;SMARTPHONE GALAXY S20FE RED;TELEFONIA
10279583;Soltero;M;55;CHILENO;;Boomers;RENCA                         ;METROPOLITANA;166980;2;1;0;0;0;2;1;166980;CELULAR A12 128GB Negro OPEN;TELEFONIA
12979734;;F;47;CHILENO;;X;SANTA JUANA                   ;BIO BIO;99990;1;1;0;0;0;1;1;99990;CELULAR CLARO LG K42 GRIS;TELEFONIA
18484475;;F;31;CHILENO;;Millenial;PROVIDENCIA                   ;METROPOLITANA;260980;2;1;0;0;0;2;1;260980;CELULAR A32 128 GB BLUE OPEN;TELEFONIA
12793745;;F;46;CHILENO;;X;PUDAHUEL                      ;METROPOLITANA;139990;2;1;0;0;0;2;1;139990;CELULAR A12 128GB Azul OPEN;TELEFONIA
16855742;Soltero;M;34;CHILENO;CONTADOR AUDITOR;X;PROVIDENCIA                   ;METROPOLITANA;753980;2;1;2;1;753980;0;0;0;IPHONE 12 128GB BLACK CLARO;TELEFONIA
6382385;;F;69;CHILENO;;Silencioso;EL TABO                       ;VALPARAISO;18990;1;1;0;0;0;1;1;18990;CELULAR NOKIA 110 BLACK OPEN;TELEFONIA
11499770;;M;53;CHILENO;;X;CORONEL                       ;BIO BIO;139990;1;1;0;0;0;1;1;139990;CELULAR A12 128GB Negro OPEN;TELEFONIA
19592104;;F;24;CHILENO;;Z;N/D;N/D;185970;3;2;0;0;0;3;2;185970;CELULAR Xiaomi Redmi 9 64 GB Morado WOM;TELEFONIA
14027026;Casado;M;41;CHILENO;;X;PROVIDENCIA                   ;METROPOLITANA;94990;2;1;0;0;0;2;1;94990;CELULAR A12 128GB Azul OPEN;TELEFONIA
11481625;;F;53;CHILENO;;X;PUENTE ALTO                   ;METROPOLITANA;119990;1;1;0;0;0;1;1;119990;CELULAR VIVO Y11S NEBULA BLUE 32GB OPEN;TELEFONIA
16130004;;F;36;CHILENO;;Millenial;PROVIDENCIA                   ;METROPOLITANA;645660;6;3;6;3;645660;0;0;0;CELULAR MOTOROLA G20 64GB BLUE CLARO;TELEFONIA
9816587;;M;58;CHILENO;;Boomers;PROVIDENCIA                   ;METROPOLITANA;169990;1;1;0;0;0;1;1;169990;CELULAR REDMI 9T 128 GB OCEAN GREEN;TELEFONIA
15390930;;M;39;CHILENO;;X;LOS ALAMOS                    ;BIO BIO;419631;7;4;0;0;0;7;4;419631;CELULAR A32 128 GB BLUE OPEN;TELEFONIA
17985996;Soltero;F;30;CHILENO;;Millenial;PROVIDENCIA                   ;METROPOLITANA;129480;2;1;0;0;0;2;1;129480;CELULAR VIVO Y11S NEBULA BLUE 32GB OPEN;TELEFONIA
14022664;Casado;F;41;CHILENO;PROFESOR;X;RENCA                         ;METROPOLITANA;309990;2;1;0;0;0;2;1;309990;CELULAR SMARTPHONE A52S 5G BLACK 128GB;TELEFONIA
6937488;;M;64;CHILENO;;Boomers;RENCA                         ;METROPOLITANA;79990;1;1;0;0;0;1;1;79990;CELULAR A02 AZUL 32GB OPEN;TELEFONIA
13767021;;M;41;CHILENO;;X;PROVIDENCIA                   ;METROPOLITANA;209990;1;1;1;1;209990;0;0;0;CELULAR POCO X3 PRO 256 GB FROST BLUE;TELEFONIA
14241962;;M;48;CHILENO;;X;RANCAGUA                      ;L.G.B.OÂ´HIGGINS;257980;2;2;0;0;0;2;2;257980;CELULAR POCO X3 PRO 256 GB FROST BLUE;TELEFONIA
5857458;Casado;M;72;CHILENO;;Silencioso;PROVIDENCIA                   ;METROPOLITANA;99990;2;1;0;0;0;2;1;99990;SMARTHPHONE SAMSUNG GALAXY A03S 64GB NEGRO;TELEFONIA
19113004;;M;26;CHILENO;;Silencioso;PROVIDENCIA                   ;METROPOLITANA;253980;2;1;2;1;253980;0;0;0;POCO X3 PRO 256 GB PHANTOM BLACK;TELEFONIA
10520406;Casado;M;53;CHILENO;INGENIERO DE EJECUCION MECANICO;X;RENCA                         ;METROPOLITANA;704980;2;1;2;1;704980;0;0;0;Celular Galaxy S21 Plus Phantom Violet 128GB;TELEFONIA
19168343;;F;25;CHILENO;;Extranjero;NATALES                       ;MAGALLANES;229990;1;1;0;0;0;1;1;229990;CELULAR A32 128 GB BLUE OPEN;TELEFONIA
10607274;;F;58;CHILENO;;Boomers;VITACURA                      ;METROPOLITANA;39990;1;1;0;0;0;1;1;39990;CELULAR NOKIA QUEEN VALUE BLACK CLARO;TELEFONIA
15229154;;F;39;CHILENO;;X;"";"";106981;3;1;0;0;0;3;1;106981;CELULAR VIVO Y11S NEBULA BLUE 32GB OPEN;TELEFONIA
18048068;;F;30;CHILENO;;Millenial;PROVIDENCIA                   ;METROPOLITANA;129990;1;1;0;0;0;1;1;129990;CELULAR MOTOROLA MOTO G20 64GB ROSA FLAMINGO;TELEFONIA
19295325;;F;25;CHILENO;;Z;COIHUECO                      ;BIO BIO;630940;6;4;0;0;0;6;4;630940;CELULAR A12 128GB Azul OPEN;TELEFONIA
15177452;;M;39;CHILENO;;X;PROVIDENCIA                   ;METROPOLITANA;325840;2;1;2;1;325840;0;0;0;CELULAR IPHONE SE 64GB DIRECTO CLARO;TELEFONIA
7802310;;F;63;CHILENO;;Boomers;QUINTERO                      ;VALPARAISO;869950;5;2;2;1;434980;3;1;434970;POCO X3 PRO 256 GB PHANTOM BLACK;TELEFONIA
13347116;;M;44;CHILENO;;X;SAN FERNANDO                  ;L.G.B.OÂ´HIGGINS;129990;1;1;1;1;129990;0;0;0;CELULAR A12 128GB NEGRO TRIANGULADO CLARO;TELEFONIA
15535868;;F;39;CHILENO;;X;LANCO                         ;LOS LAGOS;209980;2;2;0;0;0;2;2;209980;CELULAR MOTOROLA MOTO G20 64GB ROSA FLAMINGO;TELEFONIA
26568829;;F;37;VENEZOLANO;;Extranjero;SANTIAGO                      ;METROPOLITANA;423970;3;2;3;2;423970;0;0;0;CELULAR SMARTPHONE A52S 5G BLACK 128GB;TELEFONIA
13490498;;F;43;CHILENO;;X;RENCA                         ;METROPOLITANA;173980;2;1;2;1;173980;0;0;0;CELULAR MOTOROLA G9 PLUS 128GB AZUL CLARO;TELEFONIA
9016908;;M;61;CHILENO;;Boomers;PROVIDENCIA                   ;METROPOLITANA;64990;1;1;0;0;0;1;1;64990;CELULAR LG K22 TRIANGULADO WOM;TELEFONIA
17567663;;M;32;CHILENO;;Silencioso;PROVIDENCIA                   ;METROPOLITANA;324980;2;1;2;1;324980;0;0;0;POCO F3 EU Night Black 256GB;TELEFONIA
13356048;Soltero;M;43;CHILENO;;X;RENCA                         ;METROPOLITANA;74990;2;1;0;0;0;2;1;74990;Celular XIAOMI REDMI 9 64 GB DIRECTO CLARO NEGRO;TELEFONIA
19378661;;M;25;CHILENO;;Z;N/D;N/D;294980;2;1;0;0;0;2;1;294980;CELULAR REDMI NOTE 10S 128GB ONIX BLACK;TELEFONIA
14169266;;M;40;CHILENO;;X;LAS CONDES;METROPOLITANA;233980;2;1;2;1;233980;0;0;0;POCO X3 PRO 256 GB METAL BRONCE;TELEFONIA
19325025;;F;26;CHILENO;;Silencioso;PROVIDENCIA                   ;METROPOLITANA;115840;2;1;2;1;115840;0;0;0;CELULAR MOTO G20 64GB AZUL OPEN;TELEFONIA
8499617;;F;60;CHILENO;;Boomers;PARRAL                        ;MAULE;93770;2;1;0;0;0;2;1;93770;CELULAR REDMI 9C 32GB MIDNIGHT GRAY;TELEFONIA
8347852;;F;65;CHILENO;;Boomers;MAIPU                         ;METROPOLITANA;153970;3;2;2;1;53980;1;1;99990;CELULAR MOTO ONE FUSION 64GB VERDE 64GB OPEN;TELEFONIA
14509515;;F;45;CHILENO;;X;TALCA                         ;MAULE;139990;1;1;0;0;0;1;1;139990;CELULAR REDMI 9T 128 GB OCEAN GREEN;TELEFONIA
10875920;Casado;M;55;CHILENO;;Boomers;VILLA ALEGRE                  ;MAULE;37990;1;1;0;0;0;1;1;37990;CELULAR NOKIA QUEEN VALUE BLACK CLARO;TELEFONIA
13755589;;M;42;CHILENO;;X;TALCA                         ;MAULE;157971;4;2;0;0;0;4;2;157971;CELULAR A12 128GB NEGRO OPEN;TELEFONIA
5959365;;F;74;CHILENO;;Silencioso;CHILLAN VIEJO                 ;BIO BIO;159980;2;1;0;0;0;2;1;159980;CELULAR Xiaomi Redmi 9 64 GB Morado WOM;TELEFONIA
6756976;;F;69;CHILENO;;Silencioso;N/D;N/D;139990;1;1;0;0;0;1;1;139990;CELULAR A12 128GB Azul OPEN;TELEFONIA
5246205;;M;77;CHILENO;;Silencioso;HUALQUI                       ;BIO BIO;304650;4;3;0;0;0;4;3;304650;CELULAR VIVO Y20 NEGRO DIRECTO ENTEL;TELEFONIA
18652615;;F;28;CHILENO;;Millenial;PROVIDENCIA                   ;METROPOLITANA;419990;1;1;0;0;0;1;1;419990;CELULAR A72 128 GB LIGHT VIOLET OPEN;TELEFONIA
7892637;;F;62;CHILENO;;Boomers;N/D;N/D;941940;4;1;4;1;941940;0;0;0;POCO F3 EU Night Black 256GB;TELEFONIA
11384245;;F;53;CHILENO;;X;ILLAPEL                       ;COQUIMBO;228982;2;3;0;0;0;2;3;228982;SMARTPHONE A22 BLANCO 128GB;TELEFONIA
9123119;;F;62;CHILENO;;Boomers;ANGOL                         ;ARAUCANIA;199990;1;1;0;0;0;1;1;199990;Celular Y9S LIB OPEN BLACK;TELEFONIA
8988170;;M;59;CHILENO;;Boomers;LAJA                          ;BIO BIO;159980;2;1;0;0;0;2;1;159980;CELULAR VIVO Y20 BLACK 64GB MOVISTAR;TELEFONIA
17779899;;F;31;CHILENO;;Millenial;NANCAGUA                      ;L.G.B.OÂ´HIGGINS;797780;2;1;0;0;0;2;1;797780;IPHONE 11 64GB BLACK CLARO;TELEFONIA
18863675;;M;27;CHILENO;;Z;PROVIDENCIA                   ;METROPOLITANA;129990;1;1;1;1;129990;0;0;0;CELULAR XIAOMI REDMI 9T TWILIGHT BLUE MOVISTAR;TELEFONIA
8859531;Soltero;M;62;CHILENO;;Boomers;RANCAGUA                      ;L.G.B.OÂ´HIGGINS;179990;1;1;0;0;0;1;1;179990;CELULAR A22 128GB NEGRO;TELEFONIA
10052670;;F;56;CHILENO;;Boomers;SAN VICENTE                   ;L.G.B.OÂ´HIGGINS;149990;1;1;0;0;0;1;1;149990;CELULAR MOTO ONE FUSION 128GB AZUL OPEN;TELEFONIA
18755740;;M;28;CHILENO;;Millenial;PROVIDENCIA                   ;METROPOLITANA;955070;2;1;0;0;0;2;1;955070;Celular Galaxy S21 Ultra Phantom Black 128GB;TELEFONIA
19556967;;F;25;CHILENO;;Z;"";"";233980;2;1;2;1;233980;0;0;0;Celular P40 LITE LIB OPEN GREEN;TELEFONIA
7967429;Casado;M;64;CHILENO;;Boomers;RENCA                         ;METROPOLITANA;119480;2;1;0;0;0;2;1;119480;CELULAR VIVO Y11S PHANTON BLACK 32GB MOVISTAR;TELEFONIA
18530684;;F;29;CHILENO;;Millenial;VILLARICA                     ;ARAUCANIA;399990;1;3;0;0;0;1;3;399990;SMARTPHONE GALAXY S20FE RED;TELEFONIA
8353889;;F;65;CHILENO;;Boomers;LA SERENA                     ;COQUIMBO;177540;2;1;2;1;177540;0;0;0;CELULAR POCO X3 PRO 128 GB FROST BLUE;TELEFONIA
17086713;;F;33;CHILENO;;Silencioso;PROVIDENCIA                   ;METROPOLITANA;473980;3;1;3;1;473980;0;0;0;CELULAR GALAXY S20FE 128GB CLOUD LAVENDER OPEN;TELEFONIA
9872343;;F;58;CHILENO;;Boomers;SAN FELIPE                    ;VALPARAISO;24990;2;1;0;0;0;2;1;24990;CELULAR XIAOMI REDMI 9A 32GB BLACK DIRECTO CLARO;TELEFONIA
22619373;;M;40;BOLIVIANO;;Extranjero;N/D;N/D;609970;3;3;3;3;609970;0;0;0;POCO X3 PRO 256 GB PHANTOM BLACK;TELEFONIA
8031051;;F;65;CHILENO;;Boomers;PUENTE ALTO                   ;METROPOLITANA;149990;1;1;0;0;0;1;1;149990;CELULAR A12 128GB Negro OPEN;TELEFONIA
17519311;Soltero;F;32;CHILENO;;Millenial;PROVIDENCIA                   ;METROPOLITANA;149990;1;1;0;0;0;1;1;149990;CELULAR A12 128GB Rojo OPEN;TELEFONIA
26737769;;F;35;VENEZOLANO;;Extranjero;N/D;N/D;123980;2;1;2;1;123980;0;0;0;CELULAR A12 128GB Negro OPEN;TELEFONIA
13627268;;F;43;CHILENO;;X;LEBU                          ;BIO BIO;109990;1;1;0;0;0;1;1;109990;CELULAR REDMI NOTE 8 2021 64 GB SPACE BLACK;TELEFONIA
18701778;Soltero;M;28;CHILENO;;Millenial;PROVIDENCIA                   ;METROPOLITANA;603980;2;1;2;1;603980;0;0;0;Celular Galaxy S21 Phantom Grey 128GB;TELEFONIA
24081154;;M;49;ECUATORIANO;;Extranjero;N/D;N/D;249990;1;1;0;0;0;1;1;249990;CELULAR REDMI NOTE 10 PRO 128GB GLACIER BLUE;TELEFONIA
19210966;;M;26;CHILENO;;Z;RENGO                         ;L.G.B.OÂ´HIGGINS;299980;2;1;0;0;0;2;1;299980;CELULAR REDMI NOTE 10 EU 64GB ONIX GRAY OPEN;TELEFONIA
25462767;;M;37;PERUANO;;Extranjero;QUILICURA                     ;METROPOLITANA;742040;6;1;0;0;0;6;1;742040;Celular Galaxy S21 Plus Phantom Black 128GB;TELEFONIA
15208064;Soltero;M;39;CHILENO;;X;RENCA                         ;METROPOLITANA;129980;3;1;0;0;0;3;1;129980;CELULAR A12 128GB Negro OPEN;TELEFONIA
13919220;;F;41;CHILENO;;X;CONSTITUCION                  ;MAULE;109990;3;1;0;0;0;3;1;109990;CELULAR A12 128GB Negro OPEN;TELEFONIA
8682563;;F;59;CHILENO;;Boomers;CHILLAN                       ;BIO BIO;49990;2;1;0;0;0;2;1;49990;CELULAR MOTO E7i 32GB AZUL OPEN;TELEFONIA
15762423;;F;38;CHILENO;;Millenial;PROVIDENCIA                   ;METROPOLITANA;99990;2;1;2;1;99990;0;0;0;CELULAR HUAWEI Y7P NEGRO ENTEL;TELEFONIA
18664918;;M;28;CHILENO;;Silencioso;PROVIDENCIA                   ;METROPOLITANA;476000;3;1;3;1;476000;0;0;0;CELULAR GALAXY S20FE 128GB ClOUD NAVY OPEN;TELEFONIA
18269148;;M;30;CHILENO;;Millenial;PROVIDENCIA                   ;METROPOLITANA;469990;2;1;2;1;469990;0;0;0;IPHONE 11 64GB BLACK CLARO;TELEFONIA
7036545;;F;71;CHILENO;;Silencioso;PROVIDENCIA                   ;METROPOLITANA;79990;1;1;0;0;0;1;1;79990;CELULAR Redmi 9C 32GB Gray WOM;TELEFONIA
15827627;;F;35;CHILENO;;Millenial;FREIRE                        ;ARAUCANIA;114990;1;1;0;0;0;1;1;114990;CELULAR A12 128GB Negro OPEN;TELEFONIA
9800190;;F;58;CHILENO;;Boomers;TENO                          ;MAULE;103980;2;2;1;1;89990;1;1;13990;CELULAR REDMI 9C 64GB SUNRISE ORANGE;TELEFONIA
10840540;;M;54;CHILENO;;X;TREGUACO                      ;BIO BIO;320960;4;2;0;0;0;4;2;320960;CELULAR HUAWEI Y8S NEGRO WOM;TELEFONIA
5529418;;F;70;CHILENO;;Silencioso;PROVIDENCIA                   ;METROPOLITANA;149990;1;1;0;0;0;1;1;149990;CELULAR A12 128GB Negro OPEN;TELEFONIA
20104384;;F;23;CHILENO;;Z;PROVIDENCIA                   ;METROPOLITANA;69990;1;1;0;0;0;1;1;69990;CELULAR MOTOROLA E6 PLAY AZUL TRI WOM;TELEFONIA
15922863;;F;37;CHILENO;;Millenial;PROVIDENCIA                   ;METROPOLITANA;19971;4;1;0;0;0;4;1;19971;CELULAR NOKIA 110 BLACK OPEN;TELEFONIA
18648700;;F;27;CHILENO;;Millenial;"";"";90140;2;1;0;0;0;2;1;90140;CELULAR REDMI 9C 64GB SUNRISE ORANGE;TELEFONIA
9315886;;M;59;CHILENO;;Silencioso;PROVIDENCIA                   ;METROPOLITANA;323980;2;1;2;1;323980;0;0;0;POCO F3 US 256G Deep Ocean Blue ];TELEFONIA
20045898;;F;23;CHILENO;;Z;N/D;N/D;154980;2;1;0;0;0;2;1;154980;SMARTPHONE A03S NEGRO 32GB;TELEFONIA
19548737;;F;25;CHILENO;;Z;CABILDO                       ;VALPARAISO;184980;2;1;0;0;0;2;1;184980;CELULAR XIAOMI REDMI 9T 128GB VERDE CLARO;TELEFONIA
10696378;;M;55;CHILENO;;Boomers;PUERTO MONTT                  ;LOS LAGOS;309970;3;3;0;0;0;3;3;309970;CELULAR VIVO Y11S PHANTON BLACK 32GB MOVISTAR;TELEFONIA
27160043;;M;26;BRASILEÃO;;Extranjero;N/D;N/D;337860;5;2;0;0;0;5;2;337860;CELULAR REDMI NOTE 10 PRO 6+128GB GRADIENT BRONZ;TELEFONIA
15810648;;F;38;CHILENO;;Millenial;PROVIDENCIA                   ;METROPOLITANA;265970;3;1;0;0;0;3;1;265970;CELULAR POCO X3 PRO 256 GB FROST BLUE;TELEFONIA
17060823;;M;36;CHILENO;;Millenial;PICHIDEGUA                    ;L.G.B.OÂ´HIGGINS;249990;1;1;0;0;0;1;1;249990;POCO X3 PRO 256 GB PHANTOM BLACK;TELEFONIA
17052876;;M;33;CHILENO;;Millenial;"";"";173980;2;1;2;1;173980;0;0;0;CELULAR POCO X3 PRO 128G PHANTOM BLACK OPEN;TELEFONIA
7917145;;F;66;CHILENO;;Boomers;RENCA                         ;METROPOLITANA;359990;2;1;0;0;0;2;1;359990;CELULAR GALAXY S20FE 128GB ClOUD NAVY OPEN;TELEFONIA
12172383;;F;49;CHILENO;;X;PROVIDENCIA                   ;METROPOLITANA;32990;1;1;0;0;0;1;1;32990;CELULAR OWN 1026 AZUL ENTEL;TELEFONIA
16125545;;M;36;CHILENO;;Millenial;SAN BERNARDO                  ;METROPOLITANA;73980;2;1;2;1;73980;0;0;0;CELULAR MOTO E7I POWER ORANGE 32GB MOVISTAR;TELEFONIA
3912219;;M;82;CHILENO;;Silencioso;PROVIDENCIA                   ;METROPOLITANA;63670;2;1;0;0;0;2;1;63670;Celular SAMSUNG A01 CORE AZUL ENTEL;TELEFONIA
15141443;;M;36;CHILENO;;Millenial;TALCA                         ;MAULE;208980;2;1;0;0;0;2;1;208980;CELULAR MOTOROLA G9 PLUS 128GB AZUL CLARO;TELEFONIA
25717292;;F;50;COLOMBIANO;;Extranjero;"";"";835090;3;1;3;1;835090;0;0;0;Celular Galaxy S21 Plus Phantom Black 128GB;TELEFONIA
11562740;Casado;F;52;CHILENO;;X;RENCA                         ;METROPOLITANA;64870;2;1;0;0;0;2;1;64870;CELULAR SMARTPHONE 1B ALCATEL PRIME BLACK;TELEFONIA
6595718;;M;71;CHILENO;;Silencioso;SAN VICENTE                   ;L.G.B.OÂ´HIGGINS;89990;1;1;0;0;0;1;1;89990;CELULAR MOTO E7 32GB ROSA CORAL OPEN;TELEFONIA
19988229;;F;23;CHILENO;;Z;PROVIDENCIA                   ;METROPOLITANA;149991;2;1;0;0;0;2;1;149991;CELULAR A12 128GB Negro OPEN;TELEFONIA
13993514;Casado;F;40;CHILENO;PSICOLOGO;X;PROVIDENCIA                   ;METROPOLITANA;234980;2;1;2;1;234980;0;0;0;Celular P40 LITE LIB OPEN GREEN;TELEFONIA
16675524;;F;34;CHILENO;;Millenial;PROVIDENCIA                   ;METROPOLITANA;91850;4;2;0;0;0;4;2;91850;CELULAR OWN 1026 AZUL ENTEL;TELEFONIA
7417670;;F;66;CHILENO;;Boomers;MAIPU                         ;METROPOLITANA;32990;1;1;0;0;0;1;1;32990;CELULAR OWN 1026 AZUL ENTEL;TELEFONIA
27006426;;M;36;VENEZOLANO;;Extranjero;SAN PEDRO DE LA PAZ           ;BIO BIO;109990;1;1;0;0;0;1;1;109990;CELULAR REDMI NOTE 8 2021 64GB NEPTUNE BLUE;TELEFONIA
16799388;;M;34;CHILENO;;Millenial;N/D;N/D;294970;4;2;0;0;0;4;2;294970;CELULAR VIVO Y20S OBSIDIAN BLACK 128GB OPEN;TELEFONIA
11079461;;F;55;CHILENO;;Boomers;LINARES                       ;MAULE;178980;2;1;0;0;0;2;1;178980;CELULAR MOTO ONE FUSION 128GB AZUL OPEN;TELEFONIA
13303345;;F;45;CHILENO;;X;PALMILLA                      ;L.G.B.OÂ´HIGGINS;39990;1;1;0;0;0;1;1;39990;CELULAR ALCATEL P1 DIRECTO CLARO BLACK;TELEFONIA
15113118;Soltero;M;39;CHILENO;;X;RENCA                         ;METROPOLITANA;139990;1;1;0;0;0;1;1;139990;CELULAR NOKIA 5.3 CHARCOAL TRI ENTEL;TELEFONIA
4742158;;M;79;CHILENO;;Silencioso;PROVIDENCIA                   ;METROPOLITANA;67990;1;1;0;0;0;1;1;67990;CELULAR MOTOROLA E6 PLAY AZUL TRI WOM;TELEFONIA
17899434;;F;32;CHILENO;;Millenial;N/D;N/D;195840;2;1;2;1;195840;0;0;0;CELULAR A32 128 GB LIGHT VIOLET OPEN;TELEFONIA
5421459;;F;80;CHILENO;;Silencioso;RENCA                         ;METROPOLITANA;64990;1;1;0;0;0;1;1;64990;CELULAR MOTOROLA E6 PLAY AZUL TRI WOM;TELEFONIA
10746891;Soltero;F;56;CHILENO;;Boomers;RENCA                         ;METROPOLITANA;261960;4;2;0;0;0;4;2;261960;CELULAR HUAWEI Y9S BLACK DIRECTO CLARO;TELEFONIA
16265651;;M;36;CHILENO;;Silencioso;PROVIDENCIA                   ;METROPOLITANA;487970;3;1;3;1;487970;0;0;0;CELULAR GALAXY S20FE 128GB CLOUD LAVENDER OPEN;TELEFONIA
15121734;;F;39;CHILENO;;X;LITUECHE                      ;L.G.B.OÂ´HIGGINS;119480;2;1;0;0;0;2;1;119480;CELULAR REDMI 9C 64GB SUNRISE ORANGE;TELEFONIA
20095602;;F;22;CHILENO;;Z;PROVIDENCIA                   ;METROPOLITANA;20000;0;2;0;0;0;0;2;20000;CELULAR A12 128GB Negro OPEN;TELEFONIA
16202139;;M;36;CHILENO;;Millenial;PROVIDENCIA                   ;METROPOLITANA;59990;1;1;1;1;59990;0;0;0;MOTO E7i 2/32GB POWER NARANJA;TELEFONIA
9776699;;M;58;CHILENO;;Boomers;RENCA                         ;METROPOLITANA;164980;2;1;0;0;0;2;1;164980;CELULAR MOTO ONE FUSION 128GB AZUL OPEN;TELEFONIA
19580943;;F;24;CHILENO;;Extranjero;TEODORO SCHMIDT               ;ARAUCANIA;99990;2;1;0;0;0;2;1;99990;CELULAR MOTOROLA G9 PLAY 64GB SPRING PINK OPEN;TELEFONIA
8928356;;M;53;CHILENO;;X;CHIMBARONGO                   ;L.G.B.OÂ´HIGGINS;89990;1;1;0;0;0;1;1;89990;CELULAR XIAOMI REDMI 9C 64GB TIWLIGHT BLUE TRI M;TELEFONIA
13177245;;F;45;CHILENO;;X;N/D;N/D;369990;2;1;0;0;0;2;1;369990;CELULAR A72 128 GB LIGHT VIOLET OPEN;TELEFONIA
6433657;;F;74;CHILENO;;Silencioso;ANTOFAGASTA                   ;ANTOFAGASTA;557771;4;1;0;0;0;4;1;557771;CELULAR GALAXY S20FE 128GB ClOUD NAVY OPEN;TELEFONIA
6320686;;F;69;CHILENO;;Silencioso;N/D;N/D;99990;1;1;0;0;0;1;1;99990;CELULAR REDMI 9C 64GB SUNRISE ORANGE;TELEFONIA
19123662;;F;26;CHILENO;;Z;CHIGUAYANTE                   ;BIO BIO;99990;1;1;0;0;0;1;1;99990;CELULAR VIVO Y11S PHANTOM BLACK OPEN;TELEFONIA
20208891;;F;23;CHILENO;;Z;ANGOL                         ;ARAUCANIA;99990;1;1;0;0;0;1;1;99990;CELULAR HUAWEI Y7P NEGRO ENTEL;TELEFONIA
15157350;;F;38;CHILENO;;Silencioso;PROVIDENCIA                   ;METROPOLITANA;208980;2;1;0;0;0;2;1;208980;CELULAR MOTO G9 POWER 128GB MORADO SONICO OPEN;TELEFONIA
10335338;;F;57;CHILENO;;Boomers;SAN ANTONIO                   ;VALPARAISO;59990;1;1;0;0;0;1;1;59990;Celular LG K22 DIRECTO CLARO;TELEFONIA
20008203;;F;23;CHILENO;;Z;N/D;N/D;149980;2;1;0;0;0;2;1;149980;CELULAR A12 128GB Rojo OPEN;TELEFONIA
17938723;;M;30;CHILENO;;Millenial;N/D;N/D;229990;1;1;0;0;0;1;1;229990;CELULAR POCO X3 PRO 256 GB FROST BLUE;TELEFONIA
17275990;;M;32;CHILENO;;Millenial;N/D;N/D;957540;2;1;2;1;957540;0;0;0;CELULAR IPHONE 12 PRO 128GB GRAFITO CLARO;TELEFONIA
19618407;;M;24;CHILENO;;Z;PROVIDENCIA                   ;METROPOLITANA;109990;1;1;1;1;109990;0;0;0;CELULAR REDMI NOTE 8 2021 64GB MOONLIGHT WHITE;TELEFONIA
19807307;;F;24;CHILENO;;Z;N/D;N/D;86482;2;1;0;0;0;2;1;86482;CELULAR MOTO E6S 32GB GRIS DIRECTO ENTEL;TELEFONIA
13957358;;M;41;CHILENO;;X;N/D;N/D;139990;1;1;0;0;0;1;1;139990;CELULAR VIVO Y20S NEBULA 128 GB BLUE OPEN;TELEFONIA
17554801;;F;30;CHILENO;;Millenial;ARICA                         ;ARICA Y PARINACOTA;269990;1;1;0;0;0;1;1;269990;CELULAR RENO5 LITE NEGRO 128GB;TELEFONIA
19457247;;F;37;CHILENO;;Millenial;RENCA                         ;METROPOLITANA;671970;4;2;0;0;0;4;2;671970;CELULAR A32 128 GB BLUE OPEN;TELEFONIA
13034543;;M;49;CHILENO;;X;OVALLE                        ;COQUIMBO;199980;2;1;0;0;0;2;1;199980;CELULAR A21s 128 GB Rojo;TELEFONIA
13453435;;F;43;CHILENO;;X;N/D;N/D;119990;1;1;1;1;119990;0;0;0;CELULAR A12 128GB Rojo OPEN;TELEFONIA
17470513;;F;32;CHILENO;;Millenial;CONSTITUCION;MAULE;99990;2;1;0;0;0;2;1;99990;CELULAR A21s 128 GB Negro;TELEFONIA
19870707;;F;26;CHILENO;;Z;ARICA                         ;ARICA Y PARINACOTA;189990;1;1;0;0;0;1;1;189990;CELULAR A32 128 GB WHITE OPEN;TELEFONIA
12744681;;F;47;CHILENO;;X;MELIPILLA                     ;METROPOLITANA;89990;1;1;0;0;0;1;1;89990;CELULAR REDMI 9C 32GB MIDNIGHT GRAY MOVISTAR;TELEFONIA
7655830;;F;65;CHILENO;;Boomers;PROVIDENCIA                   ;METROPOLITANA;59850;4;1;0;0;0;4;1;59850;CELULAR OWN 1026 AZUL ENTEL;TELEFONIA
8925666;;M;60;CHILENO;;Silencioso;PROVIDENCIA                   ;METROPOLITANA;65990;1;1;0;0;0;1;1;65990;CELULAR MOTOROLA E6 PLAY AZUL TRI WOM;TELEFONIA
7703317;;M;62;CHILENO;;Boomers;CONCEPCION                    ;BIO BIO;237870;2;2;0;0;0;2;2;237870;CELULAR A32 128 GB BLUE OPEN;TELEFONIA
24602881;;F;27;BOLIVIANO;;Extranjero;CALAMA                        ;ANTOFAGASTA;147871;3;1;0;0;0;3;1;147871;CELULAR A02s ROJO 32GB OPEN;TELEFONIA
7820017;;F;67;CHILENO;;Boomers;RENCA                         ;METROPOLITANA;139990;1;1;0;0;0;1;1;139990;CELULAR A12 128GB AZUL OPEN;TELEFONIA
16407486;;F;36;CHILENO;;Millenial;LA PINTANA                    ;METROPOLITANA;367770;9;2;0;0;0;9;2;367770;CELULAR REDMI NOTE 10 EU 64GB ONIX GRAY OPEN;TELEFONIA
20317365;;F;25;CHILENO;;Z;OVALLE                        ;COQUIMBO;129480;2;1;0;0;0;2;1;129480;CELULAR VIVO Y11S PHANTON BLACK 32GB MOVISTAR;TELEFONIA
15115307;Soltero;M;39;CHILENO;;X;RENCA                         ;METROPOLITANA;86480;2;1;0;0;0;2;1;86480;Celular A01 LIB OPEN ROJO;TELEFONIA
15249742;Soltero;F;38;CHILENO;;Millenial;PROVIDENCIA                   ;METROPOLITANA;186960;4;1;0;0;0;4;1;186960;CELULAR A21s 128 GB Negro;TELEFONIA
25805949;;M;38;HAITIANO;;Extranjero;EL BOSQUE                     ;METROPOLITANA;284980;3;1;0;0;0;3;1;284980;CELULAR POCO X3 PRO 256 GB FROST BLUE;TELEFONIA
9598471;;F;63;CHILENO;;Silencioso;PROVIDENCIA                   ;METROPOLITANA;119480;2;1;0;0;0;2;1;119480;CELULAR REDMI 9C 32GB MIDNIGHT GRAY;TELEFONIA
13806787;;M;42;CHILENO;;X;RENCA                         ;METROPOLITANA;149990;1;1;0;0;0;1;1;149990;CELULAR A21s 128 GB Negro;TELEFONIA
19314801;;M;26;CHILENO;;Z;N/D;N/D;129990;1;1;0;0;0;1;1;129990;CELULAR POCO M3 128GB POWER BLACK;TELEFONIA
12206532;;F;50;CHILENO;;X;HUALANE                       ;MAULE;36990;1;1;0;0;0;1;1;36990;CELULAR NOKIA 225 4G BLACK MOVISTAR DIRECTO;TELEFONIA
8322449;;M;50;CHILENO;;Silencioso;PROVIDENCIA                   ;METROPOLITANA;33980;2;1;2;1;33980;0;0;0;CELULAR ALCATEL P1 DIRECTO CLARO BLACK;TELEFONIA
17873159;;M;31;CHILENO;;Millenial;PROVIDENCIA                   ;METROPOLITANA;299980;2;2;2;2;299980;0;0;0;CELULAR MOTOROLA G9 PLAY 64GB ELECTRIC BLUE OPEN;TELEFONIA
8446177;;M;58;CHILENO;;Boomers;PUREN                         ;ARAUCANIA;189980;2;1;0;0;0;2;1;189980;CELULAR A21s 128 GB AZUL;TELEFONIA
18492910;;M;28;CHILENO;;Millenial;COLINA                        ;METROPOLITANA;239990;1;1;0;0;0;1;1;239990;POCO X3 PRO 256 GB PHANTOM BLACK;TELEFONIA
10898312;;F;52;CHILENO;;Silencioso;PROVIDENCIA                   ;METROPOLITANA;37990;1;1;0;0;0;1;1;37990;CELULAR NOKIA 225 4G BLACK MOVISTAR DIRECTO;TELEFONIA
1194171;;M;70;CHILENO;;Silencioso;LA SERENA                     ;COQUIMBO;109990;2;1;0;0;0;2;1;109990;CELULAR A21s 128 GB Rojo;TELEFONIA
12793066;;F;47;CHILENO;;X;PARRAL                        ;MAULE;284980;2;2;0;0;0;2;2;284980;CELULAR REDMI NOTE 10S 128GB PEBBLE WHITE;TELEFONIA
18459327;;M;29;CHILENO;;Silencioso;PROVIDENCIA                   ;METROPOLITANA;285480;2;1;2;1;285480;0;0;0;CELULAR REDMI NOTE 10 PRO 128GB GLACIER BLUE;TELEFONIA
15600775;Casado;M;46;CHILENO;;X;RENCA                         ;METROPOLITANA;79990;2;1;0;0;0;2;1;79990;CELULAR REDMI 9C 64GB SUNRISE ORANGE;TELEFONIA
8732943;;M;62;CHILENO;;Silencioso;PICHIDEGUA                    ;L.G.B.OÂ´HIGGINS;309970;3;1;0;0;0;3;1;309970;CELULAR A12 128GB Rojo OPEN;TELEFONIA
13669762;Soltero;F;44;CHILENO;TECNICO AGRICOLA;X;PROVIDENCIA                   ;METROPOLITANA;239980;2;1;0;0;0;2;1;239980;CELULAR A32 128 GB BLUE OPEN;TELEFONIA
8598080;;M;63;CHILENO;;Boomers;MULCHEN                       ;BIO BIO;149990;1;1;0;0;0;1;1;149990;CELULAR A21s 128 GB Negro;TELEFONIA
11838892;;F;50;CHILENO;;X;RENCA                         ;METROPOLITANA;213980;2;1;2;1;213980;0;0;0;CELULAR REDMI NOTE 10S 128GB OCEAN BLUE;TELEFONIA
13556132;;F;43;CHILENO;;X;PEDRO AGUIRRE CERDA           ;METROPOLITANA;115980;2;2;0;0;0;2;2;115980;CELULAR XIAOMI REDMI 9C 32GB AZUL WOM;TELEFONIA
26256155;;M;38;HAITIANO;;Extranjero;CONCHALI                      ;METROPOLITANA;269990;1;1;0;0;0;1;1;269990;CELULAR MOTO G50 AZUL 128 GB OPEN;TELEFONIA
10725760;;F;50;CHILENO;;X;PUENTE ALTO;METROPOLITANA;463980;2;1;2;1;463980;0;0;0;CELULAR GALAXY S20FE 128GB ClOUD NAVY OPEN;TELEFONIA
14473181;;M;45;CHILENO;;Silencioso;PROVIDENCIA                   ;METROPOLITANA;129990;2;1;0;0;0;2;1;129990;CELULAR MOTO ONE FUSION 128GB AZUL OPEN;TELEFONIA
17114402;;F;33;CHILENO;;Millenial;ILLAPEL                       ;COQUIMBO;69990;1;1;0;0;0;1;1;69990;CELULAR MOTOROLA E6 PLAY AZUL TRI WOM;TELEFONIA
16846970;;F;33;CHILENO;;Millenial;CHANCO                        ;MAULE;169990;1;1;0;0;0;1;1;169990;CELULAR MOTO G9 POWER 128GB MORADO SONICO OPEN;TELEFONIA
19273079;;F;26;CHILENO;;Z;CANETE                        ;BIO BIO;215970;3;1;0;0;0;3;1;215970;XIAOMI REDMI 9T CARBON GRAY 128GB MOVISTAR;TELEFONIA
18709181;Soltero;M;27;CHILENO;;Z;PROVIDENCIA                   ;METROPOLITANA;434540;2;1;2;1;434540;0;0;0;CELULAR MI 10T PRO 256GB AURORA BLUE OPEN;TELEFONIA
16390648;;M;36;CHILENO;;Millenial;PROVIDENCIA                   ;METROPOLITANA;229990;1;1;1;1;229990;0;0;0;CELULAR POCO X3 PRO 256 GB FROST BLUE;TELEFONIA
13387962;;M;43;CHILENO;;X;TUCAPEL                       ;BIO BIO;135840;2;1;2;1;135840;0;0;0;CELULAR A12 128GB Negro OPEN;TELEFONIA
19972157;;F;23;CHILENO;;Z;PROVIDENCIA                   ;METROPOLITANA;151970;3;2;0;0;0;3;2;151970;CELULAR REDMI NOTE 8 2021 64GB MOONLIGHT WHITE;TELEFONIA
14061276;;F;40;CHILENO;;Silencioso;PROVIDENCIA                   ;METROPOLITANA;139990;1;1;1;1;139990;0;0;0;CELULAR REDMI 9T 128 GB OCEAN GREEN;TELEFONIA
11979626;;F;49;CHILENO;;X;RENCA                         ;METROPOLITANA;199990;1;1;0;0;0;1;1;199990;CELULAR A32 128 GB BLUE OPEN;TELEFONIA
10229030;;M;57;CHILENO;;Boomers;SAGRADA FAMILIA               ;MAULE;182970;4;2;0;0;0;4;2;182970;CELULAR REDMI 9A GRANITE GREY DIRECTO MOVISTAR;TELEFONIA
15273621;;F;43;CHILENO;;X;N/D;N/D;229990;1;1;0;0;0;1;1;229990;CELULAR POCO X3 PRO 128G PHANTOM BLACK OPEN;TELEFONIA
15894785;;F;40;CHILENO;;X;N/D;N/D;149990;1;1;0;0;0;1;1;149990;CELULAR A21s 128 GB Rojo;TELEFONIA
12703161;;F;47;CHILENO;;X;PROVIDENCIA                   ;METROPOLITANA;179980;2;1;0;0;0;2;1;179980;CELULAR A12 128GB Rojo OPEN;TELEFONIA
20039596;;M;23;CHILENO;;Silencioso;PROVIDENCIA                   ;METROPOLITANA;199990;1;1;1;1;199990;0;0;0;CELULAR POCO X3 PRO 128G PHANTOM BLACK OPEN;TELEFONIA
13977453;Soltero;M;41;CHILENO;;X;RENCA                         ;METROPOLITANA;109990;1;1;0;0;0;1;1;109990;Celular VIVO Y11S ENTEL DIRECTO AZUL;TELEFONIA
14078426;;M;40;CHILENO;;X;LANCO                         ;LOS LAGOS;200980;2;1;0;0;0;2;1;200980;CELULAR SAMSUNG A12 128GB BLACK CLARO;TELEFONIA
8726855;Soltero;M;62;CHILENO;;Boomers;RENCA                         ;METROPOLITANA;149990;2;1;0;0;0;2;1;149990;CELULAR A21s 128 GB AZUL;TELEFONIA
15768649;;F;42;CHILENO;;X;RENCA                         ;METROPOLITANA;137870;2;1;0;0;0;2;1;137870;CELULAR MOTO E7 32GB ROSA CORAL OPEN;TELEFONIA
16069868;;M;37;CHILENO;;Millenial;N/D;N/D;84990;1;1;0;0;0;1;1;84990;CELULAR MOTOROLA E7 IPOWER 32GB BLUE CLARO;TELEFONIA
18012629;Soltero;F;29;CHILENO;;Millenial;PROVIDENCIA                   ;METROPOLITANA;350950;5;2;0;0;0;5;2;350950;CELULAR A12 128GB Rojo OPEN;TELEFONIA
9300453;;M;61;CHILENO;;Boomers;RENCA                         ;METROPOLITANA;179980;2;1;0;0;0;2;1;179980;CELULAR A12 128GB Rojo OPEN;TELEFONIA
19744133;;M;24;CHILENO;;Z;RECOLETA                      ;METROPOLITANA;189990;1;1;0;0;0;1;1;189990;CELULAR A32 128 GB LIGHT VIOLET OPEN;TELEFONIA
25627683;;M;36;HAITIANO;;Extranjero;N/D;N/D;0;0;0;0;0;0;0;0;0;CELULAR A12 128GB NEGRO OPEN;TELEFONIA
19651070;;F;24;CHILENO;;Z;PROVIDENCIA                   ;METROPOLITANA;0;0;0;0;0;0;0;0;0;CELULAR REDMI NOTE 10S 128GB PEBBLE WHITE;TELEFONIA
17557046;;F;32;CHILENO;;Millenial;ARICA                         ;TARAPACA;0;0;0;0;0;0;0;0;0;CELULAR MOTO ONE FUSION 128GB AZUL OPEN;TELEFONIA
9080680;;F;61;CHILENO;;Boomers;TRAIGUEN                      ;ARAUCANIA;0;0;0;0;0;0;0;0;0;CELULAR A21s 128 GB Rojo;TELEFONIA
20172197;;F;23;CHILENO;;Silencioso;PROVIDENCIA                   ;METROPOLITANA;0;0;0;0;0;0;0;0;0;CELULAR A32 128 GB LIGHT VIOLET OPEN;TELEFONIA
17413028;;M;32;CHILENO;;Millenial;PEUMO                         ;L.G.B.OÂ´HIGGINS;0;0;0;0;0;0;0;0;0;CELULAR MI 10T PRO 256GB AURORA BLUE OPEN;TELEFONIA
13104522;;M;45;CHILENO;;X;N/D;N/D;0;0;0;0;0;0;0;0;0;POCO X3 PRO 256 GB PHANTOM BLACK;TELEFONIA
15262485;;F;40;CHILENO;;X;PROVIDENCIA                   ;METROPOLITANA;0;0;0;0;0;0;0;0;0;CELULAR A32 128 GB WHITE OPEN;TELEFONIA
10089395;;M;57;CHILENO;;Boomers;N/D;N/D;0;0;0;0;0;0;0;0;0;CELULAR A32 128 GB BLUE OPEN;TELEFONIA
17391344;;F;32;CHILENO;;Millenial;PROVIDENCIA                   ;METROPOLITANA;0;0;0;0;0;0;0;0;0;CELULAR NOKIA 225 4G BLACK MOVISTAR DIRECTO;TELEFONIA
10573176;;M;57;CHILENO;;Boomers;N/D;N/D;0;0;0;0;0;0;0;0;0;CELULAR A21s 128 GB Negro;TELEFONIA
17454718;;F;32;CHILENO;;Millenial;SAN ANTONIO                   ;VALPARAISO;0;0;0;0;0;0;0;0;0;CELULAR A32 128 GB BLACK OPEN;TELEFONIA
9610619;Casado;F;60;CHILENO;;Boomers;RENCA                         ;METROPOLITANA;0;0;0;0;0;0;0;0;0;CELULAR A32 128 GB LIGHT VIOLET OPEN;TELEFONIA
20166343;;M;23;CHILENO;;Z;PROVIDENCIA                   ;METROPOLITANA;0;0;0;0;0;0;0;0;0;CELULAR A32 128 GB LIGHT VIOLET OPEN;TELEFONIA
6155832;Soltero;M;74;CHILENO;;Silencioso;RENCA                         ;METROPOLITANA;0;0;0;0;0;0;0;0;0;CELULAR A21s 128 GB AZUL;TELEFONIA
13370124;;F;44;CHILENO;;X;SAN ANTONIO                   ;VALPARAISO;0;0;0;0;0;0;0;0;0;Celular A11 LIB OPEN WHITE;TELEFONIA
14321834;Casado;M;45;CHILENO;;X;PROVIDENCIA                   ;METROPOLITANA;0;0;0;0;0;0;0;0;0;CELULAR SAMSUNG A02S 32GB NEGRO DIRECTO ENTEL;TELEFONIA
7085251;;M;68;CHILENO;;Silencioso;CURARREHUE                    ;ARAUCANIA;0;0;0;0;0;0;0;0;0;CELULAR GALAXY A01 32GB AZUL ENTEL;TELEFONIA
12149078;;M;52;CHILENO;;Silencioso;VALLENAR;ATACAMA;0;0;0;0;0;0;0;0;0;Celular AL3 CLARO DIRECTO NEGRO;TELEFONIA
18176064;;F;30;CHILENO;;Millenial;N/D;N/D;0;0;0;0;0;0;0;0;0;CELULAR A32 128 GB BLUE OPEN;TELEFONIA
19650010;;M;24;CHILENO;;Silencioso;PROVIDENCIA                   ;METROPOLITANA;0;0;0;0;0;0;0;0;0;CELULAR A32 128 GB BLACK OPEN;TELEFONIA
14462477;;M;46;CHILENO;;X;CASTRO                        ;LOS LAGOS;0;0;0;0;0;0;0;0;0;CELULAR A21s 128 GB AZUL;TELEFONIA
11300131;;M;53;CHILENO;;X;RENCA                         ;METROPOLITANA;0;0;0;0;0;0;0;0;0;CELULAR MOTO ONE FUSION 64GB VERDE 64GB OPEN;TELEFONIA
24380435;;F;32;BOLIVIANO;;Extranjero;IQUIQUE                       ;TARAPACA;0;0;0;0;0;0;0;0;0;CELULAR A21s 128 GB Negro;TELEFONIA
19853195;;F;24;CHILENO;;Silencioso;PROVIDENCIA                   ;METROPOLITANA;0;0;0;0;0;0;0;0;0;CELULAR A12 128GB AZUL OPEN;TELEFONIA
5452232;;M;76;CHILENO;;Silencioso;MACUL                         ;METROPOLITANA;0;0;0;0;0;0;0;0;0;CELULAR NOKIA 225 4G BLACK TRI ENTEL;TELEFONIA
25628279;;F;45;COLOMBIANO;;Extranjero;N/D;N/D;0;0;0;0;0;0;0;0;0;CELULAR POCO X3 PRO 256 GB FROST BLUE;TELEFONIA
10178400;;M;58;CHILENO;;Boomers;CALERA                        ;VALPARAISO;0;0;0;0;0;0;0;0;0;CELULAR MOTOROLA E6 PLAY AZUL TRI WOM;TELEFONIA
19359712;;M;25;CHILENO;;Silencioso;PROVIDENCIA                   ;METROPOLITANA;0;0;0;0;0;0;0;0;0;CELULAR A21s 128 GB Negro;TELEFONIA
19806533;;F;24;CHILENO;;Z;N/D;N/D;0;0;0;0;0;0;0;0;0;CELULAR A32 128 GB BLACK OPEN;TELEFONIA
16723154;;M;34;CHILENO;;Millenial;"";"";0;0;0;0;0;0;0;0;0;POCO X3 PRO 256 GB PHANTOM BLACK;TELEFONIA
16094547;;M;37;CHILENO;;Silencioso;PROVIDENCIA                   ;METROPOLITANA;0;0;0;0;0;0;0;0;0;CELULAR A32 128 GB LIGHT VIOLET OPEN;TELEFONIA
19580845;;F;25;CHILENO;;Z;PROVIDENCIA                   ;METROPOLITANA;0;0;0;0;0;0;0;0;0;CELULAR REDMI 9T 128 GB OCEAN GREEN;TELEFONIA
10524389;Casado;M;55;CHILENO;;Boomers;RENCA                         ;METROPOLITANA;0;0;0;0;0;0;0;0;0;Celular S20 FE LIB OPEN Cloud Green;TELEFONIA
13101455;;M;45;CHILENO;;X;N/D;N/D;0;0;0;0;0;0;0;0;0;CELULAR A21s 128 GB Rojo;TELEFONIA
8179352;;F;69;CHILENO;;Silencioso;N/D;N/D;0;0;0;0;0;0;0;0;0;Celular A12 Negro 128GB Tri Entel;TELEFONIA
18490364;;F;28;CHILENO;;Millenial;TOME                          ;BIO BIO;0;0;0;0;0;0;0;0;0;CELULAR MOTO G9 POWER 128GB MORADO SONICO OPEN;TELEFONIA
16013411;Soltero;M;37;CHILENO;;Millenial;RENCA                         ;METROPOLITANA;0;0;0;0;0;0;0;0;0;CELULAR NOKIA 110 BLACK OPEN;TELEFONIA
19330517;Soltero;F;26;CHILENO;ENFERMERA;Z;PROVIDENCIA                   ;METROPOLITANA;0;0;0;0;0;0;0;0;0;CELULAR REDMI NOTE 10 128GB ONIX GRAY OPEN;TELEFONIA
15123063;;F;40;CHILENO;;X;RENCA                         ;METROPOLITANA;0;0;0;0;0;0;0;0;0;CELULAR REDMI NOTE 10S 128GB ONIX BLACK;TELEFONIA
15456605;;M;40;CHILENO;;X;RETIRO                        ;MAULE;0;0;0;0;0;0;0;0;0;CELULAR A32 128 GB BLUE OPEN;TELEFONIA
18488365;;F;28;CHILENO;;Millenial;PROVIDENCIA                   ;METROPOLITANA;0;0;0;0;0;0;0;0;0;CELULAR GALAXY A01 32GB AZUL ENTEL;TELEFONIA
19795523;;M;24;CHILENO;;Silencioso;VICTORIA;ARAUCANIA;0;0;0;0;0;0;0;0;0;CELULAR A21s 128 GB Negro;TELEFONIA
18882602;;F;28;CHILENO;;Millenial;PROVIDENCIA                   ;METROPOLITANA;0;0;0;0;0;0;0;0;0;CELULAR GALAXY S20FE 128GB CLOUD LAVENDER OPEN;TELEFONIA
5686055;;M;75;CHILENO;;Silencioso;LOS ANDES                     ;VALPARAISO;0;0;0;0;0;0;0;0;0;CELULAR OWN 1026 AZUL ENTEL;TELEFONIA
12236349;;M;50;CHILENO;;X;SAN FABIAN                    ;BIO BIO;0;0;0;0;0;0;0;0;0;CELULAR A21s 128 GB AZUL;TELEFONIA
12782474;;F;47;CHILENO;;X;TENO                          ;MAULE;0;0;0;0;0;0;0;0;0;CELULAR REDMI 9C 32GB MIDNIGHT GRAY MOVISTAR;TELEFONIA
8176824;;F;68;CHILENO;;Boomers;COPIAPO                       ;ATACAMA;0;0;0;0;0;0;0;0;0;CELULAR Xiaomi Redmi 9 64 GB Morado WOM;TELEFONIA
13408432;;M;44;CHILENO;;X;PROVIDENCIA                   ;METROPOLITANA;0;0;0;0;0;0;0;0;0;CELULAR MOTO E7I POWER 32GB BLUE MOVISTAR;TELEFONIA
11655477;;M;51;CHILENO;;X;PANGUIPULLI                   ;LOS RIOS;0;0;0;0;0;0;0;0;0;CELULAR MOTOROLA E6 PLAY AZUL TRI WOM;TELEFONIA
16374230;;F;36;CHILENO;;Millenial;N/D;N/D;0;0;0;0;0;0;0;0;0;CELULAR REDMI NOTE 10 PRO 6+128GB GRADIENT BRONZ;TELEFONIA
13571152;;M;51;CHILENO;;X;REQUINOA                      ;L.G.B.OÂ´HIGGINS;0;0;0;0;0;0;0;0;0;CELULAR REDMI NOTE 8 2021 64GB NEPTUNE BLUE;TELEFONIA
26157295;;M;46;HAITIANO;;Extranjero;PROVIDENCIA                   ;METROPOLITANA;0;0;0;0;0;0;0;0;0;Celular LG K22 ENTEL DIRECTO TITAN;TELEFONIA
11884079;;F;51;CHILENO;;X;N/D;N/D;0;0;0;0;0;0;0;0;0;CELULAR A21s 128 GB Negro;TELEFONIA
16352590;;F;39;CHILENO;;X;RENCA                         ;METROPOLITANA;0;0;0;0;0;0;0;0;0;CELULAR A21s 128 GB Rojo;TELEFONIA
18451422;;F;29;CHILENO;;Millenial;RANCAGUA                      ;L.G.B.OÂ´HIGGINS;0;0;0;0;0;0;0;0;0;CELULAR MOTO G9 POWER PURPLE 128GB MOVISTAR;TELEFONIA
18399248;;M;28;CHILENO;;Millenial;N/D;N/D;0;0;0;0;0;0;0;0;0;CELULAR MOTO E7i 32GB AZUL OPEN;TELEFONIA
18538235;;F;29;CHILENO;;Silencioso;PROVIDENCIA                   ;METROPOLITANA;0;0;0;0;0;0;0;0;0;CELULAR A21s 128 GB AZUL;TELEFONIA
16673706;;M;35;CHILENO;;Millenial;"";"";0;0;0;0;0;0;0;0;0;CELULAR A32 128 GB LIGHT VIOLET OPEN;TELEFONIA
13179114;;F;45;CHILENO;;X;OVALLE                        ;COQUIMBO;0;0;0;0;0;0;0;0;0;CELULAR A21s 128 GB AZUL;TELEFONIA
8727280;Casado;M;62;CHILENO;;Boomers;PROVIDENCIA                   ;METROPOLITANA;0;0;0;0;0;0;0;0;0;CELULAR MOTO E6I 32GB GRIS OPEN;TELEFONIA
19053252;;F;26;CHILENO;;Z;LOS ANGELES                   ;BIO BIO;0;0;0;0;0;0;0;0;0;CELULAR REDMI 9A GRANITE GREY DIRECTO MOVISTAR;TELEFONIA
26915864;;M;37;CHILENO;;Extranjero;MACHALI                       ;L.G.B.OÂ´HIGGINS;0;0;0;0;0;0;0;0;0;CELULAR A21s 128 GB Negro;TELEFONIA
15226126;Divorciado;F;45;CHILENO;;X;RENCA                         ;METROPOLITANA;0;0;0;0;0;0;0;0;0;CELULAR MOTOROLA E6 PLAY AZUL TRI WOM;TELEFONIA
8085398;;M;64;CHILENO;;Boomers;QUILLOTA                      ;VALPARAISO;0;0;0;0;0;0;0;0;0;CELULAR A12 128GB ROJO OPEN;TELEFONIA
18249195;;F;29;CHILENO;;Millenial;PROVIDENCIA                   ;METROPOLITANA;0;0;0;0;0;0;0;0;0;CELULAR REDMI NOTE 10S 128GB PEBBLE WHITE;TELEFONIA
14231200;;M;53;CHILENO;;X;LOTA                          ;BIO BIO;0;0;0;0;0;0;0;0;0;CELULAR A21s 128 GB Rojo;TELEFONIA
9196447;;M;61;CHILENO;;Boomers;CALBUCO                       ;LOS LAGOS;0;0;0;0;0;0;0;0;0;CELULAR A02s AZUL 32GB OPEN;TELEFONIA
17333604;;F;32;CHILENO;;Millenial;PROVIDENCIA                   ;METROPOLITANA;0;0;0;0;0;0;0;0;0;CELULAR VIVO Y11s PHANTOM BLACK ENTEL DIRECTO;TELEFONIA
19868016;;F;24;CHILENO;;Z;PROVIDENCIA                   ;METROPOLITANA;0;0;0;0;0;0;0;0;0;CELULAR A21s 128 GB Negro;TELEFONIA
14331195;Soltero;M;51;CHILENO;;X;PROVIDENCIA                   ;METROPOLITANA;0;0;0;0;0;0;0;0;0;CELULAR GALAXY A01 32GB AZUL ENTEL;TELEFONIA
15940222;Soltero;M;37;CHILENO;;Silencioso;PROVIDENCIA                   ;METROPOLITANA;0;0;0;0;0;0;0;0;0;CELULAR A21s 128 GB Negro;TELEFONIA
16909139;;F;34;CHILENO;;Millenial;PROVIDENCIA                   ;METROPOLITANA;0;0;0;0;0;0;0;0;0;CELULAR A21s 128 GB Rojo;TELEFONIA
18399542;;F;28;CHILENO;;Millenial;PROVIDENCIA                   ;METROPOLITANA;0;0;0;0;0;0;0;0;0;CELULAR MOTO E7I POWER 32GB BLUE MOVISTAR;TELEFONIA
12372572;;M;49;CHILENO;;X;RENCA                         ;METROPOLITANA;0;0;0;0;0;0;0;0;0;CELULAR A02s ROJO 32GB OPEN;TELEFONIA
13183863;;M;44;CHILENO;;X;RENCA                         ;METROPOLITANA;0;0;0;0;0;0;0;0;0;CELULAR REDMI 9 64GB CARBON GREY;TELEFONIA
20123833;;M;23;CHILENO;;Z;PROVIDENCIA                   ;METROPOLITANA;0;0;0;0;0;0;0;0;0;CELULAR OWN 1026 AZUL ENTEL;TELEFONIA
12134340;;M;49;CHILENO;;X;TEODORO SCHMIDT               ;ARAUCANIA;0;0;0;0;0;0;0;0;0;VIVO Y20 OBSIDIAN BLACK OPEN;TELEFONIA
19061874;Soltero;M;27;CHILENO;;Z;PROVIDENCIA                   ;METROPOLITANA;0;0;0;0;0;0;0;0;0;CELULAR A21s 128 GB Negro;TELEFONIA
22575859;;F;54;PERUANO;;Extranjero;ESTACION CENTRAL              ;METROPOLITANA;0;0;0;0;0;0;0;0;0;CELULAR A21s 128 GB Rojo;TELEFONIA
13713182;;F;43;CHILENO;;X;PROVIDENCIA                   ;METROPOLITANA;0;0;0;0;0;0;0;0;0;CELULAR POCO X3 PRO 128 GB FROST BLUE;TELEFONIA
17573396;;F;31;CHILENO;;Millenial;PROVIDENCIA                   ;METROPOLITANA;0;0;0;0;0;0;0;0;0;Celular A01 Core Azul Tri Entel;TELEFONIA
19798136;;F;24;CHILENO;;Z;TALCA                         ;MAULE;0;0;0;0;0;0;0;0;0;CELULAR A32 128 GB WHITE OPEN;TELEFONIA
17856778;;M;31;CHILENO;;Millenial;TEMUCO                        ;ARAUCANIA;0;0;0;0;0;0;0;0;0;CELULAR MOTO E7 32GB GRIS OPEN;TELEFONIA
12650914;;F;47;CHILENO;;X;PROVIDENCIA                   ;METROPOLITANA;0;0;0;0;0;0;0;0;0;CELULAR A12 128GB AZUL OPEN;TELEFONIA
19075445;;M;27;CHILENO;;Z;PROVIDENCIA                   ;METROPOLITANA;0;0;0;0;0;0;0;0;0;CELULAR A21s 128 GB Negro;TELEFONIA
18420967;;F;29;CHILENO;;Millenial;HIJUELAS                      ;VALPARAISO;0;0;0;0;0;0;0;0;0;CELULAR Redmi 9C 32GB Gray WOM;TELEFONIA
15834374;;M;39;CHILENO;;X;RIO HURTADO                   ;COQUIMBO;0;0;0;0;0;0;0;0;0;CELULAR REDMI 9C 64GB SUNRISE ORANGE;TELEFONIA
12536132;;F;49;CHILENO;;X;BUIN                          ;METROPOLITANA;0;0;0;0;0;0;0;0;0;CELULAR A32 128 GB LIGHT VIOLET OPEN;TELEFONIA
17613948;;M;31;CHILENO;;Millenial;PROVIDENCIA                   ;METROPOLITANA;0;0;0;0;0;0;0;0;0;CELULAR Xiaomi Redmi 9 64 GB Morado WOM;TELEFONIA
15130862;;F;39;CHILENO;;X;SAN IGNACIO                   ;BIO BIO;0;0;0;0;0;0;0;0;0;CELULAR A21s 128 GB Negro;TELEFONIA
18318033;;M;29;CHILENO;;Extranjero;PROVIDENCIA                   ;METROPOLITANA;0;0;0;0;0;0;0;0;0;Celular LG K22 ENTEL DIRECTO TITAN;TELEFONIA
18739419;;M;28;CHILENO;;Millenial;N/D;N/D;0;0;0;0;0;0;0;0;0;CELULAR MI 11 LITE 128GB BOBA BLACK OPEN;TELEFONIA
7140975;;M;66;CHILENO;;Boomers;RENCA                         ;METROPOLITANA;0;0;0;0;0;0;0;0;0;POCO X3 PRO 256 GB PHANTOM BLACK;TELEFONIA
17970988;Soltero;F;31;CHILENO;TECNICO DE NIVEL SUPERIOR EN ENFERMERIA;Millenial;PROVIDENCIA                   ;METROPOLITANA;0;0;0;0;0;0;0;0;0;CELULAR A72 128 GB LIGHT VIOLET OPEN;TELEFONIA
19344047;;F;26;CHILENO;;Z;"";"";0;0;0;0;0;0;0;0;0;CELULAR REDMI NOTE 9 128 GB MIDNIGHT GREY OPEN;TELEFONIA
7841074;;F;61;CHILENO;;Boomers;COPIAPO                       ;ATACAMA;0;0;0;0;0;0;0;0;0;CELULAR A21s 128 GB AZUL;TELEFONIA
22884880;;F;32;PERUANO;;Extranjero;INDEPENDENCIA                 ;METROPOLITANA;0;0;0;0;0;0;0;0;0;IPHONE X 64GB LIB OPEN SILVER;TELEFONIA
22821565;;F;25;EXTRANJERO - NO INFORMA NACIONALIDAD;;Extranjero;N/D;N/D;0;0;0;0;0;0;0;0;0;CELULAR MOTOROLA G9 PLAY 64GB SPRING PINK OPEN;TELEFONIA
19255629;;F;26;CHILENO;;Z;CONSTITUCION                  ;MAULE;0;0;0;0;0;0;0;0;0;CELULAR A12 128GB NEGRO OPEN;TELEFONIA
12013317;;M;49;CHILENO;;X;RENCA                         ;METROPOLITANA;0;0;0;0;0;0;0;0;0;CELULAR A12 128GB NEGRO OPEN;TELEFONIA
16841095;;F;33;CHILENO;;Silencioso;PROVIDENCIA                   ;METROPOLITANA;0;0;0;0;0;0;0;0;0;CELULAR OWN 1026 AZUL ENTEL;TELEFONIA
11255324;;F;54;CHILENO;;X;CONCHALI                      ;METROPOLITANA;0;0;0;0;0;0;0;0;0;CELULAR A12 128GB NEGRO OPEN;TELEFONIA
18162803;;F;29;CHILENO;;Millenial;N/D;N/D;0;0;0;0;0;0;0;0;0;CELULAR XIAOMI MI 10T 128GB LUNAR SILVER OPEN;TELEFONIA
17951229;;F;31;CHILENO;;Millenial;N/D;N/D;0;0;0;0;0;0;0;0;0;CELULAR POCO M3 64GB COOL BLUE;TELEFONIA
7321804;;M;69;CHILENO;;Silencioso;PROVIDENCIA                   ;METROPOLITANA;0;0;0;0;0;0;0;0;0;Celular SAMSUNG A01 CORE BLACK CLARO;TELEFONIA
17648271;;F;31;CHILENO;;Millenial;N/D;N/D;0;0;0;0;0;0;0;0;0;CELULAR XIAOMI REDMI 9 64GB DIRECTO CLARO MORADO;TELEFONIA
17419135;;F;32;CHILENO;;Millenial;PROVIDENCIA                   ;METROPOLITANA;0;0;0;0;0;0;0;0;0;Celular NOKIA 1.3 NEGRO WOM;TELEFONIA
10974102;;F;57;CHILENO;;Boomers;PROVIDENCIA                   ;METROPOLITANA;0;0;0;0;0;0;0;0;0;Celular A11 LIB OPEN WHITE;TELEFONIA
15023324;;F;40;CHILENO;;X;PROVIDENCIA                   ;METROPOLITANA;0;0;0;0;0;0;0;0;0;CELULAR SAMSUNG A02S DIRECTO CLARO BLACK;TELEFONIA
4795924;;M;77;CHILENO;;Silencioso;PROVIDENCIA                   ;METROPOLITANA;0;0;0;0;0;0;0;0;0;CELULAR A12 128GB NEGRO TRIANGULADO CLARO;TELEFONIA
10765467;;M;49;CHILENO;;X;MACHALI                       ;L.G.B.OÂ´HIGGINS;0;0;0;0;0;0;0;0;0;CELULAR A21s 128 GB Negro;TELEFONIA
8681186;;F;66;CHILENO;;Boomers;CORONEL                       ;BIO BIO;0;0;0;0;0;0;0;0;0;Celular A11 LIB OPEN WHITE;TELEFONIA
6842111;;F;70;CHILENO;;Silencioso;RENCA                         ;METROPOLITANA;0;0;0;0;0;0;0;0;0;CELULAR MOTOROLA G9 PLAY 64GB SPRING PINK OPEN;TELEFONIA
14681411;;M;54;ECUATORIANO;;Extranjero;MAIPU                         ;METROPOLITANA;0;0;0;0;0;0;0;0;0;CELULAR SAMSUNG NOTE 20 MYSTIC GRAY OPEN;TELEFONIA
14437363;Casado;M;49;CHILENO;;X;PUERTO MONTT                  ;LOS LAGOS;0;0;0;0;0;0;0;0;0;CELULAR REDMI 9A 32GB SKY BLUE;TELEFONIA
9362080;;M;59;CHILENO;;Boomers;VINA DEL MAR                  ;VALPARAISO;0;0;0;0;0;0;0;0;0;CELULAR XIAOMI REDMI 9C AZUL DIRECTO ENTEL;TELEFONIA
19580407;;M;25;CHILENO;;Z;PROVIDENCIA                   ;METROPOLITANA;0;0;0;0;0;0;0;0;0;CELULAR REDMI NOTE 9 128 GB MIDNIGHT GREY OPEN;TELEFONIA
21106336;Soltero;M;27;CHILENO;;Extranjero;PROVIDENCIA                   ;METROPOLITANA;0;0;0;0;0;0;0;0;0;CELULAR GALAXY S20FE 128GB ClOUD NAVY OPEN;TELEFONIA
15982377;;M;37;CHILENO;;Millenial;RENCA                         ;METROPOLITANA;0;0;0;0;0;0;0;0;0;CELULAR ZTE A3 2020 GRIS DIRECTO CLARO;TELEFONIA
14382954;;F;43;CHILENO;;X;PROVIDENCIA                   ;METROPOLITANA;0;0;0;0;0;0;0;0;0;CELULAR XIAOMI REDMI 9C 64GB MIDNIGHT GRAY;TELEFONIA
16679570;;M;35;CHILENO;;Millenial;CONSTITUCION                  ;MAULE;0;0;0;0;0;0;0;0;0;CELULAR A21s 128 GB Negro;TELEFONIA
15215695;;F;40;CHILENO;;Silencioso;PROVIDENCIA                   ;METROPOLITANA;0;0;0;0;0;0;0;0;0;CELULAR G8 POWER MOTO TRI ENTEL;TELEFONIA
18543301;;M;28;CHILENO;;Millenial;PROVIDENCIA                   ;METROPOLITANA;0;0;0;0;0;0;0;0;0;Celular Y7P LIB OPEN NEGRO;TELEFONIA
11511627;;F;52;CHILENO;;X;OVALLE                        ;COQUIMBO;0;0;0;0;0;0;0;0;0;CELULAR A21s 128 GB Rojo;TELEFONIA
12093012;;F;58;CHILENO;;Boomers;SANTA CRUZ                    ;L.G.B.OÂ´HIGGINS;0;0;0;0;0;0;0;0;0;Celular A01 CLARO DIRECTO BLACK;TELEFONIA
11234436;;F;54;CHILENO;;X;RANCAGUA                      ;L.G.B.OÂ´HIGGINS;0;0;0;0;0;0;0;0;0;CELULAR MOTOROLA G9 PLAY 64GB BLUE DIRECTO CLAR;TELEFONIA
6222330;;M;68;CHILENO;;Boomers;PROVIDENCIA                   ;METROPOLITANA;0;0;0;0;0;0;0;0;0;Celular R340 CLARO DIRECTO NEGRO;TELEFONIA
19895192;;F;24;CHILENO;;Z;N/D;N/D;0;0;0;0;0;0;0;0;0;Celular LG K22 DIRECTO CLARO;TELEFONIA
17521138;Soltero;F;31;CHILENO;;Silencioso;PROVIDENCIA                   ;METROPOLITANA;0;0;0;0;0;0;0;0;0;CELULAR A12 128GB NEGRO OPEN;TELEFONIA
15150927;;F;39;CHILENO;;X;SAN JAVIER                    ;MAULE;0;0;0;0;0;0;0;0;0;CELULAR VIVO Y11S PHANTON BLACK 32GB MOVISTAR;TELEFONIA
14241241;;M;48;CHILENO;;X;LIMACHE;VALPARAISO;0;0;0;0;0;0;0;0;0;CELULAR CLARO LG K42 GRIS;TELEFONIA
15648681;;M;38;CHILENO;;Millenial;PUDAHUEL                      ;METROPOLITANA;0;0;0;0;0;0;0;0;0;CELULAR VIVO Y11S PHANTOM BLACK OPEN;TELEFONIA
9556955;;F;60;CHILENO;;Boomers;TENO                          ;MAULE;0;0;0;0;0;0;0;0;0;Celular A01 CLARO DIRECTO BLACK;TELEFONIA
6495477;;M;68;CHILENO;;Silencioso;PROVIDENCIA                   ;METROPOLITANA;0;0;0;0;0;0;0;0;0;CELULAR MOTOROLA E6 PLAY AZUL TRI WOM;TELEFONIA
16613029;;F;34;CHILENO;;Millenial;PROVIDENCIA                   ;METROPOLITANA;0;0;0;0;0;0;0;0;0;CELULAR MOTOROLA E6 PLAY AZUL TRI WOM;TELEFONIA
13807434;;F;41;CHILENO;;X;PROVIDENCIA                   ;METROPOLITANA;0;0;0;0;0;0;0;0;0;CELULAR A02 NEGRO 32GB OPEN;TELEFONIA
19208061;Soltero;M;26;CHILENO;;Z;PROVIDENCIA                   ;METROPOLITANA;0;0;0;0;0;0;0;0;0;CELULAR POCO X3 PRO 128 GB FROST BLUE;TELEFONIA
18216427;;F;29;CHILENO;;Millenial;PROVIDENCIA                   ;METROPOLITANA;0;0;0;0;0;0;0;0;0;CELULAR A21s 128 GB Rojo;TELEFONIA
12760368;;M;47;CHILENO;;X;QUINCHAO                      ;LOS LAGOS;0;0;0;0;0;0;0;0;0;CELULAR A12 128GB NEGRO OPEN;TELEFONIA
11576957;;F;52;CHILENO;;X;RENCA                         ;METROPOLITANA;0;0;0;0;0;0;0;0;0;CELULAR A32 128 GB BLACK OPEN;TELEFONIA
16955082;Soltero;M;33;CHILENO;;Millenial;PROVIDENCIA                   ;METROPOLITANA;0;0;0;0;0;0;0;0;0;CELULAR MOTO ONE FUSION 128GB AZUL OPEN;TELEFONIA
10870275;;F;56;CHILENO;;Extranjero;VICUNA                        ;COQUIMBO;0;0;0;0;0;0;0;0;0;CELULAR A12 128GB ROJO OPEN;TELEFONIA
10361868;Soltero;F;55;CHILENO;;Boomers;PROVIDENCIA                   ;METROPOLITANA;0;0;0;0;0;0;0;0;0;CELULAR A12 128GB AZUL OPEN;TELEFONIA
16185833;;F;36;CHILENO;;Millenial;COLINA                        ;METROPOLITANA;0;0;0;0;0;0;0;0;0;CELULAR NOKIA 225 4G BLACK MOVISTAR DIRECTO;TELEFONIA
5809774;;F;75;CHILENO;;Silencioso;PROVIDENCIA                   ;METROPOLITANA;0;0;0;0;0;0;0;0;0;CELULAR VIVO Y11S PHANTON BLACK 32GB MOVISTAR;TELEFONIA
16543700;;M;35;CHILENO;;Millenial;N/D;N/D;0;0;0;0;0;0;0;0;0;CELULAR MI 11 LITE 128GB BOBA BLACK OPEN;TELEFONIA
19092659;;M;27;CHILENO;;Z;N/D;N/D;0;0;0;0;0;0;0;0;0;CELULAR A21s 128 GB Rojo;TELEFONIA
10425934;;M;54;CHILENO;;X;CALAMA                        ;ANTOFAGASTA;0;0;0;0;0;0;0;0;0;CELULAR GALAXY S20FE 128GB CLOUD LAVENDER OPEN;TELEFONIA
14408118;;F;50;CHILENO;;X;SAN RAFAEL                    ;MAULE;0;0;0;0;0;0;0;0;0;CELULAR Xiaomi Redmi 9 64 GB Morado WOM;TELEFONIA
18030940;;M;30;CHILENO;;Millenial;PROVIDENCIA                   ;METROPOLITANA;0;0;0;0;0;0;0;0;0;CELULAR Samsung Galaxy A02s 32GB Azul WOM;TELEFONIA
11838799;;F;50;CHILENO;;X;PROVIDENCIA                   ;METROPOLITANA;0;0;0;0;0;0;0;0;0;CELULAR MOTO ONE FUSION 128GB AZUL OPEN;TELEFONIA
7622822;;F;66;CHILENO;;Boomers;LOS ANGELES                   ;BIO BIO;0;0;0;0;0;0;0;0;0;CELULAR A32 128 GB BLACK OPEN;TELEFONIA
19477672;;M;28;CHILENO;;Millenial;N/D;N/D;0;0;0;0;0;0;0;0;0;CELULAR A12 128GB ROJO OPEN;TELEFONIA
17440684;Soltero;F;31;CHILENO;NUTRICIONISTA;Millenial;PROVIDENCIA                   ;METROPOLITANA;0;0;0;0;0;0;0;0;0;CELULAR GALAXY S20FE 128GB ClOUD NAVY OPEN;TELEFONIA
15611700;;F;38;CHILENO;;Millenial;LOLOL                         ;L.G.B.OÂ´HIGGINS;0;0;0;0;0;0;0;0;0;CELULAR REDMI NOTE 9 128 GB MIDNIGHT GREY OPEN;TELEFONIA
19378687;;F;26;CHILENO;;Z;PROVIDENCIA                   ;METROPOLITANA;0;0;0;0;0;0;0;0;0;CELULAR MOTO ONE FUSION 64GB VERDE 64GB OPEN;TELEFONIA
15224957;;F;40;CHILENO;;X;N/D;N/D;0;0;0;0;0;0;0;0;0;CELULAR A21s 128 GB Rojo;TELEFONIA
11541669;;F;52;CHILENO;;X;VILLA ALEMANA                 ;VALPARAISO;0;0;0;0;0;0;0;0;0;CELULAR A02 AZUL 32GB OPEN;TELEFONIA
10037173;Soltero;M;57;CHILENO;;Boomers;ANCUD                         ;LOS LAGOS;0;0;0;0;0;0;0;0;0;CELULAR NOKIA 225 4G BLACK MOVISTAR DIRECTO;TELEFONIA
19317969;Soltero;M;26;CHILENO;;Z;PROVIDENCIA                   ;METROPOLITANA;0;0;0;0;0;0;0;0;0;CELULAR GALAXY S20FE 128GB CLOUD LAVENDER OPEN;TELEFONIA
12607023;;M;47;CHILENO;;X;RENCA                         ;METROPOLITANA;0;0;0;0;0;0;0;0;0;CELULAR A32 128 GB WHITE OPEN;TELEFONIA
18349702;;M;29;CHILENO;;Millenial;N/D;N/D;0;0;0;0;0;0;0;0;0;CELULAR A32 128 GB BLACK OPEN;TELEFONIA
8532863;;M;50;CHILENO;;X;PROVIDENCIA                   ;METROPOLITANA;0;0;0;0;0;0;0;0;0;CELULAR A21s 128 GB Negro;TELEFONIA
19042425;;F;26;CHILENO;;Silencioso;PROVIDENCIA                   ;METROPOLITANA;0;0;0;0;0;0;0;0;0;CELULAR SAMSUNG A02S DIRECTO CLARO BLACK;TELEFONIA
14016018;Soltero;M;41;CHILENO;INGENIERO EN MAQUINARIA;X;RENCA                         ;METROPOLITANA;0;0;0;0;0;0;0;0;0;CELULAR POCO X3 PRO 256 GB FROST BLUE;TELEFONIA
14303775;;F;47;CHILENO;;X;SAN CARLOS                    ;BIO BIO;0;0;0;0;0;0;0;0;0;CELULAR A02 NEGRO 32GB OPEN;TELEFONIA
16511675;;M;35;CHILENO;;Millenial;PROVIDENCIA                   ;METROPOLITANA;0;0;0;0;0;0;0;0;0;Celular LG K22 ENTEL DIRECTO TITAN;TELEFONIA
7680917;Casado;F;69;CHILENO;;Silencioso;PROVIDENCIA                   ;METROPOLITANA;0;0;0;0;0;0;0;0;0;CELULAR A21s 128 GB AZUL;TELEFONIA
9548413;Casado;M;59;CHILENO;;Boomers;PROVIDENCIA                   ;METROPOLITANA;0;0;0;0;0;0;0;0;0;CELULAR A21s 128 GB Rojo;TELEFONIA
20509806;;F;21;CHILENO;;Millenial;"";"";0;0;0;0;0;0;0;0;0;CELULAR A72 128 GB BLACK OPEN;TELEFONIA
13648928;;F;43;CHILENO;;X;RENCA                         ;METROPOLITANA;0;0;0;0;0;0;0;0;0;CELULAR OWN 1026 AZUL ENTEL;TELEFONIA
10331946;;F;42;CHILENO;;Silencioso;SANTIAGO                      ;METROPOLITANA;0;0;0;0;0;0;0;0;0;CELULAR A21s 128 GB Rojo;TELEFONIA
11193068;;M;54;CHILENO;;Boomers;N/D;N/D;0;0;0;0;0;0;0;0;0;CELULAR MI 10T PRO 256GB COSMIC BLACK OPEN;TELEFONIA
9905290;;F;60;CHILENO;;Boomers;PEDRO AGUIRRE CERDA           ;METROPOLITANA;0;0;0;0;0;0;0;0;0;CELULAR REDMI NOTE 10 PRO 128GB GLACIER BLUE;TELEFONIA
19897148;;F;23;CHILENO;;Z;PROVIDENCIA                   ;METROPOLITANA;0;0;0;0;0;0;0;0;0;CELULAR A32 128 GB BLACK OPEN;TELEFONIA
14583053;;M;41;CHILENO;;Silencioso;PROVIDENCIA                   ;METROPOLITANA;0;0;0;0;0;0;0;0;0;CELULAR MOTOROLA E6 PLAY AZUL TRI WOM;TELEFONIA
11304080;;F;54;CHILENO;;X;TEMUCO                        ;ARAUCANIA;0;0;0;0;0;0;0;0;0;CELULAR A72 128 GB BLUE OPEN;TELEFONIA
17349959;;M;33;CHILENO;;Millenial;PROVIDENCIA                   ;METROPOLITANA;0;0;0;0;0;0;0;0;0;CELULAR A21s 128 GB AZUL;TELEFONIA
13157657;;F;48;CHILENO;;X;RENCA                         ;METROPOLITANA;0;0;0;0;0;0;0;0;0;Celular A11 LIB OPEN WHITE;TELEFONIA
13008671;;M;46;CHILENO;;X;N/D;N/D;0;0;0;0;0;0;0;0;0;Celular S20 + LIB OPEN GRIS;TELEFONIA
14061965;Soltero;F;40;CHILENO;;X;RENCA                         ;METROPOLITANA;0;0;0;0;0;0;0;0;0;CELULAR MOTOROLA E6 PLAY AZUL TRI WOM;TELEFONIA
7255632;;M;66;CHILENO;;Boomers;N/D;N/D;0;0;0;0;0;0;0;0;0;CELULAR A21s 128 GB Rojo;TELEFONIA
15101210;;F;39;CHILENO;;X;RENCA                         ;METROPOLITANA;0;0;0;0;0;0;0;0;0;CELULAR A12 128GB NEGRO OPEN;TELEFONIA
19121518;Soltero;M;26;CHILENO;;Z;PROVIDENCIA                   ;METROPOLITANA;0;0;0;0;0;0;0;0;0;Celular A11 LIB OPEN BLACK;TELEFONIA
17042123;;F;33;CHILENO;;Millenial;ARAUCO                        ;BIO BIO;0;0;0;0;0;0;0;0;0;Celular SAMSUNG A01 CORE BLACK CLARO;TELEFONIA
19449253;;M;25;CHILENO;;Z;PROVIDENCIA                   ;METROPOLITANA;0;0;0;0;0;0;0;0;0;CELULAR GALAXY S20FE 128GB ClOUD NAVY OPEN;TELEFONIA
13912862;;F;42;CHILENO;;X;N/D;N/D;0;0;0;0;0;0;0;0;0;CELULAR MOTO G8 POWER LITE AZUL TRI ENTEL;TELEFONIA
17663593;;M;32;CHILENO;;Millenial;PROVIDENCIA                   ;METROPOLITANA;0;0;0;0;0;0;0;0;0;POCO X3 PRO 256 GB PHANTOM BLACK;TELEFONIA
18086621;;F;30;CHILENO;;Millenial;"";"";0;0;0;0;0;0;0;0;0;CELULAR A32 128 GB BLACK OPEN;TELEFONIA
8775327;;F;69;CHILENO;;Silencioso;EL BOSQUE                     ;METROPOLITANA;0;0;0;0;0;0;0;0;0;CELULAR A02s AZUL 32GB OPEN;TELEFONIA
11660467;;F;51;CHILENO;;Silencioso;PROVIDENCIA                   ;METROPOLITANA;0;0;0;0;0;0;0;0;0;CELULAR A12 128GB AZUL OPEN;TELEFONIA
13763874;;M;42;CHILENO;;X;QUILLOTA                      ;VALPARAISO;0;0;0;0;0;0;0;0;0;CELULAR A21s 128 GB AZUL;TELEFONIA
6102180;Casado;M;74;CHILENO;;Silencioso;RINCONADA                     ;VALPARAISO;0;0;0;0;0;0;0;0;0;CELULAR A02s NEGRO 32GB OPEN;TELEFONIA
15594813;;F;38;CHILENO;;X;COPIAPO                       ;ATACAMA;0;0;0;0;0;0;0;0;0;CELULAR A32 128 GB BLACK OPEN;TELEFONIA
19619233;;F;24;CHILENO;;Z;PROVIDENCIA                   ;METROPOLITANA;0;0;0;0;0;0;0;0;0;IPHONE 11 128GB BLACK CLARO;TELEFONIA
17858695;;F;31;CHILENO;;Millenial;"";"";0;0;0;0;0;0;0;0;0;CELULAR MOTOROLA G9 PLAY 64GB ELECTRIC BLUE OPEN;TELEFONIA
14278124;;F;49;CHILENO;;X;SAN CARLOS                    ;BIO BIO;0;0;0;0;0;0;0;0;0;CELULAR A02 ROJO 32GB OPEN;TELEFONIA
11555435;;M;51;CHILENO;;X;PERALILLO                     ;L.G.B.OÂ´HIGGINS;0;0;0;0;0;0;0;0;0;CELULAR A32 128 GB BLUE OPEN;TELEFONIA
15146525;Soltero;F;40;CHILENO;;X;PROVIDENCIA                   ;METROPOLITANA;0;0;0;0;0;0;0;0;0;CELULAR A12 128GB ROJO OPEN;TELEFONIA
13752584;;F;41;CHILENO;;X;SANTA MARIA                   ;VALPARAISO;0;0;0;0;0;0;0;0;0;CELULAR A21s 128 GB AZUL;TELEFONIA
19543203;;M;24;CHILENO;;Silencioso;PROVIDENCIA                   ;METROPOLITANA;0;0;0;0;0;0;0;0;0;CELULAR GALAXY S20FE 128GB ClOUD NAVY OPEN;TELEFONIA
15352435;;M;39;CHILENO;;X;PROVIDENCIA                   ;METROPOLITANA;0;0;0;0;0;0;0;0;0;CELULAR A32 128 GB BLACK OPEN;TELEFONIA
20032965;;F;23;CHILENO;;Silencioso;PROVIDENCIA                   ;METROPOLITANA;0;0;0;0;0;0;0;0;0;CELULAR A32 128 GB LIGHT VIOLET OPEN;TELEFONIA
15131230;;F;39;CHILENO;;X;ROMERAL                       ;MAULE;0;0;0;0;0;0;0;0;0;Celular A01 LIB OPEN ROJO;TELEFONIA
18284885;;M;30;CHILENO;;Millenial;EL BOSQUE;METROPOLITANA;0;0;0;0;0;0;0;0;0;CELULAR REDMI NOTE 9 128G FOREST GREEN OPEN;TELEFONIA
16520409;;F;35;CHILENO;;Millenial;N/D;N/D;0;0;0;0;0;0;0;0;0;Celular A11 LIB OPEN WHITE;TELEFONIA
13265067;;M;45;CHILENO;;X;PROVIDENCIA                   ;METROPOLITANA;0;0;0;0;0;0;0;0;0;Celular NOKIA 1.3 NEGRO WOM;TELEFONIA
19001043;;M;26;CHILENO;;Z;PROVIDENCIA                   ;METROPOLITANA;0;0;0;0;0;0;0;0;0;CELULAR REDMI NOTE 10 EU 64GB ONIX GRAY OPEN;TELEFONIA
18292627;;F;29;CHILENO;;Millenial;CURACAVI                      ;METROPOLITANA;0;0;0;0;0;0;0;0;0;CELULAR A32 128 GB LIGHT VIOLET OPEN;TELEFONIA
20401791;;F;22;CHILENO;;Silencioso;PROVIDENCIA                   ;METROPOLITANA;0;0;0;0;0;0;0;0;0;CELULAR A32 128 GB BLUE OPEN;TELEFONIA
17838356;Soltero;F;31;CHILENO;;Millenial;PROVIDENCIA                   ;METROPOLITANA;0;0;0;0;0;0;0;0;0;CELULAR MI 11 LITE 128GB BOBA BLACK OPEN;TELEFONIA
19216403;Soltero;F;26;CHILENO;ENFERMERO;Z;PROVIDENCIA                   ;METROPOLITANA;0;0;0;0;0;0;0;0;0;CELULAR A12 128GB NEGRO OPEN;TELEFONIA
15430113;;F;40;CHILENO;;X;HUECHURABA                    ;METROPOLITANA;0;0;0;0;0;0;0;0;0;CELULAR A32 128 GB WHITE OPEN;TELEFONIA
16879400;;F;34;CHILENO;;Millenial;PROVIDENCIA                   ;METROPOLITANA;0;0;0;0;0;0;0;0;0;Celular A11 LIB OPEN BLUE;TELEFONIA
18927370;;F;27;CHILENO;;Millenial;N/D;N/D;0;0;0;0;0;0;0;0;0;CELULAR REDMI NOTE 10 EU 128G Lake Green BUNDLE;TELEFONIA
9962299;;M;57;CHILENO;;Boomers;N/D;N/D;0;0;0;0;0;0;0;0;0;CELULAR Xiaomi Redmi Note 9 128GB Blanco WOM;TELEFONIA
10562713;;F;56;CHILENO;;Boomers;TRAIGUEN                      ;ARAUCANIA;0;0;0;0;0;0;0;0;0;CELULAR MOTO E6S 32GB GRIS DIRECTO ENTEL;TELEFONIA
9339278;;M;59;CHILENO;;Boomers;LOS ALAMOS                    ;BIO BIO;0;0;0;0;0;0;0;0;0;CELULAR VIVO Y11S PHANTOM BLACK OPEN;TELEFONIA
22486238;;F;43;PERUANO;;Extranjero;ANTOFAGASTA                   ;ANTOFAGASTA;0;0;0;0;0;0;0;0;0;CELULAR A21s 128 GB Negro;TELEFONIA
27072748;;M;58;EXTRANJERO - NO INFORMA NACIONALIDAD;;Extranjero;TEMUCO                        ;ARAUCANIA;0;0;0;0;0;0;0;0;0;CELULAR A72 128 GB BLUE OPEN;TELEFONIA
18851131;;M;27;CHILENO;;Millenial;PROVIDENCIA                   ;METROPOLITANA;0;0;0;0;0;0;0;0;0;Celular Galaxy S21 Phantom Grey 128GB;TELEFONIA
17868613;;F;31;CHILENO;;Millenial;PROVIDENCIA                   ;METROPOLITANA;0;0;0;0;0;0;0;0;0;CELULAR MOTO ONE FUSION 128GB AZUL OPEN;TELEFONIA
16352846;;M;36;CHILENO;;Millenial;PROVIDENCIA                   ;METROPOLITANA;0;0;0;0;0;0;0;0;0;CELULAR MOTO G9 POWER 128GB MORADO SONICO OPEN;TELEFONIA
18598525;;M;28;CHILENO;;Silencioso;PROVIDENCIA                   ;METROPOLITANA;0;0;0;0;0;0;0;0;0;CELULAR POCO X3 PRO 256 GB FROST BLUE;TELEFONIA
17827807;;F;31;CHILENO;;Millenial;PROVIDENCIA                   ;METROPOLITANA;0;0;0;0;0;0;0;0;0;CELULAR A21s 128 GB AZUL;TELEFONIA
11447703;Soltero;M;52;CHILENO;;Silencioso;PROVIDENCIA                   ;METROPOLITANA;0;0;0;0;0;0;0;0;0;CELULAR MOTOROLA E6S GRIS 32GB DIRECTO WOM;TELEFONIA
6238710;Casado;M;71;CHILENO;;Silencioso;PROVIDENCIA                   ;METROPOLITANA;0;0;0;0;0;0;0;0;0;Celular SAMSUNG A31 BLACK CLARO;TELEFONIA
4175381;;M;84;CHILENO;;Silencioso;RENCA                         ;METROPOLITANA;0;0;0;0;0;0;0;0;0;Celular SAMSUNG A01 CORE BLACK CLARO;TELEFONIA
18854122;;M;27;CHILENO;;Millenial;N/D;N/D;0;0;0;0;0;0;0;0;0;CELULAR REDMI 9 32GB CARBON GREY OPEN;TELEFONIA
6066879;;F;75;CHILENO;;Silencioso;RECOLETA                      ;METROPOLITANA;0;0;0;0;0;0;0;0;0;CELULAR A12 128GB NEGRO OPEN;TELEFONIA
16436276;Casado;M;36;CHILENO;INGENIERO EN TELECOMUNICACIONES;Silencioso;PROVIDENCIA                   ;METROPOLITANA;0;0;0;0;0;0;0;0;0;CELULAR REDMI NOTE 9 128G ONYX BLACK OPEN;TELEFONIA
8732753;;F;61;CHILENO;;Boomers;CURANILAHUE                   ;BIO BIO;0;0;0;0;0;0;0;0;0;IPHONE 11 128GB BLACK CLARO;TELEFONIA
14517369;;M;45;CHILENO;;X;MARIA PINTO                   ;METROPOLITANA;0;0;0;0;0;0;0;0;0;CELULAR NOKIA 5.3 CHARCOAL TRI ENTEL;TELEFONIA
13750647;;F;42;CHILENO;;X;PROVIDENCIA                   ;METROPOLITANA;0;0;0;0;0;0;0;0;0;CELULAR A12 128GB AZUL OPEN;TELEFONIA
19714241;;F;24;CHILENO;;Z;PROVIDENCIA                   ;METROPOLITANA;0;0;0;0;0;0;0;0;0;CELULAR REDMI NOTE 10S 128GB PEBBLE WHITE;TELEFONIA
16746813;Casado;M;34;CHILENO;BIOQUIMICO;Silencioso;PROVIDENCIA                   ;METROPOLITANA;0;0;0;0;0;0;0;0;0;CELULAR MI 11 EU 256G Midnight Gray BUNDLE;TELEFONIA
6941696;;F;74;CHILENO;;Silencioso;POZO ALMONTE                  ;TARAPACA;0;0;0;0;0;0;0;0;0;CELULAR OWN 1026 AZUL ENTEL;TELEFONIA
19971065;;M;23;CHILENO;;Silencioso;PROVIDENCIA                   ;METROPOLITANA;0;0;0;0;0;0;0;0;0;CELULAR POCO M3 64GB COOL BLUE;TELEFONIA
26219856;;M;41;HAITIANO;;Extranjero;PUTAENDO                      ;VALPARAISO;0;0;0;0;0;0;0;0;0;Celular A01 Core Azul Tri Entel;TELEFONIA
18570541;Soltero;F;28;CHILENO;;Silencioso;PROVIDENCIA                   ;METROPOLITANA;0;0;0;0;0;0;0;0;0;CELULAR REDMI NOTE 10 128GB PEBBLE WHITE;TELEFONIA
19778683;;F;28;CHILENO;;Millenial;PROVIDENCIA                   ;METROPOLITANA;0;0;0;0;0;0;0;0;0;CELULAR OWN 1026 AZUL ENTEL;TELEFONIA
17144977;;F;33;CHILENO;;Millenial;N/D;N/D;0;0;0;0;0;0;0;0;0;CELULAR A12 128GB ROJO OPEN;TELEFONIA
8095697;;F;64;CHILENO;;Boomers;COIHAIQUE                     ;AYSEN;0;0;0;0;0;0;0;0;0;CELULAR A21s 128 GB AZUL;TELEFONIA
11380736;Soltero;M;52;CHILENO;;X;PROVIDENCIA                   ;METROPOLITANA;0;0;0;0;0;0;0;0;0;CELULAR A02 ROJO 32GB OPEN;TELEFONIA
8640773;;F;50;CHILENO;;X;CALLE LARGA                   ;VALPARAISO;0;0;0;0;0;0;0;0;0;CELULAR A21s 128 GB AZUL;TELEFONIA
5296209;;F;75;CHILENO;;Silencioso;RENCA                         ;METROPOLITANA;0;0;0;0;0;0;0;0;0;Celular AL3 CLARO DIRECTO NEGRO;TELEFONIA
7730297;;M;66;CHILENO;;Boomers;RANCAGUA                      ;L.G.B.OÂ´HIGGINS;0;0;0;0;0;0;0;0;0;CELULAR VIVO Y11s PHANTOM BLACK ENTEL DIRECTO;TELEFONIA
6294553;;M;72;CHILENO;;Silencioso;PANGUIPULLI                   ;LOS LAGOS;0;0;0;0;0;0;0;0;0;CELULAR ALCATEL P1 DIRECTO CLARO BLACK;TELEFONIA
19243214;Soltero;M;26;CHILENO;;Silencioso;PROVIDENCIA                   ;METROPOLITANA;0;0;0;0;0;0;0;0;0;CELULAR GALAXY S20FE 128GB ClOUD NAVY OPEN;TELEFONIA
20184727;;M;22;CHILENO;;Millenial;N/D;N/D;0;0;0;0;0;0;0;0;0;CELULAR A32 128 GB BLUE OPEN;TELEFONIA
9392302;;M;59;CHILENO;;Boomers;RENCA                         ;METROPOLITANA;0;0;0;0;0;0;0;0;0;CELULAR SAMSUNG A02S 32GB NEGRO DIRECTO ENTEL;TELEFONIA
18345665;Soltero;F;29;CHILENO;;Silencioso;PROVIDENCIA                   ;METROPOLITANA;0;0;0;0;0;0;0;0;0;CELULAR A21s 128 GB Negro;TELEFONIA
12228030;;F;50;CHILENO;;X;PROVIDENCIA                   ;METROPOLITANA;0;0;0;0;0;0;0;0;0;CELULAR A21s 128 GB AZUL;TELEFONIA
15865977;;F;38;CHILENO;;Millenial;SANTIAGO                      ;METROPOLITANA;0;0;0;0;0;0;0;0;0;CELULAR REDMI 9 32GB CARBON GREY OPEN;TELEFONIA
9357551;;F;60;CHILENO;;Boomers;SAN BERNARDO                  ;METROPOLITANA;0;0;0;0;0;0;0;0;0;Celular A01 LIB OPEN AZUL;TELEFONIA
14028429;;F;40;CHILENO;;X;N/D;N/D;0;0;0;0;0;0;0;0;0;CELULAR REDMI NOTE 9 DIRECTO CLARO BLUE;TELEFONIA
18141231;;F;29;CHILENO;;Millenial;COPIAPO                       ;ATACAMA;0;0;0;0;0;0;0;0;0;POCO X3 PRO 256 GB PHANTOM BLACK;TELEFONIA
14073211;;M;46;CHILENO;;X;N/D;N/D;0;0;0;0;0;0;0;0;0;CELULAR A21s 128 GB Negro;TELEFONIA
11708468;;M;51;CHILENO;;X;RIO BUENO                     ;LOS RIOS;0;0;0;0;0;0;0;0;0;CELULAR A12 128GB ROJO OPEN;TELEFONIA
19638699;;M;24;CHILENO;;Silencioso;PROVIDENCIA                   ;METROPOLITANA;0;0;0;0;0;0;0;0;0;CELULAR VIVO Y51 CRYSTAL SYMPHONY OPEN;TELEFONIA
17787874;;M;31;CHILENO;;Millenial;ANGOL                         ;ARAUCANIA;0;0;0;0;0;0;0;0;0;Celular A11 LIB OPEN BLACK;TELEFONIA
15115394;;F;39;CHILENO;;X;CHEPICA                       ;L.G.B.OÂ´HIGGINS;0;0;0;0;0;0;0;0;0;CELULAR POCO X3 PRO 256 GB FROST BLUE;TELEFONIA
18131590;;F;30;CHILENO;;Millenial;PROVIDENCIA                   ;METROPOLITANA;0;0;0;0;0;0;0;0;0;CELULAR A12 128GB NEGRO OPEN;TELEFONIA
25239417;;F;25;COLOMBIANO;;Extranjero;SANTIAGO                      ;METROPOLITANA;0;0;0;0;0;0;0;0;0;CELULAR REDMI NOTE 10 EU 64GB ONIX GRAY OPEN;TELEFONIA
18274500;Soltero;F;29;CHILENO;PSICOLOGO;Millenial;PROVIDENCIA                   ;METROPOLITANA;0;0;0;0;0;0;0;0;0;Celular AL3 CLARO DIRECTO NEGRO;TELEFONIA
11911842;;F;50;CHILENO;;X;QUILPUE                       ;VALPARAISO;0;0;0;0;0;0;0;0;0;Celular XIAOMI REDMI 9 64 GB DIRECTO CLARO NEGRO;TELEFONIA
20376720;;M;23;CHILENO;;Z;"";"";0;0;0;0;0;0;0;0;0;CELULAR REDMI NOTE 9 128G FOREST GREEN OPEN;TELEFONIA
15900937;;F;37;CHILENO;;Millenial;N/D;N/D;0;0;0;0;0;0;0;0;0;CELULAR Xiaomi Redmi 9 64 GB Morado WOM;TELEFONIA
17207931;;F;33;CHILENO;;Millenial;PROVIDENCIA                   ;METROPOLITANA;0;0;0;0;0;0;0;0;0;CELULAR A21s 128 GB AZUL;TELEFONIA
19019708;;F;26;CHILENO;;Z;PROVIDENCIA                   ;METROPOLITANA;0;0;0;0;0;0;0;0;0;Celular A11 LIB OPEN BLUE;TELEFONIA
4212454;;M;84;CHILENO;;Silencioso;MOSTAZAL                      ;L.G.B.OÂ´HIGGINS;0;0;0;0;0;0;0;0;0;CELULAR MI 11 EU 256G Midnight Gray BUNDLE;TELEFONIA
16974049;Soltero;F;34;CHILENO;;Millenial;PROVIDENCIA                   ;METROPOLITANA;0;0;0;0;0;0;0;0;0;Celular A11 LIB OPEN WHITE;TELEFONIA
6696134;;F;65;CHILENO;;Boomers;RENCA                         ;METROPOLITANA;0;0;0;0;0;0;0;0;0;Celular SAMSUNG A01 CORE BLACK CLARO;TELEFONIA
18587780;;M;28;CHILENO;;Millenial;PROVIDENCIA                   ;METROPOLITANA;0;0;0;0;0;0;0;0;0;CELULAR A21s 128 GB Rojo;TELEFONIA
11230420;;M;54;CHILENO;;X;PANGUIPULLI                   ;LOS RIOS;0;0;0;0;0;0;0;0;0;CELULAR NOKIA 225 4G BLACK MOVISTAR DIRECTO;TELEFONIA
19085421;;F;26;CHILENO;;Z;PROVIDENCIA                   ;METROPOLITANA;0;0;0;0;0;0;0;0;0;CELULAR NOKIA 110 BLACK OPEN;TELEFONIA
17171407;;M;33;CHILENO;;Millenial;PROVIDENCIA                   ;METROPOLITANA;0;0;0;0;0;0;0;0;0;Celular A11 LIB OPEN BLACK;TELEFONIA
11977714;Casado;M;49;CHILENO;INGENIERO CIVIL;X;PROVIDENCIA                   ;METROPOLITANA;0;0;0;0;0;0;0;0;0;CELULAR A12 128GB NEGRO OPEN;TELEFONIA
18877918;;F;27;CHILENO;;Z;N/D;N/D;0;0;0;0;0;0;0;0;0;CELULAR A21s 128 GB AZUL;TELEFONIA
6502099;;F;68;CHILENO;;Silencioso;ARICA                         ;ARICA Y PARINACOTA;0;0;0;0;0;0;0;0;0;CELULAR A12 128GB ROJO OPEN;TELEFONIA
13666654;Casado;M;42;CHILENO;;Silencioso;PROVIDENCIA                   ;METROPOLITANA;0;0;0;0;0;0;0;0;0;CELULAR Xiaomi Redmi 9 64 GB Morado WOM;TELEFONIA
7149063;;M;62;CHILENO;;Boomers;QUILPUE                       ;VALPARAISO;0;0;0;0;0;0;0;0;0;CELULAR GALAXY S20FE 128GB CLOUD LAVENDER OPEN;TELEFONIA
19724570;;M;24;CHILENO;;Silencioso;PROVIDENCIA                   ;METROPOLITANA;0;0;0;0;0;0;0;0;0;CELULAR A21s 128 GB Negro;TELEFONIA
13019947;;F;46;CHILENO;;X;QUILPUE                       ;VALPARAISO;0;0;0;0;0;0;0;0;0;CELULAR REDMI NOTE 9 128G FOREST GREEN OPEN;TELEFONIA
19581013;;F;26;CHILENO;;Z;SAAVEDRA                      ;ARAUCANIA;0;0;0;0;0;0;0;0;0;CELULAR A12 128GB NEGRO OPEN;TELEFONIA
4853480;;F;79;CHILENO;;Silencioso;PROVIDENCIA                   ;METROPOLITANA;0;0;0;0;0;0;0;0;0;CELULAR OWN 1026 AZUL ENTEL;TELEFONIA
19965721;;F;23;CHILENO;;Silencioso;PROVIDENCIA                   ;METROPOLITANA;0;0;0;0;0;0;0;0;0;Celular A51 128GB LIB OPEN BLACK;TELEFONIA
15267070;;M;39;CHILENO;;X;PROVIDENCIA                   ;METROPOLITANA;0;0;0;0;0;0;0;0;0;CELULAR MOTO G8 POWER LITE AZUL TRI ENTEL;TELEFONIA
14599915;;M;42;CHILENO;;X;CANETE                        ;BIO BIO;0;0;0;0;0;0;0;0;0;Celular G8 POWER LITE WOM DIRECTO TURQUESA;TELEFONIA
15709642;;M;38;CHILENO;;X;PROVIDENCIA                   ;METROPOLITANA;0;0;0;0;0;0;0;0;0;IPHONE 8 64 GB LIB OPEN DORADO;TELEFONIA
18975587;;F;27;CHILENO;;Millenial;PROVIDENCIA                   ;METROPOLITANA;0;0;0;0;0;0;0;0;0;CELULAR A21s 128 GB Negro;TELEFONIA
11385779;;F;53;CHILENO;;X;LOS ANDES                     ;VALPARAISO;0;0;0;0;0;0;0;0;0;CELULAR A02s ROJO 32GB OPEN;TELEFONIA
17120568;;F;33;CHILENO;;Millenial;N/D;N/D;0;0;0;0;0;0;0;0;0;CELULAR REDMI NOTE 9 128GB ONYX BLACK OPEN;TELEFONIA
7962081;Soltero;M;65;CHILENO;INGENIERO AGRICOLA;Boomers;PROVIDENCIA                   ;METROPOLITANA;0;0;0;0;0;0;0;0;0;CELULAR NOKIA 110 BLACK OPEN;TELEFONIA
10733998;;M;54;CHILENO;;X;N/D;N/D;0;0;0;0;0;0;0;0;0;CELULAR MOTOROLA E6 PLAY AZUL TRI WOM;TELEFONIA
17708215;Soltero;F;31;CHILENO;ENFERMERA;Millenial;PROVIDENCIA                   ;METROPOLITANA;0;0;0;0;0;0;0;0;0;CELULAR MOTO E6I 32GB GRIS OPEN;TELEFONIA
15868664;;F;37;CHILENO;;Millenial;RENCA                         ;METROPOLITANA;0;0;0;0;0;0;0;0;0;CELULAR REDMI 9 32GB CARBON GREY OPEN;TELEFONIA
17424828;;F;32;CHILENO;;Millenial;PROVIDENCIA                   ;METROPOLITANA;0;0;0;0;0;0;0;0;0;CELULAR GALAXY S20FE 128GB CLOUD GREEN OPEN;TELEFONIA
18646928;Soltero;F;28;CHILENO;;Millenial;PROVIDENCIA                   ;METROPOLITANA;0;0;0;0;0;0;0;0;0;Celular A11 LIB OPEN BLUE;TELEFONIA
13389432;Casado;F;44;CHILENO;;X;PROVIDENCIA                   ;METROPOLITANA;0;0;0;0;0;0;0;0;0;Celular A11 LIB OPEN BLUE;TELEFONIA
18853441;Soltero;M;27;CHILENO;;Millenial;N/D;N/D;0;0;0;0;0;0;0;0;0;Celular A71 LIB OPEN PLATEADO;TELEFONIA
14074579;;F;42;CHILENO;;X;VICTORIA                      ;ARAUCANIA;0;0;0;0;0;0;0;0;0;CELULAR A21s 128 GB AZUL;TELEFONIA
15378755;Soltero;F;40;CHILENO;INGENIERO EN ADMINISTRACION DE EMPRESAS;X;PROVIDENCIA                   ;METROPOLITANA;0;0;0;0;0;0;0;0;0;CELULAR XIAOMI REDMI 9C 32GB AZUL WOM;TELEFONIA
17320551;Soltero;F;32;CHILENO;;Millenial;PROVIDENCIA                   ;METROPOLITANA;0;0;0;0;0;0;0;0;0;CELULAR REDMI NOTE 9 PRO 128GB GLACIER WHITE;TELEFONIA
20302072;;F;22;CHILENO;;Z;PROVIDENCIA                   ;METROPOLITANA;0;0;0;0;0;0;0;0;0;Celular A51 128GB LIB OPEN BLACK;TELEFONIA
17007163;Soltero;F;33;CHILENO;;Millenial;PROVIDENCIA                   ;METROPOLITANA;0;0;0;0;0;0;0;0;0;CELULAR A02 NEGRO 32GB OPEN;TELEFONIA
20708870;;F;21;CHILENO;;Z;PUREN;ARAUCANIA;0;0;0;0;0;0;0;0;0;Celular A11 LIB OPEN BLACK;TELEFONIA
11905810;Casado;F;51;CHILENO;;X;PROVIDENCIA                   ;METROPOLITANA;0;0;0;0;0;0;0;0;0;CELULAR MOTO G9 POWER 128GB MORADO SONICO OPEN;TELEFONIA
26806556;;M;57;VENEZOLANO;;Extranjero;ESTACION CENTRAL              ;METROPOLITANA;0;0;0;0;0;0;0;0;0;CELULAR A21s 128 GB AZUL;TELEFONIA
20319008;;F;22;CHILENO;;Z;PROVIDENCIA                   ;METROPOLITANA;0;0;0;0;0;0;0;0;0;CELULAR REDMI NOTE 9 PRO 128GB GLACIER WHITE;TELEFONIA
15590334;;F;39;CHILENO;;X;SAN PEDRO DE LA PAZ           ;BIO BIO;0;0;0;0;0;0;0;0;0;CELULAR NOKIA 3310 CHARCOAL TRI WOM;TELEFONIA
12082888;;F;53;CHILENO;;X;ARAUCO                        ;BIO BIO;0;0;0;0;0;0;0;0;0;Celular A51 128GB LIB OPEN AZUL;TELEFONIA
14198139;Soltero;F;40;CHILENO;;X;PROVIDENCIA                   ;METROPOLITANA;0;0;0;0;0;0;0;0;0;CELULAR NOKIA 5.3 CHARCOAL TRI ENTEL;TELEFONIA
15974376;;F;37;CHILENO;;Millenial;VINA DEL MAR                  ;VALPARAISO;0;0;0;0;0;0;0;0;0;CELULAR VIVO Y11S PHANTOM BLACK OPEN;TELEFONIA
19041690;;F;26;CHILENO;;Z;N/D;N/D;0;0;0;0;0;0;0;0;0;CELULAR SAMSUNG A02S DIRECTO CLARO BLACK;TELEFONIA
26442462;;M;29;VENEZOLANO;;Extranjero;LA CRUZ                       ;VALPARAISO;0;0;0;0;0;0;0;0;0;CELULAR A21s 128 GB AZUL;TELEFONIA
13334150;;F;44;CHILENO;;X;MAIPU;METROPOLITANA;0;0;0;0;0;0;0;0;0;CELULAR REDMI NOTE 10 EU 128G Lake Green BUNDLE;TELEFONIA
19600889;;F;25;CHILENO;;Z;PROVIDENCIA                   ;METROPOLITANA;0;0;0;0;0;0;0;0;0;CELULAR POCO M3 64GB COOL BLUE;TELEFONIA
13535517;;M;42;CHILENO;;X;PROVIDENCIA                   ;METROPOLITANA;0;0;0;0;0;0;0;0;0;CELULAR A02s ROJO 32GB OPEN;TELEFONIA
19771933;;F;23;CHILENO;;Z;MONTE PATRIA;COQUIMBO;0;0;0;0;0;0;0;0;0;CELULAR REDMI NOTE 10 128GB LAKE GREEN OPEN;TELEFONIA
25401973;Soltero;M;43;CHILENO;;Extranjero;PROVIDENCIA                   ;METROPOLITANA;0;0;0;0;0;0;0;0;0;Celular NOKIA 4.2 ENTEL DIRECTO NEGRO;TELEFONIA
18224897;Soltero;F;29;CHILENO;;Millenial;PROVIDENCIA                   ;METROPOLITANA;0;0;0;0;0;0;0;0;0;CELULAR A12 128GB NEGRO OPEN;TELEFONIA
9042910;;F;60;CHILENO;;Boomers;PUENTE ALTO                   ;METROPOLITANA;0;0;0;0;0;0;0;0;0;CELULAR A21s 128 GB Rojo;TELEFONIA
16203247;Soltero;M;36;CHILENO;TECNICO EN ANALISIS QUIMICO;Millenial;CALAMA                        ;ANTOFAGASTA;0;0;0;0;0;0;0;0;0;Celular A31 LIB OPEN ROJO;TELEFONIA
17397126;;F;32;CHILENO;;Silencioso;PROVIDENCIA                   ;METROPOLITANA;0;0;0;0;0;0;0;0;0;CELULAR REDMI NOTE 10 128GB ONIX GRAY OPEN;TELEFONIA
7951153;;M;62;CHILENO;;Boomers;PROVIDENCIA                   ;METROPOLITANA;0;0;0;0;0;0;0;0;0;Celular A01 CLARO DIRECTO BLACK;TELEFONIA
19314820;Soltero;M;26;CHILENO;INGENIERO INFORMATICO;Silencioso;PROVIDENCIA                   ;METROPOLITANA;0;0;0;0;0;0;0;0;0;CELULAR REDMI 9 32GB CARBON GREY OPEN;TELEFONIA
22400148;;M;38;PERUANO;;Extranjero;N/D;N/D;0;0;0;0;0;0;0;0;0;CELULAR A21s 128 GB AZUL;TELEFONIA
11667324;Soltero;M;52;CHILENO;;X;RENCA                         ;METROPOLITANA;0;0;0;0;0;0;0;0;0;CELULAR Samsung Galaxy A02s 32GB Azul WOM;TELEFONIA
14330981;;M;44;CHILENO;;X;PROVIDENCIA                   ;METROPOLITANA;0;0;0;0;0;0;0;0;0;Celular A51 128GB LIB OPEN BLACK;TELEFONIA
14164688;;M;40;CHILENO;;X;QUILLOTA                      ;VALPARAISO;0;0;0;0;0;0;0;0;0;Celular A51 128GB LIB OPEN BLACK;TELEFONIA
19573095;;F;25;CHILENO;;Z;N/D;N/D;0;0;0;0;0;0;0;0;0;CELULAR MI 10T PRO 256GB AURORA BLUE OPEN;TELEFONIA
19059454;Soltero;M;26;CHILENO;;Z;PROVIDENCIA                   ;METROPOLITANA;0;0;0;0;0;0;0;0;0;CELULAR REDMI 9 64GB SUNSET PURPLE TRI WOM;TELEFONIA
18091445;Soltero;M;30;CHILENO;;Millenial;PROVIDENCIA                   ;METROPOLITANA;0;0;0;0;0;0;0;0;0;CELULAR A72 128 GB BLACK OPEN;TELEFONIA
18420695;;F;28;CHILENO;;Millenial;LAJA                          ;BIO BIO;0;0;0;0;0;0;0;0;0;Celular A51 128GB LIB OPEN BLACK;TELEFONIA
18689107;;F;28;CHILENO;;Millenial;OVALLE                        ;COQUIMBO;0;0;0;0;0;0;0;0;0;CELULAR A21s 128 GB AZUL;TELEFONIA
13205052;;M;44;CHILENO;;X;INDEPENDENCIA                 ;METROPOLITANA;0;0;0;0;0;0;0;0;0;Celular G8 POWER LITE WOM DIRECTO TURQUESA;TELEFONIA
13750507;;F;41;CHILENO;;X;LOS VILOS                     ;COQUIMBO;0;0;0;0;0;0;0;0;0;Celular A01 LIB OPEN AZUL;TELEFONIA
20036861;;F;22;CHILENO;;Silencioso;PROVIDENCIA                   ;METROPOLITANA;0;0;0;0;0;0;0;0;0;Celular G8 POWER LITE WOM DIRECTO TURQUESA;TELEFONIA
18946818;;F;27;CHILENO;;Millenial;LO ESPEJO                     ;METROPOLITANA;0;0;0;0;0;0;0;0;0;CELULAR XIAOMI REDMI 9C 32GB AZUL WOM;TELEFONIA
14336749;Divorciado;M;45;CHILENO;;X;QUILPUE                       ;VALPARAISO;0;0;0;0;0;0;0;0;0;IPHONE 11 64GB BLACK CLARO;TELEFONIA
9722320;;F;62;CHILENO;;Boomers;LOS ANGELES                   ;BIO BIO;0;0;0;0;0;0;0;0;0;Celular A10S MOVISTAR DIRECTO NEGRO;TELEFONIA
15910769;;F;37;CHILENO;;Millenial;PROVIDENCIA                   ;METROPOLITANA;0;0;0;0;0;0;0;0;0;CELULAR A21s 128 GB Negro;TELEFONIA
18862406;Soltero;M;27;CHILENO;PSICOLOGO;Millenial;PROVIDENCIA                   ;METROPOLITANA;0;0;0;0;0;0;0;0;0;CELULAR A12 128GB NEGRO OPEN;TELEFONIA
19429894;Soltero;M;25;CHILENO;;Silencioso;PROVIDENCIA                   ;METROPOLITANA;0;0;0;0;0;0;0;0;0;CELULAR IPHONE 12 64GB BLACK CLARO;TELEFONIA
18727983;;F;28;CHILENO;;Millenial;TEMUCO                        ;ARAUCANIA;0;0;0;0;0;0;0;0;0;CELULAR MOTO E6I 32GB GRIS OPEN;TELEFONIA
19399789;Soltero;M;25;CHILENO;;Z;PROVIDENCIA                   ;METROPOLITANA;0;0;0;0;0;0;0;0;0;Celular Galaxy S21 Phantom Grey 128GB;TELEFONIA
7091662;;M;67;CHILENO;;Boomers;PROVIDENCIA                   ;METROPOLITANA;0;0;0;0;0;0;0;0;0;CELULAR XIAOMI REDMI 9C 32GB AZUL WOM;TELEFONIA
15878056;Soltero;F;37;CHILENO;;Millenial;PROVIDENCIA                   ;METROPOLITANA;0;0;0;0;0;0;0;0;0;CELULAR A21s 128 GB AZUL;TELEFONIA
17998217;;F;30;CHILENO;;Millenial;PROVIDENCIA                   ;METROPOLITANA;0;0;0;0;0;0;0;0;0;Celular LG K22 MOVISTAR DIRECTO TITAN;TELEFONIA
16553453;;F;35;CHILENO;;Millenial;PROVIDENCIA                   ;METROPOLITANA;0;0;0;0;0;0;0;0;0;CELULAR SAMSUNG A02S DIRECTO CLARO BLACK;TELEFONIA
17128132;;M;33;CHILENO;;Millenial;N/D;N/D;0;0;0;0;0;0;0;0;0;Celular A11 LIB OPEN WHITE;TELEFONIA
12387717;;F;51;CHILENO;;X;GALVARINO                     ;ARAUCANIA;0;0;0;0;0;0;0;0;0;CELULAR MOTOROLA G9 PLAY 64GB SPRING PINK OPEN;TELEFONIA
10242087;;M;55;CHILENO;;Boomers;CURARREHUE                    ;ARAUCANIA;0;0;0;0;0;0;0;0;0;Celular Y8P ENTEL TRIANGULADO NEGRO;TELEFONIA
19551289;;F;25;CHILENO;;Z;PROVIDENCIA                   ;METROPOLITANA;0;0;0;0;0;0;0;0;0;CELULAR OWN 1026 AZUL ENTEL;TELEFONIA
10294183;;F;48;CHILENO;;X;NATALES                       ;MAGALLANES;0;0;0;0;0;0;0;0;0;Celular AL3 CLARO DIRECTO NEGRO;TELEFONIA
7642173;;F;67;CHILENO;;Boomers;CHILLAN                       ;BIO BIO;0;0;0;0;0;0;0;0;0;CELULAR A32 128 GB BLACK OPEN;TELEFONIA
19810180;;M;24;CHILENO;;Silencioso;PROVIDENCIA                   ;METROPOLITANA;0;0;0;0;0;0;0;0;0;CELULAR POCO X3 PRO 128G PHANTOM BLACK OPEN;TELEFONIA
18347836;;M;29;CHILENO;;Millenial;PROVIDENCIA                   ;METROPOLITANA;0;0;0;0;0;0;0;0;0;CELULAR A21s 128 GB Rojo;TELEFONIA
12941005;;F;45;CHILENO;;X;VALLENAR;ATACAMA;0;0;0;0;0;0;0;0;0;CELULAR A12 128GB NEGRO OPEN;TELEFONIA
15507267;;F;39;CHILENO;;Silencioso;PROVIDENCIA                   ;METROPOLITANA;0;0;0;0;0;0;0;0;0;CELULAR A21s 128 GB Rojo;TELEFONIA
9925572;;M;57;CHILENO;;Boomers;N/D;N/D;0;0;0;0;0;0;0;0;0;Celular S20 FE LIB OPEN Cloud Navy;TELEFONIA
14469365;;F;48;CHILENO;;X;N/D;N/D;0;0;0;0;0;0;0;0;0;CELULAR XIAOMI REDMI 9A 32 GB BLUE DIRECTO CLARO;TELEFONIA
13328349;;F;43;CHILENO;;X;RENCA                         ;METROPOLITANA;0;0;0;0;0;0;0;0;0;CELULAR REDMI NOTE 9 PRO 128GB INTERSTELLAR GREY;TELEFONIA
20100657;;M;22;CHILENO;;Z;PROVIDENCIA                   ;METROPOLITANA;0;0;0;0;0;0;0;0;0;CELULAR REDMI NOTE 10 128GB PEBBLE WHITE;TELEFONIA
10763167;;M;56;CHILENO;;Boomers;PROVIDENCIA                   ;METROPOLITANA;0;0;0;0;0;0;0;0;0;Celular G8 POWER LITE WOM DIRECTO TURQUESA;TELEFONIA
12801087;;M;48;CHILENO;;X;SAN PEDRO DE ATACAMA          ;ANTOFAGASTA;0;0;0;0;0;0;0;0;0;CELULAR A02s AZUL 32GB OPEN;TELEFONIA
11991593;;M;49;CHILENO;;X;PROVIDENCIA                   ;METROPOLITANA;0;0;0;0;0;0;0;0;0;CELULAR REDMI NOTE 10 128GB ONIX GRAY OPEN;TELEFONIA
13000406;;M;46;CHILENO;;X;CALBUCO                       ;LOS LAGOS;0;0;0;0;0;0;0;0;0;CELULAR POCO M3 64GB COOL BLUE;TELEFONIA
15042768;;M;41;CHILENO;;X;LA SERENA                     ;COQUIMBO;0;0;0;0;0;0;0;0;0;CELULAR A12 128GB ROJO OPEN;TELEFONIA
19466290;;F;25;CHILENO;;Z;PROVIDENCIA                   ;METROPOLITANA;0;0;0;0;0;0;0;0;0;CELULAR MOTO ONE FUSION 64GB VERDE 64GB OPEN;TELEFONIA
13538540;;F;43;CHILENO;;X;PROVIDENCIA                   ;METROPOLITANA;0;0;0;0;0;0;0;0;0;Celular A11 LIB OPEN BLACK;TELEFONIA
18264310;;F;30;CHILENO;;Millenial;ALTO HOSPICIO;TARAPACA;0;0;0;0;0;0;0;0;0;CELULAR MOTOROLA E6 PLAY AZUL TRI WOM;TELEFONIA
17855618;;M;31;CHILENO;;Millenial;COIHAIQUE                     ;AYSEN;0;0;0;0;0;0;0;0;0;Celular A51 128GB LIB OPEN AZUL;TELEFONIA
23194877;;F;28;BOLIVIANO;;Extranjero;IQUIQUE                       ;TARAPACA;0;0;0;0;0;0;0;0;0;Celular S20 FE LIB OPEN Cloud Green;TELEFONIA
15817391;;F;38;CHILENO;;Millenial;PROVIDENCIA                   ;METROPOLITANA;0;0;0;0;0;0;0;0;0;Celular XIAOMI REDMI 9 64 GB DIRECTO CLARO NEGRO;TELEFONIA
9393423;Soltero;M;50;CHILENO;TECNOLOGIA FORESTAL;X;RENCA                         ;METROPOLITANA;0;0;0;0;0;0;0;0;0;CELULAR A02 AZUL 32GB OPEN;TELEFONIA
12394279;;M;49;CHILENO;;Extranjero;PROVIDENCIA                   ;METROPOLITANA;0;0;0;0;0;0;0;0;0;CELULAR NOKIA 110 BLACK OPEN;TELEFONIA
15774540;;F;36;CHILENO;;Millenial;TALCA                         ;MAULE;0;0;0;0;0;0;0;0;0;Celular A51 128GB LIB OPEN AZUL;TELEFONIA
17628015;;F;32;CHILENO;;Millenial;PROVIDENCIA                   ;METROPOLITANA;0;0;0;0;0;0;0;0;0;Celular A51 128GB LIB OPEN BLANCO;TELEFONIA
19799313;;F;24;CHILENO;;Z;PROVIDENCIA                   ;METROPOLITANA;0;0;0;0;0;0;0;0;0;Celular A11 LIB OPEN BLUE;TELEFONIA
12346701;;M;52;CHILENO;;X;RENCA                         ;METROPOLITANA;0;0;0;0;0;0;0;0;0;Celular LG K22 MOVISTAR DIRECTO TITAN;TELEFONIA
8243804;;M;64;CHILENO;;Boomers;COPIAPO                       ;ATACAMA;0;0;0;0;0;0;0;0;0;CELULAR A11 CLARO DIRECTO BLACK;TELEFONIA
25833421;;M;27;HAITIANO;;Extranjero;CALAMA                        ;ANTOFAGASTA;0;0;0;0;0;0;0;0;0;CELULAR A02 AZUL 32GB OPEN;TELEFONIA
12914265;;M;46;CHILENO;;X;RENCA                         ;METROPOLITANA;0;0;0;0;0;0;0;0;0;CELULAR REDMI 9 64GB CARBON GREY;TELEFONIA
25199173;;M;45;HAITIANO;;Extranjero;CONCHALI                      ;METROPOLITANA;0;0;0;0;0;0;0;0;0;CELULAR A02s AZUL 32GB OPEN;TELEFONIA
10944176;;F;51;CHILENO;;X;LA FLORIDA                    ;METROPOLITANA;0;0;0;0;0;0;0;0;0;CELULAR SAMSUNG A02S DIRECTO CLARO BLACK;TELEFONIA
25204694;;M;29;PERUANO;;Extranjero;RECOLETA                      ;METROPOLITANA;0;0;0;0;0;0;0;0;0;CELULAR REDMI 9 64GB CARBON GREY;TELEFONIA
17184080;;F;33;CHILENO;;Millenial;TALCA                         ;MAULE;0;0;0;0;0;0;0;0;0;CELULAR A32 128 GB BLUE OPEN;TELEFONIA
5593521;;M;71;CHILENO;;Silencioso;PEUMO                         ;L.G.B.OÂ´HIGGINS;0;0;0;0;0;0;0;0;0;CELULAR MOTO G8 POWER LITE TURQUESA TRI ENTEL;TELEFONIA
11224685;;M;54;CHILENO;;X;PROVIDENCIA                   ;METROPOLITANA;0;0;0;0;0;0;0;0;0;CELULAR HUAWEI Y9 PRIME BLUE OPEN;TELEFONIA
25828439;;M;40;HAITIANO;;Extranjero;TALCA                         ;MAULE;0;0;0;0;0;0;0;0;0;Celular NOKIA 2.3 WOM DIRECTO CHARCOAL;TELEFONIA
7401728;;M;65;CHILENO;;Boomers;PARRAL                        ;MAULE;0;0;0;0;0;0;0;0;0;Celular P40 LITE LIB OPEN BLACK;TELEFONIA
19704503;;M;24;CHILENO;;Z;PROVIDENCIA                   ;METROPOLITANA;0;0;0;0;0;0;0;0;0;CELULAR REDMI 9 64GB CARBON GREY;TELEFONIA
17803342;Soltero;F;31;CHILENO;PROFESOR;Millenial;PROVIDENCIA                   ;METROPOLITANA;0;0;0;0;0;0;0;0;0;Celular A71 LIB OPEN PLATEADO;TELEFONIA
16558338;;M;34;CHILENO;;Millenial;N/D;N/D;0;0;0;0;0;0;0;0;0;Celular NOKIA 1.3 NEGRO WOM;TELEFONIA
6726598;Casado;M;71;CHILENO;;Silencioso;RENCA                         ;METROPOLITANA;0;0;0;0;0;0;0;0;0;Celular A01 LIB OPEN ROJO;TELEFONIA
15349719;Soltero;M;39;CHILENO;ANALISTA DE SISTEMAS;Silencioso;PROVIDENCIA                   ;METROPOLITANA;0;0;0;0;0;0;0;0;0;CELULAR MI 10T LITE 126G PEARL GRAY OPEN;TELEFONIA
12607960;;M;48;CHILENO;;X;ARICA                         ;ARICA Y PARINACOTA;0;0;0;0;0;0;0;0;0;IPHONE 8 64 GB LIB OPEN GRAY;TELEFONIA
15572601;;M;39;CHILENO;;X;PROVIDENCIA                   ;METROPOLITANA;0;0;0;0;0;0;0;0;0;CELULAR REDMI 9 32GB CARBON GREY OPEN;TELEFONIA
17006531;;M;34;CHILENO;;Millenial;"";"";0;0;0;0;0;0;0;0;0;Celular P40 LITE LIB OPEN GREEN;TELEFONIA
17212359;;M;32;CHILENO;;Millenial;CONSTITUCION                  ;MAULE;0;0;0;0;0;0;0;0;0;CELULAR A21s 128 GB Negro;TELEFONIA
14164298;;F;40;CHILENO;;X;PROVIDENCIA                   ;METROPOLITANA;0;0;0;0;0;0;0;0;0;IPHONE 8 64 GB LIB OPEN GRAY;TELEFONIA
6896034;;M;68;CHILENO;;Silencioso;LOS ALAMOS                    ;BIO BIO;0;0;0;0;0;0;0;0;0;Celular G8 POWER LITE MOVISTAR DIRECTO AZUL;TELEFONIA
7521573;;M;65;CHILENO;;Boomers;PROVIDENCIA                   ;METROPOLITANA;0;0;0;0;0;0;0;0;0;Celular A51 128GB LIB OPEN AZUL;TELEFONIA
17817709;Casado;F;30;CHILENO;;Silencioso;PROVIDENCIA                   ;METROPOLITANA;0;0;0;0;0;0;0;0;0;CELULAR NOKIA 225 4G BLACK TRI ENTEL;TELEFONIA
11696536;Soltero;M;50;CHILENO;CONTADOR GENERAL;Silencioso;PROVIDENCIA                   ;METROPOLITANA;0;0;0;0;0;0;0;0;0;CELULAR REDMI 9 32GB CARBON GREY OPEN;TELEFONIA
16131122;Soltero;F;36;CHILENO;;Millenial;PROVIDENCIA                   ;METROPOLITANA;0;0;0;0;0;0;0;0;0;Celular NOKIA 1.3 NEGRO WOM;TELEFONIA
5902522;Casado;F;74;CHILENO;;Silencioso;PROVIDENCIA                   ;METROPOLITANA;0;0;0;0;0;0;0;0;0;Celular A51 128GB LIB OPEN BLANCO;TELEFONIA
19416771;;F;25;CHILENO;;Z;PROVIDENCIA                   ;METROPOLITANA;0;0;0;0;0;0;0;0;0;Celular S20 FE LIB OPEN Cloud Navy;TELEFONIA
16888907;;M;33;CHILENO;;Millenial;PROVIDENCIA                   ;METROPOLITANA;0;0;0;0;0;0;0;0;0;Celular A51 128GB LIB OPEN AZUL;TELEFONIA
17818327;;F;31;CHILENO;;Millenial;SAN ESTEBAN                   ;VALPARAISO;0;0;0;0;0;0;0;0;0;CELULAR SAMSUNG A02S DIRECTO CLARO BLACK;TELEFONIA
15114113;;M;40;CHILENO;;X;SAN FERNANDO                  ;L.G.B.OÂ´HIGGINS;0;0;0;0;0;0;0;0;0;CELULAR SAMSUNG A01 NEGRO DIRECTO WOM;TELEFONIA
15239024;Soltero;F;38;CHILENO;;Millenial;PROVIDENCIA                   ;METROPOLITANA;0;0;0;0;0;0;0;0;0;CELULAR REDMI 9 64GB SUNSET PURPLE TRI WOM;TELEFONIA
16403511;;M;36;CHILENO;;Millenial;PROVIDENCIA                   ;METROPOLITANA;0;0;0;0;0;0;0;0;0;CELULAR A02s NEGRO 32GB OPEN;TELEFONIA
7274968;;M;67;CHILENO;;Boomers;CURANILAHUE                   ;BIO BIO;0;0;0;0;0;0;0;0;0;Celular S20 FE LIB OPEN Cloud Navy;TELEFONIA
16240718;;M;36;CHILENO;;Millenial;ANCUD                         ;LOS LAGOS;0;0;0;0;0;0;0;0;0;CELULAR REDMI NOTE 9 PRO 128GB GLACIER WHITE;TELEFONIA
18407199;;F;29;CHILENO;;Millenial;N/D;N/D;0;0;0;0;0;0;0;0;0;Celular A71 LIB OPEN PLATEADO;TELEFONIA
9929480;;F;59;CHILENO;;Boomers;VALDIVIA                      ;LOS RIOS;0;0;0;0;0;0;0;0;0;CELULAR MOTOROLA E6S GRIS 32GB DIRECTO WOM;TELEFONIA
19724753;;F;24;CHILENO;;Z;CABRERO;BIO-BIO;0;0;0;0;0;0;0;0;0;CELULAR A21s 128 GB AZUL;TELEFONIA
20006337;;F;23;CHILENO;;Z;N/D;N/D;0;0;0;0;0;0;0;0;0;Celular SAMSUNG A01 CORE AZUL ENTEL;TELEFONIA
19831120;;F;24;CHILENO;;Silencioso;PROVIDENCIA                   ;METROPOLITANA;0;0;0;0;0;0;0;0;0;Celular A11 LIB OPEN BLUE;TELEFONIA
5199460;;F;71;CHILENO;;Silencioso;RENCA                         ;METROPOLITANA;0;0;0;0;0;0;0;0;0;CELULAR A21s 128 GB AZUL;TELEFONIA
15580286;Soltero;F;38;CHILENO;;X;NATALES                       ;MAGALLANES;0;0;0;0;0;0;0;0;0;CELULAR A21s 128 GB AZUL;TELEFONIA
13909783;;M;41;CHILENO;;X;PROVIDENCIA                   ;METROPOLITANA;0;0;0;0;0;0;0;0;0;CELULAR A21s 128 GB Rojo;TELEFONIA
18914794;;F;27;CHILENO;;Millenial;PROVIDENCIA                   ;METROPOLITANA;0;0;0;0;0;0;0;0;0;CELULAR A21s 128 GB Rojo;TELEFONIA
19647949;;M;25;CHILENO;;Z;MAIPU                         ;METROPOLITANA;0;0;0;0;0;0;0;0;0;CELULAR A12 128GB NEGRO OPEN;TELEFONIA
10303993;;M;56;CHILENO;;Boomers;CALERA                        ;VALPARAISO;0;0;0;0;0;0;0;0;0;Celular A11 LIB OPEN WHITE;TELEFONIA
10608193;;F;52;CHILENO;;X;RENCA                         ;METROPOLITANA;0;0;0;0;0;0;0;0;0;CELULAR OWN 1026 AZUL ENTEL;TELEFONIA
18373148;Soltero;M;28;CHILENO;INGENIERIA EN ADMINISTRACION DE EMPRESAS MENCION FINANZAS;Silencioso;PROVIDENCIA                   ;METROPOLITANA;0;0;0;0;0;0;0;0;0;Celular SAMSUNG A01 CORE BLACK CLARO;TELEFONIA
16312913;;M;35;CHILENO;;Millenial;PROVIDENCIA                   ;METROPOLITANA;0;0;0;0;0;0;0;0;0;CELULAR POCO M3 64GB POWER BLACK;TELEFONIA
14379289;;M;43;CHILENO;;X;PROVIDENCIA                   ;METROPOLITANA;0;0;0;0;0;0;0;0;0;CELULAR MOTO E6I 32GB GRIS OPEN;TELEFONIA
13536266;;F;43;CHILENO;;X;OVALLE                        ;COQUIMBO;0;0;0;0;0;0;0;0;0;Celular A11 LIB OPEN WHITE;TELEFONIA
18874775;;F;27;CHILENO;;Millenial;PANGUIPULLI                   ;LOS LAGOS;0;0;0;0;0;0;0;0;0;CELULAR A02 ROJO 32GB OPEN;TELEFONIA
6633626;;M;70;CHILENO;;Silencioso;VICTORIA                      ;ARAUCANIA;0;0;0;0;0;0;0;0;0;Celular A51 128GB LIB OPEN AZUL;TELEFONIA
14407921;;F;52;CHILENO;;X;TALCA                         ;MAULE;0;0;0;0;0;0;0;0;0;CELULAR REDMI NOTE 8 64GB SPACE BLACK OPEN;TELEFONIA
18954124;Soltero;M;27;CHILENO;CIRUJANO DENTISTA;Silencioso;PROVIDENCIA                   ;METROPOLITANA;0;0;0;0;0;0;0;0;0;Celular A10S LIB OPEN RED;TELEFONIA
18732246;;F;27;CHILENO;;Silencioso;PROVIDENCIA                   ;METROPOLITANA;0;0;0;0;0;0;0;0;0;Celular Galaxy S21 Plus Phantom Violet 128GB;TELEFONIA
19430049;;F;25;CHILENO;;Z;PROVIDENCIA                   ;METROPOLITANA;0;0;0;0;0;0;0;0;0;Celular A51 128GB LIB OPEN BLACK;TELEFONIA
19422083;Soltero;M;25;CHILENO;;Millenial;N/D;N/D;0;0;0;0;0;0;0;0;0;Celular Y7P LIB OPEN NEGRO;TELEFONIA
14388228;;F;44;CHILENO;;X;RENCA                         ;METROPOLITANA;0;0;0;0;0;0;0;0;0;Celular A71 LIB OPEN NEGRO;TELEFONIA
26270963;;F;34;VENEZOLANO;;Extranjero;RANCAGUA                      ;L.G.B.OÂ´HIGGINS;0;0;0;0;0;0;0;0;0;Celular A71 LIB OPEN PLATEADO;TELEFONIA
14924257;;F;41;CHILENO;;Extranjero;PUENTE ALTO                   ;METROPOLITANA;0;0;0;0;0;0;0;0;0;CELULAR OWN 1026 AZUL ENTEL;TELEFONIA
19149290;;F;26;CHILENO;;Z;PAINE                         ;METROPOLITANA;0;0;0;0;0;0;0;0;0;CELULAR MOTO G8 POWER LITE TURQUESA TRI ENTEL;TELEFONIA
6838475;Divorciado;M;69;CHILENO;;Silencioso;PROVIDENCIA                   ;METROPOLITANA;0;0;0;0;0;0;0;0;0;Celular AL3 CLARO DIRECTO NEGRO;TELEFONIA
13113052;Soltero;F;47;CHILENO;;X;PROVIDENCIA                   ;METROPOLITANA;0;0;0;0;0;0;0;0;0;CELULAR LG K61 Gris OPEN;TELEFONIA
15758442;;F;38;CHILENO;;Millenial;PROVIDENCIA                   ;METROPOLITANA;0;0;0;0;0;0;0;0;0;CELULAR LG K22 TRIANGULADO WOM;TELEFONIA
16560411;;M;35;CHILENO;;Millenial;COPIAPO                       ;ATACAMA;0;0;0;0;0;0;0;0;0;Celular A31 LIB OPEN ROJO;TELEFONIA
10017432;;M;57;CHILENO;;Boomers;RENCA                         ;METROPOLITANA;0;0;0;0;0;0;0;0;0;Celular A31 LIB OPEN BLACK;TELEFONIA
13043428;;M;46;CHILENO;;Silencioso;PROVIDENCIA                   ;METROPOLITANA;0;0;0;0;0;0;0;0;0;Celular S20 FE LIB OPEN Cloud Lavender;TELEFONIA
9647637;;F;56;CHILENO;;Boomers;CALDERA                       ;ATACAMA;0;0;0;0;0;0;0;0;0;Celular A51 128GB LIB OPEN BLACK;TELEFONIA
9136203;;F;60;CHILENO;;Boomers;N/D;N/D;0;0;0;0;0;0;0;0;0;CELULAR XIAOMI POCO X3 64G COBALT BLUE;TELEFONIA
11983440;;F;50;CHILENO;;X;CONSTITUCION                  ;MAULE;0;0;0;0;0;0;0;0;0;CELULAR A02s AZUL 32GB OPEN;TELEFONIA
9432169;Soltero;M;58;CHILENO;;Boomers;RENCA                         ;METROPOLITANA;0;0;0;0;0;0;0;0;0;CELULAR VIVO Y11S PHANTOM BLACK OPEN;TELEFONIA
12625313;;M;48;CHILENO;;X;CHONCHI                       ;LOS LAGOS;0;0;0;0;0;0;0;0;0;CELULAR MOTO G8 POWER LITE TURQUESA TRI ENTEL;TELEFONIA
13087726;;M;46;CHILENO;;X;COLINA                        ;METROPOLITANA;0;0;0;0;0;0;0;0;0;Celular A31 LIB OPEN BLACK;TELEFONIA
13094953;Divorciado;M;45;CHILENO;KINESIOLOGO;X;PROVIDENCIA                   ;METROPOLITANA;0;0;0;0;0;0;0;0;0;Celular XIAOMI REDMI 9C 64 GB DIRECTO CLARO;TELEFONIA
18500343;Soltero;M;29;CHILENO;;Millenial;PROVIDENCIA                   ;METROPOLITANA;0;0;0;0;0;0;0;0;0;CELULAR XIAOMI POCO X3 64G SHADOW GRAY;TELEFONIA
16986044;;M;34;CHILENO;;Millenial;PROVIDENCIA                   ;METROPOLITANA;0;0;0;0;0;0;0;0;0;Celular Galaxy S21 Ultra Phantom Black 128GB;TELEFONIA
18408160;;F;29;CHILENO;;Millenial;LAMPA                         ;METROPOLITANA;0;0;0;0;0;0;0;0;0;CELULAR REDMI NOTE 9 128GB ONYX BLACK OPEN;TELEFONIA
16424216;;M;35;CHILENO;;Silencioso;PROVIDENCIA                   ;METROPOLITANA;0;0;0;0;0;0;0;0;0;Celular P30 LITE PLUS LIB OPEN BLACK;TELEFONIA
17642726;;F;31;CHILENO;;Millenial;N/D;N/D;0;0;0;0;0;0;0;0;0;Celular R340 CLARO DIRECTO NEGRO;TELEFONIA
18429116;;F;29;CHILENO;;Millenial;CHILLAN                       ;BIO BIO;0;0;0;0;0;0;0;0;0;CELULAR XIAOMI MI 10T 128GB COSMIC BLACK OPEN;TELEFONIA
17437946;Casado;F;32;CHILENO;;Millenial;PROVIDENCIA                   ;METROPOLITANA;0;0;0;0;0;0;0;0;0;Celular S20 FE LIB OPEN Cloud Navy;TELEFONIA
17745598;;M;31;CHILENO;;Millenial;N/D;N/D;0;0;0;0;0;0;0;0;0;CELULAR XIAOMI POCO X3 64G SHADOW GRAY;TELEFONIA
16255514;;F;36;CHILENO;;Millenial;N/D;N/D;0;0;0;0;0;0;0;0;0;CELULAR A12 128GB NEGRO OPEN;TELEFONIA
7481921;;F;64;CHILENO;;Boomers;LAS CABRAS                    ;L.G.B.OÂ´HIGGINS;0;0;0;0;0;0;0;0;0;Celular SA3 CLARO DIRECTO BLACK;TELEFONIA
14346048;;F;44;CHILENO;;Millenial;N/D;N/D;0;0;0;0;0;0;0;0;0;Celular A10S LIB OPEN NEGRO;TELEFONIA
7983243;;F;65;CHILENO;;Boomers;RECOLETA                      ;METROPOLITANA;0;0;0;0;0;0;0;0;0;CELULAR A02s AZUL 32GB OPEN;TELEFONIA
18855757;;M;26;CHILENO;;Z;PROVIDENCIA                   ;METROPOLITANA;0;0;0;0;0;0;0;0;0;CELULAR HUAWEI Y6P BLACK TEL;TELEFONIA
10109055;;F;49;CHILENO;;X;CAUQUENES                     ;MAULE;0;0;0;0;0;0;0;0;0;CELULAR A12 128GB AZUL OPEN;TELEFONIA
10870344;;F;56;CHILENO;;Boomers;PICHILEMU                     ;L.G.B.OÂ´HIGGINS;0;0;0;0;0;0;0;0;0;CELULAR NOKIA 5.3 CHARCOAL TRI ENTEL;TELEFONIA
19221264;Soltero;F;26;CHILENO;TECNICO DE NIVEL SUPERIOR EN PODOLOGIA CLINICA;Silencioso;PROVIDENCIA                   ;METROPOLITANA;0;0;0;0;0;0;0;0;0;CELULAR HUAWEI Y9 PRIME BLUE OPEN;TELEFONIA
10409662;;F;56;CHILENO;;Boomers;RENCA                         ;METROPOLITANA;0;0;0;0;0;0;0;0;0;Celular ZTE A3 2020 WOM DIRECTO NEGRO;TELEFONIA
19033724;Soltero;M;27;CHILENO;;Z;PROVIDENCIA                   ;METROPOLITANA;0;0;0;0;0;0;0;0;0;CELULAR NOKIA 225 4G BLACK TRI ENTEL;TELEFONIA
17701297;;M;31;CHILENO;;Silencioso;PROVIDENCIA                   ;METROPOLITANA;0;0;0;0;0;0;0;0;0;CELULAR Xiaomi Redmi Note 9 128GB Blanco WOM;TELEFONIA
6777470;Soltero;M;71;CHILENO;;Silencioso;RENCA                         ;METROPOLITANA;0;0;0;0;0;0;0;0;0;Celular R340 CLARO DIRECTO NEGRO;TELEFONIA
16527912;;F;36;CHILENO;;Millenial;ANGOL                         ;ARAUCANIA;0;0;0;0;0;0;0;0;0;CELULAR HUAWEI Y9 PRIME BLUE OPEN;TELEFONIA
16900997;;F;34;CHILENO;;Millenial;SAN BERNARDO                  ;METROPOLITANA;0;0;0;0;0;0;0;0;0;Celular A51 128GB LIB OPEN BLACK;TELEFONIA
9039007;;F;61;CHILENO;;Boomers;RENCA                         ;METROPOLITANA;0;0;0;0;0;0;0;0;0;Celular A01 CLARO DIRECTO BLACK;TELEFONIA
16569990;;M;35;CHILENO;;Millenial;RENGO                         ;L.G.B.OÂ´HIGGINS;0;0;0;0;0;0;0;0;0;CELULAR POCO M3 64GB POWER BLACK;TELEFONIA
14574196;;F;48;CHILENO;;X;PROVIDENCIA                   ;METROPOLITANA;0;0;0;0;0;0;0;0;0;Celular SAMSUNG A01 CORE BLACK CLARO;TELEFONIA
9563830;Casado;M;59;CHILENO;;Silencioso;PROVIDENCIA                   ;METROPOLITANA;0;0;0;0;0;0;0;0;0;Celular LG K22 MOVISTAR DIRECTO TITAN;TELEFONIA
17364067;;M;32;CHILENO;;Millenial;OVALLE                        ;COQUIMBO;0;0;0;0;0;0;0;0;0;Celular G8 POWER LITE MOVISTAR DIRECTO AZUL;TELEFONIA
19501524;;F;24;CHILENO;;Z;PROVIDENCIA                   ;METROPOLITANA;0;0;0;0;0;0;0;0;0;Celular A11 LIB OPEN BLUE;TELEFONIA
12929087;;F;47;CHILENO;;Silencioso;PROVIDENCIA                   ;METROPOLITANA;0;0;0;0;0;0;0;0;0;Celular A51 128GB LIB OPEN BLANCO;TELEFONIA
10179045;;F;59;CHILENO;;Boomers;OVALLE                        ;COQUIMBO;0;0;0;0;0;0;0;0;0;Celular LG K22 ENTEL DIRECTO TITAN;TELEFONIA
9059489;Divorciado;M;60;CHILENO;;Boomers;RENCA                         ;METROPOLITANA;0;0;0;0;0;0;0;0;0;CELULAR MOTOROLA G8 POWER LITE AZUL WOM;TELEFONIA
10747043;;F;50;CHILENO;;X;SAN FERNANDO                  ;L.G.B.OÂ´HIGGINS;0;0;0;0;0;0;0;0;0;Celular SAMSUNG A11 32GB ENTEL DIRECTO NEGRO;TELEFONIA
19255968;;M;25;CHILENO;;Z;N/D;N/D;0;0;0;0;0;0;0;0;0;Celular A31 LIB OPEN ROJO;TELEFONIA
18427420;Soltero;F;29;CHILENO;INGENIERO EN CONSTRUCCION;Silencioso;PROVIDENCIA                   ;METROPOLITANA;0;0;0;0;0;0;0;0;0;Celular Galaxy S21 Phantom Grey 128GB;TELEFONIA
6984262;Viudo;F;71;CHILENO;;Silencioso;PROVIDENCIA                   ;METROPOLITANA;0;0;0;0;0;0;0;0;0;CELULAR REDMI NOTE 9 128GB ONYX BLACK OPEN;TELEFONIA
7557248;Casado;F;68;CHILENO;;Silencioso;PELLUHUE                      ;MAULE;0;0;0;0;0;0;0;0;0;CELULAR LG K22 TRIANGULADO WOM;TELEFONIA
15150765;;F;40;CHILENO;;X;N/D;N/D;0;0;0;0;0;0;0;0;0;CELULAR POCO M3 64GB COOL BLUE;TELEFONIA
13836107;;F;42;CHILENO;;X;RENCA                         ;METROPOLITANA;0;0;0;0;0;0;0;0;0;CELULAR VIVO Y11S PHANTOM BLACK OPEN;TELEFONIA
16917871;;F;34;CHILENO;;Millenial;RENCA                         ;METROPOLITANA;0;0;0;0;0;0;0;0;0;CELULAR SAMSUNG A01 CORE BLACK WOM;TELEFONIA
9490852;;M;60;CHILENO;;Boomers;PROVIDENCIA                   ;METROPOLITANA;0;0;0;0;0;0;0;0;0;Celular A31 LIB OPEN BLACK;TELEFONIA
17973172;Soltero;M;30;CHILENO;;Millenial;PROVIDENCIA                   ;METROPOLITANA;0;0;0;0;0;0;0;0;0;CELULAR MOTO E6S 32GB GRIS DIRECTO ENTEL;TELEFONIA
13580483;;F;42;CHILENO;;X;RENAICO                       ;ARAUCANIA;0;0;0;0;0;0;0;0;0;Celular Y8P ENTEL TRIANGULADO NEGRO;TELEFONIA
12598481;Soltero;F;57;CHILENO;;Boomers;RENCA                         ;METROPOLITANA;0;0;0;0;0;0;0;0;0;CELULAR A02s NEGRO 32GB OPEN;TELEFONIA
16690890;;M;34;CHILENO;;Silencioso;PROVIDENCIA                   ;METROPOLITANA;0;0;0;0;0;0;0;0;0;CELULAR REDMI NOTE 8 64GB NEPTUNE BLUE OPEN;TELEFONIA
8843149;;M;63;CHILENO;;Boomers;ALTO HOSPICIO;TARAPACA;0;0;0;0;0;0;0;0;0;Celular A30S ENTEL TRIANGULADO NEGRO;TELEFONIA
6103266;;M;73;CHILENO;;Silencioso;ANGOL                         ;ARAUCANIA;0;0;0;0;0;0;0;0;0;CELULAR NOKIA 110 BLACK OPEN;TELEFONIA
17145825;Casado;F;33;CHILENO;TECNICO DE NIVEL SUPERIOR EN ENFERMERIA;Millenial;RENCA                         ;METROPOLITANA;0;0;0;0;0;0;0;0;0;CELULAR NOKIA 110 BLACK OPEN;TELEFONIA
17750023;;M;31;CHILENO;;Millenial;N/D;N/D;0;0;0;0;0;0;0;0;0;CELULAR REDMI 9 64GB SUNSET PURPLE TRI WOM;TELEFONIA
19867960;;F;24;CHILENO;;Z;PROVIDENCIA                   ;METROPOLITANA;0;0;0;0;0;0;0;0;0;Celular A10S LIB OPEN RED;TELEFONIA
12491650;;F;49;CHILENO;;X;CARTAGENA                     ;VALPARAISO;0;0;0;0;0;0;0;0;0;Celular Galaxy S21 Plus Phantom Violet 128GB;TELEFONIA
5327650;;F;73;CHILENO;;Silencioso;RENCA                         ;METROPOLITANA;0;0;0;0;0;0;0;0;0;Celular A10S MOVISTAR DIRECTO BLACK;TELEFONIA
19899020;;F;24;CHILENO;;Z;PROVIDENCIA                   ;METROPOLITANA;0;0;0;0;0;0;0;0;0;IPHONE 8 64 GB LIB OPEN GRAY;TELEFONIA
18007867;;F;30;CHILENO;;Millenial;ANGOL                         ;ARAUCANIA;0;0;0;0;0;0;0;0;0;CELULAR SAMSUNG A71 AZUL OPEN;TELEFONIA
11858311;;M;50;CHILENO;;X;PROVIDENCIA                   ;METROPOLITANA;0;0;0;0;0;0;0;0;0;Celular A01 CLARO DIRECTO BLACK;TELEFONIA
15609019;Soltero;M;38;CHILENO;;Millenial;PROVIDENCIA                   ;METROPOLITANA;0;0;0;0;0;0;0;0;0;TELEFONO PP BINDU ENTEL;TELEFONIA
20463156;;F;21;CHILENO;;Z;PROVIDENCIA                   ;METROPOLITANA;0;0;0;0;0;0;0;0;0;CELULAR HUAWEI Y9S BLACK DIRECTO CLARO;TELEFONIA
12373444;;F;49;CHILENO;;X;RENCA                         ;METROPOLITANA;0;0;0;0;0;0;0;0;0;Celular A51 128GB LIB OPEN BLACK;TELEFONIA
15689975;;F;39;CHILENO;;X;RENCA                         ;METROPOLITANA;0;0;0;0;0;0;0;0;0;Celular A10S LIB OPEN RED;TELEFONIA
11424328;;F;53;CHILENO;;X;VILLARICA                     ;ARAUCANIA;0;0;0;0;0;0;0;0;0;CELULAR A11 CLARO DIRECTO BLACK;TELEFONIA
19267201;;F;25;CHILENO;;Z;PROVIDENCIA                   ;METROPOLITANA;0;0;0;0;0;0;0;0;0;CELULAR SAMSUNG A21S AZUL OPEN;TELEFONIA
11447360;;M;53;CHILENO;;Silencioso;PROVIDENCIA                   ;METROPOLITANA;0;0;0;0;0;0;0;0;0;CELULAR XIAOMI REDMI 9C 64GB TIWLIGHT BLUE TRI M;TELEFONIA
8897394;;M;62;CHILENO;;Boomers;SAN VICENTE                   ;L.G.B.OÂ´HIGGINS;0;0;0;0;0;0;0;0;0;Celular A01 Core Azul Tri Entel;TELEFONIA
18705124;;F;28;CHILENO;;Millenial;LOS VILOS                     ;COQUIMBO;0;0;0;0;0;0;0;0;0;Celular SA3 CLARO DIRECTO BLACK;TELEFONIA
18509324;Soltero;F;29;CHILENO;TECNICO DE NIVEL SUPERIOR EN ENFERMERIA;Millenial;PROVIDENCIA                   ;METROPOLITANA;0;0;0;0;0;0;0;0;0;Celular A01 LIB OPEN ROJO;TELEFONIA
12228078;Casado;F;50;CHILENO;;X;RENCA                         ;METROPOLITANA;0;0;0;0;0;0;0;0;0;CELULAR LG K41S TITAN DIRECTO MOVISTAR;TELEFONIA
18726758;;F;28;CHILENO;;Millenial;PROVIDENCIA                   ;METROPOLITANA;0;0;0;0;0;0;0;0;0;CELULAR MOTOROLA G9 PLAY 64GB ELECTRIC BLUE OPEN;TELEFONIA
23417798;;M;61;COLOMBIANO;;Extranjero;QUILICURA                     ;METROPOLITANA;0;0;0;0;0;0;0;0;0;Celular SAMSUNG A21s CLARO DIRECTO BLACK;TELEFONIA
18140363;;F;30;CHILENO;;Millenial;COPIAPO                       ;ATACAMA;0;0;0;0;0;0;0;0;0;IPHONE 11 64 GB ROJO ENTEL;TELEFONIA
12733000;;F;52;CHILENO;;X;PROVIDENCIA                   ;METROPOLITANA;0;0;0;0;0;0;0;0;0;Celular A01 LIB OPEN AZUL;TELEFONIA
13919557;;F;41;CHILENO;;X;MAIPU                         ;METROPOLITANA;0;0;0;0;0;0;0;0;0;CELULAR REDMI NOTE 8 64GB SPACE BLACK OPEN;TELEFONIA
11094229;;F;56;CHILENO;;Boomers;COLLIPULLI                    ;ARAUCANIA;0;0;0;0;0;0;0;0;0;Celular A01 Core Azul Tri Entel;TELEFONIA
5416302;;F;78;CHILENO;;Silencioso;RENCA                         ;METROPOLITANA;0;0;0;0;0;0;0;0;0;CELULAR NOKIA 225 4G BLACK TRI ENTEL;TELEFONIA
26721235;;F;42;EXTRANJERO - NO INFORMA NACIONALIDAD;;Extranjero;EL BOSQUE                     ;METROPOLITANA;0;0;0;0;0;0;0;0;0;CELULAR REDMI NOTE 8 64GB NEPTUNE BLUE OPEN;TELEFONIA
11437412;;M;53;CHILENO;;X;RENCA                         ;METROPOLITANA;0;0;0;0;0;0;0;0;0;CELULAR MOTOROLA E6S GRIS 32GB DIRECTO WOM;TELEFONIA
18756586;;F;28;CHILENO;;Silencioso;PROVIDENCIA                   ;METROPOLITANA;0;0;0;0;0;0;0;0;0;Celular Galaxy S21 Plus Phantom Silver 128GB;TELEFONIA
12815583;;F;47;CHILENO;;X;CALERA                        ;VALPARAISO;0;0;0;0;0;0;0;0;0;Celular ZTE A3 2020 ENTEL DIRECTO GRIS;TELEFONIA
12990025;;F;45;CHILENO;;X;PROVIDENCIA                   ;METROPOLITANA;0;0;0;0;0;0;0;0;0;CELULAR MOTOROLA G9 PLAY 64GB ELECTRIC BLUE OPEN;TELEFONIA
19042093;Soltero;M;26;CHILENO;;Silencioso;PROVIDENCIA                   ;METROPOLITANA;0;0;0;0;0;0;0;0;0;CELULAR NOKIA 3310 CHARCOAL TRI WOM;TELEFONIA
12804533;;M;46;CHILENO;;X;PROVIDENCIA                   ;METROPOLITANA;0;0;0;0;0;0;0;0;0;CELULAR SAMSUNG A71 AZUL OPEN;TELEFONIA
19313630;;M;26;CHILENO;;Z;RENCA                         ;METROPOLITANA;0;0;0;0;0;0;0;0;0;CELULAR REDMI NOTE 8 64GB NEPTUNE BLUE OPEN;TELEFONIA
16155721;;M;36;CHILENO;;Silencioso;PROVIDENCIA                   ;METROPOLITANA;0;0;0;0;0;0;0;0;0;Celular P30 LITE PLUS LIB OPEN BLACK;TELEFONIA
17301221;;M;32;CHILENO;;Millenial;SAN FELIPE                    ;VALPARAISO;0;0;0;0;0;0;0;0;0;CELULAR SAMSUNG A71 AZUL OPEN;TELEFONIA
8301922;;M;64;CHILENO;;Boomers;PROVIDENCIA                   ;METROPOLITANA;0;0;0;0;0;0;0;0;0;Celular XIAOMI REDMI 9A 32 GB DIRECTO CLARO;TELEFONIA
16233006;;M;36;CHILENO;;Millenial;SAN FELIPE                    ;VALPARAISO;0;0;0;0;0;0;0;0;0;CELULAR LG K41S TITAN DIRECTO MOVISTAR;TELEFONIA
9319160;Casado;F;60;CHILENO;;Silencioso;PROVIDENCIA                   ;METROPOLITANA;0;0;0;0;0;0;0;0;0;CELULAR XIAOMI MI 10T 128GB COSMIC BLACK OPEN;TELEFONIA
8193976;;F;65;CHILENO;;Silencioso;PROVIDENCIA                   ;METROPOLITANA;0;0;0;0;0;0;0;0;0;Celular R340 CLARO DIRECTO NEGRO;TELEFONIA
18478543;;F;29;CHILENO;;Millenial;LA FLORIDA                    ;METROPOLITANA;0;0;0;0;0;0;0;0;0;Celular AL3 CLARO DIRECTO NEGRO;TELEFONIA
11863008;Soltero;M;54;CHILENO;AGROINDUSTRIA;Boomers;RENCA                         ;METROPOLITANA;0;0;0;0;0;0;0;0;0;CELULAR NOKIA 110 BLACK OPEN;TELEFONIA
16325524;;F;36;CHILENO;;Millenial;PROVIDENCIA                   ;METROPOLITANA;0;0;0;0;0;0;0;0;0;Celular A10S LIB OPEN NEGRO;TELEFONIA
9262414;;M;60;CHILENO;;Boomers;VALPARAISO                    ;VALPARAISO;0;0;0;0;0;0;0;0;0;CELULAR NOKIA 110 BLACK OPEN;TELEFONIA
19351732;;F;25;CHILENO;;Z;N/D;N/D;0;0;0;0;0;0;0;0;0;Celular Y8P ENTEL TRIANGULADO NEGRO;TELEFONIA
7272604;;F;70;CHILENO;;Silencioso;LA PINTANA                    ;METROPOLITANA;0;0;0;0;0;0;0;0;0;Celular A31 LIB OPEN AZUL;TELEFONIA
9290517;;M;60;CHILENO;;Boomers;LOS ANGELES                   ;BIO BIO;0;0;0;0;0;0;0;0;0;Celular A10S LIB OPEN RED;TELEFONIA
7671010;Viudo;F;68;CHILENO;;Boomers;TEMUCO                        ;ARAUCANIA;0;0;0;0;0;0;0;0;0;Celular A01 LIB OPEN ROJO;TELEFONIA
6898709;Casado;M;68;CHILENO;;Silencioso;PROVIDENCIA                   ;METROPOLITANA;0;0;0;0;0;0;0;0;0;Celular XIAOMI REDMI 9A 32 GB DIRECTO CLARO;TELEFONIA
18297279;Soltero;F;29;CHILENO;PROFESOR;Millenial;VILLA ALEMANA                 ;VALPARAISO;0;0;0;0;0;0;0;0;0;Celular SAMSUNG A01 CORE BLACK CLARO;TELEFONIA
17970284;;M;30;CHILENO;;Millenial;YUMBEL                        ;BIO BIO;0;0;0;0;0;0;0;0;0;Celular P40 LITE LIB OPEN GREEN;TELEFONIA
13203378;;F;45;CHILENO;;X;RENCA                         ;METROPOLITANA;0;0;0;0;0;0;0;0;0;Celular R340 CLARO DIRECTO NEGRO;TELEFONIA
15475458;;M;39;CHILENO;;X;PROVIDENCIA                   ;METROPOLITANA;0;0;0;0;0;0;0;0;0;Celular Galaxy S21 Phantom Grey 128GB;TELEFONIA
5590334;;M;76;CHILENO;;Silencioso;RENCA                         ;METROPOLITANA;0;0;0;0;0;0;0;0;0;CELULAR NOKIA 110 BLACK OPEN;TELEFONIA
17751213;;F;31;CHILENO;;Millenial;NANCAGUA                      ;L.G.B.OÂ´HIGGINS;0;0;0;0;0;0;0;0;0;Celular LG K22 ENTEL DIRECTO TITAN;TELEFONIA
17153879;;F;32;CHILENO;;Millenial;VALDIVIA;LOS LAGOS;0;0;0;0;0;0;0;0;0;IPHONE 5S 16GB DORADO OPEN;TELEFONIA
18683807;;F;29;CHILENO;;Millenial;PROVIDENCIA                   ;METROPOLITANA;0;0;0;0;0;0;0;0;0;CELULAR Y8S MOVISTAR DIRECTO BLACK;TELEFONIA
16867010;;F;34;CHILENO;;Millenial;PROVIDENCIA                   ;METROPOLITANA;0;0;0;0;0;0;0;0;0;CELULAR OWN 1026 AZUL ENTEL;TELEFONIA
8474047;;M;64;CHILENO;;Boomers;RENCA                         ;METROPOLITANA;0;0;0;0;0;0;0;0;0;Celular 2.3 MOVISTAR DIRECTO CHARCOAL;TELEFONIA
10580897;;M;51;CHILENO;;X;SAN BERNARDO                  ;METROPOLITANA;0;0;0;0;0;0;0;0;0;CELULAR LG K22 TRIANGULADO WOM;TELEFONIA
12080953;;F;42;CHILENO;;X;"";"";0;0;0;0;0;0;0;0;0;Celular A51 128GB LIB OPEN BLACK;TELEFONIA
13536572;Soltero;M;42;CHILENO;;X;PROVIDENCIA                   ;METROPOLITANA;0;0;0;0;0;0;0;0;0;Celular A11 LIB OPEN BLUE;TELEFONIA
11176784;;M;55;CHILENO;;Boomers;SAN RAMON                     ;METROPOLITANA;0;0;0;0;0;0;0;0;0;CELULAR SAMSUNG A01 NEGRO DIRECTO WOM;TELEFONIA
11653038;Casado;F;52;CHILENO;;X;RENCA                         ;METROPOLITANA;0;0;0;0;0;0;0;0;0;Celular A11 LIB OPEN BLUE;TELEFONIA
5007049;;M;77;CHILENO;;Silencioso;PENAFLOR                      ;METROPOLITANA;0;0;0;0;0;0;0;0;0;Celular A11 LIB OPEN BLUE;TELEFONIA
12317986;;F;48;CHILENO;;X;N/D;N/D;0;0;0;0;0;0;0;0;0;Celular A51 128GB LIB OPEN BLACK;TELEFONIA
17213694;;F;32;CHILENO;;Millenial;QUILPUE                       ;VALPARAISO;0;0;0;0;0;0;0;0;0;Celular A10S LIB OPEN RED;TELEFONIA
8325869;Casado;F;64;CHILENO;;Boomers;PROVIDENCIA                   ;METROPOLITANA;0;0;0;0;0;0;0;0;0;CELULAR OWN 1026 AZUL ENTEL;TELEFONIA
13971018;;M;43;CHILENO;;X;RENCA                         ;METROPOLITANA;0;0;0;0;0;0;0;0;0;CELULAR REDMI NOTE 8 64GB SPACE BLACK OPEN;TELEFONIA
11856514;;F;51;CHILENO;;X;RENCA                         ;METROPOLITANA;0;0;0;0;0;0;0;0;0;Celular a11 azul samsung WOM;TELEFONIA
13582690;Soltero;F;43;CHILENO;;X;RENCA                         ;METROPOLITANA;0;0;0;0;0;0;0;0;0;Celular A11 LIB OPEN BLUE;TELEFONIA
12803381;;M;46;CHILENO;;Millenial;PROVIDENCIA                   ;METROPOLITANA;0;0;0;0;0;0;0;0;0;Celular A51 128GB LIB OPEN BLACK;TELEFONIA
18156116;;M;29;CHILENO;;Millenial;QUINTA NORMAL                 ;METROPOLITANA;0;0;0;0;0;0;0;0;0;Celular P40 LITE LIB OPEN BLACK;TELEFONIA
4209345;;M;83;CHILENO;;Silencioso;RENCA                         ;METROPOLITANA;0;0;0;0;0;0;0;0;0;CELULAR HUAWEI Y9S BLACK DIRECTO CLARO;TELEFONIA
7534078;Casado;M;62;CHILENO;;Boomers;RENCA                         ;METROPOLITANA;0;0;0;0;0;0;0;0;0;CELULAR MOTO G8 POWER LITE AZUL TRI ENTEL;TELEFONIA
15592740;;M;38;CHILENO;;X;CONCEPCION                    ;BIO BIO;0;0;0;0;0;0;0;0;0;TELEFONO PP BINDU ENTEL;TELEFONIA
8901553;;M;61;CHILENO;;Boomers;SAN FELIPE                    ;VALPARAISO;0;0;0;0;0;0;0;0;0;Celular MOTO G8 POWER LITE TURQUESA OPEN;TELEFONIA
24729240;;M;46;BOLIVIANO;;Extranjero;CALAMA                        ;ANTOFAGASTA;0;0;0;0;0;0;0;0;0;Celular XIAOMI REDMI 9C 64 GB DIRECTO CLARO;TELEFONIA
13202803;;M;45;CHILENO;;X;PROVIDENCIA                   ;METROPOLITANA;0;0;0;0;0;0;0;0;0;CELULAR HUAWEI Y5P BLUE TRIANGULADO WOM;TELEFONIA
6611483;;M;69;CHILENO;;Silencioso;PUENTE ALTO                   ;METROPOLITANA;0;0;0;0;0;0;0;0;0;CELULAR MOTO G8 POWER LITE BUNDLE + ARO DE LUZ;TELEFONIA
9633848;;M;59;CHILENO;;Boomers;PROVIDENCIA                   ;METROPOLITANA;0;0;0;0;0;0;0;0;0;CELULAR MOTO ONE FUSION 64GB VERDE 64GB OPEN;TELEFONIA
8347287;;M;62;CHILENO;;Silencioso;PROVIDENCIA                   ;METROPOLITANA;0;0;0;0;0;0;0;0;0;CELULAR XIAOMI REDMI 9C AZUL DIRECTO ENTEL;TELEFONIA
17968766;;F;30;CHILENO;;Millenial;PROVIDENCIA                   ;METROPOLITANA;0;0;0;0;0;0;0;0;0;Celular G8 POWER LITE MOVISTAR DIRECTO AZUL;TELEFONIA
17937740;;F;30;CHILENO;;Millenial;VALLENAR;ATACAMA;0;0;0;0;0;0;0;0;0;Celular A20S LIB OPEN ROJO;TELEFONIA
7218186;;M;68;CHILENO;;Silencioso;ANTOFAGASTA                   ;ANTOFAGASTA;0;0;0;0;0;0;0;0;0;Celular E6S MOVISTAR DIRECTO AZUL;TELEFONIA
14358135;;F;42;CHILENO;;X;"";"";0;0;0;0;0;0;0;0;0;Celular Y7P LIB OPEN AZUL;TELEFONIA
10242315;;F;57;CHILENO;;Boomers;NOGALES                       ;VALPARAISO;0;0;0;0;0;0;0;0;0;Celular Y7P LIB OPEN NEGRO;TELEFONIA
9319362;;M;64;CHILENO;;Boomers;RANCAGUA                      ;L.G.B.OÂ´HIGGINS;0;0;0;0;0;0;0;0;0;Celular A11 LIB OPEN BLACK;TELEFONIA
10266123;;F;58;CHILENO;;Boomers;PROVIDENCIA                   ;METROPOLITANA;0;0;0;0;0;0;0;0;0;CELULAR MOTO G8 POWER LITE TURQUESA TRI ENTEL;TELEFONIA
9505330;;M;55;CHILENO;;Boomers;RENCA                         ;METROPOLITANA;0;0;0;0;0;0;0;0;0;Celular A51 128GB LIB OPEN AZUL;TELEFONIA
13780073;;F;42;CHILENO;;X;PROVIDENCIA                   ;METROPOLITANA;0;0;0;0;0;0;0;0;0;CELULAR G8 POWER MOTO TRI ENTEL;TELEFONIA
20178636;;F;23;CHILENO;;Z;PROVIDENCIA                   ;METROPOLITANA;0;0;0;0;0;0;0;0;0;IPHONE 11 64 GB ROJO ENTEL;TELEFONIA
9779885;;M;59;CHILENO;;Boomers;PROVIDENCIA                   ;METROPOLITANA;0;0;0;0;0;0;0;0;0;CELULAR LG K41S TITAN DIRECTO MOVISTAR;TELEFONIA
25122686;;F;45;BOLIVIANO;;Extranjero;CALAMA                        ;ANTOFAGASTA;0;0;0;0;0;0;0;0;0;CELULAR VIVO Y11s PHANTOM BLACK ENTEL DIRECTO;TELEFONIA
11984122;;M;50;CHILENO;;X;PUENTE ALTO                   ;METROPOLITANA;0;0;0;0;0;0;0;0;0;Celular A51 128GB LIB OPEN BLANCO;TELEFONIA
14295909;;M;47;CHILENO;;X;VILLARICA                     ;ARAUCANIA;0;0;0;0;0;0;0;0;0;Celular a11 azul samsung WOM;TELEFONIA
10582697;;M;55;CHILENO;;Boomers;SALAMANCA                     ;COQUIMBO;0;0;0;0;0;0;0;0;0;CELULAR ZTE A5 2020 NEGRO WOM;TELEFONIA
8644018;;M;64;CHILENO;;Boomers;LLAILLAY                      ;VALPARAISO;0;0;0;0;0;0;0;0;0;Celular A10S LIB OPEN RED;TELEFONIA
17674817;;F;31;CHILENO;;Millenial;PROVIDENCIA                   ;METROPOLITANA;0;0;0;0;0;0;0;0;0;Celular MOTO G8 POWER LITE TURQUESA OPEN;TELEFONIA
24955082;;M;39;BOLIVIANO;;Extranjero;SAN VICENTE                   ;L.G.B.OÂ´HIGGINS;0;0;0;0;0;0;0;0;0;CELULAR SAMSUNG A21S AZUL OPEN;TELEFONIA
18358516;;F;29;CHILENO;;Millenial;LA CISTERNA;METROPOLITANA;0;0;0;0;0;0;0;0;0;Celular A01 LIB OPEN NEGRO;TELEFONIA
15998784;;M;37;CHILENO;;Millenial;PROVIDENCIA                   ;METROPOLITANA;0;0;0;0;0;0;0;0;0;Celular S10+ LIB OPEN NEGRO;TELEFONIA
18279439;Soltero;M;29;CHILENO;;Millenial;PROVIDENCIA                   ;METROPOLITANA;0;0;0;0;0;0;0;0;0;Celular A20S LIB OPEN NEGRO;TELEFONIA
20023919;;F;22;CHILENO;;Z;PROVIDENCIA                   ;METROPOLITANA;0;0;0;0;0;0;0;0;0;CELULAR SAMSUNG A21S NEGRO OPEN;TELEFONIA
16822968;;M;34;CHILENO;;Millenial;NACIMIENTO                    ;BIO BIO;0;0;0;0;0;0;0;0;0;Celular Y5 NEO MOVISTAR DIRECTO BLACK;TELEFONIA
13367477;;F;43;CHILENO;;X;VILLA ALEMANA                 ;VALPARAISO;0;0;0;0;0;0;0;0;0;CELULAR MOTOROLA G8 POWER LITE AZUL WOM;TELEFONIA
9204041;Viudo;F;62;CHILENO;;Boomers;RENCA                         ;METROPOLITANA;0;0;0;0;0;0;0;0;0;Celular SAMSUNG A21s CLARO DIRECTO BLACK;TELEFONIA
10478196;;M;56;CHILENO;;Boomers;TALCA                         ;MAULE;0;0;0;0;0;0;0;0;0;Celular NOKIA 4.2 ENTEL DIRECTO NEGRO;TELEFONIA
11304622;Casado;F;54;CHILENO;;X;PROVIDENCIA                   ;METROPOLITANA;0;0;0;0;0;0;0;0;0;Celular G8 POWER LITE MOVISTAR DIRECTO AZUL;TELEFONIA
10638996;;M;61;CHILENO;;Boomers;RENCA                         ;METROPOLITANA;0;0;0;0;0;0;0;0;0;Celular A11 LIB OPEN BLUE;TELEFONIA
12030970;;F;46;CHILENO;;X;VILLARICA                     ;ARAUCANIA;0;0;0;0;0;0;0;0;0;Celular SAMSUNG A11 32GB ENTEL DIRECTO NEGRO;TELEFONIA
17108146;;M;33;CHILENO;;Millenial;PROVIDENCIA                   ;METROPOLITANA;0;0;0;0;0;0;0;0;0;Celular A11 LIB OPEN WHITE;TELEFONIA
9310807;;M;60;CHILENO;;Boomers;SAN ANTONIO                   ;VALPARAISO;0;0;0;0;0;0;0;0;0;CELULAR REDMI NOTE 8 64GB NEPTUNE BLUE OPEN;TELEFONIA
12681330;Divorciado;F;48;CHILENO;;X;RENCA                         ;METROPOLITANA;0;0;0;0;0;0;0;0;0;Celular S20 FE LIB OPEN Cloud Lavender;TELEFONIA
12345426;;M;49;CHILENO;;X;ANCUD                         ;LOS LAGOS;0;0;0;0;0;0;0;0;0;Celular Y5 NEO ENTEL DIRECTO BLACK;TELEFONIA
16956481;;M;33;CHILENO;;Millenial;SAN JAVIER                    ;MAULE;0;0;0;0;0;0;0;0;0;CELULAR REDMI NOTE 8 64GB SPACE BLACK OPEN;TELEFONIA
17440860;;F;32;CHILENO;;Millenial;ANTOFAGASTA                   ;ANTOFAGASTA;0;0;0;0;0;0;0;0;0;CELULAR REDMI NOTE 9 PRO 128GB GLACIER WHITE;TELEFONIA
13821056;;F;47;CHILENO;;X;OSORNO                        ;LOS LAGOS;0;0;0;0;0;0;0;0;0;Celular A01 CORE MOVISTAR DIRECTO BLACK;TELEFONIA
12592597;Casado;F;49;CHILENO;;X;RENCA                         ;METROPOLITANA;0;0;0;0;0;0;0;0;0;Celular A10S LIB OPEN NEGRO;TELEFONIA
17188098;;F;32;CHILENO;;Millenial;PROVIDENCIA                   ;METROPOLITANA;0;0;0;0;0;0;0;0;0;Celular Y6P WOM TRIANGULADO NEGRO;TELEFONIA
7265594;;M;65;CHILENO;;Boomers;PICHIDEGUA                    ;L.G.B.OÂ´HIGGINS;0;0;0;0;0;0;0;0;0;CELULAR REDMI 9A GRANITE GREY DIRECTO MOVISTAR;TELEFONIA
9063676;;M;55;CHILENO;;Boomers;PROVIDENCIA                   ;METROPOLITANA;0;0;0;0;0;0;0;0;0;Celular A51 128GB LIB OPEN BLACK;TELEFONIA
10639626;;F;53;CHILENO;;X;PROVIDENCIA                   ;METROPOLITANA;0;0;0;0;0;0;0;0;0;IPHONE XR 64GB LIB OPEN ROJO;TELEFONIA
7245965;;F;66;CHILENO;;Boomers;COQUIMBO                      ;COQUIMBO;0;0;0;0;0;0;0;0;0;CELULAR Y8S MOVISTAR DIRECTO BLACK;TELEFONIA
8765719;;F;63;CHILENO;;Boomers;N/D;N/D;0;0;0;0;0;0;0;0;0;Celular A5 CLARO DIRECTO BLACK;TELEFONIA
17282540;;F;32;CHILENO;;Millenial;PROVIDENCIA                   ;METROPOLITANA;0;0;0;0;0;0;0;0;0;Celular Y8P ENTEL TRIANGULADO PIEDRA DE LUNA;TELEFONIA
6482990;;M;67;CHILENO;;Boomers;PROVIDENCIA                   ;METROPOLITANA;0;0;0;0;0;0;0;0;0;Celular A51 128GB LIB OPEN BLACK;TELEFONIA
5773965;Casado;M;73;CHILENO;;Silencioso;RENCA                         ;METROPOLITANA;0;0;0;0;0;0;0;0;0;Celular A11 LIB OPEN BLUE;TELEFONIA
11724501;;F;51;CHILENO;;X;VALLENAR;ATACAMA;0;0;0;0;0;0;0;0;0;CELULAR XIAOMI REDMI 9C 64GB MIDNIGHT GRAY;TELEFONIA
8319394;;M;65;CHILENO;;Boomers;RENCA                         ;METROPOLITANA;0;0;0;0;0;0;0;0;0;Celular A51 128GB LIB OPEN BLANCO;TELEFONIA
11722307;;F;51;CHILENO;;X;OVALLE                        ;COQUIMBO;0;0;0;0;0;0;0;0;0;Celular SAMSUNG A21s CLARO DIRECTO BLACK;TELEFONIA
14173997;;M;41;CHILENO;;X;PROVIDENCIA                   ;METROPOLITANA;0;0;0;0;0;0;0;0;0;Celular MOTOROLA G9 PLAY WOM DIRECTO AZUL;TELEFONIA
17164071;;F;33;CHILENO;;Millenial;LOS ANDES                     ;VALPARAISO;0;0;0;0;0;0;0;0;0;Celular A10S LIB OPEN RED;TELEFONIA
20280354;;F;22;CHILENO;;Millenial;PUENTE ALTO;METROPOLITANA;0;0;0;0;0;0;0;0;0;CELULAR MOTOROLA G8 POWER LITE AZUL WOM;TELEFONIA
17195791;;F;33;CHILENO;;Millenial;SAN VICENTE                   ;L.G.B.OÂ´HIGGINS;0;0;0;0;0;0;0;0;0;Celular Y9S LIB OPEN BLACK;TELEFONIA
8749478;;M;61;CHILENO;;Boomers;ISLA DE MAIPO                 ;METROPOLITANA;0;0;0;0;0;0;0;0;0;CELULAR G8 POWER MOTO TRI ENTEL;TELEFONIA
14279261;;F;49;CHILENO;;X;LOS ANDES                     ;VALPARAISO;0;0;0;0;0;0;0;0;0;CELULAR Y8S MOVISTAR DIRECTO BLACK;TELEFONIA
7023402;;F;69;CHILENO;;Silencioso;ILLAPEL                       ;COQUIMBO;0;0;0;0;0;0;0;0;0;Celular A51 128GB LIB OPEN BLANCO;TELEFONIA
8605279;Casado;M;60;CHILENO;;Boomers;RENCA                         ;METROPOLITANA;0;0;0;0;0;0;0;0;0;Celular A20S LIB OPEN AZUL;TELEFONIA
17607129;;F;30;CHILENO;;Millenial;RENCA                         ;METROPOLITANA;0;0;0;0;0;0;0;0;0;CELULAR REDMI NOTE 8 64GB NEPTUNE BLUE OPEN;TELEFONIA
18522585;;F;28;CHILENO;;Millenial;MARIQUINA                     ;LOS LAGOS;0;0;0;0;0;0;0;0;0;CELULAR MOTOROLA G9 PLAY 64GB SPRING PINK OPEN;TELEFONIA
8878761;;F;64;CHILENO;;Boomers;QUILLOTA                      ;VALPARAISO;0;0;0;0;0;0;0;0;0;Celular A31 LIB OPEN BLACK;TELEFONIA
13201694;;M;44;CHILENO;;X;SAN FERNANDO                  ;L.G.B.OÂ´HIGGINS;0;0;0;0;0;0;0;0;0;Celular SAMSUNG A11 32GB ENTEL DIRECTO NEGRO;TELEFONIA
18287222;;F;29;CHILENO;;Millenial;CAUQUENES                     ;MAULE;0;0;0;0;0;0;0;0;0;Celular Y6 2019 MOVISTAR DIRECTO BLUE;TELEFONIA
13001516;;F;46;CHILENO;;X;RENCA                         ;METROPOLITANA;0;0;0;0;0;0;0;0;0;Celular ONE FUSION MOVISTAR DIRECTO AZUL;TELEFONIA
9895788;Soltero;M;59;CHILENO;INGENIERO AGRICOLA;Boomers;RENCA                         ;METROPOLITANA;0;0;0;0;0;0;0;0;0;Celular A01 CLARO DIRECTO BLACK;TELEFONIA
10684881;;F;41;CHILENO;;Silencioso;PROVIDENCIA                   ;METROPOLITANA;0;0;0;0;0;0;0;0;0;Celular A10S LIB OPEN NEGRO;TELEFONIA
17554329;Soltero;M;30;CHILENO;GASTRONOMIA INTERNACIONAL;Millenial;PROVIDENCIA                   ;METROPOLITANA;0;0;0;0;0;0;0;0;0;Celular LG K22 DIRECTO CLARO;TELEFONIA
15163097;;M;38;CHILENO;;X;PROVIDENCIA                   ;METROPOLITANA;0;0;0;0;0;0;0;0;0;CELULAR SAMSUNG A21S AZUL OPEN;TELEFONIA
12234793;;F;50;CHILENO;;X;"";"";0;0;0;0;0;0;0;0;0;Celular A11 LIB OPEN BLUE;TELEFONIA
18095071;;M;30;CHILENO;;Millenial;PROVIDENCIA                   ;METROPOLITANA;0;0;0;0;0;0;0;0;0;Celular Y6 2019 WOM DIRECTO AZUL;TELEFONIA
11191208;;M;56;CHILENO;;Boomers;RENCA                         ;METROPOLITANA;0;0;0;0;0;0;0;0;0;Celular R340 CLARO DIRECTO NEGRO;TELEFONIA
6121819;;F;72;CHILENO;;Silencioso;QUILLOTA                      ;VALPARAISO;0;0;0;0;0;0;0;0;0;Celular R340 CLARO DIRECTO NEGRO;TELEFONIA
16807208;;M;34;CHILENO;;Millenial;PROVIDENCIA                   ;METROPOLITANA;0;0;0;0;0;0;0;0;0;CELULAR MOTOROLA G9 PLUS CHAMPAGNE ROSE OPEN;TELEFONIA
17239773;;M;32;CHILENO;;Millenial;PROVIDENCIA                   ;METROPOLITANA;0;0;0;0;0;0;0;0;0;CELULAR MOTOROLA G9 PLAY 64GB SPRING PINK OPEN;TELEFONIA
12167086;;M;44;CHILENO;;X;RENCA                         ;METROPOLITANA;0;0;0;0;0;0;0;0;0;Celular A11 LIB OPEN BLACK;TELEFONIA
11141152;;M;54;CHILENO;;Boomers;QUEMCHI                       ;LOS LAGOS;0;0;0;0;0;0;0;0;0;Celular Y8P ENTEL TRIANGULADO PIEDRA DE LUNA;TELEFONIA
9966835;Divorciado;M;55;CHILENO;;Boomers;RENCA                         ;METROPOLITANA;0;0;0;0;0;0;0;0;0;Celular A51 128GB LIB OPEN BLACK;TELEFONIA
13035880;;F;46;CHILENO;;X;PROVIDENCIA                   ;METROPOLITANA;0;0;0;0;0;0;0;0;0;Celular A10S LIB OPEN NEGRO;TELEFONIA
13537957;Soltero;F;42;CHILENO;;X;RENCA                         ;METROPOLITANA;0;0;0;0;0;0;0;0;0;Celular A11 LIB OPEN BLACK;TELEFONIA
16528339;Divorciado;F;35;CHILENO;TECNICO DE NIVEL SUPERIOR EN ENFERMERIA;Millenial;RENCA                         ;METROPOLITANA;0;0;0;0;0;0;0;0;0;CELULAR G8 POWER MOTO TRI ENTEL;TELEFONIA
7305970;;F;69;CHILENO;;Silencioso;SALAMANCA                     ;COQUIMBO;0;0;0;0;0;0;0;0;0;Celular A10S LIB OPEN NEGRO;TELEFONIA
19504438;;F;24;CHILENO;;Z;PROVIDENCIA                   ;METROPOLITANA;0;0;0;0;0;0;0;0;0;Celular A31 LIB OPEN ROJO;TELEFONIA
18682710;Soltero;M;28;CHILENO;;Millenial;PROVIDENCIA                   ;METROPOLITANA;0;0;0;0;0;0;0;0;0;Celular MOTOROLA G9 PLAY WOM DIRECTO AZUL;TELEFONIA
14061035;;M;41;CHILENO;;X;N/D;N/D;0;0;0;0;0;0;0;0;0;Celular HUAWEI Y9 PRIME DIRECTO CLARO BLUE;TELEFONIA
25939422;;F;56;EXTRANJERO - NO INFORMA NACIONALIDAD;;Extranjero;QUINTA NORMAL                 ;METROPOLITANA;0;0;0;0;0;0;0;0;0;CELULAR REDMI NOTE 8 64GB SPACE BLACK OPEN;TELEFONIA
12111767;;M;54;CHILENO;;X;TALCAHUANO                    ;BIO BIO;0;0;0;0;0;0;0;0;0;Celular A31 LIB OPEN ROJO;TELEFONIA
10012662;;M;58;CHILENO;;Boomers;RENCA                         ;METROPOLITANA;0;0;0;0;0;0;0;0;0;CELULAR SAMSUNG A01 CORE BLACK WOM;TELEFONIA
20468700;;F;22;CHILENO;;Z;PROVIDENCIA                   ;METROPOLITANA;0;0;0;0;0;0;0;0;0;Celular SAMSUNG A01 CORE AZUL ENTEL;TELEFONIA
9703599;;F;58;CHILENO;;Boomers;PROVIDENCIA                   ;METROPOLITANA;0;0;0;0;0;0;0;0;0;CELULAR VIVO Y20 AZUL DIRECTO ENTEL;TELEFONIA
19223364;Casado;F;26;CHILENO;;Z;"";"";0;0;0;0;0;0;0;0;0;CELULAR REDMI NOTE 8 64GB NEPTUNE BLUE OPEN;TELEFONIA
19182060;Soltero;M;28;CHILENO;;Millenial;PROVIDENCIA                   ;METROPOLITANA;0;0;0;0;0;0;0;0;0;Celular A20S LIB OPEN ROJO;TELEFONIA
19720374;;M;25;CHILENO;;Z;PROVIDENCIA                   ;METROPOLITANA;0;0;0;0;0;0;0;0;0;Celular A01 CLARO DIRECTO BLACK;TELEFONIA
9379300;;F;60;CHILENO;;Boomers;SAN MIGUEL                    ;METROPOLITANA;0;0;0;0;0;0;0;0;0;Celular SAMSUNG A11 32GB ENTEL DIRECTO NEGRO;TELEFONIA
8898877;Casado;M;58;CHILENO;;Boomers;PROVIDENCIA                   ;METROPOLITANA;0;0;0;0;0;0;0;0;0;Celular Y7P LIB OPEN NEGRO;TELEFONIA
13842270;Casado;M;41;CHILENO;;X;RENCA                         ;METROPOLITANA;0;0;0;0;0;0;0;0;0;Celular SAMSUNG A11 32GB ENTEL DIRECTO NEGRO;TELEFONIA
15375229;;F;39;CHILENO;;X;"";"";0;0;0;0;0;0;0;0;0;CELULAR HUAWEI Y5P BLUE TRIANGULADO WOM;TELEFONIA
20155446;;F;22;CHILENO;;Z;PROVIDENCIA                   ;METROPOLITANA;0;0;0;0;0;0;0;0;0;Celular A11 LIB OPEN BLACK;TELEFONIA
15024328;;M;39;CHILENO;;X;RENCA                         ;METROPOLITANA;0;0;0;0;0;0;0;0;0;CELULAR SAMSUNG A21S NEGRO OPEN;TELEFONIA
15766372;;F;37;CHILENO;;Millenial;LA LIGUA                      ;VALPARAISO;0;0;0;0;0;0;0;0;0;IPHONE 8 64 GB LIB OPEN PLATEADO;TELEFONIA
18117446;;M;30;CHILENO;;Millenial;LAGO RANCO                    ;LOS RIOS;0;0;0;0;0;0;0;0;0;Celular A31 LIB OPEN ROJO;TELEFONIA
16578010;;M;34;CHILENO;;Millenial;SAN VICENTE                   ;L.G.B.OÂ´HIGGINS;0;0;0;0;0;0;0;0;0;CELULAR LG K41S TITAN DIRECTO MOVISTAR;TELEFONIA
6891877;;M;70;CHILENO;;Silencioso;CUREPTO                       ;MAULE;0;0;0;0;0;0;0;0;0;Celular A10S LIB OPEN BLUE;TELEFONIA
18756417;;F;28;CHILENO;;Millenial;PROVIDENCIA                   ;METROPOLITANA;0;0;0;0;0;0;0;0;0;Celular A11 LIB OPEN BLUE;TELEFONIA
15416939;;F;39;CHILENO;;X;PROVIDENCIA                   ;METROPOLITANA;0;0;0;0;0;0;0;0;0;Celular LG K22 ENTEL DIRECTO TITAN;TELEFONIA
19072841;;F;26;CHILENO;;Z;"";"";0;0;0;0;0;0;0;0;0;Celular A11 LIB OPEN WHITE;TELEFONIA
11196378;Soltero;M;54;CHILENO;;Boomers;RENCA                         ;METROPOLITANA;0;0;0;0;0;0;0;0;0;Celular R340 CLARO DIRECTO NEGRO;TELEFONIA
6225383;;M;70;CHILENO;;Silencioso;CALERA DE TANGO               ;METROPOLITANA;0;0;0;0;0;0;0;0;0;Celular A01 LIB OPEN NEGRO;TELEFONIA
11627991;;M;52;CHILENO;;X;PENAFLOR                      ;METROPOLITANA;0;0;0;0;0;0;0;0;0;Celular A20S LIB OPEN NEGRO;TELEFONIA
15647987;Casado;F;38;CHILENO;;X;PROVIDENCIA                   ;METROPOLITANA;0;0;0;0;0;0;0;0;0;Celular R340 CLARO DIRECTO NEGRO;TELEFONIA
10016614;;M;52;CHILENO;;X;PROVIDENCIA                   ;METROPOLITANA;0;0;0;0;0;0;0;0;0;Celular A01 LIB OPEN NEGRO;TELEFONIA
10725210;;F;55;CHILENO;;Boomers;TALCA                         ;MAULE;0;0;0;0;0;0;0;0;0;CELULAR REDMI NOTE 8 64GB SPACE BLACK OPEN;TELEFONIA
17320986;;M;32;CHILENO;;Millenial;PROVIDENCIA                   ;METROPOLITANA;0;0;0;0;0;0;0;0;0;Celular NOKIA 4.2 ENTEL DIRECTO NEGRO;TELEFONIA
13968943;;M;41;CHILENO;;X;PROVIDENCIA                   ;METROPOLITANA;0;0;0;0;0;0;0;0;0;Celular a11 azul samsung WOM;TELEFONIA
8864403;;F;62;CHILENO;;Boomers;PADRE HURTADO                 ;METROPOLITANA;0;0;0;0;0;0;0;0;0;Celular A11 LIB OPEN BLACK;TELEFONIA
8073398;;M;63;CHILENO;;Boomers;PROVIDENCIA                   ;METROPOLITANA;0;0;0;0;0;0;0;0;0;CELULAR LG K41S TITAN DIRECTO MOVISTAR;TELEFONIA
16256244;;F;35;CHILENO;;Millenial;CONSTITUCION                  ;MAULE;0;0;0;0;0;0;0;0;0;Celular SAMSUNG A01 CORE AZUL ENTEL;TELEFONIA
7466046;;F;68;CHILENO;;Silencioso;LLAILLAY                      ;VALPARAISO;0;0;0;0;0;0;0;0;0;Celular SAMSUNG A01 CORE AZUL ENTEL;TELEFONIA
7240451;;M;68;CHILENO;;Silencioso;N/D;N/D;0;0;0;0;0;0;0;0;0;Celular A30S LIB OPEN NEGRO;TELEFONIA
13275772;Soltero;M;45;CHILENO;CONTADOR AUDITOR;X;PROVIDENCIA                   ;METROPOLITANA;0;0;0;0;0;0;0;0;0;Celular NOTE10+ LIB OPEN NEGRO;TELEFONIA
12347279;;F;48;CHILENO;;X;CALAMA                        ;ANTOFAGASTA;0;0;0;0;0;0;0;0;0;Celular P40 LITE LIB OPEN GREEN;TELEFONIA
14020165;;M;43;CHILENO;;X;CHIMBARONGO                   ;L.G.B.OÂ´HIGGINS;0;0;0;0;0;0;0;0;0;CELULAR HUAWEI Y6P NEGRO ENTEL;TELEFONIA
15853101;;F;38;CHILENO;;Millenial;PROVIDENCIA                   ;METROPOLITANA;0;0;0;0;0;0;0;0;0;Celular A51 128GB LIB OPEN AZUL;TELEFONIA
15965260;;F;37;CHILENO;;Millenial;N/D;N/D;0;0;0;0;0;0;0;0;0;Celular NOKIA 2.3 WOM DIRECTO CHARCOAL;TELEFONIA
16232861;;M;36;CHILENO;;Millenial;CONCON                        ;VALPARAISO;0;0;0;0;0;0;0;0;0;Celular LG K22 ENTEL DIRECTO TITAN;TELEFONIA
6284850;;F;71;CHILENO;;Silencioso;PROVIDENCIA                   ;METROPOLITANA;0;0;0;0;0;0;0;0;0;IPHONE 7 32GB LIB OPEN DORADO;TELEFONIA
18480988;;F;29;CHILENO;;Millenial;N/D;N/D;0;0;0;0;0;0;0;0;0;Celular A51 128GB LIB OPEN BLANCO;TELEFONIA
19031454;;M;27;CHILENO;;Millenial;VICTORIA                      ;ARAUCANIA;0;0;0;0;0;0;0;0;0;Celular SAMSUNG A01 CORE BLACK CLARO;TELEFONIA
9550554;;F;57;CHILENO;;Boomers;PROVIDENCIA                   ;METROPOLITANA;0;0;0;0;0;0;0;0;0;Celular A20S LIB OPEN ROJO;TELEFONIA
16933849;;M;33;CHILENO;;Millenial;"";"";0;0;0;0;0;0;0;0;0;Celular A10S LIB OPEN RED;TELEFONIA
17436114;;M;32;CHILENO;;Millenial;ANTOFAGASTA                   ;ANTOFAGASTA;0;0;0;0;0;0;0;0;0;CELULAR SAMSUNG A21S ROJO OPEN;TELEFONIA
11142119;;M;54;CHILENO;;Boomers;PROVIDENCIA                   ;METROPOLITANA;0;0;0;0;0;0;0;0;0;CELULAR SAMSUNG A21S AZUL OPEN;TELEFONIA
12582519;;F;47;CHILENO;;X;ALTO HOSPICIO;TARAPACA;0;0;0;0;0;0;0;0;0;Celular Y8P ENTEL TRIANGULADO PIEDRA DE LUNA;TELEFONIA
9079828;;M;61;CHILENO;;Boomers;RENCA                         ;METROPOLITANA;0;0;0;0;0;0;0;0;0;Celular A11 LIB OPEN BLUE;TELEFONIA
9754043;;F;59;CHILENO;;Boomers;PROVIDENCIA                   ;METROPOLITANA;0;0;0;0;0;0;0;0;0;Celular A31 LIB OPEN AZUL;TELEFONIA
6813000;;M;68;CHILENO;;Silencioso;NANCAGUA                      ;L.G.B.OÂ´HIGGINS;0;0;0;0;0;0;0;0;0;Celular A01 LIB OPEN NEGRO;TELEFONIA
9322428;;M;53;CHILENO;;X;PROVIDENCIA                   ;METROPOLITANA;0;0;0;0;0;0;0;0;0;IPHONE 8 64 GB LIB OPEN DORADO;TELEFONIA
12820168;;M;51;CHILENO;;X;QUILLOTA                      ;VALPARAISO;0;0;0;0;0;0;0;0;0;Celular XIAOMI REDMI 9A 32 GB DIRECTO CLARO;TELEFONIA
20600953;;F;21;CHILENO;;Z;OVALLE;COQUIMBO;0;0;0;0;0;0;0;0;0;Celular SAMSUNG A01 CORE BLACK CLARO;TELEFONIA
19316490;Soltero;F;25;CHILENO;;Z;PROVIDENCIA                   ;METROPOLITANA;0;0;0;0;0;0;0;0;0;Celular Y7P LIB OPEN NEGRO;TELEFONIA
20114415;;F;22;CHILENO;;Z;PROVIDENCIA                   ;METROPOLITANA;0;0;0;0;0;0;0;0;0;Celular Y9S LIB OPEN BREATHING CRYSTAL;TELEFONIA
10161405;Divorciado;M;53;CHILENO;;X;RENCA                         ;METROPOLITANA;0;0;0;0;0;0;0;0;0;Celular A20S LIB OPEN NEGRO;TELEFONIA
15127520;;M;40;CHILENO;;X;CURICO                        ;MAULE;0;0;0;0;0;0;0;0;0;Celular Y9S LIB OPEN BREATHING CRYSTAL;TELEFONIA
12830906;;F;46;CHILENO;;X;CHILLAN                       ;BIO BIO;0;0;0;0;0;0;0;0;0;Celular A10S LIB OPEN BLUE;TELEFONIA
13552317;;F;43;CHILENO;;X;PROVIDENCIA                   ;METROPOLITANA;0;0;0;0;0;0;0;0;0;Celular MOTO G8 POWER LITE TURQUESA OPEN;TELEFONIA
9793719;;M;59;CHILENO;;Boomers;QUILLOTA                      ;VALPARAISO;0;0;0;0;0;0;0;0;0;Celular Y9 PRIME LIB OPEN VERDE;TELEFONIA
12184505;;M;49;CHILENO;;X;PROVIDENCIA                   ;METROPOLITANA;0;0;0;0;0;0;0;0;0;Celular NOKIA 4.2 ENTEL DIRECTO NEGRO;TELEFONIA
8006762;;M;68;CHILENO;;Silencioso;LA PINTANA                    ;METROPOLITANA;0;0;0;0;0;0;0;0;0;Celular A11 LIB OPEN BLUE;TELEFONIA
7607236;;M;63;CHILENO;;Boomers;N/D;N/D;0;0;0;0;0;0;0;0;0;Celular Y9S LIB OPEN BREATHING CRYSTAL;TELEFONIA
9379922;Casado;F;59;CHILENO;;Boomers;RENCA                         ;METROPOLITANA;0;0;0;0;0;0;0;0;0;Celular A11 LIB OPEN BLACK;TELEFONIA
6650555;;M;71;CHILENO;;Silencioso;PROVIDENCIA                   ;METROPOLITANA;0;0;0;0;0;0;0;0;0;Celular A3 LITE ENTEL TRIANGULADO NEGRO;TELEFONIA
6074485;;F;77;CHILENO;;Silencioso;QUILPUE                       ;VALPARAISO;0;0;0;0;0;0;0;0;0;Celular 2.3 MOVISTAR DIRECTO CHARCOAL;TELEFONIA
12074009;Soltero;F;43;CHILENO;;X;RENCA                         ;METROPOLITANA;0;0;0;0;0;0;0;0;0;IPHONE 8 64 GB LIB OPEN DORADO;TELEFONIA
26052395;;M;42;COLOMBIANO;;Extranjero;N/D;N/D;0;0;0;0;0;0;0;0;0;Celular SAMSUNG A31 BLACK CLARO;TELEFONIA
9677298;;F;59;CHILENO;;Boomers;PUENTE ALTO                   ;METROPOLITANA;0;0;0;0;0;0;0;0;0;Celular Y6 2019 WOM DIRECTO BLACK;TELEFONIA
13327797;;F;44;CHILENO;;X;VALLENAR;ATACAMA;0;0;0;0;0;0;0;0;0;Celular A20S LIB OPEN AZUL;TELEFONIA
26554204;;M;31;PERUANO;;Extranjero;SAN FELIPE                    ;VALPARAISO;0;0;0;0;0;0;0;0;0;Celular Y5 NEO ENTEL DIRECTO BLACK;TELEFONIA
7728603;;M;67;CHILENO;;Boomers;VICTORIA                      ;ARAUCANIA;0;0;0;0;0;0;0;0;0;Celular A01 LIB OPEN AZUL;TELEFONIA
9462381;;F;59;CHILENO;;Boomers;VILLARICA                     ;ARAUCANIA;0;0;0;0;0;0;0;0;0;CELULAR SAMSUNG A21S AZUL OPEN;TELEFONIA
20600733;;F;21;CHILENO;;Z;PROVIDENCIA                   ;METROPOLITANA;0;0;0;0;0;0;0;0;0;Celular Y7P LIB OPEN AZUL;TELEFONIA
6911972;;M;67;CHILENO;;Boomers;CUNCO                         ;ARAUCANIA;0;0;0;0;0;0;0;0;0;Celular A11 LIB OPEN BLACK;TELEFONIA
14526729;;M;45;CHILENO;;X;PROVIDENCIA                   ;METROPOLITANA;0;0;0;0;0;0;0;0;0;Celular A01 LIB OPEN NEGRO;TELEFONIA
23863548;;F;45;DOMINICANO;;Extranjero;N/D;N/D;0;0;0;0;0;0;0;0;0;CELULAR MOTO ONE FUSION 64GB VERDE 64GB OPEN;TELEFONIA
7841346;;M;63;CHILENO;;Boomers;BUIN                          ;METROPOLITANA;0;0;0;0;0;0;0;0;0;Celular A11 LIB OPEN BLACK;TELEFONIA
12442276;;M;49;CHILENO;;X;ANTOFAGASTA                   ;ANTOFAGASTA;0;0;0;0;0;0;0;0;0;CELULAR REDMI NOTE 8 64GB NEPTUNE BLUE OPEN;TELEFONIA
19204197;Casado;F;31;CHILENO;;Millenial;PROVIDENCIA                   ;METROPOLITANA;0;0;0;0;0;0;0;0;0;Celular A20S LIB OPEN ROJO;TELEFONIA
13289665;;F;44;CHILENO;;X;TALCA                         ;MAULE;0;0;0;0;0;0;0;0;0;Celular AL3 CLARO DIRECTO NEGRO;TELEFONIA
16333342;;F;36;CHILENO;;Millenial;SAN FELIPE                    ;VALPARAISO;0;0;0;0;0;0;0;0;0;Celular SAMSUNG A51 128GB BLACK CLARO;TELEFONIA
13431814;;M;43;CHILENO;;X;PROVIDENCIA                   ;METROPOLITANA;0;0;0;0;0;0;0;0;0;CELULAR MOTO ONE FUSION 64GB VERDE 64GB OPEN;TELEFONIA
17469653;;F;31;CHILENO;;Millenial;PROVIDENCIA                   ;METROPOLITANA;0;0;0;0;0;0;0;0;0;Celular Y6 2019 WOM DIRECTO BLACK;TELEFONIA
19057350;;F;27;CHILENO;;Z;LO ESPEJO                     ;METROPOLITANA;0;0;0;0;0;0;0;0;0;Celular A20S LIB OPEN ROJO;TELEFONIA
17675230;Soltero;M;31;CHILENO;COMUNICADOR AUDIOVISUAL;Millenial;PROVIDENCIA                   ;METROPOLITANA;0;0;0;0;0;0;0;0;0;CELULAR OWN 1014 NEGRO ENT;TELEFONIA
12329488;;F;48;CHILENO;;X;CURANILAHUE                   ;BIO BIO;0;0;0;0;0;0;0;0;0;Celular G8 POWER LITE WOM DIRECTO TURQUESA;TELEFONIA
13424471;;F;44;CHILENO;;X;ARICA                         ;TARAPACA;0;0;0;0;0;0;0;0;0;CELULAR SAMSUNG A21S ROJO OPEN;TELEFONIA
8925619;;M;58;CHILENO;;Boomers;"";"";0;0;0;0;0;0;0;0;0;Celular SAMSUNG A01 CORE AZUL ENTEL;TELEFONIA
7807261;Soltero;F;71;CHILENO;;Silencioso;RENCA                         ;METROPOLITANA;0;0;0;0;0;0;0;0;0;Celular A01 ENTEL TRIANGULADO NEGRO;TELEFONIA
10755611;;M;55;CHILENO;;Boomers;RETIRO                        ;MAULE;0;0;0;0;0;0;0;0;0;Celular A31 LIB OPEN AZUL;TELEFONIA
8546479;;F;61;CHILENO;;Boomers;RENCA                         ;METROPOLITANA;0;0;0;0;0;0;0;0;0;CELULAR SAMSUNG A21S ROJO OPEN;TELEFONIA
9284522;Casado;F;60;CHILENO;;Boomers;PROVIDENCIA                   ;METROPOLITANA;0;0;0;0;0;0;0;0;0;Celular Y7P LIB OPEN AZUL;TELEFONIA
17900026;;M;30;CHILENO;;Millenial;N/D;N/D;0;0;0;0;0;0;0;0;0;Celular A20S LIB OPEN NEGRO;TELEFONIA
11871965;;F;51;CHILENO;;X;PROVIDENCIA                   ;METROPOLITANA;0;0;0;0;0;0;0;0;0;Celular AL3 CLARO DIRECTO NEGRO;TELEFONIA
13975275;Casado;M;41;CHILENO;;X;ARICA                         ;TARAPACA;0;0;0;0;0;0;0;0;0;Celular A20S LIB OPEN ROJO;TELEFONIA
11531294;Soltero;M;52;CHILENO;;X;PROVIDENCIA                   ;METROPOLITANA;0;0;0;0;0;0;0;0;0;Celular AL3 CLARO DIRECTO NEGRO;TELEFONIA
19311085;;M;25;CHILENO;;Z;LONGAVI                       ;MAULE;0;0;0;0;0;0;0;0;0;CELULAR SAMSUNG A21S ROJO OPEN;TELEFONIA
14249615;;F;53;CHILENO;;X;CARAHUE                       ;ARAUCANIA;0;0;0;0;0;0;0;0;0;Celular A20S LIB OPEN AZUL;TELEFONIA
11458118;;M;53;CHILENO;;X;RENCA                         ;METROPOLITANA;0;0;0;0;0;0;0;0;0;Celular A11 MOVISTAR DIRECTO BLACK;TELEFONIA
17794669;;F;31;CHILENO;;Millenial;TALCA                         ;MAULE;0;0;0;0;0;0;0;0;0;IPHONE 6S 64GB GRIS OPEN;TELEFONIA
4833129;;F;74;CHILENO;;Silencioso;N/D;N/D;0;0;0;0;0;0;0;0;0;Celular S10 LITE LIB OPEN AZUL;TELEFONIA
16610666;Casado;M;34;CHILENO;;Millenial;PROVIDENCIA                   ;METROPOLITANA;0;0;0;0;0;0;0;0;0;CELULAR SAMSUNG A21S AZUL OPEN;TELEFONIA
15199884;;M;39;CHILENO;;X;LEBU                          ;BIO BIO;0;0;0;0;0;0;0;0;0;Celular A31 LIB OPEN BLACK;TELEFONIA
16982016;;F;34;CHILENO;;Millenial;LOS ANGELES                   ;BIO BIO;0;0;0;0;0;0;0;0;0;CELULAR MOTO ONE FUSION 64GB VERDE 64GB OPEN;TELEFONIA
9957794;;M;57;CHILENO;;Boomers;PROVIDENCIA                   ;METROPOLITANA;0;0;0;0;0;0;0;0;0;CELULAR SAMSUNG A21S ROJO OPEN;TELEFONIA
26638176;;F;32;CHILENO;;Extranjero;EL MONTE                      ;METROPOLITANA;0;0;0;0;0;0;0;0;0;Celular A51 128GB LIB OPEN BLANCO;TELEFONIA
18256151;;M;30;CHILENO;;Millenial;PROVIDENCIA                   ;METROPOLITANA;0;0;0;0;0;0;0;0;0;Celular A10S LIB OPEN BLUE;TELEFONIA
7217431;;M;66;CHILENO;;Boomers;PROVIDENCIA                   ;METROPOLITANA;0;0;0;0;0;0;0;0;0;Celular Y6 2019 WOM DIRECTO AZUL;TELEFONIA
7020321;;F;71;CHILENO;;Silencioso;VICTORIA                      ;ARAUCANIA;0;0;0;0;0;0;0;0;0;CELULAR HUAWEI Y8S NEGRO WOM;TELEFONIA
8473783;;M;58;CHILENO;;Boomers;"";"";0;0;0;0;0;0;0;0;0;Celular A51 128GB LIB OPEN AZUL;TELEFONIA
13173106;;M;45;CHILENO;;X;"";"";0;0;0;0;0;0;0;0;0;CELULAR SAMSUNG A21S AZUL OPEN;TELEFONIA
7077129;;F;72;CHILENO;;Silencioso;ARICA                         ;ARICA Y PARINACOTA;0;0;0;0;0;0;0;0;0;Celular CLAMSHELL RED LIB OPEN ROJO;TELEFONIA
19998408;;M;23;CHILENO;;Millenial;PROVIDENCIA                   ;METROPOLITANA;0;0;0;0;0;0;0;0;0;Celular SAMSUNG A11 32GB ENTEL DIRECTO NEGRO;TELEFONIA
17552748;;M;37;CHILENO;;Millenial;RENCA                         ;METROPOLITANA;0;0;0;0;0;0;0;0;0;Celular A10S LIB OPEN RED;TELEFONIA
6140899;;M;72;CHILENO;;Silencioso;ANTOFAGASTA                   ;ANTOFAGASTA;0;0;0;0;0;0;0;0;0;IPHONE 8 PLUS 64 GB LIB OPEN SILVER;TELEFONIA
19205083;;M;26;CHILENO;;Z;CALAMA                        ;ANTOFAGASTA;0;0;0;0;0;0;0;0;0;CELULAR SAMSUNG A21S ROJO OPEN;TELEFONIA
13411045;Soltero;F;48;CHILENO;;X;PROVIDENCIA                   ;METROPOLITANA;0;0;0;0;0;0;0;0;0;Celular A01 LIB OPEN ROJO;TELEFONIA
19984486;;F;23;CHILENO;;Z;PROVIDENCIA                   ;METROPOLITANA;0;0;0;0;0;0;0;0;0;CELULAR NOKIA 7.2 GREEN TRI WOM;TELEFONIA
17642964;;M;31;CHILENO;;Millenial;ILLAPEL                       ;COQUIMBO;0;0;0;0;0;0;0;0;0;Celular A01 LIB OPEN AZUL;TELEFONIA
19195938;Soltero;F;26;CHILENO;;Z;PROVIDENCIA                   ;METROPOLITANA;0;0;0;0;0;0;0;0;0;CELULAR Y8S MOVISTAR DIRECTO BLACK;TELEFONIA
15801855;;F;38;CHILENO;;Millenial;N/D;N/D;0;0;0;0;0;0;0;0;0;Celular TIGER V MOVISTAR DIRECTO GRIS;TELEFONIA
4710200;;M;82;CHILENO;;Silencioso;TALCAHUANO                    ;BIO BIO;0;0;0;0;0;0;0;0;0;Celular TIGER V SENIOR CLARO DIRECTO NEGRO;TELEFONIA
9506534;;F;57;CHILENO;;Boomers;PROVIDENCIA                   ;METROPOLITANA;0;0;0;0;0;0;0;0;0;CELULAR A11 CLARO DIRECTO BLACK;TELEFONIA
10494939;Casado;M;53;CHILENO;;X;RENCA                         ;METROPOLITANA;0;0;0;0;0;0;0;0;0;Celular F1026 3G ENTEL DIRECTO AZUL;TELEFONIA
7564659;;M;65;CHILENO;;Boomers;MOLINA                        ;MAULE;0;0;0;0;0;0;0;0;0;Celular A01 LIB OPEN ROJO;TELEFONIA
6393811;;M;67;CHILENO;;Boomers;PROVIDENCIA                   ;METROPOLITANA;0;0;0;0;0;0;0;0;0;Celular A20S LIB OPEN NEGRO;TELEFONIA
16526232;;M;34;CHILENO;;Millenial;VALDIVIA                      ;LOS RIOS;0;0;0;0;0;0;0;0;0;Celular A11 LIB OPEN BLUE;TELEFONIA
7445357;;F;68;CHILENO;;Silencioso;SAN FELIPE                    ;VALPARAISO;0;0;0;0;0;0;0;0;0;Celular G8 POWER LITE MOVISTAR DIRECTO AZUL;TELEFONIA
9772473;;F;59;CHILENO;;Boomers;MAIPU                         ;METROPOLITANA;0;0;0;0;0;0;0;0;0;Celular A31 LIB OPEN AZUL;TELEFONIA
14244683;;M;48;CHILENO;;X;POZO ALMONTE                  ;TARAPACA;0;0;0;0;0;0;0;0;0;Celular AL3 CLARO DIRECTO NEGRO;TELEFONIA
8289282;;M;63;CHILENO;;Silencioso;RENCA                         ;METROPOLITANA;0;0;0;0;0;0;0;0;0;CELULAR A11 CLARO DIRECTO BLACK;TELEFONIA
18971352;Soltero;M;26;CHILENO;NUTRICIONISTA;Z;PROVIDENCIA                   ;METROPOLITANA;0;0;0;0;0;0;0;0;0;Celular NOKIA 1.3 NEGRO WOM;TELEFONIA
15729917;;F;38;CHILENO;;Millenial;RENCA                         ;METROPOLITANA;0;0;0;0;0;0;0;0;0;Celular Y5 NEO MOVISTAR DIRECTO BLACK;TELEFONIA
12790683;Casado;F;46;CHILENO;;X;RENCA                         ;METROPOLITANA;0;0;0;0;0;0;0;0;0;Celular A10S LIB OPEN RED;TELEFONIA
12367950;;M;49;CHILENO;;Boomers;RENCA                         ;METROPOLITANA;0;0;0;0;0;0;0;0;0;CELULAR SAMSUNG A21S NEGRO OPEN;TELEFONIA
19414830;;M;25;CHILENO;;Z;PROVIDENCIA                   ;METROPOLITANA;0;0;0;0;0;0;0;0;0;Celular F1026 3G ENTEL DIRECTO AZUL;TELEFONIA
8058204;;F;61;CHILENO;;Boomers;CHIMBARONGO                   ;L.G.B.OÂ´HIGGINS;0;0;0;0;0;0;0;0;0;Celular SA3 CLARO DIRECTO BLACK;TELEFONIA
11966289;;F;50;CHILENO;;X;ANGOL                         ;ARAUCANIA;0;0;0;0;0;0;0;0;0;Celular SA3 CLARO DIRECTO BLACK;TELEFONIA
14052153;;F;41;CHILENO;;X;PROVIDENCIA                   ;METROPOLITANA;0;0;0;0;0;0;0;0;0;Celular SA3 CLARO DIRECTO BLACK;TELEFONIA
13169868;Casado;F;44;CHILENO;;X;RENCA                         ;METROPOLITANA;0;0;0;0;0;0;0;0;0;Celular Y5 NEO ENTEL DIRECTO BLACK;TELEFONIA
8649448;;F;61;CHILENO;;Boomers;N/D;N/D;0;0;0;0;0;0;0;0;0;Celular A20S LIB OPEN NEGRO;TELEFONIA
18000784;;M;30;CHILENO;;Millenial;PROVIDENCIA                   ;METROPOLITANA;0;0;0;0;0;0;0;0;0;Celular A01 LIB OPEN AZUL;TELEFONIA
12149510;Soltero;M;67;CHILENO;;Silencioso;PROVIDENCIA                   ;METROPOLITANA;0;0;0;0;0;0;0;0;0;Celular SA3 CLARO DIRECTO BLACK;TELEFONIA
25766351;;M;31;HAITIANO;;Extranjero;N/D;N/D;0;0;0;0;0;0;0;0;0;Celular Y9S LIB OPEN BREATHING CRYSTAL;TELEFONIA
9659680;;F;51;CHILENO;;X;MACHALI                       ;L.G.B.OÂ´HIGGINS;0;0;0;0;0;0;0;0;0;Celular A3 LITE ENTEL TRIANGULADO NEGRO;TELEFONIA
15656331;;M;38;CHILENO;;Millenial;PROVIDENCIA                   ;METROPOLITANA;0;0;0;0;0;0;0;0;0;Celular A51 128GB LIB OPEN BLACK;TELEFONIA
12739704;;F;50;CHILENO;;X;PROVIDENCIA                   ;METROPOLITANA;0;0;0;0;0;0;0;0;0;Celular SA3 CLARO DIRECTO BLACK;TELEFONIA
12441932;;M;49;CHILENO;;X;MAIPU                         ;METROPOLITANA;0;0;0;0;0;0;0;0;0;Celular Y9S LIB OPEN BREATHING CRYSTAL;TELEFONIA
8460937;Soltero;F;64;CHILENO;;Boomers;PROVIDENCIA                   ;METROPOLITANA;0;0;0;0;0;0;0;0;0;CELULAR HUAWEI Y5 NEO NEGRO WOM;TELEFONIA
10817334;;M;53;CHILENO;;X;LEBU                          ;BIO BIO;0;0;0;0;0;0;0;0;0;Celular A11 LIB OPEN BLACK;TELEFONIA
16259822;;M;36;CHILENO;;Millenial;RENCA                         ;METROPOLITANA;0;0;0;0;0;0;0;0;0;Celular A20S LIB OPEN ROJO;TELEFONIA
6516563;;M;71;CHILENO;;Silencioso;PROVIDENCIA                   ;METROPOLITANA;0;0;0;0;0;0;0;0;0;Celular SA3 CLARO DIRECTO BLACK;TELEFONIA
20213903;;M;22;CHILENO;;Z;PROVIDENCIA                   ;METROPOLITANA;0;0;0;0;0;0;0;0;0;CELULAR NOKIA 7.2 GREEN TRI WOM;TELEFONIA
19255626;Soltero;F;25;CHILENO;;Z;PROVIDENCIA                   ;METROPOLITANA;0;0;0;0;0;0;0;0;0;Celular A51 128GB LIB OPEN AZUL;TELEFONIA
17772358;Soltero;M;32;CHILENO;PREVENCION DE RIESGOS;Millenial;PROVIDENCIA                   ;METROPOLITANA;0;0;0;0;0;0;0;0;0;IPHONE 6S 64GB NEGRO;TELEFONIA
9573473;;M;54;CHILENO;;X;CHIGUAYANTE                   ;BIO BIO;0;0;0;0;0;0;0;0;0;Celular A51 128GB LIB OPEN BLANCO;TELEFONIA
13378571;;F;43;CHILENO;;X;CHILLAN                       ;BIO BIO;0;0;0;0;0;0;0;0;0;Celular A51 128GB LIB OPEN BLANCO;TELEFONIA
4484873;;M;81;CHILENO;;Silencioso;TALAGANTE                     ;METROPOLITANA;0;0;0;0;0;0;0;0;0;Celular A11 MOVISTAR DIRECTO BLACK;TELEFONIA
12723984;;F;47;CHILENO;;X;LA CISTERNA                   ;METROPOLITANA;0;0;0;0;0;0;0;0;0;Celular A31 LIB OPEN ROJO;TELEFONIA
15777254;;F;38;CHILENO;;Millenial;RENCA                         ;METROPOLITANA;0;0;0;0;0;0;0;0;0;IPHONE 5S 16GB DORADO OPEN;TELEFONIA
9282120;;F;62;CHILENO;;Boomers;VINA DEL MAR                  ;VALPARAISO;0;0;0;0;0;0;0;0;0;Celular A10S LIB OPEN RED;TELEFONIA
13368846;;M;43;CHILENO;;X;SAN ANTONIO                   ;VALPARAISO;0;0;0;0;0;0;0;0;0;Celular A20S LIB OPEN NEGRO;TELEFONIA
17236147;;F;32;CHILENO;;Millenial;SALAMANCA                     ;COQUIMBO;0;0;0;0;0;0;0;0;0;Celular A01 CORE MOVISTAR DIRECTO BLACK;TELEFONIA
16820011;;M;34;CHILENO;;Millenial;ZAPALLAR                      ;VALPARAISO;0;0;0;0;0;0;0;0;0;Celular A10S LIB OPEN NEGRO;TELEFONIA
15550310;Casado;F;54;CHILENO;;Boomers;RENCA                         ;METROPOLITANA;0;0;0;0;0;0;0;0;0;CELULAR HUAWEI Y5P BLUE TRIANGULADO WOM;TELEFONIA
8395908;Soltero;F;66;CHILENO;;Boomers;PROVIDENCIA                   ;METROPOLITANA;0;0;0;0;0;0;0;0;0;CELULAR HUAWEI Y5P BLUE TRIANGULADO WOM;TELEFONIA
18684496;Soltero;F;28;CHILENO;;Millenial;PROVIDENCIA                   ;METROPOLITANA;0;0;0;0;0;0;0;0;0;Celular A20S LIB OPEN AZUL;TELEFONIA
10144615;;M;58;CHILENO;;Boomers;MAIPU                         ;METROPOLITANA;0;0;0;0;0;0;0;0;0;CELULAR SAMSUNG A21S AZUL OPEN;TELEFONIA
12768288;;F;47;CHILENO;;X;RENCA                         ;METROPOLITANA;0;0;0;0;0;0;0;0;0;CELULAR SAMSUNG A21S ROJO OPEN;TELEFONIA
12380568;;F;49;CHILENO;;X;RENCA                         ;METROPOLITANA;0;0;0;0;0;0;0;0;0;Celular A31 LIB OPEN AZUL;TELEFONIA
18679636;;F;28;CHILENO;;Millenial;PROVIDENCIA                   ;METROPOLITANA;0;0;0;0;0;0;0;0;0;Celular A01 LIB OPEN AZUL;TELEFONIA
12948727;;F;46;CHILENO;;X;SAN FELIPE                    ;VALPARAISO;0;0;0;0;0;0;0;0;0;Celular A51 128GB LIB OPEN AZUL;TELEFONIA
11415862;;M;52;CHILENO;;X;PROVIDENCIA                   ;METROPOLITANA;0;0;0;0;0;0;0;0;0;Celular SAMSUNG A21s CLARO DIRECTO BLACK;TELEFONIA
19788861;;F;24;CHILENO;;Z;SAN JAVIER                    ;MAULE;0;0;0;0;0;0;0;0;0;Celular P30 LITE ENTEL DIRECTO NEGRO;TELEFONIA
13535555;;M;44;CHILENO;;X;OVALLE                        ;COQUIMBO;0;0;0;0;0;0;0;0;0;CELULAR MOTO ONE MACRO AZUL METAL WOM;TELEFONIA
9154960;;F;60;CHILENO;;Boomers;RENCA                         ;METROPOLITANA;0;0;0;0;0;0;0;0;0;CELULAR SAMSUNG A21S AZUL OPEN;TELEFONIA
16579546;Soltero;M;35;CHILENO;;Millenial;RENCA                         ;METROPOLITANA;0;0;0;0;0;0;0;0;0;Celular A20S LIB OPEN ROJO;TELEFONIA
7167317;Soltero;F;72;CHILENO;;Silencioso;CORONEL                       ;BIO BIO;0;0;0;0;0;0;0;0;0;Celular TIGER V SENIOR CLARO DIRECTO NEGRO;TELEFONIA
18343192;;F;29;CHILENO;;Millenial;LINARES                       ;MAULE;0;0;0;0;0;0;0;0;0;Celular E6S MOVISTAR DIRECTO AZUL;TELEFONIA
19058007;;F;26;CHILENO;;Z;N/D;N/D;0;0;0;0;0;0;0;0;0;Celular G8 POWER LITE WOM DIRECTO TURQUESA;TELEFONIA
7791642;;M;67;CHILENO;;Boomers;LUMACO                        ;ARAUCANIA;0;0;0;0;0;0;0;0;0;Celular A51 128GB LIB OPEN BLANCO;TELEFONIA
6284446;;M;68;CHILENO;;Silencioso;PROVIDENCIA                   ;METROPOLITANA;0;0;0;0;0;0;0;0;0;Celular A01 LIB OPEN ROJO;TELEFONIA
10886977;;M;56;CHILENO;;Boomers;LOS ANGELES                   ;BIO BIO;0;0;0;0;0;0;0;0;0;Celular A01 LIB OPEN ROJO;TELEFONIA
7045718;;F;65;CHILENO;;Boomers;PROVIDENCIA                   ;METROPOLITANA;0;0;0;0;0;0;0;0;0;CELULAR MOTOROLA E6S AZUL WOM;TELEFONIA
7782900;;F;65;CHILENO;;Boomers;COQUIMBO                      ;COQUIMBO;0;0;0;0;0;0;0;0;0;Celular Y6P BUNDLE WOM TRIANGULADO NEGRO;TELEFONIA
16569968;Casado;F;35;CHILENO;PROFESOR;Millenial;PROVIDENCIA                   ;METROPOLITANA;0;0;0;0;0;0;0;0;0;CELULAR SAMSUNG A21S ROJO OPEN;TELEFONIA
11842815;Soltero;F;51;CHILENO;;X;PROVIDENCIA                   ;METROPOLITANA;0;0;0;0;0;0;0;0;0;Celular Y6P BUNDLE WOM TRIANGULADO NEGRO;TELEFONIA
9119468;;M;59;CHILENO;;Boomers;RENCA                         ;METROPOLITANA;0;0;0;0;0;0;0;0;0;Celular A3 LITE ENTEL TRIANGULADO NEGRO;TELEFONIA
15742738;;M;38;CHILENO;;X;RENCA                         ;METROPOLITANA;0;0;0;0;0;0;0;0;0;Celular SAMSUNG A21s CLARO DIRECTO BLACK;TELEFONIA
4826876;;M;77;CHILENO;;Millenial;PROVIDENCIA                   ;METROPOLITANA;0;0;0;0;0;0;0;0;0;CHIP RECARGA CLARO;TELEFONIA
17750823;;M;31;CHILENO;;Millenial;N/D;N/D;0;0;0;0;0;0;0;0;0;Celular A20S LIB OPEN AZUL;TELEFONIA
19955713;;F;24;CHILENO;;Z;PROVIDENCIA                   ;METROPOLITANA;0;0;0;0;0;0;0;0;0;Celular NOKIA 1.3 NEGRO WOM;TELEFONIA
14633264;;M;43;CHILENO;;X;PROVIDENCIA                   ;METROPOLITANA;0;0;0;0;0;0;0;0;0;Celular E6S MOVISTAR DIRECTO AZUL;TELEFONIA
15347672;;F;40;CHILENO;;X;MAIPU                         ;METROPOLITANA;0;0;0;0;0;0;0;0;0;Celular A51 128GB LIB OPEN AZUL;TELEFONIA
9931234;;F;52;CHILENO;;X;HUALPEN;BIO-BIO;0;0;0;0;0;0;0;0;0;Celular MOTO G8 POWER LITE TURQUESA OPEN;TELEFONIA
12173246;Casado;M;50;CHILENO;;X;RENCA                         ;METROPOLITANA;0;0;0;0;0;0;0;0;0;Celular G8 POWER LITE WOM DIRECTO TURQUESA;TELEFONIA
26097692;;M;29;HAITIANO;;Extranjero;SAN FELIPE                    ;VALPARAISO;0;0;0;0;0;0;0;0;0;Celular G8 POWER LITE MOVISTAR DIRECTO AZUL;TELEFONIA
13708828;;M;43;CHILENO;;X;N/D;N/D;0;0;0;0;0;0;0;0;0;Celular A31 LIB OPEN BLACK;TELEFONIA
16396879;;M;35;CHILENO;;Millenial;PROVIDENCIA                   ;METROPOLITANA;0;0;0;0;0;0;0;0;0;Celular E6S ENTEL DIRECTO BLUE;TELEFONIA
17470193;;F;32;CHILENO;;Millenial;PROVIDENCIA                   ;METROPOLITANA;0;0;0;0;0;0;0;0;0;CELULAR HUAWEI Y8S NEGRO WOM;TELEFONIA
14527985;;M;46;CHILENO;;X;RENCA                         ;METROPOLITANA;0;0;0;0;0;0;0;0;0;Celular A20S LIB OPEN ROJO;TELEFONIA
7650979;;M;65;CHILENO;;Boomers;PANGUIPULLI                   ;LOS RIOS;0;0;0;0;0;0;0;0;0;Celular Y5 NEO CLARO DIRECTO BLACK;TELEFONIA
12591417;;M;48;CHILENO;;X;VILLA ALEGRE                  ;MAULE;0;0;0;0;0;0;0;0;0;CELULAR MOTO ONE FUSION 64GB VERDE 64GB OPEN;TELEFONIA
13143698;;M;45;CHILENO;;X;LOS ANGELES                   ;BIO BIO;0;0;0;0;0;0;0;0;0;Celular E6S ENTEL DIRECTO BLUE;TELEFONIA
17243640;Soltero;M;32;CHILENO;INGENIERIA EN MAQUINARIA VEHICULOS AUTOMOTRICES Y SISTEMAS ELECTRONICOS;Millenial;PROVIDENCIA                   ;METROPOLITANA;0;0;0;0;0;0;0;0;0;Celular A01 LIB OPEN ROJO;TELEFONIA
18679843;Soltero;F;28;CHILENO;;Millenial;PROVIDENCIA                   ;METROPOLITANA;0;0;0;0;0;0;0;0;0;Celular A51 128GB LIB OPEN AZUL;TELEFONIA
20273890;;M;22;CHILENO;;Millenial;N/D;N/D;0;0;0;0;0;0;0;0;0;Celular A20S LIB OPEN ROJO;TELEFONIA
7697254;;M;64;CHILENO;;Boomers;PADRE HURTADO                 ;METROPOLITANA;0;0;0;0;0;0;0;0;0;Celular A20S LIB OPEN ROJO;TELEFONIA
5484149;;F;87;CHILENO;;Silencioso;SALAMANCA                     ;COQUIMBO;0;0;0;0;0;0;0;0;0;Celular Y9 PRIME LIB OPEN VERDE;TELEFONIA
10817990;;M;55;CHILENO;;Boomers;RENCA                         ;METROPOLITANA;0;0;0;0;0;0;0;0;0;CELULAR SAMSUNG A21S AZUL OPEN;TELEFONIA
9863923;;M;59;CHILENO;;Boomers;YUMBEL                        ;BIO BIO;0;0;0;0;0;0;0;0;0;CELULAR MOTO ONE FUSION 64GB VERDE 64GB OPEN;TELEFONIA
11454307;;M;53;CHILENO;;X;SAN VICENTE                   ;L.G.B.OÂ´HIGGINS;0;0;0;0;0;0;0;0;0;Celular A01 LIB OPEN ROJO;TELEFONIA
16038634;;M;36;CHILENO;;Millenial;SAN PEDRO DE LA PAZ;BIO-BIO;0;0;0;0;0;0;0;0;0;Celular A10S LIB OPEN BLUE;TELEFONIA
6308666;;F;71;CHILENO;;Silencioso;COLLIPULLI                    ;ARAUCANIA;0;0;0;0;0;0;0;0;0;Celular Y9 PRIME LIB OPEN VERDE;TELEFONIA
9429664;;F;59;CHILENO;;Boomers;PROVIDENCIA                   ;METROPOLITANA;0;0;0;0;0;0;0;0;0;Celular A11 LIB OPEN BLACK;TELEFONIA
11115139;;M;55;CHILENO;;Boomers;PROVIDENCIA                   ;METROPOLITANA;0;0;0;0;0;0;0;0;0;Celular TIGER V SENIOR CLARO DIRECTO NEGRO;TELEFONIA
12010621;Soltero;M;51;CHILENO;TECNICO DIBUJO INDUSTRIAL;X;PROVIDENCIA                   ;METROPOLITANA;0;0;0;0;0;0;0;0;0;Celular Y9 PRIME LIB OPEN VERDE;TELEFONIA
23858603;;M;56;PERUANO;;Extranjero;RECOLETA                      ;METROPOLITANA;0;0;0;0;0;0;0;0;0;Celular G8 POWER LITE WOM DIRECTO TURQUESA;TELEFONIA
10812413;;F;54;CHILENO;;Boomers;"";"";26990;1;1;0;0;0;1;1;26990;SECADOR DE PELO SG-3049 NEGRO;PERSONAL CARE
7132568;;F;65;CHILENO;;Boomers;PUENTE ALTO                   ;METROPOLITANA;53980;2;2;0;0;0;2;2;53980;ALISADOR +SECADOR PELO;PERSONAL CARE
15971671;;M;37;CHILENO;;Millenial;N/D;N/D;66970;3;1;0;0;0;3;1;66970;CORTA PELO GC-615;PERSONAL CARE
15795535;;F;38;CHILENO;;Silencioso;PROVIDENCIA                   ;METROPOLITANA;265820;4;4;4;4;265820;0;0;0;DEPILADORA BRI920/00 IPL LUMEA ADVANCE;PERSONAL CARE
19213794;;M;26;CHILENO;;Z;CABILDO                       ;VALPARAISO;13990;1;1;0;0;0;1;1;13990;SECADOR DE PELO SG-3012C29 MORADO;PERSONAL CARE
18292006;;F;30;CHILENO;;Millenial;LOS ANGELES                   ;BIO BIO;39990;1;1;0;0;0;1;1;39990;DEPILADORA OASIS NEXT BVT;PERSONAL CARE
19395440;;F;25;CHILENO;;Z;PROVIDENCIA                   ;METROPOLITANA;160980;2;2;0;0;0;2;2;160980;SECADOR DE PELO SIEGEN SG-3035;PERSONAL CARE
9275689;;M;59;CHILENO;;Boomers;RENCA                         ;METROPOLITANA;21990;1;1;0;0;0;1;1;21990;SECADOR GAMA BORA KERATION;PERSONAL CARE
9689665;;F;60;CHILENO;;Boomers;SAGRADA FAMILIA               ;MAULE;420950;8;3;0;0;0;8;3;420950;SECADOR DE PELO SG-3051;PERSONAL CARE
15259025;;M;43;CHILENO;;Silencioso;PROVIDENCIA                   ;METROPOLITANA;24990;1;1;0;0;0;1;1;24990;SECADOR DE PELO SG-3043 DC CAFE 2200 WATTS;PERSONAL CARE
8958547;;F;62;CHILENO;;Boomers;MAIPU                         ;METROPOLITANA;211920;4;2;0;0;0;4;2;211920;SECADOR TEMPO TITAN KERATIN;PERSONAL CARE
17311430;;F;32;CHILENO;;Millenial;LO ESPEJO;METROPOLITANA;53940;6;2;6;2;53940;0;0;0;SECADOR DE PELO SG-3025 SILVER;PERSONAL CARE
15673064;;M;39;CHILENO;;Millenial;N/D;N/D;215230;3;2;0;0;0;3;2;215230;COMBO GAMA SECADOR+ALISADOR+CEPILLO;PERSONAL CARE
12349603;;M;49;CHILENO;;X;VALLENAR;ATACAMA;1258620;6;5;0;0;0;6;5;1258620;ALISADOR DE PELO SG-4651 ROJO;PERSONAL CARE
18653699;;F;28;CHILENO;;Millenial;PROVIDENCIA                   ;METROPOLITANA;353120;4;2;2;1;339980;2;1;13140;SECADOR DE PELO SG-3012C29 MORADO;PERSONAL CARE
16899509;;F;34;CHILENO;;Millenial;N/D;N/D;233029;6;2;0;0;0;6;2;233029;ALISADOR DE PELO SG-4651 ROJO;PERSONAL CARE
9802445;Casado;M;58;CHILENO;;Boomers;RENCA                         ;METROPOLITANA;14990;1;1;0;0;0;1;1;14990;SECADOR GAMA EOLIC MINI TRAVEL;PERSONAL CARE
18993820;;F;27;CHILENO;;Z;PUENTE ALTO;METROPOLITANA;43980;2;1;2;1;43980;0;0;0;ALISADOR DE PELO S12A(220) Shine Therapy PALTA M;PERSONAL CARE
10373364;;M;54;CHILENO;;Boomers;SAN PEDRO DE LA PAZ           ;BIO BIO;47990;1;1;0;0;0;1;1;47990;COMBO SIEGEN AFEITADORA + MULTISTYLER SG-8440;PERSONAL CARE
12753554;;M;47;CHILENO;;X;ANTOFAGASTA                   ;ANTOFAGASTA;1085960;4;2;0;0;0;4;2;1085960;CORTA PELO SG-8520;PERSONAL CARE
12082593;;M;53;CHILENO;;X;CABILDO                       ;VALPARAISO;672890;8;3;0;0;0;8;3;672890;COMBO SIEGEN AFEITADORA + MULTISTYLER SG-8440;PERSONAL CARE
13642301;;F;43;CHILENO;;X;ANTOFAGASTA                   ;ANTOFAGASTA;2139894;68;40;0;0;0;68;40;2139894;CORTA PELO SPORT GCX 623 BVT;PERSONAL CARE
15462608;;M;39;CHILENO;;X;COLINA                        ;METROPOLITANA;285590;7;3;0;0;0;7;3;285590;SECADOR DIAMOND 3D TITAN KERATIN;PERSONAL CARE
6767237;;M;67;CHILENO;;Boomers;TALAGANTE                     ;METROPOLITANA;337109;8;3;0;0;0;8;3;337109;SECADOR DE PELO SE-3049C01 FUCSIA;PERSONAL CARE
18890457;;F;27;CHILENO;;Millenial;RENGO                         ;L.G.B.OÂ´HIGGINS;47563;2;1;0;0;0;2;1;47563;DEPILADORA SG-9040;PERSONAL CARE
18495781;;F;28;CHILENO;;Millenial;"";"";23470;5;3;0;0;0;5;3;23470;AFEITADORA SPORT;PERSONAL CARE
13618705;;F;42;CHILENO;;X;ALTO HOSPICIO;TARAPACA;63970;3;2;0;0;0;3;2;63970;ALISADOR DE PELO SG-3540 MORADO MORADO;PERSONAL CARE
8448890;;F;64;CHILENO;;Boomers;LOS ANGELES                   ;BIO BIO;98980;2;2;0;0;0;2;2;98980;SECADOR DE PELO SG-3049 NEGRO;PERSONAL CARE
13916611;;F;42;CHILENO;;X;LA SERENA;COQUIMBO;95940;7;3;2;1;12980;5;2;82960;ALISADOR DE PELO SG-3540 MORADO MORADO;PERSONAL CARE
20322474;;F;22;CHILENO;;Z;LOS ANGELES;BIO-BIO;11990;1;1;0;0;0;1;1;11990;ONDULADOR SIEGEN SG-2352;PERSONAL CARE
10073924;;F;58;CHILENO;;Boomers;CURANILAHUE                   ;BIO BIO;980710;14;7;11;3;705740;3;4;274970;SECADOR DE PELO SG-3012 NEGRO;PERSONAL CARE
13722556;;F;43;CHILENO;;X;TALCA                         ;MAULE;14990;1;1;0;0;0;1;1;14990;SECADOR DIAMOND 3D TITAN KERATIN;PERSONAL CARE
17079814;Casado;F;33;CHILENO;;Millenial;PROVIDENCIA                   ;METROPOLITANA;34990;1;1;0;0;0;1;1;34990;AFEITADORA SG-7250 NEGRO;PERSONAL CARE
7810645;;F;65;CHILENO;;Boomers;LINARES                       ;MAULE;781263;12;8;0;0;0;12;8;781263;SECADOR DE PELO SG-3025 SILVER;PERSONAL CARE
10694535;;M;55;CHILENO;;Millenial;"";"";32990;1;1;0;0;0;1;1;32990;AFEITADORA S1223/41 ELECTRICA;PERSONAL CARE
7066759;Casado;M;68;CHILENO;OPERADOR AVANZADO DE HERRAMIAS COMPUTACIONLES;Silencioso;PAPUDO                        ;VALPARAISO;123980;2;2;0;0;0;2;2;123980;AFEITADORA SG-7210 NEGRO;PERSONAL CARE
5239337;;M;75;CHILENO;;Silencioso;SAN JAVIER                    ;MAULE;142970;3;3;0;0;0;3;3;142970;AFEITADORA S1223/41 ELECTRICA;PERSONAL CARE
20328282;;F;22;CHILENO;;Millenial;N/D;N/D;89980;3;2;0;0;0;3;2;89980;SECADOR DE PELO SE-3049C01 FUCSIA;PERSONAL CARE
14684102;;F;62;PERUANO;;Extranjero;SANTIAGO                      ;METROPOLITANA;96960;5;4;0;0;0;5;4;96960;ALISADOR DE PELO SG-3540 MORADO MORADO;PERSONAL CARE
10266627;;F;54;CHILENO;;Boomers;SAN CARLOS                    ;BIO BIO;340206;10;8;0;0;0;10;8;340206;ALISADOR DE PELO S6300 GRIS;PERSONAL CARE
27728797;;M;37;VENEZOLANO;;Millenial;"";"";28990;1;1;0;0;0;1;1;28990;ALISADOR +SECADOR PELO;PERSONAL CARE
12485454;;M;48;CHILENO;;X;ESTACION CENTRAL;METROPOLITANA;55980;2;1;0;0;0;2;1;55980;DEPILADORA SG-9004EX;PERSONAL CARE
8878405;;F;62;CHILENO;;Boomers;TALCA                         ;MAULE;335420;5;3;0;0;0;5;3;335420;SECADOR DE PELO SG-3051;PERSONAL CARE
10145453;;M;56;CHILENO;;Millenial;PUNITAQUI                     ;COQUIMBO;159960;4;3;0;0;0;4;3;159960;AFEITADORA GAMA SH 1527 WD;PERSONAL CARE
5790623;Casado;M;69;CHILENO;CONTADOR AUDITOR;Silencioso;RENCA                         ;METROPOLITANA;14990;1;1;0;0;0;1;1;14990;SECADOR DIAMOND 3D TITAN KERATIN;PERSONAL CARE
16436795;;F;36;CHILENO;;Millenial;N/D;N/D;13240;2;1;0;0;0;2;1;13240;SECADOR DE PELO SG-3012C29 MORADO;PERSONAL CARE
7639622;;F;66;CHILENO;;Boomers;SAN JAVIER                    ;MAULE;26990;1;1;0;0;0;1;1;26990;SECADOR DE PELO SG-3049 NEGRO;PERSONAL CARE
10448126;;F;57;CHILENO;;Boomers;PUTAENDO                      ;VALPARAISO;162970;3;3;0;0;0;3;3;162970;SECADOR DE PELO SG-3025 SILVER;PERSONAL CARE
11873588;;F;51;CHILENO;;X;PROVIDENCIA                   ;METROPOLITANA;22980;2;2;0;0;0;2;2;22980;SECADOR DE PELO SG-3012C29 MORADO;PERSONAL CARE
15053112;;F;39;CHILENO;;X;LA SERENA;COQUIMBO;29990;1;1;0;0;0;1;1;29990;Pack Depiladora BRE255/00 + Recortador HP6389/00;PERSONAL CARE
17835849;;F;31;CHILENO;;Millenial;"";"";26990;1;1;0;0;0;1;1;26990;SECADOR DE PELO SG-3049 NEGRO;PERSONAL CARE
20698080;;F;21;CHILENO;;Z;"";"";19990;1;1;0;0;0;1;1;19990;SECADOR DE PELO SIEGEN SG-3035;PERSONAL CARE
7732956;;F;65;CHILENO;;Boomers;NUNOA                         ;METROPOLITANA;534650;7;3;0;0;0;7;3;534650;SECADOR DE PELO SG-3051;PERSONAL CARE
18364654;;F;29;CHILENO;;Millenial;PROVIDENCIA                   ;METROPOLITANA;13990;1;1;0;0;0;1;1;13990;SECADOR DE PELO SG-3012C29 MORADO;PERSONAL CARE
15507311;;F;39;CHILENO;;X;"";"";138900;10;3;9;2;103910;1;1;34990;SECADOR DE PELO SG-3049 NEGRO;PERSONAL CARE
20364840;;M;21;CHILENO;;Z;PROVIDENCIA                   ;METROPOLITANA;29990;1;1;0;0;0;1;1;29990;SECADOR DE PELO SG-3049 NEGRO;PERSONAL CARE
17237348;Soltero;F;32;CHILENO;TECNOLOGA MEDICA;Millenial;VINA DEL MAR                  ;VALPARAISO;67960;4;3;3;2;47970;1;1;19990;ALISADOR +SECADOR PELO;PERSONAL CARE
18343354;Soltero;M;29;CHILENO;;Millenial;PROVIDENCIA                   ;METROPOLITANA;32970;3;2;0;0;0;3;2;32970;SECADOR DE PELO SG-3012 NEGRO;PERSONAL CARE
15797845;;F;43;CHILENO;;X;"";"";19990;1;1;0;0;0;1;1;19990;SECADOR DE PELO SIEGEN SG-3035;PERSONAL CARE
13340474;Casado;F;44;CHILENO;;X;PROVIDENCIA                   ;METROPOLITANA;69830;3;2;0;0;0;3;2;69830;ALISADOR DE PELO SG-3540 MORADO MORADO;PERSONAL CARE
6738364;;M;68;CHILENO;;Silencioso;TALCA                         ;MAULE;14990;1;1;0;0;0;1;1;14990;SECADOR DE PELO SG-3025 SILVER;PERSONAL CARE
15547170;Soltero;F;39;CHILENO;CONTADOR;X;RENCA                         ;METROPOLITANA;25980;2;2;0;0;0;2;2;25980;SECADOR DE PELO SE-3049C01 FUCSIA;PERSONAL CARE
13524508;;F;44;CHILENO;;X;SAN FERNANDO                  ;L.G.B.OÂ´HIGGINS;243973;3;2;0;0;0;3;2;243973;SPA PARA PIES SG-1560;PERSONAL CARE
8914849;Casado;F;58;CHILENO;TECNICO DE NIVEL SUPERIOR EN ENFERMERIA;Boomers;RENCA                         ;METROPOLITANA;58980;2;2;0;0;0;2;2;58980;AFEITADORA S1323/41 ELECTRICA;PERSONAL CARE
15469143;;F;40;CHILENO;;X;PROVIDENCIA                   ;METROPOLITANA;78710;3;1;0;0;0;3;1;78710;ALISADOR REMIG. WET2 S27A (BV) R;PERSONAL CARE
12518882;;M;49;CHILENO;;X;SAN VICENTE                   ;L.G.B.OÂ´HIGGINS;169980;2;2;0;0;0;2;2;169980;AFEITADORA SPORT SH 886 BAT;PERSONAL CARE
12447377;;M;48;CHILENO;;X;LA SERENA;COQUIMBO;204981;3;2;0;0;0;3;2;204981;CORTAPELO GAMA TITANIUM T827;PERSONAL CARE
17337801;;M;32;CHILENO;;Millenial;N/D;N/D;1099840;16;9;13;6;1021870;3;3;77970;SECADOR DE PELO SG-3049 NEGRO;PERSONAL CARE
13599147;;F;43;CHILENO;;X;PROVIDENCIA                   ;METROPOLITANA;14990;1;1;0;0;0;1;1;14990;SECADOR DE PELO SG-3025 SILVER;PERSONAL CARE
10546977;;F;54;CHILENO;;Boomers;ANTOFAGASTA                   ;ANTOFAGASTA;133980;2;2;0;0;0;2;2;133980;SECADOR DE PELO SG-3012C23 VERDE;PERSONAL CARE
19032700;Soltero;F;27;CHILENO;;Extranjero;PROVIDENCIA                   ;N/D;12990;1;1;0;0;0;1;1;12990;SECADOR DE PELO SG-3012 NEGRO;PERSONAL CARE
17679070;Soltero;F;31;CHILENO;NUTRICIONISTA;Millenial;PROVIDENCIA                   ;METROPOLITANA;31970;3;2;3;2;31970;0;0;0;SECADOR DE PELO SG-3012C23 VERDE;PERSONAL CARE
16206379;;F;36;CHILENO;;Millenial;ANCUD                         ;LOS LAGOS;505640;14;7;0;0;0;14;7;505640;ALISADOR DE PELO SG-3510 FUCSIA;PERSONAL CARE
12604648;;F;50;CHILENO;;X;MELIPILLA                     ;METROPOLITANA;17990;1;1;0;0;0;1;1;17990;CORTAPELO SPORT 544;PERSONAL CARE
3752531;;M;87;CHILENO;;Silencioso;LA LIGUA                      ;VALPARAISO;47980;2;2;0;0;0;2;2;47980;AFEITADORA SG-7210 NEGRO;PERSONAL CARE
16733568;;F;34;CHILENO;;Millenial;VALLENAR;ATACAMA;97970;3;2;0;0;0;3;2;97970;SECADOR DE VIAJE REMINGTON D2400;PERSONAL CARE
20614752;;F;21;CHILENO;;Z;LO ESPEJO;METROPOLITANA;58980;2;1;0;0;0;2;1;58980;DEPILADORA SG-9004EX;PERSONAL CARE
14008580;;F;52;CHILENO;;X;MELIPILLA                     ;METROPOLITANA;562720;4;2;0;0;0;4;2;562720;SECADOR DE PELO SIEGEN SG-3035;PERSONAL CARE
26689819;;M;35;VENEZOLANO;;Extranjero;N/D;N/D;50980;2;1;0;0;0;2;1;50980;ALISADOR AQUA THERAPY LED;PERSONAL CARE
15931148;;M;36;CHILENO;;Millenial;N/D;N/D;13990;1;1;0;0;0;1;1;13990;SECADOR DE PELO SG-3012 NEGRO;PERSONAL CARE
13993314;;M;41;CHILENO;;X;PROVIDENCIA                   ;METROPOLITANA;291960;4;4;0;0;0;4;4;291960;SECADOR DE PELO SG-3049 NEGRO;PERSONAL CARE
16735950;;F;34;CHILENO;;Millenial;N/D;N/D;77890;3;2;0;0;0;3;2;77890;ALISADOR X-WIDE DIGITAL KERATION;PERSONAL CARE
7870720;;F;66;CHILENO;;Boomers;PROVIDENCIA                   ;METROPOLITANA;27590;2;1;0;0;0;2;1;27590;SECADOR DIAMOND STD;PERSONAL CARE
8964765;;M;62;CHILENO;;Boomers;PROVIDENCIA                   ;METROPOLITANA;24990;1;1;0;0;0;1;1;24990;CORTAPELOS GM 596;PERSONAL CARE
11891531;;M;51;CHILENO;;X;RENCA                         ;METROPOLITANA;16990;1;1;0;0;0;1;1;16990;SECADOR DIAMOND STD;PERSONAL CARE
17370818;;F;32;CHILENO;;Millenial;CANETE                        ;BIO BIO;209960;4;3;0;0;0;4;3;209960;CORTA PELO SG-8520;PERSONAL CARE
18505547;;M;30;CHILENO;;Millenial;ARAUCO                        ;BIO BIO;1016011;4;3;0;0;0;4;3;1016011;AFEITADORA SPORT SH 886 BAT;PERSONAL CARE
19448620;;F;25;CHILENO;;Z;SAN FELIPE                    ;VALPARAISO;571980;2;2;1;1;549990;1;1;21990;DEPILADORA BRE225/00;PERSONAL CARE
19659431;;M;25;CHILENO;;Z;SAN ANTONIO                   ;VALPARAISO;20240;2;2;1;1;19990;1;1;250;CORTA PELO SG-8520;PERSONAL CARE
19016810;;F;27;CHILENO;;Z;MELIPILLA                     ;METROPOLITANA;244970;3;3;0;0;0;3;3;244970;CORTA PELO HC3505;PERSONAL CARE
18877693;Soltero;M;27;CHILENO;;Millenial;PROVIDENCIA                   ;METROPOLITANA;46980;2;2;1;1;19990;1;1;26990;SECADOR DE PELO SE-3049C01 FUCSIA;PERSONAL CARE
8583990;;M;62;CHILENO;;Boomers;PROVIDENCIA                   ;METROPOLITANA;44990;1;1;0;0;0;1;1;44990;AFEITADORA S1323/41 ELECTRICA;PERSONAL CARE
15188840;Soltero;M;40;CHILENO;;X;CORONEL                       ;BIO BIO;646950;5;2;0;0;0;5;2;646950;AFEITADORA SG-7210 NEGRO;PERSONAL CARE
12848570;Casado;F;47;CHILENO;;X;RENCA                         ;METROPOLITANA;14990;1;1;0;0;0;1;1;14990;SECADOR DE PELO D3019 PRO TITANIO;PERSONAL CARE
19363406;Soltero;F;26;CHILENO;;Z;PROVIDENCIA                   ;METROPOLITANA;19990;1;1;0;0;0;1;1;19990;Secador de Pelo 3000 Series Philips BHD340/10;PERSONAL CARE
17328891;;F;35;CHILENO;;Millenial;PROVIDENCIA                   ;METROPOLITANA;39990;1;1;1;1;39990;0;0;0;COMBO SIEGEN AFEITADORA + MULTISTYLER SG-8440;PERSONAL CARE
18971308;;F;27;CHILENO;;Z;CABILDO                       ;VALPARAISO;724960;4;3;0;0;0;4;3;724960;COMBO SIEGEN AFEITADORA + MULTISTYLER SG-8440;PERSONAL CARE
20229737;;F;23;CHILENO;;Z;SAN JAVIER                    ;MAULE;29990;1;1;0;0;0;1;1;29990;AFEITADORA SG-7250 NEGRO;PERSONAL CARE
18973768;Soltero;M;27;CHILENO;;Z;LOS ANDES                     ;VALPARAISO;109980;2;2;0;0;0;2;2;109980;Secador de Pelo 3000 Series Philips BHD340/10;PERSONAL CARE
6271935;;F;74;CHILENO;;Silencioso;NUEVA IMPERIAL                ;ARAUCANIA;383830;9;4;0;0;0;9;4;383830;SECADOR DE PELO SG-3012C23 VERDE;PERSONAL CARE
16040449;;M;37;CHILENO;;Millenial;N/D;N/D;38990;1;1;0;0;0;1;1;38990;ALISADOR REMIG. WET2 S27A (BV) R;PERSONAL CARE
13788605;;F;41;CHILENO;;X;CAUQUENES                     ;MAULE;216960;4;4;0;0;0;4;4;216960;COMBO GAMA SECADOR+ALISADOR+CEPILLO;PERSONAL CARE
12578810;;F;48;CHILENO;;X;PROVIDENCIA                   ;METROPOLITANA;19990;1;1;0;0;0;1;1;19990;AFEITADORA SG-7210 NEGRO;PERSONAL CARE
19365225;;F;25;CHILENO;;Z;PROVIDENCIA                   ;METROPOLITANA;50980;2;1;2;1;50980;0;0;0;ALISADOR DE PELO SG-4651 ROJO;PERSONAL CARE
19695214;;F;24;CHILENO;;Z;NATALES;MAGALLANES;60130;3;2;1;1;34990;2;1;25140;AFEITADORA SG-7250 NEGRO;PERSONAL CARE
15001054;;F;51;CHILENO;;X;ARICA                         ;ARICA Y PARINACOTA;35230;3;1;0;0;0;3;1;35230;SECADOR DE PELO SIEGEN SG-3035;PERSONAL CARE
7952268;;F;66;CHILENO;;Boomers;SANTA CRUZ                    ;L.G.B.OÂ´HIGGINS;88070;2;2;0;0;0;2;2;88070;DEPILADORA 3170 BRAUN;PERSONAL CARE
11581509;;M;52;CHILENO;;X;PAINE                         ;METROPOLITANA;497160;8;5;0;0;0;8;5;497160;COMBO SIEGEN AFEITADORA + MULTISTYLER SG-8440;PERSONAL CARE
16325878;;F;35;CHILENO;;Millenial;OVALLE                        ;COQUIMBO;28980;2;2;0;0;0;2;2;28980;SECADOR DE PELO MISTRAL STD;PERSONAL CARE
18441748;;F;29;CHILENO;;Millenial;N/D;N/D;439180;6;5;0;0;0;6;5;439180;SECADOR DE PELO SG-3049 NEGRO;PERSONAL CARE
13720827;Casado;M;42;CHILENO;;X;PROVIDENCIA                   ;METROPOLITANA;164980;2;2;1;1;149990;1;1;14990;CORTA PELO SG-8200;PERSONAL CARE
17657465;;F;31;CHILENO;;Millenial;LA LIGUA                      ;VALPARAISO;93463;3;2;0;0;0;3;2;93463;SECADOR DE PELO SG-3049 NEGRO;PERSONAL CARE
14349069;;F;48;CHILENO;;X;PROVIDENCIA                   ;METROPOLITANA;26990;1;1;0;0;0;1;1;26990;SECADOR TEMPO TITAN KERATIN;PERSONAL CARE
19120758;;F;28;CHILENO;;Millenial;CORONEL                       ;BIO BIO;72140;4;3;0;0;0;4;3;72140;CORTA PELO SG-8520;PERSONAL CARE
15045212;;F;40;CHILENO;;X;MONTE PATRIA                  ;COQUIMBO;12990;1;1;0;0;0;1;1;12990;SECADOR DE PELO SG-3012C29 MORADO;PERSONAL CARE
18477344;;F;28;CHILENO;;Millenial;"";"";203980;2;2;0;0;0;2;2;203980;SECADOR DE PELO SG-3012C23 VERDE;PERSONAL CARE
13355566;;F;43;CHILENO;;X;PROVIDENCIA                   ;METROPOLITANA;21990;1;1;0;0;0;1;1;21990;SECADOR GAMA BORA KERATION;PERSONAL CARE
16636917;;M;35;CHILENO;;Millenial;RENCA                         ;METROPOLITANA;33980;2;1;2;1;33980;0;0;0;COMBO GAMA SECADOR+ALISADOR+CEPILLO;PERSONAL CARE
16006954;Soltero;F;37;CHILENO;;Millenial;PROVIDENCIA                   ;METROPOLITANA;29990;1;1;0;0;0;1;1;29990;SECADOR DE PELO SG-3049 NEGRO;PERSONAL CARE
14363684;;M;41;CHILENO;;Millenial;"";"";35000;2;1;0;0;0;2;1;35000;ALISADOR AQUA THERAPY LED;PERSONAL CARE
18254994;;F;29;CHILENO;;Millenial;ILLAPEL                       ;COQUIMBO;667680;7;6;1;1;189990;6;5;477690;AFEITADORA SG-7250 NEGRO;PERSONAL CARE
17509229;Soltero;M;32;CHILENO;CONTADOR AUDITOR;Millenial;SAN CLEMENTE                  ;MAULE;34561;2;2;0;0;0;2;2;34561;AFEITADORA SPORT;PERSONAL CARE
3700209;;F;84;CHILENO;;Silencioso;TALAGANTE                     ;METROPOLITANA;1554250;4;2;0;0;0;4;2;1554250;ALISADOR X-WIDE DIGITAL KERATION;PERSONAL CARE
15173308;Soltero;M;39;CHILENO;;X;PROVIDENCIA                   ;METROPOLITANA;28230;3;2;0;0;0;3;2;28230;CORTA PELO SG-8200;PERSONAL CARE
16090610;;F;36;CHILENO;;Millenial;CONSTITUCION                  ;MAULE;209870;5;3;0;0;0;5;3;209870;SECADOR DE PELO SIEGEN SG-3035;PERSONAL CARE
7437535;;F;69;CHILENO;;Silencioso;LA CISTERNA                   ;METROPOLITANA;67970;3;3;0;0;0;3;3;67970;ALISADOR MATCHA;PERSONAL CARE
26221857;;M;35;PERUANO;;Extranjero;"";"";61970;3;3;0;0;0;3;3;61970;AFEITADORA SG-7250 NEGRO;PERSONAL CARE
9483031;;M;60;CHILENO;;Boomers;SAN MIGUEL;METROPOLITANA;21990;1;1;1;1;21990;0;0;0;AFEITADORA GAMA SH 860;PERSONAL CARE
16314072;;M;35;CHILENO;;Millenial;ILLAPEL                       ;COQUIMBO;480972;3;4;1;1;119990;2;3;360982;SECADOR DE PELO SG-3043 DC CAFE 2200 WATTS;PERSONAL CARE
7072684;;M;65;CHILENO;;Boomers;PROVIDENCIA                   ;METROPOLITANA;19990;1;1;0;0;0;1;1;19990;ALISADOR DE PELO SG-3510 FUCSIA;PERSONAL CARE
7889744;;F;51;CHILENO;;X;VILLA ALEMANA                 ;VALPARAISO;448920;7;5;3;1;284960;4;4;163960;SECADOR DE PELO SG-3012C23 VERDE;PERSONAL CARE
11090419;;F;55;CHILENO;;Boomers;NUEVA IMPERIAL                ;ARAUCANIA;14990;1;1;0;0;0;1;1;14990;SECADOR DE PELO SG-3012 NEGRO;PERSONAL CARE
15699329;;F;39;CHILENO;;X;NIQUEN                        ;BIO BIO;83350;4;2;0;0;0;4;2;83350;SECADOR DE PELO SG-3049 NEGRO;PERSONAL CARE
16104233;Soltero;F;37;CHILENO;;Millenial;QUILPUE;VALPARAISO;64980;2;1;2;1;64980;0;0;0;ALISADOR SIEGEN SG-4716;PERSONAL CARE
12305931;;F;49;CHILENO;;X;PROVIDENCIA                   ;METROPOLITANA;12990;1;1;0;0;0;1;1;12990;SECADOR GAMA EOLIC MINI TRAVEL;PERSONAL CARE
10639168;;F;57;CHILENO;;Boomers;VALLENAR;ATACAMA;14990;1;1;0;0;0;1;1;14990;SECADOR DE PELO SG-3012C29 MORADO;PERSONAL CARE
20185522;;M;22;CHILENO;;Millenial;VILLA ALEMANA                 ;VALPARAISO;356950;5;2;0;0;0;5;2;356950;CORTA PELO SG-8200;PERSONAL CARE
16486672;;F;35;CHILENO;;Millenial;VALPARAISO                    ;VALPARAISO;44980;2;1;0;0;0;2;1;44980;CORTA PELO SPORT GCX 623 BVT;PERSONAL CARE
11290176;;F;53;CHILENO;;X;SAN CARLOS                    ;BIO BIO;150883;2;2;0;0;0;2;2;150883;ALISADOR AQUA THERAPY LED;PERSONAL CARE
15160559;;F;40;CHILENO;;X;PROVIDENCIA                   ;METROPOLITANA;28990;1;1;0;0;0;1;1;28990;SECADOR DE PELO SG-3049 NEGRO;PERSONAL CARE
20565442;;F;21;CHILENO;;Z;PROVIDENCIA                   ;METROPOLITANA;54980;2;2;1;1;14990;1;1;39990;SECADOR GAMA BORA KERATION;PERSONAL CARE
18135260;Soltero;M;30;CHILENO;;Millenial;PROVIDENCIA                   ;METROPOLITANA;50980;2;2;0;0;0;2;2;50980;SECADOR DE PELO SG-3043 DC CAFE 2200 WATTS;PERSONAL CARE
15599806;;F;39;CHILENO;;X;PANGUIPULLI                   ;LOS RIOS;17990;1;1;0;0;0;1;1;17990;ALISADOR DE PELO SG-3510 FUCSIA;PERSONAL CARE
17966038;;F;31;CHILENO;;Millenial;N/D;N/D;49970;3;2;1;1;24990;2;1;24980;COMBO GAMA SECADOR+ALISADOR+CEPILLO;PERSONAL CARE
19116559;Soltero;F;27;CHILENO;FONOAUDIOLOGA;Z;PROVIDENCIA                   ;METROPOLITANA;14990;1;1;1;1;14990;0;0;0;SECADOR DE PELO SG-3025 SILVER;PERSONAL CARE
16958270;;F;33;CHILENO;;Millenial;RENCA                         ;METROPOLITANA;12990;1;1;0;0;0;1;1;12990;SECADOR DE PELO SG-3012C29 MORADO;PERSONAL CARE
25930881;;M;36;PERUANO;;Extranjero;INDEPENDENCIA                 ;METROPOLITANA;504960;5;4;0;0;0;5;4;504960;KIT CORTABARBA MG3731;PERSONAL CARE
24341727;;F;31;PERUANO;;Extranjero;ARICA                         ;ARICA Y PARINACOTA;64980;2;2;0;0;0;2;2;64980;Pack Depiladora BRE255/00 + Recortador HP6389/00;PERSONAL CARE
18314447;;F;29;CHILENO;;Millenial;ARICA                         ;ARICA Y PARINACOTA;42980;2;1;2;1;42980;0;0;0;COMBO GAMA SECADOR+ALISADOR+CEPILLO;PERSONAL CARE
19895672;;M;24;CHILENO;;Z;PROVIDENCIA                   ;METROPOLITANA;213980;2;2;1;1;199990;1;1;13990;SECADOR DE PELO SG-3012C23 VERDE;PERSONAL CARE
27116232;;M;30;CHILENO;;Extranjero;"";"";167970;3;4;0;0;0;3;4;167970;SECADOR DE PELO SG-3025 SILVER;PERSONAL CARE
13894252;;F;42;CHILENO;;X;SANTIAGO                      ;METROPOLITANA;25240;2;1;0;0;0;2;1;25240;ALISADOR MATCHA;PERSONAL CARE
8896149;;M;63;CHILENO;;Boomers;PUERTO MONTT                  ;LOS LAGOS;22140;2;1;0;0;0;2;1;22140;AFEITADORA SG-7210 NEGRO;PERSONAL CARE
6099351;;F;72;CHILENO;;Silencioso;N/D;N/D;407940;6;3;0;0;0;6;3;407940;CORTA PELO SG-8410;PERSONAL CARE
16275872;;F;36;CHILENO;;Millenial;LO ESPEJO                     ;METROPOLITANA;54990;1;1;1;1;54990;0;0;0;ALISADOR DE PELO SG-4651 ROJO;PERSONAL CARE
19881043;;F;24;CHILENO;;Z;BUIN                          ;METROPOLITANA;23980;2;1;2;1;23980;0;0;0;ALISADOR MATCHA;PERSONAL CARE
19901866;;F;24;CHILENO;;Z;LINARES                       ;MAULE;125970;3;2;0;0;0;3;2;125970;SECADOR DE PELO STD TITAN KERATIN PLATA;PERSONAL CARE
7899519;;M;64;CHILENO;;Boomers;RENCA                         ;METROPOLITANA;226970;3;3;0;0;0;3;3;226970;SECADOR DE PELO SG-3051;PERSONAL CARE
16319201;;M;36;CHILENO;;Millenial;VALDIVIA                      ;LOS LAGOS;33150;3;1;0;0;0;3;1;33150;AFEITADORA S1223/41 ELECTRICA;PERSONAL CARE
7138878;;F;67;CHILENO;;Boomers;COQUIMBO                      ;COQUIMBO;19990;1;1;0;0;0;1;1;19990;SECADOR GAMA BRILLIAN AQUA;PERSONAL CARE
16803307;;F;34;CHILENO;;Millenial;CASTRO                        ;LOS LAGOS;249980;2;2;0;0;0;2;2;249980;SECADOR DE PELO SIEGEN SG-3035;PERSONAL CARE
10348579;;F;57;CHILENO;;Extranjero;VILLARICA                     ;ARAUCANIA;22980;2;2;0;0;0;2;2;22980;SECADOR DE PELO SG-3025 SILVER;PERSONAL CARE
12942744;Divorciado;F;46;CHILENO;;X;RENCA                         ;METROPOLITANA;24990;1;1;0;0;0;1;1;24990;ALISADOR +SECADOR PELO;PERSONAL CARE
7915289;;M;64;CHILENO;;Boomers;PUNTA ARENAS                  ;MAGALLANES;294120;6;3;0;0;0;6;3;294120;CORTA PELO SPORT GCX 623 BVT;PERSONAL CARE
20068144;;F;22;CHILENO;;Z;OLMUE                         ;VALPARAISO;12990;2;1;0;0;0;2;1;12990;SECADOR DE PELO SG-3012C29 MORADO;PERSONAL CARE
10296923;Soltero;M;55;CHILENO;;Boomers;RENCA                         ;METROPOLITANA;35240;2;1;0;0;0;2;1;35240;TRICOMBO SECADOR+ALISADOR+ONDULADOR;PERSONAL CARE
18229927;;F;30;CHILENO;;Millenial;PROVIDENCIA                   ;METROPOLITANA;1342760;10;10;3;2;535830;7;8;806930;SECADOR DE PELO SG-3049 NEGRO;PERSONAL CARE
13744471;;M;42;CHILENO;;X;TOCOPILLA                     ;ANTOFAGASTA;501850;4;2;0;0;0;4;2;501850;SECADOR GAMA BORA KERATION;PERSONAL CARE
12233843;Casado;F;50;CHILENO;;X;COIHAIQUE                     ;AYSEN;79980;2;1;2;1;79980;0;0;0;ALISADOR SIEGEN SG-4716;PERSONAL CARE
16665843;;F;35;CHILENO;;Millenial;N/D;N/D;619940;7;2;7;2;619940;0;0;0;SECADOR DE PELO SG-3025 SILVER;PERSONAL CARE
13401770;;M;46;CHILENO;;X;COIHAIQUE                     ;AYSEN;164980;2;2;0;0;0;2;2;164980;ALISADOR +SECADOR PELO;PERSONAL CARE
11184934;;F;55;CHILENO;;Boomers;MELIPILLA                     ;METROPOLITANA;1315960;5;3;4;2;1286970;1;1;28990;CORTA PELO MGK3220 BLACK BOX MN;PERSONAL CARE
19042536;Soltero;M;27;CHILENO;;Z;PROVIDENCIA                   ;METROPOLITANA;24990;1;1;0;0;0;1;1;24990;CORTA PELO SG-8410;PERSONAL CARE
26122549;;M;38;HAITIANO;;Extranjero;"";"";310830;7;7;2;1;150980;5;6;159850;KIT CORTABARBA MG3731;PERSONAL CARE
14487444;;F;44;CHILENO;;X;N/D;N/D;51980;2;2;0;0;0;2;2;51980;SECADOR DE PELO SG-3051;PERSONAL CARE
16781125;;F;34;CHILENO;;Millenial;N/D;N/D;34980;2;1;0;0;0;2;1;34980;DEPILADORA SG-9003;PERSONAL CARE
11693680;;F;51;CHILENO;;X;SAN BERNARDO                  ;METROPOLITANA;495710;5;2;0;0;0;5;2;495710;ALISADOR DE PELO SG-4651 ROJO;PERSONAL CARE
10811840;;F;44;CHILENO;;X;VILLA ALEGRE                  ;MAULE;51970;3;2;0;0;0;3;2;51970;SECADOR DE PELO SE-3049C01 FUCSIA;PERSONAL CARE
13335511;Soltero;F;44;CHILENO;CONTADOR AUDITOR;X;COIHAIQUE                     ;AYSEN;59250;2;1;0;0;0;2;1;59250;TRICOMBO SECADOR+ALISADOR+ONDULAD;PERSONAL CARE
15507012;;F;39;CHILENO;;X;QUELLON                       ;LOS LAGOS;68980;2;1;0;0;0;2;1;68980;ALISADOR DE PELO SG-3540 MORADO MORADO;PERSONAL CARE
19642646;;F;24;CHILENO;;Z;PROVIDENCIA                   ;METROPOLITANA;159980;2;2;1;1;139990;1;1;19990;SECADOR GAMA BRILLIAN AQUA;PERSONAL CARE
12483786;;M;48;CHILENO;;X;SANTA CRUZ                    ;L.G.B.OÂ´HIGGINS;16990;1;1;0;0;0;1;1;16990;CORTA PELO SG-8200;PERSONAL CARE
15298712;;F;40;CHILENO;;X;PROVIDENCIA                   ;METROPOLITANA;88980;2;1;2;1;88980;0;0;0;DEPILADORA IPL MAGNA PK;PERSONAL CARE
11574125;;F;51;CHILENO;;X;HUALPEN;BIO BIO;15990;1;1;0;0;0;1;1;15990;SECADOR DE PELO SG-3025 SILVER;PERSONAL CARE
11665170;;M;52;CHILENO;;X;PAINE                         ;METROPOLITANA;49990;1;1;0;0;0;1;1;49990;COMBO SIEGEN AFEITADORA + MULTISTYLER SG-8440;PERSONAL CARE
13174989;;M;45;CHILENO;;Millenial;N/D;N/D;397380;12;9;0;0;0;12;9;397380;DEPILADORA SG-9040;PERSONAL CARE
19153416;;F;26;CHILENO;;Z;VILLA ALEMANA;VALPARAISO;13980;2;1;2;1;13980;0;0;0;SECADOR DE PELO SG-3012 NEGRO;PERSONAL CARE
13389145;;F;44;CHILENO;;X;SAN BERNARDO                  ;METROPOLITANA;216250;5;3;0;0;0;5;3;216250;AFEITADORA SG-7210 NEGRO;PERSONAL CARE
19050496;;F;27;CHILENO;;Z;PROVIDENCIA                   ;METROPOLITANA;24990;1;1;0;0;0;1;1;24990;ALISADOR +SECADOR PELO;PERSONAL CARE
13981365;;F;40;CHILENO;;X;PUTAENDO                      ;VALPARAISO;24990;1;1;0;0;0;1;1;24990;ALISADOR +SECADOR PELO;PERSONAL CARE
17865475;Soltero;M;32;CHILENO;;Millenial;PROVIDENCIA                   ;METROPOLITANA;12990;1;1;0;0;0;1;1;12990;CORTA PELO SPORT GC 542 BVT;PERSONAL CARE
7171853;;M;67;CHILENO;;Boomers;VILLA ALEMANA                 ;VALPARAISO;16990;1;1;0;0;0;1;1;16990;SECADOR DIAMOND STD;PERSONAL CARE
15397184;;F;38;CHILENO;;Millenial;N/D;N/D;24990;1;1;0;0;0;1;1;24990;ALISADOR +SECADOR PELO;PERSONAL CARE
10675591;;F;57;CHILENO;;Boomers;PUERTO MONTT                  ;LOS LAGOS;34990;1;1;0;0;0;1;1;34990;AFEITADORA SG-7250 NEGRO;PERSONAL CARE
8605112;;F;63;CHILENO;;Boomers;ARICA                         ;TARAPACA;304970;3;2;0;0;0;3;2;304970;CORTA PELO HC-5850;PERSONAL CARE
15533394;Soltero;M;38;CHILENO;;X;PROVIDENCIA                   ;METROPOLITANA;1027900;9;4;9;4;1027900;0;0;0;AFEITADORA SPORT;PERSONAL CARE
9459348;;M;57;CHILENO;;Boomers;LOTA                          ;BIO BIO;67481;2;2;0;0;0;2;2;67481;ALISADOR DE PELO SG-3540 MORADO MORADO;PERSONAL CARE
19010237;;F;26;CHILENO;;Z;SAN JAVIER                    ;MAULE;29990;1;1;0;0;0;1;1;29990;ALISADOR DE PELO SG-3540 MORADO MORADO;PERSONAL CARE
16202379;;M;36;CHILENO;;Millenial;N/D;N/D;52970;3;2;0;0;0;3;2;52970;CORTA PELO SPORT GCX 623 BVT;PERSONAL CARE
15404359;;F;42;CHILENO;;X;SAN PEDRO                     ;METROPOLITANA;18990;1;1;0;0;0;1;1;18990;SECADOR DE PELO D3019 PRO TITANIO;PERSONAL CARE
25665477;;F;44;COLOMBIANO;;Extranjero;N/D;N/D;21990;1;1;0;0;0;1;1;21990;ALISADOR DE PELO SG-3510 FUCSIA;PERSONAL CARE
10017189;;F;54;CHILENO;;Boomers;LOTA                          ;BIO BIO;20990;1;1;0;0;0;1;1;20990;SECADOR DE PELO SIEGEN SG-3035;PERSONAL CARE
13390650;;F;44;CHILENO;;X;LOS ALAMOS                    ;BIO BIO;69970;3;3;0;0;0;3;3;69970;SECADOR DE PELO SE-3049C01 FUCSIA;PERSONAL CARE
6107753;;M;74;CHILENO;;Silencioso;RENCA                         ;METROPOLITANA;38980;2;3;0;0;0;2;3;38980;AFEITADORA S1121/41 ELECTRICA;PERSONAL CARE
11253955;;F;54;CHILENO;;X;PROVIDENCIA                   ;METROPOLITANA;22990;1;1;0;0;0;1;1;22990;ALISADORA SIEGEN SG-3512D2;PERSONAL CARE
17041518;;F;33;CHILENO;;Millenial;PROVIDENCIA                   ;METROPOLITANA;36990;1;1;0;0;0;1;1;36990;AFEITADORA SG-7250 NEGRO;PERSONAL CARE
10549586;;F;54;CHILENO;;X;LA LIGUA                      ;VALPARAISO;29990;1;1;0;0;0;1;1;29990;SECADOR DE PELO SG-3051;PERSONAL CARE
12376503;;F;49;CHILENO;;X;RENCA                         ;METROPOLITANA;20990;1;1;0;0;0;1;1;20990;SECADOR DE PELO SIEGEN SG-3035;PERSONAL CARE
19654511;;F;22;CHILENO;;Z;PETORCA;VALPARAISO;54990;1;1;0;0;0;1;1;54990;ALISADOR DE PELO SG-4651 ROJO;PERSONAL CARE
13500081;;F;44;CHILENO;;X;PROVIDENCIA                   ;METROPOLITANA;26980;2;1;0;0;0;2;1;26980;SECADOR DE PELO MISTRAL STD;PERSONAL CARE
19537090;;M;24;CHILENO;;Z;"";"";133950;5;1;0;0;0;5;1;133950;ALISADOR DE PELO S12A(220) Shine Therapy PALTA M;PERSONAL CARE
16049555;;F;36;CHILENO;;Millenial;N/D;N/D;22990;1;1;0;0;0;1;1;22990;SECADOR GAMA BORA KERATION;PERSONAL CARE
7856543;;F;66;CHILENO;;Boomers;LA LIGUA                      ;VALPARAISO;36990;1;1;0;0;0;1;1;36990;DEPILADORA SG-9004;PERSONAL CARE
15062051;Soltero;M;40;CHILENO;;X;RENCA                         ;METROPOLITANA;9990;1;1;0;0;0;1;1;9990;Trimmer Gama GT 527;PERSONAL CARE
14036767;;F;41;CHILENO;;X;N/D;N/D;262970;3;3;0;0;0;3;3;262970;ALISADOR DE PELO S12A(220) Shine Therapy PALTA M;PERSONAL CARE
17875092;;F;30;CHILENO;;Millenial;SAN VICENTE                   ;L.G.B.OÂ´HIGGINS;450510;4;2;3;1;433520;1;1;16990;CORTA PELO SG-8200;PERSONAL CARE
12044580;;M;54;CHILENO;;Boomers;NATALES                       ;MAGALLANES;30990;1;1;0;0;0;1;1;30990;AFEITADORA QP2521/50 ONE BLADE GRAFITO;PERSONAL CARE
19267407;;F;26;CHILENO;;Z;LOS ANDES                     ;VALPARAISO;144980;4;2;0;0;0;4;2;144980;ALISADOR REMIG. WET2 S27A (BV) R;PERSONAL CARE
6045274;;M;72;CHILENO;;Silencioso;RENCA                         ;METROPOLITANA;16990;1;1;0;0;0;1;1;16990;CORTA PELO HC3505;PERSONAL CARE
13769085;;M;41;CHILENO;;X;SAN ANTONIO                   ;VALPARAISO;9990;1;1;0;0;0;1;1;9990;SECADOR PHILIPS BHC010;PERSONAL CARE
14216935;;F;44;CHILENO;;X;N/D;N/D;520960;4;3;2;1;384980;2;2;135980;SECADOR DE PELO SG-3025 SILVER;PERSONAL CARE
10566404;;M;57;CHILENO;;Boomers;PICHILEMU                     ;L.G.B.OÂ´HIGGINS;30000;2;1;0;0;0;2;1;30000;AFEITADORA SG-7250 NEGRO;PERSONAL CARE
14100914;;F;41;CHILENO;;X;CURACAVI                      ;METROPOLITANA;42980;2;2;0;0;0;2;2;42980;DEPILADORA OASIS LOOK BVT;PERSONAL CARE
20416555;;F;40;CHILENO;;X;PROVIDENCIA                   ;METROPOLITANA;14990;1;1;0;0;0;1;1;14990;CORTAPELO GAMA TITANIUM T827;PERSONAL CARE
12819000;;F;46;CHILENO;;X;NOGALES                       ;VALPARAISO;24990;1;1;0;0;0;1;1;24990;ALISADOR DE PELO SG-3512D1 ROSA;PERSONAL CARE
16024417;;F;37;CHILENO;;Millenial;PROVIDENCIA                   ;METROPOLITANA;17990;1;1;0;0;0;1;1;17990;SECADOR DE VIAJE REMINGTON D2400;PERSONAL CARE
6628086;;M;68;CHILENO;;Boomers;RENCA                         ;METROPOLITANA;22990;1;1;0;0;0;1;1;22990;AFEITADORA SPORT SH 886 BAT;PERSONAL CARE
13999384;;M;41;CHILENO;;X;VILLA ALEMANA                 ;VALPARAISO;214980;2;2;0;0;0;2;2;214980;SECADOR DE PELO MISTRAL STD;PERSONAL CARE
12969998;Divorciado;F;45;CHILENO;PROFESOR;X;RENCA                         ;METROPOLITANA;10990;1;1;0;0;0;1;1;10990;SECADOR PHILIPS BHC010;PERSONAL CARE
16575245;;F;34;CHILENO;;Millenial;PROVIDENCIA                   ;METROPOLITANA;29990;1;1;0;0;0;1;1;29990;Pack depiladoras HP6306/00 + BRE225/00;PERSONAL CARE
16771538;;F;34;CHILENO;;Millenial;PEDRO AGUIRRE CERDA;METROPOLITANA;114210;5;1;0;0;0;5;1;114210;ALISADOR DE PELO S12A(220) Shine Therapy PALTA M;PERSONAL CARE
26197634;;M;47;VENEZOLANO;;Extranjero;PROVIDENCIA                   ;METROPOLITANA;0;0;2;0;0;0;0;2;0;KIT CORTABARBA MG3711;PERSONAL CARE
19861737;;M;24;CHILENO;;Z;PROVIDENCIA                   ;METROPOLITANA;18990;1;1;0;0;0;1;1;18990;CORTA PELO SPORT GC 542 BVT;PERSONAL CARE
24519095;Soltero;F;44;DOMINICANO;;Extranjero;PROVIDENCIA                   ;METROPOLITANA;53230;3;1;0;0;0;3;1;53230;ALISADOR DE PELO S6300 GRIS;PERSONAL CARE
17458701;;F;32;CHILENO;;Millenial;YUNGAY;BIO-BIO;153960;3;1;3;1;153960;0;0;0;DEPILADORA IPL MAGNA PK;PERSONAL CARE
16263396;Soltero;F;36;CHILENO;;Millenial;PROVIDENCIA                   ;METROPOLITANA;26990;1;1;0;0;0;1;1;26990;AFEITADORA S1121/41 ELECTRICA;PERSONAL CARE
13751178;;F;48;CHILENO;;X;SAN FELIPE                    ;VALPARAISO;29990;1;1;0;0;0;1;1;29990;TRICOMBO SECADOR+ALISADOR+ONDULADOR;PERSONAL CARE
8237257;;M;60;CHILENO;;Boomers;RENCA                         ;METROPOLITANA;16990;1;1;0;0;0;1;1;16990;SECADOR GAMA BRILLIAN AQUA;PERSONAL CARE
11522717;Casado;F;51;CHILENO;;X;RENCA                         ;METROPOLITANA;179980;2;2;0;0;0;2;2;179980;DEPILADORA SG-9004;PERSONAL CARE
19757623;;F;25;CHILENO;;Z;N/D;N/D;79982;2;3;0;0;0;2;3;79982;DEPILADORA SG-9004;PERSONAL CARE
18505537;;F;28;CHILENO;;Millenial;ARAUCO                        ;BIO BIO;29980;2;1;0;0;0;2;1;29980;AFEITADORA SPORT SH 886 BAT;PERSONAL CARE
6985407;;F;65;CHILENO;;Boomers;ARICA                         ;TARAPACA;94980;2;2;0;0;0;2;2;94980;SECADOR DE PELO SIEGEN SG-3035;PERSONAL CARE
19568926;;F;25;CHILENO;;Z;PROVIDENCIA                   ;METROPOLITANA;24990;1;1;0;0;0;1;1;24990;ALISADOR +SECADOR PELO;PERSONAL CARE
16059392;;F;36;CHILENO;;Millenial;RENCA                         ;METROPOLITANA;12990;1;1;0;0;0;1;1;12990;SECADOR DE PELO SG-3012 NEGRO;PERSONAL CARE
8174222;;M;65;CHILENO;;Boomers;SAN CARLOS                    ;BIO BIO;116970;3;1;0;0;0;3;1;116970;AFEITADORA 3000BT NEGRA;PERSONAL CARE
7956343;;M;63;CHILENO;;Boomers;COIHAIQUE                     ;AYSEN;10990;1;1;0;0;0;1;1;10990;SECADOR GAMA EOLIC MINI TRAVEL;PERSONAL CARE
27011303;;F;32;ARGENTINO;;Extranjero; LOS ANDES;VALPARAÃSO;101960;4;3;0;0;0;4;3;101960;ALISADOR DE PELO S12A(220) Shine Therapy PALTA M;PERSONAL CARE
12021889;;M;52;CHILENO;;X;LLAILLAY                      ;VALPARAISO;24980;2;2;0;0;0;2;2;24980;SECADOR PHILIPS BHC010;PERSONAL CARE
20082324;;M;23;CHILENO;;Z;PROVIDENCIA                   ;METROPOLITANA;39990;1;1;0;0;0;1;1;39990;CORTADOR DE PELO SIEGEN SG-8590;PERSONAL CARE
11271801;;F;53;CHILENO;;X;RENCA                         ;METROPOLITANA;36980;2;1;0;0;0;2;1;36980;SECADOR DE PELO STD TITAN KERATIN PLATA;PERSONAL CARE
26959521;Soltero;F;54;NO INFORMA NACIONALIDAD;;Extranjero;PROVIDENCIA                   ;METROPOLITANA;44990;1;1;0;0;0;1;1;44990;ALISADOR DE PELO S12A(220) Shine Therapy PALTA M;PERSONAL CARE
9246062;;M;61;CHILENO;;Boomers;CHIMBARONGO                   ;L.G.B.OÂ´HIGGINS;136970;3;2;0;0;0;3;2;136970;DEPILADORA BRE225/00;PERSONAL CARE
16481311;;F;36;CHILENO;;Millenial;CHIMBARONGO                   ;L.G.B.OÂ´HIGGINS;14990;1;1;0;0;0;1;1;14990;ALISADOR DE PELO HP8321;PERSONAL CARE
11286323;;F;54;CHILENO;;X;RENCA                         ;METROPOLITANA;0;0;2;0;0;0;0;2;0;DEPILADORA GAMA ESSENCIAL;PERSONAL CARE
18221339;;M;30;CHILENO;;Millenial;PUENTE ALTO                   ;METROPOLITANA;34990;1;1;0;0;0;1;1;34990;COMBO GAMA SECADOR+ALISADOR+CEPILLO;PERSONAL CARE
18435225;;F;30;CHILENO;;Millenial;N/D;N/D;14990;1;1;0;0;0;1;1;14990;SECADOR DE PELO SG-3012 NEGRO;PERSONAL CARE
17316197;;F;32;CHILENO;;Millenial;PROVIDENCIA                   ;METROPOLITANA;16990;1;1;1;1;16990;0;0;0;CORTA PELO SG-8200;PERSONAL CARE
7178943;;F;64;CHILENO;;Boomers;CONCON                        ;VALPARAISO;34990;1;1;0;0;0;1;1;34990;COMBO GAMA SECADOR+ALISADOR+CEPILLO;PERSONAL CARE
20316610;;F;22;CHILENO;;Extranjero;PROVIDENCIA                   ;METROPOLITANA;47990;1;1;0;0;0;1;1;47990;ALISADOR DE PELO S12A(220) Shine Therapy PALTA M;PERSONAL CARE
12335160;Casado;F;53;CHILENO;;X;PROVIDENCIA                   ;METROPOLITANA;49990;1;1;0;0;0;1;1;49990;ALISADOR DE PELO S12A(220) Shine Therapy PALTA M;PERSONAL CARE
12863531;;M;46;CHILENO;;X;N/D;N/D;1128170;7;3;7;3;1128170;0;0;0;COMBO GAMA SECADOR+ALISADOR+CEPILLO;PERSONAL CARE
20267002;;F;23;CHILENO;;Z;PROVIDENCIA                   ;METROPOLITANA;34990;1;1;0;0;0;1;1;34990;ALISADOR REMIG. WET2 S27A (BV) R;PERSONAL CARE
18692798;;F;27;CHILENO;;Millenial;SAN JAVIER                    ;MAULE;452960;5;3;0;0;0;5;3;452960;ALISADOR DE PELO S12A(220) Shine Therapy PALTA M;PERSONAL CARE
20005277;;F;23;CHILENO;;Z;PROVIDENCIA                   ;METROPOLITANA;49990;1;1;0;0;0;1;1;49990;DEPILADORA BRE285/00 CONVENCIONAL;PERSONAL CARE
7990131;Soltero;F;61;CHILENO;;Boomers;RENCA                         ;METROPOLITANA;0;0;2;0;0;0;0;2;0;DEPILADORA SG-9040;PERSONAL CARE
19473297;;F;25;CHILENO;;Z;TALCA                         ;MAULE;10000;0;1;0;0;0;0;1;10000;ALISADOR DE PELO SG-3540 MORADO MORADO;PERSONAL CARE
17352811;;F;33;CHILENO;;Millenial;N/D;N/D;39990;1;1;0;0;0;1;1;39990;DEPILADORA 3170 BRAUN;PERSONAL CARE
9914627;;M;56;CHILENO;;Boomers;LA FLORIDA;METROPOLITANA;44990;1;1;0;0;0;1;1;44990;DEPILADORA OASIS SENSATION;PERSONAL CARE
15039509;;F;41;CHILENO;;X;SAN PEDRO DE ATACAMA          ;ANTOFAGASTA;156960;4;3;3;2;139970;1;1;16990;AFEITADORA SPORT;PERSONAL CARE
15007402;;F;39;CHILENO;;X;ARICA                         ;ARICA Y PARINACOTA;16990;1;1;0;0;0;1;1;16990;SECADOR GAMA BRILLIAN AQUA;PERSONAL CARE
9141480;;F;60;CHILENO;;Boomers;SAN CARLOS                    ;BIO BIO;43970;3;3;0;0;0;3;3;43970;SECADOR DE PELO SG-3012 NEGRO;PERSONAL CARE
14622125;Soltero;F;40;CHILENO;;X;CANETE                        ;BIO BIO;27990;1;1;0;0;0;1;1;27990;SECADOR DE PELO DIVA NEGRO;PERSONAL CARE
18054081;;F;30;CHILENO;;Millenial;N/D;N/D;18990;1;1;0;0;0;1;1;18990;SECADOR GAMA BORA KERATION;PERSONAL CARE
18033465;Soltero;M;30;CHILENO;CONSTRUCTOR CIVIL;Millenial;PROVIDENCIA                   ;METROPOLITANA;24990;1;1;0;0;0;1;1;24990;CORTA PELO SG-8520;PERSONAL CARE
10141171;;M;58;CHILENO;;Boomers;MELIPILLA                     ;METROPOLITANA;24990;1;1;0;0;0;1;1;24990;ALISADOR +SECADOR PELO;PERSONAL CARE
18139481;;F;29;CHILENO;;Millenial;PUCON                         ;ARAUCANIA;35980;2;1;0;0;0;2;1;35980;ALISADOR ELEGANCE LED BLOOM VT;PERSONAL CARE
6266649;;M;73;CHILENO;;Silencioso;ILLAPEL                       ;COQUIMBO;79980;2;1;0;0;0;2;1;79980;TRICOMBO SECADOR+ALISADOR+ONDULADOR;PERSONAL CARE
14472202;;F;42;CHILENO;;X;CHILLAN                       ;BIO BIO;29990;1;1;0;0;0;1;1;29990;COMBO GAMA SECADOR+ALISADOR+CEPILLO;PERSONAL CARE
9838720;;F;57;CHILENO;;Boomers;REQUINOA                      ;L.G.B.OÂ´HIGGINS;44990;1;1;0;0;0;1;1;44990;COMBO SIEGEN AFEITADORA + MULTISTYLER SG-8440;PERSONAL CARE
16397156;Soltero;M;35;CHILENO;;Millenial;PROVIDENCIA                   ;METROPOLITANA;41980;2;1;0;0;0;2;1;41980;ALISADOR +SECADOR PELO;PERSONAL CARE
16891301;Soltero;F;27;CHILENO;;Z;PROVIDENCIA                   ;METROPOLITANA;59990;1;1;0;0;0;1;1;59990;DEPILADORA SES 5/500 PINK BOX MN;PERSONAL CARE
18791708;;F;28;CHILENO;;Millenial;ILLAPEL                       ;COQUIMBO;17990;1;1;0;0;0;1;1;17990;ALISADOR DE PELO SG-3510 FUCSIA;PERSONAL CARE
14364128;;F;43;CHILENO;;X;N/D;N/D;114110;5;2;0;0;0;5;2;114110;DEPILADORA BRE285/00 CONVENCIONAL;PERSONAL CARE
18284588;;F;29;CHILENO;;Millenial;N/D;N/D;32990;1;1;0;0;0;1;1;32990;ALISADOR ELEGANCE LED KER;PERSONAL CARE
17872325;;F;31;CHILENO;;Millenial;N/D;N/D;109200;6;4;0;0;0;6;4;109200;AFEITADORA SH 887 WD BAT;PERSONAL CARE
18334815;;M;29;CHILENO;;Millenial;N/D;N/D;86970;3;2;0;0;0;3;2;86970;AFEITADORA SH 887 WD BAT;PERSONAL CARE
13527369;;F;44;CHILENO;;X;PARRAL                        ;MAULE;55970;3;2;0;0;0;3;2;55970;DEPILADORA BRE225/00;PERSONAL CARE
7993112;;M;65;CHILENO;;Boomers;RENCA                         ;METROPOLITANA;39990;1;1;0;0;0;1;1;39990;TRICOMBO SECADOR+ALISADOR+ONDULADOR;PERSONAL CARE
10928258;;F;44;CHILENO;;X;BUIN                          ;METROPOLITANA;19990;1;1;0;0;0;1;1;19990;COMBO GAMA DEPILADORA+SET MANICURE;PERSONAL CARE
17230523;;F;33;CHILENO;;Millenial;PROVIDENCIA                   ;METROPOLITANA;24990;1;1;0;0;0;1;1;24990;ALISADOR +SECADOR PELO;PERSONAL CARE
24619431;;F;27;BOLIVIANO;;Extranjero;CALAMA                        ;ANTOFAGASTA;69980;2;2;0;0;0;2;2;69980;TRICOMBO SECADOR+ALISADOR+ONDULADOR;PERSONAL CARE
25575590;;F;35;COLOMBIANO;;Extranjero;PUDAHUEL                      ;METROPOLITANA;111960;4;3;3;2;86970;1;1;24990;Afeitadora electrica seco-humedo Philips S3122/5;PERSONAL CARE
13181856;;F;45;CHILENO;;X;SALAMANCA                     ;COQUIMBO;19990;1;1;0;0;0;1;1;19990;DEPILADORA BRE225/00;PERSONAL CARE
9747794;;F;56;CHILENO;;Boomers;PROVIDENCIA                   ;METROPOLITANA;34990;1;1;0;0;0;1;1;34990;AFEITADORA SH 887 WD BAT;PERSONAL CARE
10115230;;F;53;CHILENO;;X;PROVIDENCIA                   ;METROPOLITANA;16990;1;1;0;0;0;1;1;16990;ALISADORA SIEGEN SG-3510C06;PERSONAL CARE
17423430;;M;32;CHILENO;;Millenial;PROVIDENCIA                   ;METROPOLITANA;64980;2;2;0;0;0;2;2;64980;DEPILADORA SG-9004;PERSONAL CARE
12926670;Soltero;F;47;CHILENO;;X;RENCA                         ;METROPOLITANA;19990;1;1;0;0;0;1;1;19990;CORTA PELO SG-8410;PERSONAL CARE
13561892;;F;49;CHILENO;;X;NANCAGUA                      ;L.G.B.OÂ´HIGGINS;49980;2;1;0;0;0;2;1;49980;AFEITADORA QP2521/50 ONE BLADE GRAFITO;PERSONAL CARE
16907341;;F;34;CHILENO;;Millenial;PROVIDENCIA                   ;METROPOLITANA;19990;1;1;0;0;0;1;1;19990;DEPILADORA BRE225/00;PERSONAL CARE
15943445;;M;37;CHILENO;;Millenial;ANCUD                         ;LOS LAGOS;27980;2;1;0;0;0;2;1;27980;COMBO GAMA DEPILADORA+SET MANICURE;PERSONAL CARE
17098447;;F;33;CHILENO;;Millenial;"";"";19990;1;1;0;0;0;1;1;19990;DEPILADORA SG-9003;PERSONAL CARE
18806205;Soltero;F;27;CHILENO;NUTRICIONISTA;Z;PROVIDENCIA                   ;METROPOLITANA;66980;2;1;0;0;0;2;1;66980;DEPILADORA BRE285/00 CONVENCIONAL;PERSONAL CARE
10677563;;M;54;CHILENO;;X;LA FLORIDA                    ;METROPOLITANA;55210;5;1;0;0;0;5;1;55210;DEPILADORA BRE225/00;PERSONAL CARE
19508006;;F;25;CHILENO;;Z;PROVIDENCIA                   ;METROPOLITANA;19990;1;1;1;1;19990;0;0;0;ALISADOR +SECADOR PELO;PERSONAL CARE
15250573;;M;39;CHILENO;;X;"";"";14990;1;1;0;0;0;1;1;14990;SECADOR GAMA BRILLIAN AQUA;PERSONAL CARE
20151027;;M;23;CHILENO;;Z;N/D;N/D;34990;1;1;0;0;0;1;1;34990;ALISADOR ELEGANCE LED KER;PERSONAL CARE
18503894;Soltero;M;29;CHILENO;;Millenial;PROVIDENCIA                   ;METROPOLITANA;12990;1;1;0;0;0;1;1;12990;CORTA PELO SG-8200;PERSONAL CARE
18978037;Soltero;M;27;CHILENO;;Z;PROVIDENCIA                   ;METROPOLITANA;14990;1;1;0;0;0;1;1;14990;CORTA PELO SG-8200;PERSONAL CARE
8483666;;F;63;CHILENO;;Boomers;LOTA                          ;BIO BIO;25990;1;1;0;0;0;1;1;25990;SECADOR DE PELO SE-3049C01 FUCSIA;PERSONAL CARE
16588916;Soltero;M;35;CHILENO;PSICOLOGO;Millenial;RENCA                         ;METROPOLITANA;29990;1;1;0;0;0;1;1;29990;AFEITADORA SPORT SH 886 BAT;PERSONAL CARE
18885526;;F;28;CHILENO;;Millenial;N/D;N/D;32990;1;1;0;0;0;1;1;32990;COMBO GAMA SECADOR+ALISADOR+CEPILLO;PERSONAL CARE
14015661;;F;41;CHILENO;;X;TALCA                         ;MAULE;179980;2;2;2;2;179980;0;0;0;COMBO GAMA DEPILADORA+SET MANICURE;PERSONAL CARE
13784278;Casado;F;41;CHILENO;;X;RENCA                         ;METROPOLITANA;26990;1;1;0;0;0;1;1;26990;DEPILADORA SG-9004;PERSONAL CARE
12100884;Casado;F;56;CHILENO;;Boomers;PROVIDENCIA                   ;METROPOLITANA;19990;1;1;0;0;0;1;1;19990;AFEITADORA SG-7210 NEGRO;PERSONAL CARE
13772011;;F;42;CHILENO;;X;MELIPILLA                     ;METROPOLITANA;0;0;2;0;0;0;0;2;0;CORTAPELOS GM 596;PERSONAL CARE
19779440;;F;23;CHILENO;;Millenial;PUENTE ALTO                   ;METROPOLITANA;29990;1;1;0;0;0;1;1;29990;CORTAPELOS GM 596;PERSONAL CARE
11406354;Casado;F;53;CHILENO;;X;RENCA                         ;METROPOLITANA;32990;1;1;0;0;0;1;1;32990;AFEITADORA S1223/41 ELECTRICA;PERSONAL CARE
19956492;;F;24;CHILENO;;Z;PROVIDENCIA                   ;METROPOLITANA;16990;1;1;0;0;0;1;1;16990;ALISADORA SIEGEN SG-3510C06;PERSONAL CARE
9449622;;F;57;CHILENO;;Boomers;ANCUD                         ;LOS LAGOS;79980;2;2;0;0;0;2;2;79980;COMBO SIEGEN AFEITADORA + MULTISTYLER SG-8440;PERSONAL CARE
17150550;;M;33;CHILENO;;Millenial;PUENTE ALTO                   ;METROPOLITANA;38980;2;1;2;1;38980;0;0;0;ALISADOR REMIG. WET2 S27A (BV) R;PERSONAL CARE
19560688;;F;25;CHILENO;;Z;SAN RAFAEL                    ;MAULE;38983;2;2;0;0;0;2;2;38983;ALISADOR ELEGANCE LED BLOOM VT;PERSONAL CARE
17932386;;F;30;CHILENO;;Millenial;TALCA                         ;MAULE;200230;3;3;0;0;0;3;3;200230;DEPILADORA IPL MAGNA PK;PERSONAL CARE
6539493;;M;65;CHILENO;;Boomers;LA SERENA                     ;COQUIMBO;34990;1;1;0;0;0;1;1;34990;AFEITADORA SH 887 WD BAT;PERSONAL CARE
10643119;Casado;F;51;CHILENO;PODOLOGO;X;SAN ANTONIO                   ;VALPARAISO;24990;1;1;0;0;0;1;1;24990;CORTA PELO SG-8520;PERSONAL CARE
11291639;;F;53;CHILENO;;X;RENCA                         ;METROPOLITANA;35980;2;1;0;0;0;2;1;35980;AFEITADORA SPORT;PERSONAL CARE
15457334;;F;40;CHILENO;;X;COLINA                        ;METROPOLITANA;34980;2;1;0;0;0;2;1;34980;CORTA PELO GC-615;PERSONAL CARE
9457384;;M;59;CHILENO;;Boomers;RENCA                         ;METROPOLITANA;24990;1;1;0;0;0;1;1;24990;ALISADOR +SECADOR PELO;PERSONAL CARE
15460173;;M;39;CHILENO;;X;TALAGANTE                     ;METROPOLITANA;209980;2;2;0;0;0;2;2;209980;ALISADOR AQUA THERAPY LED;PERSONAL CARE
22128327;;F;24;CHILENO;;Extranjero;"";"";169980;2;2;1;1;139990;1;1;29990;AFEITADORA SG-7250 NEGRO;PERSONAL CARE
12956259;;F;46;CHILENO;;X;QUILPUE                       ;VALPARAISO;39990;1;1;0;0;0;1;1;39990;ALISADOR DE PELO S12A(220) Shine Therapy PALTA M;PERSONAL CARE
10375365;;F;60;CHILENO;;X;CONCON                        ;VALPARAISO;38990;1;1;0;0;0;1;1;38990;AFEITADORA S1323/41 ELECTRICA;PERSONAL CARE
19580822;;F;24;CHILENO;;Z;NUEVA IMPERIAL                ;ARAUCANIA;27993;1;1;0;0;0;1;1;27993;ALISADOR DE PELO S12A(220) Shine Therapy PALTA M;PERSONAL CARE
12683085;;F;49;CHILENO;;X;PROVIDENCIA                   ;METROPOLITANA;12990;1;1;0;0;0;1;1;12990;CORTA PELO SG-8200;PERSONAL CARE
13729310;;F;43;CHILENO;;X;RENCA                         ;METROPOLITANA;179970;3;2;0;0;0;3;2;179970;DEPILADORA SG-9040;PERSONAL CARE
10189189;;F;58;CHILENO;;Boomers;RENCA                         ;METROPOLITANA;13990;1;1;0;0;0;1;1;13990;ONDULADOR DE PELO SG-2411 25MM;PERSONAL CARE
18569176;;F;29;CHILENO;;Millenial;PROVIDENCIA                   ;METROPOLITANA;29990;1;1;1;1;29990;0;0;0;COMBO GAMA SECADOR+ALISADOR+CEPILLO;PERSONAL CARE
19720183;;F;24;CHILENO;;Z;"";"";12990;1;1;0;0;0;1;1;12990;CORTA PELO SG-8200;PERSONAL CARE
25328180;;F;50;FILIPINO;;Extranjero;N/D;N/D;50660;3;2;0;0;0;3;2;50660;SPA PARA PIES SG-1560;PERSONAL CARE
24427665;;M;45;COLOMBIANO;;Extranjero;SANTIAGO                      ;METROPOLITANA;22990;1;1;0;0;0;1;1;22990;CORTA PELO SG-8410;PERSONAL CARE
16118550;;M;36;CHILENO;;Millenial;EL MONTE                      ;METROPOLITANA;12990;1;1;0;0;0;1;1;12990;CORTA PELO SG-8200;PERSONAL CARE
12206811;Casado;F;49;CHILENO;;X;SAN JAVIER                    ;MAULE;16990;1;1;0;0;0;1;1;16990;ALISADORA SIEGEN SG-3510C06;PERSONAL CARE
19205281;;M;26;CHILENO;;Z;N/D;N/D;285200;6;4;0;0;0;6;4;285200;ALISADOR DE PELO SG-4651 ROJO;PERSONAL CARE
18950740;;F;27;CHILENO;;Millenial;N/D;N/D;9990;1;1;0;0;0;1;1;9990;SECADOR DE PELO SG-3012 NEGRO;PERSONAL CARE
12141024;;F;59;CHILENO;;Boomers;RENCA                         ;METROPOLITANA;36990;1;1;0;0;0;1;1;36990;DEPILADORA SG-9040;PERSONAL CARE
9010328;Soltero;F;44;CHILENO;;X;PROVIDENCIA                   ;METROPOLITANA;22240;2;1;0;0;0;2;1;22240;SECADOR TEMPO TITAN KERATIN;PERSONAL CARE
7637682;;F;64;CHILENO;;Boomers;PROVIDENCIA                   ;METROPOLITANA;9990;1;1;0;0;0;1;1;9990;SECADOR GAMA EOLIC MINI TRAVEL;PERSONAL CARE
15547622;;F;39;CHILENO;;X;PAILLACO                      ;LOS LAGOS;14990;1;1;0;0;0;1;1;14990;CORTAPELO GAMA MG 566;PERSONAL CARE
25677501;;M;31;VENEZOLANO;;Extranjero;N/D;N/D;14990;1;1;0;0;0;1;1;14990;SECADOR GAMA BRILLIAN AQUA;PERSONAL CARE
16281379;;F;36;CHILENO;;Millenial;PUENTE ALTO                   ;METROPOLITANA;23980;2;1;2;1;23980;0;0;0;ALISADOR ELEGANCE LED BLOOM VT;PERSONAL CARE
18284293;;F;34;CHILENO;;Millenial;YERBAS BUENAS                 ;MAULE;38980;2;1;0;0;0;2;1;38980;DEPILADORA BRE225/00;PERSONAL CARE
20344095;;F;30;CHILENO;;Millenial;COIHAIQUE                     ;AYSEN;29990;1;1;0;0;0;1;1;29990;ALISADOR AQUA THERAPY LED;PERSONAL CARE
10499029;;F;58;CHILENO;;Boomers;N/D;N/D;301840;6;2;0;0;0;6;2;301840;ALISADOR DE PELO SG-3540 MORADO MORADO;PERSONAL CARE
26496706;;F;33;VENEZOLANO;;Extranjero;VINA DEL MAR                  ;VALPARAISO;14990;1;1;0;0;0;1;1;14990;CORTAPELO GAMA MG 566;PERSONAL CARE
13084264;;M;45;CHILENO;;X;"";"";16990;1;1;1;1;16990;0;0;0;AFEITADORA SPORT;PERSONAL CARE
14546580;;F;42;CHILENO;;X;HUALPEN;BIO BIO;71980;2;1;0;0;0;2;1;71980;ALISADOR SIEGEN SG-4716;PERSONAL CARE
15617333;;F;41;CHILENO;;X;PROVIDENCIA                   ;METROPOLITANA;-29990;-1;1;0;0;0;-1;1;-29990;AFEITADORA SG-7250 NEGRO;PERSONAL CARE
19091844;;F;26;CHILENO;;Z;N/D;N/D;52660;3;1;0;0;0;3;1;52660;SECADOR DE PELO SE-3049C01 FUCSIA;PERSONAL CARE
9998872;;M;55;CHILENO;;Boomers;COPIAPO                       ;ATACAMA;34990;1;1;0;0;0;1;1;34990;DEPILADORA SG-9004EX;PERSONAL CARE
8844665;;M;62;CHILENO;;Boomers;ILLAPEL                       ;COQUIMBO;31990;1;1;0;0;0;1;1;31990;AFEITADORA SPORT SH 886 BAT;PERSONAL CARE
15191878;;M;40;CHILENO;;X;CURANILAHUE                   ;BIO BIO;28990;1;1;0;0;0;1;1;28990;CORTA PELO SPORT GCX 623 BVT;PERSONAL CARE
15305132;;M;39;CHILENO;;X;QUILPUE                       ;VALPARAISO;15990;1;1;1;1;15990;0;0;0;SECADOR DE PELO STD TITAN KERATIN PLATA;PERSONAL CARE
20233661;;F;22;CHILENO;;Z;PROVIDENCIA                   ;METROPOLITANA;28990;1;1;0;0;0;1;1;28990;SECADOR DE PELO SG-3051;PERSONAL CARE
7828320;;M;65;CHILENO;;Boomers;RENCA                         ;METROPOLITANA;39990;1;1;0;0;0;1;1;39990;COMBO SIEGEN AFEITADORA + MULTISTYLER SG-8440;PERSONAL CARE
13413788;;F;44;CHILENO;;X;ARICA                         ;ARICA Y PARINACOTA;13990;1;1;0;0;0;1;1;13990;SECADOR DE PELO MISTRAL STD;PERSONAL CARE
18729731;;M;28;CHILENO;;Silencioso;PROVIDENCIA                   ;METROPOLITANA;19990;1;1;1;1;19990;0;0;0;AFEITADORA SG-7250 NEGRO;PERSONAL CARE
14459470;;M;46;CHILENO;;X;PROVIDENCIA                   ;METROPOLITANA;20240;2;1;0;0;0;2;1;20240;SECADOR DE PELO SE-3049C01 FUCSIA;PERSONAL CARE
4236704;;M;84;CHILENO;;Silencioso;LINARES                       ;MAULE;21990;1;1;0;0;0;1;1;21990;SECADOR DE PELO SG-3051;PERSONAL CARE
10052679;;F;57;CHILENO;;Boomers;RENCA                         ;METROPOLITANA;27980;2;2;0;0;0;2;2;27980;SECADOR DE PELO SG-3043 DC CAFE 2200 WATTS;PERSONAL CARE
17736984;;F;32;CHILENO;;Millenial;PROVIDENCIA                   ;METROPOLITANA;9990;1;1;0;0;0;1;1;9990;SECADOR GAMA EOLIC MINI TRAVEL;PERSONAL CARE
13822193;;F;42;CHILENO;;X;PROVIDENCIA                   ;METROPOLITANA;24990;1;1;0;0;0;1;1;24990;DEPILADORA SG-9004;PERSONAL CARE
25724549;;M;39;PERUANO;;Extranjero;N/D;N/D;23184;2;1;0;0;0;2;1;23184;SECADOR TEMPO TITAN KERATIN;PERSONAL CARE
10018235;;M;54;CHILENO;;X;PROVIDENCIA                   ;METROPOLITANA;19990;1;1;0;0;0;1;1;19990;CORTA PELO SG-8410;PERSONAL CARE
5166701;;F;75;CHILENO;;Silencioso;EL TABO                       ;VALPARAISO;21990;1;1;0;0;0;1;1;21990;SECADOR DE PELO SG-3043 DC CAFE 2200 WATTS;PERSONAL CARE
18701988;;M;28;CHILENO;;Millenial;N/D;N/D;51980;2;1;0;0;0;2;1;51980;ALISADOR ELEGANCE LED BLOOM VT;PERSONAL CARE
17106998;;F;32;CHILENO;;Millenial;PUENTE ALTO                   ;METROPOLITANA;32670;2;1;0;0;0;2;1;32670;ALISADOR ELEGANCE LED KER;PERSONAL CARE
15401428;;M;40;CHILENO;;X;PROVIDENCIA                   ;METROPOLITANA;23990;1;1;0;0;0;1;1;23990;SECADOR DE PELO SG-3049 NEGRO;PERSONAL CARE
9028122;;M;62;CHILENO;;Boomers;RENCA                         ;METROPOLITANA;19990;1;1;0;0;0;1;1;19990;CORTA PELO SG-8410;PERSONAL CARE
15636224;;M;39;CHILENO;;X;N/D;N/D;19980;2;1;0;0;0;2;1;19980;CORTA PELO SG-8200;PERSONAL CARE
7631775;;M;63;CHILENO;;Boomers;VALLENAR;ATACAMA;54990;1;1;0;0;0;1;1;54990;ALISADOR DE PELO SG-4651 ROJO;PERSONAL CARE
19411758;;F;25;CHILENO;;Z;N/D;N/D;12990;1;1;1;1;12990;0;0;0;SECADOR DE PELO MISTRAL STD;PERSONAL CARE
12301674;;F;49;CHILENO;;X;RENCA                         ;METROPOLITANA;40140;2;2;0;0;0;2;2;40140;DEPILADORA OASIS SENSATION;PERSONAL CARE
15142708;;M;40;CHILENO;;X;SAN RAFAEL                    ;MAULE;29990;1;1;0;0;0;1;1;29990;AFEITADORA SG-7250 NEGRO;PERSONAL CARE
15697178;;M;38;CHILENO;;X;SAN JAVIER                    ;MAULE;21990;1;1;0;0;0;1;1;21990;SECADOR DE PELO SE-3049C01 FUCSIA;PERSONAL CARE
10838948;;F;58;CHILENO;;Boomers;PARRAL                        ;MAULE;49990;1;1;0;0;0;1;1;49990;ALISADOR SIEGEN SG-4716;PERSONAL CARE
4589436;;M;80;CHILENO;;Silencioso;PROVIDENCIA                   ;METROPOLITANA;29990;1;1;0;0;0;1;1;29990;CORTAPELOS GM 596;PERSONAL CARE
5260654;Viudo;M;73;CHILENO;INGENIERO;Silencioso;RENCA                         ;METROPOLITANA;26990;1;1;0;0;0;1;1;26990;SECADOR DE PELO SIEGEN SG-3049C02;PERSONAL CARE
18841811;;F;28;CHILENO;;Millenial;VILLA ALEMANA                 ;VALPARAISO;39990;1;1;1;1;39990;0;0;0;ALISADOR DE PELO S12A(220) Shine Therapy PALTA M;PERSONAL CARE
16341345;;M;35;CHILENO;;Millenial;N/D;N/D;52980;2;1;0;0;0;2;1;52980;AFEITADORA S1323/41 ELECTRICA;PERSONAL CARE
8942951;;M;60;CHILENO;;Boomers;RENCA                         ;METROPOLITANA;23990;1;1;0;0;0;1;1;23990;SECADOR DE PELO SIEGEN SG-3049C02;PERSONAL CARE
14358454;;F;42;CHILENO;;X;PUERTO MONTT                  ;LOS LAGOS;29990;1;1;0;0;0;1;1;29990;AFEITADORA SG-7250 NEGRO;PERSONAL CARE
18561468;;F;28;CHILENO;;Millenial;SALAMANCA                     ;COQUIMBO;20990;1;1;0;0;0;1;1;20990;Depiladora E SkinPro Go Bvt;PERSONAL CARE
19548507;;F;26;CHILENO;;Z;LA LIGUA                      ;VALPARAISO;54990;1;1;0;0;0;1;1;54990;ALISADOR DE PELO SG-4651 ROJO;PERSONAL CARE
11202622;;F;55;CHILENO;;Boomers;PROVIDENCIA                   ;METROPOLITANA;34990;1;1;0;0;0;1;1;34990;AFEITADORA SH 887 WD BAT;PERSONAL CARE
17347458;;F;32;CHILENO;;Millenial;PROVIDENCIA                   ;METROPOLITANA;14990;1;1;0;0;0;1;1;14990;CORTA PELO SG-8200;PERSONAL CARE
25901382;;F;43;VENEZOLANO;;Extranjero;SAN MIGUEL                    ;METROPOLITANA;48980;2;1;2;1;48980;0;0;0;ALISADOR DE PELO S12A(220) Shine Therapy PALTA M;PERSONAL CARE
15729110;;M;38;CHILENO;;X;NOGALES                       ;VALPARAISO;54230;3;1;0;0;0;3;1;54230;AFEITADORA SPORT SH 886 BAT;PERSONAL CARE
8926115;;F;56;CHILENO;;Boomers;PROVIDENCIA                   ;METROPOLITANA;14990;1;1;0;0;0;1;1;14990;SECADOR DIAMOND STD;PERSONAL CARE
14222013;;F;40;CHILENO;;X;TEMUCO                        ;ARAUCANIA;23990;1;1;0;0;0;1;1;23990;SECADOR DE PELO SG-3049 NEGRO;PERSONAL CARE
18860878;;M;28;CHILENO;;Millenial;TOCOPILLA                     ;ANTOFAGASTA;64990;1;1;0;0;0;1;1;64990;ALISADOR DE PELO SG-4651 ROJO;PERSONAL CARE
17592942;;M;32;CHILENO;;Millenial;N/D;N/D;13990;1;1;0;0;0;1;1;13990;SECADOR DE PELO MISTRAL STD;PERSONAL CARE
13871460;;M;42;CHILENO;;Millenial;N/D;N/D;49990;1;1;0;0;0;1;1;49990;ALISADOR SIEGEN SG-4716;PERSONAL CARE
19871142;;F;23;CHILENO;;Millenial;VALLENAR;ATACAMA;74990;1;1;0;0;0;1;1;74990;ALISADORA SG-4751;PERSONAL CARE
15921052;Soltero;F;37;CHILENO;PSICOLOGO;Millenial;RENCA                         ;METROPOLITANA;14990;1;1;0;0;0;1;1;14990;SECADOR DIAMOND STD;PERSONAL CARE
16467440;;F;35;CHILENO;;Millenial;N/D;N/D;14990;1;1;0;0;0;1;1;14990;SECADOR DE PELO BHD00410;PERSONAL CARE
10326294;;M;53;CHILENO;;X;N/D;N/D;63970;3;1;0;0;0;3;1;63970;DEPILADORA SG-9004;PERSONAL CARE
15986376;;F;37;CHILENO;;Millenial;PADRE LAS CASAS               ;ARAUCANIA;34990;1;1;0;0;0;1;1;34990;AFEITADORA SH 887 WD BAT;PERSONAL CARE
7593604;Casado;F;67;CHILENO;;Boomers;RENCA                         ;METROPOLITANA;12990;1;1;0;0;0;1;1;12990;SECADOR PELO SG-3012C19;PERSONAL CARE
13586381;;M;42;CHILENO;;X;PANGUIPULLI                   ;LOS LAGOS;-8000;0;2;0;0;0;0;2;-8000;CORTA PELO HC3520;PERSONAL CARE
6503491;;M;71;CHILENO;;Silencioso;RENCA                         ;METROPOLITANA;20990;1;1;0;0;0;1;1;20990;AFEITADORA SG-7210 NEGRO;PERSONAL CARE
11846927;;F;50;CHILENO;;X;QUILICURA                     ;METROPOLITANA;38980;2;1;2;1;38980;0;0;0;ALISADOR ELEGANCE LED KER;PERSONAL CARE
17825744;Soltero;F;31;CHILENO;;Millenial;CONSTITUCION                  ;MAULE;20990;1;1;0;0;0;1;1;20990;SECADOR DE PELO SG-3043 DC CAFE 2200 WATTS;PERSONAL CARE
12947457;;F;45;CHILENO;;X;PROVIDENCIA                   ;METROPOLITANA;0;0;0;0;0;0;0;0;0;TRICOMBO SECADOR+ALISADOR+ONDULADOR;PERSONAL CARE
15178966;Soltero;M;39;CHILENO;TECNICO EN MANTENCION INDUSTRIAL;X;RENCA                         ;METROPOLITANA;0;0;0;0;0;0;0;0;0;ALISADOR +SECADOR PELO;PERSONAL CARE
10140617;;M;56;CHILENO;;Silencioso;PROVIDENCIA                   ;METROPOLITANA;0;0;0;0;0;0;0;0;0;SECADOR DE PELO DIVA NEGRO;PERSONAL CARE
16034906;;F;36;CHILENO;;Millenial;QUILPUE                       ;VALPARAISO;0;0;0;0;0;0;0;0;0;ALISADOR DE PELO SG-4651 ROJO;PERSONAL CARE
8073235;;F;66;CHILENO;;Boomers;RENCA                         ;METROPOLITANA;0;0;0;0;0;0;0;0;0;CORTA PELO SG-8410;PERSONAL CARE
12914526;;F;46;CHILENO;;X;SAN JOAQUIN                   ;METROPOLITANA;0;0;0;0;0;0;0;0;0;SECADOR DE PELO SG-3043 DC CAFE 2200 WATTS;PERSONAL CARE
14212953;;F;41;CHILENO;;X;RENCA                         ;METROPOLITANA;0;0;0;0;0;0;0;0;0;CORTA PELO GM 562;PERSONAL CARE
15046741;;F;40;CHILENO;;Extranjero;RENCA                         ;METROPOLITANA;0;0;0;0;0;0;0;0;0;ALISADOR SG3510C09 MORADO PLACAS DE CERAMICA 21;PERSONAL CARE
13826070;Soltero;F;42;CHILENO;;X;QUEILEN                       ;LOS LAGOS;0;0;0;0;0;0;0;0;0;DEPILADORA BRE225/00;PERSONAL CARE
9072125;;M;59;CHILENO;;Boomers;PROVIDENCIA                   ;METROPOLITANA;0;0;0;0;0;0;0;0;0;AFEITADORA SG-7250 NEGRO;PERSONAL CARE
9404458;;F;56;CHILENO;;Boomers;RENCA                         ;METROPOLITANA;0;0;0;0;0;0;0;0;0;SECADOR DE VIAJE REMINGTON D2400;PERSONAL CARE
16118330;;F;36;CHILENO;;Millenial;PUENTE ALTO                   ;METROPOLITANA;0;0;0;0;0;0;0;0;0;ALISADOR DE PELO SG-4651 ROJO;PERSONAL CARE
13369631;;F;44;CHILENO;;X;COLINA                        ;METROPOLITANA;0;0;0;0;0;0;0;0;0;DEPILADORA SG-9004EX;PERSONAL CARE
20056119;;M;23;CHILENO;;Z;CHILLAN                       ;BIO BIO;0;0;0;0;0;0;0;0;0;AFEITADORA QP2521/50 ONE BLADE GRAFITO;PERSONAL CARE
15205920;;F;40;CHILENO;;X;RANCAGUA                      ;L.G.B.OÂ´HIGGINS;0;0;0;0;0;0;0;0;0;SECADOR PELO SG-3012C19;PERSONAL CARE
13979401;;M;41;CHILENO;;X;LA LIGUA                      ;VALPARAISO;0;0;0;0;0;0;0;0;0;AFEITADORA S1121/41 ELECTRICA;PERSONAL CARE
16141818;;F;37;CHILENO;;Millenial;VINA DEL MAR                  ;VALPARAISO;0;0;0;0;0;0;0;0;0;SECADOR DE PELO D3019 PRO TITANIO;PERSONAL CARE
14203522;;F;40;CHILENO;;X;REQUINOA                      ;L.G.B.OÂ´HIGGINS;0;0;0;0;0;0;0;0;0;SECADOR DE PELO SG-3049 NEGRO;PERSONAL CARE
13861748;;F;42;CHILENO;;X;ARICA                         ;ARICA Y PARINACOTA;0;0;0;0;0;0;0;0;0;TRICOMBO SECADOR+ALISADOR+ONDULADOR;PERSONAL CARE
20140484;;F;23;CHILENO;;Silencioso;PROVIDENCIA                   ;METROPOLITANA;0;0;0;0;0;0;0;0;0;ALISADOR DE PELO S6300 GRIS;PERSONAL CARE
16690151;;M;34;CHILENO;;Millenial;N/D;N/D;0;0;0;0;0;0;0;0;0;ALISADOR DE PELO SG-4651 ROJO;PERSONAL CARE
8956135;;F;64;CHILENO;;Boomers;BUIN                          ;METROPOLITANA;0;0;0;0;0;0;0;0;0;KIT CORTABARBA MG3731;PERSONAL CARE
17076039;;M;33;CHILENO;;Millenial;N/D;N/D;0;0;0;0;0;0;0;0;0;CORTADOR DE PELO SIEGEN SG-8590;PERSONAL CARE
16265302;;F;36;CHILENO;;Millenial;NUNOA                         ;METROPOLITANA;0;0;0;0;0;0;0;0;0;Depiladora Epilator Series 8000 Philips BRE715/0;PERSONAL CARE
13363896;;F;44;CHILENO;;X;PROVIDENCIA                   ;METROPOLITANA;0;0;0;0;0;0;0;0;0;SECADOR DE PELO D3019 PRO TITANIO;PERSONAL CARE
18014530;;M;30;CHILENO;;Millenial;PROVIDENCIA                   ;METROPOLITANA;0;0;0;0;0;0;0;0;0;CORTA PELO GM 562;PERSONAL CARE
17378282;;F;33;CHILENO;;Millenial;PITRUFQUEN                    ;ARAUCANIA;0;0;0;0;0;0;0;0;0;CORTA PELO HC-5850;PERSONAL CARE
12983172;;F;45;CHILENO;;X;CURANILAHUE                   ;BIO BIO;0;0;0;0;0;0;0;0;0;ALISADOR REMIG. WET2 S27A (BV) R;PERSONAL CARE
12081746;;F;58;CHILENO;;Boomers;SAN CLEMENTE                  ;MAULE;0;0;0;0;0;0;0;0;0;DEPILADORA SG-9003;PERSONAL CARE
16765269;;F;34;CHILENO;;Millenial;CONCEPCION                    ;BIO BIO;0;0;0;0;0;0;0;0;0;DEPILADORA GAMA ESSENCIAL;PERSONAL CARE
11929768;;F;49;CHILENO;;X;RENCA                         ;METROPOLITANA;0;0;0;0;0;0;0;0;0;TRICOMBO SECADOR+ALISADOR+ONDULADOR;PERSONAL CARE
16567288;;F;34;CHILENO;;Millenial;ARAUCO                        ;BIO BIO;0;0;0;0;0;0;0;0;0;AFEITADORA SG-7250 NEGRO;PERSONAL CARE
14755214;;F;26;CHILENO;;Extranjero;TOCOPILLA                     ;ANTOFAGASTA;0;0;0;0;0;0;0;0;0;SECADOR DE PELO DIAMOND ST BLOOM VT 220;PERSONAL CARE
10994811;;F;53;CHILENO;;X;PROVIDENCIA                   ;METROPOLITANA;0;0;0;0;0;0;0;0;0;SECADOR DIAMOND STD;PERSONAL CARE
9881486;;M;58;CHILENO;;Boomers;TALCAHUANO                    ;BIO BIO;0;0;0;0;0;0;0;0;0;AFEITADORA SG-7250 NEGRO;PERSONAL CARE
19274514;;F;26;CHILENO;;Z;N/D;N/D;0;0;0;0;0;0;0;0;0;ALISADOR PHILIPS BHS376;PERSONAL CARE
14259580;;F;47;CHILENO;;X;PROVIDENCIA                   ;METROPOLITANA;0;0;0;0;0;0;0;0;0;SECADOR DE PELO SG-3049 NEGRO;PERSONAL CARE
6774914;Casado;M;69;CHILENO;;Silencioso;RENCA                         ;METROPOLITANA;0;0;0;0;0;0;0;0;0;ALISADOR PHILIPS BHS376;PERSONAL CARE
8797887;;F;60;CHILENO;;Silencioso;VILLA ALEMANA                 ;VALPARAISO;0;0;0;0;0;0;0;0;0;SECADOR DE PELO SG-3012 NEGRO;PERSONAL CARE
11819028;;M;52;CHILENO;;Millenial;N/D;N/D;0;0;0;0;0;0;0;0;0;SECADOR DE PELO SE-3049C01 FUCSIA;PERSONAL CARE
9197608;;M;60;CHILENO;;Boomers;ANCUD                         ;LOS LAGOS;0;0;0;0;0;0;0;0;0;CORTA PELO SPORT GCX 623 BVT;PERSONAL CARE
16446217;Soltero;F;35;CHILENO;;Millenial;PROVIDENCIA                   ;METROPOLITANA;0;0;0;0;0;0;0;0;0;DEPILADORA BRE255/00;PERSONAL CARE
16413165;;F;35;CHILENO;;Millenial;N/D;N/D;0;0;0;0;0;0;0;0;0;DEPILADORA IPL MAGNA PK;PERSONAL CARE
18523477;;F;29;CHILENO;;Millenial;LAJA                          ;BIO BIO;0;0;0;0;0;0;0;0;0;ALISADOR DE PELO ERGOSTYLER ION DUO ROJO;PERSONAL CARE
15538214;;F;39;CHILENO;;X;PROVIDENCIA                   ;METROPOLITANA;0;0;0;0;0;0;0;0;0;TRICOMBO SECADOR+ALISADOR+ONDULADOR;PERSONAL CARE
17344046;;M;32;CHILENO;;Silencioso;PROVIDENCIA                   ;METROPOLITANA;0;0;0;0;0;0;0;0;0;SECADOR DIAMOND STD;PERSONAL CARE
15768526;;F;42;CHILENO;;X;SALAMANCA                     ;COQUIMBO;0;0;0;0;0;0;0;0;0;KIT CORTABARBA MG3711;PERSONAL CARE
8273479;;F;65;CHILENO;;Boomers;VALDIVIA                      ;LOS RIOS;0;0;0;0;0;0;0;0;0;ALISADOR DE PELO SG-4651 ROJO;PERSONAL CARE
9789299;;F;46;CHILENO;;X;RENCA                         ;METROPOLITANA;0;0;0;0;0;0;0;0;0;SECADOR DE PELO SE-3049C01 FUCSIA;PERSONAL CARE
11955589;;M;50;CHILENO;;X;RENCA                         ;METROPOLITANA;0;0;0;0;0;0;0;0;0;Trimmer Gama GT 527;PERSONAL CARE
12589816;Soltero;M;47;CHILENO;;X;RENCA                         ;METROPOLITANA;0;0;0;0;0;0;0;0;0;CORTA PELO GM 562;PERSONAL CARE
25387607;;M;62;COLOMBIANO;;Extranjero;N/D;N/D;0;0;0;0;0;0;0;0;0;AFEITADORA S1323/41 ELECTRICA;PERSONAL CARE
16512393;Soltero;F;35;CHILENO;;Millenial;PROVIDENCIA                   ;METROPOLITANA;0;0;0;0;0;0;0;0;0;CORTA PELO PG6025 KIT RECORTE;PERSONAL CARE
12982448;Casado;F;46;CHILENO;;X;CURANILAHUE                   ;BIO BIO;0;0;0;0;0;0;0;0;0;SECADOR DIAMOND STD;PERSONAL CARE
16090365;Soltero;F;37;CHILENO;;Millenial;RENCA                         ;METROPOLITANA;0;0;0;0;0;0;0;0;0;SECADOR DE VIAJE REMINGTON D2400;PERSONAL CARE
20059555;;F;23;CHILENO;;Silencioso;PROVIDENCIA                   ;METROPOLITANA;0;0;0;0;0;0;0;0;0;ALISADOR SIEGEN SG-4720;PERSONAL CARE
17803604;;F;31;CHILENO;;Millenial;N/D;N/D;0;0;0;0;0;0;0;0;0;ALISADOR GAMA ELEGANCE LED TITANIO;PERSONAL CARE
19184364;Soltero;F;26;CHILENO;;Silencioso;PROVIDENCIA                   ;METROPOLITANA;0;0;0;0;0;0;0;0;0;ONDULADOR SIEGEN SG-2352;PERSONAL CARE
18118389;Soltero;M;30;CHILENO;;Millenial;PROVIDENCIA                   ;METROPOLITANA;0;0;0;0;0;0;0;0;0;DEPILADORA IPL 3500 LUZ PULSADA;PERSONAL CARE
4651620;;F;76;CHILENO;;Silencioso;IQUIQUE                       ;TARAPACA;0;0;0;0;0;0;0;0;0;CORTA PELO SG-8520;PERSONAL CARE
11916143;Casado;F;49;CHILENO;;X;ARAUCO                        ;BIO BIO;0;0;0;0;0;0;0;0;0;COMBO SIEGEN AFEITADORA + MULTISTYLER SG-8440;PERSONAL CARE
19363382;;F;26;CHILENO;;Z;SAN JAVIER                    ;MAULE;0;0;0;0;0;0;0;0;0;ALISADOR GAMA BELLA SHINE;PERSONAL CARE
16220140;;M;36;CHILENO;;Millenial;RENCA                         ;METROPOLITANA;0;0;0;0;0;0;0;0;0;SECADOR DE PELO SG-3049 NEGRO;PERSONAL CARE
14444272;;F;57;PERUANO;;Extranjero;ANTOFAGASTA                   ;ANTOFAGASTA;0;0;0;0;0;0;0;0;0;COMBO SIEGEN AFEITADORA + MULTISTYLER SG-8440;PERSONAL CARE
15515682;;F;36;CHILENO;;Millenial;RENGO                         ;L.G.B.OÂ´HIGGINS;0;0;0;0;0;0;0;0;0;AFEITADORA SG-7210 NEGRO;PERSONAL CARE
16412922;;F;35;CHILENO;;Millenial;SAN JOAQUIN                   ;METROPOLITANA;0;0;0;0;0;0;0;0;0;MULTIGROOM MG5730 SERIE 5000;PERSONAL CARE
16291611;;F;36;CHILENO;;Millenial;SANTIAGO                      ;METROPOLITANA;0;0;0;0;0;0;0;0;0;CORTA PELO PG6025 KIT RECORTE;PERSONAL CARE
19660747;;M;24;CHILENO;;Z;PROVIDENCIA                   ;METROPOLITANA;0;0;0;0;0;0;0;0;0;DEPILADORA BRE225/00;PERSONAL CARE
19930515;;F;24;CHILENO;;Silencioso;PROVIDENCIA                   ;METROPOLITANA;0;0;0;0;0;0;0;0;0;ALISADOR SG3510C09 MORADO PLACAS DE CERAMICA 21;PERSONAL CARE
12728309;;F;49;CHILENO;;X;LONGAVI                       ;MAULE;0;0;0;0;0;0;0;0;0;ALISADORA SG-4751;PERSONAL CARE
13527637;Casado;F;44;CHILENO;DISENADOR GRAFICO;X;PROVIDENCIA                   ;METROPOLITANA;0;0;0;0;0;0;0;0;0;SECADOR GAMA EOLIC MINI TRAVEL;PERSONAL CARE
19186740;Soltero;F;26;CHILENO;CIRUJANO DENTISTA;Millenial;PROVIDENCIA                   ;METROPOLITANA;0;0;0;0;0;0;0;0;0;TRICOMBO SECADOR+ALISADOR+ONDULAD;PERSONAL CARE
20202122;;F;22;CHILENO;;Silencioso;PROVIDENCIA                   ;METROPOLITANA;0;0;0;0;0;0;0;0;0;ALISADOR SG3510C09 MORADO PLACAS DE CERAMICA 21;PERSONAL CARE
19675152;;F;24;CHILENO;;Z;PROVIDENCIA                   ;METROPOLITANA;0;0;0;0;0;0;0;0;0;COMBO SIEGEN AFEITADORA + MULTISTYLER SG-8440;PERSONAL CARE
17909726;;M;29;CHILENO;;Millenial;PROVIDENCIA                   ;METROPOLITANA;0;0;0;0;0;0;0;0;0;ALISADOR SG3510C09 MORADO PLACAS DE CERAMICA 21;PERSONAL CARE
19581161;Soltero;F;25;CHILENO;;Z;PROVIDENCIA                   ;METROPOLITANA;0;0;0;0;0;0;0;0;0;ALISADOR +SECADOR PELO;PERSONAL CARE
18796045;;F;28;CHILENO;;Millenial;N/D;N/D;0;0;0;0;0;0;0;0;0;ALISADOR AQUA THERAPY LED;PERSONAL CARE
18078731;;F;30;CHILENO;;Millenial;N/D;N/D;0;0;0;0;0;0;0;0;0;CORTA PELO GC-615;PERSONAL CARE
15796269;;F;38;CHILENO;;Millenial;PROVIDENCIA                   ;METROPOLITANA;0;0;0;0;0;0;0;0;0;SECADOR DE PELO SG-3025 SILVER;PERSONAL CARE
18385242;;M;29;CHILENO;;Silencioso;PROVIDENCIA                   ;METROPOLITANA;0;0;0;0;0;0;0;0;0;CORTADOR DE PELO PACL GC 542 Sport Bat GT 527;PERSONAL CARE
15624276;;F;38;CHILENO;;X;N/D;N/D;0;0;0;0;0;0;0;0;0;CORTADOR DE PELO PACL GC 542 Sport Bat GT 527;PERSONAL CARE
13536983;;F;49;CHILENO;;X;ILLAPEL                       ;COQUIMBO;0;0;0;0;0;0;0;0;0;CORTA PELO SG-8200;PERSONAL CARE
18654201;;M;28;CHILENO;;Millenial;CHIMBARONGO                   ;L.G.B.OÂ´HIGGINS;0;0;0;0;0;0;0;0;0;CORTA PELO SPORT GCX 623 BVT;PERSONAL CARE
12725220;;F;46;CHILENO;;X;RENCA                         ;METROPOLITANA;0;0;0;0;0;0;0;0;0;CORTA PELO SG-8520;PERSONAL CARE
24745453;;M;27;PERUANO;;Extranjero;N/D;N/D;0;0;0;0;0;0;0;0;0;AFEITADORA SIEGEN SG 7290 MULTISTYLER;PERSONAL CARE
15919784;;F;38;CHILENO;;Millenial;LA GRANJA;METROPOLITANA;0;0;0;0;0;0;0;0;0;DEPILADORA IPL 3500 LUZ PULSADA;PERSONAL CARE
18898776;;F;27;CHILENO;;Millenial;N/D;N/D;0;0;0;0;0;0;0;0;0;ALISADOR DE PELO S12A(220) Shine Therapy PALTA M;PERSONAL CARE
17248787;;F;33;CHILENO;;Millenial;PROVIDENCIA                   ;METROPOLITANA;0;0;0;0;0;0;0;0;0;COMBO SIEGEN AFEITADORA + MULTISTYLER SG-8440;PERSONAL CARE
16848628;;F;34;CHILENO;;Millenial;RENCA                         ;METROPOLITANA;0;0;0;0;0;0;0;0;0;CORTA PELO SG-8520;PERSONAL CARE
10950461;;F;54;CHILENO;;Boomers;VICUNA                        ;COQUIMBO;0;0;0;0;0;0;0;0;0;ONDULADOR SIEGEN SG-2352;PERSONAL CARE
8553574;;M;63;CHILENO;;Boomers;PROVIDENCIA                   ;METROPOLITANA;0;0;0;0;0;0;0;0;0;CORTA PELO GC-625;PERSONAL CARE
17297706;;M;35;CHILENO;;Millenial;PUERTO MONTT                  ;LOS LAGOS;0;0;0;0;0;0;0;0;0;SECADOR DE PELO MISTRAL STD;PERSONAL CARE
11356854;;F;54;CHILENO;;X;PUERTO MONTT                  ;LOS LAGOS;0;0;0;0;0;0;0;0;0;DEPILADORA BRE255/00;PERSONAL CARE
20029816;;F;23;CHILENO;;Z;PROVIDENCIA                   ;METROPOLITANA;0;0;0;0;0;0;0;0;0;SECADOR DE PELO STD TITAN KERATIN PLATA;PERSONAL CARE
16042217;;F;37;CHILENO;;Millenial;N/D;N/D;0;0;0;0;0;0;0;0;0;CORTA PELO GC-615;PERSONAL CARE
19084377;;F;26;CHILENO;;Silencioso;PROVIDENCIA                   ;METROPOLITANA;0;0;0;0;0;0;0;0;0;DEPILADORA IPL MAGNA PK;PERSONAL CARE
16059352;Soltero;M;36;CHILENO;;Millenial;PROVIDENCIA                   ;METROPOLITANA;0;0;0;0;0;0;0;0;0;SECADOR GAMA EOLIC MINI TRAVEL;PERSONAL CARE
14488558;;F;48;CHILENO;;X;ERCILLA                       ;ARAUCANIA;0;0;0;0;0;0;0;0;0;CORTA PELO GM 562;PERSONAL CARE
9602421;;F;60;CHILENO;;Boomers;PEDRO AGUIRRE CERDA           ;METROPOLITANA;0;0;0;0;0;0;0;0;0;CORTA PELO SPORT GCX 623 BVT;PERSONAL CARE
19880848;;F;24;CHILENO;;Z;PROVIDENCIA                   ;METROPOLITANA;0;0;0;0;0;0;0;0;0;CEPILLO ALISADOR SIEGEN SG-2805;PERSONAL CARE
18026280;;M;30;CHILENO;;Millenial;SAN BERNARDO                  ;METROPOLITANA;0;0;0;0;0;0;0;0;0;MEN SHAVER SG-7280;PERSONAL CARE
9859339;Casado;F;59;CHILENO;;Boomers;PROVIDENCIA                   ;METROPOLITANA;0;0;0;0;0;0;0;0;0;CORTAPELOS GM 596;PERSONAL CARE
9881599;;F;54;CHILENO;;X;RENCA                         ;METROPOLITANA;0;0;0;0;0;0;0;0;0;SECADOR TEMPO TITAN KERATIN;PERSONAL CARE
18707670;;M;28;CHILENO;;Millenial;ANGOL                         ;ARAUCANIA;0;0;0;0;0;0;0;0;0;AFEITADORA SG-7250 NEGRO;PERSONAL CARE
11736656;;F;51;CHILENO;;X;RENCA                         ;METROPOLITANA;0;0;0;0;0;0;0;0;0;SECADOR DE PELO DIAMOND ST BLOOM VT 220;PERSONAL CARE
8040542;;M;64;CHILENO;;Millenial;PROVIDENCIA                   ;METROPOLITANA;0;0;0;0;0;0;0;0;0;AFEITADORA SG-7210 NEGRO;PERSONAL CARE
19464950;;F;25;CHILENO;;Z;PROVIDENCIA                   ;METROPOLITANA;0;0;0;0;0;0;0;0;0;DEPILADORA SG-9003;PERSONAL CARE
17335567;;M;32;CHILENO;;Millenial;PROVIDENCIA                   ;METROPOLITANA;0;0;0;0;0;0;0;0;0;CORTA PELO PG6025 KIT RECORTE;PERSONAL CARE
16442638;;F;35;CHILENO;;Millenial;PROVIDENCIA                   ;METROPOLITANA;0;0;0;0;0;0;0;0;0;AFEITADORA BRAUN S3040;PERSONAL CARE
9851469;Soltero;M;59;CHILENO;;Boomers;RENCA                         ;METROPOLITANA;0;0;0;0;0;0;0;0;0;AFEITADORA XR1430 NEGRO;PERSONAL CARE
12673329;;F;47;CHILENO;;X;LA PINTANA                    ;METROPOLITANA;0;0;0;0;0;0;0;0;0;SECADOR DE PELO SG-3025 SILVER;PERSONAL CARE
12938500;;F;46;CHILENO;;X;RENCA                         ;METROPOLITANA;0;0;0;0;0;0;0;0;0;SECADOR PHILIPS BHC010;PERSONAL CARE
12925393;;F;47;CHILENO;;X;PUDAHUEL                      ;METROPOLITANA;0;0;0;0;0;0;0;0;0;SECADOR DE PELO SG-3051;PERSONAL CARE
9416312;;M;58;CHILENO;;Boomers;CURICO                        ;MAULE;0;0;0;0;0;0;0;0;0;AFEITADORA QP2521/50 ONE BLADE GRAFITO;PERSONAL CARE
12755129;;F;52;CHILENO;;X;N/D;N/D;0;0;0;0;0;0;0;0;0;ALISADOR DE PELO SG-3540 MORADO MORADO;PERSONAL CARE
12420482;Casado;F;48;CHILENO;;X;RENCA                         ;METROPOLITANA;0;0;0;0;0;0;0;0;0;DEPILADORA BRE225/00;PERSONAL CARE
16783415;Soltero;F;34;CHILENO;;Millenial;PROVIDENCIA                   ;METROPOLITANA;0;0;0;0;0;0;0;0;0;SECADOR DE PELO SG-3035 NEGRO;PERSONAL CARE
17491058;Casado;M;31;CHILENO;;Millenial;PROVIDENCIA                   ;METROPOLITANA;0;0;0;0;0;0;0;0;0;CORTA PELO GC-625;PERSONAL CARE
19748403;;F;24;CHILENO;;Z;PROVIDENCIA                   ;METROPOLITANA;0;0;0;0;0;0;0;0;0;AFEITADORA SPORT;PERSONAL CARE
17807305;;F;31;CHILENO;;Millenial;PROVIDENCIA                   ;METROPOLITANA;0;0;0;0;0;0;0;0;0;SECADOR DIAMOND STD;PERSONAL CARE
17063728;;M;33;CHILENO;;Millenial;PUENTE ALTO;METROPOLITANA;0;0;0;0;0;0;0;0;0;SECADOR DE PELO DIAMOND ST BLOOM VT 220;PERSONAL CARE
18265754;Soltero;F;29;CHILENO;PROFESOR;Millenial;PROVIDENCIA                   ;METROPOLITANA;0;0;0;0;0;0;0;0;0;ONDULADOR DE PELO SG-2420 33MM;PERSONAL CARE
19142922;Soltero;F;26;CHILENO;;Z;PROVIDENCIA                   ;METROPOLITANA;0;0;0;0;0;0;0;0;0;DEPILADORA BRE225/00;PERSONAL CARE
18944023;;F;30;CHILENO;;Millenial;LEBU                          ;BIO BIO;0;0;0;0;0;0;0;0;0;ALISADOR ELEGANCE LED KER;PERSONAL CARE
11787942;;F;52;CHILENO;;X;RENCA                         ;METROPOLITANA;0;0;0;0;0;0;0;0;0;SECADOR DE PELO SE-3049C01 FUCSIA;PERSONAL CARE
18700152;Soltero;M;28;CHILENO;;Millenial;PROVIDENCIA                   ;METROPOLITANA;0;0;0;0;0;0;0;0;0;CORTA PELO GM 562;PERSONAL CARE
5750550;Viudo;F;75;CHILENO;;Silencioso;RENCA                         ;METROPOLITANA;0;0;0;0;0;0;0;0;0;DEPILADORA SG-9004;PERSONAL CARE
6601403;;F;71;CHILENO;;Silencioso;RANCAGUA                      ;L.G.B.OÂ´HIGGINS;0;0;0;0;0;0;0;0;0;CORTA PELO GM 562;PERSONAL CARE
15202626;;M;41;CHILENO;;X;TIRUA                         ;BIO BIO;0;0;0;0;0;0;0;0;0;CORTA PELO HC3520;PERSONAL CARE
15093276;;F;38;CHILENO;;X;PROVIDENCIA                   ;METROPOLITANA;0;0;0;0;0;0;0;0;0;AFEITADORA SPORT SH 886 BAT;PERSONAL CARE
9778270;;M;58;CHILENO;;Boomers;QUILLOTA                      ;VALPARAISO;0;0;0;0;0;0;0;0;0;ALISADOR DE PELO SG-3512D1 ROSA;PERSONAL CARE
16881239;Soltero;F;35;CHILENO;;Millenial;CHIMBARONGO                   ;L.G.B.OÂ´HIGGINS;0;0;0;0;0;0;0;0;0;DEPILADORA SG-9040;PERSONAL CARE
15152012;;M;40;CHILENO;;X;PROVIDENCIA                   ;METROPOLITANA;0;0;0;0;0;0;0;0;0;RECORTADOR DE VELLO NT3160/15 PHILIPS;PERSONAL CARE
19921432;;M;23;CHILENO;;Silencioso;N/D;N/D;0;0;0;0;0;0;0;0;0;CORTA PELO SG-8520;PERSONAL CARE
9542967;;F;61;CHILENO;;Boomers;SAN FELIPE                    ;VALPARAISO;0;0;0;0;0;0;0;0;0;TRICOMBO SECADOR+ALISADOR+ONDULAD;PERSONAL CARE
17368824;;F;32;CHILENO;;Millenial;ARICA                         ;TARAPACA;0;0;0;0;0;0;0;0;0;ALISADOR DE PELO SG-3540 MORADO MORADO;PERSONAL CARE
20086304;;M;32;CHILENO;;Millenial;N/D;N/D;0;0;0;0;0;0;0;0;0;CORTAPELOS GM 596;PERSONAL CARE
16960415;;F;37;CHILENO;;Millenial;QUILPUE                       ;VALPARAISO;0;0;0;0;0;0;0;0;0;CORTA PELO SG-8520;PERSONAL CARE
16435045;;F;36;CHILENO;;Millenial;TRAIGUEN                      ;ARAUCANIA;0;0;0;0;0;0;0;0;0;SECADOR PELO SG-3012C20;PERSONAL CARE
13976421;;F;40;CHILENO;;X;RENCA                         ;METROPOLITANA;0;0;0;0;0;0;0;0;0;SECADOR DE PELO TEMPO 3D 220 BLACK;PERSONAL CARE
19583286;;M;25;CHILENO;;Z;N/D;N/D;0;0;0;0;0;0;0;0;0;CORTA PELO GC-625;PERSONAL CARE
19221747;Soltero;F;26;CHILENO;;Silencioso;PROVIDENCIA                   ;METROPOLITANA;0;0;0;0;0;0;0;0;0;DEPILADORA IPL 3500 LUZ PULSADA;PERSONAL CARE
17151637;;F;33;CHILENO;;Millenial;PUDAHUEL;METROPOLITANA;0;0;0;0;0;0;0;0;0;CORTA PELO GM 562;PERSONAL CARE
18238367;Soltero;M;30;CHILENO;INGENIERO INFORMATICO;Millenial;PROVIDENCIA                   ;METROPOLITANA;0;0;0;0;0;0;0;0;0;SECADOR GAMA EOLIC MINI TRAVEL;PERSONAL CARE
14203715;;F;40;CHILENO;;X;RENCA                         ;METROPOLITANA;0;0;0;0;0;0;0;0;0;AFEITADORA SG-7210 NEGRO;PERSONAL CARE
13705898;;M;42;CHILENO;;X;SAN JAVIER                    ;MAULE;0;0;0;0;0;0;0;0;0;COMBO SIEGEN AFEITADORA + MULTISTYLER SG-8440;PERSONAL CARE
8399496;;F;51;CHILENO;;X;PANGUIPULLI                   ;LOS RIOS;0;0;0;0;0;0;0;0;0;AFEITADORA S1223/41 ELECTRICA;PERSONAL CARE
17213359;;F;32;CHILENO;;Silencioso;PROVIDENCIA                   ;METROPOLITANA;0;0;0;0;0;0;0;0;0;ALISADOR DE PELO S8607 DE COCO VERDE;PERSONAL CARE
16280268;;M;36;CHILENO;;Millenial;PROVIDENCIA                   ;METROPOLITANA;0;0;0;0;0;0;0;0;0;CORTA PELO GM 562;PERSONAL CARE
15273097;;F;40;CHILENO;;X;N/D;N/D;0;0;0;0;0;0;0;0;0;CORTAPELOS GM 596;PERSONAL CARE
19960874;;F;23;CHILENO;;Silencioso;PROVIDENCIA                   ;METROPOLITANA;0;0;0;0;0;0;0;0;0;COMBO BALANZA NEGRA+SECADOR DIAMOND ST NEGRO;PERSONAL CARE
16058432;;M;37;CHILENO;;Millenial;PROVIDENCIA                   ;METROPOLITANA;0;0;0;0;0;0;0;0;0;RECORTADOR DE VELLO NT3160/15 PHILIPS;PERSONAL CARE
10979916;;F;49;CHILENO;;X;PROVIDENCIA                   ;METROPOLITANA;0;0;0;0;0;0;0;0;0;CORTAPELOS GM 596;PERSONAL CARE
6566770;;F;68;CHILENO;;Boomers;RENCA                         ;METROPOLITANA;0;0;0;0;0;0;0;0;0;SECADOR GAMA EOLIC MINI TRAVEL;PERSONAL CARE
16059629;;F;37;CHILENO;;Millenial;ILLAPEL                       ;COQUIMBO;0;0;0;0;0;0;0;0;0;ALISADOR +SECADOR PELO;PERSONAL CARE
13131927;;F;48;CHILENO;;X;PROVIDENCIA                   ;METROPOLITANA;0;0;0;0;0;0;0;0;0;SECADOR DE PELO SG-3049 NEGRO;PERSONAL CARE
15968159;;F;37;CHILENO;;Millenial;PROVIDENCIA                   ;METROPOLITANA;0;0;0;0;0;0;0;0;0;OLLA SG-1100 CALENTADORA DE CERA;PERSONAL CARE
17860888;;F;30;CHILENO;;Millenial;PROVIDENCIA                   ;METROPOLITANA;0;0;0;0;0;0;0;0;0;DEPILADORA BRE285/00 CONVENCIONAL;PERSONAL CARE
10783879;;M;53;CHILENO;;X;OSORNO                        ;LOS LAGOS;0;0;0;0;0;0;0;0;0;DEPILADORA BRE255/00;PERSONAL CARE
9093201;;F;64;CHILENO;;Boomers;RENCA                         ;METROPOLITANA;0;0;0;0;0;0;0;0;0;ALISADOR DE PELO S8607 DE COCO VERDE;PERSONAL CARE
18636552;;F;28;CHILENO;;Silencioso;PROVIDENCIA                   ;METROPOLITANA;0;0;0;0;0;0;0;0;0;SECADOR DE PELO SG-3035 NEGRO;PERSONAL CARE
20229710;;F;22;CHILENO;;Z;RENCA                         ;METROPOLITANA;0;0;0;0;0;0;0;0;0;DEPILADORA OASIS SUPREME;PERSONAL CARE
18275005;Soltero;F;29;CHILENO;RELACIONADOR PUBLICO;Millenial;PROVIDENCIA                   ;METROPOLITANA;0;0;0;0;0;0;0;0;0;SECADOR DE PELO SG-3012 NEGRO;PERSONAL CARE
19727149;;F;25;CHILENO;;Z;N/D;N/D;0;0;0;0;0;0;0;0;0;ALISADOR ELEGANCE LED QUINOA BVT;PERSONAL CARE
11260614;;F;54;CHILENO;;X;PROVIDENCIA                   ;METROPOLITANA;0;0;0;0;0;0;0;0;0;AFEITADORA SPORT;PERSONAL CARE
6483450;;M;70;CHILENO;;Silencioso;PROVIDENCIA                   ;METROPOLITANA;0;0;0;0;0;0;0;0;0;AFEITADORA XR1430 NEGRO;PERSONAL CARE
16973990;;F;32;CHILENO;;Millenial;PROVIDENCIA                   ;METROPOLITANA;0;0;0;0;0;0;0;0;0;SECADOR DE PELO SG-3035 NEGRO;PERSONAL CARE
8248580;;M;63;CHILENO;;Boomers;RENCA                         ;METROPOLITANA;0;0;0;0;0;0;0;0;0;AFEITADORA SG-7250 NEGRO;PERSONAL CARE
16706808;;M;35;CHILENO;;Millenial;CHILLAN                       ;BIO BIO;0;0;0;0;0;0;0;0;0;CORTA PELO SPORT GC 542 BVT;PERSONAL CARE
15417461;;M;41;CHILENO;;X;PROVIDENCIA                   ;METROPOLITANA;0;0;0;0;0;0;0;0;0;CORTA PELO SPORT GC 542 BVT;PERSONAL CARE
11008978;Casado;F;57;CHILENO;;Boomers;VINA DEL MAR                  ;VALPARAISO;0;0;0;0;0;0;0;0;0;ALISADOR GAMA ELEGANCE;PERSONAL CARE
18552235;;F;29;CHILENO;;Millenial;QUILPUE                       ;VALPARAISO;0;0;0;0;0;0;0;0;0;CORTA PELO SPORT GCX 623 BVT;PERSONAL CARE
8781393;;M;62;CHILENO;;Boomers;RENCA                         ;METROPOLITANA;0;0;0;0;0;0;0;0;0;DEPILADORA SG-9004;PERSONAL CARE
17611512;;M;31;CHILENO;;Millenial;LA FLORIDA                    ;METROPOLITANA;0;0;0;0;0;0;0;0;0;ALISADOR ELEGANCE KERATION ST BVT;PERSONAL CARE
13987701;;F;41;CHILENO;;X;N/D;N/D;0;0;0;0;0;0;0;0;0;CORTA PELO GM 562;PERSONAL CARE
13745342;;F;41;CHILENO;;X;FREIRINA                      ;ATACAMA;0;0;0;0;0;0;0;0;0;ALISADOR DE PELO S9100 PRO THERMA-LUXE;PERSONAL CARE
17633009;;F;31;CHILENO;;Millenial;CALBUCO                       ;LOS LAGOS;0;0;0;0;0;0;0;0;0;SECADOR DIAMOND STD;PERSONAL CARE
11755292;;M;51;CHILENO;;X;RENCA                         ;METROPOLITANA;0;0;0;0;0;0;0;0;0;AFEITADORA PR1342 ROTATIVA RECARGABLE;PERSONAL CARE
13946085;;F;41;CHILENO;;X;RENCA                         ;METROPOLITANA;0;0;0;0;0;0;0;0;0;AFEITADORA S1323/41 ELECTRICA;PERSONAL CARE
9793060;;F;59;CHILENO;;Boomers;RENCA                         ;METROPOLITANA;0;0;0;0;0;0;0;0;0;ONDULADOR DE PELO SG-2420 33MM;PERSONAL CARE
17330203;Casado;F;33;CHILENO;;Millenial;PROVIDENCIA                   ;METROPOLITANA;0;0;0;0;0;0;0;0;0;CORTA PELO SPORT GC 542 BVT;PERSONAL CARE
16213989;Soltero;F;36;CHILENO;;Millenial;PANGUIPULLI                   ;LOS RIOS;0;0;0;0;0;0;0;0;0;TRICOMBO SECADOR+ALISADOR+ONDULAD;PERSONAL CARE
7149247;;M;65;CHILENO;;Boomers;RENCA                         ;METROPOLITANA;0;0;0;0;0;0;0;0;0;ALISADOR DE PELO ERGOSTYLER ION DUO ROJO;PERSONAL CARE
12684125;Casado;F;48;CHILENO;;X;VINA DEL MAR                  ;VALPARAISO;0;0;0;0;0;0;0;0;0;CORTA PELO HC3505;PERSONAL CARE
19217023;Soltero;F;26;CHILENO;;Z;PROVIDENCIA                   ;METROPOLITANA;0;0;0;0;0;0;0;0;0;DEPILADORA CYBELE IPL GOLD 200 MIL PULSACIONES;PERSONAL CARE
16077352;;M;37;CHILENO;;Millenial;PROVIDENCIA                   ;METROPOLITANA;0;0;0;0;0;0;0;0;0;ALISADOR DE PELO ELEGANCE TITAN KERATIN LED GRIS;PERSONAL CARE
18260487;Soltero;F;29;CHILENO;;Millenial;PROVIDENCIA                   ;METROPOLITANA;0;0;0;0;0;0;0;0;0;AFEITADORA S1323 + Toalla y Set afeitado;PERSONAL CARE
11442370;;M;53;CHILENO;;X;PROVIDENCIA                   ;METROPOLITANA;0;0;0;0;0;0;0;0;0;CORTA PELO SG-8200;PERSONAL CARE
16441355;;F;35;CHILENO;;Millenial;PROVIDENCIA                   ;METROPOLITANA;0;0;0;0;0;0;0;0;0;CORTA PELO SG-8520;PERSONAL CARE
18175946;;F;30;CHILENO;;Millenial;TALCA                         ;MAULE;0;0;0;0;0;0;0;0;0;DEPILADORA SG-9004EX;PERSONAL CARE
10447805;;F;56;CHILENO;;Boomers;PROVIDENCIA                   ;METROPOLITANA;0;0;0;0;0;0;0;0;0;CORTA PELO HC3520;PERSONAL CARE
18532424;;M;28;CHILENO;;Millenial;COPIAPO                       ;ATACAMA;0;0;0;0;0;0;0;0;0;ALISADOR ELEGANCE LED QUINOA BVT;PERSONAL CARE
7447664;;M;65;CHILENO;;Boomers;VALPARAISO                    ;VALPARAISO;0;0;0;0;0;0;0;0;0;SECADOR DE PELO D13A-220-R PLATA;PERSONAL CARE
10430042;Divorciado;M;56;CHILENO;;Boomers;CONSTITUCION                  ;MAULE;0;0;0;0;0;0;0;0;0;DEPILADORA GAMA ESSENCIAL;PERSONAL CARE
10343314;;F;54;CHILENO;;X;RENCA                         ;METROPOLITANA;0;0;0;0;0;0;0;0;0;SECADOR DE PELO SE-3049C01 FUCSIA;PERSONAL CARE
19163986;Soltero;F;26;CHILENO;;Z;PROVIDENCIA                   ;METROPOLITANA;0;0;0;0;0;0;0;0;0;SECADOR DE PELO SG-3035 NEGRO;PERSONAL CARE
15945206;;F;37;CHILENO;;Millenial;CORONEL                       ;BIO BIO;0;0;0;0;0;0;0;0;0;AFEITADORA QP2521/50 ONE BLADE GRAFITO;PERSONAL CARE
12376050;;F;49;CHILENO;;X;CHILLAN                       ;BIO BIO;0;0;0;0;0;0;0;0;0;AFEITADORA PR1342 ROTATIVA RECARGABLE;PERSONAL CARE
10652046;;F;54;CHILENO;;Boomers;PROVIDENCIA                   ;METROPOLITANA;0;0;0;0;0;0;0;0;0;DEPILADORA SG-9003;PERSONAL CARE
13459571;;M;47;CHILENO;;X;QUILICURA                     ;METROPOLITANA;0;0;0;0;0;0;0;0;0;DEPILADORA SG-9003;PERSONAL CARE
13986014;;F;40;CHILENO;;X;CALERA                        ;VALPARAISO;0;0;0;0;0;0;0;0;0;CORTA PELO SG-8520;PERSONAL CARE
9091507;;F;61;CHILENO;;Boomers;RENCA                         ;METROPOLITANA;0;0;0;0;0;0;0;0;0;CORTA PELO SPORT GCX 623 BVT;PERSONAL CARE
15199428;Casado;M;39;CHILENO;;X;PROVIDENCIA                   ;METROPOLITANA;0;0;0;0;0;0;0;0;0;SECADOR PELO SG-3012C19;PERSONAL CARE
20031702;;F;23;CHILENO;;Z;PROVIDENCIA                   ;METROPOLITANA;0;0;0;0;0;0;0;0;0;CORTA PELO SG-8200;PERSONAL CARE
14249368;;M;47;CHILENO;;X;YUMBEL                        ;BIO BIO;0;0;0;0;0;0;0;0;0;CORTA PELO SG-8200;PERSONAL CARE
8151897;Divorciado;F;63;CHILENO;;Boomers;RENCA                         ;METROPOLITANA;0;0;0;0;0;0;0;0;0;SECADOR PELO SG-3012C19;PERSONAL CARE
10939864;;F;54;CHILENO;;Boomers;QUILPUE                       ;VALPARAISO;0;0;0;0;0;0;0;0;0;ALISADOR DE PELO SG-3540 MORADO MORADO;PERSONAL CARE
11123787;Casado;F;54;CHILENO;INGENIERO EN ADMINISTRACION DE EMPRESAS;Boomers;PROVIDENCIA                   ;METROPOLITANA;0;0;0;0;0;0;0;0;0;CORTAPELOS GM 596;PERSONAL CARE
7534778;;F;66;CHILENO;;Boomers;TEMUCO                        ;ARAUCANIA;0;0;0;0;0;0;0;0;0;DEPILADORA OASIS LOOK BVT;PERSONAL CARE
17612411;;F;31;CHILENO;;Millenial;"";"";0;0;0;0;0;0;0;0;0;ALISADOR ELEGANCE LED BLOOM VT;PERSONAL CARE
9752967;;M;59;CHILENO;;Boomers;PROVIDENCIA                   ;METROPOLITANA;0;0;0;0;0;0;0;0;0;SECADOR DE PELO SG-3051;PERSONAL CARE
12801166;;F;47;CHILENO;;X;ARICA                         ;ARICA Y PARINACOTA;0;0;0;0;0;0;0;0;0;AFEITADORA S1223/41 ELECTRICA;PERSONAL CARE
18756947;Soltero;M;28;CHILENO;;Millenial;PROVIDENCIA                   ;METROPOLITANA;0;0;0;0;0;0;0;0;0;CORTA PELO SPORT GCX 623 BVT;PERSONAL CARE
17543603;;F;32;CHILENO;;Millenial;N/D;N/D;0;0;0;0;0;0;0;0;0;DEPILADORA GAMA ESSENCIAL;PERSONAL CARE
7097467;Soltero;M;70;CHILENO;;Silencioso;PROVIDENCIA                   ;METROPOLITANA;0;0;0;0;0;0;0;0;0;AFEITADORA PR1342 ROTATIVA RECARGABLE;PERSONAL CARE
14442369;;M;48;CHILENO;;X;QUILPUE                       ;VALPARAISO;0;0;0;0;0;0;0;0;0;CORTA PELO GM 562;PERSONAL CARE
8087094;Casado;F;61;CHILENO;;Boomers;PROVIDENCIA                   ;METROPOLITANA;0;0;0;0;0;0;0;0;0;ALISADOR ATTIVA STD;PERSONAL CARE
6598611;;F;66;CHILENO;;Boomers;RENCA                         ;METROPOLITANA;0;0;0;0;0;0;0;0;0;CORTA PELO MGK3220 BLACK BOX MN;PERSONAL CARE
11362411;;F;53;CHILENO;;X;EL MONTE                      ;METROPOLITANA;0;0;0;0;0;0;0;0;0;DEPILADORA SG-9004;PERSONAL CARE
18090828;Soltero;F;30;CHILENO;;Millenial;PROVIDENCIA                   ;METROPOLITANA;0;0;0;0;0;0;0;0;0;DEPILADORA SKIN Pro Go 2;PERSONAL CARE
14183435;;F;41;CHILENO;;X;PUENTE ALTO                   ;METROPOLITANA;0;0;0;0;0;0;0;0;0;CORTA PELO MGK3220 BLACK BOX MN;PERSONAL CARE
9121191;;F;49;CHILENO;;X;QUILPUE                       ;VALPARAISO;0;0;0;0;0;0;0;0;0;SECADOR PELO SG-3012C19;PERSONAL CARE
9421163;Casado;F;58;CHILENO;ACUPUNTURISTA;Boomers;RINCONADA                     ;VALPARAISO;0;0;0;0;0;0;0;0;0;CORTAPELOS GM 596;PERSONAL CARE
17594901;;F;31;CHILENO;;Millenial;N/D;N/D;0;0;0;0;0;0;0;0;0;Secador Potenza Keration;PERSONAL CARE
18255107;Soltero;F;29;CHILENO;AUXILIAR PARAMEDICO DE ESTERILIZACION;Millenial;PROVIDENCIA                   ;METROPOLITANA;0;0;0;0;0;0;0;0;0;ALISADOR +SECADOR PELO;PERSONAL CARE
17024389;;F;33;CHILENO;;Millenial;PROVIDENCIA                   ;METROPOLITANA;0;0;0;0;0;0;0;0;0;DEPILADORA IPL 3500 LUZ PULSADA;PERSONAL CARE
17196108;;F;32;CHILENO;;Millenial;NIQUEN                        ;BIO BIO;0;0;0;0;0;0;0;0;0;DEPILADORA HP-6543;PERSONAL CARE
17990832;;F;30;CHILENO;;Millenial;PROVIDENCIA                   ;METROPOLITANA;0;0;0;0;0;0;0;0;0;SECADOR DE PELO SG-3012 NEGRO;PERSONAL CARE
5998207;;F;69;CHILENO;;Silencioso;SAN CARLOS                    ;BIO BIO;0;0;0;0;0;0;0;0;0;DEPILADORA GAMA ESSENCIAL;PERSONAL CARE
17334064;;M;32;CHILENO;;Millenial;SAN VICENTE                   ;L.G.B.OÂ´HIGGINS;0;0;0;0;0;0;0;0;0;AFEITADORA SG-7210 NEGRO;PERSONAL CARE
13168536;Divorciado;F;45;CHILENO;;X;RENCA                         ;METROPOLITANA;0;0;0;0;0;0;0;0;0;SECADOR PELO SG-3012C19;PERSONAL CARE
17474521;;F;32;CHILENO;;Millenial;PROVIDENCIA                   ;METROPOLITANA;0;0;0;0;0;0;0;0;0;ALISADOR DE PELO SG-3540 MORADO MORADO;PERSONAL CARE
18806404;;F;27;CHILENO;;Z;N/D;N/D;0;0;0;0;0;0;0;0;0;ALISADOR DE PELO S12A(220) Shine Therapy PALTA M;PERSONAL CARE
15783702;Soltero;F;38;CHILENO;CIENTISTA POLITICO;Millenial;RENCA                         ;METROPOLITANA;0;0;0;0;0;0;0;0;0;CORTA PELO GM 562;PERSONAL CARE
9156485;;F;61;CHILENO;;Boomers;PROVIDENCIA                   ;METROPOLITANA;0;0;0;0;0;0;0;0;0;CORTA PELO GM 562;PERSONAL CARE
17296817;;F;33;CHILENO;;Millenial;VALDIVIA                      ;LOS LAGOS;0;0;0;0;0;0;0;0;0;SECADOR DE PELO SG-3049 NEGRO;PERSONAL CARE
18843719;;F;28;CHILENO;;Millenial;"";"";0;0;0;0;0;0;0;0;0;SECADOR GAMA EOLIC MINI TRAVEL;PERSONAL CARE
8842586;;F;60;CHILENO;;Boomers;LOTA                          ;BIO BIO;0;0;0;0;0;0;0;0;0;DEPILADORA HP-6543;PERSONAL CARE
18853904;;F;28;CHILENO;;Millenial;N/D;N/D;2118950;5;3;5;3;2118950;0;0;0;MOTO HONDA CB125F TWISTER AZUL;MOTOCICLETAS
16800684;;F;34;CHILENO;;Millenial;PROVIDENCIA                   ;METROPOLITANA;93980;2;1;2;1;93980;0;0;0;Juego comedor Perola Blanco 4 sillas Nicoli Blan;MERCADO ABC
19535097;;F;25;CHILENO;;Z;OSORNO;LOS LAGOS;120950;5;2;5;2;120950;0;0;0;Rack TV 2 nichos Off white RT3153BL;MERCADO ABC
11653616;;M;52;CHILENO;;X;PROVIDENCIA                   ;METROPOLITANA;71970;3;2;0;0;0;3;2;71970;TETERA SABAL 2,0 LTS.;MERCADO ABC
20299262;;F;22;CHILENO;;Z;MAIPU;METROPOLITANA;89940;5;1;5;1;89940;0;0;0;Sabana Polar Est. 2 P Parati;MERCADO ABC
12564998;;M;48;CHILENO;;X;"";"";120960;4;2;4;2;120960;0;0;0;UKULELE 23 ELECTROACUSTICO MUK07E;MERCADO ABC
17746777;;F;31;CHILENO;;Millenial;RENCA                         ;METROPOLITANA;316980;2;1;2;1;316980;0;0;0;SECCIONAL IRLANDA TELA C/CAFE;MERCADO ABC
15092456;;F;39;CHILENO;;Extranjero;PROVIDENCIA                   ;METROPOLITANA;146980;2;1;2;1;146980;0;0;0;Kit Seguridad Interior-Exterior HD KITM40L;MERCADO ABC
9176581;;F;59;CHILENO;;Boomers;RENCA                         ;METROPOLITANA;32980;2;1;2;1;32980;0;0;0;Set de Utensilios 8 piezas c/ Bowl SPRING;MERCADO ABC
12662163;;F;47;CHILENO;;X;TALAGANTE;METROPOLITANA;37970;3;1;3;1;37970;0;0;0;Set Cortinas Jacquard Argolla 140x220 Silueta Tu;MERCADO ABC
16834432;;M;34;CHILENO;;Extranjero;PROVIDENCIA                   ;METROPOLITANA;177980;2;1;2;1;177980;0;0;0;Silla De Auto Convertible I-Giro 360Ã¸ Light Gre;MERCADO ABC
12030573;Casado;F;53;CHILENO;PREVENCION DE RIESGOS;X;RENCA                         ;METROPOLITANA;853900;9;2;9;2;853900;0;0;0;Vitrina 1 Puerta Malta Blanca 40x36x158cm;MERCADO ABC
16261053;;F;36;CHILENO;;Millenial;N/D;N/D;771500;6;3;4;2;471520;2;1;299980;KIT COCINA 120 PORRA;MERCADO ABC
16568827;;F;34;CHILENO;;Millenial;PAINE;METROPOLITANA;114960;4;2;4;2;114960;0;0;0;Balancin Cocodrilo;MERCADO ABC
18266080;;M;29;CHILENO;;Millenial;TENO                          ;MAULE;207980;2;1;2;1;207980;0;0;0;Bicicleta De Spinning Boonen K-FIT;MERCADO ABC
11771600;;M;50;CHILENO;;X;"";"";350980;2;1;2;1;350980;0;0;0;Seccional Intercambiable Donato Beige;MERCADO ABC
13249487;;F;45;CHILENO;;X;PUENTE ALTO                   ;METROPOLITANA;33980;2;1;2;1;33980;0;0;0;BATERIA 12 PZ. MONTERREY INOX;MERCADO ABC
16510600;;F;35;CHILENO;;Millenial;RENCA                         ;METROPOLITANA;35980;2;1;2;1;35980;0;0;0;Plumon Coral Sherpa 2 P Morado;MERCADO ABC
19054768;;M;27;CHILENO;;Z;"";"";45970;3;1;3;1;45970;0;0;0;Set Mancuernas Con Barra Ajustable 10Kg K-FIT;MERCADO ABC
16789812;;F;34;CHILENO;;Millenial;SAN MIGUEL                    ;METROPOLITANA;33980;2;1;2;1;33980;0;0;0;BATERIA 12 PZ. MONTERREY INOX;MERCADO ABC
16509424;;M;35;CHILENO;;Millenial;VALPARAISO                    ;VALPARAISO;87980;2;1;2;1;87980;0;0;0;RACK EXTENSIBLE BEIJING WENGUE;MERCADO ABC
15998570;;F;37;CHILENO;;Millenial;SAN PEDRO DE LA PAZ;BIO-BIO;935950;5;3;4;2;900960;1;1;34990;ESCRITORIO GAMER EVOLUTION NEGRO/ROJO;MERCADO ABC
17802655;;M;31;CHILENO;;Millenial;PROVIDENCIA                   ;METROPOLITANA;89980;2;1;2;1;89980;0;0;0;RACK CORALINA TV55 - MIEL / HABANO;MERCADO ABC
13289035;;F;44;CHILENO;;X;LAMPA                         ;METROPOLITANA;604960;4;2;4;2;604960;0;0;0;Trotadora Electrica Spirig 1,5HP;MERCADO ABC
8795737;;F;59;CHILENO;;Boomers;PROVIDENCIA                   ;METROPOLITANA;229980;2;1;2;1;229980;0;0;0;Estante modelo 947 tv hasta 60 color duna;MERCADO ABC
6058467;Divorciado;M;70;CHILENO;MEDICO CIRUJANO;Silencioso;RENCA                         ;METROPOLITANA;30980;2;1;2;1;30980;0;0;0;TABLA DE PLANCHAR ROB BLANCO FVTX;MERCADO ABC
16550310;;F;35;CHILENO;;Millenial;SAN FELIPE;VALPARAISO;64980;2;1;2;1;64980;0;0;0;MESA FUNCIONAL 5G-1 - CENIZA / WENGUE MZW 6266;MERCADO ABC
15783278;;F;38;CHILENO;;Millenial;PROVIDENCIA                   ;METROPOLITANA;750980;2;1;2;1;750980;0;0;0;COMEDOR 1.8 JULIEN+6S TAI;MERCADO ABC
16064776;;F;36;CHILENO;;Millenial;PICHILEMU                     ;L.G.B.OÂ´HIGGINS;412980;2;1;2;1;412980;0;0;0;SOFA MIRA 3 CPO EBCA VISON RSN;MERCADO ABC
18546427;Soltero;F;28;CHILENO;;Millenial;PROVIDENCIA                   ;METROPOLITANA;33980;2;1;2;1;33980;0;0;0;MESA PIZARRA 2 EN 1;MERCADO ABC
17604975;;F;32;CHILENO;;Millenial;N/D;N/D;65470;3;1;3;1;65470;0;0;0;Parrilla Portatil Carbon Kettle Roja 17;MERCADO ABC
20603472;;M;21;CHILENO;;Z;PROVIDENCIA                   ;METROPOLITANA;679980;2;1;2;1;679980;0;0;0;Trotadora RUNNER PRF 550 con APP ZWIFT Negro;MERCADO ABC
14014844;;F;41;CHILENO;;X;TENO                          ;MAULE;108980;2;1;2;1;108980;0;0;0;RACK ROMAZINO TV70 - HABANO;MERCADO ABC
15192026;;F;40;CHILENO;;X;CORONEL;BIO-BIO;148730;7;3;6;2;118740;1;1;29990;Equipo de grabacion XVR-DVR 2MP XvrN24;MERCADO ABC
20447841;;M;22;CHILENO;;Silencioso;PROVIDENCIA                   ;METROPOLITANA;370470;3;2;3;2;370470;0;0;0;Set Mancuernas Con Barra Ajustable 40Kg K-FIT;MERCADO ABC
15372718;Casado;M;40;CHILENO;INGENIERO;Silencioso;PROVIDENCIA                   ;METROPOLITANA;43980;2;1;2;1;43980;0;0;0;RACK INVY TV40 - WENGUE;MERCADO ABC
11521414;;F;52;CHILENO;;X;CASABLANCA                    ;VALPARAISO;267950;5;5;0;0;0;5;5;267950;GUITARRA ELECTROACUSTICA MEAN1 NEGRA;MERCADO ABC
8022639;;M;62;CHILENO;;Boomers;ARICA                         ;ARICA Y PARINACOTA;181540;2;1;2;1;181540;0;0;0;PARRILLA A GAS PGM-2QIN;MERCADO ABC
19602177;;F;25;CHILENO;;Z;PROVIDENCIA                   ;METROPOLITANA;22980;2;1;2;1;22980;0;0;0;ANDADOR MOBY 7106 VERDE;MERCADO ABC
19327047;Soltero;F;25;CHILENO;;Z;PROVIDENCIA                   ;METROPOLITANA;22980;2;1;2;1;22980;0;0;0;ANDADOR ACTIVIDADES LEON;MERCADO ABC
6702291;;M;70;CHILENO;;Silencioso;MAIPU;METROPOLITANA;133980;2;1;2;1;133980;0;0;0;Banca De Pesas Multifuncional Plegable K-FIT;MERCADO ABC
16599402;;M;35;CHILENO;;Silencioso;N/D;N/D;939800;6;2;6;2;939800;0;0;0;SET 2 SILLAS BOLONIA;MERCADO ABC
25901539;;F;47;COLOMBIANO;;Extranjero;N/D;N/D;6990;1;1;0;0;0;1;1;6990;Balon Puma Big Cat 2 Ball Amarillo-rojo-negro;MERCADO ABC
16219591;;M;35;CHILENO;;Millenial;"";"";60840;2;1;2;1;60840;0;0;0;S Comer Snack SXROSADA;MERCADO ABC
10651392;;F;52;CHILENO;;X;SAN PEDRO DE LA PAZ           ;BIO BIO;74990;1;1;0;0;0;1;1;74990;GUITARRA ELECTROACUSTICA MEAN1 NEGRA;MERCADO ABC
18038819;;F;30;CHILENO;;Millenial;QUINTA DE TILCOCO;O HIGGINS;99540;2;1;2;1;99540;0;0;0;RACK TV50 MARSELLA - GALES / DUNA RGD 4298;MERCADO ABC
17362258;;F;32;CHILENO;;Millenial;OVALLE                        ;COQUIMBO;79540;2;1;2;1;79540;0;0;0;PANEL TV55 BEIJING CONAC PLC 4398;MERCADO ABC
20564273;;F;21;CHILENO;;Z;SAN JAVIER                    ;MAULE;9990;1;1;0;0;0;1;1;9990;Plato Plegable Perro Para Preparar Comida Naranj;MERCADO ABC
17555154;Soltero;M;30;CHILENO;;Millenial;PROVIDENCIA                   ;METROPOLITANA;411540;2;1;2;1;411540;0;0;0;Trotadora Electrica Spirig 1,5HP;MERCADO ABC
16243753;;F;37;CHILENO;;Millenial;SAN CARLOS                    ;BIO BIO;108980;2;1;2;1;108980;0;0;0;MUEBLE DE COCINA KITCHEN 90 - BLANCO / WENGUE;MERCADO ABC
10916722;;M;51;CHILENO;;X;PROVIDENCIA                   ;METROPOLITANA;0;0;0;0;0;0;0;0;0;TECLADO MINI SA-47AH2;MERCADO ABC
17432323;;F;32;CHILENO;;Millenial;N/D;N/D;0;0;0;0;0;0;0;0;0;Colchoneta Outback Eva Aluminizada;MERCADO ABC
20044494;;F;23;CHILENO;;Silencioso;PROVIDENCIA                   ;METROPOLITANA;0;0;0;0;0;0;0;0;0;JUEGO COMEDOR ANGELMO 4 SILLAS;MERCADO ABC
18905505;;F;27;CHILENO;;Millenial;N/D;N/D;0;0;0;0;0;0;0;0;0;BLOQUES 1000 PCS;MERCADO ABC
12442806;;F;49;CHILENO;;X;PROVIDENCIA                   ;METROPOLITANA;0;0;0;0;0;0;0;0;0;SILLA METALICA ACERO;MERCADO ABC
8714827;;F;57;CHILENO;;Boomers;N/D;N/D;0;0;0;0;0;0;0;0;0;Bateria de Cocina Ollas 10 Piezas Ceramica Berri;MERCADO ABC
9357229;;F;59;CHILENO;;Boomers;LO PRADO                      ;METROPOLITANA;0;0;0;0;0;0;0;0;0;TECLADO CT-S300C2 ESTANDAR CASIOTONE CASIO C/TRA;MERCADO ABC
16902255;;F;33;CHILENO;;Millenial;PROVIDENCIA                   ;METROPOLITANA;0;0;0;0;0;0;0;0;0;BANO PLEGABLE BASICO;MERCADO ABC
8710903;;F;64;CHILENO;;Boomers;RECOLETA                      ;METROPOLITANA;0;0;0;0;0;0;0;0;0;GRUA CONTROL REMOTO;MERCADO ABC
18852032;Soltero;M;27;CHILENO;;Millenial;TEMUCO                        ;ARAUCANIA;0;0;0;0;0;0;0;0;0;TECLADO CT-S100 61 TECLAS CON TRANSFORMADOR;MERCADO ABC
9606672;;M;58;CHILENO;;Boomers;RENCA                         ;METROPOLITANA;0;0;0;0;0;0;0;0;0;JUEGO COMEDOR KELLY 4 SILLAS;MERCADO ABC
16519867;;F;35;CHILENO;;Millenial;N/D;N/D;0;0;0;0;0;0;0;0;0;CALABRIA 6 SILLAS ARENA;MERCADO ABC
15212381;;M;40;CHILENO;;X;PROVIDENCIA                   ;METROPOLITANA;0;0;0;0;0;0;0;0;0;SOFA CAMA MURANO TELA GRAFITO RSN;MERCADO ABC
16231598;;F;37;CHILENO;;Millenial;N/D;N/D;0;0;0;0;0;0;0;0;0;CARRITO CON BLOQUES;MERCADO ABC
18428075;;M;29;CHILENO;;Millenial;RENCA                         ;METROPOLITANA;0;0;0;0;0;0;0;0;0;TECLADO CTK-2550K2 ESTANDAR C/TRANSFORMADOR;MERCADO ABC
8227528;Casado;M;61;CHILENO;PROFESOR;Boomers;RENCA                         ;METROPOLITANA;0;0;0;0;0;0;0;0;0;CENTRO DE COMANDO FRESH METAL;MERCADO ABC
13264510;Soltero;M;45;CHILENO;;X;RENCA                         ;METROPOLITANA;0;0;0;0;0;0;0;0;0;DINOSAURIO CON 30 BLOQUES Y SONIDOS;MERCADO ABC
11130962;;F;55;CHILENO;;Boomers;PROVIDENCIA                   ;METROPOLITANA;0;0;0;0;0;0;0;0;0;AUTO R/C DESERT REBELS 070 MAY;MERCADO ABC
9424348;;F;56;CHILENO;;Boomers;PROVIDENCIA                   ;METROPOLITANA;0;0;0;0;0;0;0;0;0;SET 125 DESAFIOS CIENTIFICOS;MERCADO ABC
5681974;;M;73;CHILENO;;Silencioso;CALDERA                       ;ATACAMA;0;0;0;0;0;0;0;0;0;BATMAN REALIDAD VIRTUAL 765 FYF;MERCADO ABC
7832285;Casado;F;67;CHILENO;;Boomers;PROVIDENCIA                   ;METROPOLITANA;0;0;0;0;0;0;0;0;0;CUCHILLERIA 24P ACERO AUSTRIA;MERCADO ABC
15929259;;F;36;CHILENO;;Millenial;PROVIDENCIA                   ;METROPOLITANA;0;0;0;0;0;0;0;0;0;DINOSAURIO CON 30 BLOQUES Y SONIDOS;MERCADO ABC
13127437;;F;44;CHILENO;;X;SAN CARLOS                    ;BIO BIO;0;0;0;0;0;0;0;0;0;GYM SELVA FINGERLINGS 732 INT;MERCADO ABC
14385009;;M;44;CHILENO;;X;NUNOA                         ;METROPOLITANA;0;0;0;0;0;0;0;0;0;GUITARRA CLASICA MS139 39 NEGRO;MERCADO ABC
10124934;;M;49;CHILENO;;X;RENCA                         ;METROPOLITANA;0;0;0;0;0;0;0;0;0;SABANA POLAR ESTAMPADA MUSTARD 1,5P;MERCADO ABC
17772643;;M;31;CHILENO;;Millenial;COPIAPO                       ;ATACAMA;0;0;0;0;0;0;0;0;0;HW PAQUETE DE 20 AUTOS;MERCADO ABC
11111481;Casado;M;55;CHILENO;AGROINDUSTRIA;Boomers;SAN CARLOS                    ;BIO BIO;0;0;0;0;0;0;0;0;0;QUITASOL PUSH UP D260CMxH240CM;MERCADO ABC
15611116;Casado;F;38;CHILENO;PSICOLOGA;X;RENCA                         ;METROPOLITANA;0;0;0;0;0;0;0;0;0;COMEDOR TERRAZA AMPLIABLE;MERCADO ABC
23162399;;F;39;CHILENO;;Extranjero;CALAMA                        ;ANTOFAGASTA;0;0;0;0;0;0;0;0;0;LANZADOR DE AGUA LANZA 6M 2.2L;MERCADO ABC
15814125;;F;37;CHILENO;;Millenial;PROVIDENCIA                   ;METROPOLITANA;0;0;0;0;0;0;0;0;0;SET ARTISTA BIA;MERCADO ABC
6838224;;F;74;CHILENO;;Silencioso;LOS ANGELES                   ;BIO BIO;0;0;0;0;0;0;0;0;0;SABANA 200H PREMIUM WHITE 1,5P;MERCADO ABC
