CUSTOMER_ID;ESTADO_CIVIL;SEXO;EDAD;NACIONALIDAD;PROFESION;GENERACION_CLIENTE;COMUNA_CLIENTE;CIUDAD_CLIENTE;SUMA_INGRESOS_12;CANTIDAD_PRODUCTOS_12;SUMA_BOLETAS_12;CANTIDAD_UNIDADES_ECOMMERCE_12;SUMA_BOLETAS_ECOMMERCE_12;SUMA_INGRESOS_ECOMMERCE_12;CANTIDAD_UNIDADES_TIENDA_12;SUMA_BOLETAS_TIENDA_12;SUMA_INGRESOS_TIENDA_12;ULTIMO_PRODUCTO_COMPRADO;LINEA_ULTIMO_PRODUCTO_COMPRDO
7438629;;F;65;CHILENO;;Boomers;MOSTAZAL                      ;L.G.B.OÂ´HIGGINS;99990;1;1;0;0;0;1;1;99990;CAMA ELASTICA (3,05M) CON MALLA GAMEPOWER AZUL;OUTDOOR
18709420;;F;28;CHILENO;;Millenial;PROVIDENCIA                   ;METROPOLITANA;16980;2;1;2;1;16980;0;0;0;Scooter Peluche Dinosaurio y Luces Led KeyRiders;OUTDOOR
10751068;;M;53;CHILENO;;X;LAS CONDES                    ;METROPOLITANA;201980;2;1;2;1;201980;0;0;0;V-COLUMPIO 4 ESTACIONES GAMEPOWER;OUTDOOR
13349399;;F;43;CHILENO;;X;PROVIDENCIA                   ;METROPOLITANA;188538;7;3;0;0;0;7;3;188538;Juego de Mesa Camcorro 10 en 1;OUTDOOR
9914124;;F;56;CHILENO;;Boomers;SAN FELIPE                    ;VALPARAISO;560940;6;7;0;0;0;6;7;560940;PISCINA RECTANGULAR 150CM BESTWAY AZUL;OUTDOOR
26001619;;M;37;HAITIANO;;Extranjero;MELIPILLA                     ;METROPOLITANA;327960;4;4;0;0;0;4;4;327960;Cuatrimoto Electrica Force Rosada;OUTDOOR
14127304;;M;41;CHILENO;;X;PROVIDENCIA                   ;METROPOLITANA;20980;2;1;2;1;20980;0;0;0;V-SACO DE DORMIR MUMMY AZUL;OUTDOOR
13378474;;F;44;CHILENO;;X;CHILLAN                       ;BIO BIO;42965;4;2;0;0;0;4;2;42965;Scooter con Vapor KeyRiders;OUTDOOR
25140925;;F;37;VENEZOLANO;;Extranjero;PROVIDENCIA                   ;METROPOLITANA;32960;4;2;4;2;32960;0;0;0;Columpio Goma Eva Glowup Rojo;OUTDOOR
12741263;;F;47;CHILENO;;X;SAAVEDRA                      ;ARAUCANIA;341970;3;2;0;0;0;3;2;341970;CAMA ELASTICA (2,44M) CON MALLA GAMEPOWER AZUL;OUTDOOR
8932014;;F;46;CHILENO;;X;N/D;N/D;169980;2;2;0;0;0;2;2;169980;CAMA ELASTICA (2,44M) CON MALLA GAMEPOWER AZUL;OUTDOOR
13424314;Casado;F;44;CHILENO;BIOLOGO MARINO;X;PROVIDENCIA                   ;METROPOLITANA;16990;1;1;1;1;16990;0;0;0;Juego de Mesa Camcorro 10 en 1;OUTDOOR
18745655;Soltero;F;28;CHILENO;;Millenial;PROVIDENCIA                   ;METROPOLITANA;33980;2;1;0;0;0;2;1;33980;COLCHON 2 PZA 203X152X22 CM;OUTDOOR
14552035;;M;43;CHILENO;;X;VILLA ALEMANA                 ;VALPARAISO;16990;1;1;1;1;16990;0;0;0;Juego de Mesa Camcorro 10 en 1;OUTDOOR
16682395;;M;34;CHILENO;;Millenial;PROVIDENCIA                   ;METROPOLITANA;238980;2;1;2;1;238980;0;0;0;PISCINA ESTRUCTURAL STEEL PRO 5700LT;OUTDOOR
10965148;;M;53;CHILENO;;X;PROVIDENCIA                   ;METROPOLITANA;117480;2;1;2;1;117480;0;0;0;CARPA BALTIMORE III NATIONAL GEOGRAPHIC;OUTDOOR
19282197;;F;26;CHILENO;;Z;N/D;N/D;93980;2;1;2;1;93980;0;0;0;PISCINA STEEL PRO 300X201X66CM;OUTDOOR
10298045;;F;56;CHILENO;;Boomers;PUDAHUEL                      ;METROPOLITANA;494980;2;2;0;0;0;2;2;494980;PISCINA CIRCULAR STEEL PRO 6473 L;OUTDOOR
16598751;;M;35;CHILENO;;Millenial;N/D;N/D;140970;3;2;2;1;125980;1;1;14990;Auto Electrico Descapotable Coupe Rojo;OUTDOOR
17527603;Soltero;M;32;CHILENO;CONTADOR AUDITOR;Millenial;PROVIDENCIA                   ;METROPOLITANA;96980;2;1;2;1;96980;0;0;0;V-CARPA 6 PERSONAS TORONTO NAT GEO S17;OUTDOOR
9288687;;F;60;CHILENO;;Boomers;POZO ALMONTE                  ;TARAPACA;119990;1;1;0;0;0;1;1;119990;PISCINA CIRCULAR STEEL PRO 6473 L;OUTDOOR
17368819;;F;32;CHILENO;;Millenial;RENCA                         ;METROPOLITANA;99990;1;1;1;1;99990;0;0;0;V-PISCINA ESTRUCTURAL BESTWAY STEEL PRO 3.05M X;OUTDOOR
16023342;;F;37;CHILENO;;Millenial;CURICO                        ;MAULE;99950;5;2;5;2;99950;0;0;0;V-CARPA 2 PERSONAS TORONTO NAT GEO S17;OUTDOOR
19320625;;M;26;CHILENO;;Z;N/D;N/D;44980;2;1;2;1;44980;0;0;0;Mi Primer Resbalin Dolu Plegable;OUTDOOR
16643545;;F;35;CHILENO;;Millenial;PARRAL                        ;MAULE;15990;1;1;0;0;0;1;1;15990;COLCHON 2 PZA 203X152X22 CM;OUTDOOR
20327097;;M;23;CHILENO;;Z;CARAHUE;ARAUCANIA;240930;7;2;7;2;240930;0;0;0;Scooter Peluche Dotty Dalmata y Luces Led Keyrid;OUTDOOR
16004671;;M;36;CHILENO;;Millenial;N/D;N/D;192950;5;4;0;0;0;5;4;192950;COLCHON 2 PZA 203X152X22 CM;OUTDOOR
16710537;;F;34;CHILENO;;Millenial;PROVIDENCIA                   ;METROPOLITANA;84960;4;1;4;1;84960;0;0;0;COLCHONETA ULTRALIGHT VERDE MILITAR NATIONAL GEO;OUTDOOR
17311029;;M;32;CHILENO;;Millenial;N/D;N/D;89980;2;1;2;1;89980;0;0;0;Mesa AirHockey Carromco;OUTDOOR
14164750;;M;40;CHILENO;;X;MAIPU;METROPOLITANA;93980;2;1;2;1;93980;0;0;0;V-PISCINA ESTRUCTURAL BESTWAY STEEL PRO 3.05M X;OUTDOOR
19584360;;M;25;CHILENO;;Z;CERRO NAVIA                   ;METROPOLITANA;213980;2;1;2;1;213980;0;0;0;CAMA ELASTICA (3,66M) CON MALLA GAMEPOWER AZUL;OUTDOOR
12235580;;F;50;CHILENO;;X;RENCA                         ;METROPOLITANA;143980;2;1;2;1;143980;0;0;0;PISCINA CIRCULAR STEEL PRO 6473 L;OUTDOOR
6440083;;F;75;CHILENO;;Silencioso;LINARES                       ;MAULE;720960;4;4;0;0;0;4;4;720960;BALON LANZA AGUA;OUTDOOR
10891132;;F;54;CHILENO;;Boomers;RENCA                         ;METROPOLITANA;89990;1;1;0;0;0;1;1;89990;CAMA ELASTICA (1,83M) CON MALLA GAMEPOWER AZUL;OUTDOOR
18438757;;M;28;CHILENO;;Millenial;TEMUCO                        ;ARAUCANIA;489950;5;2;5;2;489950;0;0;0;Set De Ollas - Sarten Outback;OUTDOOR
18512197;;F;29;CHILENO;;Millenial;CANELA                        ;COQUIMBO;99990;1;1;0;0;0;1;1;99990;PISCINA CIRCULAR STEEL PRO;OUTDOOR
13653155;;F;43;CHILENO;;X;SANTIAGO;METROPOLITANA;123952;5;1;0;0;0;5;1;123952;Cuatrimoto Electrica Force Negra/Verde;OUTDOOR
15145265;;M;39;CHILENO;;X;N/D;N/D;194970;3;2;0;0;0;3;2;194970;Scooter Peluche Flamenco y Luces Led KeyRiders;OUTDOOR
17968594;;M;29;CHILENO;;Millenial;PROVIDENCIA                   ;METROPOLITANA;99990;1;1;0;0;0;1;1;99990;PISCINA STEEL PRO 300X201X66CM;OUTDOOR
19297665;;F;26;CHILENO;;Z;CORONEL                       ;BIO BIO;265840;2;1;2;1;265840;0;0;0;PISCINA STEEL PRO MAX;OUTDOOR
15216802;;M;40;CHILENO;;X;ANTOFAGASTA                   ;ANTOFAGASTA;212980;2;1;0;0;0;2;1;212980;PISCINA CIRCULAR STEEL PRO 6473 L;OUTDOOR
19217889;;F;26;CHILENO;;Millenial;"";"";125840;2;1;2;1;125840;0;0;0;PISCINA CIRCULAR STEEL PRO 6473 L;OUTDOOR
15668641;;M;38;CHILENO;;Millenial;N/D;N/D;427910;8;3;8;3;427910;0;0;0;Cama Elastica + Malla y Escalera 6ft;OUTDOOR
16992939;;M;32;CHILENO;;Millenial;PROVIDENCIA                   ;METROPOLITANA;119990;1;1;0;0;0;1;1;119990;SCOOTER ELECTRICO CERO EKIDS NEGRO;OUTDOOR
19239443;;F;26;CHILENO;;Z;N/D;N/D;194540;2;1;2;1;194540;0;0;0;PISCINA RECTANGULAR 211CM BESTWAY AZUL;OUTDOOR
20170363;;F;22;CHILENO;;Z;PROVIDENCIA                   ;METROPOLITANA;385470;3;1;3;1;385470;0;0;0;PISCINA RECTANGULAR 211CM BESTWAY AZUL;OUTDOOR
8806716;;F;64;CHILENO;;Boomers;PUENTE ALTO                   ;METROPOLITANA;99990;1;1;0;0;0;1;1;99990;PISCINA STEEL PRO 300X201X66CM;OUTDOOR
12016180;;F;49;CHILENO;;X;TALCAHUANO                    ;BIO BIO;59990;1;1;0;0;0;1;1;59990;TACA TACA MADERA EVER GROUP;OUTDOOR
19128017;;M;25;CHILENO;;Z;PARRAL                        ;MAULE;892930;7;4;7;4;892930;0;0;0;PISCINA RECTANGULAR 211CM BESTWAY AZUL;OUTDOOR
6267478;;F;70;CHILENO;;Silencioso;TOCOPILLA                     ;ANTOFAGASTA;89990;1;1;0;0;0;1;1;89990;GO-KART PEDALES ROJO;OUTDOOR
18925331;;F;27;CHILENO;;Millenial;QUILICURA                     ;METROPOLITANA;23980;2;1;2;1;23980;0;0;0;Juego de Mesa Camcorro 10 en 1;OUTDOOR
18620643;;M;28;CHILENO;;Millenial;PROVIDENCIA                   ;METROPOLITANA;163980;2;1;2;1;163980;0;0;0;PISCINA CIRCULAR STEEL PRO 6473 L;OUTDOOR
13727102;;M;42;CHILENO;;X;SAN PEDRO DE LA PAZ           ;BIO BIO;109990;2;1;0;0;0;2;1;109990;PISCINA STEEL PRO 300X201X66CM;OUTDOOR
15178098;;F;39;CHILENO;;X;PROVIDENCIA                   ;METROPOLITANA;139990;1;1;0;0;0;1;1;139990;MESA DE PING PONG GAMEPOWER AZUL;OUTDOOR
19085454;;M;26;CHILENO;;Z;PURRANQUE                     ;LOS LAGOS;99990;1;1;1;1;99990;0;0;0;V-PISCINA ESTRUCTURAL BESTWAY STEEL PRO 3.05M X;OUTDOOR
9346783;;M;57;CHILENO;;Boomers;TALCAHUANO                    ;BIO BIO;24990;1;1;0;0;0;1;1;24990;Set Aro Basketball Telescopico Dolu hasta 1.70 m;OUTDOOR
15796710;;M;38;CHILENO;;Millenial;SAN PEDRO DE LA PAZ           ;BIO BIO;76980;2;1;0;0;0;2;1;76980;TACA TACA MADERA EVER GROUP;OUTDOOR
21711130;;F;27;CHILENO;;Extranjero;PROVIDENCIA                   ;METROPOLITANA;213970;3;2;3;2;213970;0;0;0;PISCINA CIRCULAR STEEL PRO;OUTDOOR
6159767;;M;72;CHILENO;;Silencioso;AISEN                         ;AYSEN;500720;6;3;0;0;0;6;3;500720;Casco 3D con Funda Peluche Unicornio Keyriders;OUTDOOR
18271448;;F;29;CHILENO;;Millenial;OSORNO                        ;LOS LAGOS;109990;1;1;0;0;0;1;1;109990;PISCINA CIRCULAR STEEL PRO;OUTDOOR
17421408;Soltero;M;32;CHILENO;INGENIERO INFORMATICO;Millenial;PROVIDENCIA                   ;METROPOLITANA;123980;2;1;2;1;123980;0;0;0;PISCINA CIRCULAR STEEL PRO;OUTDOOR
11201343;;F;55;CHILENO;;Boomers;LA SERENA                     ;COQUIMBO;496350;4;2;0;0;0;4;2;496350;PISCINA CIRCULAR STEEL PRO 6473 L;OUTDOOR
13749746;;F;41;CHILENO;;X;ILLAPEL                       ;COQUIMBO;59990;1;1;0;0;0;1;1;59990;PISCINA RECTANGULAR 150CM BESTWAY AZUL;OUTDOOR
9328216;;M;59;CHILENO;;Boomers;PUERTO MONTT                  ;LOS LAGOS;219980;2;1;0;0;0;2;1;219980;PISCINA RECTANGULAR 211CM BESTWAY AZUL;OUTDOOR
17407591;;F;32;CHILENO;;Millenial;LA SERENA                     ;COQUIMBO;19990;1;1;0;0;0;1;1;19990;Scooter Peluche Leon y Luces Led KeyRiders;OUTDOOR
19191374;;M;25;CHILENO;;Z;PROVIDENCIA                   ;METROPOLITANA;125480;2;1;2;1;125480;0;0;0;PISCINA CIRCULAR STEEL PRO;OUTDOOR
12329767;;M;49;CHILENO;;X;ANGOL                         ;ARAUCANIA;43980;2;1;0;0;0;2;1;43980;COLCHON 2 PZA 203X152X22 CM;OUTDOOR
17006972;;F;33;CHILENO;;Millenial;N/D;N/D;239980;2;1;2;1;239980;0;0;0;MESA DE POOL GAMEPOWER 03;OUTDOOR
9152505;;F;61;CHILENO;;Boomers;RENCA                         ;METROPOLITANA;59990;1;1;0;0;0;1;1;59990;Cuatrimoto Electrica Force Rosada;OUTDOOR
17615919;;F;31;CHILENO;;Millenial;PROVIDENCIA                   ;METROPOLITANA;119990;1;1;1;1;119990;0;0;0;PISCINA CIRCULAR STEEL PRO;OUTDOOR
12263988;;F;50;CHILENO;;X;NUNOA;METROPOLITANA;324960;4;2;4;2;324960;0;0;0;PISCINA STEEL PRO MAXÂ¿ 56709 BESTWAY DISENO RATT;OUTDOOR
18608688;Soltero;M;28;CHILENO;;Millenial;PROVIDENCIA                   ;METROPOLITANA;449990;1;1;0;0;0;1;1;449990;PISCINA STEEL PRO C/ESCALERA Y COBERTOR;OUTDOOR
11717329;;M;50;CHILENO;;X;QUEMCHI                       ;LOS LAGOS;252080;4;2;4;2;252080;0;0;0;AUTO ELECTRICO DESCAPOTABLE BLANCO COUP;OUTDOOR
25745124;;F;27;PERUANO;;Extranjero;N/D;N/D;373950;5;3;4;2;303960;1;1;69990;PISCINA RECTANGULAR 150CM BESTWAY AZUL;OUTDOOR
17062877;;F;33;CHILENO;;Millenial;LA FLORIDA                    ;METROPOLITANA;137540;2;1;2;1;137540;0;0;0;PISCINA CIRCULAR STEEL PRO 6473 L;OUTDOOR
19407696;;F;26;CHILENO;;Z;N/D;N/D;19990;1;1;0;0;0;1;1;19990;Scooter Peluche Unicornio y Luces Led KeyRiders;OUTDOOR
14018345;;F;41;CHILENO;;X;N/D;N/D;105480;2;1;2;1;105480;0;0;0;V-PISCINA ESTRUCTURAL BESTWAY STEEL PRO 3.05M X;OUTDOOR
15813084;;M;37;CHILENO;;Millenial;RENCA                         ;METROPOLITANA;178180;4;2;4;2;178180;0;0;0;PISCINA CIRCULAR STEEL PRO;OUTDOOR
12653113;;M;48;CHILENO;;X;COLINA                        ;METROPOLITANA;653980;2;1;2;1;653980;0;0;0;Piscina Power Steel Swim Vista Series Oval 4.8x3;OUTDOOR
14134077;;F;41;CHILENO;;X;PUDAHUEL                      ;METROPOLITANA;339990;1;1;0;0;0;1;1;339990;PISCINA STEEL PRO C/ESCALERA Y COBERTOR;OUTDOOR
18516480;;M;28;CHILENO;;Millenial;PROVIDENCIA                   ;METROPOLITANA;108370;3;1;3;1;108370;0;0;0;V-MOCHILA CAMPING EVEREST 65LTS NAT GEO S17;OUTDOOR
16744065;Soltero;F;34;CHILENO;AGRONOMO;Millenial;RENCA                         ;METROPOLITANA;23980;2;1;2;1;23980;0;0;0;COHETE C/LANZADOR;OUTDOOR
18123419;;F;29;CHILENO;;Silencioso;PROVIDENCIA                   ;METROPOLITANA;15980;2;1;2;1;15980;0;0;0;Correpasillos Unicornio Rosado;OUTDOOR
17874787;;F;31;CHILENO;;Millenial;PROVIDENCIA                   ;METROPOLITANA;59540;2;1;2;1;59540;0;0;0;Mochila National Geographic Redwood 45lt;OUTDOOR
17343331;;F;33;CHILENO;;Millenial;CORONEL                       ;BIO BIO;89980;2;1;0;0;0;2;1;89980;PISCINA RECTANGULAR 150CM BESTWAY AZUL;OUTDOOR
14001776;;M;40;CHILENO;;X;RENCA                         ;METROPOLITANA;119990;1;1;1;1;119990;0;0;0;PISCINA CIRCULAR STEEL PRO;OUTDOOR
11507061;;F;52;CHILENO;;X;DIEGO DE ALMAGRO              ;ATACAMA;128640;2;1;2;1;128640;0;0;0;PISCINA CIRCULAR STEEL PRO;OUTDOOR
16246282;;F;36;CHILENO;;Millenial;DALCAHUE                      ;LOS LAGOS;99990;1;1;1;1;99990;0;0;0;PISCINA STEEL PRO 300X201X66CM;OUTDOOR
14262418;;M;48;CHILENO;;X;"";"";134540;2;1;2;1;134540;0;0;0;PISCINA CIRCULAR STEEL PRO 6473 L;OUTDOOR
13702467;;F;43;CHILENO;;X;PUENTE ALTO;METROPOLITANA;123970;3;1;3;1;123970;0;0;0;PISCINA STEEL PRO 300X201X66CM;OUTDOOR
15793590;;M;37;CHILENO;;Millenial;LAMPA;METROPOLITANA;271960;4;1;0;0;0;4;1;271960;SCOOTER ELECTRICO CERO EKIDS NEGRO;OUTDOOR
20031843;;F;23;CHILENO;;Z;PROVIDENCIA                   ;METROPOLITANA;156970;3;1;3;1;156970;0;0;0;PISCINA RECTANGULAR 150CM BESTWAY AZUL;OUTDOOR
19746205;;F;24;CHILENO;;Z;PROVIDENCIA                   ;METROPOLITANA;79980;2;1;2;1;79980;0;0;0;Triciclo 360 Desmontable Bebesit;OUTDOOR
14311441;;M;45;CHILENO;;X;CHILLAN                       ;BIO BIO;449990;1;1;0;0;0;1;1;449990;PISCINA STEEL PRO C/ESCALERA Y COBERTOR;OUTDOOR
19524555;;M;25;CHILENO;;Z;SAN RAFAEL                    ;MAULE;66980;2;1;2;1;66980;0;0;0;TACA TACA MADERA EVER GROUP;OUTDOOR
17051041;;M;33;CHILENO;;Millenial;PROVIDENCIA                   ;METROPOLITANA;69980;2;1;2;1;69980;0;0;0;TACA TACA MADERA EVER GROUP;OUTDOOR
15906538;;F;38;CHILENO;;Millenial;N/D;N/D;159980;2;2;0;0;0;2;2;159980;Scooter Peluche Flamenco y Luces Led KeyRiders;OUTDOOR
16516106;;F;34;CHILENO;;Millenial;PROVIDENCIA                   ;METROPOLITANA;0;0;0;0;0;0;0;0;0;Picnic Mat Bestway;OUTDOOR
16740658;;F;35;CHILENO;;Silencioso;PROVIDENCIA                   ;METROPOLITANA;0;0;0;0;0;0;0;0;0;Correpasillos Rojo;OUTDOOR
12179878;;M;50;CHILENO;;X;CHIMBARONGO                   ;L.G.B.OÂ´HIGGINS;0;0;0;0;0;0;0;0;0;Picnic Mat Bestway;OUTDOOR
10538356;;M;52;CHILENO;;X;QUILPUE                       ;VALPARAISO;0;0;0;0;0;0;0;0;0;Triciclo 360 Desmontable Bebesit;OUTDOOR
18558305;;M;28;CHILENO;;Millenial;N/D;N/D;0;0;0;0;0;0;0;0;0;Mochila National Geographic Redwood 65lt;OUTDOOR
16255848;;F;35;CHILENO;;Millenial;CHILLAN                       ;BIO BIO;0;0;0;0;0;0;0;0;0;TUNEL DE JUEGO 46X180 CM;OUTDOOR
17505145;;F;32;CHILENO;;Silencioso;PROVIDENCIA                   ;METROPOLITANA;0;0;0;0;0;0;0;0;0;Triciclo 360 Desmontable Bebesit;OUTDOOR
18347778;;F;29;CHILENO;;Silencioso;PROVIDENCIA                   ;METROPOLITANA;0;0;0;0;0;0;0;0;0;Triciclo 360 Desmontable Bebesit;OUTDOOR
12279014;;F;49;CHILENO;;X;PUERTO MONTT                  ;LOS LAGOS;0;0;0;0;0;0;0;0;0;Deslizador Single 5.49 Con Rampa;OUTDOOR
18576924;;F;29;CHILENO;;Millenial;LA FLORIDA                    ;METROPOLITANA;0;0;0;0;0;0;0;0;0;COLCHON 2 PZA 203X152X22 CM;OUTDOOR
17428016;;M;32;CHILENO;;Silencioso;PROVIDENCIA                   ;METROPOLITANA;0;0;0;0;0;0;0;0;0;Triciclo 360 Desmontable Bebesit;OUTDOOR
16795554;;F;34;CHILENO;;Silencioso;PROVIDENCIA                   ;METROPOLITANA;0;0;0;0;0;0;0;0;0;Picnic Mat Bestway;OUTDOOR
17620322;;F;32;CHILENO;;Millenial;SALAMANCA                     ;COQUIMBO;0;0;0;0;0;0;0;0;0;Cuatrimoto Electrica Force Negra/Verde;OUTDOOR
17870542;;F;30;CHILENO;;Millenial;N/D;N/D;0;0;0;0;0;0;0;0;0;CENTRO JUEGOS 3EN1 RESBALIN+COLUMPIO+AROBASQ;OUTDOOR
16046616;;M;36;CHILENO;;Millenial;NUEVA IMPERIAL                ;ARAUCANIA;0;0;0;0;0;0;0;0;0;Mochila National Geographic Redwood 45lt;OUTDOOR
18748700;;M;28;CHILENO;;Millenial;N/D;N/D;0;0;0;0;0;0;0;0;0;PRODUCTO 2A OUTDOOR BANDA 1;OUTDOOR
15387305;;F;42;CHILENO;;X;PROVIDENCIA                   ;METROPOLITANA;0;0;0;0;0;0;0;0;0;Mini Trampolin Kids 3 Pies Con Mango Plegable;OUTDOOR
11919698;;F;50;CHILENO;;X;PROVIDENCIA                   ;METROPOLITANA;0;0;0;0;0;0;0;0;0;Columpio 2 Estaciones Kids;OUTDOOR
7053217;;F;61;CHILENO;;Silencioso;PROVIDENCIA                   ;METROPOLITANA;0;0;0;0;0;0;0;0;0;V-MESA DE POOL GAME POWER 01 S17;OUTDOOR
13145020;;F;44;CHILENO;;X;PROVIDENCIA                   ;METROPOLITANA;0;0;0;0;0;0;0;0;0;Columpio 2 Estaciones Kids;OUTDOOR
13970296;;F;41;CHILENO;;X;COIHAIQUE                     ;AYSEN;0;0;0;0;0;0;0;0;0;V-CARPA PLAYA OUTBACK OUTBACK;OUTDOOR
15817032;;M;38;CHILENO;;Millenial;PROVIDENCIA                   ;METROPOLITANA;0;0;0;0;0;0;0;0;0;V-CARPA 4 PERSONAS TORONTO NAT GEO S17;OUTDOOR
16179096;;F;36;CHILENO;;Silencioso;PROVIDENCIA                   ;METROPOLITANA;0;0;0;0;0;0;0;0;0;GO-KART PEDALES ROJO;OUTDOOR
15299016;;F;40;CHILENO;;X;COIHAIQUE                     ;AYSEN;0;0;0;0;0;0;0;0;0;Quitasol Outback 160 Cms.;OUTDOOR
8246749;;F;67;CHILENO;;Boomers;N/D;N/D;0;0;0;0;0;0;0;0;0;SCOOTER ELECTRICO CERO EKIDS NEGRO;OUTDOOR
12907127;;F;47;CHILENO;;X;COIHAIQUE                     ;AYSEN;0;0;0;0;0;0;0;0;0;PISCINA STEEL PRO 300X201X66CM;OUTDOOR
19404663;;F;25;CHILENO;;Z;PROVIDENCIA                   ;METROPOLITANA;0;0;0;0;0;0;0;0;0;V-Piscina Inflable Espacial 152X43Cm.;OUTDOOR
19481238;Soltero;M;26;CHILENO;;Z;PROVIDENCIA                   ;METROPOLITANA;0;0;0;0;0;0;0;0;0;COLCHON 2 PZA 203X152X22 CM;OUTDOOR
17235682;Soltero;M;32;CHILENO;;Millenial;RENCA                         ;METROPOLITANA;0;0;0;0;0;0;0;0;0;COLCHON 2 PZA 203X152X22 CM;OUTDOOR
9621143;Soltero;F;53;CHILENO;TECNICO ADMINISTRATIVO;X;RENCA                         ;METROPOLITANA;0;0;0;0;0;0;0;0;0;Piscina Campo De Basketball Inf. 254X168X102;OUTDOOR
17856190;;F;30;CHILENO;;Millenial;COIHAIQUE                     ;AYSEN;0;0;0;0;0;0;0;0;0;TACA TACA MADERA EVER GROUP;OUTDOOR
9503870;;F;62;CHILENO;;Boomers;MOSTAZAL                      ;L.G.B.OÂ´HIGGINS;0;0;0;0;0;0;0;0;0;COLCHON 2 PZA 203X152X22 CM;OUTDOOR
6602530;;M;70;CHILENO;;Silencioso;VILLA ALEMANA                 ;VALPARAISO;0;0;0;0;0;0;0;0;0;PISCINA RECTANGULAR 211CM BESTWAY AZUL;OUTDOOR
12936171;;M;46;CHILENO;;X;PUERTO MONTT                  ;LOS LAGOS;0;0;0;0;0;0;0;0;0;COLCHON 2 PZA 203X152X22 CM;OUTDOOR
18124723;;F;30;CHILENO;;Millenial;CALAMA                        ;ANTOFAGASTA;0;0;0;0;0;0;0;0;0;PISCINA CIRCULAR STEEL PRO;OUTDOOR
15381620;Casado;M;39;CHILENO;;Silencioso;PROVIDENCIA                   ;METROPOLITANA;0;0;0;0;0;0;0;0;0;PISCINA STEEL PRO 300X201X66CM;OUTDOOR
10001596;;M;43;CHILENO;;X;CONCON                        ;VALPARAISO;0;0;0;0;0;0;0;0;0;PISCINA STEEL PRO 300X201X66CM;OUTDOOR
16557109;;M;35;CHILENO;;Millenial;PROVIDENCIA                   ;METROPOLITANA;0;0;0;0;0;0;0;0;0;PISCINA STEEL PRO 300X201X66CM;OUTDOOR
13319514;Divorciado;F;45;CHILENO;MEDICO CIRUJANO;X;RENCA                         ;METROPOLITANA;0;0;0;0;0;0;0;0;0;PISCINA STEEL PRO 300X201X66CM;OUTDOOR
8355194;;F;62;CHILENO;;Boomers;COQUIMBO                      ;COQUIMBO;0;0;0;0;0;0;0;0;0;PISCINA CIRCULAR STEEL PRO;OUTDOOR
12399668;;F;55;CHILENO;;Boomers;N/D;N/D;0;0;0;0;0;0;0;0;0;CAMA ELASTICA (2,44M) CON MALLA GAMEPOWER AZUL;OUTDOOR
12651543;Casado;F;49;CHILENO;ASISTENTE DE PARVULOS;X;RENCA                         ;METROPOLITANA;0;0;0;0;0;0;0;0;0;PISCINA RECTANGULAR 150CM BESTWAY AZUL;OUTDOOR
16242121;;M;37;CHILENO;;Millenial;N/D;N/D;0;0;0;0;0;0;0;0;0;COLCHON 2 PZA 203X152X22 CM;OUTDOOR
16041952;;M;37;CHILENO;;Millenial;PROVIDENCIA                   ;METROPOLITANA;0;0;0;0;0;0;0;0;0;PISCINA ESTRUCTURAL STEEL PRO 5700LT;OUTDOOR
7559543;;M;60;CHILENO;;Boomers;SAN VICENTE                   ;L.G.B.OÂ´HIGGINS;0;0;0;0;0;0;0;0;0;CAMIONETA ELECTRICA NINO 905 ZHE;OUTDOOR
13611585;;F;43;CHILENO;;X;PROVIDENCIA                   ;METROPOLITANA;0;0;0;0;0;0;0;0;0;PISCINA STEEL PRO 300X201X66CM;OUTDOOR
17168945;;F;33;CHILENO;;Millenial;SANTIAGO                      ;METROPOLITANA;0;0;0;0;0;0;0;0;0;Piscina Kids 228 X 159 X 42Cm;OUTDOOR
19586542;;F;24;CHILENO;;Z;RENCA                         ;METROPOLITANA;0;0;0;0;0;0;0;0;0;PISCINA STEEL PRO 300X201X66CM;OUTDOOR
15720836;;M;38;CHILENO;;X;PROVIDENCIA                   ;METROPOLITANA;0;0;0;0;0;0;0;0;0;PISCINA CIRCULAR STEEL PRO;OUTDOOR
13571761;;M;42;CHILENO;;X;RENCA                         ;METROPOLITANA;0;0;0;0;0;0;0;0;0;SCOOTER ELECTRICO ASD BLANCO;OUTDOOR
12642405;;F;47;CHILENO;;X;PROVIDENCIA                   ;METROPOLITANA;0;0;0;0;0;0;0;0;0;PISCINA RECTANGULAR 211CM BESTWAY AZUL;OUTDOOR
13270994;Soltero;M;45;CHILENO;INGENIERO;X;PROVIDENCIA                   ;METROPOLITANA;0;0;0;0;0;0;0;0;0;Piscina Redonda Power Steel Frame Pool Set 4.27M;OUTDOOR
17797083;;F;31;CHILENO;;Millenial;CURICO                        ;MAULE;0;0;0;0;0;0;0;0;0;Piscina Kids 150 X 110 X 42Cm;OUTDOOR
18212791;Soltero;F;30;CHILENO;;Millenial;N/D;N/D;0;0;0;0;0;0;0;0;0;V-3MX2.01MX66Cm 3300L Deluxe Splash Frame Pool;OUTDOOR
13270934;;M;45;CHILENO;;X;PROVIDENCIA                   ;METROPOLITANA;0;0;0;0;0;0;0;0;0;PISCINA RECTANGULAR 211CM BESTWAY AZUL;OUTDOOR
14204288;;F;40;CHILENO;;X;RANCAGUA                      ;L.G.B.OÂ´HIGGINS;0;0;0;0;0;0;0;0;0;PISCINA CIRCULAR STEEL PRO;OUTDOOR
16932848;Soltero;F;33;CHILENO;TECNICO DE NIVEL SUPERIOR EN ENFERMERIA;Millenial;PROVIDENCIA                   ;METROPOLITANA;0;0;0;0;0;0;0;0;0;PISCINA CIRCULAR STEEL PRO;OUTDOOR
19633616;;F;25;CHILENO;;Z;EL BOSQUE;METROPOLITANA;0;0;0;0;0;0;0;0;0;PATINES C/LUCES 255 SHS;OUTDOOR
18195662;Soltero;M;30;CHILENO;TECNICO MECANICO;Millenial;PROVIDENCIA                   ;METROPOLITANA;0;0;0;0;0;0;0;0;0;AUTO ELECTRICO MCLAREN AMARILLO C/CONTROL REMOTO;OUTDOOR
18741759;Soltero;F;28;CHILENO;;Millenial;PROVIDENCIA                   ;METROPOLITANA;0;0;0;0;0;0;0;0;0;PISCINA STEEL PRO C/ESCALERA Y COBERTOR;OUTDOOR
17361901;;F;33;CHILENO;;Millenial;OVALLE                        ;COQUIMBO;0;0;0;0;0;0;0;0;0;PISCINA RECTANGULAR 211CM BESTWAY AZUL;OUTDOOR
15110695;;F;39;CHILENO;;X;SAN VICENTE                   ;L.G.B.OÂ´HIGGINS;0;0;0;0;0;0;0;0;0;TACA TACA MADERA EVER GROUP;OUTDOOR
17543835;;F;32;CHILENO;;Millenial;PROVIDENCIA                   ;METROPOLITANA;0;0;0;0;0;0;0;0;0;PISCINA RECTANGULAR 150CM BESTWAY AZUL;OUTDOOR
17427214;Casado;F;32;CHILENO;;Millenial;RENCA                         ;METROPOLITANA;0;0;0;0;0;0;0;0;0;Piscina Redonde Steel Pro Max Pool Set 4.27x1.07;OUTDOOR
11659887;;F;52;CHILENO;;X;PENAFLOR                      ;METROPOLITANA;0;0;0;0;0;0;0;0;0;CAMA ELASTICA (2,44M) CON MALLA GAMEPOWER AZUL;OUTDOOR
13014336;;M;46;CHILENO;;X;N/D;N/D;0;0;0;0;0;0;0;0;0;MI PRIMER TRAMPOLIN 140CM GAMEPOWER AZUL/AMARILL;OUTDOOR
16787611;Soltero;M;34;CHILENO;INGENIERO EN TELECOMUNICACIONES;Millenial;PROVIDENCIA                   ;METROPOLITANA;0;0;0;0;0;0;0;0;0;MOTO ELECTRICA BMW BLANCA;OUTDOOR
19720386;;F;25;CHILENO;;Z;PROVIDENCIA                   ;METROPOLITANA;0;0;0;0;0;0;0;0;0;TUNEL INFANTIL CUNCUNA;OUTDOOR
12705695;;F;47;CHILENO;;X;N/D;N/D;0;0;0;0;0;0;0;0;0;SCOOTER ELECTRICO FOLDABLE 350W;OUTDOOR
16380490;;M;36;CHILENO;;Millenial;EL BOSQUE                     ;METROPOLITANA;0;0;0;0;0;0;0;0;0;TRCICLO NINO COLOR A PPB TRA;OUTDOOR
16733961;;M;33;CHILENO;;Millenial;PROVIDENCIA                   ;METROPOLITANA;0;0;0;0;0;0;0;0;0;2 WHEELS DIRT BIKE COMPETITION (RED) 99620-S LOK;OUTDOOR
15490916;;M;40;CHILENO;;X;PROVIDENCIA                   ;METROPOLITANA;0;0;0;0;0;0;0;0;0;MESA DE AIR HOCKEY 142X62X79CM;OUTDOOR
8640542;;F;63;CHILENO;;Boomers;N/D;N/D;52990;1;1;0;0;0;1;1;52990;Asistencia Salud Integral Familia;GARANTIAS
7444164;;M;66;CHILENO;;Boomers;N/D;N/D;102980;3;2;0;0;0;3;2;102980;Asistencia Salud Integral Familia;GARANTIAS
19239650;;F;26;CHILENO;;Z;SANTIAGO;METROPOLITANA;72960;4;2;3;1;19970;1;1;52990;Asistencia Salud Integral Familia;GARANTIAS
26441472;;M;43;EXTRANJERO - NO INFORMA NACIONALIDAD;;Extranjero;CONCEPCION                    ;BIO BIO;473130;5;3;0;0;0;5;3;473130;Asistencia Salud Integral Familia;GARANTIAS
8680953;;F;62;CHILENO;;Boomers;SAN PEDRO DE LA PAZ;BIO-BIO;221950;5;3;2;1;158980;3;2;62970;Asistencia Salud Integral Familia;GARANTIAS
9299972;;M;60;CHILENO;;Boomers;CONSTITUCION                  ;MAULE;229050;3;2;0;0;0;3;2;229050;Asistencia Salud Integral Familia;GARANTIAS
25278973;;F;37;HAITIANO;;Extranjero;TALAGANTE                     ;METROPOLITANA;548440;5;3;0;0;0;5;3;548440;Asistencia Programa Domiciliario;GARANTIAS
17036160;;F;33;CHILENO;;Millenial;PROVIDENCIA                   ;METROPOLITANA;393950;5;5;0;0;0;5;5;393950;Asistencia Salud Integral Familia;GARANTIAS
15241848;;M;44;CHILENO;;X;N/D;N/D;52990;1;1;0;0;0;1;1;52990;Asistencia Salud Integral Familia;GARANTIAS
9953419;;F;58;CHILENO;;Boomers;"";"";195970;3;2;1;1;89990;2;1;105980;Asistencia Salud Integral Familia;GARANTIAS
10083294;;M;58;CHILENO;;Boomers;N/D;N/D;258610;3;2;0;0;0;3;2;258610;Asistencia Salud Integral Familia;GARANTIAS
4876776;;F;81;CHILENO;;Silencioso;LA SERENA                     ;COQUIMBO;69980;2;2;0;0;0;2;2;69980;Asistencia Salud Integral Familia;GARANTIAS
15795526;;F;44;CHILENO;;X;PUERTO MONTT                  ;LOS LAGOS;100870;2;2;0;0;0;2;2;100870;Asistencia Salud Integral Familia;GARANTIAS
9089441;;F;59;CHILENO;;Boomers;COPIAPO                       ;ATACAMA;65980;2;2;0;0;0;2;2;65980;Asistencia Salud Integral Familia;GARANTIAS
15411751;;F;40;CHILENO;;Extranjero;RECOLETA;METROPOLITANA;292980;2;2;1;1;239990;1;1;52990;Asistencia Salud Integral Familia;GARANTIAS
20082116;;F;23;CHILENO;;Z;PROVIDENCIA                   ;METROPOLITANA;71980;2;2;0;0;0;2;2;71980;Asistencia Salud Integral Familia;GARANTIAS
6582719;;M;71;CHILENO;;Silencioso;CORONEL                       ;BIO BIO;454230;6;5;0;0;0;6;5;454230;Asistencia Salud Integral Familia;GARANTIAS
7646797;;M;66;CHILENO;;Boomers;QUILLOTA                      ;VALPARAISO;52990;1;1;0;0;0;1;1;52990;Asistencia Programa Domiciliario;GARANTIAS
11928013;;M;51;CHILENO;;X;N/D;N/D;379950;5;5;0;0;0;5;5;379950;Asistencia Salud Integral Familia;GARANTIAS
17617509;;F;30;CHILENO;;Millenial;N/D;N/D;52990;1;1;0;0;0;1;1;52990;Asistencia Salud Integral Familia;GARANTIAS
16137163;;F;37;CHILENO;;Millenial;N/D;N/D;850090;9;5;0;0;0;9;5;850090;Asistencia Salud Integral Familia;GARANTIAS
9037632;;F;80;CHILENO;;Silencioso;ARICA                         ;TARAPACA;252970;3;2;0;0;0;3;2;252970;Asistencia Salud Integral Familia;GARANTIAS
12054391;;M;41;CHILENO;;X;PUERTO MONTT                  ;LOS LAGOS;85980;2;2;0;0;0;2;2;85980;Asistencia Programa Domiciliario;GARANTIAS
10945459;;M;53;CHILENO;;X;LOS ANGELES                   ;BIO BIO;476890;11;6;0;0;0;11;6;476890;Asistencia de Mascotas;GARANTIAS
15623226;;M;38;CHILENO;;X;MELIPILLA                     ;METROPOLITANA;298970;3;2;0;0;0;3;2;298970;Asistencia Programa Domiciliario;GARANTIAS
25233800;;F;53;COLOMBIANO;;Extranjero;LA CISTERNA                   ;METROPOLITANA;52990;1;1;0;0;0;1;1;52990;Asistencia Salud Integral Familia;GARANTIAS
11598261;;M;52;CHILENO;;X;CALBUCO                       ;LOS LAGOS;285450;5;3;0;0;0;5;3;285450;Asistencia Salud Integral Familia;GARANTIAS
6659178;;F;68;CHILENO;;Silencioso;LA SERENA                     ;COQUIMBO;90980;2;1;0;0;0;2;1;90980;Asistencia Salud Integral Familia;GARANTIAS
10176455;;M;57;CHILENO;;Boomers;COIHAIQUE                     ;AYSEN;226950;5;3;0;0;0;5;3;226950;Asistencia Salud Integral Familia;GARANTIAS
14096451;;F;42;CHILENO;;X;TALCA                         ;MAULE;737250;11;5;0;0;0;11;5;737250;Asistencia Salud Integral Familia;GARANTIAS
8474214;;F;49;CHILENO;;X;VINA DEL MAR                  ;VALPARAISO;630930;7;5;0;0;0;7;5;630930;Asistencia Programa Domiciliario;GARANTIAS
14539044;;M;47;CHILENO;;X;PETORCA                       ;VALPARAISO;52990;1;1;0;0;0;1;1;52990;ASIST. FULL HOGAR Y AUTO INGRAL;GARANTIAS
7709684;;F;68;CHILENO;;Silencioso;PELLUHUE                      ;MAULE;211960;4;2;0;0;0;4;2;211960;Asistencia Salud Integral Familia;GARANTIAS
18416201;;F;29;CHILENO;;Millenial;N/D;N/D;252980;2;2;0;0;0;2;2;252980;Asistencia Salud Integral Familia;GARANTIAS
18411539;;M;28;CHILENO;;Millenial;COLBUN                        ;MAULE;167980;2;4;0;0;0;2;4;167980;Asistencia Salud Integral Familia;GARANTIAS
18445686;;F;29;CHILENO;;Millenial;"";"";52990;1;1;0;0;0;1;1;52990;Asistencia Salud Integral Familia;GARANTIAS
7663721;Casado;F;66;CHILENO;;Boomers;CORONEL                       ;BIO BIO;-241940;-2;4;0;0;0;-2;4;-241940;GM 1A X CTA SBI;GARANTIAS
18740166;;M;28;CHILENO;;Millenial;"";"";69980;2;2;0;0;0;2;2;69980;Asistencia Salud Integral Familia;GARANTIAS
11915234;;F;54;CHILENO;;X;N/D;N/D;275940;6;4;1;1;149990;5;3;125950;Asistencia Salud Integral Familia;GARANTIAS
14057315;;M;42;CHILENO;;X;COIHUECO                      ;BIO BIO;187970;3;2;0;0;0;3;2;187970;Asistencia Salud Integral Familia;GARANTIAS
12540687;;M;49;CHILENO;;X;PUNTA ARENAS                  ;MAGALLANES;242980;2;2;0;0;0;2;2;242980;ASIST. FULL HOGAR Y AUTO INGRAL;GARANTIAS
20403818;;F;22;CHILENO;;Z;LOTA                          ;BIO BIO;73970;3;2;0;0;0;3;2;73970;Asistencia Salud Integral Familia;GARANTIAS
23473894;Soltero;F;36;PERUANO;;Extranjero;"";"";52990;1;1;0;0;0;1;1;52990;Asistencia Salud Integral Familia;GARANTIAS
12051989;;F;47;CHILENO;;X;"";"";132970;3;3;0;0;0;3;3;132970;Asistencia Salud Integral Familia;GARANTIAS
13109862;;F;45;CHILENO;;X;LOTA                          ;BIO BIO;52990;1;1;0;0;0;1;1;52990;Asistencia Salud Integral Familia;GARANTIAS
10414222;;F;58;CHILENO;;Boomers;CORONEL                       ;BIO BIO;52990;1;1;0;0;0;1;1;52990;Asistencia Salud Integral Familia;GARANTIAS
7667491;;F;67;CHILENO;;Boomers;ANCUD                         ;LOS LAGOS;105980;2;1;0;0;0;2;1;105980;Asistencia Salud Integral Familia;GARANTIAS
14411451;;F;47;CHILENO;;X;SAN VICENTE                   ;L.G.B.OÂ´HIGGINS;153860;3;3;0;0;0;3;3;153860;Asistencia Salud Integral Familia;GARANTIAS
6688463;;F;71;CHILENO;;Silencioso;N/D;N/D;402960;4;2;0;0;0;4;2;402960;Asistencia Salud Integral Familia;GARANTIAS
19216862;;F;26;CHILENO;;Z;N/D;N/D;136613;7;7;0;0;0;7;7;136613;Asistencia de Mascotas;GARANTIAS
8817002;;M;63;CHILENO;;Boomers;SAN BERNARDO                  ;METROPOLITANA;105980;2;2;0;0;0;2;2;105980;ASIST. FULL HOGAR Y AUTO INGRAL;GARANTIAS
25660077;;F;41;CHILENO;;Extranjero;RECOLETA                      ;METROPOLITANA;52990;1;1;0;0;0;1;1;52990;Asistencia Salud Integral Familia;GARANTIAS
7337862;;F;65;CHILENO;;Boomers;VALLENAR;ATACAMA;52990;1;1;0;0;0;1;1;52990;Asistencia Salud Integral Familia;GARANTIAS
11177983;;F;55;CHILENO;;Boomers;PUDAHUEL                      ;METROPOLITANA;52990;1;1;0;0;0;1;1;52990;Asistencia Salud Integral Familia;GARANTIAS
15059156;;M;37;CHILENO;;Millenial;CABILDO                       ;VALPARAISO;65980;2;2;0;0;0;2;2;65980;ASIST. FULL HOGAR Y AUTO INGRAL;GARANTIAS
8183015;;F;63;CHILENO;;Boomers;OSORNO                        ;LOS LAGOS;105980;2;1;0;0;0;2;1;105980;Asistencia Salud Integral Familia;GARANTIAS
9366719;;F;63;CHILENO;;Boomers;MAIPU                         ;METROPOLITANA;52990;1;1;0;0;0;1;1;52990;Asistencia Salud Integral Familia;GARANTIAS
18100481;;F;30;CHILENO;;Millenial;N/D;N/D;52990;1;1;0;0;0;1;1;52990;Asistencia Salud Integral Familia;GARANTIAS
14343806;;F;45;CHILENO;;X;N/D;N/D;45041;1;1;0;0;0;1;1;45041;Asistencia Salud Integral Familia;GARANTIAS
18591804;;F;28;CHILENO;;Millenial;FUTRONO                       ;LOS LAGOS;529960;4;3;1;1;449990;3;2;79970;Asistencia Salud Integral Familia;GARANTIAS
25292300;;M;33;PERUANO;;Extranjero;N/D;N/D;462950;6;6;0;0;0;6;6;462950;Asistencia Salud Integral Familia;GARANTIAS
27187954;;F;30;CHILENO;;Extranjero;"";"";52990;1;1;0;0;0;1;1;52990;Asistencia Programa Domiciliario;GARANTIAS
9394994;;M;55;CHILENO;;Boomers;BUIN                          ;METROPOLITANA;52990;1;1;0;0;0;1;1;52990;Asistencia Salud Integral Familia;GARANTIAS
9558955;;F;60;CHILENO;;Boomers;PUDAHUEL                      ;METROPOLITANA;37000;2;3;0;0;0;2;3;37000;Asistencia Programa Domiciliario;GARANTIAS
8032891;;F;66;CHILENO;;Boomers;CORONEL                       ;BIO BIO;52990;1;1;0;0;0;1;1;52990;Asistencia Salud Integral Familia;GARANTIAS
10671119;;F;54;CHILENO;;Boomers;VINA DEL MAR                  ;VALPARAISO;105980;2;2;0;0;0;2;2;105980;Asistencia Programa Domiciliario;GARANTIAS
11564243;;M;53;CHILENO;;X;LINARES                       ;MAULE;1035960;12;6;0;0;0;12;6;1035960;Asistencia Salud Integral Familia;GARANTIAS
12090557;;M;53;CHILENO;;X;"";"";52990;1;1;0;0;0;1;1;52990;Asistencia Salud Integral Familia;GARANTIAS
10853429;;M;53;CHILENO;;X;CURANILAHUE                   ;BIO BIO;747940;10;3;0;0;0;10;3;747940;Asistencia Salud Integral Familia;GARANTIAS
10085153;;F;58;CHILENO;;Boomers;ESTACION CENTRAL;METROPOLITANA;52990;1;1;0;0;0;1;1;52990;Asistencia Programa Domiciliario;GARANTIAS
8175997;;F;63;CHILENO;;Boomers;PROVIDENCIA                   ;METROPOLITANA;105980;2;1;0;0;0;2;1;105980;Asistencia Salud Integral Familia;GARANTIAS
9339618;;M;59;CHILENO;;Boomers;COLINA                        ;METROPOLITANA;354950;5;3;0;0;0;5;3;354950;Asistencia de Mascotas;GARANTIAS
6326991;;F;75;CHILENO;;Silencioso;LOS SAUCES                    ;ARAUCANIA;1180320;8;5;0;0;0;8;5;1180320;Asistencia Salud Integral Familia;GARANTIAS
13102882;;M;45;CHILENO;;X;N/D;N/D;52990;1;1;0;0;0;1;1;52990;Asistencia Salud Integral Familia;GARANTIAS
18352694;;F;29;CHILENO;;Millenial;OVALLE                        ;COQUIMBO;1043931;8;5;5;3;670950;3;2;372981;Asistencia Salud Integral Familia;GARANTIAS
25993923;;F;25;PERUANO;;Extranjero;"";"";149990;1;3;1;1;149990;0;2;0;Asistencia Salud Integral Familia;GARANTIAS
8157478;;F;66;CHILENO;;Boomers;N/D;N/D;1282820;7;3;0;0;0;7;3;1282820;Asistencia Salud Integral Familia;GARANTIAS
9867650;;F;58;CHILENO;;Boomers;PENAFLOR                      ;METROPOLITANA;144260;3;2;0;0;0;3;2;144260;Asistencia Programa Domiciliario;GARANTIAS
10795481;;F;58;CHILENO;;Boomers;N/D;N/D;294970;3;2;0;0;0;3;2;294970;Asistencia Salud Integral Familia;GARANTIAS
15746790;;F;41;CHILENO;;X;LONGAVI                       ;MAULE;392970;3;3;0;0;0;3;3;392970;Asistencia Programa Domiciliario;GARANTIAS
26489806;;M;46;VENEZOLANO;;Extranjero;CORONEL                       ;BIO BIO;334960;4;2;0;0;0;4;2;334960;Asistencia Salud Integral Familia;GARANTIAS
10747851;;M;56;CHILENO;;Boomers;COIHAIQUE                     ;AYSEN;636930;7;5;0;0;0;7;5;636930;Asistencia Salud Integral Familia;GARANTIAS
15296101;;M;40;CHILENO;;X;COIHAIQUE                     ;AYSEN;279980;2;3;0;0;0;2;3;279980;GPL 1A X CTA SBI;GARANTIAS
11159131;;F;55;CHILENO;;Boomers;CANETE                        ;BIO BIO;178960;4;2;0;0;0;4;2;178960;Asistencia Salud Integral Familia;GARANTIAS
8093722;;M;63;CHILENO;;Boomers;ANTOFAGASTA                   ;ANTOFAGASTA;335840;5;3;0;0;0;5;3;335840;Asistencia Programa Domiciliario;GARANTIAS
7172318;;F;65;CHILENO;;Boomers;ARICA                         ;ARICA Y PARINACOTA;52990;1;1;0;0;0;1;1;52990;Asistencia Salud Integral Familia;GARANTIAS
25389932;Soltero;M;44;PERUANO;;Extranjero;N/D;N/D;140330;4;2;0;0;0;4;2;140330;Asistencia Programa Domiciliario;GARANTIAS
6997823;;F;68;CHILENO;;Boomers;N/D;N/D;893320;13;4;5;1;85810;8;3;807510;Asistencia Salud Integral Familia;GARANTIAS
15676060;;M;36;CHILENO;;Millenial;N/D;N/D;0;0;2;0;0;0;0;2;0;ASIST. FULL HOGAR Y AUTO INGRAL;GARANTIAS
5323716;;M;71;CHILENO;;Silencioso;LLAILLAY                      ;VALPARAISO;52990;1;1;0;0;0;1;1;52990;Asistencia Salud Integral Familia;GARANTIAS
14689671;;F;58;PERUANO;;Extranjero;N/D;N/D;52990;1;1;0;0;0;1;1;52990;Asistencia Salud Integral Familia;GARANTIAS
5746460;;M;75;CHILENO;;Silencioso;MAIPU                         ;METROPOLITANA;322950;5;3;0;0;0;5;3;322950;Asistencia Salud Integral Familia;GARANTIAS
9361202;;F;62;CHILENO;;Boomers;CONCEPCION                    ;BIO BIO;105980;2;1;0;0;0;2;1;105980;Asistencia Salud Integral Familia;GARANTIAS
6955738;;F;70;CHILENO;;Silencioso;CHIMBARONGO                   ;L.G.B.OÂ´HIGGINS;751920;8;6;3;2;451970;5;4;299950;Asistencia Salud Integral Familia;GARANTIAS
6756838;;F;69;CHILENO;;Silencioso;PROVIDENCIA                   ;METROPOLITANA;158970;3;2;0;0;0;3;2;158970;Asistencia Salud Integral Familia;GARANTIAS
16086181;;M;36;CHILENO;;Millenial;"";"";52990;1;1;0;0;0;1;1;52990;Asistencia Salud Integral Familia;GARANTIAS
9446711;;F;57;CHILENO;;Boomers;LOS ANDES                     ;VALPARAISO;572960;4;3;0;0;0;4;3;572960;Asistencia Salud Integral Familia;GARANTIAS
13447215;;F;43;CHILENO;;X;RECOLETA;METROPOLITANA;116970;3;2;2;1;63980;1;1;52990;Asistencia Programa Domiciliario;GARANTIAS
10400774;;F;59;CHILENO;;Boomers;PUERTO MONTT                  ;LOS LAGOS;312780;4;2;0;0;0;4;2;312780;Asistencia Programa Domiciliario;GARANTIAS
5941053;;M;74;CHILENO;;Silencioso;CHILLAN                       ;BIO BIO;657320;7;3;0;0;0;7;3;657320;Asistencia Salud Integral Familia;GARANTIAS
9556113;Casado;F;62;CHILENO;;Boomers;CABRERO                       ;BIO BIO;0;0;2;0;0;0;0;2;0;GM 1A X CTA SBI;GARANTIAS
15149044;;M;40;CHILENO;;X;SAN JAVIER                    ;MAULE;268960;4;3;0;0;0;4;3;268960;Asistencia Salud Integral Familia;GARANTIAS
8236083;;M;62;CHILENO;;Boomers;PUERTO MONTT                  ;LOS LAGOS;212980;2;2;0;0;0;2;2;212980;Asistencia Programa Domiciliario;GARANTIAS
18894211;;F;27;CHILENO;;Z;TALCA                         ;MAULE;105980;2;1;0;0;0;2;1;105980;Asistencia Salud Integral Familia;GARANTIAS
18987198;;M;28;CHILENO;;Millenial;CURANILAHUE                   ;BIO BIO;181850;4;4;0;0;0;4;4;181850;Asistencia Programa Domiciliario;GARANTIAS
16986928;;M;33;CHILENO;;Millenial;LAJA                          ;BIO BIO;711940;6;2;0;0;0;6;2;711940;Asistencia de Mascotas;GARANTIAS
17709124;;F;30;CHILENO;;Millenial;CERRO NAVIA;METROPOLITANA;52990;1;1;0;0;0;1;1;52990;Asistencia Programa Domiciliario;GARANTIAS
8725385;;F;61;CHILENO;;Boomers;LLAILLAY                      ;VALPARAISO;52990;1;1;0;0;0;1;1;52990;Asistencia Salud Integral Familia;GARANTIAS
5707103;;F;77;CHILENO;;Silencioso;ANTOFAGASTA                   ;ANTOFAGASTA;770492;9;6;0;0;0;9;6;770492;Asistencia Programa Domiciliario;GARANTIAS
4979775;;F;83;CHILENO;;Silencioso;LOS ANDES                     ;VALPARAISO;45041;1;1;0;0;0;1;1;45041;Asistencia Salud Integral Familia;GARANTIAS
3634317;;M;81;CHILENO;;Silencioso;LAS CONDES                    ;METROPOLITANA;52990;1;1;0;0;0;1;1;52990;ASIST. FULL HOGAR Y AUTO INGRAL;GARANTIAS
7174785;;M;68;CHILENO;;Boomers;PELARCO                       ;MAULE;105980;2;1;0;0;0;2;1;105980;Asistencia Salud Integral Familia;GARANTIAS
8755182;;F;62;CHILENO;;Boomers;DALCAHUE                      ;LOS LAGOS;982930;6;3;0;0;0;6;3;982930;Asistencia Programa Domiciliario;GARANTIAS
27050120;;M;25;NO INFORMA NACIONALIDAD;;Extranjero;"";"";52990;1;1;0;0;0;1;1;52990;Asistencia Programa Domiciliario;GARANTIAS
9459411;;M;57;CHILENO;;Boomers;LOS ANGELES                   ;BIO BIO;41940;5;1;0;0;0;5;1;41940;GM 1A X CTA SBI;GARANTIAS
13913192;;M;42;CHILENO;;X;SANTIAGO                      ;METROPOLITANA;141950;5;3;4;2;88960;1;1;52990;Asistencia Programa Domiciliario;GARANTIAS
5179483;;M;76;CHILENO;;Silencioso;ARICA                         ;ARICA Y PARINACOTA;52990;1;1;0;0;0;1;1;52990;Asistencia Salud Integral Familia;GARANTIAS
7793683;;F;63;CHILENO;;Boomers;N/D;N/D;52990;1;1;0;0;0;1;1;52990;Asistencia Salud Integral Familia;GARANTIAS
6167669;;F;70;CHILENO;;Silencioso;CURANILAHUE                   ;BIO BIO;240860;3;3;0;0;0;3;3;240860;Asistencia Programa Domiciliario;GARANTIAS
12377289;;M;49;CHILENO;;Millenial;"";"";52990;1;1;0;0;0;1;1;52990;Asistencia Programa Domiciliario;GARANTIAS
5641235;;M;73;CHILENO;;Silencioso;LA SERENA                     ;COQUIMBO;52990;1;1;0;0;0;1;1;52990;Asistencia Programa Domiciliario;GARANTIAS
26233660;;M;46;VENEZOLANO;;Extranjero;N/D;N/D;282980;2;2;0;0;0;2;2;282980;ASIST. FULL HOGAR Y AUTO INGRAL;GARANTIAS
26102695;;F;42;EXTRANJERO - NO INFORMA NACIONALIDAD;;Extranjero;SANTIAGO                      ;METROPOLITANA;52990;1;1;0;0;0;1;1;52990;Asistencia Programa Domiciliario;GARANTIAS
11512083;;F;52;CHILENO;;X;N/D;N/D;193850;4;4;0;0;0;4;4;193850;ASIST. FULL HOGAR Y AUTO INGRAL;GARANTIAS
5679548;;F;76;CHILENO;;Silencioso;LEBU                          ;BIO BIO;165970;5;2;0;0;0;5;2;165970;Asistencia Salud Integral Familia;GARANTIAS
10349399;;M;57;CHILENO;;Boomers;N/D;N/D;52990;1;1;0;0;0;1;1;52990;Asistencia Salud Integral Familia;GARANTIAS
7715937;;M;67;CHILENO;;Boomers;ALTO HOSPICIO;TARAPACA;52990;1;1;0;0;0;1;1;52990;Asistencia Programa Domiciliario;GARANTIAS
27231512;Soltero;M;47;EXTRANJERO - NO INFORMA NACIONALIDAD;;Extranjero;"";"";52990;1;1;0;0;0;1;1;52990;Asistencia Programa Domiciliario;GARANTIAS
9377211;;F;60;CHILENO;;Boomers;N/D;N/D;101970;3;2;0;0;0;3;2;101970;Asistencia Salud Integral Familia;GARANTIAS
8769162;;F;63;CHILENO;;Boomers;LO PRADO                      ;METROPOLITANA;52990;1;1;0;0;0;1;1;52990;Asistencia Salud Integral Familia;GARANTIAS
19810118;;M;24;CHILENO;;Z;N/D;N/D;302980;2;2;0;0;0;2;2;302980;Asistencia Programa Domiciliario;GARANTIAS
24252193;;M;29;COLOMBIANO;;Extranjero;CALAMA                        ;ANTOFAGASTA;113970;3;1;0;0;0;3;1;113970;Asistencia Salud Integral Familia;GARANTIAS
8986532;;M;62;CHILENO;;Boomers;LLAILLAY                      ;VALPARAISO;52990;1;1;0;0;0;1;1;52990;Asistencia Salud Integral Familia;GARANTIAS
18973213;;M;27;CHILENO;;Z;CALLE LARGA                   ;VALPARAISO;597970;3;2;2;1;544980;1;1;52990;Asistencia Salud Integral Familia;GARANTIAS
9758176;;F;57;CHILENO;;Boomers;CONSTITUCION                  ;MAULE;105980;2;1;0;0;0;2;1;105980;ASIST. FULL HOGAR Y AUTO INGRAL;GARANTIAS
23891456;;F;23;PERUANO;;Extranjero;PROVIDENCIA                   ;METROPOLITANA;52990;1;1;0;0;0;1;1;52990;ASIST. FULL HOGAR Y AUTO INGRAL;GARANTIAS
17410449;;F;32;CHILENO;;Millenial;N/D;N/D;1360620;10;5;0;0;0;10;5;1360620;Asistencia Salud Integral Familia;GARANTIAS
5448445;;F;75;CHILENO;;Silencioso;QUILICURA                     ;METROPOLITANA;52990;1;1;0;0;0;1;1;52990;ASIST. FULL HOGAR Y AUTO INGRAL;GARANTIAS
4409317;;F;82;CHILENO;;Silencioso;N/D;N/D;52990;1;1;0;0;0;1;1;52990;Asistencia Salud Integral Familia;GARANTIAS
15495494;;M;38;CHILENO;;X;NEGRETE                       ;BIO BIO;211960;4;1;0;0;0;4;1;211960;Asistencia de Mascotas;GARANTIAS
9542624;;F;60;CHILENO;;Boomers;IQUIQUE                       ;TARAPACA;574960;4;3;0;0;0;4;3;574960;Asistencia Salud Integral Familia;GARANTIAS
14312886;;F;45;CHILENO;;X;MELIPILLA                     ;METROPOLITANA;52990;1;1;0;0;0;1;1;52990;Asistencia Programa Domiciliario;GARANTIAS
9398702;;M;59;CHILENO;;Boomers;LOS ANGELES                   ;BIO BIO;52990;1;1;0;0;0;1;1;52990;Asistencia Salud Integral Familia;GARANTIAS
8982831;;M;62;CHILENO;;Boomers;MELIPILLA                     ;METROPOLITANA;52990;1;1;0;0;0;1;1;52990;Asistencia Programa Domiciliario;GARANTIAS
12078301;;F;56;CHILENO;;Boomers;VALPARAISO                    ;VALPARAISO;52990;1;1;0;0;0;1;1;52990;Asistencia Salud Integral Familia;GARANTIAS
5670881;;F;80;CHILENO;;Silencioso;OSORNO                        ;LOS LAGOS;52990;1;1;0;0;0;1;1;52990;Asistencia Salud Integral Familia;GARANTIAS
18306587;;M;46;CHILENO;;X;PADRE LAS CASAS               ;ARAUCANIA;52990;1;1;0;0;0;1;1;52990;Asistencia Programa Domiciliario;GARANTIAS
7885549;;F;62;CHILENO;;Boomers;N/D;N/D;320700;10;4;0;0;0;10;4;320700;Asistencia Programa Domiciliario;GARANTIAS
7565184;;F;69;CHILENO;;Silencioso;LINARES                       ;MAULE;52990;1;1;0;0;0;1;1;52990;Asistencia Programa Domiciliario;GARANTIAS
9020922;;F;58;CHILENO;;Boomers;RIO NEGRO                     ;LOS LAGOS;72980;2;2;0;0;0;2;2;72980;Asistencia Salud Integral Familia;GARANTIAS
24126040;;M;51;BOLIVIANO;;Extranjero;CALAMA                        ;ANTOFAGASTA;52990;1;1;0;0;0;1;1;52990;Asistencia Salud Integral Familia;GARANTIAS
15886263;;M;38;CHILENO;;Millenial;ANDACOLLO                     ;COQUIMBO;52990;1;1;0;0;0;1;1;52990;Asistencia Programa Domiciliario;GARANTIAS
9973424;;M;56;CHILENO;;Boomers;PICHIDEGUA                    ;L.G.B.OÂ´HIGGINS;52990;1;1;0;0;0;1;1;52990;Asistencia Salud Integral Familia;GARANTIAS
26661658;;M;39;VENEZOLANO;;Extranjero;N/D;N/D;52990;1;1;0;0;0;1;1;52990;Asistencia Programa Domiciliario;GARANTIAS
18643175;Soltero;M;28;CHILENO;;Millenial;PORVENIR                      ;MAGALLANES;205970;3;2;0;0;0;3;2;205970;GM 1A X CTA SBI;GARANTIAS
9325481;;M;61;CHILENO;;Boomers;VINA DEL MAR                  ;VALPARAISO;92980;2;1;0;0;0;2;1;92980;Asistencia Salud Integral Familia;GARANTIAS
19882812;;F;24;CHILENO;;Z;N/D;N/D;276970;3;2;2;1;223980;1;1;52990;Asistencia Salud Integral Familia;GARANTIAS
26357535;;M;38;HAITIANO;;Extranjero;N/D;N/D;52990;1;1;0;0;0;1;1;52990;Asistencia Salud Integral Familia;GARANTIAS
12961007;;M;45;CHILENO;;X;PAINE                         ;METROPOLITANA;52990;1;1;0;0;0;1;1;52990;Asistencia Salud Integral Familia;GARANTIAS
6438662;;F;68;CHILENO;;Silencioso;QUINTA DE TILCOCO             ;L.G.B.OÂ´HIGGINS;560920;8;5;0;0;0;8;5;560920;Asistencia Salud Integral Familia;GARANTIAS
5873551;Soltero;F;72;CHILENO;;Silencioso;PROVIDENCIA                   ;METROPOLITANA;0;0;2;0;0;0;0;2;0;GM 1A X CTA SBI;GARANTIAS
17984241;;F;31;CHILENO;;Millenial;HIJUELAS                      ;VALPARAISO;52990;1;1;0;0;0;1;1;52990;Asistencia Salud Integral Familia;GARANTIAS
7238613;;F;67;CHILENO;;Boomers;N/D;N/D;52990;1;1;0;0;0;1;1;52990;Asistencia Salud Integral Familia;GARANTIAS
8916183;;F;61;CHILENO;;Boomers;ANTOFAGASTA                   ;ANTOFAGASTA;105980;2;1;0;0;0;2;1;105980;Asistencia Programa Domiciliario;GARANTIAS
16700698;;F;35;CHILENO;;Millenial;LA LIGUA                      ;VALPARAISO;100870;2;2;0;0;0;2;2;100870;Asistencia Salud Integral Familia;GARANTIAS
17756204;;F;31;CHILENO;;Millenial;N/D;N/D;52990;1;1;0;0;0;1;1;52990;Asistencia Salud Integral Familia;GARANTIAS
6955224;;M;68;CHILENO;;Silencioso;OVALLE                        ;COQUIMBO;79980;2;2;0;0;0;2;2;79980;Asistencia Salud Integral Familia;GARANTIAS
7964894;;M;64;CHILENO;;Boomers;PUREN                         ;ARAUCANIA;52990;1;1;0;0;0;1;1;52990;Asistencia Salud Integral Familia;GARANTIAS
14561986;;M;46;CHILENO;;X;VALPARAISO                    ;VALPARAISO;52990;1;1;0;0;0;1;1;52990;Asistencia Salud Integral Familia;GARANTIAS
13427837;;M;43;CHILENO;;X;IQUIQUE                       ;TARAPACA;52990;1;1;0;0;0;1;1;52990;Asistencia Programa Domiciliario;GARANTIAS
27131513;;F;26;COLOMBIANO;;Extranjero;"";"";52990;1;1;0;0;0;1;1;52990;Asistencia Salud Integral Familia;GARANTIAS
3536451;;M;87;CHILENO;;Silencioso;ANTOFAGASTA                   ;ANTOFAGASTA;52990;1;1;0;0;0;1;1;52990;Asistencia Programa Domiciliario;GARANTIAS
11474017;;M;53;CHILENO;;X;"";"";162980;2;2;1;1;109990;1;1;52990;Asistencia Salud Integral Familia;GARANTIAS
16295138;;M;36;CHILENO;;Millenial;LOS ALAMOS                    ;BIO BIO;52990;1;1;0;0;0;1;1;52990;Asistencia Salud Integral Familia;GARANTIAS
10262656;;F;58;CHILENO;;Boomers;PROVIDENCIA                   ;METROPOLITANA;0;0;2;0;0;0;0;2;0;Asistencia Salud Integral Familia;GARANTIAS
24429786;;M;30;BOLIVIANO;;Extranjero;ANTOFAGASTA                   ;ANTOFAGASTA;42392;1;1;0;0;0;1;1;42392;Asistencia Salud Integral Familia;GARANTIAS
16541879;;F;35;CHILENO;;Millenial;"";"";52990;1;1;0;0;0;1;1;52990;Asistencia Programa Domiciliario;GARANTIAS
11456888;;F;52;CHILENO;;X;SANTA CRUZ                    ;L.G.B.OÂ´HIGGINS;158970;3;1;0;0;0;3;1;158970;Asistencia Programa Domiciliario;GARANTIAS
6683544;;F;72;CHILENO;;Silencioso;CONSTITUCION                  ;MAULE;232980;2;2;0;0;0;2;2;232980;Asistencia Salud Integral Familia;GARANTIAS
11606543;Soltero;F;51;CHILENO;;Millenial;"";"";52990;1;1;0;0;0;1;1;52990;Asistencia Salud Integral Familia;GARANTIAS
11746140;;M;51;CHILENO;;X;LINARES                       ;MAULE;52990;1;1;0;0;0;1;1;52990;Asistencia Programa Domiciliario;GARANTIAS
12980166;;F;46;CHILENO;;X;LOS ANGELES                   ;BIO BIO;52990;1;1;0;0;0;1;1;52990;Asistencia Salud Integral Familia;GARANTIAS
5187376;;F;78;CHILENO;;Silencioso;CORONEL                       ;BIO BIO;105980;2;1;0;0;0;2;1;105980;Asistencia Salud Integral Familia;GARANTIAS
8279384;;F;67;CHILENO;;Boomers;N/D;N/D;52990;1;1;0;0;0;1;1;52990;Asistencia Salud Integral Familia;GARANTIAS
17907603;;M;30;CHILENO;;Millenial;N/D;N/D;52990;1;1;0;0;0;1;1;52990;Asistencia Salud Integral Familia;GARANTIAS
12615532;;F;48;CHILENO;;X;ANTOFAGASTA                   ;ANTOFAGASTA;105980;2;1;0;0;0;2;1;105980;Asistencia Programa Domiciliario;GARANTIAS
12490496;;F;49;CHILENO;;X;"";"";52990;1;1;0;0;0;1;1;52990;Asistencia Salud Integral Familia;GARANTIAS
7975278;;M;66;CHILENO;;Boomers;PAPUDO                        ;VALPARAISO;52990;1;1;0;0;0;1;1;52990;Asistencia Salud Integral Familia;GARANTIAS
10750512;;M;56;CHILENO;;Boomers;COQUIMBO                      ;COQUIMBO;52990;1;1;0;0;0;1;1;52990;Asistencia Programa Domiciliario;GARANTIAS
19711984;;F;24;CHILENO;;Z;SANTO DOMINGO                 ;VALPARAISO;52990;1;1;0;0;0;1;1;52990;Asistencia Salud Integral Familia;GARANTIAS
19556627;;M;25;CHILENO;;Z;N/D;N/D;52990;1;1;0;0;0;1;1;52990;Asistencia Salud Integral Familia;GARANTIAS
4645255;;M;80;CHILENO;;Silencioso;ALTO HOSPICIO;TARAPACA;431059;3;2;0;0;0;3;2;431059;Asistencia Programa Domiciliario;GARANTIAS
7592233;;F;64;CHILENO;;Boomers;MARIQUINA                     ;LOS LAGOS;92980;2;2;0;0;0;2;2;92980;Asistencia Salud Integral Familia;GARANTIAS
8867250;;F;60;CHILENO;;Boomers;SANTIAGO                      ;METROPOLITANA;210812;7;2;0;0;0;7;2;210812;Asistencia Programa Domiciliario;GARANTIAS
13975125;;F;41;CHILENO;;X;OVALLE                        ;COQUIMBO;47880;1;1;0;0;0;1;1;47880;ASIS. SALUD X CTA ASSISTIME;GARANTIAS
9563084;;M;59;CHILENO;;Boomers;LOS ANGELES                   ;BIO BIO;47880;1;1;0;0;0;1;1;47880;ASIS. SALUD X CTA ASSISTIME;GARANTIAS
24365220;;F;44;COLOMBIANO;;Extranjero;ANTOFAGASTA                   ;ANTOFAGASTA;44064;1;1;0;0;0;1;1;44064;Asistencia Programa Domiciliario;GARANTIAS
15886407;;F;38;CHILENO;;Millenial;EL BOSQUE                     ;METROPOLITANA;55080;1;1;0;0;0;1;1;55080;Asistencia Programa Domiciliario;GARANTIAS
10529292;;M;55;CHILENO;;Boomers;TALCA                         ;MAULE;102960;2;2;0;0;0;2;2;102960;Asistencia Programa Domiciliario;GARANTIAS
26222112;;F;27;COLOMBIANO;;Extranjero;N/D;N/D;47880;1;1;0;0;0;1;1;47880;ASIS. SALUD X CTA ASSISTIME;GARANTIAS
17897598;;M;33;CHILENO;;Millenial;N/D;N/D;47880;1;1;0;0;0;1;1;47880;ASIS. SALUD X CTA ASSISTIME;GARANTIAS
5039785;;F;83;CHILENO;;Silencioso;ANCUD                         ;LOS LAGOS;47880;1;1;0;0;0;1;1;47880;ASIS. SALUD X CTA ASSISTIME;GARANTIAS
11950406;;M;50;CHILENO;;X;QUINTA DE TILCOCO             ;L.G.B.OÂ´HIGGINS;77870;2;2;0;0;0;2;2;77870;ASIS. SALUD X CTA ASSISTIME;GARANTIAS
10861918;;F;54;CHILENO;;Boomers;CANETE                        ;BIO BIO;47880;1;1;0;0;0;1;1;47880;ASIS. SALUD X CTA ASSISTIME;GARANTIAS
15285623;;F;63;CHILENO;;Boomers;PUERTO MONTT                  ;LOS LAGOS;0;0;2;0;0;0;0;2;0;Asistencia Programa Domiciliario;GARANTIAS
25798400;;M;39;PERUANO;;Extranjero;"";"";90960;2;1;0;0;0;2;1;90960;ASIS. SALUD X CTA ASSISTIME;GARANTIAS
7809511;;M;65;CHILENO;;Boomers;VALPARAISO                    ;VALPARAISO;0;0;2;0;0;0;0;2;0;GM 1A X CTA SBI;GARANTIAS
24368637;;M;45;COLOMBIANO;;Extranjero;VALLENAR;ATACAMA;127870;3;2;0;0;0;3;2;127870;ASIS. SALUD X CTA ASSISTIME;GARANTIAS
26508833;;M;41;EXTRANJERO - NO INFORMA NACIONALIDAD;;Extranjero;"";"";47880;1;1;0;0;0;1;1;47880;ASIS. SALUD X CTA ASSISTIME;GARANTIAS
12899461;;F;48;CHILENO;;X;N/D;N/D;47880;1;1;0;0;0;1;1;47880;ASIS. SALUD X CTA ASSISTIME;GARANTIAS
8152651;;F;68;CHILENO;;Boomers;OVALLE                        ;COQUIMBO;-47880;-1;1;0;0;0;-1;1;-47880;ASIS. SALUD X CTA ASSISTIME;GARANTIAS
4867261;;M;78;CHILENO;;Silencioso;CABILDO                       ;VALPARAISO;47880;1;1;0;0;0;1;1;47880;ASIS. SALUD X CTA ASSISTIME;GARANTIAS
9428227;;F;60;CHILENO;;X;RANCAGUA                      ;L.G.B.OÂ´HIGGINS;47880;1;1;0;0;0;1;1;47880;ASIS. SALUD X CTA ASSISTIME;GARANTIAS
17510327;;F;32;CHILENO;;Millenial;PROVIDENCIA                   ;METROPOLITANA;47880;1;1;0;0;0;1;1;47880;ASIS. SALUD X CTA ASSISTIME;GARANTIAS
14087774;;M;49;CHILENO;;X;CALBUCO                       ;LOS LAGOS;47880;1;1;0;0;0;1;1;47880;ASIS. SALUD X CTA ASSISTIME;GARANTIAS
13058492;;M;46;CHILENO;;X;"";"";47880;1;1;0;0;0;1;1;47880;ASIS. SALUD X CTA ASSISTIME;GARANTIAS
17469659;;M;31;CHILENO;;Millenial;LOS ANDES;VALPARAISO;47880;1;1;0;0;0;1;1;47880;ASIS. SALUD X CTA ASSISTIME;GARANTIAS
8901451;;F;62;CHILENO;;Boomers;N/D;N/D;0;0;0;0;0;0;0;0;0;ASIS. SALUD X CTA ASSISTIME;GARANTIAS
18602763;;F;28;CHILENO;;Millenial;N/D;N/D;0;0;0;0;0;0;0;0;0;ASIS. SALUD X CTA ASSISTIME;GARANTIAS
15469795;;F;40;CHILENO;;X;N/D;N/D;0;0;0;0;0;0;0;0;0;ASIS. SALUD X CTA ASSISTIME;GARANTIAS
27199653;;M;29;EXTRANJERO - NO INFORMA NACIONALIDAD;;Extranjero;N/D;N/D;0;0;0;0;0;0;0;0;0;ASIS. SALUD X CTA ASSISTIME;GARANTIAS
6898624;;M;68;CHILENO;;Boomers;COIHAIQUE                     ;AYSEN;0;0;0;0;0;0;0;0;0;ASIS. SALUD X CTA ASSISTIME;GARANTIAS
12915678;;M;47;CHILENO;;X;PROVIDENCIA                   ;METROPOLITANA;0;0;0;0;0;0;0;0;0;GM 1A X CTA SBI;GARANTIAS
19832500;;M;24;CHILENO;;Millenial;N/D;N/D;0;0;0;0;0;0;0;0;0;ASIS. SALUD X CTA ASSISTIME;GARANTIAS
9528454;;M;59;CHILENO;;Boomers;PAINE                         ;METROPOLITANA;0;0;0;0;0;0;0;0;0;ASIS. SALUD X CTA ASSISTIME;GARANTIAS
16737285;;F;34;CHILENO;;Millenial;N/D;N/D;0;0;0;0;0;0;0;0;0;ASIS. SALUD X CTA ASSISTIME;GARANTIAS
15295803;;M;40;CHILENO;;X;PUERTO OCTAY                  ;LOS LAGOS;0;0;0;0;0;0;0;0;0;ASIS. SALUD X CTA ASSISTIME;GARANTIAS
13202581;;M;45;CHILENO;;X;SANTA CRUZ                    ;L.G.B.OÂ´HIGGINS;0;0;0;0;0;0;0;0;0;ASIS. SALUD X CTA ASSISTIME;GARANTIAS
19251851;;M;26;CHILENO;;Z;N/D;N/D;0;0;0;0;0;0;0;0;0;ASIS. SALUD X CTA ASSISTIME;GARANTIAS
26213938;;F;51;PERUANO;;Extranjero;INDEPENDENCIA                 ;METROPOLITANA;0;0;0;0;0;0;0;0;0;ASIS. SALUD X CTA ASSISTIME;GARANTIAS
16184108;;M;36;CHILENO;;Millenial;PROVIDENCIA                   ;METROPOLITANA;0;0;0;0;0;0;0;0;0;GPL 1A X CTA SBI;GARANTIAS
25547140;;M;61;PERUANO;;Extranjero;N/D;N/D;0;0;0;0;0;0;0;0;0;ASIS. SALUD X CTA ASSISTIME;GARANTIAS
15955090;;M;37;CHILENO;;Millenial;N/D;N/D;0;0;0;0;0;0;0;0;0;ASIS. SALUD X CTA ASSISTIME;GARANTIAS
23915492;;M;51;BOLIVIANO;;Extranjero;ALTO HOSPICIO;TARAPACA;0;0;0;0;0;0;0;0;0;ASIS. SALUD X CTA ASSISTIME;GARANTIAS
14392999;;F;43;CHILENO;;X;ANTOFAGASTA                   ;ANTOFAGASTA;0;0;0;0;0;0;0;0;0;ASIS. SALUD X CTA ASSISTIME;GARANTIAS
6098908;;M;73;CHILENO;;Silencioso;CABILDO                       ;VALPARAISO;0;0;0;0;0;0;0;0;0;ASIS. SALUD X CTA ASSISTIME;GARANTIAS
7868735;;F;66;CHILENO;;Boomers;VALDIVIA                      ;LOS RIOS;0;0;0;0;0;0;0;0;0;ASIS. SALUD X CTA ASSISTIME;GARANTIAS
13246008;;F;44;CHILENO;;X;COPIAPO                       ;ATACAMA;0;0;0;0;0;0;0;0;0;GPL 1A X CTA SBI;GARANTIAS
5975562;;M;74;CHILENO;;Silencioso;MONTE PATRIA                  ;COQUIMBO;0;0;0;0;0;0;0;0;0;TARIFA NORMAL;GARANTIAS
13924548;Casado;M;41;CHILENO;INGENIERO COMERCIAL;Silencioso;PROVIDENCIA                   ;METROPOLITANA;0;0;0;0;0;0;0;0;0;GM 1A X CTA SBI;GARANTIAS
9638715;;F;60;CHILENO;;Boomers;ZAPALLAR                      ;VALPARAISO;0;0;0;0;0;0;0;0;0;ASIST. FULL HOGAR X CTA MOK;GARANTIAS
13744941;;F;41;CHILENO;;X;VALLENAR;ATACAMA;0;0;0;0;0;0;0;0;0;ASIS. SALUD X CTA ASSISTIME;GARANTIAS
7565512;;M;72;CHILENO;;Silencioso;MAULE                         ;MAULE;0;0;0;0;0;0;0;0;0;ASIS. SALUD X CTA ASSISTIME;GARANTIAS
7137346;Casado;F;67;CHILENO;;Boomers;CALAMA                        ;ANTOFAGASTA;0;0;0;0;0;0;0;0;0;TARIFA NORMAL;GARANTIAS
6399674;;F;70;CHILENO;;Silencioso;MAIPU                         ;METROPOLITANA;0;0;0;0;0;0;0;0;0;ASIS. SALUD X CTA ASSISTIME;GARANTIAS
8549210;;F;61;CHILENO;;Boomers;PUENTE ALTO                   ;METROPOLITANA;0;0;0;0;0;0;0;0;0;ASIS. SALUD X CTA ASSISTIME;GARANTIAS
5048738;;F;80;CHILENO;;Silencioso;PUERTO MONTT                  ;LOS LAGOS;0;0;0;0;0;0;0;0;0;ASIS. SALUD X CTA ASSISTIME;GARANTIAS
6468985;Viudo;F;69;CHILENO;;Silencioso;RENCA                         ;METROPOLITANA;0;0;0;0;0;0;0;0;0;GM 1A X CTA SBI;GARANTIAS
10700543;;M;55;CHILENO;;Boomers;COBQUECURA                    ;BIO BIO;0;0;0;0;0;0;0;0;0;ASIS. SALUD X CTA ASSISTIME;GARANTIAS
8507728;;F;59;CHILENO;;Boomers;OVALLE                        ;COQUIMBO;0;0;0;0;0;0;0;0;0;ASIS. SALUD X CTA ASSISTIME;GARANTIAS
26068876;;M;29;VENEZOLANO;;Extranjero;N/D;N/D;0;0;0;0;0;0;0;0;0;ASIS. SALUD X CTA ASSISTIME;GARANTIAS
7523241;;F;65;CHILENO;;Boomers;CONCEPCION                    ;BIO BIO;0;0;0;0;0;0;0;0;0;ASIS. SALUD X CTA ASSISTIME;GARANTIAS
25728017;;F;37;VENEZOLANO;;Extranjero;SANTIAGO                      ;METROPOLITANA;153980;2;1;2;1;153980;0;0;0;CELULAR GALAXY A13 4+128GB BLACK;TELEFONIA
15979187;;M;37;CHILENO;;Millenial;ARICA                         ;ARICA Y PARINACOTA;339990;1;1;0;0;0;1;1;339990;CELULAR GALAXY A53 5G 6+128GB ORANGE;TELEFONIA
9462052;;F;57;CHILENO;;Boomers;CALAMA                        ;ANTOFAGASTA;139990;1;1;0;0;0;1;1;139990;CELULAR VIVO Y15S WAVE GREEN OPEN;TELEFONIA
15532878;;F;39;CHILENO;;X;N/D;N/D;1044930;7;6;0;0;0;7;6;1044930;CELULAR GALAXY A13 4+128GB LIGHT BLUE OPEN;TELEFONIA
14081198;;M;41;CHILENO;;X;VALDIVIA                      ;LOS LAGOS;1262940;11;5;0;0;0;11;5;1262940;CELULAR SAMSUNG A52s 128GB BLACK CLARO;TELEFONIA
15425799;;M;39;CHILENO;;X;CERRO NAVIA;METROPOLITANA;179980;2;2;0;0;0;2;2;179980;CELULAR XIAOMI REDMI 9A 32GB GRANITE GRAY TRI WO;TELEFONIA
24184274;;F;29;BOLIVIANO;;Extranjero;N/D;N/D;269990;1;1;0;0;0;1;1;269990;CELULAR SAMSUNG A33 128GB 5G BLACK CLARO;TELEFONIA
10240602;Soltero;M;56;CHILENO;;Boomers;RENCA                         ;METROPOLITANA;149990;1;1;0;0;0;1;1;149990;CELULAR VIVO Y15S BLUE MOVISTAR;TELEFONIA
20126405;;F;23;CHILENO;;Z;TOCOPILLA                     ;ANTOFAGASTA;1021160;14;11;0;0;0;14;11;1021160;CELULAR VIVO Y21s 128GB AZUL CLARO;TELEFONIA
16845509;;F;33;CHILENO;;Millenial;N/D;N/D;1325080;10;6;3;1;365830;7;5;959250;CELULAR MOTOROLA G30 GRIS WOM 128 GB;TELEFONIA
6159811;;F;76;CHILENO;;Silencioso;CALBUCO                       ;LOS LAGOS;697940;5;9;0;0;0;5;9;697940;CELULAR MOTO G20 EDICION ESPECIAL 4/128 GB VERDE;TELEFONIA
5565880;;F;75;CHILENO;;Silencioso;LOS ANDES                     ;VALPARAISO;839090;12;7;0;0;0;12;7;839090;CELULAR GALAXY A23 6+128GB LIGHT BLUE OPEN;TELEFONIA
3440248;;M;86;CHILENO;;Silencioso;LOS ANGELES                   ;BIO BIO;487960;5;4;0;0;0;5;4;487960;CELULAR MOTOROLA G50 128GB AZUL CLARO;TELEFONIA
6920198;Casado;M;65;CHILENO;INGENIERO;Boomers;LO BARNECHEA;METROPOLITANA;0;0;2;0;2;0;0;0;0;CELULAR GALAXY A53 5G 6+128GB WHITE;TELEFONIA
9656948;;M;58;CHILENO;;Boomers;RENCA                         ;METROPOLITANA;202266;3;1;0;0;0;3;1;202266;CELULAR VIVO Y53S FANTASTIC RAINBOW 128GB OPEN;TELEFONIA
19259057;;M;29;CHILENO;;Millenial;COLINA                        ;METROPOLITANA;771940;6;4;0;0;0;6;4;771940;CELULAR GALAXY A33 5G 6+128GB BLACK OPEN;TELEFONIA
19070062;;F;27;CHILENO;;Millenial;N/D;N/D;741040;8;4;0;0;0;8;4;741040;CELULAR GALAXY A23 6+128GB LIGHT BLUE OPEN;TELEFONIA
11874274;;M;51;CHILENO;;X;COMBARBALA                    ;COQUIMBO;293668;6;3;0;0;0;6;3;293668;CELULAR GALAXY A13 4+128GB LIGHT BLUE OPEN;TELEFONIA
7302992;Casado;M;67;CHILENO;;Boomers;COQUIMBO                      ;COQUIMBO;169990;1;1;1;1;169990;0;0;0;CELULAR POCO M4 PRO 128GB COOL BLUE OPEN;TELEFONIA
17448194;;F;32;CHILENO;;Millenial;LINARES                       ;MAULE;152123;3;2;0;0;0;3;2;152123;CELULAR VIVO Y21S 128GB BLANCO WOM;TELEFONIA
16705090;;M;34;CHILENO;;Millenial;ANTOFAGASTA                   ;ANTOFAGASTA;1602430;7;6;7;6;1602430;0;0;0;CELULAR GALAXY A03 4+64GB BLACK OPEN;TELEFONIA
12059267;;M;55;CHILENO;;Boomers;QUILPUE                       ;VALPARAISO;16990;1;1;0;0;0;1;1;16990;TELEFONO PP BINDU ENTEL;TELEFONIA
11360674;;F;52;CHILENO;;X;CARTAGENA                     ;VALPARAISO;161630;3;2;0;0;0;3;2;161630;CELULAR GALAXY A03 4+64GB BLACK OPEN;TELEFONIA
9417597;Casado;M;59;CHILENO;CONTADOR GENERAL;Boomers;PROVIDENCIA                   ;METROPOLITANA;89990;2;1;0;0;0;2;1;89990;CELULAR REDMI 10A US 64GB GRAPHITE GRAY OPEN;TELEFONIA
27744556;;M;29;CHILENO;;Extranjero;N/D;N/D;185980;2;1;2;1;185980;0;0;0;CELULAR GALAXY A23 6+128GB LIGHT BLUE OPEN;TELEFONIA
11078170;;F;56;CHILENO;;Boomers;PANGUIPULLI                   ;LOS LAGOS;745030;6;4;0;0;0;6;4;745030;CELULAR GALAXY A03 CORE 2GB 32GB BLUE OPEN;TELEFONIA
9562097;;F;59;CHILENO;;Boomers;SAN PEDRO DE LA PAZ;BIO-BIO;234980;2;2;2;2;234980;0;0;0;CELULAR GALAXY A22 5G 4+128GB GRAY;TELEFONIA
19157330;;M;21;CHILENO;;Z;PENCO;BIO-BIO;299990;1;1;1;1;299990;0;0;0;CELULAR GALAXY A53 5G 6+128GB WHITE;TELEFONIA
19608150;;F;25;CHILENO;;Z;VILLARICA                     ;ARAUCANIA;399950;5;5;0;0;0;5;5;399950;CELULAR GALAXY A13 4+128GB WHITE OPEN;TELEFONIA
16295330;;M;36;CHILENO;;Millenial;CANETE                        ;BIO BIO;356960;4;4;0;0;0;4;4;356960;CELULAR VIVO Y53S FANTASTIC AZUL WOM;TELEFONIA
12549106;;F;48;CHILENO;;X;CHILLAN                       ;BIO BIO;368541;5;2;0;0;0;5;2;368541;CELULAR VIVO V21 5G 128GB SUNSET DAZZLE OPEN;TELEFONIA
8822789;;F;61;CHILENO;;Boomers;RECOLETA                      ;METROPOLITANA;711190;7;3;0;0;0;7;3;711190;SMARTPHONE A52S 5G WHITE 128GB;TELEFONIA
10766968;;F;50;CHILENO;;X;RIO HURTADO                   ;COQUIMBO;199990;1;1;0;0;0;1;1;199990;CELULAR VIVO Y53S AZUL ENTEL;TELEFONIA
8915635;;F;62;CHILENO;;Boomers;LAS CABRAS                    ;L.G.B.OÂ´HIGGINS;2148830;14;4;0;0;0;14;4;2148830;IPHONE 11 64GB BLACK CLARO;TELEFONIA
10344412;Divorciado;M;57;CHILENO;;Boomers;RENCA                         ;METROPOLITANA;279990;1;1;0;0;0;1;1;279990;CELULAR GALAXY A53 5G 6+128GB BLACK;TELEFONIA
19224080;Soltero;F;27;CHILENO;;Z;VICTORIA                      ;ARAUCANIA;641110;7;3;0;0;0;7;3;641110;CELULAR VIVO Y15S WAVE GREEN OPEN;TELEFONIA
15972818;Soltero;F;37;CHILENO;ASISTENTE SOCIAL;Millenial;PROVIDENCIA                   ;METROPOLITANA;193980;2;1;2;1;193980;0;0;0;CELULAR GALAXY A33 5G 6+128GB BLACK OPEN;TELEFONIA
16360909;;F;35;CHILENO;;Millenial;PROVIDENCIA                   ;METROPOLITANA;193980;2;1;2;1;193980;0;0;0;CELULAR GALAXY A22 5G 4+128GB GRAY;TELEFONIA
17901131;;M;30;CHILENO;;Millenial;PROVIDENCIA                   ;METROPOLITANA;272570;3;2;0;0;0;3;2;272570;CELULAR POCO M4 PRO 128GB COOL BLUE OPEN;TELEFONIA
8891100;;F;60;CHILENO;;Boomers;CAUQUENES                     ;MAULE;530209;5;4;0;0;0;5;4;530209;CELULAR GALAXY A53 5G 6+128GB WHITE;TELEFONIA
16638068;;M;35;CHILENO;;Millenial;COLINA                        ;METROPOLITANA;1702370;9;4;0;0;0;9;4;1702370;CELULAR GALAXY A53 5G 6+128GB WHITE;TELEFONIA
7530688;;F;65;CHILENO;;Boomers;TOCOPILLA                     ;ANTOFAGASTA;977910;10;8;0;0;0;10;8;977910;CELULAR SAMSUNG A03 128GB BLACK CLARO;TELEFONIA
17900793;Soltero;M;30;CHILENO;;Millenial;PROVIDENCIA                   ;METROPOLITANA;580960;4;2;4;2;580960;0;0;0;IPHONE 11 64GB BLACK CLARO;TELEFONIA
16850667;;F;34;CHILENO;;Millenial;LOS SAUCES                    ;ARAUCANIA;134990;1;1;0;0;0;1;1;134990;CELULAR GALAXY A22 5G 4+128GB GRAY;TELEFONIA
13995055;;F;41;CHILENO;;X;VINA DEL MAR                  ;VALPARAISO;1182150;7;4;0;0;0;7;4;1182150;CELULAR VIVO Y15S WAVE GREEN OPEN;TELEFONIA
12034636;;F;54;CHILENO;;Boomers;QUINTA NORMAL                 ;METROPOLITANA;1768930;8;5;0;0;0;8;5;1768930;IPHONE 11 64GB BLACK CLARO;TELEFONIA
18973328;;F;27;CHILENO;;Z;LOS ANDES                     ;VALPARAISO;530469;8;6;0;0;0;8;6;530469;CELULAR VIVO Y01 AZUL ZAFIRO OPEN;TELEFONIA
9461130;Casado;M;59;CHILENO;;Boomers;RENCA                         ;METROPOLITANA;779980;4;2;4;2;779980;0;0;0;CELULAR XIAOMI 12 5G US 8GB+256GB BLUE BUNDLE;TELEFONIA
17107967;;F;33;CHILENO;;Millenial;RENGO                         ;L.G.B.OÂ´HIGGINS;34990;1;1;0;0;0;1;1;34990;CELULAR NOKIA 225 4G BLACK MOVISTAR DIRECTO;TELEFONIA
17006164;;F;33;CHILENO;;Millenial;N/D;N/D;247950;5;2;5;2;247950;0;0;0;CELULAR A32 128 GB BLACK OPEN;TELEFONIA
8158826;;F;62;CHILENO;;Boomers;PUENTE ALTO                   ;METROPOLITANA;141179;8;4;0;0;0;8;4;141179;CELULAR Moto E7 Rosado WOM;TELEFONIA
4749476;;F;81;CHILENO;;Silencioso;CONCON                        ;VALPARAISO;285200;3;2;0;0;0;3;2;285200;CELULAR NOKIA C01 PLUS IRIS INTCHI BLUE TRI WOM;TELEFONIA
11074866;;F;55;CHILENO;;Boomers;CHIGUAYANTE                   ;BIO BIO;761930;8;7;3;2;302970;5;5;458960;CELULAR GALAXY A23 6+128GB LIGHT BLUE OPEN;TELEFONIA
12938942;;F;46;CHILENO;;X;ANTOFAGASTA                   ;ANTOFAGASTA;111231;2;2;0;0;0;2;2;111231;SMARTPHONE A03S NEGRO 32GB;TELEFONIA
10118659;;M;55;CHILENO;;Boomers;PROVIDENCIA                   ;METROPOLITANA;139290;2;1;0;0;0;2;1;139290;SMARTPHONE A03S NEGRO 32GB;TELEFONIA
12648761;;M;48;CHILENO;;X;PUENTE ALTO                   ;METROPOLITANA;123980;2;1;2;1;123980;0;0;0;SMARTPHONE A03s 64 GB Red DS;TELEFONIA
14018853;;F;41;CHILENO;;X;LINARES                       ;MAULE;164990;3;1;0;0;0;3;1;164990;CELULAR MOTO G22 128GB NEGRO WOM;TELEFONIA
19480828;;F;25;CHILENO;;Z;PROVIDENCIA                   ;METROPOLITANA;104906;5;2;0;0;0;5;2;104906;CELULAR VIVO Y15S WAVE GREEN OPEN;TELEFONIA
16527818;;F;34;CHILENO;;Millenial;PAINE                         ;METROPOLITANA;729990;3;1;3;1;729990;0;0;0;CELULAR GALAXY S22 BLACK 128GB;TELEFONIA
8119993;;M;66;CHILENO;;Boomers;PROVIDENCIA                   ;METROPOLITANA;544250;7;3;0;0;0;7;3;544250;CELULAR GALAXY A03 4+64GB BLACK OPEN;TELEFONIA
17803514;Soltero;M;31;CHILENO;;Millenial;RENCA                         ;METROPOLITANA;99990;1;1;1;1;99990;0;0;0;CELULAR Moto G20 Rosado WOM;TELEFONIA
12965495;;M;45;CHILENO;;X;RENCA                         ;METROPOLITANA;385460;4;2;4;2;385460;0;0;0;CELULAR GALAXY A03 4+128GB BLACK OPEN;TELEFONIA
19462693;;M;26;CHILENO;;Z;N/D;N/D;686886;10;3;0;0;0;10;3;686886;CELULAR VIVO Y21S MIDNIGHT BLUE 128 GB OPEN;TELEFONIA
18287510;;F;29;CHILENO;;Millenial;LA LIGUA                      ;VALPARAISO;294980;2;1;2;1;294980;0;0;0;CELULAR GALAXY A53 5G BLACK CLARO;TELEFONIA
9553373;;F;60;CHILENO;;Boomers;PROVIDENCIA                   ;METROPOLITANA;121070;2;1;0;0;0;2;1;121070;CELULAR REDMI 9A 32G GLACIAL BLUE OPEN;TELEFONIA
18476430;;M;28;CHILENO;;Millenial;TALCA                         ;MAULE;400970;3;2;3;2;400970;0;0;0;IPHONE 11 64GB BLACK CLARO;TELEFONIA
19117237;;M;27;CHILENO;;Z;SAN FABIAN                    ;BIO BIO;470820;5;3;0;0;0;5;3;470820;CELULAR XIAOMI REDMI 9A 32GB BLACK DIRECTO CLARO;TELEFONIA
18244977;;M;30;CHILENO;;Millenial;PENALOLEN                     ;METROPOLITANA;773970;4;2;4;2;773970;0;0;0;CELULAR GALAXY S22 PINK GOLD 128GB;TELEFONIA
6839670;;M;69;CHILENO;;Silencioso;CURANILAHUE                   ;BIO BIO;140970;3;3;0;0;0;3;3;140970;Celular SA3 CLARO DIRECTO BLACK;TELEFONIA
17116992;;M;32;CHILENO;;Millenial;MARIQUINA                     ;LOS LAGOS;324980;3;2;0;0;0;3;2;324980;CELULAR MOTO G22 128GB NEGRO MOVISTAR;TELEFONIA
20230842;;F;22;CHILENO;;Z;LINARES                       ;MAULE;799970;4;3;0;0;0;4;3;799970;CELULAR A32 128 GB BLUE OPEN;TELEFONIA
13906246;;F;41;CHILENO;;X;CALBUCO;LOS LAGOS;101883;2;2;2;2;101883;0;0;0;CELULAR GALAXY A03 4+64GB BLUE OPEN;TELEFONIA
8091707;;M;64;CHILENO;;Boomers;VILLA ALEMANA                 ;VALPARAISO;823650;10;15;0;0;0;10;15;823650;CELULAR POCO M4 PRO 128GB COOL BLUE OPEN;TELEFONIA
5857581;;F;75;CHILENO;;Silencioso;RENCA                         ;METROPOLITANA;17990;1;1;0;0;0;1;1;17990;CELULAR AZUMI L4G BLACK CLARO;TELEFONIA
15592624;;M;39;CHILENO;;X;N/D;N/D;337180;2;3;0;0;0;2;3;337180;CELULAR REDMI NOTE 10S 128GB ONIX BLACK;TELEFONIA
14589746;;F;41;CHILENO;;X;PROVIDENCIA                   ;METROPOLITANA;69990;2;1;0;0;0;2;1;69990;CELULAR VIVO Y21S 128GB BLANCO WOM;TELEFONIA
6472161;;M;71;CHILENO;;Silencioso;LEBU                          ;BIO BIO;989520;11;6;0;0;0;11;6;989520;CELULAR GALAXY A03 4+64GB BLACK OPEN;TELEFONIA
18923839;;F;27;CHILENO;;Z;OVALLE                        ;COQUIMBO;399970;5;3;0;0;0;5;3;399970;CELULAR XIAOMI REDMI 9A 2/32GB GRANITE GRAY;TELEFONIA
20936889;;M;20;CHILENO;;Z;NUEVA IMPERIAL                ;ARAUCANIA;1355470;15;10;0;0;0;15;10;1355470;CELULAR VIVO Y53S AZUL ENTEL;TELEFONIA
13568411;;M;43;CHILENO;;X;RANCAGUA                      ;L.G.B.OÂ´HIGGINS;299970;4;3;0;0;0;4;3;299970;CELULAR GALAXY A23 6+128GB LIGHT BLUE OPEN;TELEFONIA
19436630;;F;25;CHILENO;;Z;CAUQUENES                     ;MAULE;1057930;7;6;0;0;0;7;6;1057930;CELULAR REDMI NOTE 11 4/128GB TWILIGHT BLUE OPEN;TELEFONIA
18497704;;F;29;CHILENO;;Millenial;N/D;N/D;109990;1;1;0;0;0;1;1;109990;CELULAR VIVO Y01 AZUL ZAFIRO OPEN;TELEFONIA
12587877;;M;48;CHILENO;;X;TALCA                         ;MAULE;934970;4;3;0;0;0;4;3;934970;CELULAR GALAXY A03 4+128GB BLUE OPEN;TELEFONIA
15404996;;M;40;CHILENO;;X;MELIPILLA                     ;METROPOLITANA;149990;2;1;0;0;0;2;1;149990;CELULAR GALAXY A13 4+128GB LIGHT BLUE OPEN;TELEFONIA
17666691;;F;31;CHILENO;;Millenial;VALPARAISO                    ;VALPARAISO;335970;3;2;3;2;335970;0;0;0;CELULAR MOTO G71 6/128 GB VERDE OPEN;TELEFONIA
9025398;;F;63;CHILENO;;Boomers;TALCA                         ;MAULE;1407940;17;8;0;0;0;17;8;1407940;CELULAR GALAXY A53 5G 6+128GB BLACK;TELEFONIA
17695169;;F;33;CHILENO;;Millenial;N/D;N/D;1207110;14;6;0;0;0;14;6;1207110;CELULAR GALAXY A03 CORE 2GB 32GB BLUE OPEN;TELEFONIA
18260611;;F;29;CHILENO;;Millenial;SALAMANCA                     ;COQUIMBO;229990;1;1;0;0;0;1;1;229990;CELULAR GALAXY A23 6+128GB BLACK OPEN;TELEFONIA
10547336;;M;57;CHILENO;;Boomers;SAN FERNANDO                  ;L.G.B.OÂ´HIGGINS;285022;7;3;0;0;0;7;3;285022;CELULAR MOTOROLA E30 GRIS CLARO;TELEFONIA
15710333;;F;44;CHILENO;;X;NUEVA IMPERIAL                ;ARAUCANIA;201970;4;2;0;0;0;4;2;201970;CELULAR GALAXY A22 5G 4+128GB WHITE;TELEFONIA
13981511;;F;41;CHILENO;;X;N/D;N/D;529640;4;2;0;0;0;4;2;529640;CELULAR VIVO Y21S 128GB BLANCO WOM;TELEFONIA
17901861;Soltero;M;29;CHILENO;;Millenial;PROVIDENCIA                   ;METROPOLITANA;339980;2;2;2;2;339980;0;0;0;CELULAR A32 128 GB LIGHT VIOLET OPEN;TELEFONIA
11760251;;M;50;CHILENO;;X;"";"";118103;5;2;0;0;0;5;2;118103;CELULAR VIVO Y21S PEARL WHITE 128 GB OPEN;TELEFONIA
12263724;;F;50;CHILENO;;X;N/D;N/D;694920;8;4;8;4;694920;0;0;0;CELULAR POCO M4 PRO 128GB COOL BLUE OPEN;TELEFONIA
7133996;;F;71;CHILENO;;Silencioso;MELIPILLA                     ;METROPOLITANA;907760;11;5;0;0;0;11;5;907760;CELULAR VIVO Y15S WAVE GREEN OPEN;TELEFONIA
20514456;;M;22;CHILENO;;Z;LEBU                          ;BIO BIO;240251;5;4;0;0;0;5;4;240251;CELULAR GALAXY A03 4+64GB BLACK OPEN;TELEFONIA
7585751;Soltero;F;69;CHILENO;;Silencioso;SAN FERNANDO                  ;L.G.B.OÂ´HIGGINS;239660;2;1;0;0;0;2;1;239660;CELULAR MOTO G31 4/128 GB GRIS METEORITO OPEN;TELEFONIA
9461796;;M;60;CHILENO;;Boomers;LANCO                         ;LOS LAGOS;169790;3;1;0;0;0;3;1;169790;SMARTPHONE A03s 64 GB Red DS;TELEFONIA
14574342;;F;41;CHILENO;;X;PROVIDENCIA                   ;METROPOLITANA;181050;4;1;0;0;0;4;1;181050;CELULAR GALAXY A03 CORE 2GB 32GB BLUE OPEN;TELEFONIA
11520033;;M;52;CHILENO;;X;REQUINOA                      ;L.G.B.OÂ´HIGGINS;479063;9;4;7;3;391930;2;1;87133;CELULAR VIVO Y21S 128GB BLANCO WOM;TELEFONIA
8739309;;F;64;CHILENO;;Boomers;SAN JAVIER                    ;MAULE;490;1;1;0;0;0;1;1;490;CHIP OPEN ENTEL;TELEFONIA
11673215;;M;52;CHILENO;;X;SAN VICENTE                   ;L.G.B.OÂ´HIGGINS;224980;2;2;0;0;0;2;2;224980;CELULAR GALAXY A22 5G 4+128GB MINT;TELEFONIA
26656962;;F;39;VENEZOLANO;;Extranjero;SAN MIGUEL                    ;METROPOLITANA;461920;8;4;8;4;461920;0;0;0;CELULAR MOTOROLA G20 EDICION ESPECIAL VERDE CLAR;TELEFONIA
15520656;;M;38;CHILENO;;X;PROVIDENCIA                   ;METROPOLITANA;39990;1;1;0;0;0;1;1;39990;CELULAR BMOBILE C40 CRIS OPEN;TELEFONIA
5874388;Casado;M;74;CHILENO;AGRONOMO;Silencioso;LOS ANDES                     ;VALPARAISO;32990;1;1;0;0;0;1;1;32990;Celular SA3 CLARO DIRECTO BLACK;TELEFONIA
9115995;;M;60;CHILENO;;Boomers;TOCOPILLA                     ;ANTOFAGASTA;1113982;9;6;0;0;0;9;6;1113982;CELULAR REDMI 10A US 32GB CHROME SILVER OPEN;TELEFONIA
20169885;;M;22;CHILENO;;Extranjero;PROVIDENCIA                   ;N/D;159990;1;1;1;1;159990;0;0;0;CELULAR A32 128 GB BLACK OPEN;TELEFONIA
12080810;;F;42;CHILENO;;X;BUIN                          ;METROPOLITANA;289990;1;1;0;0;0;1;1;289990;CELULAR GALAXY A53 5G BLACK CLARO;TELEFONIA
11118017;;F;55;CHILENO;;Boomers;PUNTA ARENAS                  ;MAGALLANES;109990;1;1;0;0;0;1;1;109990;CELULAR GALAXY A03 4+64GB BLUE OPEN;TELEFONIA
18961682;;F;27;CHILENO;;Z;N/D;N/D;350270;5;4;2;2;151980;3;2;198290;CELULAR REDMI NOTE 11 4/128GB TWILIGHT BLUE OPEN;TELEFONIA
26759101;;M;22;PERUANO;;Extranjero;PROVIDENCIA                   ;METROPOLITANA;393980;2;1;2;1;393980;0;0;0;IPHONE 11 64GB BLACK CLARO;TELEFONIA
16124800;Soltero;M;36;CHILENO;;Millenial;N/D;N/D;129990;1;1;1;1;129990;0;0;0;CELULAR REDMI NOTE 11 4/128GB TWILIGHT BLUE OPEN;TELEFONIA
15513459;;F;38;CHILENO;;Millenial;ANGOL;ARAUCANIA;658960;4;4;4;4;658960;0;0;0;CELULAR REDMI NOTE 11 4/128GB TWILIGHT BLUE OPEN;TELEFONIA
14383290;;M;41;CHILENO;;X;N/D;N/D;555960;4;2;0;0;0;4;2;555960;CELULAR GALAXY A23 6+128GB BLACK OPEN;TELEFONIA
18973050;Soltero;M;27;CHILENO;ADMINISTRADIOR GASTRONOMICO;Millenial;PROVIDENCIA                   ;METROPOLITANA;269990;1;1;1;1;269990;0;0;0;CELULAR GALAXY A53 5G 6+128GB ORANGE;TELEFONIA
15065414;;F;40;CHILENO;;X;ARICA                         ;ARICA Y PARINACOTA;128960;4;2;2;1;86980;2;1;41980;CELULAR SAMSUNG GALAXY A03 CORE AZUL WOM;TELEFONIA
24326933;;M;64;PERUANO;;Extranjero;CALAMA                        ;ANTOFAGASTA;277968;3;1;0;0;0;3;1;277968;CELULAR REDMI NOTE 10S 128GB ONIX BLACK;TELEFONIA
11967985;;F;55;CHILENO;;Boomers;CARAHUE                       ;ARAUCANIA;389030;8;6;0;0;0;8;6;389030;Celular SA3 CLARO DIRECTO BLACK;TELEFONIA
17949067;;M;35;CHILENO;;Millenial;VILLARRICA;ARAUCANIA;361970;3;2;2;1;201980;1;1;159990;CELULAR GALAXY A23 6+128GB BLACK OPEN;TELEFONIA
13582942;;F;43;CHILENO;;X;PROVIDENCIA                   ;METROPOLITANA;149990;2;1;0;0;0;2;1;149990;CELULAR GALAXY A23 6+128GB LIGHT BLUE OPEN;TELEFONIA
10959236;Soltero;M;51;CHILENO;;X;RENCA                         ;METROPOLITANA;239990;1;1;1;1;239990;0;0;0;CELULAR GALAXY A33 5G 6+128GB BLACK OPEN;TELEFONIA
12134638;;M;41;CHILENO;;X;CALAMA                        ;ANTOFAGASTA;286980;3;1;0;0;0;3;1;286980;CELULAR VIVO V21 5G DUSK BLUE 128GB OPEN;TELEFONIA
13464224;;F;44;CHILENO;;X;LA PINTANA                    ;METROPOLITANA;179250;2;1;0;0;0;2;1;179250;CELULAR VIVO Y15S WAVE GREEN OPEN;TELEFONIA
27444034;;F;47;VENEZOLANO;;Extranjero;N/D;N/D;758930;9;3;2;1;393980;7;2;364950;CELULAR XIAOMI 11T PRO 8/256GB CELESTIAL BLUE OP;TELEFONIA
7835650;Soltero;F;66;CHILENO;;Boomers;RENCA                         ;METROPOLITANA;110760;2;1;0;0;0;2;1;110760;CELULAR GALAXY A03 CORE 2GB 32GB BLUE OPEN;TELEFONIA
17915867;;F;31;CHILENO;;Millenial;TEMUCO;ARAUCANIA;259990;1;1;1;1;259990;0;0;0;CELULAR GALAXY A53 5G 6+128GB WHITE;TELEFONIA
12318190;;M;48;CHILENO;;X;TALCA                         ;MAULE;738260;4;3;0;0;0;4;3;738260;CELULAR POCO X4 PRO 5G EU 8GB+256GB POCO YELLOW;TELEFONIA
11997557;;M;49;CHILENO;;X;CURICO                        ;MAULE;653660;8;5;0;0;0;8;5;653660;CELULAR VIVO V21 5G 128GB SUNSET DAZZLE OPEN;TELEFONIA
12732177;;F;47;CHILENO;;X;CANETE                        ;BIO BIO;350940;6;4;0;0;0;6;4;350940;CELULAR A52 128 GB BLACK OPEN;TELEFONIA
20390029;;M;22;CHILENO;;Z;PROVIDENCIA                   ;METROPOLITANA;253980;2;1;2;1;253980;0;0;0;CELULAR MOTO G71 6/128 GB VERDE OPEN;TELEFONIA
15281284;;F;39;CHILENO;;X;PUERTO VARAS                  ;LOS LAGOS;331779;6;2;0;0;0;6;2;331779;CELULAR VIVO Y01 AZUL ZAFIRO OPEN;TELEFONIA
13801283;;M;42;CHILENO;;X;LAJA                          ;BIO BIO;603980;2;1;2;1;603980;0;0;0;CELULAR XIAOMI 12 5G US 8GB+256GB GRAY OPEN;TELEFONIA
19425352;;F;26;CHILENO;;Z;N/D;N/D;99990;1;1;1;1;99990;0;0;0;CELULAR Moto G20 Rosado WOM;TELEFONIA
8166675;;F;63;CHILENO;;Boomers;ARICA                         ;ARICA Y PARINACOTA;1094980;2;2;1;1;239990;1;1;854990;CELULAR GALAXY A33 5G 6+128GB LIGHT BLUE OPEN;TELEFONIA
9049006;;M;58;CHILENO;;Boomers;QUILICURA                     ;METROPOLITANA;351970;6;3;0;0;0;6;3;351970;CELULAR BMOBILE SENIORPHONE C40 GRIS WOM;TELEFONIA
15509920;;F;39;CHILENO;;Extranjero;BUIN                          ;METROPOLITANA;651950;5;4;0;0;0;5;4;651950;CELULAR MOTO G100 128GB VERDE BOREAL + HMDI OPEN;TELEFONIA
24392201;;M;49;PERUANO;;Extranjero;CALAMA                        ;ANTOFAGASTA;813920;8;4;0;0;0;8;4;813920;CELULAR A32 128 GB LIGHT VIOLET OPEN;TELEFONIA
5564350;;F;75;CHILENO;;Silencioso;CHILLAN                       ;BIO BIO;1037930;7;4;0;0;0;7;4;1037930;CELULAR MOTO G60 4/128 GB NEGRO OPEN;TELEFONIA
10410761;;M;55;CHILENO;;Boomers;MARIQUINA                     ;LOS LAGOS;214800;4;3;0;0;0;4;3;214800;CELULAR GALAXY A03 4+64GB BLACK OPEN;TELEFONIA
20234660;;M;22;CHILENO;;Z;"";"";399980;2;2;2;2;399980;0;0;0;CELULAR POCO M4 PRO 128GB COOL BLUE OPEN;TELEFONIA
15011469;;M;39;CHILENO;;X;ANTOFAGASTA                   ;ANTOFAGASTA;164980;2;1;2;1;164980;0;0;0;CELULAR REDMI NOTE 10S 128GB ONIX BLACK;TELEFONIA
17642900;Soltero;F;31;CHILENO;TECNICO DE NIVEL SUPERIOR EN ENFERMERIA;Millenial;PROVIDENCIA                   ;METROPOLITANA;248970;2;1;0;0;0;2;1;248970;CELULAR POCO M4 PRO 128GB COOL BLUE OPEN;TELEFONIA
22284927;;F;79;BOLIVIANO;;Extranjero;CALAMA                        ;ANTOFAGASTA;279980;2;2;0;0;0;2;2;279980;CELULAR REDMI 9T 128 GB OCEAN GREEN;TELEFONIA
10577372;;F;57;CHILENO;;Boomers;LLAILLAY                      ;VALPARAISO;202940;6;3;6;3;202940;0;0;0;CELULAR SAMSUNG A03 CORE 32GB BLACK CLARO;TELEFONIA
16330100;;F;35;CHILENO;;Millenial;PROVIDENCIA                   ;METROPOLITANA;96980;2;1;2;1;96980;0;0;0;CELULAR MOTO G20 64GB ROSA FLAMINGO OPEN;TELEFONIA
13545072;;M;42;CHILENO;;X;LAS CONDES;METROPOLITANA;344980;2;2;2;2;344980;0;0;0;CELULAR GALAXY A53 5G 6+128GB WHITE;TELEFONIA
17352774;Soltero;F;31;CHILENO;;Extranjero;PROVIDENCIA                   ;N/D;89990;1;1;1;1;89990;0;0;0;CELULAR Moto E7 Rosado WOM;TELEFONIA
25645086;;M;36;VENEZOLANO;;Extranjero;N/D;N/D;657970;3;2;1;1;259990;2;1;397980;CELULAR GALAXY A53 5G 6+128GB BLUE;TELEFONIA
8220891;;F;70;CHILENO;;Silencioso;SAN PEDRO DE LA PAZ           ;BIO BIO;454620;7;5;0;0;0;7;5;454620;CELULAR MOTO G20 64GB AZUL OPEN;TELEFONIA
25662675;Soltero;F;47;VENEZOLANO;;Extranjero;QUILPUE;VALPARAISO;139990;1;1;1;1;139990;0;0;0;CELULAR MOTOROLA G50 128GB AZUL CLARO;TELEFONIA
5960021;;F;76;CHILENO;;Silencioso;VALLENAR;ATACAMA;99990;1;1;0;0;0;1;1;99990;CELULAR Moto E7 Rosado WOM;TELEFONIA
20029318;;F;23;CHILENO;;Z;PROVIDENCIA                   ;METROPOLITANA;279990;4;1;0;0;0;4;1;279990;CELULAR GALAXY A53 5G 6+128GB ORANGE;TELEFONIA
8692798;;F;63;CHILENO;;Boomers;LA CISTERNA                   ;METROPOLITANA;287120;5;2;0;0;0;5;2;287120;CELULAR GALAXY A22 5G 4+128GB GRAY;TELEFONIA
26088951;;F;26;VENEZOLANO;;Extranjero;TALCA                         ;MAULE;269980;2;1;0;0;0;2;1;269980;CELULAR GALAXY A53 5G 6+128GB BLUE;TELEFONIA
13385647;;F;43;CHILENO;;X;LOS ANGELES                   ;BIO BIO;330773;9;5;0;0;0;9;5;330773;CELULAR VIVO Y21s 128GB AZUL CLARO;TELEFONIA
11713592;;M;51;CHILENO;;X;SAN BERNARDO;METROPOLITANA;123980;2;1;2;1;123980;0;0;0;CELULAR GALAXY A13 4+128GB LIGHT BLUE OPEN;TELEFONIA
7806976;;M;66;CHILENO;;Boomers;EMPEDRADO                     ;MAULE;1023540;14;7;7;3;568940;7;4;454600;CELULAR REDMI 10A US 64GB GRAPHITE GRAY OPEN;TELEFONIA
19268786;;F;25;CHILENO;;Z;PROVIDENCIA                   ;METROPOLITANA;266980;2;1;2;1;266980;0;0;0;CELULAR GALAXY A53 5G 6+128GB WHITE;TELEFONIA
6307439;;M;71;CHILENO;;Silencioso;QUILLOTA                      ;VALPARAISO;812172;13;6;0;0;0;13;6;812172;CELULAR GALAXY A03 4+64GB BLUE OPEN;TELEFONIA
9575523;;F;61;CHILENO;;Boomers;PUDAHUEL                      ;METROPOLITANA;2068910;9;4;5;2;961950;4;2;1106960;IPHONE XR 64GB LIB OPEN NEGRO;TELEFONIA
11109186;;F;55;CHILENO;;Boomers;PENAFLOR                      ;METROPOLITANA;219960;4;2;0;0;0;4;2;219960;CELULAR GALAXY A13 4+128GB BLACK;TELEFONIA
12776911;;F;46;CHILENO;;X;LA PINTANA                    ;METROPOLITANA;1319349;39;21;0;0;0;39;21;1319349;CELULAR VIVO Y21S 128GB BLANCO WOM;TELEFONIA
19249082;;F;26;CHILENO;;Z;N/D;N/D;36990;1;4;0;0;0;1;4;36990;Celular SA3 CLARO DIRECTO BLACK;TELEFONIA
18284460;;M;29;CHILENO;;Millenial;N/D;N/D;1227930;10;11;0;0;0;10;11;1227930;CELULAR REDMI NOTE 11 4/128GB TWILIGHT BLUE OPEN;TELEFONIA
13909401;;F;42;CHILENO;;X;N/D;N/D;465940;6;3;6;3;465940;0;0;0;CELULAR REDMI 10A US 32GB CHROME SILVER OPEN;TELEFONIA
16510540;;F;35;CHILENO;;Millenial;RENCA                         ;METROPOLITANA;179990;1;1;0;0;0;1;1;179990;CELULAR REDMI NOTE 10 5G 4/128GB GRAPHITE GRAY O;TELEFONIA
17185353;;M;33;CHILENO;;Millenial;TALCA                         ;MAULE;109990;2;1;0;0;0;2;1;109990;CELULAR REDMI NOTE 11 4/128GB TWILIGHT BLUE OPEN;TELEFONIA
10967795;;M;50;CHILENO;;Z;CHILLAN                       ;BIO BIO;884950;6;4;1;1;389990;5;3;494960;CELULAR VIVO V21 5G DUSK BLUE 128GB OPEN;TELEFONIA
5297923;;M;73;CHILENO;;Silencioso;TALAGANTE                     ;METROPOLITANA;62270;2;3;0;0;0;2;3;62270;Celular SA3 CLARO DIRECTO BLACK;TELEFONIA
19698019;;F;24;CHILENO;;Z;TALCA                         ;MAULE;884970;4;3;0;0;0;4;3;884970;CELULAR SAMSUNG A52s 128GB BLACK CLARO;TELEFONIA
15066299;;F;39;CHILENO;;X;N/D;N/D;847870;14;7;12;5;622890;2;2;224980;CELULAR A52 128 GB BLACK OPEN;TELEFONIA
14320563;;F;46;CHILENO;;X;SAN CARLOS                    ;BIO BIO;174730;5;4;0;0;0;5;4;174730;SMARTPHONE A03S NEGRO 32GB;TELEFONIA
11760565;;F;51;CHILENO;;X;PROVIDENCIA                   ;METROPOLITANA;229960;8;4;0;0;0;8;4;229960;CELULAR SAMSUNG GALAXY A03 CORE AZUL WOM;TELEFONIA
8425536;;F;62;CHILENO;;Boomers;CHILLAN                       ;BIO BIO;42980;2;2;0;0;0;2;2;42980;CELULAR AZUMI L4G BLACK CLARO;TELEFONIA
20626976;;F;21;CHILENO;;Z;PROVIDENCIA                   ;METROPOLITANA;183561;2;1;0;0;0;2;1;183561;CELULAR VIVO V21 5G DUSK BLUE 128GB OPEN;TELEFONIA
10481809;;M;56;CHILENO;;Boomers;PELARCO                       ;MAULE;149250;2;1;0;0;0;2;1;149250;CELULAR VIVO Y01 AZUL ZAFIRO OPEN;TELEFONIA
6987133;;F;69;CHILENO;;Silencioso;QUILPUE                       ;VALPARAISO;69990;2;1;0;0;0;2;1;69990;CELULAR GALAXY A13 4+128GB LIGHT BLUE OPEN;TELEFONIA
7333995;Casado;F;67;CHILENO;;Boomers;RENCA                         ;METROPOLITANA;113536;3;1;0;0;0;3;1;113536;CELULAR VIVO Y15S WAVE GREEN OPEN;TELEFONIA
14367334;;F;48;CHILENO;;X;N/D;N/D;720920;9;7;0;0;0;9;7;720920;CELULAR GALAXY A22 5G 4+128GB GRAY;TELEFONIA
12205703;;M;50;CHILENO;;X;RENCA                         ;METROPOLITANA;486970;3;4;3;4;486970;0;0;0;CELULAR XIAOMI REDMI NOTE 10S BLANCO WOM;TELEFONIA
7605128;;F;70;CHILENO;;Silencioso;VICTORIA                      ;ARAUCANIA;119990;2;1;0;0;0;2;1;119990;CELULAR VIVO Y01 AZUL ZAFIRO OPEN;TELEFONIA
11303840;;F;54;CHILENO;;Boomers;NUEVA IMPERIAL                ;ARAUCANIA;154281;3;2;0;0;0;3;2;154281;CELULAR REDMI 9C 64GB MIDNIGHT GRAY MOVISTAR;TELEFONIA
20357722;;F;22;CHILENO;;Z;N/D;N/D;612100;6;11;3;8;271970;3;3;340130;CELULAR GALAXY A13 4+128GB BLACK;TELEFONIA
17324549;;M;32;CHILENO;;Millenial;PROVIDENCIA                   ;METROPOLITANA;259980;2;1;2;1;259980;0;0;0;CELULAR POCO X4 PRO 5G EU 8GB+256GB POCO YELLOW;TELEFONIA
13469018;;F;43;CHILENO;;X;PROVIDENCIA                   ;METROPOLITANA;99990;1;1;0;0;0;1;1;99990;CELULAR REDMI 10A US 32GB CHROME SILVER OPEN;TELEFONIA
20419212;;F;22;CHILENO;;Z;"";"";93980;2;1;2;1;93980;0;0;0;CELULAR MOTOROLA G20 64GB BLUE CLARO;TELEFONIA
12179990;;M;49;CHILENO;;X;CHIMBARONGO                   ;L.G.B.OÂ´HIGGINS;771930;9;5;0;0;0;9;5;771930;CELULAR GALAXY A22 5G 4+128GB GRAY;TELEFONIA
14462828;;M;48;CHILENO;;X;PROVIDENCIA                   ;METROPOLITANA;64276;2;1;0;0;0;2;1;64276;CELULAR VIVO Y15S WAVE GREEN OPEN;TELEFONIA
19781090;;F;24;CHILENO;;Z;"";"";147970;3;3;1;1;7990;2;2;139980;CELULAR REDMI NOTE 11 4/128GB TWILIGHT BLUE OPEN;TELEFONIA
19763600;;F;24;CHILENO;;Z;N/D;N/D;560950;4;2;0;0;0;4;2;560950;CELULAR GALAXY A22 5G 4+128GB MINT;TELEFONIA
13038786;;F;45;CHILENO;;X;PANGUIPULLI                   ;LOS RIOS;89990;1;1;0;0;0;1;1;89990;CELULAR REDMI 9C 64GB SUNRISE ORANGE;TELEFONIA
7168981;;M;68;CHILENO;;Boomers;PUERTO MONTT                  ;LOS LAGOS;545023;10;5;0;0;0;10;5;545023;CELULAR GALAXY A03 64GB BLACK DIRECTO MOVISTAR;TELEFONIA
11206554;;M;55;CHILENO;;Boomers;N/D;N/D;423980;2;1;2;1;423980;0;0;0;CELULAR SAMSUNG S21 FE 128GB LIGHT VIOLET OPEN;TELEFONIA
13277052;;F;45;CHILENO;;X;MAIPU                         ;METROPOLITANA;173970;3;2;2;1;143980;1;1;29990;CELULAR REDMI NOTE 11 4/128GB TWILIGHT BLUE OPEN;TELEFONIA
13832765;Casado;F;41;CHILENO;ABOGADO;X;PROVIDENCIA                   ;METROPOLITANA;129990;1;1;0;0;0;1;1;129990;CELULAR VIVO Y01 AZUL ZAFIRO OPEN;TELEFONIA
16612649;Soltero;F;35;CHILENO;;Millenial;PUCON                         ;ARAUCANIA;608150;4;3;0;0;0;4;3;608150;CELULAR MOTO G100 128GB VERDE BOREAL + HMDI OPEN;TELEFONIA
23736616;;M;27;COLOMBIANO;;Extranjero;N/D;N/D;203980;2;1;2;1;203980;0;0;0;CELULAR REDMI NOTE 11 PRO 128GB WHITE;TELEFONIA
11063062;;F;55;CHILENO;;Boomers;LEBU                          ;BIO BIO;259000;3;2;0;0;0;3;2;259000;CELULAR GALAXY A22 5G 4+128GB MINT;TELEFONIA
26727705;Soltero;F;33;VENEZOLANO;;Extranjero;PROVIDENCIA                   ;METROPOLITANA;14990;1;3;1;3;14990;0;0;0;CELULAR NOKIA 110 BLACK OPEN;TELEFONIA
8027991;;F;67;CHILENO;;Boomers;PUENTE ALTO                   ;METROPOLITANA;119826;3;1;0;0;0;3;1;119826;CELULAR VIVO Y15S WAVE GREEN OPEN;TELEFONIA
8254808;;F;63;CHILENO;;Boomers;SAN CARLOS                    ;BIO BIO;1048950;5;3;0;0;0;5;3;1048950;Celular Galaxy S21 Phantom Grey 128GB;TELEFONIA
18008571;Soltero;F;32;CHILENO;;Millenial;ANGOL                         ;ARAUCANIA;407980;2;1;2;1;407980;0;0;0;SMARTHPHONE RENO 6 AURORA 128GB;TELEFONIA
25464460;Soltero;F;32;VENEZOLANO;;Extranjero;PROVIDENCIA                   ;METROPOLITANA;163980;2;1;2;1;163980;0;0;0;CELULAR REDMI NOTE 11 4/128GB TWILIGHT BLUE OPEN;TELEFONIA
18882928;Soltero;F;28;CHILENO;;Millenial;PROVIDENCIA                   ;METROPOLITANA;173980;2;1;2;1;173980;0;0;0;CELULAR A52 128 GB LIGHT VIOLET OPEN;TELEFONIA
20424859;;F;21;CHILENO;;Z;TALAGANTE                     ;METROPOLITANA;488280;3;1;0;0;0;3;1;488280;CELULAR VIVO V21 5G DUSK BLUE 128GB OPEN;TELEFONIA
16178965;;F;36;CHILENO;;Millenial;N/D;N/D;718720;7;3;4;2;312960;3;1;405760;CELULAR REDMI NOTE 11 4/128GB TWILIGHT BLUE OPEN;TELEFONIA
26049436;;M;50;EXTRANJERO - NO INFORMA NACIONALIDAD;;Extranjero;QUILLOTA                      ;VALPARAISO;199990;1;1;0;0;0;1;1;199990;CELULAR REDMI NOTE 11 PRO 128GB GRAPHITE;TELEFONIA
19755303;;F;24;CHILENO;;Z;PROVIDENCIA                   ;METROPOLITANA;323970;3;1;3;1;323970;0;0;0;CELULAR SAMSUN A52 128GB NEGRO WOM;TELEFONIA
9188265;;M;60;CHILENO;;Boomers;BUIN                          ;METROPOLITANA;252396;4;2;0;0;0;4;2;252396;CELULAR VIVO Y21S 128GB BLANCO WOM;TELEFONIA
7642123;;F;67;CHILENO;;Boomers;NATALES                       ;MAGALLANES;445420;3;2;0;0;0;3;2;445420;CELULAR GALAXY A53 5G 6+128GB BLACK;TELEFONIA
8391299;;M;64;CHILENO;;Boomers;ANTOFAGASTA                   ;ANTOFAGASTA;399990;1;1;1;1;399990;0;0;0;CELULAR XIAOMI 11T PRO 8/256GB CELESTIAL BLUE OP;TELEFONIA
16171803;;F;37;CHILENO;;Millenial;COPIAPO;ATACAMA;179970;3;3;0;0;0;3;3;179970;CELULAR REDMI 9C 64 GB BLUE DIRECTO CLARO;TELEFONIA
18577266;;F;28;CHILENO;;Millenial;"";"";175980;2;1;2;1;175980;0;0;0;CELULAR A52 128 GB LIGHT VIOLET OPEN;TELEFONIA
26574181;;M;32;VENEZOLANO;;Extranjero;SAN PEDRO DE LA PAZ           ;BIO BIO;249990;1;1;0;0;0;1;1;249990;CELULAR MOTO G71 6/128 GB VERDE OPEN;TELEFONIA
18813788;;M;28;CHILENO;;Millenial;"";"";149980;3;3;0;0;0;3;3;149980;PRODUCTO 2 SELECCION BANDA 1;TELEFONIA
13802484;Casado;M;42;CHILENO;;X;RENCA                         ;METROPOLITANA;189990;1;1;0;0;0;1;1;189990;CELULAR GALAXY A22 5G 4+128GB GRAY;TELEFONIA
10985520;;F;41;CHILENO;;X;VALDIVIA                      ;LOS LAGOS;199980;2;2;0;0;0;2;2;199980;CELULAR VIVO Y01 AZUL ZAFIRO OPEN;TELEFONIA
8566388;;F;59;CHILENO;;Boomers;COIHAIQUE                     ;AYSEN;165190;3;2;0;0;0;3;2;165190;CELULAR SAMSUNG A03 64GB NEGRO WOM;TELEFONIA
6661817;;F;71;CHILENO;;Silencioso;TOCOPILLA                     ;ANTOFAGASTA;2165410;20;10;0;0;0;20;10;2165410;CELULAR REDMI NOTE 11 PRO 128GB GRAPHITE;TELEFONIA
16462757;;F;35;CHILENO;;Millenial;PROVIDENCIA                   ;METROPOLITANA;99970;3;2;3;2;99970;0;0;0;CELULAR GALAXY A03 CORE 2GB 32GB BLACK OPEN;TELEFONIA
6969004;;F;69;CHILENO;;Silencioso;N/D;N/D;314970;3;3;0;0;0;3;3;314970;CELULAR A52 128 GB WHITE OPEN;TELEFONIA
19745823;;F;25;CHILENO;;Z;PROVIDENCIA                   ;METROPOLITANA;193980;2;1;2;1;193980;0;0;0;CELULAR A52 128 GB BLACK OPEN;TELEFONIA
14103402;;M;41;CHILENO;;X;ARICA                         ;ARICA Y PARINACOTA;830940;6;4;0;0;0;6;4;830940;CELULAR MOTO G100 128GB VERDE BOREAL + HMDI OPEN;TELEFONIA
6618194;;M;71;CHILENO;;Silencioso;PUENTE ALTO                   ;METROPOLITANA;227580;8;5;0;0;0;8;5;227580;CELULAR BMOBILE C40 CRIS OPEN;TELEFONIA
9470896;;M;60;CHILENO;;Boomers;SANTIAGO                      ;METROPOLITANA;410130;3;2;0;0;0;3;2;410130;CELULAR REDMI NOTE 11S 6GB+128GB TWILIGHT BLUE O;TELEFONIA
25404340;;F;34;BOLIVIANO;;Extranjero;"";"";309990;3;1;0;0;0;3;1;309990;CELULAR GALAXY A53 5G 6+128GB WHITE;TELEFONIA
15758409;;M;38;CHILENO;;Millenial;"";"";679990;1;1;0;0;0;1;1;679990;CELULAR GALAXY S22 WHITE 128GB;TELEFONIA
6884423;Soltero;F;67;CHILENO;;Boomers;COIHAIQUE                     ;AYSEN;170000;2;1;0;0;0;2;1;170000;CELULAR REDMI NOTE 10 5G 4/128GB GRAPHITE GRAY O;TELEFONIA
7324768;;M;68;CHILENO;;Silencioso;PAINE                         ;METROPOLITANA;304820;2;1;0;0;0;2;1;304820;CELULAR MOTO G51 5G 4/128 GB AZUL OPEN;TELEFONIA
22270667;;F;63;PERUANO;;Extranjero;LAS CONDES                    ;METROPOLITANA;247980;5;3;0;0;0;5;3;247980;CELULAR GALAXY A22 5G 4+128GB WHITE;TELEFONIA
15191207;;F;36;CHILENO;;Millenial;SAN PEDRO DE LA PAZ           ;BIO BIO;130380;3;1;0;0;0;3;1;130380;CELULAR GALAXY A03 4+64GB BLACK OPEN;TELEFONIA
18985168;;F;27;CHILENO;;Z;"";"";121940;6;4;0;0;0;6;4;121940;CHIP OPEN ENTEL;TELEFONIA
15698954;;F;38;CHILENO;;Millenial;N/D;N/D;407980;2;1;2;1;407980;0;0;0;IPHONE 11 64GB BLACK CLARO;TELEFONIA
16762422;Soltero;M;34;CHILENO;;Millenial;PROVIDENCIA                   ;METROPOLITANA;272820;4;2;4;2;272820;0;0;0;CELULAR Xiaomi Redmi 9 64 GB Morado WOM;TELEFONIA
20009651;;F;24;CHILENO;;Z;"";"";219980;2;2;1;1;199990;1;1;19990;CELULAR REDMI NOTE 11 PRO 128GB GRAPHITE;TELEFONIA
15667946;;F;38;CHILENO;;X;MAIPU                         ;METROPOLITANA;139990;1;1;0;0;0;1;1;139990;CELULAR GALAXY A13 4+128GB LIGHT BLUE OPEN;TELEFONIA
18288945;;F;29;CHILENO;;Extranjero;"";"";249980;2;1;0;0;0;2;1;249980;CELULAR A32 128 GB BLACK OPEN;TELEFONIA
19698529;;M;36;CHILENO;;Millenial;CALAMA                        ;ANTOFAGASTA;90470;3;2;0;0;0;3;2;90470;CELULAR XIAOMI REDMI 9A 32GB GRANITE GRAY TRI WO;TELEFONIA
15698377;;F;38;CHILENO;;Millenial;MAULE;MAULE;1107920;7;4;5;2;657940;2;2;449980;CELULAR A32 128 GB BLACK OPEN;TELEFONIA
25796172;;M;33;HAITIANO;;Extranjero;N/D;N/D;333220;5;3;0;0;0;5;3;333220;CELULAR REDMI NOTE 10 5G 4/128GB GRAPHITE GRAY O;TELEFONIA
15785725;;F;38;CHILENO;;X;LA PINTANA;METROPOLITANA;181980;2;2;1;1;11990;1;1;169990;MOTOROLA MOTO G50 AZUL 128 GB WOM;TELEFONIA
18384073;;F;29;CHILENO;;Millenial;PROVIDENCIA                   ;METROPOLITANA;451680;4;2;4;2;451680;0;0;0;CELULAR A52 128 GB BLUE OPEN;TELEFONIA
16165665;;F;36;CHILENO;;Millenial;PROVIDENCIA                   ;METROPOLITANA;449990;1;3;2;1;236980;-1;2;213010;CELULAR SAMSUNG S21 FE 128GB GRAY OPEN;TELEFONIA
11648027;;M;52;CHILENO;;X;SAN RAMON                     ;METROPOLITANA;149990;1;1;0;0;0;1;1;149990;CELULAR MOTOROLA G20 EDICION ESPECIAL VERDE CLAR;TELEFONIA
11085583;;F;55;CHILENO;;Boomers;N/D;N/D;482971;4;3;0;0;0;4;3;482971;CELULAR MOTO G60 4/128 GB NEGRO OPEN;TELEFONIA
10857314;;M;51;CHILENO;;X;COIHAIQUE                     ;AYSEN;1127950;6;3;0;0;0;6;3;1127950;CELULAR GALAXY A23 6+128GB BLACK OPEN;TELEFONIA
12910476;;M;46;CHILENO;;X;MAIPU                         ;METROPOLITANA;338750;4;3;0;0;0;4;3;338750;CELULAR VIVO Y01 AZUL ZAFIRO OPEN;TELEFONIA
8190600;;F;63;CHILENO;;Boomers;OVALLE                        ;COQUIMBO;258120;2;1;0;0;0;2;1;258120;CELULAR A32 128 GB BLUE OPEN;TELEFONIA
20159463;;M;22;CHILENO;;Z;PROVIDENCIA                   ;METROPOLITANA;403980;2;1;2;1;403980;0;0;0;IPHONE 11 64GB BLACK CLARO;TELEFONIA
19379982;;M;26;CHILENO;;Z;PROVIDENCIA                   ;METROPOLITANA;304970;6;3;0;0;0;6;3;304970;MOTOROLA MOTO G50 AZUL 128 GB WOM;TELEFONIA
9517443;;F;61;CHILENO;;Boomers;PUQUELDON                     ;LOS LAGOS;908970;6;2;0;0;0;6;2;908970;CELULAR MOTO G30 128GB GRIS TORNASOL OPEN;TELEFONIA
13409876;Soltero;F;43;CHILENO;;X;PROVIDENCIA                   ;METROPOLITANA;219990;1;1;0;0;0;1;1;219990;CELULAR VIVO Y53S FANTASTIC RAINBOW 128GB OPEN;TELEFONIA
10120866;;F;57;CHILENO;;Boomers;ARICA                         ;ARICA Y PARINACOTA;115381;2;1;0;0;0;2;1;115381;SMARTPHONE A03S NEGRO 32GB;TELEFONIA
20551909;;F;21;CHILENO;;Z;LAMPA;METROPOLITANA;573980;2;1;2;1;573980;0;0;0;CELULAR IPHONE 12 64GB BLACK CLARO;TELEFONIA
11768218;;F;50;CHILENO;;X;CAUQUENES                     ;MAULE;658270;3;1;0;0;0;3;1;658270;CELULAR GALAXY S20 FE 5G 128GB BLUE OPEN;TELEFONIA
14297499;;F;47;CHILENO;;X;LEBU                          ;BIO BIO;620380;5;2;0;0;0;5;2;620380;CELULAR SAMSUNG A52s 128GB BLACK CLARO;TELEFONIA
20179653;;M;22;CHILENO;;Z;PROVIDENCIA                   ;METROPOLITANA;259990;1;1;1;1;259990;0;0;0;CELULAR GALAXY A53 5G 6+128GB BLACK;TELEFONIA
16263069;;M;35;CHILENO;;Millenial;PROVIDENCIA                   ;METROPOLITANA;159990;1;1;1;1;159990;0;0;0;CELULAR SAMSUN A52 128GB NEGRO WOM;TELEFONIA
12938789;Soltero;F;46;CHILENO;;X;RENCA                         ;METROPOLITANA;880480;2;1;2;1;880480;0;0;0;CELULAR GALAXY S22 ULTRA BURGUNDY 128GB;TELEFONIA
16271396;;F;36;CHILENO;;Millenial;COIHAIQUE                     ;AYSEN;130980;2;1;0;0;0;2;1;130980;CELULAR REDMI 9C 64GB SUNRISE ORANGE;TELEFONIA
25774716;;F;28;CHILENO;;Extranjero;N/D;N/D;1134670;12;4;0;0;0;12;4;1134670;CELULAR REDMI 10A US 64GB GRAPHITE GRAY OPEN;TELEFONIA
11878739;;F;51;CHILENO;;X;EL MONTE                      ;METROPOLITANA;1063920;8;7;0;0;0;8;7;1063920;CELULAR GALAXY A73 5G 256GB GRAY OPEN;TELEFONIA
17410547;;F;32;CHILENO;;Millenial;CAUQUENES                     ;MAULE;809980;2;2;0;0;0;2;2;809980;CELULAR GALAXY A03 4+64GB BLACK OPEN;TELEFONIA
1589017;;M;77;CHILENO;;Silencioso;RENGO                         ;L.G.B.OÂ´HIGGINS;295960;5;3;0;0;0;5;3;295960;CELULAR BMOBILE BS30 BLACK OPEN;TELEFONIA
15617408;;M;39;CHILENO;;X;PEDRO AGUIRRE CERDA           ;METROPOLITANA;149990;1;1;0;0;0;1;1;149990;CELULAR A32 128 GB BLUE OPEN;TELEFONIA
15059523;;F;39;CHILENO;;X;N/D;N/D;254971;4;3;0;0;0;4;3;254971;CELULAR XIAOMI REDMI 9A 32GB GRANITE GRAY TRI WO;TELEFONIA
13685905;;M;44;CHILENO;;X;N/D;N/D;310130;3;2;0;0;0;3;2;310130;CELULAR GALAXY A22 5G 4+128GB MINT;TELEFONIA
16569136;;F;34;CHILENO;;Millenial;PROVIDENCIA                   ;METROPOLITANA;259990;1;1;1;1;259990;0;0;0;CELULAR GALAXY A53 5G 6+128GB BLUE;TELEFONIA
16442388;;F;35;CHILENO;;Millenial;LA SERENA                     ;COQUIMBO;2223950;7;3;7;3;2223950;0;0;0;Galaxy Z Flip3 128GB LAVENDER;TELEFONIA
10222990;;M;58;CHILENO;;Boomers;LA SERENA                     ;COQUIMBO;130380;2;1;0;0;0;2;1;130380;SMARTPHONE A03S NEGRO 32GB;TELEFONIA
17454056;;F;36;CHILENO;;Millenial;ARAUCO                        ;BIO BIO;199990;1;1;0;0;0;1;1;199990;CELULAR A32 128 GB BLACK OPEN;TELEFONIA
15938431;;M;38;CHILENO;;Millenial;CONTULMO                      ;BIO BIO;741216;9;6;0;0;0;9;6;741216;CELULAR VIVO Y21S 128GB BLANCO WOM;TELEFONIA
15566609;;F;38;CHILENO;;Millenial;TIRUA                         ;BIO BIO;419980;2;2;1;1;249990;1;1;169990;CELULAR REDMI NOTE 11S 128GB GRAPHITE GRAY;TELEFONIA
16640331;Soltero;F;35;CHILENO;;Millenial;N/D;N/D;149970;3;4;0;0;0;3;4;149970;CELULAR VIVO Y15S WAVE GREEN OPEN;TELEFONIA
8417776;Casado;F;70;CHILENO;;Silencioso;PROVIDENCIA                   ;METROPOLITANA;58710;2;1;0;0;0;2;1;58710;CELULAR BMOBILE C40 CRIS OPEN;TELEFONIA
4393615;;F;79;CHILENO;;Silencioso;LA SERENA                     ;COQUIMBO;256510;6;2;0;0;0;6;2;256510;CELULAR REDMI 10A US 64GB GRAPHITE GRAY OPEN;TELEFONIA
5170855;;F;76;CHILENO;;Silencioso;N/D;N/D;1917250;9;3;0;0;0;9;3;1917250;CELULAR IPHONE 12 MINI 64GB BLACK CLARO;TELEFONIA
17493625;;M;32;CHILENO;;Millenial;PELLUHUE                      ;MAULE;179990;1;1;0;0;0;1;1;179990;CELULAR REDMI NOTE 10 5G 4/128GB GRAPHITE GRAY O;TELEFONIA
12530038;;F;49;CHILENO;;X;LA GRANJA                     ;METROPOLITANA;96980;2;1;2;1;96980;0;0;0;CELULAR SAMSUNG A03 64GB NEGRO WOM;TELEFONIA
6853812;Divorciado;F;67;CHILENO;MATRONA;Boomers;RENCA                         ;METROPOLITANA;159990;1;1;1;1;159990;0;0;0;CELULAR REDMI NOTE 10 5G 4/128GB GRAPHITE GRAY O;TELEFONIA
17467202;;M;32;CHILENO;;Millenial;PROVIDENCIA                   ;METROPOLITANA;189990;1;1;0;0;0;1;1;189990;CELULAR A52 128 GB BLACK OPEN;TELEFONIA
19822550;;M;24;CHILENO;;Z;TOCOPILLA;ANTOFAGASTA;79970;3;3;1;1;64990;2;2;14980;CELULAR XIAOMI REDMI 9A 32GB VERDE CLARO;TELEFONIA
12063566;;F;48;CHILENO;;X;CHILLAN                       ;BIO BIO;167950;7;3;0;0;0;7;3;167950;CELULAR XIAOMI REDMI 9A 32 GB BLUE DIRECTO CLARO;TELEFONIA
16898826;;M;33;CHILENO;;Millenial;TOME;BIO-BIO;221980;2;3;2;3;221980;0;0;0;CELULAR REDMI NOTE 11 PRO 128GB GRAPHITE;TELEFONIA
15600133;;M;39;CHILENO;;X;PANGUIPULLI                   ;LOS LAGOS;803500;6;3;2;1;358540;4;2;444960;CELULAR A52 128 GB BLACK OPEN;TELEFONIA
4712510;;F;82;CHILENO;;Silencioso;ANCUD                         ;LOS LAGOS;238120;2;1;0;0;0;2;1;238120;CELULAR VIVO Y21S 128GB BLANCO WOM;TELEFONIA
19541761;;F;24;CHILENO;;Z;CONSTITUCION                  ;MAULE;179990;1;1;0;0;0;1;1;179990;CELULAR VIVO Y21S MIDNIGHT BLUE 128 GB OPEN;TELEFONIA
26570840;;M;34;NO INFORMA NACIONALIDAD;;Extranjero;PROVIDENCIA                   ;METROPOLITANA;143980;2;1;2;1;143980;0;0;0;CELULAR REDMI NOTE 10 5G 4/128GB GRAPHITE GRAY O;TELEFONIA
17972472;;M;30;CHILENO;;Millenial;"";"";149990;1;1;1;1;149990;0;0;0;CELULAR REDMI NOTE 11 4/128GB TWILIGHT BLUE OPEN;TELEFONIA
15304571;;F;40;CHILENO;;X;N/D;N/D;697440;5;3;0;0;0;5;3;697440;CELULAR VIVO Y01 AZUL ZAFIRO OPEN;TELEFONIA
19090859;Soltero;M;26;CHILENO;;Z;PROVIDENCIA                   ;METROPOLITANA;259990;1;1;1;1;259990;0;0;0;CELULAR GALAXY A53 5G 6+128GB WHITE;TELEFONIA
18893456;;M;27;CHILENO;;Z;"";"";189990;1;1;1;1;189990;0;0;0;CELULAR A52 128 GB BLACK OPEN;TELEFONIA
10694672;;F;55;CHILENO;;Boomers;LA SERENA                     ;COQUIMBO;263440;5;2;0;0;0;5;2;263440;CELULAR REDMI 10A US 64GB GRAPHITE GRAY OPEN;TELEFONIA
18028583;;M;29;CHILENO;;Millenial;BUIN                          ;METROPOLITANA;489980;2;2;1;1;179990;1;1;309990;CELULAR XIAOMI REDMI NOTE 10 PRO 128GB GRIS WOM;TELEFONIA
20374267;;F;22;CHILENO;;Z;CHILLAN;BIO-BIO;199960;4;4;4;4;199960;0;0;0;CELULAR GALAXY A03 CORE 2GB 32GB BLACK OPEN;TELEFONIA
18849564;;M;27;CHILENO;;Millenial;PROVIDENCIA                   ;METROPOLITANA;169990;1;1;1;1;169990;0;0;0;CELULAR A52 128 GB BLACK OPEN;TELEFONIA
17655391;;M;31;CHILENO;;Millenial;PROVIDENCIA                   ;METROPOLITANA;33990;1;1;0;0;0;1;1;33990;Celular SA3 CLARO DIRECTO BLACK;TELEFONIA
16883011;;F;34;CHILENO;;Millenial;N/D;N/D;169980;3;2;0;0;0;3;2;169980;CELULAR VIVO Y11S PHANTON BLACK 32GB MOVISTAR;TELEFONIA
18417609;;M;34;CHILENO;;Millenial;"";"";769800;6;3;4;2;603820;2;1;165980;CELULAR VIVO Y21S 128GB BLANCO WOM;TELEFONIA
15551020;;F;37;CHILENO;;Millenial;"";"";990;3;1;0;0;0;3;1;990;CHIP OPEN ENTEL;TELEFONIA
7853562;;M;65;CHILENO;;Boomers;OVALLE                        ;COQUIMBO;112400;2;1;0;0;0;2;1;112400;CELULAR XIAOMI REDMI 9A 32GB GRANITE GRAY TRI WO;TELEFONIA
7568460;Casado;F;67;CHILENO;;Boomers;RENCA                         ;METROPOLITANA;199990;2;1;0;0;0;2;1;199990;CELULAR VIVO V21 5G 128GB SUNSET DAZZLE OPEN;TELEFONIA
7387311;;M;66;CHILENO;;Boomers;CASTRO                        ;LOS LAGOS;662959;4;3;0;0;0;4;3;662959;CELULAR GALAXY S20FE 128GB CLOUD LAVENDER OPEN;TELEFONIA
20227259;;F;22;CHILENO;;Z;N/D;N/D;149990;2;1;2;1;149990;0;0;0;CELULAR GALAXY A22 5G 4+128GB GRAY;TELEFONIA
10086558;;M;56;CHILENO;;Boomers;SALAMANCA                     ;COQUIMBO;127400;2;1;0;0;0;2;1;127400;CELULAR SAMSUNG GALAXY A03 CORE 32GB NEGRO WOM;TELEFONIA
5969711;;F;74;CHILENO;;Silencioso;SAN FERNANDO                  ;L.G.B.OÂ´HIGGINS;99990;1;1;0;0;0;1;1;99990;CELULAR GALAXY A03 64GB BLACK DIRECTO MOVISTAR;TELEFONIA
17559378;;F;31;CHILENO;;Millenial;PROVIDENCIA                   ;METROPOLITANA;219990;2;3;3;1;219990;-1;2;0;CELULAR SMARTPHONE A52S 5G LIGHT GREEN 128GB;TELEFONIA
14070795;;M;41;CHILENO;;X;PROVIDENCIA                   ;METROPOLITANA;199990;1;1;0;0;0;1;1;199990;CELULAR MOTO G60 4/128 GB SILVER OPEN;TELEFONIA
6748934;;F;68;CHILENO;;Boomers;VALLENAR;ATACAMA;2566730;8;2;0;0;0;8;2;2566730;CELULAR SAMSUNG S21 FE 128GB GRAY OPEN;TELEFONIA
8160596;;M;65;CHILENO;;Boomers;REQUINOA                      ;L.G.B.OÂ´HIGGINS;289450;4;2;0;0;0;4;2;289450;CELULAR MOTOROLA E30 GRIS CLARO;TELEFONIA
14196288;;M;41;CHILENO;;X;PROVIDENCIA                   ;METROPOLITANA;39990;1;1;0;0;0;1;1;39990;CELULAR NOKIA 225 4G BLACK MOVISTAR DIRECTO;TELEFONIA
17647741;Casado;M;31;CHILENO;;Millenial;LOS ALAMOS                    ;BIO BIO;139990;2;1;0;0;0;2;1;139990;CELULAR VIVO Y15S WAVE GREEN OPEN;TELEFONIA
15464218;;M;39;CHILENO;;X;LA CISTERNA;METROPOLITANA;159990;1;1;0;0;0;1;1;159990;CELULAR A32 128 GB BLACK OPEN;TELEFONIA
20155364;;F;22;CHILENO;;Z;PROVIDENCIA                   ;METROPOLITANA;239990;1;1;1;1;239990;0;0;0;CELULAR 11 LITE 5G NE 8/128GB PEACH PINK OPEN;TELEFONIA
18886066;Soltero;F;26;CHILENO;TECNICO DE NIVEL SUPERIOR LABORATORISTA DENTAL;Z;PANGUIPULLI                   ;LOS LAGOS;184980;2;2;1;1;169990;1;1;14990;CELULAR A32 128 GB BLUE OPEN;TELEFONIA
6109809;;F;75;CHILENO;;Silencioso;RENCA                         ;METROPOLITANA;39990;1;1;0;0;0;1;1;39990;CELULAR BMOBILE C40 CRIS OPEN;TELEFONIA
9988193;;M;49;CHILENO;;X;RENCA                         ;METROPOLITANA;189980;3;2;0;0;0;3;2;189980;CELULAR REDMI 9A 32GB SKY BLUE;TELEFONIA
19552952;;F;25;CHILENO;;Z;VILLARICA                     ;ARAUCANIA;799990;3;1;3;1;799990;0;0;0;CELULAR XIAOMI 12 PRO 5G 8GB+256GB PURPLE BUNDLE;TELEFONIA
10187902;;M;55;CHILENO;;Boomers;CANETE                        ;BIO BIO;139980;3;2;0;0;0;3;2;139980;CELULAR VIVO Y01 AZUL ZAFIRO OPEN;TELEFONIA
14312274;;F;46;CHILENO;;X;N/D;N/D;319980;2;2;0;0;0;2;2;319980;CELULAR A54 OPPO AZUL 128GB;TELEFONIA
15191827;;M;40;CHILENO;;X;N/D;N/D;313070;3;1;0;0;0;3;1;313070;CELULAR VIVO V21 5G 128GB SUNSET DAZZLE OPEN;TELEFONIA
20584156;;M;21;CHILENO;;Z;PROVIDENCIA                   ;METROPOLITANA;499990;1;1;1;1;499990;0;0;0;CELULAR IPHONE 12 64GB BLACK CLARO;TELEFONIA
10829058;;M;54;CHILENO;;X;COLINA                        ;METROPOLITANA;256990;2;1;0;0;0;2;1;256990;CELULAR GALAXY A22 5G 4+128GB WHITE;TELEFONIA
18621160;;F;28;CHILENO;;Millenial;"";"";363980;2;1;2;1;363980;0;0;0;CELULAR XIAOMI 11T 8/256GB METEORITE GRAY OPEN;TELEFONIA
18224645;;M;29;CHILENO;;Millenial;LA LIGUA                      ;VALPARAISO;199990;1;1;1;1;199990;0;0;0;CELULAR SAMSUNG A52s 128GB BLACK CLARO;TELEFONIA
9538042;;M;56;CHILENO;;Boomers;N/D;N/D;169990;1;1;0;0;0;1;1;169990;CELULAR REDMI NOTE 11 4/128GB GRAPHITE GRAY OPEN;TELEFONIA
11375370;;M;53;CHILENO;;X;PELLUHUE                      ;MAULE;541980;6;3;0;0;0;6;3;541980;CELULAR A32 128 GB LIGHT VIOLET OPEN;TELEFONIA
9739645;;F;56;CHILENO;;Boomers;PROVIDENCIA                   ;METROPOLITANA;69990;1;1;0;0;0;1;1;69990;CELULAR XIAOMI REDMI 9A 32GB VERDE CLARO;TELEFONIA
18198580;;F;29;CHILENO;;Millenial;PROVIDENCIA                   ;METROPOLITANA;169990;1;1;1;1;169990;0;0;0;CELULAR A32 128 GB BLUE OPEN;TELEFONIA
11692092;;M;52;CHILENO;;X;"";"";229990;1;1;0;0;0;1;1;229990;CELULAR A52 128 GB BLACK OPEN;TELEFONIA
9819787;;M;59;CHILENO;;Boomers;MAIPU                         ;METROPOLITANA;80000;2;1;0;0;0;2;1;80000;CELULAR XIAOMI REDMI 9A 2/32GB GRANITE GRAY;TELEFONIA
15968097;;F;37;CHILENO;;Millenial;VICUNA                        ;COQUIMBO;50980;5;2;0;0;0;5;2;50980;CELULAR VIVO Y01 AZUL ZAFIRO OPEN;TELEFONIA
9324424;;M;60;CHILENO;;Boomers;RENCA                         ;METROPOLITANA;226990;4;2;0;0;0;4;2;226990;CELULAR XIAOMI REDMI 9A 32GB VERDE CLARO;TELEFONIA
9350350;;F;60;CHILENO;;Boomers;RENCA                         ;METROPOLITANA;312450;4;2;0;0;0;4;2;312450;CELULAR A54 OPPO AZUL 128GB;TELEFONIA
12400919;;F;48;CHILENO;;X;SAN FELIPE                    ;VALPARAISO;99990;1;1;0;0;0;1;1;99990;CELULAR XIAOMI REDMI 9C 64GB GRAY WOM;TELEFONIA
8848320;;M;58;CHILENO;;Boomers;RENCA                         ;METROPOLITANA;169990;1;1;1;1;169990;0;0;0;CELULAR REDMI NOTE 11 4/128GB GRAPHITE GRAY OPEN;TELEFONIA
17456857;;F;31;CHILENO;;Millenial;"";"";219990;1;1;0;0;0;1;1;219990;CELULAR A52 128 GB LIGHT VIOLET OPEN;TELEFONIA
18774700;;F;27;CHILENO;;Millenial;LAUTARO;ARAUCANIA;207480;2;1;2;1;207480;0;0;0;CELULAR A52 128 GB WHITE OPEN;TELEFONIA
18495989;;F;29;CHILENO;;Millenial;PROVIDENCIA                   ;METROPOLITANA;276460;4;2;0;0;0;4;2;276460;CELULAR VIVO Y15S WAVE GREEN OPEN;TELEFONIA
12782654;;F;47;CHILENO;;X;N/D;N/D;1743952;13;6;0;0;0;13;6;1743952;CELULAR XIAOMI REDMI 9A 2/32GB GRANITE GRAY;TELEFONIA
14371460;;F;50;CHILENO;;X;N/D;N/D;387972;4;3;0;0;0;4;3;387972;CELULAR A52 128 GB BLUE OPEN;TELEFONIA
18127472;;M;30;CHILENO;;Millenial;PROVIDENCIA                   ;METROPOLITANA;163980;2;1;2;1;163980;0;0;0;CELULAR REDMI NOTE 11 4/128GB TWILIGHT BLUE OPEN;TELEFONIA
11810321;Casado;M;51;CHILENO;GASTRONOMIA INTERNACIONAL;X;RENCA                         ;METROPOLITANA;79990;1;1;0;0;0;1;1;79990;CELULAR REDMI 9A 32GB SKY BLUE;TELEFONIA
15149857;;F;39;CHILENO;;X;SAN JAVIER                    ;MAULE;816940;6;4;5;3;616950;1;1;199990;CELULAR SAMSUNG GALAXY A03 CORE AZUL WOM;TELEFONIA
9916102;;F;59;CHILENO;;Boomers;PROVIDENCIA                   ;METROPOLITANA;294910;4;3;0;0;0;4;3;294910;CELULAR GALAXY A03 64GB BLACK DIRECTO MOVISTAR;TELEFONIA
23764931;;M;48;COLOMBIANO;;Extranjero;PUNTA ARENAS                  ;MAGALLANES;84990;2;1;0;0;0;2;1;84990;CELULAR MOTOROLA G20 EDICION ESPECIAL VERDE CLAR;TELEFONIA
20628091;;F;21;CHILENO;;Z;CHILLAN;BIO-BIO;169990;1;1;1;1;169990;0;0;0;CELULAR REDMI NOTE 11 4/128GB TWILIGHT BLUE OPEN;TELEFONIA
19477829;;M;25;CHILENO;;Z;PROVIDENCIA                   ;METROPOLITANA;199990;1;1;1;1;199990;0;0;0;CELULAR A52 128 GB WHITE OPEN;TELEFONIA
14526928;Soltero;M;42;CHILENO;;X;RENCA                         ;METROPOLITANA;122980;3;1;0;0;0;3;1;122980;CELULAR XIAOMI REDMI 9A 2/32GB GRANITE GRAY;TELEFONIA
7161236;;F;72;CHILENO;;Silencioso;PROVIDENCIA                   ;METROPOLITANA;564160;7;5;0;0;0;7;5;564160;CELULAR BMOBILE C40 CRIS OPEN;TELEFONIA
4737045;;F;83;CHILENO;;Silencioso;VILLA ALEMANA                 ;VALPARAISO;162950;5;5;0;0;0;5;5;162950;Celular SA3 CLARO DIRECTO BLACK;TELEFONIA
25198842;Soltero;M;35;VENEZOLANO;;Extranjero;PROVIDENCIA                   ;METROPOLITANA;571930;8;3;8;3;571930;0;0;0;CELULAR A52 128 GB WHITE OPEN;TELEFONIA
7282173;;F;68;CHILENO;;Boomers;SALAMANCA                     ;COQUIMBO;749990;1;1;0;0;0;1;1;749990;CELULAR IPHONE 12 128GB WHITE CLARO;TELEFONIA
15239423;;F;40;CHILENO;;X;N/D;N/D;803930;7;4;6;3;663940;1;1;139990;CELULAR REDMI NOTE 10 PRO 6+128GB ONYX GRAY;TELEFONIA
7007843;;M;63;CHILENO;;Boomers;TEMUCO                        ;ARAUCANIA;734950;5;2;2;1;606980;3;1;127970;IPHONE 13 MINI 128GB STARLIGHT CLARO;TELEFONIA
16933697;;M;33;CHILENO;;Extranjero;PROVIDENCIA                   ;METROPOLITANA;199990;1;1;1;1;199990;0;0;0;CELULAR GALAXY A23 6+128GB BLACK OPEN;TELEFONIA
18747786;;F;28;CHILENO;;Millenial;PAINE;METROPOLITANA;207973;3;2;3;2;207973;0;0;0;CELULAR SAMSUN A52 128GB NEGRO WOM;TELEFONIA
19122094;Soltero;F;26;CHILENO;TECNICO DE NIVEL MEDIO EN ALIMENTACION;Z;PROVIDENCIA                   ;METROPOLITANA;88980;2;2;0;0;0;2;2;88980;CELULAR GALAXY A03 CORE 2GB 32GB BLACK OPEN;TELEFONIA
13627738;;F;43;CHILENO;;X;N/D;N/D;747970;3;2;3;2;747970;0;0;0;CELULAR HUAWEI NOVA 8i BLUE;TELEFONIA
17469090;;M;32;CHILENO;;Millenial;PROVIDENCIA                   ;METROPOLITANA;199990;1;1;1;1;199990;0;0;0;CELUALAR REDMI NOTE 11 PRO US 6GB+128GB STAR BLU;TELEFONIA
17400245;;F;34;CHILENO;;Millenial;LOS ANGELES                   ;BIO BIO;399970;3;2;0;0;0;3;2;399970;CELULAR MOTOROLA G20 EDICION ESPECIAL VERDE CLAR;TELEFONIA
13722374;;F;43;CHILENO;;X;TALCA                         ;MAULE;371940;6;4;0;0;0;6;4;371940;CELULAR SAMSUNG GALAXY A03 CORE 32GB NEGRO WOM;TELEFONIA
25990350;;M;34;HAITIANO;;Extranjero;SAN VICENTE                   ;L.G.B.OÂ´HIGGINS;355110;8;4;0;0;0;8;4;355110;CELULAR VIVO Y53S FANTASTIC RAINBOW 128GB OPEN;TELEFONIA
15288218;;F;40;CHILENO;;X;ANCUD                         ;LOS LAGOS;270961;7;3;0;0;0;7;3;270961;CELULAR MOTO ONE FUSION 128GB AZUL OPEN;TELEFONIA
17957717;Soltero;F;31;CHILENO;;Millenial;PROVIDENCIA                   ;METROPOLITANA;73980;2;1;2;1;73980;0;0;0;CELULAR XIAOMI REDMI 9A 2/32GB GRANITE GRAY;TELEFONIA
17502821;;F;32;CHILENO;;Millenial;MACHALI                       ;L.G.B.OÂ´HIGGINS;318970;3;2;0;0;0;3;2;318970;CELULAR GALAXY A03 4+128GB BLACK OPEN;TELEFONIA
13325750;;F;44;CHILENO;;X;NATALES                       ;MAGALLANES;169992;1;2;0;0;0;1;2;169992;CELULAR GALAXY A22 5G 4+128GB MINT;TELEFONIA
19868184;;F;23;CHILENO;;Z;LEBU                          ;BIO BIO;79990;1;1;0;0;0;1;1;79990;CELULAR XIAOMI REDMI 9A 32GB VERDE CLARO;TELEFONIA
15444254;;F;39;CHILENO;;X;ESTACION CENTRAL              ;METROPOLITANA;339980;4;2;4;2;339980;0;0;0;CELULAR A52 128 GB BLUE OPEN;TELEFONIA
6198267;Casado;F;73;CHILENO;;Silencioso;PAINE                         ;METROPOLITANA;102400;5;2;0;0;0;5;2;102400;CELULAR BMOBILE C40 CRIS OPEN;TELEFONIA
5797177;;M;75;CHILENO;;Silencioso;LOS ANDES                     ;VALPARAISO;119990;1;1;0;0;0;1;1;119990;CELULAR VIVO Y01 AZUL ZAFIRO OPEN;TELEFONIA
14323097;Soltero;F;45;CHILENO;;X;PROVIDENCIA                   ;METROPOLITANA;33990;1;1;0;0;0;1;1;33990;Celular SA3 CLARO DIRECTO BLACK;TELEFONIA
7931475;;M;62;CHILENO;;Boomers;MAIPU                         ;METROPOLITANA;109990;1;1;0;0;0;1;1;109990;CELULAR GALAXY A03 64GB BLACK DIRECTO MOVISTAR;TELEFONIA
8523792;;F;64;CHILENO;;Boomers;VILLA ALEGRE                  ;MAULE;109880;2;1;0;0;0;2;1;109880;CELULAR REDMI 9A 32GB SKY BLUE;TELEFONIA
13016894;;F;45;CHILENO;;Millenial;N/D;N/D;990;3;1;0;0;0;3;1;990;CHIP OPEN ENTEL;TELEFONIA
19468222;;F;25;CHILENO;;Z;VALLENAR;ATACAMA;330000;2;1;0;0;0;2;1;330000;CELULAR GALAXY A53 5G 6+128GB ORANGE;TELEFONIA
10108421;;M;57;CHILENO;;Boomers;PERQUENCO                     ;ARAUCANIA;99990;2;1;0;0;0;2;1;99990;CELULAR MOTOROLA G30 GRIS WOM 128 GB;TELEFONIA
19164687;Soltero;M;26;CHILENO;;Millenial;"";"";269990;1;1;1;1;269990;0;0;0;CELULAR IPHONE SE 64GB DIRECTO CLARO;TELEFONIA
8238755;;M;65;CHILENO;;Boomers;HUASCO                        ;ATACAMA;17990;1;1;0;0;0;1;1;17990;CELULAR NOKIA 110 BLACK OPEN;TELEFONIA
10333225;;F;57;CHILENO;;Boomers;SAN FELIPE                    ;VALPARAISO;130960;5;5;0;0;0;5;5;130960;CELULAR REDMI 9A 32GB SKY BLUE;TELEFONIA
25794571;;F;28;COLOMBIANO;;Extranjero;NATALES                       ;MAGALLANES;785210;9;6;0;0;0;9;6;785210;CELULAR A32 128 GB BLACK OPEN;TELEFONIA
15275662;;M;43;CHILENO;;X;PROVIDENCIA                   ;METROPOLITANA;99990;1;1;0;0;0;1;1;99990;CELULAR GALAXY A03 CORE 2GB 32GB BLACK OPEN;TELEFONIA
9916133;;M;53;CHILENO;;X;PROVIDENCIA                   ;METROPOLITANA;214980;2;2;1;1;44990;1;1;169990;CELULAR GALAXY A22 5G 4+128GB MINT;TELEFONIA
7691138;Soltero;M;67;CHILENO;;Boomers;SAN RAMON                     ;METROPOLITANA;243280;2;1;0;0;0;2;1;243280;CELULAR MOTO G60S 6/128 GB AZUL;TELEFONIA
11974970;;F;50;CHILENO;;X;LA FLORIDA                    ;METROPOLITANA;178970;4;2;4;2;178970;0;0;0;CELULAR GALAXY A22 5G 4+128GB GRAY;TELEFONIA
15472702;Soltero;M;40;CHILENO;;X;PROVIDENCIA                   ;METROPOLITANA;393460;3;2;0;0;0;3;2;393460;CELULAR GALAXY A22 5G 4+128GB GRAY;TELEFONIA
26479397;;M;27;EXTRANJERO - NO INFORMA NACIONALIDAD;;Extranjero;PROVIDENCIA                   ;METROPOLITANA;203980;2;1;2;1;203980;0;0;0;CELULAR HUAWEI NOVA 8i BLUE;TELEFONIA
16431909;;F;43;CHILENO;;X;LA SERENA;COQUIMBO;990;3;1;0;0;0;3;1;990;CHIP OPEN ENTEL;TELEFONIA
24491934;;F;27;PERUANO;;Extranjero;PROVIDENCIA                   ;METROPOLITANA;208980;2;1;2;1;208980;0;0;0;CELULAR A52 128 GB WHITE OPEN;TELEFONIA
15460963;;F;41;CHILENO;;X;BUIN                          ;METROPOLITANA;537040;8;2;2;1;163980;6;1;373060;CELULAR VIVO V21 5G 128GB SUNSET DAZZLE OPEN;TELEFONIA
9525226;;F;59;CHILENO;;Boomers;LOTA                          ;BIO BIO;139990;2;1;0;0;0;2;1;139990;CELULAR A32 128 GB WHITE OPEN;TELEFONIA
8859415;;M;61;CHILENO;;Boomers;SAN ESTEBAN                   ;VALPARAISO;315640;5;4;0;0;0;5;4;315640;SMARTPHONE A03S 64 GB S/SIM NEGRO;TELEFONIA
18490197;;F;29;CHILENO;;Millenial;PENCO                         ;BIO BIO;69990;1;1;0;0;0;1;1;69990;CELULAR SAMSUNG A03 CORE 32GB BLACK CLARO;TELEFONIA
19345337;Soltero;M;26;CHILENO;;Z;PROVIDENCIA                   ;METROPOLITANA;823970;5;2;5;2;823970;0;0;0;CELULAR XIAOMI 12 PRO 5G 8GB+256GB PURPLE BUNDLE;TELEFONIA
16595668;;F;35;CHILENO;;Millenial;N/D;N/D;269991;2;1;0;0;0;2;1;269991;CELULAR SMARTPHONE A52S 5G LIGHT VIOLET 128GB;TELEFONIA
7943546;Soltero;M;63;CHILENO;INGENIERO AGRICOLA;Boomers;PROVIDENCIA                   ;METROPOLITANA;89591;3;1;0;0;0;3;1;89591;CELULAR NOKIA C1 PLUS BLUE;TELEFONIA
26391574;;F;39;PERUANO;;Extranjero;PENALOLEN                     ;METROPOLITANA;322961;5;4;0;0;0;5;4;322961;CELULAR VIVO Y21S MIDNIGHT BLUE 128 GB OPEN;TELEFONIA
18043519;;F;29;CHILENO;;Millenial;RANCAGUA                      ;L.G.B.OÂ´HIGGINS;473160;4;2;2;1;59540;2;1;413620;POCO F3 EU Night Black 256GB;TELEFONIA
16416118;;M;36;CHILENO;;Millenial;PROVIDENCIA                   ;METROPOLITANA;149991;2;1;0;0;0;2;1;149991;CELULAR MOTO G20 EDICION ESPECIAL 4/128 GB AZUL;TELEFONIA
19128339;;F;25;CHILENO;;Z;PARRAL                        ;MAULE;240243;7;5;0;0;0;7;5;240243;CELULAR AZUMI V60 DUAL OPEN;TELEFONIA
25059489;Soltero;M;30;COLOMBIANO;;Extranjero;PROVIDENCIA                   ;METROPOLITANA;209990;1;1;1;1;209990;0;0;0;CELULAR A52 128 GB BLUE OPEN;TELEFONIA
5713439;Viudo;F;71;CHILENO;;Silencioso;RENCA                         ;METROPOLITANA;80140;2;1;0;0;0;2;1;80140;CELULAR REDMI 9A 32GB PEACOCK GREEN;TELEFONIA
16829933;;F;33;CHILENO;;Millenial;RENCA                         ;METROPOLITANA;247970;3;2;0;0;0;3;2;247970;CELULAR A32 128 GB BLACK OPEN;TELEFONIA
14211883;;M;40;CHILENO;;X;N/D;N/D;169990;1;1;1;1;169990;0;0;0;CELULAR A32 128 GB BLUE OPEN;TELEFONIA
6824755;;F;66;CHILENO;;Boomers;CHILLAN                       ;BIO BIO;409121;7;3;0;0;0;7;3;409121;CELULAR GALAXY A22 5G 4+128GB GRAY;TELEFONIA
12110077;;F;56;CHILENO;;Boomers;SAN IGNACIO                   ;BIO BIO;229980;2;2;0;0;0;2;2;229980;CELULAR VIVO Y11S NEGRO WOM;TELEFONIA
15867352;;F;37;CHILENO;;Millenial;"";"";605940;7;4;0;0;0;7;4;605940;CELULAR MOTOROLA G20 EDICION ESPECIAL VERDE CLAR;TELEFONIA
15271237;;M;38;CHILENO;;X;N/D;N/D;279990;1;1;0;0;0;1;1;279990;SMARTPHONE A52S 5G WHITE 128GB;TELEFONIA
11083594;;F;55;CHILENO;;Boomers;YERBAS BUENAS                 ;MAULE;498900;5;3;0;0;0;5;3;498900;CELULAR VIVO Y20S NEBULA 128 GB BLUE OPEN;TELEFONIA
19449254;;F;25;CHILENO;;Z;SAN FELIPE;VALPARAISO;616310;3;2;0;0;0;3;2;616310;CELULAR XIAOMI 11T 8/256GB CELESTIAL BLUE OPEN;TELEFONIA
14083526;;F;46;CHILENO;;X;VALDIVIA                      ;LOS LAGOS;65990;1;1;0;0;0;1;1;65990;CELULAR MOTOROLA E6 PLAY AZUL TRI WOM;TELEFONIA
17554735;;M;30;CHILENO;;Millenial;ARICA                         ;ARICA Y PARINACOTA;84990;1;1;0;0;0;1;1;84990;CELULAR MOTOROLA G20 64GB BLUE CLARO;TELEFONIA
13654117;;F;42;CHILENO;;X;PEDRO AGUIRRE CERDA           ;METROPOLITANA;317970;3;3;0;0;0;3;3;317970;CELULAR POCO X3 PRO 128G PHANTOM BLACK OPEN;TELEFONIA
17366904;;M;33;CHILENO;;Millenial;N/D;N/D;833610;5;2;0;0;0;5;2;833610;CELULAR VIVO Y20S NEBULA 128 GB BLUE OPEN;TELEFONIA
9860651;;M;59;CHILENO;;Boomers;PARRAL                        ;MAULE;79990;1;1;0;0;0;1;1;79990;CELULAR XIAOMI REDMI 9A 32GB GRANITE GRAY TRI WO;TELEFONIA
26078973;;M;31;HAITIANO;;Extranjero;PEDRO AGUIRRE CERDA           ;METROPOLITANA;599990;1;1;0;0;0;1;1;599990;Celular Galaxy S21 Phantom Grey 128GB;TELEFONIA
26792583;;M;37;VENEZOLANO;;Extranjero;LA SERENA                     ;COQUIMBO;299980;2;1;0;0;0;2;1;299980;CELULAR VIVO Y20S NEBULA 128 GB BLUE OPEN;TELEFONIA
13423338;;F;43;CHILENO;;X;N/D;N/D;353900;10;5;10;5;353900;0;0;0;CELULAR REDMI NOTE 11S 6GB+128GB TWILIGHT BLUE O;TELEFONIA
11384426;;M;53;CHILENO;;X;ILLAPEL                       ;COQUIMBO;291130;3;2;0;0;0;3;2;291130;CELULAR A32 128 GB BLUE OPEN;TELEFONIA
7974197;;M;66;CHILENO;;Boomers;LA SERENA                     ;COQUIMBO;359970;3;2;0;0;0;3;2;359970;CELULAR GALAXY A22 5G 4+128GB GRAY;TELEFONIA
13546002;;M;43;CHILENO;;X;RENCA                         ;METROPOLITANA;29990;1;1;0;0;0;1;1;29990;CELULAR BMOBILE BS30 BLACK OPEN;TELEFONIA
10200711;;M;53;CHILENO;;X;NUEVA IMPERIAL                ;ARAUCANIA;130480;2;1;0;0;0;2;1;130480;SMARTHPHONE SAMSUNG GALAXY A03S 64GB NEGRO;TELEFONIA
17013578;;F;33;CHILENO;;Millenial;ARICA                         ;TARAPACA;17990;1;1;1;1;17990;0;0;0;CELULAR NOKIA 110 BLACK OPEN;TELEFONIA
25109123;;M;39;BOLIVIANO;;Extranjero;RECOLETA                      ;METROPOLITANA;762970;3;2;0;0;0;3;2;762970;CELULAR SMARTPHONE A52S 5G LIGHT GREEN 128GB;TELEFONIA
10295766;;F;60;CHILENO;;Boomers;CATEMU                        ;VALPARAISO;369980;2;2;0;0;0;2;2;369980;CELULAR XIAOMI REDMI 9C 64GB GRAY WOM;TELEFONIA
14482176;;M;40;CHILENO;;X;ARAUCO                        ;BIO BIO;219990;1;1;0;0;0;1;1;219990;CELULAR POCO X3 PRO 128 GB FROST BLUE;TELEFONIA
15745070;;M;40;CHILENO;;X;FUTRONO                       ;LOS LAGOS;100000;2;1;0;0;0;2;1;100000;CELULAR VIVO Y20 NEBULA BLUE OPEN;TELEFONIA
13662457;;F;43;CHILENO;;X;N/D;N/D;564970;3;3;0;0;0;3;3;564970;CELULAR SMARTPHONE A52S 5G BLACK 128GB;TELEFONIA
10970255;;M;54;CHILENO;;Boomers;SANTIAGO                      ;METROPOLITANA;179471;3;3;0;0;0;3;3;179471;CELULAR GALAXY A03 CORE 2GB 32GB BLACK OPEN;TELEFONIA
18944700;Soltero;M;26;CHILENO;;Z;LEBU                          ;BIO BIO;368180;4;2;0;0;0;4;2;368180;CELULAR SMARTPHONE A52S 5G LIGHT GREEN 128GB;TELEFONIA
7227932;;F;72;CHILENO;;Millenial;CURICO                        ;MAULE;54240;3;1;0;0;0;3;1;54240;CELULAR BMOBILE C40 CRIS OPEN;TELEFONIA
16177192;;M;35;CHILENO;;Millenial;N/D;N/D;238960;4;4;0;0;0;4;4;238960;SMARTPHONE A03s 64 GB Red DS;TELEFONIA
11765988;;F;51;CHILENO;;X;N/D;N/D;249980;2;2;0;0;0;2;2;249980;CELULAR VIVO Y20S NEBULA 128 GB BLUE OPEN;TELEFONIA
7820380;Soltero;F;68;CHILENO;;Silencioso;RENCA                         ;METROPOLITANA;29990;1;1;0;0;0;1;1;29990;CELULAR ALCATEL P1 DIRECTO CLARO BLACK;TELEFONIA
9414540;;F;56;CHILENO;;Boomers;ZAPALLAR                      ;VALPARAISO;161481;5;2;0;0;0;5;2;161481;CELULAR XIAOMI REDMI 9A 2/32GB GRANITE GRAY;TELEFONIA
15285633;;F;49;CHILENO;;X;PUERTO MONTT                  ;LOS LAGOS;119500;2;1;0;0;0;2;1;119500;CELULAR GALAXY A03 CORE 2GB 32GB BLACK OPEN;TELEFONIA
8220762;Soltero;F;65;CHILENO;;Silencioso;PROVIDENCIA                   ;METROPOLITANA;139990;1;1;0;0;0;1;1;139990;CELULAR VIVO Y15S WAVE GREEN OPEN;TELEFONIA
9693364;Soltero;M;55;CHILENO;AGRONOMO;Boomers;PAINE                         ;METROPOLITANA;119990;1;1;0;0;0;1;1;119990;CELULAR MOTOROLA E30 GRIS CLARO;TELEFONIA
11573053;;F;52;CHILENO;;X;PROVIDENCIA                   ;METROPOLITANA;71990;2;1;0;0;0;2;1;71990;CELULAR REDMI 9C 64GB MIDNIGHT GRAY MOVISTAR;TELEFONIA
9914257;;F;59;CHILENO;;Boomers;SANTO DOMINGO                 ;VALPARAISO;244960;4;3;0;0;0;4;3;244960;CELULAR XIAOMI REDMI 9C 64GB GRAY WOM;TELEFONIA
10480150;;F;54;CHILENO;;X;PROVIDENCIA                   ;METROPOLITANA;34990;1;1;0;0;0;1;1;34990;CELULAR NOKIA 225 4G BLACK MOVISTAR DIRECTO;TELEFONIA
20325340;;F;22;CHILENO;;Z;SAN ANTONIO;VALPARAISO;324970;3;2;2;1;134980;1;1;189990;CELULAR VIVO Y21S PEARL WHITE 128 GB OPEN;TELEFONIA
17491767;;M;33;CHILENO;;Millenial;NOGALES                       ;VALPARAISO;94970;4;5;0;0;0;4;5;94970;CELULAR GALAXY A03 CORE 2GB 32GB BLUE OPEN;TELEFONIA
13171805;;F;45;CHILENO;;X;ANTOFAGASTA                   ;ANTOFAGASTA;809980;2;2;2;2;809980;0;0;0;CELULAR IPHONE 12 64GB BLACK CLARO;TELEFONIA
6664896;;M;65;CHILENO;;Boomers;RENCA                         ;METROPOLITANA;54231;3;1;0;0;0;3;1;54231;CELULAR BMOBILE C40 CRIS OPEN;TELEFONIA
24719976;;F;36;ECUATORIANO;;Extranjero;SAN PEDRO                     ;METROPOLITANA;882930;8;4;0;0;0;8;4;882930;CELULAR VIVO Y15S WAVE GREEN OPEN;TELEFONIA
13270448;Soltero;M;45;CHILENO;CIRUJANO DENTISTA;X;PROVIDENCIA                   ;METROPOLITANA;219990;1;1;1;1;219990;0;0;0;CELULAR MOTO G60 4/128 GB SILVER OPEN;TELEFONIA
24881555;Soltero;M;26;COLOMBIANO;;Extranjero;PROVIDENCIA                   ;METROPOLITANA;213980;2;1;2;1;213980;0;0;0;CELULAR A52 128 GB LIGHT VIOLET OPEN;TELEFONIA
10637464;;M;55;CHILENO;;Boomers;QUILPUE                       ;VALPARAISO;0;0;2;0;0;0;0;2;0;CELULAR GALAXY A03 CORE 2GB 32GB BLACK OPEN;TELEFONIA
8020037;;F;64;CHILENO;;Boomers;VICUNA                        ;COQUIMBO;263910;5;2;0;0;0;5;2;263910;CELULAR A12 128GB Azul OPEN;TELEFONIA
9746946;;F;56;CHILENO;;Boomers;ARICA                         ;TARAPACA;429980;4;2;0;0;0;4;2;429980;CELULAR SMARTPHONE A52S 5G LIGHT GREEN 128GB;TELEFONIA
13142086;;F;45;CHILENO;;X;ARAUCO                        ;BIO BIO;440140;4;2;0;0;0;4;2;440140;CELULAR GALAXY A22 5G 4+128GB MINT;TELEFONIA
18616353;;M;29;CHILENO;;Millenial;PAREDONES                     ;L.G.B.OÂ´HIGGINS;419980;2;2;0;0;0;2;2;419980;CELULAR A52 128 GB BLACK OPEN;TELEFONIA
6678673;;F;85;CHILENO;;Silencioso;CORONEL                       ;BIO BIO;949338;6;5;0;0;0;6;5;949338;CELULAR A52 128 GB BLACK OPEN;TELEFONIA
15390685;;F;40;CHILENO;;X;N/D;N/D;303980;2;1;2;1;303980;0;0;0;CELULAR IPHONE SE 64GB DIRECTO CLARO;TELEFONIA
18642532;;M;24;CHILENO;;Z;QUEMCHI                       ;LOS LAGOS;1325980;3;1;0;0;0;3;1;1325980;CELULAR GALAXY S22 ULTRA BLACK 128GB;TELEFONIA
5574685;;F;74;CHILENO;;Silencioso;PROVIDENCIA                   ;METROPOLITANA;19990;2;1;0;0;0;2;1;19990;CELULAR XIAOMI REDMI 9A SE 2/32GB GB PEACOCK GRE;TELEFONIA
5654500;;F;72;CHILENO;;Silencioso;ARICA                         ;ARICA Y PARINACOTA;474430;5;2;0;0;0;5;2;474430;CELULAR NOKIA 225 4G BLACK MOVISTAR DIRECTO;TELEFONIA
15436607;;F;40;CHILENO;;X;PAINE                         ;METROPOLITANA;536111;6;4;0;0;0;6;4;536111;CELULAR GALAXY A22 5G 4+128GB GRAY;TELEFONIA
7514426;;M;66;CHILENO;;Boomers;NATALES                       ;MAGALLANES;279990;1;1;0;0;0;1;1;279990;CELULAR SMARTPHONE A52S 5G BLACK 128GB;TELEFONIA
4768821;;F;84;CHILENO;;Silencioso;COIHAIQUE                     ;AYSEN;492970;3;2;0;0;0;3;2;492970;CELULAR POCO X4 PRO 5G 128GB LASER BLUE OPEN;TELEFONIA
17592512;;F;32;CHILENO;;Millenial;LOS ANGELES                   ;BIO BIO;630000;3;1;0;0;0;3;1;630000;CELULAR SAMSUNG S21 FE 128GB LIGHT VIOLET OPEN;TELEFONIA
19955625;;F;24;CHILENO;;Z;"";"";357960;4;2;4;2;357960;0;0;0;CELULAR A52 128 GB LIGHT VIOLET OPEN;TELEFONIA
6961866;;M;69;CHILENO;;Silencioso;"";"";950790;7;4;7;4;950790;0;0;0;CELULAR A52 128 GB BLACK OPEN;TELEFONIA
14729964;;F;53;PERUANO;;Extranjero;PUENTE ALTO                   ;METROPOLITANA;726960;5;3;0;0;0;5;3;726960;CELULAR GALAXY A03 4+64GB BLUE OPEN;TELEFONIA
4472969;;M;78;CHILENO;;Silencioso;VICTORIA                      ;ARAUCANIA;69500;3;1;0;0;0;3;1;69500;CELULAR VIVO Y11S NEGRO WOM;TELEFONIA
18677750;;M;28;CHILENO;;Millenial;N/D;N/D;159990;1;1;1;1;159990;0;0;0;CELULAR GALAXY A22 5G 4+128GB MINT;TELEFONIA
17847159;;F;30;CHILENO;;Millenial;COQUIMBO                      ;COQUIMBO;279991;2;1;0;0;0;2;1;279991;CELULAR VIVO V21 5G 128GB SUNSET DAZZLE OPEN;TELEFONIA
18087720;;M;29;CHILENO;;Millenial;PROVIDENCIA                   ;METROPOLITANA;99990;1;1;0;0;0;1;1;99990;CELULAR VIVO Y11S NEGRO WOM;TELEFONIA
10471749;;F;55;CHILENO;;Boomers;PROVIDENCIA                   ;METROPOLITANA;179990;1;1;0;0;0;1;1;179990;CELULAR GALAXY A22 5G 4+128GB MINT;TELEFONIA
16469590;;F;35;CHILENO;;Millenial;ARICA                         ;ARICA Y PARINACOTA;209990;1;1;0;0;0;1;1;209990;CELULAR RENO5 LITE VIOLETA 128GB;TELEFONIA
19212201;;F;26;CHILENO;;Z;N/D;N/D;849980;3;2;0;0;0;3;2;849980;CELULAR VIVO Y20S NEBULA 128 GB BLUE OPEN;TELEFONIA
17779163;;F;31;CHILENO;;Millenial;PEUMO                         ;L.G.B.OÂ´HIGGINS;109991;2;1;0;0;0;2;1;109991;CELULAR GALAXY A03 4+64GB BLACK OPEN;TELEFONIA
15916643;;F;37;CHILENO;;Millenial;RENCA                         ;METROPOLITANA;99990;1;1;0;0;0;1;1;99990;CELULAR VIVO Y11S NEGRO WOM;TELEFONIA
26088235;Soltero;M;34;VENEZOLANO;;Extranjero;"";"";927960;4;2;4;2;927960;0;0;0;CELULAR IPHONE 12 64GB BLACK CLARO;TELEFONIA
9137473;Soltero;M;60;CHILENO;;Boomers;CALAMA                        ;ANTOFAGASTA;119990;1;1;0;0;0;1;1;119990;CELULAR XIAOMI REDMI 9C 64GB GRAY WOM;TELEFONIA
14646274;;F;54;BOLIVIANO;;Extranjero;SANTIAGO                      ;METROPOLITANA;932960;4;2;3;1;915970;1;1;16990;CELULAR GALAXY S22 GREEN 128GB;TELEFONIA
13626039;Soltero;M;47;CHILENO;INGENIERO;X;PROVIDENCIA                   ;METROPOLITANA;609000;6;4;4;3;593520;2;1;15480;SMARTPHONE A52S 5G WHITE 128GB;TELEFONIA
16246810;;F;37;CHILENO;;Extranjero;"";"";183980;2;1;2;1;183980;0;0;0;CELULAR REDMI NOTE 11 GRAPHITE GRAY + REDMI BUDS;TELEFONIA
20026276;;M;23;CHILENO;;Z;"";"";169990;1;1;1;1;169990;0;0;0;CELULAR A32 128 GB BLACK OPEN;TELEFONIA
12793748;Soltero;M;47;CHILENO;;X;RENCA                         ;METROPOLITANA;89990;1;1;0;0;0;1;1;89990;CELULAR GALAXY A03 CORE 2GB 32GB BLUE OPEN;TELEFONIA
15115867;;M;38;CHILENO;;X;PROVIDENCIA                   ;METROPOLITANA;24990;1;1;0;0;0;1;1;24990;CELULAR AZUMI L4G BLACK CLARO;TELEFONIA
8905947;;M;61;CHILENO;;Boomers;CAUQUENES                     ;MAULE;117980;2;1;0;0;0;2;1;117980;CELULAR GALAXY A03 CORE 2GB 32GB BLACK OPEN;TELEFONIA
9118643;Casado;F;62;CHILENO;;Boomers;RENCA                         ;METROPOLITANA;183980;2;1;2;1;183980;0;0;0;CELULAR MOTO G50 AZUL 128 GB OPEN;TELEFONIA
16312234;;M;36;CHILENO;;Millenial;CASTRO                        ;LOS LAGOS;341950;5;4;0;0;0;5;4;341950;Celular Y7P LIB OPEN NEGRO;TELEFONIA
16873137;;M;34;CHILENO;;Millenial;PENAFLOR                      ;METROPOLITANA;265980;2;1;0;0;0;2;1;265980;CELULAR MOTO G60S 6/128 GB AZUL;TELEFONIA
13395009;;F;44;CHILENO;;X;TIRUA                         ;BIO BIO;219990;1;1;0;0;0;1;1;219990;CELULAR A52 128 GB BLACK OPEN;TELEFONIA
6483810;;F;71;CHILENO;;Silencioso;N/D;N/D;199990;1;1;0;0;0;1;1;199990;CELULAR POCO X3 PRO 128 GB FROST BLUE;TELEFONIA
9362387;;F;61;CHILENO;;Boomers;OVALLE                        ;COQUIMBO;179991;2;1;0;0;0;2;1;179991;CELULAR REDMI NOTE 10S 128GB ONIX BLACK;TELEFONIA
7552017;;M;65;CHILENO;;Boomers;N/D;N/D;209980;2;2;0;0;0;2;2;209980;CELULAR MOTO G60S 6/128 GB AZUL;TELEFONIA
15714448;;F;38;CHILENO;;X;N/D;N/D;109990;1;1;0;0;0;1;1;109990;SMARTPHONE A03S 32 GB ROJO;TELEFONIA
15569014;;F;39;CHILENO;;X;PROVIDENCIA                   ;METROPOLITANA;117980;2;1;0;0;0;2;1;117980;CELULAR REDMI 9A 32GB PEACOCK GREEN;TELEFONIA
18263996;;F;29;CHILENO;;Millenial;PROVIDENCIA                   ;METROPOLITANA;229990;1;1;0;0;0;1;1;229990;CELULAR A52 128 GB BLACK OPEN;TELEFONIA
11639957;Casado;F;51;CHILENO;CIRUJANO DENTISTA;X;RENCA                         ;METROPOLITANA;357960;5;2;5;2;357960;0;0;0;CELULAR A12 128GB Azul OPEN;TELEFONIA
18677137;;F;28;CHILENO;;Millenial;LLAILLAY                      ;VALPARAISO;36990;1;1;0;0;0;1;1;36990;CELULAR BMOBILE C40 CRIS OPEN;TELEFONIA
8849025;Casado;F;63;CHILENO;;Boomers;SAN JAVIER                    ;MAULE;109990;2;1;0;0;0;2;1;109990;CELULAR A12 128GB Rojo OPEN;TELEFONIA
13142242;;F;45;CHILENO;;X;LAJA                          ;BIO BIO;905980;3;1;0;0;0;3;1;905980;CELULAR GALAXY S22+ WHITE 128GB;TELEFONIA
14164827;;F;40;CHILENO;;X;PROVIDENCIA                   ;METROPOLITANA;89990;1;1;0;0;0;1;1;89990;CELULAR XIAOMI REDMI 9A 2/32GB GRANITE GRAY;TELEFONIA
15507910;;M;40;CHILENO;;X;CURACAUTIN                    ;ARAUCANIA;1345490;7;5;0;0;0;7;5;1345490;CELULAR GALAXY S20FE 128GB CLOUD LAVENDER OPEN;TELEFONIA
14389248;;F;43;CHILENO;;X;TALCA                         ;MAULE;299990;1;1;0;0;0;1;1;299990;CELULAR SMARTPHONE A52S 5G LIGHT GREEN 128GB;TELEFONIA
18940715;Soltero;F;27;CHILENO;;Silencioso;PROVIDENCIA                   ;METROPOLITANA;223980;2;1;2;1;223980;0;0;0;CELULAR A52 128 GB LIGHT VIOLET OPEN;TELEFONIA
5623163;;F;76;CHILENO;;Silencioso;RENCA                         ;METROPOLITANA;157470;3;1;0;0;0;3;1;157470;CELULAR GALAXY A03 4+128GB BLACK OPEN;TELEFONIA
19461901;;M;25;CHILENO;;Z;PROVIDENCIA                   ;METROPOLITANA;119990;1;1;0;0;0;1;1;119990;SMARTPHONE A03s 64 GB Red DS;TELEFONIA
16901477;;M;34;CHILENO;;Millenial;SAN BERNARDO;METROPOLITANA;293950;5;3;0;0;0;5;3;293950;CELULAR REDMI 9A 32GB PEACOCK GREEN;TELEFONIA
7155026;;M;66;CHILENO;;Boomers;PROVIDENCIA                   ;METROPOLITANA;119990;1;1;0;0;0;1;1;119990;CELULAR XIAOMI REDMI 9 64GB DIRECTO CLARO MORADO;TELEFONIA
13727644;;F;43;CHILENO;;X;CURANILAHUE                   ;BIO BIO;343970;5;3;0;0;0;5;3;343970;CELULAR MOTOROLA G20 EDICION ESPECIAL VERDE CLAR;TELEFONIA
17556829;;F;32;CHILENO;;Millenial;N/D;N/D;189980;2;2;1;1;99990;1;1;89990;CELULAR XIAOMI REDMI 9 MORADO ENTEL;TELEFONIA
17829867;;F;31;CHILENO;;Millenial;ARICA                         ;TARAPACA;214980;2;1;0;0;0;2;1;214980;CELULAR A32 128 GB BLACK OPEN;TELEFONIA
13975034;;F;41;CHILENO;;X;VALLENAR;ATACAMA;93970;4;2;0;0;0;4;2;93970;CELULAR Moto One Fusion 128GB Blue WOM;TELEFONIA
17360616;;F;32;CHILENO;;Millenial;PROVIDENCIA                   ;METROPOLITANA;629980;2;2;1;1;289990;1;1;339990;CELULAR 11 LITE 5G NE 8/128GB PEACH PINK OPEN;TELEFONIA
19222406;Soltero;F;26;CHILENO;;Z;PROVIDENCIA                   ;METROPOLITANA;459990;2;1;2;1;459990;0;0;0;CELULAR SAMSUNG S21 FE 128GB GRAY OPEN;TELEFONIA
16694853;;M;34;CHILENO;;Millenial;PITRUFQUEN                    ;ARAUCANIA;149990;1;1;0;0;0;1;1;149990;CELULAR A54 OPPO NEGRO 128GB;TELEFONIA
12467865;;F;49;CHILENO;;X;AISEN                         ;AYSEN;129990;1;1;0;0;0;1;1;129990;CELULAR MOTO ONE FUSION 64GB VERDE 64GB OPEN;TELEFONIA
17545501;;F;31;CHILENO;;Millenial;LA PINTANA                    ;METROPOLITANA;407960;4;4;4;2;377960;0;2;30000;CELULAR REDMI NOTE 10 PRO 128GB AZUL WOM;TELEFONIA
22019565;;M;29;EXTRANJERO - NO INFORMA NACIONALIDAD;;Extranjero;PROVIDENCIA                   ;METROPOLITANA;7990;1;1;1;1;7990;0;0;0;REPETIDOR MI WIFI RANGE EXTENDER PRO XIAOMI;TELEFONIA
20390922;;F;22;CHILENO;;Silencioso;PROVIDENCIA                   ;METROPOLITANA;93980;2;1;2;1;93980;0;0;0;CELULAR MOTO E7 32GB GRIS OPEN;TELEFONIA
14351874;;F;42;CHILENO;;X;ANGOL                         ;ARAUCANIA;468440;7;5;0;0;0;7;5;468440;POCO X3 PRO 256 GB PHANTOM BLACK;TELEFONIA
15931966;;F;36;CHILENO;;Millenial;SAN CLEMENTE;MAULE;159980;4;1;0;0;0;4;1;159980;CELULAR VIVO Y20 NEBULA BLUE OPEN;TELEFONIA
7735107;;M;66;CHILENO;;Boomers;CONCEPCION                    ;BIO BIO;916941;7;4;0;0;0;7;4;916941;CELULAR A52 128 GB BLACK OPEN;TELEFONIA
14148413;;F;40;CHILENO;;X;PROVIDENCIA                   ;METROPOLITANA;269990;2;1;2;1;269990;0;0;0;CELULAR SMARTPHONE A52S 5G LIGHT VIOLET 128GB;TELEFONIA
8178029;;F;64;CHILENO;;Boomers;LOS ANGELES                   ;BIO BIO;127980;2;1;0;0;0;2;1;127980;CELULAR VIVO Y11S NEGRO WOM;TELEFONIA
15635038;;F;38;CHILENO;;X;N/D;N/D;502950;5;2;3;1;357960;2;1;144990;CELULAR REDMI NOTE 10S 128GB ONIX BLACK;TELEFONIA
9696523;;M;58;CHILENO;;Boomers;SAN FERNANDO                  ;L.G.B.OÂ´HIGGINS;780950;5;3;0;0;0;5;3;780950;CELULAR MOTO G60 4/128 GB SILVER OPEN;TELEFONIA
9460125;;F;61;CHILENO;;Boomers;CORONEL                       ;BIO BIO;32990;1;1;0;0;0;1;1;32990;Celular SA3 CLARO DIRECTO BLACK;TELEFONIA
8195752;;F;64;CHILENO;;Boomers;INDEPENDENCIA                 ;METROPOLITANA;2500762;26;4;0;0;0;26;4;2500762;CELULAR SAMSUNG S21 FE 128GB GRAY OPEN;TELEFONIA
14467208;;F;46;CHILENO;;X;ARICA                         ;ARICA Y PARINACOTA;18991;2;1;0;0;0;2;1;18991;CELULAR NOKIA 110 BLACK OPEN;TELEFONIA
13394810;;F;44;CHILENO;;X;VICTORIA                      ;ARAUCANIA;143980;3;2;0;0;0;3;2;143980;SMARTPHONE A03s 64 GB Red DS;TELEFONIA
16081278;;M;44;CHILENO;;X;IQUIQUE                       ;TARAPACA;129990;2;1;0;0;0;2;1;129990;CELULAR MOTO ONE FUSION 64GB VERDE 64GB OPEN;TELEFONIA
10610671;;F;53;CHILENO;;X;LA SERENA                     ;COQUIMBO;399930;7;3;0;0;0;7;3;399930;CELULAR NOKIA 110 BLACK OPEN;TELEFONIA
20350723;;F;21;CHILENO;;Z;TALCA                         ;MAULE;695450;6;4;2;1;225480;4;3;469970;CELULAR VIVO Y21S MIDNIGHT BLUE 128 GB OPEN;TELEFONIA
12320290;;F;54;CHILENO;;Boomers;RENCA                         ;METROPOLITANA;32990;1;1;0;0;0;1;1;32990;Celular SA3 CLARO DIRECTO BLACK;TELEFONIA
12237053;;F;49;CHILENO;;X;CERRO NAVIA                   ;METROPOLITANA;199960;5;2;0;0;0;5;2;199960;CELULAR BMOBILE BS30 BLACK OPEN;TELEFONIA
13888682;;M;41;CHILENO;;Silencioso;PROVIDENCIA                   ;METROPOLITANA;21980;2;1;2;1;21980;0;0;0;CELULAR NOKIA 110 BLACK OPEN;TELEFONIA
12572715;;M;47;CHILENO;;X;OVALLE                        ;COQUIMBO;372970;3;2;0;0;0;3;2;372970;CELULAR A52 128 GB WHITE OPEN;TELEFONIA
10900430;;F;48;CHILENO;;X;N/D;N/D;332170;5;3;0;0;0;5;3;332170;SMARTPHONE A03S 32 GB ROJO;TELEFONIA
10748919;Soltero;F;47;CHILENO;;X;PROVIDENCIA                   ;METROPOLITANA;52961;5;1;0;0;0;5;1;52961;CELULAR BMOBILE C40 CRIS OPEN;TELEFONIA
24452274;;M;32;BOLIVIANO;;Extranjero;N/D;N/D;801948;5;4;1;3;119990;4;1;681958;CELULAR A12 128GB Azul OPEN;TELEFONIA
13421298;Soltero;F;43;CHILENO;INGENIERO COMERCIAL;X;RENCA                         ;METROPOLITANA;512480;2;1;2;1;512480;0;0;0;CELULAR GALAXY S21 FE 8GB 256GB GRAY;TELEFONIA
6710755;Casado;F;67;CHILENO;;Boomers;PROVIDENCIA                   ;METROPOLITANA;59990;2;1;0;0;0;2;1;59990;CELULAR VIVO Y20S NEBULA 128 GB BLUE OPEN;TELEFONIA
15659105;;M;39;CHILENO;;X;"";"";36990;1;1;0;0;0;1;1;36990;CELULAR BMOBILE C40 CRIS OPEN;TELEFONIA
8039417;Soltero;M;61;CHILENO;;Boomers;RENCA                         ;METROPOLITANA;189990;1;1;0;0;0;1;1;189990;CELULAR VIVO Y21S MIDNIGHT BLUE 128 GB OPEN;TELEFONIA
5150048;;M;78;CHILENO;;Silencioso;NATALES                       ;MAGALLANES;36990;1;1;0;0;0;1;1;36990;CELULAR BMOBILE C40 CRIS OPEN;TELEFONIA
18429799;;F;29;CHILENO;;Millenial;"";"";351820;4;2;4;2;351820;0;0;0;SMARTPHONE GALAXY S20FE RED;TELEFONIA
16857512;;M;34;CHILENO;;Millenial;CURICO                        ;MAULE;299990;1;1;1;1;299990;0;0;0;CELULAR IPHONE SE 64GB DIRECTO CLARO;TELEFONIA
27121250;;F;63;VENEZOLANO;;Extranjero;"";"";990;1;1;0;0;0;1;1;990;CHIP OPEN ENTEL;TELEFONIA
16559319;;F;35;CHILENO;;Millenial;COPIAPO;ATACAMA;100000;2;1;0;0;0;2;1;100000;CELULAR VIVO Y11S 32GB NEBULA BLUE OPEN;TELEFONIA
14040344;Soltero;M;41;CHILENO;;X;PUERTO OCTAY                  ;LOS LAGOS;160000;2;1;0;0;0;2;1;160000;CELULAR VIVO Y20S OBSIDIAN BLACK 128GB OPEN;TELEFONIA
6671782;;M;70;CHILENO;;Silencioso;PROVIDENCIA                   ;METROPOLITANA;50980;2;1;0;0;0;2;1;50980;CELULAR BMOBILE C40 CRIS OPEN;TELEFONIA
11193157;;M;54;CHILENO;;Boomers;CERRILLOS                     ;METROPOLITANA;172162;3;2;0;0;0;3;2;172162;CELULAR Moto G20 Blue WOM;TELEFONIA
13285403;;F;46;CHILENO;;X;PROVIDENCIA                   ;METROPOLITANA;209990;1;1;1;1;209990;0;0;0;CELULAR NOKIA G50 SS 4/128 INTCHI BLUE TRI WOM;TELEFONIA
23591815;;M;54;CHILENO;;Extranjero;N/D;N/D;11990;1;1;0;0;0;1;1;11990;REPETIDOR MI WIFI RANGE EXTENDER PRO XIAOMI;TELEFONIA
8848119;;M;60;CHILENO;;Boomers;CALERA                        ;VALPARAISO;408302;5;2;0;0;0;5;2;408302;CELULAR XIAOMI REDMI 9A 2/32GB GRANITE GRAY;TELEFONIA
11809941;Casado;M;50;CHILENO;;X;RENCA                         ;METROPOLITANA;129990;2;1;0;0;0;2;1;129990;CELULAR VIVO Y21S PEARL WHITE 128 GB OPEN;TELEFONIA
12395947;;M;49;CHILENO;;X;RENCA                         ;METROPOLITANA;189991;2;1;0;0;0;2;1;189991;CELULAR VIVO Y21S MIDNIGHT BLUE 128 GB OPEN;TELEFONIA
15200334;Soltero;M;39;CHILENO;;X;PROVIDENCIA                   ;METROPOLITANA;89990;1;1;0;0;0;1;1;89990;CELULAR MOTO E7 32GB GRIS OPEN;TELEFONIA
16704526;;M;34;CHILENO;;Millenial;ANTOFAGASTA                   ;ANTOFAGASTA;139990;1;1;0;0;0;1;1;139990;CELULAR A12 128GB Azul OPEN;TELEFONIA
16949013;;F;34;CHILENO;;Millenial;TEMUCO                        ;ARAUCANIA;203980;4;2;0;0;0;4;2;203980;CELULAR MOTOROLA MOTO G20 64GB ROSA FLAMINGO;TELEFONIA
26416318;Soltero;F;38;HAITIANO;;Extranjero;LINARES                       ;MAULE;117980;2;1;0;0;0;2;1;117980;CELULAR XIAOMI REDMI 9A 32GB GRANITE GRAY TRI WO;TELEFONIA
5896458;;M;69;CHILENO;;Silencioso;QUILPUE                       ;VALPARAISO;189990;1;1;1;1;189990;0;0;0;CELULAR A22 128GB NEGRO;TELEFONIA
19146099;;M;26;CHILENO;;Z;N/D;N/D;279990;1;1;0;0;0;1;1;279990;CELULAR SMARTPHONE A52S 5G BLACK 128GB;TELEFONIA
19595649;;F;25;CHILENO;;Z;N/D;N/D;1733960;4;1;4;1;1733960;0;0;0;CELULAR GALAXY S22 ULTRA BLACK 128GB;TELEFONIA
21105506;;F;39;CHILENO;;Extranjero;CORONEL                       ;BIO BIO;405971;4;3;0;0;0;4;3;405971;CELULAR CLARO MOTOROLA E7 32GB GRIS;TELEFONIA
15693249;;F;38;CHILENO;;X;ARICA                         ;TARAPACA;369980;2;2;0;0;0;2;2;369980;CELULAR SMARTPHONE A52S 5G LIGHT VIOLET 128GB;TELEFONIA
10516881;;M;56;CHILENO;;Boomers;RENCA                         ;METROPOLITANA;189990;1;1;0;0;0;1;1;189990;CELULAR VIVO Y21S MIDNIGHT BLUE 128 GB OPEN;TELEFONIA
14536517;Casado;M;46;CHILENO;INGENIERO CIVIL INDUSTRIAL;X;PROVIDENCIA                   ;METROPOLITANA;0;0;2;0;2;0;0;0;0;CELULAR A21s 128 GB AZUL;TELEFONIA
15231457;;M;39;CHILENO;;X;VICTORIA                      ;ARAUCANIA;492950;5;5;0;0;0;5;5;492950;POCO X3 PRO US 128G METAL BRONZE;TELEFONIA
26105282;;F;40;COLOMBIANO;;Extranjero;N/D;N/D;139990;1;1;0;0;0;1;1;139990;CELULAR MOTOROLA G20 EDICION ESPECIAL VERDE CLAR;TELEFONIA
15598389;Casado;M;38;CHILENO;;X;RENCA                         ;METROPOLITANA;89980;2;2;1;1;69990;1;1;19990;CELULAR MOTOROLA E6S GRIS 32GB DIRECTO WOM;TELEFONIA
20149829;;M;22;CHILENO;;Z;PROVIDENCIA                   ;METROPOLITANA;215980;2;1;2;1;215980;0;0;0;POCO X3 PRO 256 GB PHANTOM BLACK;TELEFONIA
11835422;Casado;M;51;CHILENO;;X;PROVIDENCIA                   ;METROPOLITANA;199990;1;1;0;0;0;1;1;199990;CELULAR A22 128GB NEGRO;TELEFONIA
5178170;;F;80;CHILENO;;Extranjero;CALAMA                        ;ANTOFAGASTA;19990;1;1;0;0;0;1;1;19990;CELULAR AZUMI L4G BLACK CLARO;TELEFONIA
9818827;Casado;M;50;CHILENO;;X;COIHAIQUE                     ;AYSEN;199990;1;1;0;0;0;1;1;199990;POCO X3 PRO US 128G METAL BRONZE;TELEFONIA
17655570;Soltero;F;31;CHILENO;;Millenial;PROVIDENCIA                   ;METROPOLITANA;249990;1;1;1;1;249990;0;0;0;CELULAR A52 128 GB LIGHT VIOLET OPEN;TELEFONIA
6425965;Casado;M;71;CHILENO;;Silencioso;RAUCO                         ;MAULE;50000;3;1;0;0;0;3;1;50000;SMARTPHONE A03S NEGRO 32GB;TELEFONIA
14215569;;F;40;CHILENO;;X;TRAIGUEN                      ;ARAUCANIA;35990;1;1;0;0;0;1;1;35990;CELULAR BMOBILE BS30 BLACK OPEN;TELEFONIA
18120401;Soltero;M;30;CHILENO;;Millenial;PROVIDENCIA                   ;METROPOLITANA;127980;2;1;0;0;0;2;1;127980;CELULAR VIVO Y11S 32GB NEBULA BLUE OPEN;TELEFONIA
15814990;;M;37;CHILENO;;Millenial;"";"";111980;3;2;0;0;0;3;2;111980;CELULAR VIVO Y11S 32GB NEBULA BLUE OPEN;TELEFONIA
16144561;;F;37;CHILENO;;Millenial;BUIN                          ;METROPOLITANA;399990;1;1;0;0;0;1;1;399990;Celular Z FLIP LIB OPEN BLACK;TELEFONIA
12406805;;F;49;CHILENO;;X;PENAFLOR                      ;METROPOLITANA;299990;1;1;0;0;0;1;1;299990;CELULAR IPHONE SE 64GB DIRECTO CLARO;TELEFONIA
11767363;;M;51;CHILENO;;X;RENCA                         ;METROPOLITANA;146980;2;1;0;0;0;2;1;146980;SMARTPHONE A03S 32 GB ROJO;TELEFONIA
10822532;;M;56;CHILENO;;Boomers;PROVIDENCIA                   ;METROPOLITANA;219990;1;1;0;0;0;1;1;219990;CELULAR REDMI NOTE 10S 128GB ONIX BLACK;TELEFONIA
18712758;;F;28;CHILENO;;Millenial;ARICA                         ;TARAPACA;499980;2;2;0;0;0;2;2;499980;CELULAR POCO X3 PRO 128G PHANTOM BLACK OPEN;TELEFONIA
10447285;;M;56;CHILENO;;Boomers;HUALAIHUE                     ;LOS LAGOS;129990;1;1;0;0;0;1;1;129990;CELULAR A12 128GB Azul OPEN;TELEFONIA
17265433;;M;33;CHILENO;;Millenial;PROVIDENCIA                   ;METROPOLITANA;213980;2;1;2;1;213980;0;0;0;POCO X3 PRO 256 GB PHANTOM BLACK;TELEFONIA
18683828;;F;28;CHILENO;;Millenial;N/D;N/D;95980;3;1;0;0;0;3;1;95980;CELULAR VIVO Y11S 32 GB NEBULA BLUE WOM;TELEFONIA
17556216;;F;29;CHILENO;;Millenial;N/D;N/D;249990;1;1;0;0;0;1;1;249990;CELULAR MOTO G60S 6/128 GB AZUL;TELEFONIA
14046605;;F;41;CHILENO;;X;PROVIDENCIA                   ;METROPOLITANA;197480;2;1;2;1;197480;0;0;0;CELULAR REDMI NOTE 10S 128GB ONIX BLACK;TELEFONIA
16679735;;M;34;CHILENO;;Millenial;CONSTITUCION                  ;MAULE;1315970;4;1;4;1;1315970;0;0;0;CELULAR GALAXY S22 ULTRA BLACK 128GB;TELEFONIA
12504144;;F;48;CHILENO;;X;N/D;N/D;315940;6;5;2;1;213980;4;4;101960;CELULAR BMOBILE BS30 BLACK OPEN;TELEFONIA
17292087;;F;33;CHILENO;;Millenial;QUELLON                       ;LOS LAGOS;119990;1;1;0;0;0;1;1;119990;CELULAR A12 128GB Rojo OPEN;TELEFONIA
19081830;;F;27;CHILENO;;Z;VINA DEL MAR                  ;VALPARAISO;210980;2;1;0;0;0;2;1;210980;CELULAR VIVO Y21S MIDNIGHT BLUE 128 GB OPEN;TELEFONIA
16621151;;F;35;CHILENO;;Millenial;CHIMBARONGO                   ;L.G.B.OÂ´HIGGINS;219992;3;1;0;0;0;3;1;219992;CELULAR A32 128 GB BLACK OPEN;TELEFONIA
11140042;;F;55;CHILENO;;Boomers;N/D;N/D;136980;2;1;0;0;0;2;1;136980;CELULAR VIVO Y11S 32GB NEBULA BLUE OPEN;TELEFONIA
19594743;Soltero;F;25;CHILENO;;Z;PROVIDENCIA                   ;METROPOLITANA;0;0;2;0;2;0;0;0;0;CELULAR IPHONE SE 64GB DIRECTO CLARO;TELEFONIA
19726939;;F;25;CHILENO;;Z;LA CRUZ                       ;VALPARAISO;154174;3;2;0;0;0;3;2;154174;CELULAR VIVO Y11S 32GB NEBULA BLUE OPEN;TELEFONIA
14352472;;M;43;CHILENO;;X;TALCAHUANO                    ;BIO BIO;291910;9;6;0;0;0;9;6;291910;CHIP OPEN ENTEL;TELEFONIA
15258602;;F;40;CHILENO;;X;TEMUCO                        ;ARAUCANIA;143920;10;6;0;0;0;10;6;143920;CELULAR VIVO Y11S 32GB NEBULA BLUE OPEN;TELEFONIA
25527520;;F;33;COLOMBIANO;;Extranjero;N/D;N/D;504990;2;1;0;0;0;2;1;504990;IPHONE 11 64GB BLACK CLARO;TELEFONIA
16331901;;M;35;CHILENO;;Millenial;N/D;N/D;143970;3;2;0;0;0;3;2;143970;CELULAR A12 128GB Negro OPEN;TELEFONIA
5659956;;F;82;CHILENO;;Silencioso;ILLAPEL                       ;COQUIMBO;119990;1;1;0;0;0;1;1;119990;CELULAR MOTOROLA G20 EDICION ESPECIAL VERDE CLAR;TELEFONIA
16047774;Soltero;M;36;CHILENO;CHEF;Millenial;RENCA                         ;METROPOLITANA;249980;2;2;2;2;249980;0;0;0;CELULAR MOTO G60S 6/128 GB AZUL;TELEFONIA
17468616;;F;32;CHILENO;;Millenial;PROVIDENCIA                   ;METROPOLITANA;59990;2;1;0;0;0;2;1;59990;CELULAR VIVO Y11S 32GB NEBULA BLUE OPEN;TELEFONIA
6654623;;M;69;CHILENO;;Silencioso;"";"";179990;2;1;0;0;0;2;1;179990;CELULAR A22 128GB NEGRO;TELEFONIA
6573015;;M;69;CHILENO;;Silencioso;RENCA                         ;METROPOLITANA;109990;2;1;0;0;0;2;1;109990;CELULAR MOTO G20 EDICION ESPECIAL 4/128 GB VERDE;TELEFONIA
9790776;;F;57;CHILENO;;Boomers;CONTULMO                      ;BIO BIO;158980;2;2;0;0;0;2;2;158980;CELULAR A12 128GB Azul OPEN;TELEFONIA
17009158;;F;33;CHILENO;;Millenial;TEMUCO                        ;ARAUCANIA;99990;1;1;1;1;99990;0;0;0;CELULAR VIVO Y11S PHANTOM BLACK OPEN;TELEFONIA
11058305;Viudo;F;56;CHILENO;;Boomers;RENCA                         ;METROPOLITANA;59990;2;1;0;0;0;2;1;59990;SMARTPHONE A03S 32 GB ROJO;TELEFONIA
24670306;Soltero;F;49;BOLIVIANO;;Extranjero;PROVIDENCIA                   ;METROPOLITANA;148970;3;1;0;0;0;3;1;148970;CELULAR REDMI 9A 32GB PEACOCK GREEN;TELEFONIA
6010219;Casado;M;73;CHILENO;;Silencioso;CURACAUTIN                    ;ARAUCANIA;25981;3;1;0;0;0;3;1;25981;CELULAR NOKIA 110 BLACK OPEN;TELEFONIA
19060083;;M;25;CHILENO;;Z;PROVIDENCIA                   ;METROPOLITANA;309990;1;1;0;0;0;1;1;309990;CELULAR SMARTPHONE A52S 5G BLACK 128GB;TELEFONIA
12598679;;F;47;CHILENO;;X;LOS VILOS                     ;COQUIMBO;509980;2;2;0;0;0;2;2;509980;CELULAR MOTO G60S 6/128 GB AZUL;TELEFONIA
18822318;;F;28;CHILENO;;Millenial;N/D;N/D;209980;2;1;2;1;209980;0;0;0;MOTOROLA MOTO G50 AZUL 128 GB WOM;TELEFONIA
15929892;Soltero;F;36;CHILENO;PROFESOR;Millenial;PROVIDENCIA                   ;METROPOLITANA;239990;1;1;0;0;0;1;1;239990;CELULAR RENO5 LITE VIOLETA 128GB;TELEFONIA
9796578;;F;62;ECUATORIANO;;Extranjero;MELIPILLA                     ;METROPOLITANA;109990;1;1;0;0;0;1;1;109990;CELULAR VIVO Y11S 32GB NEBULA BLUE OPEN;TELEFONIA
17017080;;F;33;CHILENO;;Millenial;N/D;N/D;294990;2;1;0;0;0;2;1;294990;CELULAR SMARTPHONE A52S 5G LIGHT VIOLET 128GB;TELEFONIA
4963289;;F;80;CHILENO;;Silencioso;VALPARAISO                    ;VALPARAISO;101980;3;1;0;0;0;3;1;101980;Celular XIAOMI REDMI 9 64 GB DIRECTO CLARO NEGRO;TELEFONIA
18586883;;F;28;CHILENO;;Millenial;VICTORIA                      ;ARAUCANIA;389980;3;2;1;1;129990;2;1;259990;CELULAR SMARTPHONE A52S 5G BLACK 128GB;TELEFONIA
10797709;;F;59;CHILENO;;Boomers;PROVIDENCIA                   ;METROPOLITANA;89990;1;1;0;0;0;1;1;89990;CELULAR REDMI 9A 32GB PEACOCK GREEN;TELEFONIA
17656078;;F;31;CHILENO;;Millenial;CALAMA                        ;ANTOFAGASTA;255970;3;1;0;0;0;3;1;255970;CELULAR A22 128GB NEGRO;TELEFONIA
12757590;;F;49;CHILENO;;X;N/D;N/D;185980;4;1;0;0;0;4;1;185980;CELULAR XIAOMI REDMI 9A 2/32GB GRANITE GRAY;TELEFONIA
11590465;;F;52;CHILENO;;X;VALDIVIA                      ;LOS LAGOS;94990;1;1;0;0;0;1;1;94990;CELULAR REDMI 9A 32GB SKY BLUE;TELEFONIA
6760925;;M;72;CHILENO;;Silencioso;LA SERENA                     ;COQUIMBO;229860;4;2;0;0;0;4;2;229860;CELULAR A12 128GB Rojo OPEN;TELEFONIA
8501731;;F;62;CHILENO;;Boomers;RANCAGUA                      ;L.G.B.OÂ´HIGGINS;89991;2;1;0;0;0;2;1;89991;CELULAR MOTO E7 32GB GRIS OPEN;TELEFONIA
13599399;;F;43;CHILENO;;X;LONGAVI                       ;MAULE;127980;2;1;0;0;0;2;1;127980;SMARTPHONE A03S 32 GB ROJO;TELEFONIA
5612946;Casado;F;75;CHILENO;;Silencioso;CHILLAN                       ;BIO BIO;112980;2;1;0;0;0;2;1;112980;CELULAR SMARTPHONE 1B ALCATEL PRIME BLACK;TELEFONIA
22625023;;F;31;PERUANO;;Extranjero;IQUIQUE                       ;TARAPACA;1520920;9;5;1;1;109990;8;4;1410930;CELULAR A32 128 GB BLUE OPEN;TELEFONIA
20101140;;F;23;CHILENO;;Z;"";"";331820;4;2;4;2;331820;0;0;0;CELULAR MOTO G60S 6/128 GB AZUL;TELEFONIA
11666227;;F;52;CHILENO;;X;PROVIDENCIA                   ;METROPOLITANA;473951;6;5;1;1;169990;5;4;303961;CELULAR A32 128 GB BLACK OPEN;TELEFONIA
12393197;Soltero;F;49;CHILENO;;X;RENCA                         ;METROPOLITANA;167460;3;2;0;0;0;3;2;167460;CELULAR AZUMI L4G BLACK CLARO;TELEFONIA
12366195;;M;49;CHILENO;;X;LITUECHE                      ;L.G.B.OÂ´HIGGINS;454970;4;5;0;0;0;4;5;454970;CELULAR VIVO Y21S MIDNIGHT BLUE 128 GB OPEN;TELEFONIA
15761647;;M;37;CHILENO;;Millenial;PROVIDENCIA                   ;METROPOLITANA;309990;1;1;0;0;0;1;1;309990;CELULAR SMARTPHONE A52S 5G BLACK 128GB;TELEFONIA
14113194;;M;40;CHILENO;;X;ANTOFAGASTA                   ;ANTOFAGASTA;630320;7;2;0;0;0;7;2;630320;CELULAR MOTO G30 GRIS TORNASOL 128GB MOVISTAR;TELEFONIA
15113390;;F;39;CHILENO;;X;RANCAGUA                      ;L.G.B.OÂ´HIGGINS;89990;1;5;0;0;0;1;5;89990;CELULAR MOTO E7 32GB GRIS OPEN;TELEFONIA
10476918;Soltero;F;60;CHILENO;;Boomers;RENCA                         ;METROPOLITANA;138980;3;1;0;0;0;3;1;138980;CELULAR MOTOROLA MOTO G20 64GB ROSA FLAMINGO;TELEFONIA
14071120;Casado;M;41;CHILENO;;X;PROVIDENCIA                   ;METROPOLITANA;129990;1;1;0;0;0;1;1;129990;SMARTPHONE A03S AZUL 32GB;TELEFONIA
6043008;;M;72;CHILENO;;Silencioso;RENCA                         ;METROPOLITANA;49990;2;1;0;0;0;2;1;49990;CELULAR VIVO Y11S 32GB NEBULA BLUE OPEN;TELEFONIA
20208358;;M;22;CHILENO;;Z;N/D;N/D;289980;3;4;1;1;15990;2;3;273990;CELULAR REDMI NOTE 10S 128GB ONIX BLACK;TELEFONIA
18167371;;F;30;CHILENO;;Millenial;PROVIDENCIA                   ;METROPOLITANA;119990;1;1;0;0;0;1;1;119990;Celular XIAOMI REDMI 9 64 GB DIRECTO CLARO NEGRO;TELEFONIA
6304387;Soltero;M;71;CHILENO;;Silencioso;RENCA                         ;METROPOLITANA;51990;2;1;0;0;0;2;1;51990;CELULAR VIVO Y11S PHANTON BLACK 32GB MOVISTAR;TELEFONIA
19411615;Soltero;M;25;CHILENO;;Z;SAN PEDRO                     ;METROPOLITANA;538980;3;1;0;0;0;3;1;538980;CELULAR GALAXY S20FE 128GB ClOUD NAVY OPEN;TELEFONIA
19213552;;F;25;CHILENO;;Z;ISLA DE MAIPO;METROPOLITANA;69990;2;1;0;0;0;2;1;69990;CELULAR VIVO Y11S 32 GB NEBULA BLUE WOM;TELEFONIA
17987301;;F;31;CHILENO;;Millenial;PARRAL                        ;MAULE;109990;1;1;0;0;0;1;1;109990;CELULAR VIVO Y11S 32GB NEBULA BLUE OPEN;TELEFONIA
12936210;;F;47;CHILENO;;X;COIHAIQUE                     ;AYSEN;399970;3;2;0;0;0;3;2;399970;CELULAR MOTO G20 EDICION ESPECIAL 4/128 GB AZUL;TELEFONIA
22286559;;F;41;BOLIVIANO;;Extranjero;PROVIDENCIA                   ;METROPOLITANA;192981;4;1;0;0;0;4;1;192981;CELULAR A12 128GB Rojo OPEN;TELEFONIA
6664215;;F;70;CHILENO;;Silencioso;ARAUCO                        ;BIO BIO;99990;1;1;0;0;0;1;1;99990;CELULAR CLARO MOTOROLA E7 32GB GRIS;TELEFONIA
7723852;;F;66;CHILENO;;Boomers;RENCA                         ;METROPOLITANA;204990;2;1;0;0;0;2;1;204990;CELULAR VIVO Y53S FANTASTIC RAINBOW 128GB OPEN;TELEFONIA
10539378;;M;52;CHILENO;;X;LA SERENA                     ;COQUIMBO;585940;7;4;0;0;0;7;4;585940;CELULAR A12 128GB Rojo OPEN;TELEFONIA
17874547;;F;31;CHILENO;;Millenial;SAN VICENTE                   ;L.G.B.OÂ´HIGGINS;829960;4;2;0;0;0;4;2;829960;CELULAR SMARTPHONE A52S 5G LIGHT VIOLET 128GB;TELEFONIA
13372192;;F;45;CHILENO;;X;SAN JAVIER                    ;MAULE;140980;2;1;0;0;0;2;1;140980;CELULAR MOTO G20 EDICION ESPECIAL 4/128 GB AZUL;TELEFONIA
20531350;;F;22;CHILENO;;Z;PROVIDENCIA                   ;METROPOLITANA;299990;1;1;0;0;0;1;1;299990;CELULAR SMARTPHONE A52S 5G LIGHT VIOLET 128GB;TELEFONIA
15045974;Soltero;M;39;CHILENO;;X;RENCA                         ;METROPOLITANA;119990;1;1;0;0;0;1;1;119990;SMARTPHONE A03S 32 GB ROJO;TELEFONIA
13505374;;M;44;CHILENO;;X;PENALOLEN                     ;METROPOLITANA;119990;2;1;0;0;0;2;1;119990;CELULAR A12 128GB Rojo OPEN;TELEFONIA
15697790;;F;38;CHILENO;;X;SAN FERNANDO                  ;L.G.B.OÂ´HIGGINS;588049;4;2;0;0;0;4;2;588049;CELULAR MOTO G20 64GB ROSA FLAMINGO OPEN;TELEFONIA
16567744;;M;35;CHILENO;;Millenial;BUIN                          ;METROPOLITANA;810890;11;5;11;5;810890;0;0;0;SMARTPHONE A52S 5G WHITE 128GB;TELEFONIA
12090185;;M;53;CHILENO;;X;LOS ANGELES                   ;BIO BIO;59990;2;1;0;0;0;2;1;59990;CELULAR VIVO Y11S 32GB NEBULA BLUE OPEN;TELEFONIA
17894851;;M;31;CHILENO;;Millenial;PROVIDENCIA                   ;METROPOLITANA;323980;2;1;2;1;323980;0;0;0;CELULAR IPHONE SE 64GB DIRECTO CLARO;TELEFONIA
6939600;;M;66;CHILENO;;Boomers;RANCAGUA                      ;L.G.B.OÂ´HIGGINS;499971;4;2;0;0;0;4;2;499971;CELULAR SMARTPHONE A52S 5G BLACK 128GB;TELEFONIA
15350894;;M;40;CHILENO;;X;ALTO HOSPICIO;TARAPACA;219990;1;1;0;0;0;1;1;219990;CELULAR MOTO G9 POWER 128GB MORADO SONICO OPEN;TELEFONIA
16991890;;M;33;CHILENO;;Millenial;PROVIDENCIA                   ;METROPOLITANA;89990;1;1;0;0;0;1;1;89990;CELULAR XIAOMI REDMI 9A 32GB GRANITE GRAY TRI WO;TELEFONIA
18066485;Soltero;F;29;CHILENO;TECNICO SUPERIOR EN ODONTOLOGIA;Millenial;PROVIDENCIA                   ;METROPOLITANA;99990;1;1;1;1;99990;0;0;0;CELULAR NOKIA 5.3 CHARCOAL TRI ENTEL;TELEFONIA
10993780;;F;56;CHILENO;;Boomers;SAN RAMON                     ;METROPOLITANA;299990;1;1;0;0;0;1;1;299990;CELULAR SMARTPHONE A52S 5G BLACK 128GB;TELEFONIA
9045672;;M;62;CHILENO;;Boomers;LOS ANDES                     ;VALPARAISO;419970;6;2;0;0;0;6;2;419970;CELULAR IPHONE SE 64GB DIRECTO CLARO;TELEFONIA
17080326;;F;33;CHILENO;;Millenial;NUNOA                         ;METROPOLITANA;394980;2;1;2;1;394980;0;0;0;CELULAR XIAOMI 11T 8/256GB CELESTIAL BLUE OPEN;TELEFONIA
15015685;;M;39;CHILENO;;X;CALAMA                        ;ANTOFAGASTA;36990;1;1;0;0;0;1;1;36990;CELULAR NOKIA 225 4G BLACK MOVISTAR DIRECTO;TELEFONIA
6335238;;M;70;CHILENO;;Silencioso;LOTA                          ;BIO BIO;17990;1;1;0;0;0;1;1;17990;TELEFONO PP BINDU ENTEL;TELEFONIA
15015733;Soltero;M;39;CHILENO;;X;PROVIDENCIA                   ;METROPOLITANA;99990;1;1;1;1;99990;0;0;0;CELULAR NOKIA 5.3 CHARCOAL TRI ENTEL;TELEFONIA
7818316;;F;62;CHILENO;;Boomers;PEDRO AGUIRRE CERDA           ;METROPOLITANA;84990;1;1;0;0;0;1;1;84990;CELULAR CLARO MOTOROLA E7 32GB GRIS;TELEFONIA
17990339;Soltero;F;30;CHILENO;PROFESOR;Millenial;CHILLAN                       ;BIO BIO;899990;1;1;0;0;0;1;1;899990;CELULAR IPHONE 12 128GB WHITE CLARO;TELEFONIA
19576454;;M;24;CHILENO;;Z;LONGAVI                       ;MAULE;266970;3;2;0;0;0;3;2;266970;CELULAR A12 128GB Azul OPEN;TELEFONIA
11133167;;M;54;CHILENO;;Boomers;CURICO                        ;MAULE;233980;2;1;0;0;0;2;1;233980;XIAOMI REDMI 9T GRIS WOM 128 GB;TELEFONIA
22569696;;M;49;PERUANO;;Extranjero;TALCA                         ;MAULE;90980;2;3;0;0;0;2;3;90980;CELULAR SMARTPHONE A52S 5G BLACK 128GB;TELEFONIA
10955930;Casado;M;53;CHILENO;;X;CONSTITUCION                  ;MAULE;99990;1;1;0;0;0;1;1;99990;SMARTPHONE A03S 32 GB ROJO;TELEFONIA
10364867;;F;57;CHILENO;;Boomers;VALLENAR;ATACAMA;380970;3;2;0;0;0;3;2;380970;POCO X3 PRO US 128G METAL BRONZE;TELEFONIA
9360176;;M;61;CHILENO;;Boomers;PEUMO                         ;L.G.B.OÂ´HIGGINS;154980;3;2;0;0;0;3;2;154980;CELULAR VIVO Y11S 32 GB NEBULA BLUE WOM;TELEFONIA
26283077;;M;36;EXTRANJERO - NO INFORMA NACIONALIDAD;;Extranjero;TALCAHUANO                    ;BIO BIO;852970;3;2;2;1;152980;1;1;699990;CELULAR IPHONE 12 64GB BLACK CLARO;TELEFONIA
11556360;;M;51;CHILENO;;X;SANTA CRUZ                    ;L.G.B.OÂ´HIGGINS;741980;3;1;0;0;0;3;1;741980;CELULAR SAMSUNG S21 FE 128GB WHITE OPEN;TELEFONIA
12235175;;M;50;CHILENO;;X;PROVIDENCIA                   ;METROPOLITANA;119990;1;1;0;0;0;1;1;119990;CELULAR VIVO Y11S 32GB NEBULA BLUE OPEN;TELEFONIA
17202762;Soltero;M;32;CHILENO;;Silencioso;PROVIDENCIA                   ;METROPOLITANA;824970;3;2;3;2;824970;0;0;0;CELULAR IPHONE 12 PRO MAX 128GB AZUL CLARO;TELEFONIA
7746909;;F;68;CHILENO;;Silencioso;N/D;N/D;119990;1;1;0;0;0;1;1;119990;CELULAR VIVO Y11S 32GB NEBULA BLUE OPEN;TELEFONIA
16885771;Soltero;F;34;CHILENO;TECNICO DE NIVEL SUPERIOR EN ENFERMERIA;Millenial;"";"";104980;2;1;2;1;104980;0;0;0;CELULAR HUAWEI Y7A VERDE OPEN;TELEFONIA
17913644;;F;30;CHILENO;;Millenial;PROVIDENCIA                   ;METROPOLITANA;311960;4;2;0;0;0;4;2;311960;CELULAR XIAOMI REDMI 9 64GB DIRECTO CLARO MORADO;TELEFONIA
7052888;Casado;M;68;CHILENO;INGENIERO AGRICOLA;Silencioso;PROVIDENCIA                   ;METROPOLITANA;54990;2;1;0;0;0;2;1;54990;CELULAR CLARO MOTOROLA E7 32GB GRIS;TELEFONIA
14437117;;M;50;CHILENO;;X;RENCA                         ;METROPOLITANA;117983;3;2;0;0;0;3;2;117983;CELULAR REDMI 9A 32GB PEACOCK GREEN;TELEFONIA
15403231;;F;40;CHILENO;;Millenial;"";"";298960;4;2;0;0;0;4;2;298960;CELULAR POCO X3 PRO 256 GB FROST BLUE;TELEFONIA
13674476;;M;43;CHILENO;;X;N/D;N/D;99990;1;1;0;0;0;1;1;99990;CELULAR VIVO Y11S 32GB NEBULA BLUE OPEN;TELEFONIA
18648869;;F;27;CHILENO;;Millenial;PROVIDENCIA                   ;METROPOLITANA;39992;2;2;0;0;0;2;2;39992;CELULAR NOKIA QUEEN VALUE BLACK CLARO;TELEFONIA
14006772;;M;40;CHILENO;;X;MELIPILLA                     ;METROPOLITANA;532980;2;1;0;0;0;2;1;532980;CELULAR XIAOMI 11T PRO 8/256GB METEORITE GRAY;TELEFONIA
10395998;;M;54;CHILENO;;X;PEDRO AGUIRRE CERDA;METROPOLITANA;99990;1;1;0;0;0;1;1;99990;CELULAR CLARO MOTOROLA E7 32GB GRIS;TELEFONIA
5814960;;M;71;CHILENO;;Silencioso;MAIPU                         ;METROPOLITANA;51990;2;1;0;0;0;2;1;51990;CELULAR VIVO Y11S PHANTON BLACK 32GB MOVISTAR;TELEFONIA
13051561;;M;45;CHILENO;;X;LA CISTERNA                   ;METROPOLITANA;139990;1;3;1;3;139990;0;0;0;CELULAR MOTO G20 EDICION ESPECIAL 4/128 GB VERDE;TELEFONIA
16274940;;M;36;CHILENO;;Millenial;YERBAS BUENAS                 ;MAULE;129990;1;1;0;0;0;1;1;129990;SMARTPHONE A03S NEGRO 32GB;TELEFONIA
13607863;;F;43;CHILENO;;X;TIERRA AMARILLA               ;ATACAMA;156980;2;1;0;0;0;2;1;156980;CELULAR VIVO Y11S 32GB NEBULA BLUE OPEN;TELEFONIA
12956264;;F;46;CHILENO;;X;VILLA ALEMANA                 ;VALPARAISO;126980;3;1;0;0;0;3;1;126980;CELULAR REDMI NOTE 8 2021 64GB MOONLIGHT WHITE;TELEFONIA
14681972;;M;66;PERUANO;;Extranjero;INDEPENDENCIA                 ;METROPOLITANA;673740;5;4;0;0;0;5;4;673740;CELULAR A54 OPPO AZUL 128GB;TELEFONIA
18051024;Soltero;M;30;CHILENO;;Millenial;PROVIDENCIA                   ;METROPOLITANA;129990;1;1;0;0;0;1;1;129990;CELULAR VIVO Y20 BLACK 64GB MOVISTAR;TELEFONIA
4459155;;M;76;CHILENO;;Silencioso;CURANILAHUE                   ;BIO BIO;39990;1;1;0;0;0;1;1;39990;CELULAR NOKIA QUEEN VALUE BLACK CLARO;TELEFONIA
17814090;;F;34;CHILENO;;Millenial;QUILICURA                     ;METROPOLITANA;279980;2;2;0;0;0;2;2;279980;CELULAR MOTO G30 128GB LILA PASTEL OPEN;TELEFONIA
16584020;;M;35;CHILENO;;Millenial;ALTO HOSPICIO;TARAPACA;149990;1;1;0;0;0;1;1;149990;CELULAR REDMI NOTE 9 128G FOREST GREEN OPEN;TELEFONIA
10282571;;F;59;CHILENO;;Boomers;CURICO                        ;MAULE;299990;1;1;0;0;0;1;1;299990;CELULAR SMARTPHONE A52S 5G LIGHT VIOLET 128GB;TELEFONIA
15253386;;F;38;CHILENO;;X;TEMUCO                        ;ARAUCANIA;147980;2;2;0;0;0;2;2;147980;VIVO Y20 OBSIDIAN BLACK OPEN;TELEFONIA
26121663;;M;26;HAITIANO;;Extranjero;MELIPILLA                     ;METROPOLITANA;89990;1;1;0;0;0;1;1;89990;CELULAR VIVO Y11S PHANTON BLACK 32GB MOVISTAR;TELEFONIA
19751728;;F;25;CHILENO;;Silencioso;PROVIDENCIA                   ;METROPOLITANA;279990;1;1;1;1;279990;0;0;0;CELULAR SMARTPHONE A52S 5G BLACK 128GB;TELEFONIA
16448697;;M;35;CHILENO;;Millenial;PROVIDENCIA;METROPOLITANA;139990;1;1;1;1;139990;0;0;0;CELULAR MOTO G30 128GB GRIS TORNASOL OPEN;TELEFONIA
19804160;;F;24;CHILENO;;Z;PUDAHUEL;METROPOLITANA;217930;7;2;7;2;217930;0;0;0;CELULAR MOTOROLA E7 IPOWER 32GB BLUE CLARO;TELEFONIA
25758152;Soltero;M;34;VENEZOLANO;;Extranjero;PROVIDENCIA                   ;METROPOLITANA;254990;2;1;0;0;0;2;1;254990;CELULAR SMARTPHONE A52S 5G LIGHT GREEN 128GB;TELEFONIA
15075371;;F;40;CHILENO;;X;N/D;N/D;530940;7;3;4;2;384960;3;1;145980;SMARTHPHONE REDMI 10 US 64GB SEA BLUE;TELEFONIA
19196662;Soltero;M;26;CHILENO;;Z;PROVIDENCIA                   ;METROPOLITANA;189990;1;1;1;1;189990;0;0;0;CELULAR A32 128 GB LIGHT VIOLET OPEN;TELEFONIA
13583276;;F;43;CHILENO;;X;CUNCO                         ;ARAUCANIA;169980;3;2;0;0;0;3;2;169980;CELULAR A22 128GB NEGRO;TELEFONIA
12434324;;M;49;CHILENO;;X;CALBUCO                       ;LOS LAGOS;186980;2;1;0;0;0;2;1;186980;CELULAR MOTO G20 EDICION ESPECIAL 4/128 GB AZUL;TELEFONIA
6602443;;M;64;CHILENO;;Boomers;PROVIDENCIA                   ;METROPOLITANA;149990;1;1;0;0;0;1;1;149990;CELULAR VIVO Y20S NEBULA 128 GB BLUE OPEN;TELEFONIA
11879941;;F;51;CHILENO;;X;LA SERENA                     ;COQUIMBO;504930;8;1;0;0;0;8;1;504930;POCO X3 PRO 256 GB PHANTOM BLACK;TELEFONIA
18685878;Soltero;M;27;CHILENO;;Millenial;TALCAHUANO;BIO-BIO;599990;1;1;1;1;599990;0;0;0;CELULAR IPHONE 12 MINI 64GB BLACK CLARO;TELEFONIA
5847897;Soltero;M;72;CHILENO;;Silencioso;OVALLE                        ;COQUIMBO;168983;3;2;0;0;0;3;2;168983;CELULAR REDMI 9T 128 GB OCEAN GREEN;TELEFONIA
12739739;;M;47;CHILENO;;X;RENCA                         ;METROPOLITANA;149990;1;1;0;0;0;1;1;149990;CELULAR A12 128GB Rojo OPEN;TELEFONIA
10211899;;F;53;CHILENO;;X;CHILLAN                       ;BIO BIO;677950;7;3;0;0;0;7;3;677950;CELULAR REDMI 9C 32GB MIDNIGHT GRAY;TELEFONIA
18212584;;F;30;CHILENO;;Millenial;MELIPILLA                     ;METROPOLITANA;459970;3;4;0;0;0;3;4;459970;CELULAR Moto G20 Blue WOM;TELEFONIA
18979556;Soltero;M;26;CHILENO;PROFESOR;Z;PROVIDENCIA                   ;METROPOLITANA;799990;1;1;1;1;799990;0;0;0;Celular Galaxy S21 Ultra Phantom Black 128GB;TELEFONIA
13110935;;F;50;CHILENO;;X;MELIPILLA                     ;METROPOLITANA;99990;1;1;0;0;0;1;1;99990;CELULAR VIVO Y11S 32GB NEBULA BLUE OPEN;TELEFONIA
10330447;;F;60;CHILENO;;Boomers;VICTORIA                      ;ARAUCANIA;129990;1;1;0;0;0;1;1;129990;CELULAR Moto G20 Rosado WOM;TELEFONIA
16668966;;F;34;CHILENO;;Millenial;CANETE                        ;BIO BIO;99990;1;1;0;0;0;1;1;99990;VIVO Y20 OBSIDIAN BLACK OPEN;TELEFONIA
15067106;;M;41;CHILENO;;X;LLAILLAY                      ;VALPARAISO;129990;1;1;0;0;0;1;1;129990;CELULAR MOTO G20 64GB AZUL OPEN;TELEFONIA
16310139;;M;35;CHILENO;;Millenial;SAN FERNANDO                  ;L.G.B.OÂ´HIGGINS;239990;1;1;0;0;0;1;1;239990;POCO X3 PRO 256 GB PHANTOM BLACK;TELEFONIA
19164235;;F;26;CHILENO;;Z;PENAFLOR                      ;METROPOLITANA;0;0;2;0;2;0;0;0;0;CELULAR NOKIA 5.3 CHARCOAL TRI ENTEL;TELEFONIA
19449900;;F;25;CHILENO;;Z;PROVIDENCIA                   ;METROPOLITANA;864980;2;1;0;0;0;2;1;864980;Celular Galaxy S21 Ultra Phantom Silver 128GB;TELEFONIA
17297635;;F;33;CHILENO;;Millenial;PUERTO MONTT                  ;LOS LAGOS;119990;1;1;0;0;0;1;1;119990;CELULAR REDMI 9 64GB CARBON GREY;TELEFONIA
26079303;;M;31;VENEZOLANO;;Extranjero;TALAGANTE                     ;METROPOLITANA;144990;2;1;0;0;0;2;1;144990;REDMI 10 US 128GB Carbon Gray;TELEFONIA
15042479;;M;40;CHILENO;;X;RIO HURTADO                   ;COQUIMBO;462540;5;3;0;0;0;5;3;462540;CELULAR MOTOROLA G9 PLAY 64GB BLUE DIRECTO CLAR;TELEFONIA
11326344;;F;54;CHILENO;;X;FREIRINA                      ;ATACAMA;139990;1;1;0;0;0;1;1;139990;CELULAR MOTO G20 AZUL 128GB MOVISTAR;TELEFONIA
16169132;Soltero;F;37;CHILENO;;Silencioso;PROVIDENCIA                   ;METROPOLITANA;189990;1;1;1;1;189990;0;0;0;CELULAR A32 128 GB LIGHT VIOLET OPEN;TELEFONIA
16070723;;M;37;CHILENO;;Millenial;QUILICURA;METROPOLITANA;663980;2;1;2;1;663980;0;0;0;Celular Galaxy S21 Plus Phantom Silver 128GB;TELEFONIA
19224759;;F;26;CHILENO;;Z;VICTORIA                      ;ARAUCANIA;730961;5;3;0;0;0;5;3;730961;CELULAR NOKIA 110 BLACK OPEN;TELEFONIA
23816428;;F;46;COLOMBIANO;;Extranjero;SANTIAGO                      ;METROPOLITANA;2310070;16;4;0;0;0;16;4;2310070;CELULAR Moto G20 Rosado WOM;TELEFONIA
19562212;;F;25;CHILENO;;Millenial;"";"";154980;2;2;0;0;0;2;2;154980;CELULAR A12 128GB Negro OPEN;TELEFONIA
12270307;;F;50;CHILENO;;X;COLINA                        ;METROPOLITANA;79990;1;1;0;0;0;1;1;79990;CELULAR Moto E7 Rosado WOM;TELEFONIA
10507945;;M;59;CHILENO;;Boomers;MOSTAZAL                      ;L.G.B.OÂ´HIGGINS;156980;2;1;0;0;0;2;1;156980;SMARTPHONE A03S 32 GB ROJO;TELEFONIA
7864458;;M;62;CHILENO;;Boomers;RIO IBANEZ                    ;AYSEN;199990;1;1;0;0;0;1;1;199990;CELULAR POCO X3 PRO 128G PHANTOM BLACK OPEN;TELEFONIA
18823102;;F;27;CHILENO;;Z;N/D;N/D;156981;3;2;0;0;0;3;2;156981;SMARTPHONE A03S 32 GB ROJO;TELEFONIA
7503167;;F;72;CHILENO;;Silencioso;TALCAHUANO                    ;BIO BIO;34990;1;1;0;0;0;1;1;34990;CELULAR NOKIA 225 4G BLACK MOVISTAR DIRECTO;TELEFONIA
10952348;Soltero;F;54;CHILENO;PROFESOR;X;RENCA                         ;METROPOLITANA;139990;1;1;0;0;0;1;1;139990;CELULAR A12 128GB Azul OPEN;TELEFONIA
13793582;;M;42;CHILENO;;X;PROVIDENCIA                   ;METROPOLITANA;433980;2;1;2;1;433980;0;0;0;CELULAR XIAOMI 11T 8/256GB CELESTIAL BLUE KIT;TELEFONIA
18959477;;F;27;CHILENO;;Z;N/D;N/D;209990;1;1;0;0;0;1;1;209990;CELULAR A32 128 GB LIGHT VIOLET OPEN;TELEFONIA
13642888;;F;43;CHILENO;;X;PROVIDENCIA                   ;METROPOLITANA;401960;4;1;0;0;0;4;1;401960;CELULAR SAMSUNG A12 128GB BLACK CLARO;TELEFONIA
12889971;;M;47;CHILENO;;Millenial;N/D;N/D;204980;2;2;1;1;179990;1;1;24990;CELULAR A32 128 GB LIGHT VIOLET OPEN;TELEFONIA
16778215;;M;33;CHILENO;;Millenial;PROVIDENCIA                   ;METROPOLITANA;121990;2;1;0;0;0;2;1;121990;CELULAR MOTO G30 GRIS TORNASOL 128GB MOVISTAR;TELEFONIA
19911363;;M;23;CHILENO;;Extranjero;N/D;N/D;89990;1;1;0;0;0;1;1;89990;CELULAR MOTO E7 GRIS MINERAL MOVISTAR;TELEFONIA
10387167;;F;57;CHILENO;;Boomers;LOS ANDES                     ;VALPARAISO;308980;2;1;0;0;0;2;1;308980;CELULAR XIAOMI POCO X3 PRO 128GB PANTHOM BLACK;TELEFONIA
25590918;;M;45;HAITIANO;;Extranjero;CANELA                        ;COQUIMBO;581840;5;2;0;0;0;5;2;581840;CELULAR MOTO G30 128GB GRIS TORNASOL OPEN;TELEFONIA
15896318;;M;37;CHILENO;;Millenial;OSORNO                        ;LOS LAGOS;289990;1;1;0;0;0;1;1;289990;CELULAR SMARTPHONE A52S 5G BLACK 128GB;TELEFONIA
17963915;;M;31;CHILENO;;Millenial;N/D;N/D;329950;5;2;2;1;195980;3;1;133970;CELULAR MOTO E6I 32GB GRIS OPEN;TELEFONIA
26116009;;F;26;VENEZOLANO;;Extranjero;N/D;N/D;153980;2;1;2;1;153980;0;0;0;CELULAR MOTO G30 GRIS TORNASOL 128GB MOVISTAR;TELEFONIA
15602238;;M;39;CHILENO;;X;CONCHALI;METROPOLITANA;191970;3;2;3;2;191970;0;0;0;SMARTHPHONE REDMI 10 US 64GB SEA BLUE;TELEFONIA
13540966;;M;43;CHILENO;;X;N/D;N/D;59980;2;1;0;0;0;2;1;59980;Celular NOKIA 1.3 NEGRO WOM;TELEFONIA
15271135;;F;39;CHILENO;;X;N/D;N/D;435960;4;1;0;0;0;4;1;435960;REDMI 10 US 128GB Carbon Gray;TELEFONIA
7645793;;M;67;CHILENO;;Boomers;LAS CONDES                    ;METROPOLITANA;230980;2;1;0;0;0;2;1;230980;POCO X3 PRO 256 GB PHANTOM BLACK;TELEFONIA
20022545;;M;23;CHILENO;;Z;N/D;N/D;304970;3;3;0;0;0;3;3;304970;CELULAR Redmi 9C 32GB Gray WOM;TELEFONIA
10542907;;M;49;CHILENO;;X;RENCA                         ;METROPOLITANA;289990;1;1;1;1;289990;0;0;0;CELULAR SMARTPHONE A52S 5G BLACK 128GB;TELEFONIA
14273255;;M;47;CHILENO;;X;SAN PEDRO DE LA PAZ           ;BIO BIO;335971;4;2;0;0;0;4;2;335971;CELULAR POCO X3 PRO 256 GB FROST BLUE;TELEFONIA
18236514;;F;29;CHILENO;;Millenial;N/D;N/D;185970;3;2;0;0;0;3;2;185970;CELULAR REDMI 9A 32GB PEACOCO GREEN DIREC MOVIST;TELEFONIA
14564759;;F;45;CHILENO;;X;RANCAGUA                      ;L.G.B.OÂ´HIGGINS;39990;2;1;0;0;0;2;1;39990;CELULAR VIVO Y11S 32 GB NEBULA BLUE WOM;TELEFONIA
12204185;;M;49;CHILENO;;X;COCHRANE                      ;AYSEN;513970;3;1;0;0;0;3;1;513970;SMARTPHONE A52S 5G WHITE 128GB;TELEFONIA
19353619;Soltero;M;26;CHILENO;;Z;N/D;N/D;548980;2;1;0;0;0;2;1;548980;CELULAR IPHONE SE 64GB DIRECTO CLARO;TELEFONIA
9180907;;M;58;CHILENO;;Boomers;MELIPILLA                     ;METROPOLITANA;371960;4;1;4;1;371960;0;0;0;IPHONE 6S 64GB PLATA OPEN;TELEFONIA
17941424;;F;31;CHILENO;;Millenial;PROVIDENCIA                   ;METROPOLITANA;1192971;4;2;0;0;0;4;2;1192971;Celular Galaxy S21 Ultra Phantom Black 128GB;TELEFONIA
26689123;;M;32;VENEZOLANO;;Extranjero;SANTIAGO                      ;METROPOLITANA;874980;2;2;0;0;0;2;2;874980;Celular Galaxy S21 Ultra Phantom Silver 128GB;TELEFONIA
18587449;;M;28;CHILENO;;Millenial;PROVIDENCIA                   ;METROPOLITANA;139990;2;1;0;0;0;2;1;139990;CELULAR REDMI 9T 128GB SUNRISE ORANGE MOVISTAR;TELEFONIA
17357614;;F;32;CHILENO;;Millenial;N/D;N/D;104990;2;1;0;0;0;2;1;104990;XIAOMI REDMI 9T GRIS WOM 128 GB;TELEFONIA
18889080;;M;27;CHILENO;;Z;PROVIDENCIA                   ;METROPOLITANA;199990;1;1;0;0;0;1;1;199990;CELULAR VIVO Y21S PEARL WHITE 128 GB OPEN;TELEFONIA
8090789;;F;65;CHILENO;;Boomers;PROVIDENCIA                   ;METROPOLITANA;119990;1;1;0;0;0;1;1;119990;Celular XIAOMI REDMI 9 64 GB DIRECTO CLARO NEGRO;TELEFONIA
13381143;;F;44;CHILENO;;X;BULNES                        ;BIO BIO;328980;2;1;0;0;0;2;1;328980;CELULAR POCO X3 PRO 256 GB FROST BLUE;TELEFONIA
11900583;;M;51;CHILENO;;X;PROVIDENCIA                   ;METROPOLITANA;119990;1;1;0;0;0;1;1;119990;Celular XIAOMI REDMI 9 64 GB DIRECTO CLARO NEGRO;TELEFONIA
17965809;;M;30;CHILENO;;Millenial;SALAMANCA                     ;COQUIMBO;289990;1;1;0;0;0;1;1;289990;CELULAR SMARTPHONE A52S 5G BLACK 128GB;TELEFONIA
7556483;;F;68;CHILENO;;Boomers;VALLENAR;ATACAMA;199990;1;1;0;0;0;1;1;199990;CELULAR POCO X3 PRO 128 GB FROST BLUE;TELEFONIA
12824927;;F;46;CHILENO;;X;PROVIDENCIA                   ;METROPOLITANA;54990;1;1;1;1;54990;0;0;0;CELULAR NOKIA C1 PLUS BLUE;TELEFONIA
10578586;Casado;M;51;CHILENO;;X;PROVIDENCIA                   ;METROPOLITANA;84990;1;1;0;0;0;1;1;84990;CELULAR VIVO Y11S 32GB NEBULA BLUE OPEN;TELEFONIA
14499523;;M;40;CHILENO;;X;PEDRO AGUIRRE CERDA           ;METROPOLITANA;99990;1;1;0;0;0;1;1;99990;CELULAR OPPO A15 BLACK 32GB CLARO;TELEFONIA
13297792;;F;45;CHILENO;;X;SAN BERNARDO                  ;METROPOLITANA;234970;3;3;0;0;0;3;3;234970;VIVO Y20 OBSIDIAN BLACK OPEN;TELEFONIA
16154308;;F;36;CHILENO;;Millenial;CURANILAHUE                   ;BIO BIO;757940;6;3;5;2;447950;1;1;309990;SMARTPHONE A52S 5G WHITE 128GB;TELEFONIA
7800677;;F;67;CHILENO;;Boomers;PARRAL                        ;MAULE;149990;1;1;0;0;0;1;1;149990;CELULAR XIAOMI REDMI 9T TWILIGHT BLUE MOVISTAR;TELEFONIA
8799204;;M;60;CHILENO;;Boomers;MACHALI                       ;L.G.B.OÂ´HIGGINS;94990;1;1;0;0;0;1;1;94990;CELULAR CLARO MOTOROLA E7 32GB GRIS;TELEFONIA
17341590;;F;32;CHILENO;;Millenial;N/D;N/D;703980;2;1;2;1;703980;0;0;0;CELULAR IPHONE 12 64GB BLACK CLARO;TELEFONIA
19355962;;F;25;CHILENO;;Z;ANTOFAGASTA                   ;ANTOFAGASTA;156980;2;1;0;0;0;2;1;156980;SMARTPHONE A03S NEGRO 32GB;TELEFONIA
10005387;;F;57;CHILENO;;Boomers;TALAGANTE                     ;METROPOLITANA;147980;2;2;0;0;0;2;2;147980;CELULAR MOTO G20 AZUL 128GB MOVISTAR;TELEFONIA
20005224;;M;23;CHILENO;;Z;LONCOCHE                      ;ARAUCANIA;99990;1;1;0;0;0;1;1;99990;CELULAR VIVO Y11S 32GB NEBULA BLUE OPEN;TELEFONIA
16036893;;M;37;CHILENO;;Millenial;ERCILLA                       ;ARAUCANIA;169980;2;2;0;0;0;2;2;169980;SMARTPHONE A03S 64 GB NEGRO;TELEFONIA
9573741;;M;58;CHILENO;;Boomers;BULNES                        ;BIO BIO;181980;2;1;0;0;0;2;1;181980;SMARTPHONE A03S AZUL 32GB;TELEFONIA
6765302;;F;67;CHILENO;;Boomers;ARICA                         ;ARICA Y PARINACOTA;39990;1;1;0;0;0;1;1;39990;CELULAR NOKIA QUEEN VALUE BLACK CLARO;TELEFONIA
20242733;;F;22;CHILENO;;Z;PROVIDENCIA                   ;METROPOLITANA;523960;4;2;4;2;523960;0;0;0;CELULAR MOTO G30 128GB GRIS TORNASOL OPEN;TELEFONIA
15108023;;M;37;CHILENO;;Millenial;N/D;N/D;149991;2;1;0;0;0;2;1;149991;CELULAR A12 128GB Negro OPEN;TELEFONIA
6993317;;F;70;CHILENO;;Silencioso;COIHAIQUE                     ;AYSEN;279990;1;1;0;0;0;1;1;279990;CELULAR SMARTPHONE A52S 5G BLACK 128GB;TELEFONIA
27228358;;F;26;EXTRANJERO - NO INFORMA NACIONALIDAD;;Extranjero;N/D;N/D;233980;2;1;2;1;233980;0;0;0;CELULAR RENO5 LITE NEGRO 128GB;TELEFONIA
18557831;;F;28;CHILENO;;Millenial;PROVIDENCIA                   ;METROPOLITANA;171970;4;2;0;0;0;4;2;171970;SMARTPHONE A03S AZUL 32GB;TELEFONIA
15302252;;F;39;CHILENO;;X;CASTRO                        ;LOS LAGOS;299990;1;1;0;0;0;1;1;299990;CELULAR SMARTPHONE A52S 5G BLACK 128GB;TELEFONIA
7955267;;M;61;CHILENO;;Boomers;RENCA                         ;METROPOLITANA;74990;1;1;0;0;0;1;1;74990;Celular LG K22 MOVISTAR DIRECTO TITAN;TELEFONIA
12027451;;F;61;CHILENO;;Boomers;RENGO                         ;L.G.B.OÂ´HIGGINS;990;1;1;0;0;0;1;1;990;CHIP OPEN ENTEL;TELEFONIA
10722910;;M;55;CHILENO;;Boomers;TALCAHUANO                    ;BIO BIO;139990;1;1;1;1;139990;0;0;0;CELULAR MOTO G30 GRIS TORNASOL 128GB MOVISTAR;TELEFONIA
16005042;;M;35;CHILENO;;Silencioso;PROVIDENCIA                   ;METROPOLITANA;129990;1;1;0;0;0;1;1;129990;CELULAR POCO M3 128GB POWER BLACK;TELEFONIA
20142339;;F;23;CHILENO;;Z;N/D;N/D;583980;2;1;2;1;583980;0;0;0;IPHONE 11 128GB BLACK CLARO;TELEFONIA
6549889;;M;66;CHILENO;;Boomers;VILLARICA                     ;ARAUCANIA;129990;1;1;0;0;0;1;1;129990;CELULAR A12 128GB Azul OPEN;TELEFONIA
19502490;;F;24;CHILENO;;Z;PROVIDENCIA                   ;METROPOLITANA;129990;2;1;0;0;0;2;1;129990;CELULAR A12 128GB Rojo OPEN;TELEFONIA
17574919;;F;32;CHILENO;;Millenial;PROVIDENCIA                   ;METROPOLITANA;723960;4;1;4;1;723960;0;0;0;IPHONE 8 64 GB LIB OPEN PLATEADO;TELEFONIA
16160460;;F;36;CHILENO;;Millenial;N/D;N/D;198970;3;2;0;0;0;3;2;198970;CELULAR REDMI NOTE 8 2021 64 GB SPACE BLACK;TELEFONIA
9411257;;M;58;CHILENO;;Boomers;PARRAL                        ;MAULE;174980;2;1;0;0;0;2;1;174980;CELULAR VIVO Y20S OBSIDIAN BLACK 128GB OPEN;TELEFONIA
17747623;;F;32;CHILENO;;Millenial;SANTIAGO                      ;METROPOLITANA;349990;1;1;1;1;349990;0;0;0;CELULAR SMARTPHONE A52S 5G LIGHT VIOLET 128GB;TELEFONIA
16188316;;F;36;CHILENO;;Millenial;PROVIDENCIA                   ;METROPOLITANA;307530;3;1;3;1;307530;0;0;0;CELULAR A12 128GB Rojo OPEN;TELEFONIA
14267297;;F;50;CHILENO;;X;CHILLAN                       ;BIO BIO;179990;1;1;0;0;0;1;1;179990;CELULAR MOTO G30 128GB GRIS TORNASOL OPEN;TELEFONIA
8520485;;M;61;CHILENO;;Millenial;PROVIDENCIA                   ;METROPOLITANA;261220;7;4;0;0;0;7;4;261220;CELULAR NOKIA C1 PLUS BLUE;TELEFONIA
25793863;;M;41;EXTRANJERO - NO INFORMA NACIONALIDAD;;Extranjero;TALCA                         ;MAULE;164980;2;1;0;0;0;2;1;164980;VIVO Y20 OBSIDIAN BLACK OPEN;TELEFONIA
11743247;;F;50;CHILENO;;X;RENCA                         ;METROPOLITANA;119990;1;1;0;0;0;1;1;119990;CELULAR MOTOROLA G20 64GB BLUE CLARO;TELEFONIA
15737926;;M;38;CHILENO;;X;RANCAGUA;O HIGGINS;178970;3;3;1;1;119990;2;2;58980;CELULAR A12 128GB Rojo OPEN;TELEFONIA
16761618;Casado;F;34;CHILENO;;Millenial;PROVIDENCIA                   ;METROPOLITANA;219990;1;1;0;0;0;1;1;219990;CELULAR A32 128 GB BLUE OPEN;TELEFONIA
20682532;;M;31;VENEZOLANO;;Millenial;PROVIDENCIA                   ;METROPOLITANA;583980;2;1;2;1;583980;0;0;0;IPHONE 11 128GB BLACK CLARO;TELEFONIA
9109459;;M;58;CHILENO;;Boomers;RANQUIL                       ;BIO BIO;64990;1;1;0;0;0;1;1;64990;CELULAR MOTOROLA E6 PLAY AZUL TRI WOM;TELEFONIA
16580393;;F;35;CHILENO;;Millenial;COQUIMBO                      ;COQUIMBO;119480;2;3;0;0;0;2;3;119480;Celular SAMSUNG A11 32GB ENTEL DIRECTO NEGRO;TELEFONIA
11721156;Casado;F;50;CHILENO;ABOGADO;X;RENCA                         ;METROPOLITANA;624630;3;1;3;1;624630;0;0;0;SMARTPHONE A52S 5G WHITE 128GB;TELEFONIA
16841011;;F;33;CHILENO;;Millenial;LOS LAGOS                     ;LOS LAGOS;173980;2;1;2;1;173980;0;0;0;SMARTHPHONE REDMI 10 US 64GB SEA BLUE;TELEFONIA
7865878;;M;62;CHILENO;;Boomers;LA SERENA                     ;COQUIMBO;319990;1;1;0;0;0;1;1;319990;CELULAR IPHONE SE 64GB DIRECTO CLARO;TELEFONIA
20306656;;F;22;CHILENO;;Z;N/D;N/D;189980;2;1;0;0;0;2;1;189980;CELULAR A12 128GB Negro OPEN;TELEFONIA
7276929;;M;69;CHILENO;;Silencioso;MELIPILLA                     ;METROPOLITANA;74990;1;1;0;0;0;1;1;74990;CELULAR MOTOROLA E7 IPOWER 32GB BLUE CLARO;TELEFONIA
18012685;;M;29;CHILENO;;Millenial;N/D;N/D;145981;3;2;0;0;0;3;2;145981;CELULAR A12 128GB Negro OPEN;TELEFONIA
10250150;;F;51;CHILENO;;X;QUILPUE                       ;VALPARAISO;160950;3;3;0;0;0;3;3;160950;CELULAR MOTO E7I POWER 32GB BLUE MOVISTAR;TELEFONIA
18385403;;F;29;CHILENO;;Millenial;PROVIDENCIA                   ;METROPOLITANA;784980;2;1;2;1;784980;0;0;0;CELULAR IPHONE 12 128GB WHITE CLARO;TELEFONIA
18559918;;M;28;CHILENO;;Millenial;PROVIDENCIA                   ;METROPOLITANA;59990;1;1;1;1;59990;0;0;0;CELULAR MOTOROLA E6 PLAY AZUL TRI WOM;TELEFONIA
13629808;;F;51;CHILENO;;X;N/D;N/D;100980;2;1;0;0;0;2;1;100980;CELULAR VIVO Y11S NEBULA BLUE 32GB OPEN;TELEFONIA
14551044;;F;48;CHILENO;;X;SAN RAMON                     ;METROPOLITANA;114990;1;1;0;0;0;1;1;114990;CELULAR Moto One Fusion 128GB Blue WOM;TELEFONIA
16580835;;M;35;CHILENO;;Millenial;COQUIMBO;COQUIMBO;149990;2;1;0;0;0;2;1;149990;CELULAR A32 128 GB WHITE OPEN;TELEFONIA
14173474;;M;41;CHILENO;;X;MACUL                         ;METROPOLITANA;189980;2;1;0;0;0;2;1;189980;CELULAR A12 128GB Azul OPEN;TELEFONIA
14470951;;M;51;CHILENO;;X;RENCA                         ;METROPOLITANA;12990;2;1;0;0;0;2;1;12990;CELULAR OWN 1026 AZUL ENTEL;TELEFONIA
13789799;;M;42;CHILENO;;X;ANTOFAGASTA                   ;ANTOFAGASTA;189990;1;1;1;1;189990;0;0;0;CELULAR A32 128 GB BLACK OPEN;TELEFONIA
9197675;Soltero;F;55;CHILENO;;Boomers;QUILLOTA                      ;VALPARAISO;189980;2;1;0;0;0;2;1;189980;CELULAR A12 128GB Azul OPEN;TELEFONIA
26190433;;M;37;CHILENO;;Extranjero;PUERTO MONTT                  ;LOS LAGOS;312970;3;1;0;0;0;3;1;312970;CELULAR Moto One Fusion 128GB Blue WOM;TELEFONIA
19224463;;F;32;CHILENO;;Millenial;VICTORIA                      ;ARAUCANIA;209980;2;1;0;0;0;2;1;209980;CELULAR REDMI 9T 128 GB OCEAN GREEN;TELEFONIA
18811824;;M;27;CHILENO;;Millenial;N/D;N/D;249990;1;1;1;1;249990;0;0;0;POCO X3 PRO 256 GB PHANTOM BLACK;TELEFONIA
18679250;;F;27;CHILENO;;Millenial;CURICO                        ;MAULE;195470;3;2;3;2;195470;0;0;0;IPHONE 5S 16GB DORADO OPEN;TELEFONIA
26497152;;M;36;VENEZOLANO;;Extranjero;N/D;N/D;269980;2;2;0;0;0;2;2;269980;CELULAR MOTO ONE FUSION 128GB AZUL OPEN;TELEFONIA
17964517;;F;31;CHILENO;;Millenial;PAPUDO                        ;VALPARAISO;129990;1;1;0;0;0;1;1;129990;SMARTPHONE A03S NEGRO 32GB;TELEFONIA
15574114;;F;36;CHILENO;;Millenial;OVALLE                        ;COQUIMBO;154990;1;1;0;0;0;1;1;154990;MOTO G30 LILA PASTEL 128GB MOVISTAR;TELEFONIA
16889190;;M;32;CHILENO;;Millenial;N/D;N/D;234970;3;1;0;0;0;3;1;234970;CELULAR MOTOROLA G20 64GB BLUE CLARO;TELEFONIA
22208144;;F;62;PERUANO;;Extranjero;SANTIAGO                      ;METROPOLITANA;979990;2;1;2;1;979990;0;0;0;CELULAR IPHONE 12 PRO MAX 128GB AZUL CLARO;TELEFONIA
6256084;;F;74;CHILENO;;Silencioso;MELIPILLA                     ;METROPOLITANA;349990;1;1;0;0;0;1;1;349990;CELULAR SMARTPHONE A52S 5G BLACK 128GB;TELEFONIA
18844435;;F;26;CHILENO;;Z;N/D;N/D;306970;4;3;0;0;0;4;3;306970;CELULAR VIVO Y11S PHANTON BLACK 32GB MOVISTAR;TELEFONIA
6182442;;M;71;CHILENO;;Silencioso;RANCAGUA                      ;L.G.B.OÂ´HIGGINS;199991;2;1;0;0;0;2;1;199991;CELULAR A32 128 GB BLACK OPEN;TELEFONIA
16707897;;F;34;CHILENO;;Millenial;TEMUCO                        ;ARAUCANIA;229990;1;1;0;0;0;1;1;229990;CELULAR REDMI NOTE 10S 128GB PEBBLE WHITE;TELEFONIA
12336978;;M;49;CHILENO;;X;VILLARICA                     ;ARAUCANIA;124990;1;1;0;0;0;1;1;124990;CELULAR VIVO Y20 BLACK 64GB MOVISTAR;TELEFONIA
18290519;;M;30;CHILENO;;Millenial;N/D;N/D;99990;1;1;0;0;0;1;1;99990;CELULAR XIAOMI REDMI 9 64GB DIRECTO CLARO MORADO;TELEFONIA
19969201;;F;23;CHILENO;;Extranjero;PROVIDENCIA                   ;METROPOLITANA;139990;1;1;1;1;139990;0;0;0;CELULAR A12 128GB Negro OPEN;TELEFONIA
8562332;Casado;F;66;CHILENO;;Boomers;RENCA                         ;METROPOLITANA;569990;1;1;0;0;0;1;1;569990;CELULAR XIAOMI 11T PRO 8/256GB CELESTIAL BLUE KI;TELEFONIA
19241632;Soltero;F;26;CHILENO;;Z;PROVIDENCIA                   ;METROPOLITANA;753980;2;1;2;1;753980;0;0;0;IPHONE 12 128GB BLACK CLARO;TELEFONIA
19449849;;F;25;CHILENO;;Z;PROVIDENCIA                   ;METROPOLITANA;139990;1;1;0;0;0;1;1;139990;CELULAR A12 128GB Azul OPEN;TELEFONIA
19579021;;F;25;CHILENO;;Z;CANETE                        ;BIO BIO;374980;2;1;0;0;0;2;1;374980;CELULAR VIVO Y53S FANTASTIC RAINBOW 128GB OPEN;TELEFONIA
15286695;;F;43;CHILENO;;X;RENCA                         ;METROPOLITANA;490;1;1;0;0;0;1;1;490;KIT PACK OPEN RETAIL 4G TELEFONICA;TELEFONIA
7929201;;M;66;CHILENO;;Boomers;TEODORO SCHMIDT               ;ARAUCANIA;319860;3;2;0;0;0;3;2;319860;CELULAR A02 AZUL 32GB OPEN;TELEFONIA
6511624;;M;66;CHILENO;;Boomers;HUALPEN;BIO BIO;229990;1;1;1;1;229990;0;0;0;POCO X3 PRO 256 GB PHANTOM BLACK;TELEFONIA
18137879;;F;29;CHILENO;;Millenial;CORONEL                       ;BIO BIO;101480;2;1;0;0;0;2;1;101480;CELULAR MOTOROLA E6S GRIS 32GB DIRECTO WOM;TELEFONIA
12794706;;M;46;CHILENO;;X;CAUQUENES                     ;MAULE;199990;1;1;0;0;0;1;1;199990;CELULAR A32 128 GB BLUE OPEN;TELEFONIA
12457640;;M;49;CHILENO;;X;PAINE                         ;METROPOLITANA;969970;4;2;4;2;969970;0;0;0;Celular Z FLIP LIB OPEN PURPLE;TELEFONIA
15551611;;F;42;CHILENO;;X;LO ESPEJO                     ;METROPOLITANA;149990;1;1;0;0;0;1;1;149990;CELULAR A12 128GB Negro OPEN;TELEFONIA
10552404;;M;57;CHILENO;;Boomers;PROVIDENCIA                   ;METROPOLITANA;200480;2;1;0;0;0;2;1;200480;CELULAR A22 128GB NEGRO;TELEFONIA
11918942;;M;49;CHILENO;;X;PENAFLOR                      ;METROPOLITANA;181980;3;1;0;0;0;3;1;181980;CELULAR VIVO Y51 CRYSTAL SYMPHONY OPEN;TELEFONIA
10472223;;F;56;CHILENO;;Boomers;N/D;N/D;79990;1;1;0;0;0;1;1;79990;CELULAR Moto E7 Rosado WOM;TELEFONIA
10900745;;M;54;CHILENO;;Boomers;QUILLOTA                      ;VALPARAISO;79990;1;1;0;0;0;1;1;79990;CELULAR GALAXY A01 32GB AZUL ENTEL;TELEFONIA
10697349;;M;56;CHILENO;;Boomers;CALERA                        ;VALPARAISO;69990;1;1;0;0;0;1;1;69990;CELULAR MOTO E7I POWER 32GB BLUE MOVISTAR;TELEFONIA
23653811;;M;30;BOLIVIANO;;Extranjero;ANTOFAGASTA;ANTOFAGASTA;189990;1;1;1;1;189990;0;0;0;CELULAR POCO X3 PRO 128 GB FROST BLUE;TELEFONIA
13627390;;M;42;CHILENO;;X;N/D;N/D;369980;4;1;0;0;0;4;1;369980;CELULAR POCO X3 PRO 256 GB FROST BLUE;TELEFONIA
18354425;;F;28;CHILENO;;Millenial;OVALLE                        ;COQUIMBO;517610;6;3;5;2;367620;1;1;149990;CELULAR CLARO MOTOROLA E7 32GB GRIS;TELEFONIA
8848374;;M;62;CHILENO;;Boomers;RENCA                         ;METROPOLITANA;34990;1;1;0;0;0;1;1;34990;CELULAR NOKIA 225 4G BLACK MOVISTAR DIRECTO;TELEFONIA
18770519;Soltero;M;28;CHILENO;;Millenial;PROVIDENCIA                   ;METROPOLITANA;569990;1;1;0;0;0;1;1;569990;CELULAR XIAOMI 11T PRO 8/256GB CELESTIAL BLUE KI;TELEFONIA
12362388;;M;48;CHILENO;;X;ANGOL                         ;ARAUCANIA;174980;2;1;0;0;0;2;1;174980;CELULAR A12 128GB Azul OPEN;TELEFONIA
15943714;;F;37;CHILENO;;Millenial;ALGARROBO                     ;VALPARAISO;104980;2;1;2;1;104980;0;0;0;CELULAR XIAOMI REDMI 9 64GB DIRECTO CLARO MORADO;TELEFONIA
16281304;;F;36;CHILENO;;Millenial;EL BOSQUE                     ;METROPOLITANA;119990;1;1;0;0;0;1;1;119990;CELULAR MOTOROLA G20 64GB BLUE CLARO;TELEFONIA
20159446;;F;22;CHILENO;;Z;CERRO NAVIA;METROPOLITANA;153980;2;1;2;1;153980;0;0;0;SMARTPHONE A03S 64 GB S/SIM NEGRO;TELEFONIA
11385256;Casado;M;53;CHILENO;CONTADOR GENERAL;X;PROVIDENCIA                   ;METROPOLITANA;189990;1;1;1;1;189990;0;0;0;CELULAR A32 128 GB BLUE OPEN;TELEFONIA
14288535;;M;48;CHILENO;;X;LINARES                       ;MAULE;189990;2;1;0;0;0;2;1;189990;CELULAR REDMI NOTE 10S 128GB PEBBLE WHITE;TELEFONIA
13769329;;M;41;CHILENO;;X;SAN ANTONIO                   ;VALPARAISO;44990;1;1;0;0;0;1;1;44990;Celular NOKIA 1.3 NEGRO WOM;TELEFONIA
7328072;;M;69;CHILENO;;Silencioso;PROVIDENCIA                   ;METROPOLITANA;340970;3;2;0;0;0;3;2;340970;CELULAR A21s 128 GB Rojo;TELEFONIA
26090822;;M;33;HAITIANO;;Extranjero;LONGAVI                       ;MAULE;154980;2;1;0;0;0;2;1;154980;CELULAR HUAWEI Y7P NEGRO ENTEL;TELEFONIA
7522218;;M;66;CHILENO;;Boomers;CURICO                        ;MAULE;51990;2;1;0;0;0;2;1;51990;CELULAR VIVO Y11S PHANTON BLACK 32GB MOVISTAR;TELEFONIA
10788725;;M;56;CHILENO;;Boomers;PROVIDENCIA                   ;METROPOLITANA;169990;1;1;0;0;0;1;1;169990;CELULAR A54 OPPO NEGRO 128GB;TELEFONIA
9127030;;F;58;CHILENO;;Boomers;PROVIDENCIA                   ;METROPOLITANA;569990;2;1;2;1;569990;0;0;0;IPHONE 11 128GB BLACK CLARO;TELEFONIA
6273428;;M;70;CHILENO;;Silencioso;N/D;N/D;74990;1;1;0;0;0;1;1;74990;CELULAR MOTOROLA E7 IPOWER 32GB BLUE CLARO;TELEFONIA
6238737;;F;71;CHILENO;;Silencioso;LOTA                          ;BIO BIO;149990;1;1;0;0;0;1;1;149990;CELULAR XIAOMI REDMI 9T 128GB VERDE CLARO;TELEFONIA
17514866;;M;31;CHILENO;;Millenial;NATALES                       ;MAGALLANES;299970;3;4;0;0;0;3;4;299970;CELULAR CLARO MOTOROLA E7 32GB GRIS;TELEFONIA
9861340;;M;58;CHILENO;;Boomers;CONCEPCION                    ;BIO BIO;599990;1;1;0;0;0;1;1;599990;IPHONE 11 64GB BLACK CLARO;TELEFONIA
15729990;;F;30;CHILENO;;Millenial;LAS CABRAS                    ;L.G.B.OÂ´HIGGINS;457950;7;4;0;0;0;7;4;457950;MOTO G30 LILA PASTEL 128GB MOVISTAR;TELEFONIA
9061299;;M;61;CHILENO;;Boomers;RENGO                         ;L.G.B.OÂ´HIGGINS;242970;3;2;0;0;0;3;2;242970;CELULAR A54 OPPO AZUL 128GB;TELEFONIA
16059468;;F;34;CHILENO;;Millenial;SAN PEDRO DE LA PAZ           ;BIO BIO;205840;2;1;2;1;205840;0;0;0;CELULAR HUAWEI Y9A BLACK OPEN;TELEFONIA
18478740;;F;29;CHILENO;;Millenial;"";"";319990;1;1;1;1;319990;0;0;0;CELULAR SMARTPHONE A52S 5G LIGHT VIOLET 128GB;TELEFONIA
4934040;;M;78;CHILENO;;Silencioso;RENCA                         ;METROPOLITANA;10;2;1;0;0;0;2;1;10;CELULAR SMARTPHONE 1B ALCATEL PRIME BLACK;TELEFONIA
19136509;;F;26;CHILENO;;Z;PROVIDENCIA                   ;METROPOLITANA;183980;2;1;2;1;183980;0;0;0;CELULAR POCO X3 PRO 128 GB FROST BLUE;TELEFONIA
10927691;;F;47;CHILENO;;X;"";"";249990;1;1;0;0;0;1;1;249990;CELULAR HUAWEI Y9A BLACK OPEN;TELEFONIA
17693209;;M;31;CHILENO;;Millenial;PROVIDENCIA                   ;METROPOLITANA;497090;3;1;3;1;497090;0;0;0;CELULAR GALAXY S20FE 128GB CLOUD LAVENDER OPEN;TELEFONIA
11758524;;M;50;CHILENO;;Extranjero;REQUINOA                      ;L.G.B.OÂ´HIGGINS;159980;2;1;0;0;0;2;1;159980;CELULAR MOTOROLA E7 IPOWER 32GB BLUE CLARO;TELEFONIA
20513792;;F;22;CHILENO;;Z;PROVIDENCIA                   ;METROPOLITANA;205840;2;1;2;1;205840;0;0;0;Celular SAMSUNG A31 BLACK CLARO;TELEFONIA
17696017;;F;32;CHILENO;;Silencioso;SAN CARLOS                    ;BIO BIO;110990;3;1;0;0;0;3;1;110990;CELULAR VIVO Y11s PHANTOM BLACK ENTEL DIRECTO;TELEFONIA
15117500;;F;38;CHILENO;;Millenial;NANCAGUA                      ;L.G.B.OÂ´HIGGINS;1010980;2;1;0;0;0;2;1;1010980;SMARTPHONE GALAXY Z FLIP3 128GB CREAM;TELEFONIA
12432685;;M;49;CHILENO;;X;RIO BUENO                     ;LOS RIOS;69990;1;1;0;0;0;1;1;69990;CELULAR MOTOROLA E7 IPOWER 32GB BLUE CLARO;TELEFONIA
11757724;;F;51;CHILENO;;X;LAS CABRAS                    ;L.G.B.OÂ´HIGGINS;149990;1;1;0;0;0;1;1;149990;CELULAR SAMSUNG A12 128GB BLACK CLARO;TELEFONIA
12117137;;M;53;CHILENO;;X;PROVIDENCIA                   ;METROPOLITANA;209990;1;1;1;1;209990;0;0;0;POCO X3 PRO 256 GB PHANTOM BLACK;TELEFONIA
7562216;;F;68;CHILENO;;Boomers;PENAFLOR                      ;METROPOLITANA;84990;1;1;0;0;0;1;1;84990;CELULAR MOTO E7I POWER 32GB BLUE MOVISTAR;TELEFONIA
10860512;;F;52;CHILENO;;X;COLINA                        ;METROPOLITANA;189990;1;1;0;0;0;1;1;189990;CELULAR MOTOROLA G9 PLUS 128GB AZUL CLARO;TELEFONIA
15018491;;M;43;CHILENO;;X;TOCOPILLA                     ;ANTOFAGASTA;988610;7;4;0;0;0;7;4;988610;CELULAR POCO M3 128GB POWER BLACK;TELEFONIA
15270858;;F;39;CHILENO;;X;VALDIVIA                      ;LOS LAGOS;239990;1;1;0;0;0;1;1;239990;CELULAR MI 11 LITE 128GB BUBBLEGUM BLUE;TELEFONIA
11645689;;F;51;CHILENO;;X;INDEPENDENCIA                 ;METROPOLITANA;188980;2;1;0;0;0;2;1;188980;CELULAR A22 128GB NEGRO;TELEFONIA
14038085;;F;42;CHILENO;;X;SAN PABLO                     ;LOS LAGOS;109980;3;1;0;0;0;3;1;109980;CELULAR MOTO G20 64GB ROSA FLAMINGO OPEN;TELEFONIA
13744103;;M;42;CHILENO;;X;PROVIDENCIA                   ;METROPOLITANA;209990;2;1;0;0;0;2;1;209990;POCO X3 PRO 256 GB PHANTOM BLACK;TELEFONIA
10896459;;M;56;CHILENO;;Boomers;TEMUCO                        ;ARAUCANIA;91990;2;1;0;0;0;2;1;91990;CELULAR XIAOMI REDMI 9T TWILIGHT BLUE MOVISTAR;TELEFONIA
17939530;;M;30;CHILENO;;Millenial;N/D;N/D;199990;1;1;1;1;199990;0;0;0;POCO X3 PRO 256 GB PHANTOM BLACK;TELEFONIA
15802023;;M;38;CHILENO;;Millenial;MONTE PATRIA                  ;COQUIMBO;36990;1;1;0;0;0;1;1;36990;CELULAR NOKIA 225 4G BLACK MOVISTAR DIRECTO;TELEFONIA
17150891;;F;33;CHILENO;;Millenial;TALAGANTE                     ;METROPOLITANA;114980;2;1;0;0;0;2;1;114980;CELULAR CLARO MOTOROLA E7 32GB GRIS;TELEFONIA
9603940;;M;60;CHILENO;;Boomers;EL BOSQUE                     ;METROPOLITANA;119480;2;1;0;0;0;2;1;119480;CELULAR CLARO MOTOROLA E7 32GB GRIS;TELEFONIA
25900732;;M;31;VENEZOLANO;;Extranjero;"";"";223980;2;1;2;1;223980;0;0;0;CELULAR MI 11 LITE US 128GB PEACH PINK OPEN;TELEFONIA
16965707;;F;34;CHILENO;;Millenial;PROVIDENCIA                   ;METROPOLITANA;219990;1;1;0;0;0;1;1;219990;CELULAR REDMI NOTE 10S 128GB PEBBLE WHITE;TELEFONIA
13806651;;M;44;CHILENO;;X;N/D;N/D;199990;1;1;0;0;0;1;1;199990;CELULAR POCO M3 PRO 5G 128GB COOL BLUE;TELEFONIA
13898667;;F;42;CHILENO;;X;TALCA                         ;MAULE;124990;1;1;0;0;0;1;1;124990;CELULAR A12 128GB Azul OPEN;TELEFONIA
15248470;;F;44;CHILENO;;X;PUENTE ALTO                   ;METROPOLITANA;178980;3;1;0;0;0;3;1;178980;CELULAR MOTO G30 128GB GRIS TORNASOL OPEN;TELEFONIA
6474070;;M;71;CHILENO;;Silencioso;RENCA                         ;METROPOLITANA;59990;1;1;1;1;59990;0;0;0;DECO ANDROID TV 4K ENTEL;TELEFONIA
6527925;;F;67;CHILENO;;Boomers;PROVIDENCIA                   ;METROPOLITANA;419990;1;1;0;0;0;1;1;419990;CELULAR A72 128 GB BLUE OPEN;TELEFONIA
16679373;;F;35;CHILENO;;Millenial;CONSTITUCION                  ;MAULE;148980;2;1;0;0;0;2;1;148980;CELULAR REDMI NOTE 8 2021 64GB MOONLIGHT WHITE;TELEFONIA
12231938;;M;50;CHILENO;;X;PROVIDENCIA                   ;METROPOLITANA;487970;3;1;3;1;487970;0;0;0;CELULAR GALAXY S20FE 128GB CLOUD GREEN OPEN;TELEFONIA
20276735;;F;22;CHILENO;;Silencioso;PROVIDENCIA                   ;METROPOLITANA;69990;2;1;0;0;0;2;1;69990;CELULAR MOTOROLA G9 PLAY 64GB ELECTRIC BLUE OPEN;TELEFONIA
18531887;;M;28;CHILENO;;Silencioso;PROVIDENCIA                   ;METROPOLITANA;213980;2;1;2;1;213980;0;0;0;POCO X3 PRO 256 GB PHANTOM BLACK;TELEFONIA
17460635;;M;32;CHILENO;;Millenial;PROVIDENCIA                   ;METROPOLITANA;159980;3;2;0;0;0;3;2;159980;CELULAR Redmi 9C 32GB Gray WOM;TELEFONIA
24599969;;M;32;PERUANO;;Extranjero;MAIPU                         ;METROPOLITANA;747840;5;2;0;0;0;5;2;747840;CELULAR REDMI NOTE 8 2021 64GB MOONLIGHT WHITE;TELEFONIA
9401433;Casado;F;59;CHILENO;;Boomers;RENCA                         ;METROPOLITANA;50970;3;1;0;0;0;3;1;50970;Celular SA3 CLARO DIRECTO BLACK;TELEFONIA
5244447;;M;77;CHILENO;;Silencioso;PROVIDENCIA                   ;METROPOLITANA;36990;1;1;0;0;0;1;1;36990;CELULAR NOKIA 225 4G BLACK MOVISTAR DIRECTO;TELEFONIA
14303266;;M;48;CHILENO;;X;RENCA                         ;METROPOLITANA;91990;2;1;0;0;0;2;1;91990;XIAOMI REDMI 9T CARBON GRAY 128GB MOVISTAR;TELEFONIA
10979191;;F;48;CHILENO;;X;N/D;N/D;139990;1;1;1;1;139990;0;0;0;CELULAR A12 128GB Rojo OPEN;TELEFONIA
12546231;;F;47;CHILENO;;X;PARRAL                        ;MAULE;805480;2;1;2;1;805480;0;0;0;IPHONE 12 128GB BLACK CLARO;TELEFONIA
9281487;;F;59;CHILENO;;Boomers;LA SERENA                     ;COQUIMBO;319991;1;2;0;0;0;1;2;319991;CELULAR POCO F3 128 GB NIGHT BLACK;TELEFONIA
18973842;;F;27;CHILENO;;Z;PROVIDENCIA                   ;METROPOLITANA;131980;2;2;0;0;0;2;2;131980;VIVO Y20 OBSIDIAN BLACK OPEN;TELEFONIA
12450239;;F;48;CHILENO;;X;MAIPU                         ;METROPOLITANA;379980;2;1;0;0;0;2;1;379980;CELULAR REDMI NOTE 10 PRO 128GB GLACIER BLUE;TELEFONIA
18795321;Soltero;F;28;CHILENO;TECNICO DE NIVEL SUPERIOR EN LABORATORIO CLINICO Y BANCO DE SANGRE;Millenial;PROVIDENCIA                   ;METROPOLITANA;487970;3;1;3;1;487970;0;0;0;CELULAR GALAXY S20FE 128GB CLOUD LAVENDER OPEN;TELEFONIA
25045838;;M;29;PERUANO;;Extranjero;ALGARROBO                     ;VALPARAISO;194980;2;1;2;1;194980;0;0;0;Celular P40 LITE LIB OPEN GREEN;TELEFONIA
19097903;;F;26;CHILENO;;Z;CAUQUENES                     ;MAULE;1019980;2;1;0;0;0;2;1;1019980;Celular Galaxy S21 Phantom Grey 128GB;TELEFONIA
10714325;;M;50;CHILENO;;X;EL TABO                       ;VALPARAISO;179990;1;1;0;0;0;1;1;179990;CELULAR POCO X3 PRO 128G PHANTOM BLACK OPEN;TELEFONIA
18643749;;F;28;CHILENO;;Silencioso;PROVIDENCIA                   ;METROPOLITANA;218981;3;1;0;0;0;3;1;218981;SMARTPHONE A22 VERDE 128GB;TELEFONIA
16203496;;M;36;CHILENO;;Millenial;N/D;N/D;499990;1;1;0;0;0;1;1;499990;CELULAR GALAXY S20FE 128GB ClOUD NAVY OPEN;TELEFONIA
12691762;;M;48;CHILENO;;X;PROVIDENCIA                   ;METROPOLITANA;219980;2;1;0;0;0;2;1;219980;CELULAR VIVO Y11S PHANTOM BLACK OPEN;TELEFONIA
15578554;;F;39;CHILENO;;X;RENCA                         ;METROPOLITANA;119990;1;1;0;0;0;1;1;119990;SMARTPHONE A03S AZUL 32GB;TELEFONIA
16798166;;F;34;CHILENO;;Millenial;PEDRO AGUIRRE CERDA;METROPOLITANA;29990;2;1;0;0;0;2;1;29990;CELULAR MOTO E7i 32GB AZUL OPEN;TELEFONIA
19507359;;F;25;CHILENO;;Millenial;"";"";623980;2;1;2;1;623980;0;0;0;CELULAR IPHONE 12 MINI 64GB BLACK CLARO;TELEFONIA
25627233;;F;52;PERUANO;;Extranjero;N/D;N/D;189990;1;1;0;0;0;1;1;189990;SMARTPHONE A22 VERDE 128GB;TELEFONIA
20256910;;M;22;CHILENO;;Z;N/D;N/D;491690;3;1;3;1;491690;0;0;0;CELULAR GALAXY S20FE 128GB CLOUD LAVENDER OPEN;TELEFONIA
20072904;;M;23;CHILENO;;Z;N/D;N/D;179990;1;1;0;0;0;1;1;179990;CELULAR POCO X3 PRO 128G PHANTOM BLACK OPEN;TELEFONIA
10526881;;M;53;CHILENO;;Silencioso;PROVIDENCIA                   ;METROPOLITANA;149990;1;1;0;0;0;1;1;149990;XIAOMI REDMI 9T CARBON GRAY 128GB MOVISTAR;TELEFONIA
13204460;;F;45;CHILENO;;X;RENCA                         ;METROPOLITANA;120000;2;1;0;0;0;2;1;120000;CELULAR MOTO E7 32GB ROSA CORAL OPEN;TELEFONIA
18447239;;F;29;CHILENO;;Millenial;SAN ANTONIO                   ;VALPARAISO;704980;2;1;2;1;704980;0;0;0;CELULAR IPHONE 12 64GB BLACK CLARO;TELEFONIA
15962919;;M;37;CHILENO;;Millenial;PROVIDENCIA                   ;METROPOLITANA;424920;6;2;0;0;0;6;2;424920;CELULAR POCO M3 64GB COOL BLUE;TELEFONIA
13805485;;F;42;CHILENO;;X;SAN FELIPE                    ;VALPARAISO;119990;1;1;0;0;0;1;1;119990;SMARTPHONE A03S NEGRO 32GB;TELEFONIA
15153120;;M;40;CHILENO;;X;PROVIDENCIA                   ;METROPOLITANA;145480;2;1;2;1;145480;0;0;0;CELULAR A12 128GB Azul OPEN;TELEFONIA
19060890;;M;27;CHILENO;;Z;N/D;N/D;1265930;7;5;7;5;1265930;0;0;0;CELULAR POCO X3 PRO 128 GB FROST BLUE;TELEFONIA
13375503;;M;44;CHILENO;;X;N/D;N/D;129990;1;1;1;1;129990;0;0;0;CELULAR XIAOMI REDMI 9T TWILIGHT BLUE MOVISTAR;TELEFONIA
12759219;;M;47;CHILENO;;X;CALBUCO                       ;LOS LAGOS;192960;6;1;0;0;0;6;1;192960;CELULAR MOTO E6I ROSA OPEN;TELEFONIA
19095084;;F;26;CHILENO;;Silencioso;PROVIDENCIA                   ;METROPOLITANA;349990;1;1;1;1;349990;0;0;0;CELULAR SMARTPHONE A52S 5G LIGHT VIOLET 128GB;TELEFONIA
9566639;;M;60;CHILENO;;Boomers;PROVIDENCIA                   ;METROPOLITANA;129980;3;2;0;0;0;3;2;129980;CELULAR A12 128GB NEGRO TRIANGULADO CLARO;TELEFONIA
8457891;;M;53;CHILENO;;X;PROVIDENCIA                   ;METROPOLITANA;243980;2;1;2;1;243980;0;0;0;CELULAR MI 11 LITE US 128GB PEACH PINK OPEN;TELEFONIA
17788094;;F;31;CHILENO;;Millenial;CASTRO                        ;LOS LAGOS;214990;1;1;0;0;0;1;1;214990;POCO X3 PRO 256 GB PHANTOM BLACK;TELEFONIA
15513347;;F;40;CHILENO;;X;"";"";353960;3;1;3;1;353960;0;0;0;POCO X3 PRO 256 GB METAL BRONCE;TELEFONIA
15952448;;F;37;CHILENO;;Millenial;N/D;N/D;399980;2;1;2;1;399980;0;0;0;POCO X3 PRO 256 GB PHANTOM BLACK;TELEFONIA
18282464;Soltero;M;29;CHILENO;;Millenial;PROVIDENCIA                   ;METROPOLITANA;129990;1;1;1;1;129990;0;0;0;CELULAR REDMI 9T 128 GB OCEAN GREEN;TELEFONIA
15195262;;F;40;CHILENO;;X;CABRERO                       ;BIO BIO;69990;1;1;0;0;0;1;1;69990;CELULAR MOTO E7I POWER 32GB BLUE MOVISTAR;TELEFONIA
19885897;;M;23;CHILENO;;Millenial;"";"";209990;1;1;1;1;209990;0;0;0;POCO X3 PRO 256 GB PHANTOM BLACK;TELEFONIA
4308140;;M;80;CHILENO;;Silencioso;RENCA                         ;METROPOLITANA;64990;1;1;0;0;0;1;1;64990;CELULAR MOTO E6I 32GB GRIS OPEN;TELEFONIA
18505326;;F;29;CHILENO;;Millenial;N/D;N/D;200980;2;1;0;0;0;2;1;200980;MOTO G30 LILA PASTEL 128GB MOVISTAR;TELEFONIA
7093295;;M;70;CHILENO;;Silencioso;RENCA                         ;METROPOLITANA;249990;1;1;0;0;0;1;1;249990;CELULAR REDMI NOTE 10 PRO 6+128GB GRADIENT BRONZ;TELEFONIA
20318344;;F;23;CHILENO;;Z;"";"";99990;1;1;0;0;0;1;1;99990;CELULAR SAMSUNG A02S DIRECTO CLARO BLACK;TELEFONIA
7872714;;M;61;CHILENO;;Boomers;PROVIDENCIA                   ;METROPOLITANA;86990;2;1;0;0;0;2;1;86990;CELULAR VIVO Y20 BLACK 64GB MOVISTAR;TELEFONIA
15502456;;M;39;CHILENO;;X;SAN CARLOS                    ;BIO BIO;235840;2;1;2;1;235840;0;0;0;CELULAR HUAWEI Y9A BLACK OPEN;TELEFONIA
15250770;;M;38;CHILENO;;X;PROVIDENCIA                   ;METROPOLITANA;166980;2;1;2;1;166980;0;0;0;CELULAR MOTO G30 128GB GRIS TORNASOL OPEN;TELEFONIA
7184124;Casado;M;68;CHILENO;AGROINDUSTRIA;Silencioso;CABILDO                       ;VALPARAISO;29980;2;1;0;0;0;2;1;29980;CELULAR NOKIA 110 BLACK OPEN;TELEFONIA
9319969;;F;57;CHILENO;;Boomers;SAN PEDRO DE LA PAZ           ;BIO BIO;109480;2;1;0;0;0;2;1;109480;Celular VIVO Y11S ENTEL DIRECTO AZUL;TELEFONIA
20211572;;M;23;CHILENO;;Z;PROVIDENCIA                   ;METROPOLITANA;209990;1;1;1;1;209990;0;0;0;POCO X3 PRO 256 GB PHANTOM BLACK;TELEFONIA
5762871;;M;75;CHILENO;;Silencioso;PETORCA                       ;VALPARAISO;395850;4;2;0;0;0;4;2;395850;Celular NOKIA 2.3 ENTEL DIRECTO CARBON;TELEFONIA
18991792;;F;27;CHILENO;;Silencioso;LINARES                       ;MAULE;83770;2;1;0;0;0;2;1;83770;CELULAR MOTOROLA E6 PLAY AZUL TRI WOM;TELEFONIA
18981270;;F;27;CHILENO;;Millenial;LINARES                       ;MAULE;164980;3;1;0;0;0;3;1;164980;CELULAR A12 128GB Negro OPEN;TELEFONIA
18534775;Soltero;F;28;CHILENO;;Millenial;PROVIDENCIA                   ;METROPOLITANA;99990;1;1;1;1;99990;0;0;0;CELULAR MOTO ONE FUSION 64GB VERDE 64GB OPEN;TELEFONIA
23360436;;F;47;PERUANO;;Extranjero;COLINA                        ;METROPOLITANA;73980;2;1;2;1;73980;0;0;0;CELULAR MOTOROLA E7 IPOWER 32GB BLUE CLARO;TELEFONIA
17142012;;F;33;CHILENO;;X;N/D;N/D;195060;5;3;0;0;0;5;3;195060;CELULAR REDMI NOTE 8 2021 64GB NEPTUNE BLUE;TELEFONIA
16842648;;F;32;CHILENO;;Millenial;N/D;N/D;64990;1;1;0;0;0;1;1;64990;CELULAR MOTO E7 32GB ROSA CORAL OPEN;TELEFONIA
11869909;;F;52;CHILENO;;X;RENCA                         ;METROPOLITANA;1209960;3;1;3;1;1209960;0;0;0;CELULAR NOTE 20 ULTRA MYSTIC BRONZE 256 GB OPE;TELEFONIA
12748477;;M;47;CHILENO;;X;VALDIVIA                      ;LOS RIOS;104980;2;1;0;0;0;2;1;104980;CELULAR CLARO MOTOROLA E7 32GB GRIS;TELEFONIA
11205046;;F;54;CHILENO;;Boomers;PROVIDENCIA                   ;METROPOLITANA;25540;2;1;2;1;25540;0;0;0;CELULAR NOKIA 110 BLACK OPEN;TELEFONIA
9261950;;F;61;CHILENO;;Boomers;QUELLON                       ;LOS LAGOS;73980;2;2;0;0;0;2;2;73980;CELULAR MOTO E7I POWER ORANGE 32GB MOVISTAR;TELEFONIA
10881460;;M;55;CHILENO;;Boomers;AISEN                         ;AYSEN;79990;1;1;0;0;0;1;1;79990;CELULAR MOTO E7 32GB GRIS OPEN;TELEFONIA
5963304;;F;76;CHILENO;;Silencioso;ILLAPEL                       ;COQUIMBO;86980;2;1;0;0;0;2;1;86980;CELULAR MOTO E6I ROSA OPEN;TELEFONIA
16457155;Soltero;F;35;CHILENO;TECNICO EN ENFERMERIA DE NIVEL SUPERIOR;Millenial;RENCA                         ;METROPOLITANA;269990;1;1;1;1;269990;0;0;0;CELULAR RENO5 LITE VIOLETA 128GB;TELEFONIA
16580245;;F;35;CHILENO;;Silencioso;PROVIDENCIA                   ;METROPOLITANA;229990;1;1;0;0;0;1;1;229990;POCO X3 PRO 256 GB PHANTOM BLACK;TELEFONIA
12408335;;F;49;CHILENO;;X;ALTO HOSPICIO;TARAPACA;263980;2;1;2;1;263980;0;0;0;IPHONE 8 64 GB LIB OPEN GRAY;TELEFONIA
8393533;;F;68;CHILENO;;Boomers;VILLA ALEMANA                 ;VALPARAISO;119990;1;1;0;0;0;1;1;119990;CELULAR MOTO ONE FUSION 64GB VERDE 64GB OPEN;TELEFONIA
11584514;;F;56;CHILENO;;Boomers;RENCA                         ;METROPOLITANA;249050;4;1;0;0;0;4;1;249050;CELULAR POCO X3 PRO 256 GB FROST BLUE;TELEFONIA
11379530;;F;53;CHILENO;;X;VALLENAR;ATACAMA;129990;1;1;0;0;0;1;1;129990;VIVO Y20 OBSIDIAN BLACK OPEN;TELEFONIA
12029765;;F;42;CHILENO;;X;RENCA                         ;METROPOLITANA;149990;1;1;0;0;0;1;1;149990;CELULAR A21s 128 GB Negro;TELEFONIA
12003057;;F;43;CHILENO;;X;LAGO VERDE                    ;AYSEN;74990;1;1;0;0;0;1;1;74990;CELULAR MOTO E6I 32GB GRIS OPEN;TELEFONIA
10084261;;M;53;CHILENO;;X;"";"";219990;1;1;0;0;0;1;1;219990;CELULAR REDMI NOTE 10S 128GB ONIX BLACK;TELEFONIA
20432409;;F;22;CHILENO;;Z;N/D;N/D;197870;2;2;0;0;0;2;2;197870;CELULAR A21s 128 GB Rojo;TELEFONIA
12048164;;M;53;CHILENO;;X;LO ESPEJO                     ;METROPOLITANA;139980;2;1;0;0;0;2;1;139980;CELULAR A12 128GB Negro OPEN;TELEFONIA
8377485;;F;66;CHILENO;;Silencioso;PROVIDENCIA                   ;METROPOLITANA;19990;1;1;0;0;0;1;1;19990;Celular AL3 CLARO DIRECTO NEGRO;TELEFONIA
6484664;;M;69;CHILENO;;Silencioso;N/D;N/D;40980;2;1;2;1;40980;0;0;0;CELULAR NOKIA 225 4G BLACK MOVISTAR DIRECTO;TELEFONIA
15965790;;M;37;CHILENO;;Millenial;N/D;N/D;168980;2;1;0;0;0;2;1;168980;CELULAR REDMI NOTE 10 128GB PEBBLE WHITE;TELEFONIA
12387588;;M;49;CHILENO;;X;TIRUA                         ;BIO BIO;149990;1;1;0;0;0;1;1;149990;CELULAR A21s 128 GB AZUL;TELEFONIA
14202833;;F;40;CHILENO;;X;SAN VICENTE                   ;L.G.B.OÂ´HIGGINS;169980;4;1;0;0;0;4;1;169980;CELULAR VIVO Y11S NEBULA BLUE 32GB OPEN;TELEFONIA
15067782;;M;40;CHILENO;;X;PROVIDENCIA                   ;METROPOLITANA;109990;1;1;0;0;0;1;1;109990;Celular VIVO Y11S ENTEL DIRECTO AZUL;TELEFONIA
6161772;;M;72;CHILENO;;Silencioso;RENCA                         ;METROPOLITANA;19990;1;1;0;0;0;1;1;19990;Celular AL3 CLARO DIRECTO NEGRO;TELEFONIA
17550243;Soltero;M;30;CHILENO;TECNICO AGRICOLA;Millenial;PROVIDENCIA                   ;METROPOLITANA;84990;1;1;0;0;0;1;1;84990;CELULAR MOTOROLA E7 IPOWER 32GB BLUE CLARO;TELEFONIA
19344010;;F;26;CHILENO;;Z;COLINA                        ;METROPOLITANA;269990;1;1;0;0;0;1;1;269990;CELULAR REDMI NOTE 10 PRO 6+128GB GRADIENT BRONZ;TELEFONIA
8131893;;F;63;CHILENO;;Boomers;CABILDO                       ;VALPARAISO;244969;3;1;0;0;0;3;1;244969;CELULAR A21s 128 GB Rojo;TELEFONIA
8172493;;F;69;CHILENO;;Silencioso;RENCA                         ;METROPOLITANA;7990;1;1;0;0;0;1;1;7990;TELEFONO PP BINDU ENTEL;TELEFONIA
17344560;;M;32;CHILENO;;Millenial;N/D;N/D;109480;2;1;0;0;0;2;1;109480;CELULAR REDMI 9A 32GB PEACOCK GREEN;TELEFONIA
6730582;;M;68;CHILENO;;Boomers;PARRAL                        ;MAULE;79990;1;1;0;0;0;1;1;79990;CELULAR REDMI 9A GRANITE GREY DIRECTO MOVISTAR;TELEFONIA
20352178;;M;22;CHILENO;;Z;N/D;N/D;149990;1;1;1;1;149990;0;0;0;CELULAR A21s 128 GB AZUL;TELEFONIA
8392661;;M;64;CHILENO;;Boomers;TEMUCO                        ;ARAUCANIA;169980;2;1;0;0;0;2;1;169980;CELULAR MOTOROLA G9 PLAY 64GB SPRING PINK OPEN;TELEFONIA
5493785;;M;76;CHILENO;;Silencioso;RENCA                         ;METROPOLITANA;83770;2;1;0;0;0;2;1;83770;CELULAR SMARTPHONE 1B ALCATEL PRIME BLACK;TELEFONIA
12412329;;M;48;CHILENO;;X;MELIPILLA                     ;METROPOLITANA;174980;2;1;0;0;0;2;1;174980;CELULAR A21s 128 GB Negro;TELEFONIA
16815279;Casado;M;34;CHILENO;;Millenial;RENCA                         ;METROPOLITANA;149990;1;1;0;0;0;1;1;149990;CELULAR Galaxy A21s (128GB) Black WOM;TELEFONIA
11418000;;F;52;CHILENO;;X;N/D;N/D;419970;3;2;0;0;0;3;2;419970;CELULAR MI 11 LITE 128GB BOBA BLACK OPEN;TELEFONIA
7606794;;M;66;CHILENO;;Boomers;PUERTO MONTT                  ;LOS LAGOS;131460;4;1;0;0;0;4;1;131460;CELULAR A02s ROJO 32GB OPEN;TELEFONIA
18460661;;F;28;CHILENO;;Millenial;N/D;N/D;99990;1;1;0;0;0;1;1;99990;CELULAR MOTOROLA G9 PLAY 64GB ELECTRIC BLUE OPEN;TELEFONIA
19401636;;F;26;CHILENO;;Silencioso;PROVIDENCIA                   ;METROPOLITANA;158980;3;1;0;0;0;3;1;158980;CELULAR POCO M3 PRO 5G 128GB COOL BLUE;TELEFONIA
13063634;;F;53;CHILENO;;X;QUILICURA                     ;METROPOLITANA;139990;1;1;0;0;0;1;1;139990;CELULAR MOTO G20 64GB ROSA FLAMINGO OPEN;TELEFONIA
9569329;;M;56;CHILENO;;Boomers;NUEVA IMPERIAL                ;ARAUCANIA;99990;1;1;0;0;0;1;1;99990;CELULAR POCO M3 64GB POWER BLACK;TELEFONIA
13196630;;M;44;CHILENO;;X;PROVIDENCIA                   ;METROPOLITANA;159980;2;2;0;0;0;2;2;159980;CELULAR CLARO MOTOROLA E7 32GB GRIS;TELEFONIA
11835697;;F;51;CHILENO;;X;PROVIDENCIA                   ;METROPOLITANA;20000;0;1;0;0;0;0;1;20000;CELULAR MOTOROLA MOTO G20 64GB ROSA FLAMINGO;TELEFONIA
18854666;;F;28;CHILENO;;Millenial;PROVIDENCIA                   ;METROPOLITANA;499990;2;1;0;0;0;2;1;499990;CELULAR GALAXY S20FE 128GB CLOUD LAVENDER OPEN;TELEFONIA
19669199;;M;25;CHILENO;;Silencioso;PROVIDENCIA                   ;METROPOLITANA;21980;2;1;2;1;21980;0;0;0;CELULAR NOKIA 110 BLACK OPEN;TELEFONIA
11964720;;F;50;CHILENO;;X;PROVIDENCIA                   ;METROPOLITANA;149990;1;1;0;0;0;1;1;149990;CELULAR A21s 128 GB Negro;TELEFONIA
18531993;;M;28;CHILENO;;Millenial;PROVIDENCIA                   ;METROPOLITANA;463980;2;1;2;1;463980;0;0;0;CELULAR GALAXY S20FE 128GB CLOUD GREEN OPEN;TELEFONIA
19294836;Soltero;M;25;CHILENO;;Silencioso;PROVIDENCIA                   ;METROPOLITANA;135840;2;1;2;1;135840;0;0;0;CELULAR A12 128GB Negro OPEN;TELEFONIA
12500801;;F;49;CHILENO;;X;PIRQUE                        ;METROPOLITANA;129480;2;1;0;0;0;2;1;129480;CELULAR VIVO Y11S PHANTOM BLACK OPEN;TELEFONIA
18180285;;F;30;CHILENO;;Millenial;PROVIDENCIA                   ;METROPOLITANA;90990;1;1;0;0;0;1;1;90990;CELULAR VIVO Y11S NEBULA BLUE 32GB OPEN;TELEFONIA
8496888;;M;62;CHILENO;;Boomers;EL BOSQUE                     ;METROPOLITANA;144980;2;1;0;0;0;2;1;144980;CELULAR REDMI NOTE 8 2021 64 GB SPACE BLACK;TELEFONIA
8436204;;M;63;CHILENO;;Boomers;CARTAGENA                     ;VALPARAISO;101770;2;1;0;0;0;2;1;101770;CELULAR MOTOROLA E6 PLAY AZUL TRI WOM;TELEFONIA
24473854;;M;29;BOLIVIANO;;Extranjero;CALAMA                        ;ANTOFAGASTA;129480;2;1;0;0;0;2;1;129480;CELULAR A02s ROJO 32GB OPEN;TELEFONIA
12359393;;F;51;CHILENO;;Boomers;SAN JAVIER                    ;MAULE;189980;2;1;0;0;0;2;1;189980;CELULAR A21s 128 GB AZUL;TELEFONIA
10824346;;F;55;CHILENO;;Boomers;PROVIDENCIA                   ;METROPOLITANA;79990;1;1;0;0;0;1;1;79990;CELULAR CLARO MOTOROLA E7 32GB GRIS;TELEFONIA
19247659;Soltero;F;26;CHILENO;TECNICO DE NIVEL MEDIO EN ALIMENTACION;Z;PROVIDENCIA                   ;METROPOLITANA;189990;1;1;1;1;189990;0;0;0;CELULAR A32 128 GB WHITE OPEN;TELEFONIA
20114139;;F;23;CHILENO;;Z;PROVIDENCIA                   ;METROPOLITANA;179980;2;2;0;0;0;2;2;179980;CELULAR MOTO E7 32GB GRIS OPEN;TELEFONIA
18353578;Soltero;M;29;CHILENO;TECNICO EN ENFERMERIA DE NIVEL SUPERIOR;Millenial;PROVIDENCIA                   ;METROPOLITANA;277870;2;1;0;0;0;2;1;277870;POCO X3 PRO 256 GB PHANTOM BLACK;TELEFONIA
14330476;;F;45;CHILENO;;X;N/D;N/D;289960;4;2;0;0;0;4;2;289960;CELULAR POCO M3 64GB POWER BLACK;TELEFONIA
10155600;;F;57;CHILENO;;Boomers;RENCA                         ;METROPOLITANA;109480;2;1;0;0;0;2;1;109480;CELULAR XIAOMI REDMI 9A 32GB BLACK DIRECTO CLARO;TELEFONIA
14246295;;M;48;CHILENO;;X;MELIPILLA                     ;METROPOLITANA;447870;2;1;0;0;0;2;1;447870;CELULAR GALAXY S20FE 128GB ClOUD NAVY OPEN;TELEFONIA
19455705;;M;32;CHILENO;;Silencioso;PROVIDENCIA                   ;METROPOLITANA;109990;1;1;1;1;109990;0;0;0;CELULAR G8 POWER MOTO TRI ENTEL;TELEFONIA
16613813;Soltero;F;34;CHILENO;;Millenial;SALAMANCA                     ;COQUIMBO;154980;2;3;0;0;0;2;3;154980;CELULAR REDMI 9 64GB SUNSET PURPLE TRI WOM;TELEFONIA
6736202;Casado;M;70;CHILENO;;Silencioso;RENCA                         ;METROPOLITANA;434470;3;2;0;0;0;3;2;434470;Celular A10S MOVISTAR DIRECTO BLACK;TELEFONIA
7586691;;F;70;CHILENO;;Silencioso;SAN ANTONIO                   ;VALPARAISO;79480;3;1;0;0;0;3;1;79480;CELULAR MOTO E7 32GB ROSA CORAL OPEN;TELEFONIA
14090814;;F;41;CHILENO;;X;PUENTE ALTO                   ;METROPOLITANA;139990;1;1;1;1;139990;0;0;0;CELULAR A21s 128 GB AZUL;TELEFONIA
11728381;;M;51;CHILENO;;X;LOS ANDES                     ;VALPARAISO;219990;1;1;0;0;0;1;1;219990;CELULAR A32 128 GB BLUE OPEN;TELEFONIA
13611322;;M;43;CHILENO;;X;MAULE                         ;MAULE;89990;1;1;0;0;0;1;1;89990;CELULAR Redmi 9C 32GB Gray WOM;TELEFONIA
7354093;;F;65;CHILENO;;Boomers;"";"";84990;1;1;0;0;0;1;1;84990;CELULAR MOTO E7 32GB GRIS OPEN;TELEFONIA
5879824;;M;66;CHILENO;;Boomers;QUIRIHUE                      ;BIO BIO;194970;3;1;0;0;0;3;1;194970;CELULAR CLARO MOTOROLA E7 32GB GRIS;TELEFONIA
7086738;;F;65;CHILENO;;Boomers;PROVIDENCIA                   ;METROPOLITANA;79990;1;1;0;0;0;1;1;79990;CELULAR REDMI 9A 32GB PEACOCO GREEN DIREC MOVIST;TELEFONIA
10836605;;M;56;CHILENO;;Boomers;PROVIDENCIA                   ;METROPOLITANA;179980;2;1;0;0;0;2;1;179980;CELULAR A12 128GB NEGRO OPEN;TELEFONIA
19888510;;F;23;CHILENO;;Z;PROVIDENCIA                   ;METROPOLITANA;129990;1;1;0;0;0;1;1;129990;CELULAR A12 128GB NEGRO TRIANGULADO CLARO;TELEFONIA
10043420;;M;58;CHILENO;;Boomers;N/D;N/D;124990;3;1;0;0;0;3;1;124990;CELULAR REDMI 9T 128 GB OCEAN GREEN;TELEFONIA
20195101;;M;23;CHILENO;;Z;N/D;N/D;139990;1;1;0;0;0;1;1;139990;CELULAR MOTO ONE FUSION 128GB AZUL OPEN;TELEFONIA
9546233;;F;60;CHILENO;;Boomers;N/D;N/D;174980;2;1;0;0;0;2;1;174980;CELULAR A21s 128 GB Negro;TELEFONIA
18229995;;F;30;CHILENO;;Millenial;PROVIDENCIA                   ;METROPOLITANA;217870;2;1;0;0;0;2;1;217870;Celular Y8P ENTEL TRIANGULADO PIEDRA DE LUNA;TELEFONIA
26260659;;F;31;VENEZOLANO;;Extranjero;SAN MIGUEL                    ;METROPOLITANA;903980;2;1;2;1;903980;0;0;0;Celular Galaxy S21 Ultra Phantom Silver 128GB;TELEFONIA
18442876;;F;29;CHILENO;;Silencioso;PROVIDENCIA                   ;METROPOLITANA;133980;2;1;2;1;133980;0;0;0;CELULAR POCO M3 128GB COOL BLUE;TELEFONIA
7838109;;F;67;CHILENO;;Boomers;PROVIDENCIA                   ;METROPOLITANA;189990;2;1;0;0;0;2;1;189990;POCO X3 PRO 256 GB PHANTOM BLACK;TELEFONIA
20238527;;M;23;CHILENO;;Z;PROVIDENCIA                   ;METROPOLITANA;129990;1;1;1;1;129990;0;0;0;CELULAR POCO M3 128GB COOL BLUE;TELEFONIA
16127807;;F;36;CHILENO;;Silencioso;PROVIDENCIA                   ;METROPOLITANA;109990;1;1;1;1;109990;0;0;0;CELULAR REDMI NOTE 8 2021 64 GB SPACE BLACK;TELEFONIA
19012615;;M;27;CHILENO;;Z;PROVIDENCIA                   ;METROPOLITANA;1028530;5;1;5;1;1028530;0;0;0;CELULAR Galaxy Z Flip3 128GB LAVENDER OPEN;TELEFONIA
9941271;;F;57;CHILENO;;Boomers;TEMUCO                        ;ARAUCANIA;149990;1;1;0;0;0;1;1;149990;CELULAR Galaxy A21s (128GB) Black WOM;TELEFONIA
16447976;Soltero;F;35;CHILENO;TECNICO DE NIVEL SUPERIOR EN ENFERMERIA;Millenial;RENCA                         ;METROPOLITANA;79990;1;1;0;0;0;1;1;79990;CELULAR REDMI 9A GRANITE GREY DIRECTO MOVISTAR;TELEFONIA
9948131;Casado;F;58;CHILENO;;Boomers;SAN ROSENDO                   ;BIO BIO;489990;2;1;0;0;0;2;1;489990;CELULAR GALAXY S20FE 128GB CLOUD LAVENDER OPEN;TELEFONIA
13608625;;F;43;CHILENO;;X;ANTOFAGASTA                   ;ANTOFAGASTA;199990;1;3;0;0;0;1;3;199990;CELULAR REDMI NOTE 10S 128GB ONIX BLACK;TELEFONIA
5963434;;F;75;CHILENO;;Silencioso;PELARCO                       ;MAULE;109990;1;1;0;0;0;1;1;109990;CELULAR REDMI NOTE 8 2021 64GB NEPTUNE BLUE;TELEFONIA
8493226;;F;63;CHILENO;;Boomers;PROVIDENCIA                   ;METROPOLITANA;149990;1;1;0;0;0;1;1;149990;CELULAR SAMSUNG A12 128GB BLACK CLARO;TELEFONIA
5032357;;F;75;CHILENO;;Silencioso;ARICA                         ;TARAPACA;214980;3;2;0;0;0;3;2;214980;CELULAR A21s 128 GB Rojo;TELEFONIA
17564171;;M;32;CHILENO;;Millenial;LOS ANGELES                   ;BIO BIO;129990;1;1;0;0;0;1;1;129990;CELULAR MOTO ONE FUSION 64GB VERDE 64GB OPEN;TELEFONIA
15405467;;M;40;CHILENO;;Silencioso;PROVIDENCIA                   ;METROPOLITANA;149990;1;1;1;1;149990;0;0;0;CELULAR A21s 128 GB Negro;TELEFONIA
10715632;;M;48;CHILENO;;X;PROVIDENCIA                   ;METROPOLITANA;84990;1;1;0;0;0;1;1;84990;CELULAR MOTO E7 32GB ROSA CORAL OPEN;TELEFONIA
19568902;;F;25;CHILENO;;Z;LOS VILOS                     ;COQUIMBO;101770;2;1;0;0;0;2;1;101770;Celular LG K22 MOVISTAR DIRECTO TITAN;TELEFONIA
12555409;;M;48;CHILENO;;Silencioso;PROVIDENCIA                   ;METROPOLITANA;119990;1;1;0;0;0;1;1;119990;CELULAR OPPO A15 BLACK 32GB CLARO;TELEFONIA
15561980;;F;39;CHILENO;;X;CARAHUE                       ;ARAUCANIA;119990;1;1;0;0;0;1;1;119990;CELULAR OPPO A15 BLACK 32GB CLARO;TELEFONIA
14027857;;F;40;CHILENO;;X;CHILLAN                       ;BIO BIO;119990;1;1;0;0;0;1;1;119990;CELULAR REDMI 9 64GB SUNSET PURPLE TRI WOM;TELEFONIA
18074734;;M;30;CHILENO;;Millenial;PROVIDENCIA                   ;METROPOLITANA;143980;2;1;2;1;143980;0;0;0;CELULAR Galaxy A21s (128GB) Black WOM;TELEFONIA
19877971;;F;24;CHILENO;;Z;PROVIDENCIA                   ;METROPOLITANA;399990;1;1;0;0;0;1;1;399990;CELULAR GALAXY S20FE 128GB ClOUD NAVY OPEN;TELEFONIA
20123649;;F;23;CHILENO;;Z;N/D;N/D;285980;3;1;0;0;0;3;1;285980;Celular P40 LITE LIB OPEN GREEN;TELEFONIA
15053873;;M;40;CHILENO;;X;COQUIMBO                      ;COQUIMBO;391850;5;2;0;0;0;5;2;391850;CELULAR MOTO G9 PLAY ROSA SPRING MOVISTAR;TELEFONIA
19210812;;M;26;CHILENO;;Z;N/D;N/D;349970;3;2;0;0;0;3;2;349970;CELULAR A21s 128 GB AZUL;TELEFONIA
17787408;;M;31;CHILENO;;Millenial;PROVIDENCIA                   ;METROPOLITANA;0;0;0;0;0;0;0;0;0;CELULAR POCO X3 PRO 256 GB FROST BLUE;TELEFONIA
9590787;Soltero;M;57;CHILENO;;Boomers;RENCA                         ;METROPOLITANA;0;0;0;0;0;0;0;0;0;CELULAR A21s 128 GB Rojo;TELEFONIA
16649652;Soltero;M;34;CHILENO;;Millenial;CURANILAHUE                   ;BIO BIO;0;0;0;0;0;0;0;0;0;CELULAR NOKIA QUEEN VALUE BLACK CLARO;TELEFONIA
8069228;;M;64;CHILENO;;Boomers;N/D;N/D;0;0;0;0;0;0;0;0;0;Celular A10S MOVISTAR DIRECTO BLACK;TELEFONIA
11489951;;M;52;CHILENO;;X;PUENTE ALTO                   ;METROPOLITANA;0;0;0;0;0;0;0;0;0;CELULAR A21s 128 GB AZUL;TELEFONIA
18208414;;F;30;CHILENO;;Millenial;PUNTA ARENAS                  ;MAGALLANES;0;0;0;0;0;0;0;0;0;CELULAR SAMSUNG A12 128GB BLACK CLARO;TELEFONIA
18960978;Soltero;M;27;CHILENO;;Z;PROVIDENCIA                   ;METROPOLITANA;0;0;0;0;0;0;0;0;0;CELULAR IPHONE SE 64GB DIRECTO CLARO;TELEFONIA
15128076;;M;39;CHILENO;;X;CURICO                        ;MAULE;0;0;0;0;0;0;0;0;0;CELULAR XIAOMI REDMI 9C 64GB TIWLIGHT BLUE TRI W;TELEFONIA
15272846;;M;41;CHILENO;;X;N/D;N/D;0;0;0;0;0;0;0;0;0;CELULAR MOTO G9 POWER 128GB MORADO SONICO OPEN;TELEFONIA
11814439;;F;50;CHILENO;;X;ARICA                         ;ARICA Y PARINACOTA;0;0;0;0;0;0;0;0;0;CELULAR VIVO Y11S PHANTON BLACK 32GB MOVISTAR;TELEFONIA
15058582;;F;39;CHILENO;;X;RENCA                         ;METROPOLITANA;0;0;0;0;0;0;0;0;0;CELULAR REDMI 9T 128 GB OCEAN GREEN;TELEFONIA
22628236;;F;52;EXTRANJERO - NO INFORMA NACIONALIDAD;;Extranjero;CERRO NAVIA                   ;METROPOLITANA;0;0;0;0;0;0;0;0;0;POCO X3 PRO 256 GB PHANTOM BLACK;TELEFONIA
18188850;;F;29;CHILENO;;Millenial;CAUQUENES                     ;MAULE;0;0;0;0;0;0;0;0;0;CELULAR A32 128 GB LIGHT VIOLET OPEN;TELEFONIA
8489131;Soltero;M;63;CHILENO;INGENIERO AGRICOLA;Boomers;RENCA                         ;METROPOLITANA;0;0;0;0;0;0;0;0;0;Celular LG K22 ENTEL DIRECTO TITAN;TELEFONIA
10277924;;M;55;CHILENO;;Boomers;RENCA                         ;METROPOLITANA;0;0;0;0;0;0;0;0;0;Celular AL3 CLARO DIRECTO NEGRO;TELEFONIA
12289837;;M;49;CHILENO;;Silencioso;PROVIDENCIA                   ;METROPOLITANA;0;0;0;0;0;0;0;0;0;CELULAR G8 POWER MOTO TRI ENTEL;TELEFONIA
16229968;;M;51;CHILENO;;X;N/D;N/D;0;0;0;0;0;0;0;0;0;CELULAR POCO X3 PRO 256 GB FROST BLUE;TELEFONIA
20005637;;F;23;CHILENO;;Z;COQUIMBO                      ;COQUIMBO;0;0;0;0;0;0;0;0;0;CELULAR Xiaomi Redmi 9 64 GB Morado WOM;TELEFONIA
19886810;;F;23;CHILENO;;Z;PROVIDENCIA                   ;METROPOLITANA;0;0;0;0;0;0;0;0;0;CELULAR REDMI NOTE 10S 128GB ONIX BLACK;TELEFONIA
17010756;;F;33;CHILENO;;Millenial;LA FLORIDA                    ;METROPOLITANA;0;0;0;0;0;0;0;0;0;POCO X3 PRO 256 GB PHANTOM BLACK;TELEFONIA
8271816;Divorciado;F;64;CHILENO;CONSTRUCTOR CIVIL;Boomers;SAN FELIPE                    ;VALPARAISO;0;0;0;0;0;0;0;0;0;CELULAR A12 128GB ROJO OPEN;TELEFONIA
15403747;Casado;F;40;CHILENO;PROFESOR;X;N/D;N/D;0;0;0;0;0;0;0;0;0;CELULAR A02 ROJO 32GB OPEN;TELEFONIA
18196269;;M;30;CHILENO;;Millenial;PROVIDENCIA                   ;METROPOLITANA;0;0;0;0;0;0;0;0;0;CELULAR MOTO ONE FUSION 64GB VERDE 64GB OPEN;TELEFONIA
3683623;;F;86;CHILENO;;Silencioso;EL BOSQUE                     ;METROPOLITANA;0;0;0;0;0;0;0;0;0;CELULAR MI 11 LITE 128GB BUBBLEGUM BLUE;TELEFONIA
12944126;;F;46;CHILENO;;X;OVALLE                        ;COQUIMBO;0;0;0;0;0;0;0;0;0;CELULAR GALAXY A01 32GB AZUL ENTEL;TELEFONIA
13808281;;F;42;CHILENO;;Silencioso;PROVIDENCIA                   ;METROPOLITANA;0;0;0;0;0;0;0;0;0;CELULAR A32 128 GB BLACK OPEN;TELEFONIA
17927052;;F;31;CHILENO;;Millenial;N/D;N/D;0;0;0;0;0;0;0;0;0;POCO X3 PRO 256 GB METAL BRONCE;TELEFONIA
16106817;Soltero;M;36;CHILENO;GASTRONOMIA INTERNACIONAL;Silencioso;PROVIDENCIA                   ;METROPOLITANA;0;0;0;0;0;0;0;0;0;Celular A10S LIB OPEN BLUE;TELEFONIA
18693597;;M;28;CHILENO;;Silencioso;PROVIDENCIA                   ;METROPOLITANA;0;0;0;0;0;0;0;0;0;CELULAR A21s 128 GB Negro;TELEFONIA
26542253;;M;37;EXTRANJERO - NO INFORMA NACIONALIDAD;;Extranjero;N/D;N/D;0;0;0;0;0;0;0;0;0;CELULAR POCO X3 PRO 256 GB FROST BLUE;TELEFONIA
15609079;;F;37;CHILENO;;Millenial;N/D;N/D;0;0;0;0;0;0;0;0;0;POCO X3 PRO 256 GB PHANTOM BLACK;TELEFONIA
18933803;;M;27;CHILENO;;Silencioso;PROVIDENCIA                   ;METROPOLITANA;0;0;0;0;0;0;0;0;0;POCO X3 PRO 256 GB PHANTOM BLACK;TELEFONIA
19145087;;F;27;CHILENO;;Millenial;PROVIDENCIA                   ;METROPOLITANA;0;0;0;0;0;0;0;0;0;CELULAR A32 128 GB LIGHT VIOLET OPEN;TELEFONIA
6517383;;F;69;CHILENO;;Silencioso;CALERA                        ;VALPARAISO;0;0;0;0;0;0;0;0;0;Celular XIAOMI REDMI 9C 64 GB DIRECTO CLARO;TELEFONIA
10694329;;F;56;CHILENO;;Boomers;PROVIDENCIA                   ;METROPOLITANA;0;0;0;0;0;0;0;0;0;CELULAR A32 128 GB WHITE OPEN;TELEFONIA
18618726;;M;26;CHILENO;;Silencioso;PROVIDENCIA                   ;METROPOLITANA;0;0;0;0;0;0;0;0;0;CELULAR POCO X3 PRO 256 GB FROST BLUE;TELEFONIA
16548607;;F;34;CHILENO;;Extranjero;PAILLACO                      ;LOS LAGOS;0;0;0;0;0;0;0;0;0;CELULAR REDMI 9T 128 GB OCEAN GREEN;TELEFONIA
4526847;;M;79;CHILENO;;Silencioso;RENCA                         ;METROPOLITANA;0;0;0;0;0;0;0;0;0;Celular LG K22 ENTEL DIRECTO TITAN;TELEFONIA
14325059;;M;45;CHILENO;;Silencioso;PROVIDENCIA                   ;METROPOLITANA;0;0;0;0;0;0;0;0;0;CELULAR A21s 128 GB Negro;TELEFONIA
17138578;;M;32;CHILENO;;Silencioso;PROVIDENCIA                   ;METROPOLITANA;0;0;0;0;0;0;0;0;0;CELULAR A32 128 GB BLUE OPEN;TELEFONIA
14250070;;F;53;CHILENO;;X;CARAHUE                       ;ARAUCANIA;0;0;0;0;0;0;0;0;0;CELULAR POCO X3 PRO 256 GB FROST BLUE;TELEFONIA
15834658;;M;37;CHILENO;;Millenial;PROVIDENCIA                   ;METROPOLITANA;0;0;0;0;0;0;0;0;0;CELULAR MOTOROLA E7 IPOWER 32GB BLUE CLARO;TELEFONIA
17823635;;M;30;CHILENO;;Silencioso;PROVIDENCIA                   ;METROPOLITANA;0;0;0;0;0;0;0;0;0;POCO X3 PRO 256 GB PHANTOM BLACK;TELEFONIA
13599010;;M;42;CHILENO;;Silencioso;PROVIDENCIA                   ;METROPOLITANA;0;0;0;0;0;0;0;0;0;CELULAR A21s 128 GB Rojo;TELEFONIA
20388330;;M;23;CHILENO;;Z;N/D;N/D;0;0;0;0;0;0;0;0;0;CELULAR HUAWEI Y7P NEGRO ENTEL;TELEFONIA
12597279;Soltero;F;47;CHILENO;;X;RENCA                         ;METROPOLITANA;0;0;0;0;0;0;0;0;0;CELULAR REDMI NOTE 8 2021 64GB MOONLIGHT WHITE;TELEFONIA
13820989;;F;41;CHILENO;;X;PROVIDENCIA                   ;METROPOLITANA;0;0;0;0;0;0;0;0;0;CELULAR A12 128GB ROJO OPEN;TELEFONIA
10456264;;F;56;CHILENO;;Boomers;N/D;N/D;0;0;0;0;0;0;0;0;0;CELULAR MOTO ONE FUSION 64GB VERDE 64GB OPEN;TELEFONIA
12799432;;M;47;CHILENO;;X;MELIPILLA                     ;METROPOLITANA;0;0;0;0;0;0;0;0;0;CELULAR A21s 128 GB Negro;TELEFONIA
10713402;;F;51;CHILENO;;X;N/D;N/D;0;0;0;0;0;0;0;0;0;POCO X3 PRO 256 GB METAL BRONCE;TELEFONIA
10637999;;F;56;CHILENO;;Boomers;PUERTO MONTT                  ;LOS LAGOS;0;0;0;0;0;0;0;0;0;CELULAR REDMI 9T 128 GB OCEAN GREEN;TELEFONIA
17829814;;M;31;CHILENO;;Millenial;N/D;N/D;0;0;0;0;0;0;0;0;0;Celular Galaxy S21 Ultra Phantom Black 128GB;TELEFONIA
12330367;Casado;F;49;CHILENO;;X;PROVIDENCIA                   ;METROPOLITANA;0;0;0;0;0;0;0;0;0;CELULAR REDMI 9T 128 GB OCEAN GREEN;TELEFONIA
6085756;Casado;M;70;CHILENO;PROFESOR;Silencioso;RENCA                         ;METROPOLITANA;0;0;0;0;0;0;0;0;0;CELULAR REDMI NOTE 9 128G FOREST GREEN OPEN;TELEFONIA
22629497;;M;62;PERUANO;;Extranjero;OVALLE                        ;COQUIMBO;0;0;0;0;0;0;0;0;0;CELULAR MOTO ONE FUSION 128GB AZUL OPEN;TELEFONIA
17880326;;M;30;CHILENO;;Silencioso;PROVIDENCIA                   ;METROPOLITANA;0;0;0;0;0;0;0;0;0;CELULAR REDMI NOTE 9 128 GB MIDNIGHT GREY OPEN;TELEFONIA
18717006;;F;28;CHILENO;;Millenial;N/D;N/D;0;0;0;0;0;0;0;0;0;CELULAR REDMI NOTE 8 2021 64 GB SPACE BLACK;TELEFONIA
18230658;;F;29;CHILENO;;Millenial;N/D;N/D;0;0;0;0;0;0;0;0;0;CELULAR MOTO E7I POWER 32GB BLUE MOVISTAR;TELEFONIA
19278686;;F;26;CHILENO;;Z;SAN BERNARDO                  ;METROPOLITANA;0;0;0;0;0;0;0;0;0;CELULAR MOTO ONE FUSION 128GB AZUL OPEN;TELEFONIA
15069192;;F;39;CHILENO;;X;N/D;N/D;0;0;0;0;0;0;0;0;0;CELULAR A32 128 GB BLACK OPEN;TELEFONIA
18439457;;F;28;CHILENO;;Millenial;"";"";0;0;0;0;0;0;0;0;0;CELULAR MOTOROLA E6 PLAY AZUL TRI WOM;TELEFONIA
16826984;;F;34;CHILENO;;Millenial;CAUQUENES                     ;MAULE;0;0;0;0;0;0;0;0;0;CELULAR A21s 128 GB AZUL;TELEFONIA
9453521;;M;59;CHILENO;;Boomers;LLAILLAY                      ;VALPARAISO;0;0;0;0;0;0;0;0;0;CELULAR GALAXY A01 32GB AZUL ENTEL;TELEFONIA
19194186;;F;26;CHILENO;;Millenial;"";"";0;0;0;0;0;0;0;0;0;CELULAR A32 128 GB LIGHT VIOLET OPEN;TELEFONIA
15153130;;F;40;CHILENO;;X;"";"";0;0;0;0;0;0;0;0;0;CELULAR A02s NEGRO 32GB OPEN;TELEFONIA
19972542;;M;23;CHILENO;;Silencioso;PROVIDENCIA                   ;METROPOLITANA;0;0;0;0;0;0;0;0;0;IPHONE XR 64GB LIB OPEN NEGRO;TELEFONIA
17828030;;F;30;CHILENO;;Millenial;LA SERENA                     ;COQUIMBO;0;0;0;0;0;0;0;0;0;CELULAR A32 128 GB BLUE OPEN;TELEFONIA
16581761;Soltero;M;34;CHILENO;;Millenial;PROVIDENCIA                   ;METROPOLITANA;0;0;0;0;0;0;0;0;0;CELULAR NOKIA 225 4G BLACK TRI ENTEL;TELEFONIA
13764853;;F;54;CHILENO;;X;QUILPUE                       ;VALPARAISO;0;0;0;0;0;0;0;0;0;CELULAR A32 128 GB LIGHT VIOLET OPEN;TELEFONIA
9373328;;F;62;CHILENO;;Boomers;RENCA                         ;METROPOLITANA;0;0;0;0;0;0;0;0;0;CELULAR MOTO E7 32GB ROSA CORAL OPEN;TELEFONIA
17347012;;F;32;CHILENO;;Millenial;SAN PEDRO DE LA PAZ;BIO-BIO;0;0;0;0;0;0;0;0;0;CELULAR REDMI NOTE 10 PRO 6+128GB GRADIENT BRONZ;TELEFONIA
10590285;;M;52;CHILENO;;X;VALLENAR;ATACAMA;0;0;0;0;0;0;0;0;0;Celular AL3 CLARO DIRECTO NEGRO;TELEFONIA
15520609;Casado;F;51;CHILENO;;X;PROVIDENCIA                   ;METROPOLITANA;0;0;0;0;0;0;0;0;0;CELULAR REDMI 9T 128 GB OCEAN GREEN;TELEFONIA
13672724;;M;42;CHILENO;;X;MAIPU                         ;METROPOLITANA;0;0;0;0;0;0;0;0;0;Celular XIAOMI REDMI 9 64 GB DIRECTO CLARO NEGRO;TELEFONIA
17629141;;M;31;CHILENO;;Millenial;N/D;N/D;0;0;0;0;0;0;0;0;0;CELULAR SAMSUNG A02S DIRECTO CLARO BLACK;TELEFONIA
18343710;;M;29;CHILENO;;Millenial;PUENTE ALTO                   ;METROPOLITANA;0;0;0;0;0;0;0;0;0;CELULAR A32 128 GB LIGHT VIOLET OPEN;TELEFONIA
22077857;Soltero;M;41;PERUANO;;Extranjero;PROVIDENCIA                   ;METROPOLITANA;0;0;0;0;0;0;0;0;0;CELULAR A12 128GB AZUL OPEN;TELEFONIA
7294113;;M;64;CHILENO;;Boomers;PUENTE ALTO                   ;METROPOLITANA;0;0;0;0;0;0;0;0;0;CELULAR A21s 128 GB Negro;TELEFONIA
19665370;;F;23;CHILENO;;Z;PROVIDENCIA                   ;METROPOLITANA;0;0;0;0;0;0;0;0;0;Celular G8 POWER LITE MOVISTAR DIRECTO AZUL;TELEFONIA
16700845;;F;34;CHILENO;;Millenial;N/D;N/D;0;0;0;0;0;0;0;0;0;CELULAR REDMI NOTE 10S 128GB PEBBLE WHITE;TELEFONIA
8514886;;F;62;CHILENO;;Boomers;PROVIDENCIA                   ;METROPOLITANA;0;0;0;0;0;0;0;0;0;CELULAR A21s 128 GB Rojo;TELEFONIA
12434754;;M;51;CHILENO;;X;ARICA                         ;TARAPACA;0;0;0;0;0;0;0;0;0;CELULAR A21s 128 GB Negro;TELEFONIA
7506851;;F;69;CHILENO;;Silencioso;PELLUHUE                      ;MAULE;0;0;0;0;0;0;0;0;0;CELULAR A12 128GB AZUL OPEN;TELEFONIA
18196670;;F;30;CHILENO;;Millenial;"";"";0;0;0;0;0;0;0;0;0;CELULAR MOTO E6I 32GB GRIS OPEN;TELEFONIA
15622419;Divorciado;F;42;CHILENO;;X;RENCA                         ;METROPOLITANA;0;0;0;0;0;0;0;0;0;CELULAR OWN 1026 AZUL ENTEL;TELEFONIA
9936509;Viudo;F;58;CHILENO;;Boomers;RENCA                         ;METROPOLITANA;0;0;0;0;0;0;0;0;0;CELULAR A12 128GB ROJO OPEN;TELEFONIA
20185420;;F;22;CHILENO;;Z;VINA DEL MAR                  ;VALPARAISO;0;0;0;0;0;0;0;0;0;CELULAR A12 128GB AZUL OPEN;TELEFONIA
13806348;;F;42;CHILENO;;X;PROVIDENCIA                   ;METROPOLITANA;0;0;0;0;0;0;0;0;0;CELULAR NOKIA QUEEN VALUE BLACK CLARO;TELEFONIA
7470159;;F;68;CHILENO;;Boomers;CARTAGENA                     ;VALPARAISO;0;0;0;0;0;0;0;0;0;CELULAR SAMSUNG A12 128GB BLACK CLARO;TELEFONIA
5261923;;M;75;CHILENO;;Silencioso;CANETE                        ;BIO BIO;0;0;0;0;0;0;0;0;0;Celular VIVO Y11S ENTEL DIRECTO AZUL;TELEFONIA
14400444;;M;43;CHILENO;;Silencioso;PROVIDENCIA                   ;METROPOLITANA;0;0;0;0;0;0;0;0;0;CELULAR A32 128 GB LIGHT VIOLET OPEN;TELEFONIA
9083861;Divorciado;F;58;CHILENO;;Boomers;PROVIDENCIA                   ;METROPOLITANA;0;0;0;0;0;0;0;0;0;CELULAR A21s 128 GB Negro;TELEFONIA
11419736;;F;52;CHILENO;;X;LEBU                          ;BIO BIO;0;0;0;0;0;0;0;0;0;CELULAR MOTOROLA E7 IPOWER 32GB BLUE CLARO;TELEFONIA
17502638;;F;32;CHILENO;;Millenial;RENGO                         ;L.G.B.OÂ´HIGGINS;0;0;0;0;0;0;0;0;0;POCO X3 PRO 256 GB PHANTOM BLACK;TELEFONIA
25971298;;M;33;HAITIANO;;Extranjero;PENALOLEN                     ;METROPOLITANA;0;0;0;0;0;0;0;0;0;CELULAR MOTO ONE FUSION 128GB AZUL OPEN;TELEFONIA
17111822;Soltero;M;33;CHILENO;;Millenial;PROVIDENCIA                   ;METROPOLITANA;0;0;0;0;0;0;0;0;0;CELULAR REDMI NOTE 9 128G FOREST GREEN OPEN;TELEFONIA
19608134;;F;25;CHILENO;;Z;PROVIDENCIA                   ;METROPOLITANA;0;0;0;0;0;0;0;0;0;Celular A11 LIB OPEN WHITE;TELEFONIA
20220825;;F;23;CHILENO;;Z;PROVIDENCIA                   ;METROPOLITANA;0;0;0;0;0;0;0;0;0;CELULAR MI 11 LITE 128GB BOBA BLACK OPEN;TELEFONIA
6857511;;F;78;CHILENO;;Silencioso;PROVIDENCIA                   ;METROPOLITANA;0;0;0;0;0;0;0;0;0;CELULAR NOKIA 225 4G BLACK MOVISTAR DIRECTO;TELEFONIA
15826182;Casado;F;38;CHILENO;;Millenial;PARRAL                        ;MAULE;0;0;0;0;0;0;0;0;0;CELULAR REDMI NOTE 10 128GB ONIX GRAY OPEN;TELEFONIA
15864358;;M;37;CHILENO;;Millenial;RENCA                         ;METROPOLITANA;0;0;0;0;0;0;0;0;0;CELULAR GALAXY S20FE 128GB CLOUD LAVENDER OPEN;TELEFONIA
20150263;;M;23;CHILENO;;Z;N/D;N/D;0;0;0;0;0;0;0;0;0;Celular LG K22 DIRECTO CLARO;TELEFONIA
25821033;;M;24;BOLIVIANO;;Extranjero;N/D;N/D;0;0;0;0;0;0;0;0;0;CELULAR XIAOMI REDMI 9C 64GB MIDNIGHT GRAY;TELEFONIA
11746557;Casado;F;51;CHILENO;CONTADOR GENERAL;X;RENCA                         ;METROPOLITANA;0;0;0;0;0;0;0;0;0;CELULAR A32 128 GB BLACK OPEN;TELEFONIA
24033868;;F;37;PERUANO;;Extranjero;SANTIAGO                      ;METROPOLITANA;0;0;0;0;0;0;0;0;0;CELULAR MOTO G9 POWER PURPLE 128GB MOVISTAR;TELEFONIA
12748762;;M;46;CHILENO;;X;VALDIVIA                      ;LOS LAGOS;0;0;0;0;0;0;0;0;0;CELULAR A02 NEGRO 32GB OPEN;TELEFONIA
11695721;Soltero;M;52;CHILENO;;X;PROVIDENCIA                   ;METROPOLITANA;0;0;0;0;0;0;0;0;0;CELULAR MOTO E6I 32GB GRIS OPEN;TELEFONIA
19968137;;F;23;CHILENO;;Silencioso;PROVIDENCIA                   ;METROPOLITANA;0;0;0;0;0;0;0;0;0;CELULAR REDMI 9 64GB SUNSET PURPLE TRI WOM;TELEFONIA
19380438;;F;25;CHILENO;;Z;PROVIDENCIA                   ;METROPOLITANA;0;0;0;0;0;0;0;0;0;CELULAR REDMI NOTE 10S 128GB PEBBLE WHITE;TELEFONIA
8059373;;F;67;CHILENO;;Boomers;RENCA                         ;METROPOLITANA;0;0;0;0;0;0;0;0;0;CELULAR REDMI 9C 32GB TWILIGHT BLUE MOVISTAR;TELEFONIA
6870023;Casado;F;69;CHILENO;;Silencioso;RENCA                         ;METROPOLITANA;0;0;0;0;0;0;0;0;0;CELULAR MOTO E6I 32GB GRIS OPEN;TELEFONIA
19895197;;F;24;CHILENO;;Z;PROVIDENCIA                   ;METROPOLITANA;0;0;0;0;0;0;0;0;0;CELULAR A21s 128 GB Negro;TELEFONIA
19414684;Soltero;F;26;CHILENO;;Z;CHILLAN                       ;BIO BIO;0;0;0;0;0;0;0;0;0;CELULAR MOTOROLA G9 PLAY 64GB SPRING PINK OPEN;TELEFONIA
18574003;Soltero;M;28;CHILENO;;Millenial;PROVIDENCIA                   ;METROPOLITANA;0;0;0;0;0;0;0;0;0;CELULAR REDMI NOTE 9 128G FOREST GREEN OPEN;TELEFONIA
16542721;Soltero;F;34;CHILENO;;Millenial;PROVIDENCIA                   ;METROPOLITANA;0;0;0;0;0;0;0;0;0;CELULAR Xiaomi Redmi 9 64 GB Morado WOM;TELEFONIA
17810380;Soltero;F;31;CHILENO;INGENIERO COMERCIAL;Silencioso;PROVIDENCIA                   ;METROPOLITANA;0;0;0;0;0;0;0;0;0;CELULAR POCO M3 128GB POWER BLACK;TELEFONIA
16254143;;M;36;CHILENO;;Millenial;N/D;N/D;0;0;0;0;0;0;0;0;0;CELULAR POCO F3 128 GB DEEP OCEAN BLUE;TELEFONIA
5758881;Casado;M;73;CHILENO;INGENIERO;Silencioso;PROVIDENCIA                   ;METROPOLITANA;0;0;0;0;0;0;0;0;0;CELULAR A32 128 GB WHITE OPEN;TELEFONIA
17685065;;F;31;CHILENO;;Millenial;PROVIDENCIA                   ;METROPOLITANA;0;0;0;0;0;0;0;0;0;CELULAR SAMSUNG NOTE 20 MYSTIC GRAY OPEN;TELEFONIA
9063691;;F;56;CHILENO;;Boomers;TOME                          ;BIO BIO;0;0;0;0;0;0;0;0;0;CELULAR VIVO Y11S PHANTOM BLACK OPEN;TELEFONIA
11764734;;F;51;CHILENO;;X;CONSTITUCION                  ;MAULE;0;0;0;0;0;0;0;0;0;CELULAR A12 128GB NEGRO OPEN;TELEFONIA
15599989;Soltero;M;40;CHILENO;;X;PROVIDENCIA                   ;METROPOLITANA;0;0;0;0;0;0;0;0;0;CELULAR MOTO E6I ROSA OPEN;TELEFONIA
16254663;;F;37;CHILENO;;Millenial;COINCO                        ;L.G.B.OÂ´HIGGINS;0;0;0;0;0;0;0;0;0;CELULAR A32 128 GB BLACK OPEN;TELEFONIA
10314057;;M;55;CHILENO;;Boomers;PROVIDENCIA                   ;METROPOLITANA;0;0;0;0;0;0;0;0;0;CELULAR VIVO Y20 BLACK 64GB MOVISTAR;TELEFONIA
20230113;;M;22;CHILENO;;Silencioso;PROVIDENCIA                   ;METROPOLITANA;0;0;0;0;0;0;0;0;0;CELULAR POCO M3 64GB POWER BLACK;TELEFONIA
26075234;;F;35;VENEZOLANO;;Extranjero;BUIN                          ;METROPOLITANA;0;0;0;0;0;0;0;0;0;POCO X3 PRO 256 GB METAL BRONCE;TELEFONIA
7374486;Divorciado;M;65;CHILENO;;Silencioso;PROVIDENCIA                   ;METROPOLITANA;0;0;0;0;0;0;0;0;0;CELULAR VIVO Y11S PHANTON BLACK 32GB MOVISTAR;TELEFONIA
9842296;;M;58;CHILENO;;Boomers;SANTIAGO                      ;METROPOLITANA;0;0;0;0;0;0;0;0;0;CELULAR POCO X3 PRO 256 GB FROST BLUE;TELEFONIA
16373232;;M;36;CHILENO;;Millenial;N/D;N/D;0;0;0;0;0;0;0;0;0;Celular NOKIA 4.2 ENTEL DIRECTO NEGRO;TELEFONIA
18426296;;M;28;CHILENO;;Millenial;PROVIDENCIA                   ;METROPOLITANA;0;0;0;0;0;0;0;0;0;CELULAR A32 128 GB BLACK OPEN;TELEFONIA
18280687;;M;30;CHILENO;;Millenial;PALMILLA                      ;L.G.B.OÂ´HIGGINS;0;0;0;0;0;0;0;0;0;CELULAR MOTOROLA E7 IPOWER 32GB BLUE CLARO;TELEFONIA
17602863;;M;31;CHILENO;;Millenial;PROVIDENCIA                   ;METROPOLITANA;0;0;0;0;0;0;0;0;0;CELULAR SAMSUNG NOTE 20 MYSTIC GRAY OPEN;TELEFONIA
17084581;;F;33;CHILENO;;Millenial;N/D;N/D;0;0;0;0;0;0;0;0;0;CELULAR A72 128 GB BLACK OPEN;TELEFONIA
13588783;Soltero;F;43;CHILENO;;X;PROVIDENCIA                   ;METROPOLITANA;0;0;0;0;0;0;0;0;0;Celular A12 Negro 128GB Tri Entel;TELEFONIA
19746214;;F;24;CHILENO;;Silencioso;PROVIDENCIA                   ;METROPOLITANA;0;0;0;0;0;0;0;0;0;CELULAR A21s 128 GB Rojo;TELEFONIA
11730151;;F;52;CHILENO;;X;PUTAENDO                      ;VALPARAISO;0;0;0;0;0;0;0;0;0;CELULAR MOTO E6I ROSA OPEN;TELEFONIA
19713638;;F;24;CHILENO;;Z;PROVIDENCIA                   ;METROPOLITANA;0;0;0;0;0;0;0;0;0;CELULAR MOTO E6S 32GB GRIS DIRECTO ENTEL;TELEFONIA
19705187;;F;24;CHILENO;;Z;PROVIDENCIA                   ;METROPOLITANA;0;0;0;0;0;0;0;0;0;CELULAR SAMSUNG NOTE 20 MYSTIC GRAY OPEN;TELEFONIA
8010978;;F;65;CHILENO;;Boomers;PUERTO MONTT                  ;LOS LAGOS;0;0;0;0;0;0;0;0;0;CELULAR REDMI NOTE 9 128G FOREST GREEN OPEN;TELEFONIA
16846907;;M;34;CHILENO;;Millenial;CONSTITUCION                  ;MAULE;0;0;0;0;0;0;0;0;0;CELULAR A02 ROJO 32GB OPEN;TELEFONIA
8030947;;F;61;CHILENO;;Millenial;N/D;N/D;0;0;0;0;0;0;0;0;0;CELULAR A32 128 GB LIGHT VIOLET OPEN;TELEFONIA
17301540;;M;32;CHILENO;;Millenial;N/D;N/D;0;0;0;0;0;0;0;0;0;IPHONE XS 64GB DORADO OPEN;TELEFONIA
20164269;;M;23;CHILENO;;Silencioso;PROVIDENCIA                   ;METROPOLITANA;0;0;0;0;0;0;0;0;0;CELULAR MI 11 LITE 128GB BUBBLEGUM BLUE;TELEFONIA
18351564;Soltero;F;29;CHILENO;;Millenial;N/D;N/D;0;0;0;0;0;0;0;0;0;CELULAR A02s ROJO 32GB OPEN;TELEFONIA
19581070;;M;24;CHILENO;;Z;PROVIDENCIA                   ;METROPOLITANA;0;0;0;0;0;0;0;0;0;CELULAR A12 128GB AZUL OPEN;TELEFONIA
16372012;Soltero;F;36;CHILENO;;Millenial;PROVIDENCIA                   ;METROPOLITANA;0;0;0;0;0;0;0;0;0;Celular A11 LIB OPEN WHITE;TELEFONIA
10105371;;M;56;CHILENO;;Boomers;RENCA                         ;METROPOLITANA;0;0;0;0;0;0;0;0;0;CELULAR NOKIA 225 4G BLACK MOVISTAR DIRECTO;TELEFONIA
15203445;;F;41;CHILENO;;Silencioso;PROVIDENCIA                   ;METROPOLITANA;0;0;0;0;0;0;0;0;0;CELULAR MOTO E7I POWER 32GB BLUE MOVISTAR;TELEFONIA
19526867;;M;25;CHILENO;;Z;N/D;N/D;0;0;0;0;0;0;0;0;0;CELULAR MOTO G100 128GB VERDE BOREAL + HMDI OPEN;TELEFONIA
13122877;;F;45;CHILENO;;Silencioso;CALBUCO                       ;LOS LAGOS;0;0;0;0;0;0;0;0;0;CELULAR A21s 128 GB Negro;TELEFONIA
19467263;;M;24;CHILENO;;Silencioso;PROVIDENCIA                   ;METROPOLITANA;0;0;0;0;0;0;0;0;0;CELULAR XIAOMI POCO X3 64G SHADOW GRAY;TELEFONIA
11783433;;M;50;CHILENO;;X;PANGUIPULLI                   ;LOS LAGOS;0;0;0;0;0;0;0;0;0;Celular A11 LIB OPEN WHITE;TELEFONIA
20391197;;F;22;CHILENO;;Silencioso;PROVIDENCIA                   ;METROPOLITANA;0;0;0;0;0;0;0;0;0;CELULAR G8 POWER MOTO TRI ENTEL;TELEFONIA
16835054;;F;34;CHILENO;;Millenial;SAN VICENTE                   ;L.G.B.OÂ´HIGGINS;0;0;0;0;0;0;0;0;0;CELULAR MOTOROLA G9 PLAY 64GB BLUE DIRECTO CLAR;TELEFONIA
18389968;;F;28;CHILENO;;Millenial;PROVIDENCIA                   ;METROPOLITANA;0;0;0;0;0;0;0;0;0;CELULAR A12 128GB ROJO OPEN;TELEFONIA
18707618;Soltero;F;28;CHILENO;;Millenial;PROVIDENCIA                   ;METROPOLITANA;0;0;0;0;0;0;0;0;0;CELULAR A32 128 GB BLACK OPEN;TELEFONIA
11786227;Casado;M;50;CHILENO;TECNICO EN ELECTRICIDAD;X;RENCA                         ;METROPOLITANA;0;0;0;0;0;0;0;0;0;CELULAR A32 128 GB BLACK OPEN;TELEFONIA
18294318;Soltero;F;29;CHILENO;PROFESOR;Millenial;PROVIDENCIA                   ;METROPOLITANA;0;0;0;0;0;0;0;0;0;CELULAR MOTO ONE FUSION 64GB VERDE 64GB OPEN;TELEFONIA
18982906;;F;27;CHILENO;;Z;HUALANE                       ;MAULE;0;0;0;0;0;0;0;0;0;CELULAR ZTE A3 2020 GRIS DIRECTO CLARO;TELEFONIA
16279479;;M;36;CHILENO;;Millenial;PROVIDENCIA                   ;METROPOLITANA;0;0;0;0;0;0;0;0;0;CELULAR A32 128 GB LIGHT VIOLET OPEN;TELEFONIA
13013339;;M;48;CHILENO;;X;PROVIDENCIA                   ;METROPOLITANA;0;0;0;0;0;0;0;0;0;CELULAR REDMI NOTE 9 128G FOREST GREEN OPEN;TELEFONIA
11910951;;F;50;CHILENO;;X;HUALAIHUE                     ;LOS LAGOS;0;0;0;0;0;0;0;0;0;CELULAR GALAXY S20FE 128GB ClOUD NAVY OPEN;TELEFONIA
16564510;Soltero;F;34;CHILENO;;Millenial;PROVIDENCIA                   ;METROPOLITANA;0;0;0;0;0;0;0;0;0;CELULAR A21s 128 GB AZUL;TELEFONIA
26825030;;M;38;VENEZOLANO;;Extranjero;CORONEL                       ;BIO BIO;0;0;0;0;0;0;0;0;0;CELULAR REDMI 9A 32GB PEACOCK GREEN;TELEFONIA
9004799;;F;62;CHILENO;;Boomers;CERRO NAVIA                   ;METROPOLITANA;0;0;0;0;0;0;0;0;0;CELULAR VIVO Y11S PHANTOM BLACK OPEN;TELEFONIA
15731491;Casado;M;39;CHILENO;;X;PROVIDENCIA                   ;METROPOLITANA;0;0;0;0;0;0;0;0;0;CELULAR MOTO ONE FUSION 64GB VERDE 64GB OPEN;TELEFONIA
13855547;;M;42;CHILENO;;X;LA SERENA                     ;COQUIMBO;0;0;0;0;0;0;0;0;0;CELULAR A32 128 GB BLUE OPEN;TELEFONIA
15739366;;M;38;CHILENO;;X;TALCA                         ;MAULE;0;0;0;0;0;0;0;0;0;CELULAR A02 AZUL 32GB OPEN;TELEFONIA
16396326;;M;35;CHILENO;;Millenial;N/D;N/D;0;0;0;0;0;0;0;0;0;CELULAR A32 128 GB BLACK OPEN;TELEFONIA
6108959;;F;71;CHILENO;;Silencioso;CARAHUE                       ;ARAUCANIA;0;0;0;0;0;0;0;0;0;Celular A01 LIB OPEN ROJO;TELEFONIA
14204192;;M;41;CHILENO;;X;COLTAUCO                      ;L.G.B.OÂ´HIGGINS;0;0;0;0;0;0;0;0;0;CELULAR A32 128 GB BLACK OPEN;TELEFONIA
14688300;;F;55;BOLIVIANO;;Extranjero;CALAMA                        ;ANTOFAGASTA;0;0;0;0;0;0;0;0;0;CELULAR VIVO Y11S PHANTON BLACK 32GB MOVISTAR;TELEFONIA
9249640;;M;60;CHILENO;;Boomers;CHILLAN VIEJO                 ;BIO BIO;0;0;0;0;0;0;0;0;0;CELULAR MI 11 LITE 128GB BUBBLEGUM BLUE;TELEFONIA
11092283;;F;55;CHILENO;;Boomers;PUTAENDO                      ;VALPARAISO;0;0;0;0;0;0;0;0;0;CELULAR A21s 128 GB Rojo;TELEFONIA
16987924;;F;37;CHILENO;;Millenial;N/D;N/D;0;0;0;0;0;0;0;0;0;CELULAR A32 128 GB WHITE OPEN;TELEFONIA
10802962;;M;40;CHILENO;;X;COPIAPO;ATACAMA;0;0;0;0;0;0;0;0;0;CELULAR VIVO Y20S NEBULA 128 GB BLUE OPEN;TELEFONIA
9417817;;F;57;CHILENO;;Boomers;RENCA                         ;METROPOLITANA;0;0;0;0;0;0;0;0;0;CELULAR A21s 128 GB Rojo;TELEFONIA
19108783;;M;26;CHILENO;;Silencioso;PROVIDENCIA                   ;METROPOLITANA;0;0;0;0;0;0;0;0;0;CELULAR MOTO ONE FUSION 128GB AZUL OPEN;TELEFONIA
12741864;;M;46;CHILENO;;X;TEMUCO                        ;ARAUCANIA;0;0;0;0;0;0;0;0;0;CELULAR A21s 128 GB Negro;TELEFONIA
18504711;;F;28;CHILENO;;Millenial;RENCA                         ;METROPOLITANA;0;0;0;0;0;0;0;0;0;CELULAR REDMI NOTE 9 128G FOREST GREEN OPEN;TELEFONIA
13265922;Casado;M;45;CHILENO;INGENIERO QUIMICO;Silencioso;PROVIDENCIA                   ;METROPOLITANA;0;0;0;0;0;0;0;0;0;CELULAR A32 128 GB WHITE OPEN;TELEFONIA
16462460;;F;35;CHILENO;;Millenial;PARRAL                        ;MAULE;0;0;0;0;0;0;0;0;0;CELULAR MOTOROLA G9 PLAY ROSADO DIRECTO WOM;TELEFONIA
8608921;;M;60;CHILENO;;Boomers;SAN JUAN DE LA COSTA          ;LOS LAGOS;0;0;0;0;0;0;0;0;0;CELULAR A12 128GB AZUL OPEN;TELEFONIA
20366822;;M;22;CHILENO;;Z;TEMUCO                        ;ARAUCANIA;0;0;0;0;0;0;0;0;0;CELULAR A32 128 GB WHITE OPEN;TELEFONIA
13907812;;M;42;CHILENO;;X;HUECHURABA;METROPOLITANA;0;0;0;0;0;0;0;0;0;CELULAR MOTOROLA G9 PLAY 64GB ELECTRIC BLUE OPEN;TELEFONIA
17063616;;F;33;CHILENO;;Millenial;SANTIAGO                      ;METROPOLITANA;0;0;0;0;0;0;0;0;0;CELULAR ZTE A3 2020 GRIS DIRECTO CLARO;TELEFONIA
13993367;;F;40;CHILENO;;X;PETORCA                       ;VALPARAISO;0;0;0;0;0;0;0;0;0;CELULAR A21s 128 GB AZUL;TELEFONIA
15313374;;M;45;CHILENO;;X;PROVIDENCIA                   ;METROPOLITANA;0;0;0;0;0;0;0;0;0;CELULAR GALAXY A01 32GB AZUL ENTEL;TELEFONIA
6186685;;M;76;CHILENO;;Silencioso;VALLENAR;ATACAMA;0;0;0;0;0;0;0;0;0;CELULAR A21s 128 GB Negro;TELEFONIA
8946002;;F;53;CHILENO;;X;RENCA                         ;METROPOLITANA;0;0;0;0;0;0;0;0;0;CELULAR OWN 1026 AZUL ENTEL;TELEFONIA
9266741;;F;57;CHILENO;;Boomers;RENAICO                       ;ARAUCANIA;0;0;0;0;0;0;0;0;0;CELULAR REDMI 9 64GB SUNSET PURPLE TRI WOM;TELEFONIA
16123158;Soltero;M;37;CHILENO;;Silencioso;PROVIDENCIA                   ;METROPOLITANA;0;0;0;0;0;0;0;0;0;CELULAR A32 128 GB LIGHT VIOLET OPEN;TELEFONIA
19925857;;F;24;CHILENO;;Z;RENGO                         ;L.G.B.OÂ´HIGGINS;0;0;0;0;0;0;0;0;0;CELULAR REDMI NOTE 10 PRO 128GB GLACIER BLUE;TELEFONIA
19943894;;F;24;CHILENO;;Z;PROVIDENCIA                   ;METROPOLITANA;0;0;0;0;0;0;0;0;0;CELULAR REDMI NOTE 10 EU 128G Lake Green BUNDLE;TELEFONIA
14608997;;F;40;CHILENO;;X;COLINA                        ;METROPOLITANA;0;0;0;0;0;0;0;0;0;CELULAR A12 128GB AZUL OPEN;TELEFONIA
17426330;;M;32;CHILENO;;Millenial;RENCA;METROPOLITANA;0;0;0;0;0;0;0;0;0;CELULAR REDMI NOTE 10 PRO 128GB GLACIER BLUE;TELEFONIA
14733080;;F;47;PERUANO;;Extranjero;RECOLETA                      ;METROPOLITANA;0;0;0;0;0;0;0;0;0;CELULAR A21s 128 GB Negro;TELEFONIA
20303869;;F;22;CHILENO;;Z;MALLOA                        ;L.G.B.OÂ´HIGGINS;0;0;0;0;0;0;0;0;0;CELULAR MOTOROLA G9 PLAY 64GB SPRING PINK OPEN;TELEFONIA
19649946;;M;24;CHILENO;;Silencioso;PROVIDENCIA                   ;METROPOLITANA;0;0;0;0;0;0;0;0;0;POCO X3 PRO 256 GB PHANTOM BLACK;TELEFONIA
12149089;;F;50;CHILENO;;X;LEBU                          ;BIO BIO;0;0;0;0;0;0;0;0;0;CELULAR ZTE A5 2020 DIRECTO CLARO VERDE;TELEFONIA
7855262;Casado;M;64;CHILENO;;Silencioso;PROVIDENCIA                   ;METROPOLITANA;0;0;0;0;0;0;0;0;0;CELULAR MOTO ONE FUSION 64GB VERDE 64GB OPEN;TELEFONIA
20184830;;F;22;CHILENO;;Millenial;"";"";0;0;0;0;0;0;0;0;0;CELULAR POCO M3 64GB POWER BLACK;TELEFONIA
18086713;Soltero;F;30;CHILENO;;Millenial;PROVIDENCIA                   ;METROPOLITANA;0;0;0;0;0;0;0;0;0;CELULAR A21s 128 GB AZUL;TELEFONIA
17884058;;F;30;CHILENO;;Millenial;YERBAS BUENAS                 ;MAULE;0;0;0;0;0;0;0;0;0;CELULAR A72 128 GB BLACK OPEN;TELEFONIA
13838250;;M;42;CHILENO;;X;RENCA                         ;METROPOLITANA;0;0;0;0;0;0;0;0;0;CELULAR MOTOROLA G9 PLAY 64GB SPRING PINK OPEN;TELEFONIA
11997198;;M;50;CHILENO;;X;ROMERAL                       ;MAULE;0;0;0;0;0;0;0;0;0;Celular A11 LIB OPEN BLACK;TELEFONIA
19924448;;F;24;CHILENO;;Z;PROVIDENCIA                   ;METROPOLITANA;0;0;0;0;0;0;0;0;0;CELULAR A32 128 GB LIGHT VIOLET OPEN;TELEFONIA
6323792;;M;72;CHILENO;;Silencioso;N/D;N/D;0;0;0;0;0;0;0;0;0;Celular 2.3 MOVISTAR DIRECTO CHARCOAL;TELEFONIA
6355456;;M;71;CHILENO;;Silencioso;CANETE                        ;BIO BIO;0;0;0;0;0;0;0;0;0;CELULAR OWN 1026 AZUL ENTEL;TELEFONIA
9245888;;M;61;CHILENO;;Boomers;RENCA                         ;METROPOLITANA;0;0;0;0;0;0;0;0;0;Celular AL3 CLARO DIRECTO NEGRO;TELEFONIA
14088498;;M;40;CHILENO;;X;PUNTA ARENAS                  ;MAGALLANES;0;0;0;0;0;0;0;0;0;CELULAR A32 128 GB WHITE OPEN;TELEFONIA
11378951;;M;53;CHILENO;;X;CHAITEN                       ;LOS LAGOS;0;0;0;0;0;0;0;0;0;CELULAR REDMI 9A 32GB SKY BLUE DIRECTO MOVISTAR;TELEFONIA
17866357;Soltero;M;30;CHILENO;;Millenial;PROVIDENCIA                   ;METROPOLITANA;0;0;0;0;0;0;0;0;0;CELULAR REDMI NOTE 10 128GB ONIX GRAY OPEN;TELEFONIA
17029466;;M;33;CHILENO;;Millenial;PROVIDENCIA                   ;METROPOLITANA;0;0;0;0;0;0;0;0;0;CELULAR OWN 1026 AZUL ENTEL;TELEFONIA
16953552;Soltero;M;33;CHILENO;;Silencioso;PROVIDENCIA                   ;METROPOLITANA;0;0;0;0;0;0;0;0;0;Celular A11 LIB OPEN WHITE;TELEFONIA
20059330;;F;23;CHILENO;;Silencioso;PROVIDENCIA                   ;METROPOLITANA;0;0;0;0;0;0;0;0;0;IPHONE 7 32GB LIB OPEN SILVER;TELEFONIA
16798635;;F;34;CHILENO;;Millenial;COLINA                        ;METROPOLITANA;0;0;0;0;0;0;0;0;0;Celular Y9S LIB OPEN BREATHING CRYSTAL;TELEFONIA
17339747;;M;32;CHILENO;;Millenial;"";"";0;0;0;0;0;0;0;0;0;IPHONE 11 128GB BLACK CLARO;TELEFONIA
16469186;;F;35;CHILENO;;Millenial;N/D;N/D;0;0;0;0;0;0;0;0;0;CELULAR REDMI 9 32GB CARBON GREY OPEN;TELEFONIA
17906357;;M;31;CHILENO;;Millenial;PROVIDENCIA                   ;METROPOLITANA;0;0;0;0;0;0;0;0;0;CELULAR MOTO G9 POWER 128GB MORADO SONICO OPEN;TELEFONIA
15575647;;F;38;CHILENO;;Millenial;MONTE PATRIA                  ;COQUIMBO;0;0;0;0;0;0;0;0;0;CELULAR A02 ROJO 32GB OPEN;TELEFONIA
11375105;;M;53;CHILENO;;X;LINARES                       ;MAULE;0;0;0;0;0;0;0;0;0;Celular XIAOMI REDMI 9C 64 GB DIRECTO CLARO;TELEFONIA
9151605;;F;61;CHILENO;;Boomers;CERRO NAVIA                   ;METROPOLITANA;0;0;0;0;0;0;0;0;0;CELULAR A32 128 GB BLACK OPEN;TELEFONIA
20146160;;M;23;CHILENO;;Millenial;LA PINTANA                    ;METROPOLITANA;0;0;0;0;0;0;0;0;0;CELULAR XIAOMI POCO X3 64G SHADOW GRAY;TELEFONIA
19913844;;F;24;CHILENO;;Z;EL BOSQUE                     ;METROPOLITANA;0;0;0;0;0;0;0;0;0;CELULAR A32 128 GB LIGHT VIOLET OPEN;TELEFONIA
14678179;;F;60;PERUANO;;Extranjero;N/D;N/D;0;0;0;0;0;0;0;0;0;CELULAR A12 128GB ROJO OPEN;TELEFONIA
15115699;;M;42;CHILENO;;X;CHEPICA                       ;L.G.B.OÂ´HIGGINS;0;0;0;0;0;0;0;0;0;CELULAR POCO M3 64GB COOL BLUE;TELEFONIA
16130689;;M;37;CHILENO;;Millenial;N/D;N/D;0;0;0;0;0;0;0;0;0;CELULAR A21s 128 GB Rojo;TELEFONIA
8053592;;F;66;CHILENO;;Boomers;RENCA                         ;METROPOLITANA;0;0;0;0;0;0;0;0;0;CELULAR NOKIA 225 4G BLACK MOVISTAR DIRECTO;TELEFONIA
8070729;;F;62;CHILENO;;Boomers;N/D;N/D;0;0;0;0;0;0;0;0;0;Celular A10S LIB OPEN BLUE;TELEFONIA
19074609;Casado;F;26;CHILENO;;Silencioso;CHILLAN                       ;BIO BIO;0;0;0;0;0;0;0;0;0;CELULAR A02s ROJO 32GB OPEN;TELEFONIA
8824527;;M;60;CHILENO;;Boomers;PROVIDENCIA                   ;METROPOLITANA;0;0;0;0;0;0;0;0;0;Celular A11 LIB OPEN BLUE;TELEFONIA
5229889;;M;75;CHILENO;;Silencioso;SAN BERNARDO                  ;METROPOLITANA;0;0;0;0;0;0;0;0;0;CELULAR VIVO Y20 NEGRO DIRECTO ENTEL;TELEFONIA
19601166;;F;25;CHILENO;;Z;PROVIDENCIA                   ;METROPOLITANA;0;0;0;0;0;0;0;0;0;Celular G8 POWER LITE WOM DIRECTO TURQUESA;TELEFONIA
18319836;Soltero;F;29;CHILENO;TECNICO DE NIVEL SUPERIOR EN ENFERMERIA;Millenial;PROVIDENCIA                   ;METROPOLITANA;0;0;0;0;0;0;0;0;0;CELULAR A11 CLARO DIRECTO BLACK;TELEFONIA
15049963;Soltero;F;28;CHILENO;;Millenial;N/D;N/D;0;0;0;0;0;0;0;0;0;CELULAR A02 ROJO 32GB OPEN;TELEFONIA
15259007;;M;40;CHILENO;;X;PROVIDENCIA                   ;METROPOLITANA;0;0;0;0;0;0;0;0;0;Celular LG K22 DIRECTO CLARO;TELEFONIA
7291330;Casado;F;67;CHILENO;;Boomers;RANCAGUA                      ;L.G.B.OÂ´HIGGINS;0;0;0;0;0;0;0;0;0;CELULAR A02 ROJO 32GB OPEN;TELEFONIA
12767325;;M;47;CHILENO;;X;CORONEL                       ;BIO BIO;0;0;0;0;0;0;0;0;0;Celular A71 LIB OPEN NEGRO;TELEFONIA
19319111;;F;26;CHILENO;;Z;PUENTE ALTO                   ;METROPOLITANA;0;0;0;0;0;0;0;0;0;CELULAR VIVO Y51 CRYSTAL SYMPHONY OPEN;TELEFONIA
9298348;Casado;M;57;CHILENO;INGENIERO AGRICOLA;Boomers;PROVIDENCIA                   ;METROPOLITANA;0;0;0;0;0;0;0;0;0;CELULAR A32 128 GB LIGHT VIOLET OPEN;TELEFONIA
13048010;;M;46;CHILENO;;Silencioso;PROVIDENCIA                   ;METROPOLITANA;0;0;0;0;0;0;0;0;0;CELULAR A02 ROJO 32GB OPEN;TELEFONIA
12595957;;F;48;CHILENO;;X;ANTOFAGASTA                   ;ANTOFAGASTA;0;0;0;0;0;0;0;0;0;CELULAR A02s ROJO 32GB OPEN;TELEFONIA
17293922;;M;32;CHILENO;;Millenial;LA SERENA                     ;COQUIMBO;0;0;0;0;0;0;0;0;0;CELULAR OWN 1026 AZUL ENTEL;TELEFONIA
20054910;;F;23;CHILENO;;Z;COLINA                        ;METROPOLITANA;0;0;0;0;0;0;0;0;0;CELULAR MOTOROLA G9 PLAY 64GB BLUE DIRECTO CLAR;TELEFONIA
14172310;;M;41;CHILENO;;Millenial;EL BOSQUE                     ;METROPOLITANA;0;0;0;0;0;0;0;0;0;CELULAR Xiaomi Redmi 9 64 GB Morado WOM;TELEFONIA
20213692;;F;22;CHILENO;;Z;PROVIDENCIA                   ;METROPOLITANA;0;0;0;0;0;0;0;0;0;CELULAR GALAXY S20FE 128GB ClOUD NAVY OPEN;TELEFONIA
18748103;;F;28;CHILENO;;Millenial;PROVIDENCIA                   ;METROPOLITANA;0;0;0;0;0;0;0;0;0;Celular A01 Core Azul Tri Entel;TELEFONIA
16760539;;M;34;CHILENO;;Millenial;PROVIDENCIA                   ;METROPOLITANA;0;0;0;0;0;0;0;0;0;IPHONE 7 LIB OPEN NEGRO;TELEFONIA
10790311;Casado;M;54;CHILENO;TECNICO EN ADMINISTRACION DE EMPRESAS;Boomers;N/D;N/D;0;0;0;0;0;0;0;0;0;CELULAR REDMI NOTE 10 EU 128G Lake Green BUNDLE;TELEFONIA
19803253;;F;24;CHILENO;;Z;QUINTA NORMAL                 ;METROPOLITANA;0;0;0;0;0;0;0;0;0;CELULAR MOTO G9 POWER 128GB MORADO SONICO OPEN;TELEFONIA
19650048;;M;24;CHILENO;;Silencioso;PROVIDENCIA                   ;METROPOLITANA;0;0;0;0;0;0;0;0;0;CELULAR XIAOMI REDMI 9 64GB DIRECTO CLARO MORADO;TELEFONIA
19358254;;M;24;CHILENO;;Silencioso;PROVIDENCIA                   ;METROPOLITANA;0;0;0;0;0;0;0;0;0;CELULAR POCO M3 64GB COOL BLUE;TELEFONIA
8705414;;M;54;CHILENO;;Boomers;PROVIDENCIA                   ;METROPOLITANA;0;0;0;0;0;0;0;0;0;CELULAR A21s 128 GB AZUL;TELEFONIA
17015281;;F;33;CHILENO;;Silencioso;PROVIDENCIA                   ;METROPOLITANA;0;0;0;0;0;0;0;0;0;CELULAR MOTOROLA G9 PLAY 64GB BLUE DIRECTO CLAR;TELEFONIA
12872827;;F;46;CHILENO;;X;LINARES                       ;MAULE;0;0;0;0;0;0;0;0;0;CELULAR A32 128 GB BLUE OPEN;TELEFONIA
19895335;;F;24;CHILENO;;Silencioso;PROVIDENCIA                   ;METROPOLITANA;0;0;0;0;0;0;0;0;0;CELULAR OWN 1026 AZUL ENTEL;TELEFONIA
13504482;;M;44;CHILENO;;X;N/D;N/D;0;0;0;0;0;0;0;0;0;CELULAR A72 128 GB BLACK OPEN;TELEFONIA
13293434;;M;46;CHILENO;;X;PROVIDENCIA                   ;METROPOLITANA;0;0;0;0;0;0;0;0;0;CELULAR A32 128 GB BLUE OPEN;TELEFONIA
14332153;;M;44;CHILENO;;Millenial;"";"";0;0;0;0;0;0;0;0;0;Celular Y7P LIB OPEN NEGRO;TELEFONIA
16454273;;F;36;CHILENO;;Millenial;TALCA                         ;MAULE;0;0;0;0;0;0;0;0;0;CELULAR POCO M3 64GB POWER BLACK;TELEFONIA
16402891;;F;35;CHILENO;;Silencioso;PROVIDENCIA                   ;METROPOLITANA;0;0;0;0;0;0;0;0;0;CELULAR MOTOROLA G9 PLAY 64GB SPRING PINK OPEN;TELEFONIA
15672162;;M;37;CHILENO;;Millenial;"";"";0;0;0;0;0;0;0;0;0;CELULAR A72 128 GB BLACK OPEN;TELEFONIA
15821163;;F;37;CHILENO;;Millenial;N/D;N/D;0;0;0;0;0;0;0;0;0;CELULAR SAMSUNG A12 128GB BLACK CLARO;TELEFONIA
11576661;;F;52;CHILENO;;X;N/D;N/D;0;0;0;0;0;0;0;0;0;CELULAR A32 128 GB BLACK OPEN;TELEFONIA
13799899;;M;42;CHILENO;;X;LA PINTANA                    ;METROPOLITANA;0;0;0;0;0;0;0;0;0;Celular NOKIA 1.3 NEGRO WOM;TELEFONIA
26068047;;F;25;EXTRANJERO - NO INFORMA NACIONALIDAD;;Extranjero;PROVIDENCIA                   ;METROPOLITANA;0;0;0;0;0;0;0;0;0;Celular Galaxy S21 Ultra Phantom Silver 128GB;TELEFONIA
9124140;;F;56;CHILENO;;Boomers;PROVIDENCIA                   ;METROPOLITANA;0;0;0;0;0;0;0;0;0;CELULAR REDMI NOTE 9 128G FOREST GREEN OPEN;TELEFONIA
13357724;;M;44;CHILENO;;X;ILLAPEL                       ;COQUIMBO;0;0;0;0;0;0;0;0;0;CELULAR A21s 128 GB Rojo;TELEFONIA
17148242;;M;33;CHILENO;;Millenial;MELIPILLA                     ;METROPOLITANA;0;0;0;0;0;0;0;0;0;CELULAR A12 128GB NEGRO OPEN;TELEFONIA
19467735;Soltero;F;25;CHILENO;;Z;PROVIDENCIA                   ;METROPOLITANA;0;0;0;0;0;0;0;0;0;CELULAR A21s 128 GB AZUL;TELEFONIA
8145693;Casado;M;65;CHILENO;;Silencioso;PROVIDENCIA                   ;METROPOLITANA;0;0;0;0;0;0;0;0;0;CELULAR A02s AZUL 32GB OPEN;TELEFONIA
14373045;Casado;F;47;CHILENO;;X;CONCEPCION                    ;BIO BIO;0;0;0;0;0;0;0;0;0;CELULAR MOTOROLA G9 PLAY 64GB SPRING PINK OPEN;TELEFONIA
12533997;Soltero;M;50;CHILENO;;X;RENCA                         ;METROPOLITANA;0;0;0;0;0;0;0;0;0;Celular LG K22 ENTEL DIRECTO TITAN;TELEFONIA
5704252;;M;74;CHILENO;;Silencioso;PROVIDENCIA                   ;METROPOLITANA;0;0;0;0;0;0;0;0;0;CELULAR OWN 1026 AZUL ENTEL;TELEFONIA
14111535;;F;41;CHILENO;;X;N/D;N/D;0;0;0;0;0;0;0;0;0;Celular A01 CLARO DIRECTO BLACK;TELEFONIA
6969641;;M;68;CHILENO;;Boomers;ALTO HOSPICIO;TARAPACA;0;0;0;0;0;0;0;0;0;CHIP OPEN ENTEL;TELEFONIA
12694861;;M;48;CHILENO;;X;SAN FERNANDO                  ;L.G.B.OÂ´HIGGINS;0;0;0;0;0;0;0;0;0;CELULAR Samsung Galaxy A02s 32GB Azul WOM;TELEFONIA
18222923;;M;29;CHILENO;;Millenial;PROVIDENCIA                   ;METROPOLITANA;0;0;0;0;0;0;0;0;0;Celular G8 POWER LITE WOM DIRECTO TURQUESA;TELEFONIA
12947556;;M;46;CHILENO;;X;N/D;N/D;0;0;0;0;0;0;0;0;0;Celular A11 LIB OPEN BLACK;TELEFONIA
19508097;;F;25;CHILENO;;Silencioso;PROVIDENCIA                   ;METROPOLITANA;0;0;0;0;0;0;0;0;0;Celular AL3 CLARO DIRECTO NEGRO;TELEFONIA
20226453;;M;22;CHILENO;;Silencioso;"";"";0;0;0;0;0;0;0;0;0;CELULAR REDMI NOTE 9 128GB ONYX BLACK OPEN;TELEFONIA
20300568;;F;22;CHILENO;;Z;PROVIDENCIA                   ;METROPOLITANA;0;0;0;0;0;0;0;0;0;CELULAR A32 128 GB BLUE OPEN;TELEFONIA
15375180;;M;39;CHILENO;;Millenial;N/D;N/D;0;0;0;0;0;0;0;0;0;CELULAR SAMSUNG NOTE 20 MYSTIC GRAY OPEN;TELEFONIA
18541814;;F;29;CHILENO;;Millenial;SANTA CRUZ;O HIGGINS;0;0;0;0;0;0;0;0;0;CELULAR XIAOMI REDMI 9 64GB DIRECTO CLARO MORADO;TELEFONIA
19060274;;M;25;CHILENO;;Z;CAUQUENES                     ;MAULE;0;0;0;0;0;0;0;0;0;CELULAR A21s 128 GB AZUL;TELEFONIA
11544771;Divorciado;F;52;CHILENO;;X;RENCA                         ;METROPOLITANA;0;0;0;0;0;0;0;0;0;CELULAR A02s ROJO 32GB OPEN;TELEFONIA
14418620;Soltero;F;51;CHILENO;CONTADOR AUDITOR;X;OVALLE                        ;COQUIMBO;0;0;0;0;0;0;0;0;0;CELULAR REDMI NOTE 10 EU 128G Lake Green BUNDLE;TELEFONIA
6843171;;F;78;CHILENO;;Silencioso;PROVIDENCIA                   ;METROPOLITANA;0;0;0;0;0;0;0;0;0;CELULAR NOKIA 110 BLACK OPEN;TELEFONIA
8477639;;M;63;CHILENO;;Boomers;ARICA                         ;TARAPACA;0;0;0;0;0;0;0;0;0;CELULAR Xiaomi Redmi 9 64 GB Morado WOM;TELEFONIA
13452520;;M;43;CHILENO;;X;PROVIDENCIA                   ;METROPOLITANA;0;0;0;0;0;0;0;0;0;CELULAR A21s 128 GB Negro;TELEFONIA
7052616;;M;66;CHILENO;;Boomers;N/D;N/D;0;0;0;0;0;0;0;0;0;CELULAR OWN 1026 AZUL ENTEL;TELEFONIA
8187432;;F;63;CHILENO;;Boomers;PROVIDENCIA                   ;METROPOLITANA;0;0;0;0;0;0;0;0;0;CELULAR MOTO G9 POWER 128GB MORADO SONICO OPEN;TELEFONIA
18547932;;F;29;CHILENO;;Millenial;N/D;N/D;0;0;0;0;0;0;0;0;0;CELULAR MOTO E6I 32GB GRIS OPEN;TELEFONIA
10547488;;M;55;CHILENO;;Boomers;RENCA                         ;METROPOLITANA;0;0;0;0;0;0;0;0;0;CELULAR POCO M3 64GB COOL BLUE;TELEFONIA
17500661;;M;32;CHILENO;;Millenial;SAN FERNANDO                  ;L.G.B.OÂ´HIGGINS;0;0;0;0;0;0;0;0;0;Celular Y6 2019 WOM DIRECTO BLACK;TELEFONIA
11686662;;F;53;CHILENO;;Silencioso;PROVIDENCIA                   ;METROPOLITANA;0;0;0;0;0;0;0;0;0;Celular LG K22 ENTEL DIRECTO TITAN;TELEFONIA
10437479;;F;55;CHILENO;;Boomers;QUINTA NORMAL                 ;METROPOLITANA;0;0;0;0;0;0;0;0;0;CELULAR REDMI 9 32GB CARBON GREY OPEN;TELEFONIA
12755189;;M;47;CHILENO;;X;OSORNO                        ;LOS LAGOS;0;0;0;0;0;0;0;0;0;Celular A11 LIB OPEN WHITE;TELEFONIA
13632513;;M;43;CHILENO;;X;CALAMA                        ;ANTOFAGASTA;0;0;0;0;0;0;0;0;0;CELULAR A21s 128 GB Rojo;TELEFONIA
15112360;;M;35;CHILENO;;Millenial;PICHIDEGUA                    ;L.G.B.OÂ´HIGGINS;0;0;0;0;0;0;0;0;0;CELULAR POCO M3 64GB COOL BLUE;TELEFONIA
16998295;;M;33;CHILENO;;Millenial;TALCA                         ;MAULE;0;0;0;0;0;0;0;0;0;Celular SAMSUNG A31 BLACK CLARO;TELEFONIA
14174276;Soltero;F;41;CHILENO;TECNICO DE NIVEL SUPERIOR LABORATORISTA DENTAL;X;RENCA                         ;METROPOLITANA;0;0;0;0;0;0;0;0;0;CELULAR REDMI NOTE 9 PRO 128GB GLACIER WHITE;TELEFONIA
16492393;;F;35;CHILENO;;Millenial;PROVIDENCIA                   ;METROPOLITANA;0;0;0;0;0;0;0;0;0;CELULAR A02s ROJO 32GB OPEN;TELEFONIA
15891577;Soltero;F;37;CHILENO;PROFESOR;Millenial;PROVIDENCIA                   ;METROPOLITANA;0;0;0;0;0;0;0;0;0;Celular A51 128GB LIB OPEN AZUL;TELEFONIA
8402271;Casado;M;65;CHILENO;;Boomers;PROVIDENCIA                   ;METROPOLITANA;0;0;0;0;0;0;0;0;0;CELULAR A21s 128 GB Negro;TELEFONIA
14456791;;F;50;CHILENO;;X;SAN CARLOS                    ;BIO BIO;0;0;0;0;0;0;0;0;0;CELULAR REDMI NOTE 10 EU 64GB ONIX GRAY OPEN;TELEFONIA
12775196;;F;47;CHILENO;;X;LAMPA                         ;METROPOLITANA;0;0;0;0;0;0;0;0;0;CELULAR A12 128GB NEGRO OPEN;TELEFONIA
12595616;;F;48;CHILENO;;X;SALAMANCA                     ;COQUIMBO;0;0;0;0;0;0;0;0;0;CELULAR A02s NEGRO 32GB OPEN;TELEFONIA
7195997;Casado;F;66;CHILENO;;Boomers;PROVIDENCIA                   ;METROPOLITANA;0;0;0;0;0;0;0;0;0;Celular A51 128GB LIB OPEN BLANCO;TELEFONIA
16463405;Soltero;F;35;CHILENO;KINESIOLOGA;Millenial;PROVIDENCIA                   ;METROPOLITANA;0;0;0;0;0;0;0;0;0;CELULAR MOTO G8 POWER LITE AZUL TRI ENTEL;TELEFONIA
15341501;;F;39;CHILENO;;Silencioso;PROVIDENCIA                   ;METROPOLITANA;0;0;0;0;0;0;0;0;0;Celular A51 128GB LIB OPEN AZUL;TELEFONIA
19197077;;F;26;CHILENO;;Z;PROVIDENCIA                   ;METROPOLITANA;0;0;0;0;0;0;0;0;0;CELULAR A32 128 GB LIGHT VIOLET OPEN;TELEFONIA
14412087;;M;41;CHILENO;;X;LA FLORIDA                    ;METROPOLITANA;0;0;0;0;0;0;0;0;0;CELULAR POCO M3 64GB COOL BLUE;TELEFONIA
9358199;Soltero;M;43;CHILENO;PSICOLOGO;Silencioso;PROVIDENCIA                   ;METROPOLITANA;0;0;0;0;0;0;0;0;0;CELULAR REDMI 9 32GB CARBON GREY OPEN;TELEFONIA
18146772;;M;29;CHILENO;;Millenial;PROVIDENCIA                   ;METROPOLITANA;0;0;0;0;0;0;0;0;0;Celular Galaxy S21 Phantom Grey 128GB;TELEFONIA
13280779;Casado;M;44;CHILENO;CONTADOR GENERAL;X;PROVIDENCIA                   ;METROPOLITANA;0;0;0;0;0;0;0;0;0;Celular AL3 CLARO DIRECTO NEGRO;TELEFONIA
17937490;;F;30;CHILENO;;Millenial;"";"";0;0;0;0;0;0;0;0;0;Celular A71 LIB OPEN PLATEADO;TELEFONIA
8564267;;M;52;CHILENO;;X;RENCA                         ;METROPOLITANA;0;0;0;0;0;0;0;0;0;Celular A01 CLARO DIRECTO BLACK;TELEFONIA
18851581;;F;35;CHILENO;;Millenial;PROVIDENCIA                   ;METROPOLITANA;0;0;0;0;0;0;0;0;0;CELULAR A21s 128 GB AZUL;TELEFONIA
12856249;;M;47;CHILENO;;Silencioso;PROVIDENCIA                   ;METROPOLITANA;0;0;0;0;0;0;0;0;0;CELULAR ZTE A3 2020 GRIS DIRECTO CLARO;TELEFONIA
15825075;;M;38;CHILENO;;Millenial;N/D;N/D;0;0;0;0;0;0;0;0;0;CELULAR A21s 128 GB AZUL;TELEFONIA
10100421;Soltero;M;57;CHILENO;INGENIERO AGRICOLA;Boomers;RENCA                         ;METROPOLITANA;0;0;0;0;0;0;0;0;0;CELULAR NOKIA 5.3 CHARCOAL TRI ENTEL;TELEFONIA
16619162;;M;34;CHILENO;;Millenial;PROVIDENCIA                   ;METROPOLITANA;0;0;0;0;0;0;0;0;0;CELULAR XIAOMI MI 10T 128GB LUNAR SILVER OPEN;TELEFONIA
7410974;;F;67;CHILENO;;Boomers;N/D;N/D;0;0;0;0;0;0;0;0;0;Celular A11 LIB OPEN BLUE;TELEFONIA
5813257;Soltero;F;70;CHILENO;;Silencioso;EL BOSQUE                     ;METROPOLITANA;0;0;0;0;0;0;0;0;0;CELULAR REDMI 9 64GB SUNSET PURPLE TRI WOM;TELEFONIA
18324323;Soltero;F;29;CHILENO;CIRUJANA DENTISTA;Millenial;PROVIDENCIA                   ;METROPOLITANA;0;0;0;0;0;0;0;0;0;Celular Galaxy S21 Phantom White 128GB;TELEFONIA
19459324;;F;25;CHILENO;;Z;COPIAPO                       ;ATACAMA;0;0;0;0;0;0;0;0;0;CELULAR A32 128 GB BLACK OPEN;TELEFONIA
18648773;;F;27;CHILENO;;Millenial;DONIHUE;O HIGGINS;0;0;0;0;0;0;0;0;0;CELULAR MOTOROLA G9 PLAY 64GB SPRING PINK OPEN;TELEFONIA
6251736;;M;71;CHILENO;;Silencioso;PROVIDENCIA                   ;METROPOLITANA;0;0;0;0;0;0;0;0;0;CELULAR A02s AZUL 32GB OPEN;TELEFONIA
18747601;;F;28;CHILENO;;Millenial;PROVIDENCIA                   ;METROPOLITANA;0;0;0;0;0;0;0;0;0;CELULAR A21s 128 GB AZUL;TELEFONIA
5160073;Casado;F;74;CHILENO;;Silencioso;EL BOSQUE                     ;METROPOLITANA;0;0;0;0;0;0;0;0;0;Celular LG K22 DIRECTO CLARO;TELEFONIA
18697223;;F;28;CHILENO;;Millenial;PROVIDENCIA                   ;METROPOLITANA;0;0;0;0;0;0;0;0;0;REPETIDOR MI WIFI RANGE EXTENDER PRO XIAOMI;TELEFONIA
9845858;;F;59;CHILENO;;Silencioso;PROVIDENCIA                   ;METROPOLITANA;0;0;0;0;0;0;0;0;0;IPHONE 7 LIB OPEN NEGRO;TELEFONIA
20044424;;F;23;CHILENO;;Z;PROVIDENCIA                   ;METROPOLITANA;0;0;0;0;0;0;0;0;0;CELULAR REDMI NOTE 10 EU 64GB ONIX GRAY OPEN;TELEFONIA
17180271;Soltero;F;32;CHILENO;;Millenial;PROVIDENCIA                   ;METROPOLITANA;0;0;0;0;0;0;0;0;0;CELULAR A21s 128 GB AZUL;TELEFONIA
11062211;;F;56;CHILENO;;Boomers;PROVIDENCIA                   ;METROPOLITANA;0;0;0;0;0;0;0;0;0;Celular A11 LIB OPEN BLACK;TELEFONIA
19041723;;F;27;CHILENO;;Z;VICUNA                        ;COQUIMBO;0;0;0;0;0;0;0;0;0;Celular NOKIA 4.2 ENTEL DIRECTO NEGRO;TELEFONIA
20124626;;M;23;CHILENO;;Millenial;PROVIDENCIA                   ;METROPOLITANA;0;0;0;0;0;0;0;0;0;Celular LG K22 MOVISTAR DIRECTO TITAN;TELEFONIA
10430562;;M;53;CHILENO;;X;PROVIDENCIA                   ;METROPOLITANA;0;0;0;0;0;0;0;0;0;Celular Z FLIP LIB OPEN PURPLE;TELEFONIA
18522717;;M;29;CHILENO;;Millenial;PROVIDENCIA                   ;METROPOLITANA;0;0;0;0;0;0;0;0;0;CELULAR REDMI 9 32GB CARBON GREY OPEN;TELEFONIA
15438007;Soltero;F;40;CHILENO;;X;PROVIDENCIA                   ;METROPOLITANA;0;0;0;0;0;0;0;0;0;Celular A11 LIB OPEN WHITE;TELEFONIA
19574973;;F;25;CHILENO;;Silencioso;LINARES                       ;MAULE;0;0;0;0;0;0;0;0;0;Celular A31 LIB OPEN ROJO;TELEFONIA
13752754;;F;42;CHILENO;;X;PROVIDENCIA                   ;METROPOLITANA;0;0;0;0;0;0;0;0;0;Celular A11 LIB OPEN BLACK;TELEFONIA
13307319;;F;44;CHILENO;;X;CONCEPCION                    ;BIO BIO;0;0;0;0;0;0;0;0;0;Celular NOKIA 6.2 MOVISTAR DIRECTO NEGRO;TELEFONIA
26772200;Soltero;F;27;EXTRANJERO - NO INFORMA NACIONALIDAD;;Extranjero;VITACURA;METROPOLITANA;0;0;0;0;0;0;0;0;0;Celular A11 LIB OPEN WHITE;TELEFONIA
15432416;;F;40;CHILENO;;Silencioso;PROVIDENCIA                   ;METROPOLITANA;0;0;0;0;0;0;0;0;0;CELULAR A02s ROJO 32GB OPEN;TELEFONIA
15909483;;M;37;CHILENO;;Millenial;LA SERENA                     ;COQUIMBO;0;0;0;0;0;0;0;0;0;IPHONE 11 64GB BLACK CLARO;TELEFONIA
17786792;Casado;M;30;CHILENO;;Millenial;RENCA                         ;METROPOLITANA;0;0;0;0;0;0;0;0;0;CELULAR A21s 128 GB Negro;TELEFONIA
16671787;;F;35;CHILENO;;Silencioso;PROVIDENCIA                   ;METROPOLITANA;0;0;0;0;0;0;0;0;0;Celular Y9S LIB OPEN BREATHING CRYSTAL;TELEFONIA
24751650;;F;31;BOLIVIANO;;Extranjero;CALAMA                        ;ANTOFAGASTA;0;0;0;0;0;0;0;0;0;Celular A51 128GB LIB OPEN AZUL;TELEFONIA
13763104;;F;41;CHILENO;;X;LA LIGUA                      ;VALPARAISO;0;0;0;0;0;0;0;0;0;CELULAR REDMI NOTE 9 128G FOREST GREEN OPEN;TELEFONIA
14356494;;M;43;CHILENO;;X;RENGO                         ;L.G.B.OÂ´HIGGINS;0;0;0;0;0;0;0;0;0;CELULAR MOTOROLA G9 PLAY 64GB BLUE DIRECTO CLAR;TELEFONIA
16663176;;M;34;CHILENO;;Millenial;PUENTE ALTO                   ;METROPOLITANA;0;0;0;0;0;0;0;0;0;CELULAR REDMI NOTE 10 EU 128G Onyx Gray BUNDLE;TELEFONIA
19450492;;M;25;CHILENO;;Z;N/D;N/D;0;0;0;0;0;0;0;0;0;CELULAR MI 11 LITE 128GB BOBA BLACK OPEN;TELEFONIA
16021710;;M;37;CHILENO;;Millenial;PROVIDENCIA                   ;METROPOLITANA;0;0;0;0;0;0;0;0;0;CELULAR REDMI NOTE 9 128GB ONYX BLACK OPEN;TELEFONIA
15940282;;F;37;CHILENO;;Millenial;PROVIDENCIA                   ;METROPOLITANA;0;0;0;0;0;0;0;0;0;CELULAR A21s 128 GB Rojo;TELEFONIA
5602990;;M;70;CHILENO;;Silencioso;LOS ANDES                     ;VALPARAISO;0;0;0;0;0;0;0;0;0;Celular S20 FE LIB OPEN Cloud Lavender;TELEFONIA
15501623;;F;39;CHILENO;;X;LA SERENA                     ;COQUIMBO;0;0;0;0;0;0;0;0;0;CELULAR POCO M3 64GB COOL BLUE;TELEFONIA
18544860;;M;29;CHILENO;;Millenial;PROVIDENCIA                   ;METROPOLITANA;0;0;0;0;0;0;0;0;0;Celular Galaxy S21 Phantom Grey 128GB;TELEFONIA
17791197;Soltero;M;31;CHILENO;;Millenial;PROVIDENCIA                   ;METROPOLITANA;0;0;0;0;0;0;0;0;0;CELULAR A52 128 GB BLACK OPEN;TELEFONIA
16549196;;F;35;CHILENO;;Millenial;ANTOFAGASTA                   ;ANTOFAGASTA;0;0;0;0;0;0;0;0;0;CELULAR A21s 128 GB Rojo;TELEFONIA
17291388;;M;33;CHILENO;;Millenial;CURANILAHUE;BIO-BIO;0;0;0;0;0;0;0;0;0;CELULAR A02s ROJO 32GB OPEN;TELEFONIA
11467403;;M;53;CHILENO;;X;PROVIDENCIA                   ;METROPOLITANA;0;0;0;0;0;0;0;0;0;CELULAR A21s 128 GB Negro;TELEFONIA
10208770;;M;56;CHILENO;;Boomers;RENCA                         ;METROPOLITANA;0;0;0;0;0;0;0;0;0;CELULAR VIVO Y20 BLACK 64GB MOVISTAR;TELEFONIA
18851051;Soltero;F;27;CHILENO;;Z;PROVIDENCIA                   ;METROPOLITANA;0;0;0;0;0;0;0;0;0;Celular A11 LIB OPEN BLACK;TELEFONIA
18318558;;M;29;CHILENO;;Millenial;ANGOL                         ;ARAUCANIA;0;0;0;0;0;0;0;0;0;CELULAR A02s NEGRO 32GB OPEN;TELEFONIA
14056269;;M;50;CHILENO;;X;CONSTITUCION                  ;MAULE;0;0;0;0;0;0;0;0;0;CELULAR HUAWEI Y9 PRIME BLUE OPEN;TELEFONIA
16773316;Soltero;M;34;CHILENO;PROFESOR;Millenial;PROVIDENCIA                   ;METROPOLITANA;0;0;0;0;0;0;0;0;0;Celular A51 128GB LIB OPEN BLACK;TELEFONIA
12789253;;F;46;CHILENO;;X;PELLUHUE                      ;MAULE;0;0;0;0;0;0;0;0;0;CELULAR A12 128GB NEGRO OPEN;TELEFONIA
15880280;;M;40;CHILENO;;X;TIRUA                         ;BIO BIO;0;0;0;0;0;0;0;0;0;CELULAR MOTOROLA G9 PLAY 64GB BLUE DIRECTO CLAR;TELEFONIA
15230097;;F;39;CHILENO;;Silencioso;PROVIDENCIA                   ;METROPOLITANA;0;0;0;0;0;0;0;0;0;CELULAR MOTOROLA G9 PLAY 64GB SPRING PINK OPEN;TELEFONIA
17992707;Soltero;F;30;CHILENO;;Millenial;RENCA                         ;METROPOLITANA;0;0;0;0;0;0;0;0;0;Celular LG K22 ENTEL DIRECTO TITAN;TELEFONIA
12946492;;F;46;CHILENO;;X;SALAMANCA                     ;COQUIMBO;0;0;0;0;0;0;0;0;0;Celular A51 128GB LIB OPEN AZUL;TELEFONIA
19849150;;M;23;CHILENO;;Silencioso;PROVIDENCIA                   ;METROPOLITANA;0;0;0;0;0;0;0;0;0;CELULAR A12 128GB NEGRO OPEN;TELEFONIA
9995258;;M;47;CHILENO;;X;PUERTO OCTAY                  ;LOS LAGOS;0;0;0;0;0;0;0;0;0;Celular A11 LIB OPEN BLACK;TELEFONIA
12082681;;F;59;CHILENO;;Boomers;PROVIDENCIA                   ;METROPOLITANA;0;0;0;0;0;0;0;0;0;Celular SA3 CLARO DIRECTO BLACK;TELEFONIA
11629736;;M;51;CHILENO;;X;RENCA                         ;METROPOLITANA;0;0;0;0;0;0;0;0;0;Celular XIAOMI REDMI 9 64 GB DIRECTO CLARO NEGRO;TELEFONIA
17356302;;F;32;CHILENO;;Silencioso;PROVIDENCIA                   ;METROPOLITANA;0;0;0;0;0;0;0;0;0;Celular A01 Core Azul Tri Entel;TELEFONIA
13567987;;F;43;CHILENO;;X;PROVIDENCIA                   ;METROPOLITANA;0;0;0;0;0;0;0;0;0;CELULAR SAMSUNG A02S DIRECTO CLARO BLACK;TELEFONIA
15040041;;F;40;CHILENO;;X;RENCA                         ;METROPOLITANA;0;0;0;0;0;0;0;0;0;CELULAR NOKIA 110 BLACK OPEN;TELEFONIA
18411313;Soltero;M;28;CHILENO;;Silencioso;PROVIDENCIA                   ;METROPOLITANA;0;0;0;0;0;0;0;0;0;Celular XIAOMI REDMI 9 64 GB DIRECTO CLARO NEGRO;TELEFONIA
11284953;Divorciado;F;53;CHILENO;;X;PROVIDENCIA                   ;METROPOLITANA;0;0;0;0;0;0;0;0;0;CELULAR G8 POWER MOTO TRI ENTEL;TELEFONIA
15967486;;M;37;CHILENO;;Millenial;MAIPU                         ;METROPOLITANA;0;0;0;0;0;0;0;0;0;CELULAR MOTOROLA E6S ROSADO DIRECTO WOM;TELEFONIA
11238748;;M;53;CHILENO;;X;QUILICURA                     ;METROPOLITANA;0;0;0;0;0;0;0;0;0;CELULAR A21s 128 GB Negro;TELEFONIA
11426521;;F;52;CHILENO;;X;PROVIDENCIA                   ;METROPOLITANA;0;0;0;0;0;0;0;0;0;Celular G8 POWER LITE MOVISTAR DIRECTO AZUL;TELEFONIA
12945693;;F;46;CHILENO;;X;ILLAPEL                       ;COQUIMBO;0;0;0;0;0;0;0;0;0;CELULAR MOTOROLA E6 PLAY AZUL TRI WOM;TELEFONIA
17748484;Soltero;F;31;CHILENO;KINESIOLOGO;Millenial;PROVIDENCIA                   ;METROPOLITANA;0;0;0;0;0;0;0;0;0;CELULAR NOKIA 225 4G BLACK TRI ENTEL;TELEFONIA
7162533;Casado;M;65;CHILENO;;Boomers;EL QUISCO                     ;VALPARAISO;0;0;0;0;0;0;0;0;0;Celular A01 CLARO DIRECTO BLACK;TELEFONIA
6840779;;M;69;CHILENO;;Silencioso;CANELA                        ;COQUIMBO;0;0;0;0;0;0;0;0;0;CELULAR MOTO E6I 32GB GRIS OPEN;TELEFONIA
19876516;;F;24;CHILENO;;Z;PROVIDENCIA                   ;METROPOLITANA;0;0;0;0;0;0;0;0;0;Celular A51 128GB LIB OPEN BLANCO;TELEFONIA
12561668;;F;48;CHILENO;;X;PUENTE ALTO                   ;METROPOLITANA;0;0;0;0;0;0;0;0;0;CELULAR LG K61 Gris OPEN;TELEFONIA
12096627;Casado;M;53;CHILENO;;X;RENCA                         ;METROPOLITANA;0;0;0;0;0;0;0;0;0;Celular ZTE A3 2020 ENTEL DIRECTO GRIS;TELEFONIA
18826144;;M;27;CHILENO;;Millenial;CALAMA                        ;ANTOFAGASTA;0;0;0;0;0;0;0;0;0;CELULAR REDMI NOTE 9 PRO 128GB TROPICAL GREEN;TELEFONIA
18874126;;F;27;CHILENO;;Millenial;TEMUCO                        ;ARAUCANIA;0;0;0;0;0;0;0;0;0;CELULAR A12 128GB NEGRO OPEN;TELEFONIA
10721977;Casado;M;52;CHILENO;;X;PROVIDENCIA                   ;METROPOLITANA;0;0;0;0;0;0;0;0;0;CELULAR REDMI 9 64GB CARBON GREY;TELEFONIA
26745823;;F;22;VENEZOLANO;;Extranjero;"";"";0;0;0;0;0;0;0;0;0;Celular A11 LIB OPEN BLACK;TELEFONIA
17709774;Soltero;M;30;CHILENO;;Millenial;COLLIPULLI                    ;ARAUCANIA;0;0;0;0;0;0;0;0;0;CELULAR A21s 128 GB AZUL;TELEFONIA
17346160;Soltero;M;32;CHILENO;MEDICO CIRUJANO;Silencioso;PROVIDENCIA                   ;METROPOLITANA;0;0;0;0;0;0;0;0;0;Celular Galaxy S21 Phantom Grey 128GB;TELEFONIA
17585732;;F;31;CHILENO;;Millenial;PROVIDENCIA                   ;METROPOLITANA;0;0;0;0;0;0;0;0;0;CELULAR SAMSUNG A01 NEGRO DIRECTO WOM;TELEFONIA
12589837;;F;47;CHILENO;;X;TALCA                         ;MAULE;0;0;0;0;0;0;0;0;0;Celular SA3 CLARO DIRECTO BLACK;TELEFONIA
18083047;;M;29;CHILENO;;Millenial;PROVIDENCIA                   ;METROPOLITANA;0;0;0;0;0;0;0;0;0;CELULAR REDMI NOTE 10 128GB ONIX GRAY OPEN;TELEFONIA
10339651;;M;57;CHILENO;;Boomers;N/D;N/D;0;0;0;0;0;0;0;0;0;Celular A51 128GB LIB OPEN BLACK;TELEFONIA
19790780;;F;25;CHILENO;;Z;PROVIDENCIA                   ;METROPOLITANA;0;0;0;0;0;0;0;0;0;IPHONE 8 64 GB LIB OPEN PLATEADO;TELEFONIA
19121002;;F;26;CHILENO;;Z;PROVIDENCIA                   ;METROPOLITANA;0;0;0;0;0;0;0;0;0;Celular A51 128GB LIB OPEN AZUL;TELEFONIA
19528183;;F;25;CHILENO;;Z;PROVIDENCIA                   ;METROPOLITANA;0;0;0;0;0;0;0;0;0;CELULAR IPHONE SE 64GB DIRECTO CLARO;TELEFONIA
10009865;;M;52;CHILENO;;X;PROVIDENCIA                   ;METROPOLITANA;0;0;0;0;0;0;0;0;0;CELULAR A21s 128 GB Rojo;TELEFONIA
11136583;;F;55;CHILENO;;Boomers;PROVIDENCIA                   ;METROPOLITANA;0;0;0;0;0;0;0;0;0;Celular R340 CLARO DIRECTO NEGRO;TELEFONIA
15906053;;M;37;CHILENO;;Silencioso;PROVIDENCIA                   ;METROPOLITANA;0;0;0;0;0;0;0;0;0;CELULAR LG K61 Gris OPEN;TELEFONIA
10693001;Casado;M;54;CHILENO;;X;RENCA                         ;METROPOLITANA;0;0;0;0;0;0;0;0;0;CELULAR Samsung Galaxy A02s 32GB Azul WOM;TELEFONIA
11643341;;F;52;CHILENO;;X;PROVIDENCIA                   ;METROPOLITANA;0;0;0;0;0;0;0;0;0;CELULAR A21s 128 GB Rojo;TELEFONIA
18972878;Soltero;F;27;CHILENO;PROFESOR;Millenial;PROVIDENCIA                   ;METROPOLITANA;0;0;0;0;0;0;0;0;0;CELULAR A12 128GB AZUL OPEN;TELEFONIA
18572426;Soltero;F;28;CHILENO;ENFERMERA;Millenial;PROVIDENCIA                   ;METROPOLITANA;0;0;0;0;0;0;0;0;0;CELULAR SAMSUNG A02S 32GB NEGRO DIRECTO ENTEL;TELEFONIA
8767629;;M;61;CHILENO;;Boomers;OSORNO                        ;LOS LAGOS;0;0;0;0;0;0;0;0;0;Celular NOKIA 1.3 NEGRO WOM;TELEFONIA
20300720;;F;22;CHILENO;;Z;PROVIDENCIA                   ;METROPOLITANA;0;0;0;0;0;0;0;0;0;CELULAR IPHONE SE 64GB DIRECTO CLARO;TELEFONIA
17606958;Soltero;F;30;CHILENO;DISENADOR GRAFICO;Millenial;PROVIDENCIA                   ;METROPOLITANA;0;0;0;0;0;0;0;0;0;CELULAR A12 128GB NEGRO OPEN;TELEFONIA
9265921;;F;60;CHILENO;;Boomers;CURICO                        ;MAULE;0;0;0;0;0;0;0;0;0;CELULAR LG K22 TRIANGULADO WOM;TELEFONIA
13926140;Casado;M;43;CHILENO;DISENADOR GRAFICO;X;PROVIDENCIA                   ;METROPOLITANA;0;0;0;0;0;0;0;0;0;CELULAR LG K61 Gris OPEN;TELEFONIA
18366676;Soltero;F;29;CHILENO;TECNICO DE NIVEL SUPERIOR EN ENFERMERIA;Millenial;PROVIDENCIA                   ;METROPOLITANA;0;0;0;0;0;0;0;0;0;Celular NOKIA 1.3 NEGRO WOM;TELEFONIA
18080801;Soltero;F;30;CHILENO;TECNICO DE NIVEL SUPERIOR EN ENFERMERIA;Millenial;PROVIDENCIA                   ;METROPOLITANA;0;0;0;0;0;0;0;0;0;CELULAR POCO M3 64GB POWER BLACK;TELEFONIA
16597111;;F;34;CHILENO;;Millenial;OVALLE                        ;COQUIMBO;0;0;0;0;0;0;0;0;0;CELULAR A12 128GB AZUL OPEN;TELEFONIA
14378034;Casado;F;43;CHILENO;;Silencioso;PROVIDENCIA                   ;METROPOLITANA;0;0;0;0;0;0;0;0;0;CELULAR MOTO G9 POWER 128GB VERDE GRANITO OPEN;TELEFONIA
16870355;Soltero;M;34;CHILENO;CIRUJANO DENTISTA;Silencioso;PROVIDENCIA                   ;METROPOLITANA;0;0;0;0;0;0;0;0;0;Celular A51 128GB LIB OPEN BLANCO;TELEFONIA
9182804;;M;61;CHILENO;;Boomers;LA LIGUA                      ;VALPARAISO;0;0;0;0;0;0;0;0;0;CELULAR A02s ROJO 32GB OPEN;TELEFONIA
9687051;;M;57;CHILENO;;Boomers;ARAUCO                        ;BIO BIO;0;0;0;0;0;0;0;0;0;Celular SA3 CLARO DIRECTO BLACK;TELEFONIA
9895012;;M;57;CHILENO;;Boomers;PROVIDENCIA                   ;METROPOLITANA;0;0;0;0;0;0;0;0;0;Celular A11 LIB OPEN BLUE;TELEFONIA
16154418;;M;36;CHILENO;;Millenial;PROVIDENCIA                   ;METROPOLITANA;0;0;0;0;0;0;0;0;0;CELULAR A02s NEGRO 32GB OPEN;TELEFONIA
10512993;;F;57;CHILENO;;Boomers;CONCEPCION                    ;BIO BIO;0;0;0;0;0;0;0;0;0;CELULAR REDMI NOTE 9 DIRECTO CLARO BLUE;TELEFONIA
13418921;;M;44;CHILENO;;X;RENCA                         ;METROPOLITANA;0;0;0;0;0;0;0;0;0;CELULAR XIAOMI REDMI 9A 32GB SKY BLUE TRI WOM;TELEFONIA
4792395;;M;77;CHILENO;;Silencioso;RENCA                         ;METROPOLITANA;0;0;0;0;0;0;0;0;0;Celular NOKIA 4.2 ENTEL DIRECTO NEGRO;TELEFONIA
18433685;;F;28;CHILENO;;Millenial;LOTA                          ;BIO BIO;0;0;0;0;0;0;0;0;0;Celular A51 128GB LIB OPEN AZUL;TELEFONIA
17057848;Soltero;F;33;CHILENO;PROFESOR;Silencioso;PROVIDENCIA                   ;METROPOLITANA;0;0;0;0;0;0;0;0;0;Celular LG K22 DIRECTO CLARO;TELEFONIA
19874816;;M;24;CHILENO;;Silencioso;PROVIDENCIA                   ;METROPOLITANA;0;0;0;0;0;0;0;0;0;CELULAR Xiaomi Redmi Note 9 128GB Blanco WOM;TELEFONIA
17423548;;F;32;CHILENO;;Millenial;QUILACO                       ;BIO BIO;0;0;0;0;0;0;0;0;0;CELULAR A21s 128 GB Rojo;TELEFONIA
6191893;;F;61;CHILENO;;Boomers;PROVIDENCIA                   ;METROPOLITANA;0;0;0;0;0;0;0;0;0;CELULAR NOKIA 110 BLACK OPEN;TELEFONIA
20270587;;F;22;CHILENO;;Silencioso;PROVIDENCIA                   ;METROPOLITANA;0;0;0;0;0;0;0;0;0;CELULAR IPHONE SE 64GB DIRECTO CLARO;TELEFONIA
19694302;;M;24;CHILENO;;Z;TALCA                         ;MAULE;0;0;0;0;0;0;0;0;0;CELULAR XIAOMI POCO X3 64G COBALT BLUE;TELEFONIA
5599066;;M;73;CHILENO;;Silencioso;COIHAIQUE                     ;AYSEN;0;0;0;0;0;0;0;0;0;Celular P40 LITE LIB OPEN BLACK;TELEFONIA
18499496;Soltero;F;28;CHILENO;CONTADOR AUDITOR;Silencioso;PROVIDENCIA                   ;METROPOLITANA;0;0;0;0;0;0;0;0;0;Celular A71 LIB OPEN NEGRO;TELEFONIA
16083744;;M;37;CHILENO;;Millenial;SAN FERNANDO                  ;L.G.B.OÂ´HIGGINS;0;0;0;0;0;0;0;0;0;CELULAR MOTOROLA G9 PLAY ROSADO DIRECTO WOM;TELEFONIA
9116006;;M;59;CHILENO;;Boomers;RENCA                         ;METROPOLITANA;0;0;0;0;0;0;0;0;0;Celular A01 CLARO DIRECTO BLACK;TELEFONIA
16788146;Soltero;F;34;CHILENO;;Millenial;PROVIDENCIA                   ;METROPOLITANA;0;0;0;0;0;0;0;0;0;CELULAR SAMSUNG A71 AZUL OPEN;TELEFONIA
9048142;;M;62;CHILENO;;Boomers;PROVIDENCIA                   ;METROPOLITANA;0;0;0;0;0;0;0;0;0;Celular A31 LIB OPEN AZUL;TELEFONIA
7249649;;F;68;CHILENO;;Boomers;VALDIVIA                      ;LOS RIOS;0;0;0;0;0;0;0;0;0;Celular A20S LIB OPEN ROJO;TELEFONIA
13687428;;F;43;CHILENO;;X;QUILPUE                       ;VALPARAISO;0;0;0;0;0;0;0;0;0;CELULAR LG K61 Gris OPEN;TELEFONIA
12102352;Soltero;M;53;CHILENO;;X;CHILLAN                       ;NUBLE;0;0;0;0;0;0;0;0;0;CELULAR A12 128GB AZUL OPEN;TELEFONIA
17116381;;F;32;CHILENO;;Millenial;PROVIDENCIA                   ;METROPOLITANA;0;0;0;0;0;0;0;0;0;Celular SAMSUNG A01 CORE BLACK CLARO;TELEFONIA
18247405;;M;29;CHILENO;;Millenial;LA SERENA                     ;COQUIMBO;0;0;0;0;0;0;0;0;0;CELULAR REDMI NOTE 9 PRO 128GB GLACIER WHITE;TELEFONIA
9266167;;F;48;CHILENO;;X;PROVIDENCIA                   ;METROPOLITANA;0;0;0;0;0;0;0;0;0;CELULAR OWN 1026 AZUL ENTEL;TELEFONIA
17872384;;M;30;CHILENO;;Millenial;PROVIDENCIA                   ;METROPOLITANA;0;0;0;0;0;0;0;0;0;Celular A51 128GB LIB OPEN AZUL;TELEFONIA
19799788;;M;24;CHILENO;;Z;PROVIDENCIA                   ;METROPOLITANA;0;0;0;0;0;0;0;0;0;CELULAR MOTO G9 POWER 128GB MORADO SONICO OPEN;TELEFONIA
18385178;;F;29;CHILENO;;Millenial;ESTACION CENTRAL              ;METROPOLITANA;0;0;0;0;0;0;0;0;0;Celular A51 128GB LIB OPEN BLACK;TELEFONIA
14342907;Soltero;M;45;CHILENO;;Silencioso;PROVIDENCIA                   ;METROPOLITANA;0;0;0;0;0;0;0;0;0;Celular Y5 NEO ENTEL DIRECTO BLACK;TELEFONIA
8755833;Casado;M;65;CHILENO;;Boomers;PROVIDENCIA                   ;METROPOLITANA;0;0;0;0;0;0;0;0;0;Celular A01 Core Azul Tri Entel;TELEFONIA
16133109;;M;37;CHILENO;;Millenial;ANTOFAGASTA                   ;ANTOFAGASTA;0;0;0;0;0;0;0;0;0;CELULAR REDMI 9 64GB CARBON GREY;TELEFONIA
9011013;Soltero;F;63;CHILENO;;Boomers;RENCA                         ;METROPOLITANA;0;0;0;0;0;0;0;0;0;Celular G8 POWER LITE MOVISTAR DIRECTO AZUL;TELEFONIA
5977742;;M;72;CHILENO;;Silencioso;RENCA                         ;METROPOLITANA;0;0;0;0;0;0;0;0;0;CELULAR MOTOROLA E6S GRIS 32GB DIRECTO WOM;TELEFONIA
12134503;;M;53;CHILENO;;X;COQUIMBO                      ;COQUIMBO;0;0;0;0;0;0;0;0;0;CELULAR LG K61 Gris OPEN;TELEFONIA
18788863;;F;28;CHILENO;;Millenial;TEMUCO                        ;ARAUCANIA;0;0;0;0;0;0;0;0;0;CELULAR NOKIA 110 BLACK OPEN;TELEFONIA
6534025;;F;71;CHILENO;;Silencioso;PELLUHUE                      ;MAULE;0;0;0;0;0;0;0;0;0;CELULAR A02s ROJO 32GB OPEN;TELEFONIA
11862563;;M;53;CHILENO;;X;LA LIGUA                      ;VALPARAISO;0;0;0;0;0;0;0;0;0;CELULAR MOTOROLA E6S ROSADO DIRECTO WOM;TELEFONIA
19032049;Soltero;F;27;CHILENO;ENFERMERA;Silencioso;PROVIDENCIA                   ;METROPOLITANA;0;0;0;0;0;0;0;0;0;CELULAR NOKIA 5.3 CHARCOAL TRI ENTEL;TELEFONIA
17213509;;F;34;CHILENO;;Millenial;N/D;N/D;0;0;0;0;0;0;0;0;0;Celular S20 FE LIB OPEN Cloud Green;TELEFONIA
10756001;Casado;F;55;CHILENO;;Boomers;RENCA                         ;METROPOLITANA;0;0;0;0;0;0;0;0;0;Celular A31 LIB OPEN AZUL;TELEFONIA
5709621;;F;74;CHILENO;;Silencioso;VICTORIA                      ;ARAUCANIA;0;0;0;0;0;0;0;0;0;CELULAR REDMI 9 32GB CARBON GREY OPEN;TELEFONIA
19878713;;M;24;CHILENO;;Silencioso;PROVIDENCIA                   ;METROPOLITANA;0;0;0;0;0;0;0;0;0;CELULAR G8 POWER MOTO TRI ENTEL;TELEFONIA
11995837;;F;50;CHILENO;;X;SAN FERNANDO                  ;L.G.B.OÂ´HIGGINS;0;0;0;0;0;0;0;0;0;CELULAR HUAWEI Y9S BLACK DIRECTO CLARO;TELEFONIA
12330939;;M;49;CHILENO;;X;PUREN                         ;ARAUCANIA;0;0;0;0;0;0;0;0;0;Celular G8 POWER LITE MOVISTAR DIRECTO AZUL;TELEFONIA
7609117;Casado;F;63;CHILENO;;Boomers;CHILLAN                       ;BIO BIO;0;0;0;0;0;0;0;0;0;CELULAR OWN 1026 AZUL ENTEL;TELEFONIA
17298839;;F;32;CHILENO;;Millenial;PUERTO MONTT                  ;LOS LAGOS;0;0;0;0;0;0;0;0;0;Celular A31 LIB OPEN ROJO;TELEFONIA
17544533;;F;32;CHILENO;;Millenial;LOS ANDES                     ;VALPARAISO;0;0;0;0;0;0;0;0;0;CELULAR IPHONE SE 64GB DIRECTO CLARO;TELEFONIA
18481237;;M;29;CHILENO;;Millenial;PUENTE ALTO                   ;METROPOLITANA;0;0;0;0;0;0;0;0;0;Celular Galaxy S21 Ultra Phantom Silver 128GB;TELEFONIA
8383817;;F;67;CHILENO;;Boomers;VALLENAR;ATACAMA;0;0;0;0;0;0;0;0;0;CELULAR A02s AZUL 32GB OPEN;TELEFONIA
11228150;;M;54;CHILENO;;X;RENCA                         ;METROPOLITANA;0;0;0;0;0;0;0;0;0;Celular A31 LIB OPEN ROJO;TELEFONIA
5848432;;F;73;CHILENO;;Silencioso;TALCAHUANO                    ;BIO BIO;0;0;0;0;0;0;0;0;0;CELULAR NOKIA 110 BLACK OPEN;TELEFONIA
4382654;;M;79;CHILENO;;Silencioso;RENCA                         ;METROPOLITANA;0;0;0;0;0;0;0;0;0;Celular LG K22 MOVISTAR DIRECTO TITAN;TELEFONIA
5045287;;M;78;CHILENO;;Silencioso;RENCA                         ;METROPOLITANA;0;0;0;0;0;0;0;0;0;Celular LG K22 MOVISTAR DIRECTO TITAN;TELEFONIA
11884211;;F;51;CHILENO;;X;PROVIDENCIA                   ;METROPOLITANA;0;0;0;0;0;0;0;0;0;CELULAR MOTO G9 POWER 128GB MORADO SONICO OPEN;TELEFONIA
7893749;Casado;F;64;CHILENO;;Boomers;RENCA                         ;METROPOLITANA;0;0;0;0;0;0;0;0;0;CELULAR MOTOROLA E6S ROSADO DIRECTO WOM;TELEFONIA
18743409;;M;31;CHILENO;;Millenial;QUILLOTA;VALPARAISO;0;0;0;0;0;0;0;0;0;CELULAR A12 128GB NEGRO OPEN;TELEFONIA
7664466;;F;70;CHILENO;;Silencioso;PROVIDENCIA                   ;METROPOLITANA;0;0;0;0;0;0;0;0;0;CELULAR NOKIA 225 4G BLACK TRI ENTEL;TELEFONIA
8777064;;F;64;CHILENO;;Boomers;PUENTE ALTO                   ;METROPOLITANA;0;0;0;0;0;0;0;0;0;Celular LG K22 ENTEL DIRECTO TITAN;TELEFONIA
15505688;;F;40;CHILENO;;X;RENCA                         ;METROPOLITANA;0;0;0;0;0;0;0;0;0;CELULAR A12 128GB ROJO OPEN;TELEFONIA
14224276;;F;51;CHILENO;;X;PADRE LAS CASAS               ;ARAUCANIA;0;0;0;0;0;0;0;0;0;CELULAR A02s ROJO 32GB OPEN;TELEFONIA
6888909;;F;66;CHILENO;;Boomers;PUDAHUEL                      ;METROPOLITANA;0;0;0;0;0;0;0;0;0;CELULAR NOKIA 5.3 CHARCOAL TRI ENTEL;TELEFONIA
14085781;;M;42;CHILENO;;X;CONSTITUCION                  ;MAULE;0;0;0;0;0;0;0;0;0;Celular A10S MOVISTAR DIRECTO BLACK;TELEFONIA
9113158;;F;59;CHILENO;;Boomers;TALAGANTE                     ;METROPOLITANA;0;0;0;0;0;0;0;0;0;Celular Y9S LIB OPEN BLACK;TELEFONIA
15261433;;F;45;CHILENO;;X;PROVIDENCIA                   ;METROPOLITANA;0;0;0;0;0;0;0;0;0;Celular S20 FE LIB OPEN Cloud Green;TELEFONIA
11285439;Soltero;F;54;CHILENO;;X;RENCA                         ;METROPOLITANA;0;0;0;0;0;0;0;0;0;CELULAR SAMSUNG A01 NEGRO DIRECTO WOM;TELEFONIA
15558301;Soltero;M;39;CHILENO;;Silencioso;PROVIDENCIA                   ;METROPOLITANA;0;0;0;0;0;0;0;0;0;Celular Z FLIP LIB OPEN PURPLE;TELEFONIA
11514862;Casado;F;52;CHILENO;;X;RENCA                         ;METROPOLITANA;0;0;0;0;0;0;0;0;0;CELULAR ZTE A5 2020 NEGRO WOM;TELEFONIA
6409704;;F;69;CHILENO;;Silencioso;LOS ANDES                     ;VALPARAISO;0;0;0;0;0;0;0;0;0;Celular P40 LITE LIB OPEN BLACK;TELEFONIA
18368324;Soltero;M;29;CHILENO;;Millenial;PROVIDENCIA                   ;METROPOLITANA;0;0;0;0;0;0;0;0;0;Celular LG K22 MOVISTAR DIRECTO TITAN;TELEFONIA
19156418;;F;24;CHILENO;;Z;PROVIDENCIA                   ;METROPOLITANA;0;0;0;0;0;0;0;0;0;Celular SAMSUNG A01 CORE AZUL ENTEL;TELEFONIA
12847041;;M;46;CHILENO;;Silencioso;PROVIDENCIA                   ;METROPOLITANA;0;0;0;0;0;0;0;0;0;CELULAR A12 128GB NEGRO OPEN;TELEFONIA
6993255;;F;71;CHILENO;;Silencioso;CASTRO                        ;LOS LAGOS;0;0;0;0;0;0;0;0;0;CELULAR OWN 1026 AZUL ENTEL;TELEFONIA
16509457;Soltero;F;35;CHILENO;;Millenial;PROVIDENCIA                   ;METROPOLITANA;0;0;0;0;0;0;0;0;0;Celular a11 azul samsung WOM;TELEFONIA
12068849;;F;54;CHILENO;;X;RENCA                         ;METROPOLITANA;0;0;0;0;0;0;0;0;0;CELULAR A21s 128 GB AZUL;TELEFONIA
16742168;;M;35;CHILENO;;Silencioso;PROVIDENCIA                   ;METROPOLITANA;0;0;0;0;0;0;0;0;0;Celular A01 LIB OPEN AZUL;TELEFONIA
10990890;;M;52;CHILENO;;X;MONTE PATRIA                  ;COQUIMBO;0;0;0;0;0;0;0;0;0;CELULAR A12 128GB NEGRO OPEN;TELEFONIA
9228554;;F;58;CHILENO;;Boomers;RANCAGUA                      ;L.G.B.OÂ´HIGGINS;0;0;0;0;0;0;0;0;0;CELULAR Samsung Galaxy A02s 32GB Azul WOM;TELEFONIA
19333329;Soltero;M;26;CHILENO;;Z;"";"";0;0;0;0;0;0;0;0;0;Celular Galaxy S21 Plus Phantom Black 128GB;TELEFONIA
15225892;;M;40;CHILENO;;X;PUREN                         ;ARAUCANIA;0;0;0;0;0;0;0;0;0;CELULAR REDMI NOTE 9 PRO 128GB TROPICAL GREEN;TELEFONIA
13139071;;M;44;CHILENO;;X;CABRERO                       ;BIO BIO;0;0;0;0;0;0;0;0;0;Celular Y6 2019 CLARO DIRECTO BLACK;TELEFONIA
5052047;;M;78;CHILENO;;Silencioso;RENCA                         ;METROPOLITANA;0;0;0;0;0;0;0;0;0;Celular SAMSUNG A01 CORE AZUL ENTEL;TELEFONIA
6163196;;F;77;CHILENO;;Silencioso;VALLENAR;ATACAMA;0;0;0;0;0;0;0;0;0;CELULAR SAMSUNG A21S AZUL OPEN;TELEFONIA
4051720;;F;82;CHILENO;;Silencioso;BUIN                          ;METROPOLITANA;0;0;0;0;0;0;0;0;0;Celular SAMSUNG A01 CORE BLACK CLARO;TELEFONIA
10525324;;M;55;CHILENO;;Silencioso;PROVIDENCIA                   ;METROPOLITANA;0;0;0;0;0;0;0;0;0;CELULAR MOTO G8 POWER LITE AZUL TRI ENTEL;TELEFONIA
11173006;;F;55;CHILENO;;Boomers;PLACILLA                      ;L.G.B.OÂ´HIGGINS;0;0;0;0;0;0;0;0;0;CELULAR OWN 1026 AZUL ENTEL;TELEFONIA
10874014;Casado;M;52;CHILENO;;Silencioso;PROVIDENCIA                   ;METROPOLITANA;0;0;0;0;0;0;0;0;0;Celular A01 CORE MOVISTAR DIRECTO BLACK;TELEFONIA
8142780;;F;61;CHILENO;;Boomers;PROVIDENCIA                   ;METROPOLITANA;0;0;0;0;0;0;0;0;0;CELULAR MOTOROLA E6S ROSADO DIRECTO WOM;TELEFONIA
17565657;;F;31;CHILENO;;Millenial;EL BOSQUE                     ;METROPOLITANA;0;0;0;0;0;0;0;0;0;Celular S20 FE LIB OPEN Cloud Lavender;TELEFONIA
13276351;;F;45;CHILENO;;X;RENCA                         ;METROPOLITANA;0;0;0;0;0;0;0;0;0;TELEFONO PP BINDU ENTEL;TELEFONIA
18983549;Soltero;F;26;CHILENO;;Z;LINARES                       ;MAULE;0;0;0;0;0;0;0;0;0;CELULAR A12 128GB AZUL OPEN;TELEFONIA
16939268;;F;33;CHILENO;;Silencioso;PROVIDENCIA                   ;METROPOLITANA;0;0;0;0;0;0;0;0;0;CELULAR REDMI NOTE 8 64GB NEPTUNE BLUE OPEN;TELEFONIA
15256182;Casado;M;40;CHILENO;;X;RENCA                         ;METROPOLITANA;0;0;0;0;0;0;0;0;0;Celular Y6P WOM TRIANGULADO NEGRO;TELEFONIA
5733690;;F;75;CHILENO;;Silencioso;RENCA                         ;METROPOLITANA;0;0;0;0;0;0;0;0;0;CELULAR REDMI 9A GRANITE GREY DIRECTO MOVISTAR;TELEFONIA
15261473;;F;40;CHILENO;;Silencioso;PROVIDENCIA                   ;METROPOLITANA;0;0;0;0;0;0;0;0;0;Celular A31 LIB OPEN ROJO;TELEFONIA
8588640;;F;61;CHILENO;;Boomers;PROVIDENCIA                   ;METROPOLITANA;0;0;0;0;0;0;0;0;0;Celular A01 Core Azul Tri Entel;TELEFONIA
25403569;;M;40;PERUANO;;Extranjero;SANTIAGO                      ;METROPOLITANA;0;0;0;0;0;0;0;0;0;Celular A51 128GB LIB OPEN BLACK;TELEFONIA
6739848;;M;68;CHILENO;;Silencioso;SAN ANTONIO                   ;VALPARAISO;0;0;0;0;0;0;0;0;0;Celular NOKIA 4.2 ENTEL DIRECTO NEGRO;TELEFONIA
12917491;;M;47;CHILENO;;X;"";"";0;0;0;0;0;0;0;0;0;CELULAR NOKIA 225 4G BLACK TRI ENTEL;TELEFONIA
5866649;;M;74;CHILENO;;Silencioso;LONGAVI                       ;MAULE;0;0;0;0;0;0;0;0;0;CELULAR MOTOROLA G8 POWER LITE AZUL WOM;TELEFONIA
20079393;;F;23;CHILENO;;Millenial;"";"";0;0;0;0;0;0;0;0;0;CELULAR REDMI NOTE 8 64GB SPACE BLACK OPEN;TELEFONIA
17617492;;M;30;CHILENO;;Millenial;PROVIDENCIA                   ;METROPOLITANA;0;0;0;0;0;0;0;0;0;Celular A31 LIB OPEN AZUL;TELEFONIA
14013081;Soltero;F;40;CHILENO;;Silencioso;PROVIDENCIA                   ;METROPOLITANA;0;0;0;0;0;0;0;0;0;Celular A31 LIB OPEN ROJO;TELEFONIA
8697092;;F;55;CHILENO;;Boomers;RENCA                         ;METROPOLITANA;0;0;0;0;0;0;0;0;0;Celular A10S LIB OPEN BLUE;TELEFONIA
16836382;;M;34;CHILENO;;Millenial;LINARES                       ;MAULE;0;0;0;0;0;0;0;0;0;CELULAR REDMI NOTE 9 128GB ONYX BLACK OPEN;TELEFONIA
5185526;;M;75;CHILENO;;Silencioso;PROVIDENCIA                   ;METROPOLITANA;0;0;0;0;0;0;0;0;0;Celular A11 LIB OPEN BLACK;TELEFONIA
15015225;;M;39;CHILENO;;X;RENCA                         ;METROPOLITANA;0;0;0;0;0;0;0;0;0;CELULAR XIAOMI REDMI 9C AZUL DIRECTO ENTEL;TELEFONIA
14022754;;M;41;CHILENO;;X;COBQUECURA                    ;BIO BIO;0;0;0;0;0;0;0;0;0;Celular A11 LIB OPEN BLUE;TELEFONIA
11633711;;F;52;CHILENO;;X;INDEPENDENCIA                 ;METROPOLITANA;0;0;0;0;0;0;0;0;0;Celular P30 LITE LIB OPEN NEGRO;TELEFONIA
7221435;;M;66;CHILENO;;Boomers;IQUIQUE                       ;TARAPACA;0;0;0;0;0;0;0;0;0;Celular P40 LITE LIB OPEN GREEN;TELEFONIA
12726407;;M;47;CHILENO;;X;SAN VICENTE                   ;L.G.B.OÂ´HIGGINS;0;0;0;0;0;0;0;0;0;Celular A10S LIB OPEN BLUE;TELEFONIA
13631323;;M;43;CHILENO;;X;GALVARINO                     ;ARAUCANIA;0;0;0;0;0;0;0;0;0;CELULAR SAMSUNG A21S AZUL OPEN;TELEFONIA
9677087;;F;57;CHILENO;;Boomers;PROVIDENCIA                   ;METROPOLITANA;0;0;0;0;0;0;0;0;0;CELULAR REDMI NOTE 8 64GB NEPTUNE BLUE OPEN;TELEFONIA
16068654;;M;37;CHILENO;;Millenial;N/D;N/D;0;0;0;0;0;0;0;0;0;CELULAR MOTOROLA G9 PLUS CHAMPAGNE ROSE OPEN;TELEFONIA
17083266;;M;33;CHILENO;;Millenial;YUMBEL                        ;BIO BIO;0;0;0;0;0;0;0;0;0;CELULAR MOTOROLA ONE FUSION 128GB DIRECTO MOVIST;TELEFONIA
8024017;;M;66;CHILENO;;Boomers;RENCA                         ;METROPOLITANA;0;0;0;0;0;0;0;0;0;Celular a11 azul samsung WOM;TELEFONIA
16525407;;F;35;CHILENO;;Millenial;PROVIDENCIA                   ;METROPOLITANA;0;0;0;0;0;0;0;0;0;Celular P30 LITE PLUS LIB OPEN BLACK;TELEFONIA
17117134;;M;33;CHILENO;;Silencioso;PROVIDENCIA                   ;METROPOLITANA;0;0;0;0;0;0;0;0;0;Celular S20 FE LIB OPEN Cloud Green;TELEFONIA
9857282;;F;52;CHILENO;;X;PROVIDENCIA                   ;METROPOLITANA;0;0;0;0;0;0;0;0;0;CELULAR A12 128GB ROJO OPEN;TELEFONIA
12656833;;M;47;CHILENO;;X;RENGO                         ;L.G.B.OÂ´HIGGINS;0;0;0;0;0;0;0;0;0;CELULAR A02s ROJO 32GB OPEN;TELEFONIA
20347214;;F;22;CHILENO;;Z;PROVIDENCIA                   ;METROPOLITANA;0;0;0;0;0;0;0;0;0;Celular S20 FE LIB OPEN Cloud Lavender;TELEFONIA
18735378;;F;28;CHILENO;;Millenial;PROVIDENCIA                   ;METROPOLITANA;0;0;0;0;0;0;0;0;0;Celular A11 LIB OPEN BLUE;TELEFONIA
6736271;;M;69;CHILENO;;Silencioso;ALTO BIO BIO;BIO BIO;0;0;0;0;0;0;0;0;0;Celular A01 LIB OPEN AZUL;TELEFONIA
17241346;Soltero;F;32;CHILENO;;Millenial;PROVIDENCIA                   ;METROPOLITANA;0;0;0;0;0;0;0;0;0;Celular A31 LIB OPEN BLACK;TELEFONIA
6491928;;F;68;CHILENO;;Boomers;RENCA                         ;METROPOLITANA;0;0;0;0;0;0;0;0;0;CELULAR REDMI NOTE 9 PRO 128GB TROPICAL GREEN;TELEFONIA
16662711;Soltero;F;34;CHILENO;NUTRICIONISTA;Millenial;PROVIDENCIA                   ;METROPOLITANA;0;0;0;0;0;0;0;0;0;Celular P30 LITE LIB OPEN NEGRO;TELEFONIA
16949623;;F;33;CHILENO;;Millenial;N/D;N/D;0;0;0;0;0;0;0;0;0;CELULAR SAMSUNG A21S AZUL OPEN;TELEFONIA
11285352;Casado;F;54;CHILENO;;X;RENCA                         ;METROPOLITANA;0;0;0;0;0;0;0;0;0;Celular LG K22 MOVISTAR DIRECTO TITAN;TELEFONIA
11912108;;M;49;CHILENO;;X;PELLUHUE                      ;MAULE;0;0;0;0;0;0;0;0;0;Celular SAMSUNG A11 32GB ENTEL DIRECTO NEGRO;TELEFONIA
18982754;Soltero;M;27;CHILENO;;Z;PROVIDENCIA                   ;METROPOLITANA;0;0;0;0;0;0;0;0;0;Celular A11 LIB OPEN BLACK;TELEFONIA
6179350;;M;73;CHILENO;;Silencioso;TEMUCO                        ;ARAUCANIA;0;0;0;0;0;0;0;0;0;CELULAR MOTO ONE FUSION 64GB VERDE 64GB OPEN;TELEFONIA
11431551;;F;53;CHILENO;;X;MAULLIN                       ;LOS LAGOS;0;0;0;0;0;0;0;0;0;Celular NOKIA 4.2 ENTEL DIRECTO NEGRO;TELEFONIA
13978767;Casado;F;41;CHILENO;;X;RENCA                         ;METROPOLITANA;0;0;0;0;0;0;0;0;0;Celular A11 LIB OPEN BLUE;TELEFONIA
20135898;;F;23;CHILENO;;Z;PROVIDENCIA                   ;METROPOLITANA;0;0;0;0;0;0;0;0;0;CELULAR SAMSUNG A71 AZUL OPEN;TELEFONIA
12435190;;M;49;CHILENO;;X;ARICA                         ;ARICA Y PARINACOTA;0;0;0;0;0;0;0;0;0;CELULAR SAMSUNG A21S AZUL OPEN;TELEFONIA
19541301;;M;25;CHILENO;;Z;PROVIDENCIA                   ;METROPOLITANA;0;0;0;0;0;0;0;0;0;Celular Y9 PRIME WOM DIRECTO BLACK;TELEFONIA
11730941;Soltero;F;50;CHILENO;PROFESOR;X;RENCA                         ;METROPOLITANA;0;0;0;0;0;0;0;0;0;CHIP OPEN ENTEL;TELEFONIA
7318465;;F;64;CHILENO;;Boomers;PUENTE ALTO                   ;METROPOLITANA;0;0;0;0;0;0;0;0;0;CELULAR SAMSUNG A21S ROJO OPEN;TELEFONIA
7551543;;M;65;CHILENO;;Boomers;"";"";0;0;0;0;0;0;0;0;0;CELULAR REDMI 9 64GB SUNSET PURPLE TRI WOM;TELEFONIA
10723831;;M;54;CHILENO;;Boomers;RANCAGUA                      ;L.G.B.OÂ´HIGGINS;0;0;0;0;0;0;0;0;0;Celular SAMSUNG A01 CORE BLACK CLARO;TELEFONIA
17584206;;F;31;CHILENO;;Millenial;TEMUCO                        ;ARAUCANIA;0;0;0;0;0;0;0;0;0;Celular A01 Core Azul Tri Entel;TELEFONIA
20011623;;M;23;CHILENO;;Silencioso;PROVIDENCIA                   ;METROPOLITANA;0;0;0;0;0;0;0;0;0;CELULAR REDMI NOTE 8 64GB NEPTUNE BLUE OPEN;TELEFONIA
15358909;;F;39;CHILENO;;X;COIHAIQUE                     ;AYSEN;0;0;0;0;0;0;0;0;0;Celular P30 LITE LIB OPEN NEGRO;TELEFONIA
16352376;;F;32;CHILENO;;Millenial;VALLENAR;ATACAMA;0;0;0;0;0;0;0;0;0;CELULAR SAMSUNG A21S AZUL OPEN;TELEFONIA
17056488;;F;33;CHILENO;;Millenial;"";"";0;0;0;0;0;0;0;0;0;Celular A11 LIB OPEN WHITE;TELEFONIA
11586810;;F;52;CHILENO;;X;VILLARICA                     ;ARAUCANIA;0;0;0;0;0;0;0;0;0;Celular SAMSUNG A01 CORE BLACK CLARO;TELEFONIA
7034375;;M;63;CHILENO;;Boomers;TALCAHUANO                    ;BIO BIO;0;0;0;0;0;0;0;0;0;Celular A10S LIB OPEN RED;TELEFONIA
15554912;;M;39;CHILENO;;X;PROVIDENCIA                   ;METROPOLITANA;0;0;0;0;0;0;0;0;0;Celular LG K22 MOVISTAR DIRECTO TITAN;TELEFONIA
15087703;;F;39;CHILENO;;X;SAN ANTONIO                   ;VALPARAISO;0;0;0;0;0;0;0;0;0;IPHONE 7 LIB OPEN NEGRO;TELEFONIA
9932971;;F;60;CHILENO;;Boomers;RENCA                         ;METROPOLITANA;0;0;0;0;0;0;0;0;0;CELULAR LG K41S TITAN DIRECTO MOVISTAR;TELEFONIA
21894965;;F;30;NO INFORMA NACIONALIDAD;;Extranjero;N/D;N/D;0;0;0;0;0;0;0;0;0;Celular ONE FUSION MOVISTAR DIRECTO AZUL;TELEFONIA
9736716;Casado;M;59;CHILENO;;Boomers;RENCA                         ;METROPOLITANA;0;0;0;0;0;0;0;0;0;Celular A01 LIB OPEN ROJO;TELEFONIA
16596085;;M;35;CHILENO;;Millenial;PROVIDENCIA                   ;METROPOLITANA;0;0;0;0;0;0;0;0;0;CELULAR HUAWEI Y5P BLUE TRIANGULADO WOM;TELEFONIA
12398286;Soltero;M;49;CHILENO;;X;RENCA                         ;METROPOLITANA;0;0;0;0;0;0;0;0;0;Celular SAMSUNG A11 32GB ENTEL DIRECTO NEGRO;TELEFONIA
17707145;;F;31;CHILENO;;Millenial;N/D;N/D;0;0;0;0;0;0;0;0;0;IPHONE 7 LIB OPEN NEGRO;TELEFONIA
19300733;Soltero;M;26;CHILENO;ANALISTA DE SISTEMAS;Z;PROVIDENCIA                   ;METROPOLITANA;0;0;0;0;0;0;0;0;0;Celular A10S LIB OPEN NEGRO;TELEFONIA
13571785;Soltero;M;42;CHILENO;;X;PROVIDENCIA                   ;METROPOLITANA;0;0;0;0;0;0;0;0;0;CELULAR NOKIA 110 BLACK OPEN;TELEFONIA
13741269;Soltero;M;43;CHILENO;;X;PROVIDENCIA                   ;METROPOLITANA;0;0;0;0;0;0;0;0;0;Celular A01 LIB OPEN ROJO;TELEFONIA
7423588;;F;65;CHILENO;;Boomers;NAVIDAD                       ;L.G.B.OÂ´HIGGINS;0;0;0;0;0;0;0;0;0;Celular XIAOMI REDMI 9A 32 GB DIRECTO CLARO;TELEFONIA
16390673;;M;36;CHILENO;;Millenial;MAIPU                         ;METROPOLITANA;0;0;0;0;0;0;0;0;0;CELULAR REDMI 9 64GB SUNSET PURPLE TRI WOM;TELEFONIA
16144004;;F;37;CHILENO;;Millenial;COLINA                        ;METROPOLITANA;0;0;0;0;0;0;0;0;0;CELULAR SAMSUNG A71 AZUL OPEN;TELEFONIA
6559432;Casado;F;72;CHILENO;;Silencioso;RENCA                         ;METROPOLITANA;0;0;0;0;0;0;0;0;0;Celular Y6P WOM TRIANGULADO NEGRO;TELEFONIA
10776031;;M;56;CHILENO;;Boomers;SAN CARLOS                    ;BIO BIO;0;0;0;0;0;0;0;0;0;CELULAR G8 POWER MOTO TRI ENTEL;TELEFONIA
13748646;Soltero;M;42;CHILENO;;X;RENCA                         ;METROPOLITANA;0;0;0;0;0;0;0;0;0;Celular SAMSUNG A01 CORE BLACK CLARO;TELEFONIA
10189958;Soltero;M;53;CHILENO;;X;PROVIDENCIA                   ;METROPOLITANA;0;0;0;0;0;0;0;0;0;CELULAR MOTO ONE FUSION 64GB VERDE 64GB OPEN;TELEFONIA
20088985;;F;23;CHILENO;;Z;PROVIDENCIA                   ;METROPOLITANA;0;0;0;0;0;0;0;0;0;CELULAR MOTOROLA G8 POWER LITE AZUL WOM;TELEFONIA
8768239;;M;62;CHILENO;;Boomers;PROVIDENCIA                   ;METROPOLITANA;0;0;0;0;0;0;0;0;0;Celular P30 LITE LIB OPEN NEGRO;TELEFONIA
6993149;;F;67;CHILENO;;Boomers;PETORCA                       ;VALPARAISO;0;0;0;0;0;0;0;0;0;CELULAR SAMSUNG A21S ROJO OPEN;TELEFONIA
16423985;;F;35;CHILENO;;Millenial;SAN BERNARDO                  ;METROPOLITANA;0;0;0;0;0;0;0;0;0;Celular Y7P LIB OPEN NEGRO;TELEFONIA
12599786;;M;48;CHILENO;;X;SAN FELIPE                    ;VALPARAISO;0;0;0;0;0;0;0;0;0;CELULAR MOTOROLA G9 PLUS DEEP DIVE OPEN;TELEFONIA
12577937;;M;48;CHILENO;;X;RENCA                         ;METROPOLITANA;0;0;0;0;0;0;0;0;0;Celular A01 CLARO DIRECTO BLACK;TELEFONIA
16652676;;F;34;CHILENO;;Millenial;N/D;N/D;0;0;0;0;0;0;0;0;0;Celular A51 128GB LIB OPEN AZUL;TELEFONIA
7922758;;F;66;CHILENO;;Boomers;LONGAVI                       ;MAULE;0;0;0;0;0;0;0;0;0;Celular A11 LIB OPEN BLACK;TELEFONIA
6414488;;M;69;CHILENO;;Silencioso;RENCA                         ;METROPOLITANA;0;0;0;0;0;0;0;0;0;Celular SA3 CLARO DIRECTO BLACK;TELEFONIA
8452874;Casado;F;59;CHILENO;;Boomers;PROVIDENCIA                   ;METROPOLITANA;0;0;0;0;0;0;0;0;0;Celular HUAWEI Y9 PRIME DIRECTO CLARO BLUE;TELEFONIA
16762052;;F;33;CHILENO;;Millenial;CONCEPCION                    ;BIO BIO;0;0;0;0;0;0;0;0;0;Celular S10+ LIB OPEN NEGRO;TELEFONIA
6748095;Casado;M;70;CHILENO;;Silencioso;PROVIDENCIA                   ;METROPOLITANA;0;0;0;0;0;0;0;0;0;Celular SAMSUNG A11 32GB ENTEL DIRECTO NEGRO;TELEFONIA
18654123;;M;28;CHILENO;;Millenial;PROVIDENCIA                   ;METROPOLITANA;0;0;0;0;0;0;0;0;0;Celular A10S ENTEL DIRECTO NEGRO;TELEFONIA
19832495;;F;24;CHILENO;;Millenial;N/D;N/D;0;0;0;0;0;0;0;0;0;CELULAR LG K22 TRIANGULADO WOM;TELEFONIA
10516482;;F;57;CHILENO;;Boomers;SAN VICENTE                   ;L.G.B.OÂ´HIGGINS;0;0;0;0;0;0;0;0;0;Celular SAMSUNG A11 32GB ENTEL DIRECTO NEGRO;TELEFONIA
12598042;Soltero;M;48;CHILENO;;X;RENCA                         ;METROPOLITANA;0;0;0;0;0;0;0;0;0;CELULAR A02s NEGRO 32GB OPEN;TELEFONIA
18241932;Soltero;M;29;CHILENO;;Millenial;PROVIDENCIA                   ;METROPOLITANA;0;0;0;0;0;0;0;0;0;Celular Y7P LIB OPEN NEGRO;TELEFONIA
16537695;;M;35;CHILENO;;Millenial;REQUINOA                      ;L.G.B.OÂ´HIGGINS;0;0;0;0;0;0;0;0;0;Celular A71 LIB OPEN PLATEADO;TELEFONIA
10039190;;M;56;CHILENO;;Boomers;SAN FELIPE                    ;VALPARAISO;0;0;0;0;0;0;0;0;0;Celular A10S LIB OPEN RED;TELEFONIA
8787738;;M;66;CHILENO;;Boomers;RENCA                         ;METROPOLITANA;0;0;0;0;0;0;0;0;0;Celular A11 LIB OPEN BLUE;TELEFONIA
13066155;;F;46;CHILENO;;X;RENCA                         ;METROPOLITANA;0;0;0;0;0;0;0;0;0;Celular SAMSUNG A01 CORE BLACK CLARO;TELEFONIA
14400473;;M;43;CHILENO;;X;VALLENAR;ATACAMA;0;0;0;0;0;0;0;0;0;Celular V10 BLACK CLARO DIRECTO PURPURA;TELEFONIA
16892658;;F;34;CHILENO;;Millenial;VALLENAR;ATACAMA;0;0;0;0;0;0;0;0;0;CELULAR SAMSUNG NOTE 20 MYSTIC BRONZE 256 GB OPE;TELEFONIA
16980747;;M;34;CHILENO;;Millenial;N/D;N/D;0;0;0;0;0;0;0;0;0;Celular A20S LIB OPEN AZUL;TELEFONIA
12546934;Casado;M;48;CHILENO;;X;RENCA                         ;METROPOLITANA;0;0;0;0;0;0;0;0;0;Celular A10S LIB OPEN NEGRO;TELEFONIA
11670093;;F;51;CHILENO;;X;LA PINTANA                    ;METROPOLITANA;0;0;0;0;0;0;0;0;0;CELULAR REDMI NOTE 8 64GB NEPTUNE BLUE OPEN;TELEFONIA
16958543;;M;33;CHILENO;;Millenial;PROVIDENCIA                   ;METROPOLITANA;0;0;0;0;0;0;0;0;0;CELULAR HUAWEI Y9S BLACK DIRECTO CLARO;TELEFONIA
26008704;;M;41;CHILENO;;Extranjero;LA FLORIDA                    ;METROPOLITANA;0;0;0;0;0;0;0;0;0;CELULAR SAMSUNG A21S AZUL OPEN;TELEFONIA
11204901;;M;55;CHILENO;;Boomers;PROVIDENCIA                   ;METROPOLITANA;0;0;0;0;0;0;0;0;0;Celular A11 LIB OPEN WHITE;TELEFONIA
12217649;;F;49;CHILENO;;X;ALTO HOSPICIO;TARAPACA;0;0;0;0;0;0;0;0;0;Celular A01 CLARO DIRECTO BLACK;TELEFONIA
15737031;;F;38;CHILENO;;X;PROVIDENCIA                   ;METROPOLITANA;0;0;0;0;0;0;0;0;0;Celular A71 LIB OPEN PLATEADO;TELEFONIA
9590097;;M;56;CHILENO;;Boomers;TALCA                         ;MAULE;0;0;0;0;0;0;0;0;0;Celular A51 128GB LIB OPEN AZUL;TELEFONIA
10899106;;M;50;CHILENO;;X;RENCA                         ;METROPOLITANA;0;0;0;0;0;0;0;0;0;Celular A11 LIB OPEN BLUE;TELEFONIA
16277603;;M;36;CHILENO;;Millenial;RENCA                         ;METROPOLITANA;0;0;0;0;0;0;0;0;0;Celular A51 128GB LIB OPEN BLANCO;TELEFONIA
9782382;;F;59;CHILENO;;Boomers;LOS ANGELES                   ;BIO BIO;0;0;0;0;0;0;0;0;0;CELULAR XIAOMI REDMI 9C 64GB MIDNIGHT GRAY;TELEFONIA
18471929;;M;29;CHILENO;;Millenial;PUERTO MONTT                  ;LOS LAGOS;0;0;0;0;0;0;0;0;0;Celular A20S LIB OPEN AZUL;TELEFONIA
10136422;Soltero;M;46;CHILENO;;X;RENCA                         ;METROPOLITANA;0;0;0;0;0;0;0;0;0;CELULAR REDMI NOTE 8 64GB NEPTUNE BLUE OPEN;TELEFONIA
15865446;Soltero;F;37;CHILENO;;Millenial;COLLIPULLI                    ;ARAUCANIA;0;0;0;0;0;0;0;0;0;CELULAR SAMSUNG A21S ROJO OPEN;TELEFONIA
14380000;;M;45;CHILENO;;X;PROVIDENCIA                   ;METROPOLITANA;0;0;0;0;0;0;0;0;0;CELULAR REDMI NOTE 8 64GB NEPTUNE BLUE OPEN;TELEFONIA
16212552;;M;35;CHILENO;;Millenial;PROVIDENCIA                   ;METROPOLITANA;0;0;0;0;0;0;0;0;0;CELULAR MOTOROLA ONE FUSION 128GB DIRECTO MOVIST;TELEFONIA
19218606;Soltero;F;26;CHILENO;;Z;PROVIDENCIA                   ;METROPOLITANA;0;0;0;0;0;0;0;0;0;Celular A01 CORE MOVISTAR DIRECTO BLACK;TELEFONIA
12191576;;F;50;CHILENO;;X;RENCA                         ;METROPOLITANA;0;0;0;0;0;0;0;0;0;Celular A01 LIB OPEN AZUL;TELEFONIA
15983879;;M;37;CHILENO;;Millenial;SAN CARLOS                    ;BIO BIO;0;0;0;0;0;0;0;0;0;Celular A10S LIB OPEN BLUE;TELEFONIA
15079806;Soltero;F;39;CHILENO;;X;CHILLAN                       ;BIO BIO;0;0;0;0;0;0;0;0;0;CELULAR SAMSUNG A21S NEGRO OPEN;TELEFONIA
19366072;;M;26;CHILENO;;Z;PUERTO MONTT                  ;LOS LAGOS;0;0;0;0;0;0;0;0;0;CELULAR REDMI NOTE 8 64GB NEPTUNE BLUE OPEN;TELEFONIA
16179794;;F;36;CHILENO;;Millenial;PROVIDENCIA                   ;METROPOLITANA;0;0;0;0;0;0;0;0;0;Celular a11 azul samsung WOM;TELEFONIA
17646144;;M;31;CHILENO;;Millenial;PANQUEHUE                     ;VALPARAISO;0;0;0;0;0;0;0;0;0;CELULAR SAMSUNG A71 AZUL OPEN;TELEFONIA
8602177;Casado;F;54;CHILENO;PROFESOR;Boomers;RENCA                         ;METROPOLITANA;0;0;0;0;0;0;0;0;0;CELULAR REDMI NOTE 8 64GB NEPTUNE BLUE OPEN;TELEFONIA
7846430;;F;66;CHILENO;;Boomers;PROVIDENCIA                   ;METROPOLITANA;0;0;0;0;0;0;0;0;0;Celular A10S LIB OPEN NEGRO;TELEFONIA
11442066;;M;52;CHILENO;;X;PROVIDENCIA                   ;METROPOLITANA;0;0;0;0;0;0;0;0;0;CELULAR MOTOROLA G9 PLUS DEEP DIVE OPEN;TELEFONIA
18256396;;M;29;CHILENO;;Millenial;PROVIDENCIA                   ;METROPOLITANA;0;0;0;0;0;0;0;0;0;CELULAR REDMI NOTE 8 64GB NEPTUNE BLUE OPEN;TELEFONIA
15744893;;M;32;CHILENO;;Millenial;PROVIDENCIA                   ;METROPOLITANA;0;0;0;0;0;0;0;0;0;Celular A10S LIB OPEN RED;TELEFONIA
8983433;;M;61;CHILENO;;Boomers;ANTOFAGASTA                   ;ANTOFAGASTA;0;0;0;0;0;0;0;0;0;Celular A71 LIB OPEN NEGRO;TELEFONIA
6959115;;F;64;CHILENO;;Boomers;LINARES                       ;MAULE;0;0;0;0;0;0;0;0;0;Celular 2.3 MOVISTAR DIRECTO CHARCOAL;TELEFONIA
16829022;;M;33;CHILENO;;Millenial;MELIPILLA                     ;METROPOLITANA;0;0;0;0;0;0;0;0;0;Celular P40 LITE LIB OPEN GREEN;TELEFONIA
7516358;;M;64;CHILENO;;Boomers;PROVIDENCIA                   ;METROPOLITANA;0;0;0;0;0;0;0;0;0;Celular VIVO Y11S ENTEL DIRECTO AZUL;TELEFONIA
16855372;;M;34;CHILENO;;Millenial;PROVIDENCIA                   ;METROPOLITANA;0;0;0;0;0;0;0;0;0;Celular LG K22 DIRECTO CLARO;TELEFONIA
20070783;;F;23;CHILENO;;Z;PROVIDENCIA                   ;METROPOLITANA;0;0;0;0;0;0;0;0;0;Celular NOKIA 1.3 NEGRO WOM;TELEFONIA
10653398;;F;56;CHILENO;;Boomers;CHEPICA                       ;L.G.B.OÂ´HIGGINS;0;0;0;0;0;0;0;0;0;Celular A31 LIB OPEN AZUL;TELEFONIA
12147371;;F;52;CHILENO;;X;PROVIDENCIA                   ;METROPOLITANA;0;0;0;0;0;0;0;0;0;CELULAR HUAWEI Y8S CLARO DIRECTO BLACK;TELEFONIA
16698254;;F;34;CHILENO;;Millenial;PROVIDENCIA                   ;METROPOLITANA;0;0;0;0;0;0;0;0;0;Celular XIAOMI REDMI 9A 32 GB DIRECTO CLARO;TELEFONIA
7662867;Soltero;F;64;CHILENO;AUXILIAR DE ENFERMERIA;Boomers;TALAGANTE                     ;METROPOLITANA;0;0;0;0;0;0;0;0;0;CELULAR SAMSUNG A01 NEGRO DIRECTO WOM;TELEFONIA
14442991;;F;50;CHILENO;;X;PROVIDENCIA                   ;METROPOLITANA;0;0;0;0;0;0;0;0;0;Celular 2.3 MOVISTAR DIRECTO CHARCOAL;TELEFONIA
14403136;;F;51;CHILENO;;X;CABRERO                       ;BIO BIO;0;0;0;0;0;0;0;0;0;Celular A11 LIB OPEN BLACK;TELEFONIA
11204814;;F;55;CHILENO;;Boomers;COQUIMBO                      ;COQUIMBO;0;0;0;0;0;0;0;0;0;CELULAR HUAWEI Y5 NEO NEGRO WOM;TELEFONIA
19782087;;F;25;CHILENO;;Z;PROVIDENCIA                   ;METROPOLITANA;0;0;0;0;0;0;0;0;0;Celular P30 LITE PLUS LIB OPEN BLACK;TELEFONIA
15802156;;F;37;CHILENO;;Millenial;OVALLE                        ;COQUIMBO;0;0;0;0;0;0;0;0;0;Celular NOKIA 1.3 NEGRO WOM;TELEFONIA
11526096;;F;52;CHILENO;;X;PENAFLOR                      ;METROPOLITANA;0;0;0;0;0;0;0;0;0;CELULAR SAMSUNG A21S ROJO OPEN;TELEFONIA
15264377;;M;39;CHILENO;;X;COPIAPO;ATACAMA;0;0;0;0;0;0;0;0;0;CELULAR MOTO ONE FUSION 64GB VERDE 64GB OPEN;TELEFONIA
9172358;Casado;M;58;CHILENO;;Boomers;SAN VICENTE                   ;L.G.B.OÂ´HIGGINS;0;0;0;0;0;0;0;0;0;Celular SAMSUNG A01 CORE BLACK CLARO;TELEFONIA
10170245;Casado;M;57;CHILENO;;Boomers;PROVIDENCIA                   ;METROPOLITANA;0;0;0;0;0;0;0;0;0;Celular 2.3 MOVISTAR DIRECTO CHARCOAL;TELEFONIA
12418933;;F;48;CHILENO;;X;PROVIDENCIA                   ;METROPOLITANA;0;0;0;0;0;0;0;0;0;Celular G8 POWER LITE MOVISTAR DIRECTO AZUL;TELEFONIA
9515725;;M;59;CHILENO;;Boomers;PROVIDENCIA                   ;METROPOLITANA;0;0;0;0;0;0;0;0;0;CELULAR HUAWEI Y5P CLARO DIRECTO BLUE;TELEFONIA
19924202;;M;24;CHILENO;;Z;PROVIDENCIA                   ;METROPOLITANA;0;0;0;0;0;0;0;0;0;Celular A51 128GB LIB OPEN AZUL;TELEFONIA
17447168;;F;33;CHILENO;;Millenial;YERBAS BUENAS                 ;MAULE;0;0;0;0;0;0;0;0;0;Celular A11 LIB OPEN WHITE;TELEFONIA
7142698;;F;67;CHILENO;;Boomers;PERQUENCO                     ;ARAUCANIA;0;0;0;0;0;0;0;0;0;CELULAR HUAWEI Y8S NEGRO WOM;TELEFONIA
10696201;;F;55;CHILENO;;Boomers;PICHIDEGUA                    ;L.G.B.OÂ´HIGGINS;0;0;0;0;0;0;0;0;0;CELULAR HUAWEI Y9S BLACK DIRECTO CLARO;TELEFONIA
19534058;;F;25;CHILENO;;Z;VINA DEL MAR                  ;VALPARAISO;0;0;0;0;0;0;0;0;0;CELULAR HUAWEI Y8S CLARO DIRECTO BLACK;TELEFONIA
19765175;;F;24;CHILENO;;Silencioso;PROVIDENCIA                   ;METROPOLITANA;0;0;0;0;0;0;0;0;0;Celular Y6 2019 WOM DIRECTO BLACK;TELEFONIA
18399233;;M;28;CHILENO;;Millenial;NUNOA                         ;METROPOLITANA;0;0;0;0;0;0;0;0;0;CELULAR MOTO ONE FUSION 64GB VERDE 64GB OPEN;TELEFONIA
15253171;;M;39;CHILENO;;X;N/D;N/D;0;0;0;0;0;0;0;0;0;CELULAR HUAWEI Y5 NEO NEGRO WOM;TELEFONIA
20209811;;M;22;CHILENO;;Z;PROVIDENCIA                   ;METROPOLITANA;0;0;0;0;0;0;0;0;0;CELULAR SAMSUNG A71 AZUL OPEN;TELEFONIA
17248515;;M;33;CHILENO;;Millenial;PROVIDENCIA                   ;METROPOLITANA;0;0;0;0;0;0;0;0;0;CELULAR SAMSUNG A71 AZUL OPEN;TELEFONIA
7291239;;M;69;CHILENO;;Silencioso;ALGARROBO                     ;VALPARAISO;0;0;0;0;0;0;0;0;0;Celular R340 CLARO DIRECTO NEGRO;TELEFONIA
7822492;;F;63;CHILENO;;Boomers;LOS ANDES                     ;VALPARAISO;0;0;0;0;0;0;0;0;0;Celular SA3 CLARO DIRECTO BLACK;TELEFONIA
13748830;;M;42;CHILENO;;X;MONTE PATRIA                  ;COQUIMBO;0;0;0;0;0;0;0;0;0;Celular a11 azul samsung WOM;TELEFONIA
17170592;;F;33;CHILENO;;Millenial;PROVIDENCIA                   ;METROPOLITANA;0;0;0;0;0;0;0;0;0;CELULAR OWN 1026 AZUL ENTEL;TELEFONIA
10215055;;F;54;CHILENO;;X;RENCA                         ;METROPOLITANA;0;0;0;0;0;0;0;0;0;CELULAR XIAOMI REDMI 9C 64GB MIDNIGHT GRAY;TELEFONIA
22454861;;F;27;CHILENO;;Z;ARICA                         ;ARICA Y PARINACOTA;0;0;0;0;0;0;0;0;0;Celular Y9S LIB OPEN BLACK;TELEFONIA
9371366;;M;61;CHILENO;;Boomers;RENCA                         ;METROPOLITANA;0;0;0;0;0;0;0;0;0;Celular R340 CLARO DIRECTO NEGRO;TELEFONIA
17663409;Soltero;M;31;CHILENO;;Millenial;PROVIDENCIA                   ;METROPOLITANA;0;0;0;0;0;0;0;0;0;Celular SAMSUNG A01 CORE BLACK CLARO;TELEFONIA
14792871;;M;34;BOLIVIANO;;Extranjero;N/D;N/D;0;0;0;0;0;0;0;0;0;Celular A51 128GB LIB OPEN BLACK;TELEFONIA
12428404;;F;48;CHILENO;;X;RENCA                         ;METROPOLITANA;0;0;0;0;0;0;0;0;0;Celular A11 LIB OPEN BLUE;TELEFONIA
13246970;;M;45;CHILENO;;X;RENCA                         ;METROPOLITANA;0;0;0;0;0;0;0;0;0;Celular 2.3 MOVISTAR DIRECTO CHARCOAL;TELEFONIA
8996308;;M;60;CHILENO;;Boomers;ARICA                         ;ARICA Y PARINACOTA;0;0;0;0;0;0;0;0;0;CELULAR REDMI 9 64GB SUNSET PURPLE TRI WOM;TELEFONIA
9878152;;M;58;CHILENO;;Boomers;EL BOSQUE                     ;METROPOLITANA;0;0;0;0;0;0;0;0;0;Celular A01 LIB OPEN AZUL;TELEFONIA
19856612;;M;24;CHILENO;;Millenial;PROVIDENCIA                   ;METROPOLITANA;0;0;0;0;0;0;0;0;0;CELULAR ZTE A5 2020 NEGRO WOM;TELEFONIA
9339335;;M;47;CHILENO;;X;RENCA                         ;METROPOLITANA;0;0;0;0;0;0;0;0;0;Celular SA3 CLARO DIRECTO BLACK;TELEFONIA
4684066;;M;78;CHILENO;;Silencioso;NUEVA IMPERIAL                ;ARAUCANIA;0;0;0;0;0;0;0;0;0;CELULAR OWN 1026 AZUL ENTEL;TELEFONIA
9790266;;M;58;CHILENO;;Boomers;LA CISTERNA                   ;METROPOLITANA;0;0;0;0;0;0;0;0;0;CELULAR HUAWEI Y5 NEO NEGRO WOM;TELEFONIA
12722459;Casado;F;46;CHILENO;CONSTRUCTOR CIVIL;X;RENCA                         ;METROPOLITANA;0;0;0;0;0;0;0;0;0;Celular A01 LIB OPEN NEGRO;TELEFONIA
4684973;;M;78;CHILENO;;Silencioso;CHILLAN                       ;BIO BIO;0;0;0;0;0;0;0;0;0;CELULAR Y8S MOVISTAR DIRECTO BLACK;TELEFONIA
19051926;;F;27;CHILENO;;Z;LOS ANGELES                   ;BIO BIO;0;0;0;0;0;0;0;0;0;CELULAR MOTO ONE FUSION 64GB VERDE 64GB OPEN;TELEFONIA
11940638;;M;52;CHILENO;;X;RENCA                         ;METROPOLITANA;0;0;0;0;0;0;0;0;0;CELULAR HUAWEI Y5 NEO NEGRO WOM;TELEFONIA
7165355;;F;69;CHILENO;;Silencioso;PROVIDENCIA                   ;METROPOLITANA;0;0;0;0;0;0;0;0;0;CELULAR NOKIA 3310 CHARCOAL TRI WOM;TELEFONIA
7711037;Soltero;M;66;CHILENO;;Boomers;RENCA                         ;METROPOLITANA;0;0;0;0;0;0;0;0;0;Celular A11 LIB OPEN BLACK;TELEFONIA
5503885;;F;77;CHILENO;;Silencioso;LOS ANGELES                   ;BIO BIO;0;0;0;0;0;0;0;0;0;CELULAR OWN 1026 AZUL ENTEL;TELEFONIA
16322934;;F;35;CHILENO;;Millenial;RENCA                         ;METROPOLITANA;0;0;0;0;0;0;0;0;0;Celular A01 LIB OPEN AZUL;TELEFONIA
12190148;Soltero;F;50;CHILENO;;X;RENCA                         ;METROPOLITANA;0;0;0;0;0;0;0;0;0;Celular Y5 NEO ENTEL DIRECTO BLACK;TELEFONIA
20279544;;F;22;CHILENO;;Extranjero;PROVIDENCIA                   ;METROPOLITANA;0;0;0;0;0;0;0;0;0;Celular A11 LIB OPEN BLUE;TELEFONIA
5891115;;F;70;CHILENO;;Silencioso;RENCA                         ;METROPOLITANA;0;0;0;0;0;0;0;0;0;Celular A11 LIB OPEN WHITE;TELEFONIA
15499767;Soltero;M;58;CHILENO;;Boomers;RENCA                         ;METROPOLITANA;0;0;0;0;0;0;0;0;0;Celular Y6 2019 MOVISTAR DIRECTO BLUE;TELEFONIA
13539066;Soltero;M;43;CHILENO;;X;PROVIDENCIA                   ;METROPOLITANA;0;0;0;0;0;0;0;0;0;Celular A51 128GB LIB OPEN BLACK;TELEFONIA
10198441;;M;56;CHILENO;;Boomers;PROVIDENCIA                   ;METROPOLITANA;0;0;0;0;0;0;0;0;0;Celular A01 MOVISTAR DIRECTO BLACK;TELEFONIA
10242487;;F;60;CHILENO;;Boomers;HUALQUI                       ;BIO BIO;0;0;0;0;0;0;0;0;0;CELULAR OWN 1026 AZUL ENTEL;TELEFONIA
4869149;;M;79;CHILENO;;Silencioso;SAN FERNANDO                  ;L.G.B.OÂ´HIGGINS;0;0;0;0;0;0;0;0;0;Celular AL3 CLARO DIRECTO NEGRO;TELEFONIA
20463727;;F;21;CHILENO;;Z;PROVIDENCIA                   ;METROPOLITANA;0;0;0;0;0;0;0;0;0;Celular AL3 CLARO DIRECTO NEGRO;TELEFONIA
7208840;;F;68;CHILENO;;Silencioso;MELIPILLA                     ;METROPOLITANA;0;0;0;0;0;0;0;0;0;Celular Y6 2019 WOM DIRECTO BLACK;TELEFONIA
12216945;;F;49;CHILENO;;X;RENCA                         ;METROPOLITANA;0;0;0;0;0;0;0;0;0;Celular Y6 2019 WOM DIRECTO BLACK;TELEFONIA
3966519;;M;83;CHILENO;;Silencioso;NUEVA IMPERIAL                ;ARAUCANIA;0;0;0;0;0;0;0;0;0;Celular a11 azul samsung WOM;TELEFONIA
12835263;;F;50;CHILENO;;X;IQUIQUE                       ;TARAPACA;0;0;0;0;0;0;0;0;0;Celular SAMSUNG A01 CORE AZUL ENTEL;TELEFONIA
17270806;;F;32;CHILENO;;Millenial;PROVIDENCIA                   ;METROPOLITANA;0;0;0;0;0;0;0;0;0;Celular NOKIA 1.3 NEGRO WOM;TELEFONIA
19352185;;F;25;CHILENO;;Z;PROVIDENCIA                   ;METROPOLITANA;0;0;0;0;0;0;0;0;0;Celular A31 LIB OPEN BLACK;TELEFONIA
9815305;Casado;F;58;CHILENO;;Boomers;PROVIDENCIA                   ;METROPOLITANA;0;0;0;0;0;0;0;0;0;CELULAR OWN 1026 AZUL ENTEL;TELEFONIA
15567017;;M;39;CHILENO;;X;PROVIDENCIA                   ;METROPOLITANA;0;0;0;0;0;0;0;0;0;CELULAR SAMSUNG A21S AZUL OPEN;TELEFONIA
8737312;Casado;F;61;CHILENO;;Boomers;PROVIDENCIA                   ;METROPOLITANA;0;0;0;0;0;0;0;0;0;Celular a11 azul samsung WOM;TELEFONIA
18818761;Soltero;M;27;CHILENO;INGENIERIA EN ADMINISTRACION DE EMPRESAS MENCION FINANZAS;Millenial;PROVIDENCIA                   ;METROPOLITANA;0;0;0;0;0;0;0;0;0;Celular A31 LIB OPEN ROJO;TELEFONIA
14135588;;F;40;CHILENO;;X;CABILDO                       ;VALPARAISO;0;0;0;0;0;0;0;0;0;CELULAR HUAWEI Y5 NEO NEGRO WOM;TELEFONIA
17304166;;F;32;CHILENO;;Millenial;PUDAHUEL                      ;METROPOLITANA;0;0;0;0;0;0;0;0;0;Celular A11 LIB OPEN BLACK;TELEFONIA
11721494;;F;51;CHILENO;;X;PROVIDENCIA                   ;METROPOLITANA;0;0;0;0;0;0;0;0;0;CELULAR HUAWEI Y8S NEGRO WOM;TELEFONIA
7324130;Divorciado;F;71;CHILENO;;Silencioso;ANGOL                         ;ARAUCANIA;0;0;0;0;0;0;0;0;0;Celular Y7P LIB OPEN NEGRO;TELEFONIA
19625293;;F;24;CHILENO;;Z;PROVIDENCIA                   ;METROPOLITANA;0;0;0;0;0;0;0;0;0;CELULAR Y8S MOVISTAR DIRECTO BLACK;TELEFONIA
6133001;;F;73;CHILENO;;Silencioso;MAIPU                         ;METROPOLITANA;0;0;0;0;0;0;0;0;0;Celular A31 LIB OPEN BLACK;TELEFONIA
8094278;;M;61;CHILENO;;Boomers;RENCA                         ;METROPOLITANA;0;0;0;0;0;0;0;0;0;IPHONE 7 LIB OPEN NEGRO;TELEFONIA
12731264;Casado;M;47;CHILENO;;X;RENCA                         ;METROPOLITANA;0;0;0;0;0;0;0;0;0;Celular A10S LIB OPEN RED;TELEFONIA
11188285;;M;54;CHILENO;;Boomers;N/D;N/D;0;0;0;0;0;0;0;0;0;Celular A11 LIB OPEN BLUE;TELEFONIA
19261478;;F;26;CHILENO;;Z;N/D;N/D;0;0;0;0;0;0;0;0;0;Celular A31 LIB OPEN BLACK;TELEFONIA
17218959;Soltero;M;32;CHILENO;;Millenial;PROVIDENCIA                   ;METROPOLITANA;0;0;0;0;0;0;0;0;0;Celular A20S LIB OPEN AZUL;TELEFONIA
17428162;;M;32;CHILENO;;Millenial;CUNCO                         ;ARAUCANIA;0;0;0;0;0;0;0;0;0;Celular A10S MOVISTAR DIRECTO NEGRO;TELEFONIA
20057689;;M;23;CHILENO;;Z;MAIPU;METROPOLITANA;0;0;0;0;0;0;0;0;0;Celular P30 LITE LIB OPEN NEGRO;TELEFONIA
11529246;;F;51;CHILENO;;X;PROVIDENCIA                   ;METROPOLITANA;0;0;0;0;0;0;0;0;0;CELULAR MOTO ONE FUSION 64GB VERDE 64GB OPEN;TELEFONIA
18974601;;M;27;CHILENO;;Millenial;N/D;N/D;0;0;0;0;0;0;0;0;0;CELULAR SAMSUNG A21S AZUL OPEN;TELEFONIA
17129143;;M;33;CHILENO;;Millenial;N/D;N/D;0;0;0;0;0;0;0;0;0;CELULAR HUAWEI Y8S NEGRO WOM;TELEFONIA
16703833;;M;35;CHILENO;;Millenial;RENCA                         ;METROPOLITANA;0;0;0;0;0;0;0;0;0;Celular A01 CORE MOVISTAR DIRECTO BLACK;TELEFONIA
8641331;Casado;M;64;CHILENO;;Boomers;RENCA                         ;METROPOLITANA;0;0;0;0;0;0;0;0;0;Celular 2.3 MOVISTAR DIRECTO CHARCOAL;TELEFONIA
18302658;;M;36;CHILENO;;Millenial;PROVIDENCIA                   ;METROPOLITANA;0;0;0;0;0;0;0;0;0;Celular A11 LIB OPEN BLUE;TELEFONIA
17657367;;M;31;CHILENO;;Millenial;ZAPALLAR                      ;VALPARAISO;0;0;0;0;0;0;0;0;0;Celular MOTO G8 POWER LITE TURQUESA OPEN;TELEFONIA
18588374;;F;28;CHILENO;;Millenial;COPIAPO                       ;ATACAMA;0;0;0;0;0;0;0;0;0;Celular A71 LIB OPEN PLATEADO;TELEFONIA
8640275;;M;54;CHILENO;;Boomers;RENCA                         ;METROPOLITANA;0;0;0;0;0;0;0;0;0;Celular A10S LIB OPEN BLUE;TELEFONIA
6318029;Soltero;M;72;CHILENO;;Silencioso;PROVIDENCIA                   ;METROPOLITANA;0;0;0;0;0;0;0;0;0;Celular A01 CORE MOVISTAR DIRECTO BLACK;TELEFONIA
15050483;Casado;F;40;CHILENO;;X;RENCA                         ;METROPOLITANA;0;0;0;0;0;0;0;0;0;Celular J2 CORE CLARO DIRECTO NEGRO;TELEFONIA
8986530;;M;61;CHILENO;;Boomers;CONTULMO                      ;BIO BIO;0;0;0;0;0;0;0;0;0;CELULAR MOTOROLA E6S AZUL WOM;TELEFONIA
15705414;;M;38;CHILENO;;X;CAUQUENES                     ;MAULE;0;0;0;0;0;0;0;0;0;CELULAR HUAWEI Y5P BLUE TRIANGULADO WOM;TELEFONIA
14107575;;F;41;CHILENO;;X;IQUIQUE                       ;TARAPACA;0;0;0;0;0;0;0;0;0;CELULAR MOTOROLA G7 PLAY DEEP INDIGO;TELEFONIA
7651854;;F;66;CHILENO;;Boomers;MAIPU                         ;METROPOLITANA;0;0;0;0;0;0;0;0;0;Celular A20S LIB OPEN ROJO;TELEFONIA
19030248;;F;27;CHILENO;;Z;PROVIDENCIA                   ;METROPOLITANA;0;0;0;0;0;0;0;0;0;CELULAR HUAWEI Y5 NEO NEGRO WOM;TELEFONIA
10369676;;F;56;CHILENO;;Boomers;CERRO NAVIA                   ;METROPOLITANA;0;0;0;0;0;0;0;0;0;Celular Y6P WOM TRIANGULADO NEGRO;TELEFONIA
4765953;;F;82;CHILENO;;Silencioso;RENCA                         ;METROPOLITANA;0;0;0;0;0;0;0;0;0;Celular A3 LITE ENTEL TRIANGULADO NEGRO;TELEFONIA
9077698;;M;62;CHILENO;;Boomers;ARAUCO                        ;BIO BIO;0;0;0;0;0;0;0;0;0;CELULAR HUAWEI Y5P BLUE TRIANGULADO WOM;TELEFONIA
14094734;;M;42;CHILENO;;X;PROVIDENCIA                   ;METROPOLITANA;0;0;0;0;0;0;0;0;0;Celular A10S MOVISTAR DIRECTO NEGRO;TELEFONIA
12139131;Casado;F;53;CHILENO;;X;RENCA                         ;METROPOLITANA;0;0;0;0;0;0;0;0;0;Celular SAMSUNG A01 CORE BLACK CLARO;TELEFONIA
18286180;;F;30;CHILENO;;Millenial;N/D;N/D;0;0;0;0;0;0;0;0;0;Celular A20S LIB OPEN NEGRO;TELEFONIA
13391064;;M;47;CHILENO;;X;SANTA BARBARA                 ;BIO BIO;0;0;0;0;0;0;0;0;0;Celular A10S LIB OPEN RED;TELEFONIA
8091187;;M;64;CHILENO;;Boomers;MELIPILLA                     ;METROPOLITANA;0;0;0;0;0;0;0;0;0;CELULAR MOTOROLA G9 PLAY 64GB SPRING PINK OPEN;TELEFONIA
16337063;;F;35;CHILENO;;Millenial;PROVIDENCIA                   ;METROPOLITANA;0;0;0;0;0;0;0;0;0;Celular A3 LITE ENTEL TRIANGULADO NEGRO;TELEFONIA
12946396;;F;53;CHILENO;;X;RENCA                         ;METROPOLITANA;0;0;0;0;0;0;0;0;0;Celular S20 FE LIB OPEN Cloud Lavender;TELEFONIA
9200288;;F;60;CHILENO;;Boomers;TALCA                         ;MAULE;0;0;0;0;0;0;0;0;0;Celular A31 LIB OPEN ROJO;TELEFONIA
17746751;Soltero;M;31;CHILENO;;Millenial;PROVIDENCIA                   ;METROPOLITANA;0;0;0;0;0;0;0;0;0;CELULAR MOTO ONE FUSION 64GB VERDE 64GB OPEN;TELEFONIA
4448681;;M;81;CHILENO;;Silencioso;FREIRINA                      ;ATACAMA;0;0;0;0;0;0;0;0;0;Celular Y5 NEO CLARO DIRECTO BLACK;TELEFONIA
11458888;;M;52;CHILENO;;X;RETIRO                        ;MAULE;0;0;0;0;0;0;0;0;0;CELULAR NOKIA 1.3 CYAN BLUE TRI ENTEL;TELEFONIA
15115792;;F;40;CHILENO;;X;PROVIDENCIA                   ;METROPOLITANA;0;0;0;0;0;0;0;0;0;Celular Y7P LIB OPEN NEGRO;TELEFONIA
12007501;;F;40;CHILENO;;X;LAMPA                         ;METROPOLITANA;0;0;0;0;0;0;0;0;0;Celular A10S LIB OPEN BLUE;TELEFONIA
17448776;;M;32;CHILENO;;Millenial;PROVIDENCIA                   ;METROPOLITANA;0;0;0;0;0;0;0;0;0;Celular Y7P LIB OPEN AZUL;TELEFONIA
15139903;;F;39;CHILENO;;X;N/D;N/D;0;0;0;0;0;0;0;0;0;Celular A10S LIB OPEN NEGRO;TELEFONIA
24212814;;F;35;PERUANO;;Extranjero;SAN MIGUEL                    ;METROPOLITANA;0;0;0;0;0;0;0;0;0;Celular A20S LIB OPEN NEGRO;TELEFONIA
10802471;Casado;M;57;CHILENO;AGROINDUSTRIA;Boomers;PROVIDENCIA                   ;METROPOLITANA;0;0;0;0;0;0;0;0;0;Celular A01 CLARO DIRECTO BLACK;TELEFONIA
17381208;Soltero;F;32;CHILENO;PROFESOR;Millenial;PROVIDENCIA                   ;METROPOLITANA;0;0;0;0;0;0;0;0;0;CELULAR SAMSUNG A21S AZUL OPEN;TELEFONIA
15030547;;M;40;CHILENO;;X;COPIAPO                       ;ATACAMA;0;0;0;0;0;0;0;0;0;Celular S20+ LIB OPEN NEGRO;TELEFONIA
9131703;;F;54;CHILENO;;X;COPIAPO                       ;ATACAMA;0;0;0;0;0;0;0;0;0;CELULAR SAMSUNG A21S ROJO OPEN;TELEFONIA
14542480;;F;40;CHILENO;;X;PROVIDENCIA                   ;METROPOLITANA;0;0;0;0;0;0;0;0;0;Celular A5 CLARO DIRECTO BLACK;TELEFONIA
19161412;;F;27;CHILENO;;Z;PROVIDENCIA                   ;METROPOLITANA;0;0;0;0;0;0;0;0;0;Celular A01 LIB OPEN NEGRO;TELEFONIA
13259870;;M;45;CHILENO;;X;VINA DEL MAR                  ;VALPARAISO;0;0;0;0;0;0;0;0;0;CELULAR MOTO ONE MACRO AZUL METAL WOM;TELEFONIA
19003770;;M;27;CHILENO;;Millenial;CURICO                        ;MAULE;0;0;0;0;0;0;0;0;0;Celular A10S LIB OPEN RED;TELEFONIA
12345531;Casado;F;48;CHILENO;;X;PROVIDENCIA                   ;METROPOLITANA;0;0;0;0;0;0;0;0;0;Celular SA3 CLARO DIRECTO BLACK;TELEFONIA
11458354;;M;53;CHILENO;;X;TALCA                         ;MAULE;0;0;0;0;0;0;0;0;0;Celular A10S LIB OPEN NEGRO;TELEFONIA
23178004;;F;48;PERUANO;;Extranjero;N/D;N/D;0;0;0;0;0;0;0;0;0;Celular A10S LIB OPEN NEGRO;TELEFONIA
19042656;;F;27;CHILENO;;Z;PROVIDENCIA                   ;METROPOLITANA;0;0;0;0;0;0;0;0;0;CELULAR MOTOROLA G9 PLAY 64GB SPRING PINK OPEN;TELEFONIA
5538106;;M;75;CHILENO;;Silencioso;RENCA                         ;METROPOLITANA;0;0;0;0;0;0;0;0;0;Celular E6S WOM DIRECTO RED;TELEFONIA
15224629;;M;40;CHILENO;;X;PUREN                         ;ARAUCANIA;0;0;0;0;0;0;0;0;0;CELULAR HUAWEI P30 LITE PLUS PIEDRA DE LUNA OPEN;TELEFONIA
16438374;;F;35;CHILENO;;Millenial;CHIMBARONGO                   ;L.G.B.OÂ´HIGGINS;0;0;0;0;0;0;0;0;0;Celular Y6 2019 CLARO DIRECTO BLACK;TELEFONIA
15222650;Divorciado;M;39;CHILENO;;X;PROVIDENCIA                   ;METROPOLITANA;0;0;0;0;0;0;0;0;0;Celular A51 128GB LIB OPEN BLANCO;TELEFONIA
8156318;;M;63;CHILENO;;Boomers;TOCOPILLA                     ;ANTOFAGASTA;0;0;0;0;0;0;0;0;0;Celular A01 CLARO DIRECTO BLACK;TELEFONIA
17057760;;M;33;CHILENO;;Millenial;PROVIDENCIA                   ;METROPOLITANA;0;0;0;0;0;0;0;0;0;Celular J2 CORE CLARO DIRECTO NEGRO;TELEFONIA
11790920;;F;51;CHILENO;;X;SAN IGNACIO                   ;BIO BIO;0;0;0;0;0;0;0;0;0;Celular A20S LIB OPEN AZUL;TELEFONIA
15213780;;F;40;CHILENO;;X;PROVIDENCIA                   ;METROPOLITANA;0;0;0;0;0;0;0;0;0;Celular A10S LIB OPEN BLUE;TELEFONIA
9420527;;M;57;CHILENO;;Boomers;RENCA                         ;METROPOLITANA;0;0;0;0;0;0;0;0;0;Celular A10S LIB OPEN NEGRO;TELEFONIA
16664460;Soltero;M;34;CHILENO;AGRONOMO;Millenial;LOS ANGELES                   ;BIO BIO;0;0;0;0;0;0;0;0;0;Celular A20S LIB OPEN AZUL;TELEFONIA
11646596;;F;51;CHILENO;;X;RENCA                         ;METROPOLITANA;0;0;0;0;0;0;0;0;0;CELULAR MOTOROLA E6S AZUL WOM;TELEFONIA
8920018;;F;69;CHILENO;;Silencioso;QUILLOTA                      ;VALPARAISO;0;0;0;0;0;0;0;0;0;Celular Y6P WOM TRIANGULADO VERDE;TELEFONIA
10448714;;F;54;CHILENO;;X;RENCA                         ;METROPOLITANA;0;0;0;0;0;0;0;0;0;CELULAR MOTO ONE FUSION 64GB VERDE 64GB OPEN;TELEFONIA
12570633;;F;47;CHILENO;;X;COPIAPO                       ;ATACAMA;0;0;0;0;0;0;0;0;0;Celular A31 LIB OPEN BLACK;TELEFONIA
15044952;;F;38;CHILENO;;Millenial;PROVIDENCIA                   ;METROPOLITANA;0;0;0;0;0;0;0;0;0;Celular Y9 PRIME LIB OPEN VERDE;TELEFONIA
10416395;;M;61;CHILENO;;Boomers;PROVIDENCIA                   ;METROPOLITANA;0;0;0;0;0;0;0;0;0;Celular A10S LIB OPEN NEGRO;TELEFONIA
19274404;;F;26;CHILENO;;Millenial;N/D;N/D;0;0;0;0;0;0;0;0;0;Celular E6S MOVISTAR DIRECTO AZUL;TELEFONIA
8726050;Viudo;M;63;CHILENO;;Boomers;PROVIDENCIA                   ;METROPOLITANA;0;0;0;0;0;0;0;0;0;Celular Y5 NEO CLARO DIRECTO BLACK;TELEFONIA
20137064;;F;23;CHILENO;;Z;TALAGANTE                     ;METROPOLITANA;0;0;0;0;0;0;0;0;0;Celular A10S LIB OPEN BLUE;TELEFONIA
17628118;Soltero;M;31;CHILENO;ANALISTA DE SISTEMAS;Millenial;PROVIDENCIA                   ;METROPOLITANA;0;0;0;0;0;0;0;0;0;Celular P30 LITE PLUS LIB OPEN BLACK;TELEFONIA
12127174;;F;52;CHILENO;;X;PADRE LAS CASAS               ;ARAUCANIA;0;0;0;0;0;0;0;0;0;Celular A51 128GB LIB OPEN BLACK;TELEFONIA
26226948;Soltero;F;40;VENEZOLANO;;Extranjero;PROVIDENCIA                   ;METROPOLITANA;0;0;0;0;0;0;0;0;0;Celular A01 LIB OPEN AZUL;TELEFONIA
10329257;;F;56;CHILENO;;Boomers;PROVIDENCIA                   ;METROPOLITANA;0;0;0;0;0;0;0;0;0;Celular A20S LIB OPEN ROJO;TELEFONIA
16828555;;M;34;CHILENO;;Millenial;PROVIDENCIA                   ;METROPOLITANA;0;0;0;0;0;0;0;0;0;CELULAR SAMSUNG A21S AZUL OPEN;TELEFONIA
13013786;;F;46;CHILENO;;X;PROVIDENCIA                   ;METROPOLITANA;0;0;0;0;0;0;0;0;0;Celular A20S LIB OPEN ROJO;TELEFONIA
10146021;;F;64;CHILENO;;Boomers;PROVIDENCIA                   ;METROPOLITANA;0;0;0;0;0;0;0;0;0;Celular SA3 CLARO DIRECTO BLACK;TELEFONIA
19194420;;F;26;CHILENO;;Z;LOS ANGELES                   ;BIO BIO;0;0;0;0;0;0;0;0;0;CELULAR HUAWEI Y8S NEGRO WOM;TELEFONIA
4636456;;F;82;CHILENO;;Silencioso;CABILDO                       ;VALPARAISO;0;0;0;0;0;0;0;0;0;Celular Y6 2019 MOVISTAR DIRECTO BLUE;TELEFONIA
9589015;Soltero;F;61;CHILENO;AUXILIAR PARAMEDICO DE ENFERMERIA;Boomers;RENCA                         ;METROPOLITANA;0;0;0;0;0;0;0;0;0;IPHONE X 64GB BLANCO;TELEFONIA
17274237;;F;33;CHILENO;;Millenial;QUILPUE                       ;VALPARAISO;0;0;0;0;0;0;0;0;0;CELULAR HUAWEI Y6P NEGRO ENTEL;TELEFONIA
17401622;;M;32;CHILENO;;Millenial;ARAUCO                        ;BIO BIO;0;0;0;0;0;0;0;0;0;Celular A01 LIB OPEN ROJO;TELEFONIA
18631122;;F;28;CHILENO;;Millenial;PROVIDENCIA                   ;METROPOLITANA;0;0;0;0;0;0;0;0;0;Celular A51 128GB LIB OPEN AZUL;TELEFONIA
18564248;;M;29;CHILENO;;Millenial;QUILPUE                       ;VALPARAISO;0;0;0;0;0;0;0;0;0;Celular P40 LITE LIB OPEN GREEN;TELEFONIA
17889194;;F;31;CHILENO;;Millenial;PROVIDENCIA                   ;METROPOLITANA;0;0;0;0;0;0;0;0;0;CELULAR SAMSUNG A21S ROJO OPEN;TELEFONIA
7907010;;M;63;CHILENO;;Boomers;TRAIGUEN                      ;ARAUCANIA;0;0;0;0;0;0;0;0;0;Celular A20S LIB OPEN AZUL;TELEFONIA
16739866;;F;34;CHILENO;;Millenial;PUENTE ALTO                   ;METROPOLITANA;0;0;0;0;0;0;0;0;0;Celular A10S MOVISTAR DIRECTO BLACK;TELEFONIA
10275357;;M;56;CHILENO;;Boomers;SAN RAMON                     ;METROPOLITANA;0;0;0;0;0;0;0;0;0;Celular Y5 NEO ENTEL DIRECTO BLACK;TELEFONIA
15467040;;F;40;CHILENO;;X;PROVIDENCIA                   ;METROPOLITANA;0;0;0;0;0;0;0;0;0;Celular Y9 PRIME LIB OPEN VERDE;TELEFONIA
13468305;;M;43;CHILENO;;X;PROVIDENCIA                   ;METROPOLITANA;0;0;0;0;0;0;0;0;0;Celular E6S MOVISTAR DIRECTO AZUL;TELEFONIA
14018309;;F;41;CHILENO;;X;RENCA                         ;METROPOLITANA;0;0;0;0;0;0;0;0;0;CELULAR SAMSUNG A21S NEGRO OPEN;TELEFONIA
15339390;;F;39;CHILENO;;X;PROVIDENCIA                   ;METROPOLITANA;0;0;0;0;0;0;0;0;0;Celular P30 LITE LIB OPEN NEGRO;TELEFONIA
15022184;;F;39;CHILENO;;X;RENCA                         ;METROPOLITANA;0;0;0;0;0;0;0;0;0;Celular A20S ENTEL DIRECTO BLACK;TELEFONIA
17936377;;M;31;CHILENO;;Millenial;PROVIDENCIA                   ;METROPOLITANA;0;0;0;0;0;0;0;0;0;CELULAR SAMSUNG A21S ROJO OPEN;TELEFONIA
17786973;Soltero;F;31;CHILENO;;Millenial;PROVIDENCIA                   ;METROPOLITANA;0;0;0;0;0;0;0;0;0;Celular A3 LITE ENTEL TRIANGULADO NEGRO;TELEFONIA
10040829;Casado;F;55;CHILENO;;Boomers;RENCA                         ;METROPOLITANA;0;0;0;0;0;0;0;0;0;Celular Y9S LIB OPEN BLACK;TELEFONIA
10231676;;M;57;CHILENO;;Boomers;RENCA                         ;METROPOLITANA;0;0;0;0;0;0;0;0;0;Celular A20S LIB OPEN NEGRO;TELEFONIA
13029256;Casado;F;46;CHILENO;CONTADOR GENERAL;X;CURICO                        ;MAULE;0;0;0;0;0;0;0;0;0;Celular Y9 PRIME LIB OPEN BLUE;TELEFONIA
14571039;;F;47;CHILENO;;X;SAAVEDRA                      ;ARAUCANIA;0;0;0;0;0;0;0;0;0;Celular A10S LIB OPEN NEGRO;TELEFONIA
18869097;;F;28;CHILENO;;Millenial;PROVIDENCIA                   ;METROPOLITANA;0;0;0;0;0;0;0;0;0;Celular S20 + LIB OPEN CELESTE;TELEFONIA
16140920;;M;36;CHILENO;;Millenial;N/D;N/D;0;0;0;0;0;0;0;0;0;CELULAR MOTO ONE FUSION 64GB VERDE 64GB OPEN;TELEFONIA
11943412;Casado;M;50;CHILENO;;X;PROVIDENCIA                   ;METROPOLITANA;0;0;0;0;0;0;0;0;0;Celular A31 LIB OPEN AZUL;TELEFONIA
12745616;;F;47;CHILENO;;X;PROVIDENCIA                   ;METROPOLITANA;0;0;0;0;0;0;0;0;0;Celular A01 LIB OPEN ROJO;TELEFONIA
11541030;Casado;M;51;CHILENO;;X;RENCA                         ;METROPOLITANA;0;0;0;0;0;0;0;0;0;Celular A51 128GB LIB OPEN AZUL;TELEFONIA
20325015;;M;22;CHILENO;;Z;PROVIDENCIA                   ;METROPOLITANA;0;0;0;0;0;0;0;0;0;IPHONE 7 32GB LIB OPEN DORADO;TELEFONIA
17435793;;F;32;CHILENO;;Millenial;N/D;N/D;0;0;0;0;0;0;0;0;0;Celular S10 LITE LIB OPEN AZUL;TELEFONIA
18764311;;M;27;CHILENO;;Millenial;PROVIDENCIA                   ;METROPOLITANA;0;0;0;0;0;0;0;0;0;Celular G8 POWER LITE WOM DIRECTO TURQUESA;TELEFONIA
13368980;;F;43;CHILENO;;X;RENCA                         ;METROPOLITANA;0;0;0;0;0;0;0;0;0;Celular P40 LITE LIB OPEN BLACK;TELEFONIA
19591768;;F;25;CHILENO;;Extranjero;RANCAGUA                      ;L.G.B.OÂ´HIGGINS;0;0;0;0;0;0;0;0;0;Celular Y5 NEO CLARO DIRECTO BLACK;TELEFONIA
19527061;;M;25;CHILENO;;Z;SAN VICENTE                   ;L.G.B.OÂ´HIGGINS;0;0;0;0;0;0;0;0;0;Celular Y9 PRIME LIB OPEN NEGRO;TELEFONIA
13211448;Casado;F;45;CHILENO;;X;RENCA                         ;METROPOLITANA;0;0;0;0;0;0;0;0;0;Celular A20S LIB OPEN NEGRO;TELEFONIA
11377821;;M;53;CHILENO;;X;PAIGUANO                      ;COQUIMBO;0;0;0;0;0;0;0;0;0;Celular Y7P LIB OPEN NEGRO;TELEFONIA
20159100;;M;23;CHILENO;;Z;PROVIDENCIA                   ;METROPOLITANA;92970;3;2;2;1;55980;1;1;36990;AUDIFONO SONY WH-CH710N/BZUC;ACCESORIOS
11591906;;F;52;CHILENO;;X;VALDIVIA                      ;LOS LAGOS;57972;3;4;0;0;0;3;4;57972;Audifonos Gamer Expert MF6;ACCESORIOS
18460373;Soltero;F;28;CHILENO;FONOAUDIOLOGA;Millenial;PROVIDENCIA                   ;METROPOLITANA;10990;1;1;0;0;0;1;1;10990;TRAVEL ADAPTER 15W - FAST CHARGER (TYPE-C CABLE);ACCESORIOS
14098054;;M;43;CHILENO;;X;"";"";776960;5;2;0;0;0;5;2;776960;SAMSUNG TYPE-C EARPHONES BLACK;ACCESORIOS
17885516;;F;31;CHILENO;;Millenial;PROVIDENCIA                   ;METROPOLITANA;44990;1;1;1;1;44990;0;0;0;DISCO DURO CANVIO 1TB BASICS BLACK TOSHIBA;ACCESORIOS
13840645;;M;41;CHILENO;;X;LA PINTANA;METROPOLITANA;89990;1;1;1;1;89990;0;0;0;AUDIFONO GALAXY BUDS2 VIOLET;ACCESORIOS
20095227;;M;23;CHILENO;;Z;PROVIDENCIA                   ;METROPOLITANA;24990;1;1;1;1;24990;0;0;0;MI Smart Band 6 Negra XIAOMI;ACCESORIOS
16017995;;F;37;CHILENO;;Millenial;NUNOA;METROPOLITANA;19990;1;1;0;0;0;1;1;19990;Audifonos Gamer Expert MF6;ACCESORIOS
17831168;;F;31;CHILENO;;Millenial;N/D;N/D;57970;3;1;0;0;0;3;1;57970;Multi BT Keyboard Black;ACCESORIOS
11499300;;F;53;CHILENO;;X;NUEVA IMPERIAL                ;ARAUCANIA;161961;4;4;0;0;0;4;4;161961;SOPORTE TV KT- AC01;ACCESORIOS
7835860;;M;61;CHILENO;;Boomers;RENCA                         ;METROPOLITANA;9990;1;1;0;0;0;1;1;9990;SAMSUNG TYPE-C EARPHONES BLACK;ACCESORIOS
11304099;;F;54;CHILENO;;X;TEMUCO                        ;ARAUCANIA;9990;1;1;0;0;0;1;1;9990;SAMSUNG TYPE-C EARPHONES BLACK;ACCESORIOS
16438461;;F;35;CHILENO;;Millenial;ANTOFAGASTA                   ;ANTOFAGASTA;104970;6;1;0;0;0;6;1;104970;MI Smart Band 6 Negra XIAOMI;ACCESORIOS
5348679;;M;75;CHILENO;;Silencioso;ILLAPEL                       ;COQUIMBO;446980;2;2;0;0;0;2;2;446980;Parlante Karaoke Blik Screamer 2;ACCESORIOS
17868205;;M;31;CHILENO;;Millenial;LOS ANGELES;BIO-BIO;30990;1;2;0;0;0;1;2;30990;XIAOMI MI CARGADOR 65W FAST CHARGER WITH GAN TE;ACCESORIOS
16706810;;M;35;CHILENO;;Millenial;"";"";49970;3;3;0;0;0;3;3;49970;Parlante Bluetooth Blik Rockwood;ACCESORIOS
15915765;;F;37;CHILENO;;Millenial;CAUQUENES                     ;MAULE;289960;4;3;0;0;0;4;3;289960;ARO DE LUZ LED 10 PULGADAS + TRIPODE PEQUENO;ACCESORIOS
26904451;;M;30;EXTRANJERO - NO INFORMA NACIONALIDAD;;Extranjero;N/D;N/D;24560;2;1;0;0;0;2;1;24560;Parlante Karaoke Blik Screamer 2;ACCESORIOS
10280212;;F;54;CHILENO;;X;HUASCO                        ;ATACAMA;19990;1;1;0;0;0;1;1;19990;KIT GAMER 3 EN 1 LVLUP TECLADO CON LUCES, MOUSE;ACCESORIOS
26719157;;F;70;CHILENO;;Extranjero;N/D;N/D;1312852;14;8;6;3;476940;8;5;835912;SOPORTE TV 32-65 KTA03 KIOTO FIJO;ACCESORIOS
14565082;;M;43;CHILENO;;X;RENCA                         ;METROPOLITANA;84990;1;1;0;0;0;1;1;84990;DISCO DURO CANVIO 4TB BASICS BLACK;ACCESORIOS
16417795;Soltero;F;35;CHILENO;PROFESOR;Millenial;PROVIDENCIA                   ;METROPOLITANA;64990;1;1;1;1;64990;0;0;0;DISCO DURO CANVIO 2TB BASICS BLACK TOSHIBA;ACCESORIOS
18796085;;F;27;CHILENO;;Millenial;PROVIDENCIA                   ;METROPOLITANA;17970;3;2;2;1;10980;1;1;6990;TYPE C TO TYPE C CABLE 3A (MAX 60W);ACCESORIOS
20179220;;F;22;CHILENO;;Z;PROVIDENCIA                   ;METROPOLITANA;9990;1;1;0;0;0;1;1;9990;TRAVEL ADAPTER 15W - FAST CHARGER (TYPE-C CABLE);ACCESORIOS
15147969;;F;41;CHILENO;;X;CAUQUENES                     ;MAULE;41980;2;2;0;0;0;2;2;41980;SOPORTE TV 32-65 KTA03 KIOTO FIJO;ACCESORIOS
8041283;;F;63;CHILENO;;Boomers;LINARES                       ;MAULE;273863;4;4;0;0;0;4;4;273863;SOPORTE TV 26-56 KTA02 KIOTO FIJO;ACCESORIOS
16382900;;M;36;CHILENO;;Millenial;PROVIDENCIA                   ;METROPOLITANA;94980;2;2;0;0;0;2;2;94980;Headset Legion H300 Stereo Gaming;ACCESORIOS
25740493;;F;28;PERUANO;;Extranjero;"";"";28980;2;1;2;1;28980;0;0;0;PARLANTE KARAOKE MGROCKET NEGRO;ACCESORIOS
19094731;;M;27;CHILENO;;Z;N/D;N/D;114980;3;3;0;0;0;3;3;114980;Redmi Buds 3 Lite White;ACCESORIOS
17933843;;F;30;CHILENO;;Millenial;PROVIDENCIA                   ;METROPOLITANA;58980;2;2;1;1;39990;1;1;18990;TWS EARPHONE WITH CHARGING CASE NEGRO FIDDLER;ACCESORIOS
13520777;;F;44;CHILENO;;X;"";"";15992;1;1;0;0;0;1;1;15992;SOPORTE TV 14-42 KTAM02 KIOTO C/ BRAZO MOVIL;ACCESORIOS
17683064;;F;33;CHILENO;;Millenial;PROVIDENCIA                   ;METROPOLITANA;37980;2;2;0;0;0;2;2;37980;SOPORTE TV 14-42 KTAM02 KIOTO C/ BRAZO MOVIL;ACCESORIOS
20143694;;F;23;CHILENO;;Z;"";"";304430;11;5;0;0;0;11;5;304430;SMARTWATCH HUAWEI BAND 4E ACTIVE MINERAL RED;ACCESORIOS
8226694;Viudo;F;61;CHILENO;;Boomers;RENCA                         ;METROPOLITANA;9990;1;1;0;0;0;1;1;9990;TRAVEL ADAPTER 15W - FAST CHARGER (TYPE-C CABLE);ACCESORIOS
19249739;;F;27;CHILENO;;Millenial;N/D;N/D;153980;2;2;0;0;0;2;2;153980;AUDIFONO SAMSUNG WIRELESS 103B;ACCESORIOS
18229988;;F;30;CHILENO;;Millenial;PROVIDENCIA                   ;METROPOLITANA;351991;20;26;2;1;85840;18;25;266151;Mouse Gamer Ultimate M1019;ACCESORIOS
9602338;;F;61;CHILENO;;Boomers;N/D;N/D;491260;3;2;0;0;0;3;2;491260;SOPORTE TV 14-42 KTAM02 KIOTO C/ BRAZO MOVIL;ACCESORIOS
13334056;;F;43;CHILENO;;X;CONCHALI;METROPOLITANA;447960;4;2;4;2;447960;0;0;0;AUDIFONO MANOS LIBRES MOTOROLA SQUADS 200 AZUL;ACCESORIOS
13969318;;M;42;CHILENO;;X;COIHAIQUE                     ;AYSEN;1545890;11;7;0;0;0;11;7;1545890;Parlante Bluetooth Blik Rockwood;ACCESORIOS
18343172;;M;29;CHILENO;;Millenial;PROVIDENCIA                   ;METROPOLITANA;0;0;2;0;0;0;0;2;0;Disco Externo Elements Portable SE 2TB;ACCESORIOS
8744307;Casado;F;61;CHILENO;;Boomers;RENCA                         ;METROPOLITANA;22990;1;1;0;0;0;1;1;22990;Microfono Gamer M59;ACCESORIOS
17912347;;F;35;CHILENO;;Millenial;N/D;N/D;661780;6;5;0;0;0;6;5;661780;Parlante Karaoke Blik Screamer 2;ACCESORIOS
10160529;;M;57;CHILENO;;Boomers;PROVIDENCIA                   ;METROPOLITANA;21990;1;1;0;0;0;1;1;21990;KARAOKE MLAB TOWER OUTDOOR MIC BT BK 8568;ACCESORIOS
18008881;Soltero;M;30;CHILENO;;Millenial;LOS ANGELES;BIO-BIO;65970;3;2;3;2;65970;0;0;0;AUDIFONO SONY WH-CH710N/BZUC;ACCESORIOS
10533833;;F;56;CHILENO;;Boomers;PROVIDENCIA                   ;METROPOLITANA;6990;1;1;0;0;0;1;1;6990;SOPORTE TV 26-56 KTA02 KIOTO FIJO;ACCESORIOS
13092081;;F;46;CHILENO;;X;NATALES                       ;MAGALLANES;6990;1;1;0;0;0;1;1;6990;SOPORTE TV 26-56 KTA02 KIOTO FIJO;ACCESORIOS
5372209;;F;76;CHILENO;;Silencioso;ANCUD                         ;LOS LAGOS;519970;4;2;0;0;0;4;2;519970;SOPORTE TV 14-42 KTAM02 KIOTO C/ BRAZO MOVIL;ACCESORIOS
10225786;;M;56;CHILENO;;Boomers;"";"";622540;8;3;0;0;0;8;3;622540;ALTEC LANSING AUDIFONO HEADBAND BLUETOOTH COMFOR;ACCESORIOS
15774255;;F;37;CHILENO;;Millenial;TALCA                         ;MAULE;19990;1;1;1;1;19990;0;0;0;Teclado Gamer Pro M858;ACCESORIOS
14126115;;M;41;CHILENO;;X;"";"";383950;6;3;6;3;383950;0;0;0;AUDIFONO GALAXY BUDS2 VIOLET;ACCESORIOS
18258245;;M;30;CHILENO;;Millenial;PROVIDENCIA                   ;METROPOLITANA;104950;5;2;0;0;0;5;2;104950;Redmi Buds 3 Lite Black;ACCESORIOS
11989404;;F;50;CHILENO;;X;VICTORIA                      ;ARAUCANIA;6990;1;1;0;0;0;1;1;6990;SOPORTE TV 26-56 KTA02 KIOTO FIJO;ACCESORIOS
7658908;;M;65;CHILENO;;Boomers;OVALLE                        ;COQUIMBO;661918;8;5;0;0;0;8;5;661918;Redmi Buds 3 Lite White;ACCESORIOS
19146704;Soltero;M;26;CHILENO;;Z;PROVIDENCIA                   ;METROPOLITANA;17980;2;1;0;0;0;2;1;17980;SOPORTE TV 26-56 KTAT02 KIOTO MOVIL;ACCESORIOS
14730591;Casado;M;35;EXTRANJERO - NO INFORMA NACIONALIDAD;INGENIERO COMERCIAL;X;PROVIDENCIA                   ;METROPOLITANA;12990;1;1;1;1;12990;0;0;0;SAMSUNG TYPE-C EARPHONES BLACK;ACCESORIOS
19509835;;M;25;CHILENO;;Z;PROVIDENCIA                   ;METROPOLITANA;3990;1;1;1;1;3990;0;0;0;MOUSE GAMER RGB M160;ACCESORIOS
13925183;;F;47;CHILENO;;X;SAN BERNARDO                  ;METROPOLITANA;24990;1;1;0;0;0;1;1;24990;Kit 4 en 1 Gamer M501;ACCESORIOS
5484783;;M;76;CHILENO;;Silencioso;RENGO                         ;L.G.B.OÂ´HIGGINS;15990;1;1;0;0;0;1;1;15990;ALTEC LANSING AUDIFONO HEADBAND BLUETOOTH COMFOR;ACCESORIOS
19897519;;F;24;CHILENO;;Z;N/D;N/D;535930;7;7;2;2;51980;5;5;483950;Parlante Karaoke Blik Screamer 2;ACCESORIOS
20356779;;M;25;CHILENO;;Z;TEMUCO                        ;ARAUCANIA;13980;2;1;0;0;0;2;1;13980;TYPE C TO TYPE C CABLE 3A (MAX 60W);ACCESORIOS
16929016;;M;33;CHILENO;;Millenial;N/D;N/D;40980;2;2;0;0;0;2;2;40980;Parlante Karaoke Blik Screamer 1;ACCESORIOS
17718555;Soltero;M;31;CHILENO;KINESIOLOGO;Millenial;PROVIDENCIA                   ;METROPOLITANA;19990;1;1;1;1;19990;0;0;0;Headset Pav Gam 400 Grn CAN/ENG;ACCESORIOS
7883290;;F;67;CHILENO;;Boomers;MALLOA                        ;L.G.B.OÂ´HIGGINS;57710;2;1;0;0;0;2;1;57710;Redmi Buds 3;ACCESORIOS
15757167;;M;38;CHILENO;;Millenial;PROVIDENCIA                   ;METROPOLITANA;361960;4;2;3;1;351970;1;1;9990;AUDIFONO MLAB TWS FULLY WIRELESSÂ  WHITE 8721;ACCESORIOS
16085950;;F;36;CHILENO;;Millenial;LA PINTANA;METROPOLITANA;4990;1;1;0;0;0;1;1;4990;Mouse Inalambrico Rosado;ACCESORIOS
25988771;;F;38;VENEZOLANO;;Extranjero;"";"";83980;2;2;0;0;0;2;2;83980;DISCO DURO CANVIO 2TB BASICS BLACK TOSHIBA;ACCESORIOS
15669157;;F;38;CHILENO;;Millenial;GRANEROS                      ;L.G.B.OÂ´HIGGINS;547960;5;3;4;2;517970;1;1;29990;BAND 4 BLACK;ACCESORIOS
20392595;;F;22;CHILENO;;Z;PROVIDENCIA                   ;METROPOLITANA;294980;2;2;1;1;279990;1;1;14990;Parlante Karaoke Blik Screamer 1;ACCESORIOS
14303713;;M;47;CHILENO;;X;SAN CARLOS                    ;BIO BIO;109776;3;2;0;0;0;3;2;109776;SOPORTE TV 32-65 KTA03 KIOTO FIJO;ACCESORIOS
7079043;;F;69;CHILENO;;Silencioso;ARICA                         ;ARICA Y PARINACOTA;449870;10;3;0;0;0;10;3;449870;GALAXY WATCH ACTIVE4 40 MM GOLD;ACCESORIOS
15531902;;F;39;CHILENO;;X;CHEPICA                       ;L.G.B.OÂ´HIGGINS;41970;3;3;1;1;17990;2;2;23980;365 Familia 6 usuarios Anual;ACCESORIOS
17664911;;F;31;CHILENO;;Millenial;PROVIDENCIA                   ;METROPOLITANA;93980;2;1;2;1;93980;0;0;0;AUDIFONOS GALAXY BUDS PRO SILVER;ACCESORIOS
11865306;;M;51;CHILENO;;X;PROVIDENCIA                   ;METROPOLITANA;99990;1;1;0;0;0;1;1;99990;PARLANTE SOUND;ACCESORIOS
12656741;;F;47;CHILENO;;X;CONCHALI                      ;METROPOLITANA;43980;2;1;2;1;43980;0;0;0;HUAWEI FREEBUDS 4i SILVER FROST;ACCESORIOS
15363614;;M;40;CHILENO;;X;PROVIDENCIA                   ;METROPOLITANA;53980;2;1;2;1;53980;0;0;0;PARLANTE FLIP ESSENTIAL BLUETOOTH;ACCESORIOS
18402044;;M;28;CHILENO;;Millenial;BUIN                          ;METROPOLITANA;6990;1;1;0;0;0;1;1;6990;SOPORTE TV 26-56 KTA02 KIOTO FIJO;ACCESORIOS
12586968;;F;49;CHILENO;;X;SAN FERNANDO                  ;L.G.B.OÂ´HIGGINS;714900;10;9;0;0;0;10;9;714900;TRAVEL ADAPTER 15W - FAST CHARGER (TYPE-C CABLE);ACCESORIOS
12325508;;F;49;CHILENO;;X;LOS ANGELES                   ;BIO BIO;732010;7;4;0;0;0;7;4;732010;SOPORTE TV 32-65 KTA03 KIOTO FIJO;ACCESORIOS
5916315;;F;70;CHILENO;;Silencioso;MAIPU                         ;METROPOLITANA;12990;1;1;0;0;0;1;1;12990;SOPORTE TV 14-42 KTAM02 KIOTO C/ BRAZO MOVIL;ACCESORIOS
13370489;;F;44;CHILENO;;X;PROVIDENCIA                   ;METROPOLITANA;8990;1;1;0;0;0;1;1;8990;AUDIFONO ON ZX110 SONY NEGRO;ACCESORIOS
7152926;;F;70;CHILENO;;Silencioso;PUENTE ALTO                   ;METROPOLITANA;119990;1;1;0;0;0;1;1;119990;Smartwatch GT 2 BLACK;ACCESORIOS
18346627;;M;29;CHILENO;;Millenial;PROVIDENCIA                   ;METROPOLITANA;18980;2;1;0;0;0;2;1;18980;TRAVEL ADAPTER 15W - FAST CHARGER (TYPE-C CABLE);ACCESORIOS
25813039;;M;49;CHILENO;;Extranjero;N/D;N/D;179990;1;1;0;0;0;1;1;179990;GALAXY WATCH ACTIVE4 40 MM SILVER;ACCESORIOS
16108733;;F;36;CHILENO;;Millenial;CANETE                        ;BIO BIO;9990;1;1;0;0;0;1;1;9990;AUDIFONO TEEN H AVENGERS IRON MAN ALAMBRICO;ACCESORIOS
17519551;Soltero;M;31;CHILENO;;Millenial;PROVIDENCIA                   ;METROPOLITANA;9990;1;1;1;1;9990;0;0;0;TRAVEL ADAPTER 15W - FAST CHARGER (TYPE-C CABLE);ACCESORIOS
22327277;;F;40;PERUANO;;Extranjero;ALTO HOSPICIO;TARAPACA;272960;6;5;0;0;0;6;5;272960;AUDIFONO XIAOMI EARPHONES MI TRUE WIRELESS 2 BAS;ACCESORIOS
20221403;;F;22;CHILENO;;Z;MAIPU;METROPOLITANA;10000;2;1;0;0;0;2;1;10000;AUDIFONO TEEN H AVENGERS IRON MAN ALAMBRICO;ACCESORIOS
13279110;;F;44;CHILENO;;X;SAN BERNARDO                  ;METROPOLITANA;233930;6;2;4;1;78950;2;1;154980;Redmi Buds 3 Lite Black;ACCESORIOS
19509840;;F;25;CHILENO;;Z;PROVIDENCIA                   ;METROPOLITANA;149990;1;1;1;1;149990;0;0;0;GALAXY WATCH ACTIVE4 40 MM GOLD;ACCESORIOS
12242566;;M;50;CHILENO;;X;RENCA                         ;METROPOLITANA;49990;1;1;1;1;49990;0;0;0;KIT DIRECTV GO BOX;ACCESORIOS
12540795;;F;48;CHILENO;;X;COIHAIQUE                     ;AYSEN;97970;3;2;0;0;0;3;2;97970;ALTEC LANSING AUDIFONO Nano Pods TWS PURPLE 8996;ACCESORIOS
17665102;;M;31;CHILENO;;Millenial;PROVIDENCIA                   ;METROPOLITANA;29960;4;2;4;2;29960;0;0;0;TRAVEL ADAPTER 15W - FAST CHARGER (TYPE-C CABLE);ACCESORIOS
25654445;;M;40;ECUATORIANO;;Extranjero;N/D;N/D;190140;2;3;0;0;0;2;3;190140;ALTEC LANSING AUDIFONO Nano Pods TWS PURPLE 8996;ACCESORIOS
13921471;Casado;M;42;CHILENO;GASTRONOMIA INTERNACIONAL;X;PROVIDENCIA                   ;METROPOLITANA;83980;2;1;2;1;83980;0;0;0;Silla Gamer Tyrus Blanco rosadosa;ACCESORIOS
16791099;;F;34;CHILENO;;Millenial;N/D;N/D;86940;6;4;0;0;0;6;4;86940;MINI PARLANTE BT GO2;ACCESORIOS
9316759;;M;56;CHILENO;;Boomers;CHONCHI                       ;LOS LAGOS;443530;6;3;0;0;0;6;3;443530;SOPORTE TV 14-42 KTAM02 KIOTO C/ BRAZO MOVIL;ACCESORIOS
18371333;;F;28;CHILENO;;Millenial;NATALES                       ;MAGALLANES;9990;1;1;0;0;0;1;1;9990;AUDIFONO TEEN SPIDERMAN ALAMBRICO;ACCESORIOS
15755928;;M;38;CHILENO;;X;RENCA                         ;METROPOLITANA;79990;1;1;1;1;79990;0;0;0;AUDIFONO GALAXY BUDS2 VIOLET;ACCESORIOS
13768104;;M;42;CHILENO;;Millenial;PROVIDENCIA                   ;METROPOLITANA;9990;1;1;0;0;0;1;1;9990;SOPORTE TV 32-65 KTA03 KIOTO FIJO;ACCESORIOS
6248211;;M;69;CHILENO;;Silencioso;PROVIDENCIA                   ;METROPOLITANA;441960;4;3;0;0;0;4;3;441960;SOPORTE TV 26-56 KTAT02 KIOTO MOVIL;ACCESORIOS
16119774;;M;36;CHILENO;;Millenial;RENCA                         ;METROPOLITANA;13990;1;1;0;0;0;1;1;13990;SOPORTE TV 14-42 KTAM02 KIOTO C/ BRAZO MOVIL;ACCESORIOS
13589095;;M;43;CHILENO;;X;PROVIDENCIA                   ;METROPOLITANA;9990;1;1;0;0;0;1;1;9990;SOPORTE TV 32-65 KTA03 KIOTO FIJO;ACCESORIOS
15647490;;M;38;CHILENO;;X;N/D;N/D;22980;2;2;0;0;0;2;2;22980;SOPORTE TV 14-42 KTAM02 KIOTO C/ BRAZO MOVIL;ACCESORIOS
9714779;;F;58;CHILENO;;Boomers;ANTOFAGASTA                   ;ANTOFAGASTA;374970;3;2;0;0;0;3;2;374970;GALAXY WATCH ACTIVE4 40 MM GOLD;ACCESORIOS
18473555;;F;28;CHILENO;;Millenial;N/D;N/D;9990;1;1;0;0;0;1;1;9990;TRAVEL ADAPTER 15W - FAST CHARGER (TYPE-C CABLE);ACCESORIOS
19213603;;M;25;CHILENO;;Z;LA REINA;METROPOLITANA;158980;2;2;1;1;149990;1;1;8990;TYPE C TO TYPE C CABLE 3A (MAX 60W);ACCESORIOS
19775214;;M;23;CHILENO;;Silencioso;PROVIDENCIA                   ;METROPOLITANA;0;0;2;0;2;0;0;0;0;AUDIFONO XIAOMI EARBUDS MI TRUE WIRELESS BASIC 2;ACCESORIOS
15699481;Soltero;M;39;CHILENO;;X;PROVIDENCIA                   ;METROPOLITANA;14990;1;1;0;0;0;1;1;14990;AUDIFONO BLUETOOTH SPIDERMAN;ACCESORIOS
15988949;;M;36;CHILENO;;Millenial;N/D;N/D;618010;8;4;0;0;0;8;4;618010;Redmi Buds 3 Lite White;ACCESORIOS
17845560;;F;30;CHILENO;;Millenial;TALCAHUANO;BIO-BIO;11000;2;1;0;0;0;2;1;11000;MINI PARLANTE BT GO2;ACCESORIOS
26828232;;F;31;EXTRANJERO - NO INFORMA NACIONALIDAD;;Extranjero;N/D;N/D;145960;4;3;0;0;0;4;3;145960;SOPORTE TV 14-63 CON BRAZO KT-FM 3L;ACCESORIOS
25420394;;M;34;PERUANO;;Extranjero;RECOLETA                      ;METROPOLITANA;44960;4;3;0;0;0;4;3;44960;SAMSUNG TYPE-C EARPHONES BLACK;ACCESORIOS
19682647;;M;25;CHILENO;;Z;PROVIDENCIA                   ;METROPOLITANA;302980;2;2;1;1;289990;1;1;12990;SOPORTE TV 14-63 CON BRAZO KT-FM 3L;ACCESORIOS
20287722;;M;22;CHILENO;;Silencioso;PROVIDENCIA                   ;METROPOLITANA;20980;2;2;2;2;20980;0;0;0;SAMSUNG TYPE-C EARPHONES WHITE;ACCESORIOS
15150002;;F;39;CHILENO;;X;SAN JAVIER;MAULE;62980;2;1;2;1;62980;0;0;0;REDMI BUDS 3 PRO (GRAPHITE BLACK);ACCESORIOS
16289041;;M;36;CHILENO;;Millenial;LA CALERA;VALPARAISO;7990;1;1;0;0;0;1;1;7990;Mouse Gamer Ultimate M1019;ACCESORIOS
11530131;;F;52;CHILENO;;X;SAN FERNANDO                  ;L.G.B.OÂ´HIGGINS;309960;4;4;0;0;0;4;4;309960;SOPORTE TV 26-56 KTA02 KIOTO FIJO;ACCESORIOS
13166766;;F;44;CHILENO;;X;ANCUD                         ;LOS LAGOS;8000;2;1;0;0;0;2;1;8000;SOPORTE TV 26-56 KTA02 KIOTO FIJO;ACCESORIOS
16771140;;F;37;CHILENO;;Millenial;PROVIDENCIA                   ;METROPOLITANA;19990;1;1;0;0;0;1;1;19990;KIT PREPAGO HD DIRECTV;ACCESORIOS
26202439;;M;23;EXTRANJERO - NO INFORMA NACIONALIDAD;;Extranjero;"";"";10990;1;1;0;0;0;1;1;10990;SOPORTE TV 14-63 CON BRAZO KT-FM 3L;ACCESORIOS
13574906;;F;43;CHILENO;;X;CONSTITUCION                  ;MAULE;61980;2;2;0;0;0;2;2;61980;SOPORTE TV 14-63 CON BRAZO KT-FM 3L;ACCESORIOS
18799138;;M;27;CHILENO;;Millenial;"";"";5990;1;1;1;1;5990;0;0;0;PAD MOUSE GAMER EXTRA LARGE MP9040;ACCESORIOS
17690951;;F;33;CHILENO;;Millenial;"";"";59990;1;1;0;0;0;1;1;59990;AUDIFONOS IN-EAR TRULY WIRELESS JBL W100 TWS BLA;ACCESORIOS
11608523;;M;51;CHILENO;;X;RENCA                         ;METROPOLITANA;9990;1;1;0;0;0;1;1;9990;Mouse Inalambrico M280 Negro;ACCESORIOS
16299093;;M;36;CHILENO;;Millenial;N/D;N/D;6990;1;1;0;0;0;1;1;6990;SOPORTE TV 26-56 KTA02 KIOTO FIJO;ACCESORIOS
15678759;;M;39;CHILENO;;X;PROVIDENCIA                   ;METROPOLITANA;12990;1;1;0;0;0;1;1;12990;SAMSUNG TYPE-C EARPHONES WHITE;ACCESORIOS
10690596;;M;55;CHILENO;;Boomers;SAN ANTONIO                   ;VALPARAISO;69990;1;1;0;0;0;1;1;69990;DISCO DURO CANVIO 2TB BASICS BLACK TOSHIBA;ACCESORIOS
19457516;Soltero;M;28;CHILENO;CONTADOR AUDITOR;Millenial;PROVIDENCIA                   ;METROPOLITANA;41990;1;1;0;0;0;1;1;41990;PARLANTE KARAOKE MGGLADIATOR NEGRO;ACCESORIOS
9698313;;M;51;CHILENO;;Silencioso;PROVIDENCIA                   ;METROPOLITANA;126980;2;1;2;1;126980;0;0;0;Smartwatch GT 2 BLACK;ACCESORIOS
7122992;Casado;M;66;CHILENO;;Boomers;PROVIDENCIA                   ;METROPOLITANA;9990;1;1;0;0;0;1;1;9990;TRAVEL ADAPTER 15W - FAST CHARGER (TYPE-C CABLE);ACCESORIOS
18985954;;F;26;CHILENO;;Z;OVALLE                        ;COQUIMBO;159980;2;2;0;0;0;2;2;159980;ALTEC LANSING AUDIFONO HEADBAND BLUETOOTH COMFOR;ACCESORIOS
6221553;;M;69;CHILENO;;Silencioso;LA PINTANA                    ;METROPOLITANA;14990;1;1;0;0;0;1;1;14990;PARLANTE 8531 MLAB MAX BASS BT;ACCESORIOS
8928511;Divorciado;M;59;CHILENO;;Boomers;PROVIDENCIA                   ;METROPOLITANA;16980;2;1;2;1;16980;0;0;0;SAMSUNG TYPE-C EARPHONES WHITE;ACCESORIOS
12880312;;F;47;CHILENO;;X;PENAFLOR                      ;METROPOLITANA;380640;5;2;0;0;0;5;2;380640;AUDIFONO XIAOMI EARBUDS MI TRUE WIRELESS BASIC 2;ACCESORIOS
19553270;;M;25;CHILENO;;Z;PROVIDENCIA                   ;METROPOLITANA;49990;1;1;0;0;0;1;1;49990;KIT DIRECTV GO BOX;ACCESORIOS
12793458;;F;47;CHILENO;;X;PARRAL                        ;MAULE;6990;1;1;0;0;0;1;1;6990;AUDIFONO IN SAM HS1303C/ MIC AZUL;ACCESORIOS
18403039;;F;29;CHILENO;;Millenial;PROVIDENCIA                   ;METROPOLITANA;19990;1;1;0;0;0;1;1;19990;TWS EARPHONE WITH CHARGING CASE BLANCO FIDDLER;ACCESORIOS
17985941;Soltero;M;31;CHILENO;;Millenial;PROVIDENCIA                   ;METROPOLITANA;9990;1;1;0;0;0;1;1;9990;MOUSE MICROSOFT Wireless Mbl 1850 Blue;ACCESORIOS
13435842;;F;43;CHILENO;;X;PROVIDENCIA                   ;METROPOLITANA;12990;1;1;1;1;12990;0;0;0;SAMSUNG TYPE-C EARPHONES BLACK;ACCESORIOS
15685763;;M;38;CHILENO;;Millenial;PROVIDENCIA                   ;METROPOLITANA;31980;2;1;0;0;0;2;1;31980;SAMSUNG TYPE-C EARPHONES BLACK;ACCESORIOS
7647815;;M;65;CHILENO;;Boomers;COLINA                        ;METROPOLITANA;7990;1;1;0;0;0;1;1;7990;SOPORTE TV 26-56 KTA02 KIOTO FIJO;ACCESORIOS
15037527;;F;38;CHILENO;;Millenial;N/D;N/D;19980;2;1;0;0;0;2;1;19980;PARLANTE 7284 MLAB ZUKABASS NARAN/VERDE BT;ACCESORIOS
19483458;Soltero;M;25;CHILENO;;Z;PROVIDENCIA                   ;METROPOLITANA;169990;2;1;2;1;169990;0;0;0;GALAXY WATCH4 42 MM BLACK;ACCESORIOS
27038605;;F;58;VENEZOLANO;;Extranjero;PROVIDENCIA                   ;METROPOLITANA;4990;1;1;0;0;0;1;1;4990;Mouse Inalambrico Rosado;ACCESORIOS
18823310;Soltero;F;27;CHILENO;;Z;"";"";55970;3;3;0;0;0;3;3;55970;PARLANTE KARAOKE MGROCKET NEGRO;ACCESORIOS
13935452;;F;42;CHILENO;;X;COIHAIQUE                     ;AYSEN;51650;4;2;0;0;0;4;2;51650;Headset Gamer Basic;ACCESORIOS
25765827;;M;43;HAITIANO;;Extranjero;N/D;N/D;556950;5;4;0;0;0;5;4;556950;SOPORTE TV 14-42 KTAM02 KIOTO C/ BRAZO MOVIL;ACCESORIOS
19149019;Soltero;F;26;CHILENO;;Z;PROVIDENCIA                   ;METROPOLITANA;29980;2;1;0;0;0;2;1;29980;Travel Adapter SFC 25W Type C (w/o Cable);ACCESORIOS
19961182;;F;23;CHILENO;;Z;SANTIAGO;METROPOLITANA;14990;1;1;0;0;0;1;1;14990;SAMSUNG TYPE-C EARPHONES WHITE;ACCESORIOS
11342477;;M;53;CHILENO;;X;ARICA                         ;ARICA Y PARINACOTA;94970;3;2;0;0;0;3;2;94970;Travel Adapter SFC 25W Type C (w/o Cable);ACCESORIOS
16727829;;F;35;CHILENO;;Millenial;MARIA PINTO                   ;METROPOLITANA;791830;7;4;0;0;0;7;4;791830;SAMSUNG TYPE-C EARPHONES WHITE;ACCESORIOS
18687363;Soltero;M;27;CHILENO;;Z;PROVIDENCIA                   ;METROPOLITANA;19990;1;1;0;0;0;1;1;19990;KARAOKE MLAB TOWER OUTDOOR MIC BT BK 8568;ACCESORIOS
14272298;;F;48;CHILENO;;X;PROVIDENCIA                   ;METROPOLITANA;15000;2;1;0;0;0;2;1;15000;MLAB AUDIFONO AIR-ACCES POP-UP CASE HANG UP WHIT;ACCESORIOS
13788768;;F;41;CHILENO;;X;N/D;N/D;4990;1;1;0;0;0;1;1;4990;MOUSE 100 WIRED;ACCESORIOS
13759767;;M;42;CHILENO;;Millenial;N/D;N/D;515470;3;2;3;2;515470;0;0;0;GALAXY WATCH4 CLASSIC 46 MM LTE;ACCESORIOS
15067084;;F;38;CHILENO;;Millenial;SAN FELIPE                    ;VALPARAISO;14990;1;1;0;0;0;1;1;14990;SOPORTE TV 14-63 CON BRAZO KT-FM 3L;ACCESORIOS
17329457;;F;37;CHILENO;;Millenial;PUERTO MONTT                  ;LOS LAGOS;39980;2;1;0;0;0;2;1;39980;Kit 4 en 1 Gamer M501;ACCESORIOS
15430324;;F;40;CHILENO;;X;SANTIAGO                      ;METROPOLITANA;501920;8;8;6;7;473940;2;1;27980;SOPORTE TV 14-63 CON BRAZO KT-FM 3L;ACCESORIOS
20603682;;M;21;CHILENO;;Z;N/D;N/D;267980;4;2;0;0;0;4;2;267980;GALAXY WATCH4 42 MM BLACK;ACCESORIOS
26753146;;M;50;VENEZOLANO;;Extranjero;"";"";8140;2;1;0;0;0;2;1;8140;AUDIFONO MOTOROLA EARBUDS M. LIBRES METAL NEGRO;ACCESORIOS
18040989;;M;30;CHILENO;;Millenial;GRANEROS                      ;L.G.B.OÂ´HIGGINS;204540;2;1;2;1;204540;0;0;0;WATCH GT2 PRO BLACK HUAWEI;ACCESORIOS
18068900;;M;30;CHILENO;;Millenial;"";"";36990;1;1;0;0;0;1;1;36990;Teclado Gamer Pro M858;ACCESORIOS
13248596;;F;45;CHILENO;;X;"";"";64990;1;1;1;1;64990;0;0;0;DISCO DURO CANVIO 2TB ADVANCE NEGRO;ACCESORIOS
19007274;Soltero;F;27;CHILENO;;Z;CURICO                        ;MAULE;7990;1;1;0;0;0;1;1;7990;SOPORTE TV 26-56 KTA02 KIOTO FIJO;ACCESORIOS
19848860;;M;24;CHILENO;;Z;PROVIDENCIA                   ;METROPOLITANA;13990;1;1;0;0;0;1;1;13990;Headset Gamer Luces RGB;ACCESORIOS
6953770;;M;65;CHILENO;;Boomers;CALAMA                        ;ANTOFAGASTA;6990;1;1;0;0;0;1;1;6990;SOPORTE TV 26-56 KTA02 KIOTO FIJO;ACCESORIOS
13525273;;F;44;CHILENO;;X;N/D;N/D;6990;1;1;0;0;0;1;1;6990;SOPORTE TV 26-56 KTAT02 KIOTO MOVIL;ACCESORIOS
19123424;Soltero;M;26;CHILENO;;Z;PROVIDENCIA                   ;METROPOLITANA;885790;7;5;4;2;849820;3;3;35970;SAMSUNG TYPE-C EARPHONES WHITE;ACCESORIOS
16984768;;F;33;CHILENO;;Millenial;PROVIDENCIA                   ;METROPOLITANA;34990;1;1;0;0;0;1;1;34990;PARLANTE BLUETHOOTH XBOOM GO PM1;ACCESORIOS
5134847;;M;76;CHILENO;;Silencioso;RENCA                         ;METROPOLITANA;6990;1;1;0;0;0;1;1;6990;SOPORTE TV 26-56 KTA02 KIOTO FIJO;ACCESORIOS
10180825;;F;58;CHILENO;;Boomers;N/D;N/D;22990;1;1;0;0;0;1;1;22990;AUDIFONO XIAOMI EARPHONES MI TRUE WIRELESS 2 BAS;ACCESORIOS
24888828;;M;37;BOLIVIANO;;Extranjero;PROVIDENCIA                   ;METROPOLITANA;154980;2;1;0;0;0;2;1;154980;AUDIFONOS GALAXY BUDS PRO VIOLET;ACCESORIOS
12507463;;M;49;CHILENO;;X;PROVIDENCIA                   ;METROPOLITANA;13990;1;1;0;0;0;1;1;13990;AUDIFONO SAMSUNG WIRELESS 103B;ACCESORIOS
13669635;Casado;F;43;CHILENO;PROFESOR;X;COIHAIQUE                     ;AYSEN;14990;1;1;0;0;0;1;1;14990;Teclado Gamer GT M867;ACCESORIOS
18580414;Soltero;M;28;CHILENO;;Millenial;PROVIDENCIA                   ;METROPOLITANA;27990;1;1;0;0;0;1;1;27990;Kit 4 en 1 Gamer M501;ACCESORIOS
8608164;Divorciado;F;59;CHILENO;;Boomers;N/D;N/D;16990;1;1;0;0;0;1;1;16990;SOPORTE TV 14-63 CON BRAZO KT-FM 3L;ACCESORIOS
18913864;;F;39;CHILENO;;X;CASTRO                        ;LOS LAGOS;10990;1;1;0;0;0;1;1;10990;SOPORTE TV 32-65 KTA03 KIOTO FIJO;ACCESORIOS
17636211;;M;31;CHILENO;;Millenial;N/D;N/D;13990;1;1;0;0;0;1;1;13990;AUDIFONO SAMSUNG WIRELESS 103B;ACCESORIOS
21543393;;F;22;CHILENO;;Extranjero;PROVIDENCIA                   ;METROPOLITANA;12990;1;1;0;0;0;1;1;12990;CARGADOR CP404;ACCESORIOS
18759919;;M;28;CHILENO;;Millenial;PROVIDENCIA                   ;METROPOLITANA;426930;8;4;8;4;426930;0;0;0;GALAXY WATCH4 42 MM BLACK;ACCESORIOS
7302175;Casado;M;64;CHILENO;TECNICO AGRICOLA;Boomers;PROVIDENCIA                   ;METROPOLITANA;13990;1;1;0;0;0;1;1;13990;SOPORTE TV 14-42 KTAM02 KIOTO C/ BRAZO MOVIL;ACCESORIOS
19812711;;F;24;CHILENO;;Z;PROVIDENCIA                   ;METROPOLITANA;21990;1;1;0;0;0;1;1;21990;SMARTWATCH HUAWEI BAND 4E ACTIVE BLACK;ACCESORIOS
16828545;;F;34;CHILENO;;Millenial;PROVIDENCIA                   ;METROPOLITANA;65220;4;2;0;0;0;4;2;65220;PARLANTE ZUKABASS + MICROFONO MLAB BT;ACCESORIOS
12147965;;M;52;CHILENO;;X;RENCA                         ;METROPOLITANA;13990;1;1;0;0;0;1;1;13990;AUDIFONO SAMSUNG WIRELESS A08C;ACCESORIOS
19148373;Soltero;F;26;CHILENO;;Z;N/D;N/D;21990;1;1;0;0;0;1;1;21990;AUDIFONO INALAMBRICO N68 FIDDLER;ACCESORIOS
7091804;Casado;F;63;CHILENO;CONTADOR GENERAL;Boomers;SANTIAGO                      ;METROPOLITANA;7990;1;1;0;0;0;1;1;7990;Funda Con Cierre 14;ACCESORIOS
16911404;;F;33;CHILENO;;Millenial;MALLOA;O HIGGINS;99960;4;3;0;0;0;4;3;99960;BAND 4 BLACK;ACCESORIOS
26978870;;F;36;VENEZOLANO;;Extranjero;N/D;N/D;279970;4;2;4;2;279970;0;0;0;MI WATCH NEGRO XIAOMI;ACCESORIOS
19651513;;F;24;CHILENO;;Millenial;"";"";217980;2;4;2;4;217980;0;0;0;AUDIFONO MLAB TWS IN-AIR WHITE 8533;ACCESORIOS
20007987;;M;23;CHILENO;;Silencioso;PROVIDENCIA                   ;METROPOLITANA;17990;1;1;1;1;17990;0;0;0;AUDIFONO XIAOMI EARBUDS MI TRUE WIRELESS BASIC 2;ACCESORIOS
6362775;;M;71;CHILENO;;Silencioso;CONCHALI                      ;METROPOLITANA;26990;1;1;0;0;0;1;1;26990;AUDIFONO MOTO BUDBS 100 TRUE WIRELESS WHITE;ACCESORIOS
17895298;;F;30;CHILENO;;Millenial;VICHUQUEN                     ;MAULE;5990;1;1;0;0;0;1;1;5990;AUDIFONO IN SAM HS1303C/ MIC BLANCO;ACCESORIOS
19823410;;M;24;CHILENO;;Z;PROVIDENCIA                   ;METROPOLITANA;19990;1;1;1;1;19990;0;0;0;Audifonos Gamer Expert MF6;ACCESORIOS
12700649;;F;47;CHILENO;;X;CONCEPCION                    ;BIO BIO;148980;2;2;0;0;0;2;2;148980;SMARTWATCH GT 2 LATONA BROWN;ACCESORIOS
8618974;;F;63;CHILENO;;Boomers;SAN CARLOS                    ;BIO BIO;15990;1;1;0;0;0;1;1;15990;PARLANTE 8531 MLAB MAX BASS BT;ACCESORIOS
17863063;Casado;M;30;CHILENO;;Millenial;"";"";-297000;0;2;-1;1;-319990;1;1;22990;PARLANTE BLUETOOTH TAS2505B;ACCESORIOS
16486373;Casado;F;35;CHILENO;;Millenial;PROVIDENCIA                   ;METROPOLITANA;24980;2;1;0;0;0;2;1;24980;Kit 2-1 Rojo;ACCESORIOS
16011979;;M;36;CHILENO;;Millenial;RENCA                         ;METROPOLITANA;21990;1;1;0;0;0;1;1;21990;MEMORIA MICROSD CLASE 10 128GB SANDISK;ACCESORIOS
17502052;;M;32;CHILENO;;Millenial;N/D;N/D;17990;1;1;1;1;17990;0;0;0;AUDIFONO XIAOMI EARBUDS MI TRUE WIRELESS BASIC 2;ACCESORIOS
15457637;;F;40;CHILENO;;X;EL BOSQUE                     ;METROPOLITANA;9990;1;1;0;0;0;1;1;9990;AUDIFONO TEEN H AVENGERS IRON MAN ALAMBRICO;ACCESORIOS
16715576;Soltero;M;34;CHILENO;;Millenial;RENCA                         ;METROPOLITANA;189990;1;1;1;1;189990;0;0;0;GALAXY WATCH4 42 MM BLACK;ACCESORIOS
19535818;;M;25;CHILENO;;Z;ANCUD                         ;LOS LAGOS;21990;1;1;0;0;0;1;1;21990;Porta audifonos M650;ACCESORIOS
18448106;;F;29;CHILENO;;Extranjero;LOS ANDES                     ;VALPARAISO;9990;1;1;0;0;0;1;1;9990;XIAOMI MI TYPE-C TO LIGHTNING CABLE 1M;ACCESORIOS
16455948;;F;35;CHILENO;;Millenial;"";"";10980;2;1;0;0;0;2;1;10980;AUDIFONO TEEN H AVENGERS IRON MAN ALAMBRICO;ACCESORIOS
16578133;;M;35;CHILENO;;Millenial;PROVIDENCIA                   ;METROPOLITANA;23990;1;1;0;0;0;1;1;23990;AUDIFONO MOTO BUDBS 100 TRUE WIRELESS WHITE;ACCESORIOS
8950020;;M;53;CHILENO;;X;RENCA                         ;METROPOLITANA;23992;1;2;0;0;0;1;2;23992;ALTEC LANSING AUDIFONO Nano Pods TWS PURPLE 8996;ACCESORIOS
24085733;;F;47;PERUANO;;Extranjero;PROVIDENCIA                   ;METROPOLITANA;7990;1;1;0;0;0;1;1;7990;AUDIFONO ON ZX110 SONY ROSA;ACCESORIOS
18341138;;F;29;CHILENO;;Millenial;PROVIDENCIA                   ;METROPOLITANA;33980;2;1;0;0;0;2;1;33980;AUDIFONO XIAOMI EARBUDS MI TRUE WIRELESS BASIC 2;ACCESORIOS
11864964;;M;51;CHILENO;;X;PROVIDENCIA                   ;METROPOLITANA;39990;1;1;0;0;0;1;1;39990;BAND 6 BLACK HUAWEI;ACCESORIOS
19953454;;M;24;CHILENO;;Z;PROVIDENCIA                   ;METROPOLITANA;19990;1;1;0;0;0;1;1;19990;AUDIFONO XIAOMI EARBUDS MI TRUE WIRELESS BASIC 2;ACCESORIOS
16459548;Soltero;F;35;CHILENO;;Millenial;PROVIDENCIA                   ;METROPOLITANA;18990;1;1;0;0;0;1;1;18990;AUDIFONO XIAOMI EARBUDS MI TRUE WIRELESS BASIC 2;ACCESORIOS
15175496;;F;40;CHILENO;;Silencioso;PROVIDENCIA                   ;METROPOLITANA;103830;3;2;3;2;103830;0;0;0;SMARTWATCH HUAWEI BAND 4E ACTIVE BLACK;ACCESORIOS
26661896;;M;40;VENEZOLANO;;Extranjero;N/D;N/D;164970;3;3;2;2;124980;1;1;39990;DISCO DURO CANVIO 1TB BASICS BLACK TOSHIBA;ACCESORIOS
26349235;;M;31;HAITIANO;;Extranjero;N/D;N/D;26990;1;1;0;0;0;1;1;26990;AUDIFONO MOTOROLA BLUETOOTH ESCAPE 220 ROJO;ACCESORIOS
16227203;;F;36;CHILENO;;Millenial;ARICA                         ;ARICA Y PARINACOTA;9990;1;1;0;0;0;1;1;9990;PARLANTE GBASS MICRO;ACCESORIOS
20180147;;F;23;CHILENO;;Z;N/D;N/D;9990;1;1;0;0;0;1;1;9990;PARLANTE GBASS MICRO;ACCESORIOS
10367139;;F;56;CHILENO;;Boomers;PROVIDENCIA                   ;METROPOLITANA;17990;1;1;0;0;0;1;1;17990;BATERY PACK TIPO C 10.000 MAH SAMSUNG;ACCESORIOS
22333727;;M;37;PERUANO;;Extranjero;SANTIAGO                      ;METROPOLITANA;371950;6;3;0;0;0;6;3;371950;SMARTWATCH HUAWEI WATCH FIT BLACK;ACCESORIOS
15007656;;M;39;CHILENO;;X;ARICA                         ;ARICA Y PARINACOTA;69990;1;1;0;0;0;1;1;69990;SMARTWATCH HUAWEI WATCH FIT BLACK;ACCESORIOS
17644053;;F;32;CHILENO;;Millenial;RENCA                         ;METROPOLITANA;9980;2;1;0;0;0;2;1;9980;MOUSE 200 Inalambrico GOLD;ACCESORIOS
19377275;;F;25;CHILENO;;Z;N/D;N/D;19990;1;1;0;0;0;1;1;19990;KARAOKE MLAB TOWER OUTDOOR MIC BT BK 8568;ACCESORIOS
25285307;;M;44;PERUANO;;Extranjero;N/D;N/D;-16010;1;2;0;0;0;1;2;-16010;AUDIFONO HEADBAND BT NEGRO;ACCESORIOS
16382646;;M;36;CHILENO;;Millenial;N/D;N/D;219990;2;1;2;1;219990;0;0;0;Galaxy Watch Active4 44 mm Black;ACCESORIOS
17517422;;M;31;CHILENO;;Millenial;PROVIDENCIA                   ;METROPOLITANA;189990;2;1;2;1;189990;0;0;0;Galaxy Watch Active4 40 mm Black;ACCESORIOS
9483426;;F;54;CHILENO;;Boomers;PROVIDENCIA                   ;METROPOLITANA;15980;2;1;0;0;0;2;1;15980;Funda Con Cierre 15;ACCESORIOS
18901017;Soltero;M;27;CHILENO;TECNICO EN COMERCIO INTERNACIONAL;Z;PROVIDENCIA                   ;METROPOLITANA;8990;1;1;0;0;0;1;1;8990;SOPORTE TV 26-56 KTA02 KIOTO FIJO;ACCESORIOS
11448978;;F;54;CHILENO;;X;LA SERENA                     ;COQUIMBO;432960;4;4;0;0;0;4;4;432960;GALAXY WATCH ACTIVE4 40 MM GOLD;ACCESORIOS
19661371;;M;24;CHILENO;;Z;LA SERENA                     ;COQUIMBO;107540;2;1;2;1;107540;0;0;0;AUDIFONOS GALAXY BUDS PRO BLACK;ACCESORIOS
11517508;;M;52;CHILENO;;X;LOS ANDES                     ;VALPARAISO;19990;1;1;0;0;0;1;1;19990;KARAOKE MLAB TOWER OUTDOOR MIC BT BK 8568;ACCESORIOS
19850762;;M;24;CHILENO;;Z;PROVIDENCIA                   ;METROPOLITANA;89540;2;1;2;1;89540;0;0;0;PARLANTE BLUETOOTH FLIP 5 NEGRO;ACCESORIOS
24338843;;M;29;BOLIVIANO;;Extranjero;ANTOFAGASTA                   ;ANTOFAGASTA;8990;1;1;0;0;0;1;1;8990;PARLANTE 7279 MLAB ZUKABASS NEGRO BT;ACCESORIOS
13862461;;M;42;CHILENO;;X;RENCA                         ;METROPOLITANA;139640;2;1;2;1;139640;0;0;0;AUDIFONOS GALAXY BUDS PRO VIOLET;ACCESORIOS
15254155;Soltero;M;40;CHILENO;;X;VILLARICA                     ;ARAUCANIA;9990;1;1;0;0;0;1;1;9990;MLAB AUDIFONO AIR-ACCES POP-UP CASE HANG UP WHIT;ACCESORIOS
16197295;;M;37;CHILENO;;Millenial;"";"";5990;1;1;0;0;0;1;1;5990;AUDIFONO IN SAM HS1303C/ MIC NEGRO;ACCESORIOS
16670345;;M;34;CHILENO;;Millenial;TALAGANTE                     ;METROPOLITANA;303970;3;2;3;2;303970;0;0;0;GALAXY WATCH ACTIVE4 40 MM LTE GOLD;ACCESORIOS
18772328;;M;27;CHILENO;;Millenial;PROVIDENCIA                   ;METROPOLITANA;84980;2;1;2;1;84980;0;0;0;AUDIFONO GALAXY BUDS LIVE COBRE;ACCESORIOS
13615161;;F;42;CHILENO;;X;CAUQUENES                     ;MAULE;15990;1;1;0;0;0;1;1;15990;AUDIFONO BLUETOOTH PANASONIC RP-HJE120B NEGRO;ACCESORIOS
15412964;;F;42;CHILENO;;X;PROVIDENCIA                   ;METROPOLITANA;49980;2;1;0;0;0;2;1;49980;Teclado Gamer Pro M858;ACCESORIOS
18754182;;M;27;CHILENO;;Millenial;TEMUCO;ARAUCANIA;15980;2;1;0;0;0;2;1;15980;Travel Adapter SFC 25W Type C (w/o Cable);ACCESORIOS
18685501;;F;27;CHILENO;;Millenial;N/D;N/D;88980;2;1;0;0;0;2;1;88980;HUAWEI FreeBuds Lite Black;ACCESORIOS
19729987;;F;25;CHILENO;;Z;LA PINTANA                    ;METROPOLITANA;16990;1;1;0;0;0;1;1;16990;RADIO RETRO MINI WOOGIE 8751;ACCESORIOS
20007206;;F;22;CHILENO;;Z;PROVIDENCIA                   ;METROPOLITANA;53980;2;2;0;0;0;2;2;53980;AUDIFONO MOTO BUDBS 100 TRUE WIRELESS BLACK;ACCESORIOS
17711267;Soltero;M;32;CHILENO;NUTRICIONISTA;Millenial;PROVIDENCIA                   ;METROPOLITANA;47540;2;1;2;1;47540;0;0;0;Disco Externo Elements Portable SE 1TB;ACCESORIOS
21380837;;M;27;CHILENO;;Extranjero;N/D;N/D;81980;2;1;0;0;0;2;1;81980;XIAOMI MI TRUE WIRELESS EARPHONES 2S;ACCESORIOS
17073691;Casado;M;33;CHILENO;TECNICO EN TELECOMUNICACIONES;Millenial;COCHRANE                      ;AYSEN;199990;1;1;0;0;0;1;1;199990;GALAXY WATCH ACTIVE4 40 MM GOLD;ACCESORIOS
10511383;;F;57;CHILENO;;Boomers;VILLARICA                     ;ARAUCANIA;29990;1;1;0;0;0;1;1;29990;Mi True Wireless Earphones 2 Basic XIAOMI;ACCESORIOS
16352584;;F;36;CHILENO;;Millenial;PROVIDENCIA                   ;METROPOLITANA;12990;1;1;0;0;0;1;1;12990;PARLANTE ZUKABASS + MICROFONO MLAB BT;ACCESORIOS
19486622;;F;25;CHILENO;;Z;NIQUEN                        ;BIO BIO;7990;1;1;0;0;0;1;1;7990;SOPORTE TV 26-56 KTA02 KIOTO FIJO;ACCESORIOS
20411303;;M;21;CHILENO;;Z;N/D;N/D;8990;1;1;0;0;0;1;1;8990;AUDIFONO IN SAM C/ MIC EG920 BLACK;ACCESORIOS
18330310;Soltero;M;29;CHILENO;;Millenial;PROVIDENCIA                   ;METROPOLITANA;133980;2;1;2;1;133980;0;0;0;AUDIFONOS GALAXY BUDS PRO BLACK;ACCESORIOS
17807512;;F;32;CHILENO;;Millenial;PROVIDENCIA                   ;METROPOLITANA;64990;1;1;0;0;0;1;1;64990;DISCO DURO CANVIO 2TB BASICS BLACK TOSHIBA;ACCESORIOS
7447982;Casado;M;67;CHILENO;;Boomers;TALCAHUANO                    ;BIO BIO;10990;1;1;0;0;0;1;1;10990;AUDIFONO ON ZX110 SONY NEGRO;ACCESORIOS
11890142;;M;51;CHILENO;;X;GRANEROS                      ;L.G.B.OÂ´HIGGINS;0;0;2;0;0;0;0;2;0;Travel Adapter SFC 25W Type C (w/o Cable);ACCESORIOS
18549207;;M;29;CHILENO;;Extranjero;FUTRONO                       ;LOS RIOS;337980;2;2;0;0;0;2;2;337980;PARLANTE KARAOKE MGPANTERA NEGRO;ACCESORIOS
16288411;;F;36;CHILENO;;Millenial;PROVIDENCIA                   ;METROPOLITANA;12990;1;1;1;1;12990;0;0;0;AUDIFONO SAMSUNG WIRELESS 103B;ACCESORIOS
18596672;Soltero;F;28;CHILENO;;Millenial;SAN BERNARDO                  ;METROPOLITANA;12990;1;1;0;0;0;1;1;12990;PARLANTE ZUKABASS + MICROFONO MLAB BT;ACCESORIOS
22984701;;F;30;PERUANO;;Extranjero;OVALLE                        ;COQUIMBO;11990;1;1;0;0;0;1;1;11990;10000mAh Redmi Power Bank Black XIAOMI;ACCESORIOS
10151103;;M;47;CHILENO;;X;PROVIDENCIA                   ;METROPOLITANA;39990;1;1;0;0;0;1;1;39990;BAND 6 PINK HUAWEI;ACCESORIOS
7587552;Soltero;F;69;CHILENO;;Silencioso;LOS ANDES                     ;VALPARAISO;14990;1;1;0;0;0;1;1;14990;SOPORTE TV 14-42 KTAM02 KIOTO C/ BRAZO MOVIL;ACCESORIOS
13760790;;F;42;CHILENO;;X;ILLAPEL                       ;COQUIMBO;202520;4;4;2;1;167540;2;3;34980;SOPORTE TV 14-42 KTAM02 KIOTO C/ BRAZO MOVIL;ACCESORIOS
7488767;Soltero;M;68;CHILENO;;Boomers;NUEVA IMPERIAL                ;ARAUCANIA;32070;2;1;0;0;0;2;1;32070;PARLANTE KARAOKE MGROCKET NEGRO;ACCESORIOS
18973846;;F;27;CHILENO;;Z;CALLE LARGA;VALPARAISO;3990;1;1;0;0;0;1;1;3990;AUDIFONO PANASONIC IN RP-HV096E-K NEGRO;ACCESORIOS
26976274;;M;34;VENEZOLANO;;Extranjero;N/D;N/D;67980;2;2;0;0;0;2;2;67980;Funda Con Cierre 14;ACCESORIOS
9144926;;F;59;CHILENO;;Boomers;PUNTA ARENAS                  ;MAGALLANES;5990;1;1;0;0;0;1;1;5990;Mi In-Ear Headphones Basic (Black) XIAOMI;ACCESORIOS
18364337;;F;30;CHILENO;;Silencioso;PROVIDENCIA                   ;METROPOLITANA;29540;2;1;2;1;29540;0;0;0;HUAWEI Sport Bluetooth Headphones Lite Black AM6;ACCESORIOS
19020800;;F;26;CHILENO;;Z;RANCAGUA;O HIGGINS;42540;2;1;2;1;42540;0;0;0;BAND 6 PINK HUAWEI;ACCESORIOS
24013704;;F;43;DOMINICANO;;Extranjero;INDEPENDENCIA                 ;METROPOLITANA;17990;1;1;0;0;0;1;1;17990;SOPORTE TV 14-63 CON BRAZO KT-FM 3L;ACCESORIOS
15645086;;F;39;CHILENO;;X;NATALES                       ;MAGALLANES;534970;3;2;0;0;0;3;2;534970;AUDIFONO ON ZX310AP NEGRO;ACCESORIOS
11480902;;M;53;CHILENO;;X;EL TABO                       ;VALPARAISO;56970;3;2;0;0;0;3;2;56970;PARLANTE 8247 MLAB SOUNDLAB BLACK;ACCESORIOS
10334615;;M;57;CHILENO;;Silencioso;PROVIDENCIA                   ;METROPOLITANA;11990;1;1;1;1;11990;0;0;0;PARLANTE 8531 MLAB MAX BASS BT;ACCESORIOS
13739872;;F;43;CHILENO;;X;OSORNO                        ;LOS LAGOS;7990;1;1;0;0;0;1;1;7990;AUDIFONO HEADBAND BT NEGRO;ACCESORIOS
13561220;;F;43;CHILENO;;X;N/D;N/D;59990;1;1;0;0;0;1;1;59990;DISCO DURO CANVIO 2TB BASICS BLACK TOSHIBA;ACCESORIOS
19120551;;M;26;CHILENO;;Z;PROVIDENCIA                   ;METROPOLITANA;9990;1;1;0;0;0;1;1;9990;PARLANTE GBASS MICRO;ACCESORIOS
12874959;;F;47;CHILENO;;X;N/D;N/D;231950;5;2;0;0;0;5;2;231950;AUDIFONO XIAOMI EARBUDS MI TRUE WIRELESS BASIC 2;ACCESORIOS
21536687;;M;25;CHILENO;;Extranjero;N/D;N/D;14990;1;1;0;0;0;1;1;14990;BATERY PACK TIPO C 10.000 MAH SAMSUNG;ACCESORIOS
18738167;;M;28;CHILENO;;Millenial;LA GRANJA                     ;METROPOLITANA;113980;2;1;2;1;113980;0;0;0;Smartwatch GT 2 BLACK;ACCESORIOS
18717488;;F;28;CHILENO;;Millenial;N/D;N/D;31560;3;1;0;0;0;3;1;31560;AUDIFONO SAMSUNG WIRELESS 103B;ACCESORIOS
17032628;Soltero;M;33;CHILENO;;Millenial;PROVIDENCIA                   ;METROPOLITANA;8990;1;1;0;0;0;1;1;8990;HUAWEI AUDIFONOS MANOS LIBRES AM116;ACCESORIOS
26333421;Soltero;M;32;COLOMBIANO;;Extranjero;PROVIDENCIA                   ;METROPOLITANA;27980;2;1;2;1;27980;0;0;0;HUAWEI Sport Bluetooth Headphones Lite Black AM6;ACCESORIOS
14323554;;F;45;CHILENO;;X;N/D;N/D;15393;1;3;0;0;0;1;3;15393;TWS EARPHONE WITH CHARGING CASE BLANCO FIDDLER;ACCESORIOS
18401274;;F;29;CHILENO;;Millenial;PAINE                         ;METROPOLITANA;68970;3;2;2;1;58980;1;1;9990;MOUSE X200 Inalambrico NEGRO;ACCESORIOS
12760800;;M;46;CHILENO;;X;CASTRO                        ;LOS LAGOS;6990;1;1;0;0;0;1;1;6990;SOPORTE TV 26-56 KTAT02 KIOTO MOVIL;ACCESORIOS
9955977;;F;54;CHILENO;;Boomers;ISLA DE MAIPO                 ;METROPOLITANA;103980;2;1;2;1;103980;0;0;0;SILLA GAMER VOLK RED;ACCESORIOS
25608323;;M;41;VENEZOLANO;;Extranjero;INDEPENDENCIA                 ;METROPOLITANA;247960;4;2;4;2;247960;0;0;0;PARLANTE PL7 XBOOM GO BLUETHOOH 2020;ACCESORIOS
19388066;;M;25;CHILENO;;Z;RANCAGUA                      ;L.G.B.OÂ´HIGGINS;17990;1;1;0;0;0;1;1;17990;SOPORTE TV 14-63 CON BRAZO KT-FM 3L;ACCESORIOS
17660633;;F;31;CHILENO;;Millenial;PITRUFQUEN                    ;ARAUCANIA;49990;1;1;0;0;0;1;1;49990;BAND 6 BLACK HUAWEI;ACCESORIOS
18153914;;F;29;CHILENO;;Millenial;TILTIL;METROPOLITANA;88980;2;1;2;1;88980;0;0;0;PARLANTE BLUETOOTH FLIP 5 NEGRO;ACCESORIOS
19098636;;M;27;CHILENO;;Z;LA SERENA                     ;COQUIMBO;59990;1;1;1;1;59990;0;0;0;PARLANTE PL5 XBOOM GO BLUETHOOH 2020;ACCESORIOS
13270912;;F;45;CHILENO;;Silencioso;PROVIDENCIA                   ;METROPOLITANA;35840;2;1;2;1;35840;0;0;0;MI Bluetooth Speaker (16W) BLUE;ACCESORIOS
18102758;;F;30;CHILENO;;Silencioso;PROVIDENCIA                   ;METROPOLITANA;19990;1;1;0;0;0;1;1;19990;AUDIFONO XIAOMI EARBUDS MI TRUE WIRELESS BASIC 2;ACCESORIOS
15697626;;M;39;CHILENO;;X;PROVIDENCIA                   ;METROPOLITANA;94990;1;1;1;1;94990;0;0;0;MI WATCH NEGRO XIAOMI;ACCESORIOS
15795962;;M;42;CHILENO;;X;CALBUCO                       ;LOS LAGOS;5990;1;1;0;0;0;1;1;5990;MEMORIA MICROSD CLASE 10 32GB SANDISK;ACCESORIOS
15445600;;F;39;CHILENO;;X;RENCA                         ;METROPOLITANA;23980;2;1;2;1;23980;0;0;0;BAND 4 BLACK;ACCESORIOS
15245307;Soltero;F;39;CHILENO;;X;RENCA                         ;METROPOLITANA;39980;2;1;2;1;39980;0;0;0;SMARTWATCH HUAWEI BAND 4E ACTIVE MINERAL RED;ACCESORIOS
18950095;;F;27;CHILENO;;Silencioso;PROVIDENCIA                   ;METROPOLITANA;19990;1;1;0;0;0;1;1;19990;TWS EARPHONE WITH CHARGING CASE NEGRO FIDDLER;ACCESORIOS
16280449;;F;36;CHILENO;;Millenial;PAINE                         ;METROPOLITANA;10990;1;1;0;0;0;1;1;10990;SOPORTE TV 32-65 KTA03 KIOTO FIJO;ACCESORIOS
19215083;;F;26;CHILENO;;Z;PROVIDENCIA                   ;METROPOLITANA;27990;1;1;0;0;0;1;1;27990;MOUSE KTF-00016 MS MENTA;ACCESORIOS
18348040;Soltero;M;29;CHILENO;;Millenial;CASTRO                        ;LOS LAGOS;6990;1;1;0;0;0;1;1;6990;AUDIFONO IN SAM HS1303C/ MIC NEGRO;ACCESORIOS
18681803;Soltero;F;28;CHILENO;;Millenial;CURICO                        ;MAULE;10990;1;1;0;0;0;1;1;10990;SOPORTE TV 32-65 KTA03 KIOTO FIJO;ACCESORIOS
14150221;;F;41;CHILENO;;Silencioso;PROVIDENCIA                   ;METROPOLITANA;19990;1;1;0;0;0;1;1;19990;AUDIFONO SONY MDRZX310APLZUC;ACCESORIOS
18236970;;F;29;CHILENO;;Millenial;N/D;N/D;3990;1;1;0;0;0;1;1;3990;AUDIFONO IN HUAWEI BLANCO;ACCESORIOS
8900104;;F;59;CHILENO;;Boomers;COLINA                        ;METROPOLITANA;8990;1;1;0;0;0;1;1;8990;AUDIFONO IN SAM FIT EG920 BLANCO;ACCESORIOS
20442306;;M;22;CHILENO;;Silencioso;PROVIDENCIA                   ;METROPOLITANA;189980;2;1;2;1;189980;0;0;0;SILLA GAMER MODELO EMPEROR NEGRO/ROJO;ACCESORIOS
16839474;;F;34;CHILENO;;Millenial;N/D;N/D;9990;1;1;0;0;0;1;1;9990;PARLANTE ZUKABASS 4 BT USB/SD/FM CALACAS;ACCESORIOS
7752760;;M;66;CHILENO;;Boomers;ILLAPEL                       ;COQUIMBO;386760;3;2;0;0;0;3;2;386760;SOPORTE TV 26-56 KTA02 KIOTO FIJO;ACCESORIOS
13187271;;M;45;CHILENO;;X;N/D;N/D;109990;1;1;0;0;0;1;1;109990;Smartwatch ACTIVE 1 NEGRO;ACCESORIOS
11310568;;M;53;CHILENO;;X;QUINCHAO                      ;LOS LAGOS;9990;1;1;0;0;0;1;1;9990;TRAVEL ADAPTER 15W - FAST CHARGER (TYPE-C CABLE);ACCESORIOS
19879894;;F;24;CHILENO;;Silencioso;PROVIDENCIA                   ;METROPOLITANA;15990;1;1;0;0;0;1;1;15990;AUDIFONO SAMSUNG WIRELESS A08C;ACCESORIOS
17912548;;M;30;CHILENO;;Millenial;LEBU                          ;BIO BIO;9990;1;1;0;0;0;1;1;9990;SOPORTE FIJO 32-55 PULGADAS + HDMI;ACCESORIOS
15127734;;F;41;CHILENO;;X;PROVIDENCIA                   ;METROPOLITANA;20970;3;2;0;0;0;3;2;20970;AUDIFONO IN SAM HS1303C/ MIC BLANCO;ACCESORIOS
17208807;;M;33;CHILENO;;Millenial;PROVIDENCIA                   ;METROPOLITANA;7990;1;1;1;1;7990;0;0;0;Funda Con Cierre 14;ACCESORIOS
16804679;;M;34;CHILENO;;Millenial;N/D;N/D;89990;2;1;0;0;0;2;1;89990;AUDIFONO GALAXY BUDS PLUS NEGRO;ACCESORIOS
19722787;;M;24;CHILENO;;Z;PROVIDENCIA                   ;METROPOLITANA;12990;1;1;0;0;0;1;1;12990;AUDIFONO ON ZX110 SONY ROSA;ACCESORIOS
18718192;;F;27;CHILENO;;Millenial;PROVIDENCIA                   ;METROPOLITANA;93980;2;1;2;1;93980;0;0;0;AUDIFONO GALAXY BUDS PLUS NEGRO;ACCESORIOS
17720835;;M;28;CHILENO;;Millenial;N/D;N/D;11990;1;1;0;0;0;1;1;11990;AUDIFONOS HUAWEI MANOS LIBRES TIPO C CM33;ACCESORIOS
7488378;;M;62;CHILENO;;Boomers;RENCA                         ;METROPOLITANA;8990;1;1;0;0;0;1;1;8990;AUDIFONO HEADBAND BT BLANCO FIDDLER;ACCESORIOS
14054811;;M;41;CHILENO;;Silencioso;PROVIDENCIA                   ;METROPOLITANA;59990;1;1;1;1;59990;0;0;0;PARLANTE PL5 XBOOM GO BLUETHOOH 2020;ACCESORIOS
17273669;;M;33;CHILENO;;Millenial;N/D;N/D;1690;1;1;0;0;0;1;1;1690;AUDIFONO PANASONIC IN RP-HV096E-K NEGRO;ACCESORIOS
17213192;;F;33;CHILENO;;Millenial;PUERTO MONTT                  ;LOS LAGOS;19990;1;1;1;1;19990;0;0;0;BAND 4 BLACK;ACCESORIOS
16851930;;F;34;CHILENO;;Millenial;PROVIDENCIA                   ;METROPOLITANA;49990;1;1;1;1;49990;0;0;0;365 Personal Suscripcion Anual QQ2-0008TP;ACCESORIOS
16515737;;F;34;CHILENO;;Silencioso;PROVIDENCIA                   ;METROPOLITANA;-179980;-2;1;-2;1;-179980;0;0;0;Silla Gamer Python Roja;ACCESORIOS
19200318;;F;27;CHILENO;;Z;PROVIDENCIA                   ;METROPOLITANA;12990;1;1;0;0;0;1;1;12990;SOPORTE INCLINABLE 37-70 PULGADAS + CABLE;ACCESORIOS
18699608;;M;26;CHILENO;;Silencioso;PROVIDENCIA                   ;METROPOLITANA;30980;2;1;2;1;30980;0;0;0;HUAWEI Sport Bluetooth Headphones Lite Black AM6;ACCESORIOS
19563909;;F;25;CHILENO;;Z;PROVIDENCIA                   ;METROPOLITANA;0;0;0;0;0;0;0;0;0;AUDIFONO IN PANASONIC RP-TCM130PPW BLANCO;ACCESORIOS
17454112;;F;31;CHILENO;;Millenial;CHILLAN                       ;BIO BIO;0;0;0;0;0;0;0;0;0;AUDIFONO IN EX15LP SONY NEG;ACCESORIOS
19169528;Soltero;M;26;CHILENO;;Z;PROVIDENCIA                   ;METROPOLITANA;0;0;0;0;0;0;0;0;0;AUDIFONO BLUETOOTH PANASONIC RP-HJE120B NEGRO;ACCESORIOS
19592160;;M;24;CHILENO;;Silencioso;PROVIDENCIA                   ;METROPOLITANA;0;0;0;0;0;0;0;0;0;MI WATCH NEGRO XIAOMI;ACCESORIOS
5240746;;F;75;CHILENO;;Silencioso;VICTORIA                      ;ARAUCANIA;0;0;0;0;0;0;0;0;0;SOPORTE TV 26-56 KTA02 KIOTO FIJO;ACCESORIOS
20399526;;F;22;CHILENO;;Z;N/D;N/D;0;0;0;0;0;0;0;0;0;TRAVEL ADAPTER 15W - FAST CHARGER (TYPE-C CABLE);ACCESORIOS
9460323;;M;57;CHILENO;;Boomers;RENCA                         ;METROPOLITANA;0;0;0;0;0;0;0;0;0;SOPORTE TV 26-56 KTA02 KIOTO FIJO;ACCESORIOS
16898385;;M;33;CHILENO;;Millenial;CONCEPCION;BIO-BIO;0;0;0;0;0;0;0;0;0;PARLANTE 7284 MLAB ZUKABASS NARAN/VERDE BT;ACCESORIOS
12148090;;M;64;CHILENO;;Boomers;N/D;N/D;0;0;0;0;0;0;0;0;0;SILLA GAMER RACING PRO - ROSADO;ACCESORIOS
13013397;;M;49;CHILENO;;X;ANTOFAGASTA                   ;ANTOFAGASTA;0;0;0;0;0;0;0;0;0;Travel Adapter SFC 25W Type C (w/o Cable);ACCESORIOS
15292050;;F;38;CHILENO;;Millenial;PROVIDENCIA                   ;METROPOLITANA;0;0;0;0;0;0;0;0;0;Smartwatch ACTIVE 1 NEGRO;ACCESORIOS
16921544;;F;34;CHILENO;;Silencioso;PROVIDENCIA                   ;METROPOLITANA;0;0;0;0;0;0;0;0;0;AUDIFONO ON ZX310AP NEGRO;ACCESORIOS
12460923;;F;48;CHILENO;;X;N/D;N/D;0;0;0;0;0;0;0;0;0;MINI PARLANTE BT GO2;ACCESORIOS
15521114;;F;39;CHILENO;;X;CALERA                        ;VALPARAISO;0;0;0;0;0;0;0;0;0;Silla Gamer Guardian Azul;ACCESORIOS
20570092;;F;22;CHILENO;;Z;PROVIDENCIA                   ;METROPOLITANA;0;0;0;0;0;0;0;0;0;SOPORTE TV 14-42 KTAM02 KIOTO C/ BRAZO MOVIL;ACCESORIOS
18234009;;M;29;CHILENO;;Millenial;TOCOPILLA                     ;ANTOFAGASTA;0;0;0;0;0;0;0;0;0;AUDIFONO IN EX15LP SONY NEG;ACCESORIOS
12202232;;M;51;CHILENO;;X;LOS ANDES                     ;VALPARAISO;0;0;0;0;0;0;0;0;0;PARLANTE ZUKABASS + MICROFONO MLAB BT;ACCESORIOS
15496647;;M;49;CHILENO;;X;MAIPU                         ;METROPOLITANA;0;0;0;0;0;0;0;0;0;MI WATCH LITE NEGRO XIAOMI;ACCESORIOS
17535143;;M;35;CHILENO;;Millenial;VILLARRICA;ARAUCANIA;0;0;0;0;0;0;0;0;0;AUDIFONO BLUETOOTH PANASONIC RP-HJE120B NEGRO;ACCESORIOS
16062415;;F;37;CHILENO;;Millenial;PROVIDENCIA                   ;METROPOLITANA;0;0;0;0;0;0;0;0;0;AUDIFONO XIAOMI EARBUDS MI TRUE WIRELESS BASIC 2;ACCESORIOS
26291753;Soltero;F;37;EXTRANJERO - NO INFORMA NACIONALIDAD;;Extranjero;"";"";0;0;0;0;0;0;0;0;0;PARLANTE 8247 MLAB SOUNDLAB BLACK;ACCESORIOS
18666008;;F;28;CHILENO;;Millenial;LA PINTANA                    ;METROPOLITANA;0;0;0;0;0;0;0;0;0;MOUSE HP Z3700 SILVER WIRELESS;ACCESORIOS
25431935;;F;26;PERUANO;;Extranjero;CALDERA                       ;ATACAMA;0;0;0;0;0;0;0;0;0;Audifonos Orejas De Gato Rosado;ACCESORIOS
20159854;;M;22;CHILENO;;Silencioso;PROVIDENCIA                   ;METROPOLITANA;0;0;0;0;0;0;0;0;0;MLAB KARAOKE OUTDOOR FUN GREEN 8564;ACCESORIOS
19075862;;F;27;CHILENO;;Z;N/D;N/D;0;0;0;0;0;0;0;0;0;AUDIFONO IN SAM HS1303C/ MIC ROSADO;ACCESORIOS
20233185;;F;23;CHILENO;;Z;PROVIDENCIA                   ;METROPOLITANA;0;0;0;0;0;0;0;0;0;AUDIFONO IN EX15LP SONY NEG;ACCESORIOS
15515131;;M;39;CHILENO;;X;PROVIDENCIA                   ;METROPOLITANA;0;0;0;0;0;0;0;0;0;AUDIFONO SONY MDRZX310APLZUC;ACCESORIOS
18983435;;F;27;CHILENO;;Z;PROVIDENCIA                   ;METROPOLITANA;0;0;0;0;0;0;0;0;0;AUDIFONO ON ZX110 SONY NEGRO;ACCESORIOS
12194477;;M;49;CHILENO;;X;TEMUCO                        ;ARAUCANIA;0;0;0;0;0;0;0;0;0;PARLANTE 8247 MLAB SOUNDLAB BLACK;ACCESORIOS
16733221;;F;34;CHILENO;;Millenial;VALLENAR;ATACAMA;0;0;0;0;0;0;0;0;0;AUDIFONO PANASONIC IN RP-HV096E-K NEGRO;ACCESORIOS
15712194;;F;38;CHILENO;;X;PROVIDENCIA                   ;METROPOLITANA;0;0;0;0;0;0;0;0;0;Mouse Gamer BTS;ACCESORIOS
19496559;;F;25;CHILENO;;Z;COQUIMBO                      ;COQUIMBO;0;0;0;0;0;0;0;0;0;AUDIFONO Bluetooth BE7 Azul;ACCESORIOS
10022117;;M;57;CHILENO;;Boomers;CORONEL                       ;BIO BIO;0;0;0;0;0;0;0;0;0;PARLANTE KARAOKE MGROCKET NEGRO;ACCESORIOS
26397726;;M;35;EXTRANJERO - NO INFORMA NACIONALIDAD;;Extranjero;QUINTA NORMAL                 ;METROPOLITANA;0;0;0;0;0;0;0;0;0;Audifonos Orejas De Gato Rosado;ACCESORIOS
19167758;Soltero;F;27;CHILENO;;Z;PROVIDENCIA                   ;METROPOLITANA;0;0;0;0;0;0;0;0;0;SOPORTE TV 32-65 KTA03 KIOTO FIJO;ACCESORIOS
18485204;Soltero;F;28;CHILENO;;Millenial;PROVIDENCIA                   ;METROPOLITANA;0;0;0;0;0;0;0;0;0;AUDIFONO MLAB TWS IN-AIR WHITE 8533;ACCESORIOS
18632022;;F;28;CHILENO;;Millenial;PROVIDENCIA                   ;METROPOLITANA;0;0;0;0;0;0;0;0;0;AUDIFONO BLUETOOTH RP-HF410BPUA BT 24HRS AZUL;ACCESORIOS
20142283;;M;22;CHILENO;;Silencioso;PROVIDENCIA                   ;METROPOLITANA;0;0;0;0;0;0;0;0;0;SOPORTE TV 32-65 KTA03 KIOTO FIJO;ACCESORIOS
11745982;;M;51;CHILENO;;X;RENCA                         ;METROPOLITANA;0;0;0;0;0;0;0;0;0;ITFIT Tripode Selfie Stick;ACCESORIOS
17285080;;F;33;CHILENO;;Silencioso;PROVIDENCIA                   ;METROPOLITANA;0;0;0;0;0;0;0;0;0;PARLANTE 7279 MLAB ZUKABASS NEGRO BT;ACCESORIOS
11729646;Casado;M;51;CHILENO;;X;RENCA                         ;METROPOLITANA;0;0;0;0;0;0;0;0;0;Smartwatch GT 2E GREEN;ACCESORIOS
19864032;;F;24;CHILENO;;Silencioso;PROVIDENCIA                   ;METROPOLITANA;0;0;0;0;0;0;0;0;0;MOUSE MICROSOFT Wireless Mbl 1850 Purple;ACCESORIOS
16352562;Casado;M;36;CHILENO;MEDICO VETERINARIO;Millenial;ALTO HOSPICIO;TARAPACA;0;0;0;0;0;0;0;0;0;MI WATCH LITE NEGRO XIAOMI;ACCESORIOS
16946499;;F;34;CHILENO;;Millenial;TEMUCO                        ;ARAUCANIA;0;0;0;0;0;0;0;0;0;KARAOKE MINI MY LIL FIRST SING CON MIC CABLE RED;ACCESORIOS
17813261;;M;30;CHILENO;;Millenial;SAN FELIPE                    ;VALPARAISO;0;0;0;0;0;0;0;0;0;Mouse 200 Silver Wireless;ACCESORIOS
18202924;;M;29;CHILENO;;Silencioso;PROVIDENCIA                   ;METROPOLITANA;0;0;0;0;0;0;0;0;0;SOPORTE TV 26-56 KTA02 KIOTO FIJO;ACCESORIOS
25496260;;M;34;VENEZOLANO;;Extranjero;N/D;N/D;0;0;0;0;0;0;0;0;0;AUDIFONO PANASONIC IN RP-HV096E-K NEGRO;ACCESORIOS
16568188;;F;35;CHILENO;;Millenial;PAINE                         ;METROPOLITANA;0;0;0;0;0;0;0;0;0;SOPORTE TV 32-65 KTA03 KIOTO FIJO;ACCESORIOS
19721562;;F;24;CHILENO;;Silencioso;PROVIDENCIA                   ;METROPOLITANA;0;0;0;0;0;0;0;0;0;PARLANTE KARAOKE MGPANTERA NEGRO;ACCESORIOS
12830655;;F;47;CHILENO;;X;SAN BERNARDO                  ;METROPOLITANA;0;0;0;0;0;0;0;0;0;TRAVEL ADAPTER 15W - FAST CHARGER (TYPE-C CABLE);ACCESORIOS
15987631;Soltero;F;37;CHILENO;;Millenial;PROVIDENCIA                   ;METROPOLITANA;0;0;0;0;0;0;0;0;0;PARLANTE KARAOKE MGPANTERA NEGRO;ACCESORIOS
19201780;;F;27;CHILENO;;Silencioso;PROVIDENCIA                   ;METROPOLITANA;0;0;0;0;0;0;0;0;0;AUDIFONO GALAXY BUDS LIVE COBRE;ACCESORIOS
15562840;;M;37;CHILENO;;Millenial;ANGOL                         ;ARAUCANIA;0;0;0;0;0;0;0;0;0;PARLANTE 8247 MLAB SOUNDLAB BLACK;ACCESORIOS
18493972;;F;29;CHILENO;;Millenial;LA SERENA                     ;COQUIMBO;0;0;0;0;0;0;0;0;0;PARLANTE GBASS MICRO;ACCESORIOS
9259232;;F;61;CHILENO;;Boomers;MAULE                         ;MAULE;0;0;0;0;0;0;0;0;0;AUDIFONO ON SONY ZX110 BLANCO;ACCESORIOS
19583432;;M;25;CHILENO;;Z;N/D;N/D;0;0;0;0;0;0;0;0;0;Travel Adapter SFC 25W Type C (w/o Cable);ACCESORIOS
19953292;;F;24;CHILENO;;Silencioso;PROVIDENCIA                   ;METROPOLITANA;0;0;0;0;0;0;0;0;0;HUAWEI Sport Bluetooth Headphones Lite Black AM6;ACCESORIOS
17506789;;F;31;CHILENO;;Millenial;RANCAGUA                      ;L.G.B.OÂ´HIGGINS;0;0;0;0;0;0;0;0;0;PARLANTE ZUKABASS + MICROFONO MLAB BT;ACCESORIOS
20252697;;F;22;CHILENO;;Z;PROVIDENCIA                   ;METROPOLITANA;0;0;0;0;0;0;0;0;0;MOUSE M170 LOGITECH AZUL;ACCESORIOS
17382730;;M;32;CHILENO;;Millenial;CERRILLOS                     ;METROPOLITANA;0;0;0;0;0;0;0;0;0;Mouse 200 Blue Wireless;ACCESORIOS
18398153;;M;29;CHILENO;;Millenial;N/D;N/D;0;0;0;0;0;0;0;0;0;AUDIFONO PANASONIC IN RP-HV096E-K NEGRO;ACCESORIOS
18606600;;M;29;CHILENO;;Silencioso;PROVIDENCIA                   ;METROPOLITANA;0;0;0;0;0;0;0;0;0;AUDIFONO GALAXY BUDS LIVE NEGRO;ACCESORIOS
17931284;Soltero;M;31;CHILENO;MEDICO CIRUJANO;Millenial;PROVIDENCIA                   ;METROPOLITANA;0;0;0;0;0;0;0;0;0;EXPRESS MOD 3930 PURPLE;ACCESORIOS
18030970;;F;30;CHILENO;;Millenial;ISLA DE MAIPO                 ;METROPOLITANA;0;0;0;0;0;0;0;0;0;KARAOKE MLAB SUITCASE OUTDOOR MIC BT BK 8566;ACCESORIOS
17062437;Soltero;M;34;CHILENO;;Millenial;PROVIDENCIA                   ;METROPOLITANA;0;0;0;0;0;0;0;0;0;PARLANTE ZUKABASS + MICROFONO MLAB BT ROJO;ACCESORIOS
12982666;;M;46;CHILENO;;X;N/D;N/D;0;0;0;0;0;0;0;0;0;TRI PACK PENDRIVE CRUZERBLADE Z50 SANDISC COLORE;ACCESORIOS
26317953;;M;36;VENEZOLANO;;Extranjero;N/D;N/D;0;0;0;0;0;0;0;0;0;Smartwatch GT 2E RED;ACCESORIOS
5901706;Casado;M;75;CHILENO;;Silencioso;RENCA                         ;METROPOLITANA;0;0;0;0;0;0;0;0;0;RADIO RETRO ANTIQUE 8732;ACCESORIOS
14061418;;F;40;CHILENO;;X;PROVIDENCIA                   ;METROPOLITANA;0;0;0;0;0;0;0;0;0;AUDIFONO IN SAM C/ MIC EG920 BLACK;ACCESORIOS
8968548;;F;60;CHILENO;;Boomers;RENCA                         ;METROPOLITANA;0;0;0;0;0;0;0;0;0;AUDIFONO ON ZX310AP NEGRO;ACCESORIOS
15052027;;M;39;CHILENO;;X;PROVIDENCIA                   ;METROPOLITANA;0;0;0;0;0;0;0;0;0;AUDIFONO IN PANASONIC RP-TCM130PPA AZUL;ACCESORIOS
16085035;;F;36;CHILENO;;Millenial;CERRO NAVIA                   ;METROPOLITANA;0;0;0;0;0;0;0;0;0;AUDIFONO XIAOMI EARBUDS MI TRUE WIRELESS BASIC 2;ACCESORIOS
12981076;;M;45;CHILENO;;X;RENCA                         ;METROPOLITANA;0;0;0;0;0;0;0;0;0;BATERY PACK TIPO C 10.000 MAH SAMSUNG;ACCESORIOS
19360829;Soltero;M;25;CHILENO;;Silencioso;PROVIDENCIA                   ;METROPOLITANA;0;0;0;0;0;0;0;0;0;Smartwatch ACTIVE 1 NEGRO;ACCESORIOS
16880041;;F;34;CHILENO;;Millenial;CODEGUA                       ;L.G.B.OÂ´HIGGINS;0;0;0;0;0;0;0;0;0;Smartwatch GT 2 BLACK;ACCESORIOS
18955022;Soltero;F;27;CHILENO;PSICOLOGA;Silencioso;PROVIDENCIA                   ;METROPOLITANA;0;0;0;0;0;0;0;0;0;MOUSE KTF-00016 MS MENTA;ACCESORIOS
19674947;;F;25;CHILENO;;Z;PROVIDENCIA                   ;METROPOLITANA;0;0;0;0;0;0;0;0;0;Kit gamer 3 en 1;ACCESORIOS
15076864;;F;24;CHILENO;;Silencioso;PROVIDENCIA                   ;METROPOLITANA;0;0;0;0;0;0;0;0;0;AUDIFONO XIAOMI EARBUDS MI TRUE WIRELESS BASIC 2;ACCESORIOS
14350886;;F;42;CHILENO;;X;PROVIDENCIA                   ;METROPOLITANA;0;0;0;0;0;0;0;0;0;AUDIFONO IN SAM HS1303C/ MIC AZUL;ACCESORIOS
19301405;Soltero;M;26;CHILENO;;Z;PROVIDENCIA                   ;METROPOLITANA;0;0;0;0;0;0;0;0;0;HUAWEI Sport Bluetooth Headphones Lite Black AM6;ACCESORIOS
19312896;Soltero;F;26;CHILENO;;Z;"";"";0;0;0;0;0;0;0;0;0;AUDIFONO PANASONIC IN RP-HV096E-K NEGRO;ACCESORIOS
13887709;;M;41;CHILENO;;X;RECOLETA                      ;METROPOLITANA;0;0;0;0;0;0;0;0;0;Kit gamer 3 en 1;ACCESORIOS
15943054;;F;37;CHILENO;;Millenial;PROVIDENCIA                   ;METROPOLITANA;0;0;0;0;0;0;0;0;0;AUDIFONO ON SONY ZX110 BLANCO;ACCESORIOS
12949627;;M;45;CHILENO;;X;CATEMU                        ;VALPARAISO;0;0;0;0;0;0;0;0;0;HUAWEI FREEBUDS 3I BLANCOS;ACCESORIOS
19616370;;M;25;CHILENO;;Z;PROVIDENCIA                   ;METROPOLITANA;0;0;0;0;0;0;0;0;0;PARLANTE PL7 XBOOM GO BLUETHOOH 2020;ACCESORIOS
18030995;;F;30;CHILENO;;Millenial;TALAGANTE;METROPOLITANA;0;0;0;0;0;0;0;0;0;BATERY PACK TIPO C 10.000 MAH SAMSUNG;ACCESORIOS
26115360;;M;27;HAITIANO;;Extranjero;N/D;N/D;0;0;0;0;0;0;0;0;0;PARLANTE PL5 XBOOM GO BLUETHOOH 2020;ACCESORIOS
11888361;;M;50;CHILENO;;Millenial;PROVIDENCIA                   ;METROPOLITANA;0;0;0;0;0;0;0;0;0;Smartwatch GT 2 BLACK;ACCESORIOS
15419340;;M;40;CHILENO;;Extranjero;N/D;N/D;0;0;0;0;0;0;0;0;0;SOPORTE TV 26-56 KTAT02 KIOTO MOVIL;ACCESORIOS
17971736;Soltero;F;30;CHILENO;;Millenial;PROVIDENCIA                   ;METROPOLITANA;0;0;0;0;0;0;0;0;0;PARLANTE GO 2 BLUETOOTH NEGRO;ACCESORIOS
19649275;;F;24;CHILENO;;Z;PROVIDENCIA                   ;METROPOLITANA;0;0;0;0;0;0;0;0;0;Mouse Pad OMEN 100;ACCESORIOS
18770384;;F;28;CHILENO;;Millenial;PROVIDENCIA                   ;METROPOLITANA;0;0;0;0;0;0;0;0;0;PARLANTE BT MICRO PINEAPPLE 8647;ACCESORIOS
19391028;Soltero;M;26;CHILENO;;Z;PROVIDENCIA                   ;METROPOLITANA;0;0;0;0;0;0;0;0;0;AUDIFONO IN SAM C/ MIC EG920 BLACK;ACCESORIOS
18386790;;M;29;CHILENO;;Millenial;PROVIDENCIA                   ;METROPOLITANA;0;0;0;0;0;0;0;0;0;AUDIFONO ON XB550 AP SONY AZUL;ACCESORIOS
9702541;Soltero;M;45;CHILENO;ARQUITECTO;X;RENCA                         ;METROPOLITANA;0;0;0;0;0;0;0;0;0;MOUSE MICROSOFT Bluetooth Mobile 3600 Black;ACCESORIOS
20212180;;M;23;CHILENO;;Silencioso;PROVIDENCIA                   ;METROPOLITANA;0;0;0;0;0;0;0;0;0;Mouse G203 LIGHTSYNC Gaming - BLACK;ACCESORIOS
12118605;;F;53;CHILENO;;Silencioso;PROVIDENCIA                   ;METROPOLITANA;0;0;0;0;0;0;0;0;0;HUAWEI AUDIFONOS MANOS LIBRES AM116;ACCESORIOS
17634242;;M;32;CHILENO;;Extranjero;VILLA ALEMANA                 ;VALPARAISO;0;0;0;0;0;0;0;0;0;AUDIFONO ON SONY WH-CH500 BLACK;ACCESORIOS
19085217;Soltero;F;26;CHILENO;;Z;PROVIDENCIA                   ;METROPOLITANA;0;0;0;0;0;0;0;0;0;MEMORIA MICROSD CLASE 10 16GB SANDISK;ACCESORIOS
11900243;;M;50;CHILENO;;X;SAN PEDRO DE ATACAMA          ;ANTOFAGASTA;0;0;0;0;0;0;0;0;0;AUDIFONO Bluetooth BE7 Azul;ACCESORIOS
19114422;Soltero;F;27;CHILENO;;Silencioso;PROVIDENCIA                   ;METROPOLITANA;0;0;0;0;0;0;0;0;0;BATERY PACK TIPO C 10.000 MAH SAMSUNG;ACCESORIOS
17255856;Soltero;F;32;CHILENO;PSICOLOGO;Silencioso;PROVIDENCIA                   ;METROPOLITANA;0;0;0;0;0;0;0;0;0;SOPORTE TV 32-65 KTA03 KIOTO FIJO;ACCESORIOS
11581071;;M;51;CHILENO;;X;LOS ALAMOS                    ;BIO BIO;0;0;0;0;0;0;0;0;0;AUDIFONO ON ZX310AP ROJO;ACCESORIOS
18396138;Soltero;M;29;CHILENO;INGENIERO COMERCIAL;Silencioso;PROVIDENCIA                   ;METROPOLITANA;0;0;0;0;0;0;0;0;0;AUDIFONO GALAXY BUDS PLUS NEGRO;ACCESORIOS
12346621;Casado;F;49;CHILENO;;X;PROVIDENCIA                   ;METROPOLITANA;0;0;0;0;0;0;0;0;0;RADIO RETRO MINI WOOGIE 8751;ACCESORIOS
17724835;;F;31;CHILENO;;Millenial;TOCOPILLA                     ;ANTOFAGASTA;0;0;0;0;0;0;0;0;0;SOPORTE TV 32-65 KTA03 KIOTO FIJO;ACCESORIOS
19881062;;M;24;CHILENO;;Silencioso;PROVIDENCIA                   ;METROPOLITANA;0;0;0;0;0;0;0;0;0;BATERY PACK TIPO C 10.000 MAH SAMSUNG;ACCESORIOS
12727578;;F;47;CHILENO;;X;CONSTITUCION                  ;MAULE;0;0;0;0;0;0;0;0;0;SOPORTE TV 32-65 KTA03 KIOTO FIJO;ACCESORIOS
10301428;;F;53;CHILENO;;X;RENCA                         ;METROPOLITANA;0;0;0;0;0;0;0;0;0;AUDIFONO IN SAM C/ MIC EG920 BLACK;ACCESORIOS
16075063;;F;36;CHILENO;;Millenial;"";"";0;0;0;0;0;0;0;0;0;HUAWEI FreeBuds 3 Black;ACCESORIOS
8915469;;F;61;CHILENO;;Boomers;PROVIDENCIA                   ;METROPOLITANA;0;0;0;0;0;0;0;0;0;KIT PREPAGO HD DIRECTV;ACCESORIOS
13359469;;M;44;CHILENO;;X;PROVIDENCIA                   ;METROPOLITANA;0;0;0;0;0;0;0;0;0;SOPORTE TV 26-56 KTA02 KIOTO FIJO;ACCESORIOS
16039057;;F;36;CHILENO;;Millenial;SAN JOAQUIN                   ;METROPOLITANA;0;0;0;0;0;0;0;0;0;AUDIFONO ON ZX310AP BLANCO;ACCESORIOS
14036396;;F;41;CHILENO;;X;LA PINTANA                    ;METROPOLITANA;0;0;0;0;0;0;0;0;0;MOCHILA Mix 1 2021 PATRIOT ( SUP);ACCESORIOS
10904051;;M;51;CHILENO;;X;PROVIDENCIA                   ;METROPOLITANA;0;0;0;0;0;0;0;0;0;AUDIFONO MLAB TWS FREE IN-AIR TOUCH BLACK 8534;ACCESORIOS
17106528;Soltero;F;33;CHILENO;TERAPEUTA OCUPACIONAL;Millenial;PROVIDENCIA                   ;METROPOLITANA;0;0;0;0;0;0;0;0;0;365 Personal Suscripcion Anual;ACCESORIOS
19599499;Soltero;F;26;CHILENO;;Silencioso;PROVIDENCIA                   ;METROPOLITANA;0;0;0;0;0;0;0;0;0;365 Familia 6 usuarios Anual;ACCESORIOS
18335443;Soltero;F;29;CHILENO;TECNICO DE NIVEL SUPERIOR EN ENFERMERIA;Millenial;PROVIDENCIA                   ;METROPOLITANA;0;0;0;0;0;0;0;0;0;HUAWEI AUDIFONOS MANOS LIBRES AM116;ACCESORIOS
20038372;;F;23;CHILENO;;Z;N/D;N/D;0;0;0;0;0;0;0;0;0;AUDIFONO IN SAM HS1303C/ MIC NEGRO;ACCESORIOS
11696754;;F;51;CHILENO;;X;RENCA                         ;METROPOLITANA;0;0;0;0;0;0;0;0;0;KIT PREPAGO HD DIRECTV;ACCESORIOS
13752235;;M;41;CHILENO;;X;PANQUEHUE                     ;VALPARAISO;0;0;0;0;0;0;0;0;0;SOPORTE TV 14-42 KTAM02 KIOTO C/ BRAZO MOVIL;ACCESORIOS
15799691;;M;38;CHILENO;;Millenial;N/D;N/D;0;0;0;0;0;0;0;0;0;AUDIFONO IN SAM HS1303C/ MIC BLANCO;ACCESORIOS
19187654;Soltero;F;27;CHILENO;PSICOLOGA;Z;PROVIDENCIA                   ;METROPOLITANA;0;0;0;0;0;0;0;0;0;AUDIFONO ON ZX110 SONY NEGRO;ACCESORIOS
18447176;;M;29;CHILENO;;Millenial;"";"";0;0;0;0;0;0;0;0;0;PARLANTE 6985 MLAB VERTICAL BRITPOP BT;ACCESORIOS
10710403;Soltero;M;55;CHILENO;;Boomers;PROVIDENCIA                   ;METROPOLITANA;0;0;0;0;0;0;0;0;0;SOPORTE TV 26-56 KTA02 KIOTO FIJO;ACCESORIOS
13771301;;F;42;CHILENO;;X;EL MONTE                      ;METROPOLITANA;0;0;0;0;0;0;0;0;0;Smartwatch ACTIVE 1 DORADO;ACCESORIOS
14440146;;F;50;CHILENO;;X;OVALLE                        ;COQUIMBO;0;0;0;0;0;0;0;0;0;AUDIFONO MLAB TWS FREE IN-AIR TOUCH BLACK 8534;ACCESORIOS
15834405;;F;35;CHILENO;;Millenial;RIO HURTADO                   ;COQUIMBO;0;0;0;0;0;0;0;0;0;HUAWEI Sport Bluetooth Headphones Lite Black AM6;ACCESORIOS
18695409;;F;28;CHILENO;;Millenial;N/D;N/D;0;0;0;0;0;0;0;0;0;AUDIFONO MLAB TWS IN-AIR WHITE 8533;ACCESORIOS
17309352;;F;32;CHILENO;;Millenial;SANTIAGO                      ;METROPOLITANA;0;0;0;0;0;0;0;0;0;MOCHILA BLUSH PL;ACCESORIOS
12146181;;F;53;CHILENO;;X;PICHILEMU                     ;L.G.B.OÂ´HIGGINS;0;0;0;0;0;0;0;0;0;AUDIFONO SAMSUNG WIRELESS 103B;ACCESORIOS
10544848;;M;55;CHILENO;;Boomers;PROVIDENCIA                   ;METROPOLITANA;0;0;0;0;0;0;0;0;0;SOPORTE TV 26-56 KTA02 KIOTO FIJO;ACCESORIOS
18618927;Soltero;F;26;CHILENO;PROFESOR;Z;PROVIDENCIA                   ;METROPOLITANA;0;0;0;0;0;0;0;0;0;ITFIT Tripode Selfie Stick;ACCESORIOS
8126584;;M;61;CHILENO;;Boomers;RENCA                         ;METROPOLITANA;0;0;0;0;0;0;0;0;0;AUDIFONO GALAXY BUDS PLUS NEGRO;ACCESORIOS
17276334;;M;32;CHILENO;;Millenial;ILLAPEL                       ;COQUIMBO;0;0;0;0;0;0;0;0;0;AUDIFONO MLAB TWS IN-AIR WHITE 8533;ACCESORIOS
16371859;;M;36;CHILENO;;Millenial;PROVIDENCIA                   ;METROPOLITANA;0;0;0;0;0;0;0;0;0;AUDIFONO ON ZX110 SONY NEGRO;ACCESORIOS
18492664;;F;28;CHILENO;;Millenial;N/D;N/D;0;0;0;0;0;0;0;0;0;SOPORTE TV 14-42 KTAM02 KIOTO C/ BRAZO MOVIL;ACCESORIOS
18599161;Soltero;F;28;CHILENO;PSICOLOGA;Millenial;PROVIDENCIA                   ;METROPOLITANA;0;0;0;0;0;0;0;0;0;PARLANTE ZUKABASS + MICROFONO MLAB BT;ACCESORIOS
20130711;;M;23;CHILENO;;Z;RENCA                         ;METROPOLITANA;0;0;0;0;0;0;0;0;0;AUDIFONO GALAXY BUDS PLUS NEGRO;ACCESORIOS
15703586;;F;38;CHILENO;;X;LA PINTANA                    ;METROPOLITANA;0;0;0;0;0;0;0;0;0;AUDIFONO ON ZX110 SONY NEGRO;ACCESORIOS
16999366;;F;33;CHILENO;;Millenial;SAN CLEMENTE                  ;MAULE;0;0;0;0;0;0;0;0;0;AUDIFONO MLAB TWS IN-AIR WHITE 8533;ACCESORIOS
17308855;;F;32;CHILENO;;Millenial;BUIN                          ;METROPOLITANA;0;0;0;0;0;0;0;0;0;PARLANTE 6985 MLAB VERTICAL BRITPOP BT;ACCESORIOS
17654747;;M;31;CHILENO;;Millenial;PROVIDENCIA                   ;METROPOLITANA;0;0;0;0;0;0;0;0;0;AUDIFONO ON ZX110 SONY ROSA;ACCESORIOS
18483733;;M;28;CHILENO;;Millenial;CALAMA                        ;ANTOFAGASTA;0;0;0;0;0;0;0;0;0;AUDIFONO ON RPHF300E-W BLANCO PNS;ACCESORIOS
15949040;;F;37;CHILENO;;Millenial;VALPARAISO;VALPARAISO;0;0;0;0;0;0;0;0;0;PARLANTE ZUKABASS 4 BT USB/SD/FM CALACAS;ACCESORIOS
10037894;;F;57;CHILENO;;Boomers;QUILPUE                       ;VALPARAISO;0;0;0;0;0;0;0;0;0;MEMORIA MICROSD CLASE 10 128GB SANDISK;ACCESORIOS
19039380;Soltero;M;26;CHILENO;;Millenial;"";"";0;0;0;0;0;0;0;0;0;AUDIFONO MLAB TWS FULLY WIRELESSÂ  WHITE 8721;ACCESORIOS
17571189;Soltero;M;32;CHILENO;;Millenial;PROVIDENCIA                   ;METROPOLITANA;0;0;0;0;0;0;0;0;0;AUDIFONO SONY MDREX110APLIUC AZUL;ACCESORIOS
11644016;;M;52;CHILENO;;X;RENCA                         ;METROPOLITANA;0;0;0;0;0;0;0;0;0;Smartwatch GT 2 BLACK;ACCESORIOS
16354798;;F;36;CHILENO;;Millenial;PROVIDENCIA                   ;METROPOLITANA;0;0;0;0;0;0;0;0;0;AUDIFONO MLAB TWS FULLY WIRELESSÂ  WHITE 8721;ACCESORIOS
18489963;Soltero;F;28;CHILENO;CIRUJANO DENTISTA;Millenial;PROVIDENCIA                   ;METROPOLITANA;0;0;0;0;0;0;0;0;0;BAND 4 AMBER SUNRISE;ACCESORIOS
16425959;;F;35;CHILENO;;Millenial;CARAHUE                       ;ARAUCANIA;0;0;0;0;0;0;0;0;0;PARLANTE ZUKABASS 4 BT USB/SD/FM CALACAS;ACCESORIOS
12549719;;M;48;CHILENO;;X;PROVIDENCIA                   ;METROPOLITANA;0;0;0;0;0;0;0;0;0;AUDIFONO MLAB ON STYLE BLACK BT 8240;ACCESORIOS
20387357;;F;22;CHILENO;;Z;"";"";0;0;0;0;0;0;0;0;0;AUDIFONO MLAB TWS FREE IN-AIR TOUCH BLACK 8534;ACCESORIOS
17504153;;M;32;CHILENO;;Millenial;N/D;N/D;0;0;0;0;0;0;0;0;0;HUAWEI FreeBuds Lite Black;ACCESORIOS
5611136;;F;76;CHILENO;;Silencioso;RENCA                         ;METROPOLITANA;0;0;0;0;0;0;0;0;0;PARLANTE 6986 MLAB VERTICAL STICKERS BT;ACCESORIOS
12496078;;M;48;CHILENO;;X;PROVIDENCIA                   ;METROPOLITANA;0;0;0;0;0;0;0;0;0;Smartwatch GALAXY WATCH SILVER;ACCESORIOS
18333364;Soltero;F;29;CHILENO;TECNICO DE NIVEL SUPERIOR EN ENFERMERIA;Millenial;PROVIDENCIA                   ;METROPOLITANA;0;0;0;0;0;0;0;0;0;AUDIFONO ON ZX110 SONY NEGRO;ACCESORIOS
14533737;Casado;M;46;CHILENO;;X;PROVIDENCIA                   ;METROPOLITANA;0;0;0;0;0;0;0;0;0;AUDIFONO MLAB TWS IN-AIR WHITE 8533;ACCESORIOS
13634773;Casado;F;43;CHILENO;;X;RENCA                         ;METROPOLITANA;0;0;0;0;0;0;0;0;0;PARLANTE 6985 MLAB VERTICAL BRITPOP BT;ACCESORIOS
17974460;;F;30;CHILENO;;Millenial;PROVIDENCIA                   ;METROPOLITANA;0;0;0;0;0;0;0;0;0;AUDIFONO MLAB AIR-VICTORY WHITE 8725;ACCESORIOS
18114928;Soltero;F;30;CHILENO;;Millenial;PROVIDENCIA                   ;METROPOLITANA;0;0;0;0;0;0;0;0;0;HUAWEI FreeBuds Lite Black;ACCESORIOS
8889417;;M;62;CHILENO;;Boomers;ANTOFAGASTA                   ;ANTOFAGASTA;0;0;0;0;0;0;0;0;0;DISCO DURO CANVIO 1TB BASICS BLACK TOSHIBA;ACCESORIOS
12354221;;F;49;CHILENO;;X;EL MONTE                      ;METROPOLITANA;0;0;0;0;0;0;0;0;0;AUDIFONO BLUETOOTH PANASONIC RP-HJE120B NEGRO;ACCESORIOS
18818511;Soltero;F;28;CHILENO;;Millenial;PROVIDENCIA                   ;METROPOLITANA;0;0;0;0;0;0;0;0;0;DISCO DURO CANVIO 1TB BASICS BLACK TOSHIBA;ACCESORIOS
14125361;;F;41;CHILENO;;X;RENCA                         ;METROPOLITANA;0;0;0;0;0;0;0;0;0;CARGADOR Flat TA EP-TA20EWSUGCH;ACCESORIOS
6075895;;F;74;CHILENO;;Silencioso;PROVIDENCIA                   ;METROPOLITANA;0;0;0;0;0;0;0;0;0;KIT PREPAGO HD DIRECTV;ACCESORIOS
25937127;;M;37;HAITIANO;;Extranjero;N/D;N/D;0;0;0;0;0;0;0;0;0;MOCHILA NTBK 15,6 DENVER MELANGE Negro/Gris;ACCESORIOS
18314235;;F;29;CHILENO;;Millenial;PROVIDENCIA                   ;METROPOLITANA;0;0;0;0;0;0;0;0;0;PARLANTE ZUKABASS + MICROFONO MLAB BT;ACCESORIOS
13048681;;M;45;CHILENO;;X;N/D;N/D;0;0;0;0;0;0;0;0;0;AUDIFONO IN EX15AP SONY NEGRO;ACCESORIOS
13953445;;M;42;CHILENO;;X;CONCEPCION                    ;BIO BIO;0;0;0;0;0;0;0;0;0;AUDIFONO MLAB TWS IN-AIR WHITE 8533;ACCESORIOS
18329666;;F;29;CHILENO;;Millenial;N/D;N/D;0;0;0;0;0;0;0;0;0;KIT DIRECTV GO BOX;ACCESORIOS
20425576;;M;21;CHILENO;;Z;PROVIDENCIA                   ;METROPOLITANA;0;0;0;0;0;0;0;0;0;DISCO DURO CANVIO 1TB BASICS BLACK TOSHIBA;ACCESORIOS
9870575;;F;67;CHILENO;;Boomers;RENCA                         ;METROPOLITANA;0;0;0;0;0;0;0;0;0;AUDIFONO ON ZX110 SONY ROSA;ACCESORIOS
12616502;;M;47;CHILENO;;X;PROVIDENCIA                   ;METROPOLITANA;0;0;0;0;0;0;0;0;0;MEMORIA MICROSD CLASE 10 128GB SANDISK;ACCESORIOS
17829091;;M;31;CHILENO;;Millenial;N/D;N/D;0;0;0;0;0;0;0;0;0;AUDIFONO JBL In-ear Bluetooth Tune 115BT Neg;ACCESORIOS
10906579;;F;46;CHILENO;;X;PROVIDENCIA                   ;METROPOLITANA;0;0;0;0;0;0;0;0;0;AUDIFONO IN SAM C/ MIC EG920 BLACK;ACCESORIOS
11570336;;M;52;CHILENO;;X;N/D;N/D;0;0;0;0;0;0;0;0;0;MEMORIA MICROSD CLASE 10 32GB SANDISK;ACCESORIOS
11362725;;M;52;CHILENO;;X;LAS CABRAS                    ;L.G.B.OÂ´HIGGINS;0;0;0;0;0;0;0;0;0;SOPORTE TV 32-65 KTA03 KIOTO FIJO;ACCESORIOS
18479120;;M;29;CHILENO;;Millenial;COPIAPO                       ;ATACAMA;0;0;0;0;0;0;0;0;0;Smartwatch GALAXY WATCH GOLD;ACCESORIOS
17923857;;M;31;CHILENO;;Millenial;PROVIDENCIA                   ;METROPOLITANA;0;0;0;0;0;0;0;0;0;AUDIFONO MLAB TWS FULLY WIRELESSÂ  WHITE 8721;ACCESORIOS
8551932;;M;60;CHILENO;;Boomers;PROVIDENCIA                   ;METROPOLITANA;0;0;0;0;0;0;0;0;0;TECLADO + MOUSE MICROSOFT WIRELESS DESKTOP 2000;ACCESORIOS
18231447;;M;30;CHILENO;;Millenial;PROVIDENCIA                   ;METROPOLITANA;0;0;0;0;0;0;0;0;0;Smartwatch ACTIVE 1 NEGRO;ACCESORIOS
19106917;;F;26;CHILENO;;Z;"";"";0;0;0;0;0;0;0;0;0;AUDIFONO IN SAM C/ MIC EG920 BLACK;ACCESORIOS
16012066;;M;36;CHILENO;;Millenial;PROVIDENCIA                   ;METROPOLITANA;0;0;0;0;0;0;0;0;0;Smartwatch GT 2E GREEN;ACCESORIOS
17183394;;M;33;CHILENO;;Millenial;SAN CARLOS                    ;BIO BIO;0;0;0;0;0;0;0;0;0;SOPORTE TV 14-63 CON BRAZO KT-FM 3L;ACCESORIOS
9434828;;F;58;CHILENO;;Boomers;ANGOL                         ;ARAUCANIA;0;0;0;0;0;0;0;0;0;SOPORTE TV 26-56 KTA02 KIOTO FIJO;ACCESORIOS
12956488;;M;45;CHILENO;;X;PROVIDENCIA                   ;METROPOLITANA;0;0;0;0;0;0;0;0;0;AUDIFONO MLAB TWS FULLY WIRELESSÂ  WHITE 8721;ACCESORIOS
10412832;Casado;M;56;CHILENO;INGENIERO METALURGICO;Boomers;PROVIDENCIA                   ;METROPOLITANA;0;0;0;0;0;0;0;0;0;AUDIFONO ON SONY WH-CH400 GRIS;ACCESORIOS
20349398;;M;22;CHILENO;;Z;PROVIDENCIA                   ;METROPOLITANA;0;0;0;0;0;0;0;0;0;AUDIFONO MLAN AIR-WIRELESS CHARGE TOUCH RED;ACCESORIOS
16844747;;F;34;CHILENO;;Millenial;"";"";0;0;0;0;0;0;0;0;0;MOUSE 200 Inalambrico GOLD;ACCESORIOS
12598255;;F;47;CHILENO;;X;N/D;N/D;0;0;0;0;0;0;0;0;0;AUDIFONO MLAB ON STYLE BLACK BT 8240;ACCESORIOS
10838472;;M;54;CHILENO;;X;RENCA                         ;METROPOLITANA;0;0;0;0;0;0;0;0;0;AUDIFONO ON ZX110 SONY NEGRO;ACCESORIOS
26284534;;M;34;VENEZOLANO;;Extranjero;SANTA CRUZ                    ;L.G.B.OÂ´HIGGINS;0;0;0;0;0;0;0;0;0;PARLANTE 8531 MLAB MAX BASS BT;ACCESORIOS
10754130;Casado;F;55;CHILENO;;Boomers;RENCA                         ;METROPOLITANA;0;0;0;0;0;0;0;0;0;SOPORTE TV 14-63 CON BRAZO KT-FM 3L;ACCESORIOS
7492282;;M;67;CHILENO;;Boomers;RENCA                         ;METROPOLITANA;0;0;0;0;0;0;0;0;0;DISCO DURO CANVIO 2TB BASICS BLACK TOSHIBA;ACCESORIOS
7462030;;M;65;CHILENO;;Boomers;PROVIDENCIA                   ;METROPOLITANA;0;0;0;0;0;0;0;0;0;TRI PACK PENDRIVE CRUZERBLADE Z50 SANDISC COLORE;ACCESORIOS
12692026;;F;53;CHILENO;;X;RENCA                         ;METROPOLITANA;0;0;0;0;0;0;0;0;0;CARGADOR HUAWEI MICROUSB-USB AP32 USB TIPO C;ACCESORIOS
19194164;;F;26;CHILENO;;Z;"";"";0;0;0;0;0;0;0;0;0;SOPORTE TV 14-63 CON BRAZO KT-FM 3L;ACCESORIOS
17761064;;F;31;CHILENO;;Millenial;PROVIDENCIA                   ;METROPOLITANA;0;0;0;0;0;0;0;0;0;PARLANTE 8531 MLAB MAX BASS BT;ACCESORIOS
10454885;;F;48;CHILENO;;X;PROVIDENCIA                   ;METROPOLITANA;0;0;0;0;0;0;0;0;0;Smartwatch GT 2 BLACK;ACCESORIOS
18689600;;F;28;CHILENO;;Millenial;OVALLE                        ;COQUIMBO;0;0;0;0;0;0;0;0;0;HUAWEI Sport Bluetooth Headphones Lite Black AM6;ACCESORIOS
15172652;Soltero;M;37;CHILENO;AGRONOMO;Millenial;CHILLAN                       ;BIO BIO;0;0;0;0;0;0;0;0;0;KIT PREPAGO HD DIRECTV;ACCESORIOS
14216607;;M;40;CHILENO;;X;PROVIDENCIA                   ;METROPOLITANA;0;0;0;0;0;0;0;0;0;AUDIFONO IN SAM HS1303C/ MIC AZUL;ACCESORIOS
15496008;;M;37;CHILENO;;Millenial;LOS MUERMOS                   ;LOS LAGOS;0;0;0;0;0;0;0;0;0;MOUSE MICROSOFT Wireless Mbl 1850 Purple;ACCESORIOS
19651087;;M;24;CHILENO;;Z;"";"";0;0;0;0;0;0;0;0;0;AUDIFONO IN SAM C/ MIC EG920 BLACK;ACCESORIOS
17102518;;M;33;CHILENO;;Millenial;LAUTARO                       ;ARAUCANIA;0;0;0;0;0;0;0;0;0;AUDIFONO ON ZX110AP SONY NEGRO;ACCESORIOS
12898774;Soltero;M;46;CHILENO;;X;PROVIDENCIA                   ;METROPOLITANA;0;0;0;0;0;0;0;0;0;AUDIFONO IN E9LP SONY BZ NEGRO;ACCESORIOS
7411394;;M;66;CHILENO;;Boomers;LAMPA                         ;METROPOLITANA;0;0;0;0;0;0;0;0;0;DISCO DURO CANVIO 1TB BASICS BLACK TOSHIBA;ACCESORIOS
19700577;;M;24;CHILENO;;Z;PROVIDENCIA                   ;METROPOLITANA;0;0;0;0;0;0;0;0;0;HUAWEI FreeBuds Lite Black;ACCESORIOS
17462479;;F;32;CHILENO;;Millenial;PROVIDENCIA                   ;METROPOLITANA;0;0;0;0;0;0;0;0;0;SOPORTE TV 14-63 CON BRAZO KT-FM 3L;ACCESORIOS
12189189;Soltero;F;49;CHILENO;;X;PROVIDENCIA                   ;METROPOLITANA;0;0;0;0;0;0;0;0;0;AUDIFONO IN SAM HS1303C/ MIC BLANCO;ACCESORIOS
17030981;;F;33;CHILENO;;Millenial;CERRILLOS                     ;METROPOLITANA;0;0;0;0;0;0;0;0;0;AUDIFONO IN T110 JBL NEGRO;ACCESORIOS
17177639;Soltero;M;33;CHILENO;PSICOLOGO;Millenial;PROVIDENCIA                   ;METROPOLITANA;0;0;0;0;0;0;0;0;0;PARLANTE 7281 MLAB ZUKABASS ROJO BT PARTY;ACCESORIOS
13547631;;F;43;CHILENO;;X;COLINA                        ;METROPOLITANA;0;0;0;0;0;0;0;0;0;BANDA GALAXY FIT E NEGRO;ACCESORIOS
6306790;;M;72;CHILENO;;Silencioso;EL MONTE                      ;METROPOLITANA;937450;5;4;0;0;0;5;4;937450;MODELO SUNPEED ZERO ARO 29 GRAFITO M;BICICLETAS
22653180;;F;41;BOLIVIANO;;Extranjero;CALAMA                        ;ANTOFAGASTA;664960;4;3;0;0;0;4;3;664960;BICICLETA VISION GLASS MTB ARO 29 ALUMINIO 21V.;BICICLETAS
16940941;;M;33;CHILENO;;Millenial;PROVIDENCIA                   ;METROPOLITANA;437960;4;2;4;2;437960;0;0;0;BC XTS MTB ALU STRIKERPLUS 29 24VEL DISCOHID AZU;BICICLETAS
19552462;;M;24;CHILENO;;Z;PROVIDENCIA                   ;METROPOLITANA;84980;2;1;2;1;84980;0;0;0;BICICLETA INFANTIL ARO 16 ROSADA;BICICLETAS
19057734;;M;30;CHILENO;;Millenial;SAN JOSE DE MAIPO;METROPOLITANA;34980;2;1;2;1;34980;0;0;0;CASCO SUNPEED GRIS L;BICICLETAS
5621082;;M;77;CHILENO;;Silencioso;SAN FERNANDO                  ;L.G.B.OÂ´HIGGINS;544300;5;2;0;0;0;5;2;544300;MODELO SUNPEED ZERO ARO 29 PLATA M;BICICLETAS
18276123;;F;30;CHILENO;;Millenial;PROVIDENCIA                   ;METROPOLITANA;334980;2;1;2;1;334980;0;0;0;UPLAND SANCHEZ HIBRIDA 650B GRIS;BICICLETAS
9435571;;M;44;CHILENO;;X;SAN CLEMENTE                  ;MAULE;87990;1;1;0;0;0;1;1;87990;V-MTB ARO 12 HOMBRE AVENGERS CRIS;BICICLETAS
16386304;;M;35;CHILENO;;Millenial;PROVIDENCIA                   ;METROPOLITANA;0;0;2;0;2;0;0;0;0;BICI VIGOR NEGRA 24 V-BRAKE;BICICLETAS
19212807;;M;26;CHILENO;;Z;PROVIDENCIA                   ;METROPOLITANA;219980;2;1;2;1;219980;0;0;0;BC XTS MTB ALU STRIKER 29 21VEL DISCO NEGRO;BICICLETAS
19001282;;F;26;CHILENO;;Z;N/D;N/D;342830;3;2;2;1;335840;1;1;6990;CANDADO C/CLAVE 15x1500MM LE TOUR;BICICLETAS
26490693;Soltero;M;27;EXTRANJERO - NO INFORMA NACIONALIDAD;;Extranjero;NUNOA                         ;METROPOLITANA;307970;3;3;2;2;254980;1;1;52990;BC XTS MTB ALU STRIKER 29 21VEL DISCO NEGRO;BICICLETAS
10855205;;M;54;CHILENO;;Boomers;N/D;N/D;621680;4;2;4;2;621680;0;0;0;BIANCHI STONE MTB29 SX ALLOY NEGRO SEMI MATTE/CE;BICICLETAS
19097294;;F;27;CHILENO;;Z;PROVIDENCIA                   ;METROPOLITANA;269970;3;2;2;1;119980;1;1;149990;BICI ALLEYCAT NEGRA/TURQUESA 28 FITZER;BICICLETAS
16710015;;F;35;CHILENO;;Millenial;N/D;N/D;84540;2;1;2;1;84540;0;0;0;BICICLETA INFANTIL ARO 16 AZUL;BICICLETAS
19071085;Soltero;M;27;CHILENO;;Z;PROVIDENCIA                   ;METROPOLITANA;199980;2;1;2;1;199980;0;0;0;BICI VIGORPLUS VERDE 27,5 V-BRAKE;BICICLETAS
18175643;;F;30;CHILENO;;Millenial;PROVIDENCIA                   ;METROPOLITANA;387960;4;3;0;0;0;4;3;387960;BICICLETA MONKEL 29 ALUMINIO AZUL;BICICLETAS
13480720;;F;43;CHILENO;;X;N/D;N/D;315960;4;2;0;0;0;4;2;315960;BICI RETROPLUS VERDE 26 V-BRAKE;BICICLETAS
11981756;Soltero;F;50;CHILENO;;X;LA ESTRELLA                   ;L.G.B.OÂ´HIGGINS;239990;1;1;0;0;0;1;1;239990;MODELO SUNPEED ZERO ARO 29 AZUL M;BICICLETAS
19809736;;F;24;CHILENO;;Z;PROVIDENCIA                   ;METROPOLITANA;251980;2;1;2;1;251980;0;0;0;BICI STRIKER NEGRA 29 FRENO DISCO;BICICLETAS
5413845;;M;75;CHILENO;;Silencioso;RENCA                         ;METROPOLITANA;54980;2;1;2;1;54980;0;0;0;HOTWHEELS 12 TRICICLO NARANJA/AZUL;BICICLETAS
18353773;;F;29;CHILENO;;Millenial;PROVIDENCIA                   ;METROPOLITANA;139990;1;1;0;0;0;1;1;139990;HOTWHEELS 20 ROJO;BICICLETAS
8588591;;F;63;CHILENO;;Boomers;SAN CARLOS                    ;BIO BIO;311580;2;1;0;0;0;2;1;311580;BICICLETA VISION KRYPTON ALUMINIO (NEGRO / VERDE;BICICLETAS
16205861;;M;36;CHILENO;;Millenial;PROVIDENCIA                   ;METROPOLITANA;99990;1;1;0;0;0;1;1;99990;BICICLETA INFANTIL ARO 20 AMARILLA;BICICLETAS
18162470;Soltero;F;29;CHILENO;;Millenial;PROVIDENCIA                   ;METROPOLITANA;119990;1;1;0;0;0;1;1;119990;BICICLETA INFANTIL ARO 20 ROSADA;BICICLETAS
11393153;;F;53;CHILENO;;X;PUENTE ALTO                   ;METROPOLITANA;99990;1;1;0;0;0;1;1;99990;MOTOBIKE NARANJA ARO 16;BICICLETAS
10900615;;M;55;CHILENO;;Boomers;CAUQUENES                     ;MAULE;334980;2;1;0;0;0;2;1;334980;BICICLETA MONKEL 29 ALUMINIO GRIS;BICICLETAS
8733804;Casado;M;63;CHILENO;;Boomers;RENGO                         ;L.G.B.OÂ´HIGGINS;554970;3;2;0;0;0;3;2;554970;BICICLETA MONKEL 29 ALUMINIO GRIS;BICICLETAS
14556664;;F;42;CHILENO;;X;RENCA                         ;METROPOLITANA;213960;4;2;4;2;213960;0;0;0;BICI RETROPLUS VERDE 26 V-BRAKE;BICICLETAS
16507670;Soltero;M;35;CHILENO;TECNICO EN TURISMO;Millenial;PROVIDENCIA                   ;METROPOLITANA;123980;2;1;2;1;123980;0;0;0;BARBIE 12 ROSADO;BICICLETAS
17131243;;M;33;CHILENO;;Millenial;PROVIDENCIA                   ;METROPOLITANA;222980;2;1;0;0;0;2;1;222980;BICI RETROPLUS ROSADA 26 V-BRAKE;BICICLETAS
14007348;Soltero;M;41;CHILENO;;X;PROVIDENCIA                   ;METROPOLITANA;219980;2;2;0;0;0;2;2;219980;BICICLETA INFANTIL ARO 12 CELESTE;BICICLETAS
13519856;;M;45;CHILENO;;X;LOS MUERMOS                   ;LOS LAGOS;89990;1;1;0;0;0;1;1;89990;BICICLETA INFANTIL ARO 16 CELESTE;BICICLETAS
18747163;;F;28;CHILENO;;Millenial;QUIRIHUE                      ;BIO BIO;109990;1;1;0;0;0;1;1;109990;MOTOBIKE NARANJA ARO 16;BICICLETAS
14249683;;M;52;CHILENO;;X;CARAHUE                       ;ARAUCANIA;282970;3;2;0;0;0;3;2;282970;BICICLETA INFANTIL ARO 20 AMARILLA;BICICLETAS
6292448;;F;69;CHILENO;;Silencioso;VILLA ALEMANA                 ;VALPARAISO;199990;1;1;0;0;0;1;1;199990;BICICLETA VISION HELIUM CITY ARO 24 ACERO 6V;BICICLETAS
18836786;;F;27;CHILENO;;Millenial;PANGUIPULLI                   ;LOS RIOS;179990;1;1;0;0;0;1;1;179990;BICI VIGORPLUS VERDE 27,5 V-BRAKE;BICICLETAS
16950748;;F;33;CHILENO;;Millenial;PROVIDENCIA                   ;METROPOLITANA;106980;2;1;2;1;106980;0;0;0;BICICLETA INFANTIL ARO 16 ROSADA;BICICLETAS
8894383;;F;64;CHILENO;;Boomers;LA PINTANA                    ;METROPOLITANA;119990;1;1;0;0;0;1;1;119990;BICICLETA INFANTIL ARO 20 AMARILLA;BICICLETAS
17127970;;F;34;CHILENO;;Millenial;SANTA CRUZ                    ;L.G.B.OÂ´HIGGINS;89990;1;1;0;0;0;1;1;89990;BICICLETA INFANTIL ARO 12 AMARILLA;BICICLETAS
19937226;;M;33;CHILENO;;Millenial;N/D;N/D;532970;3;2;0;0;0;3;2;532970;BICICLETA MONKEL 29 ALUMINIO AZUL;BICICLETAS
13940788;;F;42;CHILENO;;X;CABILDO                       ;VALPARAISO;103980;2;1;2;1;103980;0;0;0;BICICLETA INFANTIL ARO 20 AMARILLA;BICICLETAS
17824976;;M;30;CHILENO;;Millenial;TALCA                         ;MAULE;85480;2;1;2;1;85480;0;0;0;BICICLETA INFANTIL ARO 16 ROSADA;BICICLETAS
14546622;;F;46;CHILENO;;X;PUREN                         ;ARAUCANIA;569980;2;2;0;0;0;2;2;569980;BICI STRIKER AMARILLA 29 V-BRAKE;BICICLETAS
7060084;;M;64;CHILENO;;Boomers;COPIAPO                       ;ATACAMA;99990;2;1;0;0;0;2;1;99990;BICICLETA INFANTIL ARO 12 AMARILLA;BICICLETAS
15968505;;F;37;CHILENO;;Millenial;OVALLE                        ;COQUIMBO;107540;2;1;2;1;107540;0;0;0;BICICLETA INFANTIL ARO 12 ROSADA;BICICLETAS
17881601;;F;34;CHILENO;;Millenial;CARAHUE                       ;ARAUCANIA;129990;1;1;0;0;0;1;1;129990;V-MTB ARO 16 CAPITAN AMERICA AZUL;BICICLETAS
19744607;;F;25;CHILENO;;Silencioso;PROVIDENCIA                   ;METROPOLITANA;224980;2;1;2;1;224980;0;0;0;BC XTS MTB ACE MUJ SHINE 27 18VEL DISCO TURQ;BICICLETAS
19051262;Soltero;M;27;CHILENO;;Z;PROVIDENCIA                   ;METROPOLITANA;153980;2;1;2;1;153980;0;0;0;BICI VIGORPLUS VERDE 27,5 V-BRAKE;BICICLETAS
17105460;Soltero;F;33;CHILENO;;Millenial;PROVIDENCIA                   ;METROPOLITANA;255820;4;2;2;1;85840;2;1;169980;BICICLETA INFANTIL ARO 12 ROSADA;BICICLETAS
14758744;Casado;F;49;EXTRANJERO - NO INFORMA NACIONALIDAD;;Extranjero;PROVIDENCIA                   ;METROPOLITANA;176080;2;1;0;0;0;2;1;176080;BICICLETA INFANTIL VENOM ARO 16 NEGRO;BICICLETAS
17258631;;F;33;CHILENO;;Millenial;SAN FERNANDO                  ;L.G.B.OÂ´HIGGINS;139990;1;1;0;0;0;1;1;139990;BICICLETA INFANTIL VENOM ARO 16 NEGRO;BICICLETAS
8221850;;F;65;CHILENO;;Boomers;CHIMBARONGO                   ;L.G.B.OÂ´HIGGINS;312670;4;1;0;0;0;4;1;312670;MMODELO SUNPEED ZERO ARO 27.5 AZUL DISCO M;BICICLETAS
11565109;;F;54;CHILENO;;X;LINARES                       ;MAULE;281580;2;1;0;0;0;2;1;281580;BICICLETA VISION KRYPTON ALUMINIO (NEGRO / VERDE;BICICLETAS
18313183;;F;29;CHILENO;;Millenial;N/D;N/D;0;0;0;0;0;0;0;0;0;CANDADO C/CLAVE 15x1500MM LE TOUR;BICICLETAS
19668195;;F;24;CHILENO;;Z;OVALLE                        ;COQUIMBO;0;0;0;0;0;0;0;0;0;BICI RETROPLUS VERDE 26 V-BRAKE;BICICLETAS
10125853;;M;55;CHILENO;;Boomers;RENCA                         ;METROPOLITANA;0;0;0;0;0;0;0;0;0;BICI STRIKER AMARILLA 29 V-BRAKE;BICICLETAS
16268308;;M;36;CHILENO;;Millenial;ESTACION CENTRAL              ;METROPOLITANA;0;0;0;0;0;0;0;0;0;BICI VIGOR GRIS 24 V-BRAKE;BICICLETAS
16984379;;F;33;CHILENO;;Millenial;LOS ANGELES;BIO-BIO;0;0;0;0;0;0;0;0;0;BICICLETA MTB TORNADO ARO 26 VERDE;BICICLETAS
12616983;;F;47;CHILENO;;X;N/D;N/D;0;0;0;0;0;0;0;0;0;V-BICICLETA BIANCHI CORSA CELESTE;BICICLETAS
16467656;;M;35;CHILENO;;Millenial;ARICA                         ;ARICA Y PARINACOTA;0;0;0;0;0;0;0;0;0;BICICLETA INFANTIL ARO 20 AMARILLA;BICICLETAS
15677586;;M;38;CHILENO;;Extranjero;CHILLAN                       ;BIO BIO;0;0;0;0;0;0;0;0;0;BIANCHI GOLIAT 12 PLATA;BICICLETAS
7671810;;M;64;CHILENO;;Boomers;SAN FERNANDO                  ;L.G.B.OÂ´HIGGINS;0;0;0;0;0;0;0;0;0;MODELO SUNPEED ZERO ARO 27.5 AZUL AMARILLA DISCO;BICICLETAS
18382507;;M;29;CHILENO;;Millenial;PROVIDENCIA                   ;METROPOLITANA;0;0;0;0;0;0;0;0;0;MODELO UPLAND 380 DISCO ARO 28 HIBRIDO GRIS;BICICLETAS
13311841;;F;44;CHILENO;;X;RENCA                         ;METROPOLITANA;0;0;0;0;0;0;0;0;0;BICI VIGORPLUS VERDE 27,5 V-BRAKE;BICICLETAS
13493886;;M;44;CHILENO;;X;LA PINTANA                    ;METROPOLITANA;0;0;0;0;0;0;0;0;0;V-BICI BIANCHI MTB-26 PRO SX NEGRA;BICICLETAS
12299366;;F;50;CHILENO;;X;PADRE HURTADO                 ;METROPOLITANA;0;0;0;0;0;0;0;0;0;V-BICICLETA MTB RADAL 5 ARO 27.5;BICICLETAS
10329212;Casado;M;54;CHILENO;MEDICO CIRUJANO;Silencioso;PROVIDENCIA                   ;METROPOLITANA;0;0;0;0;0;0;0;0;0;BIANCHI STONE MOUNT 29 L NEG;BICICLETAS
19384105;;F;26;CHILENO;;Z;N/D;N/D;0;0;0;0;0;0;0;0;0;BICI VIGOR GRIS 24 V-BRAKE;BICICLETAS
16478543;;F;35;CHILENO;;Millenial;EL BOSQUE                     ;METROPOLITANA;0;0;0;0;0;0;0;0;0;BICI VIGORPLUS NEGRA 27,5 V-BRAKE;BICICLETAS
9227575;Casado;F;58;CHILENO;;Boomers;RENCA                         ;METROPOLITANA;0;0;0;0;0;0;0;0;0;BICI VIGORPLUS VERDE 27,5 V-BRAKE;BICICLETAS
9235796;;M;61;CHILENO;;Boomers;VALPARAISO                    ;VALPARAISO;0;0;0;0;0;0;0;0;0;BICI VIGOR NEGRA 24 V-BRAKE;BICICLETAS
13691896;;M;43;CHILENO;;X;RENCA                         ;METROPOLITANA;0;0;0;0;0;0;0;0;0;BICI VIGOR NEGRA 24 V-BRAKE;BICICLETAS
19788087;;F;24;CHILENO;;Z;SAN FELIPE                    ;VALPARAISO;0;0;0;0;0;0;0;0;0;BICICLETA INFANTIL ARO 20 NEGRA;BICICLETAS
12239052;;F;50;CHILENO;;X;MAIPU                         ;METROPOLITANA;0;0;0;0;0;0;0;0;0;BICI VIGORPLUS NEGRA 27,5 V-BRAKE;BICICLETAS
18135536;;M;30;CHILENO;;Millenial;TALCA                         ;MAULE;0;0;0;0;0;0;0;0;0;BICI VIGORPLUS NEGRA 27,5 V-BRAKE;BICICLETAS
16408182;;F;36;CHILENO;;Millenial;LA FLORIDA                    ;METROPOLITANA;0;0;0;0;0;0;0;0;0;BICICLETA INFANTIL ARO 20 ROSADA;BICICLETAS
15623059;;F;39;CHILENO;;X;N/D;N/D;0;0;0;0;0;0;0;0;0;BICICLETA PLEGABLE BIA;BICICLETAS
15626524;;F;39;CHILENO;;X;LOS ANGELES                   ;BIO BIO;0;0;0;0;0;0;0;0;0;BICI FALCONPLUS AZUL 29 FRENO DISCO;BICICLETAS
10403221;;M;42;CHILENO;;X;PROVIDENCIA                   ;METROPOLITANA;0;0;0;0;0;0;0;0;0;BICI CITYPETITE VERDE 24 V-BRAKE;BICICLETAS
13937620;;F;42;CHILENO;;X;PROVIDENCIA                   ;METROPOLITANA;0;0;0;0;0;0;0;0;0;BICICLETA INFANTIL ARO 20 AMARILLA;BICICLETAS
13644027;;F;43;CHILENO;;X;N/D;N/D;0;0;0;0;0;0;0;0;0;BICICLETA INFANTIL ARO 16 ROSADA;BICICLETAS
16772244;;F;34;CHILENO;;Millenial;PROVIDENCIA                   ;METROPOLITANA;0;0;0;0;0;0;0;0;0;BICI VIGORPLUS NEGRA 27,5 V-BRAKE;BICICLETAS
11164426;;F;55;CHILENO;;Boomers;PROVIDENCIA                   ;METROPOLITANA;0;0;0;0;0;0;0;0;0;BICI BMX FREESTYLE ARO 20 AZUL;BICICLETAS
15754375;;F;38;CHILENO;;Millenial;MOLINA                        ;MAULE;0;0;0;0;0;0;0;0;0;BICI VIGORPLUS VERDE 27,5 V-BRAKE;BICICLETAS
18041004;Casado;F;30;CHILENO;TECNICO DE NIVEL SUPERIOR EN ENFERMERIA;Millenial;PROVIDENCIA                   ;METROPOLITANA;0;0;0;0;0;0;0;0;0;BICI BMX FREESTYLE ARO 20 AZUL;BICICLETAS
16519329;;M;35;CHILENO;;Millenial;PROVIDENCIA                   ;METROPOLITANA;0;0;0;0;0;0;0;0;0;BICI BMX FREESTYLE ARO 20 AZUL;BICICLETAS
13424687;;F;44;CHILENO;;X;LA HIGUERA                    ;COQUIMBO;0;0;0;0;0;0;0;0;0;BICI VIGORPLUS NEGRA 27,5 V-BRAKE;BICICLETAS
17231729;;M;32;CHILENO;;Millenial;RENCA                         ;METROPOLITANA;0;0;0;0;0;0;0;0;0;BICI SHINEPLUS BLANCA 27,5 FRENO DISCO;BICICLETAS
18771829;;F;27;CHILENO;;Millenial;PROVIDENCIA                   ;METROPOLITANA;0;0;0;0;0;0;0;0;0;BICICLETA INFANTIL ARO 20 ROSADA;BICICLETAS
13568007;Soltero;M;43;CHILENO;;X;PROVIDENCIA                   ;METROPOLITANA;0;0;0;0;0;0;0;0;0;BICI VIGORPLUS NEGRA 27,5 V-BRAKE;BICICLETAS
6638085;;F;69;CHILENO;;Silencioso;TALCAHUANO                    ;BIO BIO;0;0;0;0;0;0;0;0;0;BICI RETROPLUS VERDE 26 V-BRAKE;BICICLETAS
13774857;;M;41;CHILENO;;X;PROVIDENCIA                   ;METROPOLITANA;0;0;0;0;0;0;0;0;0;BICI BMX FREESTYLE ARO 20 AZUL;BICICLETAS
15757260;Soltero;F;38;CHILENO;;Millenial;PROVIDENCIA                   ;METROPOLITANA;0;0;0;0;0;0;0;0;0;BICICLETA INFANTIL ARO 16 NEGRA;BICICLETAS
10194163;;M;57;CHILENO;;Boomers;PROVIDENCIA                   ;METROPOLITANA;0;0;0;0;0;0;0;0;0;BICI VIGORPLUS NEGRA 27,5 V-BRAKE;BICICLETAS
15874834;Soltero;M;37;CHILENO;;Millenial;RENCA                         ;METROPOLITANA;0;0;0;0;0;0;0;0;0;BC XTS MTB ACE MUJ SHINE 27 18VEL DISCO NEGRA;BICICLETAS
14302405;;F;46;CHILENO;;X;PENAFLOR                      ;METROPOLITANA;0;0;0;0;0;0;0;0;0;BICICLETA INFANTIL ARO 16 CELESTE;BICICLETAS
13626513;;M;42;CHILENO;;X;RENCA                         ;METROPOLITANA;0;0;0;0;0;0;0;0;0;BICICLETA INFANTIL ARO 20 AMARILLA;BICICLETAS
12120729;;F;53;CHILENO;;X;PITRUFQUEN                    ;ARAUCANIA;0;0;0;0;0;0;0;0;0;BIANCHI AGGRESSOR 27.5 SX SIZE M NEGRO SEMI MAT;BICICLETAS
17978312;;M;30;CHILENO;;Millenial;PROVIDENCIA                   ;METROPOLITANA;0;0;0;0;0;0;0;0;0;BICI VIGORPLUS NEGRA 27,5 V-BRAKE;BICICLETAS
16322762;;F;36;CHILENO;;Millenial;MACHALI                       ;L.G.B.OÂ´HIGGINS;0;0;0;0;0;0;0;0;0;BICICLETA INFANTIL ARO 20 ROSADA;BICICLETAS
12599743;;F;48;CHILENO;;X;PROVIDENCIA                   ;METROPOLITANA;0;0;0;0;0;0;0;0;0;BICICLETA APRENDIZAJE ROSADA;BICICLETAS
13438798;;F;44;CHILENO;;X;RENCA                         ;METROPOLITANA;0;0;0;0;0;0;0;0;0;BICICLETA INFANTIL ARO 12 CELESTE;BICICLETAS
16801696;;M;34;CHILENO;;Millenial;PROVIDENCIA                   ;METROPOLITANA;0;0;0;0;0;0;0;0;0;BICICLETA APRENDIZAJE AZUL;BICICLETAS
13631042;;F;43;CHILENO;;X;LUMACO                        ;ARAUCANIA;0;0;0;0;0;0;0;0;0;FREESTYLE PRO ARO 20 NEGRA/AZUL;BICICLETAS
17637548;Soltero;M;33;CHILENO;;Millenial;"";"";0;0;0;0;0;0;0;0;0;BICI BMX FREESTYLE ARO 20 NEGRA;BICICLETAS
13646966;;F;43;CHILENO;;X;PROVIDENCIA                   ;METROPOLITANA;0;0;0;0;0;0;0;0;0;MOTOBIKE NARANJA ARO 16;BICICLETAS
8390462;;F;64;CHILENO;;Boomers;N/D;N/D;520550;5;4;0;0;0;5;4;520550;COLCHON NEW ORTOPEDIC 2P;DORMITORIO
6814112;;M;75;CHILENO;;Silencioso;ANTOFAGASTA                   ;ANTOFAGASTA;782950;5;2;0;0;0;5;2;782950;CE BAMBOO 2PBD BAMBOO+RES+2V ALICANTE;DORMITORIO
10890391;;F;56;CHILENO;;Boomers;PROVIDENCIA                   ;METROPOLITANA;7990;1;1;0;0;0;1;1;7990;PLUMON 2PZA ANDES;DORMITORIO
9693759;;F;62;CHILENO;;Boomers;VALDIVIA                      ;LOS RIOS;440430;7;3;0;0;0;7;3;440430;BOX AMERICANO MIRAGE 2PBN;DORMITORIO
14607137;;F;41;CHILENO;;X;LINARES                       ;MAULE;759471;6;4;0;0;0;6;4;759471;CE EVOLUTION BLACK 1,5P + RESPALDO CASTILLA;DORMITORIO
17854827;;F;30;CHILENO;;Millenial;PROVIDENCIA                   ;METROPOLITANA;166980;2;1;2;1;166980;0;0;0;CLOSET 6P 2C S446 FREIJO NEGRO MATE;DORMITORIO
8433580;;F;63;CHILENO;;Boomers;NOGALES                       ;VALPARAISO;690430;5;3;0;0;0;5;3;690430;CAMA EUROPEA SPRING VI 2.0 PL B/D + ASTURIAS;DORMITORIO
6588912;;F;72;CHILENO;;Silencioso;IQUIQUE                       ;TARAPACA;32970;3;1;0;0;0;3;1;32970;PACK 2 ALMOHADAS C+L;DORMITORIO
10588985;;F;54;CHILENO;;Boomers;N/D;N/D;183056;4;2;0;0;0;4;2;183056;Almohada Visco Bamboo Classic Pack 60x40 cm;DORMITORIO
17239832;;M;32;CHILENO;;Millenial;N/D;N/D;23980;2;1;0;0;0;2;1;23980;ALMOHADA VISCO SLEEP TECH SERIES 65X45 CM;DORMITORIO
8672089;Casado;F;63;CHILENO;;Boomers;RENCA                         ;METROPOLITANA;29970;3;1;0;0;0;3;1;29970;Almohada Imperial Soft 50x70 cm;DORMITORIO
13292568;;F;45;CHILENO;;X;NATALES                       ;MAGALLANES;512950;5;4;0;0;0;5;4;512950;COLCHON NEW ORTOPEDIC 1P;DORMITORIO
7352120;Casado;F;67;CHILENO;;Boomers;SAN JAVIER                    ;MAULE;339980;2;1;0;0;0;2;1;339980;COLCHON BAMBOO 2P FIBRAS BAMBOO;DORMITORIO
17969045;;M;30;CHILENO;;Millenial;ILLAPEL                       ;COQUIMBO;1331711;11;7;5;2;387950;6;5;943761;BOX BAMBOO + Respaldo + 2 Veladores ALICANTE;DORMITORIO
17394111;;F;32;CHILENO;;Millenial;ALTO HOSPICIO;TARAPACA;923900;9;4;9;4;923900;0;0;0;CE EVOLUTION BLACK 1,5P + RESPALDO CASTILLA;DORMITORIO
18572081;;M;28;CHILENO;;Millenial;PROVIDENCIA                   ;METROPOLITANA;744450;5;3;5;3;744450;0;0;0;CE ERGO T 2P 2MT BD;DORMITORIO
24735728;;F;42;COLOMBIANO;;Extranjero;SANTIAGO                      ;METROPOLITANA;179980;2;1;2;1;179980;0;0;0;CAMAROTE TRIPLE CORINA CAFE CLARO;DORMITORIO
6809356;;F;69;CHILENO;;Silencioso;LOS ANDES                     ;VALPARAISO;418249;6;4;0;0;0;6;4;418249;CE EVOLUTION BLACK 1,5P + RESPALDO CASTILLA;DORMITORIO
7525126;;M;67;CHILENO;;Boomers;RENCA                         ;METROPOLITANA;579980;2;1;0;0;0;2;1;579980;CE ERGO T 2P 2MT BD;DORMITORIO
15939853;;F;37;CHILENO;;Millenial;PUENTE ALTO;METROPOLITANA;167950;5;3;0;0;0;5;3;167950;COLCHON NEW ENTREE 1,5P;DORMITORIO
9398776;;M;59;CHILENO;;Boomers;"";"";58970;3;2;0;0;0;3;2;58970;ALMOHADA BAMBOO TECH SERIES 65X45 CM;DORMITORIO
16183009;Soltero;F;36;CHILENO;PSICOLOGO;Millenial;PROVIDENCIA                   ;N/D;158980;2;1;2;1;158980;0;0;0;CLOSET 6P 2C S446 FREIJO NEGRO MATE;DORMITORIO
8835525;;F;61;CHILENO;;Boomers;"";"";4990;1;1;0;0;0;1;1;4990;PACK 2 ALMOHADAS C+L;DORMITORIO
20302503;;F;22;CHILENO;;Extranjero;PROVIDENCIA                   ;METROPOLITANA;223960;3;1;3;1;223960;0;0;0;CLOSET AMATISTA 6P2C - CONAC / BLANCO;DORMITORIO
9680224;;F;60;CHILENO;;Boomers;N/D;N/D;10980;2;1;0;0;0;2;1;10980;Almohada Imperial Soft 50x70 cm;DORMITORIO
15814496;;F;38;CHILENO;;X;PROVIDENCIA                   ;N/D;281970;3;2;0;0;0;3;2;281970;BOX AMERICANO EXCELLENCE 2P BASE NORMAL+2ALM;DORMITORIO
7612873;;F;68;CHILENO;;Boomers;PUNTA ARENAS                  ;MAGALLANES;254980;2;1;0;0;0;2;1;254980;CAMA EUROPEA EXCELLENCE 2 PLAZAS BASE NORMAL;DORMITORIO
11581178;;M;52;CHILENO;;X;COLINA                        ;METROPOLITANA;467520;4;2;0;0;0;4;2;467520;COLCHON NEW ORTOPEDIC 2P;DORMITORIO
19505994;;M;25;CHILENO;;Extranjero;COQUIMBO                      ;COQUIMBO;132980;2;1;2;1;132980;0;0;0;CE EVOLUTION BLACK 1P BN DUAL SIDE;DORMITORIO
6508892;;F;68;CHILENO;;Boomers;N/D;N/D;1075840;5;3;0;0;0;5;3;1075840;CE EVOLUTION BLACK 1,5P BN RESP+VEL;DORMITORIO
13702731;;F;43;CHILENO;;X;PROVIDENCIA                   ;METROPOLITANA;279980;2;1;2;1;279980;0;0;0;CE CANNABIS 1,5P BN+RESP+VEL+PILLOW TOP;DORMITORIO
5187414;Viudo;F;74;CHILENO;;Silencioso;RENCA                         ;METROPOLITANA;139990;1;1;0;0;0;1;1;139990;COLCHON 1PZA NEW VERSATILE BY ABCDIN;DORMITORIO
20356165;;F;22;CHILENO;;Z;PADRE LAS CASAS;ARAUCANIA;366980;2;1;2;1;366980;0;0;0;CAMA EUROPEA IBIZA 2 PL BD;DORMITORIO
15794926;;M;37;CHILENO;;Millenial;QUILICURA;METROPOLITANA;638910;9;4;9;4;638910;0;0;0;RESPALDO 2 PL + 2 VELADORES FIORENZZA;DORMITORIO
8916280;Casado;M;61;CHILENO;;Boomers;CANELA                        ;COQUIMBO;359190;5;5;0;0;0;5;5;359190;CE EVOLUTION BLACK 1,5P + RESPALDO CASTILLA;DORMITORIO
12908628;;F;47;CHILENO;;X;EL BOSQUE                     ;METROPOLITANA;391980;2;1;0;0;0;2;1;391980;COLCHON EVEREST 2P HILOS DE COBRE;DORMITORIO
16099929;;F;36;CHILENO;;Millenial;PROVIDENCIA                   ;METROPOLITANA;189980;2;1;2;1;189980;0;0;0;BOX AMERICANO EXCELLENCE 2P BASE NORMAL+2ALM;DORMITORIO
9031506;;M;60;CHILENO;;Boomers;PROVIDENCIA                   ;METROPOLITANA;219940;6;3;0;0;0;6;3;219940;PACK 2 ALMOHADAS C+L;DORMITORIO
26680798;;F;33;EXTRANJERO - NO INFORMA NACIONALIDAD;;Extranjero;"";"";274950;5;4;0;0;0;5;4;274950;PACK 2 ALMOHADAS C+L;DORMITORIO
6293222;;M;72;CHILENO;;Silencioso;SAN BERNARDO                  ;METROPOLITANA;5000;2;1;0;0;0;2;1;5000;PACK 2 ALMOHADAS C+L;DORMITORIO
16439962;;M;35;CHILENO;;Millenial;"";"";5000;2;1;0;0;0;2;1;5000;PACK 2 ALMOHADAS C+L;DORMITORIO
18834114;Soltero;F;27;CHILENO;;Z;PROVIDENCIA                   ;METROPOLITANA;4990;1;1;1;1;4990;0;0;0;PACK 2 ALMOHADAS C+L;DORMITORIO
10438273;;M;56;CHILENO;;Boomers;N/D;N/D;1036930;7;7;0;0;0;7;7;1036930;CE EVOLUTION BLACK 2P BD DUAL SIDE;DORMITORIO
17714262;;M;32;CHILENO;;Millenial;ANCUD                         ;LOS LAGOS;179990;1;1;0;0;0;1;1;179990;COLCHON NEW ORTOPEDIC 1,5P;DORMITORIO
26676847;;F;24;VENEZOLANO;;Extranjero;N/D;N/D;276960;4;3;3;2;259970;1;1;16990;CE EVOLUTION BLACK 1,5P + RESPALDO CASTILLA;DORMITORIO
5678700;;M;76;CHILENO;;Silencioso;PROVIDENCIA                   ;METROPOLITANA;189980;2;1;0;0;0;2;1;189980;COLCHON EXCELLENCE PLUS 2P;DORMITORIO
9808076;;F;57;CHILENO;;Boomers;LOS ANGELES                   ;BIO BIO;1028140;5;3;0;0;0;5;3;1028140;Pack Imperial Soft 45x65 cm.;DORMITORIO
16015056;;F;37;CHILENO;;Millenial;SANTA MARIA                   ;VALPARAISO;234980;2;1;2;1;234980;0;0;0;BOX AMERICANO EXCELLENCE PLUS 1.5PZA +ALM+PLU;DORMITORIO
4788142;;F;79;CHILENO;;Silencioso;MELIPILLA                     ;METROPOLITANA;-189239;-2;2;0;0;0;-2;2;-189239;CE EVOLUTION BLACK 1,5P BN RESP+VEL;DORMITORIO
16349498;;F;36;CHILENO;;Millenial;ANTOFAGASTA                   ;ANTOFAGASTA;571940;6;4;2;1;233980;4;3;337960;CAMA EUROPEA WAVE 1.50X1.90;DORMITORIO
15726223;;F;38;CHILENO;;X;LA FLORIDA                    ;METROPOLITANA;300950;4;2;3;1;283960;1;1;16990;CAMA EUROPEA THERAPEDIC MAS 1,5P;DORMITORIO
15763429;;M;37;CHILENO;;Millenial;"";"";84830;17;5;17;5;84830;0;0;0;PACK 2 ALMOHADAS C+L;DORMITORIO
9382193;Soltero;F;44;CHILENO;;X;PROVIDENCIA                   ;METROPOLITANA;199980;2;1;2;1;199980;0;0;0;CAMA EUROPEA WAVE 0.90X1.90;DORMITORIO
17116530;;F;32;CHILENO;;Millenial;VILLARICA                     ;ARAUCANIA;19960;4;2;4;2;19960;0;0;0;PACK 2 ALMOHADAS C+L;DORMITORIO
14403021;;F;51;CHILENO;;X;TALCAHUANO                    ;BIO BIO;737850;8;3;0;0;0;8;3;737850;COLCHON EVOLUTION BLACK 1,5P DUAL SIDE;DORMITORIO
15794977;;F;36;CHILENO;;Millenial;N/D;N/D;7000;2;1;0;0;0;2;1;7000;Almohadas Isidora Soft 50x70 cm;DORMITORIO
12571536;;F;48;CHILENO;;X;CALAMA                        ;ANTOFAGASTA;915910;6;1;6;1;915910;0;0;0;CAMA EURO GRIS NEW ENTREE-D 2PBD;DORMITORIO
19497689;;M;25;CHILENO;;Z;PROVIDENCIA                   ;METROPOLITANA;393980;2;1;2;1;393980;0;0;0;CE CAMA ERGO T 1.50X2.00 BD + RESP FERRARA;DORMITORIO
19981092;;F;23;CHILENO;;Z;PROVIDENCIA                   ;METROPOLITANA;294980;2;1;0;0;0;2;1;294980;BOX SPRING NEOSENSE FULL BLACK;DORMITORIO
8026576;;M;64;CHILENO;;Boomers;PAINE                         ;METROPOLITANA;142970;3;2;2;1;120980;1;1;21990;COLCHON THERAPEDIC MAS 1,5P;DORMITORIO
16856916;;M;35;CHILENO;;Millenial;CONSTITUCION                  ;MAULE;169990;1;1;0;0;0;1;1;169990;COLCHON NEW ORTOPEDIC 1P;DORMITORIO
15502677;;F;39;CHILENO;;X;"";"";126980;2;1;2;1;126980;0;0;0;CE EVOLUTION BLACK 1P BN DUAL SIDE;DORMITORIO
15112400;;F;35;CHILENO;;Millenial;PICHIDEGUA                    ;L.G.B.OÂ´HIGGINS;229990;1;1;0;0;0;1;1;229990;CE EVOLUTION BLACK 1,5P BN RESP+VEL;DORMITORIO
15645257;;F;38;CHILENO;;X;N/D;N/D;900490;7;4;6;3;770500;1;1;129990;CE ORTOP ADVANCE 1.5P +RESP+1VEL NEW DUBLIN;DORMITORIO
17763340;;F;31;CHILENO;;Millenial;PUDAHUEL                      ;METROPOLITANA;589970;3;2;3;2;589970;0;0;0;CAMA EURO GRIS NEW ENTREE-D 2.0 PL B/D ASTURIAS;DORMITORIO
12241750;;M;49;CHILENO;;X;SAN VICENTE                   ;L.G.B.OÂ´HIGGINS;763910;9;5;5;3;643950;4;2;119960;COLCHON BEAT 2P;DORMITORIO
13510234;;M;44;CHILENO;;X;HUALPEN;BIO BIO;9980;2;1;0;0;0;2;1;9980;PACK 2 ALMOHADAS C+L;DORMITORIO
9187805;;F;62;CHILENO;;Boomers;BUIN                          ;METROPOLITANA;209980;2;1;0;0;0;2;1;209980;CE EVOLUTION BLACK 1,5P + RESPALDO CASTILLA;DORMITORIO
14186502;;F;40;CHILENO;;X;MACUL;METROPOLITANA;109980;2;1;2;1;109980;0;0;0;CE EVOLUTION BLACK 1P BN DUAL SIDE;DORMITORIO
9442505;Casado;M;57;CHILENO;;Boomers;PROVIDENCIA                   ;METROPOLITANA;357960;4;2;4;2;357960;0;0;0;CLOSET MANILA Z-120 5P - CONAC / BLANCO;DORMITORIO
10317254;;F;57;CHILENO;;Boomers;COLINA                        ;METROPOLITANA;24970;3;2;0;0;0;3;2;24970;PACK 2 ALMOHADAS C+L;DORMITORIO
19974031;;F;23;CHILENO;;Z;SAN ANTONIO;VALPARAISO;693900;9;4;9;4;693900;0;0;0;Cama Europea Active 1,5P;DORMITORIO
15136614;;F;39;CHILENO;;X;CONSTITUCION                  ;MAULE;340900;7;1;7;1;340900;0;0;0;COLCHON THERAPEDIC 1,5P 2MTS;DORMITORIO
5759902;;F;78;CHILENO;;Silencioso;ANTOFAGASTA                   ;ANTOFAGASTA;754960;4;2;0;0;0;4;2;754960;Cama Europea Terapeutic 2PBN + Resp + 2 Vel Vill;DORMITORIO
8383280;Casado;M;55;CHILENO;TECNICO AGRICOLA;Boomers;RENCA                         ;METROPOLITANA;299980;2;1;2;1;299980;0;0;0;COLCHON ORTOPEDIC ADVANCE 2P + CUBREC;DORMITORIO
17866361;;F;30;CHILENO;;Millenial;VALLENAR;ATACAMA;759260;5;2;5;2;759260;0;0;0;CE ERGO T KING 2MT BD;DORMITORIO
9726818;;F;56;CHILENO;;Boomers;CHILLAN                       ;BIO BIO;433530;6;4;0;0;0;6;4;433530;CLOSET MARITTIMA 6P+2C;DORMITORIO
11151925;;M;55;CHILENO;;Boomers;RENGO                         ;L.G.B.OÂ´HIGGINS;361520;5;1;0;0;0;5;1;361520;BOX AMERICANO MIRAGE 2PBN;DORMITORIO
19787745;;F;24;CHILENO;;Z;CATEMU;VALPARAISO;424950;4;1;4;1;424950;0;0;0;CAMA EUROPEA IBIZA 2 PL BD;DORMITORIO
18569568;;F;28;CHILENO;;Millenial;PUENTE ALTO;METROPOLITANA;329960;4;2;4;2;329960;0;0;0;CE EVOLUTION BLACK 1,5P + RESPALDO CASTILLA;DORMITORIO
13810684;;F;42;CHILENO;;X;TEMUCO                        ;ARAUCANIA;17980;2;1;0;0;0;2;1;17980;ALMOHADA DA SOFT SLEEP 50 X 70;DORMITORIO
8168030;;F;64;CHILENO;;Boomers;SAN RAMON                     ;METROPOLITANA;6990;2;1;0;0;0;2;1;6990;Almohadas Isidora Soft 50x70 cm;DORMITORIO
13656352;;M;43;CHILENO;;X;SAN BERNARDO                  ;METROPOLITANA;971951;6;4;2;1;251980;4;3;719971;COLCHON ERGO T 1.80X2.00;DORMITORIO
22620537;;M;45;PERUANO;;Extranjero;N/D;N/D;94970;3;2;0;0;0;3;2;94970;PACK 2 ALMOHADAS C+L;DORMITORIO
17059847;;F;32;CHILENO;;Millenial;"";"";10980;2;1;0;0;0;2;1;10980;Almohada Imperial Soft 50x70 cm;DORMITORIO
10890910;;F;55;CHILENO;;Boomers;PROVIDENCIA                   ;METROPOLITANA;4990;1;1;0;0;0;1;1;4990;PACK 2 ALMOHADAS C+L;DORMITORIO
13358469;;M;44;CHILENO;;X;RENCA                         ;METROPOLITANA;670840;5;4;0;0;0;5;4;670840;COLCHON BAMBOO 2P FIBRAS BAMBOO;DORMITORIO
9888704;;M;56;CHILENO;;Boomers;CHONCHI                       ;LOS LAGOS;283970;3;1;0;0;0;3;1;283970;COLCHON TERAPEUTIC 2P PILLOW TOP;DORMITORIO
15669451;;M;38;CHILENO;;Millenial;N/D;N/D;359960;3;1;3;1;359960;0;0;0;Closet BAKER TV 55 2PT 4CJ CHOCOLATE;DORMITORIO
11136512;;F;55;CHILENO;;Boomers;QUILLOTA                      ;VALPARAISO;312970;4;3;0;0;0;4;3;312970;COLCHON NEW ORTOPEDIC 2P;DORMITORIO
17972356;;F;30;CHILENO;;Millenial;PUTAENDO                      ;VALPARAISO;331980;2;1;2;1;331980;0;0;0;BOX AMERICANO EXCELLENCE PLUS 2P BD +AL+PLU;DORMITORIO
18649241;Soltero;F;27;CHILENO;;Millenial;PROVIDENCIA                   ;METROPOLITANA;399980;2;1;2;1;399980;0;0;0;CAMA NEW STYLE 2 1.50X2.00BD + RESPALDO FERRARA;DORMITORIO
15515695;;M;35;CHILENO;;Millenial;PROVIDENCIA                   ;METROPOLITANA;173980;2;1;2;1;173980;0;0;0;COLCHON EXCELLENCE PLUS 2 PLAZAS 2M;DORMITORIO
13969663;;M;42;CHILENO;;X;COIHAIQUE                     ;AYSEN;369111;4;3;1;1;269990;3;2;99121;SET 2 ALMOHADAS VISCO MEDIUM 60X40 CM;DORMITORIO
9786519;;F;58;CHILENO;;Boomers;LA PINTANA                    ;METROPOLITANA;209980;3;1;0;0;0;3;1;209980;CE EVOLUTION BLACK 1,5P + RESPALDO CASTILLA;DORMITORIO
19353521;;M;25;CHILENO;;Z;CURACAUTIN                    ;ARAUCANIA;239980;2;1;2;1;239980;0;0;0;CLOSET 6P 8C MOD Y338 - BICOLOR AT;DORMITORIO
16742684;Casado;M;34;CHILENO;;Millenial;PROVIDENCIA                   ;METROPOLITANA;94980;2;1;2;1;94980;0;0;0;RESPALDO FERRARA 2 PLAZAS;DORMITORIO
20709499;;F;21;CHILENO;;Z;ARICA;TARAPACA;79980;2;1;0;0;0;2;1;79980;SET 2 ALMOHADAS VISCO MEDIUM 60X40 CM;DORMITORIO
12300482;;F;50;CHILENO;;Millenial;"";"";9980;2;1;0;0;0;2;1;9980;PACK 2 ALMOHADAS C+L;DORMITORIO
20364774;;M;21;CHILENO;;Z;CONCEPCION;BIO-BIO;246810;4;1;0;0;0;4;1;246810;CE EVOLUTION BLACK 1,5P + RESPALDO CASTILLA;DORMITORIO
19392381;;F;26;CHILENO;;Z;RIO CLARO                     ;MAULE;599940;6;2;2;1;144980;4;1;454960;COLCHON BEAT 2P;DORMITORIO
13923579;;F;43;CHILENO;;Silencioso;PROVIDENCIA                   ;METROPOLITANA;259980;2;1;2;1;259980;0;0;0;Cama Europea Supreme 1P;DORMITORIO
8152135;;F;61;CHILENO;;Boomers;CONSTITUCION                  ;MAULE;701910;9;6;0;0;0;9;6;701910;Almohada Imperial Soft 50x70 cm;DORMITORIO
12684566;;F;48;CHILENO;;X;SAN MIGUEL                    ;METROPOLITANA;109970;2;1;2;1;109970;0;0;0;COLCHON EXCELLENCE 1,5P;DORMITORIO
5730596;;M;76;CHILENO;;Silencioso;TEMUCO                        ;ARAUCANIA;59980;2;2;0;0;0;2;2;59980;PACK 2 ALMOHADAS C+L;DORMITORIO
9121379;;F;55;CHILENO;;Boomers;ARICA                         ;ARICA Y PARINACOTA;4990;1;1;0;0;0;1;1;4990;PACK 2 ALMOHADAS C+L;DORMITORIO
20094239;;M;23;CHILENO;;Z;N/D;N/D;13990;3;1;0;0;0;3;1;13990;Almohadas Isidora Soft 50x70 cm;DORMITORIO
17474129;;F;32;CHILENO;;Millenial;PROVIDENCIA                   ;METROPOLITANA;158980;2;1;2;1;158980;0;0;0;COMODA 6 CAJ. ROBLE ANTRACITA-BLANCO;DORMITORIO
15121995;;F;37;CHILENO;;Millenial;CONCHALI;METROPOLITANA;198970;3;2;2;1;190980;1;1;7990;BOX AMERICANO BEAT 1,5 PLAZAS 105 X 190 CM;DORMITORIO
14398599;;F;44;CHILENO;;X;SAN CLEMENTE                  ;MAULE;339990;1;1;0;0;0;1;1;339990;CE EVOLUTION BLACK 2P BN+RESP+2 VEL;DORMITORIO
14284023;;F;48;CHILENO;;X;RECOLETA                      ;METROPOLITANA;262970;3;2;0;0;0;3;2;262970;Closet MAIPO 6PT 6CJ 180 CM CEREZO;DORMITORIO
10634803;;F;56;CHILENO;;Boomers;CHILLAN                       ;BIO BIO;233980;2;1;0;0;0;2;1;233980;COLCHON NEW STYLE 2 2P;DORMITORIO
6334122;Casado;F;68;CHILENO;;Silencioso;RENCA                         ;METROPOLITANA;13980;2;1;0;0;0;2;1;13980;Almohadas Isidora Soft 50x70 cm;DORMITORIO
25841711;Soltero;F;33;VENEZOLANO;;Extranjero;PROVIDENCIA                   ;METROPOLITANA;260980;2;1;2;1;260980;0;0;0;CAMA MULTI RETRACTIL 1.5P;DORMITORIO
12919879;;F;47;CHILENO;;X;CALAMA                        ;ANTOFAGASTA;474600;5;2;5;2;474600;0;0;0;CLOSET M-802 4P+2 C ALTO 1,82 BLANCO NATURAL;DORMITORIO
17690675;;M;32;CHILENO;;Millenial;PROVIDENCIA                   ;METROPOLITANA;189990;1;1;0;0;0;1;1;189990;COLCHON NEW ORTOPEDIC 2P;DORMITORIO
8181765;;F;59;CHILENO;;Boomers;COIHAIQUE                     ;AYSEN;439940;6;4;0;0;0;6;4;439940;SET 2 ALMOHADAS VISCO MEDIUM 60X40 CM;DORMITORIO
11519005;;F;52;CHILENO;;X;CALERA                        ;VALPARAISO;499960;4;6;0;0;0;4;6;499960;CE EVOLUTION BLACK 1,5P BN RESP+VEL;DORMITORIO
8478052;;F;62;CHILENO;;Boomers;N/D;N/D;1904840;15;4;0;0;0;15;4;1904840;CE NEW STYLE 6 2P 2MT BD+RESP+2VEL FERRARA;DORMITORIO
15818214;;F;37;CHILENO;;Millenial;QUILLOTA                      ;VALPARAISO;199990;1;1;0;0;0;1;1;199990;CE EVOLUTION BLACK 1,5P + RESPALDO CASTILLA;DORMITORIO
10241911;;F;59;CHILENO;;Boomers;SAN CARLOS                    ;BIO BIO;760970;3;3;0;0;0;3;3;760970;CE NEW STYLE 6 2P 2MT BD;DORMITORIO
18130766;Soltero;F;29;CHILENO;;Millenial;PROVIDENCIA                   ;METROPOLITANA;280980;2;1;2;1;280980;0;0;0;CE CURVE NEW ORTOPEDIC 1.5P;DORMITORIO
19156878;;F;23;CHILENO;;Z;"";"";206470;3;1;3;1;206470;0;0;0;Velador Multi Funcional Z-54 - WENGUE;DORMITORIO
17100838;Soltero;F;33;CHILENO;INGENIERIA EN ADMINISTRACION DE EMPRESAS MENCION FINANZAS;Millenial;PROVIDENCIA                   ;METROPOLITANA;100980;2;1;2;1;100980;0;0;0;ESCRITORIO TORINO;DORMITORIO
4518483;;F;82;CHILENO;;Silencioso;N/D;N/D;383960;3;1;3;1;383960;0;0;0;CAMAROTE TRIPLE MARI 1.5P;DORMITORIO
18816215;;M;27;CHILENO;;Millenial;CANETE                        ;BIO BIO;195980;2;1;2;1;195980;0;0;0;Cama Europea Danubio 1,5 P Comprimido;DORMITORIO
25349522;;F;38;VENEZOLANO;;Extranjero;N/D;N/D;196980;2;1;2;1;196980;0;0;0;CAMAROTE TRIPLE CORINA BLANCO;DORMITORIO
15694291;;M;38;CHILENO;;Millenial;ESTACION CENTRAL              ;METROPOLITANA;102960;4;2;4;2;102960;0;0;0;RACK RIO CHOCOLATE 42;DORMITORIO
18488520;;F;28;CHILENO;;Millenial;MELIPILLA                     ;METROPOLITANA;4990;1;1;0;0;0;1;1;4990;PACK 2 ALMOHADAS C+L;DORMITORIO
20101793;;F;23;CHILENO;;Z;VICTORIA                      ;ARAUCANIA;640660;3;2;0;0;0;3;2;640660;CE NEW STYLE 2 2P 2MT BD;DORMITORIO
10931063;;F;49;CHILENO;;X;SAN PEDRO DE LA PAZ;BIO-BIO;9990;3;1;0;0;0;3;1;9990;PACK 2 ALMOHADAS C+L;DORMITORIO
8564013;;F;64;CHILENO;;Boomers;MONTE PATRIA                  ;COQUIMBO;23970;3;1;0;0;0;3;1;23970;Almohadas Isidora Soft 50x90 cm;DORMITORIO
13839386;;M;41;CHILENO;;X;LA PINTANA                    ;METROPOLITANA;23970;3;1;0;0;0;3;1;23970;Almohadas Isidora Soft 50x90 cm;DORMITORIO
9699998;;F;55;CHILENO;;Boomers;CASTRO                        ;LOS LAGOS;179990;1;1;0;0;0;1;1;179990;COLCHON BEAT 2P;DORMITORIO
13067210;;F;46;CHILENO;;X;CALERA                        ;VALPARAISO;976930;7;2;0;0;0;7;2;976930;CE EVOLUTION BLACK 1,5P + RESPALDO ASTURIAS;DORMITORIO
6940257;;F;68;CHILENO;;Silencioso;CHILLAN                       ;BIO BIO;31960;4;2;0;0;0;4;2;31960;ALMOHADA SOFT MICROGEL;DORMITORIO
9777800;;F;59;CHILENO;;Boomers;ILLAPEL                       ;COQUIMBO;628880;12;6;0;0;0;12;6;628880;ALMOHADA SOFT MICROGEL;DORMITORIO
8943418;Casado;M;62;CHILENO;AUXILIAR DE ENFERMERIA;Boomers;RENCA                         ;METROPOLITANA;16990;1;1;0;0;0;1;1;16990;Almohada Bamboo Classic 70x40;DORMITORIO
10331802;;F;57;CHILENO;;Boomers;PROVIDENCIA                   ;METROPOLITANA;139980;2;1;2;1;139980;0;0;0;COLCHON EXCELLENCE FULL + 2 ALM;DORMITORIO
17049159;;F;33;CHILENO;;Millenial;PENAFLOR                      ;METROPOLITANA;603940;6;2;0;0;0;6;2;603940;COLCHON TERAPEUTIC 2P PILLOW TOP;DORMITORIO
11131830;;M;55;CHILENO;;Boomers;PADRE HURTADO                 ;METROPOLITANA;375960;4;1;0;0;0;4;1;375960;COLCHON ERGO T 1,5P;DORMITORIO
17295400;Soltero;M;32;CHILENO;PROFESOR;Millenial;PROVIDENCIA                   ;METROPOLITANA;147540;2;1;2;1;147540;0;0;0;RESPALDO EUFRATES KING;DORMITORIO
18356246;Soltero;F;29;CHILENO;;Silencioso;PROVIDENCIA                   ;METROPOLITANA;397960;4;2;4;2;397960;0;0;0;COLCHON THERAPEDIC 1,5P;DORMITORIO
10367220;Casado;F;47;CHILENO;ABOGADO;X;PROVIDENCIA                   ;METROPOLITANA;349990;2;1;2;1;349990;0;0;0;COLCHON NEST 2P 2MTS;DORMITORIO
17156801;;F;33;CHILENO;;Millenial;CURICO;MAULE;119990;1;1;0;0;0;1;1;119990;COLCHON 1PZA NEW VERSATILE BY ABCDIN;DORMITORIO
17401565;;F;32;CHILENO;;Millenial;PROVIDENCIA                   ;METROPOLITANA;4990;1;1;0;0;0;1;1;4990;PACK 2 ALMOHADAS C+L;DORMITORIO
11928507;Soltero;M;50;CHILENO;;X;RENCA                         ;METROPOLITANA;369970;3;1;0;0;0;3;1;369970;CE EVOLUTION BLACK 2P BN+RESP+2 VEL;DORMITORIO
26262690;Soltero;M;28;HAITIANO;;Extranjero;"";"";309980;2;1;2;1;309980;0;0;0;DIVAN CAMA ERGO T + RESP TABOR 1.5 PL;DORMITORIO
17155919;;F;33;CHILENO;;Millenial;N/D;N/D;845390;10;3;10;3;845390;0;0;0;Closet BAKER TV 55 2PT 4CJ CHOCOLATE;DORMITORIO
15204077;;F;41;CHILENO;;X;"";"";659820;4;2;4;2;659820;0;0;0;CE NEW STYLE 6 2P 2MT BD;DORMITORIO
11568751;;F;52;CHILENO;;X;CONSTITUCION                  ;MAULE;10980;2;1;0;0;0;2;1;10980;Almohada Imperial Soft 50x70 cm;DORMITORIO
13765631;;F;41;CHILENO;;X;VILLA ALEMANA                 ;VALPARAISO;280970;3;1;0;0;0;3;1;280970;CE EVOLUTION BLACK 1,5P BN RESP+VEL;DORMITORIO
13782248;;F;42;CHILENO;;X;PALMILLA                      ;L.G.B.OÂ´HIGGINS;23980;2;1;0;0;0;2;1;23980;ALMOHADA ROSEN SOFT PLUS KING;DORMITORIO
6035298;;M;72;CHILENO;;Silencioso;MARCHIHUE                     ;L.G.B.OÂ´HIGGINS;453970;3;1;0;0;0;3;1;453970;CAMA EUROPEA EXCELLENCE 2 PLAZAS BASE NORMAL;DORMITORIO
18003332;Soltero;F;30;CHILENO;INGENIERO EN PREVENCION DE RIESGOS;Millenial;PROVIDENCIA                   ;METROPOLITANA;235980;2;1;2;1;235980;0;0;0;COLCHON ALOE VERA 2P FIBRAS ALOE VERA;DORMITORIO
6841196;;F;72;CHILENO;;Silencioso;SAN BERNARDO                  ;METROPOLITANA;229980;2;1;0;0;0;2;1;229980;CE EVOLUTION BLACK 1,5P BN RESP+VEL;DORMITORIO
16158889;;F;36;CHILENO;;Millenial;DALCAHUE                      ;LOS LAGOS;1533900;10;6;0;0;0;10;6;1533900;BOX BAMBOO + Respaldo + 2 Veladores ALICANTE;DORMITORIO
12737191;;M;47;CHILENO;;X;TIRUA                         ;BIO BIO;4990;1;1;0;0;0;1;1;4990;PACK 2 ALMOHADAS C+L;DORMITORIO
10108064;Viudo;F;61;CHILENO;;Boomers;PROVIDENCIA                   ;METROPOLITANA;23980;2;1;0;0;0;2;1;23980;Almohada Bamboo Classic 70x40;DORMITORIO
7017860;Casado;F;63;CHILENO;ABOGADO;Boomers;PROVIDENCIA                   ;METROPOLITANA;195980;2;1;2;1;195980;0;0;0;CAMAROTE TRIPLE CORINA CAFE OSCURO;DORMITORIO
23990727;;F;41;COLOMBIANO;;Extranjero;ANTOFAGASTA                   ;ANTOFAGASTA;259980;2;1;2;1;259980;0;0;0;CE EVOLUTION BLACK 2P BD DUAL SIDE;DORMITORIO
25540080;;M;38;HAITIANO;;Extranjero;N/D;N/D;304950;5;3;0;0;0;5;3;304950;COLCHON EVOLUTION BLACK 1,5P DUAL SIDE;DORMITORIO
6637172;;F;71;CHILENO;;Silencioso;SAN RAMON                     ;METROPOLITANA;209980;2;1;2;1;209980;0;0;0;CE EVOLUTION BLACK 1,5P BN RESP+VEL;DORMITORIO
20325098;;F;22;CHILENO;;Z;SAN ANTONIO                   ;VALPARAISO;572920;8;2;0;0;0;8;2;572920;CE EVOLUTION BLACK 1,5P BN RESP+VEL;DORMITORIO
6703828;;M;69;CHILENO;;Silencioso;ARAUCO                        ;BIO BIO;379970;3;1;3;1;379970;0;0;0;CE EVOLUTION BLACK 1,5P + RESPALDO CASTILLA;DORMITORIO
19398311;;M;25;CHILENO;;Z;N/D;N/D;277970;3;2;0;0;0;3;2;277970;COLCHON BAMBOO 2P FIBRAS BAMBOO;DORMITORIO
16769628;;F;35;CHILENO;;Millenial;ARICA                         ;ARICA Y PARINACOTA;327530;3;1;3;1;327530;0;0;0;CE EVOLUTION BLACK 2P BD DUAL SIDE;DORMITORIO
17341038;;F;32;CHILENO;;Millenial;RENCA                         ;METROPOLITANA;219990;1;1;0;0;0;1;1;219990;CE EVOLUTION BLACK 1,5P BN RESP+VEL;DORMITORIO
13392212;;F;44;CHILENO;;X;LO BARNECHEA                  ;METROPOLITANA;303970;3;1;3;1;303970;0;0;0;CE EVOLUTION BLACK 2P BD DUAL SIDE;DORMITORIO
18540896;Soltero;F;28;CHILENO;;Millenial;PROVIDENCIA                   ;METROPOLITANA;309980;2;1;2;1;309980;0;0;0;BS NEW ORTOPEDIC ADVANCE B5 BLACK 2P BN + PL ];DORMITORIO
5336290;;F;83;CHILENO;;Silencioso;VINA DEL MAR                  ;VALPARAISO;8990;1;1;0;0;0;1;1;8990;ALMOHADA SOFT MICROGEL;DORMITORIO
9190124;;F;58;CHILENO;;Boomers;PROVIDENCIA                   ;METROPOLITANA;252980;2;1;0;0;0;2;1;252980;CLOSET CAJONERA NEW BELGICA M-398-NW;DORMITORIO
19049337;;F;26;CHILENO;;Z;LIMACHE;VALPARAISO;39980;2;1;2;1;39980;0;0;0;Colchon Cuna Extendible 100x60;DORMITORIO
13045802;;F;45;CHILENO;;X;"";"";139990;1;1;0;0;0;1;1;139990;COLCHON 1PZA NEW VERSATILE BY ABCDIN;DORMITORIO
18023791;;F;30;CHILENO;;Millenial;QUELLON                       ;LOS LAGOS;189980;2;1;0;0;0;2;1;189980;COLCHON THERAPEDIC 2P;DORMITORIO
18863691;;F;27;CHILENO;;Silencioso;PROVIDENCIA                   ;METROPOLITANA;244980;2;1;2;1;244980;0;0;0;Cama Europea Active 2PBN;DORMITORIO
7964160;;F;66;CHILENO;;Boomers;SAN JAVIER                    ;MAULE;15980;2;1;0;0;0;2;1;15980;ALMOHADA SOFT MICROGEL;DORMITORIO
14348885;;F;43;CHILENO;;X;PROVIDENCIA                   ;METROPOLITANA;195980;2;1;2;1;195980;0;0;0;CE EVOLUTION BLACK 1,5P + RESPALDO ASTURIAS;DORMITORIO
20325584;;F;22;CHILENO;;Z;PROVIDENCIA                   ;METROPOLITANA;39980;2;1;2;1;39980;0;0;0;Colchon Cuna Extendible 100x60;DORMITORIO
20685220;Soltero;M;25;CHILENO;;Z;N/D;N/D;194980;2;1;2;1;194980;0;0;0;CE EVOLUTION BLACK 1,5P + RESPALDO CASTILLA;DORMITORIO
13680092;;F;43;CHILENO;;X;RENCA                         ;METROPOLITANA;169980;2;1;2;1;169980;0;0;0;CE EVOLUTION BLACK 1,5P BN DUAL SIDE;DORMITORIO
17271743;;F;32;CHILENO;;Millenial;LA FLORIDA                    ;METROPOLITANA;733960;3;1;3;1;733960;0;0;0;SET MUEBLES CHARLES 2PL;DORMITORIO
16650590;Casado;M;34;CHILENO;PROFESOR;Millenial;PROVIDENCIA                   ;METROPOLITANA;17980;2;1;0;0;0;2;1;17980;ALMOHADA SOFT MICROGEL;DORMITORIO
19491567;;F;25;CHILENO;;Z;CASTRO                        ;LOS LAGOS;497080;3;1;3;1;497080;0;0;0;BOX AMERICANO EXCELLENCE PLUS 2P BD+2ALM ];DORMITORIO
7397187;;M;66;CHILENO;;Boomers;TEMUCO                        ;ARAUCANIA;177980;2;1;0;0;0;2;1;177980;COLCHON BEAT 2P;DORMITORIO
14619180;;F;45;CHILENO;;X;PROVIDENCIA                   ;METROPOLITANA;184540;2;1;2;1;184540;0;0;0;COLCHON BAMBOO 2P FIBRAS BAMBOO;DORMITORIO
10137623;;F;58;CHILENO;;Boomers;QUINTA NORMAL                 ;METROPOLITANA;208630;3;1;3;1;208630;0;0;0;COLCHON EXCELLENCE 1.5 PLAZA + CUBRECOLCHON;DORMITORIO
18184284;;F;29;CHILENO;;Millenial;"";"";209980;2;1;2;1;209980;0;0;0;CE EVOLUTION BLACK 1,5P BN RESP+VEL;DORMITORIO
16221810;;F;36;CHILENO;;Millenial;PROVIDENCIA                   ;METROPOLITANA;8490;1;1;0;0;0;1;1;8490;ALMOHADA ROSEN SOFT PLUS AMERICANA;DORMITORIO
10930407;;F;55;CHILENO;;Boomers;CALAMA                        ;ANTOFAGASTA;340960;4;3;0;0;0;4;3;340960;COLCHON TERAPEUTIC 2P PILLOW TOP;DORMITORIO
19014885;;F;26;CHILENO;;Z;PROVIDENCIA                   ;METROPOLITANA;149980;2;1;2;1;149980;0;0;0;CE EVOLUTION BLACK 1,5P BN DUAL SIDE;DORMITORIO
15215832;Casado;F;40;CHILENO;;X;PROVIDENCIA                   ;METROPOLITANA;263980;2;1;2;1;263980;0;0;0;DIVAN CAMA ERGO T 1,5P 2 MTS;DORMITORIO
17621482;;F;32;CHILENO;;Millenial;QUILICURA                     ;METROPOLITANA;159980;2;1;2;1;159980;0;0;0;CE EVOLUTION BLACK 1,5P BN DUAL SIDE;DORMITORIO
8513338;;F;61;CHILENO;;Boomers;"";"";448970;3;2;2;1;268980;1;1;179990;DIVAN CAMA ERGO T 1,5P 2 MTS;DORMITORIO
14236156;;M;50;CHILENO;;X;SAN CARLOS                    ;BIO BIO;452980;2;1;0;0;0;2;1;452980;BOX BAMBOO + Respaldo + 2 Veladores ALICANTE;DORMITORIO
18018511;;M;30;CHILENO;;Millenial;PROVIDENCIA                   ;METROPOLITANA;324980;2;1;2;1;324980;0;0;0;BS NEW ORTOPEDIC B5BLACK 2PBN+RESP+2VEL LEGNO;DORMITORIO
5678854;;F;74;CHILENO;;Silencioso;LOS ANGELES                   ;BIO BIO;989820;6;2;0;0;0;6;2;989820;CE EVEREST 2P 2MTS BD DUAL SIDE;DORMITORIO
13464725;;M;44;CHILENO;;X;PROVIDENCIA                   ;METROPOLITANA;159980;2;1;2;1;159980;0;0;0;COLCHON NEW ORTOPEDIC 1,5P;DORMITORIO
16445713;;M;36;CHILENO;;Millenial;N/D;N/D;132980;2;1;0;0;0;2;1;132980;CLOSET M-802 4P+2 C ALTO 1,82 BLANCO NATURAL;DORMITORIO
14184734;;F;41;CHILENO;;X;RENCA                         ;METROPOLITANA;283980;2;1;2;1;283980;0;0;0;BOX AMERICANO EXCELLENCE PLUS 2P BD +AL+PLU;DORMITORIO
18965195;;M;27;CHILENO;;Z;N/D;N/D;11580;2;1;0;0;0;2;1;11580;Almohada Imperial Soft 50x70 cm;DORMITORIO
13392200;;F;44;CHILENO;;Silencioso;PROVIDENCIA                   ;METROPOLITANA;269980;2;1;2;1;269980;0;0;0;DIVAN CAMA ERGO T 1,5P 2 MTS;DORMITORIO
18548810;;M;28;CHILENO;;Silencioso;PROVIDENCIA                   ;METROPOLITANA;198980;2;1;2;1;198980;0;0;0;CE EVOLUTION BLACK 1,5P BN RESP+VEL;DORMITORIO
12422472;;M;49;CHILENO;;X;TEMUCO                        ;ARAUCANIA;566640;5;1;0;0;0;5;1;566640;COLCHON BAMBOO 2P FIBRAS BAMBOO;DORMITORIO
19534181;;F;25;CHILENO;;Z;TALCAHUANO                    ;BIO BIO;389830;3;1;3;1;389830;0;0;0;CE ERGO T 2P 2MT BD;DORMITORIO
19454114;;F;30;CHILENO;;Millenial;NUEVA IMPERIAL                ;ARAUCANIA;352980;2;1;0;0;0;2;1;352980;CE EVOLUTION BLACK 2P BN+RESP+2 VEL;DORMITORIO
18536077;;F;29;CHILENO;;Millenial;CONCEPCION;BIO-BIO;185840;2;1;2;1;185840;0;0;0;BASE CAMA KAIA 2P- MIEL / BLANCO;DORMITORIO
17638544;Soltero;M;31;CHILENO;;Millenial;FREIRE                        ;ARAUCANIA;390930;5;1;0;0;0;5;1;390930;COLCHON BAMBOO 1,5P FIBRAS BAMBOO;DORMITORIO
6433115;;F;77;CHILENO;;Silencioso;OSORNO                        ;LOS LAGOS;177870;2;1;0;0;0;2;1;177870;COLCHON BAMBOO 1,5P FIBRAS BAMBOO;DORMITORIO
20123063;;M;23;CHILENO;;Silencioso;PROVIDENCIA                   ;METROPOLITANA;114540;2;1;2;1;114540;0;0;0;CLOSET 6 PUERTAS 2 CAJONES FELICCE NOGAL;DORMITORIO
8908521;Casado;M;61;CHILENO;;Boomers;RENCA                         ;METROPOLITANA;9980;2;1;0;0;0;2;1;9980;Almohada Imperial Soft 50x70 cm;DORMITORIO
19623921;;M;24;CHILENO;;Z;N/D;N/D;88540;2;1;2;1;88540;0;0;0;CLOSET MARITTIMA 6P+2C;DORMITORIO
20363446;;M;22;CHILENO;;Silencioso;PROVIDENCIA                   ;METROPOLITANA;183980;2;1;2;1;183980;0;0;0;COLCHON NEW ORTOPEDIC 1,5P;DORMITORIO
15319281;;M;44;CHILENO;;X;PROVIDENCIA                   ;METROPOLITANA;379980;2;1;2;1;379980;0;0;0;COLCHON ART 4 2P;DORMITORIO
16653274;;F;34;CHILENO;;Millenial;SANTIAGO                      ;METROPOLITANA;163980;2;1;2;1;163980;0;0;0;BOX AMERICANO EXCELLENCE 1.5 PLAZA + ALM;DORMITORIO
5004274;;F;80;CHILENO;;Silencioso;TALCA                         ;MAULE;149990;1;1;0;0;0;1;1;149990;COLCHON NEW ORTOPEDIC 1,5P;DORMITORIO
18542609;;F;28;CHILENO;;Millenial;N/D;N/D;128980;2;1;2;1;128980;0;0;0;CE EVOLUTION BLACK 1,5P + RESPALDO CASTILLA;DORMITORIO
7889921;;M;64;CHILENO;;Boomers;SANTA CRUZ                    ;L.G.B.OÂ´HIGGINS;261980;2;1;0;0;0;2;1;261980;COLCHON NEW STYLE 6 2P;DORMITORIO
16387087;;M;35;CHILENO;;Millenial;ANTOFAGASTA;ANTOFAGASTA;139980;2;1;2;1;139980;0;0;0;COLCHON ERGO T 1P;DORMITORIO
15098955;;F;39;CHILENO;;X;N/D;N/D;201970;3;1;0;0;0;3;1;201970;CE EVOLUTION BLACK 1,5P BN DUAL SIDE;DORMITORIO
11359888;;F;53;CHILENO;;X;PROVIDENCIA                   ;METROPOLITANA;519980;2;1;0;0;0;2;1;519980;CE NEW ORTOPEDIC 2PBD +RESP+2VEL NEW DUBLIN;DORMITORIO
19914830;;F;24;CHILENO;;Silencioso;PROVIDENCIA                   ;METROPOLITANA;98980;2;1;2;1;98980;0;0;0;CLOSET NIZA 6P+2C;DORMITORIO
19906227;;F;24;CHILENO;;Z;PROVIDENCIA                   ;METROPOLITANA;255840;2;1;2;1;255840;0;0;0;BOX AMERICANO EXCELLENCE PLUS 2P BN +AL+PLU;DORMITORIO
18028859;;M;29;CHILENO;;Silencioso;PROVIDENCIA                   ;METROPOLITANA;411980;2;1;2;1;411980;0;0;0;CAMA ERGO T 2PBD + RESP + 2 VEL FERRARA;DORMITORIO
19129102;;F;26;CHILENO;;Z;PROVIDENCIA                   ;METROPOLITANA;219980;2;1;2;1;219980;0;0;0;BA BEAT 2P 2MTS BN;DORMITORIO
10006917;;F;58;CHILENO;;Boomers;PLACILLA                      ;L.G.B.OÂ´HIGGINS;768060;5;2;5;2;768060;0;0;0;CLOSET 6 PUERTAS 2 CAJONES FELICCE NOGAL;DORMITORIO
15517320;;M;39;CHILENO;;X;N/D;N/D;331680;3;1;3;1;331680;0;0;0;CLOSET ESPANA 6P+4C;DORMITORIO
14906749;Soltero;F;40;CHILENO;;X;PROVIDENCIA                   ;METROPOLITANA;167540;2;1;2;1;167540;0;0;0;COLCHON NEW ENTREE 2P 2MTS;DORMITORIO
19608555;;F;24;CHILENO;;Z;PROVIDENCIA                   ;METROPOLITANA;96980;2;1;2;1;96980;0;0;0;CLOSET MARITTIMA 6P+2C;DORMITORIO
18951189;;F;27;CHILENO;;Z;N/D;N/D;155980;2;1;2;1;155980;0;0;0;COLCHON NEW ORTOPEDIC 2P;DORMITORIO
6806972;;F;71;CHILENO;;Silencioso;OVALLE                        ;COQUIMBO;3990;1;1;0;0;0;1;1;3990;PACK 2 ALMOHADAS C+L;DORMITORIO
19209879;;F;25;CHILENO;;Silencioso;PROVIDENCIA                   ;METROPOLITANA;209980;2;1;2;1;209980;0;0;0;CE EVOLUTION BLACK 2P BD DUAL SIDE;DORMITORIO
9105502;;F;61;CHILENO;;Boomers;RENCA                         ;METROPOLITANA;269970;3;1;3;1;269970;0;0;0;COLCHON ERGO T 1P;DORMITORIO
14010639;;F;40;CHILENO;;X;PROVIDENCIA                   ;METROPOLITANA;29990;1;1;1;1;29990;0;0;0;PACK 2 ALMOHADAS 100% PLUMA 50 X 70 CM;DORMITORIO
7683102;;F;63;CHILENO;;Boomers;MAIPU                         ;METROPOLITANA;282960;3;1;3;1;282960;0;0;0;DIVAN CAMA ERGO T 1,5P 2 MTS;DORMITORIO
7906453;;F;59;CHILENO;;Boomers;RENCA                         ;METROPOLITANA;26990;1;1;0;0;0;1;1;26990;Almohada Visco Bamboo Classic Pack 60x40 cm;DORMITORIO
26497619;;M;61;VENEZOLANO;;Extranjero;LINARES                       ;MAULE;378550;3;1;0;0;0;3;1;378550;CE EVOLUTION BLACK 2P BN+RESP+2 VEL;DORMITORIO
11231693;;F;54;CHILENO;;Boomers;RANCAGUA                      ;L.G.B.OÂ´HIGGINS;17980;2;1;0;0;0;2;1;17980;ALMOHADA SOFT MICROGEL;DORMITORIO
6313218;;F;71;CHILENO;;Silencioso;CORONEL                       ;BIO BIO;460660;3;1;0;0;0;3;1;460660;COLCHON TERAPEUTIC 2P PILLOW TOP;DORMITORIO
14433711;;F;55;CHILENO;;Boomers;TOCOPILLA                     ;ANTOFAGASTA;169980;2;1;2;1;169980;0;0;0;COLCHON EXCELLENCE PLUS 2P;DORMITORIO
7384571;;F;69;CHILENO;;Silencioso;LINARES                       ;MAULE;7980;2;1;0;0;0;2;1;7980;PACK 2 ALMOHADAS C+L;DORMITORIO
10619898;;F;52;CHILENO;;X;PUNTA ARENAS                  ;MAGALLANES;226980;2;1;2;1;226980;0;0;0;CE EVOLUTION BLACK 1,5P BN RESP+VEL;DORMITORIO
12925185;;M;47;CHILENO;;X;PUENTE ALTO                   ;METROPOLITANA;269980;2;1;0;0;0;2;1;269980;BOX SPRING NEOSENSE FULL BLACK;DORMITORIO
19675795;;F;24;CHILENO;;Silencioso;PROVIDENCIA                   ;METROPOLITANA;285980;2;1;2;1;285980;0;0;0;DIVAN CAMA ERGO T 1,5P 2 MTS;DORMITORIO
14572624;;M;47;CHILENO;;X;PUERTO MONTT                  ;LOS LAGOS;3990;1;1;0;0;0;1;1;3990;PACK 2 ALMOHADAS C+L;DORMITORIO
13530258;;F;43;CHILENO;;X;PROVIDENCIA                   ;METROPOLITANA;12990;1;1;0;0;0;1;1;12990;Almohada Bamboo Classic 70x40;DORMITORIO
8527134;;F;64;CHILENO;;Boomers;LINARES                       ;MAULE;23940;6;1;0;0;0;6;1;23940;PACK 2 ALMOHADAS C+L;DORMITORIO
10394183;;M;55;CHILENO;;Boomers;PROVIDENCIA                   ;METROPOLITANA;339990;2;1;2;1;339990;0;0;0;BOX AM BEAT 2PLBN + Respaldo + 2 Vel TABOR;DORMITORIO
19344514;Soltero;M;26;CHILENO;;Silencioso;N/D;N/D;16980;2;1;0;0;0;2;1;16980;ALMOHADA ROSEN SOFT PLUS AMERICANA;DORMITORIO
15633413;;M;39;CHILENO;;Silencioso;PROVIDENCIA                   ;METROPOLITANA;639980;2;1;2;1;639980;0;0;0;CE DRIVEN 2P 2MT BD;DORMITORIO
8786039;;F;65;CHILENO;;Boomers;TALCA                         ;MAULE;242970;2;1;0;0;0;2;1;242970;COLCHON NEW ORTOPEDIC 1,5P;DORMITORIO
7973604;;M;65;CHILENO;;Boomers;VILLARICA                     ;ARAUCANIA;189990;1;1;0;0;0;1;1;189990;CE EVOLUTION BLACK 1,5P BN RESP+VEL;DORMITORIO
8063527;;M;65;CHILENO;;Boomers;RENCA                         ;METROPOLITANA;275670;2;1;0;0;0;2;1;275670;BOX AMERICANO MIRAGE 2PBN;DORMITORIO
19067768;;F;27;CHILENO;;Z;PROVIDENCIA                   ;METROPOLITANA;223980;2;1;2;1;223980;0;0;0;CAMA EUROPEA EXCELLENCE 2P BASE NORMAL +2ALM;DORMITORIO
5937608;;F;72;CHILENO;;Silencioso;RENCA                         ;METROPOLITANA;7980;2;1;0;0;0;2;1;7980;PACK 2 ALMOHADAS C+L;DORMITORIO
9986892;;M;57;CHILENO;;Boomers;MONTE PATRIA                  ;COQUIMBO;237870;2;1;0;0;0;2;1;237870;CE EVOLUTION BLACK 1,5P BN RESP+VEL;DORMITORIO
14306466;Soltero;F;47;CHILENO;;X;RENCA                         ;METROPOLITANA;12990;1;1;0;0;0;1;1;12990;Almohada Bamboo Classic 70x40;DORMITORIO
16231836;;F;36;CHILENO;;Millenial;PROVIDENCIA                   ;METROPOLITANA;-10990;-1;1;-1;1;-10990;0;0;0;SET SABANA MICROFIBRA MUSTARD 2P;DORMITORIO
11615105;;F;52;CHILENO;;X;LOS ANGELES                   ;BIO BIO;0;0;0;0;0;0;0;0;0;COLCHON SPRING III 1P;DORMITORIO
13253399;Casado;F;44;CHILENO;ARQUITECTO;X;CANETE                        ;BIO BIO;0;0;0;0;0;0;0;0;0;COLCHON EXCELLENCE PLUS 1,5P;DORMITORIO
12531075;;F;49;CHILENO;;X;VINA DEL MAR                  ;VALPARAISO;0;0;0;0;0;0;0;0;0;PACK ALMOHADA VISCO ELASTICA CANNABIS 60X40CM;DORMITORIO
10559953;;M;56;CHILENO;;Boomers;RENCA                         ;METROPOLITANA;0;0;0;0;0;0;0;0;0;COLCHON SPRING III 1P;DORMITORIO
7606736;;M;64;CHILENO;;Boomers;CONSTITUCION                  ;MAULE;0;0;0;0;0;0;0;0;0;COLCHON EXCELLENCE 1,5P;DORMITORIO
16189940;;F;37;CHILENO;;Silencioso;PROVIDENCIA                   ;METROPOLITANA;0;0;0;0;0;0;0;0;0;CAMA EUROPEA EXCELLENCE PLUS 1.5 PLAZA;DORMITORIO
13408832;;F;44;CHILENO;;X;CASTRO                        ;LOS LAGOS;0;0;0;0;0;0;0;0;0;SET 2 ALMOHADAS VISCO MEDIUM 60X40 CM;DORMITORIO
25712305;;F;45;VENEZOLANO;;Extranjero;SANTIAGO                      ;METROPOLITANA;0;0;0;0;0;0;0;0;0;ALMOHADA SOFT MICROGEL;DORMITORIO
14564136;;F;44;CHILENO;;X;LOS LAGOS                     ;LOS LAGOS;0;0;0;0;0;0;0;0;0;PACK 2 ALMOHADAS C+L;DORMITORIO
19196129;;M;26;CHILENO;;Silencioso;PROVIDENCIA                   ;METROPOLITANA;0;0;0;0;0;0;0;0;0;CE NEW STYLE 2 2P 2MT BD;DORMITORIO
17758660;;F;31;CHILENO;;Millenial;PROVIDENCIA                   ;METROPOLITANA;0;0;0;0;0;0;0;0;0;CE ERGO T 2P 2MT BD;DORMITORIO
6012858;;M;69;CHILENO;;Silencioso;PROVIDENCIA                   ;METROPOLITANA;0;0;0;0;0;0;0;0;0;PACK 2 ALMOHADAS C+L;DORMITORIO
10839218;;F;53;CHILENO;;X;RENCA                         ;METROPOLITANA;0;0;0;0;0;0;0;0;0;Almohada Bamboo Classic 70x40;DORMITORIO
17892102;;F;31;CHILENO;;Millenial;QUEILEN                       ;LOS LAGOS;0;0;0;0;0;0;0;0;0;Almohada Visco Bamboo Classic Pack 60x40 cm;DORMITORIO
20500146;;M;22;CHILENO;;Z;PROVIDENCIA                   ;METROPOLITANA;0;0;0;0;0;0;0;0;0;Almohada Bamboo Classic 70x40;DORMITORIO
15794989;Soltero;M;36;CHILENO;;Millenial;PUERTO MONTT                  ;LOS LAGOS;0;0;0;0;0;0;0;0;0;BOX AMERICANO EXCELLENCE 2P BASE NORMAL;DORMITORIO
16976637;;M;34;CHILENO;;Millenial;MAIPU                         ;METROPOLITANA;0;0;0;0;0;0;0;0;0;CE ERGO T 2P 2MT BD;DORMITORIO
9458945;;M;60;CHILENO;;Boomers;PROVIDENCIA                   ;METROPOLITANA;0;0;0;0;0;0;0;0;0;COLCHON SPRING III 1P;DORMITORIO
19716769;;F;24;CHILENO;;Z;PROVIDENCIA                   ;METROPOLITANA;0;0;0;0;0;0;0;0;0;ALMOHADA SOFT MICROGEL;DORMITORIO
8685119;Casado;F;60;CHILENO;;Boomers;RENCA                         ;METROPOLITANA;0;0;0;0;0;0;0;0;0;Almohada Bamboo Classic 70x40;DORMITORIO
17992730;;F;30;CHILENO;;Millenial;SANTIAGO                      ;METROPOLITANA;0;0;0;0;0;0;0;0;0;PACK 2 ALMOHADAS C+L;DORMITORIO
11396651;Casado;M;53;CHILENO;;X;RENCA                         ;METROPOLITANA;0;0;0;0;0;0;0;0;0;BOX AMERICANO BEAT 1,5P;DORMITORIO
15144955;;F;40;CHILENO;;X;PROVIDENCIA                   ;METROPOLITANA;0;0;0;0;0;0;0;0;0;CAMA EUROPEA GRIS NEW ENTREE 1,5P;DORMITORIO
14093234;;F;40;CHILENO;;X;N/D;N/D;0;0;0;0;0;0;0;0;0;SET SABANA MICROFIBRA ROUGE 1,5P;DORMITORIO
19036752;Soltero;F;27;CHILENO;;Silencioso;PROVIDENCIA                   ;METROPOLITANA;0;0;0;0;0;0;0;0;0;Cama Tempo King + Resp + 2 Vel Grafito;DORMITORIO
13959911;;F;41;CHILENO;;X;"";"";0;0;0;0;0;0;0;0;0;ALMOHADA SOFT MICROGEL;DORMITORIO
13625887;;M;42;CHILENO;;X;SAN PEDRO DE LA PAZ           ;BIO BIO;0;0;0;0;0;0;0;0;0;DIVAN CAMA ERGO T 1,5P 2 MTS;DORMITORIO
13349085;;M;43;CHILENO;;X;SAN FERNANDO                  ;L.G.B.OÂ´HIGGINS;0;0;0;0;0;0;0;0;0;ALMOHADA SOFT MICROGEL;DORMITORIO
18609245;Soltero;F;28;CHILENO;;Millenial;PROVIDENCIA                   ;METROPOLITANA;0;0;0;0;0;0;0;0;0;COLCHON BALANCE 2P;DORMITORIO
15946149;;M;37;CHILENO;;Millenial;CURICO                        ;MAULE;0;0;0;0;0;0;0;0;0;PACK 2 ALMOHADAS C+L;DORMITORIO
8193657;;F;63;CHILENO;;Boomers;VINA DEL MAR                  ;VALPARAISO;0;0;0;0;0;0;0;0;0;CAMA EUROPEA GRIS NEW ENTREE 1,5P;DORMITORIO
18893794;;M;27;CHILENO;;Z;MAULE                         ;MAULE;0;0;0;0;0;0;0;0;0;CAMA EUROPEA EXCELLENCE PLUS 2 PLAZAS BD;DORMITORIO
10680449;;F;57;CHILENO;;Boomers;SAN FELIPE                    ;VALPARAISO;0;0;0;0;0;0;0;0;0;CE BAMBOO 2PBD BAMBOO+RES+2V ALICANTE;DORMITORIO
10726904;;F;55;CHILENO;;Boomers;SAN CARLOS                    ;BIO BIO;0;0;0;0;0;0;0;0;0;PACK 2 ALMOHADAS C+L;DORMITORIO
9703873;;F;57;CHILENO;;Silencioso;"";"";0;0;0;0;0;0;0;0;0;CE EVOLUTION BLACK 1,5P + RESPALDO CASTILLA;DORMITORIO
20446940;;M;22;CHILENO;;Extranjero;PROVIDENCIA                   ;METROPOLITANA;0;0;0;0;0;0;0;0;0;COLCHON NEW ORTOPEDIC 1,5P;DORMITORIO
17054338;;F;33;CHILENO;;Millenial;PROVIDENCIA                   ;METROPOLITANA;0;0;0;0;0;0;0;0;0;ALMOHADA BAMBOO TECH SERIES 65X45 CM;DORMITORIO
19105700;;F;27;CHILENO;;Z;PROVIDENCIA                   ;METROPOLITANA;0;0;0;0;0;0;0;0;0;CLOSET M-803 3P 2C ALTO 1,82 BLANCO NATURAL;DORMITORIO
17790892;;M;31;CHILENO;;Millenial;CONCON                        ;VALPARAISO;0;0;0;0;0;0;0;0;0;COLCHON SPRING III 1P;DORMITORIO
12259846;;M;49;CHILENO;;Millenial;N/D;N/D;0;0;0;0;0;0;0;0;0;PACK 2 ALMOHADAS C+L;DORMITORIO
15942181;;M;37;CHILENO;;Millenial;COPIAPO                       ;ATACAMA;0;0;0;0;0;0;0;0;0;CE EVEREST 2P 2MTS BD DUAL SIDE;DORMITORIO
7543625;;F;66;CHILENO;;Boomers;LA PINTANA                    ;METROPOLITANA;0;0;0;0;0;0;0;0;0;SET SABANA MICROFIBRA BLUE 2P;DORMITORIO
10802773;Casado;F;54;CHILENO;LABORATORISTA DENTAL;Boomers;PROVIDENCIA                   ;METROPOLITANA;0;0;0;0;0;0;0;0;0;COLCHON NEW STYLE 4 2P;DORMITORIO
18736159;Soltero;F;27;CHILENO;;Millenial;PROVIDENCIA                   ;METROPOLITANA;0;0;0;0;0;0;0;0;0;CE EVOLUTION BLACK 2P BD DUAL SIDE;DORMITORIO
18694338;;F;28;CHILENO;;Millenial;VALPARAISO                    ;VALPARAISO;0;0;0;0;0;0;0;0;0;SET SABANA MICROFIBRA BLUE 2P;DORMITORIO
18288962;;F;29;CHILENO;;Millenial;VALDIVIA                      ;LOS LAGOS;0;0;0;0;0;0;0;0;0;CAMA NIDO EVOLUTION BLACK 1,5P;DORMITORIO
18810479;;F;27;CHILENO;;Millenial;N/D;N/D;0;0;0;0;0;0;0;0;0;ALMOHADA SOFT MICROGEL;DORMITORIO
19264166;;F;25;CHILENO;;Z;PROVIDENCIA                   ;METROPOLITANA;0;0;0;0;0;0;0;0;0;CE EVOLUTION BLACK 1,5P BN DUAL SIDE;DORMITORIO
12748498;;M;46;CHILENO;;X;VALDIVIA                      ;LOS LAGOS;0;0;0;0;0;0;0;0;0;CLOSET ARICA TV 32 M302 TEXTURADO CASTANO;DORMITORIO
12874197;;F;47;CHILENO;;Silencioso;PROVIDENCIA                   ;METROPOLITANA;0;0;0;0;0;0;0;0;0;CLOSET MARITTIMA 6P+2C;DORMITORIO
18145692;;M;38;CHILENO;;X;PROVIDENCIA                   ;METROPOLITANA;0;0;0;0;0;0;0;0;0;DIVAN CAMA ERGO T 1,5P 2 MTS;DORMITORIO
19051146;Soltero;M;27;CHILENO;;Z;PROVIDENCIA                   ;METROPOLITANA;0;0;0;0;0;0;0;0;0;BOX AMERICANO EXCELLENCE 1.5 PLAZA + ALM;DORMITORIO
16911454;;M;33;CHILENO;;Millenial;MAIPU                         ;METROPOLITANA;0;0;0;0;0;0;0;0;0;COLCHON EXCELLENCE PLUS 1P;DORMITORIO
9872365;;F;56;CHILENO;;Boomers;PAINE                         ;METROPOLITANA;0;0;0;0;0;0;0;0;0;ALMOHADA SOFT MICROGEL;DORMITORIO
13553338;;F;42;CHILENO;;X;N/D;N/D;0;0;0;0;0;0;0;0;0;BA BEAT 2P 2MTS BN;DORMITORIO
17655558;;F;31;CHILENO;;Millenial;CALAMA                        ;ANTOFAGASTA;0;0;0;0;0;0;0;0;0;COLCHON SPRING III 1P;DORMITORIO
13641868;;M;42;CHILENO;;X;ANTOFAGASTA                   ;ANTOFAGASTA;0;0;0;0;0;0;0;0;0;CAMA NIDO EVOLUTION BLACK 1,5P;DORMITORIO
15934654;;M;37;CHILENO;;Millenial;PROVIDENCIA                   ;METROPOLITANA;0;0;0;0;0;0;0;0;0;CLOSET CROACIA BLANCO 4P;DORMITORIO
18757108;;M;28;CHILENO;;Millenial;N/D;N/D;0;0;0;0;0;0;0;0;0;PACK 2 ALMOHADAS C+L;DORMITORIO
8829460;Casado;M;61;CHILENO;INGENIERO EN ADMINISTRACION DE EMPRESAS;Boomers;RENCA                         ;METROPOLITANA;0;0;0;0;0;0;0;0;0;CE ERGO T 2P 2MT BD;DORMITORIO
18375326;;F;29;CHILENO;;Millenial;N/D;N/D;0;0;0;0;0;0;0;0;0;CLOSET NIZA 6P+2C;DORMITORIO
11086384;;F;56;CHILENO;;Boomers;VALDIVIA                      ;LOS RIOS;0;0;0;0;0;0;0;0;0;COLCHON EXCELLENCE 2P;DORMITORIO
18810960;Soltero;M;27;CHILENO;;Silencioso;PROVIDENCIA                   ;METROPOLITANA;0;0;0;0;0;0;0;0;0;CAMA EURO GRIS NEW ENTREE-D 2PBD;DORMITORIO
18168884;;F;29;CHILENO;;Millenial;"";"";0;0;0;0;0;0;0;0;0;SET SABANA MICROFIBRA SAND 2P;DORMITORIO
19752678;;M;25;CHILENO;;Silencioso;PROVIDENCIA                   ;METROPOLITANA;0;0;0;0;0;0;0;0;0;COLCHON NEW STYLE 2 1,5P;DORMITORIO
16087334;;F;36;CHILENO;;Millenial;PROVIDENCIA                   ;METROPOLITANA;0;0;0;0;0;0;0;0;0;BOX AMERICANO EXCELLENCE PLUS 1.5 PLAZA+ ALM;DORMITORIO
7359654;;M;65;CHILENO;;Boomers;ANTOFAGASTA                   ;ANTOFAGASTA;0;0;0;0;0;0;0;0;0;CE BAMBOO 2PBD BAMBOO+RES+2V ALICANTE;DORMITORIO
19322214;;F;25;CHILENO;;Silencioso;PROVIDENCIA                   ;METROPOLITANA;0;0;0;0;0;0;0;0;0;CE EVOLUTION BLACK 1,5P BN DUAL SIDE;DORMITORIO
9816079;;M;59;CHILENO;;Boomers;N/D;N/D;0;0;0;0;0;0;0;0;0;BA EXCELLENCE 2P BN +RESP+2VEL OLMO +2ALM+PL;DORMITORIO
15825690;;F;38;CHILENO;;Millenial;PROVIDENCIA                   ;METROPOLITANA;0;0;0;0;0;0;0;0;0;CE BAMBOO 2P BD FIBRAS BAMBOO DUAL SIDE;DORMITORIO
16334207;;F;35;CHILENO;;Millenial;PROVIDENCIA                   ;METROPOLITANA;0;0;0;0;0;0;0;0;0;PACK 2 ALMOHADAS C+L;DORMITORIO
18230340;;M;29;CHILENO;;Millenial;LEBU                          ;BIO BIO;0;0;0;0;0;0;0;0;0;COLCHON NEW ORTOPEDIC 1,5P;DORMITORIO
15501857;;M;39;CHILENO;;X;PROVIDENCIA                   ;METROPOLITANA;0;0;0;0;0;0;0;0;0;BOX AMERICANO EXCELLENCE 2P BN +2ALM+PLU;DORMITORIO
18543587;;M;28;CHILENO;;Millenial;SAN BERNARDO                  ;METROPOLITANA;0;0;0;0;0;0;0;0;0;CAMA NIDO EVOLUTION BLACK 1,5P;DORMITORIO
16363442;;F;35;CHILENO;;Millenial;PUNTA ARENAS                  ;MAGALLANES;0;0;0;0;0;0;0;0;0;DIVAN NEW ORTOPEDIC 1,5P BLACK;DORMITORIO
11308234;;M;54;CHILENO;;X;OSORNO                        ;LOS LAGOS;0;0;0;0;0;0;0;0;0;CE EVOLUTION BLACK 1,5P + RESPALDO CASTILLA;DORMITORIO
25054432;;F;49;PERUANO;;Extranjero;N/D;N/D;0;0;0;0;0;0;0;0;0;SET 2 ALMOHADAS VISCO MEDIUM 60X40 CM;DORMITORIO
15061545;;F;39;CHILENO;;X;RENCA                         ;METROPOLITANA;0;0;0;0;0;0;0;0;0;CE ORTOPEDIC ADVANCE 2PBN;DORMITORIO
18625830;;M;28;CHILENO;;Millenial;PROVIDENCIA                   ;METROPOLITANA;0;0;0;0;0;0;0;0;0;COLCHON NEW ORTOPEDIC 1P;DORMITORIO
18689346;;F;28;CHILENO;;Millenial;PROVIDENCIA                   ;METROPOLITANA;0;0;0;0;0;0;0;0;0;CAMA NIDO EVOLUTION BLACK 1,5P;DORMITORIO
15179331;Casado;F;39;CHILENO;;X;PROVIDENCIA                   ;METROPOLITANA;0;0;0;0;0;0;0;0;0;ALMOHADA VISCO SLEEP TECH SERIES 65X45 CM;DORMITORIO
17684267;Soltero;F;32;CHILENO;;Millenial;PROVIDENCIA                   ;METROPOLITANA;0;0;0;0;0;0;0;0;0;DUPLEX BA EXCELLENCE 1 PLAZA +RESP+VEL OLMO;DORMITORIO
16468700;Soltero;F;35;CHILENO;NUTRICIONISTA;Millenial;RENCA                         ;METROPOLITANA;0;0;0;0;0;0;0;0;0;Closet TRANCURA 6PT 2CJ 156 CM CEREZO;DORMITORIO
16553660;;M;35;CHILENO;;Millenial;SAN PEDRO DE LA PAZ           ;BIO BIO;0;0;0;0;0;0;0;0;0;COLCHON NEW STYLE 4 2P 150X200;DORMITORIO
17843008;;F;31;CHILENO;;Millenial;N/D;N/D;0;0;0;0;0;0;0;0;0;BOX AMERICANO EXCELLENCE 1.5 PLAZA + ALM+PL;DORMITORIO
19444629;Soltero;M;25;CHILENO;;Z;PROVIDENCIA                   ;METROPOLITANA;0;0;0;0;0;0;0;0;0;CLOSET CAJONERA NEW BELGICA M-398-NW;DORMITORIO
17526168;;F;30;CHILENO;;Millenial;LAS CABRAS;O HIGGINS;0;0;0;0;0;0;0;0;0;SET SABANA MICROFIBRA BLUE 1,5P;DORMITORIO
18521293;Soltero;F;29;CHILENO;;Silencioso;PROVIDENCIA                   ;METROPOLITANA;0;0;0;0;0;0;0;0;0;CE NEW STYLE 6 2P 2MT BD;DORMITORIO
15129842;;F;39;CHILENO;;X;CURICO                        ;MAULE;0;0;0;0;0;0;0;0;0;ESCRITORIO 2 CJ ECLIPSE;DORMITORIO
16686802;Soltero;F;35;CHILENO;PROFESOR;Millenial;PROVIDENCIA                   ;METROPOLITANA;0;0;0;0;0;0;0;0;0;CE EVOLUTION BLACK 1,5P + RESPALDO CASTILLA;DORMITORIO
18530848;;M;28;CHILENO;;Millenial;SANTIAGO                      ;METROPOLITANA;0;0;0;0;0;0;0;0;0;COLCHON TERAPEUTIC 1,5P PILLOW TOP;DORMITORIO
16162650;;F;36;CHILENO;;Millenial;LOS VILOS;COQUIMBO;0;0;0;0;0;0;0;0;0;COLCHON ORTOPEDIC ADVANCE 2P;DORMITORIO
16688975;;F;34;CHILENO;;Millenial;PROVIDENCIA                   ;METROPOLITANA;0;0;0;0;0;0;0;0;0;BA EXCELLENCE 1.5P +RESP+VEL OLMO +ALM+PL;DORMITORIO
18798025;;F;28;CHILENO;;Millenial;PROVIDENCIA                   ;METROPOLITANA;0;0;0;0;0;0;0;0;0;CE ERGO T 2P 2MT BD;DORMITORIO
18115032;;F;30;CHILENO;;Silencioso;PROVIDENCIA                   ;METROPOLITANA;0;0;0;0;0;0;0;0;0;COLCHON NEW ORTOPEDIC 1,5 105X200;DORMITORIO
15005592;;M;40;CHILENO;;X;PROVIDENCIA                   ;METROPOLITANA;0;0;0;0;0;0;0;0;0;SET 2 ALMOHADAS VISCO MEDIUM 60X40 CM;DORMITORIO
19000611;Soltero;M;27;CHILENO;PROFESOR;Silencioso;PROVIDENCIA                   ;METROPOLITANA;0;0;0;0;0;0;0;0;0;SILLA ESCRITORIO MANCHESTER;DORMITORIO
11736906;;F;50;CHILENO;;X;N/D;N/D;0;0;0;0;0;0;0;0;0;CLOSET CROACIA BLANCO 4P;DORMITORIO
18525504;;M;28;CHILENO;;Millenial;PROVIDENCIA                   ;METROPOLITANA;0;0;0;0;0;0;0;0;0;CAMA EUROPEA EXCELLENCE 2 PLAZAS BASE NORMAL;DORMITORIO
7136226;;F;65;CHILENO;;Boomers;CALAMA                        ;ANTOFAGASTA;0;0;0;0;0;0;0;0;0;DIVAN CAMA ERGO T 1,5P 2 MTS;DORMITORIO
20316716;;M;22;CHILENO;;Z;RENCA                         ;METROPOLITANA;0;0;0;0;0;0;0;0;0;CLOSET NIZA 6P+2C;DORMITORIO
19757750;;M;24;CHILENO;;Z;PENALOLEN                     ;METROPOLITANA;0;0;0;0;0;0;0;0;0;CE EVOLUTION BLACK 2P BD DUAL SIDE;DORMITORIO
13693917;;M;43;CHILENO;;Millenial;PROVIDENCIA                   ;METROPOLITANA;0;0;0;0;0;0;0;0;0;CLOSET CONCEPCION TV49 M-402 CASTANO / AVELLANA;DORMITORIO
9603160;;M;57;CHILENO;;Silencioso;PROVIDENCIA                   ;METROPOLITANA;0;0;0;0;0;0;0;0;0;CLOSET MARITTIMA 6P+2C;DORMITORIO
10188798;;F;58;CHILENO;;Boomers;PROVIDENCIA                   ;METROPOLITANA;0;0;0;0;0;0;0;0;0;BA EXCELLENCE PLUS 2P BD +RESP+VEL OLMO;DORMITORIO
10723520;;M;55;CHILENO;;Boomers;SAN MIGUEL                    ;METROPOLITANA;0;0;0;0;0;0;0;0;0;COLCHON EXCELLENCE PLUS 2P;DORMITORIO
15172103;;F;38;CHILENO;;Silencioso;PROVIDENCIA                   ;METROPOLITANA;0;0;0;0;0;0;0;0;0;CE EVOLUTION BLACK 2P BD DUAL SIDE;DORMITORIO
17260598;;F;33;CHILENO;;Millenial;PROVIDENCIA                   ;METROPOLITANA;0;0;0;0;0;0;0;0;0;CAMAROTE TRIPLE CORINA CAFE OSCURO;DORMITORIO
20154445;;F;23;CHILENO;;Silencioso;PROVIDENCIA                   ;METROPOLITANA;0;0;0;0;0;0;0;0;0;CE EVOLUTION BLACK 2P BD DUAL SIDE;DORMITORIO
16497099;;F;35;CHILENO;;Millenial;PROVIDENCIA                   ;METROPOLITANA;0;0;0;0;0;0;0;0;0;ALMOHADA SOFT MICROGEL;DORMITORIO
9293892;;F;64;CHILENO;;Boomers;VALPARAISO                    ;VALPARAISO;0;0;0;0;0;0;0;0;0;DUPLEX CE EVOLUTION BLACK 1P + 2 RESP + VEL ASTU;DORMITORIO
14783021;;M;30;EXTRANJERO - NO INFORMA NACIONALIDAD;;Millenial;CONCON;VALPARAISO;0;0;0;0;0;0;0;0;0;Cama Tempo 2PBD;DORMITORIO
18592852;;F;28;CHILENO;;Millenial;PROVIDENCIA                   ;METROPOLITANA;0;0;0;0;0;0;0;0;0;COLCHON IBIZA 2P;DORMITORIO
20236734;;F;23;CHILENO;;Z;PROVIDENCIA                   ;METROPOLITANA;0;0;0;0;0;0;0;0;0;BS ORTOPEDIC ADVANCE B5 BLACK 2PBD;DORMITORIO
17818926;;F;31;CHILENO;;Millenial;PROVIDENCIA                   ;METROPOLITANA;0;0;0;0;0;0;0;0;0;Cama Tempo King + Resp + 2 Vel Grafito;DORMITORIO
13346016;Casado;M;43;CHILENO;;X;PEUMO                         ;L.G.B.OÂ´HIGGINS;0;0;0;0;0;0;0;0;0;CLOSET ARICA TV 32 M302 TEXTURADO CASTANO;DORMITORIO
17452737;;F;32;CHILENO;;Millenial;PROVIDENCIA                   ;METROPOLITANA;0;0;0;0;0;0;0;0;0;CLOSET CABURGUA 2 PT CORREDERA WALNUT;DORMITORIO
13100598;;F;46;CHILENO;;X;RENCA                         ;METROPOLITANA;0;0;0;0;0;0;0;0;0;CE ERGO T 2P 2MT BD;DORMITORIO
16186283;;M;37;CHILENO;;Millenial;RENCA                         ;METROPOLITANA;0;0;0;0;0;0;0;0;0;COLCHON EXCELLENCE 2 PLAZA + 2 ALM;DORMITORIO
17845356;;F;30;CHILENO;;Millenial;TALCAHUANO                    ;BIO BIO;0;0;0;0;0;0;0;0;0;CE EXCELLENCE PLUS 2P BD+RESP+2VEL NEW DUBLIN;DORMITORIO
18231319;;F;29;CHILENO;;Millenial;PROVIDENCIA                   ;METROPOLITANA;0;0;0;0;0;0;0;0;0;Colchon Resortes Evolution 1.5P + Almohada Imper;DORMITORIO
10596888;;F;54;CHILENO;;X;ANTOFAGASTA                   ;ANTOFAGASTA;0;0;0;0;0;0;0;0;0;CE EVOLUTION BLACK 2P BD DUAL SIDE;DORMITORIO
13292152;;M;45;CHILENO;;X;MAIPU                         ;METROPOLITANA;0;0;0;0;0;0;0;0;0;CLOSET ESPANA 6P+4C;DORMITORIO
12828895;;F;47;CHILENO;;X;RENCA                         ;METROPOLITANA;0;0;0;0;0;0;0;0;0;ALMOHADA ROSEN SOFT PLUS AMERICANA;DORMITORIO
19654003;;F;24;CHILENO;;Z;PROVIDENCIA                   ;METROPOLITANA;0;0;0;0;0;0;0;0;0;CLOSET NIZA 6P+2C;DORMITORIO
19729445;;F;25;CHILENO;;Z;PROVIDENCIA                   ;METROPOLITANA;0;0;0;0;0;0;0;0;0;Pack Veladores Italia Cedro/Pinus;DORMITORIO
16577513;;M;33;CHILENO;;Millenial;N/D;N/D;0;0;0;0;0;0;0;0;0;COLCHON NEW ORTOPEDIC 2P;DORMITORIO
24553013;;F;34;BOLIVIANO;;Extranjero;CALAMA                        ;ANTOFAGASTA;0;0;0;0;0;0;0;0;0;PACK 2 ALMOHADAS 100% PLUMA 50 X 70 CM;DORMITORIO
12012784;;M;48;CHILENO;;X;PROVIDENCIA                   ;METROPOLITANA;0;0;0;0;0;0;0;0;0;DIVAN CAMA ERGO T 1,5P 2 MTS;DORMITORIO
19160638;;M;27;CHILENO;;Z;ANTOFAGASTA                   ;ANTOFAGASTA;0;0;0;0;0;0;0;0;0;CLOSET NIZA 6P+2C;DORMITORIO
16393598;Soltero;M;35;CHILENO;;Millenial;PROVIDENCIA                   ;METROPOLITANA;0;0;0;0;0;0;0;0;0;CAMA EURO GRIS NEW ENTREE-D 2PBD;DORMITORIO
16724577;;F;34;CHILENO;;Millenial;PUENTE ALTO                   ;METROPOLITANA;0;0;0;0;0;0;0;0;0;CLOSET M-803 3P 2C ALTO 1,82 BLANCO NATURAL;DORMITORIO
19353647;;F;26;CHILENO;;Z;LA SERENA                     ;COQUIMBO;0;0;0;0;0;0;0;0;0;Colchon Cuna Extendible 100x60;DORMITORIO
10246815;;M;50;CHILENO;;X;PROVIDENCIA                   ;METROPOLITANA;0;0;0;0;0;0;0;0;0;RESP ITALIA CEDRO 2P CAFE;DORMITORIO
17847700;;M;31;CHILENO;;Millenial;LOS ANGELES                   ;BIO BIO;0;0;0;0;0;0;0;0;0;RACK BELLINI 50;DORMITORIO
8736790;;F;60;CHILENO;;Boomers;PROVIDENCIA                   ;METROPOLITANA;0;0;0;0;0;0;0;0;0;COLCHON ERGO T 1P;DORMITORIO
9558571;;F;64;CHILENO;;Boomers;PUQUELDON                     ;LOS LAGOS;0;0;0;0;0;0;0;0;0;COLCHON NEW ORTOPEDIC 1,5P;DORMITORIO
16356051;;F;36;CHILENO;;Millenial;N/D;N/D;0;0;0;0;0;0;0;0;0;DIVAN NEW ORTOPEDIC 1,5P BLACK;DORMITORIO
18847272;;M;28;CHILENO;;Millenial;MAIPU                         ;METROPOLITANA;0;0;0;0;0;0;0;0;0;SET SABANA MICROFIBRA SAND 2P;DORMITORIO
19654767;;F;28;CHILENO;;Silencioso;PROVIDENCIA                   ;METROPOLITANA;0;0;0;0;0;0;0;0;0;ESCRITORIO ESCOBAR;DORMITORIO
19045679;Soltero;M;27;CHILENO;TECNOLOGO MEDICO;Silencioso;PROVIDENCIA                   ;METROPOLITANA;0;0;0;0;0;0;0;0;0;CAMA EURO GRIS NEW ENTREE-D 2PBD;DORMITORIO
19662133;;M;24;CHILENO;;Z;PROVIDENCIA                   ;METROPOLITANA;0;0;0;0;0;0;0;0;0;COLCHON NEW ORTOPEDIC 2P;DORMITORIO
14048396;;M;41;CHILENO;;X;PROVIDENCIA                   ;METROPOLITANA;0;0;0;0;0;0;0;0;0;CE NEW ORTOPEDIC 1.5P +RESP+1VEL NEW DUBLIN;DORMITORIO
16616277;Soltero;M;35;CHILENO;;Silencioso;PROVIDENCIA                   ;METROPOLITANA;0;0;0;0;0;0;0;0;0;CE EVOLUTION BLACK 1,5P + RESPALDO CASTILLA;DORMITORIO
19317866;;M;26;CHILENO;;Z;"";"";0;0;0;0;0;0;0;0;0;CE EVOLUTION BLACK 2P BD DUAL SIDE;DORMITORIO
10474966;Casado;F;57;CHILENO;;Boomers;PROVIDENCIA                   ;METROPOLITANA;0;0;0;0;0;0;0;0;0;PACK 2 ALMOHADAS C+L;DORMITORIO
16659879;;M;35;CHILENO;;Silencioso;PROVIDENCIA                   ;METROPOLITANA;0;0;0;0;0;0;0;0;0;Pack Veladores Italia Cedro/Pinus;DORMITORIO
9299552;;F;59;CHILENO;;Boomers;RENCA                         ;METROPOLITANA;0;0;0;0;0;0;0;0;0;CLOSET PORTUGAL M225;DORMITORIO
17226966;;F;33;CHILENO;;Millenial;N/D;N/D;0;0;0;0;0;0;0;0;0;CE Cannabis 1,5P + Set Liverpool;DORMITORIO
17992412;Soltero;F;30;CHILENO;PROFESOR;Millenial;PROVIDENCIA                   ;METROPOLITANA;0;0;0;0;0;0;0;0;0;Almohada Viscoelastica Bamboo Pack 60x40 cm;DORMITORIO
19945340;;M;24;CHILENO;;Silencioso;PROVIDENCIA                   ;METROPOLITANA;0;0;0;0;0;0;0;0;0;ESCRITORIO JACK CAFE;DORMITORIO
20529042;;M;22;CHILENO;;Z;RENCA                         ;METROPOLITANA;0;0;0;0;0;0;0;0;0;BOX AMERICANO EXCELLENCE 1.5 PLAZA + ALM;DORMITORIO
19227091;;M;26;CHILENO;;Z;ARICA                         ;TARAPACA;0;0;0;0;0;0;0;0;0;CE EVEREST 2P 2MTS BD DUAL SIDE;DORMITORIO
19708789;;F;24;CHILENO;;Z;N/D;N/D;0;0;0;0;0;0;0;0;0;COLCHON IBIZA 2P;DORMITORIO
20349120;;F;22;CHILENO;;Z;PROVIDENCIA                   ;METROPOLITANA;0;0;0;0;0;0;0;0;0;BS NEW ORTO B5 BCK 2PBD+RESP+2VEL NEW DUB CHO;DORMITORIO
18906172;;F;27;CHILENO;;Millenial;PROVIDENCIA                   ;METROPOLITANA;0;0;0;0;0;0;0;0;0;CE EVOLUTION BLACK 2P BD DUAL SIDE;DORMITORIO
15435605;;M;40;CHILENO;;X;QUEMCHI;LOS LAGOS;0;0;0;0;0;0;0;0;0;CLOSET BALI 8 PUERTAS CAOBA;DORMITORIO
19803138;;F;24;CHILENO;;Silencioso;PROVIDENCIA                   ;METROPOLITANA;0;0;0;0;0;0;0;0;0;Almohada Cooling 65x48 cm;DORMITORIO
13722042;;M;46;CHILENO;;X;MAULE                         ;MAULE;0;0;0;0;0;0;0;0;0;CE BAMBOO 2P BD FIBRAS BAMBOO DUAL SIDE;DORMITORIO
20194059;;F;23;CHILENO;;Z;N/D;N/D;0;0;0;0;0;0;0;0;0;CLOSET CROACIA BLANCO 4P;DORMITORIO
12088488;;M;53;CHILENO;;X;ANTOFAGASTA                   ;ANTOFAGASTA;0;0;0;0;0;0;0;0;0;Divan Colors Night Negro 1,5P + 2 Alm;DORMITORIO
8886511;;M;62;CHILENO;;Boomers;QUILPUE                       ;VALPARAISO;0;0;0;0;0;0;0;0;0;CE EVOLUTION BLACK 1,5P BN RESP+VEL;DORMITORIO
12841979;;M;47;CHILENO;;X;COPIAPO                       ;ATACAMA;0;0;0;0;0;0;0;0;0;DIVAN CAMA ERGO T 1,5P 2MTS+RESP+1 VEL TABOR;DORMITORIO
6679095;;F;67;CHILENO;;Boomers;ANTOFAGASTA                   ;ANTOFAGASTA;0;0;0;0;0;0;0;0;0;COLCHON EXCELLENCE FULL;DORMITORIO
17242583;;F;33;CHILENO;;Millenial;LO PRADO                      ;METROPOLITANA;0;0;0;0;0;0;0;0;0;PACK 2 ALMOHADAS C+L;DORMITORIO
16659542;;M;35;CHILENO;;Millenial;SANTIAGO                      ;METROPOLITANA;0;0;0;0;0;0;0;0;0;CAMAROTE TRIPLE CORINA CAFE CLARO;DORMITORIO
8404073;;F;66;CHILENO;;Boomers;PROVIDENCIA                   ;METROPOLITANA;0;0;0;0;0;0;0;0;0;CLOSET M-803 3P 2C ALTO 1,82 BLANCO NATURAL;DORMITORIO
13255519;;F;47;CHILENO;;X;N/D;N/D;0;0;0;0;0;0;0;0;0;COLCHON EXCELLENCE 1.5 PLAZA + CUBRECOLCHON;DORMITORIO
7809562;;F;66;CHILENO;;Boomers;VICTORIA                      ;ARAUCANIA;0;0;0;0;0;0;0;0;0;CE EVOLUTION BLACK 1P + RESPALDO CASTILLA;DORMITORIO
16930410;;F;33;CHILENO;;Silencioso;PROVIDENCIA                   ;METROPOLITANA;0;0;0;0;0;0;0;0;0;CE EVOLUTION BLACK 1,5P + RESPALDO ASTURIAS;DORMITORIO
7792299;Soltero;M;64;CHILENO;;Boomers;CORONEL                       ;BIO BIO;0;0;0;0;0;0;0;0;0;COLCHON TERAPEUTIC 1,5P PILLOW TOP;DORMITORIO
18061978;Soltero;F;30;CHILENO;PROFESOR;Millenial;PROVIDENCIA                   ;METROPOLITANA;0;0;0;0;0;0;0;0;0;TOCADOR BARBARA;DORMITORIO
13414982;;M;43;CHILENO;;Silencioso;PROVIDENCIA                   ;METROPOLITANA;0;0;0;0;0;0;0;0;0;CE ERGO T 2P 2MT BD;DORMITORIO
18390635;Soltero;F;29;CHILENO;;Silencioso;PROVIDENCIA                   ;METROPOLITANA;0;0;0;0;0;0;0;0;0;BASE AMERICANA SPRING VI 2.0 PL;DORMITORIO
6301824;Casado;F;68;CHILENO;;Millenial;PROVIDENCIA                   ;METROPOLITANA;0;0;0;0;0;0;0;0;0;RACK MURILLO NOGAL;DORMITORIO
9275423;;F;61;CHILENO;;Boomers;COQUIMBO                      ;COQUIMBO;0;0;0;0;0;0;0;0;0;CE ERGO T 2P 2MT BD;DORMITORIO
15351306;;F;39;CHILENO;;Silencioso;PROVIDENCIA                   ;METROPOLITANA;0;0;0;0;0;0;0;0;0;RACK BELLINI 50;DORMITORIO
5386535;;F;77;CHILENO;;Silencioso;PROVIDENCIA                   ;METROPOLITANA;0;0;0;0;0;0;0;0;0;ALMOHADA SOFT MICROGEL;DORMITORIO
16473195;;F;35;CHILENO;;Millenial;MELIPILLA                     ;METROPOLITANA;0;0;0;0;0;0;0;0;0;BOX AMERICANO EXCELLENCE 1.5 PLAZAS;DORMITORIO
19082822;Soltero;F;27;CHILENO;PSICOLOGO;Z;PROVIDENCIA                   ;METROPOLITANA;0;0;0;0;0;0;0;0;0;RACK BELLINI 50;DORMITORIO
8988308;;F;61;CHILENO;;Boomers;CASTRO                        ;LOS LAGOS;0;0;0;0;0;0;0;0;0;CLOSET CAJONERA NEW BELGICA M-398-NW;DORMITORIO
18058560;;F;30;CHILENO;;Millenial;PADRE HURTADO                 ;METROPOLITANA;0;0;0;0;0;0;0;0;0;CE BAMBOO 2P BD FIBRAS BAMBOO DUAL SIDE;DORMITORIO
9318134;Casado;F;59;CHILENO;PROFESOR;Boomers;RENCA                         ;METROPOLITANA;0;0;0;0;0;0;0;0;0;ALMOHADA ROSEN SOFT PLUS AMERICANA;DORMITORIO
19123192;Soltero;M;26;CHILENO;;Z;PROVIDENCIA                   ;METROPOLITANA;0;0;0;0;0;0;0;0;0;CLOSET NIZA 6P+2C;DORMITORIO
16484697;;F;35;CHILENO;;Millenial;"";"";0;0;0;0;0;0;0;0;0;DIVAN CAMA ERGO T 1,5P 2 MTS;DORMITORIO
16835513;;M;33;CHILENO;;Millenial;PROVIDENCIA                   ;METROPOLITANA;0;0;0;0;0;0;0;0;0;ESCRITORIO OFFICE CHOCOLATE;DORMITORIO
14285377;;F;48;CHILENO;;X;PROVIDENCIA                   ;METROPOLITANA;0;0;0;0;0;0;0;0;0;CE EVOLUTION BLACK 2P BD DUAL SIDE;DORMITORIO
13983792;Casado;F;40;CHILENO;;X;PROVIDENCIA                   ;METROPOLITANA;0;0;0;0;0;0;0;0;0;ESCRITORIO COLLEGE CHOCOLATE;DORMITORIO
9598958;;F;57;CHILENO;;Boomers;SAN FELIPE                    ;VALPARAISO;0;0;0;0;0;0;0;0;0;CE EVOLUTION BLACK 1,5P BN DUAL SIDE;DORMITORIO
16883891;Soltero;M;33;CHILENO;;Millenial;RENCA                         ;METROPOLITANA;0;0;0;0;0;0;0;0;0;DUPLEX CE EVOLUTION BLACK 1P + 2 RESP + VEL ASTU;DORMITORIO
18573080;;M;28;CHILENO;;Millenial;TALCA                         ;MAULE;0;0;0;0;0;0;0;0;0;Cama New Style 2PBD + Resp + 2 Vel Ferrara;DORMITORIO
16567861;Soltero;M;35;CHILENO;INGENIERO ELECTRONICO;Millenial;PROVIDENCIA                   ;METROPOLITANA;0;0;0;0;0;0;0;0;0;Almohada Visco Bamboo Classic Pack 60x40 cm;DORMITORIO
9135508;;M;61;CHILENO;;Boomers;PARRAL                        ;MAULE;0;0;0;0;0;0;0;0;0;CE EVOLUTION BLACK 1,5P + RESPALDO CASTILLA;DORMITORIO
15593249;;M;38;CHILENO;;Silencioso;RENCA                         ;METROPOLITANA;0;0;0;0;0;0;0;0;0;DIVAN CAMA ERGO T 1,5P 2 MTS;DORMITORIO
9895336;;F;47;CHILENO;;X;N/D;N/D;0;0;0;0;0;0;0;0;0;COMODA 6 CAJONES LEGNO;DORMITORIO
16003384;;M;37;CHILENO;;Millenial;RENCA                         ;METROPOLITANA;0;0;0;0;0;0;0;0;0;BS ORTO ADVANCE B5 BCK 1.5P+ RESPALDO TIGRIS;DORMITORIO
15953209;;F;37;CHILENO;;Millenial;N/D;N/D;0;0;0;0;0;0;0;0;0;CE EVOLUTION BLACK 2P BD DUAL SIDE;DORMITORIO
12936652;;F;47;CHILENO;;X;OSORNO                        ;LOS LAGOS;0;0;0;0;0;0;0;0;0;COLCHON COTTON ORGANIC 2P 150X200;DORMITORIO
17518661;;F;32;CHILENO;;Millenial;N/D;N/D;0;0;0;0;0;0;0;0;0;CLOSET ESPANA 6P+4C;DORMITORIO
8699497;;F;61;CHILENO;;Boomers;MARIA ELENA                   ;ANTOFAGASTA;0;0;0;0;0;0;0;0;0;BOX AMERICANO EXCELLENCE 1.5 PLAZAS;DORMITORIO
18929036;Soltero;M;27;CHILENO;;Millenial;RENCA                         ;METROPOLITANA;0;0;0;0;0;0;0;0;0;CE EVOLUTION BLACK 1,5P + RESPALDO CASTILLA;DORMITORIO
27330503;;M;27;CHILENO;;Extranjero;PUERTO MONTT                  ;LOS LAGOS;0;0;0;0;0;0;0;0;0;PACK 2 ALMOHADAS C+L;DORMITORIO
17539948;;M;32;CHILENO;;Millenial;POZO ALMONTE                  ;TARAPACA;0;0;0;0;0;0;0;0;0;CE EVOLUTION BLACK 2P BD DUAL SIDE;DORMITORIO
13949017;;F;41;CHILENO;;X;SAN VICENTE                   ;L.G.B.OÂ´HIGGINS;0;0;0;0;0;0;0;0;0;Pack Imperial Soft 45x65 cm.;DORMITORIO
14233348;;F;52;CHILENO;;X;BUIN                          ;METROPOLITANA;0;0;0;0;0;0;0;0;0;PACK 2 ALMOHADAS 100% PLUMA 50 X 70 CM;DORMITORIO
18664207;;M;28;CHILENO;;Millenial;"";"";0;0;0;0;0;0;0;0;0;BOXET ERGO T 2P;DORMITORIO
12976470;;F;46;CHILENO;;X;RENCA                         ;METROPOLITANA;0;0;0;0;0;0;0;0;0;PACK 2 ALMOHADAS C+L;DORMITORIO
13654851;Soltero;M;45;CHILENO;;X;PROVIDENCIA                   ;METROPOLITANA;0;0;0;0;0;0;0;0;0;COLCHON TERAPEUTIC 2P PILLOW TOP;DORMITORIO
11998412;;F;50;CHILENO;;X;CURICO                        ;MAULE;0;0;0;0;0;0;0;0;0;PACK 2 ALMOHADAS C+L;DORMITORIO
16436102;;F;36;CHILENO;;Millenial;PROVIDENCIA                   ;METROPOLITANA;0;0;0;0;0;0;0;0;0;BOXET ERGO T 1,5 P;DORMITORIO
7654044;;F;64;CHILENO;;Boomers;QUILICURA                     ;METROPOLITANA;0;0;0;0;0;0;0;0;0;Cama Driven King;DORMITORIO
8631184;;F;61;CHILENO;;Boomers;COQUIMBO                      ;COQUIMBO;0;0;0;0;0;0;0;0;0;CE BAMBOO 2P BD FIBRAS BAMBOO DUAL SIDE;DORMITORIO
6322977;Casado;F;70;CHILENO;AUXILIAR PARAMEDICO DE ENFERMERIA;Silencioso;RENCA                         ;METROPOLITANA;0;0;0;0;0;0;0;0;0;SET 2 ALMOHADAS VISCO MEDIUM 60X40 CM;DORMITORIO
4959505;Soltero;M;75;CHILENO;ADMINISTRADOR PUBLICO;Silencioso;PROVIDENCIA                   ;METROPOLITANA;0;0;0;0;0;0;0;0;0;COMODA POLUX 8CJNS CEREZO;DORMITORIO
20054295;;F;23;CHILENO;;Extranjero;PROVIDENCIA                   ;METROPOLITANA;0;0;0;0;0;0;0;0;0;COLCHON SPRING III 1P;DORMITORIO
18152946;;F;29;CHILENO;;Millenial;N/D;N/D;0;0;0;0;0;0;0;0;0;COLCHON SPRING III 1P;DORMITORIO
18523501;;F;29;CHILENO;;Millenial;N/D;N/D;0;0;0;0;0;0;0;0;0;PACK 2 ALMOHADAS C+L;DORMITORIO
18750029;;F;27;CHILENO;;Extranjero;"";"";0;0;0;0;0;0;0;0;0;Almohada Imperial Soft 50x70 cm;DORMITORIO
10763213;;F;54;CHILENO;;Boomers;PROVIDENCIA                   ;METROPOLITANA;0;0;0;0;0;0;0;0;0;PACK 2 ALMOHADAS C+L;DORMITORIO
16879941;;F;34;CHILENO;;Millenial;DONIHUE                       ;L.G.B.OÂ´HIGGINS;0;0;0;0;0;0;0;0;0;SET 2 ALMOHADAS VISCO MEDIUM 60X40 CM;DORMITORIO
16005946;;M;37;CHILENO;;Millenial;PROVIDENCIA                   ;METROPOLITANA;0;0;0;0;0;0;0;0;0;PACK 2 ALMOHADAS C+L;DORMITORIO
10198091;;F;55;CHILENO;;Boomers;PROVIDENCIA                   ;METROPOLITANA;0;0;0;0;0;0;0;0;0;CLOSET ESPANA 6P+4C;DORMITORIO
15062928;;F;40;CHILENO;;X;LA CRUZ                       ;VALPARAISO;0;0;0;0;0;0;0;0;0;BS NEW ORTOPEDIC B5 BLACK 2PBN;DORMITORIO
9137611;Casado;F;62;CHILENO;;Boomers;PROVIDENCIA                   ;METROPOLITANA;0;0;0;0;0;0;0;0;0;CAMA EURO GRIS NEW ENTREE-H FULL BOX;DORMITORIO
14602917;;F;54;ARGENTINO;;Extranjero;PUENTE ALTO                   ;METROPOLITANA;0;0;0;0;0;0;0;0;0;PACK 2 ALMOHADAS C+L;DORMITORIO
6684836;;F;68;CHILENO;;Boomers;LA SERENA                     ;COQUIMBO;0;0;0;0;0;0;0;0;0;CE ERGO T 2P 2MT BD;DORMITORIO
6189559;;F;75;CHILENO;;Silencioso;N/D;N/D;0;0;0;0;0;0;0;0;0;CE NEW ORTOPEDIC 2PBD +RESP+2VEL NEW DUBLIN;DORMITORIO
19950252;;F;24;CHILENO;;Z;PROVIDENCIA                   ;METROPOLITANA;0;0;0;0;0;0;0;0;0;CLOSET NEWCAPRI M-330 AVELLANA/CARVALHO4P3C+ESPE;DORMITORIO
19346238;Soltero;M;26;CHILENO;;Z;PROVIDENCIA                   ;METROPOLITANA;0;0;0;0;0;0;0;0;0;CE EVOLUTION BLACK 1,5P + RESPALDO CASTILLA;DORMITORIO
6463033;;M;71;CHILENO;;Silencioso;TALCAHUANO                    ;BIO BIO;0;0;0;0;0;0;0;0;0;CE EVOLUTION BLACK 1,5P BN RESP+VEL;DORMITORIO
17481429;Soltero;F;31;CHILENO;;Millenial;PROVIDENCIA                   ;METROPOLITANA;0;0;0;0;0;0;0;0;0;CLOSET CROACIA BLANCO 4P;DORMITORIO
9244389;;F;60;CHILENO;;Boomers;PROVIDENCIA                   ;METROPOLITANA;0;0;0;0;0;0;0;0;0;COLCHON NEW STYLE 4 2P;DORMITORIO
26344348;;M;32;VENEZOLANO;;Extranjero;N/D;N/D;0;0;0;0;0;0;0;0;0;BOX AMERICANO EXCELLENCE 1.5P +RESP+VEL OLMO;DORMITORIO
14007626;;F;41;CHILENO;;X;MELIPILLA                     ;METROPOLITANA;0;0;0;0;0;0;0;0;0;PACK 2 ALMOHADAS C+L;DORMITORIO
13794591;;F;42;CHILENO;;X;RENCA                         ;METROPOLITANA;0;0;0;0;0;0;0;0;0;CE EVOLUTION BLACK 1,5P + RESPALDO ASTURIAS;DORMITORIO
16448672;Soltero;F;35;CHILENO;;Millenial;RENCA                         ;METROPOLITANA;0;0;0;0;0;0;0;0;0;PACK 2 ALMOHADAS C+L;DORMITORIO
11367681;;M;52;CHILENO;;X;RENCA                         ;METROPOLITANA;0;0;0;0;0;0;0;0;0;Almohada Viscoelastica Bamboo Pack 73x43 cm;DORMITORIO
16389451;;M;36;CHILENO;;Millenial;N/D;N/D;0;0;0;0;0;0;0;0;0;CE EVOLUTION BLACK 1,5P BN DUAL SIDE;DORMITORIO
5428333;;M;76;CHILENO;;Silencioso;EL QUISCO                     ;VALPARAISO;0;0;0;0;0;0;0;0;0;COLCHON BALANCE 1 2P 150X200;DORMITORIO
17103887;;F;33;CHILENO;;X;N/D;N/D;0;0;0;0;0;0;0;0;0;DUPLEX CE EVOLUTION BLACK 1P + 2 RESP + VEL ASTU;DORMITORIO
13069515;;F;47;CHILENO;;X;PROVIDENCIA                   ;METROPOLITANA;0;0;0;0;0;0;0;0;0;PACK 2 ALMOHADAS C+L;DORMITORIO
10733331;;M;55;CHILENO;;Boomers;PROVIDENCIA                   ;METROPOLITANA;0;0;0;0;0;0;0;0;0;COLCHON BEAT 1P;DORMITORIO
6409061;;M;72;CHILENO;;Silencioso;LOS ANDES                     ;VALPARAISO;0;0;0;0;0;0;0;0;0;COLCHON PREMIUM 1,5P;DORMITORIO
12429981;;M;49;CHILENO;;X;"";"";0;0;0;0;0;0;0;0;0;CE EVOLUTION BLACK 1P + RESPALDO CASTILLA;DORMITORIO
16592747;;F;35;CHILENO;;Millenial;IQUIQUE                       ;TARAPACA;0;0;0;0;0;0;0;0;0;CLOSET CAJONERA NEW BELGICA M-398-NW;DORMITORIO
14113596;Casado;M;40;CHILENO;INGENIERO EN PREVENCION DE RIESGOS;X;PROVIDENCIA                   ;METROPOLITANA;0;0;0;0;0;0;0;0;0;DUPLEX CE EVOLUTION BLACK 1P + 2 RESP + VEL ASTU;DORMITORIO
17491287;Soltero;M;31;CHILENO;INGENIERO EN CONTROL DE GESTION;Millenial;PROVIDENCIA                   ;METROPOLITANA;0;0;0;0;0;0;0;0;0;Cama Tempo 2PBD;DORMITORIO
9350477;;M;60;CHILENO;;Millenial;"";"";0;0;0;0;0;0;0;0;0;CE EVOLUTION BLACK 1,5P + RESPALDO ASTURIAS;DORMITORIO
12801898;;F;46;CHILENO;;X;ANTOFAGASTA                   ;ANTOFAGASTA;0;0;0;0;0;0;0;0;0;COLCHON NEW STYLE 6 2P;DORMITORIO
13328814;;M;44;CHILENO;;X;PROVIDENCIA                   ;METROPOLITANA;0;0;0;0;0;0;0;0;0;COLCHON ERGO T 2P;DORMITORIO
19990095;;F;22;CHILENO;;Z;PROVIDENCIA                   ;METROPOLITANA;0;0;0;0;0;0;0;0;0;ALMOHADA ROSEN SOFT PLUS KING;DORMITORIO
20311366;;F;22;CHILENO;;Z;N/D;N/D;0;0;0;0;0;0;0;0;0;CE EVOLUTION BLACK 1,5P + RESPALDO ASTURIAS;DORMITORIO
10212281;;F;57;CHILENO;;Boomers;LAMPA                         ;METROPOLITANA;0;0;0;0;0;0;0;0;0;CLOSET CROACIA PERAL 4P;DORMITORIO
17252818;;F;32;CHILENO;;Millenial;SAN BERNARDO                  ;METROPOLITANA;0;0;0;0;0;0;0;0;0;CLOSET ESPANA 6P+4C;DORMITORIO
19356482;;M;25;CHILENO;;Millenial;N/D;N/D;0;0;0;0;0;0;0;0;0;CE ERGO T 2P 2MT BD;DORMITORIO
13432550;;F;45;CHILENO;;X;RENCA                         ;METROPOLITANA;0;0;0;0;0;0;0;0;0;BA EXCELLENCE PLUS 2P BD +RESP+VEL OLMO;DORMITORIO
17872511;Soltero;F;30;CHILENO;;Millenial;PROVIDENCIA                   ;METROPOLITANA;0;0;0;0;0;0;0;0;0;CE BLACK EVOLUTION FULL;DORMITORIO
15045878;;F;39;CHILENO;;X;ILLAPEL                       ;COQUIMBO;0;0;0;0;0;0;0;0;0;PACK 2 ALMOHADAS C+L;DORMITORIO
10021894;;M;55;CHILENO;;Boomers;CONSTITUCION                  ;MAULE;0;0;0;0;0;0;0;0;0;CAMA EUROPEA IBIZA 2 PL BD;DORMITORIO
18210513;Soltero;F;30;CHILENO;TECNOLOGO MEDICO;Millenial;PROVIDENCIA                   ;METROPOLITANA;0;0;0;0;0;0;0;0;0;COLCHON NEW ORTOPEDIC 2P;DORMITORIO
15731994;;M;38;CHILENO;;X;RIO CLARO                     ;MAULE;0;0;0;0;0;0;0;0;0;SET 2 ALMOHADAS VISCO MEDIUM 60X40 CM;DORMITORIO
13115636;;F;45;CHILENO;;X;TEMUCO                        ;ARAUCANIA;0;0;0;0;0;0;0;0;0;CLOSET M-801 6P+2C ALTO 1,82 BLANCO NATURAL;DORMITORIO
12348345;;F;49;CHILENO;;X;PROVIDENCIA                   ;METROPOLITANA;0;0;0;0;0;0;0;0;0;CLOSET NEWCAPRI M-330 AVELLANA/CARVALHO4P3C+ESPE;DORMITORIO
11138117;;F;55;CHILENO;;Boomers;PROVIDENCIA                   ;METROPOLITANA;0;0;0;0;0;0;0;0;0;CE THERAPEDIC MAS 2PBD;DORMITORIO
8926520;Casado;F;62;CHILENO;;Boomers;PARRAL                        ;MAULE;0;0;0;0;0;0;0;0;0;DUPLEX CE EVOLUTION BLACK 1P + 2 RESP + VEL ASTU;DORMITORIO
18137821;;M;29;CHILENO;;Millenial;PROVIDENCIA                   ;METROPOLITANA;109980;2;2;1;1;39990;1;1;69990;Producto segunda seleccion Banda 1;COMPUTACION
12915686;;M;47;CHILENO;;X;N/D;N/D;1056370;16;9;0;0;0;16;9;1056370;TAB Galaxy A7 Lite (8.7, 32GB, WIFI);COMPUTACION
25596787;;M;33;HAITIANO;;Extranjero;TALCA                         ;MAULE;1238890;12;7;4;2;342960;8;5;895930;Tab M10 FHD Plus LTE 10.3IN 2GB 32GB;COMPUTACION
10312851;;F;52;CHILENO;;X;VILLA ALEMANA                 ;VALPARAISO;1258940;6;3;6;3;1258940;0;0;0;NTBK IP5 Ryzen 7-4700U/16GB/256GB SSD/15P FHD;COMPUTACION
20777887;;F;21;CHILENO;;Z;PROVIDENCIA                   ;METROPOLITANA;273980;2;1;2;1;273980;0;0;0;Galaxy Tab S6 Lite + Book Cover (10.4,128GB,Blue;COMPUTACION
27233737;;F;38;EXTRANJERO - NO INFORMA NACIONALIDAD ;;Extranjero;"";"";1180930;7;3;4;2;323960;3;1;856970;NTBK GalaxyBook2 Pro Ci5-1240P/8GB/512GB/13.3P;COMPUTACION
14019822;;M;40;CHILENO;;X;PROVIDENCIA                   ;METROPOLITANA;329990;1;1;1;1;329990;0;0;0;NTBK IP3 Ryzen 3-5300U/8GB/256GB SSD/14P FHD;COMPUTACION
13595377;;M;43;CHILENO;;X;PROVIDENCIA                   ;METROPOLITANA;351950;5;2;5;2;351950;0;0;0;Tab Yoga Smart;COMPUTACION
18008084;;F;30;CHILENO;;Millenial;"";"";387980;2;1;2;1;387980;0;0;0;NTBK IdeaPad 3 Ryzen 5-4500U/12GB/1TB/15P;COMPUTACION
9331976;;M;59;CHILENO;;Boomers;CANETE                        ;BIO BIO;379980;2;2;0;0;0;2;2;379980;NTBK 240 G8 Celeron N4020/4GB/500GB/14P;COMPUTACION
7532777;Casado;M;65;CHILENO;;Boomers;CONCEPCION                    ;BIO BIO;149990;1;1;0;0;0;1;1;149990;Multifuncional EcoTank L3210;COMPUTACION
19111065;Soltero;M;26;CHILENO;;Z;PROVIDENCIA                   ;METROPOLITANA;145980;2;1;2;1;145980;0;0;0;NTBK D330 Celeron N4020/4GB/64GB/10P+OfficeHS;COMPUTACION
16828060;;M;34;CHILENO;;Millenial;SANTA CRUZ                    ;L.G.B.OÂ´HIGGINS;1229976;32;23;1;1;189990;31;22;1039986;NTBK INSPIRON 3505 AMD R3 3250U 8GB 1TB;COMPUTACION
19042438;;M;26;CHILENO;;Extranjero;COQUIMBO                      ;COQUIMBO;169990;1;1;1;1;169990;0;0;0;Multifuncional EcoTank L3250 Wifi;COMPUTACION
6399738;;M;72;CHILENO;;Silencioso;VILLARICA                     ;ARAUCANIA;1287060;3;2;0;0;0;3;2;1287060;NTBK FX506 Ci5-10300H/8GB/512GB SSD/GTX1650 4GB;COMPUTACION
9638889;;F;58;CHILENO;;Boomers;N/D;N/D;402054;11;4;0;0;0;11;4;402054;TINTA 664 NEGRA;COMPUTACION
5765517;;M;72;CHILENO;;Silencioso;CHILLAN                       ;BIO BIO;419990;1;1;1;1;419990;0;0;0;AIO IC A340 Core i3/4GB/1TB/24P Full HD;COMPUTACION
6555392;;F;72;CHILENO;;Silencioso;VALLENAR;ATACAMA;3241130;23;9;0;0;0;23;9;3241130;NTBK 245 G8 R5-5500U/8GB/256GB SSD/14P/Win10Pro;COMPUTACION
20261653;;M;22;CHILENO;;Z;ANTOFAGASTA;ANTOFAGASTA;599980;2;2;2;2;599980;0;0;0;NTBK 15-ef1015la Ryzen 3-4300U/4GB/256GBSSD/15P;COMPUTACION
19118646;;M;26;CHILENO;;Z;EL BOSQUE                     ;METROPOLITANA;139990;1;1;0;0;0;1;1;139990;Tab M10 Plus FHD 4GB 64GB 10.3P platinum grey;COMPUTACION
17457565;;M;32;CHILENO;;Millenial;N/D;N/D;444960;8;3;4;2;443960;4;1;1000;Multifuncional EcoTank L4260 Wifi y Duplex;COMPUTACION
18986833;Soltero;M;26;CHILENO;INGENIERO INFORMATICO;Z;OVALLE                        ;COQUIMBO;109990;1;1;0;0;0;1;1;109990;Monitor Mi 23.8P Full HD;COMPUTACION
9130098;;M;63;CHILENO;;Boomers;ILLAPEL                       ;COQUIMBO;740960;5;3;0;0;0;5;3;740960;NTBK 245 G8 R5-5500U/8GB/256GB SSD/14P/Win10Pro;COMPUTACION
18656614;;F;28;CHILENO;;Millenial;N/D;N/D;439970;6;3;0;0;0;6;3;439970;NTBK 240 G8 Celeron N4020/4GB/500GB/14P;COMPUTACION
6899728;;M;69;CHILENO;;Silencioso;N/D;N/D;661940;6;4;0;0;0;6;4;661940;Multifuncional EcoTank L4260 Wifi y Duplex;COMPUTACION
8973905;;M;61;CHILENO;;Boomers;CASTRO                        ;LOS LAGOS;406090;2;1;0;0;0;2;1;406090;NTBK IP3 Ryzen 3-5300U/8GB/256GB SSD/14P FHD;COMPUTACION
8059491;;M;66;CHILENO;;Boomers;N/D;N/D;821950;5;3;2;1;488980;3;2;332970;NTBK 2en1 Ci5-1135G7/8GB/256GB SSD/13P FHD TOUCH;COMPUTACION
20413916;;F;21;CHILENO;;Z;TENO                          ;MAULE;761560;7;3;3;1;307970;4;2;453590;TAB S6 Lite (610) 4GB 64GB 10.4P PINK;COMPUTACION
17811119;Soltero;F;30;CHILENO;;Millenial;PROVIDENCIA                   ;N/D;756980;2;1;2;1;756980;0;0;0;NTBK FX506 Ci5-10300H/8GB/512GB SSD/GTX1650 4GB;COMPUTACION
15368708;;F;39;CHILENO;;X;LA LIGUA                      ;VALPARAISO;288560;3;1;0;0;0;3;1;288560;Tab M10 Plus FHD 4GB 64GB 10.3P platinum grey;COMPUTACION
17038764;;F;33;CHILENO;;Millenial;"";"";455221;3;3;0;0;0;3;3;455221;Multifuncional EcoTank L3210;COMPUTACION
12307717;;M;51;CHILENO;;X;"";"";175010;2;1;0;0;0;2;1;175010;Tab M10 Plus FHD 4GB 64GB 10.3P platinum grey;COMPUTACION
11561192;;M;52;CHILENO;;X;CONSTITUCION                  ;MAULE;363610;2;1;0;0;0;2;1;363610;NTBK 15-ef1015la Ryzen 3-4300U/4GB/256GBSSD/15P;COMPUTACION
17764582;;M;31;CHILENO;;Millenial;"";"";323980;2;1;2;1;323980;0;0;0;NTBK IP3 Ryzen 3-5300U/8GB/256GB SSD/14P FHD;COMPUTACION
17946795;;M;33;CHILENO;;Millenial;PROVIDENCIA                   ;N/D;403980;2;1;2;1;403980;0;0;0;NTBK 250 G8 Ci5-1135G7/8GB/256 SSD/15P/Win10Pro;COMPUTACION
15003875;;F;40;CHILENO;;X;IQUIQUE                       ;TARAPACA;53980;2;1;2;1;53980;0;0;0;Multifuncional DeskJet Ink Advantage 2775 Wifi;COMPUTACION
16749789;;F;34;CHILENO;;Millenial;PROVIDENCIA                   ;METROPOLITANA;253980;2;1;2;1;253980;0;0;0;TAB S6 Lite (610) 4GB 64GB 10.4P PINK;COMPUTACION
11698682;;M;51;CHILENO;;X;LEBU                          ;BIO BIO;1060909;9;3;0;0;0;9;3;1060909;NTBK IP3 Ryzen 3-5300U/8GB/256GB SSD/14P FHD;COMPUTACION
13397096;;M;47;CHILENO;;X;TEMUCO                        ;ARAUCANIA;639150;6;4;0;0;0;6;4;639150;NTBK IP3i Celeron N4020/4G/500GB/14P/Rojo;COMPUTACION
20192961;;F;23;CHILENO;;Z;"";"";469980;5;3;0;0;0;5;3;469980;NTBK 240 G8 Celeron N4020/4GB/500GB/14P;COMPUTACION
13140924;;F;45;CHILENO;;X;TALCA                         ;MAULE;1936972;19;14;10;7;812900;9;7;1124072;Multifuncional EcoTank L3250 Wifi;COMPUTACION
8497396;;F;64;CHILENO;;Boomers;EL MONTE                      ;METROPOLITANA;499980;2;2;0;0;0;2;2;499980;NTBK HT14 Celeron N4020 4GB/128GB SSD/14P;COMPUTACION
13534261;Casado;M;43;CHILENO;PROFESOR;X;RENCA                         ;METROPOLITANA;280480;2;1;2;1;280480;0;0;0;Galaxy Tab S6 Lite + Book Cover (10.4,128GB,Blue;COMPUTACION
6503236;;F;74;CHILENO;;Silencioso;CONCEPCION                    ;BIO BIO;235980;2;1;0;0;0;2;1;235980;NTBK Inspiron 3505 Athlon 3050U/12GB/256 SSD/15P;COMPUTACION
8883873;;F;61;CHILENO;;Boomers;HUASCO                        ;ATACAMA;568420;8;4;0;0;0;8;4;568420;Multifuncional EcoTank L3250 Wifi;COMPUTACION
14448849;;F;50;CHILENO;;X;PEDRO AGUIRRE CERDA;METROPOLITANA;341960;4;2;4;2;341960;0;0;0;NTBK 240 G8 Core i3-1005G1/8GB/256GB SSD/14P;COMPUTACION
6536201;;M;67;CHILENO;;Boomers;N/D;N/D;1137340;15;4;0;0;0;15;4;1137340;NTBK 14-dq2025la Ci3-1115G4/4GB/256GB+16GB/14P;COMPUTACION
16700006;;M;34;CHILENO;;Silencioso;PROVIDENCIA                   ;METROPOLITANA;33980;2;1;2;1;33980;0;0;0;Router Huawei AX3 WIFI Quad core;COMPUTACION
17081824;;F;34;CHILENO;;Millenial;N/D;N/D;234980;2;1;2;1;234980;0;0;0;NTBK Inspiron 3505 Athlon 3050U/12GB/256 SSD/15P;COMPUTACION
12063915;;F;55;CHILENO;;Boomers;LA SERENA                     ;COQUIMBO;1055780;10;1;0;0;0;10;1;1055780;AIO 21-b0011la Celeron J4025/4GB/500GB/20.7P FHD;COMPUTACION
11980188;;M;49;CHILENO;;X;SAN ANTONIO                   ;VALPARAISO;1010360;7;6;0;0;0;7;6;1010360;NTBK IdeaPad 3 Ryzen 5-4500U/12GB/1TB/15P;COMPUTACION
19478149;;F;25;CHILENO;;Z;FREIRE;ARAUCANIA;197980;2;1;2;1;197980;0;0;0;NTBK Inspiron 3501 Ci3-1115G4/4GB/1TB/14P;COMPUTACION
8421198;;M;64;CHILENO;;Boomers;CABILDO                       ;VALPARAISO;904940;7;6;0;0;0;7;6;904940;Multifuncional EcoTank L3210;COMPUTACION
17667855;;M;31;CHILENO;;Millenial;SAN BERNARDO;METROPOLITANA;21476;3;1;3;1;21476;0;0;0;TINTA 664 TRI COLOR;COMPUTACION
20516615;;F;21;CHILENO;;Z;HUALQUI;BIO-BIO;690360;3;4;2;1;76980;1;3;613380;NTBK D14 Ci5-10210U/8GB/512SSD/14 FHD/ office365;COMPUTACION
16394132;;M;36;CHILENO;;Millenial;COLLIPULLI                    ;ARAUCANIA;149990;1;1;0;0;0;1;1;149990;Multifuncional EcoTank L3210;COMPUTACION
19251278;;M;25;CHILENO;;Z;N/D;N/D;569960;4;3;0;0;0;4;3;569960;NTBK 15-ef1015la Ryzen 3-4300U/4GB/256GBSSD/15P;COMPUTACION
19297163;Soltero;M;26;CHILENO;;Z;PROVIDENCIA                   ;METROPOLITANA;159990;1;1;1;1;159990;0;0;0;Multifuncional EcoTank L3210;COMPUTACION
17194452;;M;33;CHILENO;;Millenial;ANTOFAGASTA                   ;ANTOFAGASTA;1129590;7;7;2;1;389640;5;6;739950;NTBK HT14 Celeron N4020 4GB/128GB SSD/14P;COMPUTACION
25552974;;F;52;BOLIVIANO;;Extranjero;PENALOLEN                     ;METROPOLITANA;563940;6;2;0;0;0;6;2;563940;NTBK 15-ef1015la Ryzen 3-4300U/4GB/256GBSSD/15P;COMPUTACION
19415239;;F;25;CHILENO;;Z;COIHUECO;BIO-BIO;770920;8;3;8;3;770920;0;0;0;NTBK Inspiron 3502 Celeron/4GB/128GB SSD/+O365;COMPUTACION
18987508;;F;26;CHILENO;;Z;CURANILAHUE                   ;BIO BIO;456190;4;3;0;0;0;4;3;456190;Galaxy Tab A8 (10.5, 32GB, WIFI) Silver;COMPUTACION
3897691;;F;77;CHILENO;;Silencioso;N/D;N/D;290690;3;1;0;0;0;3;1;290690;Galaxy Tab A8 (10.5, 32GB, LTE) Gray;COMPUTACION
13252255;;F;44;CHILENO;;X;N/D;N/D;301960;4;2;4;2;301960;0;0;0;NTBK Inspiron 3502 Celeron/4GB/128GB SSD/+O365;COMPUTACION
26980410;;F;40;VENEZOLANO;;Extranjero;SANTIAGO                      ;METROPOLITANA;43980;2;1;2;1;43980;0;0;0;365 Personal Suscripcion Anual QQ2-01445;COMPUTACION
12464508;;M;48;CHILENO;;X;LA FLORIDA;METROPOLITANA;153980;2;1;2;1;153980;0;0;0;NTBK Inspiron 3502 Celeron/4GB/128GB SSD/+O365;COMPUTACION
13117218;;M;45;CHILENO;;X;VALDIVIA                      ;LOS RIOS;909980;2;1;0;0;0;2;1;909980;NTBK L5i Ci7-10750H/16GB/128SSD+1TB/RTX2060 6GB;COMPUTACION
7613392;;M;64;CHILENO;;Boomers;COMBARBALA                    ;COQUIMBO;417620;3;2;0;0;0;3;2;417620;NTBK 15-ef1015la Ryzen 3-4300U/4GB/256GBSSD/15P;COMPUTACION
17811966;;M;30;CHILENO;;Millenial;PROVIDENCIA                   ;METROPOLITANA;60900;2;1;0;0;0;2;1;60900;Multifuncional DeskJet Ink Advantage 2775 Wifi;COMPUTACION
7635000;;F;66;CHILENO;;Boomers;RANCAGUA                      ;L.G.B.OÂ´HIGGINS;677390;8;2;0;0;0;8;2;677390;NTBK 15-ef1015la Ryzen 3-4300U/4GB/256GBSSD/15P;COMPUTACION
13991334;;M;41;CHILENO;;X;RENCA                         ;METROPOLITANA;716950;5;3;5;3;716950;0;0;0;TAB Galaxy S7 FE (12.4, 128GB WIFI) BLACK;COMPUTACION
26873691;;M;40;NO INFORMA NACIONALIDAD;;Extranjero;PROVIDENCIA                   ;METROPOLITANA;203980;2;1;2;1;203980;0;0;0;NTBK Inspiron 3501 Ci3-1115G4/4GB/1TB/14P;COMPUTACION
10545250;;F;54;CHILENO;;Boomers;LAS CONDES                    ;METROPOLITANA;203980;2;1;2;1;203980;0;0;0;Galaxy Tab A8 (10.5, 64GB, WIFI) Silver;COMPUTACION
6525760;;F;71;CHILENO;;Silencioso;MAIPU                         ;METROPOLITANA;334940;6;3;0;0;0;6;3;334940;TAB M7 3ra Gen MT8766 2+32GB 7 Wifi Iron grey;COMPUTACION
10289527;;F;53;CHILENO;;X;LA PINTANA                    ;METROPOLITANA;883980;2;1;2;1;883980;0;0;0;NTBK L5i Ci7-10750H/16GB/128SSD+1TB/RTX2060 6GB;COMPUTACION
14062754;;M;40;CHILENO;;X;CONCEPCION                    ;BIO BIO;49990;1;1;1;1;49990;0;0;0;Impresora Monocromatica Xerox B210-NDI;COMPUTACION
17706127;Soltero;F;31;CHILENO;;Millenial;TALAGANTE;METROPOLITANA;303980;2;1;2;1;303980;0;0;0;NTBK IP3 Ryzen 3-5300U/8GB/256GB SSD/14P FHD;COMPUTACION
15173759;Soltero;F;39;CHILENO;PROFESOR;X;PROVIDENCIA                   ;METROPOLITANA;249990;1;1;1;1;249990;0;0;0;TAB S6 Lite (610) 4GB 64GB 10.4P PINK;COMPUTACION
16194795;;M;36;CHILENO;;Millenial;RENCA                         ;METROPOLITANA;269980;2;1;0;0;0;2;1;269980;Galaxy Tab A8 (10.5, 32GB, WIFI) Silver;COMPUTACION
12417079;;F;48;CHILENO;;X;SAN BERNARDO                  ;METROPOLITANA;877960;4;2;4;2;877960;0;0;0;NTBK Aspire 5 R5-3500U/12GB/256SSD GB/15P FHD;COMPUTACION
17381879;;F;32;CHILENO;;Millenial;LA FLORIDA;METROPOLITANA;133980;2;1;0;0;0;2;1;133980;Monitor UltraGear 23.8P 144Hz Full HD IPS;COMPUTACION
11311567;;M;54;CHILENO;;X;ALHUE                         ;METROPOLITANA;206590;2;1;0;0;0;2;1;206590;Multifuncional EcoTank L3210;COMPUTACION
14102405;;M;41;CHILENO;;X;IQUIQUE                       ;TARAPACA;7990;1;1;0;0;0;1;1;7990;T544 DYE BLACK INK BOTTLE (65ml);COMPUTACION
19606324;;M;25;CHILENO;;Z;PROVIDENCIA                   ;METROPOLITANA;633980;2;1;2;1;633980;0;0;0;NTBK GAMER GF63 Ci5-10500H/8GB/512SSD/1650 4GB;COMPUTACION
16702955;Soltero;F;34;CHILENO;AGRONOMO;Millenial;RENCA                         ;METROPOLITANA;48980;2;1;2;1;48980;0;0;0;Impresora Laser HL-1202 Monocromatica;COMPUTACION
16089067;;M;36;CHILENO;;Millenial;RENCA;METROPOLITANA;143980;2;3;2;3;143980;0;0;0;Multifuncional DCPT220;COMPUTACION
17303371;;M;33;CHILENO;;Millenial;"";"";1257960;4;2;4;2;1257960;0;0;0;MBA 13.3 SPG/8C CPU/7C GPU/8GB/256GB (MGN63BE/A);COMPUTACION
13711511;;M;43;CHILENO;;X;PAINE                         ;METROPOLITANA;159990;3;2;0;0;0;3;2;159990;Multifuncional DCPT220;COMPUTACION
20255059;;F;23;CHILENO;;Z;PROVIDENCIA                   ;METROPOLITANA;59990;1;1;0;0;0;1;1;59990;Multifuncional Pixma TR4522 Wifi;COMPUTACION
18972479;Soltero;M;26;CHILENO;INGENIERO INFORMATICO;Z;CALAMA                        ;ANTOFAGASTA;148980;2;1;2;1;148980;0;0;0;Galaxy Tab A8 (10.5, 32GB, WIFI) Silver;COMPUTACION
7425692;;F;65;CHILENO;;Boomers;CHILLAN                       ;BIO BIO;136980;2;1;0;0;0;2;1;136980;Tablet Matepad 10.4;COMPUTACION
11418180;;F;53;CHILENO;;X;N/D;N/D;1347860;5;3;0;0;0;5;3;1347860;NTBK IP3 Core i3-1115G4/4GB/512GB SSD/14P FHD;COMPUTACION
17548397;;M;30;CHILENO;;Millenial;PROVIDENCIA                   ;METROPOLITANA;285980;2;1;2;1;285980;0;0;0;TAB S6 Lite (610) 4GB 64GB 10.4P PINK;COMPUTACION
8351686;Casado;M;58;CHILENO;CONSTRUCTOR CIVIL;Boomers;PROVIDENCIA                   ;METROPOLITANA;199990;1;1;0;0;0;1;1;199990;Galaxy Tab A8 (10.5, 64GB, WIFI) Gray;COMPUTACION
19746549;;M;24;CHILENO;;Millenial;PROVIDENCIA                   ;METROPOLITANA;253980;2;1;2;1;253980;0;0;0;NTBK Aspire 5 R3/4GB/128SSD/15P FHD W+T Ingles;COMPUTACION
17747426;;M;31;CHILENO;;Millenial;SAN FERNANDO                  ;L.G.B.OÂ´HIGGINS;486980;2;1;2;1;486980;0;0;0;TAB Galaxy S7 FE (12.4, 128GB WIFI) BLACK;COMPUTACION
15395022;;F;40;CHILENO;;X;SAN BERNARDO;METROPOLITANA;71970;4;2;4;2;71970;0;0;0;TAB MLAB MBX 8 QUAD CORE 1G+16G 8716;COMPUTACION
19407286;;F;26;CHILENO;;Z;PANGUIPULLI                   ;LOS RIOS;172980;2;2;0;0;0;2;2;172980;Tab M10 Plus FHD 4GB 64GB 10.3P platinum grey;COMPUTACION
26380633;;M;51;VENEZOLANO;;Extranjero;CONCEPCION                    ;BIO BIO;499990;1;1;0;0;0;1;1;499990;NTBK Aspire 5 R5-3500U/12GB/256SSD GB/15P FHD;COMPUTACION
13903994;;F;42;CHILENO;;X;LA FLORIDA;METROPOLITANA;103980;2;1;2;1;103980;0;0;0;NTBK XH02 Celeron 4GB/64GB eMMC/11P/T+W ingles;COMPUTACION
10690636;;M;55;CHILENO;;Boomers;CANETE                        ;BIO BIO;277810;3;4;0;0;0;3;4;277810;Galaxy Tab A8 (10.5, 64GB, WIFI) Gray;COMPUTACION
9952419;;F;56;CHILENO;;Boomers;PARRAL                        ;MAULE;459970;5;2;0;0;0;5;2;459970;Multifuncional EcoTank L3210;COMPUTACION
20090497;;M;23;CHILENO;;Silencioso;PROVIDENCIA                   ;METROPOLITANA;259990;1;1;1;1;259990;0;0;0;NTBK 15-ef1015la Ryzen 3-4300U/4GB/256GBSSD/15P;COMPUTACION
13903574;;M;42;CHILENO;;X;"";"";383940;6;2;6;2;383940;0;0;0;NTBK Vivobook Ci3/4GB/128GB SSD/15P W+T Ingl;COMPUTACION
8366582;;M;60;CHILENO;;Boomers;LA FLORIDA                    ;METROPOLITANA;53980;2;1;2;1;53980;0;0;0;Multifuncional DeskJet Ink Advantage 2775 Wifi;COMPUTACION
4912550;;F;75;CHILENO;;Silencioso;TOCOPILLA                     ;ANTOFAGASTA;325221;3;2;0;0;0;3;2;325221;Impresora Laser HL-1202 Monocromatica;COMPUTACION
9345438;;M;59;CHILENO;;Boomers;RENCA                         ;METROPOLITANA;221970;4;2;4;2;221970;0;0;0;NTBK 240 G8 Celeron N4020/4GB/500GB/14P;COMPUTACION
13949948;;F;42;CHILENO;;X;BUIN                          ;METROPOLITANA;573940;6;2;0;0;0;6;2;573940;NTBK Aspire 5 Ci3-10110U/12GB/512GB SSD/15P FHD;COMPUTACION
16037073;;F;37;CHILENO;;Millenial;CONCEPCION                    ;BIO BIO;155980;2;1;2;1;155980;0;0;0;NTBK IP1 AMD 3020e/4GB/64GB eMMC/14P;COMPUTACION
20052171;;F;23;CHILENO;;Z;PROVIDENCIA                   ;METROPOLITANA;139990;1;1;1;1;139990;0;0;0;Multifuncional DCPT220;COMPUTACION
13024160;;F;46;CHILENO;;X;CALAMA                        ;ANTOFAGASTA;149990;1;1;0;0;0;1;1;149990;Tab Yoga Smart;COMPUTACION
14090067;;M;41;CHILENO;;X;SANTA BARBARA                 ;BIO BIO;119980;2;4;2;4;119980;0;0;0;Multifuncional Pixma TR4522 Wifi;COMPUTACION
19973080;;M;23;CHILENO;;Z;PROVIDENCIA                   ;METROPOLITANA;0;0;2;0;2;0;0;0;0;Monitor UltraGear 23.8P 144Hz Full HD IPS;COMPUTACION
16326399;;F;36;CHILENO;;Millenial;TOCOPILLA                     ;ANTOFAGASTA;159990;1;1;0;0;0;1;1;159990;Multifuncional EcoTank L3210;COMPUTACION
4905716;;M;74;CHILENO;;Silencioso;LAS CONDES                    ;METROPOLITANA;322290;6;5;0;0;0;6;5;322290;Multifuncional Pixma TR4522 Wifi;COMPUTACION
12930604;;M;46;CHILENO;;X;PROVIDENCIA                   ;METROPOLITANA;449990;1;1;0;0;0;1;1;449990;AIO IC A340 Core i3/4GB/1TB/24P Full HD;COMPUTACION
15652071;Soltero;F;39;CHILENO;;X;TEMUCO                        ;ARAUCANIA;815350;5;4;0;0;0;5;4;815350;NTBK 15-eh0006la Ryzen 5-4500U/8GB/512GB/15P;COMPUTACION
19987609;;F;21;CHILENO;;Z;PROVIDENCIA                   ;METROPOLITANA;15980;2;1;0;0;0;2;1;15980;T544 DYE BLACK INK BOTTLE (65ml);COMPUTACION
12923719;;M;47;CHILENO;;X;"";"";31960;4;1;0;0;0;4;1;31960;T544 DYE BLACK INK BOTTLE (65ml);COMPUTACION
17569602;Soltero;M;32;CHILENO;;Millenial;CONCEPCION;BIO-BIO;705980;2;1;2;1;705980;0;0;0;NTBK GAMER GF66 Ci5-11400H/8GB/512GB/GTX1650 4GB;COMPUTACION
8718505;;M;63;CHILENO;;Boomers;N/D;N/D;0;0;2;1;1;319990;-1;1;-319990;NTBK IP3 Ryzen 3-5300U/8GB/256GB SSD/14P FHD;COMPUTACION
17437480;;M;32;CHILENO;;Millenial;"";"";729990;1;1;0;0;0;1;1;729990;NTBK FX506 Ci5-10300H/8GB/512GB SSD/GTX1650 4GB;COMPUTACION
7353911;;M;72;CHILENO;;Silencioso;RENGO                         ;L.G.B.OÂ´HIGGINS;911240;5;4;1;1;219990;4;3;691250;NTBK IP3 Ryzen 3-5300U/8GB/256GB SSD/14P FHD;COMPUTACION
12910520;;F;46;CHILENO;;X;SAN BERNARDO                  ;METROPOLITANA;230040;4;1;0;0;0;4;1;230040;NTBK DATACHABLE IDEAPAD D330 N4020 4G 128G W10PR;COMPUTACION
10828045;;M;55;CHILENO;;Boomers;MARIQUINA                     ;LOS LAGOS;179990;1;1;0;0;0;1;1;179990;Galaxy Tab A8 (10.5, 32GB, WIFI) Gray;COMPUTACION
16132648;;M;36;CHILENO;;Millenial;OVALLE                        ;COQUIMBO;124970;3;2;2;1;109980;1;1;14990;NTBK DATACHABLE IDEAPAD D330 N4020 4G 128G W10PR;COMPUTACION
15198267;;M;39;CHILENO;;X;CURANILAHUE                   ;BIO BIO;329990;1;1;0;0;0;1;1;329990;NTBK 15-ef1015la Ryzen 3-4300U/4GB/256GBSSD/15P;COMPUTACION
21554670;Soltero;F;29;COLOMBIANO;;Extranjero;PROVIDENCIA                   ;METROPOLITANA;149990;1;1;1;1;149990;0;0;0;Multifuncional EcoTank L3210;COMPUTACION
27349241;;M;31;"";;Extranjero;PROVIDENCIA                   ;METROPOLITANA;93980;2;1;2;1;93980;0;0;0;NTBK BR11 Celeron N4500/4GB/64GB eMMC/11P;COMPUTACION
19119639;Soltero;M;27;CHILENO;;Z;PROVIDENCIA                   ;METROPOLITANA;641980;2;1;2;1;641980;0;0;0;Notebook OMEN i5-1140H/8GB/512 SSD/RTX 3060 6GB/;COMPUTACION
18321657;;F;29;CHILENO;;Millenial;PROVIDENCIA                   ;METROPOLITANA;139990;1;1;1;1;139990;0;0;0;Multifuncional EcoTank L3210;COMPUTACION
16285512;;F;35;CHILENO;;Millenial;PROVIDENCIA                   ;METROPOLITANA;180980;2;1;2;1;180980;0;0;0;Multifuncional EcoTank L3250 Wifi;COMPUTACION
15587025;;F;39;CHILENO;;X;CERRO NAVIA                   ;METROPOLITANA;299990;3;1;3;1;299990;0;0;0;NTBK ASUS Ci3/4GB/128GB Win+Tec Ingles+S/adap;COMPUTACION
12450204;;M;48;CHILENO;;X;PROVIDENCIA                   ;METROPOLITANA;259990;1;1;1;1;259990;0;0;0;NTBK 15-ef1015la Ryzen 3-4300U/4GB/256GBSSD/15P;COMPUTACION
13361563;;M;45;CHILENO;;X;LA LIGUA                      ;VALPARAISO;203280;2;1;0;0;0;2;1;203280;Multifuncional DCPT520W Wifi;COMPUTACION
7982256;Casado;F;66;CHILENO;;Boomers;RENCA                         ;METROPOLITANA;31960;4;1;0;0;0;4;1;31960;T544 DYE BLACK INK BOTTLE (65ml);COMPUTACION
23830766;;F;33;CUBANO;;Extranjero;SANTIAGO                      ;METROPOLITANA;83980;2;1;2;1;83980;0;0;0;TAB MLAB MBX 8 QUAD CORE 1G+16G 8716;COMPUTACION
5290506;;M;70;CHILENO;;Silencioso;LONCOCHE                      ;ARAUCANIA;139990;1;1;0;0;0;1;1;139990;TAB Galaxy A7 Lite (8.7, 32GB, WIFI + 4G);COMPUTACION
7125475;;F;67;CHILENO;;Boomers;VINA DEL MAR                  ;VALPARAISO;226390;3;2;0;0;0;3;2;226390;NTBK HT14 Celeron N4020 4GB/128GB SSD/14P;COMPUTACION
15571258;;M;47;CHILENO;;X;SAN BERNARDO;METROPOLITANA;1059580;6;3;1;1;359990;5;2;699590;NTBK IP3i Celeron N4020/4G/500GB/14P/Rojo;COMPUTACION
11241910;;F;54;CHILENO;;Boomers;LOS ANGELES                   ;BIO BIO;349980;2;2;1;1;89990;1;1;259990;NTBK BR11 Celeron N4500/4GB/64GB eMMC/11P;COMPUTACION
17445211;;M;32;CHILENO;;Millenial;CORONEL;BIO-BIO;149990;1;1;1;1;149990;0;0;0;Multifuncional EcoTank L3210;COMPUTACION
13501660;;F;44;CHILENO;;X;N/D;N/D;59990;1;1;0;0;0;1;1;59990;Multifuncional Pixma TR4522 Wifi;COMPUTACION
15610253;;F;39;CHILENO;;X;PROVIDENCIA                   ;METROPOLITANA;859980;2;1;0;0;0;2;1;859980;NTBK GAMER GF66 Ci5-11400H/8GB/512GB/GTX1650 4GB;COMPUTACION
20236559;;M;23;CHILENO;;Z;PROVIDENCIA                   ;METROPOLITANA;722960;4;2;4;2;722960;0;0;0;NTBK FX506 Ci5-10300H/8GB/512GB SSD/GTX1650 4GB;COMPUTACION
15731442;;M;39;CHILENO;;X;N/D;N/D;259990;1;1;1;1;259990;0;0;0;NTBK 15-ef1015la Ryzen 3-4300U/4GB/256GBSSD/15P;COMPUTACION
15493626;;F;39;CHILENO;;X;N/D;N/D;921918;12;5;0;0;0;12;5;921918;NTBK IP3 Ryzen 3-5300U/8GB/256GB SSD/14P FHD;COMPUTACION
15560215;Casado;F;39;CHILENO;;X;PROVIDENCIA                   ;METROPOLITANA;204980;2;1;2;1;204980;0;0;0;Multifuncional DCPT720DW Wifi, Duplex y ADF;COMPUTACION
16773581;Soltero;F;34;CHILENO;INGENIERO EN MAQUINARIA;Millenial;PROVIDENCIA                   ;METROPOLITANA;109980;3;1;3;1;109980;0;0;0;TAB M7 3ra Gen MT8766 2+32GB 7 Wifi Iron grey;COMPUTACION
18756986;;M;28;CHILENO;;Millenial;PROVIDENCIA                   ;METROPOLITANA;159990;1;1;1;1;159990;0;0;0;Multifuncional EcoTank L3210;COMPUTACION
7544427;;F;51;CHILENO;;X;PROVIDENCIA                   ;METROPOLITANA;293980;2;1;2;1;293980;0;0;0;NTBK 15-ef1015la Ryzen 3-4300U/4GB/256GBSSD/15P;COMPUTACION
19608149;;F;25;CHILENO;;Z;VILLARICA                     ;ARAUCANIA;356890;2;1;0;0;0;2;1;356890;NTBK 15-ef1015la Ryzen 3-4300U/4GB/256GBSSD/15P;COMPUTACION
19820070;;F;24;CHILENO;;Z;SANTIAGO;METROPOLITANA;299990;1;1;0;0;0;1;1;299990;NTBK 15-ef1015la Ryzen 3-4300U/4GB/256GBSSD/15P;COMPUTACION
27152970;;F;29;VENEZOLANO;;Extranjero;VINA DEL MAR                  ;VALPARAISO;289990;1;1;0;0;0;1;1;289990;NTBK 15-ef1015la Ryzen 3-4300U/4GB/256GBSSD/15P;COMPUTACION
17018933;;F;33;CHILENO;;Millenial;ANTOFAGASTA                   ;ANTOFAGASTA;299990;1;1;1;1;299990;0;0;0;NTBK 15-ef1015la Ryzen 3-4300U/4GB/256GBSSD/15P;COMPUTACION
20015081;;F;23;CHILENO;;Z;N/D;N/D;260390;3;2;0;0;0;3;2;260390;Multifuncional Smart Tank 515 Wifi;COMPUTACION
13181550;;M;45;CHILENO;;X;OVALLE                        ;COQUIMBO;194980;2;1;0;0;0;2;1;194980;NTBK 240 G8 Core i3-1005G1/4GB/1TB/14P;COMPUTACION
10783699;Casado;M;56;CHILENO;;Boomers;RENCA                         ;METROPOLITANA;539990;1;1;0;0;0;1;1;539990;NTBK 15-eh0006la Ryzen 5-4500U/8GB/512GB/15P;COMPUTACION
16295487;;F;35;CHILENO;;Millenial;CANETE                        ;BIO BIO;736964;9;9;0;0;0;9;9;736964;Multifuncional DeskJet Ink Advantage 2775 Wifi;COMPUTACION
13717350;Casado;M;43;CHILENO;MEDICO CIRUJANO;Silencioso;PROVIDENCIA                   ;METROPOLITANA;786980;2;1;2;1;786980;0;0;0;NTBK 2en1 Ci5-1135G7/8GB/256GB SSD/13P FHD TOUCH;COMPUTACION
11547805;;F;51;CHILENO;;X;PROVIDENCIA                   ;METROPOLITANA;59980;2;1;2;1;59980;0;0;0;TAB M7 3ra Gen MT8766 2+32GB 7 Wifi Iron grey;COMPUTACION
9112120;Casado;F;67;CHILENO;;Boomers;RENCA                         ;METROPOLITANA;752220;6;1;0;0;0;6;1;752220;NTBK 15-ef1015la Ryzen 3-4300U/4GB/256GBSSD/15P;COMPUTACION
6502955;;F;70;CHILENO;;Silencioso;TEMUCO                        ;ARAUCANIA;225980;2;2;0;0;0;2;2;225980;Galaxy Tab A8 (10.5, 64GB, WIFI) Gray;COMPUTACION
14010212;;M;42;CHILENO;;X;TALCA;MAULE;0;0;2;1;1;30990;-1;1;-30990;TAB 7 MB4 Plus 4Core 1GB 16GB 7 Plata;COMPUTACION
10119557;;M;57;CHILENO;;Boomers;LOS ANGELES                   ;BIO BIO;359980;3;2;0;0;0;3;2;359980;NTBK 15-ef1015la Ryzen 3-4300U/4GB/256GBSSD/15P;COMPUTACION
19477920;;F;25;CHILENO;;Z;PROVIDENCIA                   ;METROPOLITANA;159990;1;1;1;1;159990;0;0;0;Multifuncional EcoTank L3210;COMPUTACION
9322124;Casado;M;60;CHILENO;;Boomers;N/D;N/D;820960;4;2;4;2;820960;0;0;0;NTBK 2en1 Flex5 R5-4500U/8GB/256SSD/14P FHD+Pen;COMPUTACION
15362720;;M;39;CHILENO;;X;CONCHALI;METROPOLITANA;48980;2;1;2;1;48980;0;0;0;Multifuncional XP-2101 wifi;COMPUTACION
14166009;;F;45;CHILENO;;X;RENCA                         ;METROPOLITANA;179990;1;1;1;1;179990;0;0;0;NTBK D330 Celeron N4020/4GB/64GB/10P+OfficeHS;COMPUTACION
26675825;;F;25;VENEZOLANO;;Extranjero;PROVIDENCIA                   ;METROPOLITANA;293980;2;1;2;1;293980;0;0;0;NTBK 15-ef1015la Ryzen 3-4300U/4GB/256GBSSD/15P;COMPUTACION
11657008;;M;52;CHILENO;;X;PROVIDENCIA                   ;METROPOLITANA;625840;2;1;0;0;0;2;1;625840;NTBK 15-eh0006la Ryzen 5-4500U/8GB/512GB/15P;COMPUTACION
15781348;;F;38;CHILENO;;Millenial;"";"";198960;4;1;0;0;0;4;1;198960;NTBK 15-dw1080la Celeron N4020/4GB/1TB/15P;COMPUTACION
17559268;;F;32;CHILENO;;Millenial;QUILPUE                       ;VALPARAISO;239990;1;1;1;1;239990;0;0;0;Multifuncional EcoTank L4260 Wifi y Duplex;COMPUTACION
11996327;;M;50;CHILENO;;X;PALMILLA                      ;L.G.B.OÂ´HIGGINS;299980;2;1;0;0;0;2;1;299980;Multifuncional EcoTank L3210;COMPUTACION
15001662;;F;37;CHILENO;;Millenial;PROVIDENCIA                   ;METROPOLITANA;34980;2;1;2;1;34980;0;0;0;Tinta CL-244 Color;COMPUTACION
19268130;;M;26;CHILENO;;Z;LOS ANDES                     ;VALPARAISO;187990;1;1;0;0;0;1;1;187990;Monitor Emerald 27P 165Hz Full HD;COMPUTACION
10605923;;M;52;CHILENO;;X;PROVIDENCIA                   ;METROPOLITANA;281760;3;2;1;1;179990;2;1;101770;NTBK D330 Celeron N4020/4GB/64GB/10P+OfficeHS;COMPUTACION
15848141;;M;37;CHILENO;;Millenial;ANTOFAGASTA                   ;ANTOFAGASTA;299980;2;1;0;0;0;2;1;299980;Tab M10 Plus FHD 4GB 64GB 10.3P platinum grey;COMPUTACION
8638902;Casado;F;64;CHILENO;;Boomers;LINARES                       ;MAULE;209980;2;2;0;0;0;2;2;209980;NTBK 15-dw1080la Celeron N4020/4GB/1TB/15P;COMPUTACION
11657947;;M;52;CHILENO;;X;QUILICURA;METROPOLITANA;223950;5;2;0;0;0;5;2;223950;Producto segunda seleccion Banda 1;COMPUTACION
23932291;;F;27;PERUANO;;Extranjero;SANTIAGO;METROPOLITANA;198970;3;1;3;1;198970;0;0;0;Multifuncional EcoTank L3210;COMPUTACION
26243604;;F;53;CHILENO;;Extranjero;QUILPUE                       ;VALPARAISO;149990;1;1;0;0;0;1;1;149990;Tab M10 Plus FHD 4GB 64GB 10.3P platinum grey;COMPUTACION
15518155;;M;38;CHILENO;;X;"";"";1194230;3;1;0;0;0;3;1;1194230;NTBK GAMER GF66 Ci5-11400H/8GB/512GB/GTX1650 4GB;COMPUTACION
16442649;;M;36;CHILENO;;Millenial;"";"";210000;2;1;0;0;0;2;1;210000;Galaxy Tab A8 (10.5, 64GB, WIFI) Silver;COMPUTACION
13932712;;M;41;CHILENO;;X;PENALOLEN                     ;METROPOLITANA;283980;2;1;2;1;283980;0;0;0;NTBK 15-ef1015la Ryzen 3-4300U/4GB/256GBSSD/15P;COMPUTACION
24895721;Soltero;F;34;BOLIVIANO;;Extranjero;PROVIDENCIA                   ;METROPOLITANA;149590;3;2;0;0;0;3;2;149590;Multifuncional Pixma TR4522 Wifi;COMPUTACION
5963833;;F;76;CHILENO;;Silencioso;PARRAL                        ;MAULE;147979;2;1;0;0;0;2;1;147979;TAB Galaxy A7 Lite (8.7, 32GB, WIFI);COMPUTACION
24658658;;F;28;CHILENO;;Millenial;CONCEPCION                    ;BIO BIO;289990;1;1;1;1;289990;0;0;0;NTBK 15-ef1015la Ryzen 3-4300U/4GB/256GBSSD/15P;COMPUTACION
19263254;;F;26;CHILENO;;Z;N/D;N/D;184980;2;2;0;0;0;2;2;184980;Multifuncional EcoTank L3210;COMPUTACION
27170338;;M;39;EXTRANJERO - NO INFORMA NACIONALIDAD ;;Extranjero;"";"";429980;2;1;0;0;0;2;1;429980;NTBK 15-ef1015la Ryzen 3-4300U/4GB/256GBSSD/15P;COMPUTACION
15509254;;M;39;CHILENO;;X;PUENTE ALTO;METROPOLITANA;172960;4;2;4;2;172960;0;0;0;TAB Galaxy A7 Lite (8.7, 32GB, WIFI);COMPUTACION
20533600;;F;21;CHILENO;;Z;PROVIDENCIA                   ;METROPOLITANA;399990;1;1;0;0;0;1;1;399990;TAB Galaxy S7 FE (12.4, 64GB WIFI) LIGHT PINK;COMPUTACION
8066746;Casado;M;63;CHILENO;PROFESOR;Boomers;RENCA                         ;METROPOLITANA;209990;1;1;1;1;209990;0;0;0;Galaxy Tab A8 (10.5, 64GB, WIFI) Silver;COMPUTACION
12434902;;F;48;CHILENO;;X;ARICA                         ;ARICA Y PARINACOTA;1197960;4;3;0;0;0;4;3;1197960;NTBK 15-eh0006la Ryzen 5-4500U/8GB/512GB/15P;COMPUTACION
20226562;;M;22;CHILENO;;Z;PROVIDENCIA                   ;METROPOLITANA;517910;8;3;8;3;517910;0;0;0;NTBK IP S145 AMD A4-9125/4GB/500GB/14P;COMPUTACION
6811905;;M;70;CHILENO;;Silencioso;N/D;N/D;584960;4;4;0;0;0;4;4;584960;NTBK 15-dw1080la Celeron N4020/4GB/1TB/15P;COMPUTACION
9650422;;F;59;CHILENO;;Boomers;N/D;N/D;526960;4;2;2;1;283980;2;1;242980;NTBK HT14 Celeron N4020 4GB/128GB SSD/14P;COMPUTACION
17275743;;M;33;CHILENO;;Millenial;"";"";303980;2;1;2;1;303980;0;0;0;NTBK X415 Core i3-10110U/4GB/256GB SSD/14P FHD;COMPUTACION
14584729;;F;42;CHILENO;;X;SAN JAVIER                    ;MAULE;414990;1;1;0;0;0;1;1;414990;NTBK Aspire 3 Athlon 3020e/8GB/256GB SSD/14P;COMPUTACION
19965119;;F;23;CHILENO;;Z;ANCUD                         ;LOS LAGOS;617910;9;4;0;0;0;9;4;617910;NTBK IP S145 AMD A4-9125/4GB/500GB/14P;COMPUTACION
19603681;;F;25;CHILENO;;Z;PROVIDENCIA                   ;METROPOLITANA;231970;3;2;0;0;0;3;2;231970;Multifuncional EcoTank L3250 Wifi;COMPUTACION
7249052;;M;67;CHILENO;;Boomers;SAN FERNANDO                  ;L.G.B.OÂ´HIGGINS;152350;4;2;0;0;0;4;2;152350;TINTA EPSON BOTELLA MAGENTA T664320 SERIE L;COMPUTACION
6224248;;F;73;CHILENO;;Silencioso;ANTOFAGASTA                   ;ANTOFAGASTA;350960;4;1;0;0;0;4;1;350960;NTBK 15-dw1080la Celeron N4020/4GB/1TB/15P;COMPUTACION
17968651;;F;31;CHILENO;;Millenial;N/D;N/D;582940;7;4;0;0;0;7;4;582940;TAB Galaxy A7 Lite (8.7, 32GB, WIFI + 4G);COMPUTACION
19346584;;F;26;CHILENO;;Z;TALCA                         ;MAULE;149990;1;1;0;0;0;1;1;149990;Multifuncional EcoTank L3210;COMPUTACION
11041440;;F;57;CHILENO;;Boomers;BUIN                          ;METROPOLITANA;419990;1;1;0;0;0;1;1;419990;NTBK IP3 Ryzen 3-5300U/8GB/256GB SSD/14P FHD;COMPUTACION
16025577;;F;36;CHILENO;;Millenial;ROMERAL                       ;MAULE;242980;2;1;0;0;0;2;1;242980;Multifuncional EcoTank L3250 Wifi;COMPUTACION
8028542;;M;64;CHILENO;;Boomers;EL BOSQUE                     ;METROPOLITANA;423980;2;1;0;0;0;2;1;423980;NTBK X415 Core i3-10110U/4GB/256GB SSD/14P FHD;COMPUTACION
10297262;;F;55;CHILENO;;Boomers;N/D;N/D;330970;3;2;0;0;0;3;2;330970;Multifuncional Smart tank 530 WiFi ADF;COMPUTACION
16546353;;M;35;CHILENO;;Millenial;PROVIDENCIA                   ;METROPOLITANA;361970;3;2;0;0;0;3;2;361970;NTBK IP1 AMD 3020e/4GB/64GB eMMC/14P;COMPUTACION
9414950;;M;60;CHILENO;;Boomers;RENCA                         ;METROPOLITANA;179990;1;1;0;0;0;1;1;179990;NTBK 15-dw1080la Celeron N4020/4GB/1TB/15P;COMPUTACION
15540395;;F;38;CHILENO;;X;PROVIDENCIA                   ;METROPOLITANA;679970;3;1;0;0;0;3;1;679970;NTBK Aspire 5 R5-3500U/12GB/256SSD GB/15P FHD;COMPUTACION
18951935;;M;27;CHILENO;;Millenial;OLIVAR                        ;L.G.B.OÂ´HIGGINS;179990;1;1;0;0;0;1;1;179990;Multifuncional Ink Tank 415 Wifi;COMPUTACION
26651834;;F;34;VENEZOLANO;;Extranjero;"";"";183980;2;1;2;1;183980;0;0;0;NTBK 15-dw1080la Celeron N4020/4GB/1TB/15P;COMPUTACION
16277421;;F;36;CHILENO;;Millenial;N/D;N/D;251930;7;4;6;3;181940;1;1;69990;TAB Galaxy A7 Lite (8.7, 32GB, WIFI);COMPUTACION
11978926;;F;50;CHILENO;;X;PROVIDENCIA                   ;METROPOLITANA;648980;2;2;0;0;0;2;2;648980;NTBK Aspire 5 Ci3-10110U/12GB/512GB SSD/15P FHD;COMPUTACION
14613775;;M;43;CHILENO;;X;LOS ANDES                     ;VALPARAISO;149990;1;1;0;0;0;1;1;149990;Multifuncional EcoTank L3210;COMPUTACION
20528233;;F;21;CHILENO;;Z;PROVIDENCIA                   ;METROPOLITANA;119990;1;1;0;0;0;1;1;119990;TAB Galaxy A7 Lite (8.7, 32GB, WIFI + 4G);COMPUTACION
10275435;;F;57;CHILENO;;Boomers;PUDAHUEL                      ;METROPOLITANA;163980;2;1;2;1;163980;0;0;0;Multifuncional EcoTank L3210;COMPUTACION
15965203;;F;37;CHILENO;;Millenial;N/D;N/D;378980;2;1;2;1;378980;0;0;0;NTBK IP3 Athlon 3050U/8GB/1TB/14P;COMPUTACION
18150892;;M;30;CHILENO;;Millenial;CERRO NAVIA                   ;METROPOLITANA;33980;2;1;2;1;33980;0;0;0;TELON BUNDLE PROYECTOR EPSON;COMPUTACION
19851576;;F;24;CHILENO;;Z;PROVIDENCIA                   ;METROPOLITANA;97980;2;1;2;1;97980;0;0;0;Multifuncional Laser DCP-1602 Monocromatica;COMPUTACION
15753631;;F;37;CHILENO;;Millenial;PROVIDENCIA                   ;METROPOLITANA;606980;2;1;2;1;606980;0;0;0;NTBK IP5 Ryzen 7-4700U/16GB/256GB SSD/15P FHD;COMPUTACION
20305854;;M;22;CHILENO;;Millenial;PROVIDENCIA                   ;METROPOLITANA;1035970;3;2;3;2;1035970;0;0;0;NTBK G14 R7-4800HS/16GB/512SSD/1650 4G/14P 120Hz;COMPUTACION
26435367;;F;29;VENEZOLANO;;Extranjero;PROVIDENCIA                   ;METROPOLITANA;159990;1;1;0;0;0;1;1;159990;Multifuncional EcoTank L3210;COMPUTACION
18591135;;M;28;CHILENO;;Millenial;PANGUIPULLI                   ;LOS RIOS;478530;3;2;2;1;108540;1;1;369990;NTBK Aspire 3 Athlon 3020e/8GB/256GB SSD/14P;COMPUTACION
27141144;;M;25;NO INFORMA NACIONALIDAD;;Extranjero;PROVIDENCIA                   ;METROPOLITANA;399990;1;1;0;0;0;1;1;399990;NTBK IP3 Ryzen 3-5300U/8GB/256GB SSD/14P FHD;COMPUTACION
18292075;;F;31;CHILENO;;Millenial;CHILLAN;BIO-BIO;245480;2;1;2;1;245480;0;0;0;NTKB X415MA-EK490T;COMPUTACION
16838299;;M;33;CHILENO;;Millenial;TALCA                         ;MAULE;646960;4;2;0;0;0;4;2;646960;NTBK 14-dy0501laCi3-1125G4/8GB/256SSD/FHD/Pen;COMPUTACION
9870272;;M;56;CHILENO;;Boomers;SAN VICENTE                   ;L.G.B.OÂ´HIGGINS;449439;4;3;0;0;0;4;3;449439;NTBK 240 G8 Celeron N4020/4GB/500GB/14P;COMPUTACION
11621324;;F;51;CHILENO;;X;RENCA                         ;METROPOLITANA;225980;2;1;2;1;225980;0;0;0;NTBK 14-ck2091la i3-10110U 4GB 128GB 14 HD;COMPUTACION
13814526;;F;41;CHILENO;;X;RANCAGUA                      ;L.G.B.OÂ´HIGGINS;624940;6;1;0;0;0;6;1;624940;AIO/Athlon 3050U/4GB/1TB + 256GB/UMA/White;COMPUTACION
10303130;;F;60;CHILENO;;Boomers;SAN JAVIER                    ;MAULE;219980;2;2;0;0;0;2;2;219980;NTBK D330 Celeron N4020/4GB/64GB/10P+OfficeHS;COMPUTACION
9808904;;F;58;CHILENO;;Boomers;PROVIDENCIA                   ;METROPOLITANA;268950;5;1;0;0;0;5;1;268950;Multifuncional EcoTank L3210;COMPUTACION
11715752;;M;51;CHILENO;;X;CALBUCO                       ;LOS LAGOS;236840;5;4;0;0;0;5;4;236840;TAB Galaxy Tab A 8 4Core 2GB 32GB 8 Gris;COMPUTACION
1574518;;F;96;CHILENO;;Silencioso;COPIAPO                       ;ATACAMA;480970;3;1;0;0;0;3;1;480970;NTBK 240 G8 Core i3-1005G1/4GB/1TB/14P;COMPUTACION
18185200;;M;30;CHILENO;;Millenial;LA PINTANA                    ;METROPOLITANA;953980;2;1;2;1;953980;0;0;0;MBA 13.3 SLV/8C CPU/7C GPU/8GB/256GB-BES;COMPUTACION
15947036;;M;37;CHILENO;;Millenial;N/D;N/D;819940;6;6;0;0;0;6;6;819940;NTBK 14-cf2097la Pentium Gold 6405U/8GB/256GB/14;COMPUTACION
17307499;;M;32;CHILENO;;Millenial;PROVIDENCIA                   ;METROPOLITANA;422970;3;2;2;1;407980;1;1;14990;NTBK 14-dy0501laCi3-1125G4/8GB/256SSD/FHD/Pen;COMPUTACION
11119388;;F;55;CHILENO;;Boomers;PROVIDENCIA                   ;METROPOLITANA;89990;1;1;1;1;89990;0;0;0;TAB Galaxy A7 Lite (8.7, 32GB, WIFI);COMPUTACION
9992738;;F;58;CHILENO;;Z;PROVIDENCIA                   ;METROPOLITANA;433980;2;1;2;1;433980;0;0;0;TAB Galaxy S7 FE (12.4, 128GB WIFI) BLACK;COMPUTACION
15438291;;F;40;CHILENO;;X;CHIMBARONGO                   ;L.G.B.OÂ´HIGGINS;886910;9;5;0;0;0;9;5;886910;NTBK 240 G8 Celeron N4020/4GB/500GB/14P;COMPUTACION
13486016;;M;44;CHILENO;;X;"";"";84960;4;2;4;2;84960;0;0;0;TAB MLAB 7 MB4 PLUS 3G 1+16GB WHITE 8762;COMPUTACION
14082846;;F;41;CHILENO;;X;VALDIVIA                      ;LOS LAGOS;3000;2;2;0;0;0;2;2;3000;NTBK IP3 Ryzen 3-5300U/8GB/256GB SSD/14P FHD;COMPUTACION
20249462;;F;22;CHILENO;;Z;IQUIQUE                       ;TARAPACA;245970;3;2;0;0;0;3;2;245970;Multifuncional Ink Tank 415 Wifi;COMPUTACION
17262267;;M;33;CHILENO;;Millenial;PROVIDENCIA                   ;METROPOLITANA;99990;1;1;0;0;0;1;1;99990;TAB Galaxy A7 Lite (8.7, 32GB, WIFI);COMPUTACION
26137353;;F;32;VENEZOLANO;;Extranjero;PUERTO VARAS                  ;LOS LAGOS;208980;2;1;2;1;208980;0;0;0;NTBK IP S145 AMD A4-9125/4GB/500GB/14P;COMPUTACION
16197448;;F;37;CHILENO;;Millenial;MAIPU                         ;METROPOLITANA;223980;2;1;2;1;223980;0;0;0;NTBK IP3i Celeron N4020/4G/500GB/14P/Rojo;COMPUTACION
16811710;;M;34;CHILENO;;Millenial;PROVIDENCIA                   ;METROPOLITANA;443980;2;1;0;0;0;2;1;443980;AIO 200 G4 Pentium J5040/4GB/1TB/21.5P Full HD;COMPUTACION
13543452;;M;43;CHILENO;;X;N/D;N/D;838050;9;5;4;2;417080;5;3;420970;Monitor Emerald 27P 165Hz Full HD;COMPUTACION
25623868;;F;50;COLOMBIANO;;Extranjero;ALTO HOSPICIO;TARAPACA;281980;2;1;0;0;0;2;1;281980;NTBK 240 G8 Celeron N4020/4GB/500GB/14P;COMPUTACION
13833676;;M;43;CHILENO;;X;LA PINTANA                    ;METROPOLITANA;303980;2;1;2;1;303980;0;0;0;TAB Galaxy S7 FE (12.4, 64GB WIFI) BLACK;COMPUTACION
5348763;;M;73;CHILENO;;Silencioso;MAIPU                         ;METROPOLITANA;394970;3;1;0;0;0;3;1;394970;AIO 200 G4 Pentium J5040/4GB/1TB/21.5P Full HD;COMPUTACION
26913083;;F;45;EXTRANJERO - NO INFORMA NACIONALIDAD;;Extranjero;N/D;N/D;0;0;2;0;0;0;0;2;0;TAB 7 MB4 Plus 4Core 1GB 16GB 7 Plata;COMPUTACION
18288980;;F;29;CHILENO;;Millenial;"";"";208540;2;1;2;1;208540;0;0;0;Multifuncional DCPT720DW Wifi, Duplex y ADF;COMPUTACION
16050610;;F;37;CHILENO;;Millenial;CAUQUENES                     ;MAULE;369990;1;1;0;0;0;1;1;369990;NTBK Aspire 3 Athlon 3020e/8GB/256GB SSD/14P;COMPUTACION
18219011;Soltero;F;29;CHILENO;;Millenial;PROVIDENCIA                   ;METROPOLITANA;332980;2;1;0;0;0;2;1;332980;NTBK IP Chromebook Octacore/4GB/128GB/10P FHD;COMPUTACION
18457482;;F;29;CHILENO;;Millenial;"";"";439970;5;3;3;2;264990;2;1;174980;Multifuncional Pixma TR4522 Wifi;COMPUTACION
25399230;Casado;F;31;CHILENO;;Extranjero;PROVIDENCIA                   ;METROPOLITANA;364980;2;1;0;0;0;2;1;364980;NTBK 240 G8 Celeron N4020/4GB/500GB/14P;COMPUTACION
4454603;;M;80;CHILENO;;Silencioso;CASTRO                        ;LOS LAGOS;229990;1;1;1;1;229990;0;0;0;NTBK 240 G8 Celeron N4020/4GB/500GB/14P;COMPUTACION
14062099;;F;40;CHILENO;;X;N/D;N/D;44990;1;2;1;1;34990;0;1;10000;TAB MLAB MBX 8 QUAD CORE 1G+16G 8716;COMPUTACION
19054189;;M;27;CHILENO;;Z;"";"";99990;1;1;0;0;0;1;1;99990;TAB Galaxy A7 Lite (8.7, 32GB, WIFI);COMPUTACION
19187486;;F;27;CHILENO;;Z;PUENTE ALTO                   ;METROPOLITANA;169950;5;3;0;0;0;5;3;169950;TAB Galaxy A7 Lite (8.7, 32GB, WIFI + 4G);COMPUTACION
17714498;;M;31;CHILENO;;Millenial;N/D;N/D;89990;1;1;1;1;89990;0;0;0;Tablet HMS Matepad T10;COMPUTACION
9778407;;M;59;CHILENO;;Boomers;N/D;N/D;399820;4;2;4;2;399820;0;0;0;NTBK 14-cf2097la Pentium Gold 6405U/8GB/256GB/14;COMPUTACION
14594500;;F;44;CHILENO;;X;ARICA                         ;TARAPACA;621540;2;1;2;1;621540;0;0;0;NTBK D14 Ci5-10210U/8GB/512SSD/14 FHD/ office365;COMPUTACION
19807965;;M;24;CHILENO;;Millenial;LINARES                       ;MAULE;159990;1;1;0;0;0;1;1;159990;Galaxy Tab A7 (10.4 ,32GB, WIFI) Dark Gray;COMPUTACION
11942435;;F;50;CHILENO;;X;LA LIGUA                      ;VALPARAISO;359990;1;1;0;0;0;1;1;359990;NTBK Aspire 3 Athlon 3020e/8GB/256GB SSD/14P;COMPUTACION
13759233;;M;41;CHILENO;;X;PADRE HURTADO                 ;METROPOLITANA;133980;2;1;2;1;133980;0;0;0;Galaxy Tab A7 (10.4 ,32GB, WIFI) Gold;COMPUTACION
16988471;;F;33;CHILENO;;Millenial;LOS ANGELES                   ;BIO BIO;67830;3;2;3;2;67830;0;0;0;TAB 7 MB4 Plus 4Core 1GB 16GB 7 Plata;COMPUTACION
15990293;;M;36;CHILENO;;Millenial;IQUIQUE                       ;TARAPACA;305980;2;1;0;0;0;2;1;305980;NTBK IP Chromebook Octacore/4GB/128GB/10P FHD;COMPUTACION
14507890;;M;46;CHILENO;;X;CONSTITUCION                  ;MAULE;276980;2;1;0;0;0;2;1;276980;NTBK IP3i Celeron N4020/4G/500GB/14P/Rojo;COMPUTACION
15925643;;M;37;CHILENO;;Millenial;ALTO HOSPICIO;TARAPACA;129980;2;1;0;0;0;2;1;129980;TAB M8 QC 2GB 32GB 8P Gris;COMPUTACION
6711116;Casado;M;70;CHILENO;;Silencioso;PROVIDENCIA                   ;METROPOLITANA;349990;1;1;0;0;0;1;1;349990;AIO 200 G4 Pentium J5040/4GB/1TB/21.5P Full HD;COMPUTACION
16626451;;F;34;CHILENO;;Millenial;"";"";219990;1;1;1;1;219990;0;0;0;NTBK IP3i Celeron N4020/4G/500GB/14P/Rojo;COMPUTACION
12262783;;F;49;CHILENO;;X;RENCA                         ;METROPOLITANA;38980;2;1;2;1;38980;0;0;0;TAB 7 MB4 Plus 4Core 1GB 16GB 7 Plata;COMPUTACION
6603525;;F;76;CHILENO;;Silencioso;ARAUCO                        ;BIO BIO;312660;3;2;0;0;0;3;2;312660;AIO 21-b0021la Pentium J5040 8GB 1TB;COMPUTACION
18296660;;F;29;CHILENO;;Millenial;CHIMBARONGO                   ;L.G.B.OÂ´HIGGINS;69540;2;1;2;1;69540;0;0;0;TABLET ALCATEL 1T 7 REFRESH 32+1 BLACK;COMPUTACION
17653191;;M;31;CHILENO;;Millenial;PANGUIPULLI                   ;LOS RIOS;49990;1;1;0;0;0;1;1;49990;TAB MLAB MBX 8 QUAD CORE 1G+16G 8716;COMPUTACION
13284673;;F;45;CHILENO;;X;LA PINTANA                    ;METROPOLITANA;607960;4;2;4;2;607960;0;0;0;TAB P11 6GB128SG Pen Slate Grey;COMPUTACION
18591408;Soltero;F;28;CHILENO;PROFESOR;Millenial;PROVIDENCIA                   ;METROPOLITANA;106960;4;1;0;0;0;4;1;106960;TAB 7 MB4 Plus 4Core 1GB 16GB 7 Plata;COMPUTACION
18869539;;F;27;CHILENO;;Millenial;ARICA                         ;ARICA Y PARINACOTA;159980;2;1;2;1;159980;0;0;0;TAB Galaxy A7 Lite (8.7, 32GB, WIFI);COMPUTACION
10962410;;M;47;CHILENO;;X;"";"";88980;2;1;2;1;88980;0;0;0;TAB M8 QC 2GB 32GB 8P Gris;COMPUTACION
7680097;;M;61;CHILENO;;Boomers;N/D;N/D;251480;2;1;2;1;251480;0;0;0;NTBK 14-cf2097la Pentium Gold 6405U/8GB/256GB/14;COMPUTACION
18606092;Soltero;M;29;CHILENO;;Millenial;SAN JOSE DE MAIPO             ;METROPOLITANA;45990;1;1;0;0;0;1;1;45990;TAB MLAB MBX 8 QUAD CORE 1G+16G 8716;COMPUTACION
16010037;;M;37;CHILENO;;Millenial;ANTOFAGASTA                   ;ANTOFAGASTA;137990;1;1;0;0;0;1;1;137990;TAB Matepad T10S 3GB 64GB 10P;COMPUTACION
14042648;;F;41;CHILENO;;X;COIHAIQUE                     ;AYSEN;35970;3;1;0;0;0;3;1;35970;TINTA 664 NEGRA;COMPUTACION
26195079;Soltero;M;45;VENEZOLANO;;Extranjero;PROVIDENCIA                   ;METROPOLITANA;303980;2;1;2;1;303980;0;0;0;TAB P11 6GB128SG Pen Slate Grey;COMPUTACION
20126496;;F;22;CHILENO;;Silencioso;PROVIDENCIA                   ;METROPOLITANA;29980;2;1;0;0;0;2;1;29980;TINTA 664 NEGRA;COMPUTACION
19655461;;F;33;CHILENO;;Millenial;PANGUIPULLI                   ;LOS RIOS;64980;2;1;0;0;0;2;1;64980;TAB MLAB MBX 8 QUAD CORE 1G+16G 8716;COMPUTACION
18130447;;M;29;CHILENO;;Millenial;OSORNO                        ;LOS LAGOS;256520;4;3;2;1;238540;2;2;17980;NTBK 14-cf2097la Pentium Gold 6405U/8GB/256GB/14;COMPUTACION
19929939;;F;24;CHILENO;;Z;PROVIDENCIA                   ;METROPOLITANA;34990;1;1;1;1;34990;0;0;0;TAB 7 MB4 Plus 4Core 1GB 16GB 7 Negra;COMPUTACION
13865910;;F;41;CHILENO;;X;N/D;N/D;139990;1;1;0;0;0;1;1;139990;TAB Galaxy Tab A+SPen 8Core 3GB 32GB 8 Gris;COMPUTACION
12947438;;F;45;CHILENO;;X;N/D;N/D;424980;2;3;0;0;0;2;3;424980;NTBK 240 G8 Core i3-1005G1/4GB/1TB/14P;COMPUTACION
19667960;;M;24;CHILENO;;Z;MONTE PATRIA                  ;COQUIMBO;139990;1;1;0;0;0;1;1;139990;Tab M10 FHD Plus LTE 10.3IN 2GB 32GB;COMPUTACION
17010304;;M;33;CHILENO;;Millenial;PADRE HURTADO;METROPOLITANA;343950;5;2;5;2;343950;0;0;0;Tab M8 2G-32GB 8-inch IPS HD Wifi Grey;COMPUTACION
16702143;;F;34;CHILENO;;Millenial;N/D;N/D;239990;1;1;0;0;0;1;1;239990;NTBK IP1 AMD 3020e/4GB/64GB eMMC/14P;COMPUTACION
19476018;Soltero;M;25;CHILENO;;Z;PROVIDENCIA                   ;METROPOLITANA;403980;2;1;2;1;403980;0;0;0;NTBK IP3 Ryzen 3-5300U/8GB/256GB SSD/14P FHD;COMPUTACION
24240578;;F;41;BOLIVIANO;;Extranjero;ALTO HOSPICIO;TARAPACA;84990;1;1;0;0;0;1;1;84990;TAB M8 QC 2GB 32GB 8P Gris;COMPUTACION
15837302;;F;38;CHILENO;;Millenial;RECOLETA                      ;METROPOLITANA;273980;2;1;2;1;273980;0;0;0;TAB S6 Lite (610) 4GB 64GB 10.4P PINK;COMPUTACION
18441445;;F;29;CHILENO;;Millenial;PROVIDENCIA                   ;METROPOLITANA;53980;2;1;0;0;0;2;1;53980;TAB MLAB MBX 8 QUAD CORE 1G+16G 8716;COMPUTACION
17369624;;F;33;CHILENO;;Millenial;N/D;N/D;287970;3;2;0;0;0;3;2;287970;TAB M8 QC 2GB 32GB 8P Gris;COMPUTACION
17384157;;M;32;CHILENO;;Millenial;N/D;N/D;133980;2;1;2;1;133980;0;0;0;Galaxy Tab A7 (10.4 ,32GB, WIFI) Gold;COMPUTACION
23840600;;F;30;PERUANO;;Extranjero;RECOLETA                      ;METROPOLITANA;96980;2;1;0;0;0;2;1;96980;TAB GAMER 7 QUAD CORE 2G+16G 8715;COMPUTACION
15662708;;F;38;CHILENO;;X;RENCA                         ;METROPOLITANA;99990;1;1;1;1;99990;0;0;0;Tab M10 HD 2G-32GB 10.1 Iron grey WiFi;COMPUTACION
12607016;Casado;M;48;CHILENO;DISENADOR GRAFICO;X;SAN JAVIER                    ;MAULE;79990;1;1;0;0;0;1;1;79990;TAB M8 QC 2GB 32GB 8P Gris;COMPUTACION
18495866;;F;29;CHILENO;;Millenial;ISLA DE MAIPO                 ;METROPOLITANA;139990;1;1;1;1;139990;0;0;0;Tab M10 FHD Plus LTE 10.3IN 2GB 32GB;COMPUTACION
17579900;;M;31;CHILENO;;Millenial;PROVIDENCIA                   ;METROPOLITANA;229990;1;1;1;1;229990;0;0;0;NTBK 14-cf2097la Pentium Gold 6405U/8GB/256GB/14;COMPUTACION
15875238;;M;38;CHILENO;;Millenial;COELEMU                       ;BIO BIO;224980;2;1;0;0;0;2;1;224980;NTBK HT14 Celeron N4020 4GB/128GB SSD/14P;COMPUTACION
17747286;;M;31;CHILENO;;Millenial;PLACILLA                      ;L.G.B.OÂ´HIGGINS;49990;1;1;0;0;0;1;1;49990;TAB MLAB MBX 8 QUAD CORE 1G+16G 8716;COMPUTACION
16115551;;F;37;CHILENO;;Millenial;N/D;N/D;611930;7;3;7;3;611930;0;0;0;Galaxy Tab A7 (10.4 ,32GB, WIFI) Gold;COMPUTACION
17938334;;M;30;CHILENO;;Millenial;N/D;N/D;179990;1;1;0;0;0;1;1;179990;NTBK 240 G8 Celeron N4020/4GB/500GB/14P;COMPUTACION
14510071;;M;48;CHILENO;;X;VALDIVIA                      ;LOS RIOS;401970;3;2;0;0;0;3;2;401970;TAB S6 Lite (610) 4GB 64GB 10.4P DARK GREY;COMPUTACION
7486334;;F;68;CHILENO;;Silencioso;PUNITAQUI                     ;COQUIMBO;369990;1;1;0;0;0;1;1;369990;NTBK Aspire 3 Athlon 3020e/8GB/256GB SSD/14P;COMPUTACION
19815089;;F;24;CHILENO;;Z;CABRERO                       ;BIO BIO;170970;3;1;0;0;0;3;1;170970;TAB M8 QC 2GB 32GB 8P Gris;COMPUTACION
13325484;;M;44;CHILENO;;X;COIHAIQUE                     ;AYSEN;313360;4;3;0;0;0;4;3;313360;Tab M10 FHD Plus LTE 10.3IN 2GB 32GB;COMPUTACION
19679075;;M;24;CHILENO;;Z;PROVIDENCIA                   ;METROPOLITANA;49990;1;1;1;1;49990;0;0;0;TAB MLAB MBX 8 QUAD CORE 1G+16G 8716;COMPUTACION
15409846;;M;42;CHILENO;;X;EL BOSQUE                     ;METROPOLITANA;86000;1;1;1;1;86000;0;0;0;TAB Galaxy A7 Lite (8.7, 32GB, WIFI);COMPUTACION
8915042;Divorciado;F;58;CHILENO;INGENIERO;Boomers;SANTIAGO;METROPOLITANA;591940;6;3;6;3;591940;0;0;0;Monitor Emerald 27P 165Hz Full HD;COMPUTACION
26274849;;M;33;VENEZOLANO;;Extranjero;INDEPENDENCIA                 ;METROPOLITANA;139990;2;1;2;1;139990;0;0;0;TAB-X306X 10-INCH 4G+64G HD WIFI+4G LTE;COMPUTACION
19749462;;F;24;CHILENO;;Z;MELIPILLA                     ;METROPOLITANA;169990;1;3;0;0;0;1;3;169990;NTBK Herobook Celeron N4020/8GB/256SSD/14P FHD;COMPUTACION
16625990;;F;34;CHILENO;;Millenial;VINA DEL MAR;VALPARAISO;234980;2;1;2;1;234980;0;0;0;MULTIFUNCIONAL ECOTANK L5190 Wifi/ Fax;COMPUTACION
10178352;;F;59;CHILENO;;Boomers;PADRE LAS CASAS               ;ARAUCANIA;792980;2;1;0;0;0;2;1;792980;NTBK GAMER GF63 Ci5-10500H/8GB/512SSD/1650 4GB;COMPUTACION
26493179;;F;36;EXTRANJERO - NO INFORMA NACIONALIDAD;;Extranjero;SANTIAGO                      ;METROPOLITANA;443970;3;1;3;1;443970;0;0;0;MULTIFUNCIONAL ECOTANK L4160 Wifi;COMPUTACION
12012181;;M;53;CHILENO;;X;RENCA                         ;METROPOLITANA;199980;2;1;0;0;0;2;1;199980;Tab M10 HD 2G-32GB 10.1 Iron grey WiFi;COMPUTACION
12350259;;M;48;CHILENO;;X;N/D;N/D;440670;2;1;0;0;0;2;1;440670;NTBK Herobook Celeron N4020/8GB/256SSD/14P FHD;COMPUTACION
18669062;Soltero;M;28;CHILENO;;Millenial;LO ESPEJO                     ;METROPOLITANA;403970;3;1;3;1;403970;0;0;0;Monitor Emerald 27P 165Hz Full HD;COMPUTACION
17337907;;F;32;CHILENO;;Millenial;COLINA                        ;METROPOLITANA;168960;5;3;4;2;118970;1;1;49990;TAB MLAB MBX 8 QUAD CORE 1G+16G 8716;COMPUTACION
18087150;;F;30;CHILENO;;Millenial;BUIN                          ;METROPOLITANA;536240;5;2;0;0;0;5;2;536240;NTBK 240 G8 Celeron N4020/4GB/500GB/14P;COMPUTACION
9642493;;M;59;CHILENO;;Boomers;LITUECHE                      ;L.G.B.OÂ´HIGGINS;696370;2;1;0;0;0;2;1;696370;NTBK 15-ek0010la Core i5 8+32 512SSD 2060 6GB;COMPUTACION
13939117;;M;42;CHILENO;;X;PROVIDENCIA                   ;METROPOLITANA;399990;2;1;2;1;399990;0;0;0;NTBK Aspire 3 Athlon 3020e/8GB/256GB SSD/14P;COMPUTACION
19223486;Soltero;F;26;CHILENO;;Z;PROVIDENCIA                   ;METROPOLITANA;104990;1;1;0;0;0;1;1;104990;Matepad T10S WIFI 2+32 GB;COMPUTACION
12229937;;M;50;CHILENO;;X;RENCA                         ;METROPOLITANA;1089960;4;2;4;2;1089960;0;0;0;NTBK Vivobook 15.6 FHD i7-1065G7, 8GB, RAM - 1TB;COMPUTACION
15667201;;F;38;CHILENO;;X;PROVIDENCIA                   ;METROPOLITANA;139990;1;1;1;1;139990;0;0;0;TAB-X306X 10-INCH 4G+64G HD WIFI+4G LTE;COMPUTACION
16877482;;M;34;CHILENO;;Millenial;PROVIDENCIA                   ;METROPOLITANA;265980;3;1;3;1;265980;0;0;0;TAB Galaxy A7 Lite (8.7, 32GB, WIFI);COMPUTACION
12022048;;M;49;CHILENO;;X;"";"";59990;1;1;0;0;0;1;1;59990;Multifuncional DeskJet Ink Advantage 3775 Wifi;COMPUTACION
11527918;Soltero;F;52;CHILENO;ANALISTA DE SISTEMAS;X;RENCA                         ;METROPOLITANA;214540;2;1;2;1;214540;0;0;0;MULTIFUNCIONAL ECOTANK L4160 Wifi;COMPUTACION
6575134;Casado;F;69;CHILENO;;Silencioso;PROVIDENCIA                   ;METROPOLITANA;139990;1;1;0;0;0;1;1;139990;Impresora Monocromatica Xerox B210-NDI;COMPUTACION
15089296;;F;39;CHILENO;;X;RENCA                         ;METROPOLITANA;350960;4;2;4;2;350960;0;0;0;Galaxy Tab A7 (10.4 ,32GB, WIFI) Gold;COMPUTACION
9818624;Casado;M;58;CHILENO;;Boomers;PROVIDENCIA                   ;METROPOLITANA;432980;2;1;0;0;0;2;1;432980;NTBK IP3 Athlon 3050U/8GB/1TB/14P;COMPUTACION
11982432;;M;50;CHILENO;;X;IQUIQUE                       ;TARAPACA;746440;4;4;0;0;0;4;4;746440;NTBK IP3 Athlon 3050U/8GB/1TB/14P;COMPUTACION
18872175;Soltero;F;27;CHILENO;;Z;PROVIDENCIA                   ;METROPOLITANA;1138530;4;2;4;2;1138530;0;0;0;NTBK GAMER N5 Ci5-10300H/16GB/512SSD/GTX1650 4GB;COMPUTACION
16099661;Casado;M;36;CHILENO;INGENIERO COMERCIAL;Millenial;RENCA                         ;METROPOLITANA;39990;2;1;2;1;39990;0;0;0;TAB 7 MB4 Plus 4Core 1GB 16GB 7 Plata;COMPUTACION
15829863;Casado;F;38;CHILENO;;Millenial;PROVIDENCIA                   ;METROPOLITANA;154540;2;1;2;1;154540;0;0;0;Galaxy Tab A7 (10.4 ,32GB, WIFI) Dark Gray;COMPUTACION
15392254;Casado;M;42;CHILENO;;X;PROVIDENCIA                   ;METROPOLITANA;229990;1;1;0;0;0;1;1;229990;MULTIFUNCIONAL ECOTANK L5190 Wifi/ Fax;COMPUTACION
9152478;Casado;M;58;CHILENO;CONTADOR AUDITOR;Boomers;RENCA                         ;METROPOLITANA;139960;5;1;5;1;139960;0;0;0;TAB 7 MB4 Plus 4Core 1GB 16GB 7 Plata;COMPUTACION
16136111;;F;36;CHILENO;;Millenial;ANTOFAGASTA                   ;ANTOFAGASTA;143980;2;2;0;0;0;2;2;143980;Tab M10 HD 2G-32GB 10.1 Iron grey WiFi;COMPUTACION
15722108;;F;38;CHILENO;;Z;PROVIDENCIA                   ;METROPOLITANA;31960;4;1;0;0;0;4;1;31960;TINTA BOTELLA EPSON T664120 NEGRA SERIE L;COMPUTACION
8952918;Soltero;M;59;CHILENO;CONTADOR GENERAL;Boomers;PROVIDENCIA                   ;METROPOLITANA;141570;2;1;0;0;0;2;1;141570;Tab M10 HD 2G-32GB 10.1 Iron grey WiFi;COMPUTACION
7602125;;F;73;CHILENO;;Silencioso;PROVIDENCIA                   ;METROPOLITANA;132470;2;1;0;0;0;2;1;132470;Tab M10 HD 2G-32GB 10.1 Iron grey WiFi;COMPUTACION
18242822;;M;30;CHILENO;;Millenial;PROVIDENCIA                   ;METROPOLITANA;633980;2;1;2;1;633980;0;0;0;NTBK Gaming 3 Ryzen 5 4600H 8GB 512SSD G1650 4GB;COMPUTACION
26521549;;M;28;CHILENO;;Extranjero;N/D;N/D;79990;1;1;1;1;79990;0;0;0;TAB Galaxy A7 Lite (8.7, 32GB, WIFI);COMPUTACION
17079972;Soltero;F;33;CHILENO;ENFERMERA;Millenial;SAN ANTONIO                   ;VALPARAISO;119990;1;1;0;0;0;1;1;119990;Matepad T10S WIFI 2+32 GB;COMPUTACION
11380049;;M;53;CHILENO;;X;N/D;N/D;142100;2;1;0;0;0;2;1;142100;Tablet PRO 8 32GB WIFI + Funda Azul;COMPUTACION
19919176;;F;23;CHILENO;;Silencioso;PROVIDENCIA                   ;METROPOLITANA;89990;2;1;2;1;89990;0;0;0;TAB Galaxy A7 Lite (8.7, 32GB, WIFI);COMPUTACION
16584577;;M;35;CHILENO;;Silencioso;PROVIDENCIA                   ;METROPOLITANA;144980;2;1;2;1;144980;0;0;0;Multifuncional DCPT520W Wifi;COMPUTACION
20067978;;M;22;CHILENO;;Z;N/D;N/D;54980;2;1;2;1;54980;0;0;0;Router Huawei AX3 WIFI Quad core;COMPUTACION
16654784;;M;35;CHILENO;;Silencioso;PROVIDENCIA                   ;METROPOLITANA;133980;2;1;2;1;133980;0;0;0;Galaxy Tab A7 (10.4 ,32GB, WIFI) Dark Gray;COMPUTACION
18685010;;M;27;CHILENO;;Millenial;PROVIDENCIA                   ;METROPOLITANA;349990;1;1;1;1;349990;0;0;0;NTBK 14-ck2091la i3-10110U 4GB 128GB 14 HD;COMPUTACION
18885001;;M;25;CHILENO;;Z;PROVIDENCIA                   ;METROPOLITANA;629990;1;1;1;1;629990;0;0;0;NTBK 15-dk1028la Ci5-10300H/8GB/256SSD/1050 3GB;COMPUTACION
5398593;;F;74;CHILENO;;Silencioso;SANTIAGO                      ;METROPOLITANA;201210;3;1;0;0;0;3;1;201210;TAB-X306X 10-INCH 4G+64G HD WIFI+4G LTE;COMPUTACION
18966886;;M;27;CHILENO;;Z;MOLINA                        ;MAULE;30480;2;1;2;1;30480;0;0;0;PACK 4 TINTAS T664;COMPUTACION
16479281;;M;35;CHILENO;;Millenial;N/D;N/D;119990;1;1;1;1;119990;0;0;0;TAB Galaxy A 8 + S Pen (8, 32GB, WIFI);COMPUTACION
20374029;;F;22;CHILENO;;Z;PROVIDENCIA                   ;METROPOLITANA;6990;1;1;1;1;6990;0;0;0;TINTA BOTELLA CYAN BT5001C;COMPUTACION
5218429;;F;76;CHILENO;;Silencioso;RENCA                         ;METROPOLITANA;50840;2;1;2;1;50840;0;0;0;TABLET 7 WIFI 1+16;COMPUTACION
18986393;;F;26;CHILENO;;Z;N/D;N/D;595530;3;1;3;1;595530;0;0;0;NTBK D14 Ci5-10210U/8GB/512SSD/14 FHD/ office365;COMPUTACION
17084968;;F;33;CHILENO;;Millenial;PROVIDENCIA                   ;METROPOLITANA;629990;2;1;2;1;629990;0;0;0;NTBK Gaming 3 Ryzen 5 4600H 8GB 512SSD G1650 4GB;COMPUTACION
16150627;;F;36;CHILENO;;Millenial;COLINA                        ;METROPOLITANA;1069860;3;1;0;0;0;3;1;1069860;NTBK 15 FHD Core i5 16/1T+128 + 1650;COMPUTACION
18683277;;M;27;CHILENO;;Millenial;LAS CONDES                    ;METROPOLITANA;334980;2;1;2;1;334980;0;0;0;NTBK IP3 Athlon 3050U/8GB/1TB/14P;COMPUTACION
19618022;;M;24;CHILENO;;Millenial;"";"";144980;2;1;2;1;144980;0;0;0;Galaxy Tab A7 (10.4 ,32GB, WIFI) Dark Gray;COMPUTACION
13522483;;M;44;CHILENO;;X;N/D;N/D;610880;7;4;2;1;348540;5;3;262340;NTBK IP3 Athlon 3050U/8GB/1TB/14P;COMPUTACION
19102010;;M;27;CHILENO;;Z;N/D;N/D;549990;1;1;0;0;0;1;1;549990;NTBK M14 Ryzen 5-5500U 8GB/256GB SSD/14P FHD;COMPUTACION
7002317;;F;66;CHILENO;;Boomers;AISEN                         ;AYSEN;227870;2;1;0;0;0;2;1;227870;Tab Yoga Smart;COMPUTACION
18856978;;F;27;CHILENO;;Z;PROVIDENCIA                   ;METROPOLITANA;9990;1;1;1;1;9990;0;0;0;TINTA 664 TRI COLOR;COMPUTACION
17595249;;F;32;CHILENO;;Millenial;TEMUCO                        ;ARAUCANIA;146980;2;1;2;1;146980;0;0;0;Multifuncional DCPT520W Wifi;COMPUTACION
19742713;;F;24;CHILENO;;Z;PROVIDENCIA                   ;METROPOLITANA;629990;2;1;2;1;629990;0;0;0;NTBK Gaming 3 Ryzen 5 4600H 8GB 512SSD G1650 4GB;COMPUTACION
15841053;;M;37;CHILENO;;Silencioso;PROVIDENCIA                   ;METROPOLITANA;553980;2;1;2;1;553980;0;0;0;NTBK M14 Ryzen 5-5500U 8GB/256GB SSD/14P FHD;COMPUTACION
15752802;;F;38;CHILENO;;Millenial;"";"";799990;1;1;0;0;0;1;1;799990;NTBK GAMER N5 Ci5-10300H/16GB/512SSD/GTX1650 4GB;COMPUTACION
19863992;;F;24;CHILENO;;Silencioso;PROVIDENCIA                   ;METROPOLITANA;579990;2;1;2;1;579990;0;0;0;NTBK D14 Ci5-10210U/8GB/512SSD/14 FHD/ office365;COMPUTACION
17384773;;F;32;CHILENO;;Silencioso;PROVIDENCIA                   ;METROPOLITANA;89990;2;1;2;1;89990;0;0;0;TAB Galaxy A7 Lite (8.7, 32GB, WIFI);COMPUTACION
16230884;;M;37;CHILENO;;Millenial;PROVIDENCIA                   ;METROPOLITANA;229960;3;1;3;1;229960;0;0;0;Galaxy Tab A7 (10.4 ,32GB, WIFI) Silver;COMPUTACION
13817563;;M;42;CHILENO;;X;N/D;N/D;169980;2;2;2;2;169980;0;0;0;TAB Galaxy A7 Lite (8.7, 32GB, WIFI);COMPUTACION
19578291;;M;25;CHILENO;;Z;CHILLAN                       ;BIO BIO;599980;2;2;2;2;599980;0;0;0;NTBK IP3 Athlon 3050U/8GB/1TB/14P;COMPUTACION
20365475;;M;22;CHILENO;;Z;PUDAHUEL                      ;METROPOLITANA;183980;2;1;2;1;183980;0;0;0;Monitor Emerald 27P 165Hz Full HD;COMPUTACION
26579485;;M;37;EXTRANJERO - NO INFORMA NACIONALIDAD;;Extranjero;N/D;N/D;159990;1;1;0;0;0;1;1;159990;TAB Galaxy A7 Lite (8.7, 32GB, WIFI + 4G);COMPUTACION
16843073;;M;32;CHILENO;;Millenial;CHONCHI                       ;LOS LAGOS;302090;3;1;0;0;0;3;1;302090;Multifuncional Ink Tank 415 Wifi;COMPUTACION
15645929;;M;37;CHILENO;;Millenial;PROVIDENCIA                   ;METROPOLITANA;94990;1;1;0;0;0;1;1;94990;TAB Galaxy A7 Lite (8.7, 32GB, WIFI);COMPUTACION
12499166;;M;49;CHILENO;;X;N/D;N/D;149990;2;1;2;1;149990;0;0;0;Galaxy Tab A7 (10.4 ,64GB, WIFI) Dark Gray;COMPUTACION
16341561;;F;36;CHILENO;;Millenial;N/D;N/D;853980;2;1;2;1;853980;0;0;0;PC ARGUS Serie IRX570BSB;COMPUTACION
19380497;;M;26;CHILENO;;Z;N/D;N/D;123980;2;1;2;1;123980;0;0;0;Multifuncional Ink Tank 315;COMPUTACION
10700780;Casado;F;54;CHILENO;ABOGADO;X;TOCOPILLA                     ;ANTOFAGASTA;198570;2;1;0;0;0;2;1;198570;MULTIFUNCIONAL ECOTANK L3150 Wifi;COMPUTACION
7951621;Casado;M;63;CHILENO;;Boomers;RENCA                         ;METROPOLITANA;90000;2;1;0;0;0;2;1;90000;TABLET 7 WIFI 1+16;COMPUTACION
13996114;;M;40;CHILENO;;X;PROVIDENCIA                   ;METROPOLITANA;93980;2;1;2;1;93980;0;0;0;MONITOR LS22F350FHLXZS 1920X1080 PLANO;COMPUTACION
19366837;;M;26;CHILENO;;Millenial;"";"";174980;2;1;2;1;174980;0;0;0;Monitor G25-10 24.5-inch FHD WLED Gaming;COMPUTACION
16972776;;M;33;CHILENO;;Millenial;PARRAL                        ;MAULE;755480;2;1;2;1;755480;0;0;0;NTBK 15-dk1043la i5-10300H 8GB512SSD4V W10H;COMPUTACION
20462868;;F;21;CHILENO;;Z;PROVIDENCIA                   ;METROPOLITANA;-10;1;2;0;0;0;1;2;-10;TAB 7 PLAY AND LEARN PLUS BLUE 8868;COMPUTACION
9083518;;F;66;ECUATORIANO;;Extranjero;ARICA                         ;ARICA Y PARINACOTA;477070;2;1;0;0;0;2;1;477070;NTBK 240 G8 Core i3-1005G1/4GB/1TB/14P;COMPUTACION
7863785;;F;60;CHILENO;;Boomers;N/D;N/D;97870;2;1;0;0;0;2;1;97870;Impresora Monofuncional Laser 107w;COMPUTACION
18443425;;M;29;CHILENO;;Silencioso;PROVIDENCIA                   ;METROPOLITANA;1407960;3;1;3;1;1407960;0;0;0;NTBK Gaming 3 Ryzen 5 4600H 8GB 512SSD G1650 4GB;COMPUTACION
13155359;;M;45;CHILENO;;X;N/D;N/D;189990;1;1;0;0;0;1;1;189990;Galaxy Tab A7 (10.4 ,32GB, WIFI) Dark Gray;COMPUTACION
15877815;;M;38;CHILENO;;Millenial;N/D;N/D;397870;2;1;0;0;0;2;1;397870;NTBK 240 G8 Core i3-1005G1/4GB/1TB/14P;COMPUTACION
7138852;;F;66;CHILENO;;Boomers;ILLAPEL                       ;COQUIMBO;149990;1;1;0;0;0;1;1;149990;TAB Galaxy A7 Lite (8.7, 32GB, WIFI);COMPUTACION
12699834;;F;48;CHILENO;;X;CORONEL                       ;BIO BIO;209990;1;1;0;0;0;1;1;209990;Multifuncional DCPT720DW Wifi, Duplex y ADF;COMPUTACION
10800518;;F;55;CHILENO;;Boomers;TALCA                         ;MAULE;449980;2;2;0;0;0;2;2;449980;AIO/Athlon 3050U/4GB/1TB + 256GB/UMA/White;COMPUTACION
12526623;;F;49;CHILENO;;X;RENCA                         ;METROPOLITANA;165480;2;1;2;1;165480;0;0;0;Multifuncional DCPT720DW Wifi, Duplex y ADF;COMPUTACION
16973213;Soltero;M;33;CHILENO;;Millenial;PROVIDENCIA                   ;METROPOLITANA;44540;2;1;2;1;44540;0;0;0;Impresora Laser HL-1202 Monocromatica;COMPUTACION
8128187;;M;65;CHILENO;;Boomers;LA PINTANA                    ;METROPOLITANA;269990;1;1;0;0;0;1;1;269990;NTBK 240G7 CelN4020 14 4GB/500 PC;COMPUTACION
12183852;;M;49;CHILENO;;X;PARRAL                        ;MAULE;327870;2;1;0;0;0;2;1;327870;NTBK 240G7 CelN4020 14 4GB/500 PC;COMPUTACION
17608086;;M;31;CHILENO;;Millenial;LEBU                          ;BIO BIO;139990;1;1;0;0;0;1;1;139990;Tablet HMS Matepad T10;COMPUTACION
26203443;;M;29;CHILENO;;Extranjero;N/D;N/D;388980;2;1;0;0;0;2;1;388980;NTBK 240 G8 Core i3-1005G1/4GB/1TB/14P;COMPUTACION
10216403;;F;55;CHILENO;;Boomers;CHIGUAYANTE                   ;BIO BIO;533380;3;1;0;0;0;3;1;533380;NTBK S145-14IIL I3 10/4G 128SSD/14HD;COMPUTACION
17859839;;M;31;CHILENO;;Silencioso;PROVIDENCIA                   ;METROPOLITANA;683980;2;1;2;1;683980;0;0;0;NTBK Gaming 3 Ryzen 5 4600H 8GB 512SSD G1650 4GB;COMPUTACION
18052693;;M;30;CHILENO;;Millenial;N/D;N/D;223970;3;2;3;2;223970;0;0;0;Galaxy Tab A7 (10.4 ,32GB, WIFI + 4G) Dark Gray;COMPUTACION
17861083;;F;30;CHILENO;;Millenial;PROVIDENCIA                   ;METROPOLITANA;0;0;0;0;0;0;0;0;0;Galaxy Tab A7 (10.4 ,32GB, WIFI) Dark Gray;COMPUTACION
18326207;;M;29;CHILENO;;Millenial;PROVIDENCIA                   ;METROPOLITANA;0;0;0;0;0;0;0;0;0;NTBK 14-ck2091la i3-10110U 4GB 128GB 14 HD;COMPUTACION
17996871;;F;31;CHILENO;;Millenial;N/D;N/D;0;0;0;0;0;0;0;0;0;Multifuncional DCPT720DW Wifi, Duplex y ADF;COMPUTACION
16699460;;F;34;CHILENO;;Millenial;N/D;N/D;0;0;0;0;0;0;0;0;0;NTBK GAMER N5 Ci5-10300H/16GB/512SSD/GTX1650 4GB;COMPUTACION
19174322;;F;26;CHILENO;;Z;PROVIDENCIA                   ;METROPOLITANA;0;0;0;0;0;0;0;0;0;TAB Galaxy A7 Lite (8.7, 32GB, WIFI);COMPUTACION
15866525;Soltero;F;38;CHILENO;ABOGADO;Millenial;MELIPILLA                     ;METROPOLITANA;0;0;0;0;0;0;0;0;0;IMPRESORA EPSON L120;COMPUTACION
11233626;;F;53;CHILENO;;X;PROVIDENCIA                   ;METROPOLITANA;0;0;0;0;0;0;0;0;0;NTBK 15-dk1043la i5-10300H 8GB512SSD4V W10H;COMPUTACION
13615641;;M;43;CHILENO;;X;CERRO NAVIA                   ;METROPOLITANA;0;0;0;0;0;0;0;0;0;TAB Galaxy Tab A+SPen 8Core 3GB 32GB 8 Gris;COMPUTACION
16372450;;F;36;CHILENO;;Millenial;PROVIDENCIA                   ;METROPOLITANA;0;0;0;0;0;0;0;0;0;IMPRESORA LASER PASHER 3020;COMPUTACION
15617145;;F;38;CHILENO;;Millenial;"";"";0;0;0;0;0;0;0;0;0;T544 DYE BLACK INK BOTTLE (65ml);COMPUTACION
13012948;;M;46;CHILENO;;X;ANTOFAGASTA                   ;ANTOFAGASTA;0;0;0;0;0;0;0;0;0;NTBK 14-ck2091la i3-10110U 4GB 128GB 14 HD;COMPUTACION
18270894;;M;29;CHILENO;;Millenial;VALPARAISO                    ;VALPARAISO;0;0;0;0;0;0;0;0;0;NTBK 14-ck2091la i3-10110U 4GB 128GB 14 HD;COMPUTACION
16768620;;M;34;CHILENO;;Millenial;PROVIDENCIA                   ;METROPOLITANA;0;0;0;0;0;0;0;0;0;NTBK 14-dq1004la Core i5-1035G1 8GB 256SSD 14P;COMPUTACION
18462010;Soltero;F;29;CHILENO;ENFERMERA;Millenial;PROVIDENCIA                   ;METROPOLITANA;0;0;0;0;0;0;0;0;0;TAB Galaxy A7 Lite (8.7, 32GB, WIFI);COMPUTACION
20068420;;F;22;CHILENO;;Z;PROVIDENCIA                   ;METROPOLITANA;0;0;0;0;0;0;0;0;0;Tab Yoga Smart;COMPUTACION
8684244;;M;61;CHILENO;;Boomers;PROVIDENCIA                   ;METROPOLITANA;0;0;0;0;0;0;0;0;0;Tablet PRO 8 32GB WIFI + Funda Azul;COMPUTACION
8843453;;F;45;CHILENO;;Silencioso;PROVIDENCIA                   ;METROPOLITANA;0;0;0;0;0;0;0;0;0;TAB MLAB MBX 8 QUAD CORE 1G+16G 8716;COMPUTACION
15135475;;M;39;CHILENO;;X;PROVIDENCIA                   ;METROPOLITANA;0;0;0;0;0;0;0;0;0;NTBK 240 G8 Core i3-1005G1/4GB/1TB/14P;COMPUTACION
14413545;;M;50;CHILENO;;X;PUERTO MONTT                  ;LOS LAGOS;0;0;0;0;0;0;0;0;0;Multifuncional XP-2101 wifi;COMPUTACION
14612416;;F;41;CHILENO;;X;PROVIDENCIA                   ;METROPOLITANA;0;0;0;0;0;0;0;0;0;NTBK 240 G8 Core i3-1005G1/4GB/1TB/14P;COMPUTACION
17230569;;F;33;CHILENO;;Millenial;"";"";0;0;0;0;0;0;0;0;0;TINTA 664 TRI COLOR;COMPUTACION
12000453;;M;50;CHILENO;;X;LA PINTANA                    ;METROPOLITANA;0;0;0;0;0;0;0;0;0;Multifuncional Smart Tank 515 Wifi;COMPUTACION
14443991;;F;49;CHILENO;;X;N/D;N/D;0;0;0;0;0;0;0;0;0;Tablet PRO 8 32GB WIFI + Funda Azul;COMPUTACION
24915016;;M;58;PERUANO;;Extranjero;CERRILLOS                     ;METROPOLITANA;0;0;0;0;0;0;0;0;0;Tab M10 HD 2G-32GB 10.1 Iron grey WiFi;COMPUTACION
14204705;Soltero;M;41;CHILENO;;X;SAN VICENTE                   ;L.G.B.OÂ´HIGGINS;0;0;0;0;0;0;0;0;0;NTBK 14-ck2091la i3-10110U 4GB 128GB 14 HD;COMPUTACION
13479138;;M;44;CHILENO;;X;N/D;N/D;0;0;0;0;0;0;0;0;0;NTBK 348G7 i3-10110U 14 4GB/1T PC WHOME;COMPUTACION
15552016;Soltero;F;35;CHILENO;PROFESOR;Millenial;PROVIDENCIA                   ;METROPOLITANA;0;0;0;0;0;0;0;0;0;NTBK 15-dk1043la i5-10300H 8GB512SSD4V W10H;COMPUTACION
16980553;Soltero;M;33;CHILENO;;Millenial;PROVIDENCIA                   ;METROPOLITANA;0;0;0;0;0;0;0;0;0;TAB 7 MB4 Plus 4Core 1GB 16GB 7 Plata;COMPUTACION
15613854;Soltero;F;38;CHILENO;ENFERMERA;Silencioso;PROVIDENCIA                   ;METROPOLITANA;0;0;0;0;0;0;0;0;0;TAB Galaxy Tab A 8 4G 4Core 2GB 32GB 8 Gris;COMPUTACION
15843037;;M;37;CHILENO;;Silencioso;PROVIDENCIA                   ;METROPOLITANA;0;0;0;0;0;0;0;0;0;NTBK 240 G8 Core i3-1005G1/4GB/1TB/14P;COMPUTACION
6187344;;M;73;CHILENO;;Silencioso;QUILLOTA                      ;VALPARAISO;0;0;0;0;0;0;0;0;0;NTBK 14-ck2091la i3-10110U 4GB 128GB 14 HD;COMPUTACION
15404560;;M;40;CHILENO;;X;PENAFLOR                      ;METROPOLITANA;0;0;0;0;0;0;0;0;0;Galaxy Tab A7 (10.4 ,32GB, WIFI) Dark Gray;COMPUTACION
10000851;;F;59;CHILENO;;Boomers;MELIPILLA                     ;METROPOLITANA;0;0;0;0;0;0;0;0;0;Multifuncional Ink Tank 415 Wifi;COMPUTACION
15114825;;F;40;CHILENO;;Silencioso;PROVIDENCIA                   ;METROPOLITANA;0;0;0;0;0;0;0;0;0;TAB M7 7 1GB RAM 8 GB ROM Platinum Grey;COMPUTACION
12314302;;M;48;CHILENO;;X;N/D;N/D;0;0;0;0;0;0;0;0;0;Galaxy Tab A7 (10.4 ,32GB, WIFI) Dark Gray;COMPUTACION
26170213;;F;29;VENEZOLANO;;Extranjero;MELIPILLA                     ;METROPOLITANA;0;0;0;0;0;0;0;0;0;MULTIFUNCIONAL ECOTANK L3110;COMPUTACION
11381429;;F;53;CHILENO;;X;VILLA ALEMANA                 ;VALPARAISO;0;0;0;0;0;0;0;0;0;MULTIFUNCIONAL ECOTANK L3110;COMPUTACION
24655666;;M;34;CHILENO;;Extranjero;PROVIDENCIA                   ;METROPOLITANA;0;0;0;0;0;0;0;0;0;NTBK GemiBook Celeron/12GB/256GB/2K/Tec-Ingles;COMPUTACION
6053043;;F;73;CHILENO;;Silencioso;RENCA                         ;METROPOLITANA;0;0;0;0;0;0;0;0;0;TABLET 7 KIDS + KID CASE 1+16;COMPUTACION
14374188;;M;46;CHILENO;;X;CHIGUAYANTE                   ;BIO BIO;0;0;0;0;0;0;0;0;0;NTBK 14-ck2091la i3-10110U 4GB 128GB 14 HD;COMPUTACION
18725390;;M;28;CHILENO;;Millenial;PROVIDENCIA                   ;METROPOLITANA;0;0;0;0;0;0;0;0;0;NTBK 14-ck2091la i3-10110U 4GB 128GB 14 HD;COMPUTACION
7680114;;M;64;CHILENO;;Boomers;ANTOFAGASTA                   ;ANTOFAGASTA;0;0;0;0;0;0;0;0;0;TAB Galaxy A7 Lite (8.7, 32GB, WIFI + 4G);COMPUTACION
15387716;;F;37;CHILENO;;Millenial;PROVIDENCIA                   ;METROPOLITANA;0;0;0;0;0;0;0;0;0;MULTIFUNCIONAL ECOTANK L3150 Wifi;COMPUTACION
12787278;;M;47;CHILENO;;X;TALCA                         ;MAULE;0;0;0;0;0;0;0;0;0;MULTIFUNCIONAL ECOTANK L3110;COMPUTACION
16387786;;F;36;CHILENO;;Millenial;LEBU                          ;BIO BIO;0;0;0;0;0;0;0;0;0;TAB Galaxy Tab A 8 4G 4Core 2GB 32GB 8 Gris;COMPUTACION
16175892;;M;36;CHILENO;;Millenial;LA FLORIDA                    ;METROPOLITANA;0;0;0;0;0;0;0;0;0;TAB Galaxy Tab A 8 4Core 2GB 32GB 8 Gris;COMPUTACION
19114042;;M;27;CHILENO;;Z;LA PINTANA                    ;METROPOLITANA;0;0;0;0;0;0;0;0;0;NTBK 14-ck2091la i3-10110U 4GB 128GB 14 HD;COMPUTACION
6296276;;M;69;CHILENO;;Silencioso;TALCAHUANO                    ;BIO BIO;0;0;0;0;0;0;0;0;0;NTBK 15-dk1028la Ci5-10300H/8GB/256SSD/1050 3GB;COMPUTACION
16459500;;F;35;CHILENO;;Millenial;PROVIDENCIA                   ;METROPOLITANA;0;0;0;0;0;0;0;0;0;TAB Galaxy Tab A 8 4Core 2GB 32GB 8 Gris;COMPUTACION
19363299;;F;26;CHILENO;;Z;N/D;N/D;0;0;0;0;0;0;0;0;0;NTBK 14-ck2091la i3-10110U 4GB 128GB 14 HD;COMPUTACION
12721493;Soltero;F;47;CHILENO;;Silencioso;PROVIDENCIA                   ;METROPOLITANA;0;0;0;0;0;0;0;0;0;Galaxy Tab A7 (10.4 ,32GB, WIFI) Gold;COMPUTACION
15121041;;M;36;CHILENO;;Millenial;NANCAGUA                      ;L.G.B.OÂ´HIGGINS;0;0;0;0;0;0;0;0;0;TINTA 664 NEGRA;COMPUTACION
15477867;;M;39;CHILENO;;Silencioso;PROVIDENCIA                   ;METROPOLITANA;0;0;0;0;0;0;0;0;0;NTBK 14-ck2096la CeleronN4020 4GB500GB W10H;COMPUTACION
19563763;;M;25;CHILENO;;Z;PROVIDENCIA                   ;METROPOLITANA;0;0;0;0;0;0;0;0;0;NTBK 15-dk1043la i5-10300H 8GB512SSD4V W10H;COMPUTACION
19537294;;F;24;CHILENO;;Z;PROVIDENCIA                   ;METROPOLITANA;0;0;0;0;0;0;0;0;0;Tab M10 HD 2G-32GB 10.1 Iron grey WiFi;COMPUTACION
3847774;;M;78;CHILENO;;Silencioso;PROVIDENCIA                   ;METROPOLITANA;0;0;0;0;0;0;0;0;0;Galaxy Tab A7 (10.4 ,64GB, WIFI) Dark Gray;COMPUTACION
17385077;;F;32;CHILENO;;Millenial;PROVIDENCIA                   ;METROPOLITANA;0;0;0;0;0;0;0;0;0;Tab M10 HD 2G-32GB 10.1 Iron grey WiFi;COMPUTACION
19824512;;F;24;CHILENO;;Z;N/D;N/D;0;0;0;0;0;0;0;0;0;NTBK GemiBook Celeron/12GB/256GB/2K/Tec-Ingles;COMPUTACION
18496521;Soltero;M;29;CHILENO;;Silencioso;SAN JOAQUIN                   ;METROPOLITANA;0;0;0;0;0;0;0;0;0;MULTIFUNCIONAL ECOTANK L3110;COMPUTACION
18097274;Soltero;F;30;CHILENO;;Silencioso;PROVIDENCIA                   ;METROPOLITANA;0;0;0;0;0;0;0;0;0;TAB Galaxy Tab A 8 4Core 2GB 32GB 8 Gris;COMPUTACION
19775419;;M;23;CHILENO;;Z;N/D;N/D;0;0;0;0;0;0;0;0;0;NTBK 15-dk1043la i5-10300H 8GB512SSD4V W10H;COMPUTACION
11599679;;F;51;CHILENO;;X;MARIA ELENA                   ;ANTOFAGASTA;0;0;0;0;0;0;0;0;0;NTBK 15-dk1028la Ci5-10300H/8GB/256SSD/1050 3GB;COMPUTACION
9852792;;M;58;CHILENO;;Boomers;ANCUD                         ;LOS LAGOS;0;0;0;0;0;0;0;0;0;NTBK 245 G7 AMD Ryzen 5 3500U 8GB 1TB 14P;COMPUTACION
15244551;;F;38;CHILENO;;Silencioso;PROVIDENCIA                   ;METROPOLITANA;0;0;0;0;0;0;0;0;0;NTBK 14-ck2096la CeleronN4020 4GB500GB W10H;COMPUTACION
12739867;;M;47;CHILENO;;Silencioso;PROVIDENCIA                   ;METROPOLITANA;0;0;0;0;0;0;0;0;0;Matepad T10S WIFI 2+32 GB;COMPUTACION
14692581;;M;46;CHILENO;;Extranjero;ARICA                         ;ARICA Y PARINACOTA;0;0;0;0;0;0;0;0;0;NTBK 15-dk1043la i5-10300H 8GB512SSD4V W10H;COMPUTACION
17803694;;F;31;CHILENO;;Millenial;PROVIDENCIA                   ;METROPOLITANA;0;0;0;0;0;0;0;0;0;MULTIFUNCIONAL ECOTANK L4160 Wifi;COMPUTACION
17776131;;M;31;CHILENO;;Millenial;MAIPU                         ;METROPOLITANA;0;0;0;0;0;0;0;0;0;TAB Galaxy Tab A 8 4Core 2GB 32GB 8 Gris;COMPUTACION
12697929;;F;47;CHILENO;;X;N/D;N/D;0;0;0;0;0;0;0;0;0;Multifuncional DCPT520W Wifi;COMPUTACION
16224780;;F;36;CHILENO;;Millenial;PROVIDENCIA                   ;METROPOLITANA;0;0;0;0;0;0;0;0;0;NTBK 15-dk1028la Ci5-10300H/8GB/256SSD/1050 3GB;COMPUTACION
15076356;;M;24;CHILENO;;Z;VALPARAISO                    ;VALPARAISO;0;0;0;0;0;0;0;0;0;NTBK GAMER N5 Ci5-10300H/16GB/512SSD/GTX1650 4GB;COMPUTACION
19401453;;M;26;CHILENO;;Silencioso;PROVIDENCIA                   ;METROPOLITANA;0;0;0;0;0;0;0;0;0;NTBK 15-dk1028la Ci5-10300H/8GB/256SSD/1050 3GB;COMPUTACION
19877020;;M;24;CHILENO;;Silencioso;PROVIDENCIA                   ;METROPOLITANA;0;0;0;0;0;0;0;0;0;TAB Matepad T8 Wifi 2GB 32GB 8P;COMPUTACION
17607280;;F;32;CHILENO;;Millenial;PROVIDENCIA                   ;METROPOLITANA;0;0;0;0;0;0;0;0;0;NTBK 15-dk1028la Ci5-10300H/8GB/256SSD/1050 3GB;COMPUTACION
15170144;;F;40;CHILENO;;X;TOME                          ;BIO BIO;0;0;0;0;0;0;0;0;0;TAB S6 Lite (610) 4GB 64GB 10.4P PINK;COMPUTACION
17099299;Soltero;F;33;CHILENO;PROFESOR;Silencioso;PROVIDENCIA                   ;METROPOLITANA;0;0;0;0;0;0;0;0;0;MULTIFUNCIONAL ECOTANK L3150 Wifi;COMPUTACION
14900728;;M;41;CHILENO;;X;"";"";0;0;0;0;0;0;0;0;0;NTBK 14-dk1004la OPP R3-3250U DC 4GB 1TB 14INHD;COMPUTACION
6278484;;F;71;CHILENO;;Silencioso;OVALLE                        ;COQUIMBO;0;0;0;0;0;0;0;0;0;NTBK 14-dq1004la Core i5-1035G1 8GB 256SSD 14P;COMPUTACION
17202177;;F;33;CHILENO;;Millenial;PROVIDENCIA                   ;METROPOLITANA;0;0;0;0;0;0;0;0;0;PC Gamer ARGUS Serie IR1512;COMPUTACION
14344025;;M;45;CHILENO;;X;TALCA                         ;MAULE;0;0;0;0;0;0;0;0;0;MULTIFUNCIONAL ECOTANK L3150 Wifi;COMPUTACION
10959223;;F;53;CHILENO;;X;CASTRO                        ;LOS LAGOS;0;0;0;0;0;0;0;0;0;NTBK 14 Ryzen 5/12GB/512SSD;COMPUTACION
9006514;;F;57;CHILENO;;Boomers;PROVIDENCIA                   ;METROPOLITANA;0;0;0;0;0;0;0;0;0;NTBK 15-dy2051la i3-1115G4 8GB 256GB+16GB 15IN S;COMPUTACION
18627685;Casado;F;28;CHILENO;PROFESOR;Millenial;PROVIDENCIA                   ;METROPOLITANA;0;0;0;0;0;0;0;0;0;Multifuncional DCPT220;COMPUTACION
8598419;;F;63;CHILENO;;Boomers;ARICA                         ;ARICA Y PARINACOTA;0;0;0;0;0;0;0;0;0;NTBK Core i3/8GB/512SSD;COMPUTACION
14195516;;F;41;CHILENO;;X;PROVIDENCIA                   ;METROPOLITANA;0;0;0;0;0;0;0;0;0;NTBK 14-dk1004la OPP R3-3250U DC 4GB 1TB 14INHD;COMPUTACION
11176451;;F;55;CHILENO;;Boomers;PROVIDENCIA                   ;METROPOLITANA;0;0;0;0;0;0;0;0;0;TAB Galaxy Tab A 8 4Core 2GB 32GB 8 Negra;COMPUTACION
13017014;Casado;F;46;CHILENO;;X;RENCA                         ;METROPOLITANA;0;0;0;0;0;0;0;0;0;NTBK 245 G7 AMD Ryzen 5 3500U 8GB 1TB 14P;COMPUTACION
14275043;Casado;M;49;CHILENO;INGENIERO MECANICO;X;RENCA                         ;METROPOLITANA;0;0;0;0;0;0;0;0;0;TAB Galaxy Tab A+SPen 8Core 3GB 32GB 8 Gris;COMPUTACION
18430902;;F;28;CHILENO;;Millenial;N/D;N/D;0;0;0;0;0;0;0;0;0;TAB Galaxy Tab A 8 4Core 2GB 32GB 8 Gris;COMPUTACION
15404859;;M;40;CHILENO;;X;CURICO                        ;MAULE;0;0;0;0;0;0;0;0;0;MULTIFUNCIONAL ECOTANK L3150 Wifi;COMPUTACION
10879035;;M;54;CHILENO;;X;VILLARICA                     ;ARAUCANIA;0;0;0;0;0;0;0;0;0;NTBK 14-dq1004la Core i5-1035G1 8GB 256SSD 14P;COMPUTACION
17673656;Soltero;M;31;CHILENO;PSICOLOGO;Silencioso;PROVIDENCIA                   ;METROPOLITANA;0;0;0;0;0;0;0;0;0;IMPRESORA EPSON L120;COMPUTACION
5997129;;F;71;CHILENO;;Silencioso;LOS ANGELES                   ;BIO BIO;0;0;0;0;0;0;0;0;0;TAB Galaxy Tab A 8 4Core 2GB 32GB 8 Gris;COMPUTACION
19618305;;F;24;CHILENO;;Silencioso;PROVIDENCIA                   ;METROPOLITANA;0;0;0;0;0;0;0;0;0;NTBK 15-dy2051la i3-1115G4 8GB 256GB+16GB 15IN S;COMPUTACION
12748205;;F;47;CHILENO;;Silencioso;PROVIDENCIA                   ;METROPOLITANA;0;0;0;0;0;0;0;0;0;TAB GALAXY S6 (T860) 6GB 128GB 10.5;COMPUTACION
13113792;;M;46;CHILENO;;Silencioso;PROVIDENCIA                   ;METROPOLITANA;0;0;0;0;0;0;0;0;0;NTBK 14-dq1004la Core i5-1035G1 8GB 256SSD 14P;COMPUTACION
18212251;;M;30;CHILENO;;Millenial;PROVIDENCIA                   ;METROPOLITANA;0;0;0;0;0;0;0;0;0;NTBK 15-dy2051la i3-1115G4 8GB 256GB+16GB 15IN S;COMPUTACION
17727490;Soltero;F;31;CHILENO;;Millenial;NATALES                       ;MAGALLANES;0;0;0;0;0;0;0;0;0;NTBK 14-dq1004la Core i5-1035G1 8GB 256SSD 14P;COMPUTACION
11849584;;F;51;CHILENO;;X;PADRE HURTADO                 ;METROPOLITANA;0;0;0;0;0;0;0;0;0;NTBK 14-dq1004la Core i5-1035G1 8GB 256SSD 14P;COMPUTACION
19636511;;M;25;CHILENO;;Silencioso;PROVIDENCIA                   ;METROPOLITANA;0;0;0;0;0;0;0;0;0;NTBK 15-dk1028la Ci5-10300H/8GB/256SSD/1050 3GB;COMPUTACION
15518222;;F;38;CHILENO;;X;TALCAHUANO                    ;BIO BIO;0;0;0;0;0;0;0;0;0;NTBK 240 G7 Core i3-1005G1 4GB 1TB 14P;COMPUTACION
20233015;;F;23;CHILENO;;Z;PROVIDENCIA                   ;METROPOLITANA;0;0;0;0;0;0;0;0;0;Multifuncional DCPT220;COMPUTACION
20245451;;F;22;CHILENO;;Silencioso;PROVIDENCIA                   ;METROPOLITANA;0;0;0;0;0;0;0;0;0;NTBK G3 3500 Core i5-10300 8GB 256SSD 1650 4GB;COMPUTACION
9993850;;M;56;CHILENO;;Boomers;N/D;N/D;0;0;0;0;0;0;0;0;0;TAB Matepad T10S 3GB 64GB 10P;COMPUTACION
11931922;;M;50;CHILENO;;X;N/D;N/D;0;0;0;0;0;0;0;0;0;NTBK 14-ck2091la i3-10110U 4GB 128GB 14 HD;COMPUTACION
18657254;;F;28;CHILENO;;Millenial;PROVIDENCIA                   ;METROPOLITANA;0;0;0;0;0;0;0;0;0;NTBK 14-cf2051la i3-10110U 4GB 256GB+16GB 14 HD;COMPUTACION
19526328;;M;25;CHILENO;;Silencioso;PROVIDENCIA                   ;METROPOLITANA;0;0;0;0;0;0;0;0;0;MONITOR 22x 21.5-inch Display;COMPUTACION
10833848;;M;55;CHILENO;;Extranjero;FRUTILLAR                     ;LOS LAGOS;0;0;0;0;0;0;0;0;0;NTBK 14-ck2091la i3-10110U 4GB 128GB 14 HD;COMPUTACION
18738379;;M;28;CHILENO;;Silencioso;"";"";0;0;0;0;0;0;0;0;0;NTBK 15-dy2051la i3-1115G4 8GB 256GB+16GB 15IN S;COMPUTACION
7621246;;F;63;CHILENO;;Boomers;SAN JOAQUIN                   ;METROPOLITANA;0;0;0;0;0;0;0;0;0;IPAD MINI WI-FI 64GB GOLD (MUQY2CI/A);COMPUTACION
19566429;;F;25;CHILENO;;Z;PROVIDENCIA                   ;METROPOLITANA;0;0;0;0;0;0;0;0;0;TAB Galaxy Tab A 8 4Core 2GB 32GB 8 Negra;COMPUTACION
4327721;;F;80;CHILENO;;Silencioso;COPIAPO                       ;ATACAMA;0;0;0;0;0;0;0;0;0;Tablet HMS Matepad T10;COMPUTACION
18969756;;F;27;CHILENO;;Z;COPIAPO                       ;ATACAMA;0;0;0;0;0;0;0;0;0;TAB GAMER 7 QUAD CORE 2G+16G 8715;COMPUTACION
19609015;;F;24;CHILENO;;Z;PROVIDENCIA                   ;METROPOLITANA;0;0;0;0;0;0;0;0;0;NTBK 14-dq1004la Core i5-1035G1 8GB 256SSD 14P;COMPUTACION
19737187;;M;24;CHILENO;;Silencioso;PROVIDENCIA                   ;METROPOLITANA;0;0;0;0;0;0;0;0;0;Monitor G25-10 24.5-inch FHD WLED Gaming;COMPUTACION
16153527;;F;36;CHILENO;;Silencioso;PROVIDENCIA                   ;METROPOLITANA;0;0;0;0;0;0;0;0;0;TAB GALAXY S6 (T860) 6GB 128GB 10.5;COMPUTACION
18401410;Soltero;F;29;CHILENO;;Millenial;PROVIDENCIA                   ;METROPOLITANA;0;0;0;0;0;0;0;0;0;TAB Galaxy Tab A+SPen 8Core 3GB 32GB 8 Gris;COMPUTACION
18358790;Casado;F;29;CHILENO;;Silencioso;PROVIDENCIA                   ;METROPOLITANA;0;0;0;0;0;0;0;0;0;TAB Galaxy Tab A 8 4G 4Core 2GB 32GB 8 Gris;COMPUTACION
19263542;Soltero;M;25;CHILENO;;Silencioso;PROVIDENCIA                   ;METROPOLITANA;0;0;0;0;0;0;0;0;0;MULTIFUNCIONAL HP INK ADVANTAGE 3785/3775;COMPUTACION
16121734;;F;37;CHILENO;;Millenial;PUENTE ALTO                   ;METROPOLITANA;0;0;0;0;0;0;0;0;0;TAB Galaxy Tab A 8 4Core 2GB 32GB 8 Gris;COMPUTACION
17186185;Casado;M;33;CHILENO;;Millenial;TALCA;MAULE;0;0;0;0;0;0;0;0;0;TABLET MatePad Pro 10.8 + M-Pencil;COMPUTACION
11519980;;M;52;CHILENO;;X;PROVIDENCIA                   ;METROPOLITANA;0;0;0;0;0;0;0;0;0;Tablet HMS Matepad T10;COMPUTACION
16692910;Soltero;F;35;CHILENO;ENFERMERA;Millenial;PROVIDENCIA                   ;METROPOLITANA;0;0;0;0;0;0;0;0;0;TAB S6 Lite (610) 4GB 64GB 10.4P PINK;COMPUTACION
16133617;;F;37;CHILENO;;Silencioso;PROVIDENCIA                   ;METROPOLITANA;0;0;0;0;0;0;0;0;0;Impresora Laser HL-1202 Monocromatica;COMPUTACION
14105584;Soltero;M;42;CHILENO;;X;RENCA                         ;METROPOLITANA;0;0;0;0;0;0;0;0;0;MULTIFUNCIONAL ECOTANK L5190 Wifi/ Fax;COMPUTACION
14071575;;F;40;CHILENO;;X;PUDAHUEL                      ;METROPOLITANA;0;0;0;0;0;0;0;0;0;NTBK 245 G7 AMD Ryzen 5 3500U 8GB 1TB 14P;COMPUTACION
12441464;;M;49;CHILENO;;X;ANTOFAGASTA                   ;ANTOFAGASTA;0;0;0;0;0;0;0;0;0;TAB 7 PLAY AND LEARN PLUS PURPLE 8867;COMPUTACION
16965776;Soltero;F;34;CHILENO;INGENIERO CIVIL MECANICO;Silencioso;PROVIDENCIA                   ;METROPOLITANA;0;0;0;0;0;0;0;0;0;NTBK Inspiron 5301 Intel Core i7 11TH 8GB 512SSD;COMPUTACION
14087222;Soltero;M;41;CHILENO;;X;PROVIDENCIA                   ;METROPOLITANA;0;0;0;0;0;0;0;0;0;Galaxy Tab A7 (10.4 ,32GB, WIFI + 4G) Dark Gray;COMPUTACION
10630539;;M;43;CHILENO;;X;PROVIDENCIA                   ;METROPOLITANA;0;0;0;0;0;0;0;0;0;NTBK 15-DA2034LA PENTIUM GOLD 6405U 8GB1TB W10;COMPUTACION
15368218;;M;39;CHILENO;;X;N/D;N/D;0;0;0;0;0;0;0;0;0;Macbook Air Core I5 8GB 128SSD 13P;COMPUTACION
17955792;;M;30;CHILENO;;Millenial;PROVIDENCIA                   ;METROPOLITANA;0;0;0;0;0;0;0;0;0;TAB 7 PLAY AND LEARN PLUS PURPLE 8867;COMPUTACION
16492072;;M;35;CHILENO;;Millenial;COINCO                        ;L.G.B.OÂ´HIGGINS;0;0;0;0;0;0;0;0;0;Multifuncional DCPT520W Wifi;COMPUTACION
10364539;;F;54;CHILENO;;X;PROVIDENCIA                   ;METROPOLITANA;0;0;0;0;0;0;0;0;0;NTBK 14-DQ1001 Core i3-1005G1 4+16 256SSD 14;COMPUTACION
8913719;Soltero;F;60;CHILENO;;Boomers;RENCA                         ;METROPOLITANA;0;0;0;0;0;0;0;0;0;MBP 13.3 SLV/8C CPU/8C GPU/8GB/256GB (MYDA2CI/A);COMPUTACION
16850051;Soltero;F;33;CHILENO;;Millenial;RENCA                         ;METROPOLITANA;0;0;0;0;0;0;0;0;0;TAB Galaxy Tab A 8 4Core 2GB 32GB 8 Gris;COMPUTACION
8097726;;F;64;CHILENO;;Boomers;ANCUD                         ;LOS LAGOS;0;0;0;0;0;0;0;0;0;Multifuncional Smart Tank 515 Wifi;COMPUTACION
20314352;;F;23;CHILENO;;Z;PROVIDENCIA                   ;METROPOLITANA;0;0;0;0;0;0;0;0;0;IPAD WI-FI 32GB GOLD (MYLC2CI/A);COMPUTACION
8123142;;F;66;CHILENO;;Boomers;MAIPU                         ;METROPOLITANA;0;0;0;0;0;0;0;0;0;MULTIFUNCIONAL ECOTANK L3110;COMPUTACION
18120679;Soltero;M;30;CHILENO;;Millenial;PROVIDENCIA                   ;METROPOLITANA;0;0;0;0;0;0;0;0;0;NTBK 15-DA2034LA PENTIUM GOLD 6405U 8GB1TB W10;COMPUTACION
18950273;Soltero;M;27;CHILENO;;Silencioso;PROVIDENCIA                   ;METROPOLITANA;0;0;0;0;0;0;0;0;0;Multifuncional DCPT720DW Wifi, Duplex y ADF;COMPUTACION
15557412;;F;39;CHILENO;;X;VALPARAISO                    ;VALPARAISO;0;0;0;0;0;0;0;0;0;NTBK 15-cw1006la Ryzen 7-3700U 8GB 512SSD 15P;COMPUTACION
13684467;;M;42;CHILENO;;X;PROVIDENCIA                   ;METROPOLITANA;0;0;0;0;0;0;0;0;0;NTBK Matebook X Pro Core i7 16GB 1TB SSD 13.9P;COMPUTACION
11715697;;F;52;CHILENO;;X;MAIPU                         ;METROPOLITANA;0;0;0;0;0;0;0;0;0;NTBK IP3 AMD Ryzen 5-4500U 8GB 1TB 15P;COMPUTACION
16887874;;F;34;CHILENO;;Millenial;PROVIDENCIA                   ;METROPOLITANA;0;0;0;0;0;0;0;0;0;Multifuncional DCPT520W Wifi;COMPUTACION
8579564;;F;60;CHILENO;;Boomers;CHEPICA                       ;L.G.B.OÂ´HIGGINS;0;0;0;0;0;0;0;0;0;Multifuncional DCPT520W Wifi;COMPUTACION
15575459;;F;28;CHILENO;;Millenial;OVALLE                        ;COQUIMBO;0;0;0;0;0;0;0;0;0;TAB Galaxy Tab A 8 4Core 2GB 32GB 8 Negra;COMPUTACION
19104989;;F;27;CHILENO;;Z;"";"";0;0;0;0;0;0;0;0;0;Galaxy Tab A7 (10.4 ,32GB, WIFI) Dark Gray;COMPUTACION
16873134;;F;34;CHILENO;;Millenial;TALAGANTE                     ;METROPOLITANA;0;0;0;0;0;0;0;0;0;MULTIFUNCIONAL ECOTANK L3150 Wifi;COMPUTACION
11518546;;M;52;CHILENO;;X;N/D;N/D;0;0;0;0;0;0;0;0;0;TABLET MLAB 7 MB4 PLUS 1+16GB RED;COMPUTACION
18896697;;F;28;CHILENO;;Millenial;N/D;N/D;0;0;0;0;0;0;0;0;0;NTBK G7 240 Intel Celeron 4GB 500GB 14;COMPUTACION
18976399;;M;27;CHILENO;;Millenial;SAN BERNARDO                  ;METROPOLITANA;0;0;0;0;0;0;0;0;0;NTBK 15-cw1006la Ryzen 7-3700U 8GB 512SSD 15P;COMPUTACION
15207192;;F;39;CHILENO;;Silencioso;PROVIDENCIA                   ;METROPOLITANA;0;0;0;0;0;0;0;0;0;NTBK 14-dq1004la Core i5-1035G1 8GB 256SSD 14P;COMPUTACION
9328428;;F;56;CHILENO;;Boomers;SAN BERNARDO                  ;METROPOLITANA;0;0;0;0;0;0;0;0;0;MULTIFUNCIONAL ECOTANK L3110;COMPUTACION
19645100;;M;25;CHILENO;;Z;PROVIDENCIA                   ;METROPOLITANA;0;0;0;0;0;0;0;0;0;TAB M8 QC 2GB 32GB 8P Gris;COMPUTACION
14335304;;M;44;CHILENO;;X;PENAFLOR                      ;METROPOLITANA;0;0;0;0;0;0;0;0;0;NTBK 240 Core i5-1035G1 4GB 1TB 14P;COMPUTACION
12508241;;F;49;CHILENO;;X;LA CISTERNA                   ;METROPOLITANA;0;0;0;0;0;0;0;0;0;NTBK G7 240 Intel Celeron 4GB 500GB 14;COMPUTACION
16895738;Soltero;F;34;CHILENO;PROFESOR;Millenial;PROVIDENCIA                   ;METROPOLITANA;0;0;0;0;0;0;0;0;0;MULTIFUNCIONAL ECOTANK L3150 Wifi;COMPUTACION
15873852;Soltero;F;37;CHILENO;;Silencioso;PROVIDENCIA                   ;METROPOLITANA;0;0;0;0;0;0;0;0;0;MULTIFUNCIONAL ECOTANK L3150 Wifi;COMPUTACION
15224393;Soltero;F;39;CHILENO;PROFESOR;X;PROVIDENCIA                   ;METROPOLITANA;0;0;0;0;0;0;0;0;0;NTBK 15-dw1051la Core i5-10210U 8GB 256SSD 15P;COMPUTACION
14380833;;M;45;CHILENO;;X;PROVIDENCIA                   ;METROPOLITANA;0;0;0;0;0;0;0;0;0;TAB Galaxy Tab A 8 4G 4Core 2GB 32GB 8 Gris;COMPUTACION
9297201;;M;59;CHILENO;;Boomers;ANTOFAGASTA                   ;ANTOFAGASTA;0;0;0;0;0;0;0;0;0;TAB Galaxy Tab A 8 4Core 2GB 32GB 8 Negra;COMPUTACION
11491309;;M;52;CHILENO;;X;IQUIQUE                       ;TARAPACA;0;0;0;0;0;0;0;0;0;NTBK 15-cw1020la Ryzen 5-3500U 8GB 256GB 15P;COMPUTACION
9884304;;M;59;CHILENO;;Boomers;RENCA                         ;METROPOLITANA;0;0;0;0;0;0;0;0;0;TINTA BOTELLA EPSON T664120 NEGRA SERIE L;COMPUTACION
16162356;;M;37;CHILENO;;Millenial;"";"";0;0;0;0;0;0;0;0;0;Galaxy Tab A7 (10.4 ,32GB, WIFI + 4G) Dark Gray;COMPUTACION
15598435;;F;38;CHILENO;;X;NATALES                       ;MAGALLANES;0;0;0;0;0;0;0;0;0;MULTIFUNCIONAL ECOTANK L3110;COMPUTACION
16920009;;F;34;CHILENO;;Millenial;PROVIDENCIA                   ;METROPOLITANA;0;0;0;0;0;0;0;0;0;Multifuncional DCPT520W Wifi;COMPUTACION
5226636;;M;77;CHILENO;;Silencioso;RENCA                         ;METROPOLITANA;0;0;0;0;0;0;0;0;0;Multifuncional DeskJet Ink Advantage 3775 Wifi;COMPUTACION
12203237;;M;49;CHILENO;;X;PROVIDENCIA                   ;METROPOLITANA;0;0;0;0;0;0;0;0;0;MULTIFUNCIONAL ECOTANK L3110;COMPUTACION
16722333;;M;34;CHILENO;;Millenial;PUERTO MONTT                  ;LOS LAGOS;0;0;0;0;0;0;0;0;0;MULTIFUNCIONAL ECOTANK L3110;COMPUTACION
18085726;Soltero;F;30;CHILENO;PROFESOR;Silencioso;PROVIDENCIA                   ;METROPOLITANA;0;0;0;0;0;0;0;0;0;NTBK 240 G7 Core i3-1005G1 4GB 1TB 14P;COMPUTACION
20119653;;M;23;CHILENO;;Silencioso;PROVIDENCIA                   ;METROPOLITANA;0;0;0;0;0;0;0;0;0;NTBK 15-cw1021la Ryzen 3-3300U 12GB 256SSD 15P;COMPUTACION
10812639;;F;58;CHILENO;;Boomers;VALDIVIA                      ;LOS RIOS;0;0;0;0;0;0;0;0;0;NTBK 15-cw1021la Ryzen 3-3300U 12GB 256SSD 15P;COMPUTACION
15413702;Casado;F;40;CHILENO;TECNICO EN ADMINISTRACION DE EMPRESAS;X;RENCA                         ;METROPOLITANA;0;0;0;0;0;0;0;0;0;NTBK 14-dq1004la Core i5-1035G1 8GB 256SSD 14P;COMPUTACION
19060294;;F;25;CHILENO;;Z;PROVIDENCIA                   ;METROPOLITANA;0;0;0;0;0;0;0;0;0;Impresora Laser HL-1202 Monocromatica;COMPUTACION
11944022;Casado;F;49;CHILENO;ADMINISTRADOR PUBLICO;X;RENCA                         ;METROPOLITANA;0;0;0;0;0;0;0;0;0;NTBK G5 5500 Core i7 10750H 16GB 512SSD 2060 6GB;COMPUTACION
18962182;Casado;M;27;CHILENO;;Silencioso;PROVIDENCIA                   ;METROPOLITANA;0;0;0;0;0;0;0;0;0;MULTIFUNCIONAL ECOTANK L3110;COMPUTACION
14310733;;M;46;CHILENO;;X;N/D;N/D;0;0;0;0;0;0;0;0;0;NTBK 240 G7 Core i3-1005G1 4GB 1TB 14P;COMPUTACION
17469746;;F;32;CHILENO;;Millenial;SAN JAVIER                    ;MAULE;0;0;0;0;0;0;0;0;0;MULTIFUNCIONAL ECOTANK L3150 Wifi;COMPUTACION
7301864;;F;67;CHILENO;;Boomers;VALLENAR;ATACAMA;0;0;0;0;0;0;0;0;0;TAB Galaxy Tab A 8 4Core 2GB 32GB 8 Negra;COMPUTACION
18149289;Soltero;M;29;CHILENO;KINESIOLOGO;Silencioso;PROVIDENCIA                   ;METROPOLITANA;0;0;0;0;0;0;0;0;0;NTBK INSPIRON 3505 AMD Athlon Silver 3050U 4GB 1;COMPUTACION
6069720;;F;69;CHILENO;;Silencioso;VILLARICA                     ;ARAUCANIA;0;0;0;0;0;0;0;0;0;TAB Mediapad T3 10 4Core 2GB 16GB 9,6 Gris;COMPUTACION
16748790;;M;34;CHILENO;;Millenial;LA FLORIDA                    ;METROPOLITANA;0;0;0;0;0;0;0;0;0;NTBK S150 AMD A4-9120e 4GB 64GB eMMc 14P;COMPUTACION
8904854;;F;60;CHILENO;;X;CONCEPCION                    ;BIO BIO;0;0;0;0;0;0;0;0;0;NTBK Matebook D15 AMD Ryzen 5 8GB 256SSD 15P;COMPUTACION
13937126;Casado;F;42;CHILENO;CONTADOR AUDITOR;X;PROVIDENCIA                   ;METROPOLITANA;0;0;0;0;0;0;0;0;0;TAB 7 PLAY AND LEARN PLUS BLUE 8868;COMPUTACION
15893973;;F;37;CHILENO;;Millenial;LA FLORIDA                    ;METROPOLITANA;0;0;0;0;0;0;0;0;0;TAB Mediapad T3 10 4Core 2GB 16GB 9,6 Gris;COMPUTACION
11601995;;F;52;CHILENO;;X;N/D;N/D;0;0;0;0;0;0;0;0;0;NTBK Ideapad S145 Celeron 4GB 500GB 14P;COMPUTACION
14180357;;F;42;CHILENO;;X;N/D;N/D;0;0;0;0;0;0;0;0;0;Multifuncional DCPT520W Wifi;COMPUTACION
8564882;;M;62;CHILENO;;Boomers;RENCA                         ;METROPOLITANA;0;0;0;0;0;0;0;0;0;NTBK 15-dk0007la Core i7 16GB 1TB+128 1660ti 6GB;COMPUTACION
20199717;;F;23;CHILENO;;Z;RENCA                         ;METROPOLITANA;0;0;0;0;0;0;0;0;0;NTBK A314-22-R7EL-1 Ryzen 3-3250U 8GB 256SSD 14P;COMPUTACION
11600553;;F;52;CHILENO;;X;LIMACHE                       ;VALPARAISO;0;0;0;0;0;0;0;0;0;MULTIFUNCIONAL DCP-T710W Wifi/ ADF;COMPUTACION
13674351;;F;43;CHILENO;;Silencioso;PROVIDENCIA                   ;METROPOLITANA;0;0;0;0;0;0;0;0;0;TAB Matepad T10S 3GB 64GB 10P;COMPUTACION
16178016;;F;36;CHILENO;;Silencioso;PROVIDENCIA                   ;METROPOLITANA;0;0;0;0;0;0;0;0;0;PROYECTOR Powerlite S41;COMPUTACION
16663611;;M;34;CHILENO;;X;PROVIDENCIA                   ;METROPOLITANA;0;0;0;0;0;0;0;0;0;TAB Galaxy Tab A 8 4Core 2GB 32GB 8 Negra;COMPUTACION
16586340;;F;35;CHILENO;;Millenial;PROVIDENCIA                   ;METROPOLITANA;0;0;0;0;0;0;0;0;0;NTBK 15-dk0007la Core i7 16GB 1TB+128 1660ti 6GB;COMPUTACION
15830452;;M;37;CHILENO;;Millenial;PROVIDENCIA                   ;METROPOLITANA;0;0;0;0;0;0;0;0;0;NTBK 15-cw1021la Ryzen 3-3300U 12GB 256SSD 15P;COMPUTACION
12176253;;F;50;CHILENO;;X;RENCA                         ;METROPOLITANA;0;0;0;0;0;0;0;0;0;NTBK 15-dk0015 Core i5-9300H 8GB 256SSD 1050 3GB;COMPUTACION
17964210;;F;30;CHILENO;;Millenial;VALDIVIA                      ;LOS RIOS;0;0;0;0;0;0;0;0;0;NTBK S150 AMD A4-9120e 4GB 64GB eMMc 14P;COMPUTACION
14502167;;F;46;CHILENO;;X;PROVIDENCIA                   ;METROPOLITANA;0;0;0;0;0;0;0;0;0;TAB S6 Lite (610) 4GB 64GB 10.4P DARK GREY;COMPUTACION
26163364;;M;40;VENEZOLANO;;Extranjero;PENAFLOR                      ;METROPOLITANA;0;0;0;0;0;0;0;0;0;Tab M10 Plus FHD 4GB 64GB 10.3P platinum grey;COMPUTACION
15960653;;M;37;CHILENO;;Millenial;N/D;N/D;0;0;0;0;0;0;0;0;0;Monitor 24fw con audio;COMPUTACION
13910294;;M;41;CHILENO;;X;PROVIDENCIA                   ;METROPOLITANA;0;0;0;0;0;0;0;0;0;NTBK S150 AMD A4-9120e 4GB 64GB eMMc 14P;COMPUTACION
7328202;Casado;F;65;CHILENO;;Boomers;SAN ANTONIO                   ;VALPARAISO;0;0;0;0;0;0;0;0;0;NTBK 15-dk0007la Core i7 16GB 1TB+128 1660ti 6GB;COMPUTACION
17233624;;F;33;CHILENO;;Millenial;N/D;N/D;0;0;0;0;0;0;0;0;0;TAB MBX Cinema 8866 OctaCore 2GB 32GB 10P;COMPUTACION
18916503;;M;27;CHILENO;;Millenial;"";"";0;0;0;0;0;0;0;0;0;TAB 7 MB4 Plus 4Core 1GB 16GB 7 Negra;COMPUTACION
5634818;;F;74;CHILENO;;Silencioso;EL QUISCO                     ;VALPARAISO;0;0;0;0;0;0;0;0;0;MULTIFUNCIONAL DCP-T510 Wifi;COMPUTACION
17225260;Soltero;F;33;CHILENO;NUTRICIONISTA;Millenial;EL MONTE                      ;METROPOLITANA;0;0;0;0;0;0;0;0;0;NTBK 14-dw0005la Core i7-1065G7 8GB 512SSD 14P;COMPUTACION
13380588;;F;44;CHILENO;;X;PENCO                         ;BIO BIO;0;0;0;0;0;0;0;0;0;TAB Galaxy Tab A 8 4Core 2GB 32GB 8 Gris;COMPUTACION
6583765;Soltero;F;70;CHILENO;PROFESOR;Silencioso;PROVIDENCIA                   ;METROPOLITANA;0;0;0;0;0;0;0;0;0;Galaxy Tab A7 (10.4 ,32GB, WIFI) Dark Gray;COMPUTACION
15049511;;F;39;CHILENO;;X;SALAMANCA                     ;COQUIMBO;0;0;0;0;0;0;0;0;0;TAB MediaPad T5 10 3GB 32GB 10.1P Azul;COMPUTACION
24347027;;M;36;COLOMBIANO;;Extranjero;CALAMA                        ;ANTOFAGASTA;0;0;0;0;0;0;0;0;0;Tab M10 Plus FHD 4GB 64GB 10.3P platinum grey;COMPUTACION
13858109;;M;41;CHILENO;;X;N/D;N/D;0;0;0;0;0;0;0;0;0;NTBK IP3 Athlon 3050U/4GB/500GB/15P;COMPUTACION
18941889;;F;27;CHILENO;;Z;N/D;N/D;0;0;0;0;0;0;0;0;0;TAB 7 MB4 Plus 4Core 1GB 16GB 7 Negra;COMPUTACION
12421016;;F;49;CHILENO;;X;SAN MIGUEL                    ;METROPOLITANA;0;0;0;0;0;0;0;0;0;Tab M10 Plus FHD 4GB 64GB 10.3P platinum grey;COMPUTACION
15270388;;F;40;CHILENO;;X;PROVIDENCIA                   ;METROPOLITANA;0;0;0;0;0;0;0;0;0;TAB MediaPad T5 10 3GB 32GB 10.1P Azul;COMPUTACION
13904381;;F;42;CHILENO;;X;RENCA                         ;METROPOLITANA;0;0;0;0;0;0;0;0;0;TAB M8 QC 2GB 32GB 8P Gris;COMPUTACION
15533190;;M;39;CHILENO;;X;PROVIDENCIA                   ;METROPOLITANA;0;0;0;0;0;0;0;0;0;NTBK IP3 Athlon 3050U/4GB/500GB/15P;COMPUTACION
13321424;Soltero;M;45;CHILENO;INGENIERO;X;RENCA                         ;METROPOLITANA;0;0;0;0;0;0;0;0;0;Galaxy Tab A7 (10.4 ,32GB, WIFI) Dark Gray;COMPUTACION
16436858;;M;35;CHILENO;;Millenial;PROVIDENCIA                   ;METROPOLITANA;0;0;0;0;0;0;0;0;0;TAB Galaxy Tab A 8 4Core 2GB 32GB 8 Negra;COMPUTACION
17957158;;M;31;CHILENO;;Millenial;PROVIDENCIA                   ;METROPOLITANA;0;0;0;0;0;0;0;0;0;NTBK 15-ek0010la Core i5 8+32 512SSD 2060 6GB;COMPUTACION
18214270;;F;30;CHILENO;;Millenial;N/D;N/D;0;0;0;0;0;0;0;0;0;TAB MediaPad T5 10 3GB 32GB 10.1P Azul;COMPUTACION
6308041;Divorciado;M;67;CHILENO;;Boomers;RENCA                         ;METROPOLITANA;0;0;0;0;0;0;0;0;0;NTBK Gaming 3 Ryzen 5 4600H 8GB 512SSD G1650 4GB;COMPUTACION
13448446;;F;44;CHILENO;;X;RENCA                         ;METROPOLITANA;0;0;0;0;0;0;0;0;0;NTBK IP3 Ryzen 3-3250U/8GB/1TB/15P;COMPUTACION
20360202;;F;22;CHILENO;;Extranjero;PROVIDENCIA                   ;METROPOLITANA;0;0;0;0;0;0;0;0;0;NTBK IP3 Athlon 3050U/4GB/500GB/15P;COMPUTACION
12048597;;M;43;CHILENO;;X;PROVIDENCIA                   ;METROPOLITANA;0;0;0;0;0;0;0;0;0;TAB Galaxy Tab A 8 4Core 2GB 32GB 8 Negra;COMPUTACION
19809957;;M;24;CHILENO;;Z;PROVIDENCIA                   ;METROPOLITANA;0;0;0;0;0;0;0;0;0;NTBK 245 G7 AMD Ryzen 5 3500U 8GB 1TB 14P;COMPUTACION
17069687;;F;33;CHILENO;;Millenial;PROVIDENCIA                   ;METROPOLITANA;0;0;0;0;0;0;0;0;0;TAB MediaPad T5 10 3GB 32GB 10.1P Azul;COMPUTACION
14182399;Soltero;M;41;CHILENO;;X;PROVIDENCIA                   ;METROPOLITANA;0;0;0;0;0;0;0;0;0;Galaxy Tab A7 (10.4 ,32GB, WIFI) Dark Gray;COMPUTACION
17656642;;F;31;CHILENO;;Millenial;PROVIDENCIA                   ;METROPOLITANA;0;0;0;0;0;0;0;0;0;TAB Galaxy Tab A 8 4Core 2GB 32GB 8 Gris;COMPUTACION
10976772;;M;46;CHILENO;;X;LA CRUZ                       ;VALPARAISO;0;0;0;0;0;0;0;0;0;NTBK 15-dk0015 Core i5-9300H 8GB 256SSD 1050 3GB;COMPUTACION
17576110;;F;32;CHILENO;;Millenial;INDEPENDENCIA                 ;METROPOLITANA;0;0;0;0;0;0;0;0;0;NTBK 240 Core i5-1035G1 4GB 1TB 14P;COMPUTACION
10845384;;F;55;CHILENO;;Boomers;PROVIDENCIA                   ;METROPOLITANA;0;0;0;0;0;0;0;0;0;NTBK G7 240 Intel Celeron 4GB 500GB 14;COMPUTACION
10329970;Casado;F;58;CHILENO;;Boomers;RENCA                         ;METROPOLITANA;0;0;0;0;0;0;0;0;0;NTBK Matebook 13 Core i5-10210U 8GB 512SSD 13P;COMPUTACION
16583182;Soltero;F;35;CHILENO;;Millenial;CAUQUENES                     ;MAULE;0;0;0;0;0;0;0;0;0;TAB M7 QC 1GB 8GB 7P Gris;COMPUTACION
17447249;;F;32;CHILENO;;Millenial;LINARES                       ;MAULE;0;0;0;0;0;0;0;0;0;TAB Matepad 10.4;COMPUTACION
18721698;;M;28;CHILENO;;Millenial;PROVIDENCIA                   ;METROPOLITANA;0;0;0;0;0;0;0;0;0;TAB Matepad T8 Wifi 2GB 32GB 8P;COMPUTACION
9797714;;M;58;CHILENO;;Boomers;ANTOFAGASTA                   ;ANTOFAGASTA;0;0;0;0;0;0;0;0;0;AIO A340 A9-9425 4GB 1TB 21,5;COMPUTACION
17381673;;M;32;CHILENO;;Millenial;N/D;N/D;0;0;0;0;0;0;0;0;0;NTBK S150 AMD A4-9120e 4GB 64GB eMMc 14P;COMPUTACION
10688986;;F;44;CHILENO;;X;ARICA                         ;ARICA Y PARINACOTA;0;0;0;0;0;0;0;0;0;NTBK IP3 Ryzen 3-3250U/8GB/1TB/15P;COMPUTACION
16378712;Soltero;M;36;CHILENO;TECNICO EN ELECTRONICA;Millenial;RENCA                         ;METROPOLITANA;0;0;0;0;0;0;0;0;0;NTBK Matebook D14 AMD Ryzen 5 8GB 512SSD 14P;COMPUTACION
18867779;;M;27;CHILENO;;Z;PROVIDENCIA                   ;METROPOLITANA;0;0;0;0;0;0;0;0;0;MULTIFUNCIONAL ECOTANK L5190 Wifi/ Fax;COMPUTACION
7804352;;M;60;CHILENO;;Boomers;ARICA                         ;ARICA Y PARINACOTA;0;0;0;0;0;0;0;0;0;NTBK IP3 Athlon 3050U/4GB/500GB/15P;COMPUTACION
6613842;;F;71;CHILENO;;Silencioso;TRAIGUEN                      ;ARAUCANIA;0;0;0;0;0;0;0;0;0;NTBK 240 Core i5-1035G1 4GB 1TB 14P;COMPUTACION
12803010;Casado;M;47;CHILENO;;X;RENCA                         ;METROPOLITANA;0;0;0;0;0;0;0;0;0;NTBK IP S145 AMD A4-9125/4GB/500GB/14P;COMPUTACION
10637527;;M;50;CHILENO;;Silencioso;PROVIDENCIA                   ;METROPOLITANA;0;0;0;0;0;0;0;0;0;NTBK IP3 AMD Ryzen 5-4500U 8GB 1TB 15P;COMPUTACION
13571920;;F;42;CHILENO;;X;PALMILLA                      ;L.G.B.OÂ´HIGGINS;0;0;0;0;0;0;0;0;0;NTBK 245 A4-9125 4GB 500GB 14;COMPUTACION
17029267;;M;33;CHILENO;;Millenial;RENCA                         ;METROPOLITANA;0;0;0;0;0;0;0;0;0;NTBK 15-dk0015 Core i5-9300H 8GB 256SSD 1050 3GB;COMPUTACION
19067688;Soltero;F;28;CHILENO;;Millenial;PROVIDENCIA                   ;METROPOLITANA;0;0;0;0;0;0;0;0;0;TAB Galaxy Tab A+SPen 8Core 3GB 32GB 8 Gris;COMPUTACION
15580596;Soltero;F;38;CHILENO;;Millenial;RENCA                         ;METROPOLITANA;0;0;0;0;0;0;0;0;0;TAB Galaxy Tab A 8 4Core 2GB 32GB 8 Gris;COMPUTACION
15513831;;M;39;CHILENO;;X;PROVIDENCIA                   ;METROPOLITANA;0;0;0;0;0;0;0;0;0;NTBK 14-DQ1001 Core i3-1005G1 4+16 256SSD 14;COMPUTACION
17036523;;F;33;CHILENO;;Millenial;CURANILAHUE                   ;BIO BIO;0;0;0;0;0;0;0;0;0;NTBK IP3 AMD Ryzen 5-4500U 8GB 1TB 15P;COMPUTACION
13871131;;F;41;CHILENO;;X;N/D;N/D;0;0;0;0;0;0;0;0;0;NTBK 240 G7 Core i3-1005G1 4GB 1TB 14P;COMPUTACION
12421805;;M;49;CHILENO;;X;CASTRO                        ;LOS LAGOS;0;0;0;0;0;0;0;0;0;NTBK 15-dw1051la Core i5-10210U 8GB 256SSD 15P;COMPUTACION
11680779;;M;52;CHILENO;;X;TALCAHUANO                    ;BIO BIO;0;0;0;0;0;0;0;0;0;NTBK IP3 Athlon 3050U/4GB/500GB/15P;COMPUTACION
17854546;;F;30;CHILENO;;Millenial;PROVIDENCIA                   ;METROPOLITANA;0;0;0;0;0;0;0;0;0;TAB MBX Cinema 8866 OctaCore 2GB 32GB 10P;COMPUTACION
17628691;Soltero;M;32;CHILENO;DISENADOR GRAFICO;Millenial;PROVIDENCIA                   ;METROPOLITANA;0;0;0;0;0;0;0;0;0;MULTIFUNCIONAL DCP-T710W Wifi/ ADF;COMPUTACION
9489298;;F;59;CHILENO;;Boomers;RENCA                         ;METROPOLITANA;0;0;0;0;0;0;0;0;0;TAB MediaPad T5 10 3GB 32GB 10.1P Azul;COMPUTACION
12114115;;M;42;CHILENO;;X;PROVIDENCIA                   ;METROPOLITANA;0;0;0;0;0;0;0;0;0;NTBK IP3 Ryzen 3-3250U/8GB/1TB/15P;COMPUTACION
16403787;Soltero;F;36;CHILENO;PSICOLOGA;Millenial;PROVIDENCIA                   ;METROPOLITANA;0;0;0;0;0;0;0;0;0;NTBK 245 G7 AMD Ryzen 5 3500U 8GB 1TB 14P;COMPUTACION
16027002;;F;37;CHILENO;;Millenial;LOS ANDES                     ;VALPARAISO;0;0;0;0;0;0;0;0;0;NTBK G7 240 Intel Celeron 4GB 500GB 14;COMPUTACION
15280279;;M;39;CHILENO;;X;PROVIDENCIA                   ;METROPOLITANA;0;0;0;0;0;0;0;0;0;NTBK IP3 AMD Ryzen 5-4500U 8GB 1TB 15P;COMPUTACION
22117125;;F;53;PERUANO;;Extranjero;SANTIAGO                      ;METROPOLITANA;0;0;0;0;0;0;0;0;0;TAB Matepad T8 4G LTE 2GB 16GB;COMPUTACION
13245909;;M;44;CHILENO;;X;PROVIDENCIA                   ;METROPOLITANA;0;0;0;0;0;0;0;0;0;NTBK 15-dk0015 Core i5-9300H 8GB 256SSD 1050 3GB;COMPUTACION
7455110;;F;64;CHILENO;;Boomers;VALDIVIA                      ;LOS LAGOS;0;0;0;0;0;0;0;0;0;TAB Galaxy Tab A 8 4Core 2GB 32GB 8 Gris;COMPUTACION
8811155;;F;59;CHILENO;;Boomers;ARAUCO                        ;BIO BIO;0;0;0;0;0;0;0;0;0;MULTIFUNCIONAL ECOTANK L3110;COMPUTACION
15353773;Soltero;F;39;CHILENO;;X;PROVIDENCIA                   ;METROPOLITANA;0;0;0;0;0;0;0;0;0;TAB Galaxy Tab A 10.1 8Core 2GB 32GB 10 Negra;COMPUTACION
9399077;;F;60;CHILENO;;Boomers;NINHUE                        ;BIO BIO;0;0;0;0;0;0;0;0;0;TINTA 664 NEGRA;COMPUTACION
7074827;;F;71;CHILENO;;Silencioso;SAN PEDRO                     ;METROPOLITANA;0;0;0;0;0;0;0;0;0;TAB Galaxy Tab A 8 4G 4Core 2GB 32GB 8 Gris;COMPUTACION
17039889;;M;33;CHILENO;;Millenial;TALCA                         ;MAULE;0;0;0;0;0;0;0;0;0;TAB Galaxy Tab A 10.1 4G 8Core 2GB 32GB 10 Gold;COMPUTACION
20782692;;F;21;CHILENO;;Z;PROVIDENCIA                   ;METROPOLITANA;0;0;0;0;0;0;0;0;0;NTBK Matebook D15 AMD Ryzen 5 8GB 256SSD 15P;COMPUTACION
17061030;;M;33;CHILENO;;Millenial;CHILLAN                       ;BIO BIO;0;0;0;0;0;0;0;0;0;MULTIFUNCIONAL EPSON ECOTANK L850 fotografica;COMPUTACION
26202311;;M;31;VENEZOLANO;;Extranjero;N/D;N/D;0;0;0;0;0;0;0;0;0;MULTIFUNCIONAL ECOTANK L4160 Wifi;COMPUTACION
17262633;;M;33;CHILENO;;Millenial;RENCA                         ;METROPOLITANA;0;0;0;0;0;0;0;0;0;NTBK G7 240 Intel Celeron 4GB 500GB 14;COMPUTACION
18367767;;M;28;CHILENO;;Extranjero;COPIAPO                       ;ATACAMA;0;0;0;0;0;0;0;0;0;NTBK IP3 Athlon 3050U/4GB/500GB/15P;COMPUTACION
16397142;;F;35;CHILENO;;Millenial;LOS ANGELES                   ;BIO BIO;0;0;0;0;0;0;0;0;0;NTBK GAMER L340 Ci5-9300H 8GB 256GBSSD 1050 3GB;COMPUTACION
19601777;;F;25;CHILENO;;Z;PROVIDENCIA                   ;METROPOLITANA;0;0;0;0;0;0;0;0;0;TAB Galaxy Tab A+SPen 8Core 3GB 32GB 8 Gris;COMPUTACION
19333817;;F;26;CHILENO;;Z;PROVIDENCIA                   ;METROPOLITANA;0;0;0;0;0;0;0;0;0;NTBK 15-gw0016la AMD Athlon 8GB 256GBSSD 15P;COMPUTACION
25675049;;F;40;VENEZOLANO;;Extranjero;ESTACION CENTRAL              ;METROPOLITANA;0;0;0;0;0;0;0;0;0;NTBK HP 15-da0082la Pentium 4GB 500GB 15P;COMPUTACION
17046296;;M;33;CHILENO;;Millenial;PROVIDENCIA                   ;METROPOLITANA;0;0;0;0;0;0;0;0;0;NTBK Matebook D14 AMD Ryzen 5 8GB 512SSD 14P;COMPUTACION
10211072;;M;56;CHILENO;;Boomers;PROVIDENCIA                   ;METROPOLITANA;0;0;0;0;0;0;0;0;0;MULTIFUNCIONAL ECOTANK L3110;COMPUTACION
12698255;Soltero;M;51;CHILENO;;X;PROVIDENCIA                   ;METROPOLITANA;0;0;0;0;0;0;0;0;0;Multifuncional Smart Tank 515 Wifi;COMPUTACION
15986348;;F;37;CHILENO;;Millenial;TEMUCO                        ;ARAUCANIA;0;0;0;0;0;0;0;0;0;NTBK Matebook D14 AMD Ryzen 5 8GB 256SSD 14P;COMPUTACION
10746715;;F;56;CHILENO;;Boomers;PROVIDENCIA                   ;METROPOLITANA;0;0;0;0;0;0;0;0;0;NTBK 240 G7 Core i3-1005G1 4GB 1TB 14P;COMPUTACION
17364507;Soltero;F;32;CHILENO;PROFESOR;Millenial;PROVIDENCIA                   ;METROPOLITANA;0;0;0;0;0;0;0;0;0;NTBK G7 240 Intel Celeron 4GB 500GB 14;COMPUTACION
15433613;;F;40;CHILENO;;X;PROVIDENCIA                   ;METROPOLITANA;0;0;0;0;0;0;0;0;0;NTBK IP3 Ryzen 3-3250U/8GB/1TB/15P;COMPUTACION
8773605;Casado;F;61;CHILENO;TECNICO QUIMICO;Boomers;PROVIDENCIA                   ;METROPOLITANA;0;0;0;0;0;0;0;0;0;TAB S6 Lite (610) 4GB 64GB 10.4P DARK GREY;COMPUTACION
15060692;;M;40;CHILENO;;X;PROVIDENCIA                   ;METROPOLITANA;0;0;0;0;0;0;0;0;0;NTBK 14-DQ1001 Core i3-1005G1 4+16 256SSD 14;COMPUTACION
18514600;;F;28;CHILENO;;Millenial;LA PINTANA                    ;METROPOLITANA;0;0;0;0;0;0;0;0;0;TAB Mediapad T3 7 4Core 1GB 8GB 7 Gris;COMPUTACION
17039625;;M;33;CHILENO;;Millenial;N/D;N/D;0;0;0;0;0;0;0;0;0;MULTIFUNCIONAL ECOTANK L3150 Wifi;COMPUTACION
10063769;;F;55;CHILENO;;Boomers;RENCA                         ;METROPOLITANA;0;0;0;0;0;0;0;0;0;Multifuncional Smart Tank 515 Wifi;COMPUTACION
17540899;;M;31;CHILENO;;Millenial;PROVIDENCIA                   ;METROPOLITANA;0;0;0;0;0;0;0;0;0;NTBK IP3 Core i3-1005G1 4GB 256SSD 14P;COMPUTACION
19413828;;M;25;CHILENO;;Z;TEMUCO                        ;ARAUCANIA;0;0;0;0;0;0;0;0;0;TAB M7 QC 1GB 8GB 7P Gris;COMPUTACION
21103991;Soltero;F;28;CHILENO;;Millenial;PROVIDENCIA                   ;METROPOLITANA;0;0;0;0;0;0;0;0;0;NTBK 14-ds002la AMD A4 4GB 64GB eMMC 14P;COMPUTACION
15618949;;M;38;CHILENO;;X;PROVIDENCIA                   ;METROPOLITANA;0;0;0;0;0;0;0;0;0;TAB Galaxy Tab A 10.1 8Core 2GB 32GB 10 Negra;COMPUTACION
19065761;Soltero;M;27;CHILENO;;Z;PROVIDENCIA                   ;METROPOLITANA;0;0;0;0;0;0;0;0;0;TAB Galaxy Tab A 8 4Core 2GB 32GB 8 Negra;COMPUTACION
7085664;Soltero;F;67;CHILENO;PROFESOR;Boomers;PROVIDENCIA                   ;METROPOLITANA;0;0;0;0;0;0;0;0;0;TAB Galaxy Tab A 8 4Core 2GB 32GB 8 Gris;COMPUTACION
7830961;;M;65;CHILENO;;Boomers;COIHAIQUE                     ;AYSEN;0;0;0;0;0;0;0;0;0;TAB M8 QC 2GB 32GB 8P Gris;COMPUTACION
13517522;;M;44;CHILENO;;X;RANCAGUA                      ;L.G.B.OÂ´HIGGINS;0;0;0;0;0;0;0;0;0;TAB 7 MB4 Plus 4Core 1GB 16GB 7 Plata;COMPUTACION
16600790;;F;34;CHILENO;;Millenial;TALCAHUANO                    ;BIO BIO;0;0;0;0;0;0;0;0;0;MULTIFUNCIONAL ECOTANK L3150 Wifi;COMPUTACION
10750560;;M;55;CHILENO;;Boomers;RENGO                         ;L.G.B.OÂ´HIGGINS;0;0;0;0;0;0;0;0;0;NTBK 15-gw0016la AMD Athlon 8GB 256GBSSD 15P;COMPUTACION
19412753;Soltero;F;29;CHILENO;;Millenial;PROVIDENCIA                   ;METROPOLITANA;1912830;17;8;17;8;1912830;0;0;0;Camara Bala Exterior HDCAMEXTE624L;MERCADO ABC
15011423;;F;39;CHILENO;;X;TOCOPILLA                     ;ANTOFAGASTA;30480;2;1;2;1;30480;0;0;0;AUTO CONSTRUCCION CONTROL REMOTO;MERCADO ABC
18268765;;F;30;CHILENO;;Millenial;VALPARAISO;VALPARAISO;253940;4;1;4;1;253940;0;0;0;ESCRITORIO ESQUINERO EN FORMA DE L - RENNES ELB;MERCADO ABC
17197139;;F;28;CHILENO;;Millenial;"";"";119960;4;2;4;2;119960;0;0;0;Rack TV 2 nichos Rustico RT3153RU;MERCADO ABC
9125247;;F;60;CHILENO;;Boomers;PROVIDENCIA                   ;METROPOLITANA;761320;7;3;0;0;0;7;3;761320;Seccional Intercambiable Bugambilia By Essenza B;MERCADO ABC
17597434;;F;32;CHILENO;;Millenial;PUENTE ALTO                   ;METROPOLITANA;14980;2;1;2;1;14980;0;0;0;SET DE 25 CONTENEDORES SAN BERNARDO DE PLASTICO;MERCADO ABC
9564249;Casado;M;59;CHILENO;;Boomers;RENCA                         ;METROPOLITANA;68980;2;1;2;1;68980;0;0;0;BATERIA SPRING 7 PIEZAS GRANATE;MERCADO ABC
12250019;;F;50;CHILENO;;X;PROVIDENCIA                   ;METROPOLITANA;98980;2;1;2;1;98980;0;0;0;Vitrina Drita con Puertas de Vidrio Blanco-Rusti;MERCADO ABC
14511334;;M;48;CHILENO;;X;PROVIDENCIA                   ;N/D;46980;2;1;2;1;46980;0;0;0;MULTITESTER DIGITAL UNIT;MERCADO ABC
15590802;;F;39;CHILENO;;Millenial;N/D;N/D;258980;2;1;2;1;258980;0;0;0;PRISMA CUADRADO NEGRO MATTE 4 SILLAS;MERCADO ABC
13757560;;M;41;CHILENO;;Silencioso;PROVIDENCIA                   ;METROPOLITANA;625960;4;2;4;2;625960;0;0;0;LIVING 3.1.1 AMAPOLA TERRACOTA;MERCADO ABC
18276050;;F;30;CHILENO;;Millenial;CHILLAN                       ;BIO BIO;34980;2;1;2;1;34980;0;0;0;Plumon Coral Sherpa 2 P Morado;MERCADO ABC
17974689;;F;30;CHILENO;;Millenial;PROVIDENCIA                   ;METROPOLITANA;47980;2;1;2;1;47980;0;0;0;CASA PARA PERRO RIMAX PEQUENA TECHO AZUL;MERCADO ABC
16815970;;F;33;CHILENO;;Millenial;COIHUECO                      ;BIO BIO;2111180;38;18;37;17;2090190;1;1;20990;RACK R400 3 PUERTAS BLANCO;MERCADO ABC
5336274;;F;72;CHILENO;;Silencioso;VALLENAR;ATACAMA;723980;6;4;2;1;133980;4;3;590000;Rack TV 2 puertas Oliva LE6011OL;MERCADO ABC
17079152;;F;33;CHILENO;;Millenial;ALGARROBO;VALPARAISO;379960;4;2;4;2;379960;0;0;0;Seccional Intercambiable Donato Chocolate;MERCADO ABC
17028525;;F;33;CHILENO;;Millenial;N/D;N/D;813940;6;4;5;3;673950;1;1;139990;Trotadora Electrica Baldini 1,5HP;MERCADO ABC
15865890;;F;38;CHILENO;;Millenial;"";"";708960;4;2;4;2;708960;0;0;0;LIVING 3.1.1 DAVID CAFE;MERCADO ABC
16782950;;M;34;CHILENO;;Millenial;PROVIDENCIA                   ;METROPOLITANA;132980;2;1;2;1;132980;0;0;0;PANEL TV 60plg MOSAICO COLOR BLANCO/CANELA;MERCADO ABC
7420618;;F;63;CHILENO;;Boomers;PROVIDENCIA                   ;METROPOLITANA;72930;7;2;7;2;72930;0;0;0;Cortina Blackout Argolla 140x220 cms Selecta Gri;MERCADO ABC
13546387;;F;42;CHILENO;;X;SAN ANTONIO                   ;VALPARAISO;187426;14;6;0;0;0;14;6;187426;BANCO DE TRABAJO MADERA;MERCADO ABC
26517501;;F;24;NO INFORMA NACIONALIDAD;;Extranjero;"";"";167980;2;1;2;1;167980;0;0;0;Coche T.Sys Quest NegroAzul;MERCADO ABC
12108228;;M;41;CHILENO;;X;PROVIDENCIA                   ;METROPOLITANA;310980;2;1;2;1;310980;0;0;0;JGO LIVING FRANCIA 3,1,1 NEGRO;MERCADO ABC
10822229;;M;56;CHILENO;;Boomers;N/D;N/D;49980;2;1;2;1;49980;0;0;0;CAMARA INDOOR/OUTDOOR CON APP TUYA HYUNDAI;MERCADO ABC
17914326;;F;31;CHILENO;;Millenial;ANGOL;ARAUCANIA;604880;9;3;9;3;604880;0;0;0;Coche Travel System I-Giro Bright Gray;MERCADO ABC
14509868;;M;48;CHILENO;;X;N/D;N/D;44970;3;2;2;1;24980;1;1;19990;CAMARA DIGITAL ASD-DCA1010 NEGRO;MERCADO ABC
18485540;Soltero;M;28;CHILENO;TECNICO MECANICO;Millenial;PITRUFQUEN;ARAUCANIA;115980;2;1;2;1;115980;0;0;0;Banco R100 Multifuncional;MERCADO ABC
7938448;;F;64;CHILENO;;Boomers;"";"";15960;4;1;4;1;15960;0;0;0;Panos Microfibra Repuestos Mopa Electrica Saniti;MERCADO ABC
13607678;;F;43;CHILENO;;X;PROVIDENCIA                   ;METROPOLITANA;39980;2;1;2;1;39980;0;0;0;Plumon 1,5P U de Chile Classic;MERCADO ABC
18917194;;F;27;CHILENO;;Z;"";"";45980;2;1;2;1;45980;0;0;0;COCINA CON ACCESORIOS;MERCADO ABC
15264360;;F;39;CHILENO;;X;PROVIDENCIA                   ;METROPOLITANA;173980;2;1;2;1;173980;0;0;0;Closet Win 8 puertas 2 cajones Coffe Wood 162x62;MERCADO ABC
13264798;;F;45;CHILENO;;X;N/D;N/D;5990;1;1;0;0;0;1;1;5990;ENCAJE CLASIFICADOR DE FORMAS;MERCADO ABC
22853854;;F;37;NO INFORMA NACIONALIDAD;;Extranjero;"";"";134480;2;1;2;1;134480;0;0;0;BAR ESQUINERO KAVA BEIJING CONAC BLC 4457;MERCADO ABC
26538207;;F;41;EXTRANJERO - NO INFORMA NACIONALIDAD;;Extranjero;CHILLAN                       ;BIO BIO;988440;6;3;2;1;81980;4;2;906460;ARRIMO RA02 RETRO 2 CAJONES;MERCADO ABC
22721769;Casado;M;46;ECUATORIANO;MEDICO CIRUJANO;Extranjero;PROVIDENCIA                   ;METROPOLITANA;106980;2;1;2;1;106980;0;0;0;PANEL TV 60plg MOSAICO COLOR BLANCO/CANELA;MERCADO ABC
10561124;;M;50;CHILENO;;X;SAN CARLOS                    ;BIO BIO;379980;2;2;0;0;0;2;2;379980;GENERADOR INVERTER KR 1000IG;MERCADO ABC
9720428;;F;60;CHILENO;;Boomers;N/D;N/D;311920;9;8;2;1;90980;7;7;220940;KIT COCINA 120 PORRA;MERCADO ABC
19975487;;F;23;CHILENO;;Z;PROVIDENCIA                   ;METROPOLITANA;93980;2;1;2;1;93980;0;0;0;CUNA 3 POSICIONES BLANCA;MERCADO ABC
13701481;;F;43;CHILENO;;X;CONCHALI;METROPOLITANA;109960;4;2;4;2;109960;0;0;0;Plumon Microfibra King Rombos;MERCADO ABC
19504978;;F;25;CHILENO;;Millenial;"";"";354980;2;1;2;1;354980;0;0;0;Seccional Intercambiable Donato Chocolate;MERCADO ABC
10368915;;F;55;CHILENO;;Boomers;LA LIGUA                      ;VALPARAISO;479980;2;1;2;1;479980;0;0;0;COMEDOR LORENZI+6S TAMBURATO;MERCADO ABC
16487802;;F;35;CHILENO;;Millenial;VALPARAISO                    ;VALPARAISO;15980;2;1;2;1;15980;0;0;0;CARRITO VENTA HELADO;MERCADO ABC
8981719;;F;61;CHILENO;;Boomers;PROVIDENCIA                   ;METROPOLITANA;105980;2;1;2;1;105980;0;0;0;MUEBLE DE COCINA KITCHEN 90 - BLANCO / WENGUE;MERCADO ABC
16879966;;F;34;CHILENO;;Millenial;N/D;N/D;872920;6;2;0;0;0;6;2;872920;Seccional Derecho Isabella Oro;MERCADO ABC
17616747;Soltero;F;30;CHILENO;ENFERMERA;Millenial;PROVIDENCIA                   ;METROPOLITANA;65970;3;1;3;1;65970;0;0;0;Cortina Roller Garden Blanca 200x250cm;MERCADO ABC
18656814;Soltero;F;28;CHILENO;PROFESOR;Millenial;PROVIDENCIA                   ;METROPOLITANA;91480;2;1;2;1;91480;0;0;0;BARRA AUXILIAR DE COCINA FENDI - CEMENTO / BLANC;MERCADO ABC
13932643;Soltero;F;41;CHILENO;;X;PROVIDENCIA                   ;METROPOLITANA;104980;2;1;2;1;104980;0;0;0;Plataforma Vibratoria FullFit 2000 Bluetooth;MERCADO ABC
11946632;Casado;M;49;CHILENO;BIOQUIMICO;Silencioso;PROVIDENCIA                   ;METROPOLITANA;83980;2;1;2;1;83980;0;0;0;MUEBLE DE ASEO NALA (1C) BLANCO MLB 2602;MERCADO ABC
15462872;;F;39;CHILENO;;X;PROVIDENCIA                   ;METROPOLITANA;133980;2;1;2;1;133980;0;0;0;Trotadora Plegable K-FIT Bekele;MERCADO ABC
15183602;;F;39;CHILENO;;X;PROVIDENCIA                   ;METROPOLITANA;936960;4;2;0;0;0;4;2;936960;COMEDOR LORENZI II NOGAL+6S;MERCADO ABC
15656342;;F;38;CHILENO;;Millenial;VILCUN;ARAUCANIA;29980;2;1;2;1;29980;0;0;0;Plumon Imperial 2 plazas Tomy;MERCADO ABC
9095352;;F;60;CHILENO;;Boomers;PROVIDENCIA                   ;METROPOLITANA;143980;2;1;2;1;143980;0;0;0;Lampara de metal estilo Nordico L2010;MERCADO ABC
9834621;;M;58;CHILENO;;Boomers;ANGOL                         ;ARAUCANIA;156980;2;1;2;1;156980;0;0;0;Trotadora Plegable K-FIT 4 En 1 Bowden;MERCADO ABC
19797794;;F;24;CHILENO;;Z;PROVIDENCIA                   ;METROPOLITANA;5850;1;2;2;1;26840;-1;1;-20990;DRON CONTROL MANO;MERCADO ABC
20265138;;F;22;CHILENO;;Z;PURRANQUE                     ;LOS LAGOS;72540;2;1;2;1;72540;0;0;0;Silla Comer KinderSX RO;MERCADO ABC
13264477;;F;45;CHILENO;;X;N/D;N/D;16980;2;1;2;1;16980;0;0;0;CORREPASILLOS C SONIDO ROSADO;MERCADO ABC
16369319;;F;35;CHILENO;;Millenial;RECOLETA;METROPOLITANA;24980;2;1;2;1;24980;0;0;0;CORREPASILLOS C SONIDO ROJO;MERCADO ABC
5301522;;F;78;CHILENO;;Silencioso;TALAGANTE                     ;METROPOLITANA;49980;2;1;2;1;49980;0;0;0;MUEBLE DE COCINA KITCHEN 54 - BLANCO / WENGUE;MERCADO ABC
17988535;Soltero;M;31;CHILENO;INGENIERO EN TELECOMUNICACIONES;Millenial;N/D;N/D;40840;2;1;2;1;40840;0;0;0;Set Mancuernas Con Barra Ajustable 20Kg K-FIT;MERCADO ABC
6878956;Casado;F;69;CHILENO;INGENIERO;Silencioso;RENCA                         ;METROPOLITANA;18980;2;1;2;1;18980;0;0;0;MESA DIDACTICA MULTIFUNCION;MERCADO ABC
18082234;;F;29;CHILENO;;Millenial;PROVIDENCIA                   ;METROPOLITANA;52530;3;1;3;1;52530;0;0;0;CORREPASILLO ROJO CON TIRADOR;MERCADO ABC
13148858;;F;45;CHILENO;;X;LOS ANGELES                   ;BIO BIO;87840;2;1;2;1;87840;0;0;0;CTravel Jazz Negro Calip;MERCADO ABC
17707117;;F;31;CHILENO;;Millenial;LA CISTERNA                   ;METROPOLITANA;178930;7;3;7;3;178930;0;0;0;Sabana 1,5P Spiderman Wonder;MERCADO ABC
10789272;Casado;F;54;CHILENO;;Boomers;RENCA                         ;METROPOLITANA;24960;4;2;4;2;24960;0;0;0;SET BLOQUES 38 PCS;MERCADO ABC
13470275;;M;43;CHILENO;;X;LA FLORIDA                    ;METROPOLITANA;123980;2;1;2;1;123980;0;0;0;TECLADO CT-S100 61 TECLAS CON TRANSFORMADOR;MERCADO ABC
8179391;;M;66;CHILENO;;Boomers;CHIGUAYANTE                   ;BIO BIO;241970;3;2;0;0;0;3;2;241970;RACK MODELO VENEZZA TV DE 70 ROBLE-BEIGE;MERCADO ABC
18129909;Soltero;F;30;CHILENO;PROFESOR;Millenial;PROVIDENCIA                   ;METROPOLITANA;187080;3;1;3;1;187080;0;0;0;MESA DE CENTRO CROSS 100X50X45CM;MERCADO ABC
11831627;;F;51;CHILENO;;Silencioso;PROVIDENCIA                   ;METROPOLITANA;64980;2;1;2;1;64980;0;0;0;V-ESCRITORIO/ PIZARRA ARTISTICO FISHER PRICE;MERCADO ABC
19318855;Soltero;M;26;CHILENO;;Z;PROVIDENCIA                   ;METROPOLITANA;41980;2;1;2;1;41980;0;0;0;UKULELE 23 ELECTROACUSTICO MUK07E;MERCADO ABC
19258624;;M;26;CHILENO;;Z;PROVIDENCIA                   ;METROPOLITANA;322960;4;2;4;2;322960;0;0;0;Trotadora Electrica Baldini 1,5HP;MERCADO ABC
15551640;;M;36;CHILENO;;Millenial;TEMUCO;ARAUCANIA;324980;2;1;2;1;324980;0;0;0;SOFA MIRA 2 CPO TELA VISON RSN;MERCADO ABC
18960635;;M;27;CHILENO;;Millenial;N/D;N/D;37980;2;1;2;1;37980;0;0;0;Set Mancuernas Con Barra Ajustable 15Kg K-FIT;MERCADO ABC
19332512;;F;26;CHILENO;;Silencioso;PROVIDENCIA                   ;METROPOLITANA;29840;2;1;2;1;29840;0;0;0;Set Mancuernas Con Barra Ajustable 10Kg K-FIT;MERCADO ABC
11694663;;F;51;CHILENO;;X;N/D;N/D;20980;2;1;2;1;20980;0;0;0;Kit Juego De Dados Llave Chicharra 1/4 19 Piezas;MERCADO ABC
18836674;;F;27;CHILENO;;Millenial;N/D;N/D;189970;3;2;2;1;171980;1;1;17990;Bicicleta De Spinning Strong Pro-Fit K-FIT;MERCADO ABC
13120634;Casado;F;46;CHILENO;;X;PROVIDENCIA                   ;METROPOLITANA;69990;1;1;0;0;0;1;1;69990;GUITARRA ELECTROACUSTICA MEAN1 NEGRA;MERCADO ABC
19010978;;M;27;CHILENO;;Millenial;SAN FERNANDO                  ;L.G.B.OÂ´HIGGINS;82540;2;1;2;1;82540;0;0;0;Coche Cuna Balan Purpura B500P;MERCADO ABC
14619895;;M;42;CHILENO;;Silencioso;PROVIDENCIA                   ;METROPOLITANA;0;0;0;0;0;0;0;0;0;SOFA MANET 3 CPO TELA COLOR GRIS;MERCADO ABC
13309015;;M;45;CHILENO;;X;N/D;N/D;0;0;0;0;0;0;0;0;0;SET UKELELE ELECTROACUSTICO;MERCADO ABC
17363601;;M;32;CHILENO;;Millenial;N/D;N/D;0;0;0;0;0;0;0;0;0;SILLA METALICA ACERO;MERCADO ABC
17129042;;F;33;CHILENO;;Millenial;PROVIDENCIA                   ;METROPOLITANA;0;0;0;0;0;0;0;0;0;TECLADO MONOFONICO NINO;MERCADO ABC
13374991;;M;43;CHILENO;;X;PROVIDENCIA                   ;METROPOLITANA;0;0;0;0;0;0;0;0;0;Casa Para Perro Large Con Ventilacion Coolpets 9;MERCADO ABC
15254408;;F;46;CHILENO;;X;VILLARICA                     ;ARAUCANIA;0;0;0;0;0;0;0;0;0;SILLA METALICA ACERO;MERCADO ABC
14093374;Casado;F;40;CHILENO;MATRONA;X;PROVIDENCIA                   ;METROPOLITANA;0;0;0;0;0;0;0;0;0;SET INSTITUTO DINOSAURIO CON CERCA;MERCADO ABC
17809708;;F;31;CHILENO;;Extranjero;"";"";0;0;0;0;0;0;0;0;0;ALZADOR BEBESIT CS101 PINK;MERCADO ABC
14155971;;F;41;CHILENO;;X;LOS ANGELES                   ;BIO BIO;0;0;0;0;0;0;0;0;0;STREET FIRE MEGA DEALER SHOWROOM;MERCADO ABC
18481280;;F;29;CHILENO;;Silencioso;PROVIDENCIA                   ;METROPOLITANA;0;0;0;0;0;0;0;0;0;CAMA ACOLCHADA MASCOTA T/M;MERCADO ABC
6472999;Viudo;F;72;CHILENO;;Silencioso;PROVIDENCIA                   ;METROPOLITANA;0;0;0;0;0;0;0;0;0;BERGERE SAVERNE NEGRO RSN;MERCADO ABC
11358868;;F;53;CHILENO;;X;PROVIDENCIA                   ;METROPOLITANA;0;0;0;0;0;0;0;0;0;Cama De Mascota Con Cojin L Coolpets 80Ã54.5Ã24.;MERCADO ABC
16503440;;F;35;CHILENO;;Millenial;VINA DEL MAR                  ;VALPARAISO;0;0;0;0;0;0;0;0;0;TECLADO NU003 61 TECLAS NEGRO POLIFONICO;MERCADO ABC
13231932;;M;45;CHILENO;;Silencioso;PROVIDENCIA                   ;METROPOLITANA;0;0;0;0;0;0;0;0;0;TECLADO MONOFONICO NINO;MERCADO ABC
19192361;;M;26;CHILENO;;Millenial;PROVIDENCIA                   ;METROPOLITANA;0;0;0;0;0;0;0;0;0;JUEGO COMEDOR VENUS 6 SILLAS;MERCADO ABC
19266218;Soltero;F;26;CHILENO;PROFESOR;Z;PROVIDENCIA                   ;METROPOLITANA;0;0;0;0;0;0;0;0;0;BERGER SAVERNE TELA CHEX CAFE RSN;MERCADO ABC
6664468;;F;69;CHILENO;;Silencioso;MELIPILLA                     ;METROPOLITANA;0;0;0;0;0;0;0;0;0;TECLADO CT-S100 61 TECLAS CON TRANSFORMADOR;MERCADO ABC
18084729;;F;30;CHILENO;;Millenial;PUDAHUEL                      ;METROPOLITANA;0;0;0;0;0;0;0;0;0;TECLADO MINI SA-47AH2;MERCADO ABC
21136462;;M;23;CHILENO;;Extranjero;PROVIDENCIA                   ;METROPOLITANA;0;0;0;0;0;0;0;0;0;SOFA MIRA 3 CPO EBCA VISON RSN;MERCADO ABC
15713685;Soltero;F;38;CHILENO;AGRONOMO;Millenial;PROVIDENCIA                   ;METROPOLITANA;0;0;0;0;0;0;0;0;0;MUEBLE WC PUERTA SUPERIOR CIC BLANCO;MERCADO ABC
18362249;;M;29;CHILENO;;Millenial;CALAMA                        ;ANTOFAGASTA;0;0;0;0;0;0;0;0;0;CORREPASILLO CON TOLDO ROJO;MERCADO ABC
9723918;;M;58;CHILENO;;Boomers;ALTO BIO BIO;BIO BIO;0;0;0;0;0;0;0;0;0;TECLADO MINI SA-47AH2;MERCADO ABC
17959450;Soltero;M;30;CHILENO;;Millenial;PROVIDENCIA                   ;METROPOLITANA;0;0;0;0;0;0;0;0;0;CAMARA DIGITAL ASD-DCA1010 AZUL;MERCADO ABC
8509737;Casado;M;63;CHILENO;;Boomers;PUENTE ALTO                   ;METROPOLITANA;0;0;0;0;0;0;0;0;0;INNOVADOR DESAFIO DETECTOR;MERCADO ABC
12947500;;F;46;CHILENO;;X;CABILDO                       ;VALPARAISO;0;0;0;0;0;0;0;0;0;SILLA METALICA NEGRO;MERCADO ABC
15525712;;F;39;CHILENO;;X;RENCA                         ;METROPOLITANA;0;0;0;0;0;0;0;0;0;WALKIE TALKIE SPIDERMAN;MERCADO ABC
13612686;;F;42;CHILENO;;X;TALCA                         ;MAULE;0;0;0;0;0;0;0;0;0;BOLSO STYLE BIA;MERCADO ABC
16690745;;F;34;CHILENO;;Millenial;CORONEL                       ;BIO BIO;0;0;0;0;0;0;0;0;0;PLAY-DOH CREACIONES MARINAS;MERCADO ABC
26262269;;F;26;VENEZOLANO;;Extranjero;NUNOA                         ;METROPOLITANA;0;0;0;0;0;0;0;0;0;TECLADO ESTANDAR CTK-2500K2 C/TRANSF NEGRO;MERCADO ABC
17422530;;F;32;CHILENO;;Millenial;N/D;N/D;0;0;0;0;0;0;0;0;0;GIMNASIO ALFOMBRA CON PIANO Y MP3;MERCADO ABC
17115576;;M;47;CHILENO;;X;RENCA                         ;METROPOLITANA;0;0;0;0;0;0;0;0;0;AVN TITAN HERO MOVIE IRON MAN;MERCADO ABC
9272619;Soltero;F;59;CHILENO;;Boomers;PROVIDENCIA                   ;METROPOLITANA;0;0;0;0;0;0;0;0;0;MIS PRIMEROS BLOQUES 100PCS DOL;MERCADO ABC
10259635;Divorciado;M;52;CHILENO;;X;RENCA                         ;METROPOLITANA;0;0;0;0;0;0;0;0;0;GUITARRA CLASICA MS139 39 NATURAL;MERCADO ABC
6362923;Soltero;F;69;CHILENO;CONSTRUCTOR CIVIL;Silencioso;RENCA                         ;METROPOLITANA;0;0;0;0;0;0;0;0;0;SABANA 144H WHITE 1,5P;MERCADO ABC
11439262;;M;53;CHILENO;;X;N/D;N/D;0;0;0;0;0;0;0;0;0;PACK FRAZADAS STONE 1,5P;MERCADO ABC
26840327;;M;31;"";;Extranjero;PROVIDENCIA                   ;METROPOLITANA;0;0;0;0;0;0;0;0;0;PUF PROMOCIONAL NEGRO;MERCADO ABC
10696783;Casado;M;53;CHILENO;INGENIERO;X;PROVIDENCIA                   ;METROPOLITANA;0;0;0;0;0;0;0;0;0;JUEGO TERRAZA CUERDA RATTAN;MERCADO ABC
13723346;Casado;F;43;CHILENO;TECNICO LABORATORISTA DENTAL;X;RENCA                         ;METROPOLITANA;0;0;0;0;0;0;0;0;0;COMEDOR TERRAZA AMPLIABLE;MERCADO ABC
24148793;;M;32;PERUANO;;Extranjero;ANTOFAGASTA                   ;ANTOFAGASTA;0;0;0;0;0;0;0;0;0;CUCHILLERIA 45P ACERO PRAGA;MERCADO ABC
9288598;Casado;F;60;CHILENO;;Boomers;RENCA                         ;METROPOLITANA;0;0;0;0;0;0;0;0;0;CUCHILLERIA 24P ACERO AUSTRIA;MERCADO ABC
7585708;;F;70;CHILENO;;Silencioso;LA SERENA                     ;COQUIMBO;0;0;0;0;0;0;0;0;0;MUNECA 31CM C/SONIDO DE BESOS;MERCADO ABC
11895206;;F;50;CHILENO;;X;RENCA                         ;METROPOLITANA;0;0;0;0;0;0;0;0;0;QUILT REVERSIBLE ONDAS C/ FLECOS 2P;MERCADO ABC
17292446;Soltero;M;31;CHILENO;INGENIERO INFORMATICO;Millenial;PROVIDENCIA                   ;METROPOLITANA;0;0;0;0;0;0;0;0;0;PARRILLA A GAS 2 QUEMADORES;MERCADO ABC
11482822;Soltero;M;53;CHILENO;;X;RENCA                         ;METROPOLITANA;0;0;0;0;0;0;0;0;0;PLUMON MICROFIBRA BLUE 2P;MERCADO ABC
14245524;;F;49;CHILENO;;X;PENAFLOR                      ;METROPOLITANA;521490;11;2;0;0;0;11;2;521490;Bolsa Papel Abcdin;PROMOCIONES
17291510;;M;32;CHILENO;;Millenial;SAN PEDRO DE LA PAZ           ;BIO BIO;21340;10;10;0;0;0;10;10;21340;Bolsa Papel Abcdin;PROMOCIONES
13620665;;F;43;CHILENO;;X;CONCEPCION                    ;BIO BIO;3300;22;22;0;0;0;22;22;3300;Bolsa Papel Abcdin;PROMOCIONES
15229058;;F;40;CHILENO;;X;CONCEPCION                    ;BIO BIO;42542;2;2;0;0;0;2;2;42542;Bolsa Papel Abcdin;PROMOCIONES
12025728;;F;48;CHILENO;;X;LEBU                          ;BIO BIO;213920;12;14;0;0;0;12;14;213920;Bolsa Papel Abcdin;PROMOCIONES
16295869;;M;35;CHILENO;;Millenial;SAN PEDRO DE LA PAZ           ;BIO BIO;270270;6;4;0;0;0;6;4;270270;Bolsa Papel Abcdin;PROMOCIONES
15648222;;F;38;CHILENO;;X;CHIGUAYANTE                   ;BIO BIO;578091;8;4;0;0;0;8;4;578091;Bolsa Papel Abcdin;PROMOCIONES
15794401;;M;37;CHILENO;;Millenial;"";"";140140;2;2;1;1;139990;1;1;150;Bolsa Papel Abcdin;PROMOCIONES
19786776;;F;24;CHILENO;;Z;N/D;N/D;0;0;0;0;0;0;0;0;0;KEY FINDER ASD-ATL1003-2;PROMOCIONES
10383757;;F;55;CHILENO;;Boomers;RENCA                         ;METROPOLITANA;0;0;0;0;0;0;0;0;0;Bolsa Papel Abcdin;PROMOCIONES
18511631;;F;28;CHILENO;;Millenial;LA LIGUA                      ;VALPARAISO;1566920;8;4;8;4;1566920;0;0;0;Cocina MCG-5QI30NS 5P;LINEA BLANCA
6387135;;M;69;CHILENO;;Silencioso;PUENTE ALTO                   ;METROPOLITANA;585390;10;4;0;0;0;10;4;585390;Cocina CH-9500 NG 4P;LINEA BLANCA
16979816;;F;34;CHILENO;;Millenial;CANETE                        ;BIO BIO;2018840;16;11;3;3;719970;13;8;1298870;Secadora 7Kg 7D BZG Ventilacion Blanca;LINEA BLANCA
12736755;;M;47;CHILENO;;X;VICTORIA                      ;ARAUCANIA;189990;1;1;0;0;0;1;1;189990;Freezer Horizontal M 150 142Lts;LINEA BLANCA
16776746;;F;34;CHILENO;;Millenial;"";"";216980;2;1;2;1;216980;0;0;0;Freezer Vertical 157Lts FF-211VSM Silver;LINEA BLANCA
20372925;;F;22;CHILENO;;Z;N/D;N/D;360360;3;2;0;0;0;3;2;360360;Lavadora Efficace SZG 17,5Kg Silver;LINEA BLANCA
16595335;;F;35;CHILENO;;Millenial;N/D;N/D;623540;14;4;14;4;623540;0;0;0;Freezer 145 Lts FDHM150BY0 Horizontal;LINEA BLANCA
17813639;;M;32;CHILENO;;Millenial;NUEVA IMPERIAL                ;ARAUCANIA;232140;2;1;0;0;0;2;1;232140;Cocina CH-9400 4P SILVER;LINEA BLANCA
16903436;;F;34;CHILENO;;Millenial;N/D;N/D;592900;13;5;8;2;347930;5;3;244970;Lavadora MLS-160BSC03T 16Kg Blanca;LINEA BLANCA
12961226;;M;45;CHILENO;;X;N/D;N/D;837940;6;3;0;0;0;6;3;837940;Lavadora MLS-190GC03N 19Kg Gris;LINEA BLANCA
8185339;;F;65;CHILENO;;Boomers;QUINTERO                      ;VALPARAISO;1013830;9;2;0;0;0;9;2;1013830;Cocina CH-7400 4P;LINEA BLANCA
14351884;;F;42;CHILENO;;X;ANGOL                         ;ARAUCANIA;523980;2;1;0;0;0;2;1;523980;Refrigerador 527Lts Side by Side MRSBS5300G689WE;LINEA BLANCA
18007603;;F;37;CHILENO;;Millenial;N/D;N/D;302960;4;3;0;0;0;4;3;302960;Lavadora WA80H4200SW1ZS 8Kg Blanca;LINEA BLANCA
5269578;;F;79;CHILENO;;Silencioso;PENAFLOR                      ;METROPOLITANA;179990;1;1;0;0;0;1;1;179990;Calefont 10Lts GL Essenetial ECO;LINEA BLANCA
17815025;;F;31;CHILENO;;Millenial;CARTAGENA                     ;VALPARAISO;562980;2;1;0;0;0;2;1;562980;Refrigerador 527Lts Side by Side MRSBS5300G689WE;LINEA BLANCA
7338719;Soltero;M;68;CHILENO;;Silencioso;CALAMA                        ;ANTOFAGASTA;339990;1;3;0;0;0;1;3;339990;REFRIGERADOR TOP MOUNT GT29BPPK NO FROST 254 Lt;LINEA BLANCA
17647382;;M;31;CHILENO;;Millenial;N/D;N/D;426821;4;2;0;0;0;4;2;426821;Lavadora Premium Care 20SZ 20Kg Silver;LINEA BLANCA
12792112;;F;47;CHILENO;;X;CAUQUENES                     ;MAULE;585762;9;7;2;1;336980;7;6;248782;Lavadora Premium Care 20SZ 20Kg Silver;LINEA BLANCA
16225434;;F;36;CHILENO;;Millenial;ARICA                         ;ARICA Y PARINACOTA;520360;3;1;0;0;0;3;1;520360;Lavadora Efficace SZG 17,5Kg Silver;LINEA BLANCA
16181723;;M;36;CHILENO;;Millenial;PROVIDENCIA                   ;METROPOLITANA;529990;1;1;0;0;0;1;1;529990;Refrigerador 535Lts Side by Side RS54N3003SL/ZS;LINEA BLANCA
15238060;;M;39;CHILENO;;X;NUEVA IMPERIAL                ;ARAUCANIA;693940;6;4;0;0;0;6;4;693940;Secadora Ropa MD100A90/W 9Kg Ventilacion Blanca;LINEA BLANCA
9255280;;F;60;CHILENO;;Boomers;SANTIAGO                      ;METROPOLITANA;369520;7;3;0;0;0;7;3;369520;Freezer Horizontal M100 99Lts;LINEA BLANCA
12572191;Soltero;M;48;CHILENO;;X;RENCA                         ;METROPOLITANA;249990;1;1;0;0;0;1;1;249990;Refrigerador 241Lts BF Frio Directo Nordik 415;LINEA BLANCA
16621211;;M;35;CHILENO;;Millenial;PROVIDENCIA                   ;METROPOLITANA;183980;2;1;2;1;183980;0;0;0;Freezer Horizontal M 150 142Lts;LINEA BLANCA
20643860;;M;21;CHILENO;;Z;"";"";719950;5;3;0;0;0;5;3;719950;Lavadora Secadora WD10WVC4S6 10,5/6Kg Blanca;LINEA BLANCA
7482683;;F;70;CHILENO;;Silencioso;LA SERENA                     ;COQUIMBO;372970;5;2;0;0;0;5;2;372970;Cocina CH-7400 4P;LINEA BLANCA
10806867;Divorciado;F;51;CHILENO;;X;RENCA                         ;METROPOLITANA;303970;3;1;3;1;303970;0;0;0;Calefon ionizado 7 litros GL AS0;LINEA BLANCA
8787311;;F;83;CHILENO;;Silencioso;NUEVA IMPERIAL                ;ARAUCANIA;602170;4;1;0;0;0;4;1;602170;Refrigerador 300Lts No Frost RT29K500JS8/ZS;LINEA BLANCA
8637124;;F;50;CHILENO;;X;NATALES                       ;MAGALLANES;849960;4;2;2;1;419980;2;1;429980;Refrigerador Side by side Multidoor DM64S;LINEA BLANCA
7886861;;F;65;CHILENO;;Boomers;COIHAIQUE                     ;AYSEN;191790;2;1;0;0;0;2;1;191790;Freezer 99Lts MFH-1000B131CN Horizontal;LINEA BLANCA
6695018;;M;69;CHILENO;;Silencioso;LAMPA                         ;METROPOLITANA;249970;3;2;0;0;0;3;2;249970;Lavadora WA80H4200SW1ZS 8Kg Blanca;LINEA BLANCA
18326885;;M;29;CHILENO;;Millenial;PROVIDENCIA;METROPOLITANA;343970;3;2;3;2;343970;0;0;0;Calefont 10Lts GL Essenetial ECO;LINEA BLANCA
12794251;;F;47;CHILENO;;X;RENCA                         ;METROPOLITANA;206980;2;1;2;1;206980;0;0;0;Refrigerador 166 Lts Frio Directo BF MED165;LINEA BLANCA
15741334;;F;38;CHILENO;;X;N/D;N/D;779970;3;2;0;0;0;3;2;779970;Lavadora WT13WSBP 13Kg Blanca;LINEA BLANCA
16215755;;F;36;CHILENO;;Millenial;BUIN                          ;METROPOLITANA;434980;3;2;0;0;0;3;2;434980;Cocina F 2608 T 4P Reflex Silver;LINEA BLANCA
17456638;;F;32;CHILENO;;Millenial;"";"";299990;3;1;0;0;0;3;1;299990;Lavadora MLS-160BSC03T 16Kg Blanca;LINEA BLANCA
12387271;;F;50;CHILENO;;X;N/D;N/D;613580;8;4;0;0;0;8;4;613580;Secadora 7Kg 7D BZG Ventilacion Blanca;LINEA BLANCA
15708085;;F;38;CHILENO;;X;PADRE HURTADO;METROPOLITANA;651880;11;5;11;5;651880;0;0;0;Lavadora WA13T5260BW/ZS 13Kg Blanca;LINEA BLANCA
26571749;;M;43;VENEZOLANO;;Extranjero;CONCEPCION                    ;BIO BIO;1183640;10;4;3;1;491690;7;3;691950;Lavadora Premium Care 20SZ 20Kg Silver;LINEA BLANCA
6194454;;F;69;CHILENO;;Silencioso;PUNTA ARENAS                  ;MAGALLANES;556980;4;3;0;0;0;4;3;556980;Cocina CH-8700IN 5P;LINEA BLANCA
5429865;Soltero;F;74;CHILENO;;Silencioso;PROVIDENCIA                   ;METROPOLITANA;258980;2;1;0;0;0;2;1;258980;Lavadora 9 Kg Carga Superior Blanca;LINEA BLANCA
11860380;;F;52;CHILENO;;X;TEMUCO                        ;ARAUCANIA;539090;7;3;0;0;0;7;3;539090;Secadora Ropa MD100A90/W 9Kg Ventilacion Blanca;LINEA BLANCA
10751055;;M;52;CHILENO;;X;COPIAPO                       ;ATACAMA;536640;5;3;0;0;0;5;3;536640;Refrigerador 244Lts Frio Directo Progress 3100;LINEA BLANCA
10786605;;F;59;CHILENO;;Boomers;PICHILEMU                     ;L.G.B.OÂ´HIGGINS;432230;9;2;0;0;0;9;2;432230;Lavadora MLS-160BSC03T 16Kg Blanca;LINEA BLANCA
25003405;;F;24;BOLIVIANO;;Extranjero;COPIAPO                       ;ATACAMA;526970;5;3;0;0;0;5;3;526970;Lavadora Semiautomatica LC-6550 6,5Kg;LINEA BLANCA
8987659;;F;62;CHILENO;;Boomers;PROVIDENCIA                   ;METROPOLITANA;377970;3;2;0;0;0;3;2;377970;Cocina M 795 T 4P Silver;LINEA BLANCA
11971165;;F;50;CHILENO;;X;CARTAGENA                     ;VALPARAISO;1435930;7;4;5;2;580950;2;2;854980;Freezer Vertical 157Lts FF-211VSM Silver;LINEA BLANCA
4815170;;M;82;CHILENO;;Silencioso;PERALILLO                     ;L.G.B.OÂ´HIGGINS;154640;2;1;0;0;0;2;1;154640;Calefont 8Lts GL Essenetial ECO;LINEA BLANCA
14900723;;F;41;CHILENO;;X;N/D;N/D;836781;11;6;0;0;0;11;6;836781;Lavadora Efficace SZG 17,5Kg Silver;LINEA BLANCA
7209422;;F;73;CHILENO;;Silencioso;LA GRANJA;METROPOLITANA;169980;2;1;2;1;169980;0;0;0;Lavadora MLS-090GE04N 9Kg Gris;LINEA BLANCA
8631176;Casado;F;64;CHILENO;;Boomers;RENCA                         ;METROPOLITANA;934990;7;1;0;0;0;7;1;934990;Lavadora WT19DSBP 19Kg Silver;LINEA BLANCA
14385042;;F;44;CHILENO;;X;COQUIMBO                      ;COQUIMBO;451090;2;1;0;0;0;2;1;451090;Lavadora WA17T6260BW/ZS 17Kg Blanca;LINEA BLANCA
17130250;;F;33;CHILENO;;Silencioso;PROVIDENCIA                   ;METROPOLITANA;303970;5;1;5;1;303970;0;0;0;Lavadora Efficace SZG 17,5Kg Silver;LINEA BLANCA
13024463;;M;45;CHILENO;;X;VINA DEL MAR                  ;VALPARAISO;591140;8;2;0;0;0;8;2;591140;Lavadora MLS-160BSC03T 16Kg Blanca;LINEA BLANCA
11444148;;F;52;CHILENO;;X;SAN CARLOS                    ;BIO BIO;449620;5;3;0;0;0;5;3;449620;Calefont 8Lts GL Essenetial ECO;LINEA BLANCA
10721427;;F;55;CHILENO;;Boomers;RENCA                         ;METROPOLITANA;159990;1;1;0;0;0;1;1;159990;Lavadora Semiautomatica Twister 5100 4Kg;LINEA BLANCA
16786843;;F;34;CHILENO;;Millenial;CANETE                        ;BIO BIO;219990;1;1;0;0;0;1;1;219990;Cocina CH-7400 4P;LINEA BLANCA
6315585;;M;71;CHILENO;;Silencioso;PROVIDENCIA                   ;N/D;462780;3;1;0;0;0;3;1;462780;REFRIGERADOR SIDE BY SIDE RC-56WS 428L;LINEA BLANCA
15034881;;M;40;CHILENO;;X;N/D;N/D;512350;4;1;0;0;0;4;1;512350;Lavadora Efficace SZG 17,5Kg Silver;LINEA BLANCA
12325217;;M;49;CHILENO;;X;RENCA                         ;METROPOLITANA;169990;1;1;0;0;0;1;1;169990;Lavadora MLS-090GE04N 9Kg Gris;LINEA BLANCA
11387502;;M;52;CHILENO;;X;HIJUELAS                      ;VALPARAISO;708950;5;3;0;0;0;5;3;708950;KIT-138 HORNO HE-7200IN+CEG-4600IN+CA-610EIN;LINEA BLANCA
6308002;;M;72;CHILENO;;Silencioso;ANGOL                         ;ARAUCANIA;1364231;11;8;0;0;0;11;8;1364231;Cocina CH-7400 4P;LINEA BLANCA
11212784;;F;55;CHILENO;;Boomers;RENCA                         ;METROPOLITANA;107980;2;1;2;1;107980;0;0;0;ENCIMERA AT-XNG FEIN FF GL 4P ALBIN TROTTER;LINEA BLANCA
16674794;;F;35;CHILENO;;Millenial;LOS SAUCES;ARAUCANIA;660910;7;2;7;2;660910;0;0;0;ENCIMERA A GAS CMG6044SD-0CL 4Q MABE;LINEA BLANCA
12713516;;M;48;CHILENO;;X;SANTIAGO                      ;METROPOLITANA;686940;7;4;2;1;229980;5;3;456960;Secadora Ropa MD100A90/T 9Kg Ventilacion Gris;LINEA BLANCA
13970051;;F;42;CHILENO;;X;COIHAIQUE                     ;AYSEN;961920;8;6;1;1;269990;7;5;691930;Refrigerador 180Lts BF Frio Directo MDRB275FGF42;LINEA BLANCA
5804634;;F;78;CHILENO;;Silencioso;ARICA                         ;ARICA Y PARINACOTA;348980;2;1;0;0;0;2;1;348980;Cocina M 795 T 4P Silver;LINEA BLANCA
5832349;;F;76;CHILENO;;Silencioso;PROVIDENCIA                   ;METROPOLITANA;399990;1;3;0;0;0;1;3;399990;Refrigerador Advantage 5300 320Lts No Frost;LINEA BLANCA
7262328;;F;66;CHILENO;;Boomers;RIO NEGRO                     ;LOS LAGOS;286870;3;1;0;0;0;3;1;286870;Refrigerador 241Lts BF Frio Directo Nordik 415;LINEA BLANCA
17425823;;F;32;CHILENO;;Millenial;TALAGANTE;METROPOLITANA;573900;7;3;0;0;0;7;3;573900;Lavadora Efficace SZG 15,5Kg Silver;LINEA BLANCA
8127513;;F;62;CHILENO;;Boomers;LA PINTANA                    ;METROPOLITANA;428100;4;2;0;0;0;4;2;428100;Lavadora Efficace SZG 17,5Kg Silver;LINEA BLANCA
8412122;;F;67;CHILENO;;Boomers;PUENTE ALTO                   ;METROPOLITANA;249990;1;1;0;0;0;1;1;249990;Cocina M 775 ST 4P Silver;LINEA BLANCA
12191340;;M;51;CHILENO;;X;CARAHUE                       ;ARAUCANIA;329870;2;1;0;0;0;2;1;329870;Lavadora Efficace SZG 15,5Kg Silver;LINEA BLANCA
19416766;;M;25;CHILENO;;Z;N/D;N/D;160960;4;2;4;2;160960;0;0;0;Calefon ionizado 7 litros GN HydroSense;LINEA BLANCA
12543957;;M;48;CHILENO;;X;CAUQUENES                     ;MAULE;704920;8;4;0;0;0;8;4;704920;Secadora Ropa MD100A90/W 9Kg Ventilacion Blanca;LINEA BLANCA
15569814;;M;39;CHILENO;;X;LONGAVI                       ;MAULE;593962;4;3;0;0;0;4;3;593962;Lavadora WA13T5260BW/ZS 13Kg Blanca;LINEA BLANCA
25771751;Soltero;M;34;BOLIVIANO;;Extranjero;"";"";411980;2;1;2;1;411980;0;0;0;Refrigerador 432Lts Side by Side MDRS619FGE46;LINEA BLANCA
19500486;;F;25;CHILENO;;Z;"";"";209970;3;2;0;0;0;3;2;209970;Secadora Ropa MD100A90/W 9Kg Ventilacion Blanca;LINEA BLANCA
11458249;;F;53;CHILENO;;X;SAN JAVIER;MAULE;383960;4;2;2;1;176980;2;1;206980;Lavadora 9,5Kg BZG Blanca;LINEA BLANCA
10018259;;M;51;CHILENO;;X;COIHAIQUE                     ;AYSEN;299990;1;1;0;0;0;1;1;299990;Lavadora Superior WA13T5260BY/ZS 13Kg;LINEA BLANCA
9547229;;F;61;CHILENO;;Boomers;MACHALI                       ;L.G.B.OÂ´HIGGINS;190380;3;2;0;0;0;3;2;190380;Calefont 10Lts GL Essenetial ECO;LINEA BLANCA
16979865;;F;34;CHILENO;;Millenial;ARAUCO                        ;BIO BIO;1024640;8;4;8;4;1024640;0;0;0;Lavadora Efficace SZG 19,5Kg Silver;LINEA BLANCA
9618316;;F;43;CHILENO;;X;"";"";149980;2;1;2;1;149980;0;0;0;Lavadora MLS-090GE04N 9Kg Gris;LINEA BLANCA
10120601;;M;57;CHILENO;;Boomers;TALAGANTE                     ;METROPOLITANA;252880;2;1;0;0;0;2;1;252880;Lavadora WA90H4400SW1ZS 9Kg Blanca;LINEA BLANCA
7914344;;M;72;CHILENO;;Silencioso;PROVIDENCIA                   ;METROPOLITANA;440470;3;4;0;0;0;3;4;440470;Lavadora WT16DSBP 16Kg Silver;LINEA BLANCA
13663466;;M;44;CHILENO;;X;ESTACION CENTRAL              ;METROPOLITANA;617770;7;4;0;0;0;7;4;617770;Secadora Ropa MD100A90/W 9Kg Ventilacion Blanca;LINEA BLANCA
15963416;;M;37;CHILENO;;Millenial;N/D;N/D;259980;2;1;2;1;259980;0;0;0;Lavadora Efficace SZG 17,5Kg Silver;LINEA BLANCA
6775838;;M;65;CHILENO;;Boomers;PROVIDENCIA                   ;METROPOLITANA;399990;2;1;0;0;0;2;1;399990;Lavadora WT16DSBP 16Kg Silver;LINEA BLANCA
26555131;;F;30;EXTRANJERO - NO INFORMA NACIONALIDAD;;Extranjero;N/D;N/D;189980;2;1;0;0;0;2;1;189980;Secadora Ropa MD100A90/W 9Kg Ventilacion Blanca;LINEA BLANCA
15699703;;F;39;CHILENO;;X;NIQUEN                        ;BIO BIO;581701;5;4;0;0;0;5;4;581701;Lavadora WT19DSBP 19Kg Silver;LINEA BLANCA
13942218;;F;41;CHILENO;;X;ISLA DE MAIPO                 ;METROPOLITANA;305440;5;3;0;0;0;5;3;305440;Secadora Electrica SEM101BDBY Blanca 10 KG;LINEA BLANCA
12621678;Soltero;F;48;CHILENO;ASISTENTE SOCIAL;X;PROVIDENCIA                   ;METROPOLITANA;366980;2;1;0;0;0;2;1;366980;Cocina F 5500 T 5P Reflex Silver;LINEA BLANCA
25874796;;M;32;HAITIANO;;Extranjero;QUILICURA                     ;METROPOLITANA;356930;4;2;0;0;0;4;2;356930;COCINA CH-6700IN 4P;LINEA BLANCA
6624552;;F;64;CHILENO;;Boomers;CHIMBARONGO                   ;L.G.B.OÂ´HIGGINS;276860;4;3;0;0;0;4;3;276860;Secadora 9 Kg 9D BZG Ventilacion Blanca;LINEA BLANCA
16891220;Soltero;M;27;CHILENO;KINESIOLOGO;Z;PROVIDENCIA                   ;METROPOLITANA;216980;2;1;2;1;216980;0;0;0;Secadora Electrica SEM101BDBY Blanca 10 KG;LINEA BLANCA
18501233;;M;28;CHILENO;;Millenial;N/D;N/D;499860;3;1;0;0;0;3;1;499860;Refrigerador 260Lts BF Frio Direc MRFI2660SR346W;LINEA BLANCA
15147374;;M;37;CHILENO;;Millenial;MAULE                         ;MAULE;797200;7;4;0;0;0;7;4;797200;Secadora Ropa MD100A90/W 9Kg Ventilacion Blanca;LINEA BLANCA
6690599;;M;69;CHILENO;;Extranjero;PROVIDENCIA                   ;METROPOLITANA;169980;2;1;2;1;169980;0;0;0;Lavadora 9,5Kg BZG Blanca;LINEA BLANCA
9660236;;F;59;CHILENO;;Boomers;PROVIDENCIA                   ;METROPOLITANA;172980;2;1;0;0;0;2;1;172980;CENTRIFUGA C-752;LINEA BLANCA
6758653;Casado;M;71;CHILENO;;Silencioso;SANTA CRUZ                    ;L.G.B.OÂ´HIGGINS;233810;3;1;0;0;0;3;1;233810;Lavadora WA90H4400SW1ZS 9Kg Blanca;LINEA BLANCA
14564935;;F;52;BOLIVIANO;;Extranjero;IQUIQUE                       ;TARAPACA;604830;6;3;0;0;0;6;3;604830;Lavadora Efficace SZG 15,5Kg Silver;LINEA BLANCA
8866060;Divorciado;M;54;CHILENO;LICENCIADO EN CIENCIAS CON MENCION EN BIOLOGIA;Boomers;RENCA                         ;METROPOLITANA;226980;2;1;2;1;226980;0;0;0;Refrigerador 241Lts BF Frio Directo Nordik 415;LINEA BLANCA
13100309;Casado;F;45;CHILENO;PROFESOR;X;RANCAGUA                      ;L.G.B.OÂ´HIGGINS;673960;4;2;2;1;393980;2;1;279980;KIT - TRIO HE KURZ-BREIT4P-REIN60;LINEA BLANCA
25353948;;F;42;VENEZOLANO;;Extranjero;"";"";299980;2;1;2;1;299980;0;0;0;Lavadora WT17WSBP 17Kg Blanca;LINEA BLANCA
17814497;;F;31;CHILENO;;Millenial;ARICA;TARAPACA;356970;3;2;0;0;0;3;2;356970;Lavadora Efficace SZG 15,5Kg Silver;LINEA BLANCA
18899744;;M;27;CHILENO;;Z;POZO ALMONTE;TARAPACA;339980;2;2;2;2;339980;0;0;0;Lavadora WA90H4400SW1ZS 9Kg Blanca;LINEA BLANCA
19550624;;F;25;CHILENO;;Z;PROVIDENCIA                   ;METROPOLITANA;159990;1;1;0;0;0;1;1;159990;Freezer 99Lts MFH-1000B131CN Horizontal;LINEA BLANCA
13690224;;M;49;CHILENO;;X;PROVIDENCIA                   ;METROPOLITANA;139990;1;1;0;0;0;1;1;139990;Calefont 10Lts GL Essenetial ECO;LINEA BLANCA
17951890;;M;31;CHILENO;;Millenial;N/D;N/D;469960;4;2;4;2;469960;0;0;0;Secadora Ropa MD100A90/T 9Kg Ventilacion Gris;LINEA BLANCA
15164889;;M;39;CHILENO;;X;SAN BERNARDO                  ;METROPOLITANA;960740;9;7;0;0;0;9;7;960740;Secadora Ropa MD100A90/W 9Kg Ventilacion Blanca;LINEA BLANCA
5746236;Soltero;F;72;CHILENO;;Silencioso;ESTACION CENTRAL              ;METROPOLITANA;179980;2;1;0;0;0;2;1;179980;Lavadora Semiautomatica Twister 5300 4Kg;LINEA BLANCA
9472941;;M;59;CHILENO;;Boomers;RENCA                         ;METROPOLITANA;399980;2;1;0;0;0;2;1;399980;Lavadora WT19DSBP 19Kg Silver;LINEA BLANCA
14347744;;M;43;CHILENO;;X;ILLAPEL                       ;COQUIMBO;558960;3;2;0;0;0;3;2;558960;Lavadora MLS-090GE04N 9Kg Gris;LINEA BLANCA
18342923;Casado;F;30;CHILENO;;Millenial;"";"";386970;3;2;2;1;276980;1;1;109990;Refrigerador MDRB424FGE46 302 Lts No Frost;LINEA BLANCA
12635032;;F;47;CHILENO;;X;RENCA                         ;METROPOLITANA;179980;2;1;2;1;179980;0;0;0;Refrigerador 180Lts BF Frio Directo MDRB275FGF42;LINEA BLANCA
8131328;;F;67;CHILENO;;Boomers;PENAFLOR                      ;METROPOLITANA;299990;1;1;0;0;0;1;1;299990;Lavadora Superior WA13T5260BY/ZS 13Kg;LINEA BLANCA
18111266;;F;29;CHILENO;;Millenial;QUINTA NORMAL;METROPOLITANA;159980;2;1;2;1;159980;0;0;0;Secadora Ropa MD100A90/W 9Kg Ventilacion Blanca;LINEA BLANCA
9326519;;F;61;CHILENO;;Boomers;PETORCA                       ;VALPARAISO;364370;4;2;0;0;0;4;2;364370;Calefont 8Lts GL Essenetial ECO;LINEA BLANCA
7827266;Soltero;M;68;CHILENO;;Boomers;PROVIDENCIA                   ;METROPOLITANA;309980;2;1;0;0;0;2;1;309980;Lavadora Efficace SZG 19,5Kg Silver;LINEA BLANCA
12530536;;F;51;CHILENO;;X;RENCA                         ;METROPOLITANA;129990;1;1;0;0;0;1;1;129990;Centrifuga Primma 5B 5,5Kilos;LINEA BLANCA
18245893;;F;29;CHILENO;;Millenial;PUENTE ALTO                   ;METROPOLITANA;69980;2;1;2;1;69980;0;0;0;SECADORA SR-10 8KG GRIS SINDELEN;LINEA BLANCA
7689082;;F;66;CHILENO;;Boomers;PROVIDENCIA                   ;METROPOLITANA;755350;5;3;2;1;278980;3;2;476370;Lavadora WT19DSBP 19Kg Silver;LINEA BLANCA
5495048;;F;78;CHILENO;;Silencioso;NANCAGUA                      ;L.G.B.OÂ´HIGGINS;179990;1;1;0;0;0;1;1;179990;Secadora Ropa MD100A90/W 9Kg Ventilacion Blanca;LINEA BLANCA
11760157;;F;51;CHILENO;;X;SANTA CRUZ                    ;L.G.B.OÂ´HIGGINS;179990;1;1;0;0;0;1;1;179990;Cocina CH-7400 4P;LINEA BLANCA
13355047;;F;44;CHILENO;;X;MAULE                         ;MAULE;176980;2;1;2;1;176980;0;0;0;Refrigerador 180Lts BF Frio Directo MDRB275FGF42;LINEA BLANCA
9793927;;M;57;CHILENO;;Boomers;NUNOA                         ;METROPOLITANA;429970;3;2;2;1;399980;1;1;29990;Lavadora WT19DSBP 19Kg Silver;LINEA BLANCA
11511115;;M;51;CHILENO;;X;COQUIMBO                      ;COQUIMBO;837950;5;5;6;3;805500;-1;2;32450;Cocina MCG-5QI30NS 5P;LINEA BLANCA
12326770;;F;49;CHILENO;;X;LOS ANGELES                   ;BIO BIO;262870;3;2;0;0;0;3;2;262870;Refrigerador 166 Lts Frio Directo BF MED165;LINEA BLANCA
20157140;;F;23;CHILENO;;Silencioso;MELIPEUCO                     ;ARAUCANIA;216980;2;3;2;1;188980;0;2;28000;Refrigerador 167Lts Frio Directo 1700-S;LINEA BLANCA
15452682;;M;40;CHILENO;;X;"";"";617840;5;3;4;2;569960;1;1;47880;CALEFON ATMD TIRO NATURAL 10 LT GN ALBIN TROTTER;LINEA BLANCA
5933689;;F;77;CHILENO;;Silencioso;VICTORIA                      ;ARAUCANIA;313530;3;1;0;0;0;3;1;313530;Lavadora Efficace SZG 15,5Kg Silver;LINEA BLANCA
16776040;;F;34;CHILENO;;Millenial;PROVIDENCIA                   ;METROPOLITANA;232950;4;1;4;1;232950;0;0;0;Secadora Ropa MSV-90 9K Blanca Ventilacion;LINEA BLANCA
12587743;;M;48;CHILENO;;X;RENCA                         ;METROPOLITANA;196980;2;1;2;1;196980;0;0;0;Lavadora Efficace BZG 11,5Kg Blanca;LINEA BLANCA
17829040;Soltero;F;31;CHILENO;;Millenial;PROVIDENCIA                   ;METROPOLITANA;308980;2;1;2;1;308980;0;0;0;Lavadora WA13T5260BW/ZS 13Kg Blanca;LINEA BLANCA
11254067;;F;54;CHILENO;;X;SAN ESTEBAN                   ;VALPARAISO;599730;3;2;0;0;0;3;2;599730;REFRIGERADOR TOP MOUNT GT29BPPK NO FROST 254 Lt;LINEA BLANCA
6774801;;F;72;CHILENO;;Silencioso;RENCA                         ;METROPOLITANA;169990;1;1;0;0;0;1;1;169990;Lavadora Semiautomatica Twister 5300 4Kg;LINEA BLANCA
9335787;;M;57;CHILENO;;Boomers;CONCEPCION                    ;BIO BIO;501740;5;1;0;0;0;5;1;501740;Lavadora Efficace SZG 17,5Kg Silver;LINEA BLANCA
13407697;;F;44;CHILENO;;X;ANCUD                         ;LOS LAGOS;2395070;21;10;0;0;0;21;10;2395070;Lavadora WA90H4400SW1ZS 9Kg Blanca;LINEA BLANCA
7465604;;F;64;CHILENO;;Boomers;VILLA ALEMANA                 ;VALPARAISO;609340;6;2;0;0;0;6;2;609340;LAVAVAJILLA B MLV-12SB5203;LINEA BLANCA
9066762;;M;61;CHILENO;;Boomers;VILLARICA                     ;ARAUCANIA;476400;5;3;0;0;0;5;3;476400;Lavadora MLS-090GE04N 9Kg Gris;LINEA BLANCA
13410323;;F;44;CHILENO;;X;COIHAIQUE                     ;AYSEN;1141341;12;6;0;0;0;12;6;1141341;Lavadora MLS-090GE04N 9Kg Gris;LINEA BLANCA
18853229;Soltero;F;27;CHILENO;;Millenial;PROVIDENCIA                   ;METROPOLITANA;403960;4;2;4;2;403960;0;0;0;Refrigerador 167Lts Frio Directo 1700-S;LINEA BLANCA
8347684;;F;60;CHILENO;;Boomers;CARTAGENA                     ;VALPARAISO;231970;4;2;0;0;0;4;2;231970;Lavadora Efficace BZG 11,5Kg Blanca;LINEA BLANCA
16749955;;F;34;CHILENO;;Millenial;PROVIDENCIA                   ;METROPOLITANA;259980;2;1;2;1;259980;0;0;0;Refrigerador 249 Lts No Frost FRT-27DIP C/ Disp;LINEA BLANCA
16530845;;F;35;CHILENO;;Millenial;"";"";1122800;9;5;0;0;0;9;5;1122800;Refrigerador 527Lts Side by Side MRSBS5300G689WE;LINEA BLANCA
17573593;;F;31;CHILENO;;Millenial;SAN PEDRO DE LA PAZ           ;BIO BIO;628970;4;2;0;0;0;4;2;628970;Refrigerador 166 Lts Frio Directo BF MED165;LINEA BLANCA
5338033;;M;75;CHILENO;;Silencioso;RENCA                         ;METROPOLITANA;174090;2;1;0;0;0;2;1;174090;Calefont 10Lts GL Essenetial ECO;LINEA BLANCA
17248877;;F;33;CHILENO;;Millenial;MAIPU                         ;METROPOLITANA;403950;5;2;3;1;313970;2;1;89980;Lavadora Efficace SZG 19,5Kg Silver;LINEA BLANCA
5880540;;M;75;CHILENO;;Silencioso;SAN ANTONIO                   ;VALPARAISO;591970;3;2;0;0;0;3;2;591970;Cocina F 2608 T 4P Reflex Silver;LINEA BLANCA
14412240;;F;42;CHILENO;;Millenial;"";"";269990;1;1;0;0;0;1;1;269990;Lavadora Secadora MLSF-1108BN05N 11Kg/8Kg Blanca;LINEA BLANCA
14510458;;F;48;CHILENO;;X;N/D;N/D;119990;1;1;0;0;0;1;1;119990;Calefont 5Lts GL Essenetial ECO;LINEA BLANCA
13055179;;F;46;CHILENO;;X;PROVIDENCIA                   ;METROPOLITANA;180980;2;1;2;1;180980;0;0;0;Secadora 7Kg 7D BZG Ventilacion Blanca;LINEA BLANCA
7261503;;F;68;CHILENO;;Boomers;SAN JOSE DE MAIPO             ;METROPOLITANA;287970;3;2;0;0;0;3;2;287970;Refrigerador MDRB424FGE46 302 Lts No Frost;LINEA BLANCA
10803932;;M;56;CHILENO;;Boomers;HUECHURABA                    ;METROPOLITANA;672930;8;3;8;3;672930;0;0;0;Secadora Ropa MD100A90/W 9Kg Ventilacion Blanca;LINEA BLANCA
10523477;;F;53;CHILENO;;X;N/D;N/D;720970;3;2;0;0;0;3;2;720970;Lavadora MLS-160BSC03T 16Kg Blanca;LINEA BLANCA
18616242;;M;30;CHILENO;;Millenial;CISNES                        ;AYSEN;607950;5;5;2;2;509980;3;3;97970;Lavadora MLS-160BSC03T 16Kg Blanca;LINEA BLANCA
13022826;;M;46;CHILENO;;X;VALPARAISO                    ;VALPARAISO;279470;3;1;0;0;0;3;1;279470;Refrigerador 260Lts BF Frio Direc MRFI2660SR346W;LINEA BLANCA
17044378;;F;33;CHILENO;;Millenial;TALCAHUANO                    ;BIO BIO;579990;1;1;1;1;579990;0;0;0;COCINA LENA ENLOZADA 72x56;LINEA BLANCA
7821687;;M;64;CHILENO;;Boomers;MELIPILLA                     ;METROPOLITANA;732950;7;4;0;0;0;7;4;732950;Lavadora WT19DSBP 19Kg Silver;LINEA BLANCA
9969840;;M;58;CHILENO;;Boomers;PROVIDENCIA                   ;METROPOLITANA;169980;2;1;2;1;169980;0;0;0;Lavadora WA80H4200SW1ZS 8Kg Blanca;LINEA BLANCA
6767378;;M;71;CHILENO;;Silencioso;N/D;N/D;419980;2;2;0;0;0;2;2;419980;Freezer Horizontal M100 99Lts;LINEA BLANCA
12137595;;F;50;CHILENO;;X;MAIPU                         ;METROPOLITANA;664180;9;3;0;0;0;9;3;664180;Refrigerador 255Lts No Frost RT25FARADS8/ZS;LINEA BLANCA
6854910;;M;71;CHILENO;;Silencioso;CASTRO                        ;LOS LAGOS;526840;5;2;0;0;0;5;2;526840;Refrigerador 300Lts No Frost RT29K500JS8/ZS;LINEA BLANCA
15167354;;M;39;CHILENO;;X;CONSTITUCION                  ;MAULE;875210;8;4;0;0;0;8;4;875210;Secadora 9 Kg Premium Care Pro 9D;LINEA BLANCA
17211717;;F;33;CHILENO;;Millenial;CONSTITUCION                  ;MAULE;201430;2;1;0;0;0;2;1;201430;Secadora Ropa MSV-90 9K Blanca Ventilacion;LINEA BLANCA
26660086;;M;37;CHILENO;;Extranjero;PROVIDENCIA                   ;METROPOLITANA;1172040;10;8;0;0;0;10;8;1172040;Cocina CH-7400 4P;LINEA BLANCA
8948311;;M;62;CHILENO;;Boomers;N/D;N/D;930850;14;6;14;6;930850;0;0;0;Secadora Ropa MSV-90 9K Blanca Ventilacion;LINEA BLANCA
9924727;;F;58;CHILENO;;Boomers;PEUMO                         ;L.G.B.OÂ´HIGGINS;914550;8;2;0;0;0;8;2;914550;Lavadora WT16DSBP 16Kg Silver;LINEA BLANCA
7852579;;M;63;CHILENO;;Boomers;ARICA                         ;TARAPACA;2360200;9;4;0;0;0;9;4;2360200;Refrigerador 626Lt Side by Side GS65MPP1 APZPECL;LINEA BLANCA
7399581;;F;68;CHILENO;;Silencioso;CALAMA                        ;ANTOFAGASTA;269990;1;1;0;0;0;1;1;269990;Cocina M 775 ST 4P Silver;LINEA BLANCA
9300475;;M;61;CHILENO;;Boomers;HIJUELAS                      ;VALPARAISO;174090;2;1;0;0;0;2;1;174090;Calefont 10Lts GL Essenetial ECO;LINEA BLANCA
6210824;;F;73;CHILENO;;Silencioso;MACUL                         ;METROPOLITANA;241420;3;1;0;0;0;3;1;241420;Freezer Horizontal M 150 142Lts;LINEA BLANCA
6610870;;M;67;CHILENO;;Boomers;EL BOSQUE                     ;METROPOLITANA;891720;7;2;0;0;0;7;2;891720;Refrigerador 341Lts BF No Frost GB37MPD;LINEA BLANCA
10853538;;M;52;CHILENO;;X;NATALES                       ;MAGALLANES;957700;6;5;0;0;0;6;5;957700;Refrigerador 303Lts BF Frio Directo Nordik 480;LINEA BLANCA
11086924;;F;56;CHILENO;;Boomers;CHONCHI                       ;LOS LAGOS;197730;4;2;0;0;0;4;2;197730;Centrifuga Primma 5B 5,5Kilos;LINEA BLANCA
8454997;;M;57;CHILENO;;Boomers;PROVIDENCIA                   ;METROPOLITANA;239980;2;1;2;1;239980;0;0;0;Refrigerador 241Lts BF Frio Directo Nordik 415;LINEA BLANCA
15057026;;M;39;CHILENO;;X;N/D;N/D;333180;2;1;0;0;0;2;1;333180;Lavadora MLS-160BSC03T 16Kg Blanca;LINEA BLANCA
9847220;;M;59;CHILENO;;Boomers;ANCUD                         ;LOS LAGOS;447920;8;8;0;0;0;8;8;447920;Refrigerador 167Lts Frio Directo 1700-S;LINEA BLANCA
14220149;;F;41;CHILENO;;X;SAN VICENTE                   ;L.G.B.OÂ´HIGGINS;1244580;8;2;0;0;0;8;2;1244580;Lavadora Efficace SZG 19,5Kg Silver;LINEA BLANCA
13769079;;M;41;CHILENO;;X;SAN ANTONIO                   ;VALPARAISO;741150;6;3;0;0;0;6;3;741150;Refrigerador 322Lts No Frost BF DB60S;LINEA BLANCA
18969994;;F;26;CHILENO;;Millenial;"";"";111980;2;1;2;1;111980;0;0;0;CENTRIFUGA C-752;LINEA BLANCA
5913519;;F;74;CHILENO;;Silencioso;LO PRADO                      ;METROPOLITANA;406500;3;1;0;0;0;3;1;406500;Cocina F 2608 T 4P Reflex Silver;LINEA BLANCA
16904508;;F;34;CHILENO;;Millenial;N/D;N/D;159980;2;1;2;1;159980;0;0;0;Lavadora MLS-090GE04N 9Kg Gris;LINEA BLANCA
10294247;;M;57;CHILENO;;Boomers;CORONEL                       ;BIO BIO;214990;2;2;0;0;0;2;2;214990;Producto Segunda Seleccion Banda 5;LINEA BLANCA
15408542;;M;39;CHILENO;;X;PROVIDENCIA                   ;METROPOLITANA;219980;2;1;2;1;219980;0;0;0;Lavadora 9 Kg Carga Superior Blanca;LINEA BLANCA
16862680;;M;34;CHILENO;;Millenial;LA PINTANA;METROPOLITANA;233980;2;1;2;1;233980;0;0;0;Secadora 9 Kg Premium Care Pro 9D;LINEA BLANCA
25612731;;M;26;PERUANO;;Extranjero;N/D;N/D;292970;2;1;0;0;0;2;1;292970;Lavadora MLS-160BSC03T 16Kg Blanca;LINEA BLANCA
16230094;;F;36;CHILENO;;Millenial;PROVIDENCIA                   ;METROPOLITANA;342980;2;1;0;0;0;2;1;342980;Refrigerador 244Lts Frio Directo Progress 3100;LINEA BLANCA
20030127;;F;23;CHILENO;;Z;PROVIDENCIA                   ;METROPOLITANA;302980;2;1;2;1;302980;0;0;0;Lavadora Premium Care 20SZ 20Kg Silver;LINEA BLANCA
13806202;;F;44;CHILENO;;X;CANETE                        ;BIO BIO;600340;8;5;0;0;0;8;5;600340;Refrigerador RB27N4020S8/ZS BF 257Lts;LINEA BLANCA
11517000;;M;51;CHILENO;;X;PANQUEHUE                     ;VALPARAISO;511960;5;3;0;0;0;5;3;511960;Secadora 7Kg 7D BZG Ventilacion Blanca;LINEA BLANCA
19838143;;F;24;CHILENO;;Z;PUENTE ALTO                   ;METROPOLITANA;369960;4;2;0;0;0;4;2;369960;Refrigerador 167Lts MRFI-1700R234RN F.Direc Rojo;LINEA BLANCA
20094948;;M;22;CHILENO;;Z;LAUTARO                       ;ARAUCANIA;389980;2;1;2;1;389980;0;0;0;Lavadora Secadora 11/8Kg MF100D110B/W Blanca;LINEA BLANCA
8373576;;F;66;CHILENO;;Boomers;CAUQUENES                     ;MAULE;440200;3;1;0;0;0;3;1;440200;Lavadora WT19DSBP 19Kg Silver;LINEA BLANCA
13062800;Casado;M;45;CHILENO;;X;N/D;N/D;143980;2;1;2;1;143980;0;0;0;CAMPANA AT-MD BOGEN N19 60;LINEA BLANCA
18500791;;M;28;CHILENO;;Millenial;CORONEL                       ;BIO BIO;336960;3;2;0;0;0;3;2;336960;Lavadora MLS-160BSC03T 16Kg Blanca;LINEA BLANCA
9117500;;F;63;CHILENO;;Boomers;TEMUCO                        ;ARAUCANIA;511660;6;2;0;0;0;6;2;511660;Cocina CMC20AXX 4P Inox;LINEA BLANCA
11813816;Casado;M;53;CHILENO;;Boomers;ARICA                         ;ARICA Y PARINACOTA;489980;2;2;0;0;0;2;2;489980;Calefont 8Lts GL Essenetial ECO;LINEA BLANCA
11280703;;M;54;CHILENO;;Boomers;LOLOL                         ;L.G.B.OÂ´HIGGINS;665980;2;1;0;0;0;2;1;665980;Refrigerador 535Lts Side by Side RS54N3003SL/ZS;LINEA BLANCA
15044039;;M;40;CHILENO;;X;N/D;N/D;414980;2;2;0;0;0;2;2;414980;Secadora Ropa MD100A90/W 9Kg Ventilacion Blanca;LINEA BLANCA
15842314;;F;37;CHILENO;;Millenial;PROVIDENCIA                   ;METROPOLITANA;269980;2;1;2;1;269980;0;0;0;Cocina CH-9855NG 5P;LINEA BLANCA
14000358;;M;40;CHILENO;;X;CASABLANCA                    ;VALPARAISO;220910;2;1;0;0;0;2;1;220910;Lavadora MLS-090GE04N 9Kg Gris;LINEA BLANCA
17720057;;F;28;CHILENO;;Millenial;QUEILEN                       ;LOS LAGOS;484490;4;1;0;0;0;4;1;484490;Freezer 162 Lts SFV-205 SI Vertical;LINEA BLANCA
12043338;;F;51;CHILENO;;X;NATALES                       ;MAGALLANES;613420;4;3;0;0;0;4;3;613420;Refrigerador 260Lts BF Frio Direc MRFI2660SR346W;LINEA BLANCA
8305998;;M;60;CHILENO;;Boomers;CABILDO                       ;VALPARAISO;340960;4;3;0;0;0;4;3;340960;Cocina M 775 ST 4P Silver;LINEA BLANCA
10309248;Casado;F;58;CHILENO;;Boomers;RENCA                         ;METROPOLITANA;229980;2;1;0;0;0;2;1;229980;Freezer 150 Lts SFH-151 BL Horizontal;LINEA BLANCA
16427564;Casado;F;35;CHILENO;PROFESOR;Millenial;PROVIDENCIA                   ;METROPOLITANA;481980;2;1;0;0;0;2;1;481980;Lavadora Secadora WD10WVC4S6 10,5/6Kg Blanca;LINEA BLANCA
11761680;Casado;M;51;CHILENO;;X;RENCA                         ;METROPOLITANA;199980;2;1;2;1;199980;0;0;0;Secadora 9 Kg 9D BZG Ventilacion Blanca;LINEA BLANCA
13677946;;M;43;CHILENO;;X;RENGO                         ;L.G.B.OÂ´HIGGINS;479980;2;1;0;0;0;2;1;479980;Lavadora Secadora MLSF-1108BN05N 11Kg/8Kg Blanca;LINEA BLANCA
15483034;;F;40;CHILENO;;X;LA PINTANA                    ;METROPOLITANA;308980;2;1;2;1;308980;0;0;0;Cocina MCG-5QI30NS 5P;LINEA BLANCA
10287631;;F;53;CHILENO;;X;PROVIDENCIA                   ;METROPOLITANA;303980;2;1;2;1;303980;0;0;0;Cocina F 2808 T 4P Reflex Silver;LINEA BLANCA
15236587;;F;41;CHILENO;;X;LOS SAUCES                    ;ARAUCANIA;509960;4;3;2;1;138980;2;2;370980;Lavadora WA17T6260BW/ZS 17Kg Blanca;LINEA BLANCA
11241299;;F;53;CHILENO;;X;TALCA                         ;MAULE;795940;5;3;0;0;0;5;3;795940;Secadora Ropa MSV-90 9K Blanca Ventilacion;LINEA BLANCA
26413333;;M;30;VENEZOLANO;;Extranjero;"";"";307970;3;2;3;2;307970;0;0;0;Secadora Ropa MSV-90 9K Blanca Ventilacion;LINEA BLANCA
26890588;Soltero;M;29;EXTRANJERO - NO INFORMA NACIONALIDAD;MEDICO CIRUJANO;Extranjero;PROVIDENCIA                   ;METROPOLITANA;387960;3;1;3;1;387960;0;0;0;Refrigerador RB27N4020S8/ZS BF 257Lts;LINEA BLANCA
8926093;Divorciado;F;60;CHILENO;;Boomers;RENCA                         ;METROPOLITANA;279990;1;1;1;1;279990;0;0;0;Lavadora WT16DSBP 16Kg Silver;LINEA BLANCA
17009619;;M;33;CHILENO;;Millenial;SAN RAMON;METROPOLITANA;369980;2;1;0;0;0;2;1;369980;Refrigerador 290LTS No Frost RMB302PXLRS0;LINEA BLANCA
14062189;;M;41;CHILENO;;X;HUALPEN;BIO-BIO;219970;3;2;2;1;207980;1;1;11990;Cocina CH-9050SI 4P;LINEA BLANCA
8477115;;M;65;CHILENO;;Boomers;PROVIDENCIA                   ;METROPOLITANA;157980;2;1;0;0;0;2;1;157980;Lavadora Semiautomatica Twister 5100 4Kg;LINEA BLANCA
8493449;;M;65;CHILENO;;Silencioso;VALLENAR;ATACAMA;383660;5;4;0;0;0;5;4;383660;Calefont 5Lts GL Essenetial ECO;LINEA BLANCA
26233711;;M;33;HAITIANO;;Extranjero;LOS ANGELES                   ;BIO BIO;311930;3;2;0;0;0;3;2;311930;Cocina CH-7400 4P;LINEA BLANCA
12393787;;M;48;CHILENO;;X;N/D;N/D;1531910;19;8;0;0;0;19;8;1531910;Cocina F 5500 T 5P Reflex Silver;LINEA BLANCA
9932799;Casado;F;59;CHILENO;AUXILIAR DE ENFERMERIA;Boomers;RENCA                         ;METROPOLITANA;137980;2;1;0;0;0;2;1;137980;Centrifuga Primma 5B 5,5Kilos;LINEA BLANCA
14329995;Casado;M;45;CHILENO;;X;RENCA                         ;METROPOLITANA;363380;4;2;0;0;0;4;2;363380;Lavadora Semiautomatica Twister 5300 4Kg;LINEA BLANCA
15712246;;M;44;CHILENO;;X;PUERTO MONTT                  ;LOS LAGOS;354950;4;2;0;0;0;4;2;354950;Refrigerador 260Lts BF Frio Direc MRFI2660SR346W;LINEA BLANCA
17281572;;F;32;CHILENO;;Millenial;CHIMBARONGO;O HIGGINS;244980;2;1;2;1;244980;0;0;0;Refrigerador 166 Lts Frio Directo BF MED165;LINEA BLANCA
8970337;Casado;F;61;CHILENO;;Boomers;RENCA                         ;METROPOLITANA;153980;2;1;0;0;0;2;1;153980;Lavadora Semiautomatica Twister 5100 4Kg;LINEA BLANCA
9756047;Casado;F;58;CHILENO;;Boomers;PROVIDENCIA                   ;METROPOLITANA;251980;2;1;2;1;251980;0;0;0;Lavadora Efficace SZG 17,5Kg Silver;LINEA BLANCA
9439316;Casado;M;59;CHILENO;;Boomers;PROVIDENCIA                   ;METROPOLITANA;149990;1;1;0;0;0;1;1;149990;Lavadora Semiautomatica Twister 5100 4Kg;LINEA BLANCA
11301963;;F;54;CHILENO;;X;N/D;N/D;332970;2;1;0;0;0;2;1;332970;Lavadora Premium Care 20SZ 20Kg Silver;LINEA BLANCA
7177984;;F;70;CHILENO;;Silencioso;NATALES                       ;MAGALLANES;368750;2;1;0;0;0;2;1;368750;Refrigerador 300Lts No Frost RT29K500JS8/ZS;LINEA BLANCA
9701341;;F;57;CHILENO;;Boomers;CAUQUENES;MAULE;900950;5;2;2;1;303980;3;1;596970;Cocina F 2608 T 4P Reflex Silver;LINEA BLANCA
3882042;;M;75;CHILENO;;Silencioso;CHILLAN                       ;BIO BIO;249990;1;1;0;0;0;1;1;249990;Freezer 196Lts M200 Horizontal;LINEA BLANCA
17646959;;M;31;CHILENO;;Millenial;N/D;N/D;139990;1;1;0;0;0;1;1;139990;Calefont 8Lts GL Essenetial ECO;LINEA BLANCA
9203164;;F;63;CHILENO;;Boomers;COQUIMBO                      ;COQUIMBO;386670;3;1;0;0;0;3;1;386670;Refrigerador 303Lts BF Frio Directo Nordik 480;LINEA BLANCA
18057374;;F;30;CHILENO;;Millenial;PADRE HURTADO;METROPOLITANA;169980;2;1;2;1;169980;0;0;0;Secadora Ropa MD100A90/W 9Kg Ventilacion Blanca;LINEA BLANCA
14221400;Casado;F;41;CHILENO;;X;PROVIDENCIA                   ;METROPOLITANA;129990;1;1;0;0;0;1;1;129990;Centrifuga Primma 5B 5,5Kilos;LINEA BLANCA
5853021;;M;63;CHILENO;;Boomers;ANGOL                         ;ARAUCANIA;249990;1;1;0;0;0;1;1;249990;Cocina M 775 ST 4P Silver;LINEA BLANCA
14357343;;F;43;CHILENO;;X;N/D;N/D;223980;2;2;0;0;0;2;2;223980;Lavadora WA90H4400SW1ZS 9Kg Blanca;LINEA BLANCA
23706798;;M;56;PERUANO;;Extranjero;ANTOFAGASTA                   ;ANTOFAGASTA;237670;3;1;0;0;0;3;1;237670;Freezer FDHM150BY1 150Lts Horizontal;LINEA BLANCA
5577607;;F;74;CHILENO;;Silencioso;RENCA                         ;METROPOLITANA;281970;3;2;0;0;0;3;2;281970;Secadora Ropa MD100A90/W 9Kg Ventilacion Blanca;LINEA BLANCA
24635647;;M;50;BOLIVIANO;;Extranjero;VINA DEL MAR                  ;VALPARAISO;479980;2;2;0;0;0;2;2;479980;Lavadora WT16DSBP 16Kg Silver;LINEA BLANCA
15634314;;M;38;CHILENO;;X;"";"";527970;3;2;0;0;0;3;2;527970;Lavadora WT16DSBP 16Kg Silver;LINEA BLANCA
7431631;;M;64;CHILENO;;Boomers;QUILPUE                       ;VALPARAISO;1092640;9;4;0;0;0;9;4;1092640;Lavadora MLS-160BSC03T 16Kg Blanca;LINEA BLANCA
13379360;;F;44;CHILENO;;X;CHILLAN                       ;BIO BIO;382500;4;2;0;0;0;4;2;382500;Lavadora Semiautomatica LC-6550 6,5Kg;LINEA BLANCA
10276380;;M;57;CHILENO;;Boomers;VILLARICA                     ;ARAUCANIA;696750;3;1;0;0;0;3;1;696750;Refrigerador 525Lts Side by Side SFX500;LINEA BLANCA
16053854;Soltero;F;36;CHILENO;PROFESOR;Millenial;N/D;N/D;142980;2;1;2;1;142980;0;0;0;Centrifuga Primma 5B 5,5Kilos;LINEA BLANCA
11372682;;M;53;CHILENO;;X;TALCA                         ;MAULE;1305430;3;1;0;0;0;3;1;1305430;COCINA COMBUSTION LENTA S-800 BURDEO 82X56;LINEA BLANCA
7805936;;F;63;CHILENO;;Boomers;ARICA                         ;ARICA Y PARINACOTA;282970;4;2;0;0;0;4;2;282970;Calefon 7Lts GL ATMD;LINEA BLANCA
12410427;;F;48;CHILENO;;X;RECOLETA;METROPOLITANA;342950;5;2;5;2;342950;0;0;0;Cocina M 795 T 4P Silver;LINEA BLANCA
17292454;Soltero;F;32;CHILENO;;Millenial;PROVIDENCIA                   ;METROPOLITANA;259990;1;1;0;0;0;1;1;259990;Lavadora MLS-160BSC03T 16Kg Blanca;LINEA BLANCA
5233049;;F;77;CHILENO;;Silencioso;QUILLOTA                      ;VALPARAISO;219960;4;3;0;0;0;4;3;219960;Calefont 5Lts GL Essenetial ECO;LINEA BLANCA
16230266;;M;36;CHILENO;;Millenial;"";"";371350;4;2;0;0;0;4;2;371350;Secadora Electrica SEM101BDBY Blanca 10 KG;LINEA BLANCA
10791812;;F;54;CHILENO;;Boomers;N/D;N/D;286730;5;3;0;0;0;5;3;286730;Secadora Ropa MD100A90/W 9Kg Ventilacion Blanca;LINEA BLANCA
12583312;;M;47;CHILENO;;X;RENCA                         ;METROPOLITANA;153390;2;1;0;0;0;2;1;153390;Centrifuga Primma 5B 5,5Kilos;LINEA BLANCA
20709919;;M;21;CHILENO;;Z;PROVIDENCIA                   ;METROPOLITANA;177980;2;1;2;1;177980;0;0;0;Lavadora MLS-080BE04N 8Kg Blanca;LINEA BLANCA
16644128;Soltero;F;34;CHILENO;;Millenial;MACUL;METROPOLITANA;249980;2;1;2;1;249980;0;0;0;Freezer MFH-2950B384CN 295 lts blanco;LINEA BLANCA
13505285;;F;44;CHILENO;;X;TALCA                         ;MAULE;1785711;24;8;0;0;0;24;8;1785711;Secadora Ropa MD100A90/W 9Kg Ventilacion Blanca;LINEA BLANCA
15356432;;F;40;CHILENO;;X;PANGUIPULLI                   ;LOS RIOS;339980;3;2;0;0;0;3;2;339980;Lavadora MLS-160BSC03T 16Kg Blanca;LINEA BLANCA
5580803;;F;79;CHILENO;;Silencioso;TALCAHUANO                    ;BIO BIO;275980;2;1;0;0;0;2;1;275980;Cocina M 775 ST 4P Silver;LINEA BLANCA
17547375;;M;30;CHILENO;;Millenial;CASTRO                        ;LOS LAGOS;419980;2;2;0;0;0;2;2;419980;Lavadora WA90H4400SW1ZS 9Kg Blanca;LINEA BLANCA
5973705;Casado;F;74;CHILENO;;Silencioso;SAN ANTONIO                   ;VALPARAISO;370980;2;1;0;0;0;2;1;370980;Lavadora WT13WSBP 13Kg Blanca;LINEA BLANCA
19213167;;F;26;CHILENO;;Z;TALAGANTE;METROPOLITANA;199980;2;1;2;1;199980;0;0;0;Lavadora LMA0920WGCL0 9,5Kg Gris;LINEA BLANCA
9915875;;F;57;CHILENO;;Boomers;SAN JAVIER                    ;MAULE;394980;2;1;0;0;0;2;1;394980;Cocina F 5500 T 5P Reflex Silver;LINEA BLANCA
7801610;;F;64;CHILENO;;Boomers;QUILLOTA                      ;VALPARAISO;692530;5;3;0;0;0;5;3;692530;Lavadora Efficace SZG 15,5Kg Silver;LINEA BLANCA
6978982;;M;70;CHILENO;;Silencioso;LO BARNECHEA                  ;METROPOLITANA;429980;2;1;0;0;0;2;1;429980;Refrigerador 300Lts No Frost RT29K500JS8/ZS;LINEA BLANCA
18675919;;M;28;CHILENO;;Millenial;PROVIDENCIA                   ;METROPOLITANA;310520;4;2;4;2;310520;0;0;0;CAMPANA AT-XN REIN 60 INOX;LINEA BLANCA
16132001;;M;37;CHILENO;;Millenial;N/D;N/D;123980;2;1;2;1;123980;0;0;0;CALEFON VIVACE 7 ECO GL MADEMSA;LINEA BLANCA
11512192;;M;51;CHILENO;;X;SANTIAGO                      ;METROPOLITANA;621880;12;5;0;0;0;12;5;621880;Lavadora MLS-090GE04N 9Kg Gris;LINEA BLANCA
17131165;;M;33;CHILENO;;Millenial;CHILLAN                       ;BIO BIO;356970;3;2;2;1;226980;1;1;129990;Secadora 9 Kg 9D BZG Ventilacion Blanca;LINEA BLANCA
8404801;Soltero;F;57;CHILENO;CONTADOR AUDITOR;Boomers;PROVIDENCIA                   ;METROPOLITANA;157980;2;1;2;1;157980;0;0;0;Lavadora Semiautomatica Twister 5100 4Kg;LINEA BLANCA
7092624;;M;70;CHILENO;;Silencioso;CARTAGENA                     ;VALPARAISO;201970;3;3;0;0;0;3;3;201970;Lavadora Semiautomatica Twister 5300 4Kg;LINEA BLANCA
16679692;;M;34;CHILENO;;Millenial;CONSTITUCION                  ;MAULE;1337920;7;3;0;0;0;7;3;1337920;Refrigerador 626Lt Side by Side GS65MPP1 APZPECL;LINEA BLANCA
16545725;;F;35;CHILENO;;Millenial;N/D;N/D;605830;6;4;0;0;0;6;4;605830;Lavadora Efficace SZG 19,5Kg Silver;LINEA BLANCA
6695970;;M;69;CHILENO;;Silencioso;VICTORIA                      ;ARAUCANIA;444980;4;1;0;0;0;4;1;444980;Lavadora Secadora WD10WVC4S6 10,5/6Kg Blanca;LINEA BLANCA
13201638;;M;44;CHILENO;;X;"";"";230980;2;1;0;0;0;2;1;230980;Lavadora WA90H4400SW1ZS 9Kg Blanca;LINEA BLANCA
16387707;;F;36;CHILENO;;Millenial;ARAUCO                        ;BIO BIO;379980;2;2;0;0;0;2;2;379980;Cocina CMC20AXX 4P Inox;LINEA BLANCA
19784019;;F;24;CHILENO;;Z;"";"";253970;3;1;0;0;0;3;1;253970;Freezer Horizontal MFH-1990B258CN 198Lts;LINEA BLANCA
16338066;;F;36;CHILENO;;Millenial;N/D;N/D;621490;7;3;7;3;621490;0;0;0;REFRIGERADOR TOP MOUNT GT29BPPK NO FROST 254 Lt;LINEA BLANCA
19351212;Soltero;F;26;CHILENO;;Z;N/D;N/D;527951;6;4;2;1;185980;4;3;341971;Refrigerador 167Lts Frio Directo 1700-S;LINEA BLANCA
9727369;;M;58;CHILENO;;Boomers;ANCUD                         ;LOS LAGOS;666720;8;3;0;0;0;8;3;666720;Freezer 99Lts MFH-1000B131CN Horizontal;LINEA BLANCA
16341917;;F;36;CHILENO;;Millenial;RENCA                         ;METROPOLITANA;569960;4;2;0;0;0;4;2;569960;Cocina MCG-5QI30NS 5P;LINEA BLANCA
15420577;;M;40;CHILENO;;X;N/D;N/D;756950;6;4;3;2;316970;3;2;439980;Freezer 200 Lts FDHM200BY0 Horizontal;LINEA BLANCA
5868083;;F;76;CHILENO;;Silencioso;NUEVA IMPERIAL                ;ARAUCANIA;359020;6;2;0;0;0;6;2;359020;Lavadora Semiautomatica LC-6550 6,5Kg;LINEA BLANCA
6952683;;F;68;CHILENO;;Boomers;VINA DEL MAR                  ;VALPARAISO;405733;6;3;0;0;0;6;3;405733;Cocina CH-7400 4P;LINEA BLANCA
7332272;;M;65;CHILENO;;Boomers;TOME                          ;BIO BIO;639320;7;3;0;0;0;7;3;639320;Cocina Andes60TX4 4P Inox;LINEA BLANCA
6534157;;F;72;CHILENO;;Millenial;N/D;N/D;482960;4;2;0;0;0;4;2;482960;Lavadora Efficace SZG 19,5Kg Silver;LINEA BLANCA
12950241;;M;46;CHILENO;;Silencioso;PROVIDENCIA                   ;METROPOLITANA;692560;3;2;0;0;0;3;2;692560;Lavadora Secadora MLSF-1108BN05N 11Kg/8Kg Blanca;LINEA BLANCA
18530822;Soltero;F;28;CHILENO;ANALISTA DE SISTEMAS;Millenial;PROVIDENCIA                   ;METROPOLITANA;93980;2;1;2;1;93980;0;0;0;ENCIMERA CE4-600 INOX 4P SINDELEN;LINEA BLANCA
16985066;;F;33;CHILENO;;Millenial;N/D;N/D;291980;2;1;0;0;0;2;1;291980;Lavadora Efficace SZG 17,5Kg Blanca;LINEA BLANCA
5741217;;F;74;CHILENO;;Silencioso;LA PINTANA                    ;METROPOLITANA;471960;4;2;0;0;0;4;2;471960;Refrigerador 311Lts Frio Direct Nordik Inox 3900;LINEA BLANCA
8150795;;M;66;CHILENO;;Boomers;PADRE HURTADO                 ;METROPOLITANA;395970;3;1;0;0;0;3;1;395970;Refrigerador 254Lts No Frost GT29WPPDC;LINEA BLANCA
20948020;;F;20;CHILENO;;Z;PICHIDEGUA                    ;L.G.B.OÂ´HIGGINS;225983;2;2;0;0;0;2;2;225983;Freezer 150 Lts SFH-151 BL Horizontal;LINEA BLANCA
7670192;Viudo;F;75;CHILENO;;Silencioso;PROVIDENCIA                   ;METROPOLITANA;244970;3;1;0;0;0;3;1;244970;Cocina CH-9400 4P SILVER;LINEA BLANCA
10345016;Casado;M;47;CHILENO;INGENIERO CIVIL INDUSTRIAL;Silencioso;PROVIDENCIA                   ;METROPOLITANA;239980;2;1;2;1;239980;0;0;0;Beer Cooler MBC-960N125SEN 96Lts;LINEA BLANCA
10973733;;M;53;CHILENO;;X;CONCEPCION                    ;BIO BIO;209990;1;1;0;0;0;1;1;209990;Cocina 775X 4P;LINEA BLANCA
15708315;;F;38;CHILENO;;Boomers;VALLENAR;ATACAMA;301980;2;1;0;0;0;2;1;301980;Lavadora Efficace SZG 17,5Kg Blanca;LINEA BLANCA
7372792;;M;66;CHILENO;;Boomers;N/D;N/D;159990;1;1;0;0;0;1;1;159990;Freezer 142Lts MFH-1430B186C Horizontal;LINEA BLANCA
10300124;;F;57;CHILENO;;Boomers;SAN VICENTE                   ;L.G.B.OÂ´HIGGINS;179970;3;2;0;0;0;3;2;179970;Calefont 5Lts GL Essenetial ECO;LINEA BLANCA
10853526;;F;55;CHILENO;;Boomers;LOS ANGELES                   ;BIO BIO;782950;5;2;0;0;0;5;2;782950;Lavadora MLS-160BSC03T 16Kg Blanca;LINEA BLANCA
16537183;Soltero;F;35;CHILENO;INGENIERO EN TELECOMUNICACIONES;Millenial;RENCA                         ;METROPOLITANA;203980;2;1;2;1;203980;0;0;0;Freezer Horizontal M 150 142Lts;LINEA BLANCA
21656311;;M;72;BOLIVIANO;;Extranjero;ANTOFAGASTA                   ;ANTOFAGASTA;1079940;6;3;0;0;0;6;3;1079940;Freezer 142Lts EFC14A5MNW Horizontal;LINEA BLANCA
7276402;Casado;F;68;CHILENO;CONTADOR GENERAL;Boomers;CONCEPCION                    ;BIO BIO;609680;9;2;0;0;0;9;2;609680;Freezer 142Lts EFC14A5MNW Horizontal;LINEA BLANCA
14101202;;M;41;CHILENO;;X;ANGOL                         ;ARAUCANIA;356970;3;1;0;0;0;3;1;356970;Refrigerador 260Lts BF Frio Direc MRFI2660SR346W;LINEA BLANCA
10618204;;M;55;CHILENO;;Boomers;LAMPA                         ;METROPOLITANA;1042940;6;2;0;0;0;6;2;1042940;Refrigerador 535Lts Side by Side RS54N3003SL/ZS;LINEA BLANCA
17687828;;F;31;CHILENO;;Millenial;PROVIDENCIA                   ;METROPOLITANA;872940;6;3;6;3;872940;0;0;0;Refrigerador 244Lts Frio Directo Progress 3100;LINEA BLANCA
8769781;;M;62;CHILENO;;Boomers;TALCA                         ;MAULE;623960;4;1;0;0;0;4;1;623960;Cocina MCG-5QI30NS 5P;LINEA BLANCA
10092108;;M;58;CHILENO;;Boomers;N/D;N/D;1398320;6;2;0;0;0;6;2;1398320;Freezer 145 Lts FDHM150BY0 Horizontal;LINEA BLANCA
15659472;;F;38;PERUANO;;Millenial;CURANILAHUE                   ;BIO BIO;358980;2;2;0;0;0;2;2;358980;Lavadora WA17T6260BW/ZS 17Kg Blanca;LINEA BLANCA
9816712;;F;76;CHILENO;;Silencioso;ARICA                         ;ARICA Y PARINACOTA;687970;3;2;0;0;0;3;2;687970;Cocina Diva 820 6P;LINEA BLANCA
19587906;;F;24;CHILENO;;Z;N/D;N/D;807450;5;2;3;1;495470;2;1;311980;Lavadora Secadora MLSF-1108BN05N 11Kg/8Kg Blanca;LINEA BLANCA
10828820;;F;57;CHILENO;;Boomers;VALDIVIA                      ;LOS RIOS;199990;1;1;0;0;0;1;1;199990;Cocina CH-7400 4P;LINEA BLANCA
7668968;Soltero;F;68;CHILENO;;Silencioso;PROVIDENCIA                   ;METROPOLITANA;315980;2;1;0;0;0;2;1;315980;Lavadora WA13T5260BW/ZS 13Kg Blanca;LINEA BLANCA
5304654;;M;74;CHILENO;;Silencioso;QUILPUE                       ;VALPARAISO;389960;4;3;0;0;0;4;3;389960;Refrigerador RB27N4020S8/ZS BF 257Lts;LINEA BLANCA
24577544;;F;31;COLOMBIANO;;Extranjero;IQUIQUE                       ;TARAPACA;338970;3;1;0;0;0;3;1;338970;Lavadora Efficace SZG 17,5Kg Blanca;LINEA BLANCA
17741348;;F;31;CHILENO;;Millenial;VILLARICA                     ;ARAUCANIA;405980;2;1;0;0;0;2;1;405980;Refrigerador 254Lts No Frost GT29WPPDC;LINEA BLANCA
18099200;Soltero;F;30;CHILENO;PROFESOR;Z;PROVIDENCIA                   ;METROPOLITANA;743960;4;2;0;0;0;4;2;743960;Refrigerador 322Lts No Frost BF DB60S;LINEA BLANCA
9784392;;M;59;CHILENO;;Boomers;PUENTE ALTO                   ;METROPOLITANA;169980;2;1;0;0;0;2;1;169980;Freezer 142Lts MFH-1430B186C Horizontal;LINEA BLANCA
13138836;;F;46;CHILENO;;X;COQUIMBO                      ;COQUIMBO;315980;2;1;0;0;0;2;1;315980;Lavadora MLS-160GC03I 16Kg Gris;LINEA BLANCA
11779913;;M;51;CHILENO;;X;LOS SAUCES                    ;ARAUCANIA;299980;2;2;0;0;0;2;2;299980;Freezer 200 Lts FDHM200BY0 Horizontal;LINEA BLANCA
18989450;Soltero;M;26;CHILENO;;Z;PROVIDENCIA                   ;METROPOLITANA;339980;2;1;2;1;339980;0;0;0;Lavadora Secadora Perfect Care 8Kg/5Kg Blanca;LINEA BLANCA
19083288;;M;26;CHILENO;;Z;"";"";313980;2;1;2;1;313980;0;0;0;Lavadora Efficace SZG 19,5Kg Silver;LINEA BLANCA
11399611;;M;53;CHILENO;;X;VILLA ALEMANA                 ;VALPARAISO;226970;3;2;0;0;0;3;2;226970;Cocina CH-9500 NG 4P;LINEA BLANCA
16950352;;M;33;CHILENO;;Millenial;N/D;N/D;1027450;5;3;2;1;117480;3;2;909970;Frigobar 48 Lts FB-55 BL;LINEA BLANCA
13020526;;M;45;CHILENO;;X;VALPARAISO                    ;VALPARAISO;199990;1;1;0;0;0;1;1;199990;Cocina CH-7400 4P;LINEA BLANCA
12126050;;F;58;CHILENO;;Boomers;PUNITAQUI                     ;COQUIMBO;229970;3;1;0;0;0;3;1;229970;Calefont 8Lts GL Essenetial ECO;LINEA BLANCA
11791885;;F;54;CHILENO;;Boomers;"";"";195970;3;2;2;1;146980;1;1;48990;Freezer 99Lts MFH-1000B131CN Horizontal;LINEA BLANCA
16040729;;F;37;CHILENO;;Millenial;LO BARNECHEA;METROPOLITANA;219980;2;1;0;0;0;2;1;219980;Refrigerador 167Lts MRFI-1700R234RN F.Direc Rojo;LINEA BLANCA
8012553;;M;61;CHILENO;;Boomers;PROVIDENCIA                   ;METROPOLITANA;323980;2;1;2;1;323980;0;0;0;Cocina M 795 T 4P Silver;LINEA BLANCA
10600837;Casado;F;59;CHILENO;;Boomers;LIMACHE                       ;VALPARAISO;189990;3;1;0;0;0;3;1;189990;Cocina CH-9400 4P SILVER;LINEA BLANCA
17767476;;F;31;CHILENO;;Millenial;SAN FERNANDO;O HIGGINS;290980;2;1;2;1;290980;0;0;0;Lavadora Superior WA15T5260BY/ZS 15 Kg;LINEA BLANCA
10552544;;M;57;CHILENO;;Boomers;RIO HURTADO                   ;COQUIMBO;536960;4;2;0;0;0;4;2;536960;Freezer 196Lts M200 Horizontal;LINEA BLANCA
16461470;Casado;F;35;CHILENO;ENFERMERA;Millenial;RENCA                         ;METROPOLITANA;264980;2;1;2;1;264980;0;0;0;Cocina CH-6900IN 4P;LINEA BLANCA
7732020;;M;66;CHILENO;;Boomers;TALCAHUANO                    ;BIO BIO;223970;3;1;0;0;0;3;1;223970;Lavadora MLS-090GE04N 9Kg Gris;LINEA BLANCA
10832800;;F;50;CHILENO;;X;PROVIDENCIA                   ;METROPOLITANA;189980;2;1;2;1;189980;0;0;0;Secadora Ropa MSV-90 9K Blanca Ventilacion;LINEA BLANCA
18466538;Soltero;M;28;CHILENO;;Millenial;PROVIDENCIA                   ;METROPOLITANA;139980;2;1;2;1;139980;0;0;0;Freezer 99Lts MFH-1000B131CN Horizontal;LINEA BLANCA
6826577;;M;70;CHILENO;;Silencioso;ARAUCO                        ;BIO BIO;370980;2;1;0;0;0;2;1;370980;Refrigerador 254Lts No Frost GT29WPPDC;LINEA BLANCA
14245650;;F;48;CHILENO;;X;N/D;N/D;701940;6;2;0;0;0;6;2;701940;Lavadora WT19DSBP 19Kg Silver;LINEA BLANCA
15875165;;M;38;CHILENO;;Millenial;CHILLAN                       ;BIO BIO;358930;7;2;0;0;0;7;2;358930;Secadora Electrica SEM101BDBY Blanca 10 KG;LINEA BLANCA
16008308;;M;37;CHILENO;;Millenial;NATALES                       ;MAGALLANES;249980;2;1;0;0;0;2;1;249980;Refrigerador 252Lts No Frost MRFS-2700G333FW;LINEA BLANCA
12104800;;F;53;CHILENO;;X;CAUQUENES                     ;MAULE;231980;2;1;0;0;0;2;1;231980;COCINA CH-6700IN 4P;LINEA BLANCA
8130532;;M;62;CHILENO;;Boomers;PROVIDENCIA                   ;METROPOLITANA;117480;2;1;2;1;117480;0;0;0;Frigobar 48 Lts FB-55 BL;LINEA BLANCA
11278926;;F;54;CHILENO;;X;SAN FERNANDO                  ;L.G.B.OÂ´HIGGINS;859981;4;2;0;0;0;4;2;859981;Lavadora Secadora WD12T754DBT/ZS 12,5Kg/7Kg Blan;LINEA BLANCA
18391590;;M;29;CHILENO;;Silencioso;PROVIDENCIA                   ;METROPOLITANA;389980;2;1;2;1;389980;0;0;0;Refrigerador 322Lts No Frost BF DB60S;LINEA BLANCA
12863001;;F;46;CHILENO;;X;CERRO NAVIA                   ;METROPOLITANA;409980;2;1;0;0;0;2;1;409980;Lavadora WT19DSBP 19Kg Silver;LINEA BLANCA
19580211;Soltero;F;25;CHILENO;TECNICO DE NIVEL MEDIO EN ATENCION DE ENFERMERIA;Z;PROVIDENCIA                   ;METROPOLITANA;279990;1;1;0;0;0;1;1;279990;Refrigerador 250 Lts No Frost RMA250PHUG1;LINEA BLANCA
12600815;;F;48;CHILENO;;X;LOS ANDES                     ;VALPARAISO;150970;3;2;0;0;0;3;2;150970;Freezer 99Lts MFH-1000B131CN Horizontal;LINEA BLANCA
20048588;;F;23;CHILENO;;Z;PROVIDENCIA                   ;METROPOLITANA;189980;2;1;2;1;189980;0;0;0;Cocina CH-7400 4P;LINEA BLANCA
20236761;;F;23;CHILENO;;Z;ANTOFAGASTA                   ;ANTOFAGASTA;608220;8;4;7;3;596230;1;1;11990;Lavadora Efficace BZG 9,5Kg Blanca;LINEA BLANCA
12195334;;M;49;CHILENO;;X;TEMUCO                        ;ARAUCANIA;244980;4;1;0;0;0;4;1;244980;Freezer Horizontal MFH-1990B258CN 198Lts;LINEA BLANCA
17926568;Soltero;F;30;CHILENO;PSICOLOGA;Millenial;PROVIDENCIA                   ;METROPOLITANA;89980;2;1;2;1;89980;0;0;0;ENCIMERA CE4-600 INOX 4P SINDELEN;LINEA BLANCA
13480675;;F;43;CHILENO;;X;PROVIDENCIA                   ;METROPOLITANA;244980;2;1;2;1;244980;0;0;0;Cocina F-2525 4P;LINEA BLANCA
13233368;;F;45;CHILENO;;X;RENCA                         ;METROPOLITANA;329980;2;1;2;1;329980;0;0;0;REFRIGERADOR TOP MOUNT GT29BPPK NO FROST 254 Lt;LINEA BLANCA
16247318;;M;36;CHILENO;;Millenial;QUINTERO                      ;VALPARAISO;867290;12;4;0;0;0;12;4;867290;Refrigerador 300Lts No Frost RT29K500JS8/ZS;LINEA BLANCA
6991894;;M;69;CHILENO;;Silencioso;IQUIQUE                       ;TARAPACA;439990;1;2;0;0;0;1;2;439990;Refrigerador 322Lts No Frost BF DB60S;LINEA BLANCA
15561309;Soltero;M;39;CHILENO;INGENIERO INFORMATICO;X;RENCA                         ;METROPOLITANA;274970;3;1;0;0;0;3;1;274970;Lavadora MLS-090GE04N 9Kg Gris;LINEA BLANCA
10266437;;M;56;CHILENO;;Boomers;LAS CONDES                    ;METROPOLITANA;378950;5;3;0;0;0;5;3;378950;Refrigerador 244Lts Frio Directo Progress 3100;LINEA BLANCA
8423364;;M;57;CHILENO;;Boomers;CONCEPCION                    ;BIO BIO;283970;3;2;0;0;0;3;2;283970;FRIGOBAR 93 LTS MFB-930S121LN;LINEA BLANCA
16695501;;F;34;CHILENO;;Millenial;PAINE                         ;METROPOLITANA;409990;3;1;0;0;0;3;1;409990;Lavadora WT19DSBP 19Kg Silver;LINEA BLANCA
10820624;;M;55;CHILENO;;Boomers;CERRO NAVIA                   ;METROPOLITANA;589980;2;1;0;0;0;2;1;589980;Refrigerador 525Lts Side by Side SFX500;LINEA BLANCA
11820219;Casado;M;50;CHILENO;ARQUITECTO;X;RENCA                         ;METROPOLITANA;349980;2;1;2;1;349980;0;0;0;Lavadora Secadora WD95T4046CE/ZS 9,5Kg/6Kg Blanc;LINEA BLANCA
12611105;;F;48;CHILENO;;X;ARICA                         ;ARICA Y PARINACOTA;566960;4;2;0;0;0;4;2;566960;Lavadora Semiautomatica LC-6550 6,5Kg;LINEA BLANCA
10025273;;F;42;CHILENO;;X;N/D;N/D;179990;1;1;0;0;0;1;1;179990;Cocina CH-7400 4P;LINEA BLANCA
19528504;;F;25;CHILENO;;Z;PROVIDENCIA                   ;METROPOLITANA;419990;1;1;0;0;0;1;1;419990;Lavadora WT19DSBP 19Kg Silver;LINEA BLANCA
4774581;;F;81;CHILENO;;Silencioso;CHILLAN VIEJO                 ;BIO BIO;343980;2;1;0;0;0;2;1;343980;Refrigerador 256Lts No Frost Advantage 5200;LINEA BLANCA
19237926;;M;26;CHILENO;;Z;N/D;N/D;169980;2;1;0;0;0;2;1;169980;Freezer 142Lts MFH-1430B186C Horizontal;LINEA BLANCA
10985565;;M;43;CHILENO;;X;LO ESPEJO                     ;METROPOLITANA;259980;2;1;0;0;0;2;1;259980;Refrigerador 260Lts BF Frio Direc MRFI2660SR346W;LINEA BLANCA
5649100;;F;80;CHILENO;;Silencioso;QUILPUE                       ;VALPARAISO;179990;1;1;0;0;0;1;1;179990;Cocina CH-7400 4P;LINEA BLANCA
16003972;;F;36;CHILENO;;Millenial;"";"";424650;4;2;0;0;0;4;2;424650;Cocina F-5500 Premium 5P;LINEA BLANCA
8782103;;F;62;CHILENO;;Silencioso;PROVIDENCIA                   ;METROPOLITANA;199990;1;1;0;0;0;1;1;199990;Cocina CH-7400 4P;LINEA BLANCA
22142290;;M;65;CHILENO;;Extranjero;MELIPILLA                     ;METROPOLITANA;189980;2;1;0;0;0;2;1;189980;Lavadora MLS-090GE04N 9Kg Gris;LINEA BLANCA
13359220;;F;43;CHILENO;;X;OVALLE                        ;COQUIMBO;741330;6;3;0;0;0;6;3;741330;Lavadora WA13T5260BW/ZS 13Kg Blanca;LINEA BLANCA
10215956;;F;63;CHILENO;;Boomers;SAN CARLOS                    ;BIO BIO;333980;2;1;2;1;333980;0;0;0;Refrigerador No Frost con Dispensador 312 Lts GT;LINEA BLANCA
13939298;;F;42;CHILENO;;X;SAN JOAQUIN                   ;METROPOLITANA;556970;3;3;0;0;0;3;3;556970;Cocina CH-6900IN 4P;LINEA BLANCA
13569145;;F;43;CHILENO;;X;LAS CABRAS                    ;L.G.B.OÂ´HIGGINS;299990;1;1;0;0;0;1;1;299990;Cocina F-2808 4P;LINEA BLANCA
7902738;;M;64;CHILENO;;Boomers;NUEVA IMPERIAL                ;ARAUCANIA;285980;2;1;0;0;0;2;1;285980;Freezer 142Lts EFC14A5MNW Horizontal;LINEA BLANCA
13600891;;M;42;CHILENO;;X;YERBAS BUENAS                 ;MAULE;442970;3;1;0;0;0;3;1;442970;Lavadora LMA8120WGCL0 18Kg Gris;LINEA BLANCA
18385568;;F;29;CHILENO;;Millenial;PROVIDENCIA                   ;METROPOLITANA;154540;2;1;2;1;154540;0;0;0;Freezer 142Lts MFH-1430B186C Horizontal;LINEA BLANCA
19382938;;M;26;CHILENO;;Millenial;N/D;N/D;393980;2;1;0;0;0;2;1;393980;Cocina F-5500 Premium 5P;LINEA BLANCA
15705011;;F;38;CHILENO;;X;N/D;N/D;564910;9;3;6;2;342940;3;1;221970;Freezer 142Lts MFH-1430B186C Horizontal;LINEA BLANCA
7179668;Casado;M;67;CHILENO;INGENIERO AGRICOLA;Boomers;BULNES                        ;BIO BIO;326980;2;1;0;0;0;2;1;326980;Refrigerador 249Lts No Frost RMA250PHUG;LINEA BLANCA
13017218;;M;46;CHILENO;;X;N/D;N/D;203980;2;1;0;0;0;2;1;203980;Cocina CH-9050SI 4P;LINEA BLANCA
8927754;;M;61;CHILENO;;Boomers;TALCAHUANO                    ;BIO BIO;316980;2;1;0;0;0;2;1;316980;Lavadora Efficace SZG 17,5Kg Silver;LINEA BLANCA
12372192;;M;48;CHILENO;;X;SAN BERNARDO;METROPOLITANA;133980;2;1;2;1;133980;0;0;0;Freezer 99Lts MFH-1000B131CN Horizontal;LINEA BLANCA
19175478;;F;26;CHILENO;;Z;MARIA PINTO                   ;METROPOLITANA;450980;2;1;0;0;0;2;1;450980;Lavadora Secadora WD95T4046CE/ZS 9,5Kg/6Kg Blanc;LINEA BLANCA
8298510;;F;66;CHILENO;;Boomers;CONTULMO                      ;BIO BIO;547942;6;3;0;0;0;6;3;547942;Lavadora WA13T5260BW/ZS 13Kg Blanca;LINEA BLANCA
10217046;;M;56;CHILENO;;Extranjero;TRAIGUEN                      ;ARAUCANIA;310970;3;1;0;0;0;3;1;310970;Cocina 775X 4P;LINEA BLANCA
9514187;;M;60;CHILENO;;Boomers;PROVIDENCIA                   ;METROPOLITANA;199990;1;1;0;0;0;1;1;199990;Cocina CH-7400 4P;LINEA BLANCA
7543700;Casado;M;66;CHILENO;;Boomers;SANTIAGO                      ;METROPOLITANA;267960;4;2;0;0;0;4;2;267960;Refrigerador 210Lts Rojo Frio Dir MRFS2100R273FN;LINEA BLANCA
25943258;Soltero;M;66;NO INFORMA NACIONALIDAD;;Extranjero;CERRILLOS                     ;METROPOLITANA;269980;2;1;0;0;0;2;1;269980;Lavadora MLS-160BSC03T 16Kg Blanca;LINEA BLANCA
10545071;;M;56;CHILENO;;Boomers;PARRAL                        ;MAULE;833830;6;2;0;0;0;6;2;833830;Cocina CH-7400 4P;LINEA BLANCA
13340897;;M;43;CHILENO;;X;MELIPILLA                     ;METROPOLITANA;800940;7;2;0;0;0;7;2;800940;Refrigerador 527Lts Side by Side MRSBS5300G689WE;LINEA BLANCA
8562254;;F;72;CHILENO;;Silencioso;TALCAHUANO                    ;BIO BIO;149990;1;1;0;0;0;1;1;149990;Calefon 11Lts GL Master;LINEA BLANCA
10121706;Casado;M;58;CHILENO;INGENIERO AGRICOLA;Boomers;PAPUDO                        ;VALPARAISO;331980;2;1;0;0;0;2;1;331980;Lavadora WA15T5260BW/ZS 15Kg Blanca;LINEA BLANCA
16757811;;M;34;CHILENO;;Millenial;LA PINTANA                    ;METROPOLITANA;289960;4;2;4;2;289960;0;0;0;Cocina CH-9600RJ 4P;LINEA BLANCA
19138513;Soltero;M;26;CHILENO;TECNICO MECANICO;Z;PROVIDENCIA                   ;METROPOLITANA;138540;2;1;2;1;138540;0;0;0;Freezer 99Lts MFH-1000B131CN Horizontal;LINEA BLANCA
16809555;;M;34;CHILENO;;Millenial;"";"";196510;5;2;2;1;98540;3;1;97970;FRIGOBAR 45 LTS MDRD86FGF02;LINEA BLANCA
10517950;;F;52;CHILENO;;X;PROVIDENCIA                   ;METROPOLITANA;123980;2;1;2;1;123980;0;0;0;FRIGOBAR 93 LTS MFB-930S121LN;LINEA BLANCA
15049881;;F;31;CHILENO;;Millenial;PUNITAQUI                     ;COQUIMBO;219980;2;1;0;0;0;2;1;219980;Cocina CH-9400 4P SILVER;LINEA BLANCA
18487939;Soltero;M;29;CHILENO;;Millenial;PROVIDENCIA                   ;METROPOLITANA;129990;2;1;2;1;129990;0;0;0;Freezer 99Lts MFH-1000B131CN Horizontal;LINEA BLANCA
16673164;;M;35;CHILENO;;Millenial;GRANEROS                      ;L.G.B.OÂ´HIGGINS;258980;2;1;2;1;258980;0;0;0;Lavadora Efficace SZG 15,5Kg Silver;LINEA BLANCA
16433324;;M;35;CHILENO;;Millenial;SANTA CRUZ                    ;L.G.B.OÂ´HIGGINS;279990;1;1;1;1;279990;0;0;0;Lavadora WA13T5260BW/ZS 13Kg Blanca;LINEA BLANCA
13200674;;M;45;CHILENO;;X;SAN FERNANDO                  ;L.G.B.OÂ´HIGGINS;316980;2;1;0;0;0;2;1;316980;Lavadora WA13T5260BW/ZS 13Kg Blanca;LINEA BLANCA
6837968;;M;63;CHILENO;;Boomers;COIHAIQUE                     ;AYSEN;261980;2;1;0;0;0;2;1;261980;Refrigerador 260Lts BF Frio Direc MRFI2660SR346W;LINEA BLANCA
20325543;;F;22;CHILENO;;Z;PROVIDENCIA                   ;METROPOLITANA;219980;2;1;2;1;219980;0;0;0;Lavadora MLS-140GSC03T 14Kg Gris;LINEA BLANCA
11383530;;F;53;CHILENO;;X;PUNITAQUI                     ;COQUIMBO;209980;2;1;0;0;0;2;1;209980;Lavadora LMA0920WGCL0 9,5Kg Gris;LINEA BLANCA
7021077;;M;63;CHILENO;;Boomers;PROVIDENCIA                   ;METROPOLITANA;260980;2;1;0;0;0;2;1;260980;Refrigerador 260Lts BF Frio Direc MRFI2660SR346W;LINEA BLANCA
16223671;;M;36;CHILENO;;Millenial;N/D;N/D;1391170;12;2;0;0;0;12;2;1391170;Freezer 99Lts MFH-1000B131CN Horizontal;LINEA BLANCA
18973241;Soltero;M;27;CHILENO;TECNICO AGROPECUARIO DE NIVEL MEDIO;Silencioso;PROVIDENCIA                   ;METROPOLITANA;124980;2;1;2;1;124980;0;0;0;FRIGOBAR 93 LTS MFB-930S121LN;LINEA BLANCA
10336134;Casado;F;58;CHILENO;;Boomers;PROVIDENCIA                   ;METROPOLITANA;522960;4;1;0;0;0;4;1;522960;Refrigerador 241Lts BF Frio Directo Nordik 415;LINEA BLANCA
26541685;;M;41;EXTRANJERO - NO INFORMA NACIONALIDAD;;Extranjero;N/D;N/D;163980;2;1;2;1;163980;0;0;0;Freezer horizontal 142Lts lfh-151 blanco;LINEA BLANCA
11141076;;F;55;CHILENO;;Boomers;NATALES                       ;MAGALLANES;331970;3;5;0;0;0;3;5;331970;Freezer 200 Lts FDHM200BY0 Horizontal;LINEA BLANCA
10111519;;F;57;CHILENO;;Boomers;ARAUCO                        ;BIO BIO;149990;1;1;0;0;0;1;1;149990;Freezer 99Lts MFH-1000B131CN Horizontal;LINEA BLANCA
9803969;;F;73;CHILENO;;Silencioso;RANCAGUA                      ;L.G.B.OÂ´HIGGINS;259980;2;1;0;0;0;2;1;259980;Refrigerador 252Lts No Frost MRFS-2700G333FW;LINEA BLANCA
5017460;;M;80;CHILENO;;Silencioso;MELIPILLA                     ;METROPOLITANA;607840;5;2;0;0;0;5;2;607840;Refrigerador 260Lts BF Frio Direc MRFI2660SR346W;LINEA BLANCA
16773894;;F;34;CHILENO;;Millenial;"";"";144980;2;1;2;1;144980;0;0;0;Lavadora/Centrifuga LC4550 4,5Kg Blanca;LINEA BLANCA
8612213;;M;64;CHILENO;;Boomers;OVALLE                        ;COQUIMBO;516070;2;1;0;0;0;2;1;516070;Refrigerador 290LTS No Frost RMB302PXLRS0;LINEA BLANCA
15260661;;M;39;CHILENO;;Millenial;N/D;N/D;409970;3;2;0;0;0;3;2;409970;Lavadora Premium Care 20SZ 20Kg Silver;LINEA BLANCA
13349673;;M;43;CHILENO;;X;N/D;N/D;375970;3;2;0;0;0;3;2;375970;Lavadora Efficace BZG 9,5Kg Blanca;LINEA BLANCA
6627113;;F;68;CHILENO;;Silencioso;NUEVA IMPERIAL                ;ARAUCANIA;592970;3;1;0;0;0;3;1;592970;Refrigerador DW44S 400Lts Dispen No Frost;LINEA BLANCA
8301391;;M;49;CHILENO;;X;ANCUD                         ;LOS LAGOS;372980;2;1;0;0;0;2;1;372980;Refrigerador 254Lts No Frost GT29WPPDC;LINEA BLANCA
12946332;;F;45;CHILENO;;X;COPIAPO                       ;ATACAMA;205980;2;1;0;0;0;2;1;205980;Freezer 145 Lts FDHM150BY0 Horizontal;LINEA BLANCA
8309797;Casado;F;67;CHILENO;;Boomers;RENCA                         ;METROPOLITANA;359980;2;2;0;0;0;2;2;359980;Cocina CH-7400 4P;LINEA BLANCA
14326779;Casado;F;44;CHILENO;;X;RENCA                         ;METROPOLITANA;119990;1;1;0;0;0;1;1;119990;Lavadora MLS-080BE04N 8Kg Blanca;LINEA BLANCA
7175706;;M;68;CHILENO;;Boomers;CALERA                        ;VALPARAISO;169980;2;1;0;0;0;2;1;169980;Lavadora MLS-090GE04N 9Kg Gris;LINEA BLANCA
15482256;;F;40;CHILENO;;X;ANGOL                         ;ARAUCANIA;189980;2;2;0;0;0;2;2;189980;Cocina CMC20AXX 4P Inox;LINEA BLANCA
10026692;;F;55;CHILENO;;Boomers;TEMUCO                        ;ARAUCANIA;159990;1;1;0;0;0;1;1;159990;Lavadora Semiautomatica LC-6550 6,5Kg;LINEA BLANCA
6685121;;F;80;CHILENO;;Silencioso;YUMBEL                        ;BIO BIO;216480;2;1;0;0;0;2;1;216480;Lavadora MLS-140GSC03T 14Kg Gris;LINEA BLANCA
7099281;;F;68;CHILENO;;Silencioso;LINARES                       ;MAULE;548960;4;1;0;0;0;4;1;548960;REFRIGERADOR TOP MOUNT GT29BPPK NO FROST 254 Lt;LINEA BLANCA
19544832;;F;25;CHILENO;;Z;OVALLE                        ;COQUIMBO;141480;2;1;0;0;0;2;1;141480;Centrifuga Primma 5B 5,5Kilos;LINEA BLANCA
8700566;;M;63;CHILENO;;Boomers;RENCA                         ;METROPOLITANA;199990;1;1;0;0;0;1;1;199990;Freezer 145 Lts FDHM150BY0 Horizontal;LINEA BLANCA
5061287;Soltero;M;75;CHILENO;;Silencioso;RENCA                         ;METROPOLITANA;169990;1;1;0;0;0;1;1;169990;Cocina CMC20AXX 4P Inox;LINEA BLANCA
5520326;;M;73;CHILENO;;Silencioso;QUILPUE                       ;VALPARAISO;472770;2;1;0;0;0;2;1;472770;Refrigerador 290LTS No Frost RMB302PXLRS0;LINEA BLANCA
15044511;;M;39;CHILENO;;X;COMBARBALA                    ;COQUIMBO;542970;3;2;0;0;0;3;2;542970;Freezer horizontal 142Lts lfh-151 blanco;LINEA BLANCA
12619758;;M;48;CHILENO;;X;COPIAPO;ATACAMA;413520;4;2;4;2;413520;0;0;0;Lavadora MLS-090GE04N 9Kg Gris;LINEA BLANCA
13467665;;M;44;CHILENO;;Millenial;RENGO                         ;L.G.B.OÂ´HIGGINS;1025220;7;3;0;0;0;7;3;1025220;Lavadora WT16DSBP 16Kg Silver;LINEA BLANCA
13523460;;M;43;CHILENO;;X;OSORNO                        ;LOS LAGOS;368530;3;2;2;1;118540;1;1;249990;Lavadora MLS-160GSC03T 16Kg Gris;LINEA BLANCA
16291893;Soltero;F;36;CHILENO;;Millenial;PROVIDENCIA                   ;METROPOLITANA;209990;1;1;0;0;0;1;1;209990;Lavadora Efficace BZG 9,5Kg Blanca;LINEA BLANCA
27024546;;M;29;VENEZOLANO;;Extranjero;SANTIAGO;METROPOLITANA;419990;1;1;0;0;0;1;1;419990;Refrigerador 290LTS No Frost RMB302PXLRS0;LINEA BLANCA
17284869;;M;32;CHILENO;;Millenial;YERBAS BUENAS                 ;MAULE;320970;3;2;0;0;0;3;2;320970;Cocina CH-9500 NG 4P;LINEA BLANCA
17448670;Soltero;M;32;CHILENO;;Millenial;RENCA                         ;METROPOLITANA;175480;2;1;2;1;175480;0;0;0;Freezer 142Lts MFH-1430B186C Horizontal;LINEA BLANCA
8600556;Casado;M;64;CHILENO;INGENIERO AGRICOLA;Boomers;RENCA                         ;METROPOLITANA;177980;2;1;0;0;0;2;1;177980;Freezer 99Lts MFH-1000B131CN Horizontal;LINEA BLANCA
13513552;;F;43;CHILENO;;X;CORONEL                       ;BIO BIO;184980;2;1;0;0;0;2;1;184980;Cocina CMC20AXX 4P Inox;LINEA BLANCA
5250468;;M;77;CHILENO;;Silencioso;ARICA                         ;ARICA Y PARINACOTA;459760;3;1;0;0;0;3;1;459760;Lavadora Efficace SZG 19,5Kg Silver;LINEA BLANCA
9506984;;M;60;CHILENO;;Boomers;SAN JAVIER                    ;MAULE;538040;5;2;0;0;0;5;2;538040;Lavadora Superior WA19T6260BY/ZS 19Kg;LINEA BLANCA
16732848;;F;34;CHILENO;;Millenial;VALLENAR;ATACAMA;379980;2;2;1;1;229990;1;1;149990;Refrigerador 252Lts No Frost MRFS-2700G333FW;LINEA BLANCA
4970617;;M;84;CHILENO;;Silencioso;PUTAENDO                      ;VALPARAISO;416460;3;1;0;0;0;3;1;416460;Refrigerador 300Lts No Frost RT29K500JS8/ZS;LINEA BLANCA
18581699;;M;28;CHILENO;;Millenial;NUEVA IMPERIAL                ;ARAUCANIA;661050;4;2;2;1;314980;2;1;346070;Refrigerador 252Lts No Frost MRFS-2700G333FW;LINEA BLANCA
8271264;;F;67;CHILENO;;Boomers;COPIAPO                       ;ATACAMA;573000;8;5;0;0;0;8;5;573000;Lavadora Semiautomatica Twister 5300 4Kg;LINEA BLANCA
10927249;;M;53;CHILENO;;X;ANTOFAGASTA                   ;ANTOFAGASTA;442980;2;1;0;0;0;2;1;442980;Lavadora Secadora WD95T4046CE/ZS 9,5Kg/6Kg Blanc;LINEA BLANCA
17496449;;M;32;CHILENO;;Millenial;PROVIDENCIA                   ;METROPOLITANA;199990;1;1;0;0;0;1;1;199990;Lavadora WA90H4400SW/ZS 9Kg Blanca;LINEA BLANCA
19491985;;F;25;CHILENO;;Z;N/D;N/D;1213070;10;1;0;0;0;10;1;1213070;Refrigerador 535Lts Side by Side RS54N3003SL/ZS;LINEA BLANCA
7941290;;F;66;CHILENO;;Boomers;CURACAVI                      ;METROPOLITANA;4990;1;2;0;0;0;1;2;4990;Freezer 142Lts MFH-1430B186C Horizontal;LINEA BLANCA
18134692;Soltero;F;30;CHILENO;;Millenial;PUNITAQUI                     ;COQUIMBO;374470;3;1;0;0;0;3;1;374470;Lavadora Premium Care 20SZ 20Kg Silver;LINEA BLANCA
8213498;;F;62;CHILENO;;Boomers;NUEVA IMPERIAL                ;ARAUCANIA;386060;3;1;0;0;0;3;1;386060;Lavadora WT13WSBP 13Kg Blanca;LINEA BLANCA
10467980;;F;57;CHILENO;;Boomers;CHILLAN                       ;BIO BIO;336480;2;1;0;0;0;2;1;336480;Refrigerador 251Lts No Frost Altus 1250;LINEA BLANCA
12108106;;M;44;CHILENO;;X;CURICO                        ;MAULE;396760;3;1;0;0;0;3;1;396760;Lavadora WT16DSBP 16Kg Silver;LINEA BLANCA
13591896;;F;43;CHILENO;;X;SAN PABLO                     ;LOS LAGOS;289370;2;1;0;0;0;2;1;289370;Refrigerador 252Lts No Frost MRFS-2700G333FW;LINEA BLANCA
4921539;;M;78;CHILENO;;Silencioso;RENCA                         ;METROPOLITANA;495450;4;2;0;0;0;4;2;495450;Refrigerador 249Lts No Frost RMA250PHUG;LINEA BLANCA
19614882;;F;23;CHILENO;;Z;VINA DEL MAR                  ;VALPARAISO;554960;5;2;2;1;354980;3;1;199980;Lavadora Efficace SZG 19,5Kg Silver;LINEA BLANCA
16237505;;F;36;CHILENO;;Millenial;PUERTO MONTT                  ;LOS LAGOS;178540;2;1;2;1;178540;0;0;0;Refrigerador 167Lts Frio Directo 1700-S;LINEA BLANCA
18190904;;F;29;CHILENO;;Millenial;N/D;N/D;179980;2;1;0;0;0;2;1;179980;Freezer 145 Lts FDHM150BY0 Horizontal;LINEA BLANCA
10415083;;M;55;CHILENO;;Boomers;N/D;N/D;300560;3;1;0;0;0;3;1;300560;Cocina CH-7400 4P;LINEA BLANCA
8613744;;M;63;CHILENO;;Boomers;SAN BERNARDO                  ;METROPOLITANA;293570;2;1;0;0;0;2;1;293570;Lavadora MLS-160BSC03T 16Kg Blanca;LINEA BLANCA
17134348;;M;33;CHILENO;;Millenial;PROVIDENCIA                   ;METROPOLITANA;438980;2;1;2;1;438980;0;0;0;Refrigerador Side by side Multidoor DM64S;LINEA BLANCA
12732918;;F;46;CHILENO;;X;NEGRETE                       ;BIO BIO;510230;5;2;0;0;0;5;2;510230;Lavadora Premium Care 20SZ 20Kg Silver;LINEA BLANCA
6075621;;M;72;CHILENO;;Silencioso;YUMBEL                        ;BIO BIO;166960;3;1;0;0;0;3;1;166960;FRIGOBAR 93 LTS MFB-930S121LN;LINEA BLANCA
9306958;Divorciado;F;63;CHILENO;;Boomers;CORONEL                       ;BIO BIO;442460;3;1;0;0;0;3;1;442460;Refrigerador 322Lts No Frost BF DB60S;LINEA BLANCA
7669676;;M;62;CHILENO;;Boomers;SAN ANTONIO                   ;VALPARAISO;229980;2;1;0;0;0;2;1;229980;Secadora 9Kg Solare 9200 Ventilacion;LINEA BLANCA
10409077;Casado;F;55;CHILENO;;Boomers;TOME                          ;BIO BIO;396980;2;3;0;0;0;2;3;396980;Cocina F-5500 Premium 5P;LINEA BLANCA
21727759;Soltero;M;37;CHILENO;TECNICO EN MANTENCION INDUSTRIAL;Millenial;PROVIDENCIA                   ;METROPOLITANA;359980;2;1;2;1;359980;0;0;0;Cocina CMC20AXX 4P Inox;LINEA BLANCA
19103016;;F;26;CHILENO;;Z;N/D;N/D;208360;3;1;0;0;0;3;1;208360;Calefon 11Lts GL Master;LINEA BLANCA
15745683;;M;38;CHILENO;;Millenial;VALLENAR;ATACAMA;451760;3;1;0;0;0;3;1;451760;Lavadora WT19DSBP 19Kg Silver;LINEA BLANCA
16758931;Soltero;F;34;CHILENO;PROFESOR;Millenial;PROVIDENCIA                   ;METROPOLITANA;299980;2;1;0;0;0;2;1;299980;Cocina F-2808 4P;LINEA BLANCA
7198024;;F;68;CHILENO;;Silencioso;EL BOSQUE                     ;METROPOLITANA;423040;5;2;0;0;0;5;2;423040;Refrigerador 322Lts No Frost BF DB60S;LINEA BLANCA
7664922;;M;61;CHILENO;;Boomers;SAN FELIPE                    ;VALPARAISO;329980;2;1;0;0;0;2;1;329980;REFRIGERADOR 234Lt TMF RT22FARADS8/ZS;LINEA BLANCA
6960752;Soltero;F;71;CHILENO;;Silencioso;RENCA                         ;METROPOLITANA;129990;1;1;0;0;0;1;1;129990;Calefont 8Lts GL Essenetial ECO;LINEA BLANCA
8697397;Soltero;F;62;CHILENO;;Boomers;RENCA                         ;METROPOLITANA;227370;2;1;0;0;0;2;1;227370;Cocina CH-7400 4P;LINEA BLANCA
18573152;Soltero;F;28;CHILENO;;Millenial;PROVIDENCIA                   ;METROPOLITANA;155480;2;1;2;1;155480;0;0;0;Refrigerador 167Lts Frio Directo 1700-S;LINEA BLANCA
7464901;;F;67;CHILENO;;Boomers;GORBEA                        ;ARAUCANIA;246360;3;1;0;0;0;3;1;246360;Freezer Horizontal MFH-1990B258CN 198Lts;LINEA BLANCA
7473504;;F;68;CHILENO;;Silencioso;PROVIDENCIA                   ;METROPOLITANA;163980;2;1;2;1;163980;0;0;0;Refrigerador 167Lts Frio Directo 1700-S;LINEA BLANCA
12979886;;F;46;CHILENO;;X;CONCEPCION                    ;BIO BIO;316980;2;1;0;0;0;2;1;316980;Cocina F-2808 4P;LINEA BLANCA
16732950;;F;34;CHILENO;;Millenial;COQUIMBO                      ;COQUIMBO;395980;2;1;2;1;395980;0;0;0;Refrigerador LB33MPP 306Lts Bottom No Frost;LINEA BLANCA
13099971;;M;46;CHILENO;;X;SAN VICENTE                   ;L.G.B.OÂ´HIGGINS;429980;2;1;0;0;0;2;1;429980;Lavadora WT19DSBP 19Kg Silver;LINEA BLANCA
13528650;;F;42;CHILENO;;X;N/D;N/D;279370;2;1;0;0;0;2;1;279370;Refrigerador 244Lts Frio Directo Progress 3100;LINEA BLANCA
21246689;Soltero;M;57;CANADIENSE;;Extranjero;RENCA                         ;METROPOLITANA;385470;2;1;0;0;0;2;1;385470;Lavadora WT16DSBP 16Kg Silver;LINEA BLANCA
15499021;;M;35;CHILENO;;Silencioso;PROVIDENCIA                   ;METROPOLITANA;83980;2;1;2;1;83980;0;0;0;FRIGOBAR 45 LTS MDRD86FGF02;LINEA BLANCA
10105788;;F;58;CHILENO;;Boomers;CHIMBARONGO                   ;L.G.B.OÂ´HIGGINS;268980;2;1;2;1;268980;0;0;0;Freezer MFH-2950B384CN 295 lts blanco;LINEA BLANCA
7550850;;F;67;CHILENO;;Boomers;VINA DEL MAR                  ;VALPARAISO;379842;5;4;0;0;0;5;4;379842;Cocina F-2808 4P;LINEA BLANCA
17555016;;F;30;CHILENO;;Millenial;ARICA                         ;TARAPACA;621950;4;1;4;1;621950;0;0;0;Refrigerador 260Lts BF Frio Direc MRFI2660SR346W;LINEA BLANCA
16539111;Soltero;F;35;CHILENO;CONTADOR GENERAL;Millenial;"";"";809960;7;3;6;2;399970;1;1;409990;Lavadora WA80H4200SW/ZS 8Kg Blanca;LINEA BLANCA
3068977;;M;88;CHILENO;;Silencioso;PUENTE ALTO                   ;METROPOLITANA;219370;2;1;0;0;0;2;1;219370;Lavadora MLS-090GE04N 9Kg Gris;LINEA BLANCA
12376789;;F;49;CHILENO;;X;CHILLAN                       ;BIO BIO;1130770;9;1;0;0;0;9;1;1130770;Refrigerador 244Lts Frio Directo Progress 3100;LINEA BLANCA
8791269;;F;62;CHILENO;;Boomers;CHILLAN                       ;BIO BIO;99990;1;1;0;0;0;1;1;99990;Calefon 5Lts GL Master;LINEA BLANCA
18801227;;M;28;CHILENO;;Silencioso;PROVIDENCIA                   ;METROPOLITANA;285980;2;1;2;1;285980;0;0;0;Refrigerador 244Lts Frio Directo Progress 3100;LINEA BLANCA
7664774;Casado;M;65;CHILENO;;Silencioso;PUERTO MONTT                  ;LOS LAGOS;239360;3;1;0;0;0;3;1;239360;Lavadora Efficace BZG 9,5Kg Blanca;LINEA BLANCA
13096925;;F;46;CHILENO;;X;RANCAGUA                      ;L.G.B.OÂ´HIGGINS;168980;2;1;2;1;168980;0;0;0;Secadora Ropa MSV-90 9K Blanca Ventilacion;LINEA BLANCA
13604377;;M;42;CHILENO;;X;CABRERO                       ;BIO BIO;523440;6;3;0;0;0;6;3;523440;Cocina F-5500 Premium 5P;LINEA BLANCA
9310360;Casado;F;60;CHILENO;;Boomers;RENCA                         ;METROPOLITANA;367460;3;1;0;0;0;3;1;367460;Lavadora Superior WA13T5260BY/ZS 13Kg;LINEA BLANCA
18293762;;M;29;CHILENO;;Millenial;LAS CONDES;METROPOLITANA;305980;2;1;2;1;305980;0;0;0;Lavadora Secadora MLSF-1108BN05N 11Kg/8Kg Blanca;LINEA BLANCA
8540935;;F;65;CHILENO;;Boomers;LINARES                       ;MAULE;544200;7;2;0;0;0;7;2;544200;Refrigerador 210Lts Rojo Frio Dir MRFS2100R273FN;LINEA BLANCA
10628511;;F;56;CHILENO;;Boomers;RENGO                         ;L.G.B.OÂ´HIGGINS;335560;3;1;0;0;0;3;1;335560;Lavadora Efficace SZG 15,5Kg Silver;LINEA BLANCA
5928050;;F;74;CHILENO;;Silencioso;RENCA                         ;METROPOLITANA;366340;5;1;0;0;0;5;1;366340;Refrigerador 241Lts BF Frio Directo Nordik 415;LINEA BLANCA
14098004;;F;40;CHILENO;;X;AISEN                         ;AYSEN;146980;2;1;2;1;146980;0;0;0;Lavadora MLS-090GE04N 9Kg Gris;LINEA BLANCA
3223463;;M;91;CHILENO;;Silencioso;EL BOSQUE                     ;METROPOLITANA;161270;2;1;0;0;0;2;1;161270;Calefont 8Lts GL Essenetial ECO;LINEA BLANCA
17163763;;M;33;CHILENO;;Millenial;LOS ANDES                     ;VALPARAISO;309370;2;1;0;0;0;2;1;309370;Lavadora Efficace SZG 17,5Kg Silver;LINEA BLANCA
6172453;;F;72;CHILENO;;Silencioso;PUNITAQUI                     ;COQUIMBO;399990;1;1;0;0;0;1;1;399990;Lavadora WT19DSBP 19Kg Silver;LINEA BLANCA
17409600;Soltero;M;31;CHILENO;;Millenial;PROVIDENCIA                   ;METROPOLITANA;234540;2;1;2;1;234540;0;0;0;Cocina 775X 4P;LINEA BLANCA
13346959;;M;44;CHILENO;;X;N/D;N/D;731960;4;1;0;0;0;4;1;731960;Refrigerador 262Lts No Frost MRFI-2760S349RW-DA;LINEA BLANCA
15784277;;F;38;CHILENO;;Millenial;ISLA DE MAIPO;METROPOLITANA;259980;2;1;2;1;259980;0;0;0;Refrigerador 244Lts Frio Directo Progress 3100;LINEA BLANCA
17809828;;F;31;CHILENO;;Millenial;N/D;N/D;143980;2;1;2;1;143980;0;0;0;Cocina CMC20AXX 4P Inox;LINEA BLANCA
18520416;;F;29;CHILENO;;Millenial;VALLENAR;ATACAMA;308640;2;1;2;1;308640;0;0;0;Cocina Andes76HG0 6P Inox;LINEA BLANCA
13538958;;F;43;CHILENO;;X;LOS ANDES                     ;VALPARAISO;219980;2;1;0;0;0;2;1;219980;Cocina CH-9400 4P SILVER;LINEA BLANCA
19261169;;M;26;CHILENO;;Z;PROVIDENCIA                   ;METROPOLITANA;57540;2;1;2;1;57540;0;0;0;CAMPANA ESSENTIAL 601 INOX ALBIN TROTTER;LINEA BLANCA
11522451;;M;52;CHILENO;;X;TALCAHUANO                    ;BIO BIO;269360;3;1;0;0;0;3;1;269360;Lavadora LMA0920WGCL0 9,5Kg Gris;LINEA BLANCA
12617338;;F;48;CHILENO;;Silencioso;PROVIDENCIA                   ;METROPOLITANA;289990;1;1;0;0;0;1;1;289990;Refrigerador 241Lts BF Frio Directo Nordik 415;LINEA BLANCA
14588156;;M;42;CHILENO;;Silencioso;PROVIDENCIA                   ;METROPOLITANA;238360;3;1;3;1;238360;0;0;0;Lavadora 9 Kg Carga Superior Blanca;LINEA BLANCA
10915846;;M;49;CHILENO;;X;RENCA                         ;METROPOLITANA;362770;2;1;0;0;0;2;1;362770;Lavadora Efficace SZG 15,5Kg Silver;LINEA BLANCA
7752685;;F;67;CHILENO;;Boomers;LA SERENA                     ;COQUIMBO;234870;2;1;0;0;0;2;1;234870;Cocina CH-7400 4P;LINEA BLANCA
24333797;Soltero;F;42;PERUANO;;Extranjero;COLINA                        ;METROPOLITANA;455470;2;1;0;0;0;2;1;455470;Lavadora WT19DSBP 19Kg Silver;LINEA BLANCA
6751644;;F;69;CHILENO;;Silencioso;QUILPUE                       ;VALPARAISO;331360;3;1;0;0;0;3;1;331360;Lavadora WT13WSBP 13Kg Blanca;LINEA BLANCA
5149092;;M;78;CHILENO;;Silencioso;CHILLAN VIEJO                 ;BIO BIO;386480;2;1;0;0;0;2;1;386480;Cocina Diva 920 5P;LINEA BLANCA
5507987;;F;76;CHILENO;;Silencioso;PUENTE ALTO                   ;METROPOLITANA;355460;3;1;0;0;0;3;1;355460;Lavadora Efficace SZG 15,5Kg Silver;LINEA BLANCA
7868659;;F;64;CHILENO;;Boomers;PROVIDENCIA                   ;METROPOLITANA;543340;4;1;0;0;0;4;1;543340;Refrigerador 322Lts No Frost BF DB60S;LINEA BLANCA
8092205;;F;71;CHILENO;;Silencioso;ALHUE                         ;METROPOLITANA;511970;3;1;0;0;0;3;1;511970;Lavadora Efficace SZG 15,5Kg Silver;LINEA BLANCA
18137920;;F;29;CHILENO;;Millenial;"";"";325350;4;2;0;0;0;4;2;325350;Refrigerador MRFI2740G332RW BF 255Lts Frio Direc;LINEA BLANCA
15195673;;F;39;CHILENO;;X;YUMBEL                        ;BIO BIO;271470;3;2;0;0;0;3;2;271470;Freezer Horizontal MFH-1990B258CN 198Lts;LINEA BLANCA
10214157;;M;54;CHILENO;;X;ARICA                         ;ARICA Y PARINACOTA;189990;1;1;0;0;0;1;1;189990;Cocina MV 110 4 Platos;LINEA BLANCA
19496946;;F;25;CHILENO;;Z;"";"";301980;2;1;0;0;0;2;1;301980;Refrigerador 252Lts No Frost MRFS-2700G333FW;LINEA BLANCA
16741982;;M;34;CHILENO;;Millenial;LA REINA;METROPOLITANA;313980;2;1;2;1;313980;0;0;0;Secadora Ropa MSC-90 9K Blanca Condensacion;LINEA BLANCA
7757066;;F;67;CHILENO;;Boomers;PROVIDENCIA                   ;METROPOLITANA;235980;2;1;2;1;235980;0;0;0;Freezer 160 Lts MFV-1600B208FN vertical;LINEA BLANCA
16448706;;M;35;CHILENO;;Millenial;DALCAHUE                      ;LOS LAGOS;229990;1;1;0;0;0;1;1;229990;Freezer FDHM200BY1 200Lts Horizontal;LINEA BLANCA
14319545;;F;46;CHILENO;;X;N/D;N/D;200570;2;1;0;0;0;2;1;200570;Lavadora Semiautomatica LC-6550 6,5Kg;LINEA BLANCA
9674093;;M;59;CHILENO;;Boomers;OVALLE                        ;COQUIMBO;228860;3;1;0;0;0;3;1;228860;Lavadora WA80H4200SW/ZS 8Kg Blanca;LINEA BLANCA
8384162;;F;63;CHILENO;;Boomers;PENAFLOR                      ;METROPOLITANA;189980;2;1;0;0;0;2;1;189980;Cocina CH-7400 4P;LINEA BLANCA
19073349;;M;26;CHILENO;;Z;PROVIDENCIA                   ;METROPOLITANA;363980;2;1;2;1;363980;0;0;0;Refrigerador 254Lts No Frost GT29WPPDC;LINEA BLANCA
15355678;;F;39;CHILENO;;X;N/D;N/D;249980;2;1;0;0;0;2;1;249980;Cocina 775X 4P;LINEA BLANCA
5375206;;F;80;CHILENO;;Silencioso;LA SERENA                     ;COQUIMBO;270360;3;1;0;0;0;3;1;270360;Cocina CH-7400 4P;LINEA BLANCA
4504564;;F;83;CHILENO;;Silencioso;HIJUELAS                      ;VALPARAISO;342770;2;1;0;0;0;2;1;342770;Cocina F-2808 4P;LINEA BLANCA
6046876;;M;69;CHILENO;;Silencioso;MARIA PINTO                   ;METROPOLITANA;159990;1;1;0;0;0;1;1;159990;Calefont 10Lts GL Essenetial ECO;LINEA BLANCA
10244667;Divorciado;M;57;CHILENO;;Boomers;RENCA                         ;METROPOLITANA;199990;1;1;0;0;0;1;1;199990;Lavadora MLS-090GE04N 9Kg Gris;LINEA BLANCA
17218056;Soltero;M;32;CHILENO;PROFESOR;Millenial;RENCA                         ;METROPOLITANA;413980;2;1;2;1;413980;0;0;0;Lavadora WT19DSBP 19Kg Silver;LINEA BLANCA
15231323;;M;39;CHILENO;;X;VICTORIA                      ;ARAUCANIA;217370;2;1;0;0;0;2;1;217370;Lavadora MLS-090GE04N 9Kg Gris;LINEA BLANCA
10249996;;M;55;CHILENO;;Boomers;CONCEPCION                    ;BIO BIO;136980;2;1;0;0;0;2;1;136980;Lavadora Semiautomatica LS-6100 6Kg Gris;LINEA BLANCA
17120338;;M;33;CHILENO;;Millenial;N/D;N/D;0;0;0;0;0;0;0;0;0;Lavadora WT13WSBP 13Kg Blanca;LINEA BLANCA
7924405;;F;63;CHILENO;;Boomers;PUENTE ALTO                   ;METROPOLITANA;0;0;0;0;0;0;0;0;0;Lavadora MLS-160BSC03T 16Kg Blanca;LINEA BLANCA
23380365;;M;40;CHILENO;;Extranjero;ALTO HOSPICIO;TARAPACA;0;0;0;0;0;0;0;0;0;Lavadora Efficace SZG 15,5Kg Silver;LINEA BLANCA
17840382;;F;30;CHILENO;;Millenial;SANTIAGO                      ;METROPOLITANA;0;0;0;0;0;0;0;0;0;Cocina MCG-5QI30AME5 5P Inox;LINEA BLANCA
16241089;;F;32;CHILENO;;Millenial;CARAHUE                       ;ARAUCANIA;0;0;0;0;0;0;0;0;0;Lavadora LMA0920WGCL0 9,5Kg Gris;LINEA BLANCA
17031927;;M;33;CHILENO;;Millenial;PROVIDENCIA                   ;METROPOLITANA;0;0;0;0;0;0;0;0;0;HORNO EMPOTRABLE HE-7200 INOX 2250W 57L SINDELEN;LINEA BLANCA
5346298;;M;78;CHILENO;;Silencioso;PROVIDENCIA                   ;METROPOLITANA;0;0;0;0;0;0;0;0;0;Refrigerador 252Lts No Frost MRFS-2700G333FW;LINEA BLANCA
9753466;;M;58;CHILENO;;Boomers;LOS ANGELES                   ;BIO BIO;0;0;0;0;0;0;0;0;0;Freezer FDHM200BY1 200Lts Horizontal;LINEA BLANCA
15586894;;F;39;CHILENO;;X;CERRO NAVIA                   ;METROPOLITANA;0;0;0;0;0;0;0;0;0;Refrigerador Bottom No Frost con Dispensador 336;LINEA BLANCA
6754456;;F;71;CHILENO;;Silencioso;SAN ANTONIO                   ;VALPARAISO;0;0;0;0;0;0;0;0;0;Cocina CH-9050SI 4P;LINEA BLANCA
10486011;;F;41;CHILENO;;X;COIHAIQUE                     ;AYSEN;0;0;0;0;0;0;0;0;0;Cocina Andes60TX4 4P Inox;LINEA BLANCA
11454898;Casado;M;53;CHILENO;;X;ANCUD                         ;LOS LAGOS;0;0;0;0;0;0;0;0;0;Cocina CH-7400 4P;LINEA BLANCA
12332566;Soltero;F;49;CHILENO;;X;CONCEPCION                    ;BIO BIO;0;0;0;0;0;0;0;0;0;Freezer Horizontal M100 99Lts;LINEA BLANCA
12700362;Casado;F;47;CHILENO;;X;RENCA                         ;METROPOLITANA;0;0;0;0;0;0;0;0;0;Freezer Horizontal M100 99Lts;LINEA BLANCA
9732549;;M;59;CHILENO;;Boomers;TALAGANTE                     ;METROPOLITANA;0;0;0;0;0;0;0;0;0;Freezer 196Lts M200 Horizontal;LINEA BLANCA
17676866;;F;31;CHILENO;;Millenial;N/D;N/D;0;0;0;0;0;0;0;0;0;Cocina 785FX 4P;LINEA BLANCA
14263954;;F;52;CHILENO;;X;PROVIDENCIA                   ;METROPOLITANA;0;0;0;0;0;0;0;0;0;Refrigerador 244Lts Frio Directo Progress 3100;LINEA BLANCA
19812304;;F;24;CHILENO;;Z;N/D;N/D;0;0;0;0;0;0;0;0;0;Cocina CMC20AXX 4P Inox;LINEA BLANCA
6812194;;M;72;CHILENO;;Silencioso;PROVIDENCIA                   ;METROPOLITANA;0;0;0;0;0;0;0;0;0;Cocina F-2808 4P;LINEA BLANCA
19939065;;F;24;CHILENO;;Z;N/D;N/D;0;0;0;0;0;0;0;0;0;Cocina CH-9950NG-1 6P Negro;LINEA BLANCA
7872514;;F;67;CHILENO;;Silencioso;CANETE                        ;BIO BIO;0;0;0;0;0;0;0;0;0;Refrigerador 241Lts BF Frio Directo Nordik 415;LINEA BLANCA
4825723;;M;72;CHILENO;;Silencioso;CALERA                        ;VALPARAISO;0;0;0;0;0;0;0;0;0;Refrigerador 255Lts No Frost RT25FARADS8/ZS;LINEA BLANCA
8964195;;F;62;CHILENO;;Boomers;EL BOSQUE                     ;METROPOLITANA;0;0;0;0;0;0;0;0;0;Lavadora WT16DSBP 16Kg Silver;LINEA BLANCA
6832152;;F;74;CHILENO;;Silencioso;LOS ANGELES                   ;BIO BIO;0;0;0;0;0;0;0;0;0;Cocina CMC5515GCH-1 4P;LINEA BLANCA
10183841;;M;58;CHILENO;;Boomers;CABILDO                       ;VALPARAISO;0;0;0;0;0;0;0;0;0;Refrigerador 167Lts Frio Directo 1700-S;LINEA BLANCA
8199508;;M;62;CHILENO;;Boomers;OLMUE                         ;VALPARAISO;0;0;0;0;0;0;0;0;0;Lavadora MLS-140GSC03T 14Kg Gris;LINEA BLANCA
16161833;;F;36;CHILENO;;Millenial;N/D;N/D;0;0;0;0;0;0;0;0;0;Lavadora Secadora WD90M4453JW/ZS 9/5Kg Blanca;LINEA BLANCA
9825949;;F;64;CHILENO;;Boomers;LOS ANGELES                   ;BIO BIO;0;0;0;0;0;0;0;0;0;Cocina F-2525 4P;LINEA BLANCA
12432871;;F;52;CHILENO;;X;N/D;N/D;0;0;0;0;0;0;0;0;0;Refrigerador 527Lts Side by Side MRSBS5300G689WE;LINEA BLANCA
12882097;;F;48;CHILENO;;X;PENALOLEN                     ;METROPOLITANA;0;0;0;0;0;0;0;0;0;Lavadora WT19DSBP 19Kg Silver;LINEA BLANCA
7347891;;M;67;CHILENO;;Boomers;COPIAPO                       ;ATACAMA;0;0;0;0;0;0;0;0;0;Cocina CH-6900IN 4P;LINEA BLANCA
15609493;;F;37;CHILENO;;Millenial;N/D;N/D;0;0;0;0;0;0;0;0;0;Cocina MCG-4QI24AME4 4P Inox;LINEA BLANCA
12372563;;F;54;CHILENO;;X;LINARES                       ;MAULE;0;0;0;0;0;0;0;0;0;Cocina CMC5515GCH-1 4P;LINEA BLANCA
18759346;;F;28;CHILENO;;Millenial;SAN ANTONIO                   ;VALPARAISO;0;0;0;0;0;0;0;0;0;Refrigerador 290Lts BF No Frost RB30N4020S8;LINEA BLANCA
9198383;;F;61;CHILENO;;Boomers;ALTO HOSPICIO;TARAPACA;0;0;0;0;0;0;0;0;0;Cocina Andes60TX4 4P Inox;LINEA BLANCA
20268745;;F;23;CHILENO;;Millenial;PROVIDENCIA                   ;METROPOLITANA;0;0;0;0;0;0;0;0;0;Cocina CH-9500 NG 4P;LINEA BLANCA
20259046;;F;22;CHILENO;;Z;CABRERO                       ;BIO BIO;0;0;0;0;0;0;0;0;0;Cocina CH-7400 4P;LINEA BLANCA
11800184;Casado;F;50;CHILENO;;X;RENCA                         ;METROPOLITANA;0;0;0;0;0;0;0;0;0;Centrifuga Primma 5B 5,5Kilos;LINEA BLANCA
15081187;;M;41;CHILENO;;X;VALPARAISO                    ;VALPARAISO;0;0;0;0;0;0;0;0;0;Lavadora WT19DSBP 19Kg Silver;LINEA BLANCA
14174369;;F;41;CHILENO;;X;PROVIDENCIA                   ;METROPOLITANA;0;0;0;0;0;0;0;0;0;Calefont 10Lts GL Essenetial ECO;LINEA BLANCA
6341385;;F;71;CHILENO;;Silencioso;SANTO DOMINGO                 ;VALPARAISO;0;0;0;0;0;0;0;0;0;Cocina F-2608 4P Inox;LINEA BLANCA
9405303;;F;61;CHILENO;;Boomers;COLBUN                        ;MAULE;0;0;0;0;0;0;0;0;0;Cocina CH-7400 4P;LINEA BLANCA
19222815;;F;26;CHILENO;;Z;N/D;N/D;0;0;0;0;0;0;0;0;0;Lavadora MLS-140GSC03T 14Kg Gris;LINEA BLANCA
16105188;;F;36;CHILENO;;Millenial;N/D;N/D;0;0;0;0;0;0;0;0;0;Refrigerador 241Lts BF Frio Directo Nordik 415;LINEA BLANCA
14527942;;F;47;CHILENO;;X;RENCA                         ;METROPOLITANA;0;0;0;0;0;0;0;0;0;Lavadora MLS-160BSC03T 16Kg Blanca;LINEA BLANCA
10594762;;F;53;CHILENO;;X;N/D;N/D;0;0;0;0;0;0;0;0;0;Refrigerador 262Lts No Frost MRFI-2760S349RW-DA;LINEA BLANCA
19057272;;F;27;CHILENO;;Z;PROVIDENCIA                   ;METROPOLITANA;0;0;0;0;0;0;0;0;0;Refrigerador 251Lts No Frost Altus 1250;LINEA BLANCA
12206600;;M;50;CHILENO;;X;LOLOL                         ;L.G.B.OÂ´HIGGINS;0;0;0;0;0;0;0;0;0;Refrigerador 300Lts No Frost RT29K500JS8/ZS;LINEA BLANCA
16090172;;F;38;CHILENO;;Millenial;N/D;N/D;0;0;0;0;0;0;0;0;0;Lavadora WT19DSBP 19Kg Silver;LINEA BLANCA
11776715;;F;51;CHILENO;;X;BUIN                          ;METROPOLITANA;0;0;0;0;0;0;0;0;0;Refrigerador 527Lts Side by Side MRSBS5300G689WE;LINEA BLANCA
11443465;Casado;F;53;CHILENO;;X;NINHUE                        ;BIO BIO;0;0;0;0;0;0;0;0;0;Refrigerador 244Lts Frio Directo Progress 3100;LINEA BLANCA
26614541;;M;41;VENEZOLANO;;Extranjero;RANCAGUA                      ;L.G.B.OÂ´HIGGINS;0;0;0;0;0;0;0;0;0;Cocina CMC5515GCH-1 4P;LINEA BLANCA
22581914;;F;54;BOLIVIANO;;Extranjero;CALAMA                        ;ANTOFAGASTA;0;0;0;0;0;0;0;0;0;Cocina F-2808 4P;LINEA BLANCA
26259897;;M;39;EXTRANJERO - NO INFORMA NACIONALIDAD;;Extranjero;SANTIAGO                      ;METROPOLITANA;0;0;0;0;0;0;0;0;0;Lavadora Premium Care 20SZ 20Kg Silver;LINEA BLANCA
15382579;Soltero;M;39;CHILENO;;Silencioso;PROVIDENCIA                   ;METROPOLITANA;0;0;0;0;0;0;0;0;0;Lavadora Superior WA19T6260BW/ZS 19Kg;LINEA BLANCA
11429378;;F;52;CHILENO;;X;PROVIDENCIA                   ;METROPOLITANA;0;0;0;0;0;0;0;0;0;Cocina MV 110 4 Platos;LINEA BLANCA
8658153;;M;63;CHILENO;;Boomers;GRANEROS                      ;L.G.B.OÂ´HIGGINS;0;0;0;0;0;0;0;0;0;Lavadora MLS-090GE04N 9Kg Gris;LINEA BLANCA
26884893;;M;24;VENEZOLANO;;Extranjero;SANTIAGO                      ;METROPOLITANA;0;0;0;0;0;0;0;0;0;Refrigerador 244Lts Frio Directo Progress 3100;LINEA BLANCA
9995898;;F;54;CHILENO;;Boomers;TALCAHUANO                    ;BIO BIO;0;0;0;0;0;0;0;0;0;Lavadora WT13WSBP 13Kg Blanca;LINEA BLANCA
8900693;;F;61;CHILENO;;Boomers;PARRAL                        ;MAULE;0;0;0;0;0;0;0;0;0;Lavadora WT16DSBP 16Kg Silver;LINEA BLANCA
17670582;;M;31;CHILENO;;Silencioso;PROVIDENCIA                   ;METROPOLITANA;0;0;0;0;0;0;0;0;0;Lavadora WT13WSBP 13Kg Blanca;LINEA BLANCA
8961881;;F;63;CHILENO;;Boomers;SAN RAMON                     ;METROPOLITANA;0;0;0;0;0;0;0;0;0;Refrigerador Bottom No Frost con Dispensador 336;LINEA BLANCA
9513385;;M;57;CHILENO;;Boomers;VILLARICA                     ;ARAUCANIA;0;0;0;0;0;0;0;0;0;Cocina Andes7650FX 5P Inox;LINEA BLANCA
16255532;;M;36;CHILENO;;Millenial;CURICO                        ;MAULE;0;0;0;0;0;0;0;0;0;Cocina Andes76HG0 6P Inox;LINEA BLANCA
13743886;;F;41;CHILENO;;X;N/D;N/D;0;0;0;0;0;0;0;0;0;Cocina Andes60TX4 4P Inox;LINEA BLANCA
17558675;;M;32;CHILENO;;Millenial;QUILPUE                       ;VALPARAISO;0;0;0;0;0;0;0;0;0;Lavadora Efficace BZG 9,5Kg Blanca;LINEA BLANCA
18986743;Soltero;F;26;CHILENO;;Z;PROVIDENCIA                   ;METROPOLITANA;0;0;0;0;0;0;0;0;0;Cocina CH-9900SI 6P Silver;LINEA BLANCA
18572508;;M;28;CHILENO;;Silencioso;PROVIDENCIA                   ;METROPOLITANA;0;0;0;0;0;0;0;0;0;Lavadora MLS-160BSC03T 16Kg Blanca;LINEA BLANCA
14575492;;M;45;CHILENO;;X;RENCA                         ;METROPOLITANA;0;0;0;0;0;0;0;0;0;Secadora Ropa MSC-90 9K Blanca Condensacion;LINEA BLANCA
8378392;;F;69;CHILENO;;Silencioso;RENCA                         ;METROPOLITANA;0;0;0;0;0;0;0;0;0;Cocina CMC20AXX 4P Inox;LINEA BLANCA
18859963;;F;26;CHILENO;;Silencioso;PROVIDENCIA                   ;METROPOLITANA;0;0;0;0;0;0;0;0;0;Lavadora WT13WSBP 13Kg Blanca;LINEA BLANCA
19878832;;F;24;CHILENO;;Silencioso;PUENTE ALTO                   ;METROPOLITANA;0;0;0;0;0;0;0;0;0;Refrigerador 210Lts Rojo Frio Dir MRFS2100R273FN;LINEA BLANCA
19588225;;M;25;CHILENO;;Z;"";"";0;0;0;0;0;0;0;0;0;Cocina MV 120 4 Platos;LINEA BLANCA
25840869;;M;30;VENEZOLANO;;Extranjero;INDEPENDENCIA                 ;METROPOLITANA;0;0;0;0;0;0;0;0;0;Lavadora Secadora WD10WVC4S6 10,5/6Kg Blanca;LINEA BLANCA
8155474;;F;64;CHILENO;;Silencioso;PROVIDENCIA                   ;METROPOLITANA;0;0;0;0;0;0;0;0;0;HORNO EMPOTRABLE HE-7200 INOX 2250W 57L SINDELEN;LINEA BLANCA
26152295;;M;71;CHILENO;;Extranjero;N/D;N/D;0;0;0;0;0;0;0;0;0;Secadora Ropa MSV-90 9K Blanca Ventilacion;LINEA BLANCA
14400436;;F;41;CHILENO;;Millenial;CHILLAN                       ;NUBLE;0;0;0;0;0;0;0;0;0;Secadora Ropa Reverplus 6470 7Kg Gris Ventilacio;LINEA BLANCA
17824385;;F;30;CHILENO;;Millenial;TALCA                         ;MAULE;0;0;0;0;0;0;0;0;0;Cocina MCG-5QI30AME5 5P Inox;LINEA BLANCA
11003412;;F;57;CHILENO;;Boomers;LIMACHE                       ;VALPARAISO;0;0;0;0;0;0;0;0;0;Cocina MCG-5QI30AME5 5P Inox;LINEA BLANCA
11915147;;M;50;CHILENO;;X;LOS ALAMOS                    ;BIO BIO;0;0;0;0;0;0;0;0;0;Cocina F-2808 4P;LINEA BLANCA
19067315;;M;26;CHILENO;;Z;BUIN                          ;METROPOLITANA;0;0;0;0;0;0;0;0;0;Cocina MV 220 4P;LINEA BLANCA
7340104;;M;69;CHILENO;;Silencioso;N/D;N/D;0;0;0;0;0;0;0;0;0;Cocina MV 220 4P;LINEA BLANCA
7163498;;F;66;CHILENO;;Boomers;VALPARAISO                    ;VALPARAISO;0;0;0;0;0;0;0;0;0;Lavadora WT16DSBP 16Kg Silver;LINEA BLANCA
10471447;;F;56;CHILENO;;Boomers;MAIPU                         ;METROPOLITANA;0;0;0;0;0;0;0;0;0;Cocina CMC20AXX 4P Inox;LINEA BLANCA
25213647;;M;33;PERUANO;;Extranjero;HUECHURABA                    ;METROPOLITANA;0;0;0;0;0;0;0;0;0;Cocina Andes7650FX 5P Inox;LINEA BLANCA
16848265;;F;34;CHILENO;;Millenial;OVALLE                        ;COQUIMBO;0;0;0;0;0;0;0;0;0;Cocina 76DXR Doble Horno;LINEA BLANCA
8046819;;F;65;CHILENO;;Boomers;PUENTE ALTO                   ;METROPOLITANA;0;0;0;0;0;0;0;0;0;Cocina CH-7400 4P;LINEA BLANCA
8382717;;M;65;CHILENO;;Boomers;RENCA                         ;METROPOLITANA;0;0;0;0;0;0;0;0;0;Cocina CH-7400 4P;LINEA BLANCA
6525801;;M;72;CHILENO;;Silencioso;PUNTA ARENAS                  ;MAGALLANES;0;0;0;0;0;0;0;0;0;Lavadora Semiautomatica LC-6550 6,5Kg;LINEA BLANCA
9791976;;F;59;CHILENO;;Boomers;QUILPUE                       ;VALPARAISO;0;0;0;0;0;0;0;0;0;Cocina 775X 4P;LINEA BLANCA
7993756;Casado;M;65;CHILENO;;Boomers;VILLA ALEMANA                 ;VALPARAISO;0;0;0;0;0;0;0;0;0;Refrigerador 252Lts No Frost MRFS-2700G333FW;LINEA BLANCA
11419509;;M;52;CHILENO;;X;CANETE                        ;BIO BIO;0;0;0;0;0;0;0;0;0;Lavadora MLS-090GE04N 9Kg Gris;LINEA BLANCA
10719517;;M;56;CHILENO;;Boomers;QUILLOTA                      ;VALPARAISO;0;0;0;0;0;0;0;0;0;Cocina Venezia 5P;LINEA BLANCA
11857498;;M;51;CHILENO;;X;RENCA                         ;METROPOLITANA;0;0;0;0;0;0;0;0;0;Refrigerador 244Lts Frio Directo Progress 3100;LINEA BLANCA
17066286;;M;34;CHILENO;;Millenial;N/D;N/D;0;0;0;0;0;0;0;0;0;Lavadora Secadora MLSF-1108BN05N 11Kg/8Kg Blanca;LINEA BLANCA
7939477;;F;63;CHILENO;;Boomers;SANTIAGO                      ;METROPOLITANA;0;0;0;0;0;0;0;0;0;Cocina MV 110 4 Platos;LINEA BLANCA
19345513;;M;26;CHILENO;;Z;PROVIDENCIA                   ;METROPOLITANA;0;0;0;0;0;0;0;0;0;Cocina MV 110 4 Platos;LINEA BLANCA
15523483;;M;39;CHILENO;;X;PROVIDENCIA                   ;METROPOLITANA;0;0;0;0;0;0;0;0;0;ENCIMERA CE4-600 INOX 4P SINDELEN;LINEA BLANCA
17078730;Soltero;M;33;CHILENO;TECNICO MECANICO;Silencioso;PROVIDENCIA                   ;METROPOLITANA;0;0;0;0;0;0;0;0;0;Freezer Horizontal M100 99Lts;LINEA BLANCA
15463918;;M;39;CHILENO;;X;PROVIDENCIA                   ;METROPOLITANA;0;0;0;0;0;0;0;0;0;TERMO ELECTRICO TERMO E RH 85L 220V P;LINEA BLANCA
19643548;;M;25;CHILENO;;Silencioso;PROVIDENCIA                   ;METROPOLITANA;0;0;0;0;0;0;0;0;0;COCINA CH-5490NI 4P;LINEA BLANCA
11894556;;F;51;CHILENO;;X;RENCA                         ;METROPOLITANA;0;0;0;0;0;0;0;0;0;Refrigerador 255Lts No Frost RT25FARADS8/ZS;LINEA BLANCA
15089279;;F;39;CHILENO;;Silencioso;PROVIDENCIA                   ;METROPOLITANA;0;0;0;0;0;0;0;0;0;REFRIGERADOR TOP MOUNT NO FROST LRT-220NFI;LINEA BLANCA
19988390;;F;23;CHILENO;;Z;PROVIDENCIA                   ;METROPOLITANA;0;0;0;0;0;0;0;0;0;Refrigerador 210Lts Rojo Frio Dir MRFS2100R273FN;LINEA BLANCA
15508374;;F;40;CHILENO;;X;N/D;N/D;0;0;0;0;0;0;0;0;0;Refrigerador 300Lts No Frost RT29K500JS8/ZS;LINEA BLANCA
7614369;;F;68;CHILENO;;Boomers;PROVIDENCIA                   ;METROPOLITANA;0;0;0;0;0;0;0;0;0;Refrigerador 241Lts BF Frio Directo Nordik 415;LINEA BLANCA
6839914;;F;67;CHILENO;;Boomers;VILLA ALEMANA                 ;VALPARAISO;0;0;0;0;0;0;0;0;0;REFRIGERADOR 234Lt TMF RT22FARADS8/ZS;LINEA BLANCA
18489523;Soltero;M;28;CHILENO;;Millenial;NIQUEN                        ;BIO BIO;0;0;0;0;0;0;0;0;0;Refrigerador 255Lts No Frost RT25FARADS8/ZS;LINEA BLANCA
17185532;Soltero;M;33;CHILENO;;Millenial;PROVIDENCIA                   ;METROPOLITANA;0;0;0;0;0;0;0;0;0;Cocina 56DXQ 4P Doble Horno;LINEA BLANCA
18701124;;F;28;CHILENO;;Millenial;CHILLAN                       ;BIO BIO;0;0;0;0;0;0;0;0;0;Secadora Ropa Solare 7100 7K Ventilacion;LINEA BLANCA
17752814;Soltero;F;31;CHILENO;;Silencioso;PROVIDENCIA                   ;METROPOLITANA;0;0;0;0;0;0;0;0;0;Refrigerador 255Lts No Frost RT25FARADS8/ZS;LINEA BLANCA
17731996;;F;31;CHILENO;;Millenial;CONCHALI;METROPOLITANA;0;0;0;0;0;0;0;0;0;Lavadora WA15T5260BW/ZS 15Kg Blanca;LINEA BLANCA
16025380;;F;36;CHILENO;;Millenial;RENCA                         ;METROPOLITANA;0;0;0;0;0;0;0;0;0;CENTRIFUGA C-752;LINEA BLANCA
13957234;Casado;M;41;CHILENO;ADMINISTRADOR TURISTICO;X;PROVIDENCIA                   ;METROPOLITANA;0;0;0;0;0;0;0;0;0;FRIGOBAR 93 LTS MFB-930S121LN;LINEA BLANCA
12183723;;M;49;CHILENO;;X;PUENTE ALTO                   ;METROPOLITANA;0;0;0;0;0;0;0;0;0;Refrigerador 244Lts Frio Directo Progress 3100;LINEA BLANCA
19716802;;F;24;CHILENO;;Z;N/D;N/D;0;0;0;0;0;0;0;0;0;Lavadora Secadora MLSF-1108BN05N 11Kg/8Kg Blanca;LINEA BLANCA
3800559;;M;82;CHILENO;;Silencioso;BUIN                          ;METROPOLITANA;0;0;0;0;0;0;0;0;0;Secadora Ropa Reverplus 6470 7Kg Gris Ventilacio;LINEA BLANCA
11086045;;F;56;CHILENO;;Boomers;NUEVA IMPERIAL                ;ARAUCANIA;0;0;0;0;0;0;0;0;0;Refrigerador 260Lts BF Frio Direc MRFI2660SR346W;LINEA BLANCA
11282248;;M;54;CHILENO;;X;MARCHIHUE                     ;L.G.B.OÂ´HIGGINS;0;0;0;0;0;0;0;0;0;Lavadora Brilliant SG 15Kg Silver;LINEA BLANCA
15269171;;F;41;CHILENO;;X;MELIPILLA                     ;METROPOLITANA;0;0;0;0;0;0;0;0;0;Lavadora Secadora WD10WVC4S6 10,5/6Kg Blanca;LINEA BLANCA
20173591;;F;23;CHILENO;;Silencioso;VALPARAISO                    ;VALPARAISO;0;0;0;0;0;0;0;0;0;Lavadora WA90H4400SW/ZS 9Kg Blanca;LINEA BLANCA
13115118;;F;45;CHILENO;;X;RENCA                         ;METROPOLITANA;0;0;0;0;0;0;0;0;0;Refrigerador 244Lts Frio Directo Progress 3100;LINEA BLANCA
19594205;;M;24;CHILENO;;Z;PROVIDENCIA                   ;METROPOLITANA;0;0;0;0;0;0;0;0;0;Beer Cooler MBC-960N125SEN 96Lts;LINEA BLANCA
6565373;Casado;M;69;CHILENO;PROFESOR;Silencioso;ARICA                         ;TARAPACA;0;0;0;0;0;0;0;0;0;Refrigerador 260Lts BF Frio Direc MRFI2660SR346W;LINEA BLANCA
16672030;;F;34;CHILENO;;Millenial;PROVIDENCIA                   ;METROPOLITANA;0;0;0;0;0;0;0;0;0;Cocina CH-9600RJ 4P;LINEA BLANCA
16773798;;F;33;CHILENO;;Millenial;DIEGO DE ALMAGRO              ;ATACAMA;0;0;0;0;0;0;0;0;0;Lavadora MLS-090GE04N 9Kg Gris;LINEA BLANCA
19553247;;M;24;CHILENO;;Z;QUINTA NORMAL                 ;METROPOLITANA;0;0;0;0;0;0;0;0;0;Refrigerador 241Lts BF Frio Directo Nordik 415;LINEA BLANCA
15784837;Casado;F;38;CHILENO;PROFESOR;X;PROVIDENCIA                   ;METROPOLITANA;0;0;0;0;0;0;0;0;0;Centrifuga Primma 5B 5,5Kilos;LINEA BLANCA
11600562;;F;53;CHILENO;;X;CALAMA                        ;ANTOFAGASTA;0;0;0;0;0;0;0;0;0;Refrigerador 290Lts BF No Frost RB30N4020S8;LINEA BLANCA
19167753;;F;27;CHILENO;;Z;NATALES                       ;MAGALLANES;0;0;0;0;0;0;0;0;0;Lavadora WA90H4400SW/ZS 9Kg Blanca;LINEA BLANCA
17350521;;M;32;CHILENO;;Millenial;CAUQUENES                     ;MAULE;0;0;0;0;0;0;0;0;0;Lavadora Efficace SZG 17,5Kg Silver;LINEA BLANCA
20220850;;F;23;CHILENO;;Z;PROVIDENCIA                   ;METROPOLITANA;0;0;0;0;0;0;0;0;0;Secadora Electrica SEM101BDBY Blanca 10 KG;LINEA BLANCA
18240330;;F;29;CHILENO;;Millenial;ANTOFAGASTA                   ;ANTOFAGASTA;0;0;0;0;0;0;0;0;0;Refrigerador 331Lts No Frost BF RB34T632FSA/ZS;LINEA BLANCA
17913926;;F;31;CHILENO;;Millenial;FRESIA                        ;LOS LAGOS;0;0;0;0;0;0;0;0;0;Cocina CMC20AXX 4P Inox;LINEA BLANCA
12958168;;M;45;CHILENO;;X;RENCA                         ;METROPOLITANA;0;0;0;0;0;0;0;0;0;Refrigerador 331Lts No Frost BF RB34T632FSA/ZS;LINEA BLANCA
18403158;;F;28;CHILENO;;Millenial;PROVIDENCIA                   ;METROPOLITANA;0;0;0;0;0;0;0;0;0;Lavadora Secadora MLSF-1108BN05N 11Kg/8Kg Blanca;LINEA BLANCA
19697046;;M;24;CHILENO;;Z;N/D;N/D;0;0;0;0;0;0;0;0;0;Secadora Electrica SEM101BDBY Blanca 10 KG;LINEA BLANCA
14545842;;M;41;CHILENO;;X;RENCA                         ;METROPOLITANA;0;0;0;0;0;0;0;0;0;Cocina CH-9400 4P SILVER;LINEA BLANCA
17616214;Soltero;M;31;CHILENO;ABOGADO;Silencioso;PROVIDENCIA                   ;METROPOLITANA;0;0;0;0;0;0;0;0;0;Refrigerador 3560-S 337Lts No Frost;LINEA BLANCA
10649162;;F;55;CHILENO;;Boomers;LOS ANGELES                   ;BIO BIO;0;0;0;0;0;0;0;0;0;Refrigerador 322Lts No Frost BF DB60S;LINEA BLANCA
13948848;Soltero;M;41;CHILENO;;X;RENCA                         ;METROPOLITANA;0;0;0;0;0;0;0;0;0;Secadora Ropa MSV-90 9K Blanca Ventilacion;LINEA BLANCA
19711129;;F;24;CHILENO;;Z;CALBUCO;LOS LAGOS;0;0;0;0;0;0;0;0;0;Lavadora WA80H4200SW/ZS 8Kg Blanca;LINEA BLANCA
7928918;;F;67;CHILENO;;Boomers;OVALLE                        ;COQUIMBO;0;0;0;0;0;0;0;0;0;Cocina CMC20AXX 4P Inox;LINEA BLANCA
7783695;;F;63;CHILENO;;Boomers;PUERTO MONTT                  ;LOS LAGOS;0;0;0;0;0;0;0;0;0;Lavadora Efficace SZG 17,5Kg Silver;LINEA BLANCA
13449300;Casado;F;43;CHILENO;INTERPRETE DE IDIOMAS;X;PROVIDENCIA                   ;METROPOLITANA;0;0;0;0;0;0;0;0;0;Lavadora Superior WW10J6410CW1ZS 10Kg;LINEA BLANCA
19812274;;F;24;CHILENO;;Z;PROVIDENCIA                   ;METROPOLITANA;0;0;0;0;0;0;0;0;0;Centrifuga Primma 5B 5,5Kilos;LINEA BLANCA
17527208;;F;31;CHILENO;;Millenial;PROVIDENCIA                   ;METROPOLITANA;0;0;0;0;0;0;0;0;0;Refrigerador 244Lts Frio Directo Progress 3100;LINEA BLANCA
18270631;;F;29;CHILENO;;Millenial;PROVIDENCIA                   ;METROPOLITANA;0;0;0;0;0;0;0;0;0;SECADORA SR-10 8KG GRIS SINDELEN;LINEA BLANCA
25747888;Soltero;M;28;PERUANO;;Extranjero;"";"";0;0;0;0;0;0;0;0;0;Lavadora WA90H4400SW/ZS 9Kg Blanca;LINEA BLANCA
18162872;;F;29;CHILENO;;Millenial;PROVIDENCIA                   ;METROPOLITANA;0;0;0;0;0;0;0;0;0;Cocina CH-9950NG-1 6P Negro;LINEA BLANCA
19931521;;M;24;CHILENO;;Silencioso;PROVIDENCIA                   ;METROPOLITANA;0;0;0;0;0;0;0;0;0;Lavadora Premium Care 20SZ 20Kg Silver;LINEA BLANCA
6822135;Viudo;M;68;CHILENO;AGRONOMO;Silencioso;PROVIDENCIA                   ;METROPOLITANA;0;0;0;0;0;0;0;0;0;Lavadora MLS-090GE04N 9Kg Gris;LINEA BLANCA
8798512;;F;47;CHILENO;;X;PUNTA ARENAS                  ;MAGALLANES;0;0;0;0;0;0;0;0;0;Refrigerador 400Lts No Frost RMP400FZUC Dispen;LINEA BLANCA
16613294;;F;32;CHILENO;;Millenial;HUALPEN;BIO BIO;0;0;0;0;0;0;0;0;0;ENCIMERA XNG FEIN PRO FF GL 4P ALBIN TROTTER;LINEA BLANCA
18913194;;M;43;CHILENO;;Silencioso;PROVIDENCIA                   ;METROPOLITANA;0;0;0;0;0;0;0;0;0;Frigobar LFB-90N 98Lts Retro Design;LINEA BLANCA
16786773;;M;34;CHILENO;;Millenial;PROVIDENCIA                   ;METROPOLITANA;0;0;0;0;0;0;0;0;0;Secadora Ropa Reverplus 6470 7Kg Gris Ventilacio;LINEA BLANCA
15717919;;M;38;CHILENO;;X;PROVIDENCIA                   ;METROPOLITANA;0;0;0;0;0;0;0;0;0;Lavadora WA80H4200SW/ZS 8Kg Blanca;LINEA BLANCA
13107661;;F;45;CHILENO;;X;PENCO                         ;BIO BIO;0;0;0;0;0;0;0;0;0;Lavadora LMA0920WGCL0 9,5Kg Gris;LINEA BLANCA
11511200;;F;51;CHILENO;;X;IQUIQUE                       ;TARAPACA;0;0;0;0;0;0;0;0;0;Lavadora Efficace BZG 15,5Kg Blanca;LINEA BLANCA
19793845;;M;24;CHILENO;;Z;PROVIDENCIA                   ;METROPOLITANA;0;0;0;0;0;0;0;0;0;Lavadora WA80H4200SW/ZS 8Kg Blanca;LINEA BLANCA
15717792;;F;38;CHILENO;;X;PROVIDENCIA                   ;METROPOLITANA;0;0;0;0;0;0;0;0;0;Lavadora Efficace SZG 17,5Kg Silver;LINEA BLANCA
15431213;Soltero;M;40;CHILENO;;Silencioso;N/D;N/D;0;0;0;0;0;0;0;0;0;ENCIMERA A GAS 4 PLATOS CEG-4600 INOX;LINEA BLANCA
14548135;;F;43;CHILENO;;X;PROVIDENCIA                   ;METROPOLITANA;0;0;0;0;0;0;0;0;0;ENCIMERA XNG FEIN PRO FF GL 4P ALBIN TROTTER;LINEA BLANCA
6438384;;M;69;CHILENO;;Silencioso;OVALLE                        ;COQUIMBO;0;0;0;0;0;0;0;0;0;Cocina F-2808 4P;LINEA BLANCA
19364960;Soltero;F;26;CHILENO;;Z;PROVIDENCIA                   ;METROPOLITANA;0;0;0;0;0;0;0;0;0;CAMPANA ESSENTIAL 601 INOX ALBIN TROTTER;LINEA BLANCA
6300661;;M;72;CHILENO;;Silencioso;PROVIDENCIA                   ;METROPOLITANA;0;0;0;0;0;0;0;0;0;Refrigerador 256Lts No Frost Advantage 5200;LINEA BLANCA
15771768;;M;37;CHILENO;;Millenial;RENCA                         ;METROPOLITANA;0;0;0;0;0;0;0;0;0;Refrigerador RMN222PXLRS0 222LTS No Frost;LINEA BLANCA
19384483;;F;25;CHILENO;;Z;LA PINTANA                    ;METROPOLITANA;0;0;0;0;0;0;0;0;0;Secadora Ropa MSV-90 9K Blanca Ventilacion;LINEA BLANCA
17255753;Soltero;F;32;CHILENO;;Silencioso;PROVIDENCIA                   ;METROPOLITANA;0;0;0;0;0;0;0;0;0;Refrigerador 525Lts Side by Side SFX500;LINEA BLANCA
9879512;;M;57;CHILENO;;Boomers;SAN BERNARDO                  ;METROPOLITANA;0;0;0;0;0;0;0;0;0;Cocina CH-9500 NG 4P;LINEA BLANCA
13091271;;F;46;CHILENO;;X;SAN RAMON                     ;METROPOLITANA;0;0;0;0;0;0;0;0;0;Secadora 8 Kg Blanca WKR-08K1W3;LINEA BLANCA
13344804;;M;51;CHILENO;;X;COLTAUCO                      ;L.G.B.OÂ´HIGGINS;0;0;0;0;0;0;0;0;0;Cocina F-2808 4P;LINEA BLANCA
26454287;;M;34;EXTRANJERO - NO INFORMA NACIONALIDAD;;Extranjero;"";"";0;0;0;0;0;0;0;0;0;TERMO ELECTRICO TERMO E RH 125L 220V P;LINEA BLANCA
20064353;;F;23;CHILENO;;Z;PUERTO MONTT                  ;LOS LAGOS;0;0;0;0;0;0;0;0;0;Lavadora MLS-080BE04N 8Kg Blanca;LINEA BLANCA
7686587;;F;65;CHILENO;;Boomers;TEMUCO                        ;ARAUCANIA;0;0;0;0;0;0;0;0;0;Lavadora WA90H4400SW/ZS 9Kg Blanca;LINEA BLANCA
16539072;;F;36;CHILENO;;Millenial;N/D;N/D;0;0;0;0;0;0;0;0;0;Lavadora WT19DSBP 19Kg Silver;LINEA BLANCA
18010069;Soltero;F;30;CHILENO;TECNICO DE NIVEL MEDIO EN ATENCION DE ENFERMERIA;Millenial;PUNITAQUI                     ;COQUIMBO;0;0;0;0;0;0;0;0;0;Lavadora/Centrifuga LC4550 4,5Kg Blanca;LINEA BLANCA
13017787;;F;46;CHILENO;;X;PROVIDENCIA                   ;METROPOLITANA;0;0;0;0;0;0;0;0;0;Lavadora Efficace BZG 15,5Kg Blanca;LINEA BLANCA
22709075;;M;43;PERUANO;;Extranjero;PUERTO MONTT                  ;LOS LAGOS;0;0;0;0;0;0;0;0;0;Cocina Diva 920 5P;LINEA BLANCA
19319698;Soltero;F;26;CHILENO;;Silencioso;PROVIDENCIA                   ;METROPOLITANA;0;0;0;0;0;0;0;0;0;Refrigerador RMN222PXLRS0 222LTS No Frost;LINEA BLANCA
15566183;;M;39;CHILENO;;X;"";"";0;0;0;0;0;0;0;0;0;Freezer Horizontal 248 Lts Blanco FF-255;LINEA BLANCA
7551716;;F;68;CHILENO;;Boomers;PROVIDENCIA                   ;METROPOLITANA;0;0;0;0;0;0;0;0;0;Lavadora Impressive 16SZ 16Kg Silver;LINEA BLANCA
16131997;;F;36;CHILENO;;Silencioso;PROVIDENCIA                   ;METROPOLITANA;0;0;0;0;0;0;0;0;0;Lavadora/Centrifuga LC4550 4,5Kg Blanca;LINEA BLANCA
17470592;;M;31;CHILENO;;Millenial;N/D;N/D;0;0;0;0;0;0;0;0;0;Refrigerador 527Lts Side by Side MRSBS5300G689WE;LINEA BLANCA
19669968;;F;25;CHILENO;;Silencioso;PROVIDENCIA                   ;METROPOLITANA;0;0;0;0;0;0;0;0;0;HORNO EMPOTRABLE 2250W 57LTS HE-7220R NEGRO;LINEA BLANCA
17595680;;F;31;CHILENO;;Millenial;N/D;N/D;0;0;0;0;0;0;0;0;0;Lavadora MLS-160BSC03T 16Kg Blanca;LINEA BLANCA
15734600;;F;38;CHILENO;;Silencioso;PROVIDENCIA                   ;METROPOLITANA;0;0;0;0;0;0;0;0;0;COCINA CH-5700SI 4P;LINEA BLANCA
25882317;;M;29;BOLIVIANO;;Extranjero;CALAMA                        ;ANTOFAGASTA;0;0;0;0;0;0;0;0;0;FRIGOBAR 93 LTS MFB-930S121LN;LINEA BLANCA
20238662;;F;23;CHILENO;;Z;CARTAGENA                     ;VALPARAISO;0;0;0;0;0;0;0;0;0;Cocina 785FX 4P;LINEA BLANCA
17210863;;F;32;CHILENO;;Millenial;PROVIDENCIA                   ;METROPOLITANA;0;0;0;0;0;0;0;0;0;Lavadora MLS-160BSC03T 16Kg Blanca;LINEA BLANCA
16545544;;M;35;CHILENO;;Millenial;N/D;N/D;0;0;0;0;0;0;0;0;0;Secadora Ropa MSV-90 9K Blanca Ventilacion;LINEA BLANCA
18267788;Casado;M;29;CHILENO;;Millenial;PROVIDENCIA                   ;METROPOLITANA;0;0;0;0;0;0;0;0;0;Refrigerador 260Lts BF Frio Direc MRFI2660SR346W;LINEA BLANCA
11168716;;F;54;CHILENO;;Boomers;PROVIDENCIA                   ;METROPOLITANA;0;0;0;0;0;0;0;0;0;Lavadora/Centrifuga LC4550 4,5Kg Blanca;LINEA BLANCA
8472725;;M;63;CHILENO;;Boomers;LOTA                          ;BIO BIO;0;0;0;0;0;0;0;0;0;Refrigerador 527Lts Side by Side MRSBS5300G689WE;LINEA BLANCA
10791247;Casado;M;55;CHILENO;;Boomers;RENCA                         ;METROPOLITANA;0;0;0;0;0;0;0;0;0;Lavadora WA90H4400SW/ZS 9Kg Blanca;LINEA BLANCA
20041025;;M;23;CHILENO;;Z;PROVIDENCIA                   ;METROPOLITANA;0;0;0;0;0;0;0;0;0;Cocina 56DXQ 4P Doble Horno;LINEA BLANCA
16420831;;F;35;CHILENO;;Silencioso;PROVIDENCIA                   ;METROPOLITANA;0;0;0;0;0;0;0;0;0;Refrigerador 254Lts No Frost GT29WPPDC;LINEA BLANCA
7705913;Divorciado;F;62;CHILENO;;Boomers;RENCA                         ;METROPOLITANA;0;0;0;0;0;0;0;0;0;Lavadora/Centrifuga LC4550 4,5Kg Blanca;LINEA BLANCA
17658939;;F;31;CHILENO;;Millenial;N/D;N/D;0;0;0;0;0;0;0;0;0;Refrigerador 260Lts BF Frio Direc MRFI2660SR346W;LINEA BLANCA
16474905;;F;35;CHILENO;;Millenial;VILLA ALEMANA;VALPARAISO;0;0;0;0;0;0;0;0;0;Secadora Ropa MSV-90 9K Blanca Ventilacion;LINEA BLANCA
19784002;;F;24;CHILENO;;Z;PROVIDENCIA                   ;METROPOLITANA;0;0;0;0;0;0;0;0;0;Cocina CMC20AXX 4P Inox;LINEA BLANCA
19267652;;F;26;CHILENO;;Z;PROVIDENCIA                   ;METROPOLITANA;0;0;0;0;0;0;0;0;0;Cocina 785FX 4P;LINEA BLANCA
10345229;;M;47;CHILENO;;X;PROVIDENCIA                   ;METROPOLITANA;0;0;0;0;0;0;0;0;0;Lavadora WT16DSBP 16Kg Silver;LINEA BLANCA
25685406;;M;36;VENEZOLANO;;Extranjero;N/D;N/D;0;0;0;0;0;0;0;0;0;Refrigerador 241Lts BF Frio Directo Nordik 415;LINEA BLANCA
6986350;;M;69;CHILENO;;Silencioso;RANCAGUA                      ;L.G.B.OÂ´HIGGINS;0;0;0;0;0;0;0;0;0;Lavadora Efficace SZG 15,5Kg Silver;LINEA BLANCA
11561530;;M;51;CHILENO;;X;TEMUCO                        ;ARAUCANIA;0;0;0;0;0;0;0;0;0;Freezer FDHM150BY1 150Lts Horizontal;LINEA BLANCA
16898377;;F;33;CHILENO;;Millenial;HUALPEN;BIO-BIO;0;0;0;0;0;0;0;0;0;Refrigerador 527Lts Side by Side MRSBS5300G689WE;LINEA BLANCA
18130173;Soltero;M;30;CHILENO;KINESIOLOGO;Millenial;PROVIDENCIA                   ;METROPOLITANA;0;0;0;0;0;0;0;0;0;Cocina Diva 920 5P;LINEA BLANCA
18944601;Soltero;M;26;CHILENO;;Z;PROVIDENCIA                   ;METROPOLITANA;0;0;0;0;0;0;0;0;0;Refrigerador 254Lts No Frost GT29WPPDC;LINEA BLANCA
18131816;;F;29;CHILENO;;Millenial;PROVIDENCIA                   ;METROPOLITANA;0;0;0;0;0;0;0;0;0;Refrigerador 241Lts BF Frio Directo Nordik 415;LINEA BLANCA
12203500;Casado;F;49;CHILENO;;X;PROVIDENCIA                   ;METROPOLITANA;0;0;0;0;0;0;0;0;0;Lavadora Semiautomatica Twister 5100 4Kg;LINEA BLANCA
22226890;;F;45;COLOMBIANO;;Extranjero;N/D;N/D;0;0;0;0;0;0;0;0;0;Refrigerador 244Lts Frio Directo Progress 3100;LINEA BLANCA
7814274;;M;64;CHILENO;;Boomers;CERRILLOS                     ;METROPOLITANA;0;0;0;0;0;0;0;0;0;Lavadora Semiautomatica LC-6550 6,5Kg;LINEA BLANCA
13434245;;M;44;CHILENO;;X;CONSTITUCION                  ;MAULE;0;0;0;0;0;0;0;0;0;Lavadora Secadora MLSF-1108BN05N 11Kg/8Kg Blanca;LINEA BLANCA
10605825;;F;54;CHILENO;;Boomers;RENCA                         ;METROPOLITANA;0;0;0;0;0;0;0;0;0;Lavadora MLS-160BSC03T 16Kg Blanca;LINEA BLANCA
7263736;;F;70;CHILENO;;Silencioso;CURICO                        ;MAULE;0;0;0;0;0;0;0;0;0;Lavadora Efficace SZG 15,5Kg Silver;LINEA BLANCA
8091285;;M;64;CHILENO;;Boomers;ALTO HOSPICIO;TARAPACA;0;0;0;0;0;0;0;0;0;Refrigerador 244Lts Frio Directo Progress 3100;LINEA BLANCA
18898514;Soltero;F;27;CHILENO;;Silencioso;PROVIDENCIA                   ;METROPOLITANA;0;0;0;0;0;0;0;0;0;Cocina 775X 4P;LINEA BLANCA
8726544;;F;63;CHILENO;;Boomers;GALVARINO                     ;ARAUCANIA;0;0;0;0;0;0;0;0;0;Cocina Nova CH9850NG 6P;LINEA BLANCA
13859103;;F;42;CHILENO;;X;CHILLAN                       ;BIO BIO;0;0;0;0;0;0;0;0;0;Lavadora MLS-140GSC03T 14Kg Gris;LINEA BLANCA
13612818;;F;42;CHILENO;;X;PROVIDENCIA                   ;METROPOLITANA;0;0;0;0;0;0;0;0;0;Refrigerador Side by Side RS65R5411M9/ZS 617Lts;LINEA BLANCA
18380753;;M;29;CHILENO;;Millenial;PROVIDENCIA                   ;METROPOLITANA;0;0;0;0;0;0;0;0;0;Cocina 755 S 4P;LINEA BLANCA
19842589;;F;24;CHILENO;;Silencioso;PROVIDENCIA                   ;METROPOLITANA;0;0;0;0;0;0;0;0;0;Lavadora superior MLS-110GE04N 11Kg;LINEA BLANCA
17261502;;F;33;CHILENO;;Millenial;SANTIAGO                      ;METROPOLITANA;0;0;0;0;0;0;0;0;0;Lavadora MLS-090GE04N 9Kg Gris;LINEA BLANCA
12662579;;F;48;CHILENO;;X;RENCA                         ;METROPOLITANA;0;0;0;0;0;0;0;0;0;Refrigerador 626Lt Side by Side GS65MPP1 APZPECL;LINEA BLANCA
9809913;;M;59;CHILENO;;Boomers;PROVIDENCIA                   ;METROPOLITANA;0;0;0;0;0;0;0;0;0;Cocina CMC5515GCH-1 4P;LINEA BLANCA
5740150;;M;74;CHILENO;;Silencioso;RENCA                         ;METROPOLITANA;0;0;0;0;0;0;0;0;0;Lavadora Efficace SZG 15,5Kg Silver;LINEA BLANCA
14110045;Soltero;F;41;CHILENO;KINESIOLOGO;X;RENCA                         ;METROPOLITANA;0;0;0;0;0;0;0;0;0;Lavadora MLS-160BSC03T 16Kg Blanca;LINEA BLANCA
16047217;;F;37;CHILENO;;Millenial;OSORNO                        ;LOS LAGOS;0;0;0;0;0;0;0;0;0;Refrigerador 260Lts BF Frio Direc MRFI2660SR346W;LINEA BLANCA
9152756;;M;60;CHILENO;;Boomers;INDEPENDENCIA                 ;METROPOLITANA;0;0;0;0;0;0;0;0;0;Refrigerador 254Lts No Frost GT29WPPDC;LINEA BLANCA
18784500;Soltero;F;27;CHILENO;ABOGADO;Silencioso;PROVIDENCIA                   ;METROPOLITANA;0;0;0;0;0;0;0;0;0;Cocina CH-9400 4P SILVER;LINEA BLANCA
12944813;;M;46;CHILENO;;X;PUNITAQUI                     ;COQUIMBO;0;0;0;0;0;0;0;0;0;Refrigerador 260Lts BF Frio Direc MRFI2660SR346W;LINEA BLANCA
27385502;;M;27;CHILENO;;Z;N/D;N/D;0;0;0;0;0;0;0;0;0;Freezer FDHM200BY1 200Lts Horizontal;LINEA BLANCA
4143447;;M;82;CHILENO;;Silencioso;VILLARICA                     ;ARAUCANIA;0;0;0;0;0;0;0;0;0;Freezer Horizontal M 150 142Lts;LINEA BLANCA
10041379;;F;60;CHILENO;;Silencioso;PROVIDENCIA                   ;METROPOLITANA;0;0;0;0;0;0;0;0;0;Lavavajillas Computer 9430 Inox 14 cubiertos;LINEA BLANCA
15648694;;F;38;CHILENO;;Millenial;PROVIDENCIA                   ;METROPOLITANA;0;0;0;0;0;0;0;0;0;Secadora Ropa MSV-90 9K Blanca Ventilacion;LINEA BLANCA
18937348;;F;26;CHILENO;;Silencioso;PADRE LAS CASAS               ;ARAUCANIA;0;0;0;0;0;0;0;0;0;Cocina MV 110 4 Platos;LINEA BLANCA
16344218;;M;35;CHILENO;;Millenial;PROVIDENCIA                   ;METROPOLITANA;0;0;0;0;0;0;0;0;0;Freezer Horizontal M 150 142Lts;LINEA BLANCA
6663641;;F;73;CHILENO;;Silencioso;RENCA                         ;METROPOLITANA;0;0;0;0;0;0;0;0;0;Refrigerador 260Lts BF Frio Direc MRFI2660SR346W;LINEA BLANCA
15009088;;F;39;CHILENO;;X;ARICA                         ;ARICA Y PARINACOTA;0;0;0;0;0;0;0;0;0;Refrigerador 252Lts No Frost MRFS-2700G333FW;LINEA BLANCA
14243712;;F;48;CHILENO;;X;RENCA                         ;METROPOLITANA;0;0;0;0;0;0;0;0;0;HORNO EMPOTRABLE HE-7200 INOX 2250W 57L SINDELEN;LINEA BLANCA
16801049;;F;34;CHILENO;;Millenial;LAMPA                         ;METROPOLITANA;0;0;0;0;0;0;0;0;0;Centrifuga Primma 5B 5,5Kilos;LINEA BLANCA
7001786;;F;69;CHILENO;;Silencioso;CATEMU                        ;VALPARAISO;0;0;0;0;0;0;0;0;0;Lavadora WA17T6260BW/ZS 17Kg Blanca;LINEA BLANCA
18429336;;M;29;CHILENO;;Millenial;CHILLAN                       ;BIO BIO;0;0;0;0;0;0;0;0;0;Lavadora WA13T5260BW/ZS 13Kg Blanca;LINEA BLANCA
10672231;;M;55;CHILENO;;Boomers;PUENTE ALTO                   ;METROPOLITANA;0;0;0;0;0;0;0;0;0;Cocina F-2525 4P;LINEA BLANCA
10331715;;F;52;CHILENO;;X;CHILLAN                       ;BIO BIO;0;0;0;0;0;0;0;0;0;Lavadora LMA0920WGCL0 9,5Kg Gris;LINEA BLANCA
17273284;;F;33;CHILENO;;Millenial;LLAILLAY                      ;VALPARAISO;0;0;0;0;0;0;0;0;0;Campana Cocina CA-610EBL 60Cms Blanca;LINEA BLANCA
25967556;;F;39;VENEZOLANO;;Extranjero;INDEPENDENCIA                 ;METROPOLITANA;0;0;0;0;0;0;0;0;0;Lavadora Secadora WD10J6410AW/ZS 10,5/6Kg Blanca;LINEA BLANCA
5828741;Viudo;F;75;CHILENO;;Silencioso;PROVIDENCIA                   ;METROPOLITANA;0;0;0;0;0;0;0;0;0;Refrigerador 244Lts Frio Directo Progress 3100;LINEA BLANCA
14449329;;F;42;CHILENO;;X;PROVIDENCIA                   ;METROPOLITANA;0;0;0;0;0;0;0;0;0;Lavadora Semiautomatica Twister 5100 4Kg;LINEA BLANCA
10242901;;M;53;CHILENO;;X;LOS LAGOS                     ;LOS LAGOS;0;0;0;0;0;0;0;0;0;Lavadora Efficace SZG 15,5Kg Silver;LINEA BLANCA
17329516;;M;33;CHILENO;;Silencioso;PROVIDENCIA                   ;METROPOLITANA;0;0;0;0;0;0;0;0;0;FREEZER Z400 HORIZONTAL FENSA;LINEA BLANCA
18397508;Soltero;F;28;CHILENO;;Millenial;PROVIDENCIA                   ;METROPOLITANA;0;0;0;0;0;0;0;0;0;ENCIMERA A GAS 4 PLATOS CEG-4600 INOX;LINEA BLANCA
7247874;Divorciado;F;68;CHILENO;;Boomers;PROVIDENCIA                   ;METROPOLITANA;0;0;0;0;0;0;0;0;0;Refrigerador 290Lts BF No Frost RB30N4020S8;LINEA BLANCA
12829110;;M;48;CHILENO;;X;N/D;N/D;0;0;0;0;0;0;0;0;0;Lavadora MLS-090GE04N 9Kg Gris;LINEA BLANCA
14432873;;M;51;CHILENO;;X;BUIN                          ;METROPOLITANA;0;0;0;0;0;0;0;0;0;Refrigerador 252Lts No Frost MRFS-2700G333FW;LINEA BLANCA
6647171;;M;71;CHILENO;;Silencioso;BUIN                          ;METROPOLITANA;0;0;0;0;0;0;0;0;0;Cocina CH-7400 4P;LINEA BLANCA
14069910;;F;40;CHILENO;;X;PROVIDENCIA                   ;METROPOLITANA;0;0;0;0;0;0;0;0;0;Freezer Horizontal M 150 142Lts;LINEA BLANCA
17668598;Soltero;M;30;CHILENO;;Millenial;PROVIDENCIA                   ;METROPOLITANA;0;0;0;0;0;0;0;0;0;Lavadora Secadora WD10WVC4S6 10,5/6Kg Blanca;LINEA BLANCA
7392534;Soltero;M;66;CHILENO;;Boomers;ISLA DE MAIPO                 ;METROPOLITANA;0;0;0;0;0;0;0;0;0;Cocina 755 S 4P;LINEA BLANCA
9938587;;F;56;CHILENO;;Boomers;LA FLORIDA                    ;METROPOLITANA;0;0;0;0;0;0;0;0;0;Lavadora WA90H4400SW/ZS 9Kg Blanca;LINEA BLANCA
8108707;;F;60;CHILENO;;Boomers;SAN ANTONIO                   ;VALPARAISO;0;0;0;0;0;0;0;0;0;Lavadora superior MLS-110GE04N 11Kg;LINEA BLANCA
17654684;Soltero;M;31;CHILENO;ABOGADO;Millenial;CALAMA                        ;ANTOFAGASTA;0;0;0;0;0;0;0;0;0;Refrigerador 400Lts No Frost RMP400FZUC Dispen;LINEA BLANCA
5972754;Viudo;F;74;CHILENO;;Millenial;PROVIDENCIA                   ;METROPOLITANA;0;0;0;0;0;0;0;0;0;Lavadora Efficace BZG 9,5Kg Blanca;LINEA BLANCA
17363817;;M;32;CHILENO;;Millenial;ANTOFAGASTA                   ;ANTOFAGASTA;0;0;0;0;0;0;0;0;0;Refrigerador 249Lts No Frost RMA250PHUG;LINEA BLANCA
8917629;;F;62;CHILENO;;Boomers;PROVIDENCIA                   ;METROPOLITANA;0;0;0;0;0;0;0;0;0;Cocina CH-7400 4P;LINEA BLANCA
17301372;Soltero;M;32;CHILENO;PROFESOR;Millenial;SAN FELIPE                    ;VALPARAISO;0;0;0;0;0;0;0;0;0;Refrigerador 244Lts Frio Directo Progress 3100;LINEA BLANCA
7036822;;M;64;CHILENO;;Boomers;GRANEROS                      ;L.G.B.OÂ´HIGGINS;0;0;0;0;0;0;0;0;0;Freezaer Vertical MFV 545B 165Lts;LINEA BLANCA
16623129;;M;35;CHILENO;;Millenial;N/D;N/D;0;0;0;0;0;0;0;0;0;Refrigerador 249Lts No Frost RMA250PHUG;LINEA BLANCA
12591145;;F;47;CHILENO;;X;TALCA                         ;MAULE;0;0;0;0;0;0;0;0;0;Freezer 99Lts MFH-1000B131CN Horizontal;LINEA BLANCA
16828869;;M;34;CHILENO;;Millenial;SANTA CRUZ                    ;L.G.B.OÂ´HIGGINS;0;0;0;0;0;0;0;0;0;FRIGOBAR 93 LTS MFB-930S121LN;LINEA BLANCA
15280411;;M;38;CHILENO;;X;N/D;N/D;0;0;0;0;0;0;0;0;0;Lavadora WT13WSBP 13Kg Blanca;LINEA BLANCA
6804040;Casado;M;66;CHILENO;;Boomers;PROVIDENCIA                   ;METROPOLITANA;0;0;0;0;0;0;0;0;0;Lavadora WA90H4400SW/ZS 9Kg Blanca;LINEA BLANCA
11696131;;F;50;CHILENO;;X;TEMUCO                        ;ARAUCANIA;0;0;0;0;0;0;0;0;0;Lavadora MLS-090GE04N 9Kg Gris;LINEA BLANCA
5742539;;M;72;CHILENO;;Silencioso;PUENTE ALTO                   ;METROPOLITANA;0;0;0;0;0;0;0;0;0;Lavadora Efficace SZG 15,5Kg Silver;LINEA BLANCA
12684662;;F;48;CHILENO;;X;COLINA                        ;METROPOLITANA;0;0;0;0;0;0;0;0;0;Cocina CH-9600RJ 4P;LINEA BLANCA
6471726;Casado;M;67;CHILENO;PROFESOR;Boomers;RENCA                         ;METROPOLITANA;0;0;0;0;0;0;0;0;0;Calefont 8Lts GL Essenetial ECO;LINEA BLANCA
17749951;Soltero;M;31;CHILENO;;Silencioso;PROVIDENCIA                   ;METROPOLITANA;0;0;0;0;0;0;0;0;0;REFRIGERADOR FD RD-2000 200 LT SILVER SIND;LINEA BLANCA
25345469;;F;34;HAITIANO;;Extranjero;CERRO NAVIA                   ;METROPOLITANA;0;0;0;0;0;0;0;0;0;Cocina CH-7400 4P;LINEA BLANCA
18607822;;M;28;CHILENO;;Millenial;PUENTE ALTO                   ;METROPOLITANA;0;0;0;0;0;0;0;0;0;Refrigerador 400Lts No Frost RMP400FZUC Dispen;LINEA BLANCA
8850540;Soltero;M;57;CHILENO;INGENIERO EN CONSTRUCCION;Boomers;PROVIDENCIA                   ;METROPOLITANA;0;0;0;0;0;0;0;0;0;Lavadora WA80H4200SW/ZS 8Kg Blanca;LINEA BLANCA
18482760;;F;28;CHILENO;;Millenial;PROVIDENCIA                   ;METROPOLITANA;0;0;0;0;0;0;0;0;0;Refrigerador GT32BPPDC 312Lts No Frost;LINEA BLANCA
18140993;;M;30;CHILENO;;Millenial;HUECHURABA                    ;METROPOLITANA;0;0;0;0;0;0;0;0;0;Refrigerador 256Lts No Frost Advantage 5200;LINEA BLANCA
13034394;;F;45;CHILENO;;X;PROVIDENCIA                   ;METROPOLITANA;0;0;0;0;0;0;0;0;0;SECADORA CONDENSACION UT CDM 9K15P;LINEA BLANCA
10644125;;F;41;CHILENO;;X;PANGUIPULLI                   ;LOS RIOS;0;0;0;0;0;0;0;0;0;Refrigerador 244Lts Frio Directo Progress 3100;LINEA BLANCA
8582094;;F;63;CHILENO;;Boomers;QUILLECO                      ;BIO BIO;0;0;0;0;0;0;0;0;0;Refrigerador Altus 1350W 342Lts No Frost;LINEA BLANCA
19780901;;F;27;CHILENO;;Z;PUDAHUEL                      ;METROPOLITANA;0;0;0;0;0;0;0;0;0;Lavadora WA80H4200SW/ZS 8Kg Blanca;LINEA BLANCA
11550104;;M;52;CHILENO;;X;PROVIDENCIA                   ;METROPOLITANA;0;0;0;0;0;0;0;0;0;Cocina Diva 920 5P;LINEA BLANCA
8788937;Viudo;M;60;CHILENO;;Boomers;MEJILLONES                    ;ANTOFAGASTA;0;0;0;0;0;0;0;0;0;Cocina Andes76HG0 6P Inox;LINEA BLANCA
9840929;;F;58;CHILENO;;Boomers;PROVIDENCIA                   ;METROPOLITANA;0;0;0;0;0;0;0;0;0;Lavadora WT13WSBP 13Kg Blanca;LINEA BLANCA
15004579;Casado;F;39;CHILENO;EDUCADOR DE PARVULO;X;SAN FELIPE                    ;VALPARAISO;0;0;0;0;0;0;0;0;0;FRIGOBAR 93 LTS MFB-930S121LN;LINEA BLANCA
17037145;;F;33;CHILENO;;Millenial;PROVIDENCIA                   ;METROPOLITANA;0;0;0;0;0;0;0;0;0;Cocina MV 120 4 Platos;LINEA BLANCA
9172284;;F;57;CHILENO;;Boomers;RENCA                         ;METROPOLITANA;0;0;0;0;0;0;0;0;0;CALEFON 13L MASTER TIRO FORZADO GL SPLENDID;LINEA BLANCA
20222629;;M;22;CHILENO;;Silencioso;PROVIDENCIA                   ;METROPOLITANA;0;0;0;0;0;0;0;0;0;ENCIMERA A GAS 4 PLATOS CEG-4600 INOX;LINEA BLANCA
17631065;;F;32;CHILENO;;Millenial;"";"";0;0;0;0;0;0;0;0;0;Freezer Horizonal SFH-101BL 99Lts;LINEA BLANCA
15063176;;M;40;CHILENO;;X;QUILLOTA                      ;VALPARAISO;0;0;0;0;0;0;0;0;0;Cocina F-2525 4P;LINEA BLANCA
12310857;Soltero;F;49;CHILENO;;X;COIHAIQUE                     ;AYSEN;0;0;0;0;0;0;0;0;0;Lavadora MLS-160BSC03T 16Kg Blanca;LINEA BLANCA
14227060;;M;41;CHILENO;;X;PROVIDENCIA                   ;METROPOLITANA;0;0;0;0;0;0;0;0;0;Secadora Ropa MSV-90 9K Blanca Ventilacion;LINEA BLANCA
6592258;;M;66;CHILENO;;Boomers;PROVIDENCIA                   ;METROPOLITANA;0;0;0;0;0;0;0;0;0;Encimera CE2-435I 2P Inox;LINEA BLANCA
6533877;;F;70;CHILENO;;Silencioso;FREIRE                        ;ARAUCANIA;0;0;0;0;0;0;0;0;0;Lavadora MLS-160BSC03T 16Kg Blanca;LINEA BLANCA
18631912;;M;28;CHILENO;;Millenial;RENCA                         ;METROPOLITANA;0;0;0;0;0;0;0;0;0;Lavadora MLS-160GC03I 16Kg Gris;LINEA BLANCA
11189267;;F;55;CHILENO;;Boomers;VILLA ALEMANA                 ;VALPARAISO;0;0;0;0;0;0;0;0;0;Refrigerador 244Lts Frio Directo Progress 3100;LINEA BLANCA
18462476;;F;29;CHILENO;;Millenial;ALGARROBO                     ;VALPARAISO;0;0;0;0;0;0;0;0;0;Lavadora MLS-090GE04N 9Kg Gris;LINEA BLANCA
14270909;;F;48;CHILENO;;X;CORONEL                       ;BIO BIO;0;0;0;0;0;0;0;0;0;Lavadora Brilliant SG 15Kg Silver;LINEA BLANCA
12816457;Soltero;F;47;CHILENO;INGENIERO INFORMATICO;X;PROVIDENCIA                   ;METROPOLITANA;0;0;0;0;0;0;0;0;0;Refrigerador 256Lts No Frost Advantage 5200;LINEA BLANCA
12012295;Soltero;F;49;CHILENO;CHEF;Silencioso;PROVIDENCIA                   ;METROPOLITANA;0;0;0;0;0;0;0;0;0;Lavadora WT13WSBP 13Kg Blanca;LINEA BLANCA
6098154;;F;72;CHILENO;;Silencioso;EL MONTE                      ;METROPOLITANA;0;0;0;0;0;0;0;0;0;Refrigerador 525Lts Side by Side SFX500;LINEA BLANCA
17749041;Soltero;M;31;CHILENO;INGENIERO EN CONSTRUCCION;Millenial;PROVIDENCIA                   ;METROPOLITANA;0;0;0;0;0;0;0;0;0;Lavadora Efficace BZG 15,5Kg Blanca;LINEA BLANCA
7588080;;F;67;CHILENO;;Boomers;COIHAIQUE                     ;AYSEN;0;0;0;0;0;0;0;0;0;Refrigerador 400Lts No Frost RMP400FZUC Dispen;LINEA BLANCA
18432186;Soltero;M;28;CHILENO;;Millenial;CHILLAN                       ;BIO BIO;0;0;0;0;0;0;0;0;0;Lavadora Efficace BZG 9,5Kg Blanca;LINEA BLANCA
14485200;;M;48;CHILENO;;X;RENCA                         ;METROPOLITANA;0;0;0;0;0;0;0;0;0;Refrigerador 260Lts BF Frio Direc MRFI2660SR346W;LINEA BLANCA
6455279;;M;70;CHILENO;;Silencioso;N/D;N/D;0;0;0;0;0;0;0;0;0;Refrigerador 260Lts BF Frio Direc MRFI2660SR346W;LINEA BLANCA
9650573;;F;60;CHILENO;;Boomers;RENCA                         ;METROPOLITANA;0;0;0;0;0;0;0;0;0;Cocina CMC20AXX 4P Inox;LINEA BLANCA
5459090;;M;77;CHILENO;;Silencioso;COPIAPO                       ;ATACAMA;0;0;0;0;0;0;0;0;0;Refrigerador 241Lts BF Frio Directo Nordik 415;LINEA BLANCA
19094165;;M;27;CHILENO;;Z;N/D;N/D;0;0;0;0;0;0;0;0;0;Refrigerador 262Lts No Frost MRFI-2760S349RW-DA;LINEA BLANCA
16618394;;F;34;CHILENO;;Silencioso;MAIPU                         ;METROPOLITANA;0;0;0;0;0;0;0;0;0;COCINA CH-5490NI 4P;LINEA BLANCA
4209910;;M;80;CHILENO;;Silencioso;LLAILLAY                      ;VALPARAISO;0;0;0;0;0;0;0;0;0;Lavadora Efficace SZG 17,5Kg Silver;LINEA BLANCA
16601723;;F;34;CHILENO;;Millenial;"";"";0;0;0;0;0;0;0;0;0;Freezer FDHM150BY1 150Lts Horizontal;LINEA BLANCA
8246053;;F;59;CHILENO;;Boomers;PANGUIPULLI                   ;LOS LAGOS;0;0;0;0;0;0;0;0;0;Lavadora MLS-090GE04N 9Kg Gris;LINEA BLANCA
10325636;;F;58;CHILENO;;Boomers;QUILPUE                       ;VALPARAISO;0;0;0;0;0;0;0;0;0;Cocina 76DXR Doble Horno;LINEA BLANCA
12948095;;F;45;CHILENO;;X;ZAPALLAR                      ;VALPARAISO;0;0;0;0;0;0;0;0;0;Lavadora Efficace SZG 19,5Kg Silver;LINEA BLANCA
24948874;;F;35;COLOMBIANO;;Extranjero;PROVIDENCIA                   ;METROPOLITANA;0;0;0;0;0;0;0;0;0;Lavadora WA80H4200SW/ZS 8Kg Blanca;LINEA BLANCA
9053173;;M;59;CHILENO;;Boomers;PROVIDENCIA                   ;METROPOLITANA;0;0;0;0;0;0;0;0;0;Calefon 7Lts GL Master;LINEA BLANCA
17863695;;F;32;CHILENO;;Millenial;PROVIDENCIA                   ;METROPOLITANA;0;0;0;0;0;0;0;0;0;Lavadora LMA0920WGCL0 9,5Kg Gris;LINEA BLANCA
18436702;;F;29;CHILENO;;Millenial;N/D;N/D;0;0;0;0;0;0;0;0;0;Refrigerador MRFI1800S234RN 180Lts BF Frio Direc;LINEA BLANCA
13000939;;M;46;CHILENO;;X;QUEMCHI                       ;LOS LAGOS;0;0;0;0;0;0;0;0;0;Refrigerador 244Lts Frio Directo Progress 3100;LINEA BLANCA
24821172;;F;58;COLOMBIANO;;Extranjero;N/D;N/D;0;0;0;0;0;0;0;0;0;Cocina CMC20AXX 4P Inox;LINEA BLANCA
10794820;Casado;M;56;CHILENO;AGROINDUSTRIA;Boomers;RENCA                         ;METROPOLITANA;0;0;0;0;0;0;0;0;0;Lavadora Semiautomatica Twister 5300 4Kg;LINEA BLANCA
18356493;;F;29;CHILENO;;Millenial;PROVIDENCIA                   ;METROPOLITANA;0;0;0;0;0;0;0;0;0;Refrigerador RDNF-2950IN 295Lts No Frost;LINEA BLANCA
15502178;;F;39;CHILENO;;X;SANTA CRUZ                    ;L.G.B.OÂ´HIGGINS;0;0;0;0;0;0;0;0;0;Lavadora MLS-090GE04N 9Kg Gris;LINEA BLANCA
7635454;Casado;F;63;CHILENO;PROFESOR;Boomers;ANTOFAGASTA                   ;ANTOFAGASTA;0;0;0;0;0;0;0;0;0;Cocina CH-7400 4P;LINEA BLANCA
16218937;Soltero;M;35;CHILENO;;Millenial;PROVIDENCIA                   ;METROPOLITANA;0;0;0;0;0;0;0;0;0;Lavadora MLS-090GE04N 9Kg Gris;LINEA BLANCA
5079527;;M;75;CHILENO;;Silencioso;LO PRADO                      ;METROPOLITANA;0;0;0;0;0;0;0;0;0;Lavadora Impressive 20SZ 20Kg Silver;LINEA BLANCA
17262649;;M;32;CHILENO;;Millenial;PROVIDENCIA                   ;METROPOLITANA;0;0;0;0;0;0;0;0;0;Lavadora WT19DSBP 19Kg Silver;LINEA BLANCA
7852209;;F;62;CHILENO;;Boomers;RENCA                         ;METROPOLITANA;0;0;0;0;0;0;0;0;0;Refrigerador 251Lts No Frost Altus 1250;LINEA BLANCA
17240151;;M;32;CHILENO;;Millenial;PROVIDENCIA                   ;METROPOLITANA;0;0;0;0;0;0;0;0;0;Lavadora Brilliant SG 15Kg Silver;LINEA BLANCA
8227868;;M;60;CHILENO;;Boomers;N/D;N/D;0;0;0;0;0;0;0;0;0;Refrigerador 244Lts Frio Directo Progress 3100;LINEA BLANCA
13016856;;F;48;CHILENO;;X;ANTOFAGASTA                   ;ANTOFAGASTA;0;0;0;0;0;0;0;0;0;Cocina CH-7400 4P;LINEA BLANCA
9482212;Casado;M;59;CHILENO;;Boomers;PUDAHUEL                      ;METROPOLITANA;0;0;0;0;0;0;0;0;0;Cocina CMC20AXX 4P Inox;LINEA BLANCA
7320718;;M;63;CHILENO;;Boomers;SANTIAGO                      ;METROPOLITANA;0;0;0;0;0;0;0;0;0;Refrigerador RT25FARADSP/ZS 260Lts No Frost;LINEA BLANCA
7000184;;M;67;CHILENO;;Boomers;COIHAIQUE                     ;AYSEN;0;0;0;0;0;0;0;0;0;Freezer FDHM150BY1 150Lts Horizontal;LINEA BLANCA
14192244;;F;41;CHILENO;;X;PUDAHUEL                      ;METROPOLITANA;0;0;0;0;0;0;0;0;0;Lavadora MLS-090GE04N 9Kg Gris;LINEA BLANCA
12360806;;M;49;CHILENO;;X;BULNES                        ;BIO BIO;0;0;0;0;0;0;0;0;0;Lavadora Efficace SZG 17,5Kg Silver;LINEA BLANCA
26350820;;F;42;VENEZOLANO;;Extranjero;N/D;N/D;0;0;0;0;0;0;0;0;0;Lavadora WA90H4400SW/ZS 9Kg Blanca;LINEA BLANCA
13005064;;M;48;CHILENO;;X;SAN BERNARDO                  ;METROPOLITANA;0;0;0;0;0;0;0;0;0;Calefon Neckar 10 litros GL;LINEA BLANCA
15476622;;M;39;CHILENO;;X;N/D;N/D;0;0;0;0;0;0;0;0;0;Refrigerador MBF60X 322Lts BF No Frost;LINEA BLANCA
8146847;;F;66;CHILENO;;Boomers;PUDAHUEL                      ;METROPOLITANA;0;0;0;0;0;0;0;0;0;Freezer Horizontal M100 99Lts;LINEA BLANCA
4712549;;M;76;CHILENO;;Silencioso;SAN JAVIER                    ;MAULE;0;0;0;0;0;0;0;0;0;Freezer 99Lts MFH-1000B131CN Horizontal;LINEA BLANCA
8396344;;F;51;CHILENO;;X;ANTOFAGASTA                   ;ANTOFAGASTA;0;0;0;0;0;0;0;0;0;Lavadora MLS-090GE04N 9Kg Gris;LINEA BLANCA
10552472;Casado;F;57;CHILENO;;Boomers;PROVIDENCIA                   ;METROPOLITANA;0;0;0;0;0;0;0;0;0;Refrigerador MBF60X 322Lts BF No Frost;LINEA BLANCA
13111230;;F;48;CHILENO;;X;PUENTE ALTO                   ;METROPOLITANA;0;0;0;0;0;0;0;0;0;Freezer Vertical M165V 165Lts;LINEA BLANCA
6494652;;F;70;CHILENO;;Silencioso;RENCA                         ;METROPOLITANA;0;0;0;0;0;0;0;0;0;Lavadora Efficace SZG 17,5Kg Silver;LINEA BLANCA
11424292;;M;53;CHILENO;;X;LOS LAGOS                     ;LOS LAGOS;0;0;0;0;0;0;0;0;0;Cocina CH-7400 4P;LINEA BLANCA
13573417;;F;43;CHILENO;;X;ROMERAL                       ;MAULE;0;0;0;0;0;0;0;0;0;Freezer 142Lts EFC14A5MNW Horizontal;LINEA BLANCA
4486534;;M;79;CHILENO;;Silencioso;CERRO NAVIA                   ;METROPOLITANA;0;0;0;0;0;0;0;0;0;Lavadora WT19DSBP 19Kg Silver;LINEA BLANCA
26264781;Soltero;F;26;PERUANO;;Extranjero;PROVIDENCIA                   ;METROPOLITANA;0;0;0;0;0;0;0;0;0;Lavadora MLS-090GE04N 9Kg Gris;LINEA BLANCA
25184065;;M;28;PERUANO;;Extranjero;N/D;N/D;0;0;0;0;0;0;0;0;0;Cocina F-2525 4P;LINEA BLANCA
13333373;;F;43;CHILENO;;Millenial;"";"";0;0;0;0;0;0;0;0;0;Cocina CH-7400 4P;LINEA BLANCA
7405328;;F;68;CHILENO;;Boomers;VINA DEL MAR                  ;VALPARAISO;0;0;0;0;0;0;0;0;0;Cocina CH-7400 4P;LINEA BLANCA
12458885;;F;49;CHILENO;;X;LO PRADO                      ;METROPOLITANA;0;0;0;0;0;0;0;0;0;Freezer 142Lts MFH-1430B186C Horizontal;LINEA BLANCA
7535622;;M;64;CHILENO;;Boomers;PROVIDENCIA                   ;METROPOLITANA;0;0;0;0;0;0;0;0;0;Lavadora WA90H4400SW/ZS 9Kg Blanca;LINEA BLANCA
9307101;;M;59;CHILENO;;Boomers;PUENTE ALTO                   ;METROPOLITANA;0;0;0;0;0;0;0;0;0;Refrigerador MBF60X 322Lts BF No Frost;LINEA BLANCA
15922878;;M;37;CHILENO;;Millenial;LAJA                          ;BIO BIO;0;0;0;0;0;0;0;0;0;Freezer 142Lts EFC14A5MNW Horizontal;LINEA BLANCA
10538924;;F;58;CHILENO;;Boomers;OLIVAR                        ;L.G.B.OÂ´HIGGINS;0;0;0;0;0;0;0;0;0;Refrigerador MBF60X 322Lts BF No Frost;LINEA BLANCA
8586976;Divorciado;F;64;CHILENO;;Boomers;ANTOFAGASTA                   ;ANTOFAGASTA;0;0;0;0;0;0;0;0;0;Lavadora Efficace BZG 9,5Kg Blanca;LINEA BLANCA
18952781;Soltero;F;26;CHILENO;;Z;LOS VILOS                     ;COQUIMBO;0;0;0;0;0;0;0;0;0;Cocina CH-8700IN 5P;LINEA BLANCA
5167520;;F;79;CHILENO;;Silencioso;ISLA DE MAIPO                 ;METROPOLITANA;0;0;0;0;0;0;0;0;0;Lavadora WA90H4400SW/ZS 9Kg Blanca;LINEA BLANCA
19085178;;M;26;CHILENO;;Z;OSORNO                        ;LOS LAGOS;0;0;0;0;0;0;0;0;0;ENCIMERA CE4-600 INOX 4P SINDELEN;LINEA BLANCA
15049411;Soltero;F;39;CHILENO;;X;PROVIDENCIA                   ;METROPOLITANA;0;0;0;0;0;0;0;0;0;Lavadora Efficace SZG 15,5Kg Silver;LINEA BLANCA
12170765;;F;50;CHILENO;;X;TALTAL                        ;ANTOFAGASTA;0;0;0;0;0;0;0;0;0;Lavadora WT19DSBP 19Kg Silver;LINEA BLANCA
20184160;;F;23;CHILENO;;Z;PROVIDENCIA                   ;METROPOLITANA;0;0;0;0;0;0;0;0;0;Campana Cocina CA-610EBL 60Cms Blanca;LINEA BLANCA
10818667;Casado;M;55;CHILENO;;Boomers;NANCAGUA                      ;L.G.B.OÂ´HIGGINS;0;0;0;0;0;0;0;0;0;Cocina 785FX 4P;LINEA BLANCA
13417278;;F;44;CHILENO;;X;RENCA                         ;METROPOLITANA;0;0;0;0;0;0;0;0;0;Freezer FDHM150BY1 150Lts Horizontal;LINEA BLANCA
9794239;;F;59;CHILENO;;Boomers;MAIPU                         ;METROPOLITANA;0;0;0;0;0;0;0;0;0;Cocina CMC20AXX 4P Inox;LINEA BLANCA
8387074;;M;64;CHILENO;;Boomers;TEMUCO                        ;ARAUCANIA;0;0;0;0;0;0;0;0;0;Freezer 99Lts MFH-1000B131CN Horizontal;LINEA BLANCA
15224430;Casado;F;39;CHILENO;SECRETARIA;X;PROVIDENCIA                   ;METROPOLITANA;0;0;0;0;0;0;0;0;0;Refrigerador 244Lts Frio Directo Progress 3100;LINEA BLANCA
9660584;;F;60;CHILENO;;Boomers;N/D;N/D;0;0;0;0;0;0;0;0;0;Freezer 99Lts MFH-1000B131CN Horizontal;LINEA BLANCA
17763088;;M;31;CHILENO;;Millenial;PROVIDENCIA                   ;METROPOLITANA;0;0;0;0;0;0;0;0;0;Refrigerador 244Lts Frio Directo Progress 3100;LINEA BLANCA
17271224;Soltero;M;32;CHILENO;;Silencioso;PROVIDENCIA                   ;METROPOLITANA;0;0;0;0;0;0;0;0;0;Refrigerador 244Lts Frio Directo Progress 3100;LINEA BLANCA
15696222;;M;37;CHILENO;;Millenial;VALLENAR;ATACAMA;0;0;0;0;0;0;0;0;0;Refrigerador 244Lts Frio Directo Progress 3100;LINEA BLANCA
11362115;;F;52;CHILENO;;X;CERRILLOS                     ;METROPOLITANA;0;0;0;0;0;0;0;0;0;Lavadora Superior WA15T5260BY/ZS 15 Kg;LINEA BLANCA
15401747;;F;40;CHILENO;;X;TALAGANTE                     ;METROPOLITANA;0;0;0;0;0;0;0;0;0;Freezer 99Lts MFH-1000B131CN Horizontal;LINEA BLANCA
18897830;;M;27;CHILENO;;Millenial;"";"";0;0;0;0;0;0;0;0;0;Lavadora WT16DSBP 16Kg Silver;LINEA BLANCA
17382256;Soltero;F;32;CHILENO;PROFESOR;Millenial;CHILLAN                       ;BIO BIO;0;0;0;0;0;0;0;0;0;Lavadora Efficace SZG 15,5Kg Silver;LINEA BLANCA
17249123;;F;33;CHILENO;;Millenial;N/D;N/D;0;0;0;0;0;0;0;0;0;Freezer Horizontal M100 99Lts;LINEA BLANCA
7008072;Casado;M;69;CHILENO;;Silencioso;RANCAGUA                      ;L.G.B.OÂ´HIGGINS;0;0;0;0;0;0;0;0;0;Secadora Ropa Reverplus 6470 7Kg Gris Ventilacio;LINEA BLANCA
13326693;;F;44;CHILENO;;X;VINA DEL MAR                  ;VALPARAISO;0;0;0;0;0;0;0;0;0;Cocina MV 110 4 Platos;LINEA BLANCA
11259335;;F;54;CHILENO;;X;PARRAL                        ;MAULE;0;0;0;0;0;0;0;0;0;Lavadora WA90H4400SW/ZS 9Kg Blanca;LINEA BLANCA
17792866;;M;31;CHILENO;;Millenial;PROVIDENCIA                   ;METROPOLITANA;0;0;0;0;0;0;0;0;0;Lavadora Efficace SZG 17,5Kg Silver;LINEA BLANCA
9802304;;F;60;CHILENO;;Boomers;PROVIDENCIA                   ;METROPOLITANA;0;0;0;0;0;0;0;0;0;Refrigerador 244Lts Frio Directo Progress 3100;LINEA BLANCA
8415385;;F;64;CHILENO;;Boomers;CURANILAHUE                   ;BIO BIO;0;0;0;0;0;0;0;0;0;Refrigerador 260Lts BF Frio Direc MRFI2660SR346W;LINEA BLANCA
9360554;;F;58;CHILENO;;Boomers;ANTOFAGASTA                   ;ANTOFAGASTA;0;0;0;0;0;0;0;0;0;Cocina CH-7400 4P;LINEA BLANCA
13249724;;M;45;CHILENO;;X;LA PINTANA                    ;METROPOLITANA;0;0;0;0;0;0;0;0;0;Cocina CH-7400 4P;LINEA BLANCA
18162265;;F;30;CHILENO;;Millenial;SAN ANTONIO                   ;VALPARAISO;0;0;0;0;0;0;0;0;0;Calefon Neckar 10 litros GL;LINEA BLANCA
18104772;;F;30;CHILENO;;Silencioso;RANCAGUA                      ;L.G.B.OÂ´HIGGINS;0;0;0;0;0;0;0;0;0;Lavadora Impressive 20SZ 20Kg Silver;LINEA BLANCA
7305341;;F;63;CHILENO;;Boomers;PROVIDENCIA                   ;METROPOLITANA;0;0;0;0;0;0;0;0;0;Cocina 56DXQ 4P Doble Horno;LINEA BLANCA
14403137;;M;51;CHILENO;;X;YUMBEL                        ;BIO BIO;0;0;0;0;0;0;0;0;0;Refrigerador 241Lts BF Frio Directo Nordik 415;LINEA BLANCA
10769736;Casado;F;53;CHILENO;;X;RENCA                         ;METROPOLITANA;0;0;0;0;0;0;0;0;0;Lavadora WT19DSBP 19Kg Silver;LINEA BLANCA
15564390;;F;40;CHILENO;;X;N/D;N/D;0;0;0;0;0;0;0;0;0;Cocina CH-7400 4P;LINEA BLANCA
17433675;Soltero;F;32;CHILENO;PSICOPEDAGOGO;Millenial;PROVIDENCIA                   ;METROPOLITANA;0;0;0;0;0;0;0;0;0;Calefon Vitality G/L 8Lts;LINEA BLANCA
26752385;;F;34;CUBANO;;Extranjero;VINA DEL MAR                  ;VALPARAISO;1259990;2;1;0;0;0;2;1;1259990;MOTO SCOOTER TAKASAKI TY125T-36D COLOR BLANCO;MOTOCICLETAS
26909601;;M;26;EXTRANJERO - NO INFORMA NACIONALIDAD;;Extranjero;CURICO                        ;MAULE;0;0;0;0;0;0;0;0;0;MOTO TK150GY TAKASAKI DUAL ROJO;MOTOCICLETAS
16881691;;M;34;CHILENO;;Millenial;OLIVAR                        ;L.G.B.OÂ´HIGGINS;0;0;0;0;0;0;0;0;0;SCOOTER TAKASAKI SY150T-28 COLOR GRIS;MOTOCICLETAS
16031687;;F;37;CHILENO;;X;SAN RAMON                     ;METROPOLITANA;1375380;4;1;0;0;0;4;1;1375380;Consola PlayStation 5 con Disco (Internacional);VIDEO JUEGOS
11905571;;M;50;CHILENO;;X;RENCA                         ;METROPOLITANA;486980;3;1;0;0;0;3;1;486980;Consola PlayStation 4 500GB;VIDEO JUEGOS
13315527;Soltero;M;44;CHILENO;TECNICO DE NIVEL SUPERIOR PARAMEDICO;X;RENCA                         ;METROPOLITANA;33980;2;1;2;1;33980;0;0;0;JUEGO SWITCH Mario Kart 8 Deluxe;VIDEO JUEGOS
16675175;Soltero;M;34;CHILENO;;Millenial;LOS ANGELES;BIO-BIO;300970;3;2;2;1;225980;1;1;74990;PS5 PULSE 3D HEADSET;VIDEO JUEGOS
18130939;;F;29;CHILENO;;Millenial;"";"";429990;1;1;0;0;0;1;1;429990;Consola PlayStation 4 500GB;VIDEO JUEGOS
5770224;;F;76;CHILENO;;Silencioso;LINARES                       ;MAULE;1030870;11;3;0;0;0;11;3;1030870;ACC CONTROL PS4 DUALSHOCK;VIDEO JUEGOS
5638536;;M;75;CHILENO;;Silencioso;"";"";349120;5;3;0;0;0;5;3;349120;CONTROL PS4 Midnight Blue;VIDEO JUEGOS
16377554;;F;35;CHILENO;;Millenial;LA CISTERNA;METROPOLITANA;68970;3;1;3;1;68970;0;0;0;RATCHET CLANK RIFT APART - LATAM PS5;VIDEO JUEGOS
16493949;;M;39;CHILENO;;X;PROVIDENCIA                   ;METROPOLITANA;687970;3;1;3;1;687970;0;0;0;Consola PlayStation 5 con Disco;VIDEO JUEGOS
13974773;Casado;F;41;CHILENO;PROFESOR;Millenial;"";"";701470;3;1;3;1;701470;0;0;0;Consola PlayStation 5 con Disco (Internacional);VIDEO JUEGOS
15700970;Soltero;F;38;CHILENO;MATRONA;X;PROVIDENCIA                   ;METROPOLITANA;766970;3;1;3;1;766970;0;0;0;Consola PlayStation 5 con Disco (Internacional);VIDEO JUEGOS
16190968;Soltero;M;37;CHILENO;;Millenial;PROVIDENCIA                   ;METROPOLITANA;59990;1;1;1;1;59990;0;0;0;ACC CONTROL PS4 DUALSHOCK;VIDEO JUEGOS
15355969;;F;39;CHILENO;;X;LA PINTANA                    ;METROPOLITANA;503230;3;2;0;0;0;3;2;503230;Consola PlayStation 4 500GB;VIDEO JUEGOS
13717183;Casado;M;42;CHILENO;INGENIERO DE EJECUCION INDUSTRIAL;X;PROVIDENCIA                   ;METROPOLITANA;-52990;-2;3;0;0;0;-2;3;-52990;CONTROL PS4 Midnight Blue;VIDEO JUEGOS
12768464;;F;47;CHILENO;;X;N/D;N/D;1189980;2;4;0;2;0;2;2;1189980;Consola PlayStation 5 con Disco (Internacional);VIDEO JUEGOS
10824710;;M;53;CHILENO;;X;SAN FERNANDO                  ;L.G.B.OÂ´HIGGINS;579970;5;3;0;0;0;5;3;579970;Consola PlayStation 4 500GB;VIDEO JUEGOS
18651084;;F;27;CHILENO;;Z;RANCAGUA                      ;L.G.B.OÂ´HIGGINS;899990;1;1;0;0;0;1;1;899990;Consola PlayStation 5 con Disco (Internacional);VIDEO JUEGOS
17196935;Soltero;M;29;CHILENO;TECNICO MECANICO;Millenial;PROVIDENCIA                   ;METROPOLITANA;19990;1;1;0;0;0;1;1;19990;JUEGO CYBERPUNK 2077 - LATAM PS4;VIDEO JUEGOS
15753491;;M;38;CHILENO;;Millenial;N/D;N/D;175960;4;2;4;2;175960;0;0;0;JUEGO SWITCH Mario Kart 8 Deluxe;VIDEO JUEGOS
14093492;;F;40;CHILENO;;X;N/D;N/D;1003980;2;1;2;1;1003980;0;0;0;Consola PlayStation 5 con Disco (Internacional);VIDEO JUEGOS
18627985;Soltero;F;28;CHILENO;;Millenial;PROVIDENCIA                   ;METROPOLITANA;55980;2;1;2;1;55980;0;0;0;Control inalambrico Xbox + cable USB-C Negro;VIDEO JUEGOS
14059182;;F;41;CHILENO;;X;TALCAHUANO                    ;BIO BIO;419680;4;2;4;2;419680;0;0;0;CONSOLA SWITCH LT2 NEON;VIDEO JUEGOS
25514376;;F;49;COLOMBIANO;;Extranjero;HUECHURABA                    ;METROPOLITANA;999990;1;1;0;0;0;1;1;999990;Consola PlayStation 5 con Disco (Internacional);VIDEO JUEGOS
14559849;;F;43;CHILENO;;X;N/D;N/D;579960;3;1;3;1;579960;0;0;0;CONSOLA SWITCH LT2 NEON;VIDEO JUEGOS
19930212;;M;24;CHILENO;;Z;N/D;N/D;41980;2;1;2;1;41980;0;0;0;JUEGO SWITCH Mario Kart 8 Deluxe;VIDEO JUEGOS
13722930;;F;43;CHILENO;;X;TALCA                         ;MAULE;37990;1;1;0;0;0;1;1;37990;JUEGO SWITCH Mario Kart 8 Deluxe;VIDEO JUEGOS
15010735;;F;42;CHILENO;;X;ALTO HOSPICIO;TARAPACA;37990;1;1;0;0;0;1;1;37990;JUEGO SWITCH Super Smash Bros Ultimate;VIDEO JUEGOS
17231985;;F;32;CHILENO;;Millenial;LA PINTANA                    ;METROPOLITANA;440230;3;2;0;0;0;3;2;440230;HW SWITCH 1 1 NEON LT2 BUNDLE BLACK FRIDAY;VIDEO JUEGOS
18661650;;M;28;CHILENO;;Millenial;PUDAHUEL;METROPOLITANA;63980;2;1;2;1;63980;0;0;0;CONTROL PS4 Midnight Blue;VIDEO JUEGOS
15885463;Soltero;M;37;CHILENO;;Millenial;PROVIDENCIA                   ;METROPOLITANA;24990;1;1;1;1;24990;0;0;0;JUEGO THE LAST OF US 2 - LATAM PS4;VIDEO JUEGOS
11902890;;M;50;CHILENO;;X;CORONEL                       ;BIO BIO;389990;2;1;0;0;0;2;1;389990;HW SWITCH 1 1 NEON LT2 BUNDLE BLACK FRIDAY;VIDEO JUEGOS
5826984;;F;75;CHILENO;;Silencioso;RENCA                         ;METROPOLITANA;934670;3;1;0;0;0;3;1;934670;Consola PlayStation 5 con Disco;VIDEO JUEGOS
15588785;;M;38;CHILENO;;X;N/D;N/D;58980;2;1;2;1;58980;0;0;0;Control Inalambrico Electric Volt;VIDEO JUEGOS
17268782;Soltero;M;32;CHILENO;KINESIOLOGO;Millenial;PROVIDENCIA                   ;METROPOLITANA;34980;2;1;2;1;34980;0;0;0;JUEGO SPIDER-MAN MILES MORALES - LATAM PS4;VIDEO JUEGOS
15441441;;M;39;CHILENO;;X;"";"";313980;2;1;2;1;313980;0;0;0;Consola Xbox Series S 512GB;VIDEO JUEGOS
13656959;;F;42;CHILENO;;X;CONCHALI                      ;METROPOLITANA;78230;3;3;0;0;0;3;3;78230;SW SWITCH ZELDA SKYWARD SWORD;VIDEO JUEGOS
16927327;;M;34;CHILENO;;Millenial;RENCA                         ;METROPOLITANA;0;0;0;0;0;0;0;0;0;JUEGO SWITCH Super Mario Maker 2;VIDEO JUEGOS
16979586;Soltero;M;32;CHILENO;;Millenial;PROVIDENCIA                   ;METROPOLITANA;0;0;0;0;0;0;0;0;0;CONTROL NINTENDO SWITCH PRO CONTROLLER;VIDEO JUEGOS
18378964;;M;28;CHILENO;;Millenial;PROVIDENCIA                   ;METROPOLITANA;0;0;0;0;0;0;0;0;0;ACC CONTROL PS4 DUALSHOCK;VIDEO JUEGOS
19953975;;M;24;CHILENO;;Z;PROVIDENCIA                   ;METROPOLITANA;0;0;0;0;0;0;0;0;0;JUEGO PS4 God OF War;VIDEO JUEGOS
16374438;Soltero;M;36;CHILENO;;Silencioso;PROVIDENCIA                   ;METROPOLITANA;0;0;0;0;0;0;0;0;0;Consola PlayStation 5 con Disco;VIDEO JUEGOS
14108804;;M;41;CHILENO;;X;ANTOFAGASTA                   ;ANTOFAGASTA;0;0;0;0;0;0;0;0;0;PS4 HW 1TB MEGA 15 - SPDMN GOTY, R C, HZDCE BNDL;VIDEO JUEGOS
19878111;;M;24;CHILENO;;Z;PROVIDENCIA                   ;METROPOLITANA;0;0;0;0;0;0;0;0;0;PS4 HW 1TB MEGA 15 - SPDMN GOTY, R C, HZDCE BNDL;VIDEO JUEGOS
16067173;Casado;M;37;CHILENO;INGENIERO CIVIL INFORMATICO;Silencioso;PROVIDENCIA                   ;METROPOLITANA;0;0;0;0;0;0;0;0;0;PS5 PULSE 3D HEADSET;VIDEO JUEGOS
14592574;;F;41;CHILENO;;X;EL BOSQUE                     ;METROPOLITANA;0;0;0;0;0;0;0;0;0;CONTROL PS4 CAMOUFLAGE;VIDEO JUEGOS
19855135;;M;24;CHILENO;;Z;PROVIDENCIA                   ;METROPOLITANA;0;0;0;0;0;0;0;0;0;Consola Series X;VIDEO JUEGOS
17839582;;F;31;CHILENO;;Millenial;PROVIDENCIA                   ;METROPOLITANA;0;0;0;0;0;0;0;0;0;PS4 SLIM 1TB MEGAPACK HIT 13;VIDEO JUEGOS
16405229;;M;36;CHILENO;;Millenial;"";"";0;0;0;0;0;0;0;0;0;Consola Xbox Series S 512GB;VIDEO JUEGOS
18489024;;M;29;CHILENO;;Extranjero;"";"";0;0;0;0;0;0;0;0;0;PS4 SLIM 1TB MEGAPACK HIT 13;VIDEO JUEGOS
18042698;Soltero;M;29;CHILENO;;Millenial;PROVIDENCIA                   ;METROPOLITANA;0;0;0;0;0;0;0;0;0;Control inalambrico Xbox + cable USB-C Negro;VIDEO JUEGOS
15839406;Soltero;M;37;CHILENO;ABOGADO;Millenial;PROVIDENCIA                   ;METROPOLITANA;0;0;0;0;0;0;0;0;0;CONSOLA Switch + Mario Kart 8 Deluxe (Digital) +;VIDEO JUEGOS
15114057;;M;40;CHILENO;;X;SAN FERNANDO                  ;L.G.B.OÂ´HIGGINS;0;0;0;0;0;0;0;0;0;PS4 SLIM 1TB MEGAPACK HIT 13;VIDEO JUEGOS
9281694;;M;61;CHILENO;;Boomers;TOCOPILLA                     ;ANTOFAGASTA;0;0;0;0;0;0;0;0;0;PS4 SLIM 1TB MEGAPACK HIT 13;VIDEO JUEGOS
15070070;Casado;M;39;CHILENO;INGENIERO ELECTRICO;X;RENCA                         ;METROPOLITANA;0;0;0;0;0;0;0;0;0;CONSOLA SWITCH LT2 NEON;VIDEO JUEGOS
14139523;;M;41;CHILENO;;X;MAIPU                         ;METROPOLITANA;0;0;0;0;0;0;0;0;0;PS4 SLIM 1TB MEGAPACK HIT 13;VIDEO JUEGOS
13351758;;F;44;CHILENO;;X;CURICO                        ;MAULE;0;0;0;0;0;0;0;0;0;CONSOLA PS4 1TB MEGA 6 3 Juegos 3M PS Plus;VIDEO JUEGOS
17434292;Soltero;F;32;CHILENO;;Millenial;PROVIDENCIA                   ;METROPOLITANA;0;0;0;0;0;0;0;0;0;ACC PRO CONTROLLER ICONIC MARIO EDITION;VIDEO JUEGOS
8447651;;F;63;CHILENO;;Boomers;QUILPUE                       ;VALPARAISO;0;0;0;0;0;0;0;0;0;CONSOLA SWITCH LITE YELLOW;VIDEO JUEGOS
15542639;;M;38;CHILENO;;X;RENCA                         ;METROPOLITANA;0;0;0;0;0;0;0;0;0;Control inalambrico + cable USB-C Negro;VIDEO JUEGOS
19764524;;F;24;CHILENO;;Z;PROVIDENCIA                   ;METROPOLITANA;0;0;0;0;0;0;0;0;0;CONSOLA PS4 PRO 1TB;VIDEO JUEGOS
10500548;;M;51;CHILENO;;X;PROVIDENCIA                   ;METROPOLITANA;0;0;0;0;0;0;0;0;0;JUEGO SWITCH Animal Crossing;VIDEO JUEGOS
14377589;;M;44;CHILENO;;X;QUILICURA                     ;METROPOLITANA;0;0;0;0;0;0;0;0;0;CONSOLA SWITCH LT2 NEON;VIDEO JUEGOS
7497868;;F;65;CHILENO;;Boomers;N/D;N/D;0;0;0;0;0;0;0;0;0;ACC CONTROL PS4 DUALSHOCK;VIDEO JUEGOS
16645301;Soltero;M;34;CHILENO;INGENIERO EN TELECOMUNICACIONES;Millenial;PROVIDENCIA                   ;METROPOLITANA;0;0;0;0;0;0;0;0;0;Consola PlayStation 5 con Disco;VIDEO JUEGOS
20671460;;F;21;CHILENO;;Z;PROVIDENCIA                   ;METROPOLITANA;0;0;0;0;0;0;0;0;0;CONSOLA SWITCH LITE TURQUOISE;VIDEO JUEGOS
7521247;Soltero;M;66;CHILENO;;Boomers;PROVIDENCIA                   ;METROPOLITANA;69990;1;1;0;0;0;1;1;69990;CHIMENEA ELECTRICA KIOTO 2000W KTE-1101;CLIMATIZACION
7651210;;F;69;CHILENO;;Silencioso;COIHAIQUE                     ;AYSEN;39980;2;2;0;0;0;2;2;39980;CALIENTACAMA KIOTO DIGITAL 1 PLAZA KTC-1005;CLIMATIZACION
17983583;Soltero;F;28;CHILENO;;Millenial;PROVIDENCIA                   ;METROPOLITANA;0;0;2;0;2;0;0;0;0;ESTUFA CUARZO KIOTO 800W KTE-011A;CLIMATIZACION
13700518;;F;48;CHILENO;;X;PROVIDENCIA                   ;METROPOLITANA;403180;8;3;0;0;0;8;3;403180;VENTILADOR SOBREMESA KF-16D;CLIMATIZACION
16535924;;F;34;CHILENO;;Millenial;MACUL                         ;METROPOLITANA;428950;5;4;0;0;0;5;4;428950;CHIMENEA ELECTRICA ROBLE NEGRA;CLIMATIZACION
11137580;;M;55;CHILENO;;Boomers;QUILLOTA                      ;VALPARAISO;6490;1;1;0;0;0;1;1;6490;ESTUFA CUARZO KIOTO 800W KTE-011A;CLIMATIZACION
7925818;;F;66;CHILENO;;Boomers;LINARES                       ;MAULE;149711;8;6;0;0;0;8;6;149711;ESTUFA CUARZO KIOTO 800W KTE-011A;CLIMATIZACION
15847891;;M;37;CHILENO;;Millenial;PUERTO MONTT                  ;LOS LAGOS;128960;4;6;1;1;29990;3;5;98970;CONVECTOR 750W DIGITAL;CLIMATIZACION
16651563;;F;35;CHILENO;;Z;"";"";53980;2;2;0;0;0;2;2;53980;CALIENTACAMA KIOTO DIGITAL 2 PLAZAS KTC-1006;CLIMATIZACION
6944002;;M;68;CHILENO;;Boomers;CHILLAN                       ;BIO BIO;6490;1;1;0;0;0;1;1;6490;ESTUFA CUARZO KIOTO 800W KTE-011A;CLIMATIZACION
6368573;;F;70;CHILENO;;Silencioso;NUNOA                         ;METROPOLITANA;9990;1;1;0;0;0;1;1;9990;ESTUFA CUARZO KIOTO 800W KTE-011A;CLIMATIZACION
6014979;;M;75;CHILENO;;Silencioso;MARIA PINTO                   ;METROPOLITANA;26960;4;2;0;0;0;4;2;26960;ESTUFA CUARZO KIOTO 800W KTE-011A;CLIMATIZACION
14560320;;F;47;CHILENO;;X;TIRUA                         ;BIO BIO;45980;2;2;0;0;0;2;2;45980;CALIENTACAMA KIOTO DIGITAL 2 PLAZAS KTC-1006;CLIMATIZACION
18028271;Soltero;F;30;CHILENO;;Millenial;PROVIDENCIA                   ;METROPOLITANA;9990;1;1;0;0;0;1;1;9990;ESTUFA CUARZO KIOTO 800W KTE-011A;CLIMATIZACION
11555708;;F;52;CHILENO;;X;PROVIDENCIA                   ;METROPOLITANA;38970;3;2;0;0;0;3;2;38970;CALIENTACAMA KIOTO DIGITAL 2 PLAZAS KTC-1006;CLIMATIZACION
4564880;;F;79;CHILENO;;Silencioso;LLAILLAY                      ;VALPARAISO;1014940;12;7;0;0;0;12;7;1014940;ESTUFA A GAS UT GRX-4200 15 KILOS;CLIMATIZACION
20402669;;M;22;CHILENO;;Z;TEMUCO;ARAUCANIA;188960;4;3;3;2;175970;1;1;12990;CALIENTACAMA KIOTO ANALOGO 1 PLAZA KTC-1004;CLIMATIZACION
12547291;;F;47;CHILENO;;X;SAN CARLOS                    ;BIO BIO;816440;6;4;0;0;0;6;4;816440;CALIENTACAMA KIOTO DIGITAL 2 PLAZAS KTC-1006;CLIMATIZACION
16964578;;F;33;CHILENO;;Millenial;PROVIDENCIA                   ;METROPOLITANA;229980;2;2;1;1;169990;1;1;59990;CHIMENEA ELECTRICA KIOTO 2000W KTE-1101;CLIMATIZACION
9809144;;F;60;CHILENO;;Boomers;COLBUN                        ;MAULE;1651280;10;6;0;0;0;10;6;1651280;ESTUFA CUARZO KIOTO 800W KTE-011A;CLIMATIZACION
10662063;;M;54;CHILENO;;X;LO BARNECHEA;METROPOLITANA;267030;7;2;0;0;0;7;2;267030;CHIMENEA ELECTRICA KIOTO 2000W KTE-1101;CLIMATIZACION
14536638;;M;46;CHILENO;;Millenial;N/D;N/D;17982;2;1;0;0;0;2;1;17982;ESTUFA CUARZO KIOTO 800W KTE-011A;CLIMATIZACION
15148535;;F;39;CHILENO;;X;PELLUHUE                      ;MAULE;911013;18;11;5;3;413950;13;8;497063;ESTUFA CUARZO KIOTO 800W KTE-011A;CLIMATIZACION
19056459;Soltero;F;27;CHILENO;;Z;MAIPU;METROPOLITANA;14990;1;1;1;1;14990;0;0;0;CALIENTACAMA KIOTO DIGITAL 1 PLAZA KTC-1005;CLIMATIZACION
12826237;Divorciado;F;47;CHILENO;CONTADOR AUDITOR;X;LAS CONDES                    ;METROPOLITANA;12980;2;1;2;1;12980;0;0;0;ESTUFA CUARZO KIOTO 800W KTE-011A;CLIMATIZACION
17372093;;F;32;CHILENO;;Millenial;"";"";6990;1;1;0;0;0;1;1;6990;ESTUFA CUARZO KIOTO 800W KTE-011A;CLIMATIZACION
7095065;Viudo;F;73;CHILENO;;Silencioso;RANCAGUA                      ;L.G.B.OÂ´HIGGINS;59990;1;1;0;0;0;1;1;59990;ESTUFA ELEC. FIBRA DE CARBONO NSB120K5 SILVER;CLIMATIZACION
17421596;;F;32;CHILENO;;Millenial;"";"";10990;1;3;1;3;10990;0;0;0;TERMOVENTILADOR KIOTO NEGRO 2000W KTE-1028N;CLIMATIZACION
15890486;;M;38;CHILENO;;Millenial;N/D;N/D;34990;1;1;0;0;0;1;1;34990;CALIENTACAMAS MANUAL 3N SG-5010 1PL;CLIMATIZACION
13600366;;F;42;CHILENO;;X;"";"";30960;4;3;3;2;23970;1;1;6990;TERMOVENTILADOR KIOTO NEGRO 2000W KTE-1028N;CLIMATIZACION
15802535;;F;37;CHILENO;;Millenial;OVALLE                        ;COQUIMBO;124980;4;2;0;0;0;4;2;124980;CALIENTACAMA KIOTO DIGITAL 2 PLAZAS KTC-1006;CLIMATIZACION
10609604;;F;47;CHILENO;;X;PENAFLOR                      ;METROPOLITANA;37960;4;2;4;2;37960;0;0;0;CALIENTACAMA KIOTO ANALOGO 1 PLAZA KTC-1004;CLIMATIZACION
17220917;;F;33;CHILENO;;Millenial;PROVIDENCIA                   ;METROPOLITANA;0;0;2;0;2;0;0;0;0;TERMOVENTILADOR KIOTO NEGRO 2000W KTE-1028N;CLIMATIZACION
8772356;Casado;F;57;CHILENO;;Boomers;PROVIDENCIA                   ;METROPOLITANA;19970;3;1;3;1;19970;0;0;0;TERMOVENTILADOR KIOTO BLANCO 2000W KTE-1028B;CLIMATIZACION
8047974;;F;63;CHILENO;;Boomers;RECOLETA                      ;METROPOLITANA;419960;4;3;0;0;0;4;3;419960;TERMOVENTILADOR KIOTO BLANCO 2000W KTE-1028B;CLIMATIZACION
13541164;;F;42;CHILENO;;X;LA LIGUA                      ;VALPARAISO;330950;5;4;0;0;0;5;4;330950;CHIMENEA ELECTRICA KIOTO 2000W KTE-1101;CLIMATIZACION
10827284;;M;55;CHILENO;;Boomers;PROVIDENCIA                   ;METROPOLITANA;69980;2;1;0;0;0;2;1;69980;CALIENTACAMA KIOTO DIGITAL 2 PLAZAS KTC-1006;CLIMATIZACION
15146857;;F;39;CHILENO;;X;CAUQUENES                     ;MAULE;508950;7;3;2;1;196980;5;2;311970;MINI OLEOELECTRICA KIOTO 500W NEGRO KTE-1081N;CLIMATIZACION
19314661;;F;26;CHILENO;;Z;PROVIDENCIA                   ;METROPOLITANA;645940;6;4;4;3;388960;2;1;256980;ESTUFA CUARZO KIOTO 800W KTE-011A;CLIMATIZACION
7666899;;F;63;CHILENO;;Boomers;LA FLORIDA                    ;METROPOLITANA;15980;2;2;2;2;15980;0;0;0;TERMOVENTILADOR KIOTO NEGRO 2000W KTE-1028N;CLIMATIZACION
5539783;;F;80;CHILENO;;Silencioso;SAN ESTEBAN                   ;VALPARAISO;43970;3;2;0;0;0;3;2;43970;CALIENTACAMA KIOTO ANALOGO 1 PLAZA KTC-1004;CLIMATIZACION
15356104;;M;39;CHILENO;;Silencioso;PROVIDENCIA                   ;METROPOLITANA;7990;1;1;1;1;7990;0;0;0;TERMOVENTILADOR KIOTO BLANCO 2000W KTE-1028B;CLIMATIZACION
18231139;;F;29;CHILENO;;Millenial;PROVIDENCIA                   ;METROPOLITANA;7990;1;1;1;1;7990;0;0;0;ESTUFA CUARZO KIOTO 800W KTE-011A;CLIMATIZACION
13902159;Casado;F;42;CHILENO;;X;RENCA                         ;METROPOLITANA;9990;1;3;0;0;0;1;3;9990;TERMOVENTILADOR KIOTO BLANCO 2000W KTE-1028B;CLIMATIZACION
26805982;;M;28;VENEZOLANO;;Extranjero;N/D;N/D;7990;1;1;1;1;7990;0;0;0;ESTUFA CUARZO KIOTO 800W KTE-011A;CLIMATIZACION
17750243;;F;32;CHILENO;;Millenial;PROVIDENCIA                   ;METROPOLITANA;21980;2;1;2;1;21980;0;0;0;CALIENTACAMA KIOTO ANALOGO 1 PLAZA KTC-1004;CLIMATIZACION
17966455;Soltero;M;34;CHILENO;;Millenial;CURACAVI;METROPOLITANA;23992;1;1;0;0;0;1;1;23992;CALIENTACAMA KIOTO DIGITAL 2 PLAZAS KTC-1006;CLIMATIZACION
15390802;Soltero;M;40;CHILENO;;X;"";"";40470;7;2;0;0;0;7;2;40470;TERMOVENTILADOR KIOTO NEGRO 2000W KTE-1028N;CLIMATIZACION
18213831;;M;29;CHILENO;;Millenial;MARIA PINTO                   ;METROPOLITANA;291960;4;4;0;0;0;4;4;291960;ESTUFA VITTALE-40 15K;CLIMATIZACION
8982377;;F;61;CHILENO;;Boomers;RENCA                         ;METROPOLITANA;10990;1;1;1;1;10990;0;0;0;CALIENTACAMA KIOTO ANALOGO 1 PLAZA KTC-1004;CLIMATIZACION
20258587;;F;25;CHILENO;;Extranjero;"";"";0;0;2;0;2;0;0;0;0;CALIENTACAMA KIOTO ANALOGO 1 PLAZA KTC-1004;CLIMATIZACION
15447852;;F;39;CHILENO;;X;PUENTE ALTO                   ;METROPOLITANA;0;0;2;0;2;0;0;0;0;CALIENTACAMA KIOTO DIGITAL 1 PLAZA KTC-1005;CLIMATIZACION
13780983;;F;41;CHILENO;;X;RENCA                         ;METROPOLITANA;9990;1;1;0;0;0;1;1;9990;TERMOVENTILADOR KIOTO BLANCO 2000W KTE-1028B;CLIMATIZACION
17343013;;F;33;CHILENO;;Millenial;CORONEL                       ;BIO BIO;65950;5;4;4;3;44960;1;1;20990;TERMOVENTILADOR KIOTO BLANCO 2000W KTE-1028B;CLIMATIZACION
6131190;;F;75;CHILENO;;Silencioso;RENCA                         ;METROPOLITANA;9990;1;1;1;1;9990;0;0;0;ESTUFA CUARZO KIOTO 800W KTE-011A;CLIMATIZACION
12459671;Casado;F;49;CHILENO;;X;PROVIDENCIA                   ;METROPOLITANA;15990;1;1;0;0;0;1;1;15990;ESTUFA ELECTRICA CUARZO KIOTO 1200W KTE 1033;CLIMATIZACION
17001139;;M;34;CHILENO;;Millenial;LA CISTERNA;METROPOLITANA;38970;3;1;3;1;38970;0;0;0;CALIENTACAMA KIOTO ANALOGO 1 PLAZA KTC-1004;CLIMATIZACION
18780775;;F;27;CHILENO;;Millenial;TALCA                         ;MAULE;7990;1;1;1;1;7990;0;0;0;TERMOVENTILADOR KIOTO NEGRO 2000W KTE-1028N;CLIMATIZACION
15104350;;F;40;CHILENO;;X;PROVIDENCIA                   ;METROPOLITANA;9990;1;1;0;0;0;1;1;9990;TERMOVENTILADOR KIOTO NEGRO 2000W KTE-1028N;CLIMATIZACION
12373590;;M;49;CHILENO;;Silencioso;PROVIDENCIA                   ;METROPOLITANA;10990;1;1;1;1;10990;0;0;0;CALIENTACAMA KIOTO ANALOGO 1 PLAZA KTC-1004;CLIMATIZACION
18816386;Soltero;M;27;CHILENO;ANALISTA DE SISTEMAS;Z;N/D;N/D;554780;6;3;4;2;462960;2;1;91820;TERMOVENTILADOR CURVE TOWER;CLIMATIZACION
18780949;;F;27;CHILENO;;Millenial;VITACURA;METROPOLITANA;11980;2;1;2;1;11980;0;0;0;TERMOVENTILADOR KIOTO NEGRO 2000W KTE-1028N;CLIMATIZACION
18806044;Casado;F;27;CHILENO;;Millenial;PROVIDENCIA                   ;METROPOLITANA;15990;1;1;0;0;0;1;1;15990;ESTUFA ELECTRICA CUARZO KIOTO 1200W KTE 1033;CLIMATIZACION
18037878;;M;29;CHILENO;;Millenial;N/D;N/D;241462;3;4;0;0;0;3;4;241462;TERMOVENTILADOR KIOTO BLANCO 2000W KTE-1028B;CLIMATIZACION
8422933;;F;61;CHILENO;;Boomers;PROVIDENCIA                   ;METROPOLITANA;20970;3;3;0;0;0;3;3;20970;ESTUFA CUARZO KIOTO 800W KTE-011A;CLIMATIZACION
17467156;;F;32;CHILENO;;Millenial;PUENTE ALTO                   ;METROPOLITANA;376410;8;4;0;0;0;8;4;376410;CALIENTACAMA KIOTO DIGITAL 2 PLAZAS KTC-1006;CLIMATIZACION
15323068;;F;56;CHILENO;;Boomers;NATALES                       ;MAGALLANES;20240;2;1;0;0;0;2;1;20240;CALIENTACAMA KIOTO DIGITAL 1 PLAZA KTC-1005;CLIMATIZACION
12963333;;F;46;CHILENO;;X;LINARES                       ;MAULE;41980;2;1;2;1;41980;0;0;0;CALIENTACAMA KIOTO DIGITAL 2 PLAZAS KTC-1006;CLIMATIZACION
6047905;;F;72;CHILENO;;Silencioso;PAINE                         ;METROPOLITANA;281950;5;6;0;0;0;5;6;281950;TERMOVENTILADOR KIOTO BLANCO 2000W KTE-1028B;CLIMATIZACION
17195621;;F;33;CHILENO;;Millenial;PROVIDENCIA                   ;METROPOLITANA;375500;6;3;6;3;375500;0;0;0;CALIENTACAMA KIOTO ANALOGO 1 PLAZA KTC-1004;CLIMATIZACION
18175096;Casado;M;30;CHILENO;;Silencioso;PROVIDENCIA                   ;METROPOLITANA;7990;1;1;1;1;7990;0;0;0;TERMOVENTILADOR KIOTO BLANCO 2000W KTE-1028B;CLIMATIZACION
7335050;Divorciado;M;66;CHILENO;;Silencioso;PROVIDENCIA                   ;METROPOLITANA;9990;1;1;0;0;0;1;1;9990;ESTUFA CUARZO KIOTO 800W KTE-011A;CLIMATIZACION
25748684;;M;37;HAITIANO;;Extranjero;SANTIAGO                      ;METROPOLITANA;7990;1;1;1;1;7990;0;0;0;TERMOVENTILADOR KIOTO BLANCO 2000W KTE-1028B;CLIMATIZACION
15429839;;F;40;CHILENO;;Millenial;"";"";46970;3;2;3;2;46970;0;0;0;CALIENTACAMA KIOTO DIGITAL 2 PLAZAS KTC-1006;CLIMATIZACION
19799299;;F;24;CHILENO;;Z;PROVIDENCIA                   ;METROPOLITANA;6990;1;1;0;0;0;1;1;6990;ESTUFA CUARZO KIOTO 800W KTE-011A;CLIMATIZACION
19232024;;F;26;CHILENO;;Z;"";"";536950;5;3;3;2;516970;2;1;19980;ESTUFA CUARZO KIOTO 800W KTE-011A;CLIMATIZACION
11677999;;F;51;CHILENO;;X;SAN JAVIER                    ;MAULE;15990;1;1;0;0;0;1;1;15990;ESTUFA ELECTRICA CUARZO KIOTO 1200W KTE 1033;CLIMATIZACION
15920738;;M;37;CHILENO;;Millenial;LINARES                       ;MAULE;19980;2;1;2;1;19980;0;0;0;ESTUFA ELECTRICA CUARZO KIOTO 1200W KTE 1033;CLIMATIZACION
18623517;;F;28;CHILENO;;Millenial;PROVIDENCIA                   ;METROPOLITANA;9990;1;1;0;0;0;1;1;9990;TERMOVENTILADOR KIOTO NEGRO 2000W KTE-1028N;CLIMATIZACION
25846373;;F;39;CHILENO;;Extranjero;SAN MIGUEL                    ;METROPOLITANA;733910;9;4;9;4;733910;0;0;0;ESTUFA GAS EH2500 5K NEGRO;CLIMATIZACION
19515675;Soltero;F;25;CHILENO;TECNICO DE NIVEL SUPERIOR EN ODONTOLOGIA;Z;PROVIDENCIA                   ;METROPOLITANA;32970;3;2;3;2;32970;0;0;0;CALIENTACAMA KIOTO ANALOGO 1 PLAZA KTC-1004;CLIMATIZACION
13678154;Casado;F;43;CHILENO;;X;PROVIDENCIA                   ;METROPOLITANA;7990;1;1;1;1;7990;0;0;0;ESTUFA CUARZO KIOTO 800W KTE-011A;CLIMATIZACION
13445371;;F;44;CHILENO;;X;CONCHALI                      ;METROPOLITANA;7990;1;1;1;1;7990;0;0;0;TERMOVENTILADOR KIOTO BLANCO 2000W KTE-1028B;CLIMATIZACION
16052143;;M;37;CHILENO;;Millenial;VICTORIA                      ;ARAUCANIA;21980;2;1;0;0;0;2;1;21980;TERMOVENTILADOR KIOTO NEGRO 2000W KTE-1028N;CLIMATIZACION
13108661;;M;46;CHILENO;;X;N/D;N/D;58970;3;2;0;0;0;3;2;58970;CALIENTACAMA KIOTO DIGITAL 1 PLAZA KTC-1005;CLIMATIZACION
13277857;;F;45;CHILENO;;X;PROVIDENCIA                   ;METROPOLITANA;14990;1;1;0;0;0;1;1;14990;CALIENTACAMA KIOTO ANALOGO 1 PLAZA KTC-1004;CLIMATIZACION
26318295;;M;37;VENEZOLANO;;Extranjero;LA FLORIDA                    ;METROPOLITANA;232700;5;2;2;1;213980;3;1;18720;TERMOVENTILADOR KIOTO BLANCO 2000W KTE-1028B;CLIMATIZACION
19649127;;F;24;CHILENO;;Z;PROVIDENCIA                   ;METROPOLITANA;10990;1;1;1;1;10990;0;0;0;CALIENTACAMA KIOTO ANALOGO 1 PLAZA KTC-1004;CLIMATIZACION
9290209;;M;60;CHILENO;;Boomers;OVALLE                        ;COQUIMBO;166568;8;4;0;0;0;8;4;166568;ESTUFA CUARZO KIOTO 800W KTE-011A;CLIMATIZACION
13802446;;M;42;CHILENO;;X;CURANILAHUE                   ;BIO BIO;20980;2;2;2;2;20980;0;0;0;ESTUFA CUARZO KIOTO 800W KTE-011A;CLIMATIZACION
19550395;Soltero;F;25;CHILENO;;Z;PROVIDENCIA                   ;METROPOLITANA;47990;1;1;0;0;0;1;1;47990;ESTUFA FIBRA DE CARBONO KFB 90;CLIMATIZACION
19645211;;F;25;CHILENO;;Z;PROVIDENCIA                   ;METROPOLITANA;49990;1;1;1;1;49990;0;0;0;CHIMENEA ELECTRICA KIOTO 2000W KTE-1101;CLIMATIZACION
20287202;;F;22;CHILENO;;Z;PROVIDENCIA                   ;METROPOLITANA;563950;5;3;4;2;553960;1;1;9990;TERMOVENTILADOR KIOTO NEGRO 2000W KTE-1028N;CLIMATIZACION
7953663;;M;64;CHILENO;;Boomers;SAN FELIPE                    ;VALPARAISO;12792;1;1;0;0;0;1;1;12792;ESTUFA ELECTRICA CUARZO KIOTO 1200W KTE 1033;CLIMATIZACION
15408929;;F;38;CHILENO;;X;PROVIDENCIA                   ;METROPOLITANA;14990;1;1;0;0;0;1;1;14990;CALIENTACAMA KIOTO ANALOGO 1 PLAZA KTC-1004;CLIMATIZACION
20712556;;M;21;CHILENO;;Z;SANTIAGO;METROPOLITANA;200000;2;1;0;0;0;2;1;200000;ESTUFA GAS EH5200 15K GRAFITO;CLIMATIZACION
13971664;;F;41;CHILENO;;X;RENCA                         ;METROPOLITANA;0;0;2;0;0;0;0;2;0;ESTUFA A GAS UT GRX-6200 ET ROJA 15 KILOS;CLIMATIZACION
10898116;Soltero;F;42;CHILENO;;X;PROVIDENCIA                   ;METROPOLITANA;243980;2;1;2;1;243980;0;0;0;ESTUFA INFRARROJA THOR 1500 WIFI;CLIMATIZACION
26975415;;M;33;VENEZOLANO;;Extranjero;LOS ANGELES                   ;BIO BIO;7990;1;1;1;1;7990;0;0;0;TERMOVENTILADOR KIOTO BLANCO 2000W KTE-1028B;CLIMATIZACION
26388455;;M;35;NO INFORMA NACIONALIDAD;;Extranjero;N/D;N/D;11980;2;1;2;1;11980;0;0;0;TERMOVENTILADOR KIOTO BLANCO 2000W KTE-1028B;CLIMATIZACION
4455129;;F;80;CHILENO;;Silencioso;SAN ESTEBAN                   ;VALPARAISO;936301;4;3;0;0;0;4;3;936301;CALIENTACAMA KIOTO ANALOGO 1 PLAZA KTC-1004;CLIMATIZACION
11761270;;F;51;CHILENO;;X;N/D;N/D;552910;9;6;0;0;0;9;6;552910;CHIMENEA ELECTRICA KIOTO 2000W KTE-1101;CLIMATIZACION
26474076;;F;29;NO INFORMA NACIONALIDAD;;Extranjero;PROVIDENCIA                   ;METROPOLITANA;16980;2;1;2;1;16980;0;0;0;CALIENTACAMA KIOTO ANALOGO 1 PLAZA KTC-1004;CLIMATIZACION
17741722;;M;31;CHILENO;;Millenial;PUERTO MONTT                  ;LOS LAGOS;49990;1;1;0;0;0;1;1;49990;CHIMENEA ELECTRICA KIOTO 2000W KTE-1101;CLIMATIZACION
18650234;;F;27;CHILENO;;Millenial;PROVIDENCIA                   ;METROPOLITANA;9990;1;1;1;1;9990;0;0;0;ESTUFA CUARZO KIOTO 800W KTE-011A;CLIMATIZACION
7578450;;F;66;CHILENO;;Boomers;PROVIDENCIA                   ;METROPOLITANA;13980;2;1;0;0;0;2;1;13980;ESTUFA CUARZO KIOTO 800W KTE-011A;CLIMATIZACION
14405281;;M;43;CHILENO;;X;N/D;N/D;57990;1;1;0;0;0;1;1;57990;CALIENTACAMAS MANUAL 2N SG-5121D4 2PL;CLIMATIZACION
19801738;;F;24;CHILENO;;Z;N/D;N/D;1086820;10;6;0;0;0;10;6;1086820;CHIMENEA ELECTRICA KIOTO 2000W KTE-1101;CLIMATIZACION
13270095;;F;45;CHILENO;;X;LO ESPEJO;METROPOLITANA;12582;2;1;0;0;0;2;1;12582;ESTUFA CUARZO KIOTO 800W KTE-011A;CLIMATIZACION
6510810;;F;68;CHILENO;;Boomers;RENCA                         ;METROPOLITANA;15990;1;1;1;1;15990;0;0;0;ESTUFA ELECTRICA CUARZO KIOTO 1200W KTE 1033;CLIMATIZACION
5789251;Casado;M;73;CHILENO;;Silencioso;ANCUD                         ;LOS LAGOS;629970;3;2;1;1;119990;2;1;509980;CALEFACTOR LENA ECO350 CHARCOAL;CLIMATIZACION
18800114;Soltero;F;27;CHILENO;;Millenial;PROVIDENCIA                   ;METROPOLITANA;127980;2;1;2;1;127980;0;0;0;ESTUFA FIAMMA PRO;CLIMATIZACION
15064688;;M;39;CHILENO;;X;LA CRUZ                       ;VALPARAISO;220970;3;2;2;1;211980;1;1;8990;TERMOVENTILADOR KIOTO NEGRO 2000W KTE-1028N;CLIMATIZACION
14241383;;F;47;CHILENO;;X;VILLA ALEMANA                 ;VALPARAISO;7990;1;1;1;1;7990;0;0;0;TERMOVENTILADOR KIOTO BLANCO 2000W KTE-1028B;CLIMATIZACION
11476587;;F;52;CHILENO;;X;PARRAL                        ;MAULE;71990;3;1;0;0;0;3;1;71990;CHIMENEA ELECTRICA KIOTO 2000W KTE-1101;CLIMATIZACION
25614771;;F;30;VENEZOLANO;;Extranjero;CONCEPCION                    ;BIO BIO;7990;1;1;1;1;7990;0;0;0;TERMOVENTILADOR KIOTO NEGRO 2000W KTE-1028N;CLIMATIZACION
25704048;;M;41;VENEZOLANO;;Extranjero;SAN JOAQUIN                   ;METROPOLITANA;68360;3;2;1;1;49990;2;1;18370;TERMOVENTILADOR KIOTO NEGRO 2000W KTE-1028N;CLIMATIZACION
26449613;;M;27;VENEZOLANO;;Extranjero;PUERTO MONTT                  ;LOS LAGOS;139990;1;1;0;0;0;1;1;139990;ESTUFA KEROSENE F 1120+;CLIMATIZACION
18385413;Soltero;M;29;CHILENO;;Millenial;PROVIDENCIA                   ;METROPOLITANA;28480;2;2;0;0;0;2;2;28480;CALIENTACAMA KIOTO DIGITAL 2 PLAZAS KTC-1006;CLIMATIZACION
16923856;;M;34;CHILENO;;Millenial;"";"";8990;1;1;0;0;0;1;1;8990;TERMOVENTILADOR KIOTO BLANCO 2000W KTE-1028B;CLIMATIZACION
20051659;;F;23;CHILENO;;Silencioso;PROVIDENCIA                   ;METROPOLITANA;12980;2;1;2;1;12980;0;0;0;TERMOVENTILADOR KIOTO NEGRO 2000W KTE-1028N;CLIMATIZACION
19036863;;F;27;CHILENO;;Z;PROVIDENCIA                   ;METROPOLITANA;12990;1;1;1;1;12990;0;0;0;CALIENTACAMA KIOTO ANALOGO 1 PLAZA KTC-1004;CLIMATIZACION
25900525;;F;33;CHILENO;;Extranjero;N/D;N/D;508950;5;4;1;1;149990;4;3;358960;TERMOVENTILADOR KIOTO BLANCO 2000W KTE-1028B;CLIMATIZACION
18596443;Casado;M;28;CHILENO;;Millenial;SAN BERNARDO                  ;METROPOLITANA;17370;2;1;0;0;0;2;1;17370;TERMOVENTILADOR KIOTO NEGRO 2000W KTE-1028N;CLIMATIZACION
8101996;;M;62;CHILENO;;Boomers;RENCA                         ;METROPOLITANA;59980;2;2;0;0;0;2;2;59980;ESTUFA ELECTRICA CUARZO KIOTO 1200W KTE 1033;CLIMATIZACION
19392715;Soltero;F;25;CHILENO;TECNICO EN ENFERMERIA DE NIVEL SUPERIOR;Z;PROVIDENCIA                   ;METROPOLITANA;8990;1;1;0;0;0;1;1;8990;TERMOVENTILADOR KIOTO NEGRO 2000W KTE-1028N;CLIMATIZACION
18927578;;M;27;CHILENO;;Millenial;PROVIDENCIA                   ;METROPOLITANA;17370;2;1;0;0;0;2;1;17370;TERMOVENTILADOR KIOTO BLANCO 2000W KTE-1028B;CLIMATIZACION
19896028;;M;24;CHILENO;;Z;PROVIDENCIA                   ;METROPOLITANA;9990;1;1;1;1;9990;0;0;0;TERMOVENTILADOR KIOTO BLANCO 2000W KTE-1028B;CLIMATIZACION
16298529;Soltero;F;36;CHILENO;;Millenial;SAN RAFAEL                    ;MAULE;124960;4;2;2;1;106980;2;1;17980;TERMOVENTILADOR KIOTO BLANCO 2000W KTE-1028B;CLIMATIZACION
15733583;;F;34;CHILENO;;Millenial;MONTE PATRIA                  ;COQUIMBO;96540;4;3;0;0;0;4;3;96540;ESTUFA CUARZO KIOTO 800W KTE-011A;CLIMATIZACION
20373468;;F;22;CHILENO;;Z;N/D;N/D;27990;1;1;0;0;0;1;1;27990;CALIENTACAMA KIOTO DIGITAL 2 PLAZAS KTC-1006;CLIMATIZACION
26641165;;F;43;VENEZOLANO;;Extranjero;CASTRO                        ;LOS LAGOS;66980;2;2;0;0;0;2;2;66980;ESTUFA ELECTRICA CUARZO KIOTO 1200W KTE 1033;CLIMATIZACION
19473332;;F;25;CHILENO;;Z;PROVIDENCIA                   ;METROPOLITANA;9990;1;1;0;0;0;1;1;9990;ESTUFA CUARZO KIOTO 800W KTE-011A;CLIMATIZACION
15110142;;F;40;CHILENO;;X;RENCA                         ;METROPOLITANA;29970;3;5;3;5;29970;0;0;0;TERMOVENTILADOR KIOTO BLANCO 2000W KTE-1028B;CLIMATIZACION
13346041;;M;43;CHILENO;;X;RENCA                         ;METROPOLITANA;83980;2;1;2;1;83980;0;0;0;ESTUFA GAS EH2500 5K NEGRO;CLIMATIZACION
11891171;;M;51;CHILENO;;X;PICHIDEGUA                    ;L.G.B.OÂ´HIGGINS;941870;6;3;0;0;0;6;3;941870;CALEFACTOR LENA NORDIC450 GRIS CHARCOAL;CLIMATIZACION
7402743;;M;68;CHILENO;;Boomers;LOS LAGOS                     ;LOS RIOS;765610;7;4;6;3;705620;1;1;59990;CHIMENEA ELECTRICA KIOTO 2000W KTE-1101;CLIMATIZACION
27058213;;M;33;VENEZOLANO;;Extranjero;N/D;N/D;19162;3;2;0;0;0;3;2;19162;ESTUFA CUARZO KIOTO 800W KTE-011A;CLIMATIZACION
27067843;;M;31;EXTRANJERO - NO INFORMA NACIONALIDAD;;Extranjero;VINA DEL MAR;VALPARAISO;210970;3;3;2;2;50980;1;1;159990;ESTUFA ELECTRICA CUARZO KIOTO 1200W KTE 1033;CLIMATIZACION
6434072;;F;74;CHILENO;;Silencioso;COIHAIQUE                     ;AYSEN;661920;8;4;0;0;0;8;4;661920;CONVECTOR ELECT. UT HMC-2000 TW-TIM;CLIMATIZACION
9349711;;F;51;CHILENO;;X;RENCA                         ;METROPOLITANA;36980;2;1;2;1;36980;0;0;0;CALIENTACAMA KIOTO DIGITAL 2 PLAZAS KTC-1006;CLIMATIZACION
11933947;;F;50;CHILENO;;X;VALLENAR;ATACAMA;8990;1;1;0;0;0;1;1;8990;TERMOVENTILADOR KIOTO BLANCO 2000W KTE-1028B;CLIMATIZACION
12513716;;M;48;CHILENO;;X;SAN BERNARDO                  ;METROPOLITANA;61950;5;5;0;0;0;5;5;61950;TERMOVENTILADOR KIOTO BLANCO 2000W KTE-1028B;CLIMATIZACION
13886220;;F;42;CHILENO;;X;PROVIDENCIA                   ;METROPOLITANA;12990;1;1;1;1;12990;0;0;0;ESTUFA CUARZO KIOTO 800W KTE-011A;CLIMATIZACION
15263470;Casado;F;47;CHILENO;;X;SAN BERNARDO                  ;METROPOLITANA;489420;6;4;0;0;0;6;4;489420;ESTUFA ELECTRICA CUARZO KIOTO 1200W KTE 1033;CLIMATIZACION
6064248;;M;68;CHILENO;;Boomers;"";"";9990;1;1;0;0;0;1;1;9990;TERMOVENTILADOR KIOTO NEGRO 2000W KTE-1028N;CLIMATIZACION
7951269;;M;64;CHILENO;;Boomers;MAIPU                         ;METROPOLITANA;180000;2;1;0;0;0;2;1;180000;ESTUFA A GAS CALMA 15 KG HELIUS;CLIMATIZACION
8638023;;M;63;CHILENO;;Boomers;N/D;N/D;177970;3;3;0;0;0;3;3;177970;ESTUFA ELECTRICA CUARZO KIOTO 1200W KTE 1033;CLIMATIZACION
15095369;Soltero;F;40;CHILENO;;X;PROVIDENCIA                   ;METROPOLITANA;17990;1;1;1;1;17990;0;0;0;ESTUFA ELECTRICA CUARZO KIOTO 1200W KTE 1033;CLIMATIZACION
8163966;Casado;M;60;CHILENO;;Boomers;PROVIDENCIA                   ;METROPOLITANA;28460;2;1;0;0;0;2;1;28460;ESTUFA ELECTRICA CUARZO KIOTO 1200W KTE 1033;CLIMATIZACION
14182340;;F;41;CHILENO;;X;PUENTE ALTO                   ;METROPOLITANA;12990;1;1;1;1;12990;0;0;0;CALIENTACAMA KIOTO ANALOGO 1 PLAZA KTC-1004;CLIMATIZACION
10033782;;F;59;CHILENO;;Boomers;PUENTE ALTO                   ;METROPOLITANA;881120;11;3;0;0;0;11;3;881120;ESTUFA ELEC. RADIADOR TH-RFC50 800W-1600W-2000W;CLIMATIZACION
7712458;;F;75;CHILENO;;Z;CALBUCO                       ;LOS LAGOS;719727;15;7;0;0;0;15;7;719727;CHIMENEA ELECTRICA KIOTO 2000W KTE-1101;CLIMATIZACION
17867864;;F;30;CHILENO;;Millenial;PROVIDENCIA                   ;METROPOLITANA;9990;1;1;0;0;0;1;1;9990;TERMOVENTILADOR KIOTO BLANCO 2000W KTE-1028B;CLIMATIZACION
26729149;;M;39;VENEZOLANO;;Extranjero;PADRE LAS CASAS               ;ARAUCANIA;55970;3;2;0;0;0;3;2;55970;ESTUFA ELECTRICA CUARZO KIOTO 1200W KTE 1033;CLIMATIZACION
18318134;;F;29;CHILENO;;Millenial;N/D;N/D;25980;2;1;2;1;25980;0;0;0;CALIENTACAMA KIOTO ANALOGO 1 PLAZA KTC-1004;CLIMATIZACION
15756868;;M;38;CHILENO;;Millenial;CHILLAN                       ;BIO BIO;691480;4;3;0;0;0;4;3;691480;ESTUFA INFRARROJA THOR 1500 WIFI;CLIMATIZACION
9716139;;F;56;CHILENO;;Boomers;CORONEL                       ;BIO BIO;39560;2;1;0;0;0;2;1;39560;CALEFACTOR CUARZO VERTICAL 800 W HQ 80 AIROLITE;CLIMATIZACION
13452021;;M;44;CHILENO;;X;MAIPU                         ;METROPOLITANA;8990;1;1;0;0;0;1;1;8990;TERMOVENTILADOR KIOTO NEGRO 2000W KTE-1028N;CLIMATIZACION
9003346;Casado;F;60;CHILENO;ASISTENTE SOCIAL;Boomers;PROVIDENCIA                   ;METROPOLITANA;9990;1;1;0;0;0;1;1;9990;TERMOVENTILADOR KIOTO NEGRO 2000W KTE-1028N;CLIMATIZACION
16568716;;F;34;CHILENO;;Millenial;BUIN                          ;METROPOLITANA;9990;1;1;1;1;9990;0;0;0;TERMOVENTILADOR KIOTO BLANCO 2000W KTE-1028B;CLIMATIZACION
13195662;;F;45;CHILENO;;X;RENCA                         ;METROPOLITANA;31980;2;1;2;1;31980;0;0;0;TERMOVENTILADOR VERTICAL SUN05 PURP.;CLIMATIZACION
15690782;;M;39;CHILENO;;X;ANTOFAGASTA                   ;ANTOFAGASTA;734900;10;6;6;4;525940;4;2;208960;CALIENTACAMAS ANALOGO BASICO 2 PL;CLIMATIZACION
19447945;;F;26;CHILENO;;Z;PROVIDENCIA                   ;METROPOLITANA;8990;1;1;0;0;0;1;1;8990;TERMOVENTILADOR KIOTO NEGRO 2000W KTE-1028N;CLIMATIZACION
9247675;;F;61;CHILENO;;Boomers;EL BOSQUE                     ;METROPOLITANA;54970;3;2;0;0;0;3;2;54970;CALIENTACAMA KIOTO ANALOGO 1 PLAZA KTC-1004;CLIMATIZACION
6731612;;F;71;CHILENO;;Silencioso;LINARES                       ;MAULE;162970;3;3;0;0;0;3;3;162970;ESTUFA ELECTRICA CUARZO KIOTO 1200W KTE 1033;CLIMATIZACION
26398947;;M;45;VENEZOLANO;;Extranjero;CASTRO                        ;LOS LAGOS;115970;3;2;0;0;0;3;2;115970;CALIENTACAMA KIOTO DIGITAL 2 PLAZAS KTC-1006;CLIMATIZACION
16683756;;F;35;CHILENO;;Millenial;COIHAIQUE                     ;AYSEN;128470;3;2;0;0;0;3;2;128470;TERMOVENTILADOR KIOTO BLANCO 2000W KTE-1028B;CLIMATIZACION
19982530;;F;23;CHILENO;;Z;PROVIDENCIA                   ;METROPOLITANA;25980;2;1;2;1;25980;0;0;0;ESTUFA CUARZO KIOTO 800W KTE-011A;CLIMATIZACION
19795131;;M;24;CHILENO;;Z;VICTORIA                      ;ARAUCANIA;895930;7;7;3;3;489970;4;4;405960;TERMOVENTILADOR KIOTO NEGRO 2000W KTE-1028N;CLIMATIZACION
27139239;Soltero;M;29;NO INFORMA NACIONALIDAD;;Extranjero;"";"";314950;5;4;4;3;124960;1;1;189990;TERMOVENTILADOR KIOTO BLANCO 2000W KTE-1028B;CLIMATIZACION
18104263;;F;30;CHILENO;;Millenial;RANCAGUA                      ;L.G.B.OÂ´HIGGINS;12990;1;1;0;0;0;1;1;12990;CALIENTACAMA KIOTO ANALOGO 1 PLAZA KTC-1004;CLIMATIZACION
8534624;;F;64;CHILENO;;Boomers;MAULE                         ;MAULE;971930;7;5;0;0;0;7;5;971930;CHIMENEA ELECTRICA KIOTO 2000W KTE-1101;CLIMATIZACION
17904904;;F;31;CHILENO;;Millenial;LA SERENA                     ;COQUIMBO;275971;4;3;0;0;0;4;3;275971;CALIENTACAMA KIOTO DIGITAL 2 PLAZAS KTC-1006;CLIMATIZACION
16849272;;F;34;CHILENO;;Millenial;OVALLE                        ;COQUIMBO;374951;5;5;0;0;0;5;5;374951;CHIMENEA ELECTRICA KIOTO 2000W KTE-1101;CLIMATIZACION
16059674;;F;37;CHILENO;;Millenial;N/D;N/D;245960;4;3;2;1;15980;2;2;229980;ESTUFA CUARZO KIOTO 800W KTE-011A;CLIMATIZACION
16975413;;M;33;CHILENO;;Millenial;COIHAIQUE                     ;AYSEN;101970;3;3;2;2;51980;1;1;49990;CALIENTACAMA KIOTO ANALOGO 1 PLAZA KTC-1004;CLIMATIZACION
11280037;;F;54;CHILENO;;Boomers;NANCAGUA                      ;L.G.B.OÂ´HIGGINS;29970;3;1;0;0;0;3;1;29970;TERMOVENTILADOR KIOTO BLANCO 2000W KTE-1028B;CLIMATIZACION
8163890;;F;62;CHILENO;;Boomers;RENCA                         ;METROPOLITANA;59990;1;1;0;0;0;1;1;59990;CHIMENEA ELECTRICA KIOTO 2000W KTE-1101;CLIMATIZACION
17992411;;M;30;CHILENO;;Millenial;PROVIDENCIA                   ;METROPOLITANA;27990;1;1;0;0;0;1;1;27990;CALIENTACAMA KIOTO DIGITAL 2 PLAZAS KTC-1006;CLIMATIZACION
9264666;;F;71;CHILENO;;Silencioso;NUEVA IMPERIAL                ;ARAUCANIA;8990;1;1;0;0;0;1;1;8990;TERMOVENTILADOR KIOTO NEGRO 2000W KTE-1028N;CLIMATIZACION
11299917;;M;54;CHILENO;;X;COLLIPULLI                    ;ARAUCANIA;1097390;11;2;0;0;0;11;2;1097390;CALEFACTOR BOSCA LIMIT 360;CLIMATIZACION
19194612;;M;27;CHILENO;;Z;TEMUCO                        ;ARAUCANIA;9240;2;1;0;0;0;2;1;9240;ESTUFA CUARZO KIOTO 800W KTE-011A;CLIMATIZACION
12261351;;M;54;CHILENO;;X;INDEPENDENCIA;METROPOLITANA;35360;3;1;0;0;0;3;1;35360;CALIENTACAMA KIOTO DIGITAL 1 PLAZA KTC-1005;CLIMATIZACION
26958986;;M;29;EXTRANJERO - NO INFORMA NACIONALIDAD;;Extranjero;INDEPENDENCIA;METROPOLITANA;19970;3;1;3;1;19970;0;0;0;TERMOVENTILADOR KIOTO BLANCO 2000W KTE-1028B;CLIMATIZACION
16267079;;M;36;CHILENO;;Millenial;N/D;N/D;79900;2;1;0;0;0;2;1;79900;CONVECTOR UT N10;CLIMATIZACION
8684311;;M;60;CHILENO;;Boomers;SAN ANTONIO                   ;VALPARAISO;93960;4;4;0;0;0;4;4;93960;TERMOVENTILADOR KIOTO BLANCO 2000W KTE-1028B;CLIMATIZACION
14356762;;F;42;CHILENO;;X;MALLOA                        ;L.G.B.OÂ´HIGGINS;9990;1;1;0;0;0;1;1;9990;TERMOVENTILADOR KIOTO NEGRO 2000W KTE-1028N;CLIMATIZACION
13546091;;M;43;CHILENO;;X;CASABLANCA                    ;VALPARAISO;39970;3;2;0;0;0;3;2;39970;CALIENTACAMA KIOTO ANALOGO 1 PLAZA KTC-1004;CLIMATIZACION
11332181;;F;53;CHILENO;;X;VILLA ALEMANA                 ;VALPARAISO;310960;4;3;0;0;0;4;3;310960;ESTUFA CUARZO KIOTO 800W KTE-011A;CLIMATIZACION
18029056;;M;29;CHILENO;;Silencioso;"";"";15980;2;1;2;1;15980;0;0;0;TERMOVENTILADOR KIOTO BLANCO 2000W KTE-1028B;CLIMATIZACION
8117524;;F;62;CHILENO;;Boomers;CERRO NAVIA                   ;METROPOLITANA;423970;3;2;2;1;133980;1;1;289990;CALEFACTOR INFRAROJO GR2800 T GRIS;CLIMATIZACION
13196209;;F;45;CHILENO;;X;SANTO DOMINGO                 ;VALPARAISO;9240;2;1;0;0;0;2;1;9240;ESTUFA CUARZO KIOTO 800W KTE-011A;CLIMATIZACION
13580075;;M;43;CHILENO;;X;ANGOL                         ;ARAUCANIA;82960;4;2;0;0;0;4;2;82960;CALIENTACAMA KIOTO DIGITAL 1 PLAZA KTC-1005;CLIMATIZACION
11390286;;F;53;CHILENO;;X;LAMPA                         ;METROPOLITANA;114990;1;1;0;0;0;1;1;114990;CHIMENEA ELECTRICA ROBLE NEGRA;CLIMATIZACION
4933798;;F;81;CHILENO;;Silencioso;TALCAHUANO                    ;BIO BIO;28460;2;1;0;0;0;2;1;28460;ESTUFA ELECTRICA CUARZO KIOTO 1200W KTE 1033;CLIMATIZACION
18577171;;F;28;CHILENO;;Millenial;PROVIDENCIA                   ;METROPOLITANA;29970;3;1;3;1;29970;0;0;0;ESTUFA ELECTRICA CUARZO KIOTO 1200W KTE 1033;CLIMATIZACION
19255738;Soltero;F;25;CHILENO;TECNICO DE NIVEL MEDIO EN ALIMENTACION;Z;PROVIDENCIA                   ;METROPOLITANA;20980;2;2;1;1;12990;1;1;7990;TERMOVENTILADOR KIOTO NEGRO 2000W KTE-1028N;CLIMATIZACION
18477132;Soltero;F;29;CHILENO;;Millenial;PROVIDENCIA                   ;METROPOLITANA;54990;1;1;0;0;0;1;1;54990;CHIMENEA ELECTRICA KIOTO 2000W KTE-1101;CLIMATIZACION
13639443;;M;42;CHILENO;;X;N/D;N/D;58970;3;2;0;0;0;3;2;58970;CALIENTACAMA KIOTO DIGITAL 1 PLAZA KTC-1005;CLIMATIZACION
10355867;;F;55;CHILENO;;Boomers;RANCAGUA;O HIGGINS;54980;2;2;0;0;0;2;2;54980;CALIENTACAMA KIOTO DIGITAL 2 PLAZAS KTC-1006;CLIMATIZACION
13756108;;M;42;CHILENO;;X;RENCA                         ;METROPOLITANA;9240;2;1;0;0;0;2;1;9240;TERMOVENTILADOR KIOTO BLANCO 2000W KTE-1028B;CLIMATIZACION
8375117;;F;64;CHILENO;;Boomers;SAN BERNARDO                  ;METROPOLITANA;11990;1;1;0;0;0;1;1;11990;CALIENTACAMA KIOTO ANALOGO 1 PLAZA KTC-1004;CLIMATIZACION
6405669;;F;69;CHILENO;;Silencioso;CANETE                        ;BIO BIO;83960;4;2;0;0;0;4;2;83960;CALIENTACAMA KIOTO ANALOGO 1 PLAZA KTC-1004;CLIMATIZACION
16447900;;M;35;CHILENO;;Silencioso;PROVIDENCIA                   ;METROPOLITANA;54990;1;1;1;1;54990;0;0;0;CHIMENEA ELECTRICA KIOTO 2000W KTE-1101;CLIMATIZACION
14648340;;M;47;BOLIVIANO;;X;PROVIDENCIA                   ;METROPOLITANA;59990;1;1;1;1;59990;0;0;0;CHIMENEA ELECTRICA KIOTO 2000W KTE-1101;CLIMATIZACION
15514489;;F;39;CHILENO;;X;N/D;N/D;69970;3;3;0;0;0;3;3;69970;TERMOVENTILADOR KIOTO BLANCO 2000W KTE-1028B;CLIMATIZACION
18938850;;F;27;CHILENO;;Millenial;PUENTE ALTO;METROPOLITANA;73970;3;2;2;1;63980;1;1;9990;ESTUFA CUARZO KIOTO 800W KTE-011A;CLIMATIZACION
19768316;;M;24;CHILENO;;Z;PROVIDENCIA                   ;METROPOLITANA;59990;1;1;0;0;0;1;1;59990;TERMOVENTILADOR CURVE TOWER;CLIMATIZACION
18144102;;M;30;CHILENO;;Millenial;ARAUCO                        ;BIO BIO;8990;1;1;0;0;0;1;1;8990;ESTUFA CUARZO KIOTO 800W KTE-011A;CLIMATIZACION
15111977;;M;38;CHILENO;;X;PICHIDEGUA                    ;L.G.B.OÂ´HIGGINS;339980;2;2;0;0;0;2;2;339980;CHIMENEA ELECTRICA KIOTO 2000W KTE-1101;CLIMATIZACION
9529966;;M;58;CHILENO;;Boomers;LIMACHE                       ;VALPARAISO;0;0;2;0;0;0;0;2;0;TERMOVENTILADOR KIOTO NEGRO 2000W KTE-1028N;CLIMATIZACION
18775546;;F;27;CHILENO;;Millenial;N/D;N/D;8990;1;1;0;0;0;1;1;8990;TERMOVENTILADOR KIOTO BLANCO 2000W KTE-1028B;CLIMATIZACION
18954168;Soltero;M;27;CHILENO;;Millenial;PROVIDENCIA                   ;METROPOLITANA;16980;2;1;2;1;16980;0;0;0;CALIENTACAMA KIOTO ANALOGO 1 PLAZA KTC-1004;CLIMATIZACION
11156842;;M;55;CHILENO;;Boomers;LEBU                          ;BIO BIO;130950;5;3;0;0;0;5;3;130950;ESTUFA ELECTRICA CUARZO KIOTO 1200W KTE 1033;CLIMATIZACION
19574828;;F;25;CHILENO;;Z;LINARES                       ;MAULE;49990;1;1;0;0;0;1;1;49990;ESTUFA ELECTRICA CUARZO KC 220 ROJA;CLIMATIZACION
16389878;Soltero;F;36;CHILENO;ASISTENTE SOCIAL;Millenial;CONSTITUCION                  ;MAULE;8491;1;1;0;0;0;1;1;8491;TERMOVENTILADOR KIOTO BLANCO 2000W KTE-1028B;CLIMATIZACION
15591254;Soltero;M;38;CHILENO;TECNICO MECANICO;X;PROVIDENCIA                   ;METROPOLITANA;10990;1;1;0;0;0;1;1;10990;TERMOVENTILADOR KIOTO NEGRO 2000W KTE-1028N;CLIMATIZACION
11626800;;F;52;CHILENO;;X;PROVIDENCIA                   ;METROPOLITANA;10000;2;1;0;0;0;2;1;10000;TERMOVENTILADOR KIOTO BLANCO 2000W KTE-1028B;CLIMATIZACION
20631864;;F;21;CHILENO;;Z;PROVIDENCIA                   ;METROPOLITANA;8990;1;1;1;1;8990;0;0;0;TERMOVENTILADOR KIOTO NEGRO 2000W KTE-1028N;CLIMATIZACION
12283088;;M;50;CHILENO;;X;PEDRO AGUIRRE CERDA           ;METROPOLITANA;14990;1;1;0;0;0;1;1;14990;CALIENTACAMA KIOTO ANALOGO 1 PLAZA KTC-1004;CLIMATIZACION
26269689;;M;35;EXTRANJERO - NO INFORMA NACIONALIDAD;;Extranjero;CURICO                        ;MAULE;8990;1;1;0;0;0;1;1;8990;TERMOVENTILADOR KIOTO NEGRO 2000W KTE-1028N;CLIMATIZACION
15602498;;M;39;CHILENO;;X;RANCAGUA;O HIGGINS;86990;3;2;0;0;0;3;2;86990;CALIENTACAMAS MANUAL 2N SG-5121D4 2PL;CLIMATIZACION
20573114;;F;21;CHILENO;;Z;CALBUCO                       ;LOS LAGOS;199970;3;3;2;2;79980;1;1;119990;CALIENTACAMA KIOTO DIGITAL 2 PLAZAS KTC-1006;CLIMATIZACION
12574119;;M;48;CHILENO;;X;PANGUIPULLI                   ;LOS RIOS;166731;2;2;0;0;0;2;2;166731;CHIMENEA ELECTRICA KIOTO 2000W KTE-1101;CLIMATIZACION
10337693;;F;54;CHILENO;;X;TIRUA                         ;BIO BIO;10990;1;1;0;0;0;1;1;10990;ESTUFA CUARZO KIOTO 800W KTE-011A;CLIMATIZACION
18794972;;F;28;CHILENO;;Millenial;BUIN;METROPOLITANA;256970;3;6;0;0;0;3;6;256970;TERMOVENTILADOR KIOTO NEGRO 2000W KTE-1028N;CLIMATIZACION
25955468;;F;29;VENEZOLANO;;Extranjero;PUDAHUEL                      ;METROPOLITANA;19980;2;1;2;1;19980;0;0;0;TERMOVENTILADOR KIOTO NEGRO 2000W KTE-1028N;CLIMATIZACION
17170516;Casado;F;33;CHILENO;;Millenial;PROVIDENCIA                   ;METROPOLITANA;17980;2;2;2;2;17980;0;0;0;TERMOVENTILADOR KIOTO NEGRO 2000W KTE-1028N;CLIMATIZACION
10648007;;F;56;CHILENO;;Boomers;CASTRO                        ;LOS LAGOS;19990;1;3;0;0;0;1;3;19990;ESTUFA ELECTRICA CUARZO KIOTO 1200W KTE 1033;CLIMATIZACION
15215638;;F;40;CHILENO;;X;CHILLAN VIEJO                 ;BIO BIO;183631;5;2;0;0;0;5;2;183631;TERMOVENTILADOR KIOTO BLANCO 2000W KTE-1028B;CLIMATIZACION
14251656;;F;52;CHILENO;;X;BUIN                          ;METROPOLITANA;120970;3;3;0;0;0;3;3;120970;CALIENTACAMAS MANUAL 2N SG-5120D4 1PL;CLIMATIZACION
13566509;;F;42;CHILENO;;X;LOS LAGOS                     ;LOS RIOS;106970;3;2;0;0;0;3;2;106970;CHIMENEA ELECTRICA KIOTO 2000W KTE-1101;CLIMATIZACION
6411780;;M;68;CHILENO;;Boomers;COLTAUCO                      ;L.G.B.OÂ´HIGGINS;52970;3;1;0;0;0;3;1;52970;ESTUFA ELECTRICA CUARZO KIOTO 1200W KTE 1033;CLIMATIZACION
11278479;;F;53;CHILENO;;X;SAN VICENTE                   ;L.G.B.OÂ´HIGGINS;34990;1;1;0;0;0;1;1;34990;CALIENTACAMA KIOTO DIGITAL 2 PLAZAS KTC-1006;CLIMATIZACION
10505163;;F;57;CHILENO;;Boomers;SAN JUAN DE LA COSTA          ;LOS LAGOS;19990;1;1;0;0;0;1;1;19990;ESTUFA ELECTRICA CUARZO KIOTO 1200W KTE 1033;CLIMATIZACION
16793105;;M;34;CHILENO;;Millenial;LINARES                       ;MAULE;79570;2;1;0;0;0;2;1;79570;ESTUFA ELEC. FIBRA DE CARBONO NSB120K5 SILVER;CLIMATIZACION
14267748;;F;50;CHILENO;;X;N/D;N/D;279980;2;2;0;0;0;2;2;279980;ESTUFA FOGUITA PRO;CLIMATIZACION
10656876;;F;56;CHILENO;;Boomers;RENCA                         ;METROPOLITANA;15980;2;2;0;0;0;2;2;15980;TERMOVENTILADOR KIOTO BLANCO 2000W KTE-1028B;CLIMATIZACION
16858745;;F;34;CHILENO;;Millenial;RENCA                         ;METROPOLITANA;74980;2;2;0;0;0;2;2;74980;ESTUFA ELECTRICA CUARZO KIOTO 1200W KTE 1033;CLIMATIZACION
19486758;;F;25;CHILENO;;Z;PROVIDENCIA                   ;METROPOLITANA;29990;1;1;1;1;29990;0;0;0;CALIENTACAMA KIOTO DIGITAL 2 PLAZAS KTC-1006;CLIMATIZACION
16183986;;F;36;CHILENO;;Millenial;VALLENAR;ATACAMA;39990;1;1;0;0;0;1;1;39990;CHIMENEA ELECTRICA KIOTO 2000W KTE-1101;CLIMATIZACION
7623034;Viudo;F;66;CHILENO;AUXILIAR DE ENFERMERIA;X;MAIPU                         ;METROPOLITANA;29990;1;1;0;0;0;1;1;29990;CALIENTACAMA KIOTO DIGITAL 2 PLAZAS KTC-1006;CLIMATIZACION
17818349;;M;31;CHILENO;;Millenial;LOS ANDES                     ;VALPARAISO;89570;2;1;0;0;0;2;1;89570;CHIMENEA ELECTRICA KIOTO 2000W KTE-1101;CLIMATIZACION
15535489;;M;39;CHILENO;;X;RENGO                         ;L.G.B.OÂ´HIGGINS;56220;4;1;0;0;0;4;1;56220;CALIENTACAMA KIOTO DIGITAL 2 PLAZAS KTC-1006;CLIMATIZACION
6731698;;M;70;CHILENO;;Silencioso;MAIPU                         ;METROPOLITANA;317960;4;2;0;0;0;4;2;317960;CALIENTACAMA KIOTO DIGITAL 2 PLAZAS KTC-1006;CLIMATIZACION
10946207;;F;56;CHILENO;;Boomers;SAN BERNARDO                  ;METROPOLITANA;417200;5;3;0;0;0;5;3;417200;TERMOVENTILADOR KIOTO BLANCO 2000W KTE-1028B;CLIMATIZACION
14429464;;F;49;CHILENO;;X;ISLA DE MAIPO                 ;METROPOLITANA;320962;4;2;0;0;0;4;2;320962;CALIENTACAMAS MANUAL 3N SG-5010 1PL;CLIMATIZACION
15107635;Soltero;M;38;CHILENO;;Millenial;PROVIDENCIA                   ;METROPOLITANA;9990;1;1;0;0;0;1;1;9990;TERMOVENTILADOR KIOTO NEGRO 2000W KTE-1028N;CLIMATIZACION
18825632;;F;28;CHILENO;;Millenial;PROVIDENCIA                   ;METROPOLITANA;20990;1;1;0;0;0;1;1;20990;ESTUFA ELECTRICA CUARZO KIOTO 1200W KTE 1033;CLIMATIZACION
11987160;;F;49;CHILENO;;X;RENCA                         ;METROPOLITANA;12990;1;1;0;0;0;1;1;12990;CALIENTACAMA KIOTO ANALOGO 1 PLAZA KTC-1004;CLIMATIZACION
18369558;;F;29;CHILENO;;Millenial;N/D;N/D;2157782;14;12;4;2;1011680;10;10;1146102;CALIENTACAMA KIOTO ANALOGO 1 PLAZA KTC-1004;CLIMATIZACION
7521976;Casado;M;65;CHILENO;;Boomers;PROVIDENCIA                   ;METROPOLITANA;452530;5;2;0;0;0;5;2;452530;CHIMENEA ELECTRICA KIOTO 2000W KTE-1101;CLIMATIZACION
25594985;;F;25;PERUANO;;Extranjero;ESTACION CENTRAL              ;METROPOLITANA;599970;3;3;0;0;0;3;3;599970;TERMOVENTILADOR KIOTO NEGRO 2000W KTE-1028N;CLIMATIZACION
8785577;;F;63;CHILENO;;Boomers;ILLAPEL                       ;COQUIMBO;153980;2;2;0;0;0;2;2;153980;ESTUFA A GAS CALMA 5 KG COMPAK;CLIMATIZACION
11702902;;F;51;CHILENO;;X;SAN BERNARDO                  ;METROPOLITANA;73440;3;1;0;0;0;3;1;73440;ESTUFA FIBRA DE CARBONO KFC 90 - NEGRA ROJA;CLIMATIZACION
10419396;;M;56;CHILENO;;Boomers;CAUQUENES                     ;MAULE;275970;3;2;0;0;0;3;2;275970;CHIMENEA ELECTRICA KIOTO 2000W KTE-1101;CLIMATIZACION
9755916;Casado;M;59;CHILENO;;Boomers;RENCA                         ;METROPOLITANA;29970;3;1;0;0;0;3;1;29970;TERMOVENTILADOR KIOTO NEGRO 2000W KTE-1028N;CLIMATIZACION
14091404;;M;41;CHILENO;;X;SAN BERNARDO                  ;METROPOLITANA;117970;3;2;0;0;0;3;2;117970;CHIMENEA ELECTRICA KIOTO 2000W KTE-1101;CLIMATIZACION
14152869;;F;40;CHILENO;;X;CONCHALI                      ;METROPOLITANA;217940;6;2;6;2;217940;0;0;0;ESTUFA ELECTRICA CUARZO KIOTO 1200W KTE 1033;CLIMATIZACION
12128407;;M;48;CHILENO;;X;PAREDONES                     ;L.G.B.OÂ´HIGGINS;19990;1;1;0;0;0;1;1;19990;ESTUFA ELECTRICA CUARZO KIOTO 1200W KTE 1033;CLIMATIZACION
16968174;;M;34;CHILENO;;Millenial;PROVIDENCIA                   ;METROPOLITANA;54990;1;1;1;1;54990;0;0;0;CHIMENEA ELECTRICA KIOTO 2000W KTE-1101;CLIMATIZACION
16507862;;F;35;CHILENO;;Millenial;PUERTO MONTT                  ;LOS LAGOS;8990;1;1;1;1;8990;0;0;0;TERMOVENTILADOR KIOTO NEGRO 2000W KTE-1028N;CLIMATIZACION
8484388;;F;63;CHILENO;;Boomers;PROVIDENCIA                   ;METROPOLITANA;17220;2;1;0;0;0;2;1;17220;ESTUFA CUARZO KIOTO 800W KTE-011A;CLIMATIZACION
10008349;;F;55;CHILENO;;Boomers;RETIRO                        ;MAULE;39970;3;2;0;0;0;3;2;39970;CALIENTACAMA KIOTO DIGITAL 1 PLAZA KTC-1005;CLIMATIZACION
15317438;Casado;M;37;CHILENO;ABOGADO;Millenial;PROVIDENCIA                   ;METROPOLITANA;8990;1;1;1;1;8990;0;0;0;TERMOVENTILADOR KIOTO NEGRO 2000W KTE-1028N;CLIMATIZACION
16543619;;F;35;CHILENO;;Millenial;PEDRO AGUIRRE CERDA           ;METROPOLITANA;69990;1;1;0;0;0;1;1;69990;CHIMENEA ELECTRICA KIOTO 2000W KTE-1101;CLIMATIZACION
11408669;;M;52;CHILENO;;X;NUEVA IMPERIAL                ;ARAUCANIA;1072616;11;5;0;0;0;11;5;1072616;ESTUFA ELECTRICA CUARZO KIOTO 1200W KTE 1033;CLIMATIZACION
5305630;Casado;M;73;CHILENO;;Silencioso;PROVIDENCIA                   ;METROPOLITANA;139990;1;1;0;0;0;1;1;139990;ESTUFA FOGUITA PRO;CLIMATIZACION
17273889;Casado;F;33;CHILENO;;Millenial;PROVIDENCIA                   ;METROPOLITANA;129990;1;1;1;1;129990;0;0;0;ESTUFA GAS KGQ15N 15K NEGRO EUROPEA;CLIMATIZACION
18674858;;F;28;CHILENO;;Millenial;PROVIDENCIA                   ;METROPOLITANA;9990;1;1;0;0;0;1;1;9990;TERMOVENTILADOR KIOTO NEGRO 2000W KTE-1028N;CLIMATIZACION
12859762;Casado;F;46;CHILENO;PERIODISTA;Silencioso;PROVIDENCIA                   ;METROPOLITANA;73980;2;1;2;1;73980;0;0;0;CHIMENEA ELECTRICA KIOTO 2000W KTE-1101;CLIMATIZACION
20226396;;F;22;CHILENO;;Z;PROVIDENCIA                   ;METROPOLITANA;29990;1;1;0;0;0;1;1;29990;CALIENTACAMA KIOTO DIGITAL 2 PLAZAS KTC-1006;CLIMATIZACION
9157279;;M;60;CHILENO;;Boomers;N/D;N/D;194961;5;3;0;0;0;5;3;194961;ESTUFA ELECTRICA CUARZO KIOTO 1200W KTE 1033;CLIMATIZACION
13158208;;F;44;CHILENO;;X;NUEVA IMPERIAL                ;ARAUCANIA;129950;5;3;0;0;0;5;3;129950;CALIENTACAMA KIOTO ANALOGO 1 PLAZA KTC-1004;CLIMATIZACION
12916233;;M;49;CHILENO;;Millenial;N/D;N/D;8990;1;1;1;1;8990;0;0;0;TERMOVENTILADOR KIOTO NEGRO 2000W KTE-1028N;CLIMATIZACION
15289487;;F;39;CHILENO;;X;CASTRO                        ;LOS LAGOS;9990;1;1;0;0;0;1;1;9990;TERMOVENTILADOR KIOTO BLANCO 2000W KTE-1028B;CLIMATIZACION
16249669;;F;36;CHILENO;;Millenial;COPIAPO                       ;ATACAMA;139980;2;2;0;0;0;2;2;139980;CHIMENEA ELECTRICA KIOTO 2000W KTE-1101;CLIMATIZACION
19154393;;F;26;CHILENO;;Millenial;N/D;N/D;8990;1;1;0;0;0;1;1;8990;TERMOVENTILADOR KIOTO NEGRO 2000W KTE-1028N;CLIMATIZACION
19559390;;M;25;CHILENO;;Z;N/D;N/D;439970;3;2;0;0;0;3;2;439970;ESTUFA ELECTRICA CUARZO KIOTO 1200W KTE 1033;CLIMATIZACION
18805044;;M;27;CHILENO;;Millenial;SAN CARLOS                    ;BIO BIO;119710;3;1;0;0;0;3;1;119710;CHIMENEA ELECTRICA KIOTO 2000W KTE-1101;CLIMATIZACION
8461688;;F;66;CHILENO;;Boomers;RENCA                         ;METROPOLITANA;17980;2;2;0;0;0;2;2;17980;TERMOVENTILADOR KIOTO BLANCO 2000W KTE-1028B;CLIMATIZACION
7217018;;M;68;CHILENO;;Silencioso;SANTA CRUZ                    ;L.G.B.OÂ´HIGGINS;440960;4;2;0;0;0;4;2;440960;CALIENTACAMA KIOTO DIGITAL 2 PLAZAS KTC-1006;CLIMATIZACION
19878531;;M;24;CHILENO;;Silencioso;PROVIDENCIA                   ;METROPOLITANA;37980;2;2;2;2;37980;0;0;0;ESTUFA ELECTRICA CUARZO KIOTO 1200W KTE 1033;CLIMATIZACION
19203309;Soltero;M;30;CHILENO;INGENIERIA EN TELECOMUNICACIONES CONECTIVIDAD Y REDES;Millenial;PROVIDENCIA                   ;METROPOLITANA;23980;2;1;2;1;23980;0;0;0;TERMOVENTILADOR CERAMICO TH-CH40;CLIMATIZACION
11676432;;F;51;CHILENO;;X;PROVIDENCIA                   ;METROPOLITANA;9990;1;1;0;0;0;1;1;9990;TERMOVENTILADOR KIOTO BLANCO 2000W KTE-1028B;CLIMATIZACION
10704273;Soltero;M;55;CHILENO;;Boomers;PEDRO AGUIRRE CERDA           ;METROPOLITANA;484023;5;3;0;0;0;5;3;484023;CALIENTACAMA KIOTO DIGITAL 1 PLAZA KTC-1005;CLIMATIZACION
18200565;Soltero;M;29;CHILENO;;Millenial;MELIPILLA                     ;METROPOLITANA;239980;2;2;0;0;0;2;2;239980;ESTUFA CALMA ECO CARBON EC1000;CLIMATIZACION
20051110;;M;23;CHILENO;;Z;PROVIDENCIA                   ;METROPOLITANA;91970;5;2;5;2;91970;0;0;0;CALIENTACAMA KIOTO DIGITAL 2 PLAZAS KTC-1006;CLIMATIZACION
18318615;;M;29;CHILENO;;Millenial;N/D;N/D;9990;1;1;1;1;9990;0;0;0;ESTUFA CUARZO KIOTO 800W KTE-011A;CLIMATIZACION
11990963;;M;50;CHILENO;;X;N/D;N/D;44980;2;2;0;0;0;2;2;44980;ESTUFA ELECTRICA CUARZO KIOTO 1200W KTE 1033;CLIMATIZACION
11156467;;F;55;CHILENO;;Boomers;CURANILAHUE                   ;BIO BIO;191940;2;1;0;0;0;2;1;191940;ESTUFA GAS EH2500 5K NEGRO;CLIMATIZACION
5940249;Casado;F;70;CHILENO;;Silencioso;RENCA                         ;METROPOLITANA;14990;1;1;0;0;0;1;1;14990;CALIENTACAMA KIOTO ANALOGO 1 PLAZA KTC-1004;CLIMATIZACION
18838262;;M;28;CHILENO;;Millenial;N/D;N/D;651940;6;5;2;1;293980;4;4;357960;ESTUFA ELECTRICA CUARZO KIOTO 1200W KTE 1033;CLIMATIZACION
10413081;Soltero;F;56;CHILENO;PROFESOR;Boomers;RENCA                         ;METROPOLITANA;54960;4;3;0;0;0;4;3;54960;TERMOVENTILADOR KIOTO NEGRO 2000W KTE-1028N;CLIMATIZACION
13111210;;F;46;CHILENO;;X;NUEVA IMPERIAL                ;ARAUCANIA;46980;2;2;0;0;0;2;2;46980;MINI OLEOELECTRICA KIOTO 500W NEGRO KTE-1081N;CLIMATIZACION
19387481;;M;25;CHILENO;;Z;PROVIDENCIA                   ;METROPOLITANA;279970;3;2;0;0;0;3;2;279970;CALIENTACAMA KIOTO DIGITAL 2 PLAZAS KTC-1006;CLIMATIZACION
13462239;;F;43;CHILENO;;X;COIHAIQUE                     ;AYSEN;384950;5;3;0;0;0;5;3;384950;TERMOVENTILADOR KIOTO NEGRO 2000W KTE-1028N;CLIMATIZACION
18605725;;M;28;CHILENO;;Millenial;"";"";168480;2;1;0;0;0;2;1;168480;ESTUFA FOGUITA PRO;CLIMATIZACION
20199174;;M;23;CHILENO;;Z;N/D;N/D;203950;6;5;0;0;0;6;5;203950;CHIMENEA ELECTRICA KIOTO 2000W KTE-1101;CLIMATIZACION
14460636;Soltero;F;44;CHILENO;GASTRONOMIA INTERNACIONAL;X;RENCA                         ;METROPOLITANA;32990;1;1;0;0;0;1;1;32990;TERMOVENTILADOR TH-FH31 BLANCO 1000W-2000W;CLIMATIZACION
9877660;;M;56;CHILENO;;Boomers;PROVIDENCIA                   ;METROPOLITANA;19990;1;1;1;1;19990;0;0;0;TURBO CALEFACTOR VERT. TC-2100V BLANCO;CLIMATIZACION
10612971;;F;53;CHILENO;;X;CASTRO                        ;LOS LAGOS;331960;4;2;0;0;0;4;2;331960;CALIENTACAMA KIOTO DIGITAL 2 PLAZAS KTC-1006;CLIMATIZACION
8325886;;F;61;CHILENO;;Boomers;COIHAIQUE                     ;AYSEN;16990;1;1;0;0;0;1;1;16990;CALIENTACAMA KIOTO ANALOGO 1 PLAZA KTC-1004;CLIMATIZACION
6863734;;M;71;CHILENO;;Silencioso;EL BOSQUE                     ;METROPOLITANA;168480;2;1;0;0;0;2;1;168480;ESTUFA HIBRIDA SR-6300NG;CLIMATIZACION
9423951;;F;58;CHILENO;;Boomers;"";"";33000;2;1;0;0;0;2;1;33000;TERMOVENTILADOR TH-FH31 BLANCO 1000W-2000W;CLIMATIZACION
10422291;;F;56;CHILENO;;Silencioso;PROVIDENCIA                   ;METROPOLITANA;606980;2;1;2;1;606980;0;0;0;CALEFACTOR LENA CLASSIC500 GRIS CHARCOAL;CLIMATIZACION
14420253;;M;48;CHILENO;;X;N/D;N/D;193980;2;1;2;1;193980;0;0;0;ESTUFA A GAS SUNNY CLASSIC WOOD 6600 NEGRA;CLIMATIZACION
9631008;Divorciado;F;61;CHILENO;;Boomers;OVALLE                        ;COQUIMBO;389980;2;2;0;0;0;2;2;389980;ESTUFA FIAMMA PRO;CLIMATIZACION
11292694;;F;54;CHILENO;;X;N/D;N/D;9990;1;1;0;0;0;1;1;9990;TERMOVENTILADOR KIOTO BLANCO 2000W KTE-1028B;CLIMATIZACION
15646354;;F;32;CHILENO;;Millenial;PROVIDENCIA                   ;METROPOLITANA;12990;1;1;1;1;12990;0;0;0;CALIENTACAMA KIOTO ANALOGO 1 PLAZA KTC-1004;CLIMATIZACION
6198460;;F;74;CHILENO;;Silencioso;LO ESPEJO                     ;METROPOLITANA;178480;2;1;0;0;0;2;1;178480;ESTUFA GAS KGQ15N 15K NEGRO EUROPEA;CLIMATIZACION
20092613;;F;23;CHILENO;;Z;PUNITAQUI                     ;COQUIMBO;19990;1;1;0;0;0;1;1;19990;TERMOVENTILADOR NICROM VFH300 BL 1800W;CLIMATIZACION
15504741;;M;39;CHILENO;;X;PROVIDENCIA                   ;METROPOLITANA;54180;3;1;0;0;0;3;1;54180;CALIENTACAMA KIOTO DIGITAL 2 PLAZAS KTC-1006;CLIMATIZACION
14008877;;M;41;CHILENO;;X;SAN FERNANDO                  ;L.G.B.OÂ´HIGGINS;341520;3;2;0;0;0;3;2;341520;ESTUFA KEROSENE 720+;CLIMATIZACION
17855973;;F;31;CHILENO;;Millenial;COIHAIQUE                     ;AYSEN;149990;1;1;0;0;0;1;1;149990;ESTUFA A GAS CALMA 5 KG COMPAK;CLIMATIZACION
13938333;;F;42;CHILENO;;Silencioso;PROVIDENCIA                   ;METROPOLITANA;103980;2;1;2;1;103980;0;0;0;ESTUFA GAS EH2500 5K NEGRO;CLIMATIZACION
6692354;;M;63;CHILENO;;Boomers;LAS CONDES                    ;METROPOLITANA;209980;2;1;0;0;0;2;1;209980;PANEL RADIANTE CALMA GREEN PG5000;CLIMATIZACION
15836832;;F;38;CHILENO;;Millenial;N/D;N/D;133980;2;1;2;1;133980;0;0;0;ESTUFA PARAFINA KPM-3300;CLIMATIZACION
6313386;;M;70;CHILENO;;Silencioso;PANGUIPULLI                   ;LOS RIOS;154990;1;1;0;0;0;1;1;154990;ESTUFA GAS KGQ15N 15K NEGRO EUROPEA;CLIMATIZACION
17828389;;F;30;CHILENO;;Millenial;GRANEROS                      ;L.G.B.OÂ´HIGGINS;9990;1;1;0;0;0;1;1;9990;ESTUFA CUARZO KIOTO 800W KTE-011A;CLIMATIZACION
7297926;Casado;F;66;CHILENO;PROFESOR;Boomers;PROVIDENCIA                   ;METROPOLITANA;143980;2;1;2;1;143980;0;0;0;ESTUFA GAS EH2500 5K NEGRO;CLIMATIZACION
12359479;Casado;F;48;CHILENO;;X;RENCA                         ;METROPOLITANA;498970;4;2;4;2;498970;0;0;0;ESTUFA GAS SR-6250NG;CLIMATIZACION
12888751;;M;47;CHILENO;;X;N/D;N/D;19990;1;1;0;0;0;1;1;19990;Termoventilador Ht 2014 R;CLIMATIZACION
10463255;;M;56;CHILENO;;Boomers;TEMUCO                        ;ARAUCANIA;253970;3;2;2;1;148980;1;1;104990;ESTUFA KEROSENE F 1120+;CLIMATIZACION
6016163;;F;77;CHILENO;;Silencioso;RENGO                         ;L.G.B.OÂ´HIGGINS;180960;4;2;0;0;0;4;2;180960;VENTILADOR PEDESTAL KTP-1015;CLIMATIZACION
10383330;;M;55;CHILENO;;Boomers;LOS ANDES                     ;VALPARAISO;24990;1;1;0;0;0;1;1;24990;VENTILADOR PEDESTAL KTP-1015;CLIMATIZACION
11826137;;F;50;CHILENO;;X;TOCOPILLA                     ;ANTOFAGASTA;63960;4;2;0;0;0;4;2;63960;VENTILADOR POWER BREEZE (120T);CLIMATIZACION
6455713;;M;70;CHILENO;;Silencioso;SAN RAMON                     ;METROPOLITANA;34990;1;1;0;0;0;1;1;34990;VENTILADOR PEDESTAL KTP-1015;CLIMATIZACION
8833101;Casado;F;62;CHILENO;;Boomers;PROVIDENCIA                   ;METROPOLITANA;59990;1;1;0;0;0;1;1;59990;VENTILADOR THOMAS TH-16CP Pedestal 16;CLIMATIZACION
19868042;;F;24;CHILENO;;Z;LEBU                          ;BIO BIO;232810;5;3;2;1;155840;3;2;76970;VENTILADOR 18 PLG CP 18 GUN METAL C/ SOPORTE;CLIMATIZACION
18867426;;F;27;CHILENO;;Millenial;N/D;N/D;431960;4;3;0;0;0;4;3;431960;VENTILADOR PEDESTAL KTP-1015;CLIMATIZACION
9263955;;M;59;CHILENO;;Boomers;SAN BERNARDO                  ;METROPOLITANA;123650;4;2;0;0;0;4;2;123650;VENTILADOR PEDESTAL16 PLG MODELO CPE 160 3 EN 1;CLIMATIZACION
19414985;;M;25;CHILENO;;Z;CHILLAN                       ;BIO BIO;279990;1;1;0;0;0;1;1;279990;V-AIRE PORTATIL MIDEA MPPD-12KHRN1;CLIMATIZACION
16202080;Soltero;F;36;CHILENO;;Millenial;VILLARICA                     ;ARAUCANIA;32990;1;1;0;0;0;1;1;32990;VENTILADOR PEDESTAL KTP-1015;CLIMATIZACION
7410079;;F;61;CHILENO;;Boomers;RENCA                         ;METROPOLITANA;27980;2;1;2;1;27980;0;0;0;VENTILADOR DE PEDESTAL F804;CLIMATIZACION
20494968;;F;22;CHILENO;;Z;LIMACHE;VALPARAISO;34990;1;1;0;0;0;1;1;34990;VENTILADOR PEDESTAL KTP-1015;CLIMATIZACION
20241241;;M;22;CHILENO;;Z;PROVIDENCIA                   ;METROPOLITANA;22990;1;1;0;0;0;1;1;22990;Ventilador BOX 12 Plastico KF-12B3;CLIMATIZACION
23169948;;F;35;PERUANO;;Extranjero;"";"";29990;1;1;0;0;0;1;1;29990;VENTILADOR PEDESTAL KTP-1015;CLIMATIZACION
16228714;;F;36;CHILENO;;Millenial;SAN CARLOS                    ;BIO BIO;73960;4;1;0;0;0;4;1;73960;VENTILADOR PEDESTAL KTP-1015;CLIMATIZACION
15006776;;F;39;CHILENO;;X;N/D;N/D;711530;3;1;3;1;711530;0;0;0;A/C FRIO/CALOR PORTATIL 12000BTU;CLIMATIZACION
11981061;;F;50;CHILENO;;X;PROVIDENCIA                   ;METROPOLITANA;59990;1;1;0;0;0;1;1;59990;VENTILADOR PEDESTAL 16 METAL-MADERA;CLIMATIZACION
14388331;;M;44;CHILENO;;X;RENCA                         ;METROPOLITANA;34990;1;1;0;0;0;1;1;34990;VENTILADOR PEDESTAL KTP-1015;CLIMATIZACION
15600043;;F;39;CHILENO;;X;PANGUIPULLI                   ;LOS RIOS;86960;4;3;0;0;0;4;3;86960;VENTILADOR PEDESTAL KTP-1015;CLIMATIZACION
11299476;;F;55;CHILENO;;Boomers;PROVIDENCIA                   ;METROPOLITANA;-24990;-1;1;0;0;0;-1;1;-24990;Ventilador BOX 12 Plastico KF-12B3;CLIMATIZACION
18286973;;M;29;CHILENO;;Millenial;RENGO                         ;L.G.B.OÂ´HIGGINS;29990;1;1;0;0;0;1;1;29990;VENTILADOR PEDESTAL KTP-1015;CLIMATIZACION
15592219;;M;38;CHILENO;;X;PROVIDENCIA                   ;METROPOLITANA;34990;1;1;0;0;0;1;1;34990;VENTILADOR PEDESTAL KTP-1015;CLIMATIZACION
7130155;;M;67;CHILENO;;Boomers;SAN FERNANDO                  ;L.G.B.OÂ´HIGGINS;49990;1;1;0;0;0;1;1;49990;Ventilador BOX 20 Metalico FE-45 20Â¿;CLIMATIZACION
18870773;;F;27;CHILENO;;Millenial;"";"";24990;1;1;0;0;0;1;1;24990;VENTILADOR PEDESTAL KTP-1015;CLIMATIZACION
20550015;;M;21;CHILENO;;Millenial;N/D;N/D;315840;2;5;2;5;315840;0;0;0;TERMOVENTILADOR KIOTO NEGRO 2000W KTE-1028N;CLIMATIZACION
12772671;;M;47;CHILENO;;X;ANGOL                         ;ARAUCANIA;27990;1;1;0;0;0;1;1;27990;VENTILADOR S/MESA NVS12-15055 12P;CLIMATIZACION
26637506;;M;54;VENEZOLANO;;Extranjero;N/D;N/D;263980;2;1;2;1;263980;0;0;0;AC PORTATIL ECO III 12000;CLIMATIZACION
6355447;;F;71;CHILENO;;Silencioso;N/D;N/D;319990;1;1;0;0;0;1;1;319990;A/C FRIO/CALOR PORTATIL 12000BTU;CLIMATIZACION
19623457;;F;30;CHILENO;;Millenial;N/D;N/D;154980;2;2;0;0;0;2;2;154980;VENTILADOR PEDESTAL KTP-1015;CLIMATIZACION
11987361;Casado;M;50;CHILENO;;X;RENCA                         ;METROPOLITANA;54990;1;1;0;0;0;1;1;54990;VENTILADOR THOMAS TH-16CP Pedestal 16;CLIMATIZACION
19650423;;F;27;CHILENO;;Millenial;N/D;N/D;31990;1;1;0;0;0;1;1;31990;VENTILADOR DE TORRE 301M;CLIMATIZACION
12743157;;M;46;CHILENO;;X;PROVIDENCIA                   ;METROPOLITANA;84980;2;1;0;0;0;2;1;84980;VENTILADOR PEDESTAL16 PLG MODELO CPE 160 3 EN 1;CLIMATIZACION
13087969;;F;46;CHILENO;;X;LO ESPEJO                     ;METROPOLITANA;26992;1;1;0;0;0;1;1;26992;VENTILADOR INDUSTRIAL KTI-1013;CLIMATIZACION
8895567;;F;62;CHILENO;;Boomers;SAN FELIPE                    ;VALPARAISO;454970;3;2;3;2;454970;0;0;0;KIT INSTALACION VERTICAL 6X4MTS ACERO;CLIMATIZACION
12675158;;F;48;CHILENO;;X;SANTIAGO                      ;METROPOLITANA;149990;1;1;0;0;0;1;1;149990;ENFRIADOR AIR COOLER AC2000;CLIMATIZACION
12546327;;F;47;CHILENO;;X;PENAFLOR                      ;METROPOLITANA;44980;2;2;2;2;44980;0;0;0;VENTILADOR PEDESTAL KTP-1016;CLIMATIZACION
10272091;;M;55;CHILENO;;Boomers;ALGARROBO                     ;VALPARAISO;292840;5;5;0;0;0;5;5;292840;VENTILADOR PEDESTAL KTP-1015;CLIMATIZACION
9911978;;M;56;CHILENO;;Boomers;RENCA                         ;METROPOLITANA;59980;2;2;0;0;0;2;2;59980;Ventilador Sobremesa Plastico KF 12D;CLIMATIZACION
8658683;Casado;M;50;CHILENO;;X;RENCA                         ;METROPOLITANA;106980;2;1;2;1;106980;0;0;0;KIT PELLET MURO ACERO;CLIMATIZACION
26451240;;M;43;EXTRANJERO - NO INFORMA NACIONALIDAD;;Extranjero;LIMACHE;VALPARAISO;89970;3;2;0;0;0;3;2;89970;VENTILADOR SOBREMESA 1696 COLOR NEGRO Y CROMADO;CLIMATIZACION
20025282;;F;23;CHILENO;;Z;PROVIDENCIA                   ;METROPOLITANA;6990;1;1;1;1;6990;0;0;0;TERMOVENTILADOR KIOTO NEGRO 2000W KTE-1028N;CLIMATIZACION
15290682;;M;38;CHILENO;;X;COIHAIQUE                     ;AYSEN;49990;1;1;0;0;0;1;1;49990;CHIMENEA ELECTRICA KIOTO 2000W KTE-1101;CLIMATIZACION
9283913;;M;60;CHILENO;;Silencioso;PROVIDENCIA                   ;METROPOLITANA;99980;2;2;0;0;0;2;2;99980;CHIMENEA ELECTRICA KIOTO 2000W KTE-1101;CLIMATIZACION
16218087;;M;47;CHILENO;;X;PROVIDENCIA                   ;METROPOLITANA;69980;2;1;0;0;0;2;1;69980;CHIMENEA ELECTRICA KIOTO 2000W KTE-1101;CLIMATIZACION
20233113;;F;23;CHILENO;;Z;PROVIDENCIA                   ;METROPOLITANA;80170;2;1;0;0;0;2;1;80170;CONVECTOR INFRAROJO EEC-1550NG;CLIMATIZACION
19514659;;M;25;CHILENO;;Silencioso;PROVIDENCIA                   ;METROPOLITANA;239980;2;1;2;1;239980;0;0;0;A/C FRIO/CALOR PORTATIL 12000BTU;CLIMATIZACION
9826124;;F;57;CHILENO;;Boomers;LEBU                          ;BIO BIO;63670;2;1;0;0;0;2;1;63670;CHIMENEA ELECTRICA KIOTO 2000W KTE-1101;CLIMATIZACION
16127491;;F;36;CHILENO;;Silencioso;PROVIDENCIA                   ;METROPOLITANA;0;0;0;0;0;0;0;0;0;ESTUFA CUARZO KIOTO 800W KTE-011A;CLIMATIZACION
15866322;;F;37;CHILENO;;Millenial;PROVIDENCIA                   ;METROPOLITANA;0;0;0;0;0;0;0;0;0;TERMOVENTILADOR VINTAGE HT RETRO 2000B;CLIMATIZACION
19980656;;F;24;CHILENO;;Z;PROVIDENCIA                   ;METROPOLITANA;0;0;0;0;0;0;0;0;0;CALIENTACAMA KIOTO ANALOGO 1 PLAZA KTC-1004;CLIMATIZACION
8816616;;F;62;CHILENO;;Boomers;ANCUD                         ;LOS LAGOS;0;0;0;0;0;0;0;0;0;TERMOVENTILADOR NICROM VFH300 BL 1800W;CLIMATIZACION
7299468;Soltero;F;67;CHILENO;MEDICO CIRUJANO;Boomers;LOS ANDES                     ;VALPARAISO;0;0;0;0;0;0;0;0;0;CALEFACTOR LENA LIMIT350 CHARCOAL;CLIMATIZACION
8948419;;M;61;CHILENO;;Silencioso;PROVIDENCIA                   ;METROPOLITANA;0;0;0;0;0;0;0;0;0;CALIENTACAMA KIOTO DIGITAL 2 PLAZAS KTC-1006;CLIMATIZACION
4786919;;M;74;CHILENO;;Silencioso;N/D;N/D;0;0;0;0;0;0;0;0;0;ESTUFA CUARZO KIOTO 800W KTE-011A;CLIMATIZACION
12013410;;F;54;CHILENO;;X;LA SERENA                     ;COQUIMBO;0;0;0;0;0;0;0;0;0;CALIENTACAMA KIOTO DIGITAL 2 PLAZAS KTC-1006;CLIMATIZACION
16362335;;M;36;CHILENO;;Millenial;COIHAIQUE                     ;AYSEN;0;0;0;0;0;0;0;0;0;TERMOVENTILADOR NICROM VFH1000 BL 2000W;CLIMATIZACION
10758862;;M;52;CHILENO;;X;RENCA                         ;METROPOLITANA;0;0;0;0;0;0;0;0;0;CALIENTACAMA KIOTO DIGITAL 2 PLAZAS KTC-1006;CLIMATIZACION
17190796;;M;32;CHILENO;;Millenial;N/D;N/D;0;0;0;0;0;0;0;0;0;CONVECTOR TH-CV51 BL 750W - 1250W - 2000W;CLIMATIZACION
14467821;;F;50;CHILENO;;X;CASTRO                        ;LOS LAGOS;0;0;0;0;0;0;0;0;0;CALEFACTOR LENA SCANTEK380 GRIS CHARCOAL;CLIMATIZACION
7812923;;M;60;CHILENO;;Boomers;RENCA                         ;METROPOLITANA;0;0;0;0;0;0;0;0;0;Calefactor Bosca a Lena Limit 480;CLIMATIZACION
8566211;;M;63;CHILENO;;Boomers;RENCA                         ;METROPOLITANA;0;0;0;0;0;0;0;0;0;ESTUFA CUARZO KIOTO 800W KTE-011A;CLIMATIZACION
19466354;;M;25;CHILENO;;Z;PROVIDENCIA                   ;METROPOLITANA;0;0;0;0;0;0;0;0;0;TERMOVENTILADOR KIOTO BLANCO 2000W KTE-1028B;CLIMATIZACION
9407721;;M;60;CHILENO;;Boomers;N/D;N/D;0;0;0;0;0;0;0;0;0;ESTUFA A GAS UT GRX-6200 ET ROJA 15 KILOS;CLIMATIZACION
16036414;Soltero;F;37;CHILENO;DISENADOR EDITORIAL;Silencioso;PROVIDENCIA                   ;METROPOLITANA;0;0;0;0;0;0;0;0;0;ESTUFA CUARZO KIOTO 800W KTE-011A;CLIMATIZACION
15789897;;F;38;CHILENO;;Millenial;RENCA                         ;METROPOLITANA;0;0;0;0;0;0;0;0;0;CHIMENEA ELECTRICA KIOTO 2000W KTE-1101;CLIMATIZACION
6299039;;M;74;CHILENO;;Silencioso;PROVIDENCIA                   ;METROPOLITANA;0;0;0;0;0;0;0;0;0;MINI OLEOELECTRICA KIOTO 500W BLANCO KTE-1081B;CLIMATIZACION
12769407;;M;46;CHILENO;;X;LOS ANGELES                   ;BIO BIO;0;0;0;0;0;0;0;0;0;CALEFACTOR CARBONO 800W EEC-3000 NEGRO;CLIMATIZACION
11675230;;M;52;CHILENO;;X;PROVIDENCIA                   ;METROPOLITANA;0;0;0;0;0;0;0;0;0;CHIMENEA ELECTRICA KIOTO 2000W KTE-1101;CLIMATIZACION
8446291;Soltero;F;64;CHILENO;CONTADOR GENERAL;Boomers;RENCA                         ;METROPOLITANA;0;0;0;0;0;0;0;0;0;ESTUFA ELECTRICA CUARZO KIOTO 1200W KTE 1033;CLIMATIZACION
19077552;;F;27;CHILENO;;Z;N/D;N/D;0;0;0;0;0;0;0;0;0;CALIENTACAMA KIOTO DIGITAL 2 PLAZAS KTC-1006;CLIMATIZACION
10112745;;F;57;CHILENO;;Boomers;TALCA                         ;MAULE;0;0;0;0;0;0;0;0;0;CONVECTOR TH-CV51 BL 750W - 1250W - 2000W;CLIMATIZACION
8364286;;F;62;CHILENO;;Silencioso;PROVIDENCIA                   ;METROPOLITANA;0;0;0;0;0;0;0;0;0;CALEFACTOR LENA ITALY6100 ROJO;CLIMATIZACION
8378653;;F;63;CHILENO;;Boomers;CONCEPCION                    ;BIO BIO;0;0;0;0;0;0;0;0;0;CONVECTOR ELECT. UT HMC-2000;CLIMATIZACION
9291565;;F;60;CHILENO;;Boomers;CONCEPCION                    ;BIO BIO;0;0;0;0;0;0;0;0;0;TERMOVENTILADOR KIOTO BLANCO 2000W KTE-1028B;CLIMATIZACION
16589049;;F;35;CHILENO;;Millenial;PROVIDENCIA                   ;METROPOLITANA;0;0;0;0;0;0;0;0;0;CALIENTACAMA KIOTO DIGITAL 2 PLAZAS KTC-1006;CLIMATIZACION
19236049;Soltero;M;26;CHILENO;;Z;PROVIDENCIA                   ;METROPOLITANA;0;0;0;0;0;0;0;0;0;CALIENTACAMAS ANALOGO 1PL;CLIMATIZACION
4403767;;M;74;CHILENO;;Silencioso;PUNTA ARENAS                  ;MAGALLANES;0;0;0;0;0;0;0;0;0;MINI OLEOELECTRICA KIOTO 500W NEGRO KTE-1081N;CLIMATIZACION
19398340;;F;25;CHILENO;;Silencioso;PROVIDENCIA                   ;METROPOLITANA;0;0;0;0;0;0;0;0;0;CONVECTOR ELECTRICO KIOTO 2000W KTE-1105;CLIMATIZACION
15393277;;M;39;CHILENO;;X;N/D;N/D;0;0;0;0;0;0;0;0;0;ESTUFA ELEC. FIBRA DE CARBONO NSB120K5 ROJA;CLIMATIZACION
9085945;;M;56;CHILENO;;Boomers;PROVIDENCIA                   ;METROPOLITANA;0;0;0;0;0;0;0;0;0;ESTUFA INFRAROJA TH-IR60;CLIMATIZACION
18731290;;M;28;CHILENO;;Millenial;PROVIDENCIA                   ;METROPOLITANA;0;0;0;0;0;0;0;0;0;CALIENTACAMA KIOTO DIGITAL 2 PLAZAS KTC-1006;CLIMATIZACION
8780600;;F;60;CHILENO;;Boomers;RETIRO                        ;MAULE;0;0;0;0;0;0;0;0;0;CALIENTACAMA KIOTO DIGITAL 2 PLAZAS KTC-1006;CLIMATIZACION
7485043;;F;71;CHILENO;;Silencioso;RENCA                         ;METROPOLITANA;0;0;0;0;0;0;0;0;0;TERMOVENTILADOR KIOTO BLANCO 2000W KTE-1028B;CLIMATIZACION
11987391;;F;50;CHILENO;;X;PROVIDENCIA                   ;METROPOLITANA;0;0;0;0;0;0;0;0;0;ESTUFA A GAS UT GRX-4200 15 KILOS;CLIMATIZACION
19287642;Soltero;F;26;CHILENO;TECNICO DE NIVEL SUPERIOR EN COSMETOLOGIA;Z;PROVIDENCIA                   ;METROPOLITANA;0;0;0;0;0;0;0;0;0;ESTUFA ELECTRICA CUARZO KIOTO 1200W KTE 1033;CLIMATIZACION
6015871;;F;69;CHILENO;;Silencioso;LAS CABRAS                    ;L.G.B.OÂ´HIGGINS;0;0;0;0;0;0;0;0;0;ESTUFA CUARZO KIOTO 800W KTE-011A;CLIMATIZACION
14716351;;M;60;CHILENO;;Extranjero;PROVIDENCIA                   ;METROPOLITANA;0;0;0;0;0;0;0;0;0;CONVECTOR ELECTRICO KIOTO 2000W KTE-1105;CLIMATIZACION
12700873;;F;47;CHILENO;;X;RENCA                         ;METROPOLITANA;0;0;0;0;0;0;0;0;0;ESTUFA ELECTRICA CUARZO KIOTO 1200W KTE 1033;CLIMATIZACION
12645859;;M;48;CHILENO;;Millenial;N/D;N/D;0;0;0;0;0;0;0;0;0;CONVECTOR INFRAROJO EEC-1550NG;CLIMATIZACION
16894023;;F;34;CHILENO;;Millenial;PUERTO MONTT                  ;LOS LAGOS;0;0;0;0;0;0;0;0;0;ESTUFA CUARZO KC-1200;CLIMATIZACION
13572943;;M;43;CHILENO;;X;"";"";0;0;0;0;0;0;0;0;0;CALIENTACAMA KIOTO DIGITAL 2 PLAZAS KTC-1006;CLIMATIZACION
12053399;Casado;F;51;CHILENO;;X;CURICO                        ;MAULE;0;0;0;0;0;0;0;0;0;ESTUFA ELECTRICA CUARZO KIOTO 1200W KTE 1033;CLIMATIZACION
5431114;;M;73;CHILENO;;Silencioso;SANTIAGO                      ;METROPOLITANA;0;0;0;0;0;0;0;0;0;CONVECTOR UT N10;CLIMATIZACION
9701749;;F;62;CHILENO;;Boomers;"";"";0;0;0;0;0;0;0;0;0;ESTUFA VALORY MINI BLACK Incl REG Y MANG;CLIMATIZACION
13230313;;F;44;CHILENO;;X;LA LIGUA                      ;VALPARAISO;0;0;0;0;0;0;0;0;0;CALIENTACAMA KIOTO ANALOGO 1 PLAZA KTC-1004;CLIMATIZACION
14283114;Casado;F;48;CHILENO;INGENIERO COMERCIAL;X;PROVIDENCIA                   ;METROPOLITANA;0;0;0;0;0;0;0;0;0;CALIENTACAMAS DIGITAL SUBLIME MAXI 1.5PL;CLIMATIZACION
15289248;;F;38;CHILENO;;X;CASTRO                        ;LOS LAGOS;0;0;0;0;0;0;0;0;0;ESTUFA HIBRIDA SR-6300NG;CLIMATIZACION
19371951;;F;25;CHILENO;;Z;PROVIDENCIA                   ;METROPOLITANA;0;0;0;0;0;0;0;0;0;ESTUFA ELEC. CHIMENEA TH-FP70 NG 1000W-2000W;CLIMATIZACION
18806953;Soltero;F;26;CHILENO;ENFERMERA;Z;PROVIDENCIA                   ;METROPOLITANA;0;0;0;0;0;0;0;0;0;TERMOVENTILADOR NICROM VFH300 BL 1800W;CLIMATIZACION
18795643;Soltero;M;28;CHILENO;;Silencioso;PROVIDENCIA                   ;METROPOLITANA;0;0;0;0;0;0;0;0;0;ESTUFA CUARZO KIOTO 800W KTE-011A;CLIMATIZACION
15202132;;F;39;CHILENO;;X;N/D;N/D;0;0;0;0;0;0;0;0;0;ESTUFA CUARZO KIOTO 800W KTE-011A;CLIMATIZACION
15199621;;F;39;CHILENO;;X;CONCEPCION                    ;BIO BIO;0;0;0;0;0;0;0;0;0;ESTUFA INFRARROJA ELECTRICA KIOTO 1500W KTE-1045;CLIMATIZACION
8505563;Viudo;M;61;CHILENO;;Boomers;RENCA                         ;METROPOLITANA;0;0;0;0;0;0;0;0;0;CONVECTOR TURBO KCH 2000 BL;CLIMATIZACION
10633145;Casado;F;58;CHILENO;;Boomers;PERALILLO                     ;L.G.B.OÂ´HIGGINS;0;0;0;0;0;0;0;0;0;TERMOVENTILADOR NICROM VFH300 BL 1800W;CLIMATIZACION
14342137;;F;45;CHILENO;;X;SAN JAVIER                    ;MAULE;0;0;0;0;0;0;0;0;0;CALIENTACAMA KIOTO ANALOGO 1 PLAZA KTC-1004;CLIMATIZACION
17884194;Soltero;M;30;CHILENO;;Millenial;PROVIDENCIA                   ;METROPOLITANA;0;0;0;0;0;0;0;0;0;CALIENTACAMA KIOTO DIGITAL 1 PLAZA KTC-1005;CLIMATIZACION
19810260;;F;24;CHILENO;;Z;TEMUCO;ARAUCANIA;0;0;0;0;0;0;0;0;0;TERMOVENTILADOR KIOTO BLANCO 2000W KTE-1028B;CLIMATIZACION
14006872;;F;41;CHILENO;;X;PROVIDENCIA                   ;METROPOLITANA;0;0;0;0;0;0;0;0;0;ESTUFA CUARZO KIOTO 800W KTE-011A;CLIMATIZACION
20133025;;F;23;CHILENO;;Silencioso;PROVIDENCIA                   ;METROPOLITANA;0;0;0;0;0;0;0;0;0;ESTUFA ELECTRICA CUARZO KIOTO 1200W KTE 1033;CLIMATIZACION
19034492;Soltero;M;27;CHILENO;;Z;PROVIDENCIA                   ;METROPOLITANA;0;0;0;0;0;0;0;0;0;ESTUFA HIBRIDA SR-6300NG;CLIMATIZACION
7089290;;F;68;CHILENO;;Silencioso;PROVIDENCIA                   ;METROPOLITANA;0;0;0;0;0;0;0;0;0;ESTUFA ELECTRICA CUARZO KIOTO 1200W KTE 1033;CLIMATIZACION
9041034;;F;60;CHILENO;;Boomers;CORONEL                       ;BIO BIO;0;0;0;0;0;0;0;0;0;Estufa a gas Kaly 15;CLIMATIZACION
13366219;;M;44;CHILENO;;X;N/D;N/D;0;0;0;0;0;0;0;0;0;TERMOVENTILADOR NICROM VFH1000 BL 2000W;CLIMATIZACION
7022541;Casado;F;57;CHILENO;ABOGADO;Silencioso;PROVIDENCIA                   ;METROPOLITANA;0;0;0;0;0;0;0;0;0;TERMOVENTILADOR NICROM VFH1000 BL 2000W;CLIMATIZACION
9552058;;M;56;CHILENO;;Boomers;N/D;N/D;0;0;0;0;0;0;0;0;0;ESTUFA FIAMMA PRO;CLIMATIZACION
17259281;;F;32;CHILENO;;Millenial;MARCHIHUE                     ;L.G.B.OÂ´HIGGINS;0;0;0;0;0;0;0;0;0;TERMOVENTILADOR VERTICAL SUN05 PURP.;CLIMATIZACION
9563734;;M;57;CHILENO;;Boomers;PROVIDENCIA                   ;METROPOLITANA;0;0;0;0;0;0;0;0;0;CALIENTACAMA KIOTO DIGITAL 2 PLAZAS KTC-1006;CLIMATIZACION
14475191;Soltero;F;45;CHILENO;;X;LA ESTRELLA                   ;L.G.B.OÂ´HIGGINS;0;0;0;0;0;0;0;0;0;TERMOVENTILADOR KIOTO NEGRO 2000W KTE-1028N;CLIMATIZACION
11212662;;M;55;CHILENO;;Boomers;RENCA                         ;METROPOLITANA;0;0;0;0;0;0;0;0;0;ESTUFA PARAFINA KPM-23;CLIMATIZACION
7066893;;F;53;CHILENO;;X;COIHAIQUE                     ;AYSEN;0;0;0;0;0;0;0;0;0;CONVECTOR ELECT. UT HMC-2000;CLIMATIZACION
6929183;;F;53;CHILENO;;Silencioso;PROVIDENCIA                   ;METROPOLITANA;0;0;0;0;0;0;0;0;0;MINI OLEOELECTRICA KIOTO 500W NEGRO KTE-1081N;CLIMATIZACION
18137668;;F;30;CHILENO;;Millenial;PROVIDENCIA                   ;METROPOLITANA;0;0;0;0;0;0;0;0;0;ESTUFA ELECTRICA CUARZO KIOTO 1200W KTE 1033;CLIMATIZACION
18459972;;F;29;CHILENO;;Millenial;PROVIDENCIA                   ;METROPOLITANA;0;0;0;0;0;0;0;0;0;ESTUFA PARAFINA KPL-36;CLIMATIZACION
9859359;Casado;F;55;CHILENO;;Boomers;RENCA                         ;METROPOLITANA;0;0;0;0;0;0;0;0;0;CALIENTACAMA KIOTO DIGITAL 2 PLAZAS KTC-1006;CLIMATIZACION
16528914;Soltero;F;35;CHILENO;TECNICO DE NIVEL SUPERIOR EN ENFERMERIA;Millenial;RENCA                         ;METROPOLITANA;0;0;0;0;0;0;0;0;0;CALEFACTOR CARBONO 800W EEC-3000 NEGRO;CLIMATIZACION
10804470;Casado;F;53;CHILENO;;X;RENCA                         ;METROPOLITANA;0;0;0;0;0;0;0;0;0;CALIENTACAMA KIOTO ANALOGO 1 PLAZA KTC-1004;CLIMATIZACION
7695092;;M;60;CHILENO;;Boomers;PROVIDENCIA                   ;METROPOLITANA;0;0;0;0;0;0;0;0;0;MINI OLEOELECTRICA KIOTO 500W NEGRO KTE-1081N;CLIMATIZACION
24941324;;M;26;HAITIANO;;Extranjero;N/D;N/D;0;0;0;0;0;0;0;0;0;TERMOVENTILADOR KIOTO BLANCO 2000W KTE-1028B;CLIMATIZACION
6737575;;M;67;CHILENO;;Boomers;PANQUEHUE                     ;VALPARAISO;0;0;0;0;0;0;0;0;0;CALIENTACAMA KIOTO DIGITAL 1 PLAZA KTC-1005;CLIMATIZACION
13370640;;F;46;CHILENO;;X;CURICO                        ;MAULE;0;0;0;0;0;0;0;0;0;TERMOVENTILADOR KIOTO BLANCO 2000W KTE-1028B;CLIMATIZACION
13035600;;M;46;CHILENO;;X;PROVIDENCIA                   ;METROPOLITANA;0;0;0;0;0;0;0;0;0;ESTUFA ELEC. RADIADOR TH-RFC50 800W-1600W-2000W;CLIMATIZACION
26537551;Soltero;M;41;EXTRANJERO - NO INFORMA NACIONALIDAD;;Extranjero;PROVIDENCIA                   ;METROPOLITANA;0;0;0;0;0;0;0;0;0;CONVECTOR ELECT. UT HMC-2000 TW-TIM;CLIMATIZACION
16137729;;F;37;CHILENO;;Millenial;CHIGUAYANTE                   ;BIO BIO;0;0;0;0;0;0;0;0;0;ESTUFA ELEC. INFRAROJO KPH96T NG;CLIMATIZACION
19292632;;F;26;CHILENO;;Z;"";"";0;0;0;0;0;0;0;0;0;CALEFACTOR LENA LIMIT380 CHARCOAL;CLIMATIZACION
14275669;;F;48;CHILENO;;X;RENCA                         ;METROPOLITANA;0;0;0;0;0;0;0;0;0;CONVECTOR ELECT. UT HMC-2000;CLIMATIZACION
11147421;;F;55;CHILENO;;Boomers;LINARES                       ;MAULE;0;0;0;0;0;0;0;0;0;CALIENTACAMA KIOTO ANALOGO 1 PLAZA KTC-1004;CLIMATIZACION
18131846;;M;29;CHILENO;;Millenial;PROVIDENCIA                   ;METROPOLITANA;0;0;0;0;0;0;0;0;0;TERMOVENTILADOR KIOTO BLANCO 2000W KTE-1028B;CLIMATIZACION
26922733;;M;32;EXTRANJERO - NO INFORMA NACIONALIDAD;;Extranjero;N/D;N/D;0;0;0;0;0;0;0;0;0;TERMOVENTILADOR KIOTO NEGRO 2000W KTE-1028N;CLIMATIZACION
19459039;;M;25;CHILENO;;Z;PROVIDENCIA                   ;METROPOLITANA;0;0;0;0;0;0;0;0;0;ESTUFA GAS SR-6250NG;CLIMATIZACION
12909107;;M;46;CHILENO;;X;PROVIDENCIA                   ;METROPOLITANA;0;0;0;0;0;0;0;0;0;CALEFACTOR CONVECTOR EEP-2100BL;CLIMATIZACION
17259947;;M;33;CHILENO;;Millenial;TEMUCO                        ;ARAUCANIA;0;0;0;0;0;0;0;0;0;ESTUFA CUARZO KIOTO 800W KTE-011A;CLIMATIZACION
7057823;Casado;F;69;CHILENO;;Silencioso;PROVIDENCIA                   ;METROPOLITANA;0;0;0;0;0;0;0;0;0;CALIENTACAMA KIOTO DIGITAL 2 PLAZAS KTC-1006;CLIMATIZACION
15081928;;F;40;CHILENO;;X;N/D;N/D;0;0;0;0;0;0;0;0;0;CALIENTACAMA KIOTO DIGITAL 1 PLAZA KTC-1005;CLIMATIZACION
11996230;;F;50;CHILENO;;X;NANCAGUA                      ;L.G.B.OÂ´HIGGINS;0;0;0;0;0;0;0;0;0;TERMOVENTILADOR NICROM VFH300 BL 1800W;CLIMATIZACION
11237550;;M;54;CHILENO;;X;CABRERO                       ;BIO BIO;0;0;0;0;0;0;0;0;0;ESTUFA GAS KG5 5K NEGRO EUROPEA;CLIMATIZACION
12957890;;F;45;CHILENO;;X;EL QUISCO                     ;VALPARAISO;0;0;0;0;0;0;0;0;0;ESTUFA CUARZO KIOTO 800W KTE-011A;CLIMATIZACION
18868592;;F;28;CHILENO;;Millenial;N/D;N/D;0;0;0;0;0;0;0;0;0;ESTUFA INFRARROJA ELECTRICA KIOTO 1500W KTE-1045;CLIMATIZACION
9241572;;F;59;CHILENO;;Boomers;PROVIDENCIA                   ;METROPOLITANA;0;0;0;0;0;0;0;0;0;TERMOVENTILADOR KIOTO BLANCO 2000W KTE-1028B;CLIMATIZACION
13858039;;F;41;CHILENO;;X;RENCA                         ;METROPOLITANA;0;0;0;0;0;0;0;0;0;ESTUFA ELECTRICA CUARZO KIOTO 1200W KTE 1033;CLIMATIZACION
18711059;;F;28;CHILENO;;Millenial;COPIAPO                       ;ATACAMA;0;0;0;0;0;0;0;0;0;TERMOVENTILADOR KIOTO NEGRO 2000W KTE-1028N;CLIMATIZACION
20214160;;F;22;CHILENO;;Z;PROVIDENCIA                   ;METROPOLITANA;0;0;0;0;0;0;0;0;0;CHIMENEA ELECTRICA KIOTO 2000W KTE-1101;CLIMATIZACION
18263078;;M;29;CHILENO;;Millenial;HUARA                         ;TARAPACA;0;0;0;0;0;0;0;0;0;CONVECTOR ELECT. UT HMC-2000 TW-TIM;CLIMATIZACION
11173708;;F;55;CHILENO;;Boomers;SAN FERNANDO                  ;L.G.B.OÂ´HIGGINS;0;0;0;0;0;0;0;0;0;ESTUFA FIAMMA PRO;CLIMATIZACION
8334313;;F;63;CHILENO;;Boomers;PROVIDENCIA                   ;METROPOLITANA;0;0;0;0;0;0;0;0;0;CALIENTACAMA KIOTO DIGITAL 1 PLAZA KTC-1005;CLIMATIZACION
6905897;;M;70;CHILENO;;Silencioso;CAUQUENES                     ;MAULE;0;0;0;0;0;0;0;0;0;CHIMENEA ELECTRICA KIOTO 2000W KTE-1101;CLIMATIZACION
5920685;Casado;F;74;CHILENO;;Silencioso;PROVIDENCIA                   ;METROPOLITANA;0;0;0;0;0;0;0;0;0;ESTUFA VITTALE-40 15K;CLIMATIZACION
6162468;;M;74;CHILENO;;Silencioso;CAUQUENES                     ;MAULE;0;0;0;0;0;0;0;0;0;TERMOVENTILADOR KIOTO NEGRO 2000W KTE-1028N;CLIMATIZACION
20308653;;F;22;CHILENO;;Silencioso;PROVIDENCIA                   ;METROPOLITANA;0;0;0;0;0;0;0;0;0;TURBO CALEFACTOR VERT. TC-2100V BLANCO;CLIMATIZACION
19443584;;F;25;CHILENO;;Z;PUENTE ALTO                   ;METROPOLITANA;0;0;0;0;0;0;0;0;0;CHIMENEA ELECTRICA KIOTO 2000W KTE-1101;CLIMATIZACION
13653504;;F;42;CHILENO;;Millenial;PROVIDENCIA                   ;METROPOLITANA;0;0;0;0;0;0;0;0;0;ESTUFA VITTALE-40 15K;CLIMATIZACION
16875832;;F;34;CHILENO;;Millenial;PROVIDENCIA                   ;METROPOLITANA;0;0;0;0;0;0;0;0;0;ESTUFA ELEC. FIBRA DE CARBONO NSB120K5 ROJA;CLIMATIZACION
16274391;;M;36;CHILENO;;Millenial;RENCA                         ;METROPOLITANA;0;0;0;0;0;0;0;0;0;CALIENTACAMA KIOTO ANALOGO 1 PLAZA KTC-1004;CLIMATIZACION
19818222;;F;24;CHILENO;;Silencioso;PROVIDENCIA                   ;METROPOLITANA;0;0;0;0;0;0;0;0;0;ESTUFA ELECTRICA CUARZO KIOTO 1200W KTE 1033;CLIMATIZACION
12404658;Soltero;F;49;CHILENO;ENFERMERA MATRONA;X;RENCA                         ;METROPOLITANA;0;0;0;0;0;0;0;0;0;ESTUFA GAS KGQ15N 15K NEGRO EUROPEA;CLIMATIZACION
18335458;;M;29;CHILENO;;Millenial;PROVIDENCIA                   ;METROPOLITANA;0;0;0;0;0;0;0;0;0;CALIENTACAMAS ANALOGO BASICO 2 PL;CLIMATIZACION
22374118;;M;42;COLOMBIANO;;Extranjero;LAS CONDES                    ;METROPOLITANA;0;0;0;0;0;0;0;0;0;CALIENTACAMAS MANUAL 2N SG-5120D4 1PL;CLIMATIZACION
26319476;;F;30;HAITIANO;;Extranjero;ISLA DE MAIPO                 ;METROPOLITANA;0;0;0;0;0;0;0;0;0;CALIENTACAMAS ANALOGO BASICO 1PL;CLIMATIZACION
12243665;;M;50;CHILENO;;X;TALCA                         ;MAULE;0;0;0;0;0;0;0;0;0;ESTUFA GAS KGQ15N 15K NEGRO EUROPEA;CLIMATIZACION
16580608;;M;35;CHILENO;;Millenial;DIEGO DE ALMAGRO              ;ATACAMA;0;0;0;0;0;0;0;0;0;CONVECTOR ELECT. UT HMC-2000 TW-TIM;CLIMATIZACION
16197926;;M;36;CHILENO;;Millenial;RENCA                         ;METROPOLITANA;0;0;0;0;0;0;0;0;0;CONVECTOR ELECT. UT HMC-2000 TW-TIM;CLIMATIZACION
12753367;;F;47;CHILENO;;X;CONCEPCION                    ;BIO BIO;0;0;0;0;0;0;0;0;0;CALIENTACAMA KIOTO DIGITAL 1 PLAZA KTC-1005;CLIMATIZACION
19656567;;F;28;CHILENO;;Silencioso;BUIN                          ;METROPOLITANA;0;0;0;0;0;0;0;0;0;CALIENTACAMAS MANUAL 2N SG-5121D4 2PL;CLIMATIZACION
14311145;Soltero;M;46;CHILENO;ABOGADO;X;RENCA                         ;METROPOLITANA;0;0;0;0;0;0;0;0;0;TERMOVENTILADOR NICROM VFH300 BL 1800W;CLIMATIZACION
13220945;;F;44;CHILENO;;X;ANTOFAGASTA                   ;ANTOFAGASTA;0;0;0;0;0;0;0;0;0;ESTUFA ELECTRICA CUARZO KIOTO 1200W KTE 1033;CLIMATIZACION
12550949;;M;48;CHILENO;;X;PROVIDENCIA                   ;METROPOLITANA;0;0;0;0;0;0;0;0;0;CHIMENEA ELECTRICA KIOTO 2000W KTE-1101;CLIMATIZACION
18191805;;F;29;CHILENO;;Millenial;PROVIDENCIA                   ;METROPOLITANA;0;0;0;0;0;0;0;0;0;TERMOVENTILADOR KIOTO NEGRO 2000W KTE-1028N;CLIMATIZACION
12411778;;M;49;CHILENO;;X;SAN PEDRO                     ;METROPOLITANA;0;0;0;0;0;0;0;0;0;TERMOVENTILADOR NICROM VFH500 BL 2000W;CLIMATIZACION
18285908;Soltero;M;29;CHILENO;;Millenial;PROVIDENCIA                   ;METROPOLITANA;0;0;0;0;0;0;0;0;0;ESTUFA ELECTRICA CUARZO KIOTO 1200W KTE 1033;CLIMATIZACION
13912637;;F;42;CHILENO;;Silencioso;PROVIDENCIA                   ;METROPOLITANA;0;0;0;0;0;0;0;0;0;ESTUFA ELEC. FIBRA DE CARBONO NSB120K5 ROJA;CLIMATIZACION
16577152;;F;33;CHILENO;;Millenial;MELIPILLA                     ;METROPOLITANA;0;0;0;0;0;0;0;0;0;TERMOVENTILADOR KIOTO BLANCO 2000W KTE-1028B;CLIMATIZACION
5047597;;M;75;CHILENO;;Silencioso;PROVIDENCIA                   ;METROPOLITANA;0;0;0;0;0;0;0;0;0;ESTUFA ELEC. CHIMENEA TH-FP100 CAFE 1000W-2000W;CLIMATIZACION
17367975;;F;32;CHILENO;;Millenial;CALERA                        ;VALPARAISO;0;0;0;0;0;0;0;0;0;ESTUFA GAS SUNNY SR-6200 15K;CLIMATIZACION
10231235;;F;56;CHILENO;;Boomers;CABILDO                       ;VALPARAISO;0;0;0;0;0;0;0;0;0;CHIMENEA ELECTRICA KIOTO 2000W KTE-1101;CLIMATIZACION
26664777;;F;50;VENEZOLANO;;Extranjero;N/D;N/D;0;0;0;0;0;0;0;0;0;TERMOVENTILADOR KIOTO NEGRO 2000W KTE-1028N;CLIMATIZACION
15524995;;M;39;CHILENO;;X;RANCAGUA                      ;L.G.B.OÂ´HIGGINS;0;0;0;0;0;0;0;0;0;ESTUFA A GAS UT GRX-4200 15 KILOS;CLIMATIZACION
9098947;;M;60;CHILENO;;Boomers;MAIPU                         ;METROPOLITANA;0;0;0;0;0;0;0;0;0;CONVECTOR UT N10;CLIMATIZACION
9814292;Soltero;F;55;CHILENO;ACUPUNTURISTA;Boomers;PROVIDENCIA                   ;METROPOLITANA;0;0;0;0;0;0;0;0;0;CALIENTACAMAS ANALOGO BASICO 1PL;CLIMATIZACION
16028520;;F;37;CHILENO;;Millenial;SAN CARLOS                    ;BIO BIO;0;0;0;0;0;0;0;0;0;ESTUFA VITTALE-40 15K;CLIMATIZACION
9714403;;F;58;CHILENO;;Boomers;RENCA                         ;METROPOLITANA;0;0;0;0;0;0;0;0;0;CALEFACTOR INFRAROJO GR2800 ET;CLIMATIZACION
19395456;;M;25;CHILENO;;Silencioso;PROVIDENCIA                   ;METROPOLITANA;0;0;0;0;0;0;0;0;0;ESTUFA A GAS UT GRX-4200 15 KILOS;CLIMATIZACION
20270390;;F;22;CHILENO;;Silencioso;PROVIDENCIA                   ;METROPOLITANA;0;0;0;0;0;0;0;0;0;ESTUFA GAS KG5 5K NEGRO EUROPEA;CLIMATIZACION
13284547;;M;45;CHILENO;;Silencioso;"";"";0;0;0;0;0;0;0;0;0;ESTUFA ELEC. CHIMENEA TH-FP100 CAFE 1000W-2000W;CLIMATIZACION
19814930;;M;24;CHILENO;;Z;PROVIDENCIA                   ;METROPOLITANA;0;0;0;0;0;0;0;0;0;KIT INSTALACION VERTICAL 80MMX4MTS ACERO;CLIMATIZACION
6668793;;F;73;CHILENO;;Silencioso;QUINCHAO                      ;LOS LAGOS;0;0;0;0;0;0;0;0;0;ESTUFA ELECTRICA CARBONO ECOHEATEH1000 1000W;CLIMATIZACION
15750031;;M;38;CHILENO;;Silencioso;PROVIDENCIA                   ;METROPOLITANA;0;0;0;0;0;0;0;0;0;TERMOVENTILADOR KIOTO NEGRO 2000W KTE-1028N;CLIMATIZACION
8212612;;F;59;CHILENO;;Boomers;RENCA                         ;METROPOLITANA;0;0;0;0;0;0;0;0;0;TERMOVENTILADOR OSCILANTE FH-120S BL;CLIMATIZACION
9751798;;F;58;CHILENO;;Boomers;PROVIDENCIA                   ;METROPOLITANA;0;0;0;0;0;0;0;0;0;ESTUFA GAS EH2500 5K NEGRO;CLIMATIZACION
7602434;Casado;F;67;CHILENO;;Boomers;PROVIDENCIA                   ;METROPOLITANA;0;0;0;0;0;0;0;0;0;ESTUFA GAS EH5200 15K GRAFITO;CLIMATIZACION
18429951;;F;29;CHILENO;;Millenial;PROVIDENCIA                   ;METROPOLITANA;0;0;0;0;0;0;0;0;0;ESTUFA KEROSENE F 1120+;CLIMATIZACION
18452065;Soltero;M;28;CHILENO;;Millenial;PROVIDENCIA                   ;METROPOLITANA;0;0;0;0;0;0;0;0;0;TERMOVENTILADOR CERAMICO TH-CH40;CLIMATIZACION
17830991;;F;31;CHILENO;;Millenial;PROVIDENCIA                   ;METROPOLITANA;0;0;0;0;0;0;0;0;0;VENTILADOR 12 SOBREMESA 45W;CLIMATIZACION
4718019;;F;81;CHILENO;;Silencioso;CALAMA                        ;ANTOFAGASTA;0;0;0;0;0;0;0;0;0;ESTUFA ELECTRICA CUARZO KIOTO 1200W KTE 1033;CLIMATIZACION
7196112;;F;66;CHILENO;;Silencioso;PROVIDENCIA                   ;METROPOLITANA;0;0;0;0;0;0;0;0;0;CALIENTACAMAS DIGITAL SUBLIME MAXI 1.5PL;CLIMATIZACION
9614687;;F;44;CHILENO;;X;LA FLORIDA;METROPOLITANA;0;0;0;0;0;0;0;0;0;ENFRIADOR DE AIRE EEA-350;CLIMATIZACION
19607780;;M;24;CHILENO;;Z;ANCUD                         ;LOS LAGOS;0;0;0;0;0;0;0;0;0;TERMOVENTILADOR KIOTO NEGRO 2000W KTE-1028N;CLIMATIZACION
18431531;;M;28;CHILENO;;Millenial;COIHAIQUE                     ;AYSEN;0;0;0;0;0;0;0;0;0;CALIENTACAMA KIOTO DIGITAL 2 PLAZAS KTC-1006;CLIMATIZACION
14017946;;F;41;CHILENO;;X;PROVIDENCIA                   ;METROPOLITANA;0;0;0;0;0;0;0;0;0;CALIENTACAMAS ANALOGO BASICO 1PL;CLIMATIZACION
8667045;Casado;M;65;CHILENO;;Boomers;RENCA                         ;METROPOLITANA;0;0;0;0;0;0;0;0;0;TERMOVENTILADOR NICROM VFH300 BL 1800W;CLIMATIZACION
7493617;Casado;M;67;CHILENO;;Boomers;RENCA                         ;METROPOLITANA;0;0;0;0;0;0;0;0;0;VENTILADOR INDUSTRIAL KTI-1013;CLIMATIZACION
15318019;;M;36;CHILENO;;Millenial;RENCA                         ;METROPOLITANA;0;0;0;0;0;0;0;0;0;KIT INSTALACION VERTICAL 6X4MTS ACERO;CLIMATIZACION
7831434;;F;62;CHILENO;;Boomers;RENCA                         ;METROPOLITANA;0;0;0;0;0;0;0;0;0;VENTILADOR PEDESTAL KTP-1015;CLIMATIZACION
20142638;;M;22;CHILENO;;Z;PROVIDENCIA                   ;METROPOLITANA;0;0;0;0;0;0;0;0;0;ENFRIADOR DE AIRE EEA-350;CLIMATIZACION
8191286;;M;62;CHILENO;;Boomers;RENCA                         ;METROPOLITANA;0;0;0;0;0;0;0;0;0;Ventilador Sobremesa Plastico KF 12D;CLIMATIZACION
25746330;;M;26;VENEZOLANO;;Extranjero;CHILLAN                       ;BIO BIO;0;0;0;0;0;0;0;0;0;VENTILADOR PEDESTAL KF-16P;CLIMATIZACION
8198134;;M;59;CHILENO;;Boomers;PANGUIPULLI                   ;LOS LAGOS;0;0;0;0;0;0;0;0;0;VENTILADOR PEDESTAL KTP-1015;CLIMATIZACION
14202260;;M;41;CHILENO;;Extranjero;"";"";0;0;0;0;0;0;0;0;0;ENFRIADOR Y HUMIFICADOR THOMAS Blanco/Negro;CLIMATIZACION
13091714;;M;46;CHILENO;;X;PROVIDENCIA                   ;METROPOLITANA;0;0;0;0;0;0;0;0;0;VENTILADOR PEDESTAL KF-16P;CLIMATIZACION
12023542;;F;54;CHILENO;;X;ANCUD                         ;LOS LAGOS;0;0;0;0;0;0;0;0;0;VENTILADOR SOBREMESA KF-16D;CLIMATIZACION
19391392;Soltero;M;25;CHILENO;;Silencioso;PROVIDENCIA                   ;METROPOLITANA;0;0;0;0;0;0;0;0;0;VENTILADOR WIND BREEZE (160S);CLIMATIZACION
13259698;;M;45;CHILENO;;X;PROVIDENCIA                   ;METROPOLITANA;0;0;0;0;0;0;0;0;0;VENTILADOR INDUSTRIAL KTI-1013;CLIMATIZACION
12360021;;M;49;CHILENO;;X;SAN ESTEBAN                   ;VALPARAISO;0;0;0;0;0;0;0;0;0;ENFRIADOR Y HUMIFICADOR THOMAS Blanco/Negro;CLIMATIZACION
16572991;;F;36;CHILENO;;Millenial;SAN BERNARDO                  ;METROPOLITANA;0;0;0;0;0;0;0;0;0;VENTILADOR PEDESTAL KTP-1015;CLIMATIZACION
18559975;Soltero;M;28;CHILENO;;Millenial;LINARES                       ;MAULE;0;0;0;0;0;0;0;0;0;VENTILADOR PEDESTAL KTP-1015;CLIMATIZACION
8589553;;M;61;CHILENO;;Boomers;CABRERO                       ;BIO BIO;0;0;0;0;0;0;0;0;0;VENTILADOR WIND BREEZE (160S);CLIMATIZACION
19125401;;M;26;CHILENO;;Z;N/D;N/D;0;0;0;0;0;0;0;0;0;VENTILADOR PEDESTAL KTP-1016;CLIMATIZACION
7839873;;F;62;CHILENO;;Boomers;ARICA                         ;ARICA Y PARINACOTA;0;0;0;0;0;0;0;0;0;VENTILADOR POWER BREEZE (120T);CLIMATIZACION
16734885;;F;34;CHILENO;;Millenial;"";"";0;0;0;0;0;0;0;0;0;VENTILADOR PEDESTAL KTP-1015;CLIMATIZACION
19191678;;F;26;CHILENO;;Z;LIMACHE                       ;VALPARAISO;0;0;0;0;0;0;0;0;0;VENTILADOR THOMAS TH-16CP Pedestal 16;CLIMATIZACION
18353196;;F;29;CHILENO;;Millenial;PROVIDENCIA                   ;METROPOLITANA;0;0;0;0;0;0;0;0;0;VENTILADOR PEDESTAL KTP-1015;CLIMATIZACION
12895203;;M;47;CHILENO;;X;N/D;N/D;0;0;0;0;0;0;0;0;0;ENFRIADOR DE AIRE KFL-1702;CLIMATIZACION
5796909;Divorciado;M;72;CHILENO;;Silencioso;RENCA                         ;METROPOLITANA;0;0;0;0;0;0;0;0;0;VENTILADOR PEDESTAL KF-16P;CLIMATIZACION
18854220;;F;27;CHILENO;;Z;SAN FELIPE                    ;VALPARAISO;0;0;0;0;0;0;0;0;0;VENTILADOR 12 SOBREMESA 45W;CLIMATIZACION
11807984;;F;51;CHILENO;;X;RENCA                         ;METROPOLITANA;0;0;0;0;0;0;0;0;0;ESTUFA GAS SUNNY SR-5200 G/LIC 5K PT;CLIMATIZACION
11392871;;M;53;CHILENO;;X;PROVIDENCIA                   ;METROPOLITANA;0;0;0;0;0;0;0;0;0;Ventilador BOX 12 Plastico KF-12B3;CLIMATIZACION
17155463;;F;33;CHILENO;;Millenial;N/D;N/D;0;0;0;0;0;0;0;0;0;VENTILADOR 12 SOBREMESA 45W;CLIMATIZACION
6210646;;F;72;CHILENO;;Silencioso;RENCA                         ;METROPOLITANA;0;0;0;0;0;0;0;0;0;VENTILADOR CALMA MURAL 50W 16P;CLIMATIZACION
15633719;;F;38;CHILENO;;X;N/D;N/D;0;0;0;0;0;0;0;0;0;VENTILADOR PEDESTAL KTP-1016;CLIMATIZACION
17757606;Soltero;M;31;CHILENO;KINESIOLOGO;Millenial;PROVIDENCIA                   ;METROPOLITANA;0;0;0;0;0;0;0;0;0;VENTILADOR PEDESTAL KTP-1015;CLIMATIZACION
18048465;;F;30;CHILENO;;Millenial;N/D;N/D;0;0;0;0;0;0;0;0;0;VENTILADOR PEDESTAL KTP-1016;CLIMATIZACION
10950331;;F;55;CHILENO;;Boomers;MONTE PATRIA                  ;COQUIMBO;0;0;0;0;0;0;0;0;0;Enfriador KSH-16R;CLIMATIZACION
7270979;;F;69;CHILENO;;Silencioso;PROVIDENCIA                   ;METROPOLITANA;0;0;0;0;0;0;0;0;0;TERMOVENTILADOR KIOTO BLANCO 2000W KTE-1028B;CLIMATIZACION
7219753;;F;67;CHILENO;;Boomers;CAUQUENES                     ;MAULE;0;0;0;0;0;0;0;0;0;ESTUFA ELECTRICA CUARZO KIOTO 1200W KTE 1033;CLIMATIZACION
15387599;;F;37;CHILENO;;Millenial;N/D;N/D;0;0;0;0;0;0;0;0;0;CALIENTACAMA KIOTO DIGITAL 2 PLAZAS KTC-1006;CLIMATIZACION
16434175;;F;35;CHILENO;;Millenial;MOLINA                        ;MAULE;0;0;0;0;0;0;0;0;0;ESTUFA VITTALE-40 15K;CLIMATIZACION
13841700;;M;42;CHILENO;;X;PARRAL                        ;MAULE;27480;2;1;0;0;0;2;1;27480;SECADOR DE PELO SIEGEN SG-3035;PERSONAL CARE
18574190;;F;28;CHILENO;;Millenial;CONSTITUCION                  ;MAULE;17493;1;1;0;0;0;1;1;17493;SECADOR GAMA BORA KERATION;PERSONAL CARE
13996138;;M;40;CHILENO;;X;PROVIDENCIA                   ;METROPOLITANA;17990;1;1;0;0;0;1;1;17990;CORTAPELO SPORT 544;PERSONAL CARE
13328327;;F;43;CHILENO;;X;VALLENAR;ATACAMA;269971;3;3;0;0;0;3;3;269971;ALISADOR DE PELO HP8321;PERSONAL CARE
17666679;;F;31;CHILENO;;Millenial;PROVIDENCIA                   ;METROPOLITANA;13990;1;1;0;0;0;1;1;13990;SECADOR DE PELO SG-3012C29 MORADO;PERSONAL CARE
16961828;;M;34;CHILENO;;Extranjero;N/D;N/D;12990;1;1;0;0;0;1;1;12990;SECADOR DE PELO SG-3012C29 MORADO;PERSONAL CARE
19042704;;F;27;CHILENO;;Z;TALCA                         ;MAULE;510960;4;3;0;0;0;4;3;510960;SECADOR DE PELO SG-3051;PERSONAL CARE
5791239;;F;77;CHILENO;;Silencioso;ANTOFAGASTA                   ;ANTOFAGASTA;84980;2;1;0;0;0;2;1;84980;COMBO SIEGEN AFEITADORA + MULTISTYLER SG-8440;PERSONAL CARE
13939443;;F;42;CHILENO;;X;EL BOSQUE                     ;METROPOLITANA;193970;3;2;2;1;93980;1;1;99990;ALISADORA SG-4751;PERSONAL CARE
6797156;;M;70;CHILENO;;Silencioso;N/D;N/D;341829;9;3;0;0;0;9;3;341829;SECADOR DE PELO SE-3049C01 FUCSIA;PERSONAL CARE
20661993;;F;21;CHILENO;;Millenial;"";"";39990;1;1;0;0;0;1;1;39990;TRICOMBO SECADOR+ALISADOR+ONDULAD;PERSONAL CARE
10290321;;F;52;CHILENO;;X;COIHAIQUE                     ;AYSEN;844910;9;8;0;0;0;9;8;844910;DEPILADORA SG-9004;PERSONAL CARE
16104536;;F;36;CHILENO;;Millenial;LEBU                          ;BIO BIO;595470;3;2;0;0;0;3;2;595470;SECADOR DE PELO SG-3012C23 VERDE;PERSONAL CARE
15921000;;F;37;CHILENO;;Millenial;LINARES                       ;MAULE;750920;8;8;4;2;519960;4;6;230960;SECADOR PHILIPS BHC010;PERSONAL CARE
17888841;;F;31;CHILENO;;Millenial;PROVIDENCIA                   ;METROPOLITANA;83960;4;3;0;0;0;4;3;83960;SECADOR DE PELO SIEGEN SG-3035;PERSONAL CARE
15283468;;F;38;CHILENO;;X;N/D;N/D;19990;1;1;0;0;0;1;1;19990;SECADOR DE PELO SIEGEN SG-3035;PERSONAL CARE
18751959;;F;28;CHILENO;;Millenial;N/D;N/D;480890;11;7;0;0;0;11;7;480890;DEPILADORA SG-9003;PERSONAL CARE
13775562;;F;47;CHILENO;;X;PROVIDENCIA                   ;METROPOLITANA;178980;2;2;0;0;0;2;2;178980;ALISADOR +SECADOR PELO;PERSONAL CARE
10167817;;F;55;CHILENO;;Boomers;PROVIDENCIA                   ;METROPOLITANA;14990;1;1;0;0;0;1;1;14990;SECADOR DE VIAJE REMINGTON D2400;PERSONAL CARE
7793483;;F;71;CHILENO;;Silencioso;QUILLOTA                      ;VALPARAISO;183221;4;3;0;0;0;4;3;183221;ALISADOR DE PELO S12A(220) Shine Therapy PALTA M;PERSONAL CARE
5725267;;M;75;CHILENO;;Silencioso;LOS ANGELES                   ;BIO BIO;56550;3;2;0;0;0;3;2;56550;SECADOR DE PELO SG-3012C23 VERDE;PERSONAL CARE
14503522;;F;47;CHILENO;;X;SALAMANCA                     ;COQUIMBO;184970;3;2;0;0;0;3;2;184970;SECADOR DE PELO SG-3012 NEGRO;PERSONAL CARE
7636957;;M;65;CHILENO;;Boomers;SANTA MARIA                   ;VALPARAISO;49980;2;4;0;0;0;2;4;49980;AFEITADORA SG-7250 NEGRO;PERSONAL CARE
19794917;;F;25;CHILENO;;Z;BUIN                          ;METROPOLITANA;39990;1;1;0;0;0;1;1;39990;ALISADOR DE PELO S12A(220) Shine Therapy PALTA M;PERSONAL CARE
17333498;;F;32;CHILENO;;Millenial;RANCAGUA                      ;L.G.B.OÂ´HIGGINS;43980;2;2;1;1;21990;1;1;21990;SECADOR GAMA BORA KERATION;PERSONAL CARE
9804098;;F;55;CHILENO;;Boomers;ARICA                         ;TARAPACA;107123;3;2;0;0;0;3;2;107123;SECADOR DE PELO SIEGEN SG-3035;PERSONAL CARE
18485492;;F;28;CHILENO;;Silencioso;PROVIDENCIA                   ;METROPOLITANA;14990;1;1;0;0;0;1;1;14990;SECADOR DE PELO MISTRAL STD;PERSONAL CARE
17157274;;F;32;CHILENO;;Millenial;ROMERAL                       ;MAULE;24990;1;1;0;0;0;1;1;24990;SECADOR DE PELO SE-3049C01 FUCSIA;PERSONAL CARE
26237230;;M;43;EXTRANJERO - NO INFORMA NACIONALIDAD;;Extranjero;N/D;N/D;591321;8;7;0;0;0;8;7;591321;AFEITADORA SG-7210 NEGRO;PERSONAL CARE
20542519;;F;21;CHILENO;;Millenial;N/D;N/D;33980;2;2;0;0;0;2;2;33980;Secador de Pelo 3000 Series Philips BHD340/10;PERSONAL CARE
10861213;;F;52;CHILENO;;X;LEBU                          ;BIO BIO;19990;1;1;0;0;0;1;1;19990;Secador de Pelo 3000 Series Philips BHD340/10;PERSONAL CARE
16460422;Casado;F;36;CHILENO;;Millenial;RENCA                         ;METROPOLITANA;42990;1;1;0;0;0;1;1;42990;DEPILADORA SG-9004EX;PERSONAL CARE
18185205;;M;30;CHILENO;;Millenial;PIRQUE;METROPOLITANA;49990;1;1;1;1;49990;0;0;0;COMBO SIEGEN AFEITADORA + MULTISTYLER SG-8440;PERSONAL CARE
18650554;;F;27;CHILENO;;Millenial;MOSTAZAL;O HIGGINS;24990;1;1;0;0;0;1;1;24990;SECADOR DE PELO SE-3049C01 FUCSIA;PERSONAL CARE
8844020;;M;61;CHILENO;;Boomers;COIHAIQUE                     ;AYSEN;513910;9;6;0;0;0;9;6;513910;ALISADOR DE PELO SG-3540 MORADO MORADO;PERSONAL CARE
10296440;;F;55;CHILENO;;Boomers;LOS ANGELES                   ;BIO BIO;37083;2;2;0;0;0;2;2;37083;SECADOR DE PELO SG-3012C29 MORADO;PERSONAL CARE
9956974;Casado;F;59;CHILENO;;Boomers;PROVIDENCIA                   ;METROPOLITANA;12990;1;1;0;0;0;1;1;12990;SECADOR DE PELO SG-3012 NEGRO;PERSONAL CARE
7064691;;F;72;CHILENO;;Silencioso;N/D;N/D;627700;8;5;0;0;0;8;5;627700;SECADOR DE PELO SG-3012C29 MORADO;PERSONAL CARE
5776222;;M;77;CHILENO;;Silencioso;VILLARICA                     ;ARAUCANIA;27990;1;1;0;0;0;1;1;27990;SECADOR DE PELO SE-3049C01 FUCSIA;PERSONAL CARE
15713429;;F;38;CHILENO;;Millenial;SAN ANTONIO                   ;VALPARAISO;29980;2;2;0;0;0;2;2;29980;SECADOR DE PELO MISTRAL STD;PERSONAL CARE
16157054;;F;36;CHILENO;;Millenial;RENCA                         ;METROPOLITANA;32240;2;1;0;0;0;2;1;32240;SECADOR DE PELO SG-3051;PERSONAL CARE
16585251;;M;35;CHILENO;;Millenial;CHONCHI                       ;LOS LAGOS;76980;2;1;0;0;0;2;1;76980;AFEITADORA GAMA SH 1527 WD;PERSONAL CARE
7748683;;F;65;CHILENO;;Boomers;EL TABO                       ;VALPARAISO;173120;5;4;0;0;0;5;4;173120;SECADOR DIAMOND STD;PERSONAL CARE
11770443;;F;53;CHILENO;;Extranjero;SAN CARLOS                    ;BIO BIO;53660;3;2;0;0;0;3;2;53660;ONDULADOR GAMA 33MM TURMALINA;PERSONAL CARE
14060109;;F;41;CHILENO;;X;PROVIDENCIA                   ;METROPOLITANA;450970;3;3;2;2;429980;1;1;20990;SECADOR DE PELO SIEGEN SG-3035;PERSONAL CARE
19020933;;F;26;CHILENO;;Z;REQUINOA                      ;L.G.B.OÂ´HIGGINS;209450;3;2;0;0;0;3;2;209450;ALISADOR SG-3510C11 VERDE;PERSONAL CARE
20317837;;F;22;CHILENO;;Z;COYHAIQUE;AYSEN;50690;3;2;0;0;0;3;2;50690;SECADOR GAMA EOLIC MINI TRAVEL;PERSONAL CARE
18751426;;F;28;CHILENO;;Millenial;ALTO DEL CARMEN               ;ATACAMA;17990;1;1;0;0;0;1;1;17990;CORTA PELO SG-8200;PERSONAL CARE
17106960;Soltero;F;33;CHILENO;;Millenial;PROVIDENCIA                   ;METROPOLITANA;26990;1;1;0;0;0;1;1;26990;SECADOR DE PELO SE-3049C01 FUCSIA;PERSONAL CARE
10211328;;F;57;CHILENO;;Boomers;BUIN                          ;METROPOLITANA;90950;5;4;0;0;0;5;4;90950;SECADOR DE PELO MISTRAL STD;PERSONAL CARE
14421922;;F;47;CHILENO;;X;TALCA                         ;MAULE;34990;1;1;0;0;0;1;1;34990;DEPILADORA SG-9040;PERSONAL CARE
8004370;;F;62;CHILENO;;Boomers;RENCA                         ;METROPOLITANA;31990;1;1;0;0;0;1;1;31990;CORTA PELO SG-8520;PERSONAL CARE
17470070;;F;32;CHILENO;;Millenial;"";"";1157930;7;5;4;2;996960;3;3;160970;ALISADORA SG-4751;PERSONAL CARE
16505358;;F;35;CHILENO;;Millenial;"";"";111870;5;3;0;0;0;5;3;111870;ALISADOR DE PELO SG-4651 ROJO;PERSONAL CARE
16270833;;F;36;CHILENO;;Millenial;TALCA                         ;MAULE;39980;4;3;0;0;0;4;3;39980;ALISADOR +SECADOR PELO;PERSONAL CARE
8470993;Casado;F;51;CHILENO;EDUCADOR DE PARVULO;X;RENCA                         ;METROPOLITANA;12990;1;1;0;0;0;1;1;12990;SECADOR DE VIAJE REMINGTON D2400;PERSONAL CARE
17036406;;M;33;CHILENO;;Millenial;CURANILAHUE                   ;BIO BIO;76980;2;2;0;0;0;2;2;76980;CORTABARBA BT3206;PERSONAL CARE
10181522;;M;52;CHILENO;;X;TOCOPILLA                     ;ANTOFAGASTA;834940;6;4;0;0;0;6;4;834940;ALISADOR SIEGEN SG-4716;PERSONAL CARE
19168700;;M;27;CHILENO;;Z;SAN CARLOS                    ;BIO BIO;20990;1;1;0;0;0;1;1;20990;SECADOR DE PELO SIEGEN SG-3035;PERSONAL CARE
11198202;;M;55;CHILENO;;Boomers;OSORNO                        ;LOS LAGOS;34990;1;1;0;0;0;1;1;34990;AFEITADORA GAMA GSH986 SPORT;PERSONAL CARE
17814030;;F;31;CHILENO;;Millenial;NUEVA IMPERIAL                ;ARAUCANIA;582681;8;6;0;0;0;8;6;582681;DEPILADORA SG-9004;PERSONAL CARE
15597379;;F;38;CHILENO;;X;RENCA                         ;METROPOLITANA;34990;1;1;0;0;0;1;1;34990;COMBO GAMA SECADOR+ALISADOR+CEPILLO;PERSONAL CARE
16621764;;F;35;CHILENO;;Extranjero;PROVIDENCIA                   ;METROPOLITANA;12990;1;1;0;0;0;1;1;12990;SECADOR DE PELO SG-3012 NEGRO;PERSONAL CARE
13926511;;F;42;CHILENO;;Millenial;"";"";14990;1;1;0;0;0;1;1;14990;SECADOR DE PELO MISTRAL STD;PERSONAL CARE
20101716;;F;23;CHILENO;;Z;COLINA                        ;METROPOLITANA;38990;1;1;0;0;0;1;1;38990;ALISADOR REMIG. WET2 S27A (BV) R;PERSONAL CARE
13123981;Soltero;F;46;CHILENO;CONTADOR AUDITOR;X;CASTRO                        ;LOS LAGOS;782712;7;6;4;3;619960;3;3;162752;SECADOR GAMA EOLIC MINI TRAVEL;PERSONAL CARE
15422052;;F;40;CHILENO;;X;PROVIDENCIA                   ;METROPOLITANA;19990;1;1;0;0;0;1;1;19990;SECADOR DE PELO SIEGEN SG-3035;PERSONAL CARE
12956755;;F;45;CHILENO;;X;RENCA                         ;METROPOLITANA;12990;1;1;0;0;0;1;1;12990;SECADOR DE VIAJE REMINGTON D2400;PERSONAL CARE
16071805;;M;36;CHILENO;;Millenial;PROVIDENCIA                   ;METROPOLITANA;24990;1;1;0;0;0;1;1;24990;CORTA PELO SPORT GCX 623 BVT;PERSONAL CARE
15304797;;M;40;CHILENO;;X;COIHAIQUE                     ;AYSEN;154980;2;2;0;0;0;2;2;154980;AFEITADORA SPORT;PERSONAL CARE
16083780;;F;37;CHILENO;;Millenial;CERRO NAVIA                   ;METROPOLITANA;30140;2;1;0;0;0;2;1;30140;CORTA PELO SG-8520;PERSONAL CARE
10827256;;F;55;CHILENO;;Boomers;SAN FERNANDO                  ;L.G.B.OÂ´HIGGINS;72980;2;2;0;0;0;2;2;72980;SECADOR DE PELO SG-3012C29 MORADO;PERSONAL CARE
9046030;;M;60;CHILENO;;Boomers;RENCA                         ;METROPOLITANA;39990;1;1;0;0;0;1;1;39990;ALISADOR DE PELO SG-3540 MORADO MORADO;PERSONAL CARE
14700635;;M;49;CHILENO;;Extranjero;PROVIDENCIA                   ;METROPOLITANA;157460;3;2;0;0;0;3;2;157460;SECADOR DE PELO SE-3049C01 FUCSIA;PERSONAL CARE
17320387;;M;33;CHILENO;;Millenial;PROVIDENCIA                   ;N/D;39970;3;1;0;0;0;3;1;39970;KIT CORTABARBA MG3711;PERSONAL CARE
7870416;;M;63;CHILENO;;Boomers;PROVIDENCIA                   ;METROPOLITANA;20990;1;1;0;0;0;1;1;20990;Secador de Pelo 3000 Series Philips BHD340/10;PERSONAL CARE
12262127;;M;50;CHILENO;;X;PAINE                         ;METROPOLITANA;29990;1;3;0;0;0;1;3;29990;CORTA PELO SG-8520;PERSONAL CARE
16209930;;F;36;CHILENO;;Millenial;N/D;N/D;66980;2;2;0;0;0;2;2;66980;ONDULADOR DE PELO SG-2420 33MM;PERSONAL CARE
16731656;;F;34;CHILENO;;Millenial;SAN JAVIER                    ;MAULE;488970;3;3;1;1;269990;2;2;218980;SECADOR GAMA BRILLIAN AQUA;PERSONAL CARE
9728231;;F;54;CHILENO;;Boomers;COIHAIQUE                     ;AYSEN;289890;3;2;0;0;0;3;2;289890;TRICOMBO SECADOR+ALISADOR+ONDULAD;PERSONAL CARE
19472212;;F;25;CHILENO;;Z;TALCA                         ;MAULE;19990;1;1;0;0;0;1;1;19990;SECADOR DE PELO SIEGEN SG-3035;PERSONAL CARE
11633798;;M;52;CHILENO;;X;N/D;N/D;639940;6;3;0;0;0;6;3;639940;SECADOR DE PELO D13A-220-R PLATA;PERSONAL CARE
13509080;;F;44;CHILENO;;X;CONCEPCION                    ;BIO BIO;196970;3;2;2;1;183980;1;1;12990;SECADOR DE PELO SG-3025 SILVER;PERSONAL CARE
18219299;;F;29;CHILENO;;Millenial;VALLENAR;ATACAMA;141970;3;3;0;0;0;3;3;141970;SECADOR DE PELO SG-3051;PERSONAL CARE
7940293;;F;61;CHILENO;;Boomers;RENCA                         ;METROPOLITANA;19990;1;1;0;0;0;1;1;19990;SECADOR DE PELO SIEGEN SG-3035;PERSONAL CARE
11794650;;F;51;CHILENO;;X;"";"";28140;2;1;0;0;0;2;1;28140;CORTA PELO GC-615;PERSONAL CARE
18572266;;F;28;CHILENO;;Millenial;TALCA                         ;MAULE;367960;4;3;0;0;0;4;3;367960;ALISADOR ELEGANCE LED KER;PERSONAL CARE
19355486;;F;25;CHILENO;;Z;ARICA                         ;ARICA Y PARINACOTA;510231;2;2;0;0;0;2;2;510231;ALISADOR DE PELO SG-4651 ROJO;PERSONAL CARE
19311028;;F;25;CHILENO;;Z;CANETE                        ;BIO BIO;127950;5;4;2;1;53980;3;3;73970;SECADOR DE PELO SG-3043 DC CAFE 2200 WATTS;PERSONAL CARE
16510457;Soltero;F;36;CHILENO;DISENADOR GRAFICO;Millenial;PROVIDENCIA                   ;METROPOLITANA;38980;2;2;0;0;0;2;2;38980;SECADOR GAMA BRILLIAN AQUA;PERSONAL CARE
10470898;;F;55;CHILENO;;Boomers;CALAMA                        ;ANTOFAGASTA;14990;1;1;0;0;0;1;1;14990;CORTA PELO SG-8200;PERSONAL CARE
11444237;;F;53;CHILENO;;X;SAN CARLOS                    ;BIO BIO;103970;3;2;0;0;0;3;2;103970;SECADOR GAMA BRILLIAN AQUA;PERSONAL CARE
8352919;Casado;M;64;CHILENO;;Boomers;RENCA                         ;METROPOLITANA;21990;1;1;0;0;0;1;1;21990;AFEITADORA SG-7210 NEGRO;PERSONAL CARE
11439255;;F;52;CHILENO;;X;CHILLAN                       ;BIO BIO;13240;2;1;0;0;0;2;1;13240;SECADOR DE PELO SG-3012C29 MORADO;PERSONAL CARE
11418322;;M;53;CHILENO;;X;ANGOL                         ;ARAUCANIA;178970;3;2;0;0;0;3;2;178970;SECADOR DE PELO SG-3049 NEGRO;PERSONAL CARE
12975584;;M;46;CHILENO;;X;TALCAHUANO                    ;BIO BIO;31990;1;1;0;0;0;1;1;31990;SECADOR DE PELO SG-3051;PERSONAL CARE
19468344;;F;24;CHILENO;;Millenial;"";"";43980;2;1;2;1;43980;0;0;0;COMBO GAMA SECADOR+ALISADOR+CEPILLO;PERSONAL CARE
13771336;Casado;F;42;CHILENO;;X;TALAGANTE                     ;METROPOLITANA;19990;1;1;0;0;0;1;1;19990;Secador de Pelo 3000 Series Philips BHD340/10;PERSONAL CARE
18670457;;F;28;CHILENO;;Millenial;PUENTE ALTO                   ;METROPOLITANA;24990;1;1;0;0;0;1;1;24990;SECADOR DE PELO SE-3049C01 FUCSIA;PERSONAL CARE
12184072;;F;50;CHILENO;;X;N/D;N/D;194970;3;2;3;2;194970;0;0;0;SECADOR GAMA BORA KERATION;PERSONAL CARE
13627375;;M;43;CHILENO;;X;LEBU                          ;BIO BIO;353721;3;3;0;0;0;3;3;353721;ALISADOR DE PELO SG-3540 MORADO MORADO;PERSONAL CARE
19364361;;F;25;CHILENO;;Z;LOTA                          ;BIO BIO;13990;1;1;0;0;0;1;1;13990;SECADOR DE PELO SG-3012C29 MORADO;PERSONAL CARE
15444056;;F;39;CHILENO;;X;CURICO                        ;MAULE;51960;4;2;0;0;0;4;2;51960;SECADOR DE PELO D3019 PRO TITANIO;PERSONAL CARE
19134242;Soltero;M;27;CHILENO;;Z;PROVIDENCIA                   ;METROPOLITANA;12990;1;1;1;1;12990;0;0;0;CORTAPELO GAMA MG 566;PERSONAL CARE
16992318;;F;33;CHILENO;;Millenial;LA LIGUA                      ;VALPARAISO;38980;2;3;0;0;0;2;3;38980;SECADOR DE PELO SIEGEN SG-3035;PERSONAL CARE
11286167;;F;54;CHILENO;;X;SAN JAVIER                    ;MAULE;366660;9;5;0;0;0;9;5;366660;SECADOR DE PELO SG-3012 NEGRO;PERSONAL CARE
16364831;;F;35;CHILENO;;Millenial;COIHAIQUE                     ;AYSEN;439960;4;4;0;0;0;4;4;439960;DEPILADORA BRE255/00;PERSONAL CARE
18442191;;F;29;CHILENO;;Millenial;PROVIDENCIA                   ;METROPOLITANA;12990;1;1;0;0;0;1;1;12990;SECADOR DE PELO SG-3012C29 MORADO;PERSONAL CARE
15883396;;F;39;CHILENO;;X;N/D;N/D;64221;3;3;0;0;0;3;3;64221;CORTA PELO SG-8520;PERSONAL CARE
14224894;;M;40;CHILENO;;X;N/D;N/D;242940;6;4;0;0;0;6;4;242940;SECADOR DE PELO SG-3012C29 MORADO;PERSONAL CARE
24910521;;M;33;COLOMBIANO;;Extranjero;NATALES                       ;MAGALLANES;2775300;19;16;0;0;0;19;16;2775300;CORTAPELOS GM 596;PERSONAL CARE
17803457;;M;31;CHILENO;;Millenial;TALAGANTE                     ;METROPOLITANA;751910;9;6;6;3;553940;3;3;197970;KIT CORTABARBA MG3711;PERSONAL CARE
7821994;;F;66;CHILENO;;Boomers;PENAFLOR                      ;METROPOLITANA;170220;5;3;0;0;0;5;3;170220;ALISADOR +SECADOR PELO;PERSONAL CARE
14260879;;F;48;CHILENO;;X;RENGO                         ;L.G.B.OÂ´HIGGINS;20990;1;1;0;0;0;1;1;20990;DEPILADORA SG-9003;PERSONAL CARE
26545668;;F;43;VENEZOLANO;;Extranjero;TALCA                         ;MAULE;39990;1;1;1;1;39990;0;0;0;ALISADOR DE PELO S12A(220) Shine Therapy PALTA M;PERSONAL CARE
10865339;;M;56;CHILENO;;Boomers;COLTAUCO                      ;L.G.B.OÂ´HIGGINS;925970;3;2;0;0;0;3;2;925970;SECADOR DE PELO MISTRAL STD;PERSONAL CARE
5408239;Casado;M;74;CHILENO;;Silencioso;RENCA                         ;METROPOLITANA;29990;1;1;0;0;0;1;1;29990;AFEITADORA SPORT SH 886 BAT;PERSONAL CARE
8631247;;F;64;CHILENO;;Boomers;OVALLE                        ;COQUIMBO;2339970;13;6;0;0;0;13;6;2339970;COMBO SIEGEN AFEITADORA + MULTISTYLER SG-8440;PERSONAL CARE
10875776;;F;57;CHILENO;;Boomers;TALCAHUANO                    ;BIO BIO;58980;2;2;0;0;0;2;2;58980;COMBO SIEGEN AFEITADORA + MULTISTYLER SG-8440;PERSONAL CARE
10702367;;F;55;CHILENO;;Boomers;ANDACOLLO                     ;COQUIMBO;47980;2;2;0;0;0;2;2;47980;SECADOR DE VIAJE REMINGTON D2400;PERSONAL CARE
10229177;;M;55;CHILENO;;Boomers;RENCA                         ;METROPOLITANA;27990;1;1;0;0;0;1;1;27990;CORTA PELO HC3520;PERSONAL CARE
11146341;Casado;F;54;CHILENO;;Boomers;RENCA                         ;METROPOLITANA;16990;1;1;0;0;0;1;1;16990;SECADOR DE PELO MISTRAL STD;PERSONAL CARE
8317021;;F;63;CHILENO;;Boomers;RECOLETA                      ;METROPOLITANA;188970;3;2;2;1;163980;1;1;24990;SECADOR DE PELO SE-3049C01 FUCSIA;PERSONAL CARE
11934605;;F;49;CHILENO;;X;VALLENAR;ATACAMA;166620;4;2;2;1;132640;2;1;33980;ALISADOR SG-3510C11 VERDE;PERSONAL CARE
15940833;;M;37;CHILENO;;Z;PROVIDENCIA                   ;METROPOLITANA;49990;1;1;0;0;0;1;1;49990;DEPILADORA OASIS SENSATION;PERSONAL CARE
6820271;;F;76;CHILENO;;Silencioso;ILLAPEL                       ;COQUIMBO;133480;5;2;0;0;0;5;2;133480;CORTA PELO SG-8200;PERSONAL CARE
19924232;;M;24;CHILENO;;Z;PROVIDENCIA                   ;METROPOLITANA;24990;1;1;0;0;0;1;1;24990;CORTAPELOS GM 596;PERSONAL CARE
4788707;;M;75;CHILENO;;Silencioso;QUILLOTA                      ;VALPARAISO;26990;1;1;0;0;0;1;1;26990;SECADOR TEMPO TITAN KERATIN;PERSONAL CARE
13178417;;F;45;CHILENO;;X;OVALLE                        ;COQUIMBO;216980;2;2;0;0;0;2;2;216980;SECADOR DE PELO SG-3049 NEGRO;PERSONAL CARE
14064812;Soltero;F;41;CHILENO;;X;RENCA                         ;METROPOLITANA;226980;2;2;0;0;0;2;2;226980;SECADOR DE PELO SG-3049 NEGRO;PERSONAL CARE
10800166;;M;52;CHILENO;;X;ANTOFAGASTA                   ;ANTOFAGASTA;356970;3;2;0;0;0;3;2;356970;ALISADOR DE PELO HP8321;PERSONAL CARE
17255849;;F;33;CHILENO;;Millenial;VILLA ALEMANA                 ;VALPARAISO;44990;1;1;1;1;44990;0;0;0;DEPILADORA OASIS NEXT BVT;PERSONAL CARE
7850856;;M;65;CHILENO;;Boomers;RENAICO                       ;ARAUCANIA;109970;3;2;0;0;0;3;2;109970;DEPILADORA SG-9004;PERSONAL CARE
26522511;;F;30;EXTRANJERO - NO INFORMA NACIONALIDAD;;Extranjero;"";"";79750;5;2;5;2;79750;0;0;0;TRICOMBO SECADOR+ALISADOR+ONDULADOR;PERSONAL CARE
12804400;;F;46;CHILENO;;X;VALLENAR;ATACAMA;1269020;7;5;0;0;0;7;5;1269020;SECADOR PHILIPS BHC010;PERSONAL CARE
17300055;;F;33;CHILENO;;Millenial;SAN FELIPE                    ;VALPARAISO;76940;6;4;1;1;19990;5;3;56950;SECADOR DE PELO SG-3012C23 VERDE;PERSONAL CARE
13594425;;F;43;CHILENO;;X;RENCA                         ;METROPOLITANA;34990;1;1;0;0;0;1;1;34990;COMBO GAMA SECADOR+ALISADOR+CEPILLO;PERSONAL CARE
16013130;;M;37;CHILENO;;Millenial;PROVIDENCIA                   ;METROPOLITANA;27990;1;1;0;0;0;1;1;27990;ALISADOR DE PELO S6300 GRIS;PERSONAL CARE
8399016;Casado;M;54;CHILENO;;Boomers;RENCA                         ;METROPOLITANA;54990;1;1;0;0;0;1;1;54990;COMBO SIEGEN AFEITADORA + MULTISTYLER SG-8440;PERSONAL CARE
14007573;;F;41;CHILENO;;X;MELIPILLA                     ;METROPOLITANA;250640;5;4;0;0;0;5;4;250640;SECADOR DE PELO SG-3051;PERSONAL CARE
18787828;;M;28;CHILENO;;Millenial;PROVIDENCIA                   ;METROPOLITANA;766950;5;4;0;0;0;5;4;766950;SECADOR GAMA BORA KERATION;PERSONAL CARE
18080247;Soltero;F;30;CHILENO;;Millenial;PROVIDENCIA                   ;METROPOLITANA;43980;2;1;2;1;43980;0;0;0;CORTA PELO HC-5850;PERSONAL CARE
11989333;;F;49;CHILENO;;X;PROVIDENCIA                   ;METROPOLITANA;20990;1;1;0;0;0;1;1;20990;SECADOR DE PELO SG-3043 DC CAFE 2200 WATTS;PERSONAL CARE
17103101;Soltero;M;33;CHILENO;INGENIERO EN MINAS;X;PROVIDENCIA                   ;METROPOLITANA;12990;1;1;0;0;0;1;1;12990;SECADOR DE PELO SG-3025 SILVER;PERSONAL CARE
13171445;;F;45;CHILENO;;X;TOCOPILLA                     ;ANTOFAGASTA;39980;2;2;1;1;17990;1;1;21990;SECADOR GAMA BRILLIAN AQUA;PERSONAL CARE
16887497;Casado;M;34;CHILENO;;Millenial;CASTRO                        ;LOS LAGOS;34990;1;1;1;1;34990;0;0;0;TRICOMBO SECADOR+ALISADOR+ONDULADOR;PERSONAL CARE
12725412;;F;47;CHILENO;;X;RENGO                         ;L.G.B.OÂ´HIGGINS;31980;2;2;0;0;0;2;2;31980;SECADOR DE PELO MISTRAL STD;PERSONAL CARE
6666598;Casado;F;66;CHILENO;;Boomers;RENCA                         ;METROPOLITANA;9990;1;1;0;0;0;1;1;9990;SECADOR DE PELO SG-3012 NEGRO;PERSONAL CARE
17506512;;F;31;CHILENO;;Millenial;RANCAGUA;O HIGGINS;29990;1;1;0;0;0;1;1;29990;DEPILADORA BRE255/00;PERSONAL CARE
13393391;;F;44;CHILENO;;X;CANETE                        ;BIO BIO;9990;1;1;0;0;0;1;1;9990;SECADOR DE PELO SG-3012 NEGRO;PERSONAL CARE
15022113;;F;39;CHILENO;;X;N/D;N/D;24990;1;1;0;0;0;1;1;24990;ALISADOR MATCHA;PERSONAL CARE
8618418;;M;63;CHILENO;;Boomers;EL BOSQUE                     ;METROPOLITANA;61970;3;2;0;0;0;3;2;61970;AFEITADORA SG-7210 NEGRO;PERSONAL CARE
15920464;;F;38;CHILENO;;Millenial;LINARES                       ;MAULE;19990;1;1;0;0;0;1;1;19990;SECADOR DE PELO SIEGEN SG-3035;PERSONAL CARE
7356609;;F;64;CHILENO;;Boomers;N/D;N/D;604650;4;4;2;1;563980;2;3;40670;COMBO GAMA SECADOR+ALISADOR+CEPILLO;PERSONAL CARE
7004893;;M;68;CHILENO;;Silencioso;NUEVA IMPERIAL                ;ARAUCANIA;33240;2;1;0;0;0;2;1;33240;SECADOR DE PELO SG-3051;PERSONAL CARE
10617107;;M;55;CHILENO;;Boomers;RENCA                         ;METROPOLITANA;19990;1;1;0;0;0;1;1;19990;SECADOR DE PELO SIEGEN SG-3035;PERSONAL CARE
19595300;;F;25;CHILENO;;Z;PROVIDENCIA                   ;METROPOLITANA;9990;1;1;0;0;0;1;1;9990;SECADOR DE PELO SG-3012 NEGRO;PERSONAL CARE
8449867;;M;63;CHILENO;;Boomers;PROVIDENCIA                   ;METROPOLITANA;29990;1;1;0;0;0;1;1;29990;CORTA PELO SG-8520;PERSONAL CARE
16505688;;M;35;CHILENO;;Millenial;PROVIDENCIA                   ;METROPOLITANA;9990;1;1;1;1;9990;0;0;0;SECADOR DE PELO SG-3012 NEGRO;PERSONAL CARE
12779484;;M;47;CHILENO;;X;SAN FERNANDO                  ;L.G.B.OÂ´HIGGINS;22000;2;1;0;0;0;2;1;22000;AFEITADORA SPORT;PERSONAL CARE
12816195;;M;52;CHILENO;;X;"";"";306821;3;2;0;0;0;3;2;306821;ALISADOR REMIG. WET2 S27A (BV) R;PERSONAL CARE
9270022;;F;60;CHILENO;;Boomers;RENCA                         ;METROPOLITANA;14990;1;1;0;0;0;1;1;14990;SECADOR DE VIAJE REMINGTON D2400;PERSONAL CARE
4958032;;M;75;CHILENO;;Silencioso;COPIAPO                       ;ATACAMA;109853;5;3;0;0;0;5;3;109853;ALISADOR +SECADOR PELO;PERSONAL CARE
16502222;;M;35;CHILENO;;Millenial;VINA DEL MAR                  ;VALPARAISO;16990;1;1;0;0;0;1;1;16990;SECADOR DE PELO MISTRAL STD;PERSONAL CARE
9851199;;M;59;CHILENO;;Boomers;N/D;N/D;528920;8;6;0;0;0;8;6;528920;SPA PARA PIES SG-1560;PERSONAL CARE
10313103;;F;56;CHILENO;;Boomers;SAN BERNARDO                  ;METROPOLITANA;53980;2;2;0;0;0;2;2;53980;AFEITADORA SG-7210 NEGRO;PERSONAL CARE
10195872;;F;56;CHILENO;;Boomers;CANETE                        ;BIO BIO;16990;1;1;0;0;0;1;1;16990;ALISADOR DE PELO SG-3510 FUCSIA;PERSONAL CARE
19272443;Soltero;F;26;CHILENO;TECNICO DE NIVEL MEDIO EN ALIMENTACION;Z;PROVIDENCIA                   ;METROPOLITANA;21990;1;1;0;0;0;1;1;21990;SECADOR DE PELO SG-3043 DC CAFE 2200 WATTS;PERSONAL CARE
14477363;;F;46;CHILENO;;X;CODEGUA                       ;L.G.B.OÂ´HIGGINS;24990;1;1;0;0;0;1;1;24990;ALISADOR +SECADOR PELO;PERSONAL CARE
12784480;Casado;F;47;CHILENO;TECNICO DE NIVEL SUPERIOR EN ENFERMERIA;X;RENCA                         ;METROPOLITANA;91980;2;2;0;0;0;2;2;91980;AFEITADORA SG-7210 NEGRO;PERSONAL CARE
5669883;;F;72;CHILENO;;Millenial;N/D;N/D;248260;12;1;0;0;0;12;1;248260;ALISADOR DE PELO SG-4651 ROJO;PERSONAL CARE
7648876;;F;63;CHILENO;;Boomers;TALAGANTE                     ;METROPOLITANA;645940;6;4;0;0;0;6;4;645940;SECADOR DE PELO SG-3012C29 MORADO;PERSONAL CARE
17448266;Soltero;F;32;CHILENO;;Millenial;PROVIDENCIA                   ;METROPOLITANA;51980;2;2;0;0;0;2;2;51980;DEPILADORA SG-9004;PERSONAL CARE
7935451;;F;67;CHILENO;;Boomers;LA SERENA                     ;COQUIMBO;970;3;2;0;0;0;3;2;970;ALISADOR ELEGANCE W L IT 3D BLUE BVT;PERSONAL CARE
18216791;;F;33;CHILENO;;Millenial;CHILLAN                       ;BIO BIO;98681;2;2;0;0;0;2;2;98681;AFEITADORA SPORT;PERSONAL CARE
13378381;;F;43;CHILENO;;X;RENCA                         ;METROPOLITANA;109820;4;3;2;1;65840;2;2;43980;SECADOR DE PELO DIVA NEGRO;PERSONAL CARE
26480969;;M;36;VENEZOLANO;;Extranjero;SANTIAGO                      ;METROPOLITANA;16990;1;1;1;1;16990;0;0;0;CORTA PELO SPORT GCX 623 BVT;PERSONAL CARE
17386690;;M;32;CHILENO;;Millenial;N/D;N/D;33140;2;1;0;0;0;2;1;33140;AFEITADORA SPORT SH 886 BAT;PERSONAL CARE
9325770;;M;60;CHILENO;;Boomers;PROVIDENCIA                   ;METROPOLITANA;49990;1;1;0;0;0;1;1;49990;ALISADOR DE PELO S12A(220) Shine Therapy PALTA M;PERSONAL CARE
4679536;;M;75;CHILENO;;Silencioso;VILLA ALEMANA                 ;VALPARAISO;472970;3;2;0;0;0;3;2;472970;SECADOR GAMA EOLIC MINI TRAVEL;PERSONAL CARE
16440180;;M;35;CHILENO;;Silencioso;PROVIDENCIA                   ;METROPOLITANA;63980;2;2;0;0;0;2;2;63980;CORTA PELO SG-8520;PERSONAL CARE
12291827;;F;49;CHILENO;;X;PROVIDENCIA                   ;METROPOLITANA;25980;2;1;0;0;0;2;1;25980;SECADOR GAMA EOLIC MINI TRAVEL;PERSONAL CARE
6814408;;M;69;CHILENO;;Silencioso;RENCA                         ;METROPOLITANA;34340;3;1;0;0;0;3;1;34340;KIT CORTABARBA MG3711;PERSONAL CARE
15673575;;M;38;CHILENO;;X;COQUIMBO;COQUIMBO;29990;1;1;0;0;0;1;1;29990;AFEITADORA SPORT SH 886 BAT;PERSONAL CARE
19930389;;F;24;CHILENO;;Z;LO ESPEJO;METROPOLITANA;253950;6;3;6;3;253950;0;0;0;SECADOR DE PELO SG-3043 DC CAFE 2200 WATTS;PERSONAL CARE
8970121;;F;67;CHILENO;;Boomers;QUILLOTA                      ;VALPARAISO;24990;1;1;0;0;0;1;1;24990;ALISADOR +SECADOR PELO;PERSONAL CARE
18112900;;F;30;CHILENO;;Millenial;SAN ESTEBAN                   ;VALPARAISO;24990;1;1;0;0;0;1;1;24990;SECADOR DE PELO SE-3049C01 FUCSIA;PERSONAL CARE
12586897;;M;48;CHILENO;;X;N/D;N/D;34990;1;1;0;0;0;1;1;34990;AFEITADORA SG-7250 NEGRO;PERSONAL CARE
20584083;;F;21;CHILENO;;Z;PROVIDENCIA                   ;METROPOLITANA;201830;3;2;2;1;185840;1;1;15990;SECADOR DE PELO D3019 PRO TITANIO;PERSONAL CARE
17519066;;M;32;CHILENO;;Millenial;PROVIDENCIA                   ;METROPOLITANA;24990;1;1;0;0;0;1;1;24990;CORTA PELO HC3520;PERSONAL CARE
5776875;Casado;M;74;CHILENO;;Silencioso;RENCA                         ;METROPOLITANA;34990;1;1;0;0;0;1;1;34990;AFEITADORA S1223/41 ELECTRICA;PERSONAL CARE
17463936;;F;32;CHILENO;;Millenial;N/D;N/D;125970;3;3;0;0;0;3;3;125970;AFEITADORA SG-7210 NEGRO;PERSONAL CARE
18362090;Soltero;M;27;CHILENO;;Millenial;PARRAL                        ;MAULE;29990;1;1;0;0;0;1;1;29990;SECADOR DE PELO SG-3051;PERSONAL CARE
13183571;;M;45;CHILENO;;X;SANTA MARIA                   ;VALPARAISO;29990;1;1;0;0;0;1;1;29990;DEPILADORA SG-9004;PERSONAL CARE
7589466;;M;68;CHILENO;;Boomers;PUERTO VARAS                  ;LOS LAGOS;622431;7;4;0;0;0;7;4;622431;SECADOR DE PELO SG-3051;PERSONAL CARE
12554734;;F;48;CHILENO;;X;CHIGUAYANTE;BIO-BIO;54990;1;1;0;0;0;1;1;54990;ALISADOR SIEGEN SG-4716;PERSONAL CARE
8266846;;M;64;CHILENO;;Boomers;VINA DEL MAR                  ;VALPARAISO;18990;1;1;0;0;0;1;1;18990;AFEITADORA SG-7210 NEGRO;PERSONAL CARE
15986413;;M;37;CHILENO;;Millenial;PERQUENCO                     ;ARAUCANIA;289980;2;2;0;0;0;2;2;289980;ALISADOR DE PELO SG-3540 MORADO MORADO;PERSONAL CARE
11628288;;F;52;CHILENO;;X;CONCEPCION                    ;BIO BIO;199970;3;2;0;0;0;3;2;199970;ALISADOR DE PELO SG-4651 ROJO;PERSONAL CARE
25026554;;M;35;COLOMBIANO;;Extranjero;N/D;N/D;24990;1;1;0;0;0;1;1;24990;SECADOR DE PELO SG-3051;PERSONAL CARE
26831641;Soltero;M;53;NO INFORMA NACIONALIDAD;;Extranjero;PROVIDENCIA                   ;METROPOLITANA;101980;2;2;0;0;0;2;2;101980;ALISADORA SG-4751;PERSONAL CARE
16904764;;F;33;CHILENO;;Millenial;PROVIDENCIA                   ;METROPOLITANA;34990;1;1;0;0;0;1;1;34990;TRICOMBO SECADOR+ALISADOR+ONDULADOR;PERSONAL CARE
6396684;;F;71;CHILENO;;Silencioso;PEUMO                         ;L.G.B.OÂ´HIGGINS;13990;1;1;0;0;0;1;1;13990;SECADOR DE PELO SG-3025 SILVER;PERSONAL CARE
16056645;;M;36;CHILENO;;Millenial;IQUIQUE;TARAPACA;16990;1;1;1;1;16990;0;0;0;Secador de Pelo 3000 Series Philips BHD340/10;PERSONAL CARE
19387921;;F;25;CHILENO;;Z;PEUMO                         ;L.G.B.OÂ´HIGGINS;10990;1;1;0;0;0;1;1;10990;SECADOR GAMA EOLIC MINI TRAVEL;PERSONAL CARE
19065670;;M;27;CHILENO;;Millenial;PAINE;METROPOLITANA;33980;2;1;2;1;33980;0;0;0;ALISADOR DE PELO S12A(220) Shine Therapy PALTA M;PERSONAL CARE
7406670;;F;68;CHILENO;;Silencioso;CHILLAN                       ;BIO BIO;103950;5;2;0;0;0;5;2;103950;SECADOR DE PELO SE-3049C01 FUCSIA;PERSONAL CARE
18286171;;F;29;CHILENO;;Millenial;N/D;N/D;18990;1;1;0;0;0;1;1;18990;SECADOR DE PELO SG-3043 DC CAFE 2200 WATTS;PERSONAL CARE
11156904;Casado;F;55;CHILENO;;Boomers;RENCA                         ;METROPOLITANA;18990;1;1;0;0;0;1;1;18990;SECADOR DE PELO SG-3043 DC CAFE 2200 WATTS;PERSONAL CARE
12743835;;F;47;CHILENO;;X;VILLARICA                     ;ARAUCANIA;79980;2;2;0;0;0;2;2;79980;DEPILADORA BRE285/00 CONVENCIONAL;PERSONAL CARE
17006305;;F;33;CHILENO;;Millenial;LA FLORIDA;METROPOLITANA;24990;1;1;1;1;24990;0;0;0;ALISADOR +SECADOR PELO;PERSONAL CARE
19945454;;F;23;CHILENO;;Z;OVALLE                        ;COQUIMBO;34990;1;1;0;0;0;1;1;34990;AFEITADORA SH 887 WD BAT;PERSONAL CARE
10425579;Soltero;F;58;CHILENO;;Boomers;PROVIDENCIA                   ;METROPOLITANA;17140;2;1;0;0;0;2;1;17140;CORTAPELO GAMA MG 566;PERSONAL CARE
17528153;;F;32;CHILENO;;Millenial;SALAMANCA;COQUIMBO;129980;2;1;0;0;0;2;1;129980;DEPILADORA IPL MAGNA PK;PERSONAL CARE
18688533;;F;28;CHILENO;;Millenial;PROVIDENCIA                   ;METROPOLITANA;336520;4;3;3;2;317530;1;1;18990;DEPILADORA GAMA ESSENCIAL;PERSONAL CARE
12246113;;M;50;CHILENO;;X;VILLARICA                     ;ARAUCANIA;44990;1;3;0;0;0;1;3;44990;AFEITADORA S1323/41 ELECTRICA;PERSONAL CARE
13539405;;F;42;CHILENO;;X;LOS ANDES                     ;VALPARAISO;64980;2;2;0;0;0;2;2;64980;ALISADOR +SECADOR PELO;PERSONAL CARE
15575527;Soltero;F;39;CHILENO;;X;PROVIDENCIA                   ;METROPOLITANA;29990;1;1;0;0;0;1;1;29990;ALISADOR +SECADOR PELO;PERSONAL CARE
19581481;;F;25;CHILENO;;Z;LOS ANDES                     ;VALPARAISO;26990;1;1;0;0;0;1;1;26990;ALISADOR +SECADOR PELO;PERSONAL CARE
8951241;;F;44;CHILENO;;X;PROVIDENCIA                   ;METROPOLITANA;24990;1;1;0;0;0;1;1;24990;AFEITADORA SPORT;PERSONAL CARE
17095466;;F;33;CHILENO;;Millenial;POZO ALMONTE;TARAPACA;332970;3;2;3;2;332970;0;0;0;CORTAPELOS GM 596;PERSONAL CARE
18342807;Soltero;F;29;CHILENO;;Silencioso;PROVIDENCIA                   ;METROPOLITANA;19990;1;1;1;1;19990;0;0;0;SECADOR DE PELO SE-3049C01 FUCSIA;PERSONAL CARE
25828902;;M;33;COLOMBIANO;;Extranjero;N/D;N/D;44990;1;1;0;0;0;1;1;44990;CORTA PELO HC-5850;PERSONAL CARE
12057933;Casado;F;54;CHILENO;PROFESOR;X;RENCA                         ;METROPOLITANA;12990;1;1;0;0;0;1;1;12990;SECADOR DE PELO SG-3012 NEGRO;PERSONAL CARE
17760327;Soltero;F;30;CHILENO;CONTADOR GENERAL;Millenial;PROVIDENCIA                   ;METROPOLITANA;47990;1;1;0;0;0;1;1;47990;ALISADOR DE PELO S12A(220) Shine Therapy PALTA M;PERSONAL CARE
10107681;;F;56;CHILENO;;Boomers;CHONCHI                       ;LOS LAGOS;14990;1;3;0;0;0;1;3;14990;SECADOR DE PELO SG-3025 SILVER;PERSONAL CARE
10330934;;F;55;CHILENO;;Boomers;LOS VILOS                     ;COQUIMBO;35990;1;1;0;0;0;1;1;35990;AFEITADORA S1323/41 ELECTRICA;PERSONAL CARE
12517145;;F;48;CHILENO;;X;GRANEROS;O HIGGINS;29990;1;1;0;0;0;1;1;29990;TRICOMBO SECADOR+ALISADOR+ONDULADOR;PERSONAL CARE
9495254;;F;60;CHILENO;;Boomers;CONCEPCION                    ;BIO BIO;12990;1;1;0;0;0;1;1;12990;SECADOR DE PELO SG-3012 NEGRO;PERSONAL CARE
13727521;;M;43;CHILENO;;X;PROVIDENCIA                   ;METROPOLITANA;34990;1;1;0;0;0;1;1;34990;TRICOMBO SECADOR+ALISADOR+ONDULADOR;PERSONAL CARE
19416119;;F;25;CHILENO;;Z;CHILLAN;BIO-BIO;19240;2;2;0;0;0;2;2;19240;SECADOR GAMA BORA KERATION;PERSONAL CARE
15415449;;F;40;CHILENO;;X;CONCHALI;METROPOLITANA;38980;2;1;2;1;38980;0;0;0;DEPILADORA OASIS NEXT BVT;PERSONAL CARE
11504365;;F;53;CHILENO;;X;COIHAIQUE                     ;AYSEN;369920;8;4;0;0;0;8;4;369920;SECADOR DE PELO SE-3049C01 FUCSIA;PERSONAL CARE
6930245;Casado;M;69;CHILENO;;Silencioso;PROVIDENCIA                   ;METROPOLITANA;35990;1;1;0;0;0;1;1;35990;AFEITADORA S1323/41 ELECTRICA;PERSONAL CARE
13537186;;F;43;CHILENO;;X;QUILLOTA                      ;VALPARAISO;55980;2;1;0;0;0;2;1;55980;TRICOMBO SECADOR+ALISADOR+ONDULADOR;PERSONAL CARE
4673115;Divorciado;F;73;CHILENO;;Silencioso;PROVIDENCIA                   ;METROPOLITANA;9990;1;1;0;0;0;1;1;9990;SECADOR PHILIPS BHC010;PERSONAL CARE
17855820;;F;31;CHILENO;;Millenial;"";"";18990;1;1;0;0;0;1;1;18990;Lapiz recortador para retoques Philips HP6389/00;PERSONAL CARE
12351392;;F;49;CHILENO;;X;QUILLOTA                      ;VALPARAISO;18990;1;2;0;0;0;1;2;18990;SECADOR GAMA BORA KERATION;PERSONAL CARE
26721795;;M;35;VENEZOLANO;;Extranjero;PUERTO MONTT                  ;LOS LAGOS;194981;3;2;0;0;0;3;2;194981;CORTA PELO SG-8520;PERSONAL CARE
16568859;Soltero;M;34;CHILENO;;Millenial;PROVIDENCIA                   ;METROPOLITANA;34990;1;1;0;0;0;1;1;34990;CORTA PELO MGK3220 BLACK BOX MN;PERSONAL CARE
8441876;;F;61;CHILENO;;Boomers;RAUCO                         ;MAULE;270960;4;2;0;0;0;4;2;270960;AFEITADORA SG-7250 NEGRO;PERSONAL CARE
19391690;;M;25;CHILENO;;Z;PROVIDENCIA                   ;METROPOLITANA;44990;1;1;0;0;0;1;1;44990;DEPILADORA OASIS SENSATION;PERSONAL CARE
12563761;;F;47;CHILENO;;X;RENCA                         ;METROPOLITANA;21990;1;1;0;0;0;1;1;21990;SECADOR DE PELO SIEGEN SG-3035;PERSONAL CARE
9435017;;F;58;CHILENO;;Boomers;BUIN                          ;METROPOLITANA;44990;1;1;0;0;0;1;1;44990;DEPILADORA 3170 BRAUN;PERSONAL CARE
14430553;;M;52;CHILENO;;X;ARICA                         ;ARICA Y PARINACOTA;64982;2;2;0;0;0;2;2;64982;KIT CORTABARBA MG3731;PERSONAL CARE
11994857;;F;49;CHILENO;;X;"";"";239080;4;2;4;2;239080;0;0;0;DEPILADORA SES 5/500 PINK BOX MN;PERSONAL CARE
20463596;;M;21;CHILENO;;Z;SAN FERNANDO                  ;L.G.B.OÂ´HIGGINS;489980;2;3;0;2;0;2;1;489980;CORTADOR DE PELO PACL GC 542 Sport Bat GT 527;PERSONAL CARE
8542885;;M;63;CHILENO;;Boomers;QUINTA NORMAL                 ;METROPOLITANA;326960;4;2;0;0;0;4;2;326960;CORTA PELO SPORT GCX 623 BVT;PERSONAL CARE
27600156;;M;34;VENEZOLANO;;Extranjero;"";"";24990;1;1;0;0;0;1;1;24990;KIT CORTABARBA MG3731;PERSONAL CARE
19304341;;F;25;CHILENO;;Z;PROVIDENCIA                   ;METROPOLITANA;29990;1;1;0;0;0;1;1;29990;SECADOR DE PELO SE-3049C01 FUCSIA;PERSONAL CARE
25666003;;F;40;COLOMBIANO;;Extranjero;N/D;N/D;39970;3;1;0;0;0;3;1;39970;ALISADOR DE PELO HP8321;PERSONAL CARE
17883772;;M;30;CHILENO;;Millenial;PROVIDENCIA                   ;METROPOLITANA;24990;1;1;1;1;24990;0;0;0;CORTAPELOS GM 596;PERSONAL CARE
20032053;;F;25;CHILENO;;Z;N/D;N/D;227980;2;2;0;0;0;2;2;227980;SECADOR DE PELO DIVA NEGRO;PERSONAL CARE
19830901;;F;24;CHILENO;;Millenial;"";"";49970;3;2;0;0;0;3;2;49970;ALISADOR +SECADOR PELO;PERSONAL CARE
7604206;;M;65;CHILENO;;Boomers;PROVIDENCIA                   ;METROPOLITANA;29990;1;3;0;0;0;1;3;29990;AFEITADORA SG-7250 NEGRO;PERSONAL CARE
18266753;Soltero;F;30;CHILENO;FONOAUDIOLOGA;Silencioso;PROVIDENCIA                   ;METROPOLITANA;19990;1;1;1;1;19990;0;0;0;DEPILADORA BRE225/00;PERSONAL CARE
22948159;;F;38;COLOMBIANO;;Extranjero;N/D;N/D;432970;3;3;0;0;0;3;3;432970;ALISADOR ELEGANCE W L IT 3D BLUE BVT;PERSONAL CARE
11372085;;F;52;CHILENO;;X;RENCA                         ;METROPOLITANA;45140;2;2;0;0;0;2;2;45140;DEPILADORA OASIS SENSATION;PERSONAL CARE
11059730;;F;58;CHILENO;;Boomers;PROVIDENCIA                   ;METROPOLITANA;401980;2;2;0;0;0;2;2;401980;DEPILADORA BRE225/00;PERSONAL CARE
16445649;;M;36;CHILENO;;Millenial;"";"";34990;1;1;0;0;0;1;1;34990;COMBO GAMA SECADOR+ALISADOR+CEPILLO;PERSONAL CARE
15187103;;F;38;CHILENO;;Millenial;CORONEL                       ;BIO BIO;20990;1;1;0;0;0;1;1;20990;CORTA PELO SG-8410;PERSONAL CARE
10444773;;F;58;CHILENO;;Boomers;PROVIDENCIA                   ;METROPOLITANA;24990;1;1;0;0;0;1;1;24990;ALISADOR +SECADOR PELO;PERSONAL CARE
18038815;;F;30;CHILENO;;Millenial;ALHUE                         ;METROPOLITANA;34990;1;1;0;0;0;1;1;34990;COMBO GAMA SECADOR+ALISADOR+CEPILLO;PERSONAL CARE
16512533;;M;34;CHILENO;;Millenial;RENCA                         ;METROPOLITANA;54990;1;1;0;0;0;1;1;54990;DEPILADORA BRE700/00 MID-END CLOSED BOX;PERSONAL CARE
8631461;;F;63;CHILENO;;Boomers;CAUQUENES                     ;MAULE;51980;2;1;0;0;0;2;1;51980;CORTA PELO SG-8520;PERSONAL CARE
18801186;Soltero;F;26;CHILENO;;Z;PROVIDENCIA                   ;METROPOLITANA;24990;1;1;0;0;0;1;1;24990;CORTA PELO SG-8520;PERSONAL CARE
13906375;;F;41;CHILENO;;X;LINARES                       ;MAULE;14990;1;1;0;0;0;1;1;14990;SECADOR DIAMOND STD;PERSONAL CARE
16569410;;F;35;CHILENO;;Millenial;PROVIDENCIA                   ;METROPOLITANA;34990;1;1;0;0;0;1;1;34990;CORTADOR DE PELO SIEGEN SG-8590;PERSONAL CARE
16842662;;M;32;CHILENO;;Millenial;PROVIDENCIA                   ;METROPOLITANA;99990;1;1;0;0;0;1;1;99990;DEPILADORA IPL MAGNA PK;PERSONAL CARE
11396402;;F;53;CHILENO;;X;MELIPILLA                     ;METROPOLITANA;39990;1;1;0;0;0;1;1;39990;ALISADOR ELEGANCE W L IT 3D BLUE BVT;PERSONAL CARE
12425035;;M;49;CHILENO;;X;COQUIMBO                      ;COQUIMBO;83971;3;2;0;0;0;3;2;83971;DEPILADORA OASIS NEXT BVT;PERSONAL CARE
11820347;;M;50;CHILENO;;X;ANTOFAGASTA                   ;ANTOFAGASTA;14990;1;1;0;0;0;1;1;14990;CORTA PELO GM 562;PERSONAL CARE
13044244;;F;46;CHILENO;;X;PROVIDENCIA                   ;METROPOLITANA;16990;1;1;0;0;0;1;1;16990;ALISADOR DE PELO SG-3510 FUCSIA;PERSONAL CARE
10849936;;M;40;CHILENO;;Extranjero;LA SERENA                     ;COQUIMBO;89980;2;1;0;0;0;2;1;89980;COMBO SIEGEN AFEITADORA + MULTISTYLER SG-8440;PERSONAL CARE
14279445;;F;48;CHILENO;;X;RENCA                         ;METROPOLITANA;29990;1;1;0;0;0;1;1;29990;CORTAPELOS GM 596;PERSONAL CARE
18862330;;F;27;CHILENO;;Millenial;PROVIDENCIA                   ;METROPOLITANA;17990;1;1;1;1;17990;0;0;0;KIT CORTABARBA MG3711;PERSONAL CARE
12605420;Divorciado;M;47;CHILENO;TECNICO EN ADMINISTRACION DE EMPRESAS;X;RENCA                         ;METROPOLITANA;24990;1;1;0;0;0;1;1;24990;KIT CORTABARBA MG3731;PERSONAL CARE
16891343;;F;34;CHILENO;;Millenial;ALTO HOSPICIO;TARAPACA;24990;1;1;0;0;0;1;1;24990;ALISADOR +SECADOR PELO;PERSONAL CARE
13777493;;F;42;CHILENO;;X;PROVIDENCIA                   ;METROPOLITANA;24990;1;1;0;0;0;1;1;24990;CORTA PELO SG-8520;PERSONAL CARE
4895837;;M;77;CHILENO;;Silencioso;PROVIDENCIA                   ;METROPOLITANA;18990;1;1;0;0;0;1;1;18990;AFEITADORA SPORT;PERSONAL CARE
16575712;;F;34;CHILENO;;Millenial;LA LIGUA                      ;VALPARAISO;39990;1;1;0;0;0;1;1;39990;ALISADOR DE PELO S12A(220) Shine Therapy PALTA M;PERSONAL CARE
16607936;;F;34;CHILENO;;Millenial;PROVIDENCIA                   ;METROPOLITANA;24990;1;1;0;0;0;1;1;24990;SPA PARA PIES SG-1560;PERSONAL CARE
12767837;;F;49;CHILENO;;X;ARAUCO                        ;BIO BIO;372560;3;2;0;0;0;3;2;372560;ALISADOR DE PELO SG-3540 MORADO MORADO;PERSONAL CARE
19898495;;F;22;CHILENO;;Z;VICTORIA                      ;ARAUCANIA;49990;1;1;0;0;0;1;1;49990;COMBO SIEGEN AFEITADORA + MULTISTYLER SG-8440;PERSONAL CARE
7542881;;M;65;CHILENO;;Boomers;LINARES                       ;MAULE;50980;2;4;0;0;0;2;4;50980;SECADOR DE PELO SE-3049C01 FUCSIA;PERSONAL CARE
9504797;;F;57;CHILENO;;Boomers;COPIAPO                       ;ATACAMA;29990;1;1;0;0;0;1;1;29990;DEPILADORA SG-9004EX;PERSONAL CARE
13737538;;F;43;CHILENO;;X;N/D;N/D;362950;5;4;0;0;0;5;4;362950;ALISADOR ELEGANCE W L IT 3D BLUE BVT;PERSONAL CARE
18181753;Soltero;M;29;CHILENO;;Millenial;PROVIDENCIA                   ;METROPOLITANA;19990;1;1;1;1;19990;0;0;0;ALISADOR ELEGANCE LED BLOOM VT;PERSONAL CARE
24553415;;F;30;COLOMBIANO;;Extranjero;N/D;N/D;405960;4;3;0;0;0;4;3;405960;CORTA PELO SPORT GCX 623 BVT;PERSONAL CARE
14602082;;M;41;CHILENO;;X;RENCA                         ;METROPOLITANA;85980;2;2;0;0;0;2;2;85980;ALISADOR DE PELO SG-4651 ROJO;PERSONAL CARE
6533718;;M;68;CHILENO;;Silencioso;SAN FELIPE                    ;VALPARAISO;6990;1;2;0;0;0;1;2;6990;AFEITADORA S1121/41 ELECTRICA;PERSONAL CARE
10261072;;F;55;CHILENO;;Boomers;VALLENAR;ATACAMA;38990;1;1;0;0;0;1;1;38990;AFEITADORA SH 887 WD BAT;PERSONAL CARE
15527402;;M;36;CHILENO;;Millenial;CHIMBARONGO                   ;L.G.B.OÂ´HIGGINS;29990;1;1;0;0;0;1;1;29990;AFEITADORA SG-7250 NEGRO;PERSONAL CARE
12428120;;F;49;CHILENO;;X;SALAMANCA                     ;COQUIMBO;47970;3;2;0;0;0;3;2;47970;AFEITADORA QP2521/50 ONE BLADE GRAFITO;PERSONAL CARE
8743122;Casado;M;59;CHILENO;;Boomers;PROVIDENCIA                   ;METROPOLITANA;74990;1;1;0;0;0;1;1;74990;AFEITADORA 3000BT NEGRA;PERSONAL CARE
16855638;;F;34;CHILENO;;Millenial;PROVIDENCIA                   ;METROPOLITANA;16990;1;1;0;0;0;1;1;16990;ALISADOR DE PELO SG-3510 FUCSIA;PERSONAL CARE
14368119;;M;47;CHILENO;;X;PAINE                         ;METROPOLITANA;21990;1;1;0;0;0;1;1;21990;SECADOR TEMPO TITAN KERATIN;PERSONAL CARE
9409551;;F;61;CHILENO;;Boomers;NAVIDAD                       ;L.G.B.OÂ´HIGGINS;24990;1;1;0;0;0;1;1;24990;ALISADOR +SECADOR PELO;PERSONAL CARE
12053517;;F;55;CHILENO;;Boomers;RENCA                         ;METROPOLITANA;27990;1;1;0;0;0;1;1;27990;ALISADOR ELEGANCE LED BLOOM VT;PERSONAL CARE
19215506;Soltero;M;27;CHILENO;INGENIERO AGRICOLA;Z;PROVIDENCIA                   ;METROPOLITANA;29990;1;1;0;0;0;1;1;29990;CORTAPELOS GM 596;PERSONAL CARE
10014505;;F;53;CHILENO;;X;CONCEPCION                    ;BIO BIO;99970;3;2;0;0;0;3;2;99970;ALISADOR +SECADOR PELO;PERSONAL CARE
10639375;;F;54;CHILENO;;Boomers;SANTA CRUZ                    ;L.G.B.OÂ´HIGGINS;39990;1;1;0;0;0;1;1;39990;ALISADOR DE PELO S12A(220) Shine Therapy PALTA M;PERSONAL CARE
10395053;Soltero;M;56;CHILENO;;Boomers;PUNITAQUI                     ;COQUIMBO;52980;2;2;0;0;0;2;2;52980;SECADOR DE PELO SG-3012 NEGRO;PERSONAL CARE
18872247;;M;27;CHILENO;;Z;LA ESTRELLA                   ;L.G.B.OÂ´HIGGINS;21990;1;1;0;0;0;1;1;21990;ALISADOR GAMA BELLA SHINE;PERSONAL CARE
10239958;;F;59;CHILENO;;Boomers;N/D;N/D;22980;2;1;0;0;0;2;1;22980;SECADOR DE PELO SIEGEN SG-3035;PERSONAL CARE
12290820;;F;50;CHILENO;;X;PROVIDENCIA                   ;METROPOLITANA;46980;2;2;0;0;0;2;2;46980;CORTAPELOS GM 596;PERSONAL CARE
15596893;;F;39;CHILENO;;X;N/D;N/D;24990;1;1;0;0;0;1;1;24990;CORTA PELO SG-8520;PERSONAL CARE
18611700;;F;28;CHILENO;;Millenial;SAN FELIPE                    ;VALPARAISO;103980;2;1;0;0;0;2;1;103980;DEPILADORA IPL MAGNA PK;PERSONAL CARE
19988120;;M;24;CHILENO;;Z;PROVIDENCIA                   ;METROPOLITANA;32990;1;1;0;0;0;1;1;32990;ALISADOR ELEGANCE LED KER;PERSONAL CARE
25398382;;M;30;COLOMBIANO;;Extranjero;N/D;N/D;82870;2;2;0;0;0;2;2;82870;ALISADOR DE PELO S12A(220) Shine Therapy PALTA M;PERSONAL CARE
10501157;;F;54;CHILENO;;X;OVALLE                        ;COQUIMBO;34990;1;1;0;0;0;1;1;34990;AFEITADORA SH 887 WD BAT;PERSONAL CARE
18692258;;M;28;CHILENO;;Millenial;VILLA ALEGRE                  ;MAULE;922650;11;7;7;4;777430;4;3;145220;CORTA PELO SG-8520;PERSONAL CARE
6845477;;F;70;CHILENO;;Silencioso;N/D;N/D;306972;3;3;0;0;0;3;3;306972;ALISADOR DE PELO S12A(220) Shine Therapy PALTA M;PERSONAL CARE
15027626;;F;40;CHILENO;;X;ARICA                         ;ARICA Y PARINACOTA;36990;1;1;0;0;0;1;1;36990;ALISADOR DE PELO SG-3540 MORADO MORADO;PERSONAL CARE
13245931;;F;44;CHILENO;;X;PROVIDENCIA                   ;METROPOLITANA;26990;1;1;0;0;0;1;1;26990;DEPILADORA SG-9004;PERSONAL CARE
11396149;Soltero;F;53;CHILENO;;X;RENCA                         ;METROPOLITANA;14990;1;1;0;0;0;1;1;14990;SECADOR DIAMOND STD;PERSONAL CARE
16818441;Casado;F;34;CHILENO;PROFESOR;Millenial;PROVIDENCIA                   ;METROPOLITANA;15990;1;1;0;0;0;1;1;15990;CORTA PELO SG-8200;PERSONAL CARE
18016125;;M;30;CHILENO;;Millenial;ANCUD                         ;LOS LAGOS;28990;1;1;0;0;0;1;1;28990;SECADOR DE PELO SG-3051;PERSONAL CARE
16507277;;F;35;CHILENO;;Millenial;PROVIDENCIA                   ;METROPOLITANA;14990;1;1;1;1;14990;0;0;0;CORTA PELO SPORT GC 542 BVT;PERSONAL CARE
18559729;Soltero;F;28;CHILENO;;Millenial;PROVIDENCIA                   ;METROPOLITANA;24990;1;1;0;0;0;1;1;24990;CORTAPELOS GM 596;PERSONAL CARE
17135201;;F;33;CHILENO;;Millenial;SAN VICENTE                   ;L.G.B.OÂ´HIGGINS;19990;1;1;0;0;0;1;1;19990;DEPILADORA BRE225/00;PERSONAL CARE
20086770;;F;29;CHILENO;;Millenial;EL TABO                       ;VALPARAISO;111978;2;2;2;1;69980;0;1;41998;ALISADOR DE PELO SG-4651 ROJO;PERSONAL CARE
12027701;;M;54;CHILENO;;Boomers;PUENTE ALTO                   ;METROPOLITANA;35670;2;1;0;0;0;2;1;35670;AFEITADORA S1121/41 ELECTRICA;PERSONAL CARE
17170563;Casado;F;33;CHILENO;PSICOLOGO;Millenial;PROVIDENCIA                   ;METROPOLITANA;55980;2;2;0;0;0;2;2;55980;AFEITADORA SG-7250 NEGRO;PERSONAL CARE
27197652;;F;35;EXTRANJERO - NO INFORMA NACIONALIDAD;;Extranjero;N/D;N/D;12990;1;1;0;0;0;1;1;12990;ONDULADOR DE PELO SG-2411 25MM;PERSONAL CARE
9955877;;F;57;CHILENO;;Boomers;RENCA                         ;METROPOLITANA;39990;1;1;0;0;0;1;1;39990;DEPILADORA BRE285/00 CONVENCIONAL;PERSONAL CARE
13091086;;M;46;CHILENO;;X;N/D;N/D;44990;1;1;0;0;0;1;1;44990;DEPILADORA 3170 BRAUN;PERSONAL CARE
13376241;;F;48;CHILENO;;X;SAN CARLOS                    ;BIO BIO;15990;1;1;0;0;0;1;1;15990;CORTAPELO GAMA MG 566;PERSONAL CARE
12119237;;F;50;CHILENO;;X;N/D;N/D;29990;1;1;0;0;0;1;1;29990;ALISADOR DE PELO SG-3540 MORADO MORADO;PERSONAL CARE
17744749;;F;31;CHILENO;;Millenial;ANGOL                         ;ARAUCANIA;54990;1;1;0;0;0;1;1;54990;ALISADOR DE PELO SG-4651 ROJO;PERSONAL CARE
18154623;;M;30;CHILENO;;Millenial;SAN CARLOS                    ;BIO BIO;24570;2;1;0;0;0;2;1;24570;SECADOR DIAMOND STD;PERSONAL CARE
18631336;Soltero;F;28;CHILENO;TECNICO;Millenial;PROVIDENCIA                   ;METROPOLITANA;49990;1;1;0;0;0;1;1;49990;ALISADOR SIEGEN SG-4716;PERSONAL CARE
11756106;;F;54;CHILENO;;X;MELIPILLA                     ;METROPOLITANA;556240;5;2;0;0;0;5;2;556240;CORTA PELO SG-8520;PERSONAL CARE
8177784;;F;65;CHILENO;;Boomers;PROVIDENCIA                   ;METROPOLITANA;9990;1;1;0;0;0;1;1;9990;SECADOR DE PELO SG-3012 NEGRO;PERSONAL CARE
9227000;;M;57;CHILENO;;Boomers;SANTA CRUZ                    ;L.G.B.OÂ´HIGGINS;24990;1;1;0;0;0;1;1;24990;CORTAPELOS GM 596;PERSONAL CARE
9903952;;M;59;CHILENO;;Boomers;PETORCA                       ;VALPARAISO;23980;2;2;0;0;0;2;2;23980;CORTA PELO SG-8200;PERSONAL CARE
8388223;;F;64;CHILENO;;Boomers;RENCA                         ;METROPOLITANA;22990;1;1;0;0;0;1;1;22990;CORTA PELO SG-8410;PERSONAL CARE
12816608;Soltero;F;47;CHILENO;;X;RENCA                         ;METROPOLITANA;57980;2;1;0;0;0;2;1;57980;ALISADOR DE PELO S12A(220) Shine Therapy PALTA M;PERSONAL CARE
19075046;Soltero;F;27;CHILENO;;Millenial;PADRE LAS CASAS               ;ARAUCANIA;24990;1;1;0;0;0;1;1;24990;DEPILADORA SG-9004;PERSONAL CARE
19871043;;F;23;CHILENO;;Silencioso;PROVIDENCIA                   ;METROPOLITANA;19990;1;1;0;0;0;1;1;19990;ALISADOR SG3510C09 MORADO PLACAS DE CERAMICA 21;PERSONAL CARE
10352766;;F;52;CHILENO;;X;TEMUCO                        ;ARAUCANIA;22992;1;1;0;0;0;1;1;22992;ALISADOR DE PELO SG-3540 MORADO MORADO;PERSONAL CARE
19973892;;F;23;CHILENO;;Z;N/D;N/D;21990;1;1;0;0;0;1;1;21990;SECADOR DE PELO SG-3051;PERSONAL CARE
19125942;;M;26;CHILENO;;Z;PROVIDENCIA                   ;METROPOLITANA;34980;2;1;2;1;34980;0;0;0;COMBO GAMA SECADOR+ALISADOR+CEPILLO;PERSONAL CARE
25579923;;F;46;COLOMBIANO;;Extranjero;COLINA                        ;METROPOLITANA;39990;1;1;0;0;0;1;1;39990;ALISADOR DE PELO S12A(220) Shine Therapy PALTA M;PERSONAL CARE
8769117;;F;66;CHILENO;;Boomers;RENCA                         ;METROPOLITANA;16990;1;1;0;0;0;1;1;16990;DEPILADORA SG-9003;PERSONAL CARE
19560258;;M;25;CHILENO;;Z;N/D;N/D;26000;1;1;1;1;26000;0;0;0;ALISADOR ELEGANCE LED KER;PERSONAL CARE
19484897;;M;25;CHILENO;;Z;N/D;N/D;21990;1;1;0;0;0;1;1;21990;SECADOR TEMPO TITAN KERATIN;PERSONAL CARE
11588518;Viudo;F;52;CHILENO;;X;SAN FERNANDO                  ;L.G.B.OÂ´HIGGINS;38980;2;2;0;0;0;2;2;38980;SECADOR DE PELO SG-3043 DC CAFE 2200 WATTS;PERSONAL CARE
9749394;;F;57;CHILENO;;Boomers;"";"";34980;2;1;0;0;0;2;1;34980;ALISADOR DE PELO S6300 GRIS;PERSONAL CARE
11996137;;F;50;CHILENO;;X;SANTA CRUZ                    ;L.G.B.OÂ´HIGGINS;62990;2;1;2;1;62990;0;0;0;DEPILADORA IPL Verina Bvt;PERSONAL CARE
10225892;;F;56;CHILENO;;Boomers;N/D;N/D;50960;4;3;0;0;0;4;3;50960;CORTA PELO GM 562;PERSONAL CARE
19232547;Soltero;F;26;CHILENO;;Silencioso;PROVIDENCIA                   ;METROPOLITANA;21990;1;1;1;1;21990;0;0;0;ALISADOR ELEGANCE LED KER;PERSONAL CARE
10579169;;F;57;CHILENO;;Boomers;PROVIDENCIA                   ;METROPOLITANA;48660;3;2;0;0;0;3;2;48660;AFEITADORA SPORT;PERSONAL CARE
10189246;;M;55;CHILENO;;Boomers;CHONCHI                       ;LOS LAGOS;19990;1;1;0;0;0;1;1;19990;DEPILADORA BRE225/00;PERSONAL CARE
15086513;;M;40;CHILENO;;X;PETORCA                       ;VALPARAISO;19990;1;1;0;0;0;1;1;19990;SECADOR DE PELO SE-3049C01 FUCSIA;PERSONAL CARE
16844891;;M;34;CHILENO;;Millenial;NIQUEN                        ;BIO BIO;14990;1;1;1;1;14990;0;0;0;KIT CORTABARBA MG3711;PERSONAL CARE
15762205;;F;38;CHILENO;;Silencioso;PROVIDENCIA                   ;METROPOLITANA;18990;1;1;0;0;0;1;1;18990;SECADOR DE PELO DIVA NEGRO;PERSONAL CARE
7584266;;F;66;CHILENO;;Boomers;MAIPU                         ;METROPOLITANA;82640;5;2;0;0;0;5;2;82640;ALISADOR DE PELO S12A(220) Shine Therapy PALTA M;PERSONAL CARE
17734440;;F;31;CHILENO;;Millenial;RENCA                         ;METROPOLITANA;39990;1;1;0;0;0;1;1;39990;ALISADOR DE PELO S12A(220) Shine Therapy PALTA M;PERSONAL CARE
20373519;;F;22;CHILENO;;Silencioso;PROVIDENCIA                   ;METROPOLITANA;14990;1;1;0;0;0;1;1;14990;CORTA PELO GM 562;PERSONAL CARE
17813531;Soltero;F;31;CHILENO;;Millenial;PROVIDENCIA                   ;METROPOLITANA;52560;3;1;0;0;0;3;1;52560;SPA PARA PIES SG-1560;PERSONAL CARE
9963445;;F;58;CHILENO;;Boomers;RENCA                         ;METROPOLITANA;22990;1;1;0;0;0;1;1;22990;DEPILADORA GAMA ESSENCIAL;PERSONAL CARE
13762927;;F;42;CHILENO;;X;LA LIGUA                      ;VALPARAISO;43970;3;2;0;0;0;3;2;43970;TRICOMBO SECADOR+ALISADOR+ONDULADOR;PERSONAL CARE
17276042;;M;32;CHILENO;;Silencioso;PROVIDENCIA                   ;METROPOLITANA;33980;2;1;2;1;33980;0;0;0;COMBO SIEGEN AFEITADORA + MULTISTYLER SG-8440;PERSONAL CARE
17285960;Casado;F;33;CHILENO;;Millenial;RENCA                         ;METROPOLITANA;57980;2;3;0;0;0;2;3;57980;SECADOR DIAMOND STD;PERSONAL CARE
11406058;;F;52;CHILENO;;X;VILLARICA                     ;ARAUCANIA;21990;1;1;0;0;0;1;1;21990;DEPILADORA BRE225/00;PERSONAL CARE
18182376;;M;29;CHILENO;;Millenial;VICTORIA                      ;ARAUCANIA;13990;1;1;0;0;0;1;1;13990;SECADOR DE PELO SG-3012 NEGRO;PERSONAL CARE
20121433;;F;23;CHILENO;;Silencioso;PROVIDENCIA                   ;METROPOLITANA;23980;2;1;2;1;23980;0;0;0;ALISADOR +SECADOR PELO;PERSONAL CARE
19283455;;M;26;CHILENO;;Silencioso;PROVIDENCIA                   ;METROPOLITANA;38980;2;1;2;1;38980;0;0;0;CORTA PELO HC-5850;PERSONAL CARE
14040736;;F;40;CHILENO;;X;PROVIDENCIA                   ;METROPOLITANA;74980;2;2;0;0;0;2;2;74980;COMBO SIEGEN AFEITADORA + MULTISTYLER SG-8440;PERSONAL CARE
20077785;;M;23;CHILENO;;Z;PROVIDENCIA                   ;METROPOLITANA;29990;1;1;0;0;0;1;1;29990;CORTA PELO SG-8520;PERSONAL CARE
7113181;;F;72;CHILENO;;Silencioso;N/D;N/D;21990;1;1;0;0;0;1;1;21990;SECADOR DE PELO SE-3049C01 FUCSIA;PERSONAL CARE
19795015;;M;24;CHILENO;;Z;N/D;N/D;45670;2;1;0;0;0;2;1;45670;AFEITADORA SG-7250 NEGRO;PERSONAL CARE
14190131;;M;47;CHILENO;;Silencioso;PROVIDENCIA                   ;METROPOLITANA;26990;1;1;0;0;0;1;1;26990;CORTA PELO SG-8520;PERSONAL CARE
17350964;;F;32;CHILENO;;Millenial;CHILLAN                       ;BIO BIO;32990;1;1;0;0;0;1;1;32990;ALISADOR AQUA THERAPY LED;PERSONAL CARE
18983839;;F;26;CHILENO;;Z;VILLA ALEGRE                  ;MAULE;126970;4;3;0;0;0;4;3;126970;TRICOMBO SECADOR+ALISADOR+ONDULADOR;PERSONAL CARE
19028201;;F;27;CHILENO;;Z;N/D;N/D;34990;1;1;0;0;0;1;1;34990;ALISADOR DE PELO SG-3540 MORADO MORADO;PERSONAL CARE
19565616;;F;25;CHILENO;;Z;PROVIDENCIA                   ;METROPOLITANA;28980;2;2;0;0;0;2;2;28980;DEPILADORA SG-9004;PERSONAL CARE
12991229;;F;46;CHILENO;;X;N/D;N/D;26990;1;1;0;0;0;1;1;26990;CORTA PELO SG-8520;PERSONAL CARE
18622841;Soltero;F;27;CHILENO;;Z;PROVIDENCIA                   ;METROPOLITANA;12990;1;1;1;1;12990;0;0;0;SECADOR PELO SG-3012C19;PERSONAL CARE
16774318;;F;34;CHILENO;;Silencioso;PROVIDENCIA                   ;METROPOLITANA;21990;1;1;1;1;21990;0;0;0;ALISADOR ELEGANCE LED KER;PERSONAL CARE
9984451;Casado;M;58;CHILENO;;Boomers;RENCA                         ;METROPOLITANA;21990;1;1;0;0;0;1;1;21990;SECADOR DE PELO SE-3049C01 FUCSIA;PERSONAL CARE
11334796;;F;54;CHILENO;;X;PARRAL                        ;MAULE;19990;1;1;0;0;0;1;1;19990;SECADOR DE PELO SE-3049C01 FUCSIA;PERSONAL CARE
17290171;;F;32;CHILENO;;Millenial;CARAHUE                       ;ARAUCANIA;34990;1;1;0;0;0;1;1;34990;DEPILADORA BRE285/00 CONVENCIONAL;PERSONAL CARE
11281824;;F;55;CHILENO;;Boomers;SAN FERNANDO                  ;L.G.B.OÂ´HIGGINS;34990;1;1;0;0;0;1;1;34990;AFEITADORA SH 887 WD BAT;PERSONAL CARE
18729587;;F;28;CHILENO;;Millenial;"";"";74980;2;1;0;0;0;2;1;74980;ALISADOR DE PELO S12A(220) Shine Therapy PALTA M;PERSONAL CARE
11984696;;F;50;CHILENO;;X;LOS ANGELES                   ;BIO BIO;24990;1;1;0;0;0;1;1;24990;ALISADORA SIEGEN SG-3512D2;PERSONAL CARE
19414492;;F;26;CHILENO;;Z;CHILLAN                       ;BIO BIO;26990;1;1;0;0;0;1;1;26990;CORTAPELOS GM 596;PERSONAL CARE
13468585;;M;43;CHILENO;;X;PROVIDENCIA                   ;METROPOLITANA;19990;1;1;0;0;0;1;1;19990;AFEITADORA SG-7210 NEGRO;PERSONAL CARE
17324112;;F;32;CHILENO;;Millenial;PROVIDENCIA                   ;METROPOLITANA;36990;1;1;0;0;0;1;1;36990;TRICOMBO SECADOR+ALISADOR+ONDULADOR;PERSONAL CARE
13857820;;F;41;CHILENO;;Silencioso;PROVIDENCIA                   ;METROPOLITANA;32990;1;1;0;0;0;1;1;32990;ALISADOR ELEGANCE LED KER;PERSONAL CARE
10303782;;M;57;CHILENO;;Boomers;SAN JAVIER                    ;MAULE;12990;1;1;0;0;0;1;1;12990;SECADOR PELO SG-3012C19;PERSONAL CARE
12210881;;F;50;CHILENO;;X;RENCA                         ;METROPOLITANA;19990;1;1;0;0;0;1;1;19990;AFEITADORA SG-7210 NEGRO;PERSONAL CARE
5730243;;M;76;CHILENO;;Silencioso;N/D;N/D;29990;1;1;0;0;0;1;1;29990;AFEITADORA SG-7250 NEGRO;PERSONAL CARE
19486509;;F;25;CHILENO;;Silencioso;PROVIDENCIA                   ;METROPOLITANA;10990;1;1;0;0;0;1;1;10990;SECADOR GAMA EOLIC MINI TRAVEL;PERSONAL CARE
9370558;;F;58;CHILENO;;Boomers;BUIN                          ;METROPOLITANA;24980;2;1;0;0;0;2;1;24980;SECADOR DE PELO SG-3043 DC CAFE 2200 WATTS;PERSONAL CARE
19118696;Soltero;F;26;CHILENO;;Z;PROVIDENCIA                   ;METROPOLITANA;34990;2;1;2;1;34990;0;0;0;SpaFace Msgr Led Ultrasonic Bat Gama;PERSONAL CARE
6201314;;M;74;CHILENO;;Silencioso;RENCA                         ;METROPOLITANA;47980;2;1;0;0;0;2;1;47980;CORTAPELOS GM 596;PERSONAL CARE
19894564;;F;24;CHILENO;;Z;PROVIDENCIA                   ;METROPOLITANA;36990;1;2;0;0;0;1;2;36990;CORTADOR DE PELO SIEGEN SG-8590;PERSONAL CARE
12676229;;M;48;CHILENO;;X;PUENTE ALTO                   ;METROPOLITANA;29990;1;1;0;0;0;1;1;29990;TRICOMBO SECADOR+ALISADOR+ONDULADOR;PERSONAL CARE
16579518;Casado;F;35;CHILENO;PROFESOR;Millenial;VICTORIA                      ;ARAUCANIA;78970;4;1;0;0;0;4;1;78970;DEPILADORA OASIS SENSATION;PERSONAL CARE
11565764;;F;52;CHILENO;;X;PROVIDENCIA                   ;METROPOLITANA;41990;1;2;0;0;0;1;2;41990;AFEITADORA S1323/41 ELECTRICA;PERSONAL CARE
16668885;;F;35;CHILENO;;Millenial;CANETE                        ;BIO BIO;35980;2;2;0;0;0;2;2;35980;SECADOR DE PELO SG-3043 DC CAFE 2200 WATTS;PERSONAL CARE
19351358;;F;25;CHILENO;;X;COMBARBALA                    ;COQUIMBO;31990;1;1;0;0;0;1;1;31990;DEPILADORA SG-9004;PERSONAL CARE
15950336;;M;37;CHILENO;;Millenial;N/D;N/D;29990;1;1;0;0;0;1;1;29990;TRICOMBO SECADOR+ALISADOR+ONDULADOR;PERSONAL CARE
13047044;;F;46;CHILENO;;X;PROVIDENCIA                   ;METROPOLITANA;24990;1;1;0;0;0;1;1;24990;ALISADOR ELEGANCE LED BLOOM VT;PERSONAL CARE
10075576;;F;57;CHILENO;;Boomers;RENCA                         ;METROPOLITANA;32990;1;1;0;0;0;1;1;32990;TRICOMBO SECADOR+ALISADOR+ONDULADOR;PERSONAL CARE
16920083;;F;34;CHILENO;;Millenial;"";"";36980;2;1;2;1;36980;0;0;0;TRICOMBO SECADOR+ALISADOR+ONDULADOR;PERSONAL CARE
6751804;Casado;F;71;CHILENO;;Silencioso;RENCA                         ;METROPOLITANA;47990;1;1;0;0;0;1;1;47990;COMBO SIEGEN AFEITADORA + MULTISTYLER SG-8440;PERSONAL CARE
18898546;;M;27;CHILENO;;Millenial;VILLA ALEMANA                 ;VALPARAISO;12990;1;1;0;0;0;1;1;12990;Trimmer Gama GT 527;PERSONAL CARE
8301265;Viudo;F;63;CHILENO;;Boomers;RENCA                         ;METROPOLITANA;49990;1;1;0;0;0;1;1;49990;DEPILADORA BRE285/00 CONVENCIONAL;PERSONAL CARE
15113004;;F;40;CHILENO;;X;RENGO                         ;L.G.B.OÂ´HIGGINS;20990;1;1;0;0;0;1;1;20990;ALISADOR DE PELO SG-3510 FUCSIA;PERSONAL CARE
14391239;;M;44;CHILENO;;X;N/D;N/D;202980;2;2;0;0;0;2;2;202980;Trimmer Gama GT 527;PERSONAL CARE
15134437;;F;40;CHILENO;;X;PROVIDENCIA                   ;METROPOLITANA;25990;1;1;0;0;0;1;1;25990;SECADOR DE PELO SG-3049 NEGRO;PERSONAL CARE
18623528;;F;28;CHILENO;;Millenial;TALAGANTE                     ;METROPOLITANA;23992;1;2;0;0;0;1;2;23992;SECADOR DE PELO SG-3049 NEGRO;PERSONAL CARE
7134409;;F;73;CHILENO;;Silencioso;N/D;N/D;0;0;0;0;0;0;0;0;0;AFEITADORA S1121/41 ELECTRICA;PERSONAL CARE
20105366;;F;23;CHILENO;;Z;N/D;N/D;0;0;0;0;0;0;0;0;0;AFEITADORA SG-7250 NEGRO;PERSONAL CARE
14090174;;M;41;CHILENO;;Millenial;N/D;N/D;0;0;0;0;0;0;0;0;0;AFEITADORA SG-7250 NEGRO;PERSONAL CARE
18750794;;M;28;CHILENO;;Millenial;SANTA CRUZ                    ;L.G.B.OÂ´HIGGINS;0;0;0;0;0;0;0;0;0;DEPILADORA SG-9004EX;PERSONAL CARE
20511335;;F;22;CHILENO;;Millenial;N/D;N/D;0;0;0;0;0;0;0;0;0;DEPILADORA GAMA ESSENCIAL;PERSONAL CARE
10235966;;M;41;CHILENO;;X;VILLA ALEMANA                 ;VALPARAISO;0;0;0;0;0;0;0;0;0;RECORTADOR DE VELLO NT3160/15 PHILIPS;PERSONAL CARE
13184504;Casado;F;45;CHILENO;;X;RENCA                         ;METROPOLITANA;0;0;0;0;0;0;0;0;0;Trimmer Gama GT 527;PERSONAL CARE
20395851;;F;22;CHILENO;;Silencioso;PROVIDENCIA                   ;METROPOLITANA;0;0;0;0;0;0;0;0;0;SECADOR DE PELO SG-3012 NEGRO;PERSONAL CARE
15761324;;F;37;CHILENO;;Silencioso;PROVIDENCIA                   ;METROPOLITANA;0;0;0;0;0;0;0;0;0;KIT CORTABARBA MG3731;PERSONAL CARE
19579221;;F;25;CHILENO;;Z;N/D;N/D;0;0;0;0;0;0;0;0;0;DEPILADORA SG-9003;PERSONAL CARE
3542150;;M;80;CHILENO;;Silencioso;SAN BERNARDO                  ;METROPOLITANA;0;0;0;0;0;0;0;0;0;AFEITADORA S1121/41 ELECTRICA;PERSONAL CARE
14396590;;F;43;CHILENO;;X;MAIPU                         ;METROPOLITANA;0;0;0;0;0;0;0;0;0;ALISADOR REMIG. WET2 S27A (BV) R;PERSONAL CARE
19540878;;M;29;CHILENO;;Extranjero;PUERTO MONTT                  ;LOS LAGOS;0;0;0;0;0;0;0;0;0;SECADOR DE PELO MISTRAL STD;PERSONAL CARE
15368996;;F;39;CHILENO;;Silencioso;PROVIDENCIA                   ;METROPOLITANA;0;0;0;0;0;0;0;0;0;SECADOR GAMA EOLIC MINI TRAVEL;PERSONAL CARE
6399752;;M;72;CHILENO;;Silencioso;PROVIDENCIA                   ;METROPOLITANA;0;0;0;0;0;0;0;0;0;CORTABARBA BT3206;PERSONAL CARE
20030392;;M;22;CHILENO;;Silencioso;PROVIDENCIA                   ;METROPOLITANA;0;0;0;0;0;0;0;0;0;ALISADOR +SECADOR PELO;PERSONAL CARE
16000591;Casado;F;37;CHILENO;;Millenial;RENCA                         ;METROPOLITANA;0;0;0;0;0;0;0;0;0;SECADOR DIAMOND STD;PERSONAL CARE
12019572;;F;45;CHILENO;;X;PROVIDENCIA                   ;METROPOLITANA;0;0;0;0;0;0;0;0;0;SECADOR DE PELO SG-3051;PERSONAL CARE
10969065;;M;54;CHILENO;;Boomers;CASTRO                        ;LOS LAGOS;0;0;0;0;0;0;0;0;0;ALISADOR SIEGEN SG-4716;PERSONAL CARE
15469449;Soltero;F;40;CHILENO;BIOTECNOLOGO INDUSTRIAL;Silencioso;PROVIDENCIA                   ;METROPOLITANA;0;0;0;0;0;0;0;0;0;PACK AFEITADORA S1223/41+CORTA PELO HC3505/15;PERSONAL CARE
16242622;;F;36;CHILENO;;Silencioso;PROVIDENCIA                   ;METROPOLITANA;0;0;0;0;0;0;0;0;0;SECADOR DE PELO SE-3049C01 FUCSIA;PERSONAL CARE
8747860;;F;60;CHILENO;;Boomers;RENCA                         ;METROPOLITANA;0;0;0;0;0;0;0;0;0;SECADOR DE PELO DIVA NEGRO;PERSONAL CARE
18176414;;F;29;CHILENO;;Millenial;PROVIDENCIA                   ;METROPOLITANA;0;0;0;0;0;0;0;0;0;SECADOR DE PELO HP8204/10 THERMOPROTECT 2100W FR;PERSONAL CARE
14686181;;M;47;PERUANO;;Extranjero;N/D;N/D;0;0;0;0;0;0;0;0;0;AFEITADORA S1223/41 ELECTRICA;PERSONAL CARE
18345580;;F;29;CHILENO;;Millenial;LOS ANGELES                   ;BIO BIO;0;0;0;0;0;0;0;0;0;SECADOR DE PELO SG-3049 NEGRO;PERSONAL CARE
17120158;;F;33;CHILENO;;Silencioso;PROVIDENCIA                   ;METROPOLITANA;0;0;0;0;0;0;0;0;0;ALISADOR DE PELO S6300 GRIS;PERSONAL CARE
15611818;;F;38;CHILENO;;X;COPIAPO                       ;ATACAMA;0;0;0;0;0;0;0;0;0;ALISADOR SG3510C09 MORADO PLACAS DE CERAMICA 21;PERSONAL CARE
18319675;;F;29;CHILENO;;Millenial;PROVIDENCIA                   ;METROPOLITANA;0;0;0;0;0;0;0;0;0;SECADOR DE PELO SG-3049 NEGRO;PERSONAL CARE
26637948;;F;32;EXTRANJERO - NO INFORMA NACIONALIDAD;;Extranjero;ESTACION CENTRAL              ;METROPOLITANA;0;0;0;0;0;0;0;0;0;SECADOR DE PELO SIEGEN SG-3049C02;PERSONAL CARE
15554142;;F;38;CHILENO;;X;COLBUN                        ;MAULE;0;0;0;0;0;0;0;0;0;AFEITADORA SG-7250 NEGRO;PERSONAL CARE
18624532;;F;28;CHILENO;;Millenial;PROVIDENCIA                   ;METROPOLITANA;0;0;0;0;0;0;0;0;0;SECADOR PELO SG-3012C19;PERSONAL CARE
24600792;Soltero;F;36;BOLIVIANO;;Extranjero;PROVIDENCIA                   ;METROPOLITANA;0;0;0;0;0;0;0;0;0;TRICOMBO SECADOR+ALISADOR+ONDULADOR;PERSONAL CARE
17579670;;M;31;CHILENO;;Millenial;PENAFLOR                      ;METROPOLITANA;0;0;0;0;0;0;0;0;0;ALISADORA SG-3510C02 MORADO;PERSONAL CARE
5348811;;M;77;CHILENO;;Silencioso;RENCA                         ;METROPOLITANA;0;0;0;0;0;0;0;0;0;AFEITADORA S1121/41 ELECTRICA;PERSONAL CARE
16728731;;F;35;CHILENO;;Silencioso;PROVIDENCIA                   ;METROPOLITANA;0;0;0;0;0;0;0;0;0;CORTA PELO SG-8520;PERSONAL CARE
12743890;;M;47;CHILENO;;X;RENCA                         ;METROPOLITANA;0;0;0;0;0;0;0;0;0;DEPILADORA BRAUN SE830 FACE MN SR WH BOX CHI;PERSONAL CARE
19369009;Soltero;F;26;CHILENO;PSICOLOGO;Z;PROVIDENCIA                   ;METROPOLITANA;0;0;0;0;0;0;0;0;0;SECADOR DE PELO SIEGEN SG-3035;PERSONAL CARE
19898590;;F;24;CHILENO;;Z;TALCA;MAULE;0;0;0;0;0;0;0;0;0;SECADOR DE PELO SE-3049C01 FUCSIA;PERSONAL CARE
20327457;;M;22;CHILENO;;Silencioso;PROVIDENCIA                   ;METROPOLITANA;0;0;0;0;0;0;0;0;0;AFEITADORA BRAUN 310S;PERSONAL CARE
14546645;;M;47;CHILENO;;X;N/D;N/D;0;0;0;0;0;0;0;0;0;PACK AFEITADORA S1223/41+CORTA PELO HC3505/15;PERSONAL CARE
11877483;;M;50;CHILENO;;X;SAN JOSE DE MAIPO             ;METROPOLITANA;0;0;0;0;0;0;0;0;0;CORTA PELO SPORT GCX 623 BVT;PERSONAL CARE
20029977;;F;23;CHILENO;;Millenial;N/D;N/D;0;0;0;0;0;0;0;0;0;SECADOR DE PELO SIEGEN SG-3035;PERSONAL CARE
9934862;;F;56;CHILENO;;Boomers;ANGOL                         ;ARAUCANIA;0;0;0;0;0;0;0;0;0;SECADOR DE PELO SG-3012 NEGRO;PERSONAL CARE
10953868;;M;51;CHILENO;;X;COIHAIQUE                     ;AYSEN;0;0;0;0;0;0;0;0;0;SECADOR PELO SG-3012C19;PERSONAL CARE
19298486;;F;26;CHILENO;;Z;CURICO                        ;MAULE;0;0;0;0;0;0;0;0;0;CORTA PELO GM 562;PERSONAL CARE
16573465;;F;35;CHILENO;;Millenial;VILLA ALEMANA;VALPARAISO;0;0;0;0;0;0;0;0;0;SECADOR DE PELO SIEGEN SG-3035;PERSONAL CARE
19121786;;M;26;CHILENO;;Z;HUALQUI;BIO-BIO;0;0;0;0;0;0;0;0;0;ALISADOR +SECADOR PELO;PERSONAL CARE
16486203;;M;35;CHILENO;;Millenial;COIHAIQUE                     ;AYSEN;0;0;0;0;0;0;0;0;0;CORTABARBA BT3206;PERSONAL CARE
19127632;;F;26;CHILENO;;Z;PROVIDENCIA                   ;METROPOLITANA;0;0;0;0;0;0;0;0;0;Trimmer Gama GT 527;PERSONAL CARE
15416944;;F;39;CHILENO;;X;COLINA                        ;METROPOLITANA;0;0;0;0;0;0;0;0;0;ALISADORA SG-4751;PERSONAL CARE
11766412;;F;51;CHILENO;;X;CAUQUENES                     ;MAULE;0;0;0;0;0;0;0;0;0;SECADOR DE PELO SIEGEN SG-3035;PERSONAL CARE
12084613;;F;53;CHILENO;;Silencioso;PROVIDENCIA                   ;METROPOLITANA;0;0;0;0;0;0;0;0;0;AFEITADORA SG-7250 NEGRO;PERSONAL CARE
13810019;;M;42;CHILENO;;X;VICTORIA                      ;ARAUCANIA;0;0;0;0;0;0;0;0;0;SECADOR DIAMOND STD;PERSONAL CARE
9822365;;F;58;CHILENO;;Boomers;SAN JOAQUIN                   ;METROPOLITANA;0;0;0;0;0;0;0;0;0;ALISADOR DE PELO SG-3540 MORADO MORADO;PERSONAL CARE
15220912;;F;40;CHILENO;;X;N/D;N/D;0;0;0;0;0;0;0;0;0;ALISADOR DE PELO SG-4651 ROJO;PERSONAL CARE
17980017;Soltero;M;30;CHILENO;;Silencioso;PROVIDENCIA                   ;METROPOLITANA;0;0;0;0;0;0;0;0;0;KIT CORTABARBA MG3711;PERSONAL CARE
17545245;Soltero;F;32;CHILENO;;Millenial;LA GRANJA                     ;METROPOLITANA;0;0;0;0;0;0;0;0;0;SECADOR DE PELO SIEGEN SG-3035;PERSONAL CARE
18790915;;F;29;CHILENO;;Silencioso;PROVIDENCIA                   ;METROPOLITANA;0;0;0;0;0;0;0;0;0;ALISADOR DE PELO SG-3540 MORADO MORADO;PERSONAL CARE
16153490;;M;36;CHILENO;;Millenial;PROVIDENCIA                   ;METROPOLITANA;0;0;0;0;0;0;0;0;0;CORTA PELO SG-8520;PERSONAL CARE
18842455;;F;27;CHILENO;;Millenial;N/D;N/D;0;0;0;0;0;0;0;0;0;AFEITADORA S1121/41 ELECTRICA;PERSONAL CARE
10594412;;F;57;CHILENO;;Boomers;N/D;N/D;0;0;0;0;0;0;0;0;0;AFEITADORA SG-7250 NEGRO;PERSONAL CARE
9739608;;F;56;CHILENO;;Boomers;RENGO                         ;L.G.B.OÂ´HIGGINS;0;0;0;0;0;0;0;0;0;DEPILADORA OASIS SENSATION;PERSONAL CARE
11346037;;F;54;CHILENO;;Silencioso;PROVIDENCIA                   ;METROPOLITANA;0;0;0;0;0;0;0;0;0;SECADOR PELO SG-3012C19;PERSONAL CARE
13826966;;F;44;CHILENO;;X;PROVIDENCIA                   ;METROPOLITANA;0;0;0;0;0;0;0;0;0;SECADOR DE PELO D3019 PRO TITANIO;PERSONAL CARE
20393251;;M;21;CHILENO;;Z;PROVIDENCIA                   ;METROPOLITANA;0;0;0;0;0;0;0;0;0;CORTA PELO SPORT GCX 623 BVT;PERSONAL CARE
8413877;Casado;M;64;CHILENO;;Boomers;RENCA                         ;METROPOLITANA;0;0;0;0;0;0;0;0;0;CORTA PELO HC3505;PERSONAL CARE
14570081;;M;46;CHILENO;;X;NUEVA IMPERIAL                ;ARAUCANIA;0;0;0;0;0;0;0;0;0;ALISADOR DE PELO SG-3510 FUCSIA;PERSONAL CARE
20334169;;F;22;CHILENO;;Z;"";"";0;0;0;0;0;0;0;0;0;ALISADOR DE PELO S12A(220) Shine Therapy PALTA M;PERSONAL CARE
10827817;;M;56;CHILENO;;Boomers;PALMILLA                      ;L.G.B.OÂ´HIGGINS;0;0;0;0;0;0;0;0;0;AFEITADORA SH 887 WD BAT;PERSONAL CARE
12745694;Casado;F;48;CHILENO;;X;N/D;N/D;0;0;0;0;0;0;0;0;0;SECADOR DE PELO SIEGEN SG-3035;PERSONAL CARE
11145912;;F;54;CHILENO;;Boomers;RENCA                         ;METROPOLITANA;0;0;0;0;0;0;0;0;0;SECADOR PELO SG-3012C19;PERSONAL CARE
15938273;;F;37;CHILENO;;Millenial;PITRUFQUEN                    ;ARAUCANIA;0;0;0;0;0;0;0;0;0;ALISADOR DE PELO HP8321 + ESTUCHE + CEPILLO;PERSONAL CARE
15216154;;F;40;CHILENO;;X;RENCA                         ;METROPOLITANA;0;0;0;0;0;0;0;0;0;COMBO SIEGEN AFEITADORA + MULTISTYLER SG-8440;PERSONAL CARE
12785613;;F;46;CHILENO;;X;N/D;N/D;0;0;0;0;0;0;0;0;0;CORTADOR DE PELO PACL GC 542 Sport Bat GT 527;PERSONAL CARE
10821851;;F;56;CHILENO;;Boomers;VINA DEL MAR                  ;VALPARAISO;0;0;0;0;0;0;0;0;0;SECADOR DE PELO SIEGEN SG-3035;PERSONAL CARE
17455128;;F;32;CHILENO;;Millenial;SAN ANTONIO                   ;VALPARAISO;0;0;0;0;0;0;0;0;0;DEPILADORA CYBELE IPL GOLD 200 MIL PULSACIONES;PERSONAL CARE
20015088;;M;23;CHILENO;;Z;VALLENAR;ATACAMA;0;0;0;0;0;0;0;0;0;CORTA PELO SG-8520;PERSONAL CARE
13942102;;M;41;CHILENO;;X;RENCA                         ;METROPOLITANA;0;0;0;0;0;0;0;0;0;DEPILADORA IPL MAGNA PK;PERSONAL CARE
19781417;;F;23;CHILENO;;Z;N/D;N/D;0;0;0;0;0;0;0;0;0;DEPILADORA IPL 3500 LUZ PULSADA;PERSONAL CARE
19580937;;F;24;CHILENO;;Z;CARAHUE                       ;ARAUCANIA;0;0;0;0;0;0;0;0;0;ALISADOR DE PELO SG-3540 MORADO MORADO;PERSONAL CARE
17745573;Soltero;F;31;CHILENO;MATRONA;Millenial;"";"";0;0;0;0;0;0;0;0;0;CORTA PELO SG-8520;PERSONAL CARE
9895803;;F;58;CHILENO;;Boomers;QUILPUE                       ;VALPARAISO;0;0;0;0;0;0;0;0;0;SECADOR TEMPO TITAN KERATIN;PERSONAL CARE
10403348;;F;57;CHILENO;;Boomers;RENCA                         ;METROPOLITANA;0;0;0;0;0;0;0;0;0;SECADOR DE PELO SE-3049C01 FUCSIA;PERSONAL CARE
17073119;;F;33;CHILENO;;Millenial;PROVIDENCIA                   ;METROPOLITANA;0;0;0;0;0;0;0;0;0;AFEITADORA S1323/41 ELECTRICA;PERSONAL CARE
12017504;;M;55;CHILENO;;Boomers;NUEVA IMPERIAL                ;ARAUCANIA;0;0;0;0;0;0;0;0;0;ALISADOR DE PELO S8607 DE COCO VERDE;PERSONAL CARE
9988166;;F;60;CHILENO;;Boomers;RENCA                         ;METROPOLITANA;0;0;0;0;0;0;0;0;0;SECADOR DE PELO SIEGEN SG-3035;PERSONAL CARE
13512762;;M;44;CHILENO;;X;CURANILAHUE                   ;BIO BIO;0;0;0;0;0;0;0;0;0;DEPILADORA BRE255/00;PERSONAL CARE
13638144;;F;43;CHILENO;;X;ARICA                         ;ARICA Y PARINACOTA;0;0;0;0;0;0;0;0;0;CORTA PELO GC-625;PERSONAL CARE
11408094;;F;53;CHILENO;;X;RENCA                         ;METROPOLITANA;0;0;0;0;0;0;0;0;0;CORTA PELO SG-8520;PERSONAL CARE
17334989;;F;32;CHILENO;;Millenial;SANTA CRUZ;O HIGGINS;0;0;0;0;0;0;0;0;0;CORTABARBA BT3206;PERSONAL CARE
15950339;;M;37;CHILENO;;Millenial;CONSTITUCION                  ;MAULE;0;0;0;0;0;0;0;0;0;AFEITADORA SPORT;PERSONAL CARE
17252505;;F;32;CHILENO;;Millenial;PROVIDENCIA                   ;METROPOLITANA;0;0;0;0;0;0;0;0;0;DEPILADORA IPL 3500 LUZ PULSADA;PERSONAL CARE
13597789;;M;42;CHILENO;;X;N/D;N/D;0;0;0;0;0;0;0;0;0;SECADOR DE PELO SG-3012 NEGRO;PERSONAL CARE
14563128;;M;44;CHILENO;;X;PROVIDENCIA                   ;METROPOLITANA;0;0;0;0;0;0;0;0;0;CORTA PELO GC-615;PERSONAL CARE
9339398;;M;57;CHILENO;;Boomers;TALCA                         ;MAULE;0;0;0;0;0;0;0;0;0;SECADOR DE PELO SE-3049C01 FUCSIA;PERSONAL CARE
15454795;;M;40;CHILENO;;X;EL TABO                       ;VALPARAISO;0;0;0;0;0;0;0;0;0;CORTA PELO HC3520;PERSONAL CARE
18821832;;F;27;CHILENO;;Z;PROVIDENCIA                   ;METROPOLITANA;0;0;0;0;0;0;0;0;0;DEPILADORA BRE225/00;PERSONAL CARE
15262688;;F;40;CHILENO;;X;PROVIDENCIA                   ;METROPOLITANA;0;0;0;0;0;0;0;0;0;AFEITADORA SPORT;PERSONAL CARE
17567443;;F;32;CHILENO;;Millenial;N/D;N/D;0;0;0;0;0;0;0;0;0;SECADOR TEMPO TITAN KERATIN;PERSONAL CARE
19033506;Soltero;M;27;CHILENO;TECNICO EN AUTOMATIZACION Y CONTROL INDUSTRIAL;Z;PROVIDENCIA                   ;METROPOLITANA;0;0;0;0;0;0;0;0;0;AFEITADORA SG-7250 NEGRO;PERSONAL CARE
19973036;;F;24;CHILENO;;Z;AYSEN;AYSEN;0;0;0;0;0;0;0;0;0;ALISADOR +SECADOR PELO;PERSONAL CARE
12551858;;M;53;CHILENO;;X;N/D;N/D;0;0;0;0;0;0;0;0;0;ALISADORA SG-4653;PERSONAL CARE
20016952;;F;23;CHILENO;;Z;PROVIDENCIA                   ;METROPOLITANA;0;0;0;0;0;0;0;0;0;SECADOR DE PELO DIVA NEGRO;PERSONAL CARE
7189037;;F;63;CHILENO;;Boomers;PROVIDENCIA                   ;METROPOLITANA;0;0;0;0;0;0;0;0;0;SECADOR DE PELO TEMPO 3D 220 BLACK;PERSONAL CARE
15623887;;F;39;CHILENO;;X;PROVIDENCIA                   ;METROPOLITANA;0;0;0;0;0;0;0;0;0;TRICOMBO SECADOR+ALISADOR+ONDULAD;PERSONAL CARE
17881718;Soltero;M;30;CHILENO;PROFESOR;Silencioso;PROVIDENCIA                   ;METROPOLITANA;0;0;0;0;0;0;0;0;0;ALISADOR +SECADOR PELO;PERSONAL CARE
17659986;;F;32;CHILENO;;Millenial;ANCUD                         ;LOS LAGOS;0;0;0;0;0;0;0;0;0;SECADOR DE PELO SIEGEN SG-3035;PERSONAL CARE
19399169;;F;25;CHILENO;;Silencioso;PROVIDENCIA                   ;METROPOLITANA;0;0;0;0;0;0;0;0;0;COMBO SECADOR+ALISADOR+ONDULADOR DE PELO;PERSONAL CARE
20380427;;F;22;CHILENO;;Silencioso;PROVIDENCIA                   ;METROPOLITANA;0;0;0;0;0;0;0;0;0;DEPILADORA SES 5/500 PINK BOX MN;PERSONAL CARE
18977468;;F;27;CHILENO;;Millenial;COLINA                        ;METROPOLITANA;0;0;0;0;0;0;0;0;0;CORTA PELO SG-8520;PERSONAL CARE
19276638;Soltero;M;26;CHILENO;;Z;PROVIDENCIA                   ;METROPOLITANA;0;0;0;0;0;0;0;0;0;DEPILADORA BRE225/00;PERSONAL CARE
17844866;;M;30;CHILENO;;Millenial;TALCAHUANO                    ;BIO BIO;0;0;0;0;0;0;0;0;0;COMBO BALANZA NEGRA+SECADOR DIAMOND ST NEGRO;PERSONAL CARE
12407286;;F;49;CHILENO;;X;RENCA                         ;METROPOLITANA;0;0;0;0;0;0;0;0;0;SECADOR DE PELO SG-3012 NEGRO;PERSONAL CARE
11588852;;F;52;CHILENO;;X;VALDIVIA                      ;LOS LAGOS;0;0;0;0;0;0;0;0;0;CORTA PELO SG-8200;PERSONAL CARE
16720489;;M;34;CHILENO;;Millenial;N/D;N/D;0;0;0;0;0;0;0;0;0;AFEITADORA SPORT SH 886 BAT;PERSONAL CARE
17856371;;M;30;CHILENO;;Millenial;N/D;N/D;0;0;0;0;0;0;0;0;0;KIT CORTABARBA MG3711;PERSONAL CARE
17161128;;M;33;CHILENO;;Millenial;PROVIDENCIA                   ;METROPOLITANA;0;0;0;0;0;0;0;0;0;DEPILADORA CYBELE IPL GOLD 200 MIL PULSACIONES;PERSONAL CARE
17906432;;F;31;CHILENO;;Millenial;N/D;N/D;0;0;0;0;0;0;0;0;0;DEPILADORA BRE700/00 MID-END CLOSED BOX;PERSONAL CARE
15258368;;F;40;CHILENO;;X;TEMUCO                        ;ARAUCANIA;0;0;0;0;0;0;0;0;0;SECADOR DE PELO DIAMOND ST BLOOM VT 220;PERSONAL CARE
6664620;;F;71;CHILENO;;Silencioso;RENCA                         ;METROPOLITANA;0;0;0;0;0;0;0;0;0;SECADOR DIAMOND STD;PERSONAL CARE
17763175;;F;31;CHILENO;;Millenial;NANCAGUA                      ;L.G.B.OÂ´HIGGINS;0;0;0;0;0;0;0;0;0;ALISADOR SIEGEN SG-4716;PERSONAL CARE
12941857;;F;46;CHILENO;;Millenial;"";"";0;0;0;0;0;0;0;0;0;COMBO BALANZA NEGRA+SECADOR DIAMOND ST NEGRO;PERSONAL CARE
18051764;Soltero;F;30;CHILENO;PREVENCION DE RIESGOS;Millenial;PROVIDENCIA                   ;METROPOLITANA;0;0;0;0;0;0;0;0;0;ALISADOR DE PELO SG-3510 FUCSIA;PERSONAL CARE
16924872;;F;33;CHILENO;;Millenial;PROVIDENCIA                   ;METROPOLITANA;0;0;0;0;0;0;0;0;0;ALISADOR DE PELO S12A(220) Shine Therapy PALTA M;PERSONAL CARE
11706137;;M;50;CHILENO;;X;RENCA                         ;METROPOLITANA;0;0;0;0;0;0;0;0;0;CORTA PELO SG-8200;PERSONAL CARE
20115143;;F;23;CHILENO;;Z;VICTORIA                      ;ARAUCANIA;0;0;0;0;0;0;0;0;0;ALISADOR ELEGANCE LED QUINOA BVT;PERSONAL CARE
8710201;;F;56;CHILENO;;Boomers;PROVIDENCIA                   ;METROPOLITANA;0;0;0;0;0;0;0;0;0;SECADOR DE PELO SG-3025 SILVER;PERSONAL CARE
10638142;;F;47;CHILENO;;X;RENCA                         ;METROPOLITANA;0;0;0;0;0;0;0;0;0;SECADOR PHILIPS BHC010;PERSONAL CARE
18147355;;F;30;CHILENO;;Silencioso;PROVIDENCIA                   ;METROPOLITANA;0;0;0;0;0;0;0;0;0;ALISADOR DE PELO SG-3540 MORADO MORADO;PERSONAL CARE
17311625;;F;32;CHILENO;;Millenial;PROVIDENCIA                   ;METROPOLITANA;0;0;0;0;0;0;0;0;0;SECADOR DE PELO MISTRAL STD;PERSONAL CARE
17165521;;M;33;CHILENO;;Millenial;ARAUCO                        ;BIO BIO;0;0;0;0;0;0;0;0;0;CORTA PELO HC3505;PERSONAL CARE
16153173;;F;36;CHILENO;;Millenial;PROVIDENCIA                   ;METROPOLITANA;0;0;0;0;0;0;0;0;0;DEPILADORA GAMA ESSENCIAL;PERSONAL CARE
13611330;;M;43;CHILENO;;X;RENCA                         ;METROPOLITANA;0;0;0;0;0;0;0;0;0;CORTA PELO GC-625;PERSONAL CARE
17861629;;F;30;CHILENO;;Millenial;PUERTO MONTT                  ;LOS LAGOS;0;0;0;0;0;0;0;0;0;COMBO SIEGEN AFEITADORA + MULTISTYLER SG-8440;PERSONAL CARE
14460473;;M;42;CHILENO;;X;ANTOFAGASTA                   ;ANTOFAGASTA;0;0;0;0;0;0;0;0;0;AFEITADORA SG-7210 NEGRO;PERSONAL CARE
18491231;Soltero;M;29;CHILENO;;Silencioso;PROVIDENCIA                   ;METROPOLITANA;0;0;0;0;0;0;0;0;0;CORTA PELO GC-625;PERSONAL CARE
8533587;;F;46;CHILENO;;X;TALAGANTE                     ;METROPOLITANA;0;0;0;0;0;0;0;0;0;CORTA PELO GC-625;PERSONAL CARE
10796389;Soltero;F;44;CHILENO;ASISTENTE SOCIAL;X;RENCA                         ;METROPOLITANA;0;0;0;0;0;0;0;0;0;DEPILADORA BRE225/00;PERSONAL CARE
10227490;;F;53;CHILENO;;X;PROVIDENCIA                   ;METROPOLITANA;0;0;0;0;0;0;0;0;0;AFEITADORA SG-7250 NEGRO;PERSONAL CARE
8308533;;M;64;CHILENO;;Boomers;PROVIDENCIA                   ;METROPOLITANA;0;0;0;0;0;0;0;0;0;AFEITADORA S1323 + Toalla y Set afeitado;PERSONAL CARE
18876015;Soltero;F;27;CHILENO;;Silencioso;PROVIDENCIA                   ;METROPOLITANA;0;0;0;0;0;0;0;0;0;CORTA PELO GM 562;PERSONAL CARE
13510546;;F;43;CHILENO;;X;CHIGUAYANTE                   ;BIO BIO;0;0;0;0;0;0;0;0;0;DEPILADORA OASIS LOOK BVT;PERSONAL CARE
14535970;;F;46;CHILENO;;X;RENCA                         ;METROPOLITANA;0;0;0;0;0;0;0;0;0;AFEITADORA XR1430 NEGRO;PERSONAL CARE
11566112;Casado;M;52;CHILENO;;X;RENCA                         ;METROPOLITANA;0;0;0;0;0;0;0;0;0;CORTA PELO GM 562;PERSONAL CARE
20114179;;F;23;CHILENO;;Z;PROVIDENCIA                   ;METROPOLITANA;0;0;0;0;0;0;0;0;0;SECADOR DE PELO HP8204/10 THERMOPROTECT 2100W FR;PERSONAL CARE
17838616;;F;31;CHILENO;;Millenial;MAIPU                         ;METROPOLITANA;0;0;0;0;0;0;0;0;0;DEPILADORA GAMA ESSENCIAL;PERSONAL CARE
12345220;;F;49;CHILENO;;X;ANCUD                         ;LOS LAGOS;0;0;0;0;0;0;0;0;0;ALISADOR DE PELO SG-3540 MORADO MORADO;PERSONAL CARE
10269941;;M;57;CHILENO;;Boomers;LA FLORIDA                    ;METROPOLITANA;0;0;0;0;0;0;0;0;0;CORTA PELO SPORT GC 542 BVT;PERSONAL CARE
12940797;;F;45;CHILENO;;X;VALLENAR;ATACAMA;0;0;0;0;0;0;0;0;0;CORTA PELO SPORT GC 542 BVT;PERSONAL CARE
20088785;;F;23;CHILENO;;Z;PROVIDENCIA                   ;METROPOLITANA;0;0;0;0;0;0;0;0;0;ALISADOR SIEGEN SG-4716;PERSONAL CARE
14252267;;M;53;CHILENO;;X;N/D;N/D;0;0;0;0;0;0;0;0;0;ONDULADOR DE PELO TURMALINA 25MM;PERSONAL CARE
18009836;;F;30;CHILENO;;Millenial;OVALLE                        ;COQUIMBO;0;0;0;0;0;0;0;0;0;DEPILADORA OASIS NEXT BVT;PERSONAL CARE
13516685;;F;48;CHILENO;;X;PROVIDENCIA                   ;METROPOLITANA;0;0;0;0;0;0;0;0;0;ALISADOR DE PELO SG-4651 ROJO;PERSONAL CARE
17640858;;M;37;CHILENO;;Millenial;PROVIDENCIA                   ;METROPOLITANA;0;0;0;0;0;0;0;0;0;CORTA PELO SPORT GC 542 BVT;PERSONAL CARE
16544491;Casado;M;35;CHILENO;;Millenial;RENCA                         ;METROPOLITANA;0;0;0;0;0;0;0;0;0;RECORTADOR DE VELLO NT3160/15 PHILIPS;PERSONAL CARE
20546490;;M;22;CHILENO;;Z;PROVIDENCIA                   ;METROPOLITANA;0;0;0;0;0;0;0;0;0;AFEITADORA QP2521/50 ONE BLADE GRAFITO;PERSONAL CARE
6954957;Casado;M;65;CHILENO;;Boomers;PENAFLOR                      ;METROPOLITANA;0;0;0;0;0;0;0;0;0;AFEITADORA SG-7250 NEGRO;PERSONAL CARE
18617552;;F;28;CHILENO;;Millenial;DIEGO DE ALMAGRO              ;ATACAMA;0;0;0;0;0;0;0;0;0;ALISADOR DE PELO SG-3540 MORADO MORADO;PERSONAL CARE
17039951;Soltero;F;34;CHILENO;;Millenial;PROVIDENCIA                   ;METROPOLITANA;0;0;0;0;0;0;0;0;0;SECADOR PELO SG-3012C19;PERSONAL CARE
8695171;Viudo;F;65;CHILENO;;Boomers;RENGO                         ;L.G.B.OÂ´HIGGINS;0;0;0;0;0;0;0;0;0;SECADOR DE PELO SG-3035 NEGRO;PERSONAL CARE
17100068;;F;33;CHILENO;;Millenial;PROVIDENCIA                   ;METROPOLITANA;0;0;0;0;0;0;0;0;0;DEPILADORA GAMA ESSENCIAL;PERSONAL CARE
16272462;;F;36;CHILENO;;Millenial;PROVIDENCIA                   ;METROPOLITANA;0;0;0;0;0;0;0;0;0;ALISADOR DE PELO I X-WIDE ST TITAN KERATIN GRIS;PERSONAL CARE
13934627;;F;44;CHILENO;;X;LA PINTANA                    ;METROPOLITANA;0;0;0;0;0;0;0;0;0;SECADOR DE PELO SG-3035 NEGRO;PERSONAL CARE
8908424;;F;58;CHILENO;;Boomers;RENCA                         ;METROPOLITANA;0;0;0;0;0;0;0;0;0;DEPILADORA BRE225/00;PERSONAL CARE
10719715;;F;53;CHILENO;;X;PROVIDENCIA                   ;METROPOLITANA;0;0;0;0;0;0;0;0;0;SECADOR PELO SG-3012C19;PERSONAL CARE
12466889;;F;49;CHILENO;;X;RANCAGUA                      ;L.G.B.OÂ´HIGGINS;0;0;0;0;0;0;0;0;0;CORTA PELO SG-8200;PERSONAL CARE
18196629;;F;30;CHILENO;;Millenial;N/D;N/D;0;0;0;0;0;0;0;0;0;CORTA PELO GM 562;PERSONAL CARE
7596915;;F;68;CHILENO;;Silencioso;LINARES                       ;MAULE;0;0;0;0;0;0;0;0;0;DEPILADORA SG-9040;PERSONAL CARE
9941314;;F;58;CHILENO;;Boomers;ZAPALLAR                      ;VALPARAISO;0;0;0;0;0;0;0;0;0;AFEITADORA SG-7250 NEGRO;PERSONAL CARE
10058653;;F;56;CHILENO;;Boomers;PROVIDENCIA                   ;N/D;0;0;0;0;0;0;0;0;0;CORTA PELO GM 562;PERSONAL CARE
16272950;Soltero;F;50;CHILENO;MEDICO VETERINARIO;X;RENCA                         ;METROPOLITANA;0;0;0;0;0;0;0;0;0;DEPILADORA IPL 3500 LUZ PULSADA;PERSONAL CARE
16577499;Soltero;F;33;CHILENO;;Millenial;MARIA PINTO                   ;METROPOLITANA;0;0;0;0;0;0;0;0;0;AFEITADORA SPORT SH 886 BAT;PERSONAL CARE
12646943;;F;47;CHILENO;;X;PROVIDENCIA                   ;METROPOLITANA;0;0;0;0;0;0;0;0;0;ALISADOR DE PELO SG-3540 MORADO MORADO;PERSONAL CARE
9069016;;F;60;CHILENO;;Boomers;RENGO                         ;L.G.B.OÂ´HIGGINS;0;0;0;0;0;0;0;0;0;AFEITADORA SG-7210 NEGRO;PERSONAL CARE
17568621;Soltero;M;31;CHILENO;GASTRONOMIA INTERNACIONAL;Millenial;PROVIDENCIA                   ;METROPOLITANA;0;0;0;0;0;0;0;0;0;ALISADOR DE PELO S12A(220) Shine Therapy PALTA M;PERSONAL CARE
23553987;;F;48;BOLIVIANO;;Extranjero;CALAMA                        ;ANTOFAGASTA;0;0;0;0;0;0;0;0;0;AFEITADORA SPORT SH 886 BAT;PERSONAL CARE
12718546;;F;47;CHILENO;;X;RINCONADA                     ;VALPARAISO;0;0;0;0;0;0;0;0;0;CORTA PELO SG-8200;PERSONAL CARE
15913124;;F;37;CHILENO;;Millenial;SAN ANTONIO                   ;VALPARAISO;0;0;0;0;0;0;0;0;0;ALISADOR DE PELO SG-3512D1 ROSA;PERSONAL CARE
8788442;;F;60;CHILENO;;Boomers;ALTO HOSPICIO;TARAPACA;0;0;0;0;0;0;0;0;0;DEPILADORA GAMA ESSENCIAL;PERSONAL CARE
18091729;;M;30;CHILENO;;Extranjero;QUILICURA                     ;METROPOLITANA;0;0;0;0;0;0;0;0;0;CORTA PELO SPORT GC 542 BVT;PERSONAL CARE
13753606;;M;41;CHILENO;;X;NOGALES                       ;VALPARAISO;0;0;0;0;0;0;0;0;0;CORTADOR DE PELO SIEGEN SG-8590;PERSONAL CARE
12807273;;F;46;CHILENO;;X;RENCA                         ;METROPOLITANA;0;0;0;0;0;0;0;0;0;DEPILADORA BRE255/00;PERSONAL CARE
7693636;Soltero;F;63;CHILENO;;Boomers;ARICA                         ;ARICA Y PARINACOTA;0;0;0;0;0;0;0;0;0;AFEITADORA S1223/41 ELECTRICA;PERSONAL CARE
6381057;;F;73;CHILENO;;Silencioso;RENCA                         ;METROPOLITANA;0;0;0;0;0;0;0;0;0;DEPILADORA SG-9004;PERSONAL CARE
19468199;;F;24;CHILENO;;Z;PROVIDENCIA                   ;METROPOLITANA;0;0;0;0;0;0;0;0;0;SECADOR GAMA EOLIC MINI TRAVEL;PERSONAL CARE
9730223;;F;61;CHILENO;;Boomers;RENCA                         ;METROPOLITANA;0;0;0;0;0;0;0;0;0;ALISADOR +SECADOR PELO;PERSONAL CARE
8128589;Divorciado;F;61;CHILENO;;Boomers;RENCA                         ;METROPOLITANA;0;0;0;0;0;0;0;0;0;AFEITADORA SG-7210 NEGRO;PERSONAL CARE
10134410;;F;55;CHILENO;;Boomers;LA FLORIDA                    ;METROPOLITANA;0;0;0;0;0;0;0;0;0;AFEITADORA SPORT;PERSONAL CARE
17854324;Soltero;M;30;CHILENO;;Millenial;RENCA                         ;METROPOLITANA;0;0;0;0;0;0;0;0;0;CORTA PELO GM 562;PERSONAL CARE
12614814;;F;48;CHILENO;;X;PROVIDENCIA                   ;METROPOLITANA;0;0;0;0;0;0;0;0;0;ALISADOR DE PELO SG-3540 MORADO MORADO;PERSONAL CARE
12524347;;M;49;CHILENO;;X;RENCA                         ;METROPOLITANA;0;0;0;0;0;0;0;0;0;ALISADOR GAMA BELLA SHINE;PERSONAL CARE
5394465;;F;76;CHILENO;;Silencioso;RENCA                         ;METROPOLITANA;0;0;0;0;0;0;0;0;0;AFEITADORA SG-7250 NEGRO;PERSONAL CARE
14342865;;F;45;CHILENO;;X;ISLA DE MAIPO;METROPOLITANA;0;0;0;0;0;0;0;0;0;ALISADOR DE PELO S8607 DE COCO VERDE;PERSONAL CARE
9089829;;F;59;CHILENO;;Boomers;RENCA                         ;METROPOLITANA;0;0;0;0;0;0;0;0;0;AFEITADORA S1223/41 ELECTRICA;PERSONAL CARE
13845032;;F;41;CHILENO;;X;LOS ANGELES                   ;BIO BIO;0;0;0;0;0;0;0;0;0;CORTA PELO GM 562;PERSONAL CARE
9166935;Soltero;M;60;CHILENO;;Boomers;PROVIDENCIA                   ;METROPOLITANA;0;0;0;0;0;0;0;0;0;AFEITADORA SG-7210 NEGRO;PERSONAL CARE
10294873;;M;56;CHILENO;;Boomers;RENCA                         ;METROPOLITANA;0;0;0;0;0;0;0;0;0;SECADOR DIAMOND STD;PERSONAL CARE
19066731;Soltero;F;26;CHILENO;;Z;PROVIDENCIA                   ;METROPOLITANA;0;0;0;0;0;0;0;0;0;ALISADOR ELEGANCE LED BLOOM VT;PERSONAL CARE
15801835;;M;38;CHILENO;;Millenial;MONTE PATRIA                  ;COQUIMBO;0;0;0;0;0;0;0;0;0;CORTA PELO SG-8520;PERSONAL CARE
9330416;;F;63;CHILENO;;Boomers;CHILLAN                       ;BIO BIO;0;0;0;0;0;0;0;0;0;DEPILADORA OASIS NEXT BVT;PERSONAL CARE
12399396;;M;48;CHILENO;;X;CABILDO                       ;VALPARAISO;0;0;0;0;0;0;0;0;0;AFEITADORA SG-7250 NEGRO;PERSONAL CARE
7595341;;F;66;CHILENO;;Boomers;PROVIDENCIA                   ;METROPOLITANA;0;0;0;0;0;0;0;0;0;SECADOR PELO SIEGEN SG-3042;PERSONAL CARE
19888508;;M;23;CHILENO;;Millenial;N/D;N/D;0;0;0;0;0;0;0;0;0;AFEITADORA SG-7250 NEGRO;PERSONAL CARE
19507437;;M;25;CHILENO;;Z;"";"";0;0;0;0;0;0;0;0;0;SECADOR PELO SG-3012C19;PERSONAL CARE
13425183;Soltero;M;43;CHILENO;;X;PROVIDENCIA                   ;METROPOLITANA;0;0;0;0;0;0;0;0;0;CORTA PELO GM 562;PERSONAL CARE
7447234;;M;64;CHILENO;;Boomers;PROVIDENCIA                   ;METROPOLITANA;0;0;0;0;0;0;0;0;0;ALISADOR +SECADOR PELO;PERSONAL CARE
19615977;;M;26;CHILENO;;Z;CONCON                        ;VALPARAISO;0;0;0;0;0;0;0;0;0;ALISADOR DE PELO ERGOSTYLER ION DUO ROJO;PERSONAL CARE
13427065;;F;44;CHILENO;;X;ANTOFAGASTA                   ;ANTOFAGASTA;0;0;0;0;0;0;0;0;0;SECADOR DE PELO SG-3012C17 NARANJO;PERSONAL CARE
18317656;Soltero;F;29;CHILENO;;Millenial;N/D;N/D;0;0;0;0;0;0;0;0;0;DEPILADORA GAMA ESSENCIAL;PERSONAL CARE
8898631;Casado;F;61;CHILENO;;Boomers;PROVIDENCIA                   ;METROPOLITANA;0;0;0;0;0;0;0;0;0;ALISADOR DE PELO ERGOSTYLER ION DUO ROJO;PERSONAL CARE
17625017;;F;31;CHILENO;;Millenial;PROVIDENCIA                   ;METROPOLITANA;0;0;0;0;0;0;0;0;0;Secador Potenza Keration;PERSONAL CARE
9383914;Casado;M;58;CHILENO;;Boomers;PROVIDENCIA                   ;METROPOLITANA;0;0;0;0;0;0;0;0;0;CORTA PELO GC-615;PERSONAL CARE
18520778;Soltero;F;28;CHILENO;;Millenial;PROVIDENCIA                   ;METROPOLITANA;0;0;0;0;0;0;0;0;0;ALISADOR DE PELO S12A(220) Shine Therapy PALTA M;PERSONAL CARE
10468421;Casado;F;59;CHILENO;;Boomers;RENCA                         ;METROPOLITANA;0;0;0;0;0;0;0;0;0;CORTA PELO GM 562;PERSONAL CARE
11951146;;F;50;CHILENO;;X;RENGO                         ;L.G.B.OÂ´HIGGINS;0;0;0;0;0;0;0;0;0;AFEITADORA PR1342 ROTATIVA RECARGABLE;PERSONAL CARE
12442381;;M;49;CHILENO;;X;ANTOFAGASTA                   ;ANTOFAGASTA;0;0;0;0;0;0;0;0;0;SECADOR DE PELO DIAMOND ST BLOOM VT 220;PERSONAL CARE
16784670;;F;34;CHILENO;;Millenial;CHILLAN                       ;BIO BIO;0;0;0;0;0;0;0;0;0;SECADOR DE PELO STD TITAN KERATIN PLATA;PERSONAL CARE
18078426;;F;30;CHILENO;;Millenial;MELIPILLA                     ;METROPOLITANA;0;0;0;0;0;0;0;0;0;ALISADOR DE PELO ELEGANCE TITAN KERATIN LED GRIS;PERSONAL CARE
17175258;;F;33;CHILENO;;Millenial;PROVIDENCIA                   ;METROPOLITANA;0;0;0;0;0;0;0;0;0;ALISADOR DE PELO S7740 TRIPLE INFUSION;PERSONAL CARE
7929755;;F;64;CHILENO;;Boomers;ALTO HOSPICIO;TARAPACA;0;0;0;0;0;0;0;0;0;CORTA PELO HC-5850;PERSONAL CARE
19068205;Soltero;F;27;CHILENO;;Z;PROVIDENCIA                   ;METROPOLITANA;0;0;0;0;0;0;0;0;0;ONDULADOR DE PELO TURMALINA 25MM;PERSONAL CARE
8834691;Soltero;F;63;CHILENO;;Boomers;PROVIDENCIA                   ;METROPOLITANA;0;0;0;0;0;0;0;0;0;DEPILADORA GAMA ESSENCIAL;PERSONAL CARE
16138837;;F;36;CHILENO;;Millenial;N/D;N/D;0;0;0;0;0;0;0;0;0;CORTA PELO GM 562;PERSONAL CARE
5420414;;F;74;CHILENO;;Silencioso;SAN ANTONIO                   ;VALPARAISO;0;0;0;0;0;0;0;0;0;AFEITADORA PR1342 ROTATIVA RECARGABLE;PERSONAL CARE
8371950;;M;63;CHILENO;;Boomers;MOSTAZAL                      ;L.G.B.OÂ´HIGGINS;0;0;0;0;0;0;0;0;0;AFEITADORA SG-7250 NEGRO;PERSONAL CARE
18362506;;F;29;CHILENO;;Millenial;PROVIDENCIA                   ;METROPOLITANA;0;0;0;0;0;0;0;0;0;DEPILADORA HP-6543;PERSONAL CARE
16927946;;F;33;CHILENO;;Millenial;ILLAPEL                       ;COQUIMBO;0;0;0;0;0;0;0;0;0;ALISADOR DE PELO S6300 GRIS;PERSONAL CARE
15757192;;F;38;CHILENO;;Millenial;BUIN;METROPOLITANA;0;0;0;0;0;0;0;0;0;TOMA PRESION BP-309 BAT MUNECA;PERSONAL CARE
13348149;Casado;F;43;CHILENO;;X;RENCA                         ;METROPOLITANA;0;0;0;0;0;0;0;0;0;SECADOR DE PELO SG-3012 NEGRO;PERSONAL CARE
11747811;Viudo;M;51;CHILENO;PROFESOR;X;RENCA                         ;METROPOLITANA;0;0;0;0;0;0;0;0;0;SECADOR DE PELO STD TITAN KERATIN PLATA;PERSONAL CARE
18623288;Soltero;M;26;CHILENO;;Z;PROVIDENCIA                   ;METROPOLITANA;0;0;0;0;0;0;0;0;0;SECADOR DE PELO TEMPO 5D SENSI MOON;PERSONAL CARE
20318415;;F;22;CHILENO;;Z;PROVIDENCIA                   ;METROPOLITANA;0;0;0;0;0;0;0;0;0;ONDULADOR DE PELO TURMALINA 25MM;PERSONAL CARE
5784138;;M;73;CHILENO;;Silencioso;OSORNO                        ;LOS LAGOS;0;0;0;0;0;0;0;0;0;AFEITADORA SG-7250 NEGRO;PERSONAL CARE
11392009;;F;53;CHILENO;;X;PUENTE ALTO                   ;METROPOLITANA;0;0;0;0;0;0;0;0;0;ALISADOR CP3 DIGITAL TITANIUM;PERSONAL CARE
15553656;Casado;F;39;CHILENO;;X;RENCA                         ;METROPOLITANA;0;0;0;0;0;0;0;0;0;SECADOR DE PELO D13A-220-R PLATA;PERSONAL CARE
18033255;Soltero;F;30;CHILENO;;Millenial;PROVIDENCIA                   ;METROPOLITANA;0;0;0;0;0;0;0;0;0;DEPILADORA IPL SIEGEN SG-9402;PERSONAL CARE
16945305;;F;33;CHILENO;;Millenial;PROVIDENCIA                   ;METROPOLITANA;0;0;0;0;0;0;0;0;0;SECADOR DE PELO DIVA NEGRO;PERSONAL CARE
14196963;Casado;F;41;CHILENO;;X;PROVIDENCIA                   ;METROPOLITANA;0;0;0;0;0;0;0;0;0;SECADOR DE PELO SE-3049C01 FUCSIA;PERSONAL CARE
12967730;;F;46;CHILENO;;X;QUILLOTA                      ;VALPARAISO;0;0;0;0;0;0;0;0;0;SECADOR DE PELO STD TITAN KERATIN PLATA;PERSONAL CARE
8453428;;M;70;CHILENO;;Silencioso;VALLENAR;ATACAMA;1423600;10;9;0;0;0;10;9;1423600;Horno Microondas Digital TH-25DM 25Lts;ELECTRODOMESTICOS
15993816;Casado;M;37;CHILENO;CONTADOR AUDITOR;Millenial;RENCA                         ;METROPOLITANA;119990;1;1;0;0;0;1;1;119990;Maquina de Coser JS-2135CL Calipso;ELECTRODOMESTICOS
11430679;Divorciado;F;53;CHILENO;;X;RENCA                         ;METROPOLITANA;14990;1;1;0;0;0;1;1;14990;TOSTADOR OLDEMBURGO 2 REBANADAS;ELECTRODOMESTICOS
17533310;;M;32;CHILENO;;Millenial;"";"";371950;5;3;5;3;371950;0;0;0;Hervidor Inox One Midea;ELECTRODOMESTICOS
7491235;;F;69;CHILENO;;Silencioso;CANETE                        ;BIO BIO;252970;3;4;0;0;0;3;4;252970;Picadora TH-9020V Vaso Vidrio 2Lts;ELECTRODOMESTICOS
6600289;;F;73;CHILENO;;Silencioso;LA CISTERNA                   ;METROPOLITANA;246040;4;2;0;0;0;4;2;246040;Horno Microondas Digital TH20DM 20Lts Espejado;ELECTRODOMESTICOS
15350214;Soltero;F;39;CHILENO;CONTADOR AUDITOR;X;PROVIDENCIA                   ;METROPOLITANA;14990;1;1;0;0;0;1;1;14990;Hervidor Electrico TH-4212N 1,7Lts Negro;ELECTRODOMESTICOS
9519487;;F;59;CHILENO;;Boomers;OSORNO                        ;LOS LAGOS;251220;4;3;0;0;0;4;3;251220;Plancha UT-KERAMIKTOP 2200Watts Base Ceramica;ELECTRODOMESTICOS
6364848;;F;70;CHILENO;;Silencioso;N/D;N/D;248970;3;2;0;0;0;3;2;248970;MULTIMIXER THOMAS TH- 8706;ELECTRODOMESTICOS
13868414;;F;42;CHILENO;;X;TOCOPILLA                     ;ANTOFAGASTA;55980;2;1;0;0;0;2;1;55980;Tostador de PanTH-120R 2 Rebanadas Rojo;ELECTRODOMESTICOS
19966152;;F;23;CHILENO;;Z;CONSTITUCION                  ;MAULE;306950;5;4;0;0;0;5;4;306950;Horno Electrico UT-BACKOFEN48 48Lts;ELECTRODOMESTICOS
8093607;;F;65;CHILENO;;Boomers;COIHAIQUE                     ;AYSEN;244970;3;3;0;0;0;3;3;244970;Horno Electrico TH62I 60Lts;ELECTRODOMESTICOS
6131824;Casado;M;71;CHILENO;;Silencioso;RENCA                         ;METROPOLITANA;13990;1;1;0;0;0;1;1;13990;Plancha Easy Steam (PV4500);ELECTRODOMESTICOS
8016518;;F;62;CHILENO;;Boomers;SAN JAVIER                    ;MAULE;21990;1;1;0;0;0;1;1;21990;Hervidor Electrico TH-4515N 2Lts Negro;ELECTRODOMESTICOS
9511039;;F;59;CHILENO;;Boomers;N/D;N/D;10990;1;1;1;1;10990;0;0;0;Hervidor Inox One Midea;ELECTRODOMESTICOS
11486769;;F;53;CHILENO;;Millenial;PROVIDENCIA                   ;METROPOLITANA;132980;2;1;0;0;0;2;1;132980;HORNO ELECTRICO HE-600IN INOX SINDELEN;ELECTRODOMESTICOS
9069792;;F;61;CHILENO;;Boomers;N/D;N/D;70680;4;2;0;0;0;4;2;70680;Plancha TH-7052 2000Watts Base Inox;ELECTRODOMESTICOS
9419697;;M;58;CHILENO;;Boomers;VILLARICA                     ;ARAUCANIA;1318900;10;9;2;1;119980;8;8;1198920;Licuadora L-25000NG;ELECTRODOMESTICOS
10986973;;M;53;CHILENO;;X;SAN BERNARDO                  ;METROPOLITANA;13990;1;4;0;0;0;1;4;13990;HERVIDOR TH-4340;ELECTRODOMESTICOS
23183779;;M;57;CHILENO;;Boomers;IQUIQUE                       ;TARAPACA;1004950;5;4;3;2;665970;2;2;338980;Plancha a Vapor 5001;ELECTRODOMESTICOS
10679446;;F;52;CHILENO;;X;N/D;N/D;143970;3;2;2;1;123980;1;1;19990;HORNO ELECTRICO HE-600IN INOX SINDELEN;ELECTRODOMESTICOS
12205039;Soltero;M;49;CHILENO;;X;RENCA                         ;METROPOLITANA;1534920;7;3;7;3;1534920;0;0;0;HORNO ELECTRICO THOMAS TH-38i;ELECTRODOMESTICOS
16598021;;F;35;CHILENO;;Millenial;PROVIDENCIA                   ;METROPOLITANA;14990;1;1;0;0;0;1;1;14990;Exprimidor Fauna 500 cc;ELECTRODOMESTICOS
23738807;;M;32;PERUANO;;Extranjero;QUINTA NORMAL                 ;METROPOLITANA;226030;8;4;0;0;0;8;4;226030;Hervidor Electrico TH-4515N 2Lts Negro;ELECTRODOMESTICOS
20206307;;M;22;CHILENO;;Z;EL BOSQUE;METROPOLITANA;881940;6;3;6;3;881940;0;0;0;Freidora de Aire 18M Oster;ELECTRODOMESTICOS
14312079;;F;46;CHILENO;;X;MELIPILLA                     ;METROPOLITANA;16990;1;1;0;0;0;1;1;16990;HERVIDOR TH-4340;ELECTRODOMESTICOS
7187548;Casado;M;65;CHILENO;;Boomers;PROVIDENCIA                   ;METROPOLITANA;64990;1;1;0;0;0;1;1;64990;ASPIRADORA THOMAS TH-1640;ELECTRODOMESTICOS
10688426;;F;44;CHILENO;;X;LEBU                          ;BIO BIO;241771;3;3;0;0;0;3;3;241771;HERVIDOR ELECTRICO UT-STARK18;ELECTRODOMESTICOS
7605067;;F;65;CHILENO;;Boomers;CORONEL                       ;BIO BIO;122980;2;2;0;0;0;2;2;122980;Horno Microondas Mecanico UT-SYDNEY18 18Lts;ELECTRODOMESTICOS
14725467;;F;53;PERUANO;;Extranjero;ARICA                         ;ARICA Y PARINACOTA;1436130;11;8;0;0;0;11;8;1436130;Cafetera TH-130;ELECTRODOMESTICOS
5513959;;F;77;CHILENO;;Silencioso;PROVIDENCIA                   ;N/D;22990;3;1;0;0;0;3;1;22990;Licuadora Berry Blender Roja 1400 Vaso Vidrio;ELECTRODOMESTICOS
9972852;;F;54;CHILENO;;Boomers;SAN RAMON                     ;METROPOLITANA;15990;1;1;0;0;0;1;1;15990;Hervidor Electrico UT-MANLY17 1,7Lts Negro;ELECTRODOMESTICOS
16868530;;M;34;CHILENO;;Millenial;LA SERENA                     ;COQUIMBO;283742;28;5;0;0;0;28;5;283742;Parrilla Electrica TH-180;ELECTRODOMESTICOS
7064401;;F;70;CHILENO;;Silencioso;PROVIDENCIA                   ;METROPOLITANA;18240;2;1;0;0;0;2;1;18240;Tostador de Pan TH-116 2 Rebanadas Negro;ELECTRODOMESTICOS
8743305;;F;62;CHILENO;;Boomers;CONSTITUCION                  ;MAULE;184220;4;2;0;0;0;4;2;184220;Licuadora TH-401V Roja 1,75Lts Vaso Vidrio;ELECTRODOMESTICOS
25795278;;M;28;BOLIVIANO;;Extranjero;N/D;N/D;299930;8;3;0;0;0;8;3;299930;HERVIDOR BERLIN 1,7 LITROS;ELECTRODOMESTICOS
10109759;;F;59;CHILENO;;Boomers;PROVIDENCIA                   ;METROPOLITANA;27990;1;1;0;0;0;1;1;27990;Licuadora L-1630V Negra 1,5Lts Vaso Vidrio;ELECTRODOMESTICOS
19238267;;F;26;CHILENO;;Z;"";"";12240;2;1;0;0;0;2;1;12240;Hervidor Inox One Midea;ELECTRODOMESTICOS
8654575;;F;63;CHILENO;;Boomers;RENCA                         ;METROPOLITANA;1490780;6;3;0;0;0;6;3;1490780;Licuadora L-5500IN 1,5Lts;ELECTRODOMESTICOS
26056281;;M;38;PERUANO;;Extranjero;RECOLETA                      ;METROPOLITANA;296410;3;2;0;0;0;3;2;296410;Horno Microondas Digital MS23K3513AK/ZS 23Lts;ELECTRODOMESTICOS
16766185;;M;34;CHILENO;;Millenial;N/D;N/D;724090;7;4;0;0;0;7;4;724090;Aspiradora UT-SILENT1603 Arrastre 1600Watts;ELECTRODOMESTICOS
12166321;;M;44;CHILENO;;X;CASTRO                        ;LOS LAGOS;194374;3;2;0;0;0;3;2;194374;Maquina de coser Singer 024;ELECTRODOMESTICOS
15220285;;M;40;CHILENO;;X;SAN PEDRO DE LA PAZ           ;BIO BIO;799200;9;5;6;4;725940;3;1;73260;Batidora de Mano y Pedestal 3612;ELECTRODOMESTICOS
13131845;;F;45;CHILENO;;X;COIHUECO                      ;BIO BIO;335980;2;2;0;0;0;2;2;335980;Plancha UT-KERAMIKTOP 2200Watts Base Ceramica;ELECTRODOMESTICOS
12206933;;F;50;CHILENO;;X;CHANCO                        ;MAULE;93253;5;4;0;0;0;5;4;93253;TOSTADOR OLDEMBURGO 2 REBANADAS;ELECTRODOMESTICOS
6350259;;F;65;CHILENO;;Boomers;PROVIDENCIA                   ;METROPOLITANA;480931;9;5;0;0;0;9;5;480931;FREIDORA DE AIRE THOMAS TH-AF60Mi;ELECTRODOMESTICOS
22915263;;M;52;ECUATORIANO;;Extranjero;VALLENAR;ATACAMA;2180860;13;6;0;0;0;13;6;2180860;Aspiradora AP1700 Arrastre 1700Watts;ELECTRODOMESTICOS
9814026;;F;59;CHILENO;;Boomers;CONSTITUCION                  ;MAULE;307153;5;5;0;0;0;5;5;307153;Hervidor Electrico TH-4212N 1,7Lts Negro;ELECTRODOMESTICOS
19717189;;F;24;CHILENO;;Z;PUREN;ARAUCANIA;169960;4;3;4;3;169960;0;0;0;BATIDORA PEDESTAL RENANIA 5 LITROS;ELECTRODOMESTICOS
6202363;;F;73;CHILENO;;Silencioso;ARICA                         ;TARAPACA;428450;5;2;0;0;0;5;2;428450;Batidora Pedestal Bowl 300 Inox;ELECTRODOMESTICOS
11783307;;F;50;CHILENO;;X;N/D;N/D;1195010;9;4;0;0;0;9;4;1195010;Maquina de Coser 311;ELECTRODOMESTICOS
12895009;;F;53;CHILENO;;X;SAN BERNARDO                  ;METROPOLITANA;589110;7;5;1;1;149990;6;4;439120;Hervidor Electrico TH-4212N 1,7Lts Negro;ELECTRODOMESTICOS
26616609;Soltero;M;42;EXTRANJERO - NO INFORMA NACIONALIDAD;;X;"";"";125410;3;2;0;0;0;3;2;125410;Batidora Pedestal TH910PN 4,6Lts 1300Watts;ELECTRODOMESTICOS
10978375;;F;52;CHILENO;;X;N/D;N/D;71981;2;2;0;0;0;2;2;71981;Hervidor Electrico UT-KLAR20PW 2Lts Blanco;ELECTRODOMESTICOS
13923242;;F;45;CHILENO;;X;SAN BERNARDO                  ;METROPOLITANA;26990;1;1;0;0;0;1;1;26990;Hervidor Electrico UT-REIN17SS;ELECTRODOMESTICOS
20902272;;M;21;CHILENO;;Z;"";"";79990;1;1;0;0;0;1;1;79990;Aspiradora TH1870 Arrastre 1800Watts Gris;ELECTRODOMESTICOS
7422871;Casado;F;60;CHILENO;PROFESOR;Boomers;LAS CONDES                    ;METROPOLITANA;74240;3;2;1;1;59990;2;1;14250;Horno Microondas Mecanico UT-SYDNEY18 18Lts;ELECTRODOMESTICOS
7832042;;M;65;CHILENO;;Boomers;LOS ANDES                     ;VALPARAISO;59990;1;1;0;0;0;1;1;59990;Aspiradora UT-SILENT1603 Arrastre 1600Watts;ELECTRODOMESTICOS
15093167;;F;38;CHILENO;;X;ANTOFAGASTA                   ;ANTOFAGASTA;933170;16;13;0;0;0;16;13;933170;Horno Electrico TH-48N 48Lts;ELECTRODOMESTICOS
5956168;;F;77;CHILENO;;Silencioso;N/D;N/D;106060;2;1;0;0;0;2;1;106060;Horno Electrico TH62I 60Lts;ELECTRODOMESTICOS
13752466;;F;41;CHILENO;;X;SAN FELIPE                    ;VALPARAISO;199980;2;2;2;2;199980;0;0;0;Aspiradora AP1700 Arrastre 1700Watts;ELECTRODOMESTICOS
16543974;;F;35;CHILENO;;Millenial;QUILLOTA                      ;VALPARAISO;738900;11;7;0;0;0;11;7;738900;Horno Microondas Mecanico Easy Wave 20Lts;ELECTRODOMESTICOS
18927163;Soltero;F;27;CHILENO;;Millenial;PROVIDENCIA                   ;METROPOLITANA;31970;3;2;0;0;0;3;2;31970;Hervidor Inox One Midea;ELECTRODOMESTICOS
10796594;;M;54;CHILENO;;Boomers;RENCA                         ;METROPOLITANA;69980;2;1;0;0;0;2;1;69980;HORNO ELECTRICO DORTMUND 45 LITROS;ELECTRODOMESTICOS
9559199;;M;60;CHILENO;;Boomers;SAN FERNANDO                  ;L.G.B.OÂ´HIGGINS;203970;3;3;0;0;0;3;3;203970;Combo Hervidor + Batidora;ELECTRODOMESTICOS
8601103;;M;63;CHILENO;;Boomers;TOME                          ;BIO BIO;91060;2;1;0;0;0;2;1;91060;Horno Electrico TH-48N 48Lts;ELECTRODOMESTICOS
12959569;;F;46;CHILENO;;X;PUENTE ALTO                   ;METROPOLITANA;58959;1;1;0;0;0;1;1;58959;Aspiradora UT-SILENT1804 Arrastre 1800Watts;ELECTRODOMESTICOS
13553958;;F;43;CHILENO;;X;CALERA DE TANGO               ;METROPOLITANA;89980;2;1;0;0;0;2;1;89980;Licuadora TH-501V 1,5Lts Vaso Vidrio;ELECTRODOMESTICOS
9288475;Casado;M;58;CHILENO;;Boomers;PROVIDENCIA                   ;METROPOLITANA;21990;1;1;0;0;0;1;1;21990;Hervidor Electrico TH-4515N 2Lts Negro;ELECTRODOMESTICOS
10057571;;F;58;CHILENO;;Boomers;ARICA                         ;ARICA Y PARINACOTA;68040;4;2;0;0;0;4;2;68040;Licuadora L-25000NG;ELECTRODOMESTICOS
6833630;;F;71;CHILENO;;Silencioso;LINARES                       ;MAULE;186390;5;2;0;0;0;5;2;186390;Horno Electrico TH-48N 48Lts;ELECTRODOMESTICOS
18248638;;M;29;CHILENO;;Millenial;CANETE                        ;BIO BIO;182390;4;2;0;0;0;4;2;182390;Horno Microonda Columba 1700;ELECTRODOMESTICOS
14204722;;M;41;CHILENO;;X;SAN VICENTE                   ;L.G.B.OÂ´HIGGINS;22284;2;2;0;0;0;2;2;22284;Hervidor Family Kettle HE500;ELECTRODOMESTICOS
10630922;;F;55;CHILENO;;Boomers;ARICA                         ;TARAPACA;16990;1;1;0;0;0;1;1;16990;Plancha Perfect Steam (PV7200) 2200 watts;ELECTRODOMESTICOS
25121486;;M;40;PERUANO;;Extranjero;N/D;N/D;262731;2;2;0;0;0;2;2;262731;Hervidor Electrico TH-4212N 1,7Lts Negro;ELECTRODOMESTICOS
6214370;;F;71;CHILENO;;Silencioso;RENGO                         ;L.G.B.OÂ´HIGGINS;13990;1;1;0;0;0;1;1;13990;Batidora Vertical Stick Mixer 2609;ELECTRODOMESTICOS
17939399;;F;30;CHILENO;;Extranjero;"";"";204930;7;5;2;1;39980;5;4;164950;BATIDORA PEDESTAL RENANIA 5 LITROS;ELECTRODOMESTICOS
16199092;Soltero;M;36;CHILENO;;Millenial;RENCA                         ;METROPOLITANA;24990;1;1;0;0;0;1;1;24990;Hervidor Electrico TH-5407i 2Lts;ELECTRODOMESTICOS
15848087;;M;37;CHILENO;;Millenial;N/D;N/D;163960;4;3;0;0;0;4;3;163960;Procesador TH-9010 Multimixer 1,5Lts Vaso Vidrio;ELECTRODOMESTICOS
7737554;Casado;F;67;CHILENO;;Boomers;RENCA                         ;METROPOLITANA;13990;1;1;0;0;0;1;1;13990;Plancha a Vapor 5001;ELECTRODOMESTICOS
11148710;;F;54;CHILENO;;Boomers;ESTACION CENTRAL              ;METROPOLITANA;1337910;18;13;1;1;119990;17;12;1217920;FREIDORA DE AIRE THOMAS TH-AF60Mi;ELECTRODOMESTICOS
10947246;;F;50;CHILENO;;X;LA PINTANA                    ;METROPOLITANA;19990;1;1;0;0;0;1;1;19990;Hervidor Electrico UT-DUNKEL17P 2Lts Negro;ELECTRODOMESTICOS
10200477;;M;58;CHILENO;;Boomers;HIJUELAS                      ;VALPARAISO;94980;2;2;0;0;0;2;2;94980;HORNO ELECTRICO BREMEN 23 LITROS;ELECTRODOMESTICOS
12544715;;M;50;CHILENO;;X;PARRAL                        ;MAULE;364980;2;2;0;0;0;2;2;364980;Aspiradora VCC4190V3E/XZS Arrastre 2000Watts;ELECTRODOMESTICOS
6008718;;F;70;CHILENO;;Silencioso;PUENTE ALTO                   ;METROPOLITANA;814950;5;4;0;0;0;5;4;814950;HERVIDOR TH-4340;ELECTRODOMESTICOS
10356201;;F;55;CHILENO;;Boomers;BUIN                          ;METROPOLITANA;221630;4;2;0;0;0;4;2;221630;Combo Hervidor + Batidora;ELECTRODOMESTICOS
16041818;;F;37;CHILENO;;Millenial;LA CISTERNA                   ;METROPOLITANA;93483;7;5;0;0;0;7;5;93483;Hervidor Electrico TH-4515N 2Lts Negro;ELECTRODOMESTICOS
4721689;;F;76;CHILENO;;Silencioso;RENCA                         ;METROPOLITANA;74990;1;1;0;0;0;1;1;74990;Horno Microondas Digital TH-20S01 20Lts;ELECTRODOMESTICOS
7845973;;F;61;CHILENO;;Boomers;PROVIDENCIA                   ;METROPOLITANA;43980;2;1;2;1;43980;0;0;0;Horno Microonda Columba 1700;ELECTRODOMESTICOS
7956525;Soltero;F;66;CHILENO;;Boomers;PROVIDENCIA                   ;METROPOLITANA;109990;1;1;0;0;0;1;1;109990;Maquina de coser Singer 1605;ELECTRODOMESTICOS
13614372;;F;43;CHILENO;;X;N/D;N/D;288900;10;4;7;3;164930;3;1;123970;Donuts Maker;ELECTRODOMESTICOS
20788571;;M;21;CHILENO;;Z;VALDIVIA;LOS LAGOS;29980;2;1;2;1;29980;0;0;0;Waffle Corazon;ELECTRODOMESTICOS
26032376;;F;42;PERUANO;;Extranjero;SANTIAGO                      ;METROPOLITANA;640920;8;5;5;2;98950;3;3;541970;Hervidor Electrico TH-4515N 2Lts Negro;ELECTRODOMESTICOS
12774737;;F;47;CHILENO;;X;N/D;N/D;79990;1;1;0;0;0;1;1;79990;Batidora Pedestal TH910PN 4,6Lts 1300Watts;ELECTRODOMESTICOS
12413590;;M;49;CHILENO;;X;RANCAGUA                      ;L.G.B.OÂ´HIGGINS;1331760;13;8;0;0;0;13;8;1331760;Horno Microondas Digital UT-CLASSY720 20Lts;ELECTRODOMESTICOS
17894115;Soltero;M;31;CHILENO;TECNICO DE NIVEL SUPERIOR EN ENFERMERIA;Millenial;PROVIDENCIA                   ;METROPOLITANA;69990;1;1;0;0;0;1;1;69990;HORNO ELECTRICO DORTMUND 45 LITROS;ELECTRODOMESTICOS
5829662;;F;73;CHILENO;;Silencioso;PUENTE ALTO                   ;METROPOLITANA;28990;1;1;0;0;0;1;1;28990;Tostador de Pan TP-1400 4 Rebanadas Inox;ELECTRODOMESTICOS
17147212;;M;33;CHILENO;;Millenial;SAN JAVIER                    ;MAULE;751870;13;5;6;3;693940;7;2;57930;Maquina de coser Singer 024;ELECTRODOMESTICOS
11832673;;M;50;CHILENO;;X;VALPARAISO                    ;VALPARAISO;1653780;22;12;20;10;1406800;2;2;246980;Horno Microondas Mecanico C1700N 17Lts Blanco;ELECTRODOMESTICOS
20250319;;M;22;CHILENO;;Z;N/D;N/D;24980;2;1;2;1;24980;0;0;0;HERVIDOR BERLIN 1,7 LITROS;ELECTRODOMESTICOS
5993051;Casado;M;71;CHILENO;;Silencioso;TALCAHUANO                    ;BIO BIO;677500;7;3;0;0;0;7;3;677500;Horno Electrico UT-BACKOFEN26 26Lts;ELECTRODOMESTICOS
7908775;;F;63;CHILENO;;Boomers;COLTAUCO                      ;L.G.B.OÂ´HIGGINS;14990;1;1;0;0;0;1;1;14990;Hervidor Electrico 3101 1,7Lts Negro;ELECTRODOMESTICOS
6814864;;F;74;CHILENO;;Silencioso;NOGALES                       ;VALPARAISO;658290;16;6;0;0;0;16;6;658290;FREIDORA DE AIRE BAVIERA 3,8 LITROS;ELECTRODOMESTICOS
10285336;;F;55;CHILENO;;Boomers;CHEPICA                       ;L.G.B.OÂ´HIGGINS;348940;6;3;0;0;0;6;3;348940;Sandwichera TH-952 2 Panes Blanca;ELECTRODOMESTICOS
19480724;;F;25;CHILENO;;Z;N/D;N/D;1245900;10;8;0;0;0;10;8;1245900;Horno Electrico TH62I 60Lts;ELECTRODOMESTICOS
8205150;;M;64;CHILENO;;Boomers;PROVIDENCIA                   ;METROPOLITANA;54980;2;1;0;0;0;2;1;54980;Freidora de Aire 18M Oster;ELECTRODOMESTICOS
15302672;;F;39;CHILENO;;X;CHONCHI                       ;LOS LAGOS;105900;2;1;0;0;0;2;1;105900;Olla Multiuso 6801 5,7Lts;ELECTRODOMESTICOS
18741781;Soltero;M;28;CHILENO;;Millenial;PROVIDENCIA                   ;METROPOLITANA;164970;3;2;0;0;0;3;2;164970;HORNO ELECTRICO DORTMUND 45 LITROS;ELECTRODOMESTICOS
12776336;;F;47;CHILENO;;X;RENCA                         ;METROPOLITANA;73990;3;2;0;0;0;3;2;73990;Olla Arrocera OA-400NG 1,8Lts;ELECTRODOMESTICOS
10533387;;F;57;CHILENO;;Boomers;PAINE                         ;METROPOLITANA;57710;3;2;0;0;0;3;2;57710;Plancha UT-PLATTEISEN 2000Watts Base Ceramica;ELECTRODOMESTICOS
20313284;;M;22;CHILENO;;Z;"";"";56990;3;2;0;0;0;3;2;56990;Batidora Pedestal Bowl 300 Inox;ELECTRODOMESTICOS
11322215;;F;53;CHILENO;;X;LONCOCHE                      ;ARAUCANIA;213500;2;1;0;0;0;2;1;213500;Maquina de coser Singer 024;ELECTRODOMESTICOS
10319238;;M;55;CHILENO;;Boomers;N/D;N/D;53980;2;1;2;1;53980;0;0;0;Olla Multiuso TH-40PC 0,5Lts;ELECTRODOMESTICOS
11375989;;F;53;CHILENO;;X;N/D;N/D;1149260;15;7;0;0;0;15;7;1149260;Hervidor Electrico TH-4515N 2Lts Negro;ELECTRODOMESTICOS
16539578;Casado;F;35;CHILENO;INTERPRETE DE IDIOMAS;Millenial;PROVIDENCIA                   ;METROPOLITANA;296930;7;6;0;0;0;7;6;296930;Horno Electrico UT-LEIF36 36Lts;ELECTRODOMESTICOS
14635304;Soltero;F;59;ECUATORIANO;;Extranjero;CERRO NAVIA                   ;METROPOLITANA;51980;2;2;0;0;0;2;2;51980;Batidora Manual UT-TEKLA300;ELECTRODOMESTICOS
13527006;;F;44;CHILENO;;X;NATALES                       ;MAGALLANES;69990;1;1;0;0;0;1;1;69990;Aspiradora VCC4190V3E/XZS Arrastre 2000Watts;ELECTRODOMESTICOS
11390812;;M;53;CHILENO;;X;VALPARAISO                    ;VALPARAISO;105892;3;1;0;0;0;3;1;105892;Horno Electrico UT-BACKOFEN26 26Lts;ELECTRODOMESTICOS
17758675;;F;31;CHILENO;;Millenial;RENCA                         ;METROPOLITANA;41980;2;2;0;0;0;2;2;41980;Hervidor Electrico UT-MANLY17 1,7Lts Negro;ELECTRODOMESTICOS
18093195;;F;29;CHILENO;;Millenial;CONCHALI;METROPOLITANA;50980;2;1;2;1;50980;0;0;0;Horno Microondas Mecanico Fancy 20Lts;ELECTRODOMESTICOS
18138976;;F;29;CHILENO;;Millenial;TIERRA AMARILLA               ;ATACAMA;236970;5;2;0;0;0;5;2;236970;BATIDORA PEDESTAL RENANIA 5 LITROS;ELECTRODOMESTICOS
18480029;;F;29;CHILENO;;Millenial;TALAGANTE;METROPOLITANA;481960;4;2;4;2;481960;0;0;0;Horno Electrico UT-BACKOFEN26 26Lts;ELECTRODOMESTICOS
16158484;;F;37;CHILENO;;Millenial;N/D;N/D;25990;1;1;0;0;0;1;1;25990;Licuadora Berry Blender Roja 1400 Vaso Vidrio;ELECTRODOMESTICOS
12934577;;F;46;CHILENO;;Millenial;QUINCHAO;LOS LAGOS;197940;6;1;0;0;0;6;1;197940;Aspiradora TH1870 Arrastre 1800Watts Gris;ELECTRODOMESTICOS
7026864;Casado;F;68;CHILENO;;Silencioso;PROVIDENCIA                   ;METROPOLITANA;79990;1;1;0;0;0;1;1;79990;Enceradora EA-5000;ELECTRODOMESTICOS
22756923;;F;49;PERUANO;;Extranjero;MEJILLONES                    ;ANTOFAGASTA;1509631;12;7;0;0;0;12;7;1509631;Aspiradora UT-SILENT1603 Arrastre 1600Watts;ELECTRODOMESTICOS
15279891;;F;39;CHILENO;;X;N/D;N/D;169970;3;2;0;0;0;3;2;169970;FREIDORA DE AIRE THOMAS TH-AF60Mi;ELECTRODOMESTICOS
12005052;;F;46;CHILENO;;X;TOME                          ;BIO BIO;271451;5;4;2;1;203980;3;3;67471;Batidora Vertical Minipimer UT-KLOT400P;ELECTRODOMESTICOS
12220567;Casado;F;49;CHILENO;;X;PROVIDENCIA                   ;METROPOLITANA;751510;7;5;0;0;0;7;5;751510;Hervidor Family Kettle HE500;ELECTRODOMESTICOS
9924606;;F;54;CHILENO;;Boomers;SAN CARLOS                    ;BIO BIO;573043;6;5;0;0;0;6;5;573043;Combo Licuadora + Batidora;ELECTRODOMESTICOS
9961362;;M;57;CHILENO;;Boomers;SAN RAMON                     ;METROPOLITANA;165960;5;3;0;0;0;5;3;165960;Cafetera UT-KAFFEEKLASSIK;ELECTRODOMESTICOS
9371558;;F;61;CHILENO;;Boomers;SAN FERNANDO                  ;L.G.B.OÂ´HIGGINS;86883;2;3;0;0;0;2;3;86883;Sandwichera TH-952 2 Panes Blanca;ELECTRODOMESTICOS
20355149;;F;22;CHILENO;;Z;N/D;N/D;341970;3;3;0;0;0;3;3;341970;Exprimidor de Jugo 407W 1Lts;ELECTRODOMESTICOS
11725868;;F;51;CHILENO;;X;RENCA                         ;METROPOLITANA;69980;2;1;0;0;0;2;1;69980;HORNO ELECTRICO BREMEN 23 LITROS;ELECTRODOMESTICOS
11607081;;F;52;CHILENO;;X;LA CISTERNA                   ;METROPOLITANA;12990;1;1;0;0;0;1;1;12990;HERVIDOR COLONIA 1,7 LITROS;ELECTRODOMESTICOS
10843720;;F;54;CHILENO;;Boomers;N/D;N/D;902824;10;6;0;0;0;10;6;902824;Hervidor Electrico UT-MANLY17 1,7Lts Negro;ELECTRODOMESTICOS
26361758;;M;27;HAITIANO;;Extranjero;PROVIDENCIA                   ;METROPOLITANA;44980;2;2;1;1;29990;1;1;14990;Licuadora Roja 550W 1,5Lts Vaso Vidrio;ELECTRODOMESTICOS
19751423;;F;25;CHILENO;;Z;"";"";451050;14;8;0;0;0;14;8;451050;Licuadora L-1630V Negra 1,5Lts Vaso Vidrio;ELECTRODOMESTICOS
6209081;Divorciado;M;70;CHILENO;;Silencioso;PROVIDENCIA                   ;METROPOLITANA;32970;3;3;0;0;0;3;3;32970;HERVIDOR BERLIN 1,7 LITROS;ELECTRODOMESTICOS
17065175;;M;33;CHILENO;;Millenial;N/D;N/D;114970;3;3;0;0;0;3;3;114970;HERVIDOR COLONIA 1,7 LITROS;ELECTRODOMESTICOS
6849807;;F;68;CHILENO;;Boomers;SAN RAMON                     ;METROPOLITANA;245920;9;4;0;0;0;9;4;245920;Horno Electrico TH-25N01 25Lts;ELECTRODOMESTICOS
18961185;;F;27;CHILENO;;Z;N/D;N/D;557920;8;5;7;4;517930;1;1;39990;Batidora de Mano y Pedestal 3612;ELECTRODOMESTICOS
12891986;;M;46;CHILENO;;X;N/D;N/D;633600;11;6;0;0;0;11;6;633600;Picadora UT-PETRUS320 1Lts Vaso Vidrio;ELECTRODOMESTICOS
18473310;;F;28;CHILENO;;Extranjero;PROVIDENCIA                   ;N/D;50980;2;1;2;1;50980;0;0;0;Horno Electrico TH-25N01 25Lts;ELECTRODOMESTICOS
7797942;;M;65;CHILENO;;Boomers;SAN PEDRO DE LA PAZ           ;BIO BIO;94990;1;1;0;0;0;1;1;94990;Batidora Pedestal TH910PN 4,6Lts 1300Watts;ELECTRODOMESTICOS
9174808;;F;58;CHILENO;;Boomers;ANTOFAGASTA                   ;ANTOFAGASTA;534930;7;4;0;0;0;7;4;534930;Exprimidor de Jugo 407W 1Lts;ELECTRODOMESTICOS
17986929;;F;31;CHILENO;;Millenial;MELIPILLA                     ;METROPOLITANA;107960;4;3;0;0;0;4;3;107960;Hervidor Electrico TH-4212N 1,7Lts Negro;ELECTRODOMESTICOS
17652797;;F;31;CHILENO;;Millenial;N/D;N/D;58980;2;4;0;0;0;2;4;58980;PLANCHA A VAPOR 6953 BASE AEROCERAMICA AUTAPA.22;ELECTRODOMESTICOS
16503863;;M;35;CHILENO;;Silencioso;PROVIDENCIA                   ;METROPOLITANA;79990;1;1;0;0;0;1;1;79990;Horno Microondas Digital TH-20S01 20Lts;ELECTRODOMESTICOS
10414395;;M;54;CHILENO;;X;REQUINOA                      ;L.G.B.OÂ´HIGGINS;0;0;2;0;0;0;0;2;0;Horno Electrico UT-BACKOFEN60 60Lts;ELECTRODOMESTICOS
8515704;;F;58;CHILENO;;Boomers;PUENTE ALTO                   ;METROPOLITANA;76210;2;1;0;0;0;2;1;76210;Horno Microondas Mecanico UT-SYDNEY18 18Lts;ELECTRODOMESTICOS
12146237;Casado;M;52;CHILENO;INGENIERO AGRICOLA;X;RENCA                         ;METROPOLITANA;27990;1;1;0;0;0;1;1;27990;PLANCHA VAPOR TH-7146;ELECTRODOMESTICOS
15493407;;F;40;CHILENO;;X;QUEILEN                       ;LOS LAGOS;15990;1;1;0;0;0;1;1;15990;Exprimidor Fauna 500 cc;ELECTRODOMESTICOS
8989603;;F;59;CHILENO;;Boomers;ANGOL                         ;ARAUCANIA;49980;2;2;0;0;0;2;2;49980;Hervidor Inox One Midea;ELECTRODOMESTICOS
11767948;;M;51;CHILENO;;X;ARICA                         ;ARICA Y PARINACOTA;105980;2;2;0;0;0;2;2;105980;Hervidor Electrico TH-4515N 2Lts Negro;ELECTRODOMESTICOS
8429672;;F;65;CHILENO;;Boomers;VICTORIA                      ;ARAUCANIA;14990;1;1;0;0;0;1;1;14990;HERVIDOR COLONIA 1,7 LITROS;ELECTRODOMESTICOS
18287074;;F;29;CHILENO;;Millenial;N/D;N/D;561831;7;7;0;0;0;7;7;561831;HERVIDOR ELECTRICO UT-STARK18;ELECTRODOMESTICOS
7880748;;M;62;CHILENO;;Boomers;SAN JAVIER                    ;MAULE;402950;5;4;0;0;0;5;4;402950;Licuadora L2000VNG 1,5Lts Vaso Vidrio;ELECTRODOMESTICOS
10229589;;F;56;CHILENO;;Boomers;RANCAGUA                      ;L.G.B.OÂ´HIGGINS;638959;4;2;0;0;0;4;2;638959;Horno Microondas Mecanico Easy Wave 20Lts;ELECTRODOMESTICOS
7453208;;M;67;CHILENO;;Boomers;PAPUDO                        ;VALPARAISO;12990;1;1;0;0;0;1;1;12990;Hervidor Electrico TH-4212N 1,7Lts Negro;ELECTRODOMESTICOS
13129359;;F;46;CHILENO;;X;MACUL                         ;METROPOLITANA;99980;2;1;0;0;0;2;1;99980;Horno Microondas Mecanico Easy Wave 20Lts;ELECTRODOMESTICOS
7297424;;F;68;CHILENO;;Boomers;ANCUD                         ;LOS LAGOS;478980;4;2;0;0;0;4;2;478980;Horno Microondas Digital MS23K3513AK/ZS 23Lts;ELECTRODOMESTICOS
14109238;;F;41;CHILENO;;X;PROVIDENCIA                   ;METROPOLITANA;25990;1;1;0;0;0;1;1;25990;Plancha UT-KERAMIKTOP 2200Watts Base Ceramica;ELECTRODOMESTICOS
21383177;;F;45;CHILENO;;Extranjero;NATALES                       ;MAGALLANES;49990;1;1;0;0;0;1;1;49990;BATIDORA PEDESTAL RENANIA 5 LITROS;ELECTRODOMESTICOS
19500154;;F;25;CHILENO;;Z;PROVIDENCIA                   ;METROPOLITANA;139990;1;1;1;1;139990;0;0;0;CAFETERA PRIMA LATTE 6603 ROJA;ELECTRODOMESTICOS
11222543;;F;54;CHILENO;;X;"";"";42980;2;2;0;0;0;2;2;42980;Licuadora L2000VNG 1,5Lts Vaso Vidrio;ELECTRODOMESTICOS
5915657;;F;78;CHILENO;;Silencioso;LA PINTANA                    ;METROPOLITANA;89990;1;1;0;0;0;1;1;89990;FREIDORA DE AIRE THOMAS TH-AF60Mi;ELECTRODOMESTICOS
5304687;;F;79;CHILENO;;Silencioso;PROVIDENCIA                   ;METROPOLITANA;10990;1;1;0;0;0;1;1;10990;Hervidor Inox One Midea;ELECTRODOMESTICOS
19293887;;M;31;CHILENO;;Millenial;COPIAPO                       ;ATACAMA;52972;3;1;0;0;0;3;1;52972;Plancha UT-SHANGRILA Inalambrica 2200Watss;ELECTRODOMESTICOS
15410919;;M;41;CHILENO;;X;ANTOFAGASTA                   ;ANTOFAGASTA;274980;2;2;0;0;0;2;2;274980;Horno Microondas Mecanico Fancy 20Lts;ELECTRODOMESTICOS
10698588;;M;55;CHILENO;;Boomers;PARRAL                        ;MAULE;66230;5;6;0;0;0;5;6;66230;Tostador de Pan TH-126 4 Rebanadas Negro;ELECTRODOMESTICOS
15698047;;F;38;CHILENO;;X;PICHILEMU                     ;L.G.B.OÂ´HIGGINS;19990;1;1;0;0;0;1;1;19990;Hervidor Electrico TH-4515N 2Lts Negro;ELECTRODOMESTICOS
16215557;;F;37;CHILENO;;Millenial;RENCA                         ;METROPOLITANA;19990;1;1;0;0;0;1;1;19990;Licuadora Berry Blender Roja 1400 Vaso Vidrio;ELECTRODOMESTICOS
13160550;;F;44;CHILENO;;X;N/D;N/D;1225870;14;14;3;3;349970;11;11;875900;Combo Hervidor + Tostador + Sandwichera;ELECTRODOMESTICOS
15171254;;F;40;CHILENO;;X;RENCA                         ;METROPOLITANA;38990;1;1;0;0;0;1;1;38990;Licuadora L-5500IN 1,5Lts;ELECTRODOMESTICOS
18368945;;F;27;CHILENO;;Millenial;FRUTILLAR                     ;LOS LAGOS;553960;4;3;0;0;0;4;3;553960;CAFETERA PRIMA LATTE 6603 ROJA;ELECTRODOMESTICOS
17824017;;F;30;CHILENO;;Millenial;"";"";912613;12;18;12;18;912613;0;0;0;Horno Microondas Digital TH-20S01 20Lts;ELECTRODOMESTICOS
11458106;Divorciado;M;54;CHILENO;AGROINDUSTRIA;X;RENCA                         ;METROPOLITANA;121210;2;3;0;0;0;2;3;121210;Horno Electrico TH62I 60Lts;ELECTRODOMESTICOS
13715148;Casado;F;42;CHILENO;;X;RENCA                         ;METROPOLITANA;19990;1;1;0;0;0;1;1;19990;Hervidor Electrico UT-DUNKEL17P 2Lts Negro;ELECTRODOMESTICOS
5736554;;F;77;CHILENO;;Silencioso;RENCA                         ;METROPOLITANA;21990;1;1;0;0;0;1;1;21990;Hervidor Electrico UT-DUNKEL17P 2Lts Negro;ELECTRODOMESTICOS
12061967;;F;56;CHILENO;;Boomers;CANETE                        ;BIO BIO;560960;4;3;0;0;0;4;3;560960;Hervidor Family Kettle HE500;ELECTRODOMESTICOS
7412403;;F;67;CHILENO;;Boomers;LA CISTERNA                   ;METROPOLITANA;93970;3;3;0;0;0;3;3;93970;PICADORA 123 SILHQUETTE;ELECTRODOMESTICOS
17663668;;M;31;CHILENO;;Millenial;SAN JOAQUIN;METROPOLITANA;33980;2;1;2;1;33980;0;0;0;FREIDORA DE AIRE HESSIA 2,0 LITROS;ELECTRODOMESTICOS
10943976;;F;49;CHILENO;;X;N/D;N/D;14990;1;1;0;0;0;1;1;14990;HERVIDOR HAMBURGO 2,0 LITROS;ELECTRODOMESTICOS
13103794;;M;46;CHILENO;;X;LAS CONDES;METROPOLITANA;204970;3;2;2;1;169980;1;1;34990;FREIDORA DE AIRE HESSIA 2,0 LITROS;ELECTRODOMESTICOS
17296615;;F;32;CHILENO;;Millenial;N/D;N/D;169990;1;3;1;1;169990;0;2;0;Horno Electrico TH-100i 100Lts;ELECTRODOMESTICOS
15153315;;M;40;CHILENO;;X;LINARES                       ;MAULE;247360;3;2;0;0;0;3;2;247360;Horno Microondas Digital TH-25DM 25Lts;ELECTRODOMESTICOS
8900456;;M;61;CHILENO;;Boomers;CHIGUAYANTE                   ;BIO BIO;71970;3;2;0;0;0;3;2;71970;Licuadora Kaliman Negra con Teclas;ELECTRODOMESTICOS
11505558;;M;53;CHILENO;;X;PROVIDENCIA                   ;METROPOLITANA;77960;4;2;4;2;77960;0;0;0;Horno Microondas Mecanico Fancy 20Lts;ELECTRODOMESTICOS
18034033;;F;30;CHILENO;;Millenial;PROVIDENCIA                   ;METROPOLITANA;20240;2;1;0;0;0;2;1;20240;Hervidor Electrico UT-DUNKEL17P 2Lts Negro;ELECTRODOMESTICOS
27417379;;F;36;VENEZOLANO;;Extranjero;"";"";17990;1;1;0;0;0;1;1;17990;Hervidor Family Kettle HE500;ELECTRODOMESTICOS
16233587;;F;37;CHILENO;;Millenial;CONCON                        ;VALPARAISO;251200;3;2;0;0;0;3;2;251200;Horno Microondas Mecanico UT-SYDNEY18 18Lts;ELECTRODOMESTICOS
20494515;;F;21;CHILENO;;Z;PANGUIPULLI;LOS LAGOS;18990;1;1;0;0;0;1;1;18990;Sandwichera TH-952 2 Panes Blanca;ELECTRODOMESTICOS
4639647;;M;79;CHILENO;;Silencioso;TOCOPILLA                     ;ANTOFAGASTA;1775880;12;7;0;0;0;12;7;1775880;HERVIDOR BERLIN 1,7 LITROS;ELECTRODOMESTICOS
18572611;;F;28;CHILENO;;Millenial;TALCA                         ;MAULE;426180;5;2;0;0;0;5;2;426180;Aspiradora UT-SILENT1804 Arrastre 1800Watts;ELECTRODOMESTICOS
18984890;;M;27;CHILENO;;Z; OVALLE;COQUIMBO;19990;1;1;0;0;0;1;1;19990;Licuadora Berry Blender Roja 1400 Vaso Vidrio;ELECTRODOMESTICOS
18912944;;F;45;CHILENO;;X;TALCA                         ;MAULE;32990;1;1;0;0;0;1;1;32990;Licuadora Personal TH-300PB;ELECTRODOMESTICOS
14688543;;F;50;CHILENO;;Extranjero;LA SERENA                     ;COQUIMBO;14990;1;1;0;0;0;1;1;14990;HERVIDOR HAMBURGO 2,0 LITROS;ELECTRODOMESTICOS
9128774;;F;51;CHILENO;;X;N/D;N/D;971900;11;5;11;5;971900;0;0;0;Hervidor Inox Red Midea;ELECTRODOMESTICOS
14613808;;M;44;CHILENO;;Millenial;"";"";409980;2;2;0;0;0;2;2;409980;Maquina de Coser BM-3850CL Lila;ELECTRODOMESTICOS
11231486;;M;53;CHILENO;;X;ISLA DE MAIPO                 ;METROPOLITANA;115900;2;1;0;0;0;2;1;115900;Horno Microondas Digital L UT-25KROMM 25Lts;ELECTRODOMESTICOS
5486745;;F;72;CHILENO;;Silencioso;RENCA                         ;METROPOLITANA;52990;1;1;0;0;0;1;1;52990;Horno Electrico TH-25N01 25Lts;ELECTRODOMESTICOS
14614332;;F;41;CHILENO;;X;PROVIDENCIA                   ;METROPOLITANA;12990;1;1;0;0;0;1;1;12990;Exprimidor de Jugo CJ-2000 1Lts;ELECTRODOMESTICOS
11942452;;F;50;CHILENO;;X;RENCA                         ;METROPOLITANA;96980;2;2;0;0;0;2;2;96980;Horno Electrico TH-25N01 25Lts;ELECTRODOMESTICOS
24326126;Soltero;M;35;ARGENTINO;;Extranjero;PROVIDENCIA                   ;METROPOLITANA;31970;3;1;3;1;31970;0;0;0;Combo Hervidor + Batidora;ELECTRODOMESTICOS
10236549;;F;56;CHILENO;;Boomers;PETORCA                       ;VALPARAISO;23990;1;1;0;0;0;1;1;23990;Plancha TH-7052 2000Watts Base Inox;ELECTRODOMESTICOS
12606921;;M;48;CHILENO;;X;SAN JAVIER                    ;MAULE;434189;6;2;0;0;0;6;2;434189;HORNO ELECTRICO MUNICH 60 LITROS;ELECTRODOMESTICOS
18981265;;M;27;CHILENO;;Extranjero;PROVIDENCIA                   ;N/D;32990;1;1;0;0;0;1;1;32990;Combo Juguera + Hervidor;ELECTRODOMESTICOS
18931241;;F;27;CHILENO;;Z;"";"";226980;4;2;0;0;0;4;2;226980;Hervidor Electrico Tetera TH-6505RT 1,7Lts Rojo;ELECTRODOMESTICOS
7097421;;F;69;CHILENO;;Silencioso;CANETE                        ;BIO BIO;84960;4;3;0;0;0;4;3;84960;Batidora Vertical Stick Mixer 2609;ELECTRODOMESTICOS
7320226;;M;64;CHILENO;;Boomers;CHANARAL                      ;ATACAMA;342460;3;2;0;0;0;3;2;342460;HERVIDOR BERLIN 1,7 LITROS;ELECTRODOMESTICOS
16719542;;F;34;CHILENO;;Millenial;BUIN                          ;METROPOLITANA;11000;2;1;0;0;0;2;1;11000;Exprimidor de Jugo CJ-2000 1Lts;ELECTRODOMESTICOS
7978561;Casado;M;60;CHILENO;CONTADOR GENERAL;Boomers;RENCA                         ;METROPOLITANA;24990;1;1;1;1;24990;0;0;0;HORNO 10 LITROS OSTER ROJO;ELECTRODOMESTICOS
13158542;;M;45;CHILENO;;X;"";"";16000;2;1;0;0;0;2;1;16000;Hervidor Electrico Tetera UT-LECKER18R 1,8Lts;ELECTRODOMESTICOS
20045712;;F;23;CHILENO;;Z;PROVIDENCIA                   ;METROPOLITANA;53980;2;1;2;1;53980;0;0;0;Horno Microondas Mecanico Fancy 20Lts;ELECTRODOMESTICOS
15703696;;F;38;CHILENO;;Millenial;"";"";99990;3;2;0;0;0;3;2;99990;HORNO ELECTRICO DORTMUND 45 LITROS;ELECTRODOMESTICOS
10186672;;F;57;CHILENO;;Boomers;TIRUA                         ;BIO BIO;27990;1;1;0;0;0;1;1;27990;Licuadora L-1630V Negra 1,5Lts Vaso Vidrio;ELECTRODOMESTICOS
7095384;;F;68;CHILENO;;Boomers;COIHAIQUE                     ;AYSEN;87980;2;1;0;0;0;2;1;87980;Aspiradora Tambor APA1000 1000Watts;ELECTRODOMESTICOS
11989813;;M;50;CHILENO;;X;PUENTE ALTO                   ;METROPOLITANA;197721;3;2;0;0;0;3;2;197721;Hervidor Inox One Midea;ELECTRODOMESTICOS
18680521;;F;28;CHILENO;;Millenial;SAN ESTEBAN;VALPARAISO;155962;4;3;0;0;0;4;3;155962;Freidora de Aire 18M Oster;ELECTRODOMESTICOS
14417092;;F;57;CHILENO;;Boomers;CURICO                        ;MAULE;407980;2;4;0;0;0;2;4;407980;Tostador de Pan TH-116 2 Rebanadas Negro;ELECTRODOMESTICOS
26132365;;M;27;HAITIANO;;Extranjero;CALAMA                        ;ANTOFAGASTA;24990;1;1;0;0;0;1;1;24990;Licuadora TH-320 Roja/Negro 1,5 Lts Vaso Vidrio;ELECTRODOMESTICOS
10916767;;M;53;CHILENO;;X;RENCA                         ;METROPOLITANA;49990;1;1;0;0;0;1;1;49990;Horno Microondas Mecanico Fancy 20Lts;ELECTRODOMESTICOS
18751648;;M;28;CHILENO;;Millenial;VALLENAR;ATACAMA;93980;2;1;2;1;93980;0;0;0;FREIDORA DE AIRE THOMAS TH-AF60Mi;ELECTRODOMESTICOS
6283951;;F;70;CHILENO;;Silencioso;TALCA                         ;MAULE;64990;1;1;1;1;64990;0;0;0;Horno Microondas Mecanico UT-SYDNEY18 18Lts;ELECTRODOMESTICOS
8156171;;F;66;CHILENO;;Boomers;NO APLICA;N/D;40970;3;2;0;0;0;3;2;40970;Batidora Manual 3532;ELECTRODOMESTICOS
8928751;;M;61;CHILENO;;Boomers;AISEN                         ;AYSEN;69660;3;2;0;0;0;3;2;69660;Hervidor Electrico TH-4212N 1,7Lts Negro;ELECTRODOMESTICOS
10694693;;F;58;CHILENO;;Boomers;SAN JAVIER                    ;MAULE;34990;3;2;0;0;0;3;2;34990;Hervidor Electrico Tetera UT-LECKER18R 1,8Lts;ELECTRODOMESTICOS
15823650;;M;38;CHILENO;;X;PUENTE ALTO;METROPOLITANA;38980;2;4;1;3;22990;1;1;15990;Hervidor Electrico UT-MANLY17 1,7Lts Negro;ELECTRODOMESTICOS
17320324;;F;33;CHILENO;;Millenial;PROVIDENCIA                   ;METROPOLITANA;302960;4;4;4;4;302960;0;0;0;CAFETERA PRIMA LATTE 6603 ROJA;ELECTRODOMESTICOS
7497900;;M;66;CHILENO;;Boomers;CAUQUENES                     ;MAULE;660943;6;4;0;0;0;6;4;660943;Plancha UT-DUNST 2200Watts Base Ceramica;ELECTRODOMESTICOS
6155118;;M;74;CHILENO;;Silencioso;LA CISTERNA                   ;METROPOLITANA;31980;2;1;0;0;0;2;1;31980;Picadora UT-PETRUS320 1Lts Vaso Vidrio;ELECTRODOMESTICOS
18460342;;F;29;CHILENO;;Millenial;CALBUCO                       ;LOS LAGOS;20240;2;1;0;0;0;2;1;20240;Combo Hervidor + Batidora;ELECTRODOMESTICOS
16022744;;F;36;CHILENO;;Millenial;PENAFLOR                      ;METROPOLITANA;489960;4;2;4;2;489960;0;0;0;Aspiradora Trapeadora Robot Ut-Excellenza (B);ELECTRODOMESTICOS
11177133;Soltero;F;55;CHILENO;;Boomers;RENCA                         ;METROPOLITANA;14990;1;1;0;0;0;1;1;14990;Hervidor Inox One Midea;ELECTRODOMESTICOS
10051846;;F;55;CHILENO;;Boomers;N/D;N/D;534970;3;2;2;1;339980;1;1;194990;Maquina de Coser BM-3850CL Lila;ELECTRODOMESTICOS
13776002;;M;41;CHILENO;;Millenial;LA CISTERNA;METROPOLITANA;79980;2;1;0;0;0;2;1;79980;Licuadora Oster Clasica Azul 4134 1,25 lt;ELECTRODOMESTICOS
17263685;;M;32;CHILENO;;Extranjero;TEMUCO                        ;ARAUCANIA;12990;1;1;0;0;0;1;1;12990;Hervidor Electrico TH-4212N 1,7Lts Negro;ELECTRODOMESTICOS
12958082;;F;45;CHILENO;;X;SAN ANTONIO                   ;VALPARAISO;289980;2;2;0;0;0;2;2;289980;CAFETERA PRIMA LATTE 6603 ROJA;ELECTRODOMESTICOS
6768916;;M;69;CHILENO;;Silencioso;RENCA                         ;METROPOLITANA;48130;3;1;0;0;0;3;1;48130;Licuadora Roja 550W 1,5Lts Vaso Vidrio;ELECTRODOMESTICOS
16614443;;F;34;CHILENO;;Millenial;TOCOPILLA                     ;ANTOFAGASTA;50980;2;2;0;0;0;2;2;50980;Batidora Manual TH-8830;ELECTRODOMESTICOS
23861610;;M;33;PERUANO;;Extranjero;PROVIDENCIA                   ;METROPOLITANA;59950;5;1;5;1;59950;0;0;0;HERVIDOR 889B 2,5L Negro;ELECTRODOMESTICOS
17856261;;M;31;CHILENO;;Millenial;AISEN                         ;AYSEN;121670;2;1;0;0;0;2;1;121670;Maquina de coser Singer 1605;ELECTRODOMESTICOS
11453820;;M;52;CHILENO;;X;FUTRONO                       ;LOS LAGOS;207473;3;3;0;0;0;3;3;207473;BATIDORA MANUAL 260R;ELECTRODOMESTICOS
13416648;;F;43;CHILENO;;X;N/D;N/D;156980;2;1;2;1;156980;0;0;0;Maquina de coser Singer 024;ELECTRODOMESTICOS
17342337;;M;32;CHILENO;;Millenial;COLINA                        ;METROPOLITANA;43980;2;1;0;0;0;2;1;43980;Olla a Presion Multiolla Daily Food 6L;ELECTRODOMESTICOS
17469378;;F;32;CHILENO;;Millenial;N/D;N/D;1087940;6;4;4;2;1032960;2;2;54980;Plancha Easy Steam (PV4500);ELECTRODOMESTICOS
7641793;;M;66;CHILENO;;Boomers;ILLAPEL                       ;COQUIMBO;89990;3;1;0;0;0;3;1;89990;HORNO ELECTRICO MUNICH 60 LITROS;ELECTRODOMESTICOS
19724387;;M;24;CHILENO;;Extranjero;YUMBEL                        ;BIO BIO;32990;1;1;0;0;0;1;1;32990;Combo Juguera + Hervidor;ELECTRODOMESTICOS
11694617;;F;51;CHILENO;;X;SAN BERNARDO                  ;METROPOLITANA;79990;1;1;1;1;79990;0;0;0;Horno Electrico TH-48N 48Lts;ELECTRODOMESTICOS
9956409;;M;57;CHILENO;;Boomers;ARICA                         ;ARICA Y PARINACOTA;676730;6;3;0;0;0;6;3;676730;Horno Microondas Mecanico Easy Wave 20Lts;ELECTRODOMESTICOS
10640419;Casado;F;56;CHILENO;;Boomers;PROVIDENCIA                   ;METROPOLITANA;34990;1;1;0;0;0;1;1;34990;Combo Juguera + Hervidor;ELECTRODOMESTICOS
18076886;;M;30;CHILENO;;Millenial;N/D;N/D;14990;1;1;0;0;0;1;1;14990;HERVIDOR HAMBURGO 2,0 LITROS;ELECTRODOMESTICOS
15834550;;M;38;CHILENO;;Millenial;PROVIDENCIA                   ;METROPOLITANA;39980;2;1;0;0;0;2;1;39980;Licuadora Berry Blender Roja 1400 Vaso Vidrio;ELECTRODOMESTICOS
18201604;;F;30;CHILENO;;Millenial;PROVIDENCIA                   ;METROPOLITANA;85980;2;1;2;1;85980;0;0;0;Aspiradora Trapeadora Robot Ut-Excellenza (B);ELECTRODOMESTICOS
18276530;;M;30;CHILENO;;Millenial;PAINE                         ;METROPOLITANA;259980;2;2;0;0;0;2;2;259980;Horno Microondas Digital TH-25DM 25Lts;ELECTRODOMESTICOS
20254496;;F;23;CHILENO;;Z;CANETE                        ;BIO BIO;262970;3;2;0;0;0;3;2;262970;Horno Electrico TH62I 60Lts;ELECTRODOMESTICOS
12086595;;M;53;CHILENO;;X;SAN BERNARDO                  ;METROPOLITANA;16990;1;1;0;0;0;1;1;16990;Hervidor Family Kettle HE500;ELECTRODOMESTICOS
24804984;;M;39;HAITIANO;;Extranjero;N/D;N/D;328670;6;3;0;0;0;6;3;328670;Horno Microondas Mecanico Easy Wave 20Lts;ELECTRODOMESTICOS
15672532;;M;38;CHILENO;;X;CONSTITUCION                  ;MAULE;615342;8;3;0;0;0;8;3;615342;Parrilla Electrica TH-224;ELECTRODOMESTICOS
24762697;;M;27;ECUATORIANO;;Extranjero;SAN MIGUEL                    ;METROPOLITANA;31990;1;1;0;0;0;1;1;31990;Parrilla Electrica TH-180;ELECTRODOMESTICOS
10339895;;M;43;CHILENO;;X;RENCA                         ;METROPOLITANA;85980;2;1;2;1;85980;0;0;0;Prensadora de Jugo en Frio Slow Juicer Pro;ELECTRODOMESTICOS
8098073;;F;72;CHILENO;;Silencioso;VICTORIA                      ;ARAUCANIA;124980;2;2;0;0;0;2;2;124980;Batidora de Mano y Pedestal 3612;ELECTRODOMESTICOS
10296480;;F;63;CHILENO;;Boomers;EL CARMEN                     ;BIO BIO;1002151;7;2;0;0;0;7;2;1002151;Horno Electrico UT-BACKOFEN26 26Lts;ELECTRODOMESTICOS
11345901;;F;53;CHILENO;;X;RENCA                         ;METROPOLITANA;59990;1;1;0;0;0;1;1;59990;Horno Microondas Mecanico TH-18B05 18Lts;ELECTRODOMESTICOS
8896034;;M;60;CHILENO;;Boomers;CURACAVI                      ;METROPOLITANA;20990;1;1;0;0;0;1;1;20990;Hervidor Electrico TH-4515N 2Lts Negro;ELECTRODOMESTICOS
7839150;;F;69;CHILENO;;Silencioso;SAN BERNARDO                  ;METROPOLITANA;509340;7;4;0;0;0;7;4;509340;Aspiradora UT-SILENT1804 Arrastre 1800Watts;ELECTRODOMESTICOS
15307170;;M;38;CHILENO;;X;N/D;N/D;392940;6;6;0;0;0;6;6;392940;Batidora Pedestal UT-KLEIN700;ELECTRODOMESTICOS
12728102;;F;47;CHILENO;;X;SAN JAVIER                    ;MAULE;194380;7;4;0;0;0;7;4;194380;HORNO ELECTRICO DORTMUND 45 LITROS;ELECTRODOMESTICOS
10657966;;M;50;CHILENO;;X;COPIAPO;ATACAMA;191980;2;1;2;1;191980;0;0;0;Cafetera De Longhi Icona Vintage Azul ECOV311AZ;ELECTRODOMESTICOS
16805726;;F;34;CHILENO;;Millenial;VALDIVIA;LOS LAGOS;91970;3;2;2;1;76980;1;1;14990;Horno Microondas Digital Deli (2017 DM) 20Lts;ELECTRODOMESTICOS
19609707;;F;25;CHILENO;;Z;"";"";34990;1;1;1;1;34990;0;0;0;Aspiradora TH1407 Arrastre 1400Watts;ELECTRODOMESTICOS
19364134;;F;25;CHILENO;;Millenial;PROVIDENCIA                   ;METROPOLITANA;64990;1;1;1;1;64990;0;0;0;Aspiradora TH1870 Arrastre 1800Watts Gris;ELECTRODOMESTICOS
10107493;;F;55;CHILENO;;Boomers;PROVIDENCIA                   ;METROPOLITANA;249960;4;4;0;0;0;4;4;249960;Hervidor Electrico HA-3300 2,5Lts Blanco;ELECTRODOMESTICOS
17094097;;F;33;CHILENO;;Millenial;LOLOL                         ;L.G.B.OÂ´HIGGINS;199940;6;4;1;1;29990;5;3;169950;FREIDORA DE AIRE HESSIA 2,0 LITROS;ELECTRODOMESTICOS
16697793;;M;34;CHILENO;;Millenial;SAN MIGUEL;METROPOLITANA;95867;3;1;3;1;95867;0;0;0;Horno Microondas Digital Deli (2017 DM) 20Lts;ELECTRODOMESTICOS
26749795;;M;27;VENEZOLANO;;Extranjero;"";"";30980;2;1;0;0;0;2;1;30980;Batidora Manual 3532;ELECTRODOMESTICOS
17580620;;F;32;CHILENO;;Millenial;COIHAIQUE                     ;AYSEN;353970;3;2;0;0;0;3;2;353970;Plancha a Vapor 5001;ELECTRODOMESTICOS
7547303;;F;65;CHILENO;;Boomers;CERRO NAVIA                   ;METROPOLITANA;719350;4;3;0;0;0;4;3;719350;Wafflera time blanca WJ170112 700W;ELECTRODOMESTICOS
25218720;;F;54;GUATAMALTECO;;Extranjero;N/D;N/D;38980;2;1;2;1;38980;0;0;0;Aspiradora TH1407 Arrastre 1400Watts;ELECTRODOMESTICOS
19066217;;F;27;CHILENO;;Z;PAINE                         ;METROPOLITANA;262910;9;4;4;2;122960;5;2;139950;Cafetera UT-KAFFEEKLASSIK;ELECTRODOMESTICOS
11625768;;M;54;CHILENO;;Boomers;N/D;N/D;299100;9;3;3;2;203970;6;1;95130;HORNO ELECTRICO BREMEN 23 LITROS;ELECTRODOMESTICOS
19458030;;F;24;CHILENO;;Z;SAAVEDRA                      ;ARAUCANIA;150000;2;1;0;0;0;2;1;150000;Horno Electrico TH-100i 100Lts;ELECTRODOMESTICOS
13800356;;F;42;CHILENO;;X;RENCA                         ;METROPOLITANA;14990;1;1;0;0;0;1;1;14990;Hervidor Inox One Midea;ELECTRODOMESTICOS
8724010;;F;63;CHILENO;;Boomers;ANGOL                         ;ARAUCANIA;197970;3;3;0;0;0;3;3;197970;HORNO ELECTRICO 16N01 16LTS NEGRO;ELECTRODOMESTICOS
20193864;;F;23;CHILENO;;Z;PROVIDENCIA                   ;METROPOLITANA;59990;1;1;1;1;59990;0;0;0;Batidora Pedestal UT-KLEIN700;ELECTRODOMESTICOS
27100818;;M;26;VENEZOLANO;;Extranjero;"";"";19990;1;1;0;0;0;1;1;19990;Licuadora Berry Blender Roja 1400 Vaso Vidrio;ELECTRODOMESTICOS
19348972;;F;25;CHILENO;;Z;LA SERENA;COQUIMBO;177970;3;2;3;2;177970;0;0;0;Tostador de Pan TH-116 2 Rebanadas Negro;ELECTRODOMESTICOS
8243644;;M;63;CHILENO;;Boomers;RENCA                         ;METROPOLITANA;69990;1;1;0;0;0;1;1;69990;HORNO ELECTRICO MUNICH 60 LITROS;ELECTRODOMESTICOS
17975892;;F;30;CHILENO;;Millenial;SAN CARLOS                    ;BIO BIO;28990;1;2;0;0;0;1;2;28990;Hervidor Electrico UT-REIN17SS;ELECTRODOMESTICOS
17618560;;F;30;CHILENO;;Millenial;N/D;N/D;19990;1;1;0;0;0;1;1;19990;Licuadora Berry Blender Roja 1400 Vaso Vidrio;ELECTRODOMESTICOS
16128024;;M;36;CHILENO;;Millenial;PROVIDENCIA                   ;METROPOLITANA;87960;4;2;4;2;87960;0;0;0;LICUADORA THOMAS TH-700VR;ELECTRODOMESTICOS
11940290;;F;50;CHILENO;;X;N/D;N/D;12990;1;1;0;0;0;1;1;12990;HERVIDOR COLONIA 1,7 LITROS;ELECTRODOMESTICOS
20454701;;F;21;CHILENO;;Z;MELIPILLA                     ;METROPOLITANA;961800;14;6;0;0;0;14;6;961800;HORNO ELECTRICO DORTMUND 45 LITROS;ELECTRODOMESTICOS
18959184;;F;27;CHILENO;;Millenial;N/D;N/D;18990;1;1;0;0;0;1;1;18990;Batidora Manual TH-8830;ELECTRODOMESTICOS
6809932;;F;70;CHILENO;;Silencioso;"";"";54990;1;1;0;0;0;1;1;54990;Freidora electrica Ut-KeramikAir;ELECTRODOMESTICOS
14323995;;F;49;CHILENO;;X;CHILLAN                       ;BIO BIO;170940;6;5;0;0;0;6;5;170940;Batidora Pedestal UT-KLEIN700;ELECTRODOMESTICOS
14391638;;F;44;CHILENO;;X;TALCAHUANO                    ;BIO BIO;166970;3;3;3;3;166970;0;0;0;Horno Electrico TH62I 60Lts;ELECTRODOMESTICOS
17429732;;M;31;CHILENO;;Millenial;PROVIDENCIA                   ;METROPOLITANA;129990;1;1;1;1;129990;0;0;0;CAFETERA PRIMA LATTE 6603 ROJA;ELECTRODOMESTICOS
20604584;;M;21;CHILENO;;Millenial;N/D;N/D;16990;1;1;0;0;0;1;1;16990;Set Hervidor Valory VK330 Blanco + Tostador de;ELECTRODOMESTICOS
11858529;;M;50;CHILENO;;X;PROVIDENCIA                   ;METROPOLITANA;49990;1;1;0;0;0;1;1;49990;FREIDORA DE AIRE BAVIERA 3,8 LITROS;ELECTRODOMESTICOS
13411331;;F;44;CHILENO;;X;SANTA JUANA                   ;BIO BIO;14990;1;1;0;0;0;1;1;14990;PLANCHA A VAPOR 4070 SUELA CERAMICA 2500W;ELECTRODOMESTICOS
4858878;;F;78;CHILENO;;Silencioso;PROVIDENCIA                   ;METROPOLITANA;79990;1;1;0;0;0;1;1;79990;Batidora Pedestal UT-KLEIN700;ELECTRODOMESTICOS
15189710;;M;39;CHILENO;;X;RENCA                         ;METROPOLITANA;154090;2;1;0;0;0;2;1;154090;SUPER FREIDORA DE AIRE OV3;ELECTRODOMESTICOS
22636204;;F;32;PERUANO;;Extranjero;PROVIDENCIA                   ;METROPOLITANA;129990;1;1;1;1;129990;0;0;0;SUPER FREIDORA DE AIRE OV3;ELECTRODOMESTICOS
12414764;;M;49;CHILENO;;X;PAREDONES                     ;L.G.B.OÂ´HIGGINS;34990;1;1;0;0;0;1;1;34990;Licuadora Roja 550W 1,5Lts Vaso Vidrio;ELECTRODOMESTICOS
16326454;;M;36;CHILENO;;Millenial;N/D;N/D;181970;3;3;0;0;0;3;3;181970;Horno Microondas Digital MS23K3513AK/ZS 23Lts;ELECTRODOMESTICOS
8658695;;F;59;CHILENO;;Boomers;PROVIDENCIA                   ;METROPOLITANA;25460;2;1;0;0;0;2;1;25460;Plancha Easy Steam (PV4500);ELECTRODOMESTICOS
10551113;;F;56;CHILENO;;Boomers;PICHILEMU                     ;L.G.B.OÂ´HIGGINS;90950;2;1;0;0;0;2;1;90950;HORNO ELECTRICO MUNICH 60 LITROS;ELECTRODOMESTICOS
18531002;;F;28;CHILENO;;Millenial;"";"";149990;1;3;0;2;0;1;1;149990;FREIDORA DE AIRE HESSIA 2,0 LITROS;ELECTRODOMESTICOS
15902863;;F;37;CHILENO;;Millenial;PEUMO                         ;L.G.B.OÂ´HIGGINS;164090;2;1;0;0;0;2;1;164090;Maquina de Coser Remington J011;ELECTRODOMESTICOS
15221107;;M;40;CHILENO;;X;VINA DEL MAR                  ;VALPARAISO;161970;3;2;2;1;134980;1;1;26990;Hervidor Electrico UT-REIN17SS;ELECTRODOMESTICOS
9317359;;M;47;CHILENO;;X;NATALES                       ;MAGALLANES;213960;4;2;2;1;189980;2;1;23980;Batidora Vertical Stick Mixer 2609;ELECTRODOMESTICOS
12393961;;F;48;CHILENO;;X;BUIN                          ;METROPOLITANA;1350870;14;8;4;2;423970;10;6;926900;Combo Hervidor + Batidora;ELECTRODOMESTICOS
19718562;;F;24;CHILENO;;Z;N/D;N/D;51970;3;2;0;0;0;3;2;51970;Plancha UT-KERAMIKTOP 2200Watts Base Ceramica;ELECTRODOMESTICOS
9553208;;M;55;CHILENO;;Boomers;TOCOPILLA                     ;ANTOFAGASTA;1040910;9;6;0;0;0;9;6;1040910;HERVIDOR HAMBURGO 2,0 LITROS;ELECTRODOMESTICOS
13339429;;F;44;CHILENO;;X;MAIPU                         ;METROPOLITANA;1314870;12;7;4;1;686950;8;6;627920;Hervidor Electrico Tetera HA-4100 4Lts Iox;ELECTRODOMESTICOS
8383240;;M;64;CHILENO;;Boomers;SANTA JUANA                   ;BIO BIO;32990;1;1;0;0;0;1;1;32990;Hervidor Electrico Tetera HA-4100 4Lts Iox;ELECTRODOMESTICOS
19888205;;M;23;CHILENO;;Z;LOS ANDES;VALPARAISO;181960;4;2;4;2;181960;0;0;0;ASPIRADORA ROBOT THOMAS TH-1060SC;ELECTRODOMESTICOS
8642754;;M;62;CHILENO;;Boomers;VINA DEL MAR                  ;VALPARAISO;117970;3;5;0;0;0;3;5;117970;Licuadora L-25000NG;ELECTRODOMESTICOS
9880578;;M;49;CHILENO;;X;SAN BERNARDO                  ;METROPOLITANA;344940;6;5;2;1;209980;4;4;134960;Horno Electrico TH-25N01 25Lts;ELECTRODOMESTICOS
19896209;;M;23;CHILENO;;Z;LINARES                       ;MAULE;49990;1;1;0;0;0;1;1;49990;HORNO ELECTRICO DORTMUND 45 LITROS;ELECTRODOMESTICOS
7634049;;F;64;CHILENO;;Boomers;SAN VICENTE                   ;L.G.B.OÂ´HIGGINS;119990;1;1;0;0;0;1;1;119990;Horno Electrico TH62I 60Lts;ELECTRODOMESTICOS
24508969;Soltero;M;36;PERUANO;;Extranjero;CERRO NAVIA;METROPOLITANA;103980;2;1;2;1;103980;0;0;0;Horno Electrico TH-80i 80Lts;ELECTRODOMESTICOS
24039557;Soltero;F;27;COLOMBIANO;;Millenial;PROVIDENCIA                   ;METROPOLITANA;96940;6;1;0;0;0;6;1;96940;Combo Licuadora + Batidora;ELECTRODOMESTICOS
11989626;;M;50;CHILENO;;X;TEODORO SCHMIDT               ;ARAUCANIA;84980;2;1;0;0;0;2;1;84980;Horno Electrico TH-38N 38Lts;ELECTRODOMESTICOS
18076855;;F;30;CHILENO;;Millenial;N/D;N/D;113980;2;1;2;1;113980;0;0;0;Arrocera Oster 10 en 1 con freidora de aire CKST;ELECTRODOMESTICOS
8033304;Casado;M;62;CHILENO;;Boomers;ANGOL                         ;ARAUCANIA;16990;1;1;0;0;0;1;1;16990;HERVIDOR HAMBURGO 2,0 LITROS;ELECTRODOMESTICOS
11820000;;F;50;CHILENO;;X;CALAMA                        ;ANTOFAGASTA;39990;1;1;0;0;0;1;1;39990;LICUADORA CROMADA CON TECLAS PLUS;ELECTRODOMESTICOS
10883299;;F;55;CHILENO;;Boomers;CAUQUENES                     ;MAULE;13990;1;1;0;0;0;1;1;13990;HERVIDOR COLONIA 1,7 LITROS;ELECTRODOMESTICOS
8130556;;F;68;CHILENO;;Z;TALCAHUANO                    ;BIO BIO;90710;2;1;0;0;0;2;1;90710;Horno Electrico UT-LEIF36 36Lts;ELECTRODOMESTICOS
6711024;;F;70;CHILENO;;Silencioso;CURACAVI                      ;METROPOLITANA;178651;3;2;0;0;0;3;2;178651;Plancha Paninis 2880;ELECTRODOMESTICOS
12717971;;F;47;CHILENO;;X;N/D;N/D;1263860;14;14;0;2;0;14;12;1263860;HORNO ELECTRICO BREMEN 23 LITROS;ELECTRODOMESTICOS
12574558;;F;47;CHILENO;;X;PANGUIPULLI                   ;LOS RIOS;219980;2;2;0;0;0;2;2;219980;HORNO ELECTRICO BREMEN 23 LITROS;ELECTRODOMESTICOS
9482242;;M;59;CHILENO;;Boomers;BUIN                          ;METROPOLITANA;659830;6;3;0;0;0;6;3;659830;Combo Juguera + Hervidor;ELECTRODOMESTICOS
5332543;;F;76;CHILENO;;Silencioso;SAN CARLOS                    ;BIO BIO;90221;3;2;0;0;0;3;2;90221;Aspiradora TH1407 Arrastre 1400Watts;ELECTRODOMESTICOS
14382844;;F;42;CHILENO;;X;PROVIDENCIA                   ;METROPOLITANA;19990;1;1;0;0;0;1;1;19990;Hervidor Electrico UT-DUNKEL17P 2Lts Negro;ELECTRODOMESTICOS
11846214;;F;50;CHILENO;;X;RENCA                         ;METROPOLITANA;53980;2;2;0;0;0;2;2;53980;Hervidor Electrico TH-4212N 1,7Lts Negro;ELECTRODOMESTICOS
20105431;;F;23;CHILENO;;Z;TEMUCO                        ;ARAUCANIA;59990;1;1;0;0;0;1;1;59990;Horno Microondas Digital TH-20S01 20Lts;ELECTRODOMESTICOS
5259171;;F;80;CHILENO;;Silencioso;RENCA                         ;METROPOLITANA;19990;1;1;0;0;0;1;1;19990;Hervidor Electrico UT-DUNKEL17P 2Lts Negro;ELECTRODOMESTICOS
15473198;;M;39;CHILENO;;X;"";"";34990;1;1;0;0;0;1;1;34990;Licuadora TH-501V 1,5Lts Vaso Vidrio;ELECTRODOMESTICOS
6433607;Casado;M;69;CHILENO;TECNOLOGO MEDICO;Silencioso;RENCA                         ;METROPOLITANA;99990;1;1;0;0;0;1;1;99990;ASPIRADORA ROBOT THOMAS TH-1060SC;ELECTRODOMESTICOS
5415648;;M;76;CHILENO;;Silencioso;ARICA                         ;ARICA Y PARINACOTA;34990;1;3;0;0;0;1;3;34990;Aspiradora Handy Clean Black 1400;ELECTRODOMESTICOS
17313202;;M;32;CHILENO;;Millenial;"";"";35390;5;1;0;0;0;5;1;35390;Licuadora Berry Blender Roja 1400 Vaso Vidrio;ELECTRODOMESTICOS
17437098;;F;32;CHILENO;;Millenial;"";"";109980;2;2;0;0;0;2;2;109980;Horno Electrico TH62I 60Lts;ELECTRODOMESTICOS
17852727;;M;30;CHILENO;;Millenial;LO PRADO;METROPOLITANA;108970;3;1;0;0;0;3;1;108970;FREIDORA DE AIRE BAVIERA 3,8 LITROS;ELECTRODOMESTICOS
6488861;;F;66;CHILENO;;Boomers;QUILPUE                       ;VALPARAISO;334620;7;3;0;0;0;7;3;334620;Maquina de coser Singer 1605;ELECTRODOMESTICOS
13399527;;F;44;CHILENO;;X;LANCO                         ;LOS LAGOS;28990;1;1;0;0;0;1;1;28990;Plancha UT-KERAMIKTOP 2200Watts Base Ceramica;ELECTRODOMESTICOS
18920430;;F;32;CHILENO;;Millenial;MAFIL                         ;LOS RIOS;105962;4;3;0;0;0;4;3;105962;Horno Microondas Mecanico Easy Wave 20Lts;ELECTRODOMESTICOS
24545971;;F;47;PERUANO;;Extranjero;"";"";138970;3;2;3;2;138970;0;0;0;SUPER FREIDORA DE AIRE OV3;ELECTRODOMESTICOS
9963868;;F;57;CHILENO;;Boomers;MACUL                         ;METROPOLITANA;52980;2;1;0;0;0;2;1;52980;Hervidor Electrico Tetera HA-4100 4Lts Iox;ELECTRODOMESTICOS
22714815;;M;32;CHILENO;;Extranjero;"";"";113980;2;1;2;1;113980;0;0;0;SUPER FREIDORA DE AIRE OV3;ELECTRODOMESTICOS
15881685;;M;37;CHILENO;;Millenial;CORONEL                       ;BIO BIO;186970;3;3;0;0;0;3;3;186970;Combo Licuadora + Batidora;ELECTRODOMESTICOS
9559689;;F;58;CHILENO;;Boomers;COPIAPO                       ;ATACAMA;292370;5;3;0;0;0;5;3;292370;Maquina de coser Singer 1605;ELECTRODOMESTICOS
11891692;;F;51;CHILENO;;X;SAN VICENTE                   ;L.G.B.OÂ´HIGGINS;180303;3;2;0;0;0;3;2;180303;Licuadora TH-401V Roja 1,75Lts Vaso Vidrio;ELECTRODOMESTICOS
15724049;;F;38;CHILENO;;X;PENCO                         ;BIO BIO;36990;1;1;1;1;36990;0;0;0;Licuadora L1000 Inox 1,7LtsVaso Vidrio;ELECTRODOMESTICOS
7897481;;F;48;CHILENO;;X;N/D;N/D;123980;2;1;2;1;123980;0;0;0;SUPER FREIDORA DE AIRE OV3;ELECTRODOMESTICOS
19654210;;F;24;CHILENO;;Z;QUINCHAO                      ;LOS LAGOS;80000;2;1;0;0;0;2;1;80000;Aspiradora TH1870 Arrastre 1800Watts Gris;ELECTRODOMESTICOS
4960815;;F;76;CHILENO;;Silencioso;EL QUISCO                     ;VALPARAISO;389418;5;2;0;0;0;5;2;389418;Horno Microondas Mecanico TH-18B05 18Lts;ELECTRODOMESTICOS
16320209;;M;36;CHILENO;;Millenial;PANGUIPULLI;LOS LAGOS;87480;2;1;2;1;87480;0;0;0;Horno Microondas Digital 2600DM 26Lts;ELECTRODOMESTICOS
7501474;;F;69;CHILENO;;Silencioso;N/D;N/D;222970;3;3;0;0;0;3;3;222970;Horno Microondas Digital L UT-25KROMM 25Lts;ELECTRODOMESTICOS
16174225;;M;36;CHILENO;;Millenial;LA FLORIDA;METROPOLITANA;241950;5;2;0;0;0;5;2;241950;Aspiradora TH1407 Arrastre 1400Watts;ELECTRODOMESTICOS
9659801;;F;56;CHILENO;;Boomers;MELIPILLA                     ;METROPOLITANA;114980;2;1;0;0;0;2;1;114980;CAFETERA THOMAS TH-150E;ELECTRODOMESTICOS
10602009;;F;59;CHILENO;;Boomers;SAN PEDRO DE ATACAMA          ;ANTOFAGASTA;1401871;16;6;0;0;0;16;6;1401871;SUPER FREIDORA DE AIRE OV3;ELECTRODOMESTICOS
15253347;;F;39;CHILENO;;Z;LANCO                         ;LOS LAGOS;20000;2;1;0;0;0;2;1;20000;Hervidor Electrico TH-4515N 2Lts Negro;ELECTRODOMESTICOS
8343364;;F;56;CHILENO;;Boomers;MAULE                         ;MAULE;28990;1;1;0;0;0;1;1;28990;Hervidor Electrico UT-REIN17SS;ELECTRODOMESTICOS
19340018;;F;25;CHILENO;;Z;VILLA ALEMANA                 ;VALPARAISO;134980;2;2;2;2;134980;0;0;0;CAFETERA PRIMA LATTE 6603 ROJA;ELECTRODOMESTICOS
19059148;;F;26;CHILENO;;Z;PUCON;ARAUCANIA;18990;1;1;0;0;0;1;1;18990;Cafetera TH-130;ELECTRODOMESTICOS
16295151;;F;36;CHILENO;;Millenial;"";"";94210;4;2;0;0;0;4;2;94210;Combo Licuadora + Batidora;ELECTRODOMESTICOS
18283278;;F;29;CHILENO;;Millenial;N/D;N/D;94980;2;2;0;0;0;2;2;94980;ASPIRADORA THOMAS TH-1640;ELECTRODOMESTICOS
12689876;Casado;F;47;CHILENO;;Silencioso;PROVIDENCIA                   ;METROPOLITANA;337960;4;2;4;2;337960;0;0;0;Licuadora Reversible Roja;ELECTRODOMESTICOS
7278379;;F;69;CHILENO;;Silencioso;PUENTE ALTO                   ;METROPOLITANA;49410;2;1;0;0;0;2;1;49410;Procesador TH-9010 Multimixer 1,5Lts Vaso Vidrio;ELECTRODOMESTICOS
10970959;;F;54;CHILENO;;Boomers;CONSTITUCION                  ;MAULE;384970;3;3;0;0;0;3;3;384970;FREIDORA DE AIRE THOMAS TH-AF60Mi;ELECTRODOMESTICOS
11602997;;F;52;CHILENO;;X;PROVIDENCIA                   ;METROPOLITANA;89990;3;1;0;0;0;3;1;89990;HORNO ELECTRICO MUNICH 60 LITROS;ELECTRODOMESTICOS
13133863;Casado;F;45;CHILENO;;X;RENCA                         ;METROPOLITANA;18240;2;1;0;0;0;2;1;18240;Sandwichera TH-952 2 Panes Blanca;ELECTRODOMESTICOS
8225533;;F;64;CHILENO;;Boomers;ANGOL                         ;ARAUCANIA;19990;1;1;0;0;0;1;1;19990;Tostador de Pan TH-116 2 Rebanadas Negro;ELECTRODOMESTICOS
9066419;;F;59;CHILENO;;Boomers;QUILPUE                       ;VALPARAISO;144960;4;2;0;0;0;4;2;144960;Freidora de Aire 18M Oster;ELECTRODOMESTICOS
12809990;;F;47;CHILENO;;X;N/D;N/D;71970;3;1;3;1;71970;0;0;0;Cafetera TH-141Di;ELECTRODOMESTICOS
18235703;;F;29;CHILENO;;Millenial;ANTOFAGASTA                   ;ANTOFAGASTA;373950;5;4;2;2;239980;3;2;133970;Freidora de Aire 18M Oster;ELECTRODOMESTICOS
19214872;;F;21;CHILENO;;Z;"";"";19990;1;1;0;0;0;1;1;19990;Hervidor Electrico TH-4515N 2Lts Negro;ELECTRODOMESTICOS
9340289;;M;59;CHILENO;;Boomers;SAN CARLOS                    ;BIO BIO;18990;1;1;0;0;0;1;1;18990;Batidora Manual 3532;ELECTRODOMESTICOS
6342753;;F;73;CHILENO;;Silencioso;LO PRADO                      ;METROPOLITANA;27990;1;1;0;0;0;1;1;27990;PICADORA 123 SILHQUETTE;ELECTRODOMESTICOS
11384391;;M;52;CHILENO;;X;ARAUCO                        ;BIO BIO;19990;1;1;0;0;0;1;1;19990;Batidora Manual UT-TEKLA300;ELECTRODOMESTICOS
6393301;;F;73;CHILENO;;Silencioso;RENCA                         ;METROPOLITANA;15000;2;1;0;0;0;2;1;15000;HERVIDOR HAMBURGO 2,0 LITROS;ELECTRODOMESTICOS
17261711;Soltero;M;33;CHILENO;;Millenial;PROVIDENCIA                   ;METROPOLITANA;169970;3;1;3;1;169970;0;0;0;FREIDORA DE AIRE THOMAS TH-AF60Mi;ELECTRODOMESTICOS
17704919;;M;30;CHILENO;;Millenial;PUENTE ALTO                   ;METROPOLITANA;29290;2;1;0;0;0;2;1;29290;MULTIMIXER THOMAS TH- 8706;ELECTRODOMESTICOS
14104542;;F;47;CHILENO;;X;ALTO HOSPICIO;TARAPACA;119400;3;2;0;0;0;3;2;119400;Licuadora Osterizer 4112/72 1,25Lts Vaso Vidrio;ELECTRODOMESTICOS
4852788;;F;79;CHILENO;;Silencioso;SAN BERNARDO                  ;METROPOLITANA;23990;1;1;0;0;0;1;1;23990;Hervidor Electrico TH-5407i 2Lts;ELECTRODOMESTICOS
10386949;;F;55;CHILENO;;Boomers;COPIAPO                       ;ATACAMA;11990;1;1;0;0;0;1;1;11990;Plancha Easy Steam (PV4500);ELECTRODOMESTICOS
15792720;;F;36;CHILENO;;Millenial;ANCUD                         ;LOS LAGOS;99990;1;1;1;1;99990;0;0;0;CAFETERA PRIMA LATTE 6603 ROJA;ELECTRODOMESTICOS
14137140;;M;41;CHILENO;;X;PROVIDENCIA                   ;METROPOLITANA;107960;4;2;4;2;107960;0;0;0;Horno Microondas Mecanico C1700N 17Lts Blanco;ELECTRODOMESTICOS
16845360;;F;33;CHILENO;;Millenial;SAN CARLOS;BIO-BIO;159980;2;2;1;1;139990;1;1;19990;Maquina de Coser 311;ELECTRODOMESTICOS
16081741;;F;37;CHILENO;;Millenial;N/D;N/D;336940;6;4;0;0;0;6;4;336940;Licuadora Berry Blender Roja 1400 Vaso Vidrio;ELECTRODOMESTICOS
16689184;Soltero;F;35;CHILENO;;Millenial;PROVIDENCIA                   ;METROPOLITANA;14990;1;1;0;0;0;1;1;14990;Hervidor Inox One Midea;ELECTRODOMESTICOS
4798877;;M;81;CHILENO;;Silencioso;CURANILAHUE                   ;BIO BIO;308970;3;2;2;1;293980;1;1;14990;HERVIDOR HAMBURGO 2,0 LITROS;ELECTRODOMESTICOS
15968851;;F;37;CHILENO;;Millenial;N/D;N/D;351310;5;3;0;0;0;5;3;351310;Aspiradora TH1415 Arrastre 1500Watts;ELECTRODOMESTICOS
24764961;;M;36;PERUANO;;Extranjero;PROVIDENCIA                   ;METROPOLITANA;14990;1;1;0;0;0;1;1;14990;HERVIDOR HAMBURGO 2,0 LITROS;ELECTRODOMESTICOS
16015540;;F;37;CHILENO;;Millenial;PAINE                         ;METROPOLITANA;211980;2;2;0;0;0;2;2;211980;HERVIDOR ELECTRICO UT-STARK18;ELECTRODOMESTICOS
16699240;Soltero;F;34;CHILENO;TECNICO DE NIVEL SUPERIOR EN ODONTOLOGIA;Millenial;PROVIDENCIA                   ;METROPOLITANA;113980;2;1;2;1;113980;0;0;0;SUPER FREIDORA DE AIRE OV3;ELECTRODOMESTICOS
10589345;;F;55;CHILENO;;Boomers;VALDIVIA                      ;LOS RIOS;79990;1;1;0;0;0;1;1;79990;Horno Microondas Digital MS23K3513AK/ZS 23Lts;ELECTRODOMESTICOS
10898582;;F;55;CHILENO;;Boomers;SAN ANTONIO                   ;VALPARAISO;89990;1;1;0;0;0;1;1;89990;Horno Microondas Digital TH-25DM 25Lts;ELECTRODOMESTICOS
9188647;;F;62;CHILENO;;Boomers;TIRUA                         ;BIO BIO;240960;4;3;0;0;0;4;3;240960;Hervidor Electrico UT-REIN17SS;ELECTRODOMESTICOS
19185806;Soltero;F;26;CHILENO;;Z;PROVIDENCIA                   ;METROPOLITANA;34990;1;1;1;1;34990;0;0;0;Aspiradora Handy Clean Black 1400;ELECTRODOMESTICOS
12926004;Divorciado;F;46;CHILENO;;X;RENCA                         ;METROPOLITANA;47990;1;1;0;0;0;1;1;47990;Picadora TH-9020V Vaso Vidrio 2Lts;ELECTRODOMESTICOS
12458666;;F;49;CHILENO;;X;PUDAHUEL                      ;METROPOLITANA;214980;2;2;0;0;0;2;2;214980;Horno Microondas Mecanico Fancy 20Lts;ELECTRODOMESTICOS
26401120;;F;45;EXTRANJERO - NO INFORMA NACIONALIDAD;;Extranjero;RANCAGUA;O HIGGINS;239880;10;4;5;1;147930;5;3;91950;Combo Hervidor + Tostador + Sandwichera;ELECTRODOMESTICOS
15897428;Casado;F;37;CHILENO;;Silencioso;PROVIDENCIA                   ;METROPOLITANA;32350;2;1;0;0;0;2;1;32350;Batidora Vertical Multimixer TH-8720;ELECTRODOMESTICOS
5739829;;F;73;CHILENO;;Silencioso;SAN BERNARDO                  ;METROPOLITANA;704550;4;2;0;0;0;4;2;704550;ASPIRADORA THOMAS TH-1640;ELECTRODOMESTICOS
13443024;;M;44;CHILENO;;X;ERCILLA                       ;ARAUCANIA;99990;1;1;0;0;0;1;1;99990;Maquina de coser Singer 1605;ELECTRODOMESTICOS
11563523;;F;51;CHILENO;;X;RENCA                         ;METROPOLITANA;18990;1;1;0;0;0;1;1;18990;MULTIMIXER THOMAS TH- 8706;ELECTRODOMESTICOS
10300170;;F;55;CHILENO;;Boomers;CANETE                        ;BIO BIO;1214400;10;7;0;0;0;10;7;1214400;Hervidor Electrico TH-5407i 2Lts;ELECTRODOMESTICOS
13994443;;F;40;CHILENO;;X;VINA DEL MAR                  ;VALPARAISO;49990;1;1;0;0;0;1;1;49990;Horno Microondas Mecanico Easy Wave 20Lts;ELECTRODOMESTICOS
9764609;;F;46;CHILENO;;X;RENCA                         ;METROPOLITANA;44990;1;1;1;1;44990;0;0;0;Horno Microondas Mecanico Fancy 20Lts;ELECTRODOMESTICOS
8327659;;M;63;CHILENO;;Boomers;CALAMA                        ;ANTOFAGASTA;320390;5;2;0;0;0;5;2;320390;HORNO ELECTRICO BREMEN 23 LITROS;ELECTRODOMESTICOS
8261653;;F;59;CHILENO;;Boomers;PROVIDENCIA                   ;METROPOLITANA;19990;1;3;0;0;0;1;3;19990;Hervidor Electrico TH-4515N 2Lts Negro;ELECTRODOMESTICOS
11192753;;F;54;CHILENO;;Boomers;PROVIDENCIA                   ;METROPOLITANA;90450;3;1;0;0;0;3;1;90450;Horno Electrico UT-BACKOFEN38 38Lts;ELECTRODOMESTICOS
16577140;Soltero;F;33;CHILENO;;Millenial;PROVIDENCIA                   ;METROPOLITANA;16990;1;1;0;0;0;1;1;16990;HERVIDOR BERLIN 1,7 LITROS;ELECTRODOMESTICOS
19399574;;F;26;CHILENO;;Z;N/D;N/D;66980;4;3;1;1;39990;3;2;26990;Plancha Paninis 2880;ELECTRODOMESTICOS
18800919;;F;26;CHILENO;;Z;LOS ANGELES                   ;BIO BIO;109990;1;1;1;1;109990;0;0;0;SUPER FREIDORA DE AIRE OV3;ELECTRODOMESTICOS
17815990;;F;31;CHILENO;;Millenial;SAN ANTONIO;VALPARAISO;378940;6;3;1;1;29990;5;2;348950;Horno Microondas Digital ME0113MB1/XZS 32Lts;ELECTRODOMESTICOS
18741624;;F;28;CHILENO;;Extranjero;MELIPILLA                     ;METROPOLITANA;40232;3;3;0;0;0;3;3;40232;Batidora Vertical Multimixer TH-8720;ELECTRODOMESTICOS
5580322;;F;77;CHILENO;;Silencioso;RENCA                         ;METROPOLITANA;177970;3;2;0;0;0;3;2;177970;Aspiradora UT-SILENT1603 Arrastre 1600Watts;ELECTRODOMESTICOS
15658396;;M;38;CHILENO;;X;RENCA                         ;METROPOLITANA;54990;1;1;0;0;0;1;1;54990;Aspiradora VCC4190V3E/XZS Arrastre 2000Watts;ELECTRODOMESTICOS
8076001;;F;64;CHILENO;;Boomers;COQUIMBO                      ;COQUIMBO;59990;1;1;0;0;0;1;1;59990;BATIDORA PEDESTAL RENANIA 5 LITROS;ELECTRODOMESTICOS
9200856;;M;58;CHILENO;;Boomers;ALHUE                         ;METROPOLITANA;20000;2;1;0;0;0;2;1;20000;Hervidor Electrico TH-4515N 2Lts Negro;ELECTRODOMESTICOS
17628271;;M;31;CHILENO;;Millenial;SAN FELIPE;VALPARAISO;79980;2;1;2;1;79980;0;0;0;ASPIRADORA ROBOT WIFI FIDDLER HOME BLANCA;ELECTRODOMESTICOS
9959207;;M;55;CHILENO;;Boomers;COLINA                        ;METROPOLITANA;541960;4;4;0;0;0;4;4;541960;Aspiradora TH1407 Arrastre 1400Watts;ELECTRODOMESTICOS
11776760;;F;50;CHILENO;;X;CHILLAN                       ;BIO BIO;35980;2;2;0;0;0;2;2;35980;Licuadora L-1630V Negra 1,5Lts Vaso Vidrio;ELECTRODOMESTICOS
11912594;;F;49;CHILENO;;X;CHILLAN                       ;BIO BIO;175650;2;1;0;0;0;2;1;175650;MAQUINA COSER 2250;ELECTRODOMESTICOS
7157041;;M;67;CHILENO;;Boomers;PROVIDENCIA                   ;METROPOLITANA;34990;1;1;0;0;0;1;1;34990;Licuadora UT-METALLEK505P 1,5Lts Vaso Vidrio;ELECTRODOMESTICOS
9631992;Casado;F;60;CHILENO;PROFESOR;Boomers;RENCA                         ;METROPOLITANA;14990;1;1;0;0;0;1;1;14990;HERVIDOR HAMBURGO 2,0 LITROS;ELECTRODOMESTICOS
18488438;;F;28;CHILENO;;Millenial;MELIPILLA                     ;METROPOLITANA;48980;2;2;0;0;0;2;2;48980;Batidora Vertical Stick Mixer 2609;ELECTRODOMESTICOS
17654959;;M;31;CHILENO;;Millenial;PROVIDENCIA                   ;METROPOLITANA;21990;1;1;0;0;0;1;1;21990;HERVIDOR ELECTRICO UT-STARK18;ELECTRODOMESTICOS
16147130;;M;36;CHILENO;;Millenial;N/D;N/D;291910;8;4;7;3;261920;1;1;29990;PLANCHA A VAPOR 6953 BASE AEROCERAMICA AUTAPA.22;ELECTRODOMESTICOS
10892919;;F;52;CHILENO;;X;COPIAPO                       ;ATACAMA;149980;2;1;0;0;0;2;1;149980;Enceradora EA-5000;ELECTRODOMESTICOS
14251236;;F;53;CHILENO;;X;MONTE PATRIA                  ;COQUIMBO;146070;3;1;0;0;0;3;1;146070;Maquina de coser Singer 1605;ELECTRODOMESTICOS
11638599;;M;52;CHILENO;;X;LA REINA                      ;METROPOLITANA;133980;2;1;2;1;133980;0;0;0;Horno con Air Fryer 35Lt;ELECTRODOMESTICOS
19948764;;F;23;CHILENO;;Z;LA SERENA;COQUIMBO;482423;8;6;8;6;482423;0;0;0;Licuadora Osterizer 4112/72 1,25Lts Vaso Vidrio;ELECTRODOMESTICOS
15609553;Soltero;M;37;CHILENO;;Millenial;PROVIDENCIA                   ;METROPOLITANA;164980;2;2;1;1;129990;1;1;34990;Cafetera UT-KAFFEEKLASSIK;ELECTRODOMESTICOS
20171630;;M;23;CHILENO;;Z;VINA DEL MAR                  ;VALPARAISO;574980;2;2;1;1;34990;1;1;539990;FREIDORA DE AIRE HESSIA 2,0 LITROS;ELECTRODOMESTICOS
8042215;;F;66;CHILENO;;Boomers;MAIPU                         ;METROPOLITANA;57980;2;2;0;0;0;2;2;57980;Plancha Easy Steam (PV4500);ELECTRODOMESTICOS
9572671;;M;57;CHILENO;;Boomers;CARTAGENA                     ;VALPARAISO;506190;8;5;0;0;0;8;5;506190;Horno Microondas Mecanico UT-SYDNEY18 18Lts;ELECTRODOMESTICOS
12066993;;F;62;PERUANO;;Extranjero;N/D;N/D;60320;4;1;0;0;0;4;1;60320;Batidora Pedestal B5300 Inox;ELECTRODOMESTICOS
19607985;;F;25;CHILENO;;Z;VILLARICA                     ;ARAUCANIA;27990;1;1;0;0;0;1;1;27990;Batidora Vertical Multimixer TH-8720;ELECTRODOMESTICOS
11143871;Casado;F;55;CHILENO;;Boomers;RENCA                         ;METROPOLITANA;12990;1;1;0;0;0;1;1;12990;HERVIDOR COLONIA 1,7 LITROS;ELECTRODOMESTICOS
25355217;Soltero;F;39;VENEZOLANO;;Extranjero;PROVIDENCIA                   ;METROPOLITANA;143980;2;1;2;1;143980;0;0;0;SUPER FREIDORA DE AIRE OV3;ELECTRODOMESTICOS
18313738;;M;29;CHILENO;;Millenial;GRANEROS                      ;L.G.B.OÂ´HIGGINS;201660;3;1;3;1;201660;0;0;0;SUPER FREIDORA DE AIRE OV3;ELECTRODOMESTICOS
8305423;;F;65;CHILENO;;Boomers;OVALLE                        ;COQUIMBO;36990;1;1;0;0;0;1;1;36990;Combo Hervidor + Tostador + Sandwichera;ELECTRODOMESTICOS
14484539;;F;47;CHILENO;;X;PROVIDENCIA                   ;METROPOLITANA;19990;1;1;0;0;0;1;1;19990;Plancha TH-7052 2000Watts Base Inox;ELECTRODOMESTICOS
17886104;Soltero;M;31;CHILENO;;Millenial;PROVIDENCIA                   ;METROPOLITANA;126960;4;3;2;1;45980;2;2;80980;Horno electrico Black Oven 42lts;ELECTRODOMESTICOS
9308647;;M;59;CHILENO;;Boomers;COIHAIQUE                     ;AYSEN;86980;2;2;0;0;0;2;2;86980;Hervidor Electrico TH-4212N 1,7Lts Negro;ELECTRODOMESTICOS
10718055;Casado;F;40;CHILENO;INGENIERO EN ADMINISTRACION DE EMPRESAS;X;PROVIDENCIA                   ;METROPOLITANA;62980;2;1;0;0;0;2;1;62980;Horno Microondas Mecanico Easy Wave 20Lts;ELECTRODOMESTICOS
10229274;;M;60;CHILENO;;Boomers;TEMUCO                        ;ARAUCANIA;71810;4;2;0;0;0;4;2;71810;HERVIDOR COLONIA 1,7 LITROS;ELECTRODOMESTICOS
15762815;;F;38;CHILENO;;Millenial;PROVIDENCIA                   ;METROPOLITANA;29990;1;1;1;1;29990;0;0;0;Hervidor Electrico Tetera TH-6505RT 1,7Lts Rojo;ELECTRODOMESTICOS
11931237;;M;50;CHILENO;;X;ANTOFAGASTA                   ;ANTOFAGASTA;65970;3;2;0;0;0;3;2;65970;Licuadora L-1630V Negra 1,5Lts Vaso Vidrio;ELECTRODOMESTICOS
16449822;;M;36;CHILENO;;Extranjero;N/D;N/D;84980;2;4;0;0;0;2;4;84980;Licuadora L-1630V Negra 1,5Lts Vaso Vidrio;ELECTRODOMESTICOS
8873552;;M;62;CHILENO;;Boomers;CHIMBARONGO                   ;L.G.B.OÂ´HIGGINS;125970;3;2;0;0;0;3;2;125970;Licuadora L-1630V Negra 1,5Lts Vaso Vidrio;ELECTRODOMESTICOS
13077121;;F;46;CHILENO;;X;PENALOLEN                     ;METROPOLITANA;23980;2;1;2;1;23980;0;0;0;Licuadora Berry Blender Roja 1400 Vaso Vidrio;ELECTRODOMESTICOS
9972267;;M;54;CHILENO;;Boomers;ARICA                         ;ARICA Y PARINACOTA;49990;1;1;0;0;0;1;1;49990;FREIDORA DE AIRE BAVIERA 3,8 LITROS;ELECTRODOMESTICOS
15276257;;F;39;CHILENO;;X;INDEPENDENCIA;METROPOLITANA;39990;1;1;1;1;39990;0;0;0;FREIDORA DE AIRE BAVIERA 3,8 LITROS;ELECTRODOMESTICOS
10716792;;F;50;CHILENO;;X;ANGOL;ARAUCANIA;12990;1;1;0;0;0;1;1;12990;Plancha Easy Steam (PV4500);ELECTRODOMESTICOS
7058899;;M;70;CHILENO;;Silencioso;LOS ANDES                     ;VALPARAISO;39990;1;1;0;0;0;1;1;39990;HORNO ELECTRICO BREMEN 23 LITROS;ELECTRODOMESTICOS
12825668;;F;54;CHILENO;;X;PROVIDENCIA                   ;METROPOLITANA;453950;5;5;1;1;359990;4;4;93960;FREIDORA DE AIRE BAVIERA 3,8 LITROS;ELECTRODOMESTICOS
10116233;Casado;F;56;CHILENO;;Boomers;PROVIDENCIA                   ;METROPOLITANA;16990;1;1;0;0;0;1;1;16990;Hervidor Electrico HA-3300 2,5Lts Blanco;ELECTRODOMESTICOS
13320958;;M;44;CHILENO;;X;VALDIVIA                      ;LOS LAGOS;59990;1;1;1;1;59990;0;0;0;Aspiradora UT-SILENT1804 Arrastre 1800Watts;ELECTRODOMESTICOS
19796109;;F;25;CHILENO;;Z;N/D;N/D;33980;2;2;0;0;0;2;2;33980;Batidora Manual UT-TEKLA300;ELECTRODOMESTICOS
8767560;;F;62;CHILENO;;Boomers;RENCA                         ;METROPOLITANA;0;0;2;0;0;0;0;2;0;Hervidor Electrico TH-5407i 2Lts;ELECTRODOMESTICOS
8618705;;F;62;CHILENO;;Boomers;COLINA                        ;METROPOLITANA;49990;1;1;0;0;0;1;1;49990;FREIDORA DE AIRE BAVIERA 3,8 LITROS;ELECTRODOMESTICOS
11202764;;F;55;CHILENO;;Boomers;ANTOFAGASTA                   ;ANTOFAGASTA;112980;2;2;2;2;112980;0;0;0;Maquina de coser Singer 1605;ELECTRODOMESTICOS
11567923;;M;52;CHILENO;;X;SAN CARLOS                    ;BIO BIO;214959;4;2;0;0;0;4;2;214959;SUPER FREIDORA DE AIRE OV3;ELECTRODOMESTICOS
12192606;;M;50;CHILENO;;X;N/D;N/D;19990;1;1;0;0;0;1;1;19990;Exprimidor de Jugo TH-1215 1,5Lts;ELECTRODOMESTICOS
13845074;;F;41;CHILENO;;X;NACIMIENTO                    ;BIO BIO;34990;1;1;0;0;0;1;1;34990;Batidora Vertical Minipimer UT-KLOT400P;ELECTRODOMESTICOS
12794785;;F;47;CHILENO;;X;CHILLAN                       ;BIO BIO;937159;12;5;0;0;0;12;5;937159;Plancha UT-KERAMIKTOP 2200Watts Base Ceramica;ELECTRODOMESTICOS
7746245;;F;66;CHILENO;;Boomers;PROVIDENCIA                   ;METROPOLITANA;137960;4;2;4;2;137960;0;0;0;Enceradora EA-5000;ELECTRODOMESTICOS
19563743;;M;25;CHILENO;;Z;"";"";56982;4;2;0;0;0;4;2;56982;Horno Microondas Digital UT-CLASSY720 20Lts;ELECTRODOMESTICOS
13950783;;M;41;CHILENO;;X;RENCA                         ;METROPOLITANA;99990;1;1;1;1;99990;0;0;0;FREIDORA DE AIRE THOMAS TH-AF60Mi;ELECTRODOMESTICOS
9978533;Casado;F;57;CHILENO;;Boomers;PROVIDENCIA                   ;METROPOLITANA;99990;1;1;0;0;0;1;1;99990;FREIDORA DE AIRE THOMAS TH-AF60Mi;ELECTRODOMESTICOS
10881240;Casado;F;55;CHILENO;;Boomers;RENCA                         ;METROPOLITANA;19990;1;1;0;0;0;1;1;19990;Licuadora Berry Blender Roja 1400 Vaso Vidrio;ELECTRODOMESTICOS
4730997;;M;80;CHILENO;;Silencioso;PROVIDENCIA                   ;METROPOLITANA;19990;1;1;0;0;0;1;1;19990;Licuadora Berry Blender Roja 1400 Vaso Vidrio;ELECTRODOMESTICOS
16427247;;M;36;CHILENO;;Millenial;PROVIDENCIA                   ;METROPOLITANA;13990;1;1;0;0;0;1;1;13990;Hervidor Electrico 3101 1,7Lts Negro;ELECTRODOMESTICOS
19751760;;M;25;CHILENO;;Z;QUILICURA;METROPOLITANA;0;0;2;0;2;0;0;0;0;Plancha UT-KERAMIK1 2200Watts Base Ceramica;ELECTRODOMESTICOS
12347890;;F;53;CHILENO;;X;SAN PEDRO DE ATACAMA          ;ANTOFAGASTA;259970;3;3;0;0;0;3;3;259970;Licuadora TH-501V 1,5Lts Vaso Vidrio;ELECTRODOMESTICOS
16296436;;F;36;CHILENO;;Millenial;RENCA                         ;METROPOLITANA;29990;1;1;0;0;0;1;1;29990;Licuadora L2000VNG 1,5Lts Vaso Vidrio;ELECTRODOMESTICOS
15881404;;M;38;CHILENO;;Millenial;PROVIDENCIA                   ;METROPOLITANA;16990;1;1;0;0;0;1;1;16990;Sandwichera TH-952 2 Panes Blanca;ELECTRODOMESTICOS
8114710;;F;65;CHILENO;;Boomers;SAN ANTONIO                   ;VALPARAISO;135980;2;2;0;0;0;2;2;135980;Horno Electrico UT-BACKOFEN60 60Lts;ELECTRODOMESTICOS
9524207;;F;60;CHILENO;;Boomers;CABILDO                       ;VALPARAISO;161940;6;3;0;0;0;6;3;161940;BATIDORA MANUAL 260R;ELECTRODOMESTICOS
13248714;;F;45;CHILENO;;X;N/D;N/D;1253950;7;4;7;4;1253950;0;0;0;Hervidor Electrico Tetera HA-4100 4Lts Iox;ELECTRODOMESTICOS
17881625;;F;30;CHILENO;;Millenial;SANTIAGO                      ;METROPOLITANA;16990;1;1;0;0;0;1;1;16990;Cafetera TH-130;ELECTRODOMESTICOS
11117310;;F;55;CHILENO;;Boomers;RENCA                         ;METROPOLITANA;44990;1;1;0;0;0;1;1;44990;Horno Electrico TH-25N01 25Lts;ELECTRODOMESTICOS
16546612;;F;35;CHILENO;;Millenial;"";"";348630;7;3;0;0;0;7;3;348630;Plancha a Vapor 5001;ELECTRODOMESTICOS
5730707;;F;72;CHILENO;;Silencioso;ALTO HOSPICIO;TARAPACA;219980;2;1;0;0;0;2;1;219980;HORNO ELECTRICO HE-600IN INOX SINDELEN;ELECTRODOMESTICOS
14358325;;F;42;CHILENO;;X;N/D;N/D;204972;3;3;0;0;0;3;3;204972;Horno Electrico TH62I 60Lts;ELECTRODOMESTICOS
15014835;;M;40;CHILENO;;X;N/D;N/D;12990;1;1;0;0;0;1;1;12990;Exprimidor Fauna 500 cc;ELECTRODOMESTICOS
9089367;;M;59;CHILENO;;Boomers;PROVIDENCIA                   ;METROPOLITANA;39990;1;1;0;0;0;1;1;39990;Licuadora TH-501V 1,5Lts Vaso Vidrio;ELECTRODOMESTICOS
16336298;Soltero;F;36;CHILENO;;Millenial;PROVIDENCIA                   ;METROPOLITANA;21990;1;1;0;0;0;1;1;21990;HERVIDOR ELECTRICO UT-STARK18;ELECTRODOMESTICOS
18323576;;F;29;CHILENO;;Millenial;N/D;N/D;672930;7;4;7;4;672930;0;0;0;Aspiradora Handy Clean Black 1400;ELECTRODOMESTICOS
16603208;;M;35;CHILENO;;Millenial;"";"";30000;2;1;0;0;0;2;1;30000;Combo Juguera + Hervidor;ELECTRODOMESTICOS
6633871;;F;67;CHILENO;;Boomers;VILLARICA                     ;ARAUCANIA;183980;2;3;0;0;0;2;3;183980;Horno Electrico TH-80i 80Lts;ELECTRODOMESTICOS
7849340;;M;64;CHILENO;;Boomers;NUNOA;METROPOLITANA;49230;2;1;0;0;0;2;1;49230;Plancha UT-SHANGRILA Inalambrica 2200Watss;ELECTRODOMESTICOS
8081743;;M;55;CHILENO;;Boomers;RENCA                         ;METROPOLITANA;321970;3;2;0;0;0;3;2;321970;Horno Electrico UT-BACKOFEN26 26Lts;ELECTRODOMESTICOS
17380833;;F;32;CHILENO;;Millenial;"";"";92870;2;2;0;0;0;2;2;92870;Horno Electrico TH-25N01 25Lts;ELECTRODOMESTICOS
18967048;;M;27;CHILENO;;Z;PROVIDENCIA                   ;METROPOLITANA;12990;1;1;1;1;12990;0;0;0;TOSTADOR OLDEMBURGO 2 REBANADAS;ELECTRODOMESTICOS
14443035;;M;47;CHILENO;;X;"";"";69970;3;2;3;2;69970;0;0;0;FREIDORA DE AIRE BAVIERA 3,8 LITROS;ELECTRODOMESTICOS
18670900;;F;28;CHILENO;;Millenial;N/D;N/D;724950;5;5;0;0;0;5;5;724950;FREIDORA DE AIRE BAVIERA 3,8 LITROS;ELECTRODOMESTICOS
12015567;;F;49;CHILENO;;X;SAN ANTONIO                   ;VALPARAISO;26990;1;1;0;0;0;1;1;26990;Cafetera TH-138i;ELECTRODOMESTICOS
18176949;;F;30;CHILENO;;Millenial;TALCA;MAULE;14990;1;1;0;0;0;1;1;14990;Tostador de Pan TH-116 2 Rebanadas Negro;ELECTRODOMESTICOS
18843566;;M;28;CHILENO;;Millenial;PROVIDENCIA                   ;METROPOLITANA;29990;1;1;1;1;29990;0;0;0;Licuadora Roja 550W 1,5Lts Vaso Vidrio;ELECTRODOMESTICOS
5842735;Casado;F;72;CHILENO;;Silencioso;RENCA                         ;METROPOLITANA;36990;1;1;0;0;0;1;1;36990;Licuadora TH-401V Roja 1,75Lts Vaso Vidrio;ELECTRODOMESTICOS
25069063;;M;29;PERUANO;;Extranjero;N/D;N/D;131970;3;3;0;0;0;3;3;131970;Horno Microondas Digital TH-20S01 20Lts;ELECTRODOMESTICOS
10917811;;F;54;CHILENO;;X;PROVIDENCIA                   ;METROPOLITANA;16990;1;1;0;0;0;1;1;16990;Hervidor Electrico HA-3300 2,5Lts Blanco;ELECTRODOMESTICOS
16424836;;M;35;CHILENO;;Millenial;LO ESPEJO                     ;METROPOLITANA;266940;6;3;6;3;266940;0;0;0;Freidora de Aire Oster 40M;ELECTRODOMESTICOS
8423523;;M;65;CHILENO;;Boomers;VALLENAR;ATACAMA;199980;2;2;0;0;0;2;2;199980;FREIDORA DE AIRE BAVIERA 3,8 LITROS;ELECTRODOMESTICOS
5833662;;M;76;CHILENO;;Silencioso;ARICA                         ;TARAPACA;129980;2;2;0;0;0;2;2;129980;Horno Microondas Mecanico Easy Wave 20Lts;ELECTRODOMESTICOS
10521310;;F;56;CHILENO;;Boomers;MELIPILLA                     ;METROPOLITANA;94980;2;2;0;0;0;2;2;94980;Horno Electrico UT-LEIF36 36Lts;ELECTRODOMESTICOS
15206766;;F;39;CHILENO;;X;LOS ANGELES                   ;BIO BIO;119990;2;1;0;0;0;2;1;119990;Maquina de coser Singer 1605;ELECTRODOMESTICOS
5990097;;F;76;CHILENO;;Silencioso;RENCA                         ;METROPOLITANA;49970;3;2;2;1;36980;1;1;12990;TOSTADOR OLDEMBURGO 2 REBANADAS;ELECTRODOMESTICOS
7654366;;F;69;CHILENO;;Silencioso;RENCA                         ;METROPOLITANA;79990;1;1;0;0;0;1;1;79990;Batidora Pedestal TH910PN 4,6Lts 1300Watts;ELECTRODOMESTICOS
17632056;;F;31;CHILENO;;Millenial;PUERTO MONTT                  ;LOS LAGOS;94980;2;1;0;0;0;2;1;94980;Parrilla Electrica TH-224;ELECTRODOMESTICOS
11270427;;M;54;CHILENO;;X;RENCA                         ;METROPOLITANA;13240;2;1;0;0;0;2;1;13240;TOSTADOR OLDEMBURGO 2 REBANADAS;ELECTRODOMESTICOS
4480852;;M;79;CHILENO;;Silencioso;N/D;N/D;99510;6;1;0;0;0;6;1;99510;Licuadora BL1500 Silver 1,75Lts Vaso Vidrio;ELECTRODOMESTICOS
26625988;;F;46;VENEZOLANO;;Extranjero;"";"";14990;1;1;0;0;0;1;1;14990;Batidora Vertical Stick Mixer 2609;ELECTRODOMESTICOS
19387055;;F;26;CHILENO;;Z;N/D;N/D;54990;1;1;0;0;0;1;1;54990;Horno Electrico UT-BACKOFEN26 26Lts;ELECTRODOMESTICOS
7187394;;M;69;CHILENO;;Silencioso;SAN FERNANDO                  ;L.G.B.OÂ´HIGGINS;24990;1;1;0;0;0;1;1;24990;LICUADORA HANOVER 1,5 LITROS;ELECTRODOMESTICOS
13373430;;F;44;CHILENO;;X;CAUQUENES                     ;MAULE;59990;1;1;0;0;0;1;1;59990;Horno electrico Black Oven 42lts;ELECTRODOMESTICOS
18653724;;F;28;CHILENO;;Millenial;TALCA;MAULE;119980;2;1;0;0;0;2;1;119980;Horno Electrico TH62I 60Lts;ELECTRODOMESTICOS
6079391;;F;69;CHILENO;;Silencioso;N/D;N/D;44990;1;1;1;1;44990;0;0;0;Horno Microondas Mecanico Fancy 20Lts;ELECTRODOMESTICOS
18255918;;F;30;CHILENO;;Millenial;QUILLOTA                      ;VALPARAISO;15990;1;1;0;0;0;1;1;15990;Hervidor Electrico UT-MANLY17 1,7Lts Negro;ELECTRODOMESTICOS
19661273;;F;24;CHILENO;;Z;N/D;N/D;16982;4;2;0;0;0;4;2;16982;Hervidor Electrico TH-4515N 2Lts Negro;ELECTRODOMESTICOS
17279664;;F;32;CHILENO;;Millenial;SANTIAGO                      ;METROPOLITANA;14990;1;1;0;0;0;1;1;14990;Hervidor Electrico TH-4212N 1,7Lts Negro;ELECTRODOMESTICOS
7357360;;F;65;CHILENO;;Boomers;PUNTA ARENAS                  ;MAGALLANES;153970;3;2;0;0;0;3;2;153970;Aspiradora TH1870 Arrastre 1800Watts Gris;ELECTRODOMESTICOS
15281079;;M;40;CHILENO;;X;CASTRO                        ;LOS LAGOS;75250;2;1;0;0;0;2;1;75250;Aspiradora UT-SILENT1804 Arrastre 1800Watts;ELECTRODOMESTICOS
19063589;;M;27;CHILENO;;Z;PROVIDENCIA                   ;METROPOLITANA;31970;3;1;3;1;31970;0;0;0;PLANCHA A VAPOR 4070 SUELA CERAMICA 2500W;ELECTRODOMESTICOS
10819157;;F;56;CHILENO;;Boomers;MELIPILLA                     ;METROPOLITANA;47980;2;2;0;0;0;2;2;47980;Plancha THOMAS TH-7170 2200Watts Base Ceramica;ELECTRODOMESTICOS
16060494;;M;37;CHILENO;;Millenial;TIRUA                         ;BIO BIO;109990;1;1;0;0;0;1;1;109990;Horno Electrico TH62I 60Lts;ELECTRODOMESTICOS
13290857;;F;51;CHILENO;;X;PROVIDENCIA                   ;METROPOLITANA;29990;1;1;0;0;0;1;1;29990;Licuadora BL1500 Silver 1,75Lts Vaso Vidrio;ELECTRODOMESTICOS
6701718;Soltero;F;68;CHILENO;;Boomers;PROVIDENCIA                   ;METROPOLITANA;58980;2;1;2;1;58980;0;0;0;H MICROONDA MMP-23GABV 23L;ELECTRODOMESTICOS
14066599;;F;46;CHILENO;;X;LOS ANGELES                   ;BIO BIO;36990;1;1;0;0;0;1;1;36990;Combo Hervidor + Tostador + Sandwichera;ELECTRODOMESTICOS
7583717;;F;69;CHILENO;;Silencioso;COLINA                        ;METROPOLITANA;433060;7;2;0;0;0;7;2;433060;Enceradora EA-5000;ELECTRODOMESTICOS
13272560;;M;44;CHILENO;;X;PUCHUNCAVI                    ;VALPARAISO;223960;4;2;4;2;223960;0;0;0;Horno Microondas Digital UT-CLASSY720 20Lts;ELECTRODOMESTICOS
10329498;;M;51;CHILENO;;X;N/D;N/D;39990;1;1;0;0;0;1;1;39990;Aspiradora AP1700 Arrastre 1700Watts;ELECTRODOMESTICOS
6250832;;F;76;CHILENO;;Silencioso;OVALLE                        ;COQUIMBO;223960;4;4;0;0;0;4;4;223960;Hervidor Electrico UT-MANLY17 1,7Lts Negro;ELECTRODOMESTICOS
9449700;;F;59;CHILENO;;Boomers;LA CISTERNA                   ;METROPOLITANA;41980;2;1;0;0;0;2;1;41980;Licuadora Roja 550W 1,5Lts Vaso Vidrio;ELECTRODOMESTICOS
20361797;;F;22;CHILENO;;Z;CORONEL                       ;BIO BIO;194980;2;3;0;0;0;2;3;194980;Horno Electrico TH-100i 100Lts;ELECTRODOMESTICOS
5055224;;F;78;CHILENO;;Silencioso;MELIPILLA                     ;METROPOLITANA;107960;4;1;0;0;0;4;1;107960;Plancha Paninis 2880;ELECTRODOMESTICOS
5011310;;M;77;CHILENO;;Silencioso;PROVIDENCIA                   ;METROPOLITANA;34990;1;1;0;0;0;1;1;34990;Aspiradora TH1407 Arrastre 1400Watts;ELECTRODOMESTICOS
16298020;;F;36;CHILENO;;Millenial;N/D;N/D;26990;1;1;0;0;0;1;1;26990;Cafetera TH-138i;ELECTRODOMESTICOS
15676349;;F;34;CHILENO;;Millenial;CAUQUENES                     ;MAULE;12990;1;1;0;0;0;1;1;12990;PLANCHA A VAPOR 4070 SUELA CERAMICA 2500W;ELECTRODOMESTICOS
13975894;;M;40;CHILENO;;X;PROVIDENCIA                   ;METROPOLITANA;57980;3;3;0;0;0;3;3;57980;LICUADORA CROMADA CON TECLAS PLUS;ELECTRODOMESTICOS
9112960;;M;60;CHILENO;;Boomers;MAIPU                         ;METROPOLITANA;107160;3;1;0;0;0;3;1;107160;HORNO ELECTRICO MUNICH 60 LITROS;ELECTRODOMESTICOS
10524147;;F;56;CHILENO;;Boomers;CHONCHI                       ;LOS LAGOS;17990;1;1;0;0;0;1;1;17990;Hervidor Electrico HA-3300 2,5Lts Blanco;ELECTRODOMESTICOS
11527178;Casado;M;51;CHILENO;;X;RENCA                         ;METROPOLITANA;29990;1;1;0;0;0;1;1;29990;Procesador TH-9010 Multimixer 1,5Lts Vaso Vidrio;ELECTRODOMESTICOS
16673149;Soltero;F;35;CHILENO;DISENADOR DE VESTUARIO;Millenial;PROVIDENCIA                   ;METROPOLITANA;337960;4;2;4;2;337960;0;0;0;Maquina Overlock 3534T Azul;ELECTRODOMESTICOS
12689248;;M;47;CHILENO;;X;LA PINTANA                    ;METROPOLITANA;54990;1;1;0;0;0;1;1;54990;Horno Electrico TH-38N 38Lts;ELECTRODOMESTICOS
7765322;;F;66;CHILENO;;Boomers;PARRAL                        ;MAULE;273980;2;2;0;0;0;2;2;273980;Licuadora L-1630V Negra 1,5Lts Vaso Vidrio;ELECTRODOMESTICOS
11136994;;M;54;CHILENO;;Boomers;SAN BERNARDO                  ;METROPOLITANA;98980;2;1;0;0;0;2;1;98980;Horno electrico Black Oven 42lts;ELECTRODOMESTICOS
19975200;;M;23;CHILENO;;Millenial;N/D;N/D;291960;4;2;4;2;291960;0;0;0;H MICROONDA MMP-25GE3D 25L;ELECTRODOMESTICOS
17847067;;F;31;CHILENO;;Millenial;N/D;N/D;12990;1;1;1;1;12990;0;0;0;PLANCHA A VAPOR 4070 SUELA CERAMICA 2500W;ELECTRODOMESTICOS
10172921;Soltero;F;56;CHILENO;;Silencioso;PROVIDENCIA                   ;METROPOLITANA;12990;1;1;0;0;0;1;1;12990;Cafetera TH-130;ELECTRODOMESTICOS
26404406;Soltero;M;40;EXTRANJERO - NO INFORMA NACIONALIDAD;;Extranjero;"";"";12990;1;1;0;0;0;1;1;12990;Hervidor Inox One Midea;ELECTRODOMESTICOS
10893451;;F;54;CHILENO;;X;BUIN                          ;METROPOLITANA;181970;3;2;0;0;0;3;2;181970;Hervidor Electrico Tetera HA-4100 4Lts Iox;ELECTRODOMESTICOS
15928914;;M;37;CHILENO;;Millenial;CORONEL                       ;BIO BIO;119990;1;1;0;0;0;1;1;119990;Horno Microondas Digital L UT-25KROMM 25Lts;ELECTRODOMESTICOS
16404557;;F;36;CHILENO;;Millenial;COLINA                        ;METROPOLITANA;164550;4;2;0;0;0;4;2;164550;Horno Electrico TH-25N01 25Lts;ELECTRODOMESTICOS
15741506;Soltero;F;38;CHILENO;;X;NIQUEN                        ;BIO BIO;98970;3;1;0;0;0;3;1;98970;ASPIRADORA THOMAS TH-1640;ELECTRODOMESTICOS
18594646;;F;28;CHILENO;;Millenial;N/D;N/D;21990;1;1;0;0;0;1;1;21990;Plancha UT-KERAMIK1 2200Watts Base Ceramica;ELECTRODOMESTICOS
9535828;Soltero;M;60;CHILENO;;Boomers;ANTOFAGASTA                   ;ANTOFAGASTA;112980;2;2;0;0;0;2;2;112980;HERVIDOR COLONIA 1,7 LITROS;ELECTRODOMESTICOS
17645990;;F;32;CHILENO;;Millenial;N/D;N/D;99980;2;2;0;0;0;2;2;99980;Aspiradora VCC4190V3E/XZS Arrastre 2000Watts;ELECTRODOMESTICOS
7556610;;F;68;CHILENO;;Boomers;RENGO                         ;L.G.B.OÂ´HIGGINS;164990;3;1;0;0;0;3;1;164990;MAQUINA COSER 2250;ELECTRODOMESTICOS
17306571;;F;32;CHILENO;;Millenial;"";"";94970;3;1;0;0;0;3;1;94970;Horno Electrico TH-48N 48Lts;ELECTRODOMESTICOS
10877607;;F;55;CHILENO;;Boomers;RANCAGUA                      ;L.G.B.OÂ´HIGGINS;345938;6;2;0;0;0;6;2;345938;Horno Electrico TH-100i 100Lts;ELECTRODOMESTICOS
6151757;;M;74;CHILENO;;Silencioso;PUERTO MONTT                  ;LOS LAGOS;50970;3;1;0;0;0;3;1;50970;Cafetera TH-138i;ELECTRODOMESTICOS
16568006;;F;35;CHILENO;;Millenial;PAINE;METROPOLITANA;91950;5;2;2;1;38980;3;1;52970;Plancha THOMAS TH-7170 2200Watts Base Ceramica;ELECTRODOMESTICOS
20616586;;F;21;CHILENO;;Z;QUINTA NORMAL;METROPOLITANA;53980;2;1;2;1;53980;0;0;0;Horno Microondas Digital MMP-20GC3D 20Lts;ELECTRODOMESTICOS
7830436;;F;67;CHILENO;;Boomers;N/D;N/D;39990;1;1;0;0;0;1;1;39990;Licuadora TH-501V 1,5Lts Vaso Vidrio;ELECTRODOMESTICOS
18247905;;M;29;CHILENO;;Millenial;PROVIDENCIA                   ;METROPOLITANA;30000;2;1;2;1;30000;0;0;0;Freidora de Aire 18M Oster;ELECTRODOMESTICOS
8602161;Viudo;F;62;CHILENO;;Boomers;RENCA                         ;METROPOLITANA;47990;1;1;0;0;0;1;1;47990;Horno Electrico TH-25N01 25Lts;ELECTRODOMESTICOS
26946430;;M;30;"";;Extranjero;"";"";26980;2;1;0;0;0;2;1;26980;Hervidor Inox One Midea;ELECTRODOMESTICOS
6005960;;M;76;CHILENO;;Silencioso;RENCA                         ;METROPOLITANA;39990;1;1;0;0;0;1;1;39990;Licuadora TH-501V 1,5Lts Vaso Vidrio;ELECTRODOMESTICOS
24879493;;F;39;COLOMBIANO;;Extranjero;CALAMA;ANTOFAGASTA;34990;1;1;0;0;0;1;1;34990;Licuadora TH-501V 1,5Lts Vaso Vidrio;ELECTRODOMESTICOS
8191258;;F;67;CHILENO;;Boomers;RENCA                         ;METROPOLITANA;309950;5;3;0;0;0;5;3;309950;Hervidor Electrico Tetera HA-4100 4Lts Iox;ELECTRODOMESTICOS
13641750;;F;42;CHILENO;;X;ALTO HOSPICIO;TARAPACA;221970;3;2;0;0;0;3;2;221970;Plancha a Vapor Oster 3803;ELECTRODOMESTICOS
10989201;Soltero;F;43;CHILENO;;X;LOS VILOS;COQUIMBO;90980;2;1;0;0;0;2;1;90980;Horno Microondas Digital TH20DM 20Lts Espejado;ELECTRODOMESTICOS
6684758;;M;70;CHILENO;;Silencioso;IQUIQUE                       ;TARAPACA;12990;1;1;0;0;0;1;1;12990;PLANCHA A VAPOR 4070 SUELA CERAMICA 2500W;ELECTRODOMESTICOS
12309992;Casado;M;49;CHILENO;ABOGADO;X;RENCA                         ;METROPOLITANA;71980;2;2;0;0;0;2;2;71980;Aspiradora TH1407 Arrastre 1400Watts;ELECTRODOMESTICOS
16494802;Casado;F;35;CHILENO;;Millenial;PROVIDENCIA                   ;METROPOLITANA;35990;1;1;0;0;0;1;1;35990;Batidora Vertical Minipimer UT-KLOT800SS;ELECTRODOMESTICOS
18690644;Soltero;M;28;CHILENO;;Millenial;PROVIDENCIA                   ;METROPOLITANA;9990;1;1;0;0;0;1;1;9990;Plancha a Vapor Oster 3803;ELECTRODOMESTICOS
17336279;Soltero;F;33;CHILENO;;Millenial;PROVIDENCIA                   ;METROPOLITANA;19990;1;1;0;0;0;1;1;19990;Hervidor Electrico TH-4515N 2Lts Negro;ELECTRODOMESTICOS
18509594;;M;29;CHILENO;;Millenial;PICHIDEGUA                    ;L.G.B.OÂ´HIGGINS;163960;4;2;0;0;0;4;2;163960;HORNO ELECTRICO HE-600IN INOX SINDELEN;ELECTRODOMESTICOS
11043923;;F;56;CHILENO;;Boomers;QUILPUE                       ;VALPARAISO;59990;2;1;0;0;0;2;1;59990;Horno Electrico UT-BACKOFEN26 26Lts;ELECTRODOMESTICOS
15116827;;F;35;CHILENO;;Millenial;SANTA CRUZ                    ;L.G.B.OÂ´HIGGINS;17990;1;1;0;0;0;1;1;17990;Hervidor Electrico UT-KLAR20PW 2Lts Blanco;ELECTRODOMESTICOS
7552019;;F;67;CHILENO;;Boomers;ILLAPEL                       ;COQUIMBO;211970;3;3;0;0;0;3;3;211970;Hervidor Electrico UT-MANLY17 1,7Lts Negro;ELECTRODOMESTICOS
9153418;;F;61;CHILENO;;Boomers;SANTIAGO                      ;METROPOLITANA;14990;1;1;0;0;0;1;1;14990;Batidora Vertical Stick Mixer 2609;ELECTRODOMESTICOS
7381693;;F;71;CHILENO;;Silencioso;SAN FELIPE                    ;VALPARAISO;585920;8;3;0;0;0;8;3;585920;HERVIDOR TH-4340;ELECTRODOMESTICOS
11654424;;F;52;CHILENO;;X;PUENTE ALTO                   ;METROPOLITANA;16990;1;1;0;0;0;1;1;16990;Sandwichera TH-952 2 Panes Blanca;ELECTRODOMESTICOS
10704913;;M;55;CHILENO;;Boomers;PAINE                         ;METROPOLITANA;16990;1;1;0;0;0;1;1;16990;Batidora Manual 3532;ELECTRODOMESTICOS
23086435;;F;61;PERUANO;;Extranjero;EL BOSQUE                     ;METROPOLITANA;27990;1;1;0;0;0;1;1;27990;Plancha THOMAS TH-7170 2200Watts Base Ceramica;ELECTRODOMESTICOS
8919659;;F;58;CHILENO;;Boomers;ANCUD                         ;LOS LAGOS;29990;1;1;0;0;0;1;1;29990;Licuadora Berry Blender Roja 1400 Vaso Vidrio;ELECTRODOMESTICOS
26186177;;M;37;COLOMBIANO;;Extranjero;N/D;N/D;363981;2;2;0;0;0;2;2;363981;LICUADORA CROMADA CON TECLAS PLUS;ELECTRODOMESTICOS
19411504;;F;25;CHILENO;;Millenial;"";"";20000;2;1;0;0;0;2;1;20000;Batidora Manual TH-8830;ELECTRODOMESTICOS
6765094;;F;75;CHILENO;;Silencioso;PROVIDENCIA                   ;METROPOLITANA;14990;1;1;0;0;0;1;1;14990;HERVIDOR HAMBURGO 2,0 LITROS;ELECTRODOMESTICOS
19661569;;F;24;CHILENO;;Z;RIO HURTADO                   ;COQUIMBO;17980;2;1;0;0;0;2;1;17980;Hervidor Electrico TH-4212N 1,7Lts Negro;ELECTRODOMESTICOS
13055842;;F;46;CHILENO;;X;RENCA                         ;METROPOLITANA;157980;2;1;0;0;0;2;1;157980;CAFETERA PRIMA LATTE 6603 ROJA;ELECTRODOMESTICOS
22147610;;F;74;PERUANO;;Extranjero;LO ESPEJO                     ;METROPOLITANA;16990;1;1;0;0;0;1;1;16990;HERVIDOR TH-4340;ELECTRODOMESTICOS
16109089;;F;36;CHILENO;;Millenial;LEBU                          ;BIO BIO;198970;3;2;0;0;0;3;2;198970;Horno Microondas Mecanico Fancy 20Lts;ELECTRODOMESTICOS
12992623;;M;48;CHILENO;;X;PANGUIPULLI                   ;LOS LAGOS;89990;1;1;0;0;0;1;1;89990;ASPIRADORA SAMSUNG VC18M3110VB/ZS;ELECTRODOMESTICOS
20166169;;F;23;CHILENO;;Z;"";"";76970;4;2;0;0;0;4;2;76970;Licuadora L2000VNG 1,5Lts Vaso Vidrio;ELECTRODOMESTICOS
4017346;;M;82;CHILENO;;Silencioso;EL BOSQUE                     ;METROPOLITANA;79990;1;3;0;0;0;1;3;79990;Horno Microondas Digital TH-20S01 20Lts;ELECTRODOMESTICOS
6725009;;F;66;CHILENO;;Boomers;PROVIDENCIA                   ;METROPOLITANA;49990;1;1;0;0;0;1;1;49990;Horno Electrico UT-BACKOFEN26 26Lts;ELECTRODOMESTICOS
10245005;;F;57;CHILENO;;Boomers;N/D;N/D;14990;1;1;0;0;0;1;1;14990;HERVIDOR HAMBURGO 2,0 LITROS;ELECTRODOMESTICOS
9324161;;M;59;CHILENO;;Boomers;VILLA ALEMANA                 ;VALPARAISO;59980;2;1;0;0;0;2;1;59980;Horno Electrico TH-25N01 25Lts;ELECTRODOMESTICOS
16413615;;F;35;CHILENO;;Millenial;SAN VICENTE                   ;L.G.B.OÂ´HIGGINS;29990;1;1;0;0;0;1;1;29990;Batidora Pedestal Bowl 300 Inox;ELECTRODOMESTICOS
7911627;;M;64;CHILENO;;Boomers;SAN VICENTE                   ;L.G.B.OÂ´HIGGINS;54990;1;1;0;0;0;1;1;54990;Aspiradora UT-SILENT1804 Arrastre 1800Watts;ELECTRODOMESTICOS
26882573;;F;27;EXTRANJERO - NO INFORMA NACIONALIDAD;;Extranjero;SAN MIGUEL                    ;METROPOLITANA;253970;3;2;3;2;253970;0;0;0;H MICROONDA MMP-23GABV 23L;ELECTRODOMESTICOS
8569923;Casado;M;64;CHILENO;;Boomers;RENCA                         ;METROPOLITANA;59990;1;1;0;0;0;1;1;59990;Licuadora Reversible Roja;ELECTRODOMESTICOS
8388614;;F;64;CHILENO;;Boomers;LOTA                          ;BIO BIO;85230;3;3;0;0;0;3;3;85230;Hervidor Electrico Tetera HA-4100 4Lts Iox;ELECTRODOMESTICOS
13776050;;F;41;CHILENO;;X;MAIPU                         ;METROPOLITANA;38980;2;1;0;0;0;2;1;38980;Licuadora Roja 550W 1,5Lts Vaso Vidrio;ELECTRODOMESTICOS
9306338;;F;62;CHILENO;;Boomers;PROVIDENCIA                   ;METROPOLITANA;49990;1;1;0;0;0;1;1;49990;Horno Microondas Mecanico TH-18B05 18Lts;ELECTRODOMESTICOS
10182726;;M;57;CHILENO;;Boomers;TALCAHUANO                    ;BIO BIO;30230;3;1;0;0;0;3;1;30230;Licuadora Berry Blender Roja 1400 Vaso Vidrio;ELECTRODOMESTICOS
9610119;;F;62;CHILENO;;Boomers;PROVIDENCIA                   ;METROPOLITANA;37980;2;2;0;0;0;2;2;37980;Plancha Easy Steam (PV4500);ELECTRODOMESTICOS
7988227;Casado;F;64;CHILENO;;Boomers;CERRO NAVIA                   ;METROPOLITANA;92970;4;1;0;0;0;4;1;92970;Horno Microondas Mecanico TH-18B05 18Lts;ELECTRODOMESTICOS
8921473;;F;50;CHILENO;;X;CARAHUE                       ;ARAUCANIA;349970;3;5;0;0;0;3;5;349970;Horno Microondas Digital TH-25DM 25Lts;ELECTRODOMESTICOS
11738359;;F;50;CHILENO;;X;SAN ANTONIO                   ;VALPARAISO;29220;4;2;0;0;0;4;2;29220;PLANCHA A VAPOR 4070 SUELA CERAMICA 2500W;ELECTRODOMESTICOS
17427830;;M;32;CHILENO;;Millenial;"";"";49990;1;1;0;0;0;1;1;49990;Horno Electrico TH-25N01 25Lts;ELECTRODOMESTICOS
20368618;;M;22;CHILENO;;Z;RANCAGUA;O HIGGINS;112970;3;1;0;0;0;3;1;112970;Olla Multiuso 6801 5,7Lts;ELECTRODOMESTICOS
18580706;;F;28;CHILENO;;Millenial;ILLAPEL                       ;COQUIMBO;35980;2;2;0;0;0;2;2;35980;Batidora Manual TH-8830;ELECTRODOMESTICOS
26532360;;M;33;CHILENO;;Extranjero;PUERTO MONTT                  ;LOS LAGOS;18990;1;1;0;0;0;1;1;18990;MULTIMIXER THOMAS TH- 8706;ELECTRODOMESTICOS
15166063;;F;40;CHILENO;;X;SAN IGNACIO                   ;BIO BIO;29990;1;1;0;0;0;1;1;29990;Combo Juguera + Hervidor;ELECTRODOMESTICOS
16316074;;M;36;CHILENO;;Millenial;N/D;N/D;519970;3;3;1;1;279990;2;2;239980;Horno Electrico TH62I 60Lts;ELECTRODOMESTICOS
16325988;;F;35;CHILENO;;Millenial;OVALLE                        ;COQUIMBO;29990;1;1;0;0;0;1;1;29990;Tostador de Pan TP-1400 4 Rebanadas Inox;ELECTRODOMESTICOS
16058602;;F;37;CHILENO;;Millenial;CALERA                        ;VALPARAISO;9990;1;1;0;0;0;1;1;9990;Plancha a Vapor Oster 3803;ELECTRODOMESTICOS
7609271;;F;65;CHILENO;;Boomers;SAN ANTONIO                   ;VALPARAISO;39990;1;1;0;0;0;1;1;39990;Aspiradora Handy Clean Black 1400;ELECTRODOMESTICOS
16570384;Casado;M;35;CHILENO;;Millenial;PROVIDENCIA                   ;METROPOLITANA;207960;4;2;4;2;207960;0;0;0;Horno Microondas Digital ME0113MB1/XZS 32Lts;ELECTRODOMESTICOS
6764175;;F;72;CHILENO;;Silencioso;QUILLOTA                      ;VALPARAISO;113681;2;2;0;0;0;2;2;113681;Batidora Manual BA-5010 Inox;ELECTRODOMESTICOS
6634188;;M;71;CHILENO;;Silencioso;ALTO HOSPICIO;TARAPACA;29990;1;1;0;0;0;1;1;29990;Licuadora Berry Blender Roja 1400 Vaso Vidrio;ELECTRODOMESTICOS
13563190;;M;43;CHILENO;;X;COLINA                        ;METROPOLITANA;27990;1;1;0;0;0;1;1;27990;Plancha UT-PLATTEISEN 2000Watts Base Ceramica;ELECTRODOMESTICOS
13742586;;M;41;CHILENO;;X;TOCOPILLA                     ;ANTOFAGASTA;173970;3;3;0;0;0;3;3;173970;Tostador de Pan TH-116 2 Rebanadas Negro;ELECTRODOMESTICOS
13850245;;M;42;CHILENO;;X;ANCUD                         ;LOS LAGOS;49990;1;1;0;0;0;1;1;49990;Aspiradora TH1407 Arrastre 1400Watts;ELECTRODOMESTICOS
12565866;;M;50;CHILENO;;X;GORBEA                        ;ARAUCANIA;17990;1;1;0;0;0;1;1;17990;Hervidor Electrico UT-KLAR20PW 2Lts Blanco;ELECTRODOMESTICOS
12980544;;F;46;CHILENO;;X;PROVIDENCIA                   ;METROPOLITANA;119990;1;1;1;1;119990;0;0;0;SUPER FREIDORA DE AIRE OV3;ELECTRODOMESTICOS
9165629;;M;58;CHILENO;;Boomers;RENCA                         ;METROPOLITANA;20990;1;1;0;0;0;1;1;20990;Hervidor Electrico TH-4515N 2Lts Negro;ELECTRODOMESTICOS
11281606;;F;54;CHILENO;;X;CHIMBARONGO                   ;L.G.B.OÂ´HIGGINS;119990;1;1;0;0;0;1;1;119990;MAQUINA COSER 2250;ELECTRODOMESTICOS
10878387;;F;51;CHILENO;;X;N/D;N/D;69990;1;1;0;0;0;1;1;69990;Batidora Pedestal TH910PN 4,6Lts 1300Watts;ELECTRODOMESTICOS
13112720;;F;46;CHILENO;;X;PADRE LAS CASAS               ;ARAUCANIA;39990;1;1;0;0;0;1;1;39990;Picadora TH-9020V Vaso Vidrio 2Lts;ELECTRODOMESTICOS
13259692;;M;45;CHILENO;;X;PROVIDENCIA                   ;METROPOLITANA;48980;2;1;2;1;48980;0;0;0;Batidora Vertical Minipimer UT-KLOT800SS;ELECTRODOMESTICOS
15440107;;M;40;CHILENO;;X;PROVIDENCIA                   ;METROPOLITANA;687910;9;2;0;0;0;9;2;687910;PROCESADOR THOMAS TH-9160;ELECTRODOMESTICOS
15193416;;F;39;CHILENO;;X;PROVIDENCIA                   ;METROPOLITANA;31990;1;1;0;0;0;1;1;31990;Licuadora TH-320 Roja/Negro 1,5 Lts Vaso Vidrio;ELECTRODOMESTICOS
19350812;;F;25;CHILENO;;Z;VALDIVIA                      ;LOS LAGOS;24980;2;2;0;0;0;2;2;24980;HERVIDOR COLONIA 1,7 LITROS;ELECTRODOMESTICOS
18974125;Soltero;F;26;CHILENO;;Z;PROVIDENCIA                   ;METROPOLITANA;20990;1;1;0;0;0;1;1;20990;Plancha UT-DUNST 2200Watts Base Ceramica;ELECTRODOMESTICOS
19899251;;M;23;CHILENO;;Z;N/D;N/D;629980;2;2;1;1;559990;1;1;69990;Horno Electrico TH-38N 38Lts;ELECTRODOMESTICOS
8813968;;M;59;CHILENO;;Boomers;PUERTO MONTT                  ;LOS LAGOS;29990;1;1;0;0;0;1;1;29990;HORNO ELECTRICO 16N01 16LTS NEGRO;ELECTRODOMESTICOS
13841813;;M;42;CHILENO;;X;NIQUEN                        ;BIO BIO;76970;3;3;0;0;0;3;3;76970;Cafetera UT-KAFFEEKLASSIK;ELECTRODOMESTICOS
19051684;;M;26;CHILENO;;Boomers;COIHAIQUE                     ;AYSEN;29980;2;1;0;0;0;2;1;29980;Licuadora Berry Blender Roja 1400 Vaso Vidrio;ELECTRODOMESTICOS
7838078;;F;64;CHILENO;;Boomers;RENCA                         ;METROPOLITANA;12990;1;1;0;0;0;1;1;12990;Hervidor Inox One Midea;ELECTRODOMESTICOS
17863618;Casado;M;31;CHILENO;;Millenial;PROVIDENCIA                   ;METROPOLITANA;64990;1;1;0;0;0;1;1;64990;Horno Microondas Digital TH-20S01 20Lts;ELECTRODOMESTICOS
10666011;;F;56;CHILENO;;Boomers;OVALLE                        ;COQUIMBO;22990;1;1;0;0;0;1;1;22990;Tostador de PanTH-120R 2 Rebanadas Rojo;ELECTRODOMESTICOS
5780187;;F;72;CHILENO;;Silencioso;INDEPENDENCIA                 ;METROPOLITANA;117970;3;1;0;0;0;3;1;117970;Horno Microondas Digital TH-25DM 25Lts;ELECTRODOMESTICOS
26382250;;M;35;VENEZOLANO;;Extranjero;ANTOFAGASTA                   ;ANTOFAGASTA;34990;1;1;0;0;0;1;1;34990;Licuadora Roja 550W 1,5Lts Vaso Vidrio;ELECTRODOMESTICOS
9546265;;F;61;CHILENO;;Boomers;CONCEPCION                    ;BIO BIO;131950;5;3;0;0;0;5;3;131950;Licuadora TH-501V 1,5Lts Vaso Vidrio;ELECTRODOMESTICOS
6450197;;F;77;CHILENO;;Silencioso;GORBEA                        ;ARAUCANIA;24990;1;1;0;0;0;1;1;24990;PICADORA 123 SILHQUETTE;ELECTRODOMESTICOS
12951340;;F;45;CHILENO;;X;PROVIDENCIA                   ;METROPOLITANA;14990;1;1;0;0;0;1;1;14990;Batidora Manual 3532;ELECTRODOMESTICOS
12048124;Casado;F;53;CHILENO;;X;RENCA                         ;METROPOLITANA;21990;1;1;0;0;0;1;1;21990;Licuadora L-1630V Negra 1,5Lts Vaso Vidrio;ELECTRODOMESTICOS
25556272;;M;34;HAITIANO;;Extranjero;SANTA CRUZ                    ;L.G.B.OÂ´HIGGINS;129640;5;2;0;0;0;5;2;129640;Horno Microondas Digital TH-20S01 20Lts;ELECTRODOMESTICOS
9888801;;M;58;CHILENO;;Boomers;LINARES                       ;MAULE;600960;4;4;4;2;600960;0;2;0;Horno Electrico TH-80i 80Lts;ELECTRODOMESTICOS
9425127;;F;60;CHILENO;;Boomers;EL BOSQUE                     ;METROPOLITANA;52980;2;2;0;0;0;2;2;52980;Picadora TH-9020V Vaso Vidrio 2Lts;ELECTRODOMESTICOS
13416598;Soltero;F;43;CHILENO;INGENIERO EN PREVENCION DE RIESGOS;X;PROVIDENCIA                   ;METROPOLITANA;19990;1;1;0;0;0;1;1;19990;Plancha TH-7052 2000Watts Base Inox;ELECTRODOMESTICOS
13047464;;M;46;CHILENO;;Millenial;"";"";29990;1;1;0;0;0;1;1;29990;Licuadora TH-501V 1,5Lts Vaso Vidrio;ELECTRODOMESTICOS
18214250;;F;30;CHILENO;;Millenial;PROVIDENCIA                   ;METROPOLITANA;17990;1;1;0;0;0;1;1;17990;Batidora Manual TH-8830;ELECTRODOMESTICOS
9608457;;M;46;CHILENO;;X;N/D;N/D;54980;2;3;0;0;0;2;3;54980;Batidora Vertical Minipimer UT-KLOT400P;ELECTRODOMESTICOS
8511401;Casado;F;65;CHILENO;;Boomers;RENCA                         ;METROPOLITANA;191960;4;4;0;0;0;4;4;191960;ASPIRADORA THOMAS TH-1640;ELECTRODOMESTICOS
6383389;Casado;F;68;CHILENO;;Boomers;RENCA                         ;METROPOLITANA;44980;2;1;0;0;0;2;1;44980;Licuadora Kaliman Negra con Teclas;ELECTRODOMESTICOS
3707909;;F;84;CHILENO;;Silencioso;QUILPUE                       ;VALPARAISO;57980;2;2;0;0;0;2;2;57980;Tostador de PanTH-120R 2 Rebanadas Rojo;ELECTRODOMESTICOS
16079421;;F;50;CHILENO;;X;RENCA                         ;METROPOLITANA;16990;1;1;0;0;0;1;1;16990;HERVIDOR TH-4340;ELECTRODOMESTICOS
5416494;;M;75;CHILENO;;Silencioso;N/D;N/D;49990;1;1;0;0;0;1;1;49990;ASPIRADORA THOMAS TH-1640;ELECTRODOMESTICOS
12069543;;F;53;CHILENO;;X;PROVIDENCIA                   ;METROPOLITANA;215470;4;2;2;1;85480;2;1;129990;Freidora de Aire Digital 40D;ELECTRODOMESTICOS
10799522;;F;55;CHILENO;;Boomers;SAN RAMON                     ;METROPOLITANA;48980;2;1;0;0;0;2;1;48980;Batidora Vertical Multimixer TH-8720;ELECTRODOMESTICOS
6512407;;M;68;CHILENO;;Silencioso;CHILLAN VIEJO                 ;BIO BIO;34990;1;1;0;0;0;1;1;34990;Licuadora Roja 550W 1,5Lts Vaso Vidrio;ELECTRODOMESTICOS
9850085;;M;52;CHILENO;;X;PROVIDENCIA                   ;METROPOLITANA;19990;1;1;0;0;0;1;1;19990;Plancha TH-7052 2000Watts Base Inox;ELECTRODOMESTICOS
9029022;;M;61;CHILENO;;Boomers;EL MONTE                      ;METROPOLITANA;96970;3;2;0;0;0;3;2;96970;Aspiradora TH1407 Arrastre 1400Watts;ELECTRODOMESTICOS
10083268;;M;63;CHILENO;;Boomers;PROVIDENCIA                   ;METROPOLITANA;109980;2;1;0;0;0;2;1;109980;Horno Electrico TH-38N 38Lts;ELECTRODOMESTICOS
7669790;;F;63;CHILENO;;Boomers;CASTRO                        ;LOS LAGOS;239950;5;3;0;0;0;5;3;239950;Cafetera UT-KAFFEEKLASSIK;ELECTRODOMESTICOS
25855366;;F;47;COLOMBIANO;;Extranjero;N/D;N/D;47980;2;1;2;1;47980;0;0;0;Horno Microondas Mecanico C1700N 17Lts Blanco;ELECTRODOMESTICOS
6706144;;F;67;CHILENO;;Boomers;NATALES                       ;MAGALLANES;14990;1;1;0;0;0;1;1;14990;PLANCHA A VAPOR 4070 SUELA CERAMICA 2500W;ELECTRODOMESTICOS
7704967;;F;67;CHILENO;;Boomers;PUENTE ALTO                   ;METROPOLITANA;9990;1;1;0;0;0;1;1;9990;Hervidor Electrico HE420 2lts Negro;ELECTRODOMESTICOS
13371601;;F;49;CHILENO;;X;RENCA                         ;METROPOLITANA;14990;1;1;0;0;0;1;1;14990;Batidora Vertical Stick Mixer 2609;ELECTRODOMESTICOS
10084700;Casado;F;58;CHILENO;CONTADOR GENERAL;Boomers;PROVIDENCIA                   ;METROPOLITANA;16990;1;1;0;0;0;1;1;16990;HERVIDOR TH-4340;ELECTRODOMESTICOS
19614974;;M;23;CHILENO;;Z;VILLA ALEMANA;VALPARAISO;204960;4;3;3;2;164970;1;1;39990;Freidora de Aire 18M Oster;ELECTRODOMESTICOS
14040139;;F;43;CHILENO;;X;PEUMO                         ;L.G.B.OÂ´HIGGINS;54980;2;2;0;0;0;2;2;54980;Batidora Manual BA-5010 Inox;ELECTRODOMESTICOS
9056421;;F;59;CHILENO;;Boomers;COIHAIQUE                     ;AYSEN;44980;2;1;0;0;0;2;1;44980;Picadora UT-PETRUS320 1Lts Vaso Vidrio;ELECTRODOMESTICOS
9945209;Casado;F;54;CHILENO;;X;RENCA                         ;METROPOLITANA;29990;1;1;0;0;0;1;1;29990;Combo Licuadora + Batidora;ELECTRODOMESTICOS
13835224;;M;42;CHILENO;;X;N/D;N/D;22980;2;1;0;0;0;2;1;22980;Hervidor Inox One Midea;ELECTRODOMESTICOS
12043454;;F;60;CHILENO;;Boomers;RENCA                         ;METROPOLITANA;83980;2;1;0;0;0;2;1;83980;Horno Electrico TH-38N 38Lts;ELECTRODOMESTICOS
6809964;;F;68;CHILENO;;Silencioso;SAN JOAQUIN                   ;METROPOLITANA;53980;2;1;0;0;0;2;1;53980;Aspiradora TH1415 Arrastre 1500Watts;ELECTRODOMESTICOS
17913292;;M;31;CHILENO;;Millenial;LOS ANGELES                   ;BIO BIO;24990;1;1;0;0;0;1;1;24990;Batidora Manual BA-5010 Inox;ELECTRODOMESTICOS
10826343;;F;55;CHILENO;;Boomers;MELIPILLA                     ;METROPOLITANA;244980;2;2;0;0;0;2;2;244980;Horno Electrico TH-100i 100Lts;ELECTRODOMESTICOS
11931346;;F;50;CHILENO;;X;ANTOFAGASTA                   ;ANTOFAGASTA;16990;1;1;0;0;0;1;1;16990;Batidora Manual 3532;ELECTRODOMESTICOS
13647021;Soltero;F;43;CHILENO;;X;RENCA                         ;METROPOLITANA;53980;2;1;0;0;0;2;1;53980;Aspiradora AP1700 Arrastre 1700Watts;ELECTRODOMESTICOS
19266536;;F;26;CHILENO;;Z;ALTO HOSPICIO;TARAPACA;116980;2;2;0;0;0;2;2;116980;Combo Hervidor + Batidora;ELECTRODOMESTICOS
7728140;;M;66;CHILENO;;Boomers;CORONEL                       ;BIO BIO;94990;1;1;0;0;0;1;1;94990;Batidora Pedestal TH910PN 4,6Lts 1300Watts;ELECTRODOMESTICOS
17681916;;F;30;CHILENO;;Millenial;SAN BERNARDO                  ;METROPOLITANA;79990;1;1;0;0;0;1;1;79990;Horno Microondas Digital TH-20S01 20Lts;ELECTRODOMESTICOS
16758288;;M;34;CHILENO;;Millenial;PROVIDENCIA                   ;METROPOLITANA;19990;1;1;0;0;0;1;1;19990;Tostador de PanTH-120R 2 Rebanadas Rojo;ELECTRODOMESTICOS
10448081;Casado;F;59;CHILENO;;Boomers;RENCA                         ;METROPOLITANA;41990;1;1;0;0;0;1;1;41990;Procesador TH-9010 Multimixer 1,5Lts Vaso Vidrio;ELECTRODOMESTICOS
5337116;;M;77;CHILENO;;Silencioso;PROVIDENCIA                   ;METROPOLITANA;43990;1;1;0;0;0;1;1;43990;Licuadora TH-401V Roja 1,75Lts Vaso Vidrio;ELECTRODOMESTICOS
11768639;;F;54;CHILENO;;Boomers;SAN CARLOS                    ;BIO BIO;402824;7;6;0;0;0;7;6;402824;Picadora TH-9020V Vaso Vidrio 2Lts;ELECTRODOMESTICOS
10039774;;F;58;CHILENO;;Boomers;ANGOL                         ;ARAUCANIA;30990;1;1;0;0;0;1;1;30990;Plancha THOMAS TH-7170 2200Watts Base Ceramica;ELECTRODOMESTICOS
25673705;;M;33;HAITIANO;;Extranjero;N/D;N/D;456860;3;2;0;0;0;3;2;456860;Licuadora Kaliman Negra con Teclas;ELECTRODOMESTICOS
5596165;;F;70;CHILENO;;Silencioso;VINA DEL MAR                  ;VALPARAISO;12990;1;1;0;0;0;1;1;12990;Hervidor Inox One Midea;ELECTRODOMESTICOS
12935511;;F;46;CHILENO;;X;PROVIDENCIA                   ;METROPOLITANA;28990;1;1;0;0;0;1;1;28990;Hervidor Electrico UT-REIN17SS;ELECTRODOMESTICOS
6337377;Casado;M;72;CHILENO;;Silencioso;RENCA                         ;METROPOLITANA;43990;1;1;0;0;0;1;1;43990;Licuadora TH-401V Roja 1,75Lts Vaso Vidrio;ELECTRODOMESTICOS
12976839;Casado;M;45;CHILENO;;X;RENCA                         ;METROPOLITANA;53980;2;1;0;0;0;2;1;53980;Aspiradora TH1407 Arrastre 1400Watts;ELECTRODOMESTICOS
17141659;;F;34;CHILENO;;Millenial;PROVIDENCIA                   ;METROPOLITANA;54990;1;1;0;0;0;1;1;54990;Aspiradora UT-SILENT1804 Arrastre 1800Watts;ELECTRODOMESTICOS
12718094;;M;47;CHILENO;;X;ILLAPEL                       ;COQUIMBO;20990;1;1;0;0;0;1;1;20990;Hervidor Electrico UT-DUNKEL17P 2Lts Negro;ELECTRODOMESTICOS
13643544;;F;43;CHILENO;;X;RENCA                         ;METROPOLITANA;19990;1;1;0;0;0;1;1;19990;Combo Hervidor + Batidora;ELECTRODOMESTICOS
9809747;;F;59;CHILENO;;Boomers;REQUINOA                      ;L.G.B.OÂ´HIGGINS;64990;1;1;0;0;0;1;1;64990;Horno Microondas Digital UT-CLASSY720 20Lts;ELECTRODOMESTICOS
14687607;Soltero;F;70;PERUANO;;Silencioso;MELIPILLA                     ;METROPOLITANA;29990;1;1;0;0;0;1;1;29990;Hervidor Electrico Tetera HA-4100 4Lts Iox;ELECTRODOMESTICOS
17493484;Soltero;M;31;CHILENO;ADMINISTRADOR PUBLICO;Millenial;RENCA                         ;METROPOLITANA;189980;2;2;1;1;169990;1;1;19990;Set Hervidor Valory VK330 Blanco + Tostador de;ELECTRODOMESTICOS
13077849;;M;46;CHILENO;;X;RANCAGUA                      ;L.G.B.OÂ´HIGGINS;54990;1;1;0;0;0;1;1;54990;Aspiradora UT-SILENT1804 Arrastre 1800Watts;ELECTRODOMESTICOS
19511886;;F;24;CHILENO;;Z;"";"";115960;4;2;2;1;36980;2;1;78980;Procesador TH-9010 Multimixer 1,5Lts Vaso Vidrio;ELECTRODOMESTICOS
10497888;;M;51;CHILENO;;X;LEBU                          ;BIO BIO;127060;3;3;0;0;0;3;3;127060;Combo Hervidor + Batidora;ELECTRODOMESTICOS
8645180;;F;65;CHILENO;;Boomers;VALDIVIA                      ;LOS LAGOS;348850;4;2;0;0;0;4;2;348850;Aspiradora TH1407 Arrastre 1400Watts;ELECTRODOMESTICOS
19865399;;M;24;CHILENO;;Z;N/D;N/D;94980;2;1;0;0;0;2;1;94980;Horno Microondas Mecanico M-2020NG 20Lts;ELECTRODOMESTICOS
19138171;;F;27;CHILENO;;Millenial;N/D;N/D;52980;2;2;0;0;0;2;2;52980;Hervidor Electrico Tetera TH-6505RT 1,7Lts Rojo;ELECTRODOMESTICOS
16425819;;F;35;CHILENO;;Millenial;PROVIDENCIA                   ;METROPOLITANA;139980;2;2;0;0;0;2;2;139980;Horno Microondas Mecanico Easy Wave 20Lts;ELECTRODOMESTICOS
6393068;;F;70;CHILENO;;Silencioso;ARICA                         ;ARICA Y PARINACOTA;71980;2;2;0;0;0;2;2;71980;PROCESADOR THOMAS TH-9160;ELECTRODOMESTICOS
4737071;;M;77;CHILENO;;Silencioso;PROVIDENCIA                   ;METROPOLITANA;14990;1;1;0;0;0;1;1;14990;Batidora Vertical Stick Mixer 2609;ELECTRODOMESTICOS
26054087;;M;27;EXTRANJERO - NO INFORMA NACIONALIDAD;;Extranjero;"";"";380950;5;2;0;0;0;5;2;380950;Horno Microondas Digital TH20DM 20Lts Espejado;ELECTRODOMESTICOS
7028919;;F;70;CHILENO;;Silencioso;VALDIVIA                      ;LOS RIOS;24990;1;1;0;0;0;1;1;24990;Tostador de PanTH-120R 2 Rebanadas Rojo;ELECTRODOMESTICOS
7869914;;M;63;CHILENO;;Boomers;N/D;N/D;69990;1;1;0;0;0;1;1;69990;Aspiradora TH1870 Arrastre 1800Watts Gris;ELECTRODOMESTICOS
16063313;;F;37;CHILENO;;Millenial;LOS ANGELES                   ;BIO BIO;84990;1;1;0;0;0;1;1;84990;Horno Electrico UT-BACKOFEN38 38Lts;ELECTRODOMESTICOS
17833891;;F;31;CHILENO;;Millenial;PROVIDENCIA                   ;METROPOLITANA;38980;2;1;2;1;38980;0;0;0;Set Picador KP-123BL 1,2Lts;ELECTRODOMESTICOS
11824875;;F;51;CHILENO;;X;"";"";16990;1;1;0;0;0;1;1;16990;HERVIDOR TH-4340;ELECTRODOMESTICOS
6525258;;F;72;CHILENO;;Silencioso;RENCA                         ;METROPOLITANA;34990;1;1;0;0;0;1;1;34990;Cafetera UT-KAFFEEKLASSIK;ELECTRODOMESTICOS
19345853;Soltero;M;26;CHILENO;;Z;PROVIDENCIA                   ;METROPOLITANA;54990;1;1;0;0;0;1;1;54990;Horno Electrico TH-25N01 25Lts;ELECTRODOMESTICOS
14904350;;F;40;CHILENO;;X;COQUIMBO                      ;COQUIMBO;34990;1;1;0;0;0;1;1;34990;Aspiradora AP1700 Arrastre 1700Watts;ELECTRODOMESTICOS
13152130;;M;45;CHILENO;;Silencioso;PROVIDENCIA                   ;METROPOLITANA;19990;1;1;0;0;0;1;1;19990;Hervidor Electrico TH-5407i 2Lts;ELECTRODOMESTICOS
15672918;;M;39;CHILENO;;X;N/D;N/D;54970;3;3;0;0;0;3;3;54970;Horno Electrico UT-BACKOFEN48 48Lts;ELECTRODOMESTICOS
19404045;;M;26;CHILENO;;Z;SAN ANTONIO                   ;VALPARAISO;69990;1;1;0;0;0;1;1;69990;ASPIRADORA SAMSUNG VC18M3110VB/ZS;ELECTRODOMESTICOS
23768581;;M;36;BOLIVIANO;;Extranjero;CALAMA                        ;ANTOFAGASTA;274980;3;2;0;0;0;3;2;274980;Licuadora Osterizer 4112/72 1,25Lts Vaso Vidrio;ELECTRODOMESTICOS
18517569;;M;29;CHILENO;;Millenial;N/D;N/D;84980;2;1;0;0;0;2;1;84980;Horno Microondas Mecanico TH-18B05 18Lts;ELECTRODOMESTICOS
10176304;;M;58;CHILENO;;Boomers;PROVIDENCIA                   ;METROPOLITANA;54990;1;1;0;0;0;1;1;54990;Aspiradora UT-SILENT1603 Arrastre 1600Watts;ELECTRODOMESTICOS
17484022;;M;32;CHILENO;;Millenial;"";"";14990;1;1;0;0;0;1;1;14990;Hervidor Electrico HA-3300 2,5Lts Blanco;ELECTRODOMESTICOS
16270726;;F;36;CHILENO;;Millenial;TALCA                         ;MAULE;153980;2;1;0;0;0;2;1;153980;Aspiradora Trapeadora Robot Ut-Excellenza (B);ELECTRODOMESTICOS
12086662;;M;43;CHILENO;;X;"";"";39990;1;1;0;0;0;1;1;39990;Plancha Paninis 2880;ELECTRODOMESTICOS
26746383;;M;42;VENEZOLANO;;Extranjero;PROVIDENCIA                   ;METROPOLITANA;16980;2;1;2;1;16980;0;0;0;PLANCHA A VAPOR 4070 SUELA CERAMICA 2500W;ELECTRODOMESTICOS
12927708;;M;46;CHILENO;;X;LAUTARO                       ;ARAUCANIA;77763;4;2;0;0;0;4;2;77763;Licuadora Roja 550W 1,5Lts Vaso Vidrio;ELECTRODOMESTICOS
18309289;;F;53;CHILENO;;X;NATALES                       ;MAGALLANES;192960;4;3;0;0;0;4;3;192960;Hervidor Electrico Tetera UT-LECKER18R 1,8Lts;ELECTRODOMESTICOS
18232033;;F;29;CHILENO;;Millenial;COMBARBALA;COQUIMBO;59990;1;1;0;0;0;1;1;59990;PROCESADOR DE ALIMENTOS UT-PROCESSOR750;ELECTRODOMESTICOS
8750733;;F;64;CHILENO;;Boomers;N/D;N/D;29990;1;1;0;0;0;1;1;29990;Licuadora L-5500IN 1,5Lts;ELECTRODOMESTICOS
7485884;;F;69;CHILENO;;Silencioso;QUELLON                       ;LOS LAGOS;181980;2;2;0;0;0;2;2;181980;Tostador de Pan TH-126 4 Rebanadas Negro;ELECTRODOMESTICOS
13339079;;M;44;CHILENO;;Millenial;N/D;N/D;21540;2;1;2;1;21540;0;0;0;PLANCHA A VAPOR 4070 SUELA CERAMICA 2500W;ELECTRODOMESTICOS
13286343;;F;46;CHILENO;;X;N/D;N/D;53980;2;1;0;0;0;2;1;53980;Aspiradora Handy Clean Black 1400;ELECTRODOMESTICOS
10980361;;F;59;CHILENO;;Boomers;RETIRO                        ;MAULE;73980;2;2;0;0;0;2;2;73980;Hervidor Electrico Tetera TH-6505RT 1,7Lts Rojo;ELECTRODOMESTICOS
8165425;;F;64;CHILENO;;Boomers;LIMACHE                       ;VALPARAISO;63980;2;1;0;0;0;2;1;63980;Batidora Pedestal Bowl 300 Inox;ELECTRODOMESTICOS
6433919;;F;74;CHILENO;;Silencioso;CALAMA                        ;ANTOFAGASTA;24990;1;1;0;0;0;1;1;24990;Licuadora L2000VNG 1,5Lts Vaso Vidrio;ELECTRODOMESTICOS
18973055;;F;27;CHILENO;;Millenial;LOS ANDES                     ;VALPARAISO;12990;1;1;1;1;12990;0;0;0;PLANCHA A VAPOR 4070 SUELA CERAMICA 2500W;ELECTRODOMESTICOS
18613727;;M;28;CHILENO;;Millenial;N/D;N/D;27990;1;1;0;0;0;1;1;27990;Hervidor Electrico Tetera UT-LECKER18R 1,8Lts;ELECTRODOMESTICOS
15202853;;F;40;CHILENO;;X;TIRUA                         ;BIO BIO;222970;3;2;0;0;0;3;2;222970;Hervidor Electrico Tetera HA-4100 4Lts Iox;ELECTRODOMESTICOS
15849307;;M;37;CHILENO;;Millenial;OVALLE                        ;COQUIMBO;29990;1;1;0;0;0;1;1;29990;Licuadora UT-METALLEK505P 1,5Lts Vaso Vidrio;ELECTRODOMESTICOS
5036467;;M;76;CHILENO;;Silencioso;"";"";64990;1;3;0;0;0;1;3;64990;Horno Microondas Digital TH20DM 20Lts Espejado;ELECTRODOMESTICOS
16884024;;F;33;CHILENO;;Millenial;N/D;N/D;59540;2;1;2;1;59540;0;0;0;Freidora de Aire 18M Oster;ELECTRODOMESTICOS
11697245;;M;51;CHILENO;;X;MELIPILLA                     ;METROPOLITANA;27990;1;1;0;0;0;1;1;27990;Picadora UT-PETRUS320 1Lts Vaso Vidrio;ELECTRODOMESTICOS
7005747;Casado;F;66;CHILENO;PROFESOR;Boomers;PROVIDENCIA                   ;METROPOLITANA;17990;1;1;0;0;0;1;1;17990;Hervidor Electrico UT-KLAR20PW 2Lts Blanco;ELECTRODOMESTICOS
11290725;;F;54;CHILENO;;X;TALCAHUANO                    ;BIO BIO;884820;4;3;2;1;795840;2;2;88980;Horno Electrico TH-25N01 25Lts;ELECTRODOMESTICOS
8591998;;F;65;CHILENO;;Boomers;OVALLE                        ;COQUIMBO;124960;4;4;0;0;0;4;4;124960;Parrilla Electrica M18W;ELECTRODOMESTICOS
6730283;;M;69;CHILENO;;Silencioso;SANTA CRUZ                    ;L.G.B.OÂ´HIGGINS;59990;1;1;0;0;0;1;1;59990;Horno Microondas Digital TH-20S01 20Lts;ELECTRODOMESTICOS
12362786;;F;49;CHILENO;;X;MAIPU                         ;METROPOLITANA;19990;1;1;0;0;0;1;1;19990;Hervidor Electrico UT-DUNKEL17P 2Lts Negro;ELECTRODOMESTICOS
11537143;;M;52;CHILENO;;X;RENCA                         ;METROPOLITANA;79990;1;1;0;0;0;1;1;79990;Aspiradora TH1870 Arrastre 1800Watts Gris;ELECTRODOMESTICOS
9629173;;F;54;CHILENO;;X;N/D;N/D;159980;2;2;0;0;0;2;2;159980;FREIDORA DE AIRE THOMAS TH-AF60Mi;ELECTRODOMESTICOS
6297386;;F;62;CHILENO;;Boomers;SAN BERNARDO                  ;METROPOLITANA;17990;1;1;0;0;0;1;1;17990;Hervidor Electrico UT-KLAR20PW 2Lts Blanco;ELECTRODOMESTICOS
20252761;;F;22;CHILENO;;Z;N/D;N/D;74970;3;3;0;0;0;3;3;74970;Licuadora L1000 Inox 1,7LtsVaso Vidrio;ELECTRODOMESTICOS
14367570;;M;47;CHILENO;;X;RENCA                         ;METROPOLITANA;21990;1;1;0;0;0;1;1;21990;Licuadora L-1630V Negra 1,5Lts Vaso Vidrio;ELECTRODOMESTICOS
10556851;Casado;M;54;CHILENO;AGRONOMO;Boomers;RENCA                         ;METROPOLITANA;352640;5;3;0;0;0;5;3;352640;HORNO ELECTRICO 16N01 16LTS NEGRO;ELECTRODOMESTICOS
10167823;;M;58;CHILENO;;Boomers;RENCA                         ;METROPOLITANA;29990;1;1;0;0;0;1;1;29990;Hervidor Electrico Tetera HA-4100 4Lts Iox;ELECTRODOMESTICOS
15713815;;F;38;CHILENO;;X;MARCHIHUE                     ;L.G.B.OÂ´HIGGINS;510630;6;2;0;0;0;6;2;510630;Licuadora TH-401V Roja 1,75Lts Vaso Vidrio;ELECTRODOMESTICOS
13704079;;F;43;CHILENO;;X;SAN RAMON                     ;METROPOLITANA;21990;1;1;0;0;0;1;1;21990;Hervidor Electrico TH-4515N 2Lts Negro;ELECTRODOMESTICOS
11517160;;M;51;CHILENO;;X;PUTAENDO                      ;VALPARAISO;267420;10;4;0;0;0;10;4;267420;Licuadora TH-320 Roja/Negro 1,5 Lts Vaso Vidrio;ELECTRODOMESTICOS
10144371;;F;55;CHILENO;;Boomers;CANETE                        ;BIO BIO;89990;1;1;0;0;0;1;1;89990;Horno Electrico TH-38N 38Lts;ELECTRODOMESTICOS
8769769;;F;62;CHILENO;;Boomers;IQUIQUE                       ;TARAPACA;64990;1;1;0;0;0;1;1;64990;Aspiradora AP3400 Arrastre 2000Watts;ELECTRODOMESTICOS
7227752;;M;67;CHILENO;;Boomers;PUENTE ALTO                   ;METROPOLITANA;39990;1;1;0;0;0;1;1;39990;Procesador TH-9010 Multimixer 1,5Lts Vaso Vidrio;ELECTRODOMESTICOS
8855478;;M;56;CHILENO;;Boomers;PROVIDENCIA                   ;METROPOLITANA;64990;1;1;0;0;0;1;1;64990;Aspiradora AP3400 Arrastre 2000Watts;ELECTRODOMESTICOS
18373756;Soltero;F;28;CHILENO;;Millenial;PROVIDENCIA                   ;METROPOLITANA;69990;1;1;1;1;69990;0;0;0;Horno Microondas Digital TH-20S01 20Lts;ELECTRODOMESTICOS
16054643;;M;36;CHILENO;;Millenial;CHONCHI                       ;LOS LAGOS;221980;2;2;0;0;0;2;2;221980;Hervidor Electrico Tetera HA-4100 4Lts Iox;ELECTRODOMESTICOS
16896118;;F;34;CHILENO;;Millenial;N/D;N/D;164980;3;2;0;0;0;3;2;164980;Tostador de Pan TP-1400 4 Rebanadas Inox;ELECTRODOMESTICOS
11311761;;F;53;CHILENO;;X;PICHILEMU                     ;L.G.B.OÂ´HIGGINS;324500;6;2;2;1;244540;4;1;79960;PLANCHA VAPOR TH-7146;ELECTRODOMESTICOS
10337235;;F;53;CHILENO;;X;CURACAUTIN                    ;ARAUCANIA;21990;1;1;0;0;0;1;1;21990;Hervidor Electrico UT-DUNKEL17P 2Lts Negro;ELECTRODOMESTICOS
9544027;;M;55;CHILENO;;Boomers;RIO IBANEZ                    ;AYSEN;24990;1;1;0;0;0;1;1;24990;Hervidor Electrico TH-4515N 2Lts Negro;ELECTRODOMESTICOS
14461649;;F;47;CHILENO;;X;ANCUD                         ;LOS LAGOS;19990;1;1;0;0;0;1;1;19990;Hervidor Electrico TH-4515N 2Lts Negro;ELECTRODOMESTICOS
26524605;;M;45;EXTRANJERO - NO INFORMA NACIONALIDAD;;Extranjero;N/D;N/D;31980;2;2;0;0;0;2;2;31980;Batidora Manual 3532;ELECTRODOMESTICOS
19556063;;F;24;CHILENO;;Z;MARIQUINA                     ;LOS LAGOS;69990;1;1;0;0;0;1;1;69990;Aspiradora TH1870 Arrastre 1800Watts Gris;ELECTRODOMESTICOS
7093765;;F;70;CHILENO;;Silencioso;N/D;N/D;41990;1;1;0;0;0;1;1;41990;Procesador TH-9010 Multimixer 1,5Lts Vaso Vidrio;ELECTRODOMESTICOS
16510711;;F;36;CHILENO;;Millenial;ANGOL                         ;ARAUCANIA;32990;1;1;0;0;0;1;1;32990;Combo Juguera + Hervidor;ELECTRODOMESTICOS
19223674;;M;26;CHILENO;;Z;PANGUIPULLI                   ;LOS RIOS;64990;1;1;0;0;0;1;1;64990;Horno Microondas Digital TH20DM 20Lts Espejado;ELECTRODOMESTICOS
12210215;;M;50;CHILENO;;X;ANTOFAGASTA                   ;ANTOFAGASTA;27990;1;1;0;0;0;1;1;27990;Hervidor Electrico Tetera TH-6505RT 1,7Lts Rojo;ELECTRODOMESTICOS
12839378;;M;47;CHILENO;;X;PROVIDENCIA                   ;METROPOLITANA;74990;1;1;0;0;0;1;1;74990;Horno Microondas Digital TH-20S01 20Lts;ELECTRODOMESTICOS
13085523;;F;45;CHILENO;;X;"";"";19990;1;1;0;0;0;1;1;19990;Hervidor Electrico UT-DUNKEL17P 2Lts Negro;ELECTRODOMESTICOS
18736787;Soltero;F;28;CHILENO;;Millenial;PROVIDENCIA                   ;METROPOLITANA;21990;1;1;0;0;0;1;1;21990;Licuadora TH-320 Roja/Negro 1,5 Lts Vaso Vidrio;ELECTRODOMESTICOS
9535784;;F;61;CHILENO;;Boomers;VICTORIA                      ;ARAUCANIA;27990;1;1;0;0;0;1;1;27990;BATIDORA MANUAL 260R;ELECTRODOMESTICOS
17802332;;F;33;CHILENO;;Millenial;ERCILLA                       ;ARAUCANIA;21990;1;1;0;0;0;1;1;21990;Licuadora Berry Blender Roja 1400 Vaso Vidrio;ELECTRODOMESTICOS
19520560;;M;25;CHILENO;;Z;ARICA                         ;ARICA Y PARINACOTA;25990;1;1;0;0;0;1;1;25990;Combo Licuadora + Batidora;ELECTRODOMESTICOS
18959483;Soltero;F;27;CHILENO;;Z;PROVIDENCIA                   ;METROPOLITANA;98970;3;1;0;0;0;3;1;98970;Licuadora TH-501V 1,5Lts Vaso Vidrio;ELECTRODOMESTICOS
10305230;;F;55;CHILENO;;Boomers;VICTORIA                      ;ARAUCANIA;51182;2;2;0;0;0;2;2;51182;Licuadora TH-401V Roja 1,75Lts Vaso Vidrio;ELECTRODOMESTICOS
15358704;;M;39;CHILENO;;X;PROVIDENCIA                   ;METROPOLITANA;53980;2;1;2;1;53980;0;0;0;Molinillo de Cafe Delonghi KG89;ELECTRODOMESTICOS
26713519;Soltero;M;46;EXTRANJERO - NO INFORMA NACIONALIDAD;;Extranjero;"";"";34990;1;1;0;0;0;1;1;34990;Licuadora Kaliman Negra con Teclas;ELECTRODOMESTICOS
11647426;;F;52;CHILENO;;X;PUENTE ALTO                   ;METROPOLITANA;25990;1;2;0;0;0;1;2;25990;Combo Hervidor + Tostador + Sandwichera;ELECTRODOMESTICOS
7809946;;F;66;CHILENO;;Boomers;LINARES                       ;MAULE;34990;1;1;0;0;0;1;1;34990;Licuadora TH-401V Roja 1,75Lts Vaso Vidrio;ELECTRODOMESTICOS
10090862;;F;57;CHILENO;;Boomers;NO APLICA;N/D;27990;1;1;0;0;0;1;1;27990;Plancha THOMAS TH-7170 2200Watts Base Ceramica;ELECTRODOMESTICOS
8286657;;F;79;CHILENO;;Silencioso;RENCA                         ;METROPOLITANA;78980;2;1;0;0;0;2;1;78980;Aspiradora TH1415 Arrastre 1500Watts;ELECTRODOMESTICOS
18213307;;F;29;CHILENO;;Millenial;PROVIDENCIA                   ;METROPOLITANA;64990;1;1;0;0;0;1;1;64990;Horno Microondas Mecanico UT-SYDNEY18 18Lts;ELECTRODOMESTICOS
14014197;Casado;F;40;CHILENO;TECNICO DE NIVEL SUPERIOR EN ENFERMERIA;X;PROVIDENCIA                   ;METROPOLITANA;19990;1;1;0;0;0;1;1;19990;Licuadora L-1630V Negra 1,5Lts Vaso Vidrio;ELECTRODOMESTICOS
20149267;;M;29;CHILENO;;Millenial;"";"";209980;2;2;0;0;0;2;2;209980;Cafetera TH-130;ELECTRODOMESTICOS
15819209;;F;37;CHILENO;;Millenial;LOS ANDES                     ;VALPARAISO;17990;1;1;0;0;0;1;1;17990;Hervidor Electrico TH-4515N 2Lts Negro;ELECTRODOMESTICOS
19293031;;F;26;CHILENO;;Z;PROVIDENCIA                   ;METROPOLITANA;84990;1;1;0;0;0;1;1;84990;Batidora Pedestal UT-KLEIN700;ELECTRODOMESTICOS
7674681;;F;72;CHILENO;;Silencioso;NATALES                       ;MAGALLANES;49990;1;1;0;0;0;1;1;49990;Horno Electrico UT-BACKOFEN26 26Lts;ELECTRODOMESTICOS
13264774;;M;45;CHILENO;;X;N/D;N/D;195980;2;1;0;0;0;2;1;195980;Maquina de Coser 311;ELECTRODOMESTICOS
9512530;;M;59;CHILENO;;Boomers;PETORCA                       ;VALPARAISO;36990;1;1;0;0;0;1;1;36990;Procesador TH-9010 Multimixer 1,5Lts Vaso Vidrio;ELECTRODOMESTICOS
12965918;Casado;F;45;CHILENO;;X;RENCA                         ;METROPOLITANA;60000;1;1;0;0;0;1;1;60000;Producto Segunda Seleccion Banda 8;ELECTRODOMESTICOS
10809099;;F;52;CHILENO;;X;PROVIDENCIA                   ;METROPOLITANA;32990;1;1;0;0;0;1;1;32990;Licuadora L-5500IN 1,5Lts;ELECTRODOMESTICOS
8640404;;M;48;CHILENO;;X;"";"";49990;1;1;0;0;0;1;1;49990;Horno Microondas Mecanico TH-18B05 18Lts;ELECTRODOMESTICOS
11353146;;F;54;CHILENO;;X;CORONEL                       ;BIO BIO;20990;1;1;0;0;0;1;1;20990;Hervidor Electrico TH-5407i 2Lts;ELECTRODOMESTICOS
15103997;Viudo;F;40;CHILENO;;X;REQUINOA                      ;L.G.B.OÂ´HIGGINS;69990;1;1;0;0;0;1;1;69990;Horno electrico Black Oven 42lts;ELECTRODOMESTICOS
17147190;;F;33;CHILENO;;Millenial;SAN JAVIER                    ;MAULE;148460;6;3;3;2;58470;3;1;89990;Horno Microondas Mecanico TH-18B05 18Lts;ELECTRODOMESTICOS
8003542;Casado;F;64;CHILENO;;Boomers;PROVIDENCIA                   ;METROPOLITANA;34990;1;1;0;0;0;1;1;34990;Licuadora TH-401V Roja 1,75Lts Vaso Vidrio;ELECTRODOMESTICOS
11826770;;F;50;CHILENO;;X;RENCA                         ;METROPOLITANA;69990;1;1;0;0;0;1;1;69990;Aspiradora UT-SILENT1804 Arrastre 1800Watts;ELECTRODOMESTICOS
9238608;Casado;F;57;CHILENO;;Boomers;PROVIDENCIA                   ;METROPOLITANA;49990;1;1;0;0;0;1;1;49990;Batidora Vertical Minipimer UT-KLOT800SS;ELECTRODOMESTICOS
19209285;;F;25;CHILENO;;Z;PUENTE ALTO                   ;METROPOLITANA;46980;2;1;0;0;0;2;1;46980;Licuadora L2000VNG 1,5Lts Vaso Vidrio;ELECTRODOMESTICOS
10561382;;M;55;CHILENO;;Boomers;ALHUE                         ;METROPOLITANA;86980;2;1;0;0;0;2;1;86980;Aspiradora TH1870 Arrastre 1800Watts Gris;ELECTRODOMESTICOS
14087626;;F;43;CHILENO;;X;PROVIDENCIA                   ;METROPOLITANA;44990;1;1;0;0;0;1;1;44990;Horno Microondas Mecanico Easy Wave 20Lts;ELECTRODOMESTICOS
15386458;;M;37;CHILENO;;Millenial;RENCA                         ;METROPOLITANA;34990;1;1;0;0;0;1;1;34990;Licuadora TH-401V Roja 1,75Lts Vaso Vidrio;ELECTRODOMESTICOS
16945586;;F;33;CHILENO;;Silencioso;PROVIDENCIA                   ;METROPOLITANA;39990;1;1;1;1;39990;0;0;0;Horno Electrico TH-25N01 25Lts;ELECTRODOMESTICOS
6179010;;F;71;CHILENO;;Silencioso;PROVIDENCIA                   ;METROPOLITANA;9990;1;1;0;0;0;1;1;9990;Plancha a Vapor Oster 3803;ELECTRODOMESTICOS
20040365;;M;24;CHILENO;;Z;PROVIDENCIA                   ;METROPOLITANA;14990;1;1;0;0;0;1;1;14990;Hervidor Electrico TH-4515N 2Lts Negro;ELECTRODOMESTICOS
6167424;;F;70;CHILENO;;Silencioso;ILLAPEL                       ;COQUIMBO;20990;1;1;0;0;0;1;1;20990;Combo Hervidor + Batidora;ELECTRODOMESTICOS
9227557;;M;60;CHILENO;;Boomers;PROVIDENCIA                   ;METROPOLITANA;25990;1;1;0;0;0;1;1;25990;Plancha UT-KERAMIKTOP 2200Watts Base Ceramica;ELECTRODOMESTICOS
19990546;;M;23;CHILENO;;Z;PROVIDENCIA                   ;METROPOLITANA;74990;1;1;0;0;0;1;1;74990;Horno Microondas Digital TH-20S01 20Lts;ELECTRODOMESTICOS
15880356;;F;37;CHILENO;;Millenial;PROVIDENCIA                   ;METROPOLITANA;14990;1;1;0;0;0;1;1;14990;Batidora Manual 3532;ELECTRODOMESTICOS
8082690;Casado;F;61;CHILENO;;Boomers;RENCA                         ;METROPOLITANA;15990;1;1;0;0;0;1;1;15990;HERVIDOR TH-4340;ELECTRODOMESTICOS
5961500;Soltero;F;73;CHILENO;PROFESOR;Silencioso;VINA DEL MAR                  ;VALPARAISO;24990;1;1;0;0;0;1;1;24990;HORNO ELECTRICO 16N01 16LTS NEGRO;ELECTRODOMESTICOS
7944880;;F;64;CHILENO;;Boomers;ILLAPEL                       ;COQUIMBO;61980;2;2;0;0;0;2;2;61980;Licuadora TH-401V Roja 1,75Lts Vaso Vidrio;ELECTRODOMESTICOS
8265078;;M;64;CHILENO;;Boomers;N/D;N/D;21990;1;1;0;0;0;1;1;21990;Licuadora TH-320 Roja/Negro 1,5 Lts Vaso Vidrio;ELECTRODOMESTICOS
9727375;;M;58;CHILENO;;Boomers;LOS ANGELES                   ;BIO BIO;16990;1;1;0;0;0;1;1;16990;Cafetera TH-130;ELECTRODOMESTICOS
15658966;;M;38;CHILENO;;Millenial;LOS ALAMOS                    ;BIO BIO;182960;4;3;0;0;0;4;3;182960;Horno Electrico UT-BACKOFEN48 48Lts;ELECTRODOMESTICOS
13986177;;M;40;CHILENO;;X;"";"";34990;1;1;0;0;0;1;1;34990;Licuadora L1000 Inox 1,7LtsVaso Vidrio;ELECTRODOMESTICOS
11664177;;F;52;CHILENO;;X;VICTORIA                      ;ARAUCANIA;146960;4;2;0;0;0;4;2;146960;Horno Microondas Mecanico Easy Wave 20Lts;ELECTRODOMESTICOS
11155529;;M;54;CHILENO;;Boomers;PROVIDENCIA                   ;METROPOLITANA;169990;1;1;0;0;0;1;1;169990;Maquina de Coser ME9100;ELECTRODOMESTICOS
15285194;;M;40;CHILENO;;X;PUERTO MONTT;LOS LAGOS;133530;3;2;3;2;133530;0;0;0;FREIDORA DE AIRE THOMAS TH-AF60Mi;ELECTRODOMESTICOS
11560350;;F;52;CHILENO;;X;MOLINA                        ;MAULE;239970;3;3;0;0;0;3;3;239970;Horno Microondas Digital UT-CLASSY720 20Lts;ELECTRODOMESTICOS
18836237;;F;28;CHILENO;;Millenial;PROVIDENCIA                   ;METROPOLITANA;34990;1;1;0;0;0;1;1;34990;Batidora Vertical Minipimer UT-KLOT400P;ELECTRODOMESTICOS
18559992;;F;28;CHILENO;;Millenial;RETIRO                        ;MAULE;10990;1;1;0;0;0;1;1;10990;Exprimidor Fauna 500 cc;ELECTRODOMESTICOS
18436528;;M;29;CHILENO;;Millenial;"";"";39990;1;1;0;0;0;1;1;39990;Aspiradora Handy Clean Black 1400;ELECTRODOMESTICOS
16251952;;F;36;CHILENO;;Millenial;RANCAGUA                      ;L.G.B.OÂ´HIGGINS;48980;2;2;0;0;0;2;2;48980;Licuadora Personal TH-300PB;ELECTRODOMESTICOS
15367986;;M;39;CHILENO;;X;MACUL                         ;METROPOLITANA;48970;3;1;0;0;0;3;1;48970;Plancha Paninis 2880;ELECTRODOMESTICOS
7084268;Casado;M;67;CHILENO;;Boomers;CURANILAHUE                   ;BIO BIO;12990;1;1;0;0;0;1;1;12990;Hervidor Electrico 3101 1,7Lts Negro;ELECTRODOMESTICOS
17716230;;F;31;CHILENO;;Silencioso;PROVIDENCIA                   ;METROPOLITANA;25000;0;2;0;0;0;0;2;25000;Batidora Vertical Minipimer UT-KLOT800SS;ELECTRODOMESTICOS
17172824;Soltero;M;33;CHILENO;;Millenial;PROVIDENCIA                   ;METROPOLITANA;34990;1;1;0;0;0;1;1;34990;Licuadora TH-501V 1,5Lts Vaso Vidrio;ELECTRODOMESTICOS
8520317;;M;55;CHILENO;;Boomers;PROVIDENCIA                   ;METROPOLITANA;88980;2;1;0;0;0;2;1;88980;Aspiradora TH1870 Arrastre 1800Watts Gris;ELECTRODOMESTICOS
19180222;Soltero;F;26;CHILENO;;Z;PROVIDENCIA                   ;METROPOLITANA;26990;1;1;1;1;26990;0;0;0;Combo Licuadora + Batidora;ELECTRODOMESTICOS
18134149;;F;29;CHILENO;;Millenial;N/D;N/D;22980;2;1;0;0;0;2;1;22980;Hervidor Electrico TH-4515N 2Lts Negro;ELECTRODOMESTICOS
6497391;;F;68;CHILENO;;Boomers;PROVIDENCIA                   ;METROPOLITANA;64980;2;1;0;0;0;2;1;64980;Aspiradora Tambor APA1000 1000Watts;ELECTRODOMESTICOS
13006307;;M;46;CHILENO;;X;ARICA                         ;ARICA Y PARINACOTA;468750;4;2;0;0;0;4;2;468750;Horno Microondas Mecanico M-2020NG 20Lts;ELECTRODOMESTICOS
4405528;;M;78;CHILENO;;Silencioso;LONCOCHE                      ;ARAUCANIA;14990;1;1;0;0;0;1;1;14990;Hervidor Electrico TH-4212N 1,7Lts Negro;ELECTRODOMESTICOS
22213581;Casado;F;27;CHILENO;;Extranjero;PROVIDENCIA                   ;METROPOLITANA;92960;4;1;0;0;0;4;1;92960;Batidora Vertical Minipimer UT-KLOT400P;ELECTRODOMESTICOS
7287676;;M;67;CHILENO;;Boomers;COPIAPO                       ;ATACAMA;68980;2;2;0;0;0;2;2;68980;PROCESADOR THOMAS TH-9160;ELECTRODOMESTICOS
15146311;;F;40;CHILENO;;X;TALCA                         ;MAULE;531742;6;4;0;0;0;6;4;531742;Hervidor Electrico TH-5407i 2Lts;ELECTRODOMESTICOS
26539120;;M;51;CHILENO;;Extranjero;TALCA                         ;MAULE;149980;2;2;0;0;0;2;2;149980;Horno Electrico UT-BACKOFEN48 48Lts;ELECTRODOMESTICOS
10104904;;M;57;CHILENO;;Boomers;PROVIDENCIA                   ;METROPOLITANA;40970;3;3;0;0;0;3;3;40970;Licuadora Berry Blender Roja 1400 Vaso Vidrio;ELECTRODOMESTICOS
8192701;;F;62;CHILENO;;Boomers;RENCA                         ;METROPOLITANA;89990;1;1;0;0;0;1;1;89990;Batidora Pedestal TH910PN 4,6Lts 1300Watts;ELECTRODOMESTICOS
11502129;;F;53;CHILENO;;X;TEMUCO                        ;ARAUCANIA;34990;1;1;0;0;0;1;1;34990;Licuadora TH-501V 1,5Lts Vaso Vidrio;ELECTRODOMESTICOS
13930384;;F;42;CHILENO;;X;PEDRO AGUIRRE CERDA;METROPOLITANA;22990;1;1;0;0;0;1;1;22990;PLANCHA VAPOR TH-7146;ELECTRODOMESTICOS
13365419;;M;44;CHILENO;;X;NOGALES                       ;VALPARAISO;29990;1;1;0;0;0;1;1;29990;Licuadora Osterizer 4112/72 1,25Lts Vaso Vidrio;ELECTRODOMESTICOS
9001456;;F;61;CHILENO;;Boomers;PICHIDEGUA                    ;L.G.B.OÂ´HIGGINS;54980;2;2;0;0;0;2;2;54980;Licuadora Osterizer 4112/72 1,25Lts Vaso Vidrio;ELECTRODOMESTICOS
17638664;;M;31;CHILENO;;Millenial;PROVIDENCIA                   ;METROPOLITANA;59990;1;1;0;0;0;1;1;59990;Horno Electrico TH-38N 38Lts;ELECTRODOMESTICOS
16273803;Casado;F;36;CHILENO;;Millenial;PROVIDENCIA                   ;METROPOLITANA;24990;1;1;0;0;0;1;1;24990;Licuadora BL1500 Silver 1,75Lts Vaso Vidrio;ELECTRODOMESTICOS
16491081;;F;35;CHILENO;;Millenial;SAN VICENTE                   ;L.G.B.OÂ´HIGGINS;14990;1;1;0;0;0;1;1;14990;Hervidor Electrico HA-3300 2,5Lts Blanco;ELECTRODOMESTICOS
18762234;Soltero;M;28;CHILENO;;Millenial;PROVIDENCIA                   ;METROPOLITANA;29990;1;1;0;0;0;1;1;29990;Licuadora L-5500IN 1,5Lts;ELECTRODOMESTICOS
16779659;;F;34;CHILENO;;Millenial;ANCUD                         ;LOS LAGOS;39980;2;1;0;0;0;2;1;39980;Parrilla Electrica TH-180;ELECTRODOMESTICOS
7941688;;F;63;CHILENO;;Boomers;RENCA                         ;METROPOLITANA;54990;1;1;0;0;0;1;1;54990;Parrilla Electrica TH-224;ELECTRODOMESTICOS
12822108;Divorciado;F;47;CHILENO;;X;RENCA                         ;METROPOLITANA;169980;2;1;2;1;169980;0;0;0;FREIDORA DE AIRE THOMAS TH-AF60Mi;ELECTRODOMESTICOS
11521193;;M;51;CHILENO;;X;LOS ANDES                     ;VALPARAISO;89980;2;1;0;0;0;2;1;89980;Horno electrico Black Oven 42lts;ELECTRODOMESTICOS
13287013;;M;45;CHILENO;;X;NUEVA IMPERIAL                ;ARAUCANIA;137860;3;3;0;0;0;3;3;137860;Licuadora L2000VNG 1,5Lts Vaso Vidrio;ELECTRODOMESTICOS
12576427;;F;48;CHILENO;;X;HUASCO                        ;ATACAMA;169990;1;1;0;0;0;1;1;169990;Horno Electrico TH-100i 100Lts;ELECTRODOMESTICOS
15827238;Soltero;F;36;CHILENO;;Millenial;PROVIDENCIA                   ;METROPOLITANA;34990;1;1;0;0;0;1;1;34990;Licuadora TH-501V 1,5Lts Vaso Vidrio;ELECTRODOMESTICOS
20088368;;F;22;CHILENO;;Millenial;N/D;N/D;24990;1;1;0;0;0;1;1;24990;HERVIDOR ELECTRICO UT-STARK18;ELECTRODOMESTICOS
9867694;Soltero;F;66;CHILENO;;Boomers;RENCA                         ;METROPOLITANA;29990;1;1;0;0;0;1;1;29990;Plancha THOMAS TH-7170 2200Watts Base Ceramica;ELECTRODOMESTICOS
25752852;;M;30;VENEZOLANO;;Extranjero;CONCEPCION                    ;BIO BIO;74990;1;1;0;0;0;1;1;74990;Horno Electrico TH-48N 48Lts;ELECTRODOMESTICOS
26293675;;M;27;VENEZOLANO;;Extranjero;N/D;N/D;98970;3;3;0;0;0;3;3;98970;Licuadora TH-501V 1,5Lts Vaso Vidrio;ELECTRODOMESTICOS
18589543;;F;28;CHILENO;;Millenial;CHIGUAYANTE                   ;BIO BIO;27990;1;1;0;0;0;1;1;27990;Hervidor Electrico Tetera TH-6505RT 1,7Lts Rojo;ELECTRODOMESTICOS
17282945;;F;32;CHILENO;;Millenial;SAN JOAQUIN                   ;METROPOLITANA;13980;2;1;2;1;13980;0;0;0;Exprimidor Fauna 500 cc;ELECTRODOMESTICOS
15734154;;F;40;CHILENO;;X;PROVIDENCIA                   ;METROPOLITANA;24990;1;1;0;0;0;1;1;24990;Licuadora Roja 550W 1,5Lts Vaso Vidrio;ELECTRODOMESTICOS
12847377;;F;47;CHILENO;;X;VALPARAISO                    ;VALPARAISO;10493;1;1;0;0;0;1;1;10493;HERVIDOR TH-4340;ELECTRODOMESTICOS
10348066;;M;49;CHILENO;;X;NATALES                       ;MAGALLANES;17990;1;1;0;0;0;1;1;17990;Hervidor Electrico TH-4515N 2Lts Negro;ELECTRODOMESTICOS
8701834;Casado;M;61;CHILENO;PROFESOR;Boomers;RENCA                         ;METROPOLITANA;34990;1;1;0;0;0;1;1;34990;Aspiradora TH1407 Arrastre 1400Watts;ELECTRODOMESTICOS
7361768;;F;66;CHILENO;;Boomers;CERRO NAVIA                   ;METROPOLITANA;73980;2;1;2;1;73980;0;0;0;Enceradora EA-5000;ELECTRODOMESTICOS
19997492;;F;23;CHILENO;;Z;PROVIDENCIA                   ;METROPOLITANA;71970;3;2;0;0;0;3;2;71970;Licuadora Kaliman Negra con Teclas;ELECTRODOMESTICOS
11283169;;F;54;CHILENO;;X;RENCA                         ;METROPOLITANA;79990;1;1;0;0;0;1;1;79990;Batidora Pedestal TH910PN 4,6Lts 1300Watts;ELECTRODOMESTICOS
9680854;;F;60;CHILENO;;Boomers;RENCA                         ;METROPOLITANA;181970;3;2;0;0;0;3;2;181970;Maquina de Coser Remington J011;ELECTRODOMESTICOS
6264818;;F;73;CHILENO;;Silencioso;CANETE                        ;BIO BIO;54990;1;1;0;0;0;1;1;54990;Aspiradora VCC4190V3E/XZS Arrastre 2000Watts;ELECTRODOMESTICOS
10501646;;F;51;CHILENO;;X;VALDIVIA                      ;LOS LAGOS;19990;1;1;0;0;0;1;1;19990;Plancha TH-7052 2000Watts Base Inox;ELECTRODOMESTICOS
12971862;;F;45;CHILENO;;X;TOME                          ;BIO BIO;49980;2;1;0;0;0;2;1;49980;Licuadora Roja 550W 1,5Lts Vaso Vidrio;ELECTRODOMESTICOS
18681551;;F;28;CHILENO;;Millenial;PROVIDENCIA                   ;METROPOLITANA;36990;1;1;1;1;36990;0;0;0;Aspiradora AP1700 Arrastre 1700Watts;ELECTRODOMESTICOS
16226049;;F;36;CHILENO;;Millenial;LA LIGUA                      ;VALPARAISO;202618;7;1;0;0;0;7;1;202618;Freidora de Aire 18M Oster;ELECTRODOMESTICOS
9268559;;F;61;CHILENO;;Boomers;RENCA                         ;METROPOLITANA;12990;1;1;0;0;0;1;1;12990;Plancha Easy Steam (PV4500);ELECTRODOMESTICOS
11322526;Casado;F;54;CHILENO;;X;RENCA                         ;METROPOLITANA;0;0;2;0;0;0;0;2;0;Horno Electrico UT-BACKOFEN60 60Lts;ELECTRODOMESTICOS
11431803;;M;53;CHILENO;;X;CALBUCO                       ;LOS LAGOS;46980;2;2;0;0;0;2;2;46980;Combo Hervidor + Batidora;ELECTRODOMESTICOS
19009106;;F;26;CHILENO;;Z;CURICO                        ;MAULE;40980;2;1;0;0;0;2;1;40980;Combo Licuadora + Batidora;ELECTRODOMESTICOS
19128433;;F;27;CHILENO;;Z;LA LIGUA                      ;VALPARAISO;36990;1;1;0;0;0;1;1;36990;Licuadora TH-401V Roja 1,75Lts Vaso Vidrio;ELECTRODOMESTICOS
18082540;Soltero;F;29;CHILENO;;Millenial;PROVIDENCIA                   ;METROPOLITANA;16990;1;1;0;0;0;1;1;16990;MULTIMIXER THOMAS TH- 8706;ELECTRODOMESTICOS
19968278;;M;23;CHILENO;;Z;PROVIDENCIA                   ;METROPOLITANA;77540;2;1;2;1;77540;0;0;0;Cafetera Dolce Gusto Piccolo XS 0,8 Lts Negra;ELECTRODOMESTICOS
19460421;;F;24;CHILENO;;Silencioso;PROVIDENCIA                   ;METROPOLITANA;14990;1;1;1;1;14990;0;0;0;Combo Hervidor + Batidora;ELECTRODOMESTICOS
15756127;;F;38;CHILENO;;Millenial;PROVIDENCIA                   ;METROPOLITANA;46990;1;1;0;0;0;1;1;46990;Horno Electrico UT-BACKOFEN26 26Lts;ELECTRODOMESTICOS
10720700;;F;52;CHILENO;;X;CONCEPCION                    ;BIO BIO;39990;1;1;0;0;0;1;1;39990;Aspiradora TH1415 Arrastre 1500Watts;ELECTRODOMESTICOS
8666271;Soltero;F;61;CHILENO;;Boomers;RENCA                         ;METROPOLITANA;29990;1;1;0;0;0;1;1;29990;Licuadora L-5500IN 1,5Lts;ELECTRODOMESTICOS
13887850;;F;41;CHILENO;;X;PROVIDENCIA                   ;METROPOLITANA;59990;1;1;0;0;0;1;1;59990;Horno Microondas Mecanico M-2030 NG 20Lts;ELECTRODOMESTICOS
18680206;;F;28;CHILENO;;Millenial;NATALES                       ;MAGALLANES;97010;0;5;0;0;0;0;5;97010;Exprimidor Fauna 500 cc;ELECTRODOMESTICOS
16927988;;F;33;CHILENO;;Millenial;PROVIDENCIA                   ;METROPOLITANA;15990;1;1;0;0;0;1;1;15990;HERVIDOR TH-4340;ELECTRODOMESTICOS
13870256;;F;42;CHILENO;;X;SAN VICENTE                   ;L.G.B.OÂ´HIGGINS;22990;1;1;0;0;0;1;1;22990;PLANCHA VAPOR TH-7146;ELECTRODOMESTICOS
25454741;;F;56;COLOMBIANO;;Extranjero;ANTOFAGASTA                   ;ANTOFAGASTA;29980;2;1;0;0;0;2;1;29980;Sandwichera TH-952 2 Panes Blanca;ELECTRODOMESTICOS
18961117;;F;27;CHILENO;;Z;PROVIDENCIA                   ;METROPOLITANA;36990;1;1;0;0;0;1;1;36990;Licuadora TH-501V 1,5Lts Vaso Vidrio;ELECTRODOMESTICOS
7835517;;F;65;CHILENO;;Boomers;CONSTITUCION                  ;MAULE;47990;1;1;0;0;0;1;1;47990;Picadora TH-9020V Vaso Vidrio 2Lts;ELECTRODOMESTICOS
8135330;;M;63;CHILENO;;Boomers;LUMACO                        ;ARAUCANIA;64990;1;1;0;0;0;1;1;64990;Horno Electrico TH-38N 38Lts;ELECTRODOMESTICOS
20314639;;M;22;CHILENO;;Z;N/D;N/D;44990;1;3;2;1;222980;-1;2;-177990;Aspiradora TH1415 Arrastre 1500Watts;ELECTRODOMESTICOS
9815426;;M;58;CHILENO;;Boomers;VICTORIA                      ;ARAUCANIA;99990;1;1;0;0;0;1;1;99990;Horno Electrico TH62I 60Lts;ELECTRODOMESTICOS
18447323;;F;29;CHILENO;;Millenial;SAN ANTONIO                   ;VALPARAISO;16990;1;1;0;0;0;1;1;16990;Plancha Easy Steam (PV4500);ELECTRODOMESTICOS
6131972;;F;72;CHILENO;;Silencioso;CURICO                        ;MAULE;40173;2;1;0;0;0;2;1;40173;Horno Electrico UT-BACKOFEN26 26Lts;ELECTRODOMESTICOS
15441297;;M;39;CHILENO;;X;PROVIDENCIA                   ;METROPOLITANA;-99990;-1;1;0;0;0;-1;1;-99990;Horno Electrico TH62I 60Lts;ELECTRODOMESTICOS
16079781;;F;51;CHILENO;;X;CASTRO                        ;LOS LAGOS;23990;1;1;0;0;0;1;1;23990;Licuadora L-1630V Negra 1,5Lts Vaso Vidrio;ELECTRODOMESTICOS
14520055;;F;49;CHILENO;;X;MAULE                         ;MAULE;43980;2;2;0;0;0;2;2;43980;Plancha UT-DUNST 2200Watts Base Ceramica;ELECTRODOMESTICOS
14474525;Soltero;F;44;CHILENO;;X;PROVIDENCIA                   ;METROPOLITANA;16990;1;1;0;0;0;1;1;16990;Batidora Manual UT-TEKLA300;ELECTRODOMESTICOS
11487610;;F;53;CHILENO;;X;PROVIDENCIA                   ;METROPOLITANA;104960;4;2;0;0;0;4;2;104960;Cafetera UT-KAFFEEKLASSIK;ELECTRODOMESTICOS
14067049;;F;41;CHILENO;;X;COLLIPULLI                    ;ARAUCANIA;149990;1;1;0;0;0;1;1;149990;Horno Electrico TH-100i 100Lts;ELECTRODOMESTICOS
14023533;;F;40;CHILENO;;X;PARRAL                        ;MAULE;24990;1;1;0;0;0;1;1;24990;Licuadora Roja 550W 1,5Lts Vaso Vidrio;ELECTRODOMESTICOS
4411582;;F;83;CHILENO;;Silencioso;LA SERENA                     ;COQUIMBO;79990;1;1;0;0;0;1;1;79990;Batidora Pedestal TH910PN 4,6Lts 1300Watts;ELECTRODOMESTICOS
18704522;;F;28;CHILENO;;Millenial;COIHAIQUE                     ;AYSEN;638960;4;2;2;1;98980;2;1;539980;Horno Microondas Digital UT-CLASSY720 20Lts;ELECTRODOMESTICOS
10368753;;M;56;CHILENO;;Boomers;SAN VICENTE                   ;L.G.B.OÂ´HIGGINS;316960;4;3;0;0;0;4;3;316960;Licuadora Personal TH-300PB;ELECTRODOMESTICOS
7491446;;M;67;CHILENO;;Boomers;PROVIDENCIA                   ;METROPOLITANA;210650;4;2;0;0;0;4;2;210650;Tostador de Pan TH-126 4 Rebanadas Negro;ELECTRODOMESTICOS
16324797;Soltero;F;37;CHILENO;INGENIERO EN PREVENCION DE RIESGOS;Millenial;RENCA                         ;METROPOLITANA;37980;2;2;0;0;0;2;2;37980;Exprimidor de Jugo 407W 1Lts;ELECTRODOMESTICOS
9227418;;F;63;CHILENO;;Boomers;RENCA                         ;METROPOLITANA;29990;1;1;0;0;0;1;1;29990;Plancha Paninis 2880;ELECTRODOMESTICOS
7831875;Casado;M;62;CHILENO;;Boomers;RENCA                         ;METROPOLITANA;84990;1;1;0;0;0;1;1;84990;Horno Electrico TH62I 60Lts;ELECTRODOMESTICOS
8733354;Casado;F;63;CHILENO;;Boomers;RENCA                         ;METROPOLITANA;64990;1;1;0;0;0;1;1;64990;Aspiradora TH1870 Arrastre 1800Watts Gris;ELECTRODOMESTICOS
15576513;;M;38;CHILENO;;X;N/D;N/D;14990;1;1;0;0;0;1;1;14990;HERVIDOR TH-4340;ELECTRODOMESTICOS
8796425;Soltero;F;60;CHILENO;;Boomers;RENCA                         ;METROPOLITANA;22990;1;1;0;0;0;1;1;22990;PLANCHA VAPOR TH-7146;ELECTRODOMESTICOS
10120421;;F;59;CHILENO;;Boomers;ISLA DE MAIPO                 ;METROPOLITANA;24990;1;1;0;0;0;1;1;24990;Combo Juguera + Hervidor;ELECTRODOMESTICOS
17827165;Soltero;M;31;CHILENO;TECNICO MECANICO;Millenial;PROVIDENCIA                   ;METROPOLITANA;19990;1;1;0;0;0;1;1;19990;Batidora Manual BA-5010 Inox;ELECTRODOMESTICOS
6615364;;F;73;CHILENO;;Silencioso;CURACAVI                      ;METROPOLITANA;18990;1;1;0;0;0;1;1;18990;Tostador de PanTH-120R 2 Rebanadas Rojo;ELECTRODOMESTICOS
9997168;;F;53;CHILENO;;X;N/D;N/D;251970;3;3;0;0;0;3;3;251970;PICADORA 123 SILHQUETTE;ELECTRODOMESTICOS
9720863;;F;61;CHILENO;;Boomers;CURICO                        ;MAULE;114980;2;1;0;0;0;2;1;114980;Horno Microondas Digital L UT-25KROMM 25Lts;ELECTRODOMESTICOS
8921274;;M;61;CHILENO;;Boomers;CAUQUENES                     ;MAULE;88170;2;1;0;0;0;2;1;88170;Horno electrico Black Oven 42lts;ELECTRODOMESTICOS
8853040;;F;73;CHILENO;;Silencioso;VILLA ALEMANA                 ;VALPARAISO;12990;1;1;0;0;0;1;1;12990;Batidora Vertical Stick Mixer 2609;ELECTRODOMESTICOS
9909432;;F;62;CHILENO;;Boomers;QUILPUE                       ;VALPARAISO;39990;1;1;0;0;0;1;1;39990;Licuadora UT-METALLEK805R 1,75Lts Vaso Vidrio;ELECTRODOMESTICOS
12630963;;F;48;CHILENO;;X;N/D;N/D;106980;2;1;0;0;0;2;1;106980;Horno Electrico UT-BACKOFEN48 48Lts;ELECTRODOMESTICOS
10396584;;M;55;CHILENO;;Boomers;CURICO                        ;MAULE;99990;1;1;0;0;0;1;1;99990;Horno Electrico TH62I 60Lts;ELECTRODOMESTICOS
7222860;;F;70;CHILENO;;Silencioso;CANETE                        ;BIO BIO;159990;1;1;0;0;0;1;1;159990;Maquina de Coser Remington J011;ELECTRODOMESTICOS
12028814;;M;53;CHILENO;;X;PROVIDENCIA                   ;METROPOLITANA;12990;1;1;0;0;0;1;1;12990;Hervidor Electrico 3101 1,7Lts Negro;ELECTRODOMESTICOS
16503448;;F;35;CHILENO;;Millenial;"";"";16990;1;1;1;1;16990;0;0;0;Combo Hervidor + Batidora;ELECTRODOMESTICOS
10082301;;F;58;CHILENO;;Boomers;SAN FERNANDO                  ;L.G.B.OÂ´HIGGINS;16990;1;1;0;0;0;1;1;16990;Batidora Manual UT-TEKLA300;ELECTRODOMESTICOS
10775021;;F;55;CHILENO;;Boomers;VINA DEL MAR                  ;VALPARAISO;27990;1;1;0;0;0;1;1;27990;Picadora UT-PETRUS320 1Lts Vaso Vidrio;ELECTRODOMESTICOS
5542372;;F;78;CHILENO;;Silencioso;COLINA                        ;METROPOLITANA;79980;2;1;0;0;0;2;1;79980;Horno Microondas Mecanico UT-SYDNEY18 18Lts;ELECTRODOMESTICOS
10367081;;F;53;CHILENO;;X;PEMUCO                        ;BIO BIO;18990;1;1;0;0;0;1;1;18990;Batidora Manual TH-8830;ELECTRODOMESTICOS
9502371;;M;59;CHILENO;;Boomers;ARAUCO                        ;BIO BIO;79990;1;1;0;0;0;1;1;79990;Batidora Pedestal TH910PN 4,6Lts 1300Watts;ELECTRODOMESTICOS
18962055;;F;27;CHILENO;;Z;N/D;N/D;239980;4;2;0;0;0;4;2;239980;Horno Electrico TH-25N01 25Lts;ELECTRODOMESTICOS
13986760;;F;41;CHILENO;;X;PUERTO VARAS                  ;LOS LAGOS;93170;2;1;0;0;0;2;1;93170;Batidora Pedestal TH910PN 4,6Lts 1300Watts;ELECTRODOMESTICOS
26495080;;M;45;EXTRANJERO - NO INFORMA NACIONALIDAD;;Extranjero;N/D;N/D;323970;4;2;2;1;83980;2;1;239990;Horno Microondas Digital MS28F303TAS/ZS 28Lts;ELECTRODOMESTICOS
10302665;;M;56;CHILENO;;Boomers;RENCA                         ;METROPOLITANA;17990;1;1;0;0;0;1;1;17990;MULTIMIXER THOMAS TH- 8706;ELECTRODOMESTICOS
15440103;;M;40;CHILENO;;X;PROVIDENCIA                   ;METROPOLITANA;29990;1;1;0;0;0;1;1;29990;Licuadora L1000 Inox 1,7LtsVaso Vidrio;ELECTRODOMESTICOS
6628423;;M;69;CHILENO;;Silencioso;RENCA                         ;METROPOLITANA;27990;1;1;0;0;0;1;1;27990;Licuadora L-1630V Negra 1,5Lts Vaso Vidrio;ELECTRODOMESTICOS
13476221;;F;44;CHILENO;;X;PROVIDENCIA                   ;METROPOLITANA;24990;1;1;0;0;0;1;1;24990;Combo Juguera + Hervidor;ELECTRODOMESTICOS
17582645;;F;32;CHILENO;;Millenial;LAUTARO                       ;ARAUCANIA;34990;1;1;0;0;0;1;1;34990;Procesador TH-9010 Multimixer 1,5Lts Vaso Vidrio;ELECTRODOMESTICOS
15820560;Casado;F;37;CHILENO;INGENIERO QUIMICO;Millenial;RENCA                         ;METROPOLITANA;63980;2;1;2;1;63980;0;0;0;ASPIRADORA VCC4580V3K/XZS SAMSUNG BLACK;ELECTRODOMESTICOS
9778903;;M;59;CHILENO;;Boomers;PROVIDENCIA                   ;METROPOLITANA;19990;1;1;0;0;0;1;1;19990;Plancha TH-7052 2000Watts Base Inox;ELECTRODOMESTICOS
6761829;;M;68;CHILENO;;Silencioso;HIJUELAS                      ;VALPARAISO;15990;1;1;0;0;0;1;1;15990;Hervidor Electrico HA-3300 2,5Lts Blanco;ELECTRODOMESTICOS
15418361;;F;39;CHILENO;;Silencioso;PROVIDENCIA                   ;METROPOLITANA;53980;2;1;2;1;53980;0;0;0;Cafetera P65 Silver;ELECTRODOMESTICOS
9280541;;M;57;CHILENO;;Millenial;PROVIDENCIA                   ;METROPOLITANA;69990;1;1;0;0;0;1;1;69990;Horno Microondas Mecanico M-2030 NG 20Lts;ELECTRODOMESTICOS
14737332;;F;54;NORUEGO;;Extranjero;VILLA ALEMANA                 ;VALPARAISO;39990;1;1;0;0;0;1;1;39990;Horno Electrico TH-25N01 25Lts;ELECTRODOMESTICOS
7610864;Soltero;F;68;CHILENO;;Silencioso;NUNOA                         ;METROPOLITANA;95970;3;1;0;0;0;3;1;95970;Horno Electrico TH-38N 38Lts;ELECTRODOMESTICOS
17910898;;M;30;CHILENO;;Millenial;OVALLE                        ;COQUIMBO;14990;1;1;1;1;14990;0;0;0;Tostador de Pan TH-116 2 Rebanadas Negro;ELECTRODOMESTICOS
4998249;Casado;M;73;CHILENO;PROFESOR;Silencioso;PROVIDENCIA                   ;METROPOLITANA;13990;1;1;0;0;0;1;1;13990;Exprimidor de Jugo CJ-2000 1Lts;ELECTRODOMESTICOS
19026790;;F;27;CHILENO;;Z;N/D;N/D;39990;1;1;1;1;39990;0;0;0;Horno Microondas Mecanico Easy Wave 20Lts;ELECTRODOMESTICOS
25659306;;M;41;VENEZOLANO;;Extranjero;N/D;N/D;43980;2;1;2;1;43980;0;0;0;Horno Microondas Mecanico Easy Wave 20Lts;ELECTRODOMESTICOS
19034997;;M;27;CHILENO;;Z;CONCEPCION                    ;BIO BIO;34990;1;1;1;1;34990;0;0;0;Aspiradora TH1407 Arrastre 1400Watts;ELECTRODOMESTICOS
18471371;;F;29;CHILENO;;Millenial;PUERTO MONTT                  ;LOS LAGOS;54980;2;1;0;0;0;2;1;54980;Licuadora L-5500IN 1,5Lts;ELECTRODOMESTICOS
12591855;;F;47;CHILENO;;X;ALTO HOSPICIO;TARAPACA;73170;2;1;0;0;0;2;1;73170;Horno Microondas Mecanico UT-SYDNEY18 18Lts;ELECTRODOMESTICOS
11929728;;F;50;CHILENO;;X;RENCA                         ;METROPOLITANA;74990;1;1;0;0;0;1;1;74990;Horno electrico Black Oven 42lts;ELECTRODOMESTICOS
8571936;;M;64;CHILENO;;Boomers;COIHAIQUE                     ;AYSEN;34990;1;1;0;0;0;1;1;34990;Aspiradora TH1407 Arrastre 1400Watts;ELECTRODOMESTICOS
17952738;;M;30;CHILENO;;Millenial;PROVIDENCIA                   ;METROPOLITANA;77960;3;1;3;1;77960;0;0;0;ASPIRADORA THOMAS TH-1640;ELECTRODOMESTICOS
13976869;;M;41;CHILENO;;X;NANCAGUA                      ;L.G.B.OÂ´HIGGINS;25990;1;1;0;0;0;1;1;25990;Combo Licuadora + Batidora;ELECTRODOMESTICOS
17865722;;M;31;CHILENO;;Millenial;N/D;N/D;34990;1;1;0;0;0;1;1;34990;Aspiradora Handy Clean Black 1400;ELECTRODOMESTICOS
12258279;;M;50;CHILENO;;X;PROVIDENCIA                   ;METROPOLITANA;153980;2;1;2;1;153980;0;0;0;MICROONDAS 30L MG30T5018CK/ZS SAMSUNG;ELECTRODOMESTICOS
9771869;;F;65;CHILENO;;Boomers;PUENTE ALTO                   ;METROPOLITANA;14990;1;1;0;0;0;1;1;14990;Hervidor Electrico UT-MANLY17 1,7Lts Negro;ELECTRODOMESTICOS
11517378;Soltero;F;52;CHILENO;;X;RENCA                         ;METROPOLITANA;19990;1;1;0;0;0;1;1;19990;Batidora Manual UT-TEKLA300;ELECTRODOMESTICOS
7527384;;F;72;CHILENO;;Silencioso;RENCA                         ;METROPOLITANA;55980;2;2;0;0;0;2;2;55980;Plancha UT-PLATTEISEN 2000Watts Base Ceramica;ELECTRODOMESTICOS
17028785;;F;33;CHILENO;;Silencioso;PROVIDENCIA                   ;METROPOLITANA;0;0;2;0;2;0;0;0;0;Horno Microondas Digital L UT-25KROMM 25Lts;ELECTRODOMESTICOS
14060634;;F;41;CHILENO;;X;PROVIDENCIA                   ;METROPOLITANA;16990;1;1;0;0;0;1;1;16990;MULTIMIXER THOMAS TH- 8706;ELECTRODOMESTICOS
10804233;;F;56;CHILENO;;Boomers;ANTOFAGASTA                   ;ANTOFAGASTA;49980;2;2;1;1;39990;1;1;9990;Exprimidor de Jugo CJ-2000 1Lts;ELECTRODOMESTICOS
9460786;;F;64;CHILENO;;Boomers;EMPEDRADO                     ;MAULE;13990;1;1;0;0;0;1;1;13990;Batidora Vertical Stick Mixer 2609;ELECTRODOMESTICOS
19467298;;M;24;CHILENO;;Z;PROVIDENCIA                   ;METROPOLITANA;188630;3;2;3;2;188630;0;0;0;Aspiradora Trapeadora Robot Ut-Excellenza (B);ELECTRODOMESTICOS
17442516;;M;32;CHILENO;;Silencioso;PROVIDENCIA                   ;METROPOLITANA;50840;2;1;2;1;50840;0;0;0;Horno Microondas Mecanico Easy Wave 20Lts;ELECTRODOMESTICOS
14461322;;M;47;CHILENO;;X;ARICA                         ;ARICA Y PARINACOTA;69990;1;1;0;0;0;1;1;69990;Enceradora EA-5000;ELECTRODOMESTICOS
18777201;;F;28;CHILENO;;Millenial;MELIPILLA                     ;METROPOLITANA;24990;1;1;0;0;0;1;1;24990;BATIDORA INMERSION S MIX 2616;ELECTRODOMESTICOS
20531920;;F;22;CHILENO;;Silencioso;PROVIDENCIA                   ;METROPOLITANA;53980;2;1;2;1;53980;0;0;0;Horno Microondas Mecanico Fancy 20Lts;ELECTRODOMESTICOS
7163115;;F;70;CHILENO;;Silencioso;PANQUEHUE                     ;VALPARAISO;16990;1;1;0;0;0;1;1;16990;Batidora Manual 3532;ELECTRODOMESTICOS
10484914;;F;56;CHILENO;;Boomers;PROVIDENCIA                   ;METROPOLITANA;224270;2;1;0;0;0;2;1;224270;Maquina de Coser BM-3850CL Lila;ELECTRODOMESTICOS
19426845;;M;25;CHILENO;;Z;PROVIDENCIA                   ;METROPOLITANA;44990;1;1;0;0;0;1;1;44990;Horno Microondas Mecanico Easy Wave 20Lts;ELECTRODOMESTICOS
12952141;;M;45;CHILENO;;X;PROVIDENCIA                   ;METROPOLITANA;14990;1;1;1;1;14990;0;0;0;Hervidor Electrico UT-KLAR20PW 2Lts Blanco;ELECTRODOMESTICOS
14139924;;F;41;CHILENO;;Silencioso;PROVIDENCIA                   ;METROPOLITANA;86970;3;2;0;0;0;3;2;86970;Aspiradora VCC4190V3E/XZS Arrastre 2000Watts;ELECTRODOMESTICOS
22734541;;M;43;ECUATORIANO;;Extranjero;CANETE                        ;BIO BIO;29990;1;1;0;0;0;1;1;29990;PLANCHA A VAPOR 6953 BASE AEROCERAMICA AUTAPA.22;ELECTRODOMESTICOS
10878722;;F;55;CHILENO;;Boomers;ANCUD                         ;LOS LAGOS;24990;1;1;0;0;0;1;1;24990;Cafetera TH-138i;ELECTRODOMESTICOS
19370967;;F;25;CHILENO;;Z;N/D;N/D;166680;3;1;3;1;166680;0;0;0;Batidora Berry Mixer (KM3000) 1300 watts;ELECTRODOMESTICOS
3851228;;M;85;CHILENO;;Silencioso;QUILPUE                       ;VALPARAISO;98170;2;1;0;0;0;2;1;98170;Batidora Pedestal TH910PN 4,6Lts 1300Watts;ELECTRODOMESTICOS
13528398;;M;43;CHILENO;;X;N/D;N/D;50969;3;1;0;0;0;3;1;50969;LICUADORA CROMADA CON TECLAS PLUS;ELECTRODOMESTICOS
8074389;;M;64;CHILENO;;Boomers;NUEVA IMPERIAL                ;ARAUCANIA;16990;1;1;0;0;0;1;1;16990;Plancha a vapor 6052 Oster;ELECTRODOMESTICOS
15536206;;M;39;CHILENO;;X;PROVIDENCIA                   ;METROPOLITANA;71970;3;2;3;2;71970;0;0;0;Horno Microonda Columba 1700;ELECTRODOMESTICOS
20012245;;M;24;CHILENO;;Z;VILLA ALEMANA;VALPARAISO;69990;1;1;0;0;0;1;1;69990;Enceradora EA-5000;ELECTRODOMESTICOS
5745348;;F;72;CHILENO;;Millenial;"";"";27990;1;1;0;0;0;1;1;27990;Hervidor Electrico Tetera TH-6505RT 1,7Lts Rojo;ELECTRODOMESTICOS
13350461;;F;44;CHILENO;;X;PROVIDENCIA                   ;METROPOLITANA;14990;1;1;0;0;0;1;1;14990;Tostador de Pan TH-116 2 Rebanadas Negro;ELECTRODOMESTICOS
17353804;;F;32;CHILENO;;Millenial;PROVIDENCIA                   ;METROPOLITANA;43980;2;1;2;1;43980;0;0;0;Aspiradora TH1415 Arrastre 1500Watts;ELECTRODOMESTICOS
4880978;;M;77;CHILENO;;Silencioso;PROVIDENCIA                   ;METROPOLITANA;53980;2;1;2;1;53980;0;0;0;Horno Microondas Mecanico Fancy 20Lts;ELECTRODOMESTICOS
6354860;Soltero;F;71;CHILENO;;Silencioso;RENCA                         ;METROPOLITANA;29990;1;1;0;0;0;1;1;29990;Licuadora Kaliman Negra con Teclas;ELECTRODOMESTICOS
13150500;;F;45;CHILENO;;X;N/D;N/D;218970;3;3;0;0;0;3;3;218970;Combo Hervidor + Batidora;ELECTRODOMESTICOS
13051507;Casado;F;45;CHILENO;;X;PROVIDENCIA                   ;METROPOLITANA;27980;2;1;0;0;0;2;1;27980;Batidora Vertical Stick Mixer 2609;ELECTRODOMESTICOS
12190922;;F;50;CHILENO;;X;TIRUA                         ;BIO BIO;14990;1;1;0;0;0;1;1;14990;Hervidor Electrico HA-2650NG;ELECTRODOMESTICOS
14353034;;F;43;CHILENO;;X;CORONEL                       ;BIO BIO;24493;1;1;0;0;0;1;1;24493;Licuadora Osterizer 4112/72 1,25Lts Vaso Vidrio;ELECTRODOMESTICOS
16801811;Soltero;M;34;CHILENO;;Millenial;RENCA                         ;METROPOLITANA;65840;2;1;2;1;65840;0;0;0;FREIDORA DE AIRE CKSTAF18D 1000W;ELECTRODOMESTICOS
11221558;;M;53;CHILENO;;X;PUTAENDO                      ;VALPARAISO;63170;2;1;0;0;0;2;1;63170;Aspiradora VCC4190V3E/XZS Arrastre 2000Watts;ELECTRODOMESTICOS
16543876;;F;35;CHILENO;;Millenial;PROVIDENCIA                   ;METROPOLITANA;53980;2;1;0;0;0;2;1;53980;HORNO ELECTRICO 16N01 16LTS NEGRO;ELECTRODOMESTICOS
10279709;;M;50;CHILENO;;Boomers;PROVIDENCIA                   ;METROPOLITANA;85480;2;1;2;1;85480;0;0;0;FREIDORA DE AIRE THOMAS TH-AF60Mi;ELECTRODOMESTICOS
16945915;;F;34;CHILENO;;Millenial;N/D;N/D;133160;3;2;0;0;0;3;2;133160;Olla Multiuso 6801 5,7Lts;ELECTRODOMESTICOS
10069808;;F;56;CHILENO;;Boomers;MAIPU                         ;METROPOLITANA;24493;1;1;0;0;0;1;1;24493;Procesador TH-9010 Multimixer 1,5Lts Vaso Vidrio;ELECTRODOMESTICOS
10324994;Soltero;F;52;CHILENO;;X;RENCA                         ;METROPOLITANA;26990;1;1;0;0;0;1;1;26990;Hervidor Electrico UT-REIN17SS;ELECTRODOMESTICOS
16203453;Soltero;F;36;CHILENO;ENFERMERA;Millenial;RENCA                         ;METROPOLITANA;83980;2;1;2;1;83980;0;0;0;FREIDORA DE AIRE THOMAS TH-AF60Mi;ELECTRODOMESTICOS
18668182;;F;28;CHILENO;;Silencioso;PROVIDENCIA                   ;METROPOLITANA;39990;1;1;1;1;39990;0;0;0;Parrilla Electrica TH-224;ELECTRODOMESTICOS
19028863;;F;27;CHILENO;;Z;PROVIDENCIA                   ;METROPOLITANA;48540;2;1;2;1;48540;0;0;0;Parrilla Electrica TH-224;ELECTRODOMESTICOS
11079456;;F;55;CHILENO;;Boomers;RENCA                         ;METROPOLITANA;179990;1;1;0;0;0;1;1;179990;Horno Electrico TH-100i 100Lts;ELECTRODOMESTICOS
9987180;;F;59;CHILENO;;Boomers;TEMUCO                        ;ARAUCANIA;131980;2;1;0;0;0;2;1;131980;Horno Electrico UT-BACKOFEN48 48Lts;ELECTRODOMESTICOS
13546872;;F;43;CHILENO;;X;SAN ANTONIO                   ;VALPARAISO;25990;1;1;0;0;0;1;1;25990;Combo Licuadora + Batidora;ELECTRODOMESTICOS
14410970;;M;49;CHILENO;;X;N/D;N/D;22980;2;1;0;0;0;2;1;22980;Cafetera TH-130;ELECTRODOMESTICOS
19372911;;F;25;CHILENO;;Z;N/D;N/D;64990;1;1;0;0;0;1;1;64990;Horno Electrico TH-38N 38Lts;ELECTRODOMESTICOS
18759318;;F;28;CHILENO;;Millenial;N/D;N/D;52890;6;1;0;0;0;6;1;52890;Licuadora Roja 550W 1,5Lts Vaso Vidrio;ELECTRODOMESTICOS
10353505;;F;59;CHILENO;;Boomers;PUYEHUE                       ;LOS LAGOS;97870;2;2;0;0;0;2;2;97870;Aspiradora TH1415 Arrastre 1500Watts;ELECTRODOMESTICOS
14188834;;M;40;CHILENO;;Silencioso;PROVIDENCIA                   ;METROPOLITANA;183980;2;1;2;1;183980;0;0;0;Robot aspirador Roomba 675;ELECTRODOMESTICOS
5662070;;M;75;CHILENO;;Silencioso;RENCA                         ;METROPOLITANA;59990;1;1;0;0;0;1;1;59990;Horno Microondas Mecanico UT-SYDNEY18 18Lts;ELECTRODOMESTICOS
16827577;;M;34;CHILENO;;Millenial;PROVIDENCIA                   ;METROPOLITANA;29990;1;1;0;0;0;1;1;29990;Licuadora Personal TH-300PB;ELECTRODOMESTICOS
9365023;;F;60;CHILENO;;Boomers;N/D;N/D;12990;1;1;0;0;0;1;1;12990;Sandwichera TH-952 2 Panes Blanca;ELECTRODOMESTICOS
17951636;;M;31;CHILENO;;Silencioso;PROVIDENCIA                   ;METROPOLITANA;53980;2;1;2;1;53980;0;0;0;Cafetera P65 Silver;ELECTRODOMESTICOS
20138414;;M;23;CHILENO;;Z;PROVIDENCIA                   ;METROPOLITANA;38980;2;1;2;1;38980;0;0;0;Aspiradora TH1407 Arrastre 1400Watts;ELECTRODOMESTICOS
9696152;;F;59;CHILENO;;Boomers;PUNTA ARENAS                  ;MAGALLANES;54990;1;1;0;0;0;1;1;54990;Horno Microondas Mecanico UT-SYDNEY18 18Lts;ELECTRODOMESTICOS
14345949;;F;44;CHILENO;;X;TALCA                         ;MAULE;15393;1;1;0;0;0;1;1;15393;Plancha UT-KERAMIK1 2200Watts Base Ceramica;ELECTRODOMESTICOS
6833299;;M;70;CHILENO;;Silencioso;PROVIDENCIA                   ;METROPOLITANA;29990;1;1;0;0;0;1;1;29990;Licuadora L-5500IN 1,5Lts;ELECTRODOMESTICOS
12593457;;M;48;CHILENO;;X;N/D;N/D;39990;1;1;0;0;0;1;1;39990;Horno Microondas Mecanico Easy Wave 20Lts;ELECTRODOMESTICOS
13626636;;F;43;CHILENO;;X;NACIMIENTO;BIO-BIO;81210;5;2;1;1;39990;4;1;41220;Horno Electrico TH-25N01 25Lts;ELECTRODOMESTICOS
5119180;;M;75;CHILENO;;Silencioso;CURANILAHUE                   ;BIO BIO;35992;1;1;0;0;0;1;1;35992;Licuadora L-25000NG;ELECTRODOMESTICOS
19273590;;M;27;CHILENO;;Millenial;CANETE                        ;BIO BIO;200230;3;3;0;0;0;3;3;200230;Hervidor Electrico UT-KLAR20PW 2Lts Blanco;ELECTRODOMESTICOS
17761425;Soltero;F;31;CHILENO;TECNOLOGO MEDICO;Millenial;N/D;N/D;85480;2;1;2;1;85480;0;0;0;FREIDORA DE AIRE THOMAS TH-AF60Mi;ELECTRODOMESTICOS
13494335;;F;44;CHILENO;;X;PROVIDENCIA                   ;METROPOLITANA;32990;1;1;0;0;0;1;1;32990;Licuadora L-5500IN 1,5Lts;ELECTRODOMESTICOS
13051945;;M;45;CHILENO;;X;SANTIAGO                      ;METROPOLITANA;88980;2;1;2;1;88980;0;0;0;FREIDORA DE AIRE THOMAS TH-AF60Mi;ELECTRODOMESTICOS
7530587;Soltero;M;65;CHILENO;;Boomers;LA SERENA                     ;COQUIMBO;136980;2;1;0;0;0;2;1;136980;Horno Electrico UT-BACKOFEN60 60Lts;ELECTRODOMESTICOS
6005304;Casado;M;71;CHILENO;;Silencioso;RENCA                         ;METROPOLITANA;21990;1;3;0;0;0;1;3;21990;Hervidor Electrico UT-REIN17SS;ELECTRODOMESTICOS
20118777;;F;23;CHILENO;;Z;SAN ANTONIO                   ;VALPARAISO;24990;1;1;0;0;0;1;1;24990;BATIDORA INMERSION S MIX 2616;ELECTRODOMESTICOS
6771925;;M;71;CHILENO;;Silencioso;CALBUCO                       ;LOS LAGOS;64990;1;1;0;0;0;1;1;64990;Horno Microondas Mecanico UT-SYDNEY18 18Lts;ELECTRODOMESTICOS
7292445;;M;68;CHILENO;;Silencioso;CATEMU                        ;VALPARAISO;69990;1;1;0;0;0;1;1;69990;Horno Microondas Digital TH-20S01 20Lts;ELECTRODOMESTICOS
13190215;;F;45;CHILENO;;X;N/D;N/D;11990;1;1;0;0;0;1;1;11990;Exprimidor de Jugo CJ-2000 1Lts;ELECTRODOMESTICOS
15894665;;F;37;CHILENO;;Millenial;SAN BERNARDO                  ;METROPOLITANA;14990;1;1;0;0;0;1;1;14990;Hervidor Electrico UT-MANLY17 1,7Lts Negro;ELECTRODOMESTICOS
12159673;Casado;F;51;CHILENO;;X;RENCA                         ;METROPOLITANA;39990;1;1;0;0;0;1;1;39990;HERVIDOR TETERA RELOJ 900R 2,5L ROJO;ELECTRODOMESTICOS
10413843;;M;55;CHILENO;;Boomers;N/D;N/D;134980;2;1;0;0;0;2;1;134980;Horno Electrico UT-BACKOFEN48 48Lts;ELECTRODOMESTICOS
20123518;;F;23;CHILENO;;Silencioso;PROVIDENCIA                   ;METROPOLITANA;26990;1;1;0;0;0;1;1;26990;PICADORA 123 SILHQUETTE;ELECTRODOMESTICOS
17193363;;F;32;CHILENO;;Millenial;COQUIMBO                      ;COQUIMBO;24990;1;1;1;1;24990;0;0;0;Licuadora L2000VNG 1,5Lts Vaso Vidrio;ELECTRODOMESTICOS
12145276;;M;52;CHILENO;;Silencioso;PROVIDENCIA                   ;METROPOLITANA;0;0;2;0;0;0;0;2;0;Horno Electrico TH-80i 80Lts;ELECTRODOMESTICOS
15082821;;M;39;CHILENO;;X;"";"";19990;1;1;0;0;0;1;1;19990;Licuadora L-1630V Negra 1,5Lts Vaso Vidrio;ELECTRODOMESTICOS
14083550;;F;40;CHILENO;;X;PROVIDENCIA                   ;METROPOLITANA;109990;1;1;0;0;0;1;1;109990;Horno Electrico TH62I 60Lts;ELECTRODOMESTICOS
16853629;;F;34;CHILENO;;Millenial;ANGOL                         ;ARAUCANIA;39980;2;1;0;0;0;2;1;39980;Licuadora TH-320 Roja/Negro 1,5 Lts Vaso Vidrio;ELECTRODOMESTICOS
13960917;;F;42;CHILENO;;X;TEMUCO                        ;ARAUCANIA;106980;2;1;2;1;106980;0;0;0;FREIDORA DE AIRE CKSTAF55 1700W;ELECTRODOMESTICOS
10146040;Casado;F;59;CHILENO;;Boomers;RENCA                         ;METROPOLITANA;14990;1;1;0;0;0;1;1;14990;Batidora Manual 3532;ELECTRODOMESTICOS
14160738;Soltero;F;41;CHILENO;;X;PROVIDENCIA                   ;METROPOLITANA;26570;2;1;0;0;0;2;1;26570;Hervidor Electrico TH-4515N 2Lts Negro;ELECTRODOMESTICOS
12242436;;F;51;CHILENO;;X;LOS ANGELES                   ;BIO BIO;29990;1;1;0;0;0;1;1;29990;Hervidor Electrico Tetera HA-4100 4Lts Iox;ELECTRODOMESTICOS
15483813;Soltero;M;40;CHILENO;;X;PROVIDENCIA                   ;METROPOLITANA;143980;2;1;2;1;143980;0;0;0;CAFETERA PRIMA LATTE 6603 NEGRA;ELECTRODOMESTICOS
10298185;;F;66;CHILENO;;Boomers;CATEMU                        ;VALPARAISO;35980;2;1;0;0;0;2;1;35980;HERVIDOR ELECTRICO UT-STARK18;ELECTRODOMESTICOS
8889729;;M;61;CHILENO;;Boomers;PROVIDENCIA                   ;METROPOLITANA;84990;1;1;0;0;0;1;1;84990;MICROONDAS ME83X/XZS SAMSUNG MIRROR;ELECTRODOMESTICOS
10016374;;F;57;CHILENO;;Boomers;CONCEPCION                    ;BIO BIO;49990;1;1;0;0;0;1;1;49990;Horno Electrico UT-BACKOFEN26 26Lts;ELECTRODOMESTICOS
5535748;;M;76;CHILENO;;Silencioso;VALDIVIA                      ;LOS LAGOS;83270;2;1;0;0;0;2;1;83270;Horno Microondas Mecanico UT-SYDNEY18 18Lts;ELECTRODOMESTICOS
13498235;;F;43;CHILENO;;X;LA GRANJA                     ;METROPOLITANA;154980;2;1;0;0;0;2;1;154980;Horno Microondas Digital L UT-25KROMM 25Lts;ELECTRODOMESTICOS
15821758;;M;37;CHILENO;;Millenial;PROVIDENCIA                   ;METROPOLITANA;109990;1;1;0;0;0;1;1;109990;Horno Electrico TH62I 60Lts;ELECTRODOMESTICOS
9757145;;M;59;CHILENO;;Boomers;N/D;N/D;29990;1;1;0;0;0;1;1;29990;Licuadora UT-METALLEK505P 1,5Lts Vaso Vidrio;ELECTRODOMESTICOS
14099852;;M;41;CHILENO;;X;VALLENAR;ATACAMA;-305940;-4;1;-4;1;-305940;0;0;0;Hervidor Electrico 3100 1,7Lts Negro;ELECTRODOMESTICOS
8519568;Soltero;F;64;CHILENO;;Boomers;RENCA                         ;METROPOLITANA;19990;1;1;0;0;0;1;1;19990;Hervidor Electrico TH-5407i 2Lts;ELECTRODOMESTICOS
11284583;;M;54;CHILENO;;X;CONSTITUCION                  ;MAULE;47670;2;1;0;0;0;2;1;47670;Licuadora L1000 Inox 1,7LtsVaso Vidrio;ELECTRODOMESTICOS
16440844;;M;36;CHILENO;;Millenial;PROVIDENCIA                   ;METROPOLITANA;64990;1;1;0;0;0;1;1;64990;Horno Microondas Digital TH-20S01 20Lts;ELECTRODOMESTICOS
11374572;;M;53;CHILENO;;X;CONSTITUCION                  ;MAULE;23990;1;1;0;0;0;1;1;23990;Licuadora L-1630V Negra 1,5Lts Vaso Vidrio;ELECTRODOMESTICOS
9200153;;M;60;CHILENO;;Boomers;RENCA                         ;METROPOLITANA;15990;1;1;0;0;0;1;1;15990;Hervidor Electrico HA-3300 2,5Lts Blanco;ELECTRODOMESTICOS
10893852;;F;58;CHILENO;;Boomers;VINA DEL MAR                  ;VALPARAISO;39980;2;1;0;0;0;2;1;39980;Batidora Manual BA-5010 Inox;ELECTRODOMESTICOS
26625021;;M;32;VENEZOLANO;;Extranjero;N/D;N/D;54990;1;1;0;0;0;1;1;54990;Batidora Vertical Minipimer UT-KLOT800SS;ELECTRODOMESTICOS
17914350;;M;31;CHILENO;;Millenial;CARAHUE                       ;ARAUCANIA;79990;1;1;1;1;79990;0;0;0;Horno Microondas Digital TH-25DM 25Lts;ELECTRODOMESTICOS
5591647;;F;70;CHILENO;;Silencioso;LAJA                          ;BIO BIO;34990;1;1;0;0;0;1;1;34990;Batidora Vertical Minipimer UT-KLOT400P;ELECTRODOMESTICOS
13991598;;F;41;CHILENO;;X;PROVIDENCIA                   ;METROPOLITANA;69990;1;1;0;0;0;1;1;69990;Horno electrico Black Oven 42lts;ELECTRODOMESTICOS
14470489;;M;48;CHILENO;;X;N/D;N/D;134970;3;1;0;0;0;3;1;134970;Horno Electrico UT-BACKOFEN38 38Lts;ELECTRODOMESTICOS
11999962;;M;49;CHILENO;;X;LINARES                       ;MAULE;103170;2;1;0;0;0;2;1;103170;Batidora Pedestal TH910PN 4,6Lts 1300Watts;ELECTRODOMESTICOS
6930583;;M;69;CHILENO;;Silencioso;RENCA                         ;METROPOLITANA;39990;1;1;0;0;0;1;1;39990;Aspiradora TH1407 Arrastre 1400Watts;ELECTRODOMESTICOS
9366645;;F;60;CHILENO;;Boomers;LOS ANGELES                   ;BIO BIO;11990;1;1;0;0;0;1;1;11990;Exprimidor de Jugo CJ-2000 1Lts;ELECTRODOMESTICOS
12242114;;F;50;CHILENO;;X;PUENTE ALTO                   ;METROPOLITANA;13240;2;1;0;0;0;2;1;13240;Hervidor Electrico TH-4212N 1,7Lts Negro;ELECTRODOMESTICOS
10100676;;F;57;CHILENO;;Boomers;CONCEPCION                    ;BIO BIO;165840;2;1;2;1;165840;0;0;0;MAQUINA COSER MERRITT ME 9300;ELECTRODOMESTICOS
9083717;;M;60;CHILENO;;Boomers;RENCA                         ;METROPOLITANA;69990;1;1;0;0;0;1;1;69990;Aspiradora UT-SILENT1804 Arrastre 1800Watts;ELECTRODOMESTICOS
8227445;Casado;F;62;CHILENO;;Boomers;RENCA                         ;METROPOLITANA;16990;1;1;0;0;0;1;1;16990;Batidora Manual 3532;ELECTRODOMESTICOS
8920694;;M;61;CHILENO;;Boomers;SANTIAGO                      ;METROPOLITANA;21230;3;1;0;0;0;3;1;21230;Exprimidor de Jugo CJ-2000 1Lts;ELECTRODOMESTICOS
10556491;Casado;F;54;CHILENO;;Boomers;RENCA                         ;METROPOLITANA;64990;1;1;0;0;0;1;1;64990;Aspiradora VCC4190V3E/XZS Arrastre 2000Watts;ELECTRODOMESTICOS
7529139;;F;69;CHILENO;;Silencioso;OSORNO                        ;LOS LAGOS;14990;1;1;0;0;0;1;1;14990;Tostador de Pan TH-116 2 Rebanadas Negro;ELECTRODOMESTICOS
15605453;Soltero;M;38;CHILENO;;Millenial;PROVIDENCIA                   ;METROPOLITANA;48980;2;1;2;1;48980;0;0;0;Hervidor Oster 4410sg Silver Gold;ELECTRODOMESTICOS
13782848;Soltero;M;51;CHILENO;;X;RENCA                         ;METROPOLITANA;22980;2;1;0;0;0;2;1;22980;Hervidor Electrico 3101 1,7Lts Negro;ELECTRODOMESTICOS
8593838;;F;61;CHILENO;;Boomers;PROVIDENCIA                   ;METROPOLITANA;143980;2;1;2;1;143980;0;0;0;CAFETERA PRIMA LATTE 6603 NEGRA;ELECTRODOMESTICOS
11999839;Casado;F;50;CHILENO;;X;COLBUN                        ;MAULE;24990;1;1;0;0;0;1;1;24990;Tostador de Pan TH-126 4 Rebanadas Negro;ELECTRODOMESTICOS
17166035;;F;33;CHILENO;;Millenial;LINARES                       ;MAULE;59990;1;3;0;0;0;1;3;59990;Horno Microondas Mecanico UT-SYDNEY18 18Lts;ELECTRODOMESTICOS
6813730;;M;71;CHILENO;;Silencioso;PROVIDENCIA                   ;METROPOLITANA;89990;1;1;0;0;0;1;1;89990;Batidora Pedestal TH910PN 4,6Lts 1300Watts;ELECTRODOMESTICOS
19477727;;M;25;CHILENO;;Z;VILCUN                        ;ARAUCANIA;19990;1;1;0;0;0;1;1;19990;Hervidor Electrico UT-DUNKEL17P 2Lts Negro;ELECTRODOMESTICOS
16909103;;F;34;CHILENO;;Silencioso;PROVIDENCIA                   ;METROPOLITANA;24990;1;1;0;0;0;1;1;24990;Batidora Manual BA-5010 Inox;ELECTRODOMESTICOS
18646488;;F;28;CHILENO;;Millenial;N/D;N/D;272360;3;2;0;0;0;3;2;272360;Horno Electrico TH-100i 100Lts;ELECTRODOMESTICOS
19088944;;F;27;CHILENO;;Z;ARAUCO                        ;BIO BIO;69990;1;1;0;0;0;1;1;69990;Aspiradora UT-SILENT1603 Arrastre 1600Watts;ELECTRODOMESTICOS
9262993;;F;59;CHILENO;;Boomers;RENCA                         ;METROPOLITANA;60970;3;1;0;0;0;3;1;60970;Hervidor Electrico UT-REIN17SS;ELECTRODOMESTICOS
9424828;;M;57;CHILENO;;Boomers;PROVIDENCIA                   ;METROPOLITANA;13990;1;1;0;0;0;1;1;13990;Exprimidor de Jugo CJ-2000 1Lts;ELECTRODOMESTICOS
8529740;;M;64;CHILENO;;Silencioso;PROVIDENCIA                   ;METROPOLITANA;64990;1;1;0;0;0;1;1;64990;Horno Microondas Mecanico TH-18B05 18Lts;ELECTRODOMESTICOS
15741189;;M;38;CHILENO;;X;LEBU                          ;BIO BIO;28990;1;1;0;0;0;1;1;28990;Combo Licuadora + Batidora;ELECTRODOMESTICOS
6946230;;M;68;CHILENO;;Boomers;ARICA                         ;ARICA Y PARINACOTA;11000;0;2;0;0;0;0;2;11000;Licuadora TH-401V Roja 1,75Lts Vaso Vidrio;ELECTRODOMESTICOS
9448000;;F;61;CHILENO;;Boomers;RENCA                         ;METROPOLITANA;139990;1;1;0;0;0;1;1;139990;Horno Electrico TH-80i 80Lts;ELECTRODOMESTICOS
6691801;;F;71;CHILENO;;Silencioso;MAIPU                         ;METROPOLITANA;24990;1;1;0;0;0;1;1;24990;Licuadora TH-320 Roja/Negro 1,5 Lts Vaso Vidrio;ELECTRODOMESTICOS
12224141;;F;49;CHILENO;;X;QUILPUE                       ;VALPARAISO;74990;1;1;0;0;0;1;1;74990;Horno Electrico TH-48N 48Lts;ELECTRODOMESTICOS
10443640;;F;57;CHILENO;;Boomers;OLMUE                         ;VALPARAISO;89990;1;1;0;0;0;1;1;89990;Batidora Pedestal TH910PN 4,6Lts 1300Watts;ELECTRODOMESTICOS
24612328;;F;59;COLOMBIANO;;Extranjero;SAN FELIPE                    ;VALPARAISO;72660;3;1;0;0;0;3;1;72660;Licuadora UT-METALLEK505P 1,5Lts Vaso Vidrio;ELECTRODOMESTICOS
15428446;;F;40;CHILENO;;X;SAN BERNARDO                  ;METROPOLITANA;14990;1;1;0;0;0;1;1;14990;Batidora Manual 3532;ELECTRODOMESTICOS
18056524;Soltero;M;29;CHILENO;;Millenial;PROVIDENCIA                   ;METROPOLITANA;10;-1;2;0;0;0;-1;2;10;Aspiradora TH1407 Arrastre 1400Watts;ELECTRODOMESTICOS
20709598;Casado;M;30;CHILENO;;Millenial;PROVIDENCIA                   ;METROPOLITANA;151540;2;1;2;1;151540;0;0;0;CAFETERA PRIMA LATTE 6603 NEGRA;ELECTRODOMESTICOS
18360304;;F;29;CHILENO;;Millenial;PROVIDENCIA                   ;METROPOLITANA;64990;1;1;0;0;0;1;1;64990;Horno Microondas Digital TH-20S01 20Lts;ELECTRODOMESTICOS
12987701;;F;46;CHILENO;;X;TEMUCO                        ;ARAUCANIA;84990;1;3;0;0;0;1;3;84990;Batidora Pedestal TH910PN 4,6Lts 1300Watts;ELECTRODOMESTICOS
14089053;;F;41;CHILENO;;X;PROVIDENCIA                   ;METROPOLITANA;14990;1;1;0;0;0;1;1;14990;Hervidor Electrico UT-MANLY17 1,7Lts Negro;ELECTRODOMESTICOS
18359364;;M;29;CHILENO;;Millenial;N/D;N/D;133980;2;1;2;1;133980;0;0;0;Maquina de Coser 3008 Janome Blanco;ELECTRODOMESTICOS
5045758;;M;77;CHILENO;;Silencioso;PROVIDENCIA                   ;METROPOLITANA;34990;1;1;0;0;0;1;1;34990;Licuadora UT-METALLEK505P 1,5Lts Vaso Vidrio;ELECTRODOMESTICOS
12491872;;M;49;CHILENO;;Silencioso;PROVIDENCIA                   ;METROPOLITANA;93980;2;1;0;0;0;2;1;93980;Horno Microondas Digital TH-25DM 25Lts;ELECTRODOMESTICOS
10732458;Viudo;F;54;CHILENO;;X;PROVIDENCIA                   ;METROPOLITANA;15990;1;1;0;0;0;1;1;15990;PLANCHA A VAPOR 6003 BASE ANTIADHERENTE 1600W;ELECTRODOMESTICOS
17120538;;F;33;CHILENO;;Millenial;PROVIDENCIA                   ;METROPOLITANA;0;0;0;0;0;0;0;0;0;Horno Microondas Digital MS23K3513AK/ZS 23Lts;ELECTRODOMESTICOS
7716643;;F;64;CHILENO;;Boomers;VINA DEL MAR                  ;VALPARAISO;0;0;0;0;0;0;0;0;0;Hervidor Electrico TH-5407i 2Lts;ELECTRODOMESTICOS
8226693;;F;60;CHILENO;;Boomers;ISLA DE MAIPO                 ;METROPOLITANA;0;0;0;0;0;0;0;0;0;Hervidor Electrico TH-4515N 2Lts Negro;ELECTRODOMESTICOS
7342462;;F;73;CHILENO;;Silencioso;N/D;N/D;0;0;0;0;0;0;0;0;0;Aspiradora TH1407 Arrastre 1400Watts;ELECTRODOMESTICOS
17584926;;F;31;CHILENO;;Silencioso;PROVIDENCIA                   ;METROPOLITANA;0;0;0;0;0;0;0;0;0;Robot aspirador Roomba 614;ELECTRODOMESTICOS
23161823;;F;43;BOLIVIANO;;Extranjero;TOCOPILLA                     ;ANTOFAGASTA;0;0;0;0;0;0;0;0;0;Hervidor Electrico TH-4515N 2Lts Negro;ELECTRODOMESTICOS
20376968;;M;22;CHILENO;;Z;PROVIDENCIA                   ;METROPOLITANA;0;0;0;0;0;0;0;0;0;Aspiradora UT-SILENT1603 Arrastre 1600Watts;ELECTRODOMESTICOS
10913616;;F;57;CHILENO;;Boomers;LONGAVI                       ;MAULE;0;0;0;0;0;0;0;0;0;Horno Electrico TH-80i 80Lts;ELECTRODOMESTICOS
7137808;Casado;M;64;CHILENO;;Boomers;SAN BERNARDO                  ;METROPOLITANA;0;0;0;0;0;0;0;0;0;PROCESADOR DE ALIMENTOS UT-PROCESSOR750;ELECTRODOMESTICOS
12755739;;M;47;CHILENO;;X;RANCAGUA                      ;L.G.B.OÂ´HIGGINS;0;0;0;0;0;0;0;0;0;Licuadora L-25000NG;ELECTRODOMESTICOS
20222348;;F;22;CHILENO;;Z;PROVIDENCIA                   ;METROPOLITANA;0;0;0;0;0;0;0;0;0;Hervidor Electrico 3100 1,7Lts Negro;ELECTRODOMESTICOS
9564905;;F;60;CHILENO;;Boomers;COQUIMBO                      ;COQUIMBO;0;0;0;0;0;0;0;0;0;Licuadora L-1630V Negra 1,5Lts Vaso Vidrio;ELECTRODOMESTICOS
11925928;;F;50;CHILENO;;X;N/D;N/D;0;0;0;0;0;0;0;0;0;Plancha TH-7052 2000Watts Base Inox;ELECTRODOMESTICOS
6767146;;F;67;CHILENO;;Boomers;RENCA                         ;METROPOLITANA;0;0;0;0;0;0;0;0;0;Tostador de Pan TH-126 4 Rebanadas Negro;ELECTRODOMESTICOS
10345588;;F;55;CHILENO;;X;TALCA                         ;MAULE;0;0;0;0;0;0;0;0;0;Horno Electrico TH-25N01 25Lts;ELECTRODOMESTICOS
10540719;;F;53;CHILENO;;X;EL BOSQUE                     ;METROPOLITANA;0;0;0;0;0;0;0;0;0;Hervidor Electrico HA-3300 2,5Lts Blanco;ELECTRODOMESTICOS
15120244;;M;37;CHILENO;;Millenial;RENCA                         ;METROPOLITANA;0;0;0;0;0;0;0;0;0;Batidora Pedestal B5300 Inox;ELECTRODOMESTICOS
11780968;Casado;F;51;CHILENO;;X;RENCA                         ;METROPOLITANA;0;0;0;0;0;0;0;0;0;Hervidor Electrico Tetera HA-4100 4Lts Iox;ELECTRODOMESTICOS
5202147;;M;75;CHILENO;;Silencioso;PROVIDENCIA                   ;METROPOLITANA;0;0;0;0;0;0;0;0;0;Exprimidor de Jugo 407W 1Lts;ELECTRODOMESTICOS
5237782;;M;73;CHILENO;;Silencioso;RENCA                         ;METROPOLITANA;0;0;0;0;0;0;0;0;0;Plancha THOMAS TH-7170 2200Watts Base Ceramica;ELECTRODOMESTICOS
19147879;;F;27;CHILENO;;Millenial;ARICA                         ;TARAPACA;0;0;0;0;0;0;0;0;0;Cafetera TH-130;ELECTRODOMESTICOS
5272446;;F;76;CHILENO;;Silencioso;PROVIDENCIA                   ;METROPOLITANA;0;0;0;0;0;0;0;0;0;Hervidor Electrico UT-DUNKEL17P 2Lts Negro;ELECTRODOMESTICOS
22562997;;M;34;PERUANO;;Extranjero;N/D;N/D;0;0;0;0;0;0;0;0;0;Aspiradora AP1700 Arrastre 1700Watts;ELECTRODOMESTICOS
13092284;;F;46;CHILENO;;X;PROVIDENCIA                   ;METROPOLITANA;0;0;0;0;0;0;0;0;0;Licuadora L-1630V Negra 1,5Lts Vaso Vidrio;ELECTRODOMESTICOS
14500016;;F;46;CHILENO;;X;RENCA                         ;METROPOLITANA;0;0;0;0;0;0;0;0;0;Combo Licuadora + Batidora;ELECTRODOMESTICOS
17563037;;F;32;CHILENO;;Millenial;SAN BERNARDO                  ;METROPOLITANA;0;0;0;0;0;0;0;0;0;HORNO ELECTRICO 16 LITROS HE-16NG;ELECTRODOMESTICOS
6798743;Casado;F;70;CHILENO;;Silencioso;OVALLE                        ;COQUIMBO;0;0;0;0;0;0;0;0;0;Batidora Pedestal TH910PN 4,6Lts 1300Watts;ELECTRODOMESTICOS
18189655;;M;29;CHILENO;;Millenial;PUENTE ALTO                   ;METROPOLITANA;0;0;0;0;0;0;0;0;0;Horno Electrico TH-48N 48Lts;ELECTRODOMESTICOS
13841225;;F;41;CHILENO;;X;LA PINTANA                    ;METROPOLITANA;0;0;0;0;0;0;0;0;0;Picadora UT-PETRUS320 1Lts Vaso Vidrio;ELECTRODOMESTICOS
16351739;;F;35;CHILENO;;Millenial;ALTO HOSPICIO;TARAPACA;0;0;0;0;0;0;0;0;0;Combo Hervidor + Batidora;ELECTRODOMESTICOS
18230003;;F;30;CHILENO;;Millenial;N/D;N/D;0;0;0;0;0;0;0;0;0;BATIDORA MANUAL 150W 5VEL. B-1500 BLANCA;ELECTRODOMESTICOS
10113741;;F;56;CHILENO;;Boomers;RENGO                         ;L.G.B.OÂ´HIGGINS;0;0;0;0;0;0;0;0;0;HERVIDOR TH-4340;ELECTRODOMESTICOS
18068929;;M;30;CHILENO;;Millenial;TALCAHUANO                    ;BIO BIO;0;0;0;0;0;0;0;0;0;ASPIRADORA THOMAS TH-1640;ELECTRODOMESTICOS
24254354;;F;36;CHILENO;;Millenial;"";"";0;0;0;0;0;0;0;0;0;Plancha a Vapor Oster 3803;ELECTRODOMESTICOS
6498595;;F;73;CHILENO;;Silencioso;SAN ANTONIO                   ;VALPARAISO;0;0;0;0;0;0;0;0;0;Licuadora L2000VNG 1,5Lts Vaso Vidrio;ELECTRODOMESTICOS
9930025;;F;59;CHILENO;;Boomers;GALVARINO                     ;ARAUCANIA;0;0;0;0;0;0;0;0;0;Maquina de Coser 311;ELECTRODOMESTICOS
10455633;Soltero;M;54;CHILENO;PROFESOR;Boomers;RENCA                         ;METROPOLITANA;0;0;0;0;0;0;0;0;0;Aspiradora UT-SILENT1603 Arrastre 1600Watts;ELECTRODOMESTICOS
24946540;;F;27;COLOMBIANO;;Extranjero;N/D;N/D;0;0;0;0;0;0;0;0;0;Horno Microondas Digital TH20DM 20Lts Espejado;ELECTRODOMESTICOS
5726618;Soltero;F;75;CHILENO;;Silencioso;PROVIDENCIA                   ;METROPOLITANA;0;0;0;0;0;0;0;0;0;Batidora Pedestal TH910PN 4,6Lts 1300Watts;ELECTRODOMESTICOS
14523660;;M;45;CHILENO;;X;N/D;N/D;0;0;0;0;0;0;0;0;0;Aspiradora UT-SILENT1603 Arrastre 1600Watts;ELECTRODOMESTICOS
19986276;;M;23;CHILENO;;Silencioso;PROVIDENCIA                   ;METROPOLITANA;0;0;0;0;0;0;0;0;0;Batidora Pedestal TH910PN 4,6Lts 1300Watts;ELECTRODOMESTICOS
11790210;;F;50;CHILENO;;X;CHILLAN                       ;BIO BIO;0;0;0;0;0;0;0;0;0;Plancha UT-KERAMIKTOP 2200Watts Base Ceramica;ELECTRODOMESTICOS
26143448;;F;47;EXTRANJERO - NO INFORMA NACIONALIDAD;;Extranjero;N/D;N/D;0;0;0;0;0;0;0;0;0;BATIDORA INMERSION S MIX 2616;ELECTRODOMESTICOS
8013148;;M;62;CHILENO;;Boomers;RENCA                         ;METROPOLITANA;0;0;0;0;0;0;0;0;0;HORNO ELECTRICO 16N01 16LTS NEGRO;ELECTRODOMESTICOS
12191838;;M;51;CHILENO;;X;NUEVA IMPERIAL                ;ARAUCANIA;0;0;0;0;0;0;0;0;0;Hervidor Electrico UT-MANLY17 1,7Lts Negro;ELECTRODOMESTICOS
7989408;Divorciado;F;58;CHILENO;;Boomers;PROVIDENCIA                   ;METROPOLITANA;0;0;0;0;0;0;0;0;0;Horno Electrico TH-38N 38Lts;ELECTRODOMESTICOS
18414996;;M;29;CHILENO;;Millenial;N/D;N/D;0;0;0;0;0;0;0;0;0;Cafetera UT-KAFFEEKLASSIK;ELECTRODOMESTICOS
6725399;;F;71;CHILENO;;Silencioso;TEMUCO                        ;ARAUCANIA;0;0;0;0;0;0;0;0;0;Tostador de Pan TH-126 4 Rebanadas Negro;ELECTRODOMESTICOS
7230536;;M;65;CHILENO;;Boomers;PUNTA ARENAS                  ;MAGALLANES;0;0;0;0;0;0;0;0;0;Horno Microondas Digital L UT-25KROMM 25Lts;ELECTRODOMESTICOS
25667229;;M;31;VENEZOLANO;;Extranjero;N/D;N/D;0;0;0;0;0;0;0;0;0;Aspiradora Mi Robot Vacuum-Mop Essential;ELECTRODOMESTICOS
17557727;;M;31;CHILENO;;Millenial;ANTOFAGASTA;ANTOFAGASTA;0;0;0;0;0;0;0;0;0;Aspiradora Roomba 621;ELECTRODOMESTICOS
17620766;;F;28;CHILENO;;Millenial;LITUECHE                      ;L.G.B.OÂ´HIGGINS;0;0;0;0;0;0;0;0;0;Aspiradora Tambor APA1000 1000Watts;ELECTRODOMESTICOS
8960364;;M;60;CHILENO;;Boomers;LINARES                       ;MAULE;0;0;0;0;0;0;0;0;0;Licuadora L-25000NG;ELECTRODOMESTICOS
6846627;;M;70;CHILENO;;Silencioso;PROVIDENCIA                   ;METROPOLITANA;0;0;0;0;0;0;0;0;0;Horno Electrico TH-80i 80Lts;ELECTRODOMESTICOS
19528553;;F;25;CHILENO;;Silencioso;PROVIDENCIA                   ;METROPOLITANA;0;0;0;0;0;0;0;0;0;Licuadora Personal TH-300PB;ELECTRODOMESTICOS
7390306;;M;63;CHILENO;;Boomers;PROVIDENCIA                   ;METROPOLITANA;0;0;0;0;0;0;0;0;0;Hervidor Electrico HA-3300 2,5Lts Blanco;ELECTRODOMESTICOS
16490715;;F;36;CHILENO;;Millenial;PROVIDENCIA                   ;METROPOLITANA;0;0;0;0;0;0;0;0;0;Horno Electrico TH-80i 80Lts;ELECTRODOMESTICOS
10238276;;M;57;CHILENO;;Boomers;CARAHUE                       ;ARAUCANIA;0;0;0;0;0;0;0;0;0;Batidora Pedestal TH910PN 4,6Lts 1300Watts;ELECTRODOMESTICOS
5088520;;M;79;CHILENO;;Silencioso;PUTAENDO                      ;VALPARAISO;0;0;0;0;0;0;0;0;0;Aspiradora UT-SILENT1804 Arrastre 1800Watts;ELECTRODOMESTICOS
10086776;;F;58;CHILENO;;Silencioso;PROVIDENCIA                   ;METROPOLITANA;0;0;0;0;0;0;0;0;0;Hervidor Electrico UT-MANLY17 1,7Lts Negro;ELECTRODOMESTICOS
4979999;;F;78;CHILENO;;Silencioso;SAN RAFAEL                    ;MAULE;0;0;0;0;0;0;0;0;0;Hervidor Electrico UT-REIN17SS;ELECTRODOMESTICOS
11563737;;F;52;CHILENO;;X;RENCA                         ;METROPOLITANA;0;0;0;0;0;0;0;0;0;Batidora Vertical Stick Mixer 2609;ELECTRODOMESTICOS
7625586;Casado;F;66;CHILENO;;Boomers;RENCA                         ;METROPOLITANA;0;0;0;0;0;0;0;0;0;Batidora Manual UT-TEKLA300;ELECTRODOMESTICOS
15039430;;M;40;CHILENO;;X;RENCA                         ;METROPOLITANA;0;0;0;0;0;0;0;0;0;Licuadora UT-METALLEK805R 1,75Lts Vaso Vidrio;ELECTRODOMESTICOS
21154325;;F;39;BOLIVIANO;;Extranjero;CALAMA                        ;ANTOFAGASTA;0;0;0;0;0;0;0;0;0;Aspiradora TH1407 Arrastre 1400Watts;ELECTRODOMESTICOS
26440222;;M;43;CHILENO;;Extranjero;N/D;N/D;0;0;0;0;0;0;0;0;0;Aspiradora Handy Clean Black 1400;ELECTRODOMESTICOS
7593802;;F;71;CHILENO;;Silencioso;VALDIVIA                      ;LOS RIOS;0;0;0;0;0;0;0;0;0;Horno Microondas Mecanico UT-SYDNEY18 18Lts;ELECTRODOMESTICOS
5758915;;F;75;CHILENO;;Silencioso;PROVIDENCIA                   ;METROPOLITANA;0;0;0;0;0;0;0;0;0;Maquina de coser Singer 024;ELECTRODOMESTICOS
8790889;;F;63;CHILENO;;Boomers;COINCO                        ;L.G.B.OÂ´HIGGINS;0;0;0;0;0;0;0;0;0;Batidora Manual 3532;ELECTRODOMESTICOS
25879386;;M;48;VENEZOLANO;;Extranjero;N/D;N/D;0;0;0;0;0;0;0;0;0;Licuadora Kaliman Negra con Teclas;ELECTRODOMESTICOS
11002359;;F;59;CHILENO;;Boomers;N/D;N/D;0;0;0;0;0;0;0;0;0;Licuadora UT-METALLEK505P 1,5Lts Vaso Vidrio;ELECTRODOMESTICOS
16918866;;M;34;CHILENO;;Millenial;PUNTA ARENAS                  ;MAGALLANES;0;0;0;0;0;0;0;0;0;Licuadora TH-501V 1,5Lts Vaso Vidrio;ELECTRODOMESTICOS
21751165;;M;51;BOLIVIANO;;Extranjero;IQUIQUE                       ;TARAPACA;0;0;0;0;0;0;0;0;0;Hervidor Electrico Control Temp 8970 1,7Lts Inox;ELECTRODOMESTICOS
14536038;Casado;M;48;CHILENO;;X;RENCA                         ;METROPOLITANA;0;0;0;0;0;0;0;0;0;Hervidor Electrico HA-2650NG;ELECTRODOMESTICOS
8177281;;F;64;CHILENO;;Boomers;RENCA                         ;METROPOLITANA;0;0;0;0;0;0;0;0;0;Plancha THOMAS TH-7170 2200Watts Base Ceramica;ELECTRODOMESTICOS
19591886;;F;25;CHILENO;;Z;N/D;N/D;0;0;0;0;0;0;0;0;0;CAFETERA PRIMA LATTE 6603 NEGRA;ELECTRODOMESTICOS
6840850;;F;66;CHILENO;;Boomers;VINA DEL MAR                  ;VALPARAISO;0;0;0;0;0;0;0;0;0;Horno Microondas Digital TH-20S01 20Lts;ELECTRODOMESTICOS
6719915;;F;63;CHILENO;;Boomers;MAIPU                         ;METROPOLITANA;0;0;0;0;0;0;0;0;0;HORNO ELECTRICO 16N01 16LTS NEGRO;ELECTRODOMESTICOS
8710604;;F;56;CHILENO;;Boomers;PROVIDENCIA                   ;METROPOLITANA;0;0;0;0;0;0;0;0;0;Licuadora L-25000NG;ELECTRODOMESTICOS
19027233;;M;27;CHILENO;;Z;PUENTE ALTO                   ;METROPOLITANA;0;0;0;0;0;0;0;0;0;Aspiradora Trapeadora Robot Ut-Excellenza (B);ELECTRODOMESTICOS
10202240;;F;57;CHILENO;;Boomers;SAN ANTONIO                   ;VALPARAISO;0;0;0;0;0;0;0;0;0;HERVIDOR TETERA RELOJ 900R 2,5L ROJO;ELECTRODOMESTICOS
14539134;;M;42;CHILENO;;X;N/D;N/D;0;0;0;0;0;0;0;0;0;Hervidor Electrico Tetera HA-4100 4Lts Iox;ELECTRODOMESTICOS
13800075;;F;41;CHILENO;;X;YUMBEL                        ;BIO BIO;0;0;0;0;0;0;0;0;0;Exprimidor de Jugo 407W 1Lts;ELECTRODOMESTICOS
13272935;Soltero;F;44;CHILENO;INGENIERO EN ALIMENTOS;X;RENCA                         ;METROPOLITANA;0;0;0;0;0;0;0;0;0;Batidora Vertical Stick Mixer 2609;ELECTRODOMESTICOS
10882776;;F;54;CHILENO;;Boomers;PROVIDENCIA                   ;METROPOLITANA;0;0;0;0;0;0;0;0;0;Combo Licuadora + Batidora;ELECTRODOMESTICOS
18887724;;M;27;CHILENO;;Z;VALDIVIA                      ;LOS LAGOS;0;0;0;0;0;0;0;0;0;Hervidor Electrico 3101 1,7Lts Negro;ELECTRODOMESTICOS
26763965;;M;37;HAITIANO;;Extranjero;HUALQUI                       ;BIO BIO;0;0;0;0;0;0;0;0;0;Licuadora TH-320 Roja/Negro 1,5 Lts Vaso Vidrio;ELECTRODOMESTICOS
12665730;;F;48;CHILENO;;X;MACUL                         ;METROPOLITANA;0;0;0;0;0;0;0;0;0;Horno Microondas Mecanico Fancy 20Lts;ELECTRODOMESTICOS
7850654;;F;63;CHILENO;;Boomers;PROVIDENCIA                   ;METROPOLITANA;0;0;0;0;0;0;0;0;0;Hervidor Electrico 3100 1,7Lts Negro;ELECTRODOMESTICOS
9731695;Casado;F;62;CHILENO;;Boomers;RENCA                         ;METROPOLITANA;0;0;0;0;0;0;0;0;0;Horno Electrico TH-38N 38Lts;ELECTRODOMESTICOS
18389157;;M;28;CHILENO;;Millenial;ANTOFAGASTA                   ;ANTOFAGASTA;0;0;0;0;0;0;0;0;0;MICROONDAS ME83X/XZS SAMSUNG MIRROR;ELECTRODOMESTICOS
18016604;Casado;M;30;CHILENO;;Millenial;RENCA                         ;METROPOLITANA;0;0;0;0;0;0;0;0;0;Horno Microondas Digital UT-CLASSY720 20Lts;ELECTRODOMESTICOS
23875245;;M;37;VENEZOLANO;;Extranjero;PROVIDENCIA                   ;METROPOLITANA;0;0;0;0;0;0;0;0;0;Maquina de Coser JS-2135CL Calipso;ELECTRODOMESTICOS
6778259;Soltero;M;71;CHILENO;;Silencioso;GORBEA                        ;ARAUCANIA;0;0;0;0;0;0;0;0;0;Batidora Manual 3532;ELECTRODOMESTICOS
7790901;;M;66;CHILENO;;Boomers;MAULE                         ;MAULE;0;0;0;0;0;0;0;0;0;Aspiradora UT-SILENT1603 Arrastre 1600Watts;ELECTRODOMESTICOS
16989738;;F;33;CHILENO;;Millenial;CALERA                        ;VALPARAISO;0;0;0;0;0;0;0;0;0;Licuadora TH-401V Roja 1,75Lts Vaso Vidrio;ELECTRODOMESTICOS
7729003;;M;67;CHILENO;;Boomers;RETIRO                        ;MAULE;0;0;0;0;0;0;0;0;0;Horno Electrico TH62I 60Lts;ELECTRODOMESTICOS
9867588;;M;58;CHILENO;;Boomers;EL BOSQUE                     ;METROPOLITANA;0;0;0;0;0;0;0;0;0;Hervidor Electrico UT-DUNKEL17P 2Lts Negro;ELECTRODOMESTICOS
13413918;Casado;F;43;CHILENO;;X;PROVIDENCIA                   ;METROPOLITANA;0;0;0;0;0;0;0;0;0;Horno Electrico TH-38N 38Lts;ELECTRODOMESTICOS
7823525;Casado;M;61;CHILENO;;Boomers;SAN FERNANDO                  ;L.G.B.OÂ´HIGGINS;0;0;0;0;0;0;0;0;0;Horno Microondas Mecanico TH-18B05 18Lts;ELECTRODOMESTICOS
11950884;Casado;M;50;CHILENO;;Silencioso;PROVIDENCIA                   ;METROPOLITANA;0;0;0;0;0;0;0;0;0;Horno Electrico UT-BACKOFEN48 48Lts;ELECTRODOMESTICOS
7896589;;F;62;CHILENO;;Boomers;CERRO NAVIA                   ;METROPOLITANA;0;0;0;0;0;0;0;0;0;PICADORA 123 SILHQUETTE;ELECTRODOMESTICOS
19933035;;F;24;CHILENO;;Silencioso;PROVIDENCIA                   ;METROPOLITANA;0;0;0;0;0;0;0;0;0;Maquina de Coser 3008 Janome Blanco;ELECTRODOMESTICOS
8873267;;M;63;CHILENO;;Boomers;VALLENAR;ATACAMA;0;0;0;0;0;0;0;0;0;Batidora Vertical Multimixer TH-8720;ELECTRODOMESTICOS
25108969;;F;28;BOLIVIANO;;Extranjero;N/D;N/D;0;0;0;0;0;0;0;0;0;Combo Licuadora + Batidora;ELECTRODOMESTICOS
8542790;;F;64;CHILENO;;Silencioso;PROVIDENCIA                   ;METROPOLITANA;0;0;0;0;0;0;0;0;0;Horno Microondas Digital MS23K3513AK/ZS 23Lts;ELECTRODOMESTICOS
7186753;;F;68;CHILENO;;Boomers;TALCAHUANO                    ;BIO BIO;0;0;0;0;0;0;0;0;0;Hervidor Electrico UT-KLAR20PW 2Lts Blanco;ELECTRODOMESTICOS
11724284;;M;50;CHILENO;;X;TIERRA AMARILLA               ;ATACAMA;0;0;0;0;0;0;0;0;0;Horno Electrico TH-38N 38Lts;ELECTRODOMESTICOS
11248903;;M;54;CHILENO;;Boomers;N/D;N/D;0;0;0;0;0;0;0;0;0;Licuadora L-5500IN 1,5Lts;ELECTRODOMESTICOS
13135225;;F;45;CHILENO;;X;TALCAHUANO                    ;BIO BIO;0;0;0;0;0;0;0;0;0;Exprimidor de Jugo CJ-2000 1Lts;ELECTRODOMESTICOS
12910122;;F;46;CHILENO;;X;COQUIMBO                      ;COQUIMBO;0;0;0;0;0;0;0;0;0;Batidora Vertical Minipimer UT-KLOT400P;ELECTRODOMESTICOS
18683186;;F;27;CHILENO;;Silencioso;PROVIDENCIA                   ;METROPOLITANA;0;0;0;0;0;0;0;0;0;Batidora Vertical Minipimer UT-KLOT400P;ELECTRODOMESTICOS
23065756;;M;37;PERUANO;;Extranjero;RECOLETA                      ;METROPOLITANA;0;0;0;0;0;0;0;0;0;Horno Electrico UT-LEIF36 36Lts;ELECTRODOMESTICOS
16388670;;M;38;CHILENO;;Millenial;PROVIDENCIA                   ;METROPOLITANA;0;0;0;0;0;0;0;0;0;Horno Electrico HE-300NG 30Lts;ELECTRODOMESTICOS
10673938;;M;56;CHILENO;;Boomers;PUERTO MONTT                  ;LOS LAGOS;0;0;0;0;0;0;0;0;0;MULTIMIXER THOMAS TH- 8706;ELECTRODOMESTICOS
6672412;;F;67;CHILENO;;Boomers;RENCA                         ;METROPOLITANA;0;0;0;0;0;0;0;0;0;Licuadora TH-320 Roja/Negro 1,5 Lts Vaso Vidrio;ELECTRODOMESTICOS
5774436;;F;70;CHILENO;;Silencioso;PUENTE ALTO                   ;METROPOLITANA;0;0;0;0;0;0;0;0;0;Hervidor Electrico UT-KLAR20PW 2Lts Blanco;ELECTRODOMESTICOS
12372089;;F;49;CHILENO;;X;RENCA                         ;METROPOLITANA;0;0;0;0;0;0;0;0;0;Batidora Manual UT-TEKLA300;ELECTRODOMESTICOS
18016141;;F;30;CHILENO;;Millenial;ANCUD                         ;LOS LAGOS;0;0;0;0;0;0;0;0;0;HORNO ELECTRICO 16N01 16LTS NEGRO;ELECTRODOMESTICOS
17372188;;M;32;CHILENO;;Silencioso;PROVIDENCIA                   ;METROPOLITANA;0;0;0;0;0;0;0;0;0;Hervidor Electrico TH-4212N 1,7Lts Negro;ELECTRODOMESTICOS
16309876;;F;36;CHILENO;;Millenial;TALCAHUANO                    ;BIO BIO;0;0;0;0;0;0;0;0;0;Tostador de Pan TH-126 4 Rebanadas Negro;ELECTRODOMESTICOS
9779661;;F;59;CHILENO;;Boomers;RENCA                         ;METROPOLITANA;0;0;0;0;0;0;0;0;0;Plancha TH-7052 2000Watts Base Inox;ELECTRODOMESTICOS
16975613;;F;33;CHILENO;;Millenial;RENCA                         ;METROPOLITANA;0;0;0;0;0;0;0;0;0;Batidora Pedestal TH910PN 4,6Lts 1300Watts;ELECTRODOMESTICOS
13953180;;F;42;CHILENO;;X;N/D;N/D;0;0;0;0;0;0;0;0;0;Aspiradora TH1407 Arrastre 1400Watts;ELECTRODOMESTICOS
5821159;;F;69;CHILENO;;Silencioso;TALCAHUANO                    ;BIO BIO;0;0;0;0;0;0;0;0;0;PICADORA 123 SILHQUETTE;ELECTRODOMESTICOS
12945931;;M;45;CHILENO;;X;IQUIQUE                       ;TARAPACA;0;0;0;0;0;0;0;0;0;Hervidor Electrico TH-4515N 2Lts Negro;ELECTRODOMESTICOS
13393920;;F;44;CHILENO;;X;ANGOL                         ;ARAUCANIA;0;0;0;0;0;0;0;0;0;Horno Electrico TH-25N01 25Lts;ELECTRODOMESTICOS
15560635;;F;39;CHILENO;;X;N/D;N/D;0;0;0;0;0;0;0;0;0;Exprimidor Fauna 500 cc;ELECTRODOMESTICOS
15525487;;F;39;CHILENO;;X;SANTA CRUZ                    ;L.G.B.OÂ´HIGGINS;0;0;0;0;0;0;0;0;0;Horno Electrico UT-BACKOFEN48 48Lts;ELECTRODOMESTICOS
7608486;;M;64;CHILENO;;Boomers;N/D;N/D;0;0;0;0;0;0;0;0;0;Hervidor Electrico UT-MANLY17 1,7Lts Negro;ELECTRODOMESTICOS
11252286;;M;54;CHILENO;;X;PROVIDENCIA                   ;METROPOLITANA;0;0;0;0;0;0;0;0;0;Exprimidor Fauna 500 cc;ELECTRODOMESTICOS
19465684;;F;26;CHILENO;;Z;PROVIDENCIA                   ;METROPOLITANA;0;0;0;0;0;0;0;0;0;ARROCERA ROJA 4723;ELECTRODOMESTICOS
17364842;;F;32;CHILENO;;Millenial;N/D;N/D;0;0;0;0;0;0;0;0;0;Parrilla Electrica TH-180;ELECTRODOMESTICOS
19722611;;M;24;CHILENO;;Z;PROVIDENCIA                   ;METROPOLITANA;0;0;0;0;0;0;0;0;0;Licuadora L-1630V Negra 1,5Lts Vaso Vidrio;ELECTRODOMESTICOS
12590591;;F;47;CHILENO;;X;CONSTITUCION                  ;MAULE;0;0;0;0;0;0;0;0;0;Licuadora L-1630V Negra 1,5Lts Vaso Vidrio;ELECTRODOMESTICOS
10440778;;M;57;CHILENO;;Boomers;PROVIDENCIA                   ;METROPOLITANA;0;0;0;0;0;0;0;0;0;Horno Microondas Digital UT-CLASSY720 20Lts;ELECTRODOMESTICOS
16333314;;M;36;CHILENO;;Millenial;SAN FELIPE                    ;VALPARAISO;0;0;0;0;0;0;0;0;0;Licuadora L-25000NG;ELECTRODOMESTICOS
9838718;;F;57;CHILENO;;Boomers;MAIPU                         ;METROPOLITANA;0;0;0;0;0;0;0;0;0;Batidora Manual BA-5010 Inox;ELECTRODOMESTICOS
17714133;;M;31;CHILENO;;Millenial;MONTE PATRIA                  ;COQUIMBO;0;0;0;0;0;0;0;0;0;BATIDORA INMERSION S MIX 2616;ELECTRODOMESTICOS
10936326;Soltero;F;55;CHILENO;;Boomers;RENCA                         ;METROPOLITANA;0;0;0;0;0;0;0;0;0;Licuadora L-5500IN 1,5Lts;ELECTRODOMESTICOS
11843514;;F;55;CHILENO;;Boomers;COLINA                        ;METROPOLITANA;0;0;0;0;0;0;0;0;0;Aspiradora Tambor APA1000 1000Watts;ELECTRODOMESTICOS
24244531;;F;36;PERUANO;;Extranjero;ESTACION CENTRAL              ;METROPOLITANA;0;0;0;0;0;0;0;0;0;Batidora Pedestal TH910PN 4,6Lts 1300Watts;ELECTRODOMESTICOS
10163063;;F;56;CHILENO;;Boomers;RENCA                         ;METROPOLITANA;0;0;0;0;0;0;0;0;0;Licuadora L-5500IN 1,5Lts;ELECTRODOMESTICOS
19725467;;M;24;CHILENO;;Z;PROVIDENCIA                   ;METROPOLITANA;0;0;0;0;0;0;0;0;0;Horno Electrico TH-38N 38Lts;ELECTRODOMESTICOS
12910747;;M;46;CHILENO;;X;TALCA                         ;MAULE;0;0;0;0;0;0;0;0;0;Hervidor Electrico Tetera HA-4100 4Lts Iox;ELECTRODOMESTICOS
11179103;Casado;F;54;CHILENO;;Boomers;SAN PEDRO DE LA PAZ           ;BIO BIO;0;0;0;0;0;0;0;0;0;Batidora Manual TH-8830;ELECTRODOMESTICOS
10120967;;F;58;CHILENO;;Boomers;MARIA PINTO                   ;METROPOLITANA;0;0;0;0;0;0;0;0;0;Plancha UT-SHANGRILA Inalambrica 2200Watss;ELECTRODOMESTICOS
7302139;;F;68;CHILENO;;Boomers;VALDIVIA                      ;LOS RIOS;0;0;0;0;0;0;0;0;0;Aspiradora UT-SILENT1804 Arrastre 1800Watts;ELECTRODOMESTICOS
9286829;Casado;M;57;CHILENO;;Boomers;RENCA                         ;METROPOLITANA;0;0;0;0;0;0;0;0;0;Aspiradora TH1415 Arrastre 1500Watts;ELECTRODOMESTICOS
8496927;Casado;M;69;CHILENO;AGROINDUSTRIA;Silencioso;RENCA                         ;METROPOLITANA;0;0;0;0;0;0;0;0;0;MULTIMIXER THOMAS TH- 8706;ELECTRODOMESTICOS
12545515;Divorciado;F;48;CHILENO;;X;RENCA                         ;METROPOLITANA;0;0;0;0;0;0;0;0;0;Horno Electrico TH-48N 48Lts;ELECTRODOMESTICOS
17633923;;F;32;CHILENO;;Millenial;N/D;N/D;0;0;0;0;0;0;0;0;0;Horno Electrico TH-25N01 25Lts;ELECTRODOMESTICOS
19554824;;F;25;CHILENO;;Z;PROVIDENCIA                   ;METROPOLITANA;0;0;0;0;0;0;0;0;0;Licuadora TH-401V Roja 1,75Lts Vaso Vidrio;ELECTRODOMESTICOS
20060530;;F;23;CHILENO;;Silencioso;PROVIDENCIA                   ;METROPOLITANA;0;0;0;0;0;0;0;0;0;Hervidor Electrico TH-5407i 2Lts;ELECTRODOMESTICOS
19300520;;M;25;CHILENO;;Z;N/D;N/D;0;0;0;0;0;0;0;0;0;Plancha UT-DUNST 2200Watts Base Ceramica;ELECTRODOMESTICOS
16685617;;F;35;CHILENO;;X;PROVIDENCIA                   ;METROPOLITANA;0;0;0;0;0;0;0;0;0;Set Picador KP-123BL 1,2Lts;ELECTRODOMESTICOS
9463239;;F;61;CHILENO;;Boomers;PUENTE ALTO                   ;METROPOLITANA;0;0;0;0;0;0;0;0;0;Hervidor Electrico TH-4515N 2Lts Negro;ELECTRODOMESTICOS
8529209;;F;63;CHILENO;;Boomers;N/D;N/D;0;0;0;0;0;0;0;0;0;Horno Electrico TH-25N01 25Lts;ELECTRODOMESTICOS
17396307;;F;32;CHILENO;;Millenial;SAN PEDRO DE LA PAZ           ;BIO BIO;0;0;0;0;0;0;0;0;0;Horno Microondas Mecanico M-2030 NG 20Lts;ELECTRODOMESTICOS
13602872;;F;42;CHILENO;;X;SAN CARLOS                    ;BIO BIO;0;0;0;0;0;0;0;0;0;PLANCHA A VAPOR 6953 BASE AEROCERAMICA AUTAPA.22;ELECTRODOMESTICOS
16644434;;M;34;CHILENO;;Millenial;N/D;N/D;0;0;0;0;0;0;0;0;0;Licuadora TH-320 Roja/Negro 1,5 Lts Vaso Vidrio;ELECTRODOMESTICOS
15894492;;F;38;CHILENO;;Silencioso;PROVIDENCIA                   ;METROPOLITANA;0;0;0;0;0;0;0;0;0;Aspiradora UT-SILENT1804 Arrastre 1800Watts;ELECTRODOMESTICOS
18257796;;M;29;CHILENO;;Millenial;LIMACHE                       ;VALPARAISO;0;0;0;0;0;0;0;0;0;Horno Microondas Mecanico TH-18B05 18Lts;ELECTRODOMESTICOS
11586283;;M;51;CHILENO;;Silencioso;PROVIDENCIA                   ;METROPOLITANA;0;0;0;0;0;0;0;0;0;Licuadora UT-METALLEK505P 1,5Lts Vaso Vidrio;ELECTRODOMESTICOS
18137040;;F;30;CHILENO;;Millenial;CORONEL                       ;BIO BIO;0;0;0;0;0;0;0;0;0;Batidora Vertical Minipimer UT-KLOT400P;ELECTRODOMESTICOS
9518943;;F;58;CHILENO;;Boomers;ALTO HOSPICIO;TARAPACA;0;0;0;0;0;0;0;0;0;Licuadora TH-320 Roja/Negro 1,5 Lts Vaso Vidrio;ELECTRODOMESTICOS
19389350;;F;26;CHILENO;;Silencioso;PROVIDENCIA                   ;METROPOLITANA;0;0;0;0;0;0;0;0;0;Horno Electrico TH-25N01 25Lts;ELECTRODOMESTICOS
16102713;;M;36;CHILENO;;Millenial;COIHAIQUE                     ;AYSEN;0;0;0;0;0;0;0;0;0;Aspiradora UT-SILENT1804 Arrastre 1800Watts;ELECTRODOMESTICOS
16611745;;F;33;CHILENO;;Millenial;PROVIDENCIA                   ;METROPOLITANA;0;0;0;0;0;0;0;0;0;Horno Microondas Digital MS23K3513AK/ZS 23Lts;ELECTRODOMESTICOS
10331332;;F;57;CHILENO;;Boomers;RENCA                         ;METROPOLITANA;0;0;0;0;0;0;0;0;0;Batidora Vertical Minipimer UT-KLOT400P;ELECTRODOMESTICOS
9655207;;M;57;CHILENO;;Boomers;DALCAHUE                      ;LOS LAGOS;0;0;0;0;0;0;0;0;0;Aspiradora TH1415 Arrastre 1500Watts;ELECTRODOMESTICOS
16010440;;F;37;CHILENO;;Silencioso;LAGUNA BLANCA                 ;MAGALLANES;0;0;0;0;0;0;0;0;0;Horno Microondas Mecanico UT-SYDNEY18 18Lts;ELECTRODOMESTICOS
18022558;;F;30;CHILENO;;Millenial;PROVIDENCIA                   ;METROPOLITANA;0;0;0;0;0;0;0;0;0;BATIDORA PEDESTAL THOMAS TH-910PB;ELECTRODOMESTICOS
16156921;;F;36;CHILENO;;Millenial;PROVIDENCIA                   ;METROPOLITANA;0;0;0;0;0;0;0;0;0;Aspiradora AP1700 Arrastre 1700Watts;ELECTRODOMESTICOS
15238273;;F;47;CHILENO;;X;PROVIDENCIA                   ;METROPOLITANA;0;0;0;0;0;0;0;0;0;Horno Microondas Mecanico TH-18B05 18Lts;ELECTRODOMESTICOS
15716199;;F;38;CHILENO;;X;PROVIDENCIA                   ;METROPOLITANA;0;0;0;0;0;0;0;0;0;Parrilla Electrica TH-224;ELECTRODOMESTICOS
13878423;;F;42;CHILENO;;X;SAN VICENTE                   ;L.G.B.OÂ´HIGGINS;0;0;0;0;0;0;0;0;0;Aspiradora Trapeadora Robot Ut-Excellenza (B);ELECTRODOMESTICOS
7087473;Viudo;M;69;CHILENO;;Silencioso;ANTOFAGASTA                   ;ANTOFAGASTA;0;0;0;0;0;0;0;0;0;Hervidor Electrico TH-4515N 2Lts Negro;ELECTRODOMESTICOS
7379769;;F;70;CHILENO;;Silencioso;VALDIVIA                      ;LOS RIOS;0;0;0;0;0;0;0;0;0;LICUADORA CROMADA CON TECLAS PLUS;ELECTRODOMESTICOS
17599055;Soltero;M;32;CHILENO;;Millenial;SANTIAGO                      ;METROPOLITANA;0;0;0;0;0;0;0;0;0;Horno Microondas Mecanico Easy Wave 20Lts;ELECTRODOMESTICOS
8409571;;M;51;CHILENO;;X;HUECHURABA                    ;METROPOLITANA;0;0;0;0;0;0;0;0;0;Horno Microondas Digital L UT-25KROMM 25Lts;ELECTRODOMESTICOS
17119060;;M;33;CHILENO;;Millenial;VINA DEL MAR                  ;VALPARAISO;0;0;0;0;0;0;0;0;0;Horno Microondas Digital TH-20S01 20Lts;ELECTRODOMESTICOS
14380105;Soltero;F;45;CHILENO;CONTADOR AUDITOR;X;RENCA                         ;METROPOLITANA;0;0;0;0;0;0;0;0;0;Hervidor Electrico TH-4212N 1,7Lts Negro;ELECTRODOMESTICOS
13911803;;F;42;CHILENO;;X;PROVIDENCIA                   ;METROPOLITANA;0;0;0;0;0;0;0;0;0;Licuadora TH-501V 1,5Lts Vaso Vidrio;ELECTRODOMESTICOS
7648041;;F;56;CHILENO;;Boomers;PROVIDENCIA                   ;METROPOLITANA;0;0;0;0;0;0;0;0;0;Horno Microondas Mecanico UT-SYDNEY18 18Lts;ELECTRODOMESTICOS
16950624;;M;33;CHILENO;;Millenial;LONCOCHE                      ;ARAUCANIA;0;0;0;0;0;0;0;0;0;Aspiradora AP1700 Arrastre 1700Watts;ELECTRODOMESTICOS
17243346;;F;33;CHILENO;;Millenial;LA PINTANA                    ;METROPOLITANA;0;0;0;0;0;0;0;0;0;Horno Electrico TH-25N01 25Lts;ELECTRODOMESTICOS
5912990;;F;74;CHILENO;;Silencioso;VINA DEL MAR                  ;VALPARAISO;0;0;0;0;0;0;0;0;0;Horno Microondas Digital TH-20S01 20Lts;ELECTRODOMESTICOS
17691392;;M;31;CHILENO;;Millenial;SAN FERNANDO                  ;L.G.B.OÂ´HIGGINS;0;0;0;0;0;0;0;0;0;Cafetera TH-130;ELECTRODOMESTICOS
18461227;Soltero;M;29;CHILENO;INGENIERO INFORMATICO;Millenial;PROVIDENCIA                   ;METROPOLITANA;0;0;0;0;0;0;0;0;0;Aspiradora TH1415 Arrastre 1500Watts;ELECTRODOMESTICOS
10129992;;F;57;CHILENO;;Silencioso;PROVIDENCIA                   ;METROPOLITANA;0;0;0;0;0;0;0;0;0;Licuadora UT-METALLEK605P 1,55Lts;ELECTRODOMESTICOS
15869140;;F;37;CHILENO;;Millenial;PROVIDENCIA                   ;METROPOLITANA;0;0;0;0;0;0;0;0;0;Horno Electrico UT-LEIF36 36Lts;ELECTRODOMESTICOS
16818039;;F;34;CHILENO;;Millenial;LOTA                          ;BIO BIO;0;0;0;0;0;0;0;0;0;Hervidor Electrico TH-5407i 2Lts;ELECTRODOMESTICOS
5830920;;F;73;CHILENO;;Silencioso;EL BOSQUE                     ;METROPOLITANA;0;0;0;0;0;0;0;0;0;HERVIDOR TH-4340;ELECTRODOMESTICOS
17806541;;F;31;CHILENO;;Millenial;IQUIQUE                       ;TARAPACA;0;0;0;0;0;0;0;0;0;H. Microondas Fancy (2000rd);ELECTRODOMESTICOS
8203934;;F;65;CHILENO;;Boomers;ANTOFAGASTA                   ;ANTOFAGASTA;0;0;0;0;0;0;0;0;0;Combo Hervidor + Tostador + Sandwichera;ELECTRODOMESTICOS
11556120;;F;52;CHILENO;;X;RENGO                         ;L.G.B.OÂ´HIGGINS;0;0;0;0;0;0;0;0;0;Horno Microondas Digital MS23K3513AK/ZS 23Lts;ELECTRODOMESTICOS
4968593;;F;79;CHILENO;;Silencioso;N/D;N/D;0;0;0;0;0;0;0;0;0;Maquina de Coser ST-371HD Heavy Duty;ELECTRODOMESTICOS
11603083;;F;52;CHILENO;;X;CANETE                        ;BIO BIO;0;0;0;0;0;0;0;0;0;Combo Plancha Batidora Secador de Pelo;ELECTRODOMESTICOS
14282123;;F;47;CHILENO;;X;PERQUENCO                     ;ARAUCANIA;0;0;0;0;0;0;0;0;0;Horno Microondas Digital TH-25DM 25Lts;ELECTRODOMESTICOS
17739449;Soltero;F;30;CHILENO;;Silencioso;PROVIDENCIA                   ;METROPOLITANA;0;0;0;0;0;0;0;0;0;BATIDORA PEDESTAL THOMAS TH-910PB;ELECTRODOMESTICOS
15965041;;M;37;CHILENO;;Millenial;QUILICURA;METROPOLITANA;0;0;0;0;0;0;0;0;0;ARROCERA ROJA 4723;ELECTRODOMESTICOS
17390511;;F;34;CHILENO;;Millenial;LO ESPEJO;METROPOLITANA;0;0;0;0;0;0;0;0;0;Batidora Pedestal TH910PN 4,6Lts 1300Watts;ELECTRODOMESTICOS
12648584;;F;49;CHILENO;;X;PROVIDENCIA                   ;METROPOLITANA;0;0;0;0;0;0;0;0;0;MULTIMIXER THOMAS TH- 8706;ELECTRODOMESTICOS
19500086;;F;25;CHILENO;;Silencioso;PROVIDENCIA                   ;METROPOLITANA;0;0;0;0;0;0;0;0;0;Licuadora TH-320 Roja/Negro 1,5 Lts Vaso Vidrio;ELECTRODOMESTICOS
19847424;;M;24;CHILENO;;Z;PROVIDENCIA                   ;METROPOLITANA;0;0;0;0;0;0;0;0;0;Hervidor Termo BA-6928 Inox 2,8Lts;ELECTRODOMESTICOS
13378088;;M;44;CHILENO;;X;PROVIDENCIA                   ;METROPOLITANA;0;0;0;0;0;0;0;0;0;Horno Electrico UT-BACKOFEN60 60Lts;ELECTRODOMESTICOS
15949023;Casado;F;37;CHILENO;;Silencioso;PROVIDENCIA                   ;METROPOLITANA;0;0;0;0;0;0;0;0;0;Robot aspirador Roomba 675;ELECTRODOMESTICOS
20230648;;F;22;CHILENO;;Silencioso;PROVIDENCIA                   ;METROPOLITANA;0;0;0;0;0;0;0;0;0;Sandwichera TH-952 2 Panes Blanca;ELECTRODOMESTICOS
14348998;;F;42;CHILENO;;X;OSORNO                        ;LOS LAGOS;0;0;0;0;0;0;0;0;0;Aspiradora TH1870 Arrastre 1800Watts Gris;ELECTRODOMESTICOS
10103246;;F;48;CHILENO;;X;ILLAPEL                       ;COQUIMBO;0;0;0;0;0;0;0;0;0;Aspiradora TH1415 Arrastre 1500Watts;ELECTRODOMESTICOS
13812336;;F;42;CHILENO;;X;VILCUN                        ;ARAUCANIA;0;0;0;0;0;0;0;0;0;Plancha TH-7052 2000Watts Base Inox;ELECTRODOMESTICOS
9720186;Casado;F;60;CHILENO;;Boomers;PROVIDENCIA                   ;METROPOLITANA;0;0;0;0;0;0;0;0;0;PROCESADOR THOMAS TH-9160;ELECTRODOMESTICOS
10822277;Casado;F;56;CHILENO;;Boomers;PUERTO MONTT                  ;LOS LAGOS;0;0;0;0;0;0;0;0;0;Licuadora UT-METALLEK505P 1,5Lts Vaso Vidrio;ELECTRODOMESTICOS
12734393;;F;48;CHILENO;;X;CANETE                        ;BIO BIO;0;0;0;0;0;0;0;0;0;Aspiradora TH1407 Arrastre 1400Watts;ELECTRODOMESTICOS
12837009;;F;49;CHILENO;;X;PROVIDENCIA                   ;METROPOLITANA;0;0;0;0;0;0;0;0;0;Aspiradora VCC4190V3E/XZS Arrastre 2000Watts;ELECTRODOMESTICOS
7084029;;F;67;CHILENO;;Boomers;BUIN                          ;METROPOLITANA;0;0;0;0;0;0;0;0;0;ASPIRADORA ROBOT VR05R5050WK/ZS;ELECTRODOMESTICOS
16738163;Casado;F;33;CHILENO;;Silencioso;BULNES                        ;BIO BIO;0;0;0;0;0;0;0;0;0;Maquina de Coser ME9100;ELECTRODOMESTICOS
17829891;;F;31;CHILENO;;Millenial;RENCA                         ;METROPOLITANA;0;0;0;0;0;0;0;0;0;Licuadora L2000VNG 1,5Lts Vaso Vidrio;ELECTRODOMESTICOS
18532695;Soltero;F;28;CHILENO;PROFESOR;Silencioso;PROVIDENCIA                   ;METROPOLITANA;0;0;0;0;0;0;0;0;0;Aspiradora Trapeadora Robot Ut-Excellenza (B);ELECTRODOMESTICOS
4208552;;M;81;CHILENO;;Silencioso;PENALOLEN                     ;METROPOLITANA;0;0;0;0;0;0;0;0;0;Hervidor Electrico 3100 1,7Lts Negro;ELECTRODOMESTICOS
6167257;;M;73;CHILENO;;Silencioso;ANTOFAGASTA                   ;ANTOFAGASTA;0;0;0;0;0;0;0;0;0;Hervidor Electrico HA-3300 2,5Lts Blanco;ELECTRODOMESTICOS
17584712;;M;31;CHILENO;;Millenial;TEMUCO                        ;ARAUCANIA;0;0;0;0;0;0;0;0;0;Aspiradora TH1870 Arrastre 1800Watts Gris;ELECTRODOMESTICOS
6824975;;F;68;CHILENO;;Boomers;RANCAGUA                      ;L.G.B.OÂ´HIGGINS;0;0;0;0;0;0;0;0;0;Horno Electrico TH-48N 48Lts;ELECTRODOMESTICOS
9638261;;M;57;CHILENO;;Boomers;CASTRO                        ;LOS LAGOS;0;0;0;0;0;0;0;0;0;Horno Microondas Digital L UT-25KROMM 25Lts;ELECTRODOMESTICOS
11779027;;M;51;CHILENO;;X;LOS ALAMOS                    ;BIO BIO;0;0;0;0;0;0;0;0;0;Hervidor Electrico TH-4515N 2Lts Negro;ELECTRODOMESTICOS
18336973;Soltero;M;29;CHILENO;TECNICO MECANICO;Silencioso;PROVIDENCIA                   ;METROPOLITANA;0;0;0;0;0;0;0;0;0;Aspiradora VCC4190V3E/XZS Arrastre 2000Watts;ELECTRODOMESTICOS
11370944;;F;52;CHILENO;;X;PROVIDENCIA                   ;METROPOLITANA;0;0;0;0;0;0;0;0;0;Aspiradora Trapeadora Robot Ut-Excellenza (B);ELECTRODOMESTICOS
14049381;;F;40;CHILENO;;X;SAN FERNANDO                  ;L.G.B.OÂ´HIGGINS;0;0;0;0;0;0;0;0;0;Hervidor Electrico TH-4515N 2Lts Negro;ELECTRODOMESTICOS
6012517;Casado;F;73;CHILENO;;Silencioso;PROVIDENCIA                   ;METROPOLITANA;0;0;0;0;0;0;0;0;0;Hervidor Electrico UT-DUNKEL17P 2Lts Negro;ELECTRODOMESTICOS
9737089;;M;59;CHILENO;;Boomers;PROVIDENCIA                   ;METROPOLITANA;0;0;0;0;0;0;0;0;0;Licuadora L1000 Inox 1,7LtsVaso Vidrio;ELECTRODOMESTICOS
17994235;Soltero;M;30;CHILENO;PROFESOR;Millenial;PROVIDENCIA                   ;METROPOLITANA;0;0;0;0;0;0;0;0;0;MICROONDAS 30L MG30T5018CN/ZS SAMSUNG.;ELECTRODOMESTICOS
19327803;;M;25;CHILENO;;Z;"";"";0;0;0;0;0;0;0;0;0;Batidora Pedestal TH910PN 4,6Lts 1300Watts;ELECTRODOMESTICOS
20148482;;F;22;CHILENO;;Silencioso;PROVIDENCIA                   ;METROPOLITANA;0;0;0;0;0;0;0;0;0;MICROONDAS ME83X/XZS SAMSUNG MIRROR;ELECTRODOMESTICOS
8409263;;M;61;CHILENO;;Boomers;PUNTA ARENAS                  ;MAGALLANES;0;0;0;0;0;0;0;0;0;Hervidor Electrico UT-KLAR20PW 2Lts Blanco;ELECTRODOMESTICOS
15567660;;M;36;CHILENO;;Millenial;PROVIDENCIA                   ;METROPOLITANA;0;0;0;0;0;0;0;0;0;Horno Microondas Digital MS23K3513AK/ZS 23Lts;ELECTRODOMESTICOS
18048565;;M;30;CHILENO;;Silencioso;PROVIDENCIA                   ;METROPOLITANA;0;0;0;0;0;0;0;0;0;Aspiradora UT-MEINER1803 Arrastre 1800Watts;ELECTRODOMESTICOS
6853109;;F;70;CHILENO;;Silencioso;RENCA                         ;METROPOLITANA;0;0;0;0;0;0;0;0;0;Plancha THOMAS TH-7170 2200Watts Base Ceramica;ELECTRODOMESTICOS
10110690;;F;58;CHILENO;;Boomers;COCHAMO                       ;LOS LAGOS;0;0;0;0;0;0;0;0;0;Licuadora Osterizer 4112/72 1,25Lts Vaso Vidrio;ELECTRODOMESTICOS
12653643;;F;48;CHILENO;;X;PROVIDENCIA                   ;METROPOLITANA;0;0;0;0;0;0;0;0;0;Parrilla Electrica TH-224;ELECTRODOMESTICOS
12200344;;M;50;CHILENO;;X;N/D;N/D;0;0;0;0;0;0;0;0;0;MULTIMIXER THOMAS TH- 8706;ELECTRODOMESTICOS
19346743;;M;25;CHILENO;;Z;LINARES                       ;MAULE;0;0;0;0;0;0;0;0;0;Plancha TH-7052 2000Watts Base Inox;ELECTRODOMESTICOS
17526282;Soltero;F;30;CHILENO;EDUCADOR DE PARVULO;Millenial;RENCA                         ;METROPOLITANA;0;0;0;0;0;0;0;0;0;FREIDORA DE AIRE CKSTAF55 1700W;ELECTRODOMESTICOS
5948041;Divorciado;F;67;CHILENO;;Boomers;RENCA                         ;METROPOLITANA;0;0;0;0;0;0;0;0;0;LICUADORA CROMADA CON TECLAS PLUS;ELECTRODOMESTICOS
4380006;;F;83;CHILENO;;Silencioso;ANTOFAGASTA                   ;ANTOFAGASTA;0;0;0;0;0;0;0;0;0;Hervidor Electrico 3100 1,7Lts Negro;ELECTRODOMESTICOS
18023955;Soltero;M;30;CHILENO;ABOGADO;Silencioso;PROVIDENCIA                   ;METROPOLITANA;0;0;0;0;0;0;0;0;0;Batidora Vertical Minipimer UT-KLOT400P;ELECTRODOMESTICOS
8513165;;F;64;CHILENO;;Boomers;MAIPU                         ;METROPOLITANA;0;0;0;0;0;0;0;0;0;Maquina de Coser 3008 Janome Blanco;ELECTRODOMESTICOS
12630444;;F;48;CHILENO;;X;TALCAHUANO                    ;BIO BIO;0;0;0;0;0;0;0;0;0;Maquina de Coser ME9100;ELECTRODOMESTICOS
12473444;Casado;M;48;CHILENO;INGENIERO EN REFRIGERACION Y CLIMATIZACION INDUSTRIAL;X;RENCA                         ;METROPOLITANA;0;0;0;0;0;0;0;0;0;Hervidor Electrico UT-MANLY17 1,7Lts Negro;ELECTRODOMESTICOS
14272535;Casado;M;48;CHILENO;;X;RENCA                         ;METROPOLITANA;0;0;0;0;0;0;0;0;0;Maquina de Coser BM-3850CL Lila;ELECTRODOMESTICOS
18184960;;F;30;CHILENO;;Millenial;PROVIDENCIA                   ;METROPOLITANA;0;0;0;0;0;0;0;0;0;Horno Microondas Digital L UT-25KROMM 25Lts;ELECTRODOMESTICOS
8516366;Soltero;F;64;CHILENO;;Boomers;MAIPU                         ;METROPOLITANA;0;0;0;0;0;0;0;0;0;Horno Electrico TH-25N01 25Lts;ELECTRODOMESTICOS
24903359;;F;33;PERUANO;;Extranjero;LO PRADO                      ;METROPOLITANA;0;0;0;0;0;0;0;0;0;ARROCERA ROJA 4723;ELECTRODOMESTICOS
25089969;;M;30;HAITIANO;;Extranjero;SANTA CRUZ                    ;L.G.B.OÂ´HIGGINS;0;0;0;0;0;0;0;0;0;Licuadora Osterizer 4112/72 1,25Lts Vaso Vidrio;ELECTRODOMESTICOS
15841587;Soltero;F;37;CHILENO;;Millenial;PROVIDENCIA                   ;METROPOLITANA;0;0;0;0;0;0;0;0;0;Hervidor Electrico TH-4515N 2Lts Negro;ELECTRODOMESTICOS
19722274;;F;24;CHILENO;;Silencioso;PROVIDENCIA                   ;METROPOLITANA;0;0;0;0;0;0;0;0;0;Licuadora TH-320 Roja/Negro 1,5 Lts Vaso Vidrio;ELECTRODOMESTICOS
8739067;Soltero;F;63;CHILENO;;Boomers;PROVIDENCIA                   ;METROPOLITANA;0;0;0;0;0;0;0;0;0;Hervidor Electrico HA-2650NG;ELECTRODOMESTICOS
10110343;;F;58;CHILENO;;Boomers;RENCA                         ;METROPOLITANA;0;0;0;0;0;0;0;0;0;FREIDORA DE AIRE CKSTAF15B 1850W;ELECTRODOMESTICOS
18970083;Soltero;M;26;CHILENO;;Z;N/D;N/D;0;0;0;0;0;0;0;0;0;Horno Electrico TH62I 60Lts;ELECTRODOMESTICOS
11442046;Casado;M;52;CHILENO;;X;RENCA                         ;METROPOLITANA;0;0;0;0;0;0;0;0;0;Horno Microondas Mecanico C1700N 17Lts Blanco;ELECTRODOMESTICOS
7475288;;M;68;CHILENO;;Boomers;PROVIDENCIA                   ;METROPOLITANA;0;0;0;0;0;0;0;0;0;Hervidor Electrico UT-KLAR20PW 2Lts Blanco;ELECTRODOMESTICOS
20425868;Soltero;F;31;CHILENO;;Silencioso;PROVIDENCIA                   ;METROPOLITANA;0;0;0;0;0;0;0;0;0;MAQUINA DE COSER COMPUTARIZADA JANOME DM7200;ELECTRODOMESTICOS
15447094;;F;39;CHILENO;;X;N/D;N/D;0;0;0;0;0;0;0;0;0;Hervidor Electrico Tetera TH-6505RT 1,7Lts Rojo;ELECTRODOMESTICOS
7677652;;M;64;CHILENO;;Boomers;SAN FELIPE                    ;VALPARAISO;0;0;0;0;0;0;0;0;0;Horno Electrico UT-BACKOFEN26 26Lts;ELECTRODOMESTICOS
11228557;;F;54;CHILENO;;X;PROVIDENCIA                   ;METROPOLITANA;0;0;0;0;0;0;0;0;0;Horno Microondas Digital L UT-25KROMM 25Lts;ELECTRODOMESTICOS
17809944;;F;31;CHILENO;;Millenial;SAN NICOLAS                   ;BIO BIO;0;0;0;0;0;0;0;0;0;Hervidor Electrico HE420 2lts Negro;ELECTRODOMESTICOS
23942618;;M;28;PERUANO;;Extranjero;LA PINTANA                    ;METROPOLITANA;0;0;0;0;0;0;0;0;0;LICUADORA MULTIFUNCION LCM-18000 GF;ELECTRODOMESTICOS
13103577;;F;46;CHILENO;;X;PROVIDENCIA                   ;METROPOLITANA;0;0;0;0;0;0;0;0;0;Extractor de Jugo EX800 1,4Lts;ELECTRODOMESTICOS
14365535;Soltero;F;40;CHILENO;;X;PROVIDENCIA                   ;METROPOLITANA;0;0;0;0;0;0;0;0;0;Horno Electrico TH-25N01 25Lts;ELECTRODOMESTICOS
16468002;;M;35;CHILENO;;Silencioso;PROVIDENCIA                   ;METROPOLITANA;0;0;0;0;0;0;0;0;0;Horno Microondas Digital TH-20S01 20Lts;ELECTRODOMESTICOS
16288025;Soltero;F;36;CHILENO;TECNICO DE NIVEL SUPERIOR EN ENFERMERIA;Millenial;PROVIDENCIA                   ;METROPOLITANA;0;0;0;0;0;0;0;0;0;Horno Electrico TH-25N01 25Lts;ELECTRODOMESTICOS
15906672;Soltero;F;38;CHILENO;;Millenial;PROVIDENCIA                   ;METROPOLITANA;0;0;0;0;0;0;0;0;0;Aspiradora TH1407 Arrastre 1400Watts;ELECTRODOMESTICOS
20467202;;F;22;CHILENO;;Silencioso;PROVIDENCIA                   ;METROPOLITANA;0;0;0;0;0;0;0;0;0;Horno Electrico UT-BACKOFEN60 60Lts;ELECTRODOMESTICOS
16528439;;F;35;CHILENO;;Millenial;SAN FERNANDO                  ;L.G.B.OÂ´HIGGINS;0;0;0;0;0;0;0;0;0;Horno Electrico TH62I 60Lts;ELECTRODOMESTICOS
15616588;;F;38;CHILENO;;Millenial;N/D;N/D;0;0;0;0;0;0;0;0;0;Aspiradora TH1415 Arrastre 1500Watts;ELECTRODOMESTICOS
7638895;;F;63;CHILENO;;Boomers;PROVIDENCIA                   ;METROPOLITANA;0;0;0;0;0;0;0;0;0;Plancha UT-PLATTEISEN 2000Watts Base Ceramica;ELECTRODOMESTICOS
17671068;;F;31;CHILENO;;Millenial;QUINTA NORMAL                 ;METROPOLITANA;0;0;0;0;0;0;0;0;0;Horno electrico Black Oven 42lts;ELECTRODOMESTICOS
7661591;;F;60;CHILENO;;Boomers;VALPARAISO                    ;VALPARAISO;0;0;0;0;0;0;0;0;0;COMBO ALFA MAQ COSER STYLE 20 + OV MOD 8708;ELECTRODOMESTICOS
5186317;;F;78;CHILENO;;Silencioso;RENCA                         ;METROPOLITANA;0;0;0;0;0;0;0;0;0;Maquina de Coser ME9100;ELECTRODOMESTICOS
6620431;;M;70;CHILENO;;Silencioso;RENCA                         ;METROPOLITANA;0;0;0;0;0;0;0;0;0;Hervidor Electrico UT-KLAR20PW 2Lts Blanco;ELECTRODOMESTICOS
17826475;Soltero;M;31;CHILENO;;Millenial;PROVIDENCIA                   ;METROPOLITANA;0;0;0;0;0;0;0;0;0;Batidora Vertical Multimixer TH-8720;ELECTRODOMESTICOS
6948224;Casado;M;65;CHILENO;;Boomers;PROVIDENCIA                   ;METROPOLITANA;0;0;0;0;0;0;0;0;0;Horno Electrico UT-LEIF36 36Lts;ELECTRODOMESTICOS
13366057;;M;44;CHILENO;;X;PROVIDENCIA                   ;METROPOLITANA;0;0;0;0;0;0;0;0;0;Plancha UT-DUNST 2200Watts Base Ceramica;ELECTRODOMESTICOS
13580859;;M;43;CHILENO;;X;COLLIPULLI                    ;ARAUCANIA;0;0;0;0;0;0;0;0;0;Hervidor Electrico UT-REIN17SS;ELECTRODOMESTICOS
12931359;;M;46;CHILENO;;Millenial;N/D;N/D;0;0;0;0;0;0;0;0;0;Aspiradora TH1415 Arrastre 1500Watts;ELECTRODOMESTICOS
12821712;;F;47;CHILENO;;X;RENCA                         ;METROPOLITANA;0;0;0;0;0;0;0;0;0;Licuadora TH-320 Roja/Negro 1,5 Lts Vaso Vidrio;ELECTRODOMESTICOS
17143785;;M;32;CHILENO;;Millenial;"";"";0;0;0;0;0;0;0;0;0;Aspiradora TH1415 Arrastre 1500Watts;ELECTRODOMESTICOS
7371045;;F;66;CHILENO;;Boomers;OVALLE                        ;COQUIMBO;0;0;0;0;0;0;0;0;0;HERVIDOR TH-4340;ELECTRODOMESTICOS
17250565;Soltero;M;33;CHILENO;TECNICO DE NIVEL SUPERIOR EN ENFERMERIA;Millenial;PROVIDENCIA                   ;METROPOLITANA;0;0;0;0;0;0;0;0;0;Horno Electrico UT-BACKOFEN60 60Lts;ELECTRODOMESTICOS
19633190;;M;25;CHILENO;;Silencioso;PROVIDENCIA                   ;METROPOLITANA;0;0;0;0;0;0;0;0;0;Combo Hervidor + Tostador + Sandwichera;ELECTRODOMESTICOS
11548331;;F;52;CHILENO;;Silencioso;PROVIDENCIA                   ;METROPOLITANA;0;0;0;0;0;0;0;0;0;Hervidor Electrico TH-4515N 2Lts Negro;ELECTRODOMESTICOS
19853340;;F;24;CHILENO;;Silencioso;PROVIDENCIA                   ;METROPOLITANA;0;0;0;0;0;0;0;0;0;Horno Microondas Mecanico Easy Wave 20Lts;ELECTRODOMESTICOS
9424616;;F;58;CHILENO;;Boomers;LOS ANGELES                   ;BIO BIO;0;0;0;0;0;0;0;0;0;Batidora Vertical Stick Mixer 2609;ELECTRODOMESTICOS
26193532;;M;45;VENEZOLANO;;Extranjero;N/D;N/D;0;0;0;0;0;0;0;0;0;FREIDORA DE AIRE CKSTAF15B 1850W;ELECTRODOMESTICOS
7310386;;F;67;CHILENO;;Boomers;PROVIDENCIA                   ;METROPOLITANA;0;0;0;0;0;0;0;0;0;Plancha UT-KERAMIKTOP 2200Watts Base Ceramica;ELECTRODOMESTICOS
18745780;;F;27;CHILENO;;Millenial;CORONEL                       ;BIO BIO;0;0;0;0;0;0;0;0;0;PROCESADOR THOMAS TH-9160;ELECTRODOMESTICOS
13169362;;F;44;CHILENO;;X;ANCUD                         ;LOS LAGOS;0;0;0;0;0;0;0;0;0;Hervidor Electrico Tetera TH-6505RT 1,7Lts Rojo;ELECTRODOMESTICOS
6749893;;F;72;CHILENO;;Silencioso;MARIQUINA                     ;LOS LAGOS;0;0;0;0;0;0;0;0;0;Cafetera UT-KAFFEEKLASSIK;ELECTRODOMESTICOS
18386314;;F;29;CHILENO;;Millenial;NATALES                       ;MAGALLANES;0;0;0;0;0;0;0;0;0;Cafetera TH-130;ELECTRODOMESTICOS
14203482;;F;41;CHILENO;;X;PROVIDENCIA                   ;METROPOLITANA;0;0;0;0;0;0;0;0;0;Tostador de Pan TH-116 2 Rebanadas Negro;ELECTRODOMESTICOS
18230848;;M;30;CHILENO;;Millenial;PADRE LAS CASAS               ;ARAUCANIA;0;0;0;0;0;0;0;0;0;Horno Electrico TH62I 60Lts;ELECTRODOMESTICOS
26766572;;F;35;EXTRANJERO - NO INFORMA NACIONALIDAD;;Extranjero;SANTIAGO                      ;METROPOLITANA;0;0;0;0;0;0;0;0;0;Licuadora Kaliman Negra con Teclas;ELECTRODOMESTICOS
16194678;;F;36;CHILENO;;Millenial;PROVIDENCIA                   ;METROPOLITANA;0;0;0;0;0;0;0;0;0;Horno Microondas Digital TH20DM 20Lts Espejado;ELECTRODOMESTICOS
20168533;;F;22;CHILENO;;Z;PROVIDENCIA                   ;METROPOLITANA;0;0;0;0;0;0;0;0;0;Horno Electrico UT-BACKOFEN48 48Lts;ELECTRODOMESTICOS
13839179;;M;42;CHILENO;;X;PROVIDENCIA                   ;METROPOLITANA;0;0;0;0;0;0;0;0;0;Cafetera TH-130;ELECTRODOMESTICOS
5779652;Casado;F;74;CHILENO;;Silencioso;RENCA                         ;METROPOLITANA;0;0;0;0;0;0;0;0;0;Batidora Manual UT-TEKLA300;ELECTRODOMESTICOS
8740040;Casado;M;62;CHILENO;;Boomers;RENCA                         ;METROPOLITANA;0;0;0;0;0;0;0;0;0;Horno Microondas Digital MS23K3513AK/ZS 23Lts;ELECTRODOMESTICOS
9349180;;M;59;CHILENO;;Boomers;PROVIDENCIA                   ;METROPOLITANA;0;0;0;0;0;0;0;0;0;Parrilla Electrica TH-224;ELECTRODOMESTICOS
9789969;;F;57;CHILENO;;Boomers;TALCAHUANO                    ;BIO BIO;0;0;0;0;0;0;0;0;0;Aspiradora UT-KRAFT(DIG) Arrastre 2200Watts;ELECTRODOMESTICOS
7887961;;M;61;CHILENO;;Boomers;PROVIDENCIA                   ;METROPOLITANA;0;0;0;0;0;0;0;0;0;Hervidor Electrico Tetera UT-LECKER18R 1,8Lts;ELECTRODOMESTICOS
4372181;;F;71;CHILENO;;Silencioso;LOS ANDES                     ;VALPARAISO;0;0;0;0;0;0;0;0;0;Aspiradora UT-SILENT1603 Arrastre 1600Watts;ELECTRODOMESTICOS
13193503;;F;47;CHILENO;;X;VINA DEL MAR                  ;VALPARAISO;0;0;0;0;0;0;0;0;0;Horno Electrico UT-LEIF36 36Lts;ELECTRODOMESTICOS
13296486;Soltero;F;45;CHILENO;;X;PROVIDENCIA                   ;METROPOLITANA;0;0;0;0;0;0;0;0;0;Hervidor Electrico TH-4515N 2Lts Negro;ELECTRODOMESTICOS
16196497;;F;36;CHILENO;;Millenial;LAS CABRAS                    ;L.G.B.OÂ´HIGGINS;0;0;0;0;0;0;0;0;0;Cafetera TH-130;ELECTRODOMESTICOS
18282031;;M;29;CHILENO;;Millenial;N/D;N/D;0;0;0;0;0;0;0;0;0;Hervidor Electrico TH-4800 2Lts Negro Azul;ELECTRODOMESTICOS
12414903;Casado;M;49;CHILENO;;X;PROVIDENCIA                   ;METROPOLITANA;0;0;0;0;0;0;0;0;0;Hervidor Electrico UT-REIN17SS;ELECTRODOMESTICOS
11877379;;M;50;CHILENO;;Silencioso;PROVIDENCIA                   ;METROPOLITANA;0;0;0;0;0;0;0;0;0;Licuadora UT-METALLEK605P 1,55Lts;ELECTRODOMESTICOS
11384575;Casado;F;53;CHILENO;;X;RENCA                         ;METROPOLITANA;0;0;0;0;0;0;0;0;0;PLANCHA VAPOR TH-7146;ELECTRODOMESTICOS
9847684;Casado;F;57;CHILENO;;Boomers;CHILLAN VIEJO                 ;BIO BIO;0;0;0;0;0;0;0;0;0;Horno Electrico UT-BACKOFEN38 38Lts;ELECTRODOMESTICOS
12415615;;F;49;CHILENO;;X;CERRO NAVIA                   ;METROPOLITANA;0;0;0;0;0;0;0;0;0;Hervidor Electrico UT-KLAR20PW 2Lts Blanco;ELECTRODOMESTICOS
16094399;;F;36;CHILENO;;Millenial;RENCA                         ;METROPOLITANA;0;0;0;0;0;0;0;0;0;Aspiradora UT-MEINER1803 Arrastre 1800Watts;ELECTRODOMESTICOS
17029215;;M;33;CHILENO;;Millenial;PROVIDENCIA                   ;METROPOLITANA;0;0;0;0;0;0;0;0;0;Batidora Manual BM-490IN Multi Accesorios;ELECTRODOMESTICOS
19064920;Soltero;M;26;CHILENO;INGENIERO INDUSTRIAL;Z;PROVIDENCIA                   ;METROPOLITANA;0;0;0;0;0;0;0;0;0;Licuadora Roja 550W 1,5Lts Vaso Vidrio;ELECTRODOMESTICOS
5646380;;M;76;CHILENO;;Silencioso;RENCA                         ;METROPOLITANA;0;0;0;0;0;0;0;0;0;Tostador de Pan TH-116 2 Rebanadas Negro;ELECTRODOMESTICOS
8305201;;F;68;CHILENO;;Boomers;RENCA                         ;METROPOLITANA;0;0;0;0;0;0;0;0;0;Horno Microondas Digital MMP-20GC3D 20Lts;ELECTRODOMESTICOS
24521841;;M;36;BOLIVIANO;;Extranjero;N/D;N/D;0;0;0;0;0;0;0;0;0;Horno Microondas Digital TH-20S01 20Lts;ELECTRODOMESTICOS
19793847;;F;24;CHILENO;;Z;PROVIDENCIA                   ;METROPOLITANA;0;0;0;0;0;0;0;0;0;Horno Microondas Mecanico Easy Wave 20Lts;ELECTRODOMESTICOS
14526319;;M;44;CHILENO;;X;PROVIDENCIA                   ;METROPOLITANA;0;0;0;0;0;0;0;0;0;Aspiradora AP1700 Arrastre 1700Watts;ELECTRODOMESTICOS
7657857;Casado;M;65;CHILENO;TECNICO EN ADMINISTRACION DE EMPRESAS;Boomers;PROVIDENCIA                   ;METROPOLITANA;0;0;0;0;0;0;0;0;0;Plancha THOMAS TH-7170 2200Watts Base Ceramica;ELECTRODOMESTICOS
8118527;Casado;F;62;CHILENO;TECNOLOGO MEDICO;Boomers;RENCA                         ;METROPOLITANA;0;0;0;0;0;0;0;0;0;Olla Arrocera TH38IF 1,8Lts;ELECTRODOMESTICOS
13718131;;F;43;CHILENO;;X;RANCAGUA                      ;L.G.B.OÂ´HIGGINS;0;0;0;0;0;0;0;0;0;Horno Electrico UT-LEIF36 36Lts;ELECTRODOMESTICOS
20294759;;F;22;CHILENO;;Z;PROVIDENCIA                   ;METROPOLITANA;0;0;0;0;0;0;0;0;0;Hervidor Electrico TH-4800 2Lts Negro Azul;ELECTRODOMESTICOS
15495507;;F;38;CHILENO;;X;PROVIDENCIA                   ;METROPOLITANA;0;0;0;0;0;0;0;0;0;Batidora Manual BA-5010 Inox;ELECTRODOMESTICOS
14130289;;M;41;CHILENO;;X;CONCHALI                      ;METROPOLITANA;0;0;0;0;0;0;0;0;0;Horno Microondas Mecanico Easy Wave 20Lts;ELECTRODOMESTICOS
18513735;Soltero;M;28;CHILENO;;Millenial;PROVIDENCIA                   ;METROPOLITANA;0;0;0;0;0;0;0;0;0;Hervidor Electrico Tetera TH-6505RT 1,7Lts Rojo;ELECTRODOMESTICOS
13406807;;M;43;CHILENO;;Silencioso;PROVIDENCIA                   ;METROPOLITANA;0;0;0;0;0;0;0;0;0;Licuadora L2000VNG 1,5Lts Vaso Vidrio;ELECTRODOMESTICOS
16987349;Casado;F;34;CHILENO;;Millenial;RENCA                         ;METROPOLITANA;0;0;0;0;0;0;0;0;0;Hervidor Electrico UT-KLAR20PW 2Lts Blanco;ELECTRODOMESTICOS
15785957;;F;38;CHILENO;;Millenial;N/D;N/D;0;0;0;0;0;0;0;0;0;Batidora Berry Mixer (KM3000) 1300 watts;ELECTRODOMESTICOS
17530942;;F;32;CHILENO;;Millenial;CABRERO                       ;BIO BIO;0;0;0;0;0;0;0;0;0;Aspiradora VCC4190V3E/XZS Arrastre 2000Watts;ELECTRODOMESTICOS
16485707;;M;36;CHILENO;;Silencioso;PROVIDENCIA                   ;METROPOLITANA;0;0;0;0;0;0;0;0;0;Licuadora L-1630V Negra 1,5Lts Vaso Vidrio;ELECTRODOMESTICOS
9160708;Casado;M;61;CHILENO;;Boomers;PROVIDENCIA                   ;METROPOLITANA;0;0;0;0;0;0;0;0;0;Plancha UT-DUNST 2200Watts Base Ceramica;ELECTRODOMESTICOS
18958878;Soltero;F;26;CHILENO;MATRONA;Silencioso;PROVIDENCIA                   ;METROPOLITANA;0;0;0;0;0;0;0;0;0;Hervidor Electrico UT-MANLY17 1,7Lts Negro;ELECTRODOMESTICOS
4932047;;F;83;CHILENO;;Silencioso;COIHAIQUE                     ;AYSEN;0;0;0;0;0;0;0;0;0;Licuadora L-5500IN 1,5Lts;ELECTRODOMESTICOS
17972570;;M;30;CHILENO;;Millenial;SANTIAGO;METROPOLITANA;0;0;0;0;0;0;0;0;0;Batidora Pedestal TH910PN 4,6Lts 1300Watts;ELECTRODOMESTICOS
10981158;;F;47;CHILENO;;X;PROVIDENCIA                   ;METROPOLITANA;0;0;0;0;0;0;0;0;0;Aspiradora VCC4190V3E/XZS Arrastre 2000Watts;ELECTRODOMESTICOS
6614504;;M;66;CHILENO;;Boomers;PROVIDENCIA                   ;METROPOLITANA;0;0;0;0;0;0;0;0;0;Batidora Vertical Multimixer TH-8720;ELECTRODOMESTICOS
15716013;;M;39;CHILENO;;X;PUENTE ALTO                   ;METROPOLITANA;0;0;0;0;0;0;0;0;0;Olla Arrocera OA-400NG 1,8Lts;ELECTRODOMESTICOS
13095441;;M;45;CHILENO;;X;PROVIDENCIA                   ;METROPOLITANA;0;0;0;0;0;0;0;0;0;Licuadora Osterizer 4112/72 1,25Lts Vaso Vidrio;ELECTRODOMESTICOS
18865575;Soltero;M;26;CHILENO;;Silencioso;PROVIDENCIA                   ;METROPOLITANA;0;0;0;0;0;0;0;0;0;Licuadora Berry Blender Roja 1400 Vaso Vidrio;ELECTRODOMESTICOS
6750947;;F;66;CHILENO;;Boomers;VINA DEL MAR                  ;VALPARAISO;0;0;0;0;0;0;0;0;0;Hervidor Electrico 3100 1,7Lts Negro;ELECTRODOMESTICOS
25705422;;F;30;COLOMBIANO;;Extranjero;CERRO NAVIA                   ;METROPOLITANA;0;0;0;0;0;0;0;0;0;Licuadora L2000VNG 1,5Lts Vaso Vidrio;ELECTRODOMESTICOS
16650100;;M;38;CHILENO;;X;PROVIDENCIA                   ;METROPOLITANA;0;0;0;0;0;0;0;0;0;Batidora Manual BA-5010 Inox;ELECTRODOMESTICOS
18268156;;F;29;CHILENO;;Millenial;SAN CARLOS                    ;BIO BIO;0;0;0;0;0;0;0;0;0;Horno Electrico UT-LEIF36 36Lts;ELECTRODOMESTICOS
19010346;Soltero;F;26;CHILENO;;Z;CONSTITUCION                  ;MAULE;0;0;0;0;0;0;0;0;0;Hervidor Electrico 3100 1,7Lts Negro;ELECTRODOMESTICOS
11754345;Divorciado;F;50;CHILENO;;X;RENCA                         ;METROPOLITANA;0;0;0;0;0;0;0;0;0;Horno Electrico TH-25N01 25Lts;ELECTRODOMESTICOS
7368144;Soltero;F;63;CHILENO;;Silencioso;PROVIDENCIA                   ;METROPOLITANA;0;0;0;0;0;0;0;0;0;Maquina de coser Singer 3305;ELECTRODOMESTICOS
19305709;Soltero;F;26;CHILENO;ENFERMERA;Silencioso;PROVIDENCIA                   ;METROPOLITANA;0;0;0;0;0;0;0;0;0;Hervidor Electrico TH-4515N 2Lts Negro;ELECTRODOMESTICOS
12135555;;F;51;CHILENO;;X;LA FLORIDA                    ;METROPOLITANA;0;0;0;0;0;0;0;0;0;Maquina de Coser JS-2135CL Calipso;ELECTRODOMESTICOS
8895174;;M;61;CHILENO;;Boomers;PROVIDENCIA                   ;METROPOLITANA;0;0;0;0;0;0;0;0;0;Plancha THOMAS TH-7170 2200Watts Base Ceramica;ELECTRODOMESTICOS
18275349;;F;29;CHILENO;;Millenial;PROVIDENCIA                   ;METROPOLITANA;0;0;0;0;0;0;0;0;0;Hervidor Electrico TH-4515N 2Lts Negro;ELECTRODOMESTICOS
7621438;;M;64;CHILENO;;Boomers;CASTRO                        ;LOS LAGOS;0;0;0;0;0;0;0;0;0;Hervidor Electrico TH-4212N 1,7Lts Negro;ELECTRODOMESTICOS
7361207;;F;63;CHILENO;;Boomers;PROVIDENCIA                   ;METROPOLITANA;0;0;0;0;0;0;0;0;0;Maquina de Coser ME9100;ELECTRODOMESTICOS
17077713;;M;33;CHILENO;;Millenial;N/D;N/D;0;0;0;0;0;0;0;0;0;Licuadora TH-320 Roja/Negro 1,5 Lts Vaso Vidrio;ELECTRODOMESTICOS
8401947;Casado;F;66;CHILENO;;Boomers;RENCA                         ;METROPOLITANA;0;0;0;0;0;0;0;0;0;Licuadora TH-320 Roja/Negro 1,5 Lts Vaso Vidrio;ELECTRODOMESTICOS
9134094;;F;58;CHILENO;;Boomers;RENCA                         ;METROPOLITANA;0;0;0;0;0;0;0;0;0;Horno Microondas Digital TH-20S01 20Lts;ELECTRODOMESTICOS
20049872;;M;24;CHILENO;;Silencioso;PROVIDENCIA                   ;METROPOLITANA;0;0;0;0;0;0;0;0;0;ASPIRADORA POLVO Y AGUA APA-1150 IN;ELECTRODOMESTICOS
17329327;;F;41;CHILENO;;Silencioso;PROVIDENCIA                   ;METROPOLITANA;0;0;0;0;0;0;0;0;0;Robot aspirador Roomba 675;ELECTRODOMESTICOS
7178483;Casado;F;70;CHILENO;AUXILIAR DE ENFERMERIA;Silencioso;PROVIDENCIA                   ;METROPOLITANA;0;0;0;0;0;0;0;0;0;Licuadora L2000VNG 1,5Lts Vaso Vidrio;ELECTRODOMESTICOS
9621326;;F;60;CHILENO;;Boomers;RENGO                         ;L.G.B.OÂ´HIGGINS;0;0;0;0;0;0;0;0;0;Licuadora UT-METALLEK505P 1,5Lts Vaso Vidrio;ELECTRODOMESTICOS
4663076;;F;79;CHILENO;;Silencioso;PROVIDENCIA                   ;METROPOLITANA;0;0;0;0;0;0;0;0;0;Licuadora TH-401V Roja 1,75Lts Vaso Vidrio;ELECTRODOMESTICOS
16518479;Soltero;M;35;CHILENO;;Millenial;PROVIDENCIA                   ;METROPOLITANA;0;0;0;0;0;0;0;0;0;Combo Hervidor + Batidora;ELECTRODOMESTICOS
26116247;Soltero;M;33;VENEZOLANO;;Extranjero;SANTIAGO                      ;METROPOLITANA;0;0;0;0;0;0;0;0;0;Hervidor Electrico UT-MANLY17 1,7Lts Negro;ELECTRODOMESTICOS
11120378;;F;55;CHILENO;;Boomers;LIMACHE                       ;VALPARAISO;0;0;0;0;0;0;0;0;0;EXTRACTOR DE JUGOS UT-NUTRISMART;ELECTRODOMESTICOS
13503612;;F;43;CHILENO;;X;RENCA                         ;METROPOLITANA;0;0;0;0;0;0;0;0;0;Horno Electrico TH-80i 80Lts;ELECTRODOMESTICOS
17233508;;M;33;CHILENO;;Millenial;MULCHEN                       ;BIO BIO;0;0;0;0;0;0;0;0;0;Aspiradora AP1700 Arrastre 1700Watts;ELECTRODOMESTICOS
18829688;Soltero;F;28;CHILENO;;Silencioso;PROVIDENCIA                   ;METROPOLITANA;0;0;0;0;0;0;0;0;0;Horno Electrico TH-25N01 25Lts;ELECTRODOMESTICOS
15981935;;F;37;CHILENO;;Millenial;PROVIDENCIA                   ;METROPOLITANA;0;0;0;0;0;0;0;0;0;Batidora Manual 2532;ELECTRODOMESTICOS
9083328;;M;61;CHILENO;;Boomers;PROVIDENCIA                   ;METROPOLITANA;0;0;0;0;0;0;0;0;0;Licuadora TH-320 Roja/Negro 1,5 Lts Vaso Vidrio;ELECTRODOMESTICOS
10953529;;F;52;CHILENO;;X;PROVIDENCIA                   ;METROPOLITANA;0;0;0;0;0;0;0;0;0;Licuadora TH-320 Roja/Negro 1,5 Lts Vaso Vidrio;ELECTRODOMESTICOS
16590493;;M;35;CHILENO;;Millenial;PROVIDENCIA                   ;METROPOLITANA;0;0;0;0;0;0;0;0;0;Horno Microondas Mecanico TH-18B05 18Lts;ELECTRODOMESTICOS
12432953;Casado;F;49;CHILENO;;X;PROVIDENCIA                   ;METROPOLITANA;0;0;0;0;0;0;0;0;0;Plancha UT-DUNST 2200Watts Base Ceramica;ELECTRODOMESTICOS
15058329;;F;40;CHILENO;;X;RENCA                         ;METROPOLITANA;0;0;0;0;0;0;0;0;0;Plancha TH-7052 2000Watts Base Inox;ELECTRODOMESTICOS
9389535;;F;60;CHILENO;;Boomers;PROVIDENCIA                   ;METROPOLITANA;0;0;0;0;0;0;0;0;0;Batidora Manual 2532;ELECTRODOMESTICOS
18979328;;M;27;CHILENO;;Z;PROVIDENCIA                   ;METROPOLITANA;0;0;0;0;0;0;0;0;0;FREIDORA DE AIRE CKSTAF15B 1850W;ELECTRODOMESTICOS
16309385;;M;36;CHILENO;;Millenial;RENCA                         ;METROPOLITANA;0;0;0;0;0;0;0;0;0;Horno Microondas Mecanico Easy Wave 20Lts;ELECTRODOMESTICOS
18708653;;F;27;CHILENO;;Millenial;PROVIDENCIA                   ;METROPOLITANA;0;0;0;0;0;0;0;0;0;Hervidor Electrico 3100 1,7Lts Negro;ELECTRODOMESTICOS
14053174;;F;40;CHILENO;;X;RENCA                         ;METROPOLITANA;0;0;0;0;0;0;0;0;0;Tostador de Pan TH-116 2 Rebanadas Negro;ELECTRODOMESTICOS
12397315;Soltero;F;49;CHILENO;;X;RENCA                         ;METROPOLITANA;0;0;0;0;0;0;0;0;0;Picadora UT-PETRUS320 1Lts Vaso Vidrio;ELECTRODOMESTICOS
15322964;;F;40;CHILENO;;X;RENCA                         ;METROPOLITANA;0;0;0;0;0;0;0;0;0;BATIDORA PEDESTAL THOMAS TH-910PB;ELECTRODOMESTICOS
7336001;;M;67;CHILENO;;Boomers;ANTOFAGASTA                   ;ANTOFAGASTA;0;0;0;0;0;0;0;0;0;Maquina de Coser XB-2500CL Rosado;ELECTRODOMESTICOS
9198682;;F;60;CHILENO;;Boomers;PROVIDENCIA                   ;METROPOLITANA;0;0;0;0;0;0;0;0;0;PROCESADOR THOMAS TH-9160;ELECTRODOMESTICOS
16319137;;F;35;CHILENO;;Millenial;ANTOFAGASTA                   ;ANTOFAGASTA;0;0;0;0;0;0;0;0;0;Hervidor Electrico TH-5407i 2Lts;ELECTRODOMESTICOS
16614969;;M;35;CHILENO;;Millenial;RENCA                         ;METROPOLITANA;0;0;0;0;0;0;0;0;0;ASPIRADORA AP-3600 EGR;ELECTRODOMESTICOS
17251218;;M;33;CHILENO;;Millenial;N/D;N/D;0;0;0;0;0;0;0;0;0;Aspiradora UT-ZYKLON1402 Arrastre 1400Watts;ELECTRODOMESTICOS
7073785;;M;65;CHILENO;;Boomers;PROVIDENCIA                   ;METROPOLITANA;0;0;0;0;0;0;0;0;0;Hervidor Electrico 388R Rojo;ELECTRODOMESTICOS
10088013;Casado;F;60;CHILENO;;Boomers;RENCA                         ;METROPOLITANA;0;0;0;0;0;0;0;0;0;ASPIRADORA THOMAS TH-1640;ELECTRODOMESTICOS
19619088;;F;24;CHILENO;;Z;PROVIDENCIA                   ;METROPOLITANA;0;0;0;0;0;0;0;0;0;Horno Microondas Mecanico C1700N 17Lts Blanco;ELECTRODOMESTICOS
8821865;;M;63;CHILENO;;Boomers;PROVIDENCIA                   ;METROPOLITANA;0;0;0;0;0;0;0;0;0;Licuadora L2000VNG 1,5Lts Vaso Vidrio;ELECTRODOMESTICOS
8791598;Divorciado;F;63;CHILENO;;Boomers;RENCA                         ;METROPOLITANA;0;0;0;0;0;0;0;0;0;Horno Electrico TH62I 60Lts;ELECTRODOMESTICOS
7432997;Casado;M;66;CHILENO;BIOQUIMICO;Boomers;SAN FELIPE                    ;VALPARAISO;0;0;0;0;0;0;0;0;0;BATIDORA PEDESTAL THOMAS TH-910PB;ELECTRODOMESTICOS
12571266;;M;48;CHILENO;;X;PROVIDENCIA                   ;METROPOLITANA;0;0;0;0;0;0;0;0;0;Plancha TH-7052 2000Watts Base Inox;ELECTRODOMESTICOS
6400446;Casado;F;72;CHILENO;;Silencioso;RENCA                         ;METROPOLITANA;0;0;0;0;0;0;0;0;0;LICUADORA MULTIFUNCION LCM-18000 GF;ELECTRODOMESTICOS
5956849;Viudo;F;71;CHILENO;;Silencioso;PROVIDENCIA                   ;METROPOLITANA;0;0;0;0;0;0;0;0;0;Hervidor Electrico UT-KLAR20PW 2Lts Blanco;ELECTRODOMESTICOS
6181633;;M;74;CHILENO;;Silencioso;PROVIDENCIA                   ;METROPOLITANA;0;0;0;0;0;0;0;0;0;Licuadora TH-501V 1,5Lts Vaso Vidrio;ELECTRODOMESTICOS
12714481;;M;47;CHILENO;;X;N/D;N/D;0;0;0;0;0;0;0;0;0;Hervidor Electrico UT-MANLY17 1,7Lts Negro;ELECTRODOMESTICOS
15122329;;M;40;CHILENO;;X;PROVIDENCIA                   ;METROPOLITANA;0;0;0;0;0;0;0;0;0;Hervidor Termo BA-6928 Rojo 2,8Lts;ELECTRODOMESTICOS
4677607;;M;79;CHILENO;;Silencioso;ARICA                         ;ARICA Y PARINACOTA;0;0;0;0;0;0;0;0;0;Hervidor Electrico 388R Rojo;ELECTRODOMESTICOS
16614207;;F;35;CHILENO;TECNICO EN ADMINISTRACION DE EMPRESAS;Millenial;PROVIDENCIA                   ;METROPOLITANA;0;0;0;0;0;0;0;0;0;Licuadora L2000VNG 1,5Lts Vaso Vidrio;ELECTRODOMESTICOS
17678658;Soltero;F;31;CHILENO;;Silencioso;PROVIDENCIA                   ;METROPOLITANA;0;0;0;0;0;0;0;0;0;Batidora Pedestal TH910PN 4,6Lts 1300Watts;ELECTRODOMESTICOS
13734040;Soltero;F;49;CHILENO;SOCIOLOGO;X;PROVIDENCIA                   ;METROPOLITANA;0;0;0;0;0;0;0;0;0;Hervidor Electrico 3100 1,7Lts Negro;ELECTRODOMESTICOS
10718212;;F;56;CHILENO;;Boomers;RENCA                         ;METROPOLITANA;0;0;0;0;0;0;0;0;0;Batidora Pedestal Bowl 300 Inox;ELECTRODOMESTICOS
17551539;Casado;M;32;CHILENO;;Millenial;CARAHUE                       ;ARAUCANIA;0;0;0;0;0;0;0;0;0;Tostador de Pan TH-126 4 Rebanadas Negro;ELECTRODOMESTICOS
10628901;Soltero;M;55;CHILENO;;Boomers;RENCA                         ;METROPOLITANA;0;0;0;0;0;0;0;0;0;LICUADORA MA-4210;ELECTRODOMESTICOS
12604136;Soltero;F;48;CHILENO;;X;RENCA                         ;METROPOLITANA;0;0;0;0;0;0;0;0;0;Hervidor Electrico UT-MANLY17 1,7Lts Negro;ELECTRODOMESTICOS
8397464;;F;65;CHILENO;;Boomers;HUECHURABA                    ;METROPOLITANA;0;0;0;0;0;0;0;0;0;Hervidor Electrico TH-6200 R 1,7Lts Rojo;ELECTRODOMESTICOS
26458412;;M;30;HAITIANO;;Extranjero;LINARES                       ;MAULE;0;0;0;0;0;0;0;0;0;Hervidor Electrico 3100 1,7Lts Negro;ELECTRODOMESTICOS
15680879;;F;42;CHILENO;;X;PROVIDENCIA                   ;METROPOLITANA;0;0;0;0;0;0;0;0;0;Horno Microondas Digital TH-25DM 25Lts;ELECTRODOMESTICOS
15192508;;M;39;CHILENO;;Millenial;N/D;N/D;0;0;0;0;0;0;0;0;0;Horno Microondas Digital L UT-25KROMM 25Lts;ELECTRODOMESTICOS
7410461;;M;64;CHILENO;;Boomers;ANCUD                         ;LOS LAGOS;0;0;0;0;0;0;0;0;0;Horno Microondas Mecanico C1700N 17Lts Blanco;ELECTRODOMESTICOS
7586391;;F;68;CHILENO;;Boomers;N/D;N/D;0;0;0;0;0;0;0;0;0;Licuadora L2000VNG 1,5Lts Vaso Vidrio;ELECTRODOMESTICOS
7020826;Casado;M;57;CHILENO;;Boomers;RENCA                         ;METROPOLITANA;0;0;0;0;0;0;0;0;0;Plancha TH-7052 2000Watts Base Inox;ELECTRODOMESTICOS
13341364;;M;44;CHILENO;;X;PROVIDENCIA                   ;METROPOLITANA;0;0;0;0;0;0;0;0;0;Exprimidor Fauna 500 cc;ELECTRODOMESTICOS
5423796;;F;79;CHILENO;;Silencioso;PROVIDENCIA                   ;METROPOLITANA;0;0;0;0;0;0;0;0;0;Aspiradora TH1870 Arrastre 1800Watts Gris;ELECTRODOMESTICOS
11668581;;M;51;CHILENO;;Silencioso;PROVIDENCIA                   ;METROPOLITANA;0;0;0;0;0;0;0;0;0;Aspiradora VCC4190V3E/XZS Arrastre 2000Watts;ELECTRODOMESTICOS
8460670;;F;52;CHILENO;;X;PROVIDENCIA                   ;METROPOLITANA;0;0;0;0;0;0;0;0;0;Aspiradora Roomba 621;ELECTRODOMESTICOS
11695471;;F;51;CHILENO;;Silencioso;PROVIDENCIA                   ;METROPOLITANA;0;0;0;0;0;0;0;0;0;Aspiradora Polvo AP-700 GR;ELECTRODOMESTICOS
18413131;;F;28;CHILENO;;Millenial;PROVIDENCIA                   ;METROPOLITANA;0;0;0;0;0;0;0;0;0;PLANCHA VERTICAL V-1600VBL;ELECTRODOMESTICOS
18115804;;F;30;CHILENO;;Millenial;PROVIDENCIA                   ;METROPOLITANA;0;0;0;0;0;0;0;0;0;PANINI/WAFLERA TH-965;ELECTRODOMESTICOS
20219822;;F;23;CHILENO;;Z;PROVIDENCIA                   ;METROPOLITANA;0;0;0;0;0;0;0;0;0;BATIDORA PLANETARIA BP-4500 BL;ELECTRODOMESTICOS
11746327;Casado;F;52;CHILENO;EDUCADOR DE PARVULOS;X;YERBAS BUENAS                 ;MAULE;0;0;0;0;0;0;0;0;0;Horno Microondas Digital TH-20S01 20Lts;ELECTRODOMESTICOS
12725909;;F;46;CHILENO;;X;PROVIDENCIA                   ;METROPOLITANA;0;0;0;0;0;0;0;0;0;Licuadora Roja 550W 1,5Lts Vaso Vidrio;ELECTRODOMESTICOS
13676645;;F;42;CHILENO;;X;PARRAL                        ;MAULE;0;0;0;0;0;0;0;0;0;Horno Electrico TH62I 60Lts;ELECTRODOMESTICOS
17674823;Soltero;F;31;CHILENO;PROFESOR;Millenial;PROVIDENCIA                   ;METROPOLITANA;0;0;0;0;0;0;0;0;0;Freidora electrica Ut-KeramikAir;ELECTRODOMESTICOS
18897701;;M;27;CHILENO;;Millenial;LA FLORIDA;METROPOLITANA;0;0;0;0;0;0;0;0;0;Plancha TH-7052 2000Watts Base Inox;ELECTRODOMESTICOS
18467593;;F;28;CHILENO;;Millenial;N/D;N/D;0;0;0;0;0;0;0;0;0;Plancha Vertical TH-7300 1200Watts;ELECTRODOMESTICOS
13489220;Soltero;M;43;CHILENO;;X;RENCA                         ;METROPOLITANA;0;0;0;0;0;0;0;0;0;Licuadora UT-METALLEK705 1,75Lts Vaso Vidrio;ELECTRODOMESTICOS
7203707;;M;67;CHILENO;;Boomers;SANTIAGO                      ;METROPOLITANA;0;0;0;0;0;0;0;0;0;Tostador de PanTH-120R 2 Rebanadas Rojo;ELECTRODOMESTICOS
16163789;;M;36;CHILENO;;Millenial;N/D;N/D;0;0;0;0;0;0;0;0;0;Hervidor Electrico TH-6200 R 1,7Lts Rojo;ELECTRODOMESTICOS
15852368;;F;38;CHILENO;;Millenial;PROVIDENCIA                   ;METROPOLITANA;0;0;0;0;0;0;0;0;0;MAQUINA DE COSER ME 3B FULL MERRITT;ELECTRODOMESTICOS
16990379;;M;34;CHILENO;;Millenial;PROVIDENCIA                   ;METROPOLITANA;0;0;0;0;0;0;0;0;0;Licuadora TH-501V 1,5Lts Vaso Vidrio;ELECTRODOMESTICOS
9071526;;F;54;CHILENO;;Boomers;AISEN                         ;AYSEN;0;0;0;0;0;0;0;0;0;Aspiradora Handy Clean Black 1400;ELECTRODOMESTICOS
6729696;;F;75;CHILENO;;Silencioso;RENCA                         ;METROPOLITANA;0;0;0;0;0;0;0;0;0;Licuadora Roja 550W 1,5Lts Vaso Vidrio;ELECTRODOMESTICOS
16920057;Casado;F;34;CHILENO;;Silencioso;PROVIDENCIA                   ;METROPOLITANA;0;0;0;0;0;0;0;0;0;Hervidor Electrico 3100 1,7Lts Negro;ELECTRODOMESTICOS
9178065;Casado;M;57;CHILENO;;Boomers;PROVIDENCIA                   ;METROPOLITANA;0;0;0;0;0;0;0;0;0;Hervidor Electrico HE420 2lts Negro;ELECTRODOMESTICOS
12663881;;F;48;CHILENO;;X;VALDIVIA                      ;LOS RIOS;0;0;0;0;0;0;0;0;0;Horno Microondas Digital TH-20S01 20Lts;ELECTRODOMESTICOS
25550023;;F;56;PERUANO;;Extranjero;N/D;N/D;0;0;0;0;0;0;0;0;0;Maquina de Coser ME9100;ELECTRODOMESTICOS
9466564;;F;58;CHILENO;;Boomers;RENCA                         ;METROPOLITANA;0;0;0;0;0;0;0;0;0;Hervidor Electrico Tetera TH-6505RT 1,7Lts Rojo;ELECTRODOMESTICOS
12551993;;F;47;CHILENO;;X;BUIN                          ;METROPOLITANA;0;0;0;0;0;0;0;0;0;Combo Hervidor + Batidora;ELECTRODOMESTICOS
26437898;;M;33;VENEZOLANO;;Extranjero;SAN FELIPE                    ;VALPARAISO;0;0;0;0;0;0;0;0;0;Freidora electrica Ut-KeramikAir;ELECTRODOMESTICOS
8936891;;F;57;CHILENO;;Boomers;CALERA                        ;VALPARAISO;0;0;0;0;0;0;0;0;0;Horno Electrico TH-100i 100Lts;ELECTRODOMESTICOS
11048574;;F;56;CHILENO;;Boomers;SANTIAGO                      ;METROPOLITANA;0;0;0;0;0;0;0;0;0;Hervidor Electrico TH-4350 3Lts Blanco;ELECTRODOMESTICOS
5905493;Casado;M;74;CHILENO;;Silencioso;RENCA                         ;METROPOLITANA;0;0;0;0;0;0;0;0;0;Aspiradora TH1870 Arrastre 1800Watts Gris;ELECTRODOMESTICOS
13511385;;M;43;CHILENO;;X;RENCA                         ;METROPOLITANA;0;0;0;0;0;0;0;0;0;Batidora Pedestal B5300 Inox;ELECTRODOMESTICOS
6433440;;F;73;CHILENO;;Silencioso;MELIPILLA                     ;METROPOLITANA;0;0;0;0;0;0;0;0;0;Licuadora TH-401V Roja 1,75Lts Vaso Vidrio;ELECTRODOMESTICOS
19227163;;M;26;CHILENO;;Silencioso;PROVIDENCIA                   ;METROPOLITANA;0;0;0;0;0;0;0;0;0;Termohervidor 2,8 MA6720 Rojo;ELECTRODOMESTICOS
14320746;;M;45;CHILENO;;X;IQUIQUE                       ;TARAPACA;0;0;0;0;0;0;0;0;0;Plancha UT-PLATTEISEN 2000Watts Base Ceramica;ELECTRODOMESTICOS
8071628;;F;64;CHILENO;;Boomers;PROVIDENCIA                   ;METROPOLITANA;0;0;0;0;0;0;0;0;0;Batidora Vertical Minipimer UT-KLOT400P;ELECTRODOMESTICOS
26083599;;M;30;HAITIANO;;Extranjero;SAN FELIPE                    ;VALPARAISO;0;0;0;0;0;0;0;0;0;Licuadora TH-320 Roja/Negro 1,5 Lts Vaso Vidrio;ELECTRODOMESTICOS
18788115;;F;28;CHILENO;;Millenial;LITUECHE                      ;L.G.B.OÂ´HIGGINS;0;0;0;0;0;0;0;0;0;BATIDORA INMERSION S MIX 2616;ELECTRODOMESTICOS
13772811;;M;42;CHILENO;;X;MELIPILLA                     ;METROPOLITANA;0;0;0;0;0;0;0;0;0;Hervidor Electrico 3100 1,7Lts Negro;ELECTRODOMESTICOS
5800039;Casado;M;75;CHILENO;;Silencioso;RENCA                         ;METROPOLITANA;0;0;0;0;0;0;0;0;0;Tostador de PanTH-120R 2 Rebanadas Rojo;ELECTRODOMESTICOS
9928202;;F;57;CHILENO;;Boomers;N/D;N/D;0;0;0;0;0;0;0;0;0;Batidora Vertical Minipimer UT-KLOT400P;ELECTRODOMESTICOS
17664306;Casado;F;31;CHILENO;;Silencioso;PROVIDENCIA                   ;METROPOLITANA;0;0;0;0;0;0;0;0;0;Batidora Pedestal TH910PN 4,6Lts 1300Watts;ELECTRODOMESTICOS
16517954;;M;35;CHILENO;;Millenial;NUNOA                         ;METROPOLITANA;0;0;0;0;0;0;0;0;0;PLANCHA VERTICAL V-1600VBL;ELECTRODOMESTICOS
15965652;;M;37;CHILENO;;Millenial;PROVIDENCIA                   ;METROPOLITANA;0;0;0;0;0;0;0;0;0;Licuadora Roja 550W 1,5Lts Vaso Vidrio;ELECTRODOMESTICOS
6910480;;F;72;CHILENO;;Silencioso;PROVIDENCIA                   ;METROPOLITANA;0;0;0;0;0;0;0;0;0;Licuadora TH-320 Roja/Negro 1,5 Lts Vaso Vidrio;ELECTRODOMESTICOS
10460488;;F;55;CHILENO;;Boomers;SAN BERNARDO                  ;METROPOLITANA;0;0;0;0;0;0;0;0;0;Aspiradora UT-SILENT1603 Arrastre 1600Watts;ELECTRODOMESTICOS
14415400;;M;50;CHILENO;;X;MELIPILLA                     ;METROPOLITANA;0;0;0;0;0;0;0;0;0;Horno Electrico UT-BACKOFEN26 26Lts;ELECTRODOMESTICOS
18945243;;F;27;CHILENO;;Z;PROVIDENCIA                   ;METROPOLITANA;0;0;0;0;0;0;0;0;0;Horno Electrico UT-BACKOFEN48 48Lts;ELECTRODOMESTICOS
10592120;;F;55;CHILENO;;Boomers;VINA DEL MAR                  ;VALPARAISO;0;0;0;0;0;0;0;0;0;Aspiradora TH1870 Arrastre 1800Watts Gris;ELECTRODOMESTICOS
11566538;Casado;M;52;CHILENO;;X;PROVIDENCIA                   ;METROPOLITANA;0;0;0;0;0;0;0;0;0;Horno Electrico UT-BACKOFEN26 26Lts;ELECTRODOMESTICOS
17027001;;M;33;CHILENO;;Millenial;CONCHALI                      ;METROPOLITANA;0;0;0;0;0;0;0;0;0;Hervidor Electrico UT-MANLY17 1,7Lts Negro;ELECTRODOMESTICOS
13872553;;M;42;CHILENO;;X;PROVIDENCIA                   ;METROPOLITANA;0;0;0;0;0;0;0;0;0;Horno Electrico TH-25N01 25Lts;ELECTRODOMESTICOS
5631396;;F;76;CHILENO;;Silencioso;PROVIDENCIA                   ;METROPOLITANA;0;0;0;0;0;0;0;0;0;Hervidor Electrico UT-MANLY17 1,7Lts Negro;ELECTRODOMESTICOS
7677451;;F;64;CHILENO;;Boomers;OVALLE                        ;COQUIMBO;0;0;0;0;0;0;0;0;0;Horno Microondas Digital UT-CLASSY720 20Lts;ELECTRODOMESTICOS
17494179;Soltero;F;32;CHILENO;;Millenial;PROVIDENCIA                   ;METROPOLITANA;0;0;0;0;0;0;0;0;0;Horno Electrico TH-25N01 25Lts;ELECTRODOMESTICOS
25836793;;M;48;VENEZOLANO;;Extranjero;INDEPENDENCIA                 ;METROPOLITANA;0;0;0;0;0;0;0;0;0;Licuadora Negra 550W 1,5Lts Vaso Vidrio;ELECTRODOMESTICOS
13348439;;F;45;CHILENO;;X;SANTA CRUZ                    ;L.G.B.OÂ´HIGGINS;0;0;0;0;0;0;0;0;0;ASPIRADORA THOMAS TH-1640;ELECTRODOMESTICOS
9187182;;F;64;CHILENO;;Boomers;SAN MIGUEL                    ;METROPOLITANA;0;0;0;0;0;0;0;0;0;Licuadora TH-501V 1,5Lts Vaso Vidrio;ELECTRODOMESTICOS
7649414;;M;61;CHILENO;;Boomers;N/D;N/D;0;0;0;0;0;0;0;0;0;Aspiradora Cyclonic Adventage roja CA4000N;ELECTRODOMESTICOS
13375353;;F;45;CHILENO;;X;SANTIAGO                      ;METROPOLITANA;0;0;0;0;0;0;0;0;0;Batidora Manual UT-TEKLA300;ELECTRODOMESTICOS
11421534;Casado;F;52;CHILENO;;X;PROVIDENCIA                   ;METROPOLITANA;0;0;0;0;0;0;0;0;0;Horno Microondas Mecanico TH-18B05 18Lts;ELECTRODOMESTICOS
6792850;;F;72;CHILENO;;Silencioso;PROVIDENCIA                   ;METROPOLITANA;0;0;0;0;0;0;0;0;0;PLANCHA A VAPOR 6953 BASE AEROCERAMICA AUTAPA.22;ELECTRODOMESTICOS
10855918;;M;51;CHILENO;;X;RENCA                         ;METROPOLITANA;0;0;0;0;0;0;0;0;0;PICADORA 123 SILHQUETTE;ELECTRODOMESTICOS
15764865;;F;39;CHILENO;;X;PROVIDENCIA                   ;METROPOLITANA;0;0;0;0;0;0;0;0;0;Aspiradora TH1407 Arrastre 1400Watts;ELECTRODOMESTICOS
15681523;;M;39;CHILENO;;X;SANTIAGO                      ;METROPOLITANA;0;0;0;0;0;0;0;0;0;Hervidor Termo BA-6928 Rojo 2,8Lts;ELECTRODOMESTICOS
25516424;;M;39;HAITIANO;;Extranjero;"";"";0;0;0;0;0;0;0;0;0;Licuadora TH-501V 1,5Lts Vaso Vidrio;ELECTRODOMESTICOS
8156124;Casado;F;64;CHILENO;TECNICO DE NIVEL SUPERIOR EN ENFERMERIA;Boomers;RENCA                         ;METROPOLITANA;0;0;0;0;0;0;0;0;0;Aspiradora UT-SILENT1804 Arrastre 1800Watts;ELECTRODOMESTICOS
5974312;;M;74;CHILENO;;Silencioso;PROVIDENCIA                   ;METROPOLITANA;0;0;0;0;0;0;0;0;0;PLANCHA A VAPOR 6003 BASE ANTIADHERENTE 1600W;ELECTRODOMESTICOS
12759967;;F;47;CHILENO;;X;ANCUD                         ;LOS LAGOS;0;0;0;0;0;0;0;0;0;Horno Microondas Mecanico UT-SYDNEY18 18Lts;ELECTRODOMESTICOS
10260394;Soltero;F;58;CHILENO;;Boomers;RENCA                         ;METROPOLITANA;0;0;0;0;0;0;0;0;0;Plancha UT-DUNST 2200Watts Base Ceramica;ELECTRODOMESTICOS
8028977;;M;64;CHILENO;;Boomers;PROVIDENCIA                   ;METROPOLITANA;0;0;0;0;0;0;0;0;0;Aspiradora VCC4190V3E/XZS Arrastre 2000Watts;ELECTRODOMESTICOS
17366780;Soltero;M;32;CHILENO;BIOQUIMICO;Millenial;PROVIDENCIA                   ;METROPOLITANA;0;0;0;0;0;0;0;0;0;Aspiradora UT-SILENT1804 Arrastre 1800Watts;ELECTRODOMESTICOS
18718123;;F;27;CHILENO;;Millenial;N/D;N/D;0;0;0;0;0;0;0;0;0;Horno Electrico TH-100i 100Lts;ELECTRODOMESTICOS
6801746;Soltero;M;71;CHILENO;;Silencioso;RENCA                         ;METROPOLITANA;0;0;0;0;0;0;0;0;0;Hervidor Electrico TH-5407i 2Lts;ELECTRODOMESTICOS
5997180;;F;74;CHILENO;;Silencioso;PROVIDENCIA                   ;METROPOLITANA;0;0;0;0;0;0;0;0;0;Aspiradora TH1870 Arrastre 1800Watts Gris;ELECTRODOMESTICOS
20525280;;F;21;CHILENO;;Z;PROVIDENCIA                   ;METROPOLITANA;0;0;0;0;0;0;0;0;0;Aspiradora TH1415 Arrastre 1500Watts;ELECTRODOMESTICOS
7387282;;F;64;CHILENO;;Silencioso;PROVIDENCIA                   ;METROPOLITANA;0;0;0;0;0;0;0;0;0;Exprimidor Fauna 500 cc;ELECTRODOMESTICOS
19356983;;F;25;CHILENO;;Z;PROVIDENCIA                   ;METROPOLITANA;0;0;0;0;0;0;0;0;0;PLANCHA A VAPOR 6003 BASE ANTIADHERENTE 1600W;ELECTRODOMESTICOS
17435929;;F;32;CHILENO;;Millenial;"";"";0;0;0;0;0;0;0;0;0;Aspiradora AP3400 Arrastre 2000Watts;ELECTRODOMESTICOS
11812413;;M;51;CHILENO;;X;RENCA                         ;METROPOLITANA;0;0;0;0;0;0;0;0;0;Aspiradora VCC4190V3E/XZS Arrastre 2000Watts;ELECTRODOMESTICOS
17907513;;F;30;CHILENO;;Millenial;PROVIDENCIA                   ;METROPOLITANA;0;0;0;0;0;0;0;0;0;Horno Electrico TH62I 60Lts;ELECTRODOMESTICOS
6483159;;M;72;CHILENO;;Silencioso;LOS ANDES                     ;VALPARAISO;0;0;0;0;0;0;0;0;0;Licuadora TH-501V 1,5Lts Vaso Vidrio;ELECTRODOMESTICOS
17191397;Casado;M;33;CHILENO;;Millenial;OVALLE                        ;COQUIMBO;0;0;0;0;0;0;0;0;0;MICROONDAS ME83X/XZS SAMSUNG MIRROR;ELECTRODOMESTICOS
8751861;;M;52;CHILENO;;X;ARICA                         ;ARICA Y PARINACOTA;0;0;0;0;0;0;0;0;0;HERVIDOR ELECTRICO UT-STARK18;ELECTRODOMESTICOS
15384808;;M;39;CHILENO;;X;PANGUIPULLI                   ;LOS RIOS;0;0;0;0;0;0;0;0;0;Horno Microondas Digital MS23K3513AK/ZS 23Lts;ELECTRODOMESTICOS
13565809;;F;42;CHILENO;;X;RECOLETA                      ;METROPOLITANA;0;0;0;0;0;0;0;0;0;SANDWICHERA THOMAS TH-958;ELECTRODOMESTICOS
15607441;;F;38;CHILENO;;Millenial;CONCHALI                      ;METROPOLITANA;0;0;0;0;0;0;0;0;0;Horno Electrico TH-25N01 25Lts;ELECTRODOMESTICOS
6019815;Casado;F;72;CHILENO;;Silencioso;PROVIDENCIA                   ;METROPOLITANA;0;0;0;0;0;0;0;0;0;Procesador TH-9010 Multimixer 1,5Lts Vaso Vidrio;ELECTRODOMESTICOS
17688897;Soltero;M;31;CHILENO;;Millenial;PROVIDENCIA                   ;METROPOLITANA;0;0;0;0;0;0;0;0;0;Plancha Vertical UT-TURBOSTEAMER 1400Watts;ELECTRODOMESTICOS
9180640;;F;58;CHILENO;;Boomers;LA UNION                      ;LOS LAGOS;0;0;0;0;0;0;0;0;0;Hervidor Electrico UT-KLAR20PW 2Lts Blanco;ELECTRODOMESTICOS
9859843;;M;59;CHILENO;;Boomers;RENCA                         ;METROPOLITANA;0;0;0;0;0;0;0;0;0;Horno Electrico UT-BACKOFEN26 26Lts;ELECTRODOMESTICOS
15521632;;M;39;CHILENO;;X;PROVIDENCIA                   ;METROPOLITANA;0;0;0;0;0;0;0;0;0;HERVIDOR ELECTRICO UT-STARK18;ELECTRODOMESTICOS
24828798;;F;42;COLOMBIANO;;Extranjero;N/D;N/D;0;0;0;0;0;0;0;0;0;Aspiradora TH1415 Arrastre 1500Watts;ELECTRODOMESTICOS
13933909;;M;42;CHILENO;;X;RENCA                         ;METROPOLITANA;0;0;0;0;0;0;0;0;0;Maquina de Coser ME9100;ELECTRODOMESTICOS
9305352;;F;57;CHILENO;;Boomers;FREIRINA                      ;ATACAMA;0;0;0;0;0;0;0;0;0;Enceradora EA-5000;ELECTRODOMESTICOS
16649605;;M;34;CHILENO;;Millenial;RENCA                         ;METROPOLITANA;0;0;0;0;0;0;0;0;0;Combo Hervidor + Batidora;ELECTRODOMESTICOS
11973304;;F;50;CHILENO;;X;RENCA                         ;METROPOLITANA;0;0;0;0;0;0;0;0;0;Licuadora Personal TH-300PB;ELECTRODOMESTICOS
12324491;;F;49;CHILENO;;X;CONCEPCION                    ;BIO BIO;0;0;0;0;0;0;0;0;0;Horno Electrico TH-25N01 25Lts;ELECTRODOMESTICOS
10365882;;F;54;CHILENO;;X;SANTIAGO                      ;METROPOLITANA;0;0;0;0;0;0;0;0;0;MAQUINA DE COSER ME 3B FULL MERRITT;ELECTRODOMESTICOS
14103959;;M;41;CHILENO;;X;RENCA                         ;METROPOLITANA;0;0;0;0;0;0;0;0;0;Maquina de Coser Remington J011;ELECTRODOMESTICOS
19027148;;F;27;CHILENO;;Z;"";"";0;0;0;0;0;0;0;0;0;Horno Microondas Digital TH-25DGM 25Lts;ELECTRODOMESTICOS
13365781;;F;43;CHILENO;;X;PROVIDENCIA                   ;METROPOLITANA;0;0;0;0;0;0;0;0;0;Aspiradora TH1415 Arrastre 1500Watts;ELECTRODOMESTICOS
9263552;;F;60;CHILENO;;Boomers;ANTOFAGASTA                   ;ANTOFAGASTA;0;0;0;0;0;0;0;0;0;Plancha UT-SHANGRILA Inalambrica 2200Watss;ELECTRODOMESTICOS
19058980;;M;27;CHILENO;;Z;PROVIDENCIA                   ;METROPOLITANA;0;0;0;0;0;0;0;0;0;Hervidor Electrico TH-5407i 2Lts;ELECTRODOMESTICOS
14346873;Soltero;F;43;CHILENO;;X;PROVIDENCIA                   ;METROPOLITANA;0;0;0;0;0;0;0;0;0;Aspiradora UT-SILENT1603 Arrastre 1600Watts;ELECTRODOMESTICOS
8165806;;F;64;CHILENO;;Boomers;RENCA                         ;METROPOLITANA;0;0;0;0;0;0;0;0;0;Horno Electrico UT-BACKOFEN38 38Lts;ELECTRODOMESTICOS
15018481;;F;40;CHILENO;;X;ANTOFAGASTA                   ;ANTOFAGASTA;0;0;0;0;0;0;0;0;0;Hervidor Electrico TH-4515N 2Lts Negro;ELECTRODOMESTICOS
6172799;;F;71;CHILENO;;Silencioso;PUDAHUEL                      ;METROPOLITANA;0;0;0;0;0;0;0;0;0;Procesador TH-9010 Multimixer 1,5Lts Vaso Vidrio;ELECTRODOMESTICOS
9220623;Casado;F;63;CHILENO;;Boomers;RENCA                         ;METROPOLITANA;0;0;0;0;0;0;0;0;0;Licuadora Personal TH-300PB;ELECTRODOMESTICOS
6281509;;F;71;CHILENO;;Silencioso;RENCA                         ;METROPOLITANA;0;0;0;0;0;0;0;0;0;Hervidor Electrico UT-MANLY17 1,7Lts Negro;ELECTRODOMESTICOS
10360977;;F;56;CHILENO;;Boomers;RENCA                         ;METROPOLITANA;0;0;0;0;0;0;0;0;0;Batidora Manual 2532;ELECTRODOMESTICOS
8819845;;M;62;CHILENO;;Boomers;COIHAIQUE                     ;AYSEN;0;0;0;0;0;0;0;0;0;Batidora Manual UT-TEKLA300;ELECTRODOMESTICOS
19786729;;F;24;CHILENO;;Z;SAN FELIPE                    ;VALPARAISO;0;0;0;0;0;0;0;0;0;Plancha Paninis 2880;ELECTRODOMESTICOS
5020387;;M;76;CHILENO;;Silencioso;PROVIDENCIA                   ;METROPOLITANA;0;0;0;0;0;0;0;0;0;Tostador de PanTH-120R 2 Rebanadas Rojo;ELECTRODOMESTICOS
7023541;;F;73;CHILENO;;Silencioso;LA SERENA                     ;COQUIMBO;0;0;0;0;0;0;0;0;0;Horno Electrico TH62I 60Lts;ELECTRODOMESTICOS
5643905;;F;76;CHILENO;;Silencioso;RENCA                         ;METROPOLITANA;0;0;0;0;0;0;0;0;0;Hervidor Electrico TH-4350 3Lts Blanco;ELECTRODOMESTICOS
17335767;Casado;F;32;CHILENO;;Millenial;PROVIDENCIA                   ;METROPOLITANA;0;0;0;0;0;0;0;0;0;Combo Licuadora + Batidora;ELECTRODOMESTICOS
18139887;Soltero;M;30;CHILENO;TECNICO ADMINISTRADOR DE EMP;Millenial;PROVIDENCIA                   ;METROPOLITANA;0;0;0;0;0;0;0;0;0;Maquina de Coser BM-3850CL Lila;ELECTRODOMESTICOS
11587369;;F;52;CHILENO;;X;PROVIDENCIA                   ;METROPOLITANA;0;0;0;0;0;0;0;0;0;Batidora Vertical Stick Mixer 2609;ELECTRODOMESTICOS
5270079;;M;80;CHILENO;;Silencioso;RENCA                         ;METROPOLITANA;0;0;0;0;0;0;0;0;0;Plancha OSTER 4801T 1200Watts Base Ceramica;ELECTRODOMESTICOS
7630757;;M;66;CHILENO;;Boomers;QUILPUE                       ;VALPARAISO;0;0;0;0;0;0;0;0;0;Horno Electrico TH-16N 16Lts;ELECTRODOMESTICOS
6890093;;F;64;CHILENO;;Boomers;PROVIDENCIA                   ;METROPOLITANA;0;0;0;0;0;0;0;0;0;Batidora Manual 2532;ELECTRODOMESTICOS
7856841;;F;63;CHILENO;;Boomers;RENCA                         ;METROPOLITANA;0;0;0;0;0;0;0;0;0;Picadora UT-PETRUS320 1Lts Vaso Vidrio;ELECTRODOMESTICOS
13962145;;F;41;CHILENO;;X;RENCA                         ;METROPOLITANA;0;0;0;0;0;0;0;0;0;Batidora Vertical Minipimer UT-KLOT400P;ELECTRODOMESTICOS
6834048;;F;74;CHILENO;;Silencioso;MELIPILLA                     ;METROPOLITANA;0;0;0;0;0;0;0;0;0;ASPIRADORA THOMAS TH-1640;ELECTRODOMESTICOS
5842463;;F;72;CHILENO;;Silencioso;COIHUECO                      ;BIO BIO;0;0;0;0;0;0;0;0;0;Horno Electrico TH-48N 48Lts;ELECTRODOMESTICOS
15157128;;F;40;CHILENO;;X;RENCA                         ;METROPOLITANA;0;0;0;0;0;0;0;0;0;Hervidor Electrico Tetera TH-6505RT 1,7Lts Rojo;ELECTRODOMESTICOS
16995333;Soltero;M;33;CHILENO;;Millenial;PROVIDENCIA                   ;METROPOLITANA;0;0;0;0;0;0;0;0;0;Aspiradora AP1700 Arrastre 1700Watts;ELECTRODOMESTICOS
19895054;;M;24;CHILENO;;Z;N/D;N/D;0;0;0;0;0;0;0;0;0;Tostador de Pan TH-126 4 Rebanadas Negro;ELECTRODOMESTICOS
18722120;;F;28;CHILENO;;Millenial;SAN FERNANDO                  ;L.G.B.OÂ´HIGGINS;0;0;0;0;0;0;0;0;0;Aspiradora TH1407 Arrastre 1400Watts;ELECTRODOMESTICOS
24682006;;F;57;BOLIVIANO;;Extranjero;COLINA                        ;METROPOLITANA;0;0;0;0;0;0;0;0;0;Horno Electrico UT-BACKOFEN26 26Lts;ELECTRODOMESTICOS
7675240;;F;57;CHILENO;;Boomers;PROVIDENCIA                   ;METROPOLITANA;0;0;0;0;0;0;0;0;0;Horno Microondas Mecanico C1700N 17Lts Blanco;ELECTRODOMESTICOS
18041016;;M;30;CHILENO;;Millenial;PROVIDENCIA                   ;METROPOLITANA;0;0;0;0;0;0;0;0;0;Aspiradora TH1415 Arrastre 1500Watts;ELECTRODOMESTICOS
9453182;;M;59;CHILENO;;Z;CORONEL                       ;BIO BIO;0;0;0;0;0;0;0;0;0;Horno Electrico TH62I 60Lts;ELECTRODOMESTICOS
13562131;;F;43;CHILENO;;X;PROVIDENCIA                   ;METROPOLITANA;0;0;0;0;0;0;0;0;0;Horno Electrico TH62I 60Lts;ELECTRODOMESTICOS
13902612;;M;41;CHILENO;;X;"";"";0;0;0;0;0;0;0;0;0;Horno Electrico UT-LEIF36 36Lts;ELECTRODOMESTICOS
9951486;Casado;F;58;CHILENO;;Boomers;PROVIDENCIA                   ;METROPOLITANA;0;0;0;0;0;0;0;0;0;HERVIDOR TH-4340;ELECTRODOMESTICOS
5140694;;M;77;CHILENO;;Silencioso;RENCA                         ;METROPOLITANA;0;0;0;0;0;0;0;0;0;Horno Electrico TH62I 60Lts;ELECTRODOMESTICOS
6329214;;F;75;CHILENO;;Silencioso;TOCOPILLA                     ;ANTOFAGASTA;0;0;0;0;0;0;0;0;0;Hervidor Electrico TH-4515N 2Lts Negro;ELECTRODOMESTICOS
15463177;Casado;M;39;CHILENO;;X;RENCA                         ;METROPOLITANA;0;0;0;0;0;0;0;0;0;Parrilla Electrica TH-224;ELECTRODOMESTICOS
10784301;;F;54;CHILENO;;X;VILLARICA                     ;ARAUCANIA;0;0;0;0;0;0;0;0;0;Horno Electrico TH-38N 38Lts;ELECTRODOMESTICOS
10551347;;F;49;CHILENO;;X;LOS LAGOS                     ;LOS LAGOS;0;0;0;0;0;0;0;0;0;Batidora Manual 2532;ELECTRODOMESTICOS
7503343;;F;70;CHILENO;;Silencioso;PROVIDENCIA                   ;METROPOLITANA;0;0;0;0;0;0;0;0;0;Enceradora EA-5000;ELECTRODOMESTICOS
16086211;;M;36;CHILENO;;Millenial;PROVIDENCIA                   ;METROPOLITANA;0;0;0;0;0;0;0;0;0;Licuadora L-1630V Negra 1,5Lts Vaso Vidrio;ELECTRODOMESTICOS
16832615;;F;34;CHILENO;;Millenial;COPIAPO                       ;ATACAMA;0;0;0;0;0;0;0;0;0;Licuadora Personal TH-300PB;ELECTRODOMESTICOS
16765191;Soltero;F;34;CHILENO;PROFESOR;Millenial;PROVIDENCIA                   ;METROPOLITANA;0;0;0;0;0;0;0;0;0;Licuadora Personal TH-300PB;ELECTRODOMESTICOS
13570298;Casado;M;43;CHILENO;;X;RENCA                         ;METROPOLITANA;0;0;0;0;0;0;0;0;0;Hervidor Electrico TH-5407i 2Lts;ELECTRODOMESTICOS
16519732;;F;35;CHILENO;;Millenial;"";"";0;0;0;0;0;0;0;0;0;Plancha UT-KERAMIK1 2200Watts Base Ceramica;ELECTRODOMESTICOS
7197564;;F;70;CHILENO;;Silencioso;PROVIDENCIA                   ;METROPOLITANA;0;0;0;0;0;0;0;0;0;Batidora Manual 2532;ELECTRODOMESTICOS
15553288;;F;35;CHILENO;;Millenial;LONCOCHE                      ;ARAUCANIA;0;0;0;0;0;0;0;0;0;Hervidor Electrico UT-MANLY17 1,7Lts Negro;ELECTRODOMESTICOS
8515323;Casado;F;55;CHILENO;ABOGADO;Boomers;RENCA                         ;METROPOLITANA;0;0;0;0;0;0;0;0;0;Hervidor Electrico TH-4515N 2Lts Negro;ELECTRODOMESTICOS
14033214;;F;41;CHILENO;;X;N/D;N/D;0;0;0;0;0;0;0;0;0;Tostador de PanTH-120R 2 Rebanadas Rojo;ELECTRODOMESTICOS
9413479;Casado;M;60;CHILENO;;Boomers;SAN VICENTE                   ;L.G.B.OÂ´HIGGINS;0;0;0;0;0;0;0;0;0;Horno Electrico TH-48N 48Lts;ELECTRODOMESTICOS
26023599;;F;35;VENEZOLANO;;Extranjero;SANTIAGO                      ;METROPOLITANA;0;0;0;0;0;0;0;0;0;FREIDORA DE AIRE CKSTAF15B 1850W;ELECTRODOMESTICOS
12526393;;F;49;CHILENO;;X;PROVIDENCIA                   ;METROPOLITANA;0;0;0;0;0;0;0;0;0;MOPA A VAPOR SINDELEN MV-1305 GR;ELECTRODOMESTICOS
12950688;;F;48;CHILENO;;X;LOS ANDES                     ;VALPARAISO;0;0;0;0;0;0;0;0;0;Horno Microondas Digital MS23K3513AK/ZS 23Lts;ELECTRODOMESTICOS
11729302;;F;51;CHILENO;;X;SAN FELIPE                    ;VALPARAISO;0;0;0;0;0;0;0;0;0;Hervidor Electrico TH-5407i 2Lts;ELECTRODOMESTICOS
19239846;;F;26;CHILENO;;Z;PROVIDENCIA                   ;METROPOLITANA;0;0;0;0;0;0;0;0;0;Olla Arrocera TH38IF 1,8Lts;ELECTRODOMESTICOS
10087938;;F;53;CHILENO;;X;PROVIDENCIA                   ;METROPOLITANA;0;0;0;0;0;0;0;0;0;Plancha OSTER 4801T 1200Watts Base Ceramica;ELECTRODOMESTICOS
13037054;;M;46;CHILENO;;X;PROVIDENCIA                   ;METROPOLITANA;0;0;0;0;0;0;0;0;0;Combo Hervidor + Batidora;ELECTRODOMESTICOS
8437445;;M;49;CHILENO;;X;NUNOA;METROPOLITANA;0;0;0;0;0;0;0;0;0;Horno Microondas Mecanico Easy Wave 20Lts;ELECTRODOMESTICOS
11991003;;M;50;CHILENO;;X;PROVIDENCIA                   ;METROPOLITANA;0;0;0;0;0;0;0;0;0;Hervidor Electrico TH-5407i 2Lts;ELECTRODOMESTICOS
8425747;Casado;M;58;CHILENO;;Boomers;PROVIDENCIA                   ;METROPOLITANA;0;0;0;0;0;0;0;0;0;Aspiradora AP1700 Arrastre 1700Watts;ELECTRODOMESTICOS
10616630;;F;51;CHILENO;;X;PROVIDENCIA                   ;METROPOLITANA;0;0;0;0;0;0;0;0;0;Licuadora UT-METALLEK605P 1,55Lts;ELECTRODOMESTICOS
7962353;;F;67;CHILENO;;Boomers;PROVIDENCIA                   ;METROPOLITANA;0;0;0;0;0;0;0;0;0;Tostador de Pan TH-126 4 Rebanadas Negro;ELECTRODOMESTICOS
11854312;;F;51;CHILENO;;X;N/D;N/D;0;0;0;0;0;0;0;0;0;Aspiradora UT-SILENT1804 Arrastre 1800Watts;ELECTRODOMESTICOS
7368792;Casado;F;69;CHILENO;;Silencioso;PROVIDENCIA                   ;METROPOLITANA;0;0;0;0;0;0;0;0;0;Picadora UT-PETRUS320 1Lts Vaso Vidrio;ELECTRODOMESTICOS
19119665;;M;27;CHILENO;;Z;CONCEPCION                    ;BIO BIO;0;0;0;0;0;0;0;0;0;Combo Hervidor + Batidora;ELECTRODOMESTICOS
11878499;;F;50;CHILENO;;X;PROVIDENCIA                   ;METROPOLITANA;0;0;0;0;0;0;0;0;0;Licuadora TH-401V Roja 1,75Lts Vaso Vidrio;ELECTRODOMESTICOS
5629719;;F;74;CHILENO;;Silencioso;PEUMO                         ;L.G.B.OÂ´HIGGINS;0;0;0;0;0;0;0;0;0;Batidora Manual BA-5010 Inox;ELECTRODOMESTICOS
18904868;;F;27;CHILENO;;Millenial;PROVIDENCIA                   ;METROPOLITANA;0;0;0;0;0;0;0;0;0;Aspiradora VCC4190V3E/XZS Arrastre 2000Watts;ELECTRODOMESTICOS
10705676;;F;52;CHILENO;;X;BUIN                          ;METROPOLITANA;0;0;0;0;0;0;0;0;0;Aspiradora TH1870 Arrastre 1800Watts Gris;ELECTRODOMESTICOS
12829981;;F;47;CHILENO;;X;RENCA                         ;METROPOLITANA;0;0;0;0;0;0;0;0;0;Horno Microondas Mecanico Easy Wave 20Lts;ELECTRODOMESTICOS
15948309;;F;48;CHILENO;;X;MAIPU                         ;METROPOLITANA;0;0;0;0;0;0;0;0;0;Procesador TH-9010 Multimixer 1,5Lts Vaso Vidrio;ELECTRODOMESTICOS
6265592;;F;66;CHILENO;;Boomers;RENCA                         ;METROPOLITANA;0;0;0;0;0;0;0;0;0;HORNO 10 LITROS OSTER ROJO;ELECTRODOMESTICOS
14533937;;F;45;CHILENO;;X;RENCA                         ;METROPOLITANA;0;0;0;0;0;0;0;0;0;Hervidor Electrico TH-5407i 2Lts;ELECTRODOMESTICOS
9874784;;M;56;CHILENO;;Boomers;TILTIL                        ;METROPOLITANA;0;0;0;0;0;0;0;0;0;Plancha TH-7052 2000Watts Base Inox;ELECTRODOMESTICOS
16537165;;M;35;CHILENO;;Millenial;LINARES                       ;MAULE;0;0;0;0;0;0;0;0;0;Tostador de PanTH-120R 2 Rebanadas Rojo;ELECTRODOMESTICOS
7531553;;M;66;CHILENO;;Boomers;FLORIDA                       ;BIO BIO;0;0;0;0;0;0;0;0;0;Horno Microondas Mecanico C1700N 17Lts Blanco;ELECTRODOMESTICOS
25872139;;M;36;HAITIANO;;Extranjero;QUINTA NORMAL                 ;METROPOLITANA;0;0;0;0;0;0;0;0;0;Horno Microondas Digital TH-20S01 20Lts;ELECTRODOMESTICOS
7262383;;F;64;CHILENO;;Boomers;MAIPU                         ;METROPOLITANA;0;0;0;0;0;0;0;0;0;Maquina de Coser 311;ELECTRODOMESTICOS
10129997;;F;62;CHILENO;;Boomers;RENCA                         ;METROPOLITANA;0;0;0;0;0;0;0;0;0;Horno Electrico TH62I 60Lts;ELECTRODOMESTICOS
12802534;;M;47;CHILENO;;X;PROVIDENCIA                   ;METROPOLITANA;0;0;0;0;0;0;0;0;0;Plancha UT-PLATTEISEN 2000Watts Base Ceramica;ELECTRODOMESTICOS
18554359;;M;28;CHILENO;;Millenial;LA PINTANA                    ;METROPOLITANA;0;0;0;0;0;0;0;0;0;Aspiradora TH1415 Arrastre 1500Watts;ELECTRODOMESTICOS
10553524;Casado;M;56;CHILENO;;Boomers;PROVIDENCIA                   ;METROPOLITANA;0;0;0;0;0;0;0;0;0;Batidora Vertical Minipimer UT-KLOT400P;ELECTRODOMESTICOS
13291162;;F;48;CHILENO;;X;PROVIDENCIA                   ;METROPOLITANA;0;0;0;0;0;0;0;0;0;Batidora Pedestal B5300 Inox;ELECTRODOMESTICOS
16929291;Soltero;F;29;CHILENO;;Millenial;PROVIDENCIA                   ;METROPOLITANA;0;0;0;0;0;0;0;0;0;Licuadora TH-320 Roja/Negro 1,5 Lts Vaso Vidrio;ELECTRODOMESTICOS
8901760;Casado;F;61;CHILENO;EDUCADOR DE PARVULO;Boomers;PROVIDENCIA                   ;METROPOLITANA;0;0;0;0;0;0;0;0;0;Horno Microondas Digital TH-20S01 20Lts;ELECTRODOMESTICOS
9021566;Divorciado;F;63;CHILENO;;Boomers;RENCA                         ;METROPOLITANA;0;0;0;0;0;0;0;0;0;Horno Electrico TH-25N01 25Lts;ELECTRODOMESTICOS
15044042;Soltero;F;42;CHILENO;;X;PROVIDENCIA                   ;METROPOLITANA;0;0;0;0;0;0;0;0;0;Licuadora TH-320 Roja/Negro 1,5 Lts Vaso Vidrio;ELECTRODOMESTICOS
11611761;Soltero;M;51;CHILENO;;X;PROVIDENCIA                   ;METROPOLITANA;0;0;0;0;0;0;0;0;0;Licuadora TH-320 Roja/Negro 1,5 Lts Vaso Vidrio;ELECTRODOMESTICOS
9667584;;F;43;CHILENO;;X;PROVIDENCIA                   ;METROPOLITANA;0;0;0;0;0;0;0;0;0;Plancha Vertical TH-7300 1200Watts;ELECTRODOMESTICOS
18105783;;F;31;CHILENO;;Millenial;CURICO                        ;MAULE;0;0;0;0;0;0;0;0;0;Combo Juguera + Hervidor;ELECTRODOMESTICOS
10965704;;F;50;CHILENO;;X;PROVIDENCIA                   ;METROPOLITANA;0;0;0;0;0;0;0;0;0;HORNO 10 LITROS OSTER ROJO;ELECTRODOMESTICOS
9049635;;F;63;CHILENO;;Boomers;SAN JAVIER                    ;MAULE;0;0;0;0;0;0;0;0;0;Aspiradora UT-SILENT1804 Arrastre 1800Watts;ELECTRODOMESTICOS
18553822;;F;28;CHILENO;;Millenial;PROVIDENCIA                   ;METROPOLITANA;0;0;0;0;0;0;0;0;0;Exprimidor de Jugo CJ-2000 1Lts;ELECTRODOMESTICOS
17683430;;F;31;CHILENO;;Millenial;PROVIDENCIA                   ;METROPOLITANA;0;0;0;0;0;0;0;0;0;Horno Electrico TH-25N01 25Lts;ELECTRODOMESTICOS
9019649;;F;56;CHILENO;;Boomers;COIHAIQUE                     ;AYSEN;0;0;0;0;0;0;0;0;0;Cafetera UT-KAFFEEKLASSIK;ELECTRODOMESTICOS
5312064;;F;80;NORUEGO;;Extranjero;EL QUISCO                     ;VALPARAISO;0;0;0;0;0;0;0;0;0;Aspiradora UT-MEINER1803 Arrastre 1800Watts;ELECTRODOMESTICOS
5742423;;F;79;CHILENO;;Silencioso;PUENTE ALTO                   ;METROPOLITANA;0;0;0;0;0;0;0;0;0;Horno Electrico UT-LEIF36 36Lts;ELECTRODOMESTICOS
9864138;;M;59;CHILENO;;Boomers;RENCA                         ;METROPOLITANA;0;0;0;0;0;0;0;0;0;Licuadora TH-320 Roja/Negro 1,5 Lts Vaso Vidrio;ELECTRODOMESTICOS
5623072;;M;74;CHILENO;;Millenial;PROVIDENCIA                   ;METROPOLITANA;0;0;0;0;0;0;0;0;0;Hervidor Electrico UT-MANLY17 1,7Lts Negro;ELECTRODOMESTICOS
12081758;;F;58;CHILENO;;Boomers;CONSTITUCION                  ;MAULE;0;0;0;0;0;0;0;0;0;Cafetera TH-130;ELECTRODOMESTICOS
9747241;Casado;M;59;CHILENO;;Boomers;RENCA                         ;METROPOLITANA;0;0;0;0;0;0;0;0;0;Picadora UT-PETRUS320 1Lts Vaso Vidrio;ELECTRODOMESTICOS
20166377;;M;22;CHILENO;;Z;PROVIDENCIA                   ;METROPOLITANA;0;0;0;0;0;0;0;0;0;Horno Microondas Mecanico TH-18B05 18Lts;ELECTRODOMESTICOS
17968118;Soltero;F;30;CHILENO;;Millenial;PROVIDENCIA                   ;METROPOLITANA;0;0;0;0;0;0;0;0;0;Licuadora L-1630V Negra 1,5Lts Vaso Vidrio;ELECTRODOMESTICOS
7111341;;F;70;CHILENO;;Silencioso;LOS ANDES                     ;VALPARAISO;0;0;0;0;0;0;0;0;0;Combo Hervidor + Batidora;ELECTRODOMESTICOS
20128667;;F;23;CHILENO;;Z;PROVIDENCIA                   ;METROPOLITANA;0;0;0;0;0;0;0;0;0;Horno Microondas Digital TH-20S01 20Lts;ELECTRODOMESTICOS
10166298;;M;57;CHILENO;;Boomers;CAUQUENES                     ;MAULE;0;0;0;0;0;0;0;0;0;Aspiradora AP1700 Arrastre 1700Watts;ELECTRODOMESTICOS
15998884;;F;37;CHILENO;;Millenial;CANETE;BIO-BIO;0;0;0;0;0;0;0;0;0;Aspiradora Handy Clean Black 1400;ELECTRODOMESTICOS
6625720;;F;70;CHILENO;;Silencioso;RENCA                         ;METROPOLITANA;0;0;0;0;0;0;0;0;0;Horno Electrico TH-48N 48Lts;ELECTRODOMESTICOS
5743645;;F;75;CHILENO;;Silencioso;RENCA                         ;METROPOLITANA;0;0;0;0;0;0;0;0;0;PROCESADOR THOMAS TH-9160;ELECTRODOMESTICOS
6991594;;M;70;CHILENO;;Silencioso;SAN FELIPE                    ;VALPARAISO;0;0;0;0;0;0;0;0;0;Hervidor Electrico TH-4515N 2Lts Negro;ELECTRODOMESTICOS
9729971;Soltero;F;57;CHILENO;;Boomers;RENCA                         ;METROPOLITANA;0;0;0;0;0;0;0;0;0;Hervidor Electrico TH-4515N 2Lts Negro;ELECTRODOMESTICOS
7488486;;M;67;CHILENO;;Boomers;SANTIAGO                      ;METROPOLITANA;0;0;0;0;0;0;0;0;0;Licuadora L1000 Inox 1,7LtsVaso Vidrio;ELECTRODOMESTICOS
14116336;;M;41;CHILENO;;Extranjero;VICUNA                        ;COQUIMBO;0;0;0;0;0;0;0;0;0;Batidora Manual 2532;ELECTRODOMESTICOS
6218906;Casado;F;67;CHILENO;;Boomers;PROVIDENCIA                   ;METROPOLITANA;0;0;0;0;0;0;0;0;0;PANINI/WAFLERA TH-965;ELECTRODOMESTICOS
16601896;Soltero;F;35;CHILENO;;Millenial;PROVIDENCIA                   ;METROPOLITANA;0;0;0;0;0;0;0;0;0;Horno Electrico UT-BACKOFEN60 60Lts;ELECTRODOMESTICOS
18875642;;F;27;CHILENO;;Z;IQUIQUE                       ;TARAPACA;0;0;0;0;0;0;0;0;0;Hervidor Electrico UT-MANLY17 1,7Lts Negro;ELECTRODOMESTICOS
9457778;Viudo;F;59;CHILENO;;Boomers;PLACILLA                      ;L.G.B.OÂ´HIGGINS;0;0;0;0;0;0;0;0;0;Aspiradora TH2220 Arrastre 2200Watts;ELECTRODOMESTICOS
18106342;;M;31;CHILENO;;Millenial;PROVIDENCIA                   ;METROPOLITANA;0;0;0;0;0;0;0;0;0;Hervidor Electrico 3100 1,7Lts Negro;ELECTRODOMESTICOS
18239721;;F;31;CHILENO;;Millenial;PROVIDENCIA                   ;METROPOLITANA;0;0;0;0;0;0;0;0;0;Batidora Vertical BM-450 Negra;ELECTRODOMESTICOS
9772887;;F;59;CHILENO;;Boomers;PROVIDENCIA                   ;METROPOLITANA;0;0;0;0;0;0;0;0;0;Horno Microondas Mecanico M-2030 NG 20Lts;ELECTRODOMESTICOS
14901911;Soltero;F;40;CHILENO;;X;PROVIDENCIA                   ;METROPOLITANA;0;0;0;0;0;0;0;0;0;Batidora Manual 2532;ELECTRODOMESTICOS
26339804;;M;33;HAITIANO;;Extranjero;LONGAVI                       ;MAULE;0;0;0;0;0;0;0;0;0;Licuadora TH-320 Roja/Negro 1,5 Lts Vaso Vidrio;ELECTRODOMESTICOS
15515583;;F;39;CHILENO;;X;LINARES                       ;MAULE;0;0;0;0;0;0;0;0;0;Tostador de Pan TH-126 4 Rebanadas Negro;ELECTRODOMESTICOS
11908144;Casado;F;53;CHILENO;;X;PROVIDENCIA                   ;METROPOLITANA;0;0;0;0;0;0;0;0;0;Licuadora UT-METALLEK505P 1,5Lts Vaso Vidrio;ELECTRODOMESTICOS
19224602;;F;26;CHILENO;;Z;N/D;N/D;0;0;0;0;0;0;0;0;0;Horno Electrico UT-BACKOFEN26 26Lts;ELECTRODOMESTICOS
5904065;;F;72;CHILENO;;Silencioso;CALERA                        ;VALPARAISO;0;0;0;0;0;0;0;0;0;Horno Electrico TH-38N 38Lts;ELECTRODOMESTICOS
7597627;;F;70;CHILENO;;Silencioso;ILLAPEL                       ;COQUIMBO;0;0;0;0;0;0;0;0;0;Licuadora TH-320 Roja/Negro 1,5 Lts Vaso Vidrio;ELECTRODOMESTICOS
16600688;;F;34;CHILENO;;Millenial;TALCAHUANO                    ;BIO BIO;0;0;0;0;0;0;0;0;0;Horno Electrico TH-38N 38Lts;ELECTRODOMESTICOS
19641587;;M;24;CHILENO;;Millenial;"";"";0;0;0;0;0;0;0;0;0;Aspiradora Polvo AP-700 GR;ELECTRODOMESTICOS
6336404;Casado;F;71;CHILENO;;Silencioso;RENCA                         ;METROPOLITANA;0;0;0;0;0;0;0;0;0;Hervidor Electrico UT-KLAR20PW 2Lts Blanco;ELECTRODOMESTICOS
9824272;;M;59;CHILENO;;Boomers;RENCA                         ;METROPOLITANA;0;0;0;0;0;0;0;0;0;Horno Microondas Digital TH-20S01 20Lts;ELECTRODOMESTICOS
7716533;;F;67;CHILENO;;Boomers;TALCA                         ;MAULE;0;0;0;0;0;0;0;0;0;Plancha TH-7052 2000Watts Base Inox;ELECTRODOMESTICOS
13375088;Casado;M;51;CHILENO;;X;RENCA                         ;METROPOLITANA;0;0;0;0;0;0;0;0;0;Hervidor Electrico TH-5407i 2Lts;ELECTRODOMESTICOS
18028818;;M;29;CHILENO;;Millenial;SAN JAVIER                    ;MAULE;0;0;0;0;0;0;0;0;0;Horno Microondas Digital TH-20S01 20Lts;ELECTRODOMESTICOS
7144795;;M;65;CHILENO;;Boomers;PARRAL                        ;MAULE;0;0;0;0;0;0;0;0;0;Aspiradora UT-SILENT1804 Arrastre 1800Watts;ELECTRODOMESTICOS
16167082;;F;36;CHILENO;;Millenial;MULCHEN                       ;BIO BIO;0;0;0;0;0;0;0;0;0;Aspiradora UT-KRAFT(DIG) Arrastre 2200Watts;ELECTRODOMESTICOS
6647460;;F;69;CHILENO;;Silencioso;PUCON                         ;ARAUCANIA;0;0;0;0;0;0;0;0;0;Licuadora TH-501V 1,5Lts Vaso Vidrio;ELECTRODOMESTICOS
7403638;;F;65;CHILENO;;Boomers;SALAMANCA                     ;COQUIMBO;0;0;0;0;0;0;0;0;0;Hervidor Electrico Tetera UT-LECKER18R 1,8Lts;ELECTRODOMESTICOS
12399149;;F;48;CHILENO;;X;RENCA                         ;METROPOLITANA;0;0;0;0;0;0;0;0;0;Horno Electrico TH62I 60Lts;ELECTRODOMESTICOS
16782520;Soltero;F;35;CHILENO;;Millenial;PROVIDENCIA                   ;METROPOLITANA;0;0;0;0;0;0;0;0;0;Horno Microondas Digital TH-20S01 20Lts;ELECTRODOMESTICOS
8231650;;F;63;CHILENO;;Boomers;RENCA                         ;METROPOLITANA;0;0;0;0;0;0;0;0;0;Horno Electrico TH-38N 38Lts;ELECTRODOMESTICOS
14479843;;M;42;CHILENO;;X;PROVIDENCIA                   ;METROPOLITANA;0;0;0;0;0;0;0;0;0;Hervidor Electrico HA-3300 2,5Lts Blanco;ELECTRODOMESTICOS
13201395;Casado;M;45;CHILENO;;X;PROVIDENCIA                   ;METROPOLITANA;0;0;0;0;0;0;0;0;0;Horno Microondas Mecanico TH-18B05 18Lts;ELECTRODOMESTICOS
10060770;;M;58;CHILENO;;Boomers;ARAUCO                        ;BIO BIO;0;0;0;0;0;0;0;0;0;Licuadora TH-501V 1,5Lts Vaso Vidrio;ELECTRODOMESTICOS
16696862;;M;34;CHILENO;;Millenial;N/D;N/D;0;0;0;0;0;0;0;0;0;Hervidor Electrico UT-MANLY17 1,7Lts Negro;ELECTRODOMESTICOS
5494399;;F;72;CHILENO;;Silencioso;PROVIDENCIA                   ;METROPOLITANA;0;0;0;0;0;0;0;0;0;Hervidor Electrico TH-6200 R 1,7Lts Rojo;ELECTRODOMESTICOS
11279401;;F;54;CHILENO;;X;SAN FERNANDO                  ;L.G.B.OÂ´HIGGINS;0;0;0;0;0;0;0;0;0;Hervidor Electrico UT-DUNKEL17P 2Lts Negro;ELECTRODOMESTICOS
8791643;;M;63;CHILENO;;Boomers;LA LIGUA                      ;VALPARAISO;0;0;0;0;0;0;0;0;0;Hervidor Electrico TH-4800 2Lts Negro Azul;ELECTRODOMESTICOS
20158606;;F;23;CHILENO;;Z;PROVIDENCIA                   ;METROPOLITANA;0;0;0;0;0;0;0;0;0;Extractor de Jugo TH-2551 2Lts;ELECTRODOMESTICOS
12459891;;M;49;CHILENO;;X;RENCA                         ;METROPOLITANA;0;0;0;0;0;0;0;0;0;Licuadora TH-320 Roja/Negro 1,5 Lts Vaso Vidrio;ELECTRODOMESTICOS
18348121;;F;29;CHILENO;;Millenial;CASTRO                        ;LOS LAGOS;0;0;0;0;0;0;0;0;0;Hervidor Termo HA-3600 1,5Lts Inox;ELECTRODOMESTICOS
10589540;;F;55;CHILENO;;Boomers;PROVIDENCIA                   ;METROPOLITANA;0;0;0;0;0;0;0;0;0;Maquina de Coser ST-371HD Heavy Duty;ELECTRODOMESTICOS
26332319;;M;28;VENEZOLANO;;Extranjero;"";"";0;0;0;0;0;0;0;0;0;tosty arepa;ELECTRODOMESTICOS
17826195;;F;31;CHILENO;;Millenial;PUCON                         ;ARAUCANIA;0;0;0;0;0;0;0;0;0;Picadora UT-PETRUS320 1Lts Vaso Vidrio;ELECTRODOMESTICOS
10476178;;F;56;CHILENO;;Boomers;VILLARICA                     ;ARAUCANIA;0;0;0;0;0;0;0;0;0;Horno Microondas Mecanico Easy Wave 20Lts;ELECTRODOMESTICOS
15971824;;M;37;CHILENO;;Millenial;N/D;N/D;0;0;0;0;0;0;0;0;0;Licuadora Sport Blender BSE10;ELECTRODOMESTICOS
25174620;;M;33;HAITIANO;;Extranjero;TILTIL                        ;METROPOLITANA;0;0;0;0;0;0;0;0;0;Hervidor Electrico TH-4800 2Lts Negro Azul;ELECTRODOMESTICOS
14561229;;M;43;CHILENO;;X;TEMUCO                        ;ARAUCANIA;0;0;0;0;0;0;0;0;0;Licuadora TH-320 Roja/Negro 1,5 Lts Vaso Vidrio;ELECTRODOMESTICOS
8109875;;F;61;CHILENO;;Boomers;ILLAPEL                       ;COQUIMBO;0;0;0;0;0;0;0;0;0;Licuadora 4661W-052 Blanca 1,5Lts Vaso Vidrio;ELECTRODOMESTICOS
24497798;;F;48;ECUATORIANO;;Extranjero;N/D;N/D;0;0;0;0;0;0;0;0;0;Hervidor Electrico UT-MILAN18;ELECTRODOMESTICOS
15529275;;F;38;CHILENO;;X;PROVIDENCIA                   ;METROPOLITANA;0;0;0;0;0;0;0;0;0;Aspiradora VCC4190V3E/XZS Arrastre 2000Watts;ELECTRODOMESTICOS
17845566;;F;30;CHILENO;;Millenial;VILLA ALEMANA                 ;VALPARAISO;0;0;0;0;0;0;0;0;0;Aspiradora Polvo AP-700 GR;ELECTRODOMESTICOS
16991676;Soltero;M;33;CHILENO;;Millenial;PROVIDENCIA                   ;METROPOLITANA;0;0;0;0;0;0;0;0;0;Hervidor Electrico TH-4800 2Lts Negro Azul;ELECTRODOMESTICOS
26161028;;F;36;VENEZOLANO;;Extranjero;PROVIDENCIA                   ;METROPOLITANA;0;0;0;0;0;0;0;0;0;Licuadora 58159-CL 1,4Lts Vaso Tritan;ELECTRODOMESTICOS
16257933;;M;21;CHILENO;;Z;PROVIDENCIA                   ;METROPOLITANA;0;0;0;0;0;0;0;0;0;Hervidor Electrico TH-4800 2Lts Negro Azul;ELECTRODOMESTICOS
6502310;Casado;F;73;CHILENO;;Silencioso;RENCA                         ;METROPOLITANA;0;0;0;0;0;0;0;0;0;Plancha TH-7052 2000Watts Base Inox;ELECTRODOMESTICOS
19403835;Soltero;F;26;CHILENO;;Z;PROVIDENCIA                   ;METROPOLITANA;0;0;0;0;0;0;0;0;0;Hervidor Electrico Tetera TH-6505RT 1,7Lts Rojo;ELECTRODOMESTICOS
26534738;;M;32;VENEZOLANO;;Extranjero;SAN FERNANDO                  ;L.G.B.OÂ´HIGGINS;0;0;0;0;0;0;0;0;0;Batidora Vertical Stick Mixer 2609;ELECTRODOMESTICOS
19860988;;F;23;CHILENO;;Z;PROVIDENCIA                   ;METROPOLITANA;0;0;0;0;0;0;0;0;0;Licuadora TH-320 Roja/Negro 1,5 Lts Vaso Vidrio;ELECTRODOMESTICOS
18778469;;F;28;CHILENO;;Millenial;CALBUCO                       ;LOS LAGOS;0;0;0;0;0;0;0;0;0;Hervidor Electrico TH-5405i 1,8Lts Inox;ELECTRODOMESTICOS
8101811;Casado;M;63;CHILENO;;Boomers;PROVIDENCIA                   ;METROPOLITANA;0;0;0;0;0;0;0;0;0;Horno Electrico TH62I 60Lts;ELECTRODOMESTICOS
19422189;Soltero;F;25;CHILENO;;Z;PROVIDENCIA                   ;METROPOLITANA;0;0;0;0;0;0;0;0;0;Hervidor Electrico UT-MANLY17 1,7Lts Negro;ELECTRODOMESTICOS
13627513;;F;42;CHILENO;;X;LA PINTANA                    ;METROPOLITANA;847400;5;5;0;0;0;5;5;847400;MINICOMPONENTE RN5;ELECTRONICA MAYOR
14507053;;M;48;CHILENO;;X;NATALES                       ;MAGALLANES;392160;2;1;0;0;0;2;1;392160;LED 58 KEUH5821 SMART TV UHD;ELECTRONICA MAYOR
17332537;Casado;M;32;CHILENO;;Millenial;CHANARAL                      ;ATACAMA;675060;6;4;0;0;0;6;4;675060;LED 43 UN43T5202AGXZS FHD SMART TV;ELECTRONICA MAYOR
8551314;;M;63;CHILENO;;Boomers;CABILDO                       ;VALPARAISO;158570;3;1;0;0;0;3;1;158570;LED 32 32PHD6825 HD SMART TV;ELECTRONICA MAYOR
10422633;;M;56;CHILENO;;Boomers;CERRO NAVIA                   ;METROPOLITANA;142140;2;1;0;0;0;2;1;142140;PARLANTE ULTRABUZZ;ELECTRONICA MAYOR
11440607;;F;52;CHILENO;;X;LOS ALAMOS                    ;BIO BIO;406950;5;5;0;0;0;5;5;406950;PARLANTE ULTRASENSATION;ELECTRONICA MAYOR
4268147;;M;83;CHILENO;;Silencioso;MACUL                         ;METROPOLITANA;187500;2;1;0;0;0;2;1;187500;PARLANTE ULTRABOOSTER 1;ELECTRONICA MAYOR
13394128;;F;44;CHILENO;;X;RENCA                         ;METROPOLITANA;195730;2;1;0;0;0;2;1;195730;LED 32 32S5305 HD HDR10/HLG;ELECTRONICA MAYOR
25640426;;F;41;CHILENO;;Extranjero;VALLENAR;ATACAMA;331960;4;2;4;2;331960;0;0;0;LED 50 KEUH50 SMART TV UHD;ELECTRONICA MAYOR
13302919;;F;44;CHILENO;;X;RENCA                         ;METROPOLITANA;109990;1;1;0;0;0;1;1;109990;PARLANTE ULTRAMEGA;ELECTRONICA MAYOR
15919955;;F;37;CHILENO;;Millenial;"";"";118980;2;1;2;1;118980;0;0;0;LED 32 32PHD6825 HD SMART TV;ELECTRONICA MAYOR
9755992;;F;55;CHILENO;;Boomers;TOCOPILLA                     ;ANTOFAGASTA;231482;4;3;0;0;0;4;3;231482;PARLANTE KARAOKE 8 MAXEIGHT;ELECTRONICA MAYOR
8438798;;F;59;CHILENO;;Boomers;PAINE                         ;METROPOLITANA;69990;1;1;0;0;0;1;1;69990;PARLANTE SENSEIGTH K3175;ELECTRONICA MAYOR
6829313;;F;68;CHILENO;;Millenial;SANTIAGO;METROPOLITANA;124980;2;2;0;0;0;2;2;124980;MINICOMPONENTE MX-T40/ZS ALL IN ONE;ELECTRONICA MAYOR
7232011;;F;68;CHILENO;;Boomers;MELIPILLA                     ;METROPOLITANA;2772160;15;7;0;0;0;15;7;2772160;LED 32 UN32T4300AGXZS HD SMART TV;ELECTRONICA MAYOR
6537663;;F;70;CHILENO;;Silencioso;TALCA                         ;MAULE;191440;2;1;0;0;0;2;1;191440;PARLANTE ULTRAFORCE-I;ELECTRONICA MAYOR
7997941;;F;65;CHILENO;;Boomers;PUERTO MONTT                  ;LOS LAGOS;139990;1;1;0;0;0;1;1;139990;PARLANTE ULTRAFORCE-I;ELECTRONICA MAYOR
13104968;;M;46;CHILENO;;X;RENCA                         ;METROPOLITANA;197150;2;1;0;0;0;2;1;197150;PARLANTE ULTRAFORCE-I;ELECTRONICA MAYOR
18613282;;F;28;CHILENO;;Millenial;N/D;N/D;376940;6;4;2;1;169980;4;3;206960;LED 40 KEHD4020 SMART TV;ELECTRONICA MAYOR
17709577;;F;30;CHILENO;;Millenial;"";"";374970;3;3;0;0;0;3;3;374970;PARLANTE ULTRA BOOSTER Z2;ELECTRONICA MAYOR
9959526;;M;57;CHILENO;;Boomers;ARICA                         ;ARICA Y PARINACOTA;218940;2;1;0;0;0;2;1;218940;LED 32 32LM33765 ANDROID SMART TV UHD;ELECTRONICA MAYOR
10494381;;M;53;CHILENO;;X;PUENTE ALTO                   ;METROPOLITANA;346970;3;2;0;0;0;3;2;346970;MINICOMPONENTE MX-T70/ZS ALL IN ONE;ELECTRONICA MAYOR
14357314;;M;43;CHILENO;;X;N/D;N/D;129990;1;1;0;0;0;1;1;129990;LED 32 32S60-32P ANDROID TV SMART LINE HD;ELECTRONICA MAYOR
7115773;;M;67;CHILENO;;Boomers;RENCA                         ;METROPOLITANA;316980;2;1;2;1;316980;0;0;0;LED SAMSUNG 50 AU7090 CRYSTAL UHD 4K SMART TV 20;ELECTRONICA MAYOR
9153375;Casado;F;61;CHILENO;;Boomers;RENCA                         ;METROPOLITANA;172980;2;1;0;0;0;2;1;172980;LED KIOTO 32 MI3228 SMART TV;ELECTRONICA MAYOR
17390611;;F;32;CHILENO;;Millenial;BUIN                          ;METROPOLITANA;632980;2;1;0;0;0;2;1;632980;LED SAMSUNG 65 4K UHD SMART TV AU7090 CRYSTAL;ELECTRONICA MAYOR
11087971;;M;55;CHILENO;;Boomers;SAN VICENTE                   ;L.G.B.OÂ´HIGGINS;578450;5;3;0;0;0;5;3;578450;LED PHILIPS 43 43PUD7406 ANDROID TV UHD 4K;ELECTRONICA MAYOR
17090725;Soltero;M;33;CHILENO;;Millenial;SAN JAVIER                    ;MAULE;896410;8;5;0;0;0;8;5;896410;PARLANTE ULTRASENSATION;ELECTRONICA MAYOR
19582190;;F;25;CHILENO;;Z;LOS ANDES                     ;VALPARAISO;179990;1;1;1;1;179990;0;0;0;LED 43 43S5305 SMART TV FULL HD;ELECTRONICA MAYOR
10713887;;M;53;CHILENO;;X;LIMACHE                       ;VALPARAISO;359640;3;2;0;0;0;3;2;359640;PARLANTE SCREAMER 5;ELECTRONICA MAYOR
20204567;;F;23;CHILENO;;Z;PROVIDENCIA                   ;METROPOLITANA;20980;2;1;2;1;20980;0;0;0;KARAOKE STREET SONG 4 MICÂ CABLEÂ BLACK 8900;ELECTRONICA MAYOR
13406631;;F;45;CHILENO;;X;CALBUCO                       ;LOS LAGOS;728900;12;7;0;0;0;12;7;728900;LED 55 KEUH5521 SMART TV UHD;ELECTRONICA MAYOR
17588607;;M;30;CHILENO;;Millenial;N/D;N/D;971920;8;6;0;0;0;8;6;971920;LED LG 32 SMART TV FHD 32LQ630BPSA.AWH;ELECTRONICA MAYOR
18842325;;F;27;CHILENO;;Millenial;PROVIDENCIA                   ;METROPOLITANA;44990;1;1;0;0;0;1;1;44990;PARLANTE SPBYF7 PORTATIL;ELECTRONICA MAYOR
13842365;;F;42;CHILENO;;X;PARRAL                        ;MAULE;352980;2;1;0;0;0;2;1;352980;LED SAMSUNG 50 AU7090 CRYSTAL UHD 4K SMART TV 20;ELECTRONICA MAYOR
7111644;Casado;F;66;CHILENO;;Boomers;PROVIDENCIA                   ;METROPOLITANA;279990;2;1;0;0;0;2;1;279990;PARLANTE ULTRA BOOSTER Z2;ELECTRONICA MAYOR
14073225;;M;41;CHILENO;;X;CANETE                        ;BIO BIO;791060;14;5;0;0;0;14;5;791060;MINICOMPONENTE CJ45;ELECTRONICA MAYOR
24351119;;F;59;BOLIVIANO;;Extranjero;SIERRA GORDA                  ;ANTOFAGASTA;449990;2;2;0;0;0;2;2;449990;PARLANTE ULTRAFUSION;ELECTRONICA MAYOR
9083899;;F;61;CHILENO;;Boomers;N/D;N/D;1008210;9;3;0;0;0;9;3;1008210;LED PHILIPS 43 43PUD7406 ANDROID TV UHD 4K;ELECTRONICA MAYOR
18979505;;F;27;CHILENO;;Z;PROVIDENCIA                   ;METROPOLITANA;1677860;13;8;6;3;758930;7;5;918930;LED 55 KEUH5521 SMART TV UHD;ELECTRONICA MAYOR
8875653;;M;58;CHILENO;;Boomers;ANGOL                         ;ARAUCANIA;199990;1;1;0;0;0;1;1;199990;LED 55 KEUH5521 SMART TV UHD;ELECTRONICA MAYOR
15614996;;F;38;CHILENO;;X;CHIGUAYANTE                   ;BIO BIO;213970;3;2;3;2;213970;0;0;0;MAGIC REMOTE MR21G;ELECTRONICA MAYOR
16963074;;M;33;CHILENO;;Millenial;"";"";542160;4;2;0;0;0;4;2;542160;LED LG 50 50UQ7500PSF.AWH UHD TV;ELECTRONICA MAYOR
8521524;;M;61;CHILENO;;Boomers;MAIPU                         ;METROPOLITANA;659980;2;1;0;0;0;2;1;659980;LED SAMSUNG 50 AU7090 CRYSTAL UHD 4K SMART TV 20;ELECTRONICA MAYOR
13489397;;F;44;CHILENO;;X;PUENTE ALTO;METROPOLITANA;153980;2;1;2;1;153980;0;0;0;LED 32 AOC ROKU TV HD 32S5195;ELECTRONICA MAYOR
10110666;;F;57;CHILENO;;Boomers;HIJUELAS                      ;VALPARAISO;1062560;10;6;0;0;0;10;6;1062560;LED 50 KEUH50 SMART TV UHD;ELECTRONICA MAYOR
19591416;;F;25;CHILENO;;Z;N/D;N/D;372460;6;2;0;0;0;6;2;372460;PARLANTE MGULTRAEXTREME;ELECTRONICA MAYOR
12431335;;F;49;CHILENO;;X;COLINA                        ;METROPOLITANA;202980;2;1;0;0;0;2;1;202980;PARLANTE ULTRAFORCE-I;ELECTRONICA MAYOR
19660463;;F;25;CHILENO;;Z;N/D;N/D;213140;3;2;0;0;0;3;2;213140;PARLANTE ULTRABOOSTER 1;ELECTRONICA MAYOR
18663719;Soltero;F;28;CHILENO;;Millenial;PROVIDENCIA                   ;METROPOLITANA;121980;2;1;2;1;121980;0;0;0;LED 32 32PHD6825 HD SMART TV;ELECTRONICA MAYOR
16846799;;F;34;CHILENO;;Millenial;N/D;N/D;731940;6;5;0;0;0;6;5;731940;KARAOKE PORTATIL TWO-EIGHT 8860;ELECTRONICA MAYOR
26856844;Soltero;F;44;COLOMBIANO;;Extranjero;VALLENAR;ATACAMA;1014940;6;5;4;3;819960;2;2;194980;LED SAMSUNG 50 AU7090 CRYSTAL UHD 4K SMART TV 20;ELECTRONICA MAYOR
17656977;;F;32;CHILENO;;Millenial;LA LIGUA;VALPARAISO;338980;2;2;2;2;338980;0;0;0;LED 58 KEUH5821 SMART TV UHD;ELECTRONICA MAYOR
17512243;Soltero;F;32;CHILENO;MEDICO CIRUJANO;Extranjero;PROVIDENCIA                   ;N/D;1091980;2;1;2;1;1091980;0;0;0;LED SAMSUNG 85 BU8000 CRYSTAL UHD 4K SMART TV;ELECTRONICA MAYOR
9854081;;M;58;CHILENO;;Boomers;SAN ANTONIO                   ;VALPARAISO;69990;1;1;0;0;0;1;1;69990;KARAOKE 15 HEAVY BASS MIC INA CON ATRIL 8892;ELECTRONICA MAYOR
15068924;;M;39;CHILENO;;Millenial;N/D;N/D;103980;2;1;2;1;103980;0;0;0;LED 32 32PHD6825 HD SMART TV;ELECTRONICA MAYOR
26505259;Soltero;F;27;NO INFORMA NACIONALIDAD;;Extranjero;TALCA                         ;MAULE;1282970;3;2;0;0;0;3;2;1282970;QLED 50 QN50Q60AAGXZS 4K UHD SMART TV;ELECTRONICA MAYOR
9810388;Casado;M;57;CHILENO;;Boomers;RENCA                         ;METROPOLITANA;85000;1;1;0;0;0;1;1;85000;2a ELECTRONICA MAYOR;ELECTRONICA MAYOR
9532932;;M;59;CHILENO;;Boomers;VALLENAR;ATACAMA;49980;2;2;0;0;0;2;2;49980;MLAB KARAOKE 8 CITY SET MICROFONO INALAMBRICO AT;ELECTRONICA MAYOR
13123794;;M;46;CHILENO;;X;N/D;N/D;1819940;22;11;0;0;0;22;11;1819940;LED SAMSUNG 43 UN43AU7090GXZS SMART TV UHD 4K;ELECTRONICA MAYOR
8347872;;F;62;CHILENO;;Boomers;N/D;N/D;643930;7;3;4;2;557960;3;1;85970;LED SAMSUNG 50 AU7090 CRYSTAL UHD 4K SMART TV 20;ELECTRONICA MAYOR
14836907;Casado;M;66;CHILENO;;Boomers;N/D;N/D;548560;8;4;0;0;0;8;4;548560;LED 50 NanoCell 50NANO80 UHD SMART + MAGIC;ELECTRONICA MAYOR
15455573;;F;40;CHILENO;;X;PENAFLOR                      ;METROPOLITANA;279990;1;1;0;0;0;1;1;279990;LED 50 50P615-50P ANDROID TV PASSION LINE UHD 4K;ELECTRONICA MAYOR
19024187;;F;27;CHILENO;;Millenial;LA PINTANA;METROPOLITANA;244980;2;2;1;1;159990;1;1;84990;PARLANTE SCREAMER 5;ELECTRONICA MAYOR
25942885;Soltero;M;36;PERUANO;;Extranjero;"";"";134990;1;1;0;0;0;1;1;134990;PARLANTE KARAOKE K3421;ELECTRONICA MAYOR
13521524;;F;43;CHILENO;;X;N/D;N/D;349970;3;6;0;4;0;3;2;349970;MINICOMPONENTE OL45;ELECTRONICA MAYOR
8645726;;M;62;CHILENO;;Extranjero;COPIAPO                       ;ATACAMA;69990;1;1;0;0;0;1;1;69990;KARAOKE 15 HEAVY BASS MIC INA CON ATRIL 8892;ELECTRONICA MAYOR
11407322;;M;53;CHILENO;;X;LONCOCHE                      ;ARAUCANIA;199990;1;1;0;0;0;1;1;199990;LED 32 UN32T4300AGXZS HD SMART TV;ELECTRONICA MAYOR
13576849;;F;45;CHILENO;;X;LINARES                       ;MAULE;402930;7;7;0;0;0;7;7;402930;PARLANTE SCREAMER 5;ELECTRONICA MAYOR
9958192;;F;56;CHILENO;;Boomers;CURICO                        ;MAULE;969890;11;5;0;0;0;11;5;969890;LED SAMSUNG 50 AU7090 CRYSTAL UHD 4K SMART TV 20;ELECTRONICA MAYOR
16726445;;F;34;CHILENO;;Millenial;RIO CLARO                     ;MAULE;319990;3;2;0;0;0;3;2;319990;MINICOMPONENTE OL45;ELECTRONICA MAYOR
12926656;;M;47;CHILENO;;X;CANETE                        ;BIO BIO;934890;11;9;0;0;0;11;9;934890;LED 55 55P615 UHD ANDROID TV 4K;ELECTRONICA MAYOR
7378573;;F;64;CHILENO;;Boomers;CERRILLOS                     ;METROPOLITANA;801952;5;3;0;0;0;5;3;801952;LED SAMSUNG 43 UN43AU7090GXZS SMART TV UHD 4K;ELECTRONICA MAYOR
8167029;;M;64;CHILENO;;Boomers;COLINA                        ;METROPOLITANA;195481;2;1;0;0;0;2;1;195481;MINICOMPONENTE MHC-V02 ALL IN ONE;ELECTRONICA MAYOR
15238812;;F;39;CHILENO;;X;N/D;N/D;168360;4;2;0;0;0;4;2;168360;PARLANTE SCREAMER 5;ELECTRONICA MAYOR
13796726;;F;42;CHILENO;;X;TALCAHUANO                    ;BIO BIO;264970;3;5;0;0;0;3;5;264970;LED 32 UN32T4300AGXZS HD SMART TV;ELECTRONICA MAYOR
26826253;;M;32;CHILENO;;Extranjero;N/D;N/D;1901620;22;6;0;0;0;22;6;1901620;LED 50 KEUH50 SMART TV UHD;ELECTRONICA MAYOR
7563003;;M;67;CHILENO;;Silencioso;PROVIDENCIA                   ;METROPOLITANA;209990;1;1;0;0;0;1;1;209990;LED 32 UN32T4300AGXZS HD SMART TV;ELECTRONICA MAYOR
7926880;Casado;M;66;CHILENO;;Boomers;CAUQUENES                     ;MAULE;359980;2;2;0;0;0;2;2;359980;LED 32 AOC ROKU TV HD 32S5195;ELECTRONICA MAYOR
10174639;;F;75;CHILENO;;Silencioso;QUELLON                       ;LOS LAGOS;419980;2;2;0;0;0;2;2;419980;PARLANTE ULTRA BOOSTER Z2;ELECTRONICA MAYOR
11287841;;F;53;CHILENO;;X;LA FLORIDA                    ;METROPOLITANA;398950;5;4;0;0;0;5;4;398950;LED 32 32S60-32P ANDROID TV SMART LINE HD;ELECTRONICA MAYOR
7461590;;F;62;CHILENO;;Boomers;ARICA                         ;ARICA Y PARINACOTA;129990;1;1;0;0;0;1;1;129990;MINICOMPONENTE OL45;ELECTRONICA MAYOR
14613403;;F;43;CHILENO;;X;MELIPILLA                     ;METROPOLITANA;1110680;9;4;0;0;0;9;4;1110680;LED SAMSUNG 55 4K UHD SMART TV UN55AU7090GXZS;ELECTRONICA MAYOR
4648269;;M;77;CHILENO;;Silencioso;MELIPILLA                     ;METROPOLITANA;238360;2;1;0;0;0;2;1;238360;LED 32 UN32T4300AGXZS HD SMART TV;ELECTRONICA MAYOR
16515933;Casado;M;34;CHILENO;;Millenial;RENCA                         ;METROPOLITANA;379970;3;1;0;0;0;3;1;379970;LED 55 KEUH5521 SMART TV UHD;ELECTRONICA MAYOR
18616043;Soltero;M;28;CHILENO;;Millenial;"";"";299990;1;1;0;0;0;1;1;299990;LED 55 55P615 UHD ANDROID TV 4K;ELECTRONICA MAYOR
11834563;;F;51;CHILENO;;X;QUINTA NORMAL                 ;METROPOLITANA;740580;11;5;9;4;686910;2;1;53670;LED 50 50LM34493 ANDROID SMART TV UHD 4K;ELECTRONICA MAYOR
7843223;;M;67;CHILENO;;Boomers;LA GRANJA                     ;METROPOLITANA;734090;7;5;0;0;0;7;5;734090;PARLANTE KARAOKE 12 FM/BT/USB;ELECTRONICA MAYOR
10299693;;F;54;CHILENO;;Boomers;COIHAIQUE                     ;AYSEN;359110;4;2;0;0;0;4;2;359110;MINICOMPONENTE RN7;ELECTRONICA MAYOR
12164482;;F;50;CHILENO;;X;CASABLANCA                    ;VALPARAISO;49990;1;1;0;0;0;1;1;49990;PARLANTE KARAOKE 12 FM/BT/USB;ELECTRONICA MAYOR
17966772;;M;31;CHILENO;;Millenial;"";"";129990;1;1;1;1;129990;0;0;0;LED 40 KEHD4020 SMART TV;ELECTRONICA MAYOR
17158178;;M;33;CHILENO;;Millenial;COYHAIQUE;AYSEN;439990;1;1;0;0;0;1;1;439990;LED SAMSUNG 55 4K UHD SMART TV UN55AU7090GXZS;ELECTRONICA MAYOR
16978723;Casado;M;33;CHILENO;CIRUJANO DENTISTA;Millenial;RENCA                         ;METROPOLITANA;119990;1;1;1;1;119990;0;0;0;LED 40 KEHD4020 SMART TV;ELECTRONICA MAYOR
25125798;;F;56;PERUANO;;Extranjero;LAS CONDES                    ;METROPOLITANA;464720;5;3;0;0;0;5;3;464720;LED 32 UN32T4300AGXZS HD SMART TV;ELECTRONICA MAYOR
20103509;;F;23;CHILENO;;Z;TEMUCO                        ;ARAUCANIA;84990;1;3;0;0;0;1;3;84990;PARLANTE SCREAMER 5;ELECTRONICA MAYOR
10683693;;F;54;CHILENO;;X;EL MONTE                      ;METROPOLITANA;238940;4;1;4;1;238940;0;0;0;LED 50 KEUH50 SMART TV UHD;ELECTRONICA MAYOR
16708417;;F;34;CHILENO;;Millenial;PROVIDENCIA                   ;METROPOLITANA;257640;2;1;0;0;0;2;1;257640;LED 55 KEUH5521 SMART TV UHD;ELECTRONICA MAYOR
19422566;;F;25;CHILENO;;Millenial;"";"";200000;2;1;0;0;0;2;1;200000;LED 43 43S5195 ROKU TV FHD;ELECTRONICA MAYOR
16866834;;F;34;CHILENO;;Millenial;N/D;N/D;176670;2;1;0;0;0;2;1;176670;PARLANTE ULTRABUZZ;ELECTRONICA MAYOR
16346289;;F;36;CHILENO;;Millenial;SAN BERNARDO                  ;METROPOLITANA;176670;2;1;0;0;0;2;1;176670;PARLANTE ULTRABUZZ;ELECTRONICA MAYOR
15348168;;M;40;CHILENO;;X;PARRAL                        ;MAULE;1790808;19;10;0;0;0;19;10;1790808;LED 32 32S5305 HD HDR10/HLG;ELECTRONICA MAYOR
16638897;;M;35;CHILENO;;Millenial;"";"";134710;3;1;0;0;0;3;1;134710;LED KIOTO 32 MI3228 SMART TV;ELECTRONICA MAYOR
16504057;;M;35;CHILENO;;Millenial;ANGOL                         ;ARAUCANIA;292240;3;2;0;0;0;3;2;292240;LED 43 43S5195 ROKU TV FHD;ELECTRONICA MAYOR
15038252;Casado;M;53;CHILENO;;X;PROVIDENCIA                   ;METROPOLITANA;112980;2;1;2;1;112980;0;0;0;LED KIOTO 32 MI3228 SMART TV;ELECTRONICA MAYOR
6184288;;F;71;CHILENO;;Silencioso;QUILLOTA                      ;VALPARAISO;669970;3;3;0;0;0;3;3;669970;LED 50 50UP7500 UHD SMART TV;ELECTRONICA MAYOR
12995614;;M;45;CHILENO;;X;SAN BERNARDO                  ;METROPOLITANA;689990;1;1;0;0;0;1;1;689990;LED NanoCell 65NANO75 UHD SMART + MAGIC;ELECTRONICA MAYOR
9115452;;F;59;CHILENO;;Boomers;N/D;N/D;2042910;13;4;4;2;565820;9;2;1477090;PARLANTE MGULTRAEXTREME;ELECTRONICA MAYOR
7510142;Casado;M;67;CHILENO;;Boomers;RENCA                         ;METROPOLITANA;217160;2;1;0;0;0;2;1;217160;LED 42 KHFH4221 SMART TV;ELECTRONICA MAYOR
7941014;;F;65;CHILENO;;Boomers;RENCA                         ;METROPOLITANA;188980;2;1;2;1;188980;0;0;0;LED 43 Full HD Smart TV 43PFD6825;ELECTRONICA MAYOR
9428538;Soltero;F;58;CHILENO;;Boomers;PROVIDENCIA                   ;METROPOLITANA;369960;4;2;4;2;369960;0;0;0;LED 50 KEUH50 SMART TV UHD;ELECTRONICA MAYOR
15286812;;M;39;CHILENO;;X;PROVIDENCIA                   ;METROPOLITANA;99990;1;1;1;1;99990;0;0;0;LED KIOTO 32 MI3228 SMART TV;ELECTRONICA MAYOR
13689331;;M;43;CHILENO;;X;PROVIDENCIA                   ;METROPOLITANA;209980;2;1;2;1;209980;0;0;0;LED 55 KEUH5521 SMART TV UHD;ELECTRONICA MAYOR
13676213;;F;42;CHILENO;;X;RENCA                         ;METROPOLITANA;189980;2;1;2;1;189980;0;0;0;LED 50 KEUH50 SMART TV UHD;ELECTRONICA MAYOR
16188857;;F;36;CHILENO;;Millenial;VALLENAR;ATACAMA;179990;1;1;0;0;0;1;1;179990;LED 50 KEUH50 SMART TV UHD;ELECTRONICA MAYOR
17965047;;M;30;CHILENO;;Millenial;PETORCA                       ;VALPARAISO;199990;1;1;0;0;0;1;1;199990;LED LG 32 SMART TV FHD 32LQ630BPSA.AWH;ELECTRONICA MAYOR
19914869;;F;24;CHILENO;;Z;PROVIDENCIA                   ;METROPOLITANA;199990;1;1;1;1;199990;0;0;0;LED 58 KEUH5821 SMART TV UHD;ELECTRONICA MAYOR
17719980;;F;28;CHILENO;;Boomers;CASTRO                        ;LOS LAGOS;227990;3;2;0;0;0;3;2;227990;SOUNDBAR BLIK SURREAL 2.0;ELECTRONICA MAYOR
17760469;;F;30;CHILENO;;Millenial;PROVIDENCIA                   ;METROPOLITANA;234980;2;2;1;1;199990;1;1;34990;LED 43 UN43T5202AGXZS FHD SMART TV;ELECTRONICA MAYOR
6404708;;M;69;CHILENO;;Silencioso;EL BOSQUE                     ;METROPOLITANA;299990;1;1;0;0;0;1;1;299990;LED 65 KEUH6521 SMART TV UHD;ELECTRONICA MAYOR
16919542;;M;34;CHILENO;;Millenial;PENALOLEN;METROPOLITANA;129990;1;1;0;0;0;1;1;129990;LED 40 KEHD4020 SMART TV;ELECTRONICA MAYOR
13205463;;F;44;CHILENO;;X;CONSTITUCION                  ;MAULE;150990;3;2;0;0;0;3;2;150990;LED 40 KEHD4020 SMART TV;ELECTRONICA MAYOR
14441681;;F;50;CHILENO;;X;LA LIGUA                      ;VALPARAISO;227960;4;3;2;1;112980;2;2;114980;LED KIOTO 32 MI3228 SMART TV;ELECTRONICA MAYOR
13442811;;M;44;CHILENO;;X;PROVIDENCIA                   ;METROPOLITANA;189980;2;1;2;1;189980;0;0;0;LED 50 KEUH50 SMART TV UHD;ELECTRONICA MAYOR
25489401;;M;42;HAITIANO;;Extranjero;ESTACION CENTRAL              ;METROPOLITANA;563960;4;4;0;0;0;4;4;563960;LED KIOTO 32 MI3228 SMART TV;ELECTRONICA MAYOR
13180530;;F;45;CHILENO;;X;MONTE PATRIA                  ;COQUIMBO;1150450;5;3;0;0;0;5;3;1150450;PARLANTE SCREAMER 5;ELECTRONICA MAYOR
9322641;;M;61;CHILENO;;Boomers;SANTA MARIA                   ;VALPARAISO;699730;8;7;0;0;0;8;7;699730;LED 58 KEUH5821 SMART TV UHD;ELECTRONICA MAYOR
24478667;;M;33;COLOMBIANO;;Extranjero;MELIPILLA                     ;METROPOLITANA;472950;5;3;0;0;0;5;3;472950;LED 43 43UP7500 UHD SMART TV;ELECTRONICA MAYOR
17151639;;M;33;CHILENO;;Millenial;COIHAIQUE                     ;AYSEN;104980;2;2;1;1;89990;1;1;14990;LED KIOTO 32 MI3228 SMART TV;ELECTRONICA MAYOR
7217164;;F;69;CHILENO;;Silencioso;TOCOPILLA                     ;ANTOFAGASTA;478960;4;5;0;0;0;4;5;478960;MONITOR 24 24TL520S SMART TV HD;ELECTRONICA MAYOR
18800294;;M;27;CHILENO;;Millenial;LOS ANGELES                   ;BIO BIO;19990;1;1;0;0;0;1;1;19990;PARLANTE MG TWISTER;ELECTRONICA MAYOR
14478033;;F;48;CHILENO;;X;VILLARICA                     ;ARAUCANIA;355960;5;2;0;0;0;5;2;355960;LED 50 KEUH50 SMART TV UHD;ELECTRONICA MAYOR
16234925;;F;35;CHILENO;;Millenial;TEMUCO;ARAUCANIA;109990;1;1;0;0;0;1;1;109990;PARLANTE ULTRAMAGIC;ELECTRONICA MAYOR
7242140;;M;68;CHILENO;;Boomers;VILLA ALEGRE                  ;MAULE;139990;1;1;0;0;0;1;1;139990;LED 32 AOC ROKU TV HD 32S5195;ELECTRONICA MAYOR
11692180;;F;52;CHILENO;;X;AISEN                         ;AYSEN;848940;6;3;4;2;568960;2;1;279980;LED 55 KEUH5521 SMART TV UHD;ELECTRONICA MAYOR
12956377;;M;45;CHILENO;;X;QUILPUE                       ;VALPARAISO;89990;1;1;1;1;89990;0;0;0;LED KIOTO 32 MI3228 SMART TV;ELECTRONICA MAYOR
10041427;;F;55;CHILENO;;Boomers;PUNITAQUI                     ;COQUIMBO;342850;4;2;0;0;0;4;2;342850;LED 32 32PHD6825 HD SMART TV;ELECTRONICA MAYOR
7516552;;F;68;CHILENO;;Boomers;SAN RAMON                     ;METROPOLITANA;227720;2;1;0;0;0;2;1;227720;MINICOMPONENTE RN7;ELECTRONICA MAYOR
19974939;;M;23;CHILENO;;Z;N/D;N/D;582970;3;2;2;1;556980;1;1;25990;SOUNDBAR BLIK SURREAL 2.0;ELECTRONICA MAYOR
20137029;;M;23;CHILENO;;Z;PROVIDENCIA                   ;METROPOLITANA;160960;3;1;3;1;160960;0;0;0;LED 40 KEHD4020 SMART TV;ELECTRONICA MAYOR
10306211;;M;57;CHILENO;;Boomers;CERRO NAVIA                   ;METROPOLITANA;249970;3;1;0;0;0;3;1;249970;LED 55 KEUH5521 SMART TV UHD;ELECTRONICA MAYOR
19960560;;F;23;CHILENO;;Z;PROVIDENCIA                   ;METROPOLITANA;139990;1;1;1;1;139990;0;0;0;LED 40 KEHD4020 SMART TV;ELECTRONICA MAYOR
17411136;;F;32;CHILENO;;Millenial;SAN BERNARDO;METROPOLITANA;93980;2;1;2;1;93980;0;0;0;LED KIOTO 32 MI3228 SMART TV;ELECTRONICA MAYOR
14072045;;M;41;CHILENO;;X;N/D;N/D;1299202;15;7;8;2;793770;7;5;505432;LED 40 KEHD4020 SMART TV;ELECTRONICA MAYOR
11513856;;M;51;CHILENO;;X;CALAMA                        ;ANTOFAGASTA;169990;1;1;1;1;169990;0;0;0;LED 50 KEUH50 SMART TV UHD;ELECTRONICA MAYOR
18876551;;M;27;CHILENO;;Z;N/D;N/D;189990;1;1;1;1;189990;0;0;0;LED 43 43S5195 ROKU TV FHD;ELECTRONICA MAYOR
6752491;;F;70;CHILENO;;Silencioso;ANTOFAGASTA                   ;ANTOFAGASTA;143420;3;2;0;0;0;3;2;143420;PARLANTE ULTRAMAGIC;ELECTRONICA MAYOR
18895221;Soltero;M;27;CHILENO;TECNICO MECANICO;Z;CONSTITUCION                  ;MAULE;173990;2;1;0;0;0;2;1;173990;LED 40 KEHD4020 SMART TV;ELECTRONICA MAYOR
18780244;;F;27;CHILENO;;Millenial;ZAPALLAR                      ;VALPARAISO;128980;2;1;2;1;128980;0;0;0;LED 40 KEHD4020 SMART TV;ELECTRONICA MAYOR
10911642;;M;56;CHILENO;;Boomers;PUENTE ALTO                   ;METROPOLITANA;207160;2;1;0;0;0;2;1;207160;LED 42 KHFH4221 SMART TV;ELECTRONICA MAYOR
20325227;;M;22;CHILENO;;Millenial;"";"";128980;2;1;2;1;128980;0;0;0;LED 40 KEHD4020 SMART TV;ELECTRONICA MAYOR
9127374;;F;60;CHILENO;;Boomers;PUENTE ALTO                   ;METROPOLITANA;189990;1;1;0;0;0;1;1;189990;LED 32 UN32T4300AGXZS HD SMART TV;ELECTRONICA MAYOR
16714392;;F;35;CHILENO;;Millenial;"";"";289980;2;2;0;0;0;2;2;289980;LED 55 KEUH5521 SMART TV UHD;ELECTRONICA MAYOR
13791671;;F;42;CHILENO;;X;PELLUHUE                      ;MAULE;606960;4;3;0;0;0;4;3;606960;LED 65 KEUH6521 SMART TV UHD;ELECTRONICA MAYOR
12225089;;M;49;CHILENO;;X;"";"";199990;1;1;0;0;0;1;1;199990;LED 43 43S5195 ROKU TV FHD;ELECTRONICA MAYOR
17721825;;M;31;CHILENO;;Millenial;N/D;N/D;322980;2;2;0;0;0;2;2;322980;LED SAMSUNG 50 AU7090 CRYSTAL UHD 4K SMART TV 20;ELECTRONICA MAYOR
8376862;;M;64;CHILENO;;Boomers;RENCA                         ;METROPOLITANA;545980;3;2;0;0;0;3;2;545980;LED 65 KEUH6521 SMART TV UHD;ELECTRONICA MAYOR
16934790;;M;37;CHILENO;;Millenial;N/D;N/D;237170;3;1;0;0;0;3;1;237170;LED 55 KEUH5521 SMART TV UHD;ELECTRONICA MAYOR
16576397;;F;35;CHILENO;;Millenial;MELIPILLA                     ;METROPOLITANA;299980;2;2;2;2;299980;0;0;0;LED 40 KEHD4020 SMART TV;ELECTRONICA MAYOR
11182442;;F;55;CHILENO;;Boomers;PROVIDENCIA                   ;METROPOLITANA;196550;3;2;0;0;0;3;2;196550;PARLANTE ULTRAMEGA;ELECTRONICA MAYOR
5255102;Viudo;F;74;CHILENO;;Silencioso;VICTORIA                      ;ARAUCANIA;139990;1;1;0;0;0;1;1;139990;LED KIOTO 32 MI3228 SMART TV;ELECTRONICA MAYOR
15319224;;M;43;CHILENO;;X;RENCA                         ;METROPOLITANA;492042;4;2;0;0;0;4;2;492042;LED 55UP7500 UHD SMART;ELECTRONICA MAYOR
17629599;;M;30;CHILENO;;Millenial;NANCAGUA                      ;L.G.B.OÂ´HIGGINS;417450;4;1;0;0;0;4;1;417450;LED 50 UN50TU7090GXZS UHD SMART TV;ELECTRONICA MAYOR
20113053;;F;23;CHILENO;;Z;PAINE                         ;METROPOLITANA;193970;3;2;2;1;123980;1;1;69990;BARRA DE SONIDO HT-S350;ELECTRONICA MAYOR
13330521;;F;44;CHILENO;;X;RENCA                         ;METROPOLITANA;419990;1;1;0;0;0;1;1;419990;LED 50 50NANO75 NanoCell UHD SMART + MAGIC;ELECTRONICA MAYOR
14061124;;M;41;CHILENO;;X;"";"";149993;3;2;0;0;0;3;2;149993;PARLANTE ULTRAFORCE-I;ELECTRONICA MAYOR
12101834;;M;54;CHILENO;;X;NEGRETE                       ;BIO BIO;169990;1;1;0;0;0;1;1;169990;LED 32 UN32T4300AGXZS HD SMART TV;ELECTRONICA MAYOR
18034221;;M;30;CHILENO;;Millenial;N/D;N/D;79990;1;1;0;0;0;1;1;79990;PARLANTE SENSEIGTH K3175;ELECTRONICA MAYOR
8062540;;F;62;CHILENO;;Boomers;N/D;N/D;130980;2;1;2;1;130980;0;0;0;LED 40 KEHD4020 SMART TV;ELECTRONICA MAYOR
10931362;;F;54;CHILENO;;X;TEMUCO                        ;ARAUCANIA;1867290;10;5;0;0;0;10;5;1867290;LED 58 KEUH5821 SMART TV UHD;ELECTRONICA MAYOR
13389735;;M;43;CHILENO;;X;CURANILAHUE                   ;BIO BIO;685430;7;5;0;0;0;7;5;685430;LED 50 KEUH50 SMART TV UHD;ELECTRONICA MAYOR
17621980;Soltero;M;32;CHILENO;TECNICO MECANICO;Millenial;CONCHALI;METROPOLITANA;199980;2;1;2;1;199980;0;0;0;LED 55 KEUH5521 SMART TV UHD;ELECTRONICA MAYOR
15286244;;M;40;CHILENO;;X;CALBUCO                       ;LOS LAGOS;164970;3;1;0;0;0;3;1;164970;LED KIOTO 32 MI3228 SMART TV;ELECTRONICA MAYOR
15836367;;M;37;CHILENO;;Millenial;QUILPUE;VALPARAISO;109990;1;1;1;1;109990;0;0;0;LED 32 32S5305 HD HDR10/HLG;ELECTRONICA MAYOR
15626625;;F;38;CHILENO;;Millenial;N/D;N/D;1479880;11;4;11;4;1479880;0;0;0;SOUNDBAR F-HQ700AS9500S;ELECTRONICA MAYOR
5647259;;M;73;CHILENO;;Silencioso;ARICA                         ;ARICA Y PARINACOTA;881550;8;4;0;0;0;8;4;881550;LED 43 UN43T5202AGXZS FHD SMART TV;ELECTRONICA MAYOR
12884577;;F;47;CHILENO;;X;PUDAHUEL;METROPOLITANA;143980;2;1;2;1;143980;0;0;0;PARLANTE MGULTRAEXTREME;ELECTRONICA MAYOR
8620383;;F;63;CHILENO;;Boomers;PROVIDENCIA                   ;METROPOLITANA;0;0;2;0;0;0;0;2;0;KARAOKE RHYTHM CHARGER 12 MIC CABLE 8890;ELECTRONICA MAYOR
26075639;Casado;M;38;EXTRANJERO - NO INFORMA NACIONALIDAD;;Extranjero;"";"";329990;1;3;0;0;0;1;3;329990;LED 55 55P615 UHD ANDROID TV 4K;ELECTRONICA MAYOR
13747932;;F;41;CHILENO;;X;MONTE PATRIA                  ;COQUIMBO;829950;5;3;4;2;699960;1;1;129990;SOUNDBAR HW-A450/ZS;ELECTRONICA MAYOR
14693354;;F;56;PERUANO;;Extranjero;CONCHALI                      ;METROPOLITANA;437000;8;3;0;0;0;8;3;437000;PARLANTE ULTRAFORCE-I;ELECTRONICA MAYOR
9683045;;F;59;CHILENO;;Boomers;QUINTERO                      ;VALPARAISO;295890;4;3;0;0;0;4;3;295890;MINICOMPONENTE CJ45;ELECTRONICA MAYOR
11602855;;M;52;CHILENO;;X;N/D;N/D;989410;9;5;0;0;0;9;5;989410;LED 58 KEUH5821 SMART TV UHD;ELECTRONICA MAYOR
8749845;;M;61;CHILENO;;Boomers;MELIPILLA                     ;METROPOLITANA;219990;1;1;0;0;0;1;1;219990;LED 43 Full HD Smart TV 43PFD6825;ELECTRONICA MAYOR
5977856;;M;71;CHILENO;;Silencioso;CORONEL                       ;BIO BIO;377220;4;3;0;0;0;4;3;377220;LED 40 KEHD4020 SMART TV;ELECTRONICA MAYOR
12169953;;F;52;CHILENO;;X;N/D;N/D;895830;3;2;2;1;385840;1;1;509990;LED 60UP7750 UHD SMART + MAGIC;ELECTRONICA MAYOR
13770865;;M;42;CHILENO;;X;PROVIDENCIA                   ;METROPOLITANA;88690;2;1;0;0;0;2;1;88690;PARLANTE SENSEIGTH K3175;ELECTRONICA MAYOR
9066210;;M;60;CHILENO;;Boomers;SAN JAVIER                    ;MAULE;1139980;8;3;2;1;379980;6;2;760000;LED 55 KEUH5521 SMART TV UHD;ELECTRONICA MAYOR
27124561;;M;29;CHILENO;;Extranjero;LA LIGUA                      ;VALPARAISO;339980;2;2;0;0;0;2;2;339980;LED 40 KEHD4020 SMART TV;ELECTRONICA MAYOR
8754672;;M;62;CHILENO;;Boomers;PROVIDENCIA                   ;METROPOLITANA;456980;3;2;0;0;0;3;2;456980;LED 43 Full HD Smart TV 43PFD6825;ELECTRONICA MAYOR
18738247;Soltero;M;28;CHILENO;;Millenial;PROVIDENCIA                   ;METROPOLITANA;306980;2;1;0;0;0;2;1;306980;LED 50 50P615-50P ANDROID TV PASSION LINE UHD 4K;ELECTRONICA MAYOR
25188001;;M;34;ARGENTINO;;Extranjero;N/D;N/D;347970;3;2;0;0;0;3;2;347970;LED 32 UN32T4300AGXZS HD SMART TV;ELECTRONICA MAYOR
19764720;;M;24;CHILENO;;Z;PROVIDENCIA                   ;METROPOLITANA;229990;1;1;1;1;229990;0;0;0;LED 43 UN43T5202AGXZS FHD SMART TV;ELECTRONICA MAYOR
7896423;;F;72;CHILENO;;Silencioso;LINARES                       ;MAULE;109990;1;1;0;0;0;1;1;109990;PARLANTE ULTRAMEGA;ELECTRONICA MAYOR
9077124;;F;62;CHILENO;;Boomers;RANCAGUA                      ;L.G.B.OÂ´HIGGINS;369990;3;2;0;0;0;3;2;369990;LED 65 KEUH6521 SMART TV UHD;ELECTRONICA MAYOR
15629336;;F;38;CHILENO;;X;LOS ANGELES                   ;BIO BIO;374990;6;3;0;0;0;6;3;374990;LED 55 KEUH5521 SMART TV UHD;ELECTRONICA MAYOR
16509574;;M;35;CHILENO;;Millenial;"";"";426970;3;2;0;0;0;3;2;426970;LED 40 KEHD4020 SMART TV;ELECTRONICA MAYOR
18240658;;M;29;CHILENO;;Millenial;NATALES                       ;MAGALLANES;378980;2;1;0;0;0;2;1;378980;LED 58 UN58AU7000GXZS UHD 4K SMART TV;ELECTRONICA MAYOR
19277176;;F;26;CHILENO;;Z;SAN BERNARDO                  ;METROPOLITANA;159990;1;1;1;1;159990;0;0;0;LED 50 KEUH50 SMART TV UHD;ELECTRONICA MAYOR
12701362;;F;47;CHILENO;;X;SAN PEDRO DE LA PAZ           ;BIO BIO;1267100;13;8;0;0;0;13;8;1267100;LED 32 UN32T4300AGXZS HD SMART TV;ELECTRONICA MAYOR
26471207;Soltero;F;45;EXTRANJERO - NO INFORMA NACIONALIDAD;;Extranjero;ANTOFAGASTA                   ;ANTOFAGASTA;303980;3;2;0;0;0;3;2;303980;LED 43 UN43T5202AGXZS FHD SMART TV;ELECTRONICA MAYOR
16375268;;F;35;CHILENO;;Millenial;SAN VICENTE                   ;L.G.B.OÂ´HIGGINS;243970;3;1;3;1;243970;0;0;0;LED 40 KEHD4020 SMART TV;ELECTRONICA MAYOR
8363166;Casado;F;62;CHILENO;;Boomers;CORONEL                       ;BIO BIO;313940;6;5;0;0;0;6;5;313940;LED 55 KEUH5521 SMART TV UHD;ELECTRONICA MAYOR
10171404;;M;57;CHILENO;;Boomers;N/D;N/D;1239560;11;4;0;0;0;11;4;1239560;LED 58 KEUH5821 SMART TV UHD;ELECTRONICA MAYOR
20433087;;M;27;CHILENO;;Millenial;N/D;N/D;520800;4;2;0;0;0;4;2;520800;LED 40 UN40T5290AGXZS FHD SMART TV;ELECTRONICA MAYOR
10379227;Casado;M;56;CHILENO;;Boomers;RENCA                         ;METROPOLITANA;26990;1;1;0;0;0;1;1;26990;KARAOKE FUNKY DISCO;ELECTRONICA MAYOR
10343835;;M;54;CHILENO;;Boomers;RENCA                         ;METROPOLITANA;221170;3;2;0;0;0;3;2;221170;LED 40 KEHD4020 SMART TV;ELECTRONICA MAYOR
14007801;;F;41;CHILENO;;X;MELIPILLA                     ;METROPOLITANA;439980;2;2;0;0;0;2;2;439980;LED 58 UN58AU7000GXZS UHD 4K SMART TV;ELECTRONICA MAYOR
16628334;;F;34;CHILENO;;Millenial;PROVIDENCIA                   ;METROPOLITANA;178970;3;2;2;1;153980;1;1;24990;MINICOMPONENTE CJ45;ELECTRONICA MAYOR
18970145;;M;26;CHILENO;;Z;N/D;N/D;159990;1;1;1;1;159990;0;0;0;MONITOR 24 24TL520S SMART TV HD;ELECTRONICA MAYOR
6688801;;F;74;CHILENO;;Silencioso;TOCOPILLA                     ;ANTOFAGASTA;485970;3;2;0;0;0;3;2;485970;QLED 50 QN50Q60AAGXZS 4K UHD SMART TV;ELECTRONICA MAYOR
25600318;;M;38;VENEZOLANO;;Extranjero;LOTA                          ;BIO BIO;409000;3;1;0;0;0;3;1;409000;LED 55 55P615 UHD ANDROID TV 4K;ELECTRONICA MAYOR
12588180;;M;48;CHILENO;;X;TALCA                         ;MAULE;170000;2;1;0;0;0;2;1;170000;2a ELECTRONICA MAYOR;ELECTRONICA MAYOR
9667429;;M;58;CHILENO;;Boomers;MAIPU                         ;METROPOLITANA;383970;3;2;2;1;233980;1;1;149990;LED 50 UN50TU7090GXZS UHD SMART TV;ELECTRONICA MAYOR
14229161;;M;41;CHILENO;;X;PUNTA ARENAS;MAGALLANES;229990;1;1;1;1;229990;0;0;0;LED 50 50U6305 SMART TV ULTRA HD;ELECTRONICA MAYOR
15181010;;F;40;CHILENO;;X;CHIGUAYANTE                   ;BIO BIO;169990;1;1;1;1;169990;0;0;0;LED 32 UN32T4300AGXZS HD SMART TV;ELECTRONICA MAYOR
25179686;;F;43;ECUATORIANO;;Extranjero;N/D;N/D;139990;1;1;0;0;0;1;1;139990;PARLANTE ULTRAFORCE-I;ELECTRONICA MAYOR
19757316;;F;24;CHILENO;;Z;ALGARROBO;VALPARAISO;44980;2;2;0;0;0;2;2;44980;SOUNDBAR BLIK SURREAL 2.0;ELECTRONICA MAYOR
7456214;Casado;M;68;CHILENO;;Boomers;ANGOL                         ;ARAUCANIA;694221;4;2;0;0;0;4;2;694221;LED 70 UN70AU7000GXZS UHD;ELECTRONICA MAYOR
6487794;;M;71;CHILENO;;Silencioso;CONTULMO                      ;BIO BIO;256600;4;3;0;0;0;4;3;256600;LED KIOTO 32 MI3228 SMART TV;ELECTRONICA MAYOR
16850928;;F;34;CHILENO;;Millenial;POZO ALMONTE                  ;TARAPACA;279990;1;1;0;0;0;1;1;279990;LED 50 KEUH50 SMART TV UHD;ELECTRONICA MAYOR
18510186;;F;29;CHILENO;;Millenial;QUILLOTA                      ;VALPARAISO;369980;4;2;0;0;0;4;2;369980;LED 42 KHFH4221 SMART TV;ELECTRONICA MAYOR
19551595;;M;24;CHILENO;;Silencioso;PROVIDENCIA                   ;METROPOLITANA;401980;2;1;2;1;401980;0;0;0;QLED 50 QN50Q60AAGXZS 4K UHD SMART TV;ELECTRONICA MAYOR
18407456;Soltero;M;29;CHILENO;;Millenial;QUINTA NORMAL;METROPOLITANA;251980;2;1;2;1;251980;0;0;0;LED 50 UN50TU7090GXZS UHD SMART TV;ELECTRONICA MAYOR
15400565;;F;45;CHILENO;;X;LA PINTANA                    ;METROPOLITANA;589280;4;2;0;0;0;4;2;589280;PARLANTE ULTRAFORCE-I;ELECTRONICA MAYOR
14072343;;M;41;CHILENO;;X;CURANILAHUE                   ;BIO BIO;257970;3;2;3;2;257970;0;0;0;LED 32 32LM630BPSB SMART TV;ELECTRONICA MAYOR
8495702;;M;65;CHILENO;;Boomers;CANETE                        ;BIO BIO;381410;2;1;0;0;0;2;1;381410;LED 58 KEUH5821 SMART TV UHD;ELECTRONICA MAYOR
18204325;;M;30;CHILENO;;Millenial;"";"";161990;3;2;0;0;0;3;2;161990;LED 40 KEHD4020 SMART TV;ELECTRONICA MAYOR
9467444;;M;59;CHILENO;;Boomers;PROVIDENCIA                   ;METROPOLITANA;1141600;14;5;0;0;0;14;5;1141600;LED 43 UN43T5202AGXZS FHD SMART TV;ELECTRONICA MAYOR
10177693;;M;57;CHILENO;;Boomers;SAN BERNARDO                  ;METROPOLITANA;267820;2;1;0;0;0;2;1;267820;LED 43 UN43T5202AGXZS FHD SMART TV;ELECTRONICA MAYOR
5357745;Casado;M;72;CHILENO;;Silencioso;PROVIDENCIA                   ;METROPOLITANA;139990;1;1;0;0;0;1;1;139990;MINICOMPONENTE OL45;ELECTRONICA MAYOR
7165014;;M;66;CHILENO;;Boomers;PROVIDENCIA                   ;METROPOLITANA;300000;2;1;0;0;0;2;1;300000;LED 43 43P615 ANDROID TV UHD 4K PASSION LINE;ELECTRONICA MAYOR
18110243;;F;34;CHILENO;;Millenial;PENCO;BIO-BIO;290000;2;1;0;0;0;2;1;290000;LED 50 50P615-50P ANDROID TV PASSION LINE UHD 4K;ELECTRONICA MAYOR
4518903;;M;81;CHILENO;;Silencioso;RENCA                         ;METROPOLITANA;243770;3;1;0;0;0;3;1;243770;LED 32 UN32T4300AGXZS HD SMART TV;ELECTRONICA MAYOR
4994528;;F;79;CHILENO;;Silencioso;RENCA                         ;METROPOLITANA;225780;2;1;0;0;0;2;1;225780;LED 40 KEHD4020 SMART TV;ELECTRONICA MAYOR
16272225;;M;36;CHILENO;;Millenial;BUIN                          ;METROPOLITANA;164990;3;1;0;0;0;3;1;164990;MINICOMPONENTE MX-T40/ZS ALL IN ONE;ELECTRONICA MAYOR
18944321;;M;27;CHILENO;;Z;LOS ALAMOS                    ;BIO BIO;149990;1;1;0;0;0;1;1;149990;MINICOMPONENTE MHC-V02 ALL IN ONE;ELECTRONICA MAYOR
26663249;;F;32;VENEZOLANO;;Extranjero;N/D;N/D;434960;4;4;0;0;0;4;4;434960;LED 32LM637B HD SMART;ELECTRONICA MAYOR
20614382;;M;21;CHILENO;;Z;PROVIDENCIA                   ;METROPOLITANA;329980;2;1;2;1;329980;0;0;0;LED 50 UN50TU7090GXZS UHD SMART TV;ELECTRONICA MAYOR
5053351;Casado;M;68;CHILENO;;Boomers;CURICO                        ;MAULE;79990;1;1;0;0;0;1;1;79990;KARAOKE SP-101BT ALL IN ONE PORTATIL 60W;ELECTRONICA MAYOR
15802756;;M;38;CHILENO;;X;SANTA CRUZ                    ;L.G.B.OÂ´HIGGINS;328950;5;2;0;0;0;5;2;328950;MINICOMPONENTE OL45;ELECTRONICA MAYOR
16257343;;F;36;CHILENO;;Millenial;N/D;N/D;414970;3;2;0;0;0;3;2;414970;LED 50 KEUH50 SMART TV UHD;ELECTRONICA MAYOR
8253388;;F;61;CHILENO;;Boomers;PUENTE ALTO                   ;METROPOLITANA;324960;4;3;0;0;0;4;3;324960;LED 43 43UP7500 UHD SMART TV;ELECTRONICA MAYOR
5995380;;F;75;CHILENO;;Silencioso;OVALLE                        ;COQUIMBO;291970;3;1;0;0;0;3;1;291970;LED 43 Full HD Smart TV 43PFD6825;ELECTRONICA MAYOR
18671455;;F;28;CHILENO;;Millenial;N/D;N/D;447970;3;2;2;1;187980;1;1;259990;LED 32 32LM33765 ANDROID SMART TV UHD;ELECTRONICA MAYOR
17772121;;M;32;CHILENO;;Millenial;N/D;N/D;194980;2;1;0;0;0;2;1;194980;PARLANTE MGULTRAEXTREME;ELECTRONICA MAYOR
17003001;;M;33;CHILENO;;Millenial;LA FLORIDA                    ;METROPOLITANA;159990;2;1;2;1;159990;0;0;0;LED 32 UN32T4300AGXZS HD SMART TV;ELECTRONICA MAYOR
19196712;Soltero;F;29;CHILENO;TERAPEUTA OCUPACIONAL;Millenial;PROVIDENCIA                   ;METROPOLITANA;529950;5;3;2;1;139980;3;2;389970;LED 32 UN32T4300AGXZS HD SMART TV;ELECTRONICA MAYOR
18594424;Soltero;M;29;CHILENO;;Millenial;RENCA                         ;METROPOLITANA;389989;1;2;0;0;0;1;2;389989;LED 58 UN58AU7000GXZS UHD 4K SMART TV;ELECTRONICA MAYOR
22859160;Soltero;M;48;PERUANO;;Extranjero;ARICA                         ;ARICA Y PARINACOTA;276980;2;1;0;0;0;2;1;276980;LED 43 Full HD Smart TV 43PFD6825;ELECTRONICA MAYOR
5852881;;M;74;CHILENO;;Silencioso;PROVIDENCIA                   ;METROPOLITANA;433960;4;2;0;0;0;4;2;433960;LED 43 UN43T5202AGXZS FHD SMART TV;ELECTRONICA MAYOR
19603137;;M;25;CHILENO;;Z;PROVIDENCIA                   ;METROPOLITANA;30980;2;1;2;1;30980;0;0;0;MAGIC REMOTE MR21G;ELECTRONICA MAYOR
18470190;;M;29;CHILENO;;Millenial;COIHAIQUE                     ;AYSEN;289990;1;3;1;1;249990;0;2;40000;LED 50 50UP7500 UHD SMART TV;ELECTRONICA MAYOR
17519753;;F;31;CHILENO;;Millenial;PROVIDENCIA                   ;METROPOLITANA;296980;2;1;0;0;0;2;1;296980;LED 50 50P615-50P ANDROID TV PASSION LINE UHD 4K;ELECTRONICA MAYOR
14468256;;M;48;CHILENO;;X;PROVIDENCIA                   ;METROPOLITANA;1055480;11;8;0;0;0;11;8;1055480;LED 65 65P725 ANDROID TV 4K UHD;ELECTRONICA MAYOR
10025479;;M;57;CHILENO;;Boomers;CONSTITUCION                  ;MAULE;299990;1;1;1;1;299990;0;0;0;LED 50 50UP7500 UHD SMART TV;ELECTRONICA MAYOR
17075105;;M;34;CHILENO;;Millenial;PROVIDENCIA                   ;METROPOLITANA;499980;2;2;2;2;499980;0;0;0;LED 50 50PUD7625 SMART TV ULTRA HD 4K;ELECTRONICA MAYOR
12233374;;F;50;CHILENO;;X;CERRO NAVIA;METROPOLITANA;299990;1;1;0;0;0;1;1;299990;LED 50 50UP7500 UHD SMART TV;ELECTRONICA MAYOR
9277828;;F;60;CHILENO;;Boomers;PUYEHUE                       ;LOS LAGOS;465980;3;1;0;0;0;3;1;465980;LED 65 KEUH6521 SMART TV UHD;ELECTRONICA MAYOR
16030834;Soltero;M;37;CHILENO;;Millenial;PROVIDENCIA                   ;METROPOLITANA;181980;2;2;0;0;0;2;2;181980;LED 32 32S5305 HD HDR10/HLG;ELECTRONICA MAYOR
8276478;;F;66;CHILENO;;Boomers;ANCUD                         ;LOS LAGOS;795940;6;1;0;0;0;6;1;795940;LED 58 58PUD7625 BORDES ULTRA DELGADOS 4K UHD;ELECTRONICA MAYOR
7689614;;M;49;CHILENO;;X;ARICA                         ;ARICA Y PARINACOTA;214561;3;2;0;0;0;3;2;214561;PARLANTE MG TWISTER;ELECTRONICA MAYOR
12197909;;F;49;CHILENO;;X;SAN FABIAN                    ;BIO BIO;239970;3;3;0;0;0;3;3;239970;PARLANTE ULTRAMEGA;ELECTRONICA MAYOR
13940591;Casado;M;42;CHILENO;;Silencioso;PROVIDENCIA                   ;METROPOLITANA;30980;2;1;2;1;30980;0;0;0;MAGIC REMOTE MR21G;ELECTRONICA MAYOR
12858664;Casado;M;47;CHILENO;;X;RENCA                         ;METROPOLITANA;509970;3;2;0;0;0;3;2;509970;KARAOKE 15 HEAVY BASS MIC INA CON ATRIL 8892;ELECTRONICA MAYOR
18476512;;M;30;CHILENO;;Millenial;PROVIDENCIA                   ;METROPOLITANA;329990;1;1;0;0;0;1;1;329990;LED 55UP7500 UHD SMART;ELECTRONICA MAYOR
11932074;;M;50;CHILENO;;X;ANTOFAGASTA                   ;ANTOFAGASTA;230000;2;1;0;0;0;2;1;230000;LED 43 UN43T5202AGXZS FHD SMART TV;ELECTRONICA MAYOR
12973978;;F;46;CHILENO;;X;RENCA                         ;METROPOLITANA;408560;3;2;0;0;0;3;2;408560;KARAOKE SP-101BT ALL IN ONE PORTATIL 60W;ELECTRONICA MAYOR
13124000;;F;46;CHILENO;;X;N/D;N/D;1104930;8;5;0;0;0;8;5;1104930;LED KIOTO 32 MI3228 SMART TV;ELECTRONICA MAYOR
15666391;;M;38;CHILENO;;X;N/D;N/D;775920;8;4;0;0;0;8;4;775920;LED 55 55P615 UHD ANDROID TV 4K;ELECTRONICA MAYOR
8759250;;F;62;CHILENO;;Boomers;N/D;N/D;59970;3;3;0;0;0;3;3;59970;PARLANTE KARAOKE 8 MAXEIGHT;ELECTRONICA MAYOR
24869959;;M;36;COLOMBIANO;;Extranjero;SANTIAGO                      ;METROPOLITANA;813950;5;2;0;0;0;5;2;813950;LED 40 UN40T5290AGXZS FHD SMART TV;ELECTRONICA MAYOR
19583443;;M;25;CHILENO;;Z;N/D;N/D;329980;3;2;0;0;0;3;2;329980;PARLANTE ULTRABUZZ;ELECTRONICA MAYOR
10839612;;M;53;CHILENO;;X;CABILDO                       ;VALPARAISO;582960;5;3;0;0;0;5;3;582960;LED 32LM637B HD SMART;ELECTRONICA MAYOR
17185013;Soltero;M;33;CHILENO;;Millenial;PROVIDENCIA                   ;METROPOLITANA;269990;1;1;1;1;269990;0;0;0;LED 50 UN50TU7090GXZS UHD SMART TV;ELECTRONICA MAYOR
10107425;;F;56;CHILENO;;Boomers;MELIPILLA                     ;METROPOLITANA;176920;8;3;0;0;0;8;3;176920;PARLANTE MG TWISTER;ELECTRONICA MAYOR
17822837;;F;31;CHILENO;;Millenial;"";"";153980;3;2;0;0;0;3;2;153980;LED KIOTO 32 MI3228 SMART TV;ELECTRONICA MAYOR
16693138;;F;35;CHILENO;;Millenial;"";"";589990;2;1;2;1;589990;0;0;0;LED 70 UN70AU7000GXZS UHD;ELECTRONICA MAYOR
18830164;;F;28;CHILENO;;Millenial;PROVIDENCIA                   ;METROPOLITANA;201990;2;1;2;1;201990;0;0;0;LED 40 UN40T5290AGXZS FHD SMART TV;ELECTRONICA MAYOR
15757895;;F;38;CHILENO;;Millenial;COIHAIQUE                     ;AYSEN;299980;2;2;0;0;0;2;2;299980;LED 32 UN32T4300AGXZS HD SMART TV;ELECTRONICA MAYOR
11505885;Soltero;M;52;CHILENO;;X;RENCA                         ;METROPOLITANA;179990;2;1;0;0;0;2;1;179990;LED 40 KEHD4020 SMART TV;ELECTRONICA MAYOR
13929923;;F;42;CHILENO;;X;CARTAGENA                     ;VALPARAISO;449980;3;2;2;1;59990;1;1;389990;LED 58 UN58AU7000GXZS UHD 4K SMART TV;ELECTRONICA MAYOR
18901200;;M;31;CHILENO;;Millenial;NUEVA IMPERIAL                ;ARAUCANIA;587980;2;1;0;0;0;2;1;587980;LED 60 UN60AU8000GXZS UHD SMART TV;ELECTRONICA MAYOR
20003772;;F;23;CHILENO;;Z;PROVIDENCIA                   ;METROPOLITANA;41980;2;2;0;0;0;2;2;41980;PARLANTE KARAOKE 8 MAXEIGHT;ELECTRONICA MAYOR
13617251;;F;43;CHILENO;;X;N/D;N/D;24990;1;1;0;0;0;1;1;24990;PARLANTE KARAOKE 8 MAXEIGHT;ELECTRONICA MAYOR
26356635;;F;49;BOLIVIANO;;Extranjero;BUIN                          ;METROPOLITANA;326970;3;2;0;0;0;3;2;326970;LED 40 UN40T5290AGXZS FHD SMART TV;ELECTRONICA MAYOR
11410585;;F;53;CHILENO;;X;RENCA                         ;METROPOLITANA;169990;1;1;0;0;0;1;1;169990;LED 32 UN32T4300AGXZS HD SMART TV;ELECTRONICA MAYOR
9985035;;M;59;CHILENO;;Boomers;PROVIDENCIA                   ;METROPOLITANA;206980;2;1;0;0;0;2;1;206980;PARLANTE MGULTRAEXTREME;ELECTRONICA MAYOR
12266341;;M;50;CHILENO;;X;N/D;N/D;962500;9;4;0;0;0;9;4;962500;LED 50 KEUH50 SMART TV UHD;ELECTRONICA MAYOR
26324864;;M;42;HAITIANO;;Extranjero;CONCEPCION                    ;BIO BIO;241980;2;1;0;0;0;2;1;241980;PARLANTE ULTRASENSATION;ELECTRONICA MAYOR
12834534;;F;49;CHILENO;;X;SANTIAGO                      ;METROPOLITANA;239990;1;1;0;0;0;1;1;239990;LED 50 50PUD7625 SMART TV ULTRA HD 4K;ELECTRONICA MAYOR
11787694;Casado;M;50;CHILENO;;X;RENCA                         ;METROPOLITANA;79990;1;1;0;0;0;1;1;79990;KARAOKE SP-101BT ALL IN ONE PORTATIL 60W;ELECTRONICA MAYOR
16529476;;F;35;CHILENO;;Millenial;LAUTARO                       ;ARAUCANIA;685940;6;3;0;0;0;6;3;685940;LED 43 Full HD Smart TV 43PFD6825;ELECTRONICA MAYOR
17563263;;M;32;CHILENO;;Millenial;N/D;N/D;969940;6;3;2;1;354980;4;2;614960;LED 55 55PUD6794 SMART TV UHD 4K;ELECTRONICA MAYOR
19714721;;M;25;CHILENO;;Z;N/D;N/D;637950;5;3;4;2;597960;1;1;39990;LED 50 UN50TU7090GXZS UHD SMART TV;ELECTRONICA MAYOR
14219967;;M;41;CHILENO;;X;TEMUCO                        ;ARAUCANIA;379990;1;1;0;0;0;1;1;379990;LED 58 UN58AU7000GXZS UHD 4K SMART TV;ELECTRONICA MAYOR
14240455;;M;48;CHILENO;;X;RENCA                         ;METROPOLITANA;269990;2;1;2;1;269990;0;0;0;LED 50 UN50TU7090GXZS UHD SMART TV;ELECTRONICA MAYOR
16853210;;M;35;CHILENO;;Millenial;NACIMIENTO                    ;BIO BIO;539980;2;2;0;0;0;2;2;539980;LED 43 Full HD Smart TV 43PFD6825;ELECTRONICA MAYOR
16470554;;F;35;CHILENO;;Millenial;PROVIDENCIA                   ;METROPOLITANA;309990;2;1;0;0;0;2;1;309990;LED 58 KEUH5821 SMART TV UHD;ELECTRONICA MAYOR
6503062;;M;68;CHILENO;;Silencioso;EL BOSQUE                     ;METROPOLITANA;239990;1;1;0;0;0;1;1;239990;LED 43 UN43TU7090GXZS UHD SMART TV;ELECTRONICA MAYOR
11681834;;F;51;CHILENO;;X;SAN PEDRO DE LA PAZ           ;BIO BIO;89990;1;1;0;0;0;1;1;89990;PARLANTE ULTRAMEGA;ELECTRONICA MAYOR
15747573;;F;38;CHILENO;;Millenial;N/D;N/D;34990;1;1;0;0;0;1;1;34990;KARAOKE FUNKY DISCO;ELECTRONICA MAYOR
7920208;;M;67;CHILENO;;Boomers;RETIRO                        ;MAULE;476970;3;2;0;0;0;3;2;476970;LED 65 KEUH6521 SMART TV UHD;ELECTRONICA MAYOR
16910304;;F;33;CHILENO;;Millenial;PUDAHUEL                      ;METROPOLITANA;209990;2;1;2;1;209990;0;0;0;LED 43 Full HD Smart TV 43PFD6825;ELECTRONICA MAYOR
23304063;Soltero;M;64;SUIZO;;Extranjero;PROVIDENCIA                   ;METROPOLITANA;239990;1;1;0;0;0;1;1;239990;LED 43 UN43TU7090GXZS UHD SMART TV;ELECTRONICA MAYOR
17941306;;F;31;CHILENO;;Millenial;"";"";304980;4;2;0;0;0;4;2;304980;LED 43 43LM6370 SMART TV FHD;ELECTRONICA MAYOR
18772934;;F;28;CHILENO;;Millenial;N/D;N/D;274980;2;2;0;0;0;2;2;274980;PARLANTE ULTRASENSATION;ELECTRONICA MAYOR
15869565;;M;38;CHILENO;;Millenial;COPIAPO                       ;ATACAMA;421970;3;2;3;2;421970;0;0;0;LED 43 43S5305 SMART TV FULL HD;ELECTRONICA MAYOR
26671020;;M;36;VENEZOLANO;;Extranjero;CORONEL                       ;BIO BIO;387980;2;1;0;0;0;2;1;387980;LED 55 UN55TU7090GXZS SMART TV UHD;ELECTRONICA MAYOR
14350119;;M;43;CHILENO;;X;N/D;N/D;219980;2;2;0;0;0;2;2;219980;LED 50 KEUH50 SMART TV UHD;ELECTRONICA MAYOR
19399254;;F;25;CHILENO;;Z;PROVIDENCIA                   ;METROPOLITANA;339990;1;1;1;1;339990;0;0;0;LED 55 UN55TU7090GXZS SMART TV UHD;ELECTRONICA MAYOR
11622784;;F;52;CHILENO;;X;VALPARAISO                    ;VALPARAISO;199990;1;1;0;0;0;1;1;199990;LED 40 UN40T5290AGXZS FHD SMART TV;ELECTRONICA MAYOR
13793556;;F;42;CHILENO;;X;SAN CARLOS                    ;BIO BIO;199990;1;1;0;0;0;1;1;199990;LED 50 KEUH50 SMART TV UHD;ELECTRONICA MAYOR
11199137;;F;55;CHILENO;;Boomers;BUIN                          ;METROPOLITANA;419970;3;1;0;0;0;3;1;419970;LED 65 KEUH6521 SMART TV UHD;ELECTRONICA MAYOR
11892627;;M;51;CHILENO;;X;TALCA                         ;MAULE;44990;1;1;0;0;0;1;1;44990;PARLANTE COBRA;ELECTRONICA MAYOR
18374991;Soltero;F;29;CHILENO;;Millenial;LA PINTANA                    ;METROPOLITANA;242980;2;2;0;0;0;2;2;242980;LED 42 KHFH4221 SMART TV;ELECTRONICA MAYOR
7600581;Soltero;F;70;CHILENO;;Silencioso;PROVIDENCIA                   ;METROPOLITANA;181980;2;1;0;0;0;2;1;181980;LED KIOTO 32 MI3228 SMART TV;ELECTRONICA MAYOR
18818711;;F;27;CHILENO;;Millenial;PROVIDENCIA                   ;METROPOLITANA;514970;3;1;0;0;0;3;1;514970;LED 55 55UP7750 UHD SMART + MAGIC;ELECTRONICA MAYOR
6297035;;M;67;CHILENO;;Boomers;PROVIDENCIA                   ;METROPOLITANA;159980;2;2;0;0;0;2;2;159980;LED KIOTO 32 MI3228 SMART TV;ELECTRONICA MAYOR
18950903;;M;28;CHILENO;;Millenial;CASTRO                        ;LOS LAGOS;119990;1;1;0;0;0;1;1;119990;PARLANTE MEGALUX K2777;ELECTRONICA MAYOR
8595564;;F;58;CHILENO;;Boomers;PAILLACO                      ;LOS RIOS;221970;3;1;0;0;0;3;1;221970;LED 42 KHFH4221 SMART TV;ELECTRONICA MAYOR
19780483;;M;23;CHILENO;;Z;PROVIDENCIA                   ;METROPOLITANA;93980;2;1;2;1;93980;0;0;0;PARLANTE ULTRAMEGA;ELECTRONICA MAYOR
17451014;;M;32;CHILENO;;Millenial;"";"";135840;2;1;2;1;135840;0;0;0;LED 32 CS32S1 SMART TV HD NEGRO;ELECTRONICA MAYOR
12429749;;F;49;CHILENO;;X;PELARCO                       ;MAULE;339240;5;3;0;0;0;5;3;339240;KARAOKE STREET SONG 4 MICÂ CABLEÂ BLACK 8900;ELECTRONICA MAYOR
15227232;;M;40;CHILENO;;X;COLLIPULLI                    ;ARAUCANIA;179990;1;1;0;0;0;1;1;179990;LED 32LM637B HD SMART;ELECTRONICA MAYOR
13277613;;F;45;CHILENO;;X;PROVIDENCIA                   ;METROPOLITANA;119990;1;1;0;0;0;1;1;119990;PARLANTE MEGALUX K2777;ELECTRONICA MAYOR
17488518;;F;31;CHILENO;;Millenial;PROVIDENCIA                   ;METROPOLITANA;463980;2;1;2;1;463980;0;0;0;LED 60 UN60AU8000GXZS UHD SMART TV;ELECTRONICA MAYOR
9720569;;F;60;CHILENO;;Boomers;CONCEPCION                    ;BIO BIO;154960;4;2;0;0;0;4;2;154960;SOUNDBAR XTS-801 Negro 40W;ELECTRONICA MAYOR
11362062;;F;52;CHILENO;;X;MELIPILLA                     ;METROPOLITANA;290970;3;2;0;0;0;3;2;290970;LED KIOTO 32 MI3228 SMART TV;ELECTRONICA MAYOR
17446014;;M;32;CHILENO;;Millenial;TEODORO SCHMIDT               ;ARAUCANIA;69990;1;1;0;0;0;1;1;69990;PARLANTE SENSEIGTH K3175;ELECTRONICA MAYOR
17557811;Casado;F;32;CHILENO;PROFESOR;Millenial;PROVIDENCIA                   ;METROPOLITANA;189990;1;1;0;0;0;1;1;189990;LED 40 KEHD4020 SMART TV;ELECTRONICA MAYOR
13561282;;M;43;CHILENO;;X;PICHIDEGUA                    ;L.G.B.OÂ´HIGGINS;396950;5;4;0;0;0;5;4;396950;KARAOKE PORTATIL TWO-EIGHT 8860;ELECTRONICA MAYOR
9792067;;F;63;CHILENO;;Boomers;PEDRO AGUIRRE CERDA           ;METROPOLITANA;208950;5;3;0;0;0;5;3;208950;KARAOKE STREET SONG 4 MICÂ CABLEÂ BLACK 8900;ELECTRONICA MAYOR
10314527;;F;46;CHILENO;;X;VALPARAISO                    ;VALPARAISO;274980;2;1;2;1;274980;0;0;0;LED 43 UN43T5202AGXZS FHD SMART TV;ELECTRONICA MAYOR
19467323;;M;26;CHILENO;;Z;"";"";205980;2;1;0;0;0;2;1;205980;PARLANTE ULTRAFORCE-I;ELECTRONICA MAYOR
13437789;;F;44;CHILENO;;X;"";"";309990;1;1;0;0;0;1;1;309990;LED 55 55P615 UHD ANDROID TV 4K;ELECTRONICA MAYOR
10491597;;M;41;CHILENO;;X;"";"";169470;3;2;0;0;0;3;2;169470;KARAOKE RHYTHM CHARGER 12 MIC CABLE 8890;ELECTRONICA MAYOR
7357232;;F;66;CHILENO;;Boomers;SALAMANCA                     ;COQUIMBO;259990;1;1;0;0;0;1;1;259990;LED 50 50PUD7625 SMART TV ULTRA HD 4K;ELECTRONICA MAYOR
13445407;;M;44;CHILENO;;X;"";"";139990;1;1;0;0;0;1;1;139990;LED KIOTO 32 MI3228 SMART TV;ELECTRONICA MAYOR
15685384;;M;38;CHILENO;;X;PROVIDENCIA                   ;METROPOLITANA;464980;2;1;2;1;464980;0;0;0;LED 60 UN60AU8000GXZS UHD SMART TV;ELECTRONICA MAYOR
15045342;;M;40;CHILENO;;X;N/D;N/D;357540;2;1;2;1;357540;0;0;0;QLED FRAME 32 QN32LS03TBGXZS FHD SMART TV;ELECTRONICA MAYOR
17369190;;F;32;CHILENO;;Millenial;ARICA                         ;TARAPACA;279070;4;1;4;1;279070;0;0;0;LED 43 Full HD Smart TV 43PFD6825;ELECTRONICA MAYOR
18312828;;M;29;CHILENO;;Millenial;ARICA                         ;ARICA Y PARINACOTA;419990;1;1;0;0;0;1;1;419990;LED 65 KEUH6521 SMART TV UHD;ELECTRONICA MAYOR
16752182;Soltero;M;34;CHILENO;TECNICO AGRICOLA;Millenial;PUNTA ARENAS                  ;MAGALLANES;189990;1;1;0;0;0;1;1;189990;LED 32 UN32T4300AGXZS HD SMART TV;ELECTRONICA MAYOR
26602624;;F;64;VENEZOLANO;;Extranjero;TEMUCO                        ;ARAUCANIA;518960;4;2;0;0;0;4;2;518960;LED 55 NanoCell 55NANO75 UHD SMART + MAGIC;ELECTRONICA MAYOR
7645296;;F;63;CHILENO;;Boomers;LAMPA                         ;METROPOLITANA;194980;2;1;0;0;0;2;1;194980;LED 40 KEHD4020 SMART TV;ELECTRONICA MAYOR
7920630;;F;64;CHILENO;;Boomers;LA LIGUA                      ;VALPARAISO;286980;2;1;0;0;0;2;1;286980;LED 40 UN40T5290AGXZS FHD SMART TV;ELECTRONICA MAYOR
12034171;;M;53;CHILENO;;X;RENGO                         ;L.G.B.OÂ´HIGGINS;753950;5;3;0;0;0;5;3;753950;LED 55UP7500 UHD SMART;ELECTRONICA MAYOR
6668869;;M;68;CHILENO;;Silencioso;RENCA                         ;METROPOLITANA;139990;1;1;0;0;0;1;1;139990;MONITOR 24 24TL520S SMART TV HD;ELECTRONICA MAYOR
14236210;;M;49;CHILENO;;X;LO PRADO                      ;METROPOLITANA;139990;1;1;0;0;0;1;1;139990;LED KIOTO 32 MI3228 SMART TV;ELECTRONICA MAYOR
15285982;;F;28;CHILENO;;Millenial;PROVIDENCIA                   ;METROPOLITANA;268540;2;1;2;1;268540;0;0;0;LED 50 KEUH50 SMART TV UHD;ELECTRONICA MAYOR
8936757;Casado;M;61;CHILENO;CIRUJANO DENTISTA;Boomers;PROVIDENCIA                   ;METROPOLITANA;339990;1;1;0;0;0;1;1;339990;LED 50 UN50TU7090GXZS UHD SMART TV;ELECTRONICA MAYOR
6821510;Casado;M;70;CHILENO;;Silencioso;COLLIPULLI                    ;ARAUCANIA;44990;1;1;0;0;0;1;1;44990;PARLANTE SPBYF7 PORTATIL;ELECTRONICA MAYOR
6443713;;F;70;CHILENO;;Silencioso;PANQUEHUE                     ;VALPARAISO;64980;2;1;0;0;0;2;1;64980;PARLANTE KARAOKE PINGUINO PORTATIL NEGRO;ELECTRONICA MAYOR
12769377;;M;47;CHILENO;;Millenial;N/D;N/D;99370;2;1;0;0;0;2;1;99370;PARLANTE SENSEIGTH K3175;ELECTRONICA MAYOR
5873286;;F;76;CHILENO;;Silencioso;N/D;N/D;134990;1;1;0;0;0;1;1;134990;MONITOR 24 24TL520S SMART TV HD;ELECTRONICA MAYOR
15477447;Soltero;M;39;CHILENO;;X;PROVIDENCIA                   ;METROPOLITANA;139990;1;1;0;0;0;1;1;139990;PARLANTE KARAOKE MGLIGHTNING NEGRO;ELECTRONICA MAYOR
10990696;;F;40;CHILENO;;X;N/D;N/D;305362;4;2;0;0;0;4;2;305362;LED 40 UN40T5290AGXZS FHD SMART TV;ELECTRONICA MAYOR
9192723;;F;64;CHILENO;;Boomers;LA PINTANA                    ;METROPOLITANA;169990;1;1;0;0;0;1;1;169990;LED 32 UN32T4300AGXZS HD SMART TV;ELECTRONICA MAYOR
8947398;;F;63;CHILENO;;Silencioso;PROVIDENCIA                   ;METROPOLITANA;215980;2;1;0;0;0;2;1;215980;PARLANTE ULTRAFORCE-I;ELECTRONICA MAYOR
18422878;;F;29;CHILENO;;Millenial;OVALLE                        ;COQUIMBO;1878940;11;2;4;1;460510;7;1;1418430;OLED 55C1 UHD SMART + MAGIC;ELECTRONICA MAYOR
17323924;;F;32;CHILENO;;Millenial;SAN JAVIER                    ;MAULE;287980;2;1;0;0;0;2;1;287980;LED 43 43LM6370 SMART TV FHD;ELECTRONICA MAYOR
12067528;;F;53;CHILENO;;X;CORONEL                       ;BIO BIO;504960;4;2;0;0;0;4;2;504960;LED 58 58PUD7625 BORDES ULTRA DELGADOS 4K UHD;ELECTRONICA MAYOR
13627649;;M;43;CHILENO;;X;CANETE                        ;BIO BIO;99990;1;1;0;0;0;1;1;99990;PARLANTE ULTRAMAGIC;ELECTRONICA MAYOR
13255209;;F;46;CHILENO;;X;SAN RAMON                     ;METROPOLITANA;359990;1;1;0;0;0;1;1;359990;LED 55UP7500 UHD SMART;ELECTRONICA MAYOR
17717310;Soltero;M;31;CHILENO;;Millenial;PROVIDENCIA                   ;METROPOLITANA;139990;1;1;0;0;0;1;1;139990;LED 32 KHHD3221 SMART TV;ELECTRONICA MAYOR
8705713;;F;60;CHILENO;;Boomers;SAN JAVIER                    ;MAULE;188630;6;4;0;0;0;6;4;188630;PARLANTE KARAOKE 8 MAXEIGHT;ELECTRONICA MAYOR
17135870;Soltero;F;33;CHILENO;PROFESOR;Millenial;PROVIDENCIA                   ;METROPOLITANA;172574;3;2;0;0;0;3;2;172574;LED 32 32PHD6825 HD SMART TV;ELECTRONICA MAYOR
7240811;;M;67;CHILENO;;Boomers;OVALLE                        ;COQUIMBO;24990;1;1;0;0;0;1;1;24990;KARAOKE STREET SONG 4 MICÂ CABLEÂ BLACK 8900;ELECTRONICA MAYOR
14557245;;M;48;CHILENO;;X;PADRE LAS CASAS               ;ARAUCANIA;202970;3;1;0;0;0;3;1;202970;MINICOMPONENTE OL45;ELECTRONICA MAYOR
15818521;Soltero;F;38;CHILENO;;Millenial;PROVIDENCIA                   ;METROPOLITANA;149990;1;1;0;0;0;1;1;149990;PARLANTE ULTRAFUSION;ELECTRONICA MAYOR
16203352;;F;36;CHILENO;;Millenial;IQUIQUE                       ;TARAPACA;139990;1;1;0;0;0;1;1;139990;LED KIOTO 32 MI3228 SMART TV;ELECTRONICA MAYOR
11222011;Casado;F;53;CHILENO;;X;SAN FELIPE                    ;VALPARAISO;77980;2;1;0;0;0;2;1;77980;PARLANTE KARAOKE 12 FM/BT/USB;ELECTRONICA MAYOR
18745665;;F;27;CHILENO;;Millenial;LOTA                          ;BIO BIO;199990;1;1;0;0;0;1;1;199990;LED 43 43S5305 SMART TV FULL HD;ELECTRONICA MAYOR
13746929;;M;42;CHILENO;;X;OVALLE                        ;COQUIMBO;259990;1;3;0;0;0;1;3;259990;LED 50 KEUH50 SMART TV UHD;ELECTRONICA MAYOR
26655907;Casado;F;30;NO INFORMA NACIONALIDAD;;Extranjero;SAN FERNANDO                  ;L.G.B.OÂ´HIGGINS;44990;1;1;0;0;0;1;1;44990;PARLANTE KARAOKE 12 FM/BT/USB;ELECTRONICA MAYOR
15423211;;F;41;CHILENO;;X;ESTACION CENTRAL              ;METROPOLITANA;760880;12;4;2;1;99980;10;3;660900;LED 43 Full HD Smart TV 43PFD6825;ELECTRONICA MAYOR
9164185;;M;59;CHILENO;;Boomers;PUERTO MONTT                  ;LOS LAGOS;215980;2;1;0;0;0;2;1;215980;PARLANTE ULTRAFORCE-I;ELECTRONICA MAYOR
8753290;;M;61;CHILENO;;Boomers;RENCA                         ;METROPOLITANA;479970;3;1;0;0;0;3;1;479970;LED 58 58PUD7625 BORDES ULTRA DELGADOS 4K UHD;ELECTRONICA MAYOR
12127100;;F;58;CHILENO;;Boomers;LA SERENA                     ;COQUIMBO;34990;1;1;0;0;0;1;1;34990;KARAOKE TOWER OUTDOOR POWER MIC BT BK 8571;ELECTRONICA MAYOR
7818787;;F;62;CHILENO;;Boomers;RECOLETA                      ;METROPOLITANA;295970;3;1;0;0;0;3;1;295970;LED 50 KHUH5021 SMART TV;ELECTRONICA MAYOR
8888221;;F;63;CHILENO;;Boomers;PINTO                         ;BIO BIO;114980;2;2;0;0;0;2;2;114980;PARLANTE COBRA;ELECTRONICA MAYOR
9515782;;M;59;CHILENO;;Boomers;N/D;N/D;469960;4;2;0;0;0;4;2;469960;PARLANTE ULTRAFUSION;ELECTRONICA MAYOR
13695919;;M;42;CHILENO;;X;QUILACO                       ;BIO BIO;309990;2;1;0;0;0;2;1;309990;LED 50 50PUD7625 SMART TV ULTRA HD 4K;ELECTRONICA MAYOR
10459182;;M;55;CHILENO;;Boomers;HUECHURABA                    ;METROPOLITANA;329970;3;2;0;0;0;3;2;329970;PARLANTE ULTRAFORCE-I;ELECTRONICA MAYOR
11311466;Soltero;F;54;CHILENO;;X;PROVIDENCIA                   ;METROPOLITANA;39990;1;1;0;0;0;1;1;39990;PARLANTE SPBYF7 PORTATIL;ELECTRONICA MAYOR
13400254;;F;47;CHILENO;;X;PROVIDENCIA                   ;METROPOLITANA;39980;2;1;0;0;0;2;1;39980;PARLANTE KARAOKE 8 MAXEIGHT;ELECTRONICA MAYOR
19537158;;F;25;CHILENO;;Z;OSORNO                        ;LOS LAGOS;179990;1;1;0;0;0;1;1;179990;PARLANTE ULTRAFORCE-I;ELECTRONICA MAYOR
10418873;;F;57;CHILENO;;Boomers;VICTORIA                      ;ARAUCANIA;197970;4;2;0;0;0;4;2;197970;LED 32 KHHD3221 SMART TV;ELECTRONICA MAYOR
11388141;;F;53;CHILENO;;X;N/D;N/D;235980;2;1;0;0;0;2;1;235980;PARLANTE ULTRAFORCE-I;ELECTRONICA MAYOR
16563266;;F;35;CHILENO;;Millenial;VALDIVIA                      ;LOS LAGOS;44990;1;1;0;0;0;1;1;44990;PARLANTE COBRA;ELECTRONICA MAYOR
15046613;;F;40;CHILENO;;X;SALAMANCA                     ;COQUIMBO;399980;3;2;0;0;0;3;2;399980;LED 50 50PUD7625 SMART TV ULTRA HD 4K;ELECTRONICA MAYOR
10186442;;M;58;CHILENO;;Boomers;PUERTO MONTT                  ;LOS LAGOS;254980;2;2;0;0;0;2;2;254980;LED 43 Full HD Smart TV 43PFD6825;ELECTRONICA MAYOR
18939336;;F;27;CHILENO;;Millenial;"";"";716940;6;4;2;1;123980;4;3;592960;LED 32 32S5295 SMART TV HD;ELECTRONICA MAYOR
16573842;;M;35;CHILENO;;Millenial;CABILDO                       ;VALPARAISO;179990;1;1;0;0;0;1;1;179990;PARLANTE ULTRAFORCE-I;ELECTRONICA MAYOR
15827482;;F;43;CHILENO;;X;PADRE LAS CASAS               ;ARAUCANIA;19990;1;1;0;0;0;1;1;19990;PARLANTE MG TWISTER;ELECTRONICA MAYOR
12470046;;M;48;CHILENO;;X;PROVIDENCIA                   ;METROPOLITANA;209990;2;1;2;1;209990;0;0;0;LED 40 UN40T5290AGXZS FHD SMART TV;ELECTRONICA MAYOR
19470649;;M;25;CHILENO;;Z;VILLA ALEMANA                 ;VALPARAISO;0;0;2;0;0;0;0;2;0;KARAOKE STREET SONG 4 MICÂ CABLEÂ BLACK 8900;ELECTRONICA MAYOR
18999979;;F;27;CHILENO;;Millenial;ANGOL;ARAUCANIA;199990;1;1;0;0;0;1;1;199990;PARLANTE ULTRAFORCE-I;ELECTRONICA MAYOR
13388756;;F;44;CHILENO;;Silencioso;PROVIDENCIA                   ;METROPOLITANA;481680;4;2;4;2;481680;0;0;0;LED 40 UN40T5290AGXZS FHD SMART TV;ELECTRONICA MAYOR
12543911;;F;49;CHILENO;;X;MAULE                         ;MAULE;213980;2;2;0;0;0;2;2;213980;PARLANTE ULTRASENSATION;ELECTRONICA MAYOR
16340694;;F;35;CHILENO;;Millenial;PENAFLOR                      ;METROPOLITANA;389980;2;1;0;0;0;2;1;389980;LED 43 Full HD Smart TV 43PFD6825;ELECTRONICA MAYOR
14600155;;M;43;CHILENO;;X;PENAFLOR                      ;METROPOLITANA;494960;4;2;0;0;0;4;2;494960;LED 40 40S65A-40P ANDROID TV SMART LINE FHD;ELECTRONICA MAYOR
14488484;;F;47;CHILENO;;X;N/D;N/D;410970;4;1;0;0;0;4;1;410970;LED 40 UN40T5290AGXZS FHD SMART TV;ELECTRONICA MAYOR
7929671;;F;78;CHILENO;;Silencioso;RENCA                         ;METROPOLITANA;314570;2;1;0;0;0;2;1;314570;LED 43 UN43TU7090GXZS UHD SMART TV;ELECTRONICA MAYOR
19830249;;F;24;CHILENO;;Z;EL BOSQUE                     ;METROPOLITANA;129990;1;1;0;0;0;1;1;129990;PARLANTE ULTRAMAGIC;ELECTRONICA MAYOR
6578909;;F;76;CHILENO;;Silencioso;RANCAGUA                      ;L.G.B.OÂ´HIGGINS;349980;2;1;0;0;0;2;1;349980;LED 55 UN55TU7090GXZS SMART TV UHD;ELECTRONICA MAYOR
18838210;;M;28;CHILENO;;Silencioso;PROVIDENCIA                   ;METROPOLITANA;119990;1;1;0;0;0;1;1;119990;PARLANTE MEGALUX K2777;ELECTRONICA MAYOR
11142635;Soltero;F;55;CHILENO;;Boomers;RANCAGUA                      ;L.G.B.OÂ´HIGGINS;327980;2;1;0;0;0;2;1;327980;LED 43 43UP7500 UHD SMART TV;ELECTRONICA MAYOR
15904499;;M;37;CHILENO;;Millenial;CALBUCO                       ;LOS LAGOS;152980;2;1;0;0;0;2;1;152980;PARLANTE ULTRAMAGIC;ELECTRONICA MAYOR
10079518;;F;57;CHILENO;;Boomers;COIHAIQUE                     ;AYSEN;284960;4;3;0;0;0;4;3;284960;PARLANTE KARAOKE 8 MAXEIGHT;ELECTRONICA MAYOR
11561121;Casado;F;52;CHILENO;;X;CONSTITUCION                  ;MAULE;285950;5;3;0;0;0;5;3;285950;PARLANTE ULTRAMAGIC;ELECTRONICA MAYOR
15341269;;F;39;CHILENO;;X;LOS ANGELES                   ;BIO BIO;44990;1;1;0;0;0;1;1;44990;KARAOKE PORTATIL TWO-EIGHT 8860;ELECTRONICA MAYOR
12352289;Divorciado;F;48;CHILENO;;X;RENCA                         ;METROPOLITANA;214980;2;1;2;1;214980;0;0;0;LED 40 UN40T5290AGXZS FHD SMART TV;ELECTRONICA MAYOR
6396868;;M;70;CHILENO;;Silencioso;VALDIVIA                      ;LOS RIOS;690460;4;3;0;0;0;4;3;690460;LED KIOTO 32 MI3228 SMART TV;ELECTRONICA MAYOR
9886021;;M;59;CHILENO;;Boomers;MAIPU                         ;METROPOLITANA;169990;1;1;0;0;0;1;1;169990;LED 32 UN32T4300AGXZS HD SMART TV;ELECTRONICA MAYOR
26892582;;F;30;VENEZOLANO;;Extranjero;N/D;N/D;189990;1;1;1;1;189990;0;0;0;LED 43 Full HD Smart TV 43PFD6825;ELECTRONICA MAYOR
17765331;;M;30;CHILENO;;Millenial;GORBEA;ARAUCANIA;79990;1;1;0;0;0;1;1;79990;SOUNDBAR HW-T400/ZS;ELECTRONICA MAYOR
13364605;;F;47;CHILENO;;X;LOS ANDES                     ;VALPARAISO;322970;3;3;1;1;109990;2;2;212980;LED 40 UN40T5290AGXZS FHD SMART TV;ELECTRONICA MAYOR
9735564;;M;59;CHILENO;;Boomers;LINARES                       ;MAULE;417980;2;2;0;0;0;2;2;417980;LED 58 UN58AU7000GXZS UHD 4K SMART TV;ELECTRONICA MAYOR
11426288;;M;52;CHILENO;;X;ANCUD                         ;LOS LAGOS;528950;6;2;0;0;0;6;2;528950;LED 50 50PUD7625 SMART TV ULTRA HD 4K;ELECTRONICA MAYOR
20028567;;F;23;CHILENO;;Z;N/D;N/D;47990;1;1;0;0;0;1;1;47990;PARLANTE COBRA;ELECTRONICA MAYOR
18422906;Soltero;M;29;CHILENO;;Millenial;PROVIDENCIA                   ;METROPOLITANA;259990;2;1;2;1;259990;0;0;0;LED 43 UN43TU7090GXZS UHD SMART TV;ELECTRONICA MAYOR
12193978;;M;50;CHILENO;;X;TEMUCO                        ;ARAUCANIA;157980;2;1;0;0;0;2;1;157980;PARLANTE MEGALUX K2777;ELECTRONICA MAYOR
14318829;;M;48;CHILENO;;X;SAN BERNARDO                  ;METROPOLITANA;22990;1;1;0;0;0;1;1;22990;KARAOKE STREET SONG 4 MICÂ CABLEÂ BLACK 8900;ELECTRONICA MAYOR
9368955;;F;61;CHILENO;;Boomers;SANTA CRUZ                    ;L.G.B.OÂ´HIGGINS;139990;1;1;0;0;0;1;1;139990;LED KIOTO 32 MI3228 SMART TV;ELECTRONICA MAYOR
17986232;;M;30;CHILENO;;Millenial;PROVIDENCIA                   ;METROPOLITANA;69990;1;1;0;0;0;1;1;69990;PARLANTE COBRA;ELECTRONICA MAYOR
12584153;;F;48;CHILENO;;X;MELIPILLA                     ;METROPOLITANA;820410;2;1;0;0;0;2;1;820410;LED 65 UN65AU7000GXZS UHD 4K SMART TV;ELECTRONICA MAYOR
18352897;;M;29;CHILENO;;Millenial;MONTE PATRIA                  ;COQUIMBO;44990;1;1;0;0;0;1;1;44990;KARAOKE RHYTHM CHARGER 12 MIC CABLE 8890;ELECTRONICA MAYOR
13660372;;F;43;CHILENO;;X;N/D;N/D;3483330;21;1;0;0;0;21;1;3483330;LED 58 UN58AU7000GXZS UHD 4K SMART TV;ELECTRONICA MAYOR
14542991;;F;45;CHILENO;;X;PROVIDENCIA                   ;METROPOLITANA;119990;1;2;0;0;0;1;2;119990;PARLANTE ULTRAFUSION;ELECTRONICA MAYOR
19215653;;M;25;CHILENO;;Z;PERALILLO                     ;L.G.B.OÂ´HIGGINS;635920;6;3;0;0;0;6;3;635920;LED 40 UN40T5290AGXZS FHD SMART TV;ELECTRONICA MAYOR
18982869;;M;27;CHILENO;;Z;SAN JAVIER                    ;MAULE;362970;3;5;3;3;529970;0;2;-167000;LED 40 KEHD4020 SMART TV;ELECTRONICA MAYOR
19506636;;F;25;CHILENO;;Z;PROVIDENCIA                   ;METROPOLITANA;187540;2;1;2;1;187540;0;0;0;LED 42 KHFH4221 SMART TV;ELECTRONICA MAYOR
20165987;;M;27;CHILENO;;Millenial;PROVIDENCIA                   ;METROPOLITANA;449970;4;2;4;2;449970;0;0;0;LED 43 Full HD Smart TV 43PFD6825;ELECTRONICA MAYOR
9506007;;F;60;CHILENO;;Boomers;SAN PEDRO                     ;METROPOLITANA;329990;1;1;0;0;0;1;1;329990;LED 50 UN50TU7090GXZS UHD SMART TV;ELECTRONICA MAYOR
7978429;;F;60;CHILENO;;Boomers;QUILPUE                       ;VALPARAISO;846470;6;2;0;0;0;6;2;846470;LED 50 50UP7500 UHD SMART TV;ELECTRONICA MAYOR
18512861;;F;29;CHILENO;;Millenial;LA PINTANA                    ;METROPOLITANA;381960;4;2;3;1;363970;1;1;17990;LED 32LM637B HD SMART;ELECTRONICA MAYOR
10379451;;M;57;CHILENO;;Boomers;TALCAHUANO                    ;BIO BIO;239990;1;1;0;0;0;1;1;239990;LED 40 UN40T5290AGXZS FHD SMART TV;ELECTRONICA MAYOR
8226864;;F;61;CHILENO;;Boomers;SAN VICENTE                   ;L.G.B.OÂ´HIGGINS;279990;1;1;0;0;0;1;1;279990;LED 43 43UP7500 UHD SMART TV;ELECTRONICA MAYOR
15961520;;M;37;CHILENO;;Millenial;N/D;N/D;323219;3;1;0;0;0;3;1;323219;LED 43 UN43TU7090GXZS UHD SMART TV;ELECTRONICA MAYOR
11991375;Casado;M;49;CHILENO;;X;RENCA                         ;METROPOLITANA;229990;1;1;0;0;0;1;1;229990;LED 40 UN40T5290AGXZS FHD SMART TV;ELECTRONICA MAYOR
19922356;;F;24;CHILENO;;Z;PROVIDENCIA                   ;METROPOLITANA;741950;5;3;5;3;741950;0;0;0;LED 42 KHFH4221 SMART TV;ELECTRONICA MAYOR
22621633;;F;56;COLOMBIANO;;Extranjero;VALLENAR;ATACAMA;349990;1;1;0;0;0;1;1;349990;LED 58 58PUD7625 BORDES ULTRA DELGADOS 4K UHD;ELECTRONICA MAYOR
6659775;;M;68;CHILENO;;Boomers;"";"";767860;3;3;0;0;0;3;3;767860;LED 70 UN70AU7000GXZS UHD;ELECTRONICA MAYOR
19713124;;F;24;CHILENO;;Z;N/D;N/D;19990;1;1;0;0;0;1;1;19990;KARAOKE STREET SONG 4 MICÂ CABLEÂ BLACK 8900;ELECTRONICA MAYOR
16128338;;F;36;CHILENO;;Millenial;"";"";129990;2;1;2;1;129990;0;0;0;LED 32 KHHD3221 SMART TV;ELECTRONICA MAYOR
13375630;;M;44;CHILENO;;X;PUENTE ALTO                   ;METROPOLITANA;159990;1;1;0;0;0;1;1;159990;MONITOR 24 24TL520S SMART TV HD;ELECTRONICA MAYOR
10455684;;F;54;CHILENO;;X;CONSTITUCION                  ;MAULE;162470;2;1;0;0;0;2;1;162470;PARLANTE ULTRAFUSION;ELECTRONICA MAYOR
16140063;;M;36;CHILENO;;Millenial;N/D;N/D;539970;3;2;0;0;0;3;2;539970;LED 32 UN32T4300AGXZS HD SMART TV;ELECTRONICA MAYOR
26168977;;M;31;VENEZOLANO;;Extranjero;N/D;N/D;199990;1;3;0;0;0;1;3;199990;LED 40 UN40T5290AGXZS FHD SMART TV;ELECTRONICA MAYOR
5584652;;F;71;CHILENO;;Silencioso;N/D;N/D;983820;10;5;0;0;0;10;5;983820;LED 42 KHFH4221 SMART TV;ELECTRONICA MAYOR
18003541;;F;30;CHILENO;;Millenial;N/D;N/D;385980;2;1;2;1;385980;0;0;0;LED 55UP7500 UHD SMART;ELECTRONICA MAYOR
11471487;;F;52;CHILENO;;X;COQUIMBO                      ;COQUIMBO;34990;1;1;0;0;0;1;1;34990;MLAB KARAOKE 8 CITY SET MICROFONO INALAMBRICO AT;ELECTRONICA MAYOR
19614298;;M;24;CHILENO;;Z;PROVIDENCIA                   ;METROPOLITANA;144980;2;1;2;1;144980;0;0;0;LED 32 CS32S1 SMART TV HD NEGRO;ELECTRONICA MAYOR
23766105;;F;39;PERUANO;;Extranjero;RECOLETA                      ;METROPOLITANA;194980;2;1;0;0;0;2;1;194980;LED 42 KHFH4221 SMART TV;ELECTRONICA MAYOR
10652745;;F;50;CHILENO;;X;VILLA ALEMANA                 ;VALPARAISO;389990;1;1;0;0;0;1;1;389990;LED 55 UN55TU7090GXZS SMART TV UHD;ELECTRONICA MAYOR
18684168;;F;28;CHILENO;;Millenial;PROVIDENCIA                   ;METROPOLITANA;50840;2;1;2;1;50840;0;0;0;KARAOKE PORTATIL TWO-EIGHT 8860;ELECTRONICA MAYOR
15193445;;M;39;CHILENO;;X;LOTA;BIO-BIO;33990;1;1;0;0;0;1;1;33990;SOUNDBAR HW-R450/ZS;ELECTRONICA MAYOR
12863753;;M;47;CHILENO;;X;SANTIAGO                      ;METROPOLITANA;133980;2;1;2;1;133980;0;0;0;MINICOMPONENTE CJ45;ELECTRONICA MAYOR
9925090;;F;56;CHILENO;;Boomers;N/D;N/D;2629940;19;2;0;0;0;19;2;2629940;LED 55 UN55TU7090GXZS SMART TV UHD;ELECTRONICA MAYOR
12817772;;M;46;CHILENO;;X;LOS ANDES                     ;VALPARAISO;351870;2;1;0;0;0;2;1;351870;LED 43 UN43TU7090GXZS UHD SMART TV;ELECTRONICA MAYOR
9135790;;F;59;CHILENO;;Boomers;SAN RAFAEL                    ;MAULE;175480;2;1;2;1;175480;0;0;0;LED 42 KHFH4221 SMART TV;ELECTRONICA MAYOR
17817026;;M;30;CHILENO;;Millenial;SAN ANTONIO                   ;VALPARAISO;267980;2;2;0;0;0;2;2;267980;LED 40 UN40T5290AGXZS FHD SMART TV;ELECTRONICA MAYOR
17078887;;M;33;CHILENO;;Extranjero;MELIPILLA                     ;METROPOLITANA;139990;1;1;0;0;0;1;1;139990;LED 32 KHHD3221 SMART TV;ELECTRONICA MAYOR
12963063;;M;46;CHILENO;;X;N/D;N/D;422968;3;1;0;0;0;3;1;422968;LED 43 UN43TU7090GXZS UHD SMART TV;ELECTRONICA MAYOR
15357805;;M;39;CHILENO;;Silencioso;PROVIDENCIA                   ;METROPOLITANA;193980;2;1;2;1;193980;0;0;0;LED 32LM637B HD SMART;ELECTRONICA MAYOR
6684713;;M;71;CHILENO;;Silencioso;VICTORIA                      ;ARAUCANIA;354980;2;2;0;0;0;2;2;354980;LED 50 50UP7500 UHD SMART TV;ELECTRONICA MAYOR
8485335;Soltero;M;60;CHILENO;;Boomers;RENCA                         ;METROPOLITANA;273790;4;1;0;0;0;4;1;273790;LED 32 UN32T4300AGXZS HD SMART TV;ELECTRONICA MAYOR
18959060;;F;27;CHILENO;;Millenial;VILLARICA                     ;ARAUCANIA;610150;3;1;0;0;0;3;1;610150;LED 60UP7750 UHD SMART + MAGIC;ELECTRONICA MAYOR
18885038;;M;27;CHILENO;;Z;SAN PABLO                     ;LOS LAGOS;381760;3;1;0;0;0;3;1;381760;LED 50 50UP7500 UHD SMART TV;ELECTRONICA MAYOR
9710217;;F;60;CHILENO;;Boomers;CHANCO                        ;MAULE;197870;2;1;0;0;0;2;1;197870;LED KIOTO 32 MI3228 SMART TV;ELECTRONICA MAYOR
8700129;;F;65;CHILENO;;Boomers;COLLIPULLI                    ;ARAUCANIA;178980;2;1;0;0;0;2;1;178980;MONITOR 24 24TL520S SMART TV HD;ELECTRONICA MAYOR
17130160;;M;33;CHILENO;;Millenial;PROVIDENCIA                   ;METROPOLITANA;771680;3;1;3;1;771680;0;0;0;LED 55 UN55TU7090GXZS SMART TV UHD;ELECTRONICA MAYOR
13757731;;M;41;CHILENO;;Millenial;N/D;N/D;585060;3;1;0;0;0;3;1;585060;LED 65 UN65AU7000GXZS UHD 4K SMART TV;ELECTRONICA MAYOR
16567121;;F;35;CHILENO;;Millenial;LA PINTANA                    ;METROPOLITANA;126770;2;1;0;0;0;2;1;126770;SOUNDBAR SK1;ELECTRONICA MAYOR
14010543;;F;41;CHILENO;;X;N/D;N/D;167970;3;1;0;0;0;3;1;167970;LED 32 KHHD3221 SMART TV;ELECTRONICA MAYOR
6869095;;M;69;CHILENO;;Silencioso;LA CISTERNA                   ;METROPOLITANA;446170;2;1;0;0;0;2;1;446170;LED 50 50UP7500 UHD SMART TV;ELECTRONICA MAYOR
14246032;Casado;F;48;CHILENO;;X;N/D;N/D;255960;4;2;0;0;0;4;2;255960;LED 32 KHHD3221 SMART TV;ELECTRONICA MAYOR
10379000;Casado;F;54;CHILENO;;Boomers;LOS ANDES                     ;VALPARAISO;614330;5;3;0;0;0;5;3;614330;LED 32 KHHD3221 SMART TV;ELECTRONICA MAYOR
8136234;;F;67;CHILENO;;Boomers;SAN JAVIER                    ;MAULE;290020;2;1;0;0;0;2;1;290020;LED 43 Full HD Smart TV 43PFD6825;ELECTRONICA MAYOR
5748890;;M;71;CHILENO;;Silencioso;QUINTA NORMAL                 ;METROPOLITANA;42670;2;1;0;0;0;2;1;42670;KARAOKE FUNKY DISCO;ELECTRONICA MAYOR
17997895;;F;30;CHILENO;;Millenial;OSORNO                        ;LOS LAGOS;129990;1;1;1;1;129990;0;0;0;LED 32 KHHD3221 SMART TV;ELECTRONICA MAYOR
9823103;;F;56;CHILENO;;Boomers;RENCA                         ;METROPOLITANA;329990;1;1;0;0;0;1;1;329990;LED 50 50UP7500 UHD SMART TV;ELECTRONICA MAYOR
18371675;;F;28;CHILENO;;Millenial;N/D;N/D;181540;2;1;2;1;181540;0;0;0;LED 40 KEHD4020 SMART TV;ELECTRONICA MAYOR
13249008;;M;45;CHILENO;;X;PUDAHUEL                      ;METROPOLITANA;554240;5;2;1;1;279990;4;1;274250;LED 43 UN43TU7090GXZS UHD SMART TV;ELECTRONICA MAYOR
10085644;;M;57;CHILENO;;Boomers;VICTORIA                      ;ARAUCANIA;456170;2;1;0;0;0;2;1;456170;LED 55UP7500 UHD SMART;ELECTRONICA MAYOR
13838309;;M;42;CHILENO;;X;HIJUELAS                      ;VALPARAISO;261260;3;1;0;0;0;3;1;261260;LED 32 KHHD3221 SMART TV;ELECTRONICA MAYOR
18286376;;M;29;CHILENO;;Millenial;PROVIDENCIA                   ;METROPOLITANA;139990;1;1;1;1;139990;0;0;0;LED 32 KHHD3221 SMART TV;ELECTRONICA MAYOR
18829902;Soltero;M;28;CHILENO;INGENIERIA EN ELECTRICIDAD MENCION PROYECTOS DE INSTALACIONES ELECTRICAS;Millenial;PROVIDENCIA                   ;METROPOLITANA;243980;2;1;2;1;243980;0;0;0;LED 40 UN40T5290AGXZS FHD SMART TV;ELECTRONICA MAYOR
5586185;;M;72;CHILENO;;Silencioso;SAN FELIPE                    ;VALPARAISO;126770;2;1;0;0;0;2;1;126770;SOUNDBAR HW-T400/ZS;ELECTRONICA MAYOR
12985432;;M;46;CHILENO;;X;RENCA                         ;METROPOLITANA;221570;2;1;0;0;0;2;1;221570;LED 32 UN32T4300AGXZS HD SMART TV;ELECTRONICA MAYOR
8436323;Divorciado;M;61;CHILENO;;Boomers;N/D;N/D;683220;6;3;0;0;0;6;3;683220;LED 32 KHHD3221 SMART TV;ELECTRONICA MAYOR
11994884;;M;50;CHILENO;;X;PEUMO                         ;L.G.B.OÂ´HIGGINS;397700;2;1;0;0;0;2;1;397700;MINICOMPONENTE MX-T70/ZS ALL IN ONE;ELECTRONICA MAYOR
11633877;;F;52;CHILENO;;X;EL BOSQUE                     ;METROPOLITANA;194490;3;3;0;0;0;3;3;194490;LED 55 55P615 UHD ANDROID TV 4K;ELECTRONICA MAYOR
18460986;;F;28;CHILENO;;Millenial;MAULLIN                       ;LOS LAGOS;169990;1;1;0;0;0;1;1;169990;LED 42 KHFH4221 SMART TV;ELECTRONICA MAYOR
12399377;;F;49;CHILENO;;X;CABILDO                       ;VALPARAISO;221570;2;1;0;0;0;2;1;221570;LED 32 UN32T4300AGXZS HD SMART TV;ELECTRONICA MAYOR
17887088;;M;30;CHILENO;;Millenial;PROVIDENCIA                   ;METROPOLITANA;249990;1;1;0;0;0;1;1;249990;LED 40 UN40T5290AGXZS FHD SMART TV;ELECTRONICA MAYOR
16521748;;M;35;CHILENO;;Millenial;PROVIDENCIA                   ;METROPOLITANA;129990;1;1;0;0;0;1;1;129990;MINICOMPONENTE OL45;ELECTRONICA MAYOR
9634959;;M;59;CHILENO;;Boomers;N/D;N/D;579990;1;1;0;0;0;1;1;579990;LED 65UP7500 UHD SMART;ELECTRONICA MAYOR
13694631;;M;43;CHILENO;;X;SAN FERNANDO                  ;L.G.B.OÂ´HIGGINS;183980;2;1;2;1;183980;0;0;0;SOUNDBAR SN5Y;ELECTRONICA MAYOR
17014161;;F;33;CHILENO;;Millenial;PROVIDENCIA                   ;METROPOLITANA;199570;2;1;0;0;0;2;1;199570;PARLANTE ULTRASENSATION;ELECTRONICA MAYOR
6855309;;F;70;CHILENO;;Silencioso;BUIN                          ;METROPOLITANA;521970;2;1;0;0;0;2;1;521970;LED 60 UN60AU8000GXZS UHD SMART TV;ELECTRONICA MAYOR
16760341;Casado;M;34;CHILENO;;Millenial;RENCA                         ;METROPOLITANA;315840;2;1;2;1;315840;0;0;0;LED 43 UN43TU7090GXZS UHD SMART TV;ELECTRONICA MAYOR
11975935;;M;49;CHILENO;;X;CERRO NAVIA                   ;METROPOLITANA;159980;2;1;0;0;0;2;1;159980;PARLANTE ULTRAFORCE-I;ELECTRONICA MAYOR
10154515;;M;58;CHILENO;;Boomers;PUCHUNCAVI                    ;VALPARAISO;155770;2;1;0;0;0;2;1;155770;PARLANTE ULTRASENSATION;ELECTRONICA MAYOR
18489629;;M;28;CHILENO;;Millenial;PENCO                         ;BIO BIO;389990;1;1;0;0;0;1;1;389990;LED 55 UN55TU7090GXZS SMART TV UHD;ELECTRONICA MAYOR
15012437;;F;40;CHILENO;;X;MARIA ELENA                   ;ANTOFAGASTA;349990;1;1;0;0;0;1;1;349990;LED 50 UN50TU7090GXZS UHD SMART TV;ELECTRONICA MAYOR
9836515;;M;58;CHILENO;;Boomers;GRANEROS                      ;L.G.B.OÂ´HIGGINS;263570;2;1;0;0;0;2;1;263570;LED 43 CS43F2 SMART TV FHD NEGRO;ELECTRONICA MAYOR
26803632;;M;39;VENEZOLANO;;Extranjero;N/D;N/D;-45720;1;3;0;0;0;1;3;-45720;PARLANTE BT T15 NEGRO + ATRIL;ELECTRONICA MAYOR
8046919;;F;64;CHILENO;;Boomers;EL TABO                       ;VALPARAISO;350980;2;1;0;0;0;2;1;350980;LED 50 UN50TU7090GXZS UHD SMART TV;ELECTRONICA MAYOR
12285812;;F;50;CHILENO;;X;LA GRANJA                     ;METROPOLITANA;79990;1;1;0;0;0;1;1;79990;PARLANTE ULTRAMAGIC;ELECTRONICA MAYOR
11846168;;F;50;CHILENO;;X;PROVIDENCIA                   ;METROPOLITANA;133980;2;1;2;1;133980;0;0;0;MINICOMPONENTE MHC-V02 ALL IN ONE;ELECTRONICA MAYOR
18434183;Soltero;M;28;CHILENO;;Millenial;PROVIDENCIA                   ;METROPOLITANA;663980;2;1;2;1;663980;0;0;0;LED 70 UN70AU7000GXZS UHD;ELECTRONICA MAYOR
7922869;Casado;M;64;CHILENO;;Boomers;RENCA                         ;METROPOLITANA;800870;2;1;0;0;0;2;1;800870;LED 70 UN70AU7000GXZS UHD;ELECTRONICA MAYOR
10072384;;F;55;CHILENO;;Boomers;ARICA                         ;ARICA Y PARINACOTA;189990;1;1;0;0;0;1;1;189990;LED 32 UN32T4300AGXZS HD SMART TV;ELECTRONICA MAYOR
10637088;;M;54;CHILENO;;Boomers;N/D;N/D;-399990;-1;1;0;0;0;-1;1;-399990;LED 55 55PUD6794 SMART TV UHD 4K;ELECTRONICA MAYOR
9255777;;M;59;CHILENO;;Boomers;CONCEPCION                    ;BIO BIO;342960;3;2;0;0;0;3;2;342960;LED 32LM637B HD SMART;ELECTRONICA MAYOR
6262435;;M;68;CHILENO;;Silencioso;QUILPUE                       ;VALPARAISO;289990;2;1;0;0;0;2;1;289990;LED 50 KHUH5021 SMART TV;ELECTRONICA MAYOR
17916092;;F;31;CHILENO;;Millenial;N/D;N/D;149990;1;1;1;1;149990;0;0;0;LED 32 KHHD3221 SMART TV;ELECTRONICA MAYOR
5139754;;F;79;CHILENO;;Silencioso;SAN JAVIER                    ;MAULE;433290;4;2;0;0;0;4;2;433290;MINICOMPONENTE MX-T50/ZS ALL IN ONE;ELECTRONICA MAYOR
20037850;;F;23;CHILENO;;Extranjero;PROVIDENCIA                   ;METROPOLITANA;26990;1;1;0;0;0;1;1;26990;KARAOKE STREET SONG 4 MICÂ CABLEÂ BLACK 8900;ELECTRONICA MAYOR
4530403;;M;82;CHILENO;;Silencioso;N/D;N/D;437870;2;1;0;0;0;2;1;437870;LED 55 UN55TU7090GXZS SMART TV UHD;ELECTRONICA MAYOR
17441231;;F;32;CHILENO;;Millenial;PROVIDENCIA                   ;METROPOLITANA;337870;2;1;0;0;0;2;1;337870;LED 50 KHUH5021 SMART TV;ELECTRONICA MAYOR
6908147;Casado;M;68;CHILENO;;Silencioso;PROVIDENCIA                   ;METROPOLITANA;359990;1;1;0;0;0;1;1;359990;LED 50 50U6305 SMART TV ULTRA HD;ELECTRONICA MAYOR
18295190;;F;29;CHILENO;;Millenial;PROVIDENCIA                   ;METROPOLITANA;313980;2;1;2;1;313980;0;0;0;LED 43 UN43TU7090GXZS UHD SMART TV;ELECTRONICA MAYOR
14126631;;F;41;CHILENO;;X;N/D;N/D;69990;1;1;0;0;0;1;1;69990;PARLANTE KARAOKE MGROKR NEGRO;ELECTRONICA MAYOR
14533667;;F;42;CHILENO;;X;CERRO NAVIA                   ;METROPOLITANA;79990;1;1;0;0;0;1;1;79990;PARLANTE KARAOKE MGROKR NEGRO;ELECTRONICA MAYOR
13138737;Casado;F;45;CHILENO;;X;RENCA                         ;METROPOLITANA;282860;3;1;0;0;0;3;1;282860;MINICOMPONENTE CJ45;ELECTRONICA MAYOR
19807441;;F;24;CHILENO;;Z;TALCA                         ;MAULE;295860;3;1;0;0;0;3;1;295860;LED 40 UN40T5290AGXZS FHD SMART TV;ELECTRONICA MAYOR
10873039;;M;52;CHILENO;;Silencioso;PROVIDENCIA                   ;METROPOLITANA;619980;2;2;2;2;619980;0;0;0;LED 43 43UP7500 UHD SMART TV;ELECTRONICA MAYOR
9195648;;M;59;CHILENO;;Boomers;HUASCO                        ;ATACAMA;244560;3;1;0;0;0;3;1;244560;LED 32 UN32T4300AGXZS HD SMART TV;ELECTRONICA MAYOR
10955243;Soltero;F;53;CHILENO;;X;RENCA                         ;METROPOLITANA;47670;2;1;0;0;0;2;1;47670;PARLANTE SPBYF7 PORTATIL;ELECTRONICA MAYOR
18049995;;M;30;CHILENO;;Millenial;N/D;N/D;79990;1;1;0;0;0;1;1;79990;SOUNDBAR HW-T400/ZS;ELECTRONICA MAYOR
15651720;;F;39;CHILENO;;X;VICTORIA                      ;ARAUCANIA;509980;2;2;1;1;139990;1;1;369990;LED 55 55P615 UHD ANDROID TV 4K;ELECTRONICA MAYOR
16456545;;F;37;CHILENO;;Millenial;TALCA                         ;MAULE;589990;1;1;0;0;0;1;1;589990;LED 65 UN65AU7000GXZS UHD 4K SMART TV;ELECTRONICA MAYOR
25193178;;F;45;PERUANO;;Extranjero;VITACURA                      ;METROPOLITANA;0;0;0;0;0;0;0;0;0;LED 50 UN50TU7090GXZS UHD SMART TV;ELECTRONICA MAYOR
10772824;;F;55;CHILENO;;Boomers;RENGO                         ;L.G.B.OÂ´HIGGINS;0;0;0;0;0;0;0;0;0;LED 55 UN55TU7090GXZS SMART TV UHD;ELECTRONICA MAYOR
18807365;;M;28;CHILENO;;Millenial;CONCEPCION                    ;BIO BIO;0;0;0;0;0;0;0;0;0;LED 32 UN32T4300AGXZS HD SMART TV;ELECTRONICA MAYOR
18238078;;F;30;CHILENO;;Millenial;N/D;N/D;0;0;0;0;0;0;0;0;0;PARLANTE ULTRAFORCE-I;ELECTRONICA MAYOR
9543319;;F;62;CHILENO;;Boomers;SAN CARLOS                    ;BIO BIO;0;0;0;0;0;0;0;0;0;PARLANTE ULTRAFORCE-I;ELECTRONICA MAYOR
7736170;;M;66;CHILENO;;Boomers;SAN CARLOS                    ;BIO BIO;0;0;0;0;0;0;0;0;0;LED 32LM637B HD SMART;ELECTRONICA MAYOR
15057003;;M;39;CHILENO;;X;CABILDO                       ;VALPARAISO;0;0;0;0;0;0;0;0;0;LED 49 49UN7100 UHD SMART TV;ELECTRONICA MAYOR
7627965;;M;63;CHILENO;;Boomers;ESTACION CENTRAL              ;METROPOLITANA;0;0;0;0;0;0;0;0;0;SOUNDBAR XTS-801 Negro 40W;ELECTRONICA MAYOR
12453668;;F;48;CHILENO;;X;RENCA                         ;METROPOLITANA;0;0;0;0;0;0;0;0;0;LED 60 UN60AU8000GXZS UHD SMART TV;ELECTRONICA MAYOR
17890271;;M;30;CHILENO;;Millenial;PUERTO MONTT                  ;LOS LAGOS;0;0;0;0;0;0;0;0;0;LED 43 43LM6370 SMART TV FHD;ELECTRONICA MAYOR
6337818;;M;71;CHILENO;;Silencioso;ANGOL                         ;ARAUCANIA;0;0;0;0;0;0;0;0;0;LED 43 CS43F2 SMART TV FHD NEGRO;ELECTRONICA MAYOR
11723159;;M;50;CHILENO;;X;PROVIDENCIA                   ;METROPOLITANA;0;0;0;0;0;0;0;0;0;LED 42 42S6500 ANDROID TV FHD;ELECTRONICA MAYOR
7382004;;M;65;CHILENO;;Boomers;PARRAL                        ;MAULE;0;0;0;0;0;0;0;0;0;PARLANTE COBRA;ELECTRONICA MAYOR
17885011;Soltero;M;29;CHILENO;;Millenial;PROVIDENCIA                   ;METROPOLITANA;0;0;0;0;0;0;0;0;0;LED 50 50PUD7625 SMART TV ULTRA HD 4K;ELECTRONICA MAYOR
17147754;;M;33;CHILENO;;Millenial;PADRE LAS CASAS               ;ARAUCANIA;0;0;0;0;0;0;0;0;0;LED 50 KHUH5021 SMART TV;ELECTRONICA MAYOR
16410276;;F;35;CHILENO;;Millenial;PIRQUE                        ;METROPOLITANA;0;0;0;0;0;0;0;0;0;LED 50 50U6305 SMART TV ULTRA HD;ELECTRONICA MAYOR
16394457;;M;36;CHILENO;;Millenial;COLINA                        ;METROPOLITANA;0;0;0;0;0;0;0;0;0;LED 40 UN40T5290AGXZS FHD SMART TV;ELECTRONICA MAYOR
16419637;;F;36;CHILENO;;Millenial;PEDRO AGUIRRE CERDA           ;METROPOLITANA;0;0;0;0;0;0;0;0;0;LED 55 55P615 UHD ANDROID TV 4K;ELECTRONICA MAYOR
10578177;;M;53;CHILENO;;X;RENCA                         ;METROPOLITANA;0;0;0;0;0;0;0;0;0;LED 43 Full HD Smart TV 43PFD6825;ELECTRONICA MAYOR
16634877;;F;34;CHILENO;;Millenial;PADRE LAS CASAS               ;ARAUCANIA;0;0;0;0;0;0;0;0;0;LED 40 UN40T5290AGXZS FHD SMART TV;ELECTRONICA MAYOR
17708872;;M;31;CHILENO;;Silencioso;PROVIDENCIA                   ;METROPOLITANA;0;0;0;0;0;0;0;0;0;LED 32 CS32S1 SMART TV HD NEGRO;ELECTRONICA MAYOR
12519142;;M;48;CHILENO;;X;SAN VICENTE                   ;L.G.B.OÂ´HIGGINS;0;0;0;0;0;0;0;0;0;MLAB KARAOKE 8 CITY SET MICROFONO INALAMBRICO AT;ELECTRONICA MAYOR
7978222;;F;64;CHILENO;;Boomers;MAFIL                         ;LOS RIOS;0;0;0;0;0;0;0;0;0;MINICOMPONENTE OL45;ELECTRONICA MAYOR
12926582;;M;47;CHILENO;;X;QUILICURA                     ;METROPOLITANA;0;0;0;0;0;0;0;0;0;LED 43 Full HD Smart TV 43PFD6825;ELECTRONICA MAYOR
19138398;;F;26;CHILENO;;Z;"";"";0;0;0;0;0;0;0;0;0;PARLANTE KARAOKE MGROKR NEGRO;ELECTRONICA MAYOR
8863712;Casado;M;60;CHILENO;;Boomers;RENCA                         ;METROPOLITANA;0;0;0;0;0;0;0;0;0;SISTEMA DE SONIDO CM1560;ELECTRONICA MAYOR
8130355;;M;64;CHILENO;;Boomers;QUILPUE                       ;VALPARAISO;0;0;0;0;0;0;0;0;0;LED 50 UN50TU7090GXZS UHD SMART TV;ELECTRONICA MAYOR
17302282;;M;32;CHILENO;;Millenial;DIEGO DE ALMAGRO              ;ATACAMA;0;0;0;0;0;0;0;0;0;KARAOKE FUNKY DISCO;ELECTRONICA MAYOR
12890558;;M;47;CHILENO;;Silencioso;PROVIDENCIA                   ;METROPOLITANA;0;0;0;0;0;0;0;0;0;PARLANTE ULTRAFORCE-I;ELECTRONICA MAYOR
9231226;;M;61;CHILENO;;Boomers;COLBUN                        ;MAULE;0;0;0;0;0;0;0;0;0;LED KIOTO 32 MI3228 SMART TV;ELECTRONICA MAYOR
13171325;;M;45;CHILENO;;X;N/D;N/D;0;0;0;0;0;0;0;0;0;PARLANTE ULTRAFORCE-I;ELECTRONICA MAYOR
17448994;Casado;F;32;CHILENO;TECNICO DE NIVEL SUPERIOR EN ENFERMERIA GINECOOBSTETRICA Y NEONATAL;Millenial;PROVIDENCIA                   ;METROPOLITANA;0;0;0;0;0;0;0;0;0;LED 43 43S5295 SMART TV FHD;ELECTRONICA MAYOR
19603117;;F;25;CHILENO;;Z;SAN FERNANDO                  ;L.G.B.OÂ´HIGGINS;0;0;0;0;0;0;0;0;0;LED KIOTO 32 MI3228 SMART TV;ELECTRONICA MAYOR
8093781;;F;61;CHILENO;;Boomers;IQUIQUE                       ;TARAPACA;0;0;0;0;0;0;0;0;0;KARAOKE TOWER OUTDOOR POWER MIC BT BK 8571;ELECTRONICA MAYOR
19976257;;F;24;CHILENO;;Z;PROVIDENCIA                   ;METROPOLITANA;0;0;0;0;0;0;0;0;0;PARLANTE ULTRASENSATION;ELECTRONICA MAYOR
16083082;;F;37;CHILENO;;Silencioso;PROVIDENCIA                   ;METROPOLITANA;0;0;0;0;0;0;0;0;0;PARLANTE ULTRAFORCE-I;ELECTRONICA MAYOR
5182230;;M;74;CHILENO;;Silencioso;TOCOPILLA                     ;ANTOFAGASTA;0;0;0;0;0;0;0;0;0;KARAOKE FUNKY DISCO;ELECTRONICA MAYOR
19511417;;F;25;CHILENO;;Silencioso;PROVIDENCIA                   ;METROPOLITANA;0;0;0;0;0;0;0;0;0;LED 43 43S5295 SMART TV FHD;ELECTRONICA MAYOR
15083530;;M;41;CHILENO;;X;VINA DEL MAR                  ;VALPARAISO;0;0;0;0;0;0;0;0;0;LED KIOTO 32 MI3228 SMART TV;ELECTRONICA MAYOR
14446329;;F;48;CHILENO;;Z;PROVIDENCIA                   ;METROPOLITANA;0;0;0;0;0;0;0;0;0;LED 50 UN50TU7090GXZS UHD SMART TV;ELECTRONICA MAYOR
17122085;Soltero;F;33;CHILENO;;Millenial;PROVIDENCIA                   ;METROPOLITANA;0;0;0;0;0;0;0;0;0;LED 50 UN50TU7090GXZS UHD SMART TV;ELECTRONICA MAYOR
13920757;;M;41;CHILENO;;X;N/D;N/D;0;0;0;0;0;0;0;0;0;LED 32 32S5295 SMART TV HD;ELECTRONICA MAYOR
17661373;Soltero;M;31;CHILENO;;Millenial;PROVIDENCIA                   ;METROPOLITANA;0;0;0;0;0;0;0;0;0;PARLANTE ULTRAFORCE-I;ELECTRONICA MAYOR
13180402;;M;46;CHILENO;;Silencioso;PROVIDENCIA                   ;METROPOLITANA;0;0;0;0;0;0;0;0;0;LED 32 32PHD6825 HD SMART TV;ELECTRONICA MAYOR
24321071;;M;29;EXTRANJERO - NO INFORMA NACIONALIDAD;;Extranjero;N/D;N/D;0;0;0;0;0;0;0;0;0;PARLANTE ULTRASENSATION;ELECTRONICA MAYOR
19282934;Soltero;F;26;CHILENO;;Silencioso;PROVIDENCIA                   ;METROPOLITANA;0;0;0;0;0;0;0;0;0;LED 40 KEHD4020 SMART TV;ELECTRONICA MAYOR
17152110;;F;33;CHILENO;;Millenial;VILLARICA                     ;ARAUCANIA;0;0;0;0;0;0;0;0;0;LED 55 UN55TU7090GXZS SMART TV UHD;ELECTRONICA MAYOR
13150074;;F;45;CHILENO;;X;CANETE                        ;BIO BIO;0;0;0;0;0;0;0;0;0;LED 50 50PUD7625 SMART TV ULTRA HD 4K;ELECTRONICA MAYOR
19607732;;F;24;CHILENO;;Z;PROVIDENCIA                   ;METROPOLITANA;0;0;0;0;0;0;0;0;0;LED 40 KEHD4020 SMART TV;ELECTRONICA MAYOR
19711535;;M;24;CHILENO;;Z;PROVIDENCIA                   ;METROPOLITANA;0;0;0;0;0;0;0;0;0;LED 50 UN50TU7090GXZS UHD SMART TV;ELECTRONICA MAYOR
17090878;;M;33;CHILENO;;Millenial;PROVIDENCIA                   ;METROPOLITANA;0;0;0;0;0;0;0;0;0;LED 40 KEHD4020 SMART TV;ELECTRONICA MAYOR
18261001;;M;30;CHILENO;;Millenial;RENGO                         ;L.G.B.OÂ´HIGGINS;0;0;0;0;0;0;0;0;0;LED KIOTO 32 MI3228 SMART TV;ELECTRONICA MAYOR
17382668;;M;32;CHILENO;;Millenial;LA PINTANA                    ;METROPOLITANA;0;0;0;0;0;0;0;0;0;LED 55 55P615 UHD ANDROID TV 4K;ELECTRONICA MAYOR
22291938;;M;35;PERUANO;;Extranjero;ANTOFAGASTA                   ;ANTOFAGASTA;0;0;0;0;0;0;0;0;0;LED 55 UN55TU7090GXZS SMART TV UHD;ELECTRONICA MAYOR
18489430;;M;28;CHILENO;;Millenial;SAN CARLOS                    ;BIO BIO;0;0;0;0;0;0;0;0;0;LED 32 CS32S1 SMART TV HD NEGRO;ELECTRONICA MAYOR
16246005;;M;36;CHILENO;;Millenial;N/D;N/D;0;0;0;0;0;0;0;0;0;LED 50 UN50TU7090GXZS UHD SMART TV;ELECTRONICA MAYOR
16486681;;M;35;CHILENO;;Millenial;MELIPILLA                     ;METROPOLITANA;0;0;0;0;0;0;0;0;0;LED 55 UN55TU7090GXZS SMART TV UHD;ELECTRONICA MAYOR
18611189;;F;28;CHILENO;;Extranjero;RENCA                         ;METROPOLITANA;0;0;0;0;0;0;0;0;0;MLAB KARAOKE 8 CITY SET MICROFONO INALAMBRICO AT;ELECTRONICA MAYOR
12382558;;F;48;CHILENO;;X;TALCAHUANO                    ;BIO BIO;0;0;0;0;0;0;0;0;0;KARAOKE FUNKY DISCO;ELECTRONICA MAYOR
7890852;;M;63;CHILENO;;Boomers;N/D;N/D;0;0;0;0;0;0;0;0;0;LED 40 KEHD4020 SMART TV;ELECTRONICA MAYOR
18616610;Soltero;F;28;CHILENO;;Millenial;PROVIDENCIA                   ;METROPOLITANA;0;0;0;0;0;0;0;0;0;LED 43 Full HD Smart TV 43PFD6825;ELECTRONICA MAYOR
15624344;;M;38;CHILENO;;Millenial;PROVIDENCIA                   ;METROPOLITANA;0;0;0;0;0;0;0;0;0;MINICOMPONENTE MHC-V02 ALL IN ONE;ELECTRONICA MAYOR
11473343;;F;53;CHILENO;;Boomers;PROVIDENCIA                   ;METROPOLITANA;0;0;0;0;0;0;0;0;0;LED 50 UN50TU7090GXZS UHD SMART TV;ELECTRONICA MAYOR
6355692;;F;70;CHILENO;;Silencioso;PROVIDENCIA                   ;METROPOLITANA;0;0;0;0;0;0;0;0;0;LED 60 UN60AU8000GXZS UHD SMART TV;ELECTRONICA MAYOR
11782318;;F;50;CHILENO;;X;PUENTE ALTO                   ;METROPOLITANA;0;0;0;0;0;0;0;0;0;MINICOMPONENTE MHC-V02 ALL IN ONE;ELECTRONICA MAYOR
12428638;;F;49;CHILENO;;X;CURACAVI                      ;METROPOLITANA;0;0;0;0;0;0;0;0;0;MINICOMPONENTE RN5;ELECTRONICA MAYOR
12892580;Casado;F;46;CHILENO;PROFESOR;X;PROVIDENCIA                   ;METROPOLITANA;0;0;0;0;0;0;0;0;0;LED 40 KEHD4020 SMART TV;ELECTRONICA MAYOR
7119154;;F;67;CHILENO;;Boomers;TEMUCO                        ;ARAUCANIA;0;0;0;0;0;0;0;0;0;LED 50 UN50TU7090GXZS UHD SMART TV;ELECTRONICA MAYOR
6848007;;F;58;CHILENO;;Boomers;PROVIDENCIA                   ;METROPOLITANA;0;0;0;0;0;0;0;0;0;LED 40 KEHD4020 SMART TV;ELECTRONICA MAYOR
15847587;Casado;M;38;CHILENO;;Millenial;PROVIDENCIA                   ;METROPOLITANA;0;0;0;0;0;0;0;0;0;PARLANTE ULTRAMAGIC;ELECTRONICA MAYOR
16679454;Soltero;M;34;CHILENO;;Millenial;PROVIDENCIA                   ;METROPOLITANA;0;0;0;0;0;0;0;0;0;KARAOKE EXTRA SAVAGE MICÂ CABLEÂ BLACK 8902;ELECTRONICA MAYOR
10464144;;M;54;CHILENO;;X;PROVIDENCIA                   ;METROPOLITANA;0;0;0;0;0;0;0;0;0;SOUNDBAR HW-A450/ZS;ELECTRONICA MAYOR
13246028;;F;44;CHILENO;;Silencioso;PROVIDENCIA                   ;METROPOLITANA;0;0;0;0;0;0;0;0;0;LED 50 UN50TU7090GXZS UHD SMART TV;ELECTRONICA MAYOR
17542520;;F;30;CHILENO;;Millenial;PROVIDENCIA                   ;METROPOLITANA;0;0;0;0;0;0;0;0;0;PARLANTE ULTRAFORCE-I;ELECTRONICA MAYOR
9922909;;M;58;CHILENO;;Boomers;N/D;N/D;0;0;0;0;0;0;0;0;0;LED 32 32LM630BPSB SMART TV;ELECTRONICA MAYOR
13340861;;M;43;CHILENO;;X;N/D;N/D;0;0;0;0;0;0;0;0;0;LED 50 50NANO75 NanoCell UHD SMART + MAGIC;ELECTRONICA MAYOR
14019485;;M;40;CHILENO;;Silencioso;PROVIDENCIA                   ;METROPOLITANA;0;0;0;0;0;0;0;0;0;LED 49 49UN7100 UHD SMART TV;ELECTRONICA MAYOR
19871583;;F;23;CHILENO;;Z;PROVIDENCIA                   ;METROPOLITANA;0;0;0;0;0;0;0;0;0;LED 50 50NANO75 NanoCell UHD SMART + MAGIC;ELECTRONICA MAYOR
18056818;;F;30;CHILENO;;Millenial;PROVIDENCIA                   ;METROPOLITANA;0;0;0;0;0;0;0;0;0;LED 43 UN43TU7090GXZS UHD SMART TV;ELECTRONICA MAYOR
15649842;;F;38;CHILENO;;Millenial;MAIPU                         ;METROPOLITANA;0;0;0;0;0;0;0;0;0;LED 32 UN32T4300AGXZS HD SMART TV;ELECTRONICA MAYOR
12776396;;F;47;CHILENO;;X;RENCA                         ;METROPOLITANA;0;0;0;0;0;0;0;0;0;LED 49 49UN7100 UHD SMART TV;ELECTRONICA MAYOR
17098492;;F;33;CHILENO;;Millenial;PROVIDENCIA                   ;METROPOLITANA;0;0;0;0;0;0;0;0;0;LED 43 UN43T5202AGXZS FHD SMART TV;ELECTRONICA MAYOR
18164484;;F;29;CHILENO;;Millenial;PUERTO MONTT                  ;LOS LAGOS;0;0;0;0;0;0;0;0;0;LED KIOTO 32 MI3228 SMART TV;ELECTRONICA MAYOR
18679133;;M;28;CHILENO;;Millenial;MOLINA                        ;MAULE;0;0;0;0;0;0;0;0;0;LED 50 UN50TU7090GXZS UHD SMART TV;ELECTRONICA MAYOR
19290158;;F;26;CHILENO;;Z;PROVIDENCIA                   ;METROPOLITANA;0;0;0;0;0;0;0;0;0;LED 43 UN43T5202AGXZS FHD SMART TV;ELECTRONICA MAYOR
9888468;;F;56;CHILENO;;Boomers;LOS ANDES                     ;VALPARAISO;0;0;0;0;0;0;0;0;0;KARAOKE URBAN AZUL;ELECTRONICA MAYOR
15486420;Soltero;F;33;CHILENO;PROFESOR;Millenial;N/D;N/D;0;0;0;0;0;0;0;0;0;LED 50 KEUH50 SMART TV UHD;ELECTRONICA MAYOR
12742686;;F;47;CHILENO;;X;VILLARICA                     ;ARAUCANIA;0;0;0;0;0;0;0;0;0;LED 40 KEHD4020 SMART TV;ELECTRONICA MAYOR
13680584;Casado;F;43;CHILENO;;X;PROVIDENCIA                   ;METROPOLITANA;0;0;0;0;0;0;0;0;0;LED 50 UN50TU7090GXZS UHD SMART TV;ELECTRONICA MAYOR
15157393;;F;37;CHILENO;;Millenial;PARRAL                        ;MAULE;0;0;0;0;0;0;0;0;0;LED 55 UN55TU7090GXZS SMART TV UHD;ELECTRONICA MAYOR
15801600;;F;38;CHILENO;;Millenial;OVALLE                        ;COQUIMBO;0;0;0;0;0;0;0;0;0;MINICOMPONENTE RN7;ELECTRONICA MAYOR
18311108;;M;29;CHILENO;;Millenial;PROVIDENCIA                   ;METROPOLITANA;0;0;0;0;0;0;0;0;0;LED KIOTO 32 MI3228 SMART TV;ELECTRONICA MAYOR
17381995;;F;32;CHILENO;;Millenial;N/D;N/D;0;0;0;0;0;0;0;0;0;MINICOMPONENTE RN9;ELECTRONICA MAYOR
13999787;;M;40;CHILENO;;X;LOS ANDES                     ;VALPARAISO;0;0;0;0;0;0;0;0;0;MAGIC REMOTE MR20GA;ELECTRONICA MAYOR
12835068;;M;46;CHILENO;;X;SAN ANTONIO                   ;VALPARAISO;0;0;0;0;0;0;0;0;0;MINICOMPONENTE CM4360;ELECTRONICA MAYOR
20174259;;F;22;CHILENO;;Z;LOS VILOS;COQUIMBO;0;0;0;0;0;0;0;0;0;LED 40 KEHD4020 SMART TV;ELECTRONICA MAYOR
12171387;;F;50;CHILENO;;X;DIEGO DE ALMAGRO              ;ATACAMA;0;0;0;0;0;0;0;0;0;PARLANTE ULTRAFUSION;ELECTRONICA MAYOR
16288663;;M;36;CHILENO;;Silencioso;PROVIDENCIA                   ;METROPOLITANA;0;0;0;0;0;0;0;0;0;LED 43 43S5295 SMART TV FHD;ELECTRONICA MAYOR
13814324;Soltero;M;41;CHILENO;;Silencioso;PROVIDENCIA                   ;METROPOLITANA;0;0;0;0;0;0;0;0;0;LED 32 UN32T4300AGXZS HD SMART TV;ELECTRONICA MAYOR
17218052;;F;32;CHILENO;;Millenial;N/D;N/D;0;0;0;0;0;0;0;0;0;KARAOKE FUNKY DISCO;ELECTRONICA MAYOR
16957332;;F;33;CHILENO;;Millenial;COPIAPO                       ;ATACAMA;0;0;0;0;0;0;0;0;0;LED 43 Full HD Smart TV 43PFD6825;ELECTRONICA MAYOR
10127977;;M;57;CHILENO;;Boomers;PROVIDENCIA                   ;METROPOLITANA;0;0;0;0;0;0;0;0;0;LED 32 UN32T4300AGXZS HD SMART TV;ELECTRONICA MAYOR
18384868;;M;29;CHILENO;;Millenial;SAN ESTEBAN                   ;VALPARAISO;0;0;0;0;0;0;0;0;0;LED 55 55UN7100 UHD SMART TV;ELECTRONICA MAYOR
6105371;;M;72;CHILENO;;Silencioso;LONGAVI                       ;MAULE;0;0;0;0;0;0;0;0;0;LED 50 CS50S1USM UHD SMART TV NEGRO;ELECTRONICA MAYOR
15792520;;F;37;CHILENO;;Millenial;SAN JAVIER                    ;MAULE;0;0;0;0;0;0;0;0;0;SOUNDBAR HW-A450/ZS;ELECTRONICA MAYOR
10118832;;F;58;CHILENO;;Boomers;CONCHALI                      ;METROPOLITANA;0;0;0;0;0;0;0;0;0;LED KIOTO 32 MI3228 SMART TV;ELECTRONICA MAYOR
17526080;;M;30;CHILENO;;Millenial;COLTAUCO                      ;L.G.B.OÂ´HIGGINS;0;0;0;0;0;0;0;0;0;LED 43 43LM6300PSB SMART TV HD;ELECTRONICA MAYOR
12835129;;M;46;CHILENO;;X;ARICA                         ;ARICA Y PARINACOTA;0;0;0;0;0;0;0;0;0;LED 32 UN32T4300AGXZS HD SMART TV;ELECTRONICA MAYOR
19136408;Soltero;F;26;CHILENO;NUTRICIONISTA;Z;PROVIDENCIA                   ;METROPOLITANA;0;0;0;0;0;0;0;0;0;LED 49 49UN7100 UHD SMART TV;ELECTRONICA MAYOR
13826422;;F;42;CHILENO;;X;RANCAGUA                      ;L.G.B.OÂ´HIGGINS;0;0;0;0;0;0;0;0;0;LED 43 UN43T5202AGXZS FHD SMART TV;ELECTRONICA MAYOR
17030973;Soltero;M;33;CHILENO;;Millenial;PROVIDENCIA                   ;METROPOLITANA;0;0;0;0;0;0;0;0;0;LED 49 49UN7100 UHD SMART TV;ELECTRONICA MAYOR
20026099;;M;23;CHILENO;;Z;N/D;N/D;0;0;0;0;0;0;0;0;0;LED 43 43UP7500 UHD SMART TV;ELECTRONICA MAYOR
9539749;;F;60;CHILENO;;Boomers;TALCA                         ;MAULE;0;0;0;0;0;0;0;0;0;LED KIOTO 32 MI3228 SMART TV;ELECTRONICA MAYOR
13978922;Soltero;F;41;CHILENO;;X;RENCA                         ;METROPOLITANA;0;0;0;0;0;0;0;0;0;LED 32 CS32S1 SMART TV HD NEGRO;ELECTRONICA MAYOR
12114124;Casado;M;40;CHILENO;INGENIERO COMERCIAL;Silencioso;PROVIDENCIA                   ;METROPOLITANA;0;0;0;0;0;0;0;0;0;LED 43 43LM6300PSB SMART TV HD;ELECTRONICA MAYOR
10045330;;F;56;CHILENO;;Boomers;PROVIDENCIA                   ;METROPOLITANA;0;0;0;0;0;0;0;0;0;LED 43 43LM6300PSB SMART TV HD;ELECTRONICA MAYOR
16154159;Casado;M;36;CHILENO;;Silencioso;PROVIDENCIA                   ;METROPOLITANA;0;0;0;0;0;0;0;0;0;LED 50 UN50TU7090GXZS UHD SMART TV;ELECTRONICA MAYOR
6531650;Divorciado;M;69;CHILENO;;Silencioso;MELIPILLA                     ;METROPOLITANA;0;0;0;0;0;0;0;0;0;LED KIOTO 32 MI3228 SMART TV;ELECTRONICA MAYOR
15705683;;M;38;CHILENO;;Millenial;N/D;N/D;0;0;0;0;0;0;0;0;0;LED 55 55UN7100 UHD SMART TV;ELECTRONICA MAYOR
18939565;;F;27;CHILENO;;Millenial;ESTACION CENTRAL              ;METROPOLITANA;0;0;0;0;0;0;0;0;0;LED 50 KEUH50 SMART TV UHD;ELECTRONICA MAYOR
13819951;;M;43;CHILENO;;X;LA PINTANA                    ;METROPOLITANA;0;0;0;0;0;0;0;0;0;LED 65 KUHK6520 UHD SMART TV;ELECTRONICA MAYOR
17429563;;M;31;CHILENO;;Millenial;CERRO NAVIA                   ;METROPOLITANA;0;0;0;0;0;0;0;0;0;LED 40 KEHD4020 SMART TV;ELECTRONICA MAYOR
4498327;;F;80;CHILENO;;Silencioso;ANCUD                         ;LOS LAGOS;0;0;0;0;0;0;0;0;0;LED KIOTO 32 MI3228 SMART TV;ELECTRONICA MAYOR
13519918;;F;43;CHILENO;;X;PROVIDENCIA                   ;METROPOLITANA;0;0;0;0;0;0;0;0;0;LED 32 32LM630BPSB SMART TV;ELECTRONICA MAYOR
8398143;;F;52;CHILENO;;X;LOS ANGELES                   ;BIO BIO;0;0;0;0;0;0;0;0;0;LED 43 43S5295 SMART TV FHD;ELECTRONICA MAYOR
16956759;;F;33;CHILENO;;Millenial;RENCA                         ;METROPOLITANA;0;0;0;0;0;0;0;0;0;LED 55 55UN7100 UHD SMART TV;ELECTRONICA MAYOR
9169119;;M;59;CHILENO;;Boomers;LA LIGUA                      ;VALPARAISO;0;0;0;0;0;0;0;0;0;LED 65 KUHK6520 UHD SMART TV;ELECTRONICA MAYOR
15717989;;F;39;CHILENO;;Silencioso;PROVIDENCIA                   ;METROPOLITANA;0;0;0;0;0;0;0;0;0;LED 32 32S5295 SMART TV HD;ELECTRONICA MAYOR
18364464;;F;29;CHILENO;;Millenial;"";"";0;0;0;0;0;0;0;0;0;LED 55 UN55TU7090GXZS SMART TV UHD;ELECTRONICA MAYOR
17126925;;M;33;CHILENO;;Millenial;RENCA                         ;METROPOLITANA;0;0;0;0;0;0;0;0;0;LED 49 49UN7100 UHD SMART TV;ELECTRONICA MAYOR
16443065;Soltero;M;35;CHILENO;TECNICO AGRICOLA;Millenial;PROVIDENCIA                   ;METROPOLITANA;0;0;0;0;0;0;0;0;0;LED 55 55UN7100 UHD SMART TV;ELECTRONICA MAYOR
17055753;Soltero;M;33;CHILENO;;Silencioso;PROVIDENCIA                   ;METROPOLITANA;0;0;0;0;0;0;0;0;0;LED 50 UN50TU7090GXZS UHD SMART TV;ELECTRONICA MAYOR
19009317;Soltero;M;27;CHILENO;;Z;PROVIDENCIA                   ;METROPOLITANA;0;0;0;0;0;0;0;0;0;LED 40 KEHD4020 SMART TV;ELECTRONICA MAYOR
15949664;;F;38;CHILENO;;Millenial;VINA DEL MAR                  ;VALPARAISO;0;0;0;0;0;0;0;0;0;LED 43 43LM6300PSB SMART TV HD;ELECTRONICA MAYOR
8858968;;M;62;CHILENO;;Boomers;SAN FERNANDO                  ;L.G.B.OÂ´HIGGINS;0;0;0;0;0;0;0;0;0;LED 50 UN50TU7090GXZS UHD SMART TV;ELECTRONICA MAYOR
19124299;;M;25;CHILENO;;Z;PROVIDENCIA                   ;METROPOLITANA;0;0;0;0;0;0;0;0;0;LED 50 UN50TU7090GXZS UHD SMART TV;ELECTRONICA MAYOR
17011487;Soltero;M;33;CHILENO;;Millenial;PROVIDENCIA                   ;METROPOLITANA;0;0;0;0;0;0;0;0;0;LED 50 50NANO75 NanoCell UHD SMART + MAGIC;ELECTRONICA MAYOR
19332749;Soltero;F;26;CHILENO;NUTRICIONISTA;Z;PROVIDENCIA                   ;METROPOLITANA;0;0;0;0;0;0;0;0;0;LED KIOTO 32 MI3228 SMART TV;ELECTRONICA MAYOR
20323540;;F;22;CHILENO;;Z;PROVIDENCIA                   ;METROPOLITANA;0;0;0;0;0;0;0;0;0;LED 40 KEHD4020 SMART TV;ELECTRONICA MAYOR
17937019;;F;32;CHILENO;;Millenial;PROVIDENCIA                   ;METROPOLITANA;0;0;0;0;0;0;0;0;0;LED 32 UN32T4300AGXZS HD SMART TV;ELECTRONICA MAYOR
18745615;;F;27;CHILENO;;Millenial;LOTA                          ;BIO BIO;0;0;0;0;0;0;0;0;0;LED 70 UN70TU6900GXZS UHD SMART TV;ELECTRONICA MAYOR
12211382;;F;49;CHILENO;;X;PROVIDENCIA                   ;METROPOLITANA;0;0;0;0;0;0;0;0;0;LED 43 43UN7300 UHD SMART TV 4K;ELECTRONICA MAYOR
17501804;;F;32;CHILENO;;Millenial;PROVIDENCIA                   ;METROPOLITANA;0;0;0;0;0;0;0;0;0;LED 50 50PUD6513/44 SMART TV UHD 4K;ELECTRONICA MAYOR
23885162;;F;55;DOMINICANO;;Extranjero;SANTIAGO                      ;METROPOLITANA;0;0;0;0;0;0;0;0;0;SOUNDBAR SK1;ELECTRONICA MAYOR
18419891;;F;28;CHILENO;;Millenial;CONCEPCION                    ;BIO BIO;0;0;0;0;0;0;0;0;0;LED 65 KUHK6520 UHD SMART TV;ELECTRONICA MAYOR
16392246;Soltero;F;35;CHILENO;;Millenial;PROVIDENCIA                   ;METROPOLITANA;0;0;0;0;0;0;0;0;0;LED 43 43S5295 SMART TV FHD;ELECTRONICA MAYOR
13347321;;M;44;CHILENO;;Millenial;N/D;N/D;0;0;0;0;0;0;0;0;0;LED 55 UN55TU7090GXZS SMART TV UHD;ELECTRONICA MAYOR
17845933;;F;31;CHILENO;;Millenial;SAN CLEMENTE                  ;MAULE;0;0;0;0;0;0;0;0;0;LED 50 KEUH50 SMART TV UHD;ELECTRONICA MAYOR
17304232;;M;32;CHILENO;;Millenial;"";"";0;0;0;0;0;0;0;0;0;LED KIOTO 32 MI3228 SMART TV;ELECTRONICA MAYOR
8051706;;M;65;CHILENO;;Boomers;EL BOSQUE                     ;METROPOLITANA;0;0;0;0;0;0;0;0;0;LED 32 UN32T4300AGXZS HD SMART TV;ELECTRONICA MAYOR
12036691;;F;53;CHILENO;;X;TALCAHUANO                    ;BIO BIO;0;0;0;0;0;0;0;0;0;PARLANTE COBRA;ELECTRONICA MAYOR
20188886;;M;23;CHILENO;;Z;PROVIDENCIA                   ;METROPOLITANA;0;0;0;0;0;0;0;0;0;LED 50 UN50TU7090GXZS UHD SMART TV;ELECTRONICA MAYOR
20220342;;M;23;CHILENO;;Silencioso;PROVIDENCIA                   ;METROPOLITANA;0;0;0;0;0;0;0;0;0;LED 40 KEHD4020 SMART TV;ELECTRONICA MAYOR
17649693;;F;32;CHILENO;;Millenial;RENCA                         ;METROPOLITANA;0;0;0;0;0;0;0;0;0;LED 32 UN32T4300AGXZS HD SMART TV;ELECTRONICA MAYOR
16439434;;F;35;CHILENO;;Millenial;N/D;N/D;0;0;0;0;0;0;0;0;0;PARLANTE ULTRABUZZ;ELECTRONICA MAYOR
4885963;;F;76;CHILENO;;Silencioso;RENCA                         ;METROPOLITANA;0;0;0;0;0;0;0;0;0;LED 32 32S5295 SMART TV HD;ELECTRONICA MAYOR
13054378;Casado;M;46;CHILENO;CORREDOR DE PROPIEDADES;X;RENCA                         ;METROPOLITANA;0;0;0;0;0;0;0;0;0;LED 43 43S5295 SMART TV FHD;ELECTRONICA MAYOR
9997622;;M;54;CHILENO;;X;LA SERENA                     ;COQUIMBO;0;0;0;0;0;0;0;0;0;LED 43 43LM6300PSB SMART TV HD;ELECTRONICA MAYOR
15428111;Soltero;M;39;CHILENO;;Silencioso;PROVIDENCIA                   ;METROPOLITANA;0;0;0;0;0;0;0;0;0;LED 55 UN55TU7090GXZS SMART TV UHD;ELECTRONICA MAYOR
18678031;;F;28;CHILENO;;Millenial;CURANILAHUE                   ;BIO BIO;0;0;0;0;0;0;0;0;0;LED 40 KEHD4020 SMART TV;ELECTRONICA MAYOR
18245094;Soltero;M;29;CHILENO;;Millenial;LAS CONDES                    ;METROPOLITANA;0;0;0;0;0;0;0;0;0;LED 43 43UN7300 UHD SMART TV 4K;ELECTRONICA MAYOR
20201001;;M;22;CHILENO;;Silencioso;PROVIDENCIA                   ;METROPOLITANA;0;0;0;0;0;0;0;0;0;LED 32 32LM630BPSB SMART TV;ELECTRONICA MAYOR
12328755;;M;49;CHILENO;;X;CURANILAHUE                   ;BIO BIO;0;0;0;0;0;0;0;0;0;LED KIOTO 32 MI3228 SMART TV;ELECTRONICA MAYOR
8222241;Casado;F;65;CHILENO;;Boomers;RENCA                         ;METROPOLITANA;0;0;0;0;0;0;0;0;0;LED KIOTO 32 MI3228 SMART TV;ELECTRONICA MAYOR
4766330;;F;80;CHILENO;;Silencioso;ARICA                         ;ARICA Y PARINACOTA;0;0;0;0;0;0;0;0;0;LED 43 43UN7300 UHD SMART TV 4K;ELECTRONICA MAYOR
20402667;;M;22;CHILENO;;Z;PROVIDENCIA                   ;METROPOLITANA;0;0;0;0;0;0;0;0;0;LED 50 UN50TU7090GXZS UHD SMART TV;ELECTRONICA MAYOR
12253733;;M;49;CHILENO;;X;PROVIDENCIA                   ;METROPOLITANA;0;0;0;0;0;0;0;0;0;LED 50 UN50TU7090GXZS UHD SMART TV;ELECTRONICA MAYOR
8938167;;F;62;CHILENO;;Boomers;CURANILAHUE                   ;BIO BIO;0;0;0;0;0;0;0;0;0;LED 32 UN32T4300AGXZS HD SMART TV;ELECTRONICA MAYOR
18983028;;F;27;CHILENO;;Z;MAULE                         ;MAULE;0;0;0;0;0;0;0;0;0;LED 50 50PUD6513/44 SMART TV UHD 4K;ELECTRONICA MAYOR
18433504;;F;29;CHILENO;;Millenial;CANETE                        ;BIO BIO;0;0;0;0;0;0;0;0;0;LED 50 KEUH50 SMART TV UHD;ELECTRONICA MAYOR
18659353;;M;28;CHILENO;;Millenial;QUILLOTA                      ;VALPARAISO;0;0;0;0;0;0;0;0;0;LED 40 KEHD4020 SMART TV;ELECTRONICA MAYOR
11514621;;F;52;CHILENO;;X;SALAMANCA                     ;COQUIMBO;0;0;0;0;0;0;0;0;0;LED 50 KEUH50 SMART TV UHD;ELECTRONICA MAYOR
17186601;;F;32;CHILENO;;Millenial;TALCA                         ;MAULE;0;0;0;0;0;0;0;0;0;LED 49 49UN7100 UHD SMART TV;ELECTRONICA MAYOR
18885469;;M;28;CHILENO;;Millenial;PANGUIPULLI                   ;LOS RIOS;0;0;0;0;0;0;0;0;0;MINICOMPONENTE CM4360;ELECTRONICA MAYOR
19088668;Soltero;M;27;CHILENO;;Silencioso;PROVIDENCIA                   ;METROPOLITANA;0;0;0;0;0;0;0;0;0;LED 43 UN43T5202AGXZS FHD SMART TV;ELECTRONICA MAYOR
19713565;;F;24;CHILENO;;Millenial;"";"";0;0;0;0;0;0;0;0;0;PARLANTE ULTRABUZZ;ELECTRONICA MAYOR
15687077;;F;38;CHILENO;;Millenial;IQUIQUE                       ;TARAPACA;0;0;0;0;0;0;0;0;0;LED KIOTO 32 MI3228 SMART TV;ELECTRONICA MAYOR
26787586;;M;36;EXTRANJERO - NO INFORMA NACIONALIDAD;;Extranjero;N/D;N/D;0;0;0;0;0;0;0;0;0;LED 49 49UN7100 UHD SMART TV;ELECTRONICA MAYOR
14060371;;M;41;CHILENO;;Millenial;SAN PEDRO DE LA PAZ           ;BIO BIO;0;0;0;0;0;0;0;0;0;LED 50 KEUH50 SMART TV UHD;ELECTRONICA MAYOR
12715550;Soltero;F;48;CHILENO;;X;COIHAIQUE                     ;AYSEN;0;0;0;0;0;0;0;0;0;PARLANTE BOLA DISCO CON MICROFONO INAL;ELECTRONICA MAYOR
10577410;Viudo;F;58;CHILENO;;Boomers;PROVIDENCIA                   ;METROPOLITANA;0;0;0;0;0;0;0;0;0;LED KIOTO 32 MI3228 SMART TV;ELECTRONICA MAYOR
7766387;;F;65;CHILENO;;Boomers;N/D;N/D;0;0;0;0;0;0;0;0;0;MINICOMPONENTE RN7;ELECTRONICA MAYOR
19911620;;M;23;CHILENO;;Silencioso;PROVIDENCIA                   ;METROPOLITANA;0;0;0;0;0;0;0;0;0;MONITOR 24 24TL520S SMART TV HD;ELECTRONICA MAYOR
14154181;;F;41;CHILENO;;X;PROVIDENCIA                   ;METROPOLITANA;0;0;0;0;0;0;0;0;0;LED 60 60UN7310 SMART TV UHD;ELECTRONICA MAYOR
19042167;Soltero;F;26;CHILENO;;Z;LA SERENA                     ;COQUIMBO;0;0;0;0;0;0;0;0;0;PARLANTE MG TWISTER;ELECTRONICA MAYOR
15919571;;M;37;CHILENO;;Millenial;PROVIDENCIA                   ;METROPOLITANA;0;0;0;0;0;0;0;0;0;LED 50 50UN8000 UHD SMART;ELECTRONICA MAYOR
14171381;;F;41;CHILENO;;X;N/D;N/D;0;0;0;0;0;0;0;0;0;LED 40 KEHD4020 SMART TV;ELECTRONICA MAYOR
18652633;;F;28;CHILENO;;Millenial;QUEMCHI                       ;LOS LAGOS;0;0;0;0;0;0;0;0;0;LED 55 55UN7100 UHD SMART TV;ELECTRONICA MAYOR
14588634;;M;42;CHILENO;;Silencioso;PROVIDENCIA                   ;METROPOLITANA;0;0;0;0;0;0;0;0;0;LED 32 32LM630BPSB SMART TV;ELECTRONICA MAYOR
18146502;;F;29;CHILENO;;Silencioso;PROVIDENCIA                   ;METROPOLITANA;0;0;0;0;0;0;0;0;0;LED 43 UN43T5202AGXZS FHD SMART TV;ELECTRONICA MAYOR
15351187;;F;39;CHILENO;;X;ANCUD                         ;LOS LAGOS;0;0;0;0;0;0;0;0;0;LED 50 KEUH50 SMART TV UHD;ELECTRONICA MAYOR
13449174;;M;44;CHILENO;;X;PROVIDENCIA                   ;METROPOLITANA;0;0;0;0;0;0;0;0;0;LED 40 KEHD4020 SMART TV;ELECTRONICA MAYOR
18299711;Soltero;M;29;CHILENO;;Silencioso;PROVIDENCIA                   ;METROPOLITANA;0;0;0;0;0;0;0;0;0;LED 55 55UN7100 UHD SMART TV;ELECTRONICA MAYOR
19148153;;F;26;CHILENO;;Z;N/D;N/D;0;0;0;0;0;0;0;0;0;MAGIC REMOTE MR20GA;ELECTRONICA MAYOR
17115203;;F;41;CHILENO;;X;ARICA                         ;ARICA Y PARINACOTA;0;0;0;0;0;0;0;0;0;LED 32 UN32T4300AGXZS HD SMART TV;ELECTRONICA MAYOR
13106308;;F;46;CHILENO;;X;N/D;N/D;0;0;0;0;0;0;0;0;0;LED 32 UN32T4300AGXZS HD SMART TV;ELECTRONICA MAYOR
18102941;;F;30;CHILENO;;Millenial;N/D;N/D;0;0;0;0;0;0;0;0;0;KARAOKE 8 CITY SET MIC WIRELESS ATRIL SILVER;ELECTRONICA MAYOR
9277236;;M;50;CHILENO;;X;VINA DEL MAR                  ;VALPARAISO;0;0;0;0;0;0;0;0;0;MONITOR 24 24TL520S SMART TV HD;ELECTRONICA MAYOR
13701466;Soltero;M;43;CHILENO;TECNICO MECANICO;Silencioso;PROVIDENCIA                   ;METROPOLITANA;0;0;0;0;0;0;0;0;0;LED KIOTO 32 MI3228 SMART TV;ELECTRONICA MAYOR
12238334;;F;49;CHILENO;;X;PROVIDENCIA                   ;METROPOLITANA;0;0;0;0;0;0;0;0;0;LED 49 49UN7100 UHD SMART TV;ELECTRONICA MAYOR
13988523;;F;41;CHILENO;;X;PROVIDENCIA                   ;METROPOLITANA;0;0;0;0;0;0;0;0;0;LED 32 32S5295 SMART TV HD;ELECTRONICA MAYOR
18536308;;M;28;CHILENO;;Millenial;N/D;N/D;0;0;0;0;0;0;0;0;0;MINICOMPONENTE CM4360;ELECTRONICA MAYOR
15711337;Soltero;M;38;CHILENO;;X;PROVIDENCIA                   ;METROPOLITANA;0;0;0;0;0;0;0;0;0;LED 55 55UN7100 UHD SMART TV;ELECTRONICA MAYOR
10162632;;M;53;CHILENO;;X;PROVIDENCIA                   ;METROPOLITANA;0;0;0;0;0;0;0;0;0;LED 50 UN50TU7090GXZS UHD SMART TV;ELECTRONICA MAYOR
14678173;;F;77;PERUANO;;Extranjero;LO PRADO                      ;METROPOLITANA;0;0;0;0;0;0;0;0;0;LED 40 KEHD4020 SMART TV;ELECTRONICA MAYOR
22341920;;M;51;BOLIVIANO;;Extranjero;POZO ALMONTE                  ;TARAPACA;0;0;0;0;0;0;0;0;0;LED 32 32LK540 HD SMART;ELECTRONICA MAYOR
13362180;;M;44;CHILENO;;X;PROVIDENCIA                   ;METROPOLITANA;0;0;0;0;0;0;0;0;0;LED 50 KEUH50 SMART TV UHD;ELECTRONICA MAYOR
16587146;;F;33;CHILENO;;Silencioso;PROVIDENCIA                   ;METROPOLITANA;0;0;0;0;0;0;0;0;0;LED 55 55PUD6794 SMART TV UHD 4K;ELECTRONICA MAYOR
13673229;;M;42;CHILENO;;X;PROVIDENCIA                   ;METROPOLITANA;0;0;0;0;0;0;0;0;0;LED 55 55PUD6794 SMART TV UHD 4K;ELECTRONICA MAYOR
7272417;;F;71;CHILENO;;Silencioso;N/D;N/D;0;0;0;0;0;0;0;0;0;LED 32 32LK540 HD SMART;ELECTRONICA MAYOR
15631877;;F;38;CHILENO;;Millenial;RENCA                         ;METROPOLITANA;0;0;0;0;0;0;0;0;0;LED 32 UN32T4300AGXZS HD SMART TV;ELECTRONICA MAYOR
19007369;;F;30;CHILENO;;Millenial;ROMERAL                       ;MAULE;0;0;0;0;0;0;0;0;0;KARAOKE FUNKY DISCO;ELECTRONICA MAYOR
7355500;;F;66;CHILENO;;Boomers;ANGOL                         ;ARAUCANIA;0;0;0;0;0;0;0;0;0;LED 55 55UN7100 UHD SMART TV;ELECTRONICA MAYOR
14903358;;F;40;CHILENO;;X;PROVIDENCIA                   ;METROPOLITANA;0;0;0;0;0;0;0;0;0;PARLANTE ULTRAFUSION;ELECTRONICA MAYOR
9278061;;F;54;CHILENO;;Boomers;SANTIAGO                      ;METROPOLITANA;0;0;0;0;0;0;0;0;0;LED 43 UN43T5202AGXZS FHD SMART TV;ELECTRONICA MAYOR
12637849;;F;47;CHILENO;;X;NATALES                       ;MAGALLANES;0;0;0;0;0;0;0;0;0;LED KIOTO 32 MI3228 SMART TV;ELECTRONICA MAYOR
10145612;;F;59;CHILENO;;Boomers;TALCA                         ;MAULE;0;0;0;0;0;0;0;0;0;LED 40 KEHD4020 SMART TV;ELECTRONICA MAYOR
20124824;;M;23;CHILENO;;Z;MARIA PINTO;METROPOLITANA;0;0;0;0;0;0;0;0;0;PARLANTE ULTRAFUSION;ELECTRONICA MAYOR
5239597;;M;77;CHILENO;;Silencioso;RENCA                         ;METROPOLITANA;0;0;0;0;0;0;0;0;0;LED 40 KEHD4020 SMART TV;ELECTRONICA MAYOR
18362402;Soltero;F;29;CHILENO;PSICOPEDAGOGO;Millenial;PROVIDENCIA                   ;METROPOLITANA;0;0;0;0;0;0;0;0;0;SOUNDBAR HW-T400/ZS;ELECTRONICA MAYOR
17731493;;F;31;CHILENO;;Millenial;PROVIDENCIA                   ;METROPOLITANA;0;0;0;0;0;0;0;0;0;PARLANTE SPBYF7 PORTATIL;ELECTRONICA MAYOR
16572574;;M;34;CHILENO;;Millenial;PROVIDENCIA                   ;METROPOLITANA;0;0;0;0;0;0;0;0;0;LED KIOTO 32 MI3228 SMART TV;ELECTRONICA MAYOR
10919742;;M;54;CHILENO;;Boomers;RENCA                         ;METROPOLITANA;0;0;0;0;0;0;0;0;0;LED KIOTO 32 MI3228 SMART TV;ELECTRONICA MAYOR
6914550;;M;65;CHILENO;;Boomers;ARICA                         ;TARAPACA;0;0;0;0;0;0;0;0;0;LED 55 UN55TU7090GXZS SMART TV UHD;ELECTRONICA MAYOR
17913341;Soltero;F;32;CHILENO;TECNICO;Millenial;PROVIDENCIA                   ;METROPOLITANA;0;0;0;0;0;0;0;0;0;LED 50 50PUD6513/44 SMART TV UHD 4K;ELECTRONICA MAYOR
8271214;;F;64;CHILENO;;Boomers;PUERTO MONTT                  ;LOS LAGOS;0;0;0;0;0;0;0;0;0;LED 40 KEHD4020 SMART TV;ELECTRONICA MAYOR
16192918;;F;36;CHILENO;;Millenial;N/D;N/D;0;0;0;0;0;0;0;0;0;LED 50 50PUD6513/44 SMART TV UHD 4K;ELECTRONICA MAYOR
8224668;;F;64;CHILENO;;Boomers;TEMUCO                        ;ARAUCANIA;0;0;0;0;0;0;0;0;0;LED 40 KEHD4020 SMART TV;ELECTRONICA MAYOR
13967388;;F;42;CHILENO;;X;PUERTO MONTT                  ;LOS LAGOS;0;0;0;0;0;0;0;0;0;LED KIOTO 32 MI3228 SMART TV;ELECTRONICA MAYOR
15467770;;M;40;CHILENO;;Silencioso;PROVIDENCIA                   ;METROPOLITANA;0;0;0;0;0;0;0;0;0;LED 40 KEHD4020 SMART TV;ELECTRONICA MAYOR
19877476;;M;24;CHILENO;;Z;PROVIDENCIA                   ;METROPOLITANA;0;0;0;0;0;0;0;0;0;LED 43 43UN7300 UHD SMART TV 4K;ELECTRONICA MAYOR
5937869;Viudo;M;73;CHILENO;PROFESOR;Silencioso;SAN JAVIER                    ;MAULE;0;0;0;0;0;0;0;0;0;LED KIOTO 32 MI3228 SMART TV;ELECTRONICA MAYOR
11091583;Soltero;F;56;CHILENO;;Boomers;PROVIDENCIA                   ;METROPOLITANA;0;0;0;0;0;0;0;0;0;LED KIOTO 32 MI3228 SMART TV;ELECTRONICA MAYOR
7518742;;M;64;CHILENO;;Boomers;PROVIDENCIA                   ;METROPOLITANA;0;0;0;0;0;0;0;0;0;LED 49 49UN7100 UHD SMART TV;ELECTRONICA MAYOR
11965348;;F;50;CHILENO;;X;ANGOL                         ;ARAUCANIA;0;0;0;0;0;0;0;0;0;LED 40 KEHD4020 SMART TV;ELECTRONICA MAYOR
13972828;Soltero;M;41;CHILENO;;X;PROVIDENCIA                   ;METROPOLITANA;0;0;0;0;0;0;0;0;0;LED 55 UN55TU8300GXZS UHD SMART TV CURVO;ELECTRONICA MAYOR
17594805;;F;31;CHILENO;;Millenial;COIHAIQUE                     ;AYSEN;0;0;0;0;0;0;0;0;0;LED 43 43LM6300PSB SMART TV HD;ELECTRONICA MAYOR
24893037;;F;31;BOLIVIANO;;Extranjero;CALAMA                        ;ANTOFAGASTA;0;0;0;0;0;0;0;0;0;LED 32 32LM630BPSB SMART TV;ELECTRONICA MAYOR
15290804;;M;38;CHILENO;;Millenial;QUELLON                       ;LOS LAGOS;0;0;0;0;0;0;0;0;0;LED 55 UN55TU7090GXZS SMART TV UHD;ELECTRONICA MAYOR
17470692;Soltero;M;31;CHILENO;;Millenial;CONSTITUCION                  ;MAULE;0;0;0;0;0;0;0;0;0;LED 49 49UN7100 UHD SMART TV;ELECTRONICA MAYOR
8255449;;F;63;CHILENO;;Boomers;VALPARAISO                    ;VALPARAISO;0;0;0;0;0;0;0;0;0;LED 32 UN32T4300AGXZS HD SMART TV;ELECTRONICA MAYOR
11394623;;F;53;CHILENO;;X;PUENTE ALTO                   ;METROPOLITANA;0;0;0;0;0;0;0;0;0;LED 55 UN55TU8300GXZS UHD SMART TV CURVO;ELECTRONICA MAYOR
11224561;;F;54;CHILENO;;X;SAN ANTONIO                   ;VALPARAISO;0;0;0;0;0;0;0;0;0;LED 58 KUHK5820 UHD SMART TV;ELECTRONICA MAYOR
8375182;;M;61;CHILENO;;Boomers;COIHAIQUE                     ;AYSEN;0;0;0;0;0;0;0;0;0;LED 49 49LJ5100 FHD;ELECTRONICA MAYOR
17853127;Soltero;M;31;CHILENO;PROFESOR;Millenial;PROVIDENCIA                   ;METROPOLITANA;0;0;0;0;0;0;0;0;0;LED 43 CS43S1USM UHD SMART TV NEGRO;ELECTRONICA MAYOR
8133290;;M;60;CHILENO;;Boomers;VALPARAISO                    ;VALPARAISO;0;0;0;0;0;0;0;0;0;LED 43 43LM6300PSB SMART TV HD;ELECTRONICA MAYOR
18431564;;F;28;CHILENO;;Silencioso;PROVIDENCIA                   ;METROPOLITANA;0;0;0;0;0;0;0;0;0;LED 50 KEUH50 SMART TV UHD;ELECTRONICA MAYOR
17029700;;F;33;CHILENO;;Millenial;PROVIDENCIA                   ;METROPOLITANA;0;0;0;0;0;0;0;0;0;PARLANTE GBASS GOLIAT;ELECTRONICA MAYOR
16971564;;M;33;CHILENO;;Millenial;QUILPUE                       ;VALPARAISO;0;0;0;0;0;0;0;0;0;LED 58 58PUD6513/44 SMART TV UHD;ELECTRONICA MAYOR
19893409;;F;23;CHILENO;;Silencioso;PROVIDENCIA                   ;METROPOLITANA;0;0;0;0;0;0;0;0;0;LED 50 50U6295 SMART TV UHD;ELECTRONICA MAYOR
9888096;;M;57;CHILENO;;Boomers;TEMUCO                        ;ARAUCANIA;0;0;0;0;0;0;0;0;0;LED 55 55UN7100 UHD SMART TV;ELECTRONICA MAYOR
17179286;;M;33;CHILENO;;Millenial;ANGOL                         ;ARAUCANIA;0;0;0;0;0;0;0;0;0;LED 50 KEUH50 SMART TV UHD;ELECTRONICA MAYOR
17636116;;F;32;CHILENO;;Millenial;CABILDO                       ;VALPARAISO;0;0;0;0;0;0;0;0;0;LED KIOTO 32 MI3228 SMART TV;ELECTRONICA MAYOR
15750806;;F;38;CHILENO;;Millenial;VILLARICA                     ;ARAUCANIA;0;0;0;0;0;0;0;0;0;LED 32 32S5295 SMART TV HD;ELECTRONICA MAYOR
24294158;;M;34;CUBANO;;Extranjero;N/D;N/D;0;0;0;0;0;0;0;0;0;LED 50 UN50TU7090GXZS UHD SMART TV;ELECTRONICA MAYOR
15425475;;F;39;CHILENO;;Millenial;N/D;N/D;0;0;0;0;0;0;0;0;0;LED KIOTO 32 MI3228 SMART TV;ELECTRONICA MAYOR
26080660;;M;33;VENEZOLANO;;Extranjero;ESTACION CENTRAL              ;METROPOLITANA;0;0;0;0;0;0;0;0;0;LED 55 M7650 SMART TV ULTRA HD;ELECTRONICA MAYOR
20179189;;F;22;CHILENO;;Z;PROVIDENCIA                   ;METROPOLITANA;0;0;0;0;0;0;0;0;0;KARAOKE FUNKY DISCO;ELECTRONICA MAYOR
18567453;;F;28;CHILENO;;Millenial;VALPARAISO                    ;VALPARAISO;0;0;0;0;0;0;0;0;0;LED 50 KEUH50 SMART TV UHD;ELECTRONICA MAYOR
16531191;;M;35;CHILENO;;Millenial;CHANCO                        ;MAULE;0;0;0;0;0;0;0;0;0;LED 50 50PUD6513/44 SMART TV UHD 4K;ELECTRONICA MAYOR
11881320;;F;51;CHILENO;;X;NOGALES                       ;VALPARAISO;0;0;0;0;0;0;0;0;0;LED 55 55UN7100 UHD SMART TV;ELECTRONICA MAYOR
8729399;;F;63;CHILENO;;Boomers;QUILLOTA                      ;VALPARAISO;0;0;0;0;0;0;0;0;0;SOUNDBAR SJ2;ELECTRONICA MAYOR
16132956;Soltero;F;37;CHILENO;ASISTENTE SOCIAL;Silencioso;PROVIDENCIA                   ;METROPOLITANA;0;0;0;0;0;0;0;0;0;LED 32 UN32T4300AGXZS HD SMART TV;ELECTRONICA MAYOR
20024095;;F;24;CHILENO;;Z;RENGO                         ;L.G.B.OÂ´HIGGINS;0;0;0;0;0;0;0;0;0;LED 40 KEHD4020 SMART TV;ELECTRONICA MAYOR
25849502;;M;33;CHILENO;;Extranjero;"";"";0;0;0;0;0;0;0;0;0;SOUNDBAR HW-T400/ZS;ELECTRONICA MAYOR
13567456;;M;43;CHILENO;;X;MOSTAZAL                      ;L.G.B.OÂ´HIGGINS;0;0;0;0;0;0;0;0;0;PARLANTE SPBYF7 PORTATIL;ELECTRONICA MAYOR
12846757;;M;46;CHILENO;;X;VALPARAISO                    ;VALPARAISO;0;0;0;0;0;0;0;0;0;LED 50 50PUD6654 SMART TV UHD BL BT SILVER;ELECTRONICA MAYOR
11343687;;F;54;CHILENO;;X;ANTOFAGASTA                   ;ANTOFAGASTA;0;0;0;0;0;0;0;0;0;LED 50 50PUD6654 SMART TV UHD BL BT SILVER;ELECTRONICA MAYOR
14314054;;F;46;CHILENO;;X;RENCA                         ;METROPOLITANA;0;0;0;0;0;0;0;0;0;LED 32 32LM630BPSB SMART TV;ELECTRONICA MAYOR
8065569;;M;65;CHILENO;;Boomers;PROVIDENCIA                   ;METROPOLITANA;0;0;0;0;0;0;0;0;0;MINICOMPONENTE CJ45;ELECTRONICA MAYOR
13250871;;M;44;CHILENO;;X;PROVIDENCIA                   ;METROPOLITANA;0;0;0;0;0;0;0;0;0;KARAOKE 8 CITY SET MIC WIRELESS ATRIL SILVER;ELECTRONICA MAYOR
17417614;;M;32;CHILENO;;Millenial;CAUQUENES                     ;MAULE;0;0;0;0;0;0;0;0;0;LED KIOTO 32 MI3228 SMART TV;ELECTRONICA MAYOR
10690994;;M;53;CHILENO;;X;CABILDO                       ;VALPARAISO;0;0;0;0;0;0;0;0;0;LED 40 KEHD4020 SMART TV;ELECTRONICA MAYOR
7407685;;M;66;CHILENO;;Boomers;ARICA                         ;ARICA Y PARINACOTA;0;0;0;0;0;0;0;0;0;LED 65 UN65TU6900GXZS UHD SMART TV;ELECTRONICA MAYOR
7259844;;M;67;CHILENO;;Boomers;QUILLOTA                      ;VALPARAISO;0;0;0;0;0;0;0;0;0;LED 43 43LM6300PSB SMART TV HD;ELECTRONICA MAYOR
18289532;;M;29;CHILENO;;Millenial;PROVIDENCIA                   ;METROPOLITANA;0;0;0;0;0;0;0;0;0;MINICOMPONENTE RN7;ELECTRONICA MAYOR
18088518;;F;30;CHILENO;;Millenial;COLINA                        ;METROPOLITANA;0;0;0;0;0;0;0;0;0;LED 40 KEHD4020 SMART TV;ELECTRONICA MAYOR
15705630;;M;38;CHILENO;;Millenial;PROVIDENCIA                   ;METROPOLITANA;0;0;0;0;0;0;0;0;0;LED 43 43LM6300PSB SMART TV HD;ELECTRONICA MAYOR
20101403;;F;23;CHILENO;;Z;PROVIDENCIA                   ;METROPOLITANA;0;0;0;0;0;0;0;0;0;LED KIOTO 32 MI3228 SMART TV;ELECTRONICA MAYOR
17221696;;M;33;CHILENO;;Millenial;SAN PEDRO DE LA PAZ           ;BIO BIO;0;0;0;0;0;0;0;0;0;LED 40 KEHD4020 SMART TV;ELECTRONICA MAYOR
16101394;;M;34;CHILENO;;Millenial;N/D;N/D;0;0;0;0;0;0;0;0;0;LED 55 UN55TU7100GXZS SMART TV;ELECTRONICA MAYOR
16729264;Casado;M;34;CHILENO;;Millenial;PROVIDENCIA                   ;METROPOLITANA;0;0;0;0;0;0;0;0;0;LED 32 UN32T4300AGXZS HD SMART TV;ELECTRONICA MAYOR
14643494;;F;58;PERUANO;;Extranjero;LA FLORIDA                    ;METROPOLITANA;0;0;0;0;0;0;0;0;0;LED 40 40S65A-40P ANDROID TV SMART LINE FHD;ELECTRONICA MAYOR
17645962;;F;31;CHILENO;;Millenial;RINCONADA                     ;VALPARAISO;0;0;0;0;0;0;0;0;0;LED 58 58PUD6513/44 SMART TV UHD;ELECTRONICA MAYOR
19516347;;M;27;CHILENO;;Millenial;PROVIDENCIA                   ;METROPOLITANA;0;0;0;0;0;0;0;0;0;MINICOMPONENTE CJ45;ELECTRONICA MAYOR
17860270;Soltero;M;30;CHILENO;;Millenial;PROVIDENCIA                   ;METROPOLITANA;0;0;0;0;0;0;0;0;0;LED 50 UN50TU7090GXZS UHD SMART TV;ELECTRONICA MAYOR
9509324;;M;58;CHILENO;;Boomers;VALPARAISO                    ;VALPARAISO;0;0;0;0;0;0;0;0;0;KARAOKE RHYTHM CHARGER 12 MIC CABLE 8890;ELECTRONICA MAYOR
19216917;;F;26;CHILENO;;Z;PROVIDENCIA                   ;METROPOLITANA;0;0;0;0;0;0;0;0;0;LED 49 49UJ6300 UHD SMART;ELECTRONICA MAYOR
14121051;;F;41;CHILENO;;X;PROVIDENCIA                   ;METROPOLITANA;0;0;0;0;0;0;0;0;0;LED 32 UN32T4300AGXZS HD SMART TV;ELECTRONICA MAYOR
14098328;;F;41;CHILENO;;X;ANTOFAGASTA                   ;ANTOFAGASTA;0;0;0;0;0;0;0;0;0;KARAOKE RHYTHM CHARGER 12 MIC CABLE 8890;ELECTRONICA MAYOR
12518683;;F;49;CHILENO;;X;VINA DEL MAR                  ;VALPARAISO;0;0;0;0;0;0;0;0;0;LED 40 KEHD4020 SMART TV;ELECTRONICA MAYOR
10125787;;F;60;CHILENO;;Boomers;RENCA                         ;METROPOLITANA;0;0;0;0;0;0;0;0;0;LED 40 KEHD4020 SMART TV;ELECTRONICA MAYOR
13411827;;M;44;CHILENO;;X;ARICA                         ;ARICA Y PARINACOTA;0;0;0;0;0;0;0;0;0;LED 55 UN55TU8300GXZS UHD SMART TV CURVO;ELECTRONICA MAYOR
7312345;;F;66;CHILENO;;Boomers;EL BOSQUE                     ;METROPOLITANA;0;0;0;0;0;0;0;0;0;LED 50 50PUD6513/44 SMART TV UHD 4K;ELECTRONICA MAYOR
17041587;Soltero;M;33;CHILENO;INGENIERO CIVIL MECANICO;Silencioso;PROVIDENCIA                   ;METROPOLITANA;0;0;0;0;0;0;0;0;0;LED 43 UN43T5202AGXZS FHD SMART TV;ELECTRONICA MAYOR
17483266;;M;32;CHILENO;;Millenial;PROVIDENCIA                   ;METROPOLITANA;0;0;0;0;0;0;0;0;0;LED 75 UN75TU6900GXZS UHD SMART TV;ELECTRONICA MAYOR
18623375;;F;28;CHILENO;;Millenial;PROVIDENCIA                   ;METROPOLITANA;0;0;0;0;0;0;0;0;0;MONITOR 24 24TL520S SMART TV HD;ELECTRONICA MAYOR
10875965;Soltero;M;55;CHILENO;;Boomers;NANCAGUA                      ;L.G.B.OÂ´HIGGINS;0;0;0;0;0;0;0;0;0;MINICOMPONENTE OL45;ELECTRONICA MAYOR
9969283;;M;56;CHILENO;;Boomers;SALAMANCA                     ;COQUIMBO;0;0;0;0;0;0;0;0;0;LED 49 49UN7100 UHD SMART TV;ELECTRONICA MAYOR
6144773;;F;76;CHILENO;;Silencioso;CONCON                        ;VALPARAISO;0;0;0;0;0;0;0;0;0;LED 43 43LM6300PSB SMART TV HD;ELECTRONICA MAYOR
19034851;;F;27;CHILENO;;Z;HUECHURABA                    ;METROPOLITANA;0;0;0;0;0;0;0;0;0;LED 43 UN43T5202AGXZS FHD SMART TV;ELECTRONICA MAYOR
15244642;Soltero;M;41;CHILENO;;X;PROVIDENCIA                   ;METROPOLITANA;0;0;0;0;0;0;0;0;0;MINICOMPONENTE RN5;ELECTRONICA MAYOR
14090817;;F;41;CHILENO;;X;SAN IGNACIO                   ;BIO BIO;0;0;0;0;0;0;0;0;0;PARLANTE ULTRAMAGIC;ELECTRONICA MAYOR
16811457;;F;33;CHILENO;;Millenial;CASTRO                        ;LOS LAGOS;0;0;0;0;0;0;0;0;0;LED 43 43S5295 SMART TV FHD;ELECTRONICA MAYOR
13430683;;M;44;CHILENO;;X;RENCA                         ;METROPOLITANA;0;0;0;0;0;0;0;0;0;KARAOKE BLACK PHANTER II;ELECTRONICA MAYOR
18482964;;F;28;CHILENO;;Extranjero;N/D;N/D;0;0;0;0;0;0;0;0;0;LED 50 UN50TU7090GXZS UHD SMART TV;ELECTRONICA MAYOR
17029306;;M;33;CHILENO;;Millenial;RENCA                         ;METROPOLITANA;0;0;0;0;0;0;0;0;0;PARLANTE ULTRAMEGA;ELECTRONICA MAYOR
17024543;Soltero;M;33;CHILENO;BIBLIOTECARIO;Millenial;PROVIDENCIA                   ;METROPOLITANA;0;0;0;0;0;0;0;0;0;LED 43 UN43T5202AGXZS FHD SMART TV;ELECTRONICA MAYOR
12213887;;F;49;CHILENO;;X;RENCA                         ;METROPOLITANA;0;0;0;0;0;0;0;0;0;PARLANTE ULTRAMAGIC;ELECTRONICA MAYOR
9031678;;F;61;CHILENO;;Boomers;RETIRO                        ;MAULE;0;0;0;0;0;0;0;0;0;LED 32 32PHD5813 SMART TV HD;ELECTRONICA MAYOR
7483167;;M;66;CHILENO;;Boomers;PUCON                         ;ARAUCANIA;0;0;0;0;0;0;0;0;0;LED 32 32PHD5813 SMART TV HD;ELECTRONICA MAYOR
11674064;;F;51;CHILENO;;X;CHEPICA                       ;L.G.B.OÂ´HIGGINS;0;0;0;0;0;0;0;0;0;LED 55 55UN7100 UHD SMART TV;ELECTRONICA MAYOR
15048997;;M;38;CHILENO;;Millenial;N/D;N/D;0;0;0;0;0;0;0;0;0;MINICOMPONENTE RN7;ELECTRONICA MAYOR
11686594;;M;53;CHILENO;;X;NUEVA IMPERIAL                ;ARAUCANIA;0;0;0;0;0;0;0;0;0;LED 55 UN55NU7095GXZS SMART TV TV 4K;ELECTRONICA MAYOR
13347513;;M;43;CHILENO;;X;RENCA                         ;METROPOLITANA;0;0;0;0;0;0;0;0;0;LED 49 49LJ5100 FHD;ELECTRONICA MAYOR
18072018;;M;30;CHILENO;;Millenial;PROVIDENCIA                   ;METROPOLITANA;0;0;0;0;0;0;0;0;0;LED 43 43PFD5813 SMART TV FULL HD;ELECTRONICA MAYOR
26621725;Soltero;F;33;VENEZOLANO;;Extranjero;PROVIDENCIA                   ;METROPOLITANA;0;0;0;0;0;0;0;0;0;LED 32 UN32T4300AGXZS HD SMART TV;ELECTRONICA MAYOR
11162305;Divorciado;F;55;CHILENO;;Boomers;RENCA                         ;METROPOLITANA;0;0;0;0;0;0;0;0;0;LED 50 UN50TU7090GXZS UHD SMART TV;ELECTRONICA MAYOR
10222918;;F;56;CHILENO;;Boomers;PROVIDENCIA                   ;METROPOLITANA;0;0;0;0;0;0;0;0;0;PARLANTE ULTRAMAGIC;ELECTRONICA MAYOR
17719248;;F;30;CHILENO;;Millenial;CASTRO                        ;LOS LAGOS;0;0;0;0;0;0;0;0;0;LED 43 43S5295 SMART TV FHD;ELECTRONICA MAYOR
13291330;;F;45;CHILENO;;X;PROVIDENCIA                   ;METROPOLITANA;0;0;0;0;0;0;0;0;0;PARLANTE ULTRAMAGIC;ELECTRONICA MAYOR
15733729;Soltero;F;38;CHILENO;;X;RENCA                         ;METROPOLITANA;0;0;0;0;0;0;0;0;0;LED 50 50PUD6513/44 SMART TV UHD 4K;ELECTRONICA MAYOR
11694837;;F;51;CHILENO;;X;SAN BERNARDO                  ;METROPOLITANA;0;0;0;0;0;0;0;0;0;KARAOKE BLACK PHANTER II;ELECTRONICA MAYOR
10114035;;M;55;CHILENO;;Boomers;LA LIGUA                      ;VALPARAISO;0;0;0;0;0;0;0;0;0;LED 32 32S60-32P ANDROID TV SMART LINE HD;ELECTRONICA MAYOR
18507550;Casado;F;28;CHILENO;;Millenial;PROVIDENCIA                   ;METROPOLITANA;0;0;0;0;0;0;0;0;0;LED 43 UN43T5202AGXZS FHD SMART TV;ELECTRONICA MAYOR
18368038;Soltero;F;29;CHILENO;;Millenial;PROVIDENCIA                   ;METROPOLITANA;0;0;0;0;0;0;0;0;0;LED 43 UN43T5202AGXZS FHD SMART TV;ELECTRONICA MAYOR
7879864;;M;66;CHILENO;;Boomers;PADRE HURTADO                 ;METROPOLITANA;0;0;0;0;0;0;0;0;0;SOUNDBAR HW-T400/ZS;ELECTRONICA MAYOR
10176153;;F;60;CHILENO;;Boomers;BUIN                          ;METROPOLITANA;0;0;0;0;0;0;0;0;0;LED 50 UN50TU7090GXZS UHD SMART TV;ELECTRONICA MAYOR
8911364;;F;63;CHILENO;;Boomers;PUNTA ARENAS                  ;MAGALLANES;0;0;0;0;0;0;0;0;0;LED 55 UN55RU7300GXZS SMART TV UHD;ELECTRONICA MAYOR
9984482;;F;61;CHILENO;;Boomers;TALCAHUANO                    ;BIO BIO;0;0;0;0;0;0;0;0;0;MINICOMPONENTE RN5;ELECTRONICA MAYOR
15144389;;M;40;CHILENO;;X;N/D;N/D;0;0;0;0;0;0;0;0;0;LED 43 CS43S1USM UHD SMART TV NEGRO;ELECTRONICA MAYOR
19172100;;M;27;CHILENO;;Z;RANCAGUA                      ;L.G.B.OÂ´HIGGINS;0;0;0;0;0;0;0;0;0;LED 50 UN50TU7090GXZS UHD SMART TV;ELECTRONICA MAYOR
9416745;;F;56;CHILENO;;Boomers;LOS ANDES                     ;VALPARAISO;0;0;0;0;0;0;0;0;0;LED 49 49LJ5100 FHD;ELECTRONICA MAYOR
11346056;Casado;M;54;CHILENO;;X;PROVIDENCIA                   ;METROPOLITANA;0;0;0;0;0;0;0;0;0;LED 32 32S5295 SMART TV HD;ELECTRONICA MAYOR
18971065;Soltero;F;27;CHILENO;;Millenial;PROVIDENCIA                   ;METROPOLITANA;0;0;0;0;0;0;0;0;0;PARLANTE ULTRAFORCE-I;ELECTRONICA MAYOR
24489576;;M;44;BOLIVIANO;;Extranjero;IQUIQUE                       ;TARAPACA;0;0;0;0;0;0;0;0;0;LED 49 49LJ5100 FHD;ELECTRONICA MAYOR
18008672;Soltero;F;30;CHILENO;TECNICO DE NIVEL SUPERIOR PARAMEDICO EN ODONTOLOGIA;Millenial;PROVIDENCIA                   ;METROPOLITANA;0;0;0;0;0;0;0;0;0;MINICOMPONENTE CJ45;ELECTRONICA MAYOR
14046096;Soltero;F;40;CHILENO;INGENIERO EN PREVENCION DE RIESGOS;X;PROVIDENCIA                   ;METROPOLITANA;0;0;0;0;0;0;0;0;0;KARAOKE RHYTHM CHARGER 12 MIC CABLE 8890;ELECTRONICA MAYOR
16169257;Casado;F;37;CHILENO;TECNICO DE NIVEL SUPERIOR EN ENFERMERIA;Millenial;PROVIDENCIA                   ;METROPOLITANA;0;0;0;0;0;0;0;0;0;LED 43 UN43J5202AGXZS SMART TV FHD;ELECTRONICA MAYOR
18558306;Soltero;M;28;CHILENO;;Millenial;PROVIDENCIA                   ;METROPOLITANA;0;0;0;0;0;0;0;0;0;LED 49 49LJ5100 FHD;ELECTRONICA MAYOR
8848879;;M;63;CHILENO;;Boomers;ANGOL                         ;ARAUCANIA;0;0;0;0;0;0;0;0;0;LED 32 UN32T4300AGXZS HD SMART TV;ELECTRONICA MAYOR
15427120;;M;39;CHILENO;;X;PROVIDENCIA                   ;METROPOLITANA;0;0;0;0;0;0;0;0;0;LED 32 UN32T4300AGXZS HD SMART TV;ELECTRONICA MAYOR
7239122;;F;74;CHILENO;;Silencioso;SAN ANTONIO                   ;VALPARAISO;0;0;0;0;0;0;0;0;0;LED 49 49LJ5100 FHD;ELECTRONICA MAYOR
14193178;;M;42;CHILENO;;X;PROVIDENCIA                   ;METROPOLITANA;0;0;0;0;0;0;0;0;0;LED 50 50PUD6513/44 SMART TV UHD 4K;ELECTRONICA MAYOR
13090975;;M;46;CHILENO;;X;RENCA                         ;METROPOLITANA;0;0;0;0;0;0;0;0;0;MONITOR 24 24TL520S SMART TV HD;ELECTRONICA MAYOR
8274606;;M;63;CHILENO;;Boomers;LOS SAUCES                    ;ARAUCANIA;0;0;0;0;0;0;0;0;0;PARLANTE ULTRAFORCE-I;ELECTRONICA MAYOR
11266165;;F;53;CHILENO;;X;PROVIDENCIA                   ;METROPOLITANA;0;0;0;0;0;0;0;0;0;LED 70 UN70TU6900GXZS UHD SMART TV;ELECTRONICA MAYOR
18013925;Soltero;M;30;CHILENO;;Millenial;PROVIDENCIA                   ;METROPOLITANA;0;0;0;0;0;0;0;0;0;PARLANTE ULTRAFORCE-I;ELECTRONICA MAYOR
10458186;;M;47;CHILENO;;X;PROVIDENCIA                   ;METROPOLITANA;0;0;0;0;0;0;0;0;0;LED 43 43PFD5813 SMART TV FULL HD;ELECTRONICA MAYOR
7559729;;M;64;CHILENO;;Boomers;SAN ANTONIO                   ;VALPARAISO;0;0;0;0;0;0;0;0;0;LED 49 49LJ5100 FHD;ELECTRONICA MAYOR
8038872;;M;63;CHILENO;;Boomers;PROVIDENCIA                   ;METROPOLITANA;0;0;0;0;0;0;0;0;0;LED 32 UN32T4300AGXZS HD SMART TV;ELECTRONICA MAYOR
16910280;;F;34;CHILENO;;Millenial;PROVIDENCIA                   ;METROPOLITANA;0;0;0;0;0;0;0;0;0;LED 32 32LM630BPSB SMART TV;ELECTRONICA MAYOR
13384734;Soltero;M;43;CHILENO;INGENIERO;X;PROVIDENCIA                   ;METROPOLITANA;0;0;0;0;0;0;0;0;0;MINICOMPONENTE RN5;ELECTRONICA MAYOR
17748353;;M;31;CHILENO;;Millenial;RENCA                         ;METROPOLITANA;0;0;0;0;0;0;0;0;0;LED 55 UN55NU7095GXZS SMART TV TV 4K;ELECTRONICA MAYOR
16759783;;M;34;CHILENO;;Millenial;SAN ANTONIO                   ;VALPARAISO;0;0;0;0;0;0;0;0;0;LED 43 UN43TU7090GXZS UHD SMART TV;ELECTRONICA MAYOR
18087199;Soltero;M;30;CHILENO;TECNICO EN ADMINISTRACION DE EMPRESAS;Millenial;PROVIDENCIA                   ;METROPOLITANA;0;0;0;0;0;0;0;0;0;LED 43 43S5295 SMART TV FHD;ELECTRONICA MAYOR
13577408;;F;42;CHILENO;;X;QUINTA NORMAL                 ;METROPOLITANA;0;0;0;0;0;0;0;0;0;MINICOMPONENTE OL45;ELECTRONICA MAYOR
11733660;;F;51;CHILENO;;X;QUILLOTA                      ;VALPARAISO;0;0;0;0;0;0;0;0;0;LED 32 32S5295 SMART TV HD;ELECTRONICA MAYOR
15293819;;M;40;CHILENO;;X;PROVIDENCIA                   ;METROPOLITANA;0;0;0;0;0;0;0;0;0;LED 58 58PUD6513/44 SMART TV UHD;ELECTRONICA MAYOR
7217391;;F;67;CHILENO;;Boomers;RENGO                         ;L.G.B.OÂ´HIGGINS;0;0;0;0;0;0;0;0;0;LED 32 32LK540 HD SMART;ELECTRONICA MAYOR
11136350;;F;55;CHILENO;;Boomers;PROVIDENCIA                   ;METROPOLITANA;0;0;0;0;0;0;0;0;0;LED 43 MI4328 SMART TV;ELECTRONICA MAYOR
12351740;;F;49;CHILENO;;X;SAN FELIPE                    ;VALPARAISO;0;0;0;0;0;0;0;0;0;LED 50 50U6295 SMART TV UHD;ELECTRONICA MAYOR
20270372;;F;22;CHILENO;;Z;PROVIDENCIA                   ;METROPOLITANA;0;0;0;0;0;0;0;0;0;LED KIOTO 32 MI3228 SMART TV;ELECTRONICA MAYOR
13769480;;M;45;CHILENO;;X;CONCON                        ;VALPARAISO;0;0;0;0;0;0;0;0;0;LED 43 UN43J5202AGXZS SMART TV FHD;ELECTRONICA MAYOR
8033762;;M;64;CHILENO;;Boomers;RENCA                         ;METROPOLITANA;0;0;0;0;0;0;0;0;0;LED KIOTO 32 MI3228 SMART TV;ELECTRONICA MAYOR
8734734;;F;68;CHILENO;;Boomers;ANTOFAGASTA                   ;ANTOFAGASTA;0;0;0;0;0;0;0;0;0;LED 32 UN32T4300AGXZS HD SMART TV;ELECTRONICA MAYOR
3973134;;M;84;CHILENO;;Silencioso;SAN VICENTE                   ;L.G.B.OÂ´HIGGINS;0;0;0;0;0;0;0;0;0;LED 32 32PHD5813 SMART TV HD;ELECTRONICA MAYOR
18087046;Casado;F;30;CHILENO;;Millenial;PROVIDENCIA                   ;METROPOLITANA;0;0;0;0;0;0;0;0;0;MINICOMPONENTE MX-T50/ZS ALL IN ONE;ELECTRONICA MAYOR
6617692;;F;69;CHILENO;;Silencioso;PUENTE ALTO                   ;METROPOLITANA;0;0;0;0;0;0;0;0;0;LED 65 65UN7300 UHD SMART TV;ELECTRONICA MAYOR
7836893;;M;66;CHILENO;;Boomers;CHIMBARONGO                   ;L.G.B.OÂ´HIGGINS;0;0;0;0;0;0;0;0;0;LED 43 UN43J5202AGXZS SMART TV FHD;ELECTRONICA MAYOR
25975827;;M;39;VENEZOLANO;;Extranjero;ESTACION CENTRAL              ;METROPOLITANA;0;0;0;0;0;0;0;0;0;LED 50 50PUD6513/44 SMART TV UHD 4K;ELECTRONICA MAYOR
13538770;;F;42;CHILENO;;X;PROVIDENCIA                   ;METROPOLITANA;0;0;0;0;0;0;0;0;0;PARLANTE DJ VIBRANIUM;ELECTRONICA MAYOR
15784186;;F;38;CHILENO;;Millenial;PROVIDENCIA                   ;METROPOLITANA;0;0;0;0;0;0;0;0;0;LED 50 MI50291 SMART TV 4K;ELECTRONICA MAYOR
12392664;;F;49;CHILENO;;X;SAN RAMON                     ;METROPOLITANA;0;0;0;0;0;0;0;0;0;KARAOKE RHYTHM CHARGER 12 MIC CABLE 8890;ELECTRONICA MAYOR
7634337;;F;67;CHILENO;;Boomers;SAN CARLOS                    ;BIO BIO;0;0;0;0;0;0;0;0;0;LED 50 UN50TU7090GXZS UHD SMART TV;ELECTRONICA MAYOR
18522112;;M;28;CHILENO;;Millenial;SAN BERNARDO                  ;METROPOLITANA;0;0;0;0;0;0;0;0;0;LED 50 UN50TU7090GXZS UHD SMART TV;ELECTRONICA MAYOR
20230942;;F;22;CHILENO;;Z;PROVIDENCIA                   ;METROPOLITANA;0;0;0;0;0;0;0;0;0;PARLANTE CITY MIC WIRELESS GREEN 8710;ELECTRONICA MAYOR
12727608;;M;47;CHILENO;;X;RENCA                         ;METROPOLITANA;0;0;0;0;0;0;0;0;0;LED 55 55UN7300 UHD SMART TV;ELECTRONICA MAYOR
16764570;;F;34;CHILENO;;Millenial;PROVIDENCIA                   ;METROPOLITANA;0;0;0;0;0;0;0;0;0;LED 32 32LM630BPSB SMART TV;ELECTRONICA MAYOR
13181030;;F;45;CHILENO;;X;PENALOLEN                     ;METROPOLITANA;0;0;0;0;0;0;0;0;0;PARLANTE CITY MIC WIRELESS GREEN 8710;ELECTRONICA MAYOR
17906071;;M;31;CHILENO;;Millenial;EL BOSQUE                     ;METROPOLITANA;0;0;0;0;0;0;0;0;0;LED 32 UN32T4300AGXZS HD SMART TV;ELECTRONICA MAYOR
13644847;;M;43;CHILENO;;X;PROVIDENCIA                   ;METROPOLITANA;0;0;0;0;0;0;0;0;0;LED 32 32S5295 SMART TV HD;ELECTRONICA MAYOR
9516639;Casado;M;59;CHILENO;AGROINDUSTRIA;Boomers;PROVIDENCIA                   ;METROPOLITANA;0;0;0;0;0;0;0;0;0;MINICOMPONENTE MHC-V02 ALL IN ONE;ELECTRONICA MAYOR
15260455;;M;41;CHILENO;;X;"";"";0;0;0;0;0;0;0;0;0;LED 32 32PHD5813 SMART TV HD;ELECTRONICA MAYOR
11651265;;M;53;CHILENO;;X;CONSTITUCION                  ;MAULE;0;0;0;0;0;0;0;0;0;LED 32 32PHD5813 SMART TV HD;ELECTRONICA MAYOR
19163056;;F;27;CHILENO;;Z;RENCA                         ;METROPOLITANA;0;0;0;0;0;0;0;0;0;LED 58 58PUD6513/44 SMART TV UHD;ELECTRONICA MAYOR
7443798;;M;68;CHILENO;;Boomers;LOS ANGELES                   ;BIO BIO;0;0;0;0;0;0;0;0;0;MINICOMPONENTE RN5;ELECTRONICA MAYOR
14467053;;F;50;CHILENO;;X;RENCA                         ;METROPOLITANA;0;0;0;0;0;0;0;0;0;PARLANTE DJ VIBRANIUM;ELECTRONICA MAYOR
16723219;Soltero;M;34;CHILENO;;Millenial;PROVIDENCIA                   ;METROPOLITANA;0;0;0;0;0;0;0;0;0;LED KIOTO 32 MI3228 SMART TV;ELECTRONICA MAYOR
12787305;;F;49;CHILENO;;X;PROVIDENCIA                   ;METROPOLITANA;0;0;0;0;0;0;0;0;0;LED 32 32LM630BPSB SMART TV;ELECTRONICA MAYOR
17965093;;M;30;CHILENO;;Millenial;PROVIDENCIA                   ;METROPOLITANA;0;0;0;0;0;0;0;0;0;LED 43 MI4328 SMART TV;ELECTRONICA MAYOR
12517809;;M;48;CHILENO;;X;MACHALI                       ;L.G.B.OÂ´HIGGINS;0;0;0;0;0;0;0;0;0;MONITOR 24 24TL520S SMART TV HD;ELECTRONICA MAYOR
18245598;;M;30;CHILENO;;Millenial;N/D;N/D;0;0;0;0;0;0;0;0;0;LED 50 UN50TU7090GXZS UHD SMART TV;ELECTRONICA MAYOR
12677969;;M;47;CHILENO;;X;PUDAHUEL                      ;METROPOLITANA;0;0;0;0;0;0;0;0;0;LED 50 UN50TU7090GXZS UHD SMART TV;ELECTRONICA MAYOR
18688451;;F;28;CHILENO;;Millenial;PROVIDENCIA                   ;METROPOLITANA;0;0;0;0;0;0;0;0;0;LED 50 MI50291 SMART TV 4K;ELECTRONICA MAYOR
8002049;;M;63;CHILENO;;Boomers;RENCA                         ;METROPOLITANA;0;0;0;0;0;0;0;0;0;LED 32 CS32S1 SMART TV HD NEGRO;ELECTRONICA MAYOR
15089242;Soltero;F;39;CHILENO;;X;PROVIDENCIA                   ;METROPOLITANA;0;0;0;0;0;0;0;0;0;MINICOMPONENTE RN5;ELECTRONICA MAYOR
