CUSTOMER_ID;ESTADO_CIVIL;SEXO;EDAD;NACIONALIDAD;PROFESION;GENERACION_CLIENTE;COMUNA_CLIENTE;CIUDAD_CLIENTE;SUMA_INGRESOS_12;CANTIDAD_PRODUCTOS_12;SUMA_BOLETAS_12;CANTIDAD_UNIDADES_ECOMMERCE_12;SUMA_BOLETAS_ECOMMERCE_12;SUMA_INGRESOS_ECOMMERCE_12;CANTIDAD_UNIDADES_TIENDA_12;SUMA_BOLETAS_TIENDA_12;SUMA_INGRESOS_TIENDA_12;ULTIMO_PRODUCTO_COMPRADO;LINEA_ULTIMO_PRODUCTO_COMPRDO
12630789;;F;48;CHILENO;;X;MAIPU                         ;METROPOLITANA;255870;7;3;0;0;0;7;3;255870;Bolsa Papel Grande Abcdin;PROMOCIONES
9949948;Casado;M;58;CHILENO;;Boomers;PROVIDENCIA                   ;METROPOLITANA;500;2;1;0;0;0;2;1;500;Bolsa Papel Grande Abcdin;PROMOCIONES
18489503;;F;28;CHILENO;;Millenial;CHILLAN                       ;BIO BIO;1578340;5;5;0;0;0;5;5;1578340;MOTO LX125-76A LONCIN NEGRO/GRIS;MOTOCICLETAS
19897212;;F;23;CHILENO;;Z;N/D;N/D;1943761;13;5;0;0;0;13;5;1943761;MOTO LX125-76A LONCIN NEGRO;MOTOCICLETAS
18551597;;F;28;CHILENO;;Millenial;PROVIDENCIA                   ;METROPOLITANA;0;0;0;0;0;0;0;0;0;Bolsa Papel Grande Abcdin;PROMOCIONES
8851547;;F;65;CHILENO;;Boomers;LOS ANGELES                   ;BIO BIO;0;0;0;0;0;0;0;0;0;Bolsa Papel Abcdin;PROMOCIONES
18790329;;M;28;CHILENO;;Millenial;ANTOFAGASTA                   ;ANTOFAGASTA;0;0;0;0;0;0;0;0;0;Waterboom;PROM RETAIL FINANCIERO
16928210;;F;33;CHILENO;;Millenial;PROVIDENCIA                   ;METROPOLITANA;214960;4;3;4;3;214960;0;0;0;V-MOCHILA TACOMA 29LTS NARANJO NAT GEO S17;OUTDOOR
16753608;;M;34;CHILENO;;Millenial;VALPARAISO;VALPARAISO;46980;2;1;2;1;46980;0;0;0;MI PRIMER TRAMPOLIN 140CM GAMEPOWER AZUL/AMARILL;OUTDOOR
10023886;;M;57;CHILENO;;Boomers;COLINA                        ;METROPOLITANA;142970;3;3;0;0;0;3;3;142970;MOTO ELECTRICA CELESTE;OUTDOOR
17479248;;M;32;CHILENO;;Silencioso;PROVIDENCIA                   ;METROPOLITANA;211950;5;2;5;2;211950;0;0;0;V-SACO DE DORMIR EXPLORER NARANJO;OUTDOOR
20528517;;F;21;CHILENO;;Z;PUREN;ARAUCANIA;848630;33;4;33;4;848630;0;0;0;Scooter con Burbujas KeyRiders;OUTDOOR
19094639;;F;27;CHILENO;;Z;N/D;N/D;232960;4;3;4;3;232960;0;0;0;V-CARPA PLAYA OUTBACK OUTBACK;OUTDOOR
18467402;;M;28;CHILENO;;Extranjero;PROVIDENCIA                   ;N/D;13980;2;1;2;1;13980;0;0;0;Botella Metalica National Geographic 960Ml Color;OUTDOOR
13914347;;M;42;CHILENO;;X;TALCA;MAULE;70980;2;1;2;1;70980;0;0;0;CAMA ELASTICA (1,83M) CON MALLA GAMEPOWER AZUL;OUTDOOR
19368967;;F;25;CHILENO;;Z;CALBUCO                       ;LOS LAGOS;160960;4;2;0;0;0;4;2;160960;Scooter Peluche Dinosaurio y Luces Led KeyRiders;OUTDOOR
17873266;;F;31;CHILENO;;Millenial;PUENTE ALTO                   ;METROPOLITANA;193980;2;1;2;1;193980;0;0;0;Cama Elastica + Malla y Escalera 8ft;OUTDOOR
9405161;;F;59;CHILENO;;Boomers;RENCA                         ;METROPOLITANA;73980;2;1;2;1;73980;0;0;0;Resbalin Rojo 135X90X60.5 Cm;OUTDOOR
12683347;;F;48;CHILENO;;X;CALAMA                        ;ANTOFAGASTA;327970;3;2;2;1;127980;1;1;199990;Auto Electrico Descapotable Coupe Rojo;OUTDOOR
15326115;;F;46;CHILENO;;X;PROVIDENCIA                   ;METROPOLITANA;159060;4;2;4;2;159060;0;0;0;V-BOLSO PORTA EQUIPAJE MEDIANO NAT GEO S17;OUTDOOR
17134700;;M;33;CHILENO;;Millenial;"";"";127980;2;1;2;1;127980;0;0;0;Auto Electrico Descapotable Coupe Rojo;OUTDOOR
8842916;;M;61;CHILENO;;Boomers;RENCA                         ;METROPOLITANA;9990;1;2;2;1;62980;-1;1;-52990;Mesa AirHockey Carromco;OUTDOOR
10519708;;M;57;CHILENO;;Boomers;RENCA                         ;METROPOLITANA;137980;2;1;2;1;137980;0;0;0;Auto Electrico 4x4 Descapotable Verde Militar;OUTDOOR
18671210;;M;34;CHILENO;;Millenial;N/D;N/D;138980;2;1;2;1;138980;0;0;0;Auto Electrico 4x4 Descapotable Verde Militar;OUTDOOR
16579685;;F;36;CHILENO;;Millenial;PROVIDENCIA                   ;METROPOLITANA;66970;3;2;2;1;31980;1;1;34990;COLCHON 2 PZA 203X152X22 CM;OUTDOOR
14236935;;F;55;CHILENO;;Boomers;VALDIVIA                      ;LOS LAGOS;414960;4;4;0;0;0;4;4;414960;GO-KART PEDALES NEGRO;OUTDOOR
9043036;;F;59;CHILENO;;Millenial;"";"";113980;2;1;2;1;113980;0;0;0;PISCINA CIRCULAR STEEL PRO;OUTDOOR
25628061;;M;32;VENEZOLANO;;Extranjero;SANTIAGO                      ;METROPOLITANA;57970;3;1;3;1;57970;0;0;0;V-SILLA PLEGABLE PLAYA PACIFIC S17;OUTDOOR
12045519;Casado;M;44;CHILENO;INGENIERO CIVIL;X;PROVIDENCIA                   ;METROPOLITANA;35960;4;2;4;2;35960;0;0;0;SPIN BALL;OUTDOOR
6090985;;M;72;CHILENO;;Silencioso;N/D;N/D;292950;5;4;0;0;0;5;4;292950;Correpasillos Unicornio Rosado;OUTDOOR
19898334;;F;23;CHILENO;;Z;N/D;N/D;180820;4;2;2;1;95840;2;1;84980;V-CARPA 5 PERSONAS ROCKPORT NATGEO;OUTDOOR
17816081;Soltero;F;31;CHILENO;EDUCADOR DE PARVULO;Millenial;PROVIDENCIA                   ;METROPOLITANA;19990;1;1;0;0;0;1;1;19990;COLCHON 2 PZA 203X152X22 CM;OUTDOOR
15808778;Soltero;M;38;CHILENO;;Millenial;PROVIDENCIA                   ;METROPOLITANA;20990;1;1;0;0;0;1;1;20990;COLCHON 2 PZA 203X152X22 CM;OUTDOOR
15926169;;F;36;CHILENO;;Millenial;N/D;N/D;99990;1;1;1;1;99990;0;0;0;PISCINA CIRCULAR STEEL PRO;OUTDOOR
12788710;;M;47;CHILENO;;X;LO BARNECHEA                  ;METROPOLITANA;19990;1;1;0;0;0;1;1;19990;COLCHON 2 PZA 203X152X22 CM;OUTDOOR
18366841;;F;29;CHILENO;;Millenial;PROVIDENCIA                   ;METROPOLITANA;15680;2;1;2;1;15680;0;0;0;V-QUITASOL BLANCO NAT GEO S17;OUTDOOR
17215814;;M;33;CHILENO;;Millenial;"";"";6000;2;1;0;0;0;2;1;6000;Botella Metalica National Geographic 500Ml Color;OUTDOOR
16758568;;M;34;CHILENO;;Millenial;PROVIDENCIA                   ;METROPOLITANA;124970;3;3;1;1;19990;2;2;104980;COLCHON 2 PZA 203X152X22 CM;OUTDOOR
6432529;Casado;F;70;CHILENO;PROFESOR;Silencioso;PROVIDENCIA                   ;METROPOLITANA;230960;4;2;4;2;230960;0;0;0;GO-KART PEDALES NEGRO;OUTDOOR
10025568;;F;61;CHILENO;;Boomers;NATALES                       ;MAGALLANES;19990;1;1;0;0;0;1;1;19990;Scooter Peluche Unicornio y Luces Led KeyRiders;OUTDOOR
14592402;;M;48;CHILENO;;X;PROVIDENCIA                   ;METROPOLITANA;19990;1;1;0;0;0;1;1;19990;Juego de Mesa Camcorro 10 en 1;OUTDOOR
15113286;;F;39;CHILENO;;X;PROVIDENCIA                   ;METROPOLITANA;144540;2;1;2;1;144540;0;0;0;PISCINA CIRCULAR STEEL PRO 6473 L;OUTDOOR
16853858;;F;34;CHILENO;;Millenial;ANGOL                         ;ARAUCANIA;76960;4;1;0;0;0;4;1;76960;Juego de Mesa Camcorro 10 en 1;OUTDOOR
26453269;;M;37;EXTRANJERO - NO INFORMA NACIONALIDAD;;Extranjero;N/D;N/D;409960;5;3;5;3;409960;0;0;0;PISCINA STEEL PRO 300X201X66CM;OUTDOOR
15243234;Casado;F;39;CHILENO;PROFESOR;X;RENCA                         ;METROPOLITANA;349990;1;1;0;0;0;1;1;349990;PISCINA STEEL PRO MAXÂ¿ 56709 BESTWAY DISENO RATT;OUTDOOR
15103442;;F;40;CHILENO;;Silencioso;"";"";234540;2;1;2;1;234540;0;0;0;PISCINA ESTRUCTURAL STEEL PRO 5700LT;OUTDOOR
10428332;;M;56;CHILENO;;Boomers;LAS CONDES                    ;METROPOLITANA;279980;2;1;0;0;0;2;1;279980;MESA DE POOL GAMEPOWER 03;OUTDOOR
10177531;;M;55;CHILENO;;Silencioso;PROVIDENCIA                   ;METROPOLITANA;114830;3;1;3;1;114830;0;0;0;V-CARPA 6 PERSONAS TORONTO NAT GEO S17;OUTDOOR
7923497;;F;64;CHILENO;;Boomers;N/D;N/D;523940;5;3;2;1;124980;3;2;398960;PISCINA CIRCULAR STEEL PRO 6473 L;OUTDOOR
19359362;Soltero;F;27;CHILENO;;Z;PROVIDENCIA                   ;METROPOLITANA;83980;2;1;2;1;83980;0;0;0;Mesa AirHockey Carromco;OUTDOOR
10691523;;M;55;CHILENO;;Boomers;RENCA                         ;METROPOLITANA;139990;1;1;0;0;0;1;1;139990;MESA DE PING PONG GAMEPOWER AZUL;OUTDOOR
18894812;;F;27;CHILENO;;Millenial;CONSTITUCION                  ;MAULE;545470;3;2;2;1;525480;1;1;19990;Scooter Peluche Unicornio y Luces Led KeyRiders;OUTDOOR
18765518;Casado;F;27;CHILENO;;Z;PROVIDENCIA                   ;METROPOLITANA;145840;2;1;2;1;145840;0;0;0;PISCINA CIRCULAR STEEL PRO 6473 L;OUTDOOR
17550490;;F;30;CHILENO;;Millenial;PROVIDENCIA                   ;METROPOLITANA;174540;2;1;2;1;174540;0;0;0;MESA DE PING PONG GAMEPOWER AZUL;OUTDOOR
13190873;;F;45;CHILENO;;X;VINA DEL MAR                  ;VALPARAISO;19980;2;1;2;1;19980;0;0;0;SPIN BALL;OUTDOOR
14114720;;M;41;CHILENO;;X;PROVIDENCIA                   ;METROPOLITANA;328640;2;1;2;1;328640;0;0;0;PISCINA STEEL PRO MAX;OUTDOOR
16043262;;F;37;CHILENO;;Millenial;SAN BERNARDO                  ;METROPOLITANA;0;0;2;1;1;89990;-1;1;-89990;PISCINA STEEL PRO 300X201X66CM;OUTDOOR
11728379;;M;51;CHILENO;;X;CABILDO                       ;VALPARAISO;895920;8;6;5;3;724950;3;3;170970;TACA TACA MADERA EVER GROUP;OUTDOOR
17103580;;M;33;CHILENO;;Millenial;EL QUISCO;VALPARAISO;114980;2;1;2;1;114980;0;0;0;PISCINA CIRCULAR STEEL PRO;OUTDOOR
12412313;;F;49;CHILENO;;X;PROVIDENCIA                   ;METROPOLITANA;103980;2;1;2;1;103980;0;0;0;V-TACA TACA GAME POWER FULL ORANGE 06 S17;OUTDOOR
9732866;;F;53;CHILENO;;X;CERRO NAVIA                   ;METROPOLITANA;126980;2;1;2;1;126980;0;0;0;PISCINA CIRCULAR STEEL PRO;OUTDOOR
7922645;;M;65;CHILENO;;Boomers;SAN CARLOS                    ;BIO BIO;172980;2;3;0;0;0;2;3;172980;AUTO ELECTRICO DESCAPOTABLE BLANCO COUP;OUTDOOR
15615743;;M;38;CHILENO;;Silencioso;PROVIDENCIA                   ;METROPOLITANA;325840;2;1;2;1;325840;0;0;0;PISCINA STEEL PRO MAX;OUTDOOR
13100250;;F;45;CHILENO;;X;N/D;N/D;444530;3;2;2;1;144540;1;1;299990;PISCINA CIRCULAR STEEL PRO 6473 L;OUTDOOR
17054242;;M;33;CHILENO;;Millenial;VALPARAISO                    ;VALPARAISO;79980;2;1;2;1;79980;0;0;0;Mesa AirHockey Carromco;OUTDOOR
10308029;;M;54;CHILENO;;X;RENCA                         ;METROPOLITANA;129990;1;1;0;0;0;1;1;129990;GO-KART PEDALES NEGRO;OUTDOOR
18610894;;M;28;CHILENO;;Millenial;N/D;N/D;233980;2;1;2;1;233980;0;0;0;PISCINA ESTRUCTURAL STEEL PRO 5700LT;OUTDOOR
26463430;;F;35;VENEZOLANO;;Extranjero;VALDIVIA                      ;LOS RIOS;314510;4;1;4;1;314510;0;0;0;PISCINA CIRCULAR STEEL PRO 6473 L;OUTDOOR
8554423;;F;63;CHILENO;;Boomers;EL BOSQUE                     ;METROPOLITANA;412980;2;1;0;0;0;2;1;412980;PISCINA STEEL PRO C/ESCALERA Y COBERTOR;OUTDOOR
10790197;;M;41;CHILENO;;X;COIHAIQUE                     ;AYSEN;139980;2;4;0;0;0;2;4;139980;Scooter Peluche Unicornio y Luces Led KeyRiders;OUTDOOR
18215405;;F;30;CHILENO;;Millenial;CHILLAN;BIO-BIO;75840;2;1;2;1;75840;0;0;0;PISCINA STEEL PRO 300X201X66CM;OUTDOOR
14097019;Casado;F;42;CHILENO;;X;PROVIDENCIA                   ;METROPOLITANA;312970;3;2;0;0;0;3;2;312970;TACA TACA MADERA EVER GROUP;OUTDOOR
22534602;;M;40;PERUANO;;Extranjero;"";"";151650;4;2;2;1;103980;2;1;47670;PISCINA STEEL PRO 300X201X66CM;OUTDOOR
26793444;;M;32;VENEZOLANO;;Extranjero;N/D;N/D;49990;1;1;0;0;0;1;1;49990;Scooter Burbujas Barbie;OUTDOOR
12967194;Soltero;M;46;CHILENO;;X;PROVIDENCIA                   ;METROPOLITANA;72990;1;1;0;0;0;1;1;72990;PISCINA RECTANGULAR 150CM BESTWAY AZUL;OUTDOOR
18093551;;F;29;CHILENO;;Millenial;PROVIDENCIA                   ;METROPOLITANA;239990;1;1;0;0;0;1;1;239990;PISCINA RECTANGULAR 211CM BESTWAY AZUL;OUTDOOR
13845094;Soltero;F;41;CHILENO;;X;PROVIDENCIA                   ;METROPOLITANA;99990;1;1;0;0;0;1;1;99990;PISCINA STEEL PRO 300X201X66CM;OUTDOOR
13004562;;M;45;CHILENO;;X;NANCAGUA                      ;L.G.B.OÂ´HIGGINS;79990;1;1;0;0;0;1;1;79990;PISCINA STEEL PRO 300X201X66CM;OUTDOOR
11915215;;M;50;CHILENO;;X;LOS ALAMOS                    ;BIO BIO;76970;3;2;0;0;0;3;2;76970;COLCHON 2 PZA 203X152X22 CM;OUTDOOR
16559663;;F;35;CHILENO;;Millenial;N/D;N/D;69990;1;1;0;0;0;1;1;69990;Cuatrimoto Electrica Force Negra/Verde;OUTDOOR
19247508;;F;28;CHILENO;;Millenial;PUNTA ARENAS                  ;MAGALLANES;76980;2;1;2;1;76980;0;0;0;Cuatrimoto Electrica Force Rosada;OUTDOOR
17728869;Casado;F;31;CHILENO;;Millenial;PROVIDENCIA                   ;METROPOLITANA;49980;2;1;0;0;0;2;1;49980;Scooter con Burbujas KeyRiders;OUTDOOR
17742345;;F;31;CHILENO;;Millenial;PROVIDENCIA                   ;METROPOLITANA;85980;2;1;2;1;85980;0;0;0;TACA TACA MADERA EVER GROUP;OUTDOOR
11634544;;M;52;CHILENO;;X;PARRAL                        ;MAULE;249980;2;2;0;0;0;2;2;249980;GO-KART PEDALES NEGRO;OUTDOOR
26547232;;M;30;VENEZOLANO;;Extranjero;"";"";63980;2;1;2;1;63980;0;0;0;Cuatrimoto Electrica Force Rosada;OUTDOOR
5999645;;F;68;CHILENO;;Boomers;RENCA                         ;METROPOLITANA;123980;2;1;2;1;123980;0;0;0;PISCINA CIRCULAR STEEL PRO;OUTDOOR
8199863;;M;57;CHILENO;;Boomers;MACHALI                       ;L.G.B.OÂ´HIGGINS;139980;2;1;0;0;0;2;1;139980;MESA DE PING PONG GAMEPOWER AZUL;OUTDOOR
20583772;;F;21;CHILENO;;Z;"";"";119990;1;1;1;1;119990;0;0;0;PISCINA CIRCULAR STEEL PRO;OUTDOOR
18466620;;F;28;CHILENO;;Millenial;"";"";331720;7;3;5;2;237950;2;1;93770;Cama Elastica + Malla y Escalera 6ft;OUTDOOR
11751389;;F;51;CHILENO;;X;PROVIDENCIA                   ;METROPOLITANA;163980;2;1;2;1;163980;0;0;0;PISCINA RECTANGULAR 211CM BESTWAY AZUL;OUTDOOR
10630238;;F;55;CHILENO;;Boomers;PROVIDENCIA                   ;METROPOLITANA;502980;2;1;0;0;0;2;1;502980;PISCINA STEEL PRO C/ESCALERA Y COBERTOR;OUTDOOR
19030983;;F;27;CHILENO;;Millenial;EL CARMEN                     ;BIO BIO;59990;1;1;0;0;0;1;1;59990;TACA TACA MADERA EVER GROUP;OUTDOOR
20686926;;F;21;CHILENO;;Millenial;"";"";49990;1;1;0;0;0;1;1;49990;V-CARPA 4 PERSONAS ASPEN ROJO OUTBACK;OUTDOOR
16681915;Soltero;F;34;CHILENO;CONTADOR AUDITOR;Millenial;PROVIDENCIA                   ;METROPOLITANA;397960;4;2;4;2;397960;0;0;0;PISCINA STEEL PRO MAXÂ¿ 56709 BESTWAY DISENO RATT;OUTDOOR
17233842;Soltero;M;34;CHILENO;TECNICO MECANICO;Millenial;RENCA                         ;METROPOLITANA;69990;1;1;0;0;0;1;1;69990;PISCINA RECTANGULAR 150CM BESTWAY AZUL;OUTDOOR
16704264;;M;34;CHILENO;;Millenial;N/D;N/D;269640;2;1;2;1;269640;0;0;0;PISCINA STEEL PRO MAXÂ¿ 56709 BESTWAY DISENO RATT;OUTDOOR
18889824;;F;27;CHILENO;;Z;SALAMANCA                     ;COQUIMBO;98640;2;1;2;1;98640;0;0;0;PISCINA STEEL PRO 300X201X66CM;OUTDOOR
17493476;;F;31;CHILENO;;Millenial;N/D;N/D;119990;1;1;1;1;119990;0;0;0;PISCINA CIRCULAR STEEL PRO;OUTDOOR
9791391;;F;57;CHILENO;;Boomers;N/D;N/D;259990;1;1;0;0;0;1;1;259990;BUGGY ELECTRICO POLARIS BLANCO;OUTDOOR
7479860;;F;70;CHILENO;;Silencioso;VALDIVIA                      ;LOS RIOS;0;0;2;0;0;0;0;2;0;TACA TACA MADERA EVER GROUP;OUTDOOR
10248870;;M;57;CHILENO;;Boomers;ESTACION CENTRAL              ;METROPOLITANA;89990;1;1;0;0;0;1;1;89990;SCOOTER ELECTRICO CERO EKIDS NEGRO;OUTDOOR
20515382;;M;21;CHILENO;;Z;PROVIDENCIA                   ;METROPOLITANA;35820;4;1;4;1;35820;0;0;0;Correpasillos Unicornio Rosado;OUTDOOR
15502515;;M;40;CHILENO;;X;PROVIDENCIA                   ;METROPOLITANA;99990;1;1;1;1;99990;0;0;0;PISCINA STEEL PRO 300X201X66CM;OUTDOOR
10066820;;M;54;CHILENO;;Boomers;PROVIDENCIA                   ;METROPOLITANA;103980;2;1;2;1;103980;0;0;0;SCOOTER ELECTRICO CERO EKIDS NEGRO;OUTDOOR
16596132;;F;35;CHILENO;;Millenial;PROVIDENCIA                   ;METROPOLITANA;34990;1;1;0;0;0;1;1;34990;Scooter Lanza Agua hasta 5 mts KeyRiders;OUTDOOR
16975211;Casado;M;34;CHILENO;TECNICO EN COMERCIO INTERNACIONAL;Millenial;COIHAIQUE                     ;AYSEN;69990;1;1;0;0;0;1;1;69990;PISCINA STEEL PRO 300X201X66CM;OUTDOOR
18638091;;M;28;CHILENO;;Millenial;SAN ANTONIO                   ;VALPARAISO;59970;3;2;2;1;29980;1;1;29990;V-SACO DORMIR TUCSON AZUL NAT GEO S17;OUTDOOR
7159226;;F;70;CHILENO;;Silencioso;CORONEL                       ;BIO BIO;9990;1;1;0;0;0;1;1;9990;Correpasillos Rojo;OUTDOOR
18195855;;F;30;CHILENO;;Millenial;TEMUCO                        ;ARAUCANIA;19990;1;1;0;0;0;1;1;19990;Correpasillos Unicornio Rosado;OUTDOOR
17747186;;F;31;CHILENO;;Millenial;MELIPILLA                     ;METROPOLITANA;133980;2;1;2;1;133980;0;0;0;PISCINA RECTANGULAR 211CM BESTWAY AZUL;OUTDOOR
17692603;;F;31;CHILENO;;Millenial;CARAHUE                       ;ARAUCANIA;55980;2;1;0;0;0;2;1;55980;COLCHON 2 PZA 203X152X22 CM;OUTDOOR
19423266;;F;25;CHILENO;;Z;N/D;N/D;46990;1;1;0;0;0;1;1;46990;Centro Juegos 2en1 Juego De Bloques Y Escritorio;OUTDOOR
12822642;;F;47;CHILENO;;X;PROVIDENCIA                   ;METROPOLITANA;69980;2;1;2;1;69980;0;0;0;TACA TACA MADERA EVER GROUP;OUTDOOR
13714232;;F;42;CHILENO;;X;PROVIDENCIA                   ;METROPOLITANA;69980;2;1;2;1;69980;0;0;0;TACA TACA MADERA EVER GROUP;OUTDOOR
18878176;;F;27;CHILENO;;Z;PARRAL                        ;MAULE;24990;1;1;0;0;0;1;1;24990;Scooter Peluche Dinosaurio y Luces Led KeyRiders;OUTDOOR
12230076;;F;50;CHILENO;;X;VILLA ALEMANA                 ;VALPARAISO;0;0;0;0;0;0;0;0;0;TACA TACA MADERA EVER GROUP;OUTDOOR
18012852;;F;36;CHILENO;;Silencioso;PROVIDENCIA                   ;METROPOLITANA;0;0;0;0;0;0;0;0;0;Correpasillos Unicornio Rosado;OUTDOOR
14617301;;F;41;CHILENO;;X;LOS ANGELES                   ;BIO BIO;0;0;0;0;0;0;0;0;0;TACA TACA MADERA EVER GROUP;OUTDOOR
19027255;Soltero;F;27;CHILENO;;Silencioso;PROVIDENCIA                   ;METROPOLITANA;0;0;0;0;0;0;0;0;0;TACA TACA MADERA EVER GROUP;OUTDOOR
7244039;;F;63;CHILENO;;Boomers;VINA DEL MAR                  ;VALPARAISO;0;0;0;0;0;0;0;0;0;TUNEL DE JUEGO 46X180 CM;OUTDOOR
15531213;;M;38;CHILENO;;X;VALDIVIA                      ;LOS RIOS;0;0;0;0;0;0;0;0;0;SCOOTER ELECTRICO ASD NEGRO;OUTDOOR
18537428;Soltero;F;29;CHILENO;TERAPEUTA OCUPACIONAL;Silencioso;PROVIDENCIA                   ;METROPOLITANA;0;0;0;0;0;0;0;0;0;TUNEL DE JUEGO 46X180 CM;OUTDOOR
19150714;Soltero;M;27;CHILENO;;Silencioso;PROVIDENCIA                   ;METROPOLITANA;0;0;0;0;0;0;0;0;0;SCOOTER ELECTRICO NINEBOT ES2;OUTDOOR
9111074;Divorciado;M;50;CHILENO;;X;RENCA                         ;METROPOLITANA;0;0;0;0;0;0;0;0;0;SCOOTER ELECTRICO NINEBOT ES2;OUTDOOR
16346882;;F;35;CHILENO;;Millenial;PROVIDENCIA                   ;METROPOLITANA;0;0;0;0;0;0;0;0;0;CERCA ROSADA;OUTDOOR
18826480;;M;27;CHILENO;;Z;PROVIDENCIA                   ;METROPOLITANA;0;0;0;0;0;0;0;0;0;V-CARPA PLAYA OUTBACK OUTBACK;OUTDOOR
18552150;;M;29;CHILENO;;Millenial;VILLA ALEMANA                 ;VALPARAISO;0;0;0;0;0;0;0;0;0;Set De Ollas - Sarten Outback;OUTDOOR
19006950;Soltero;M;27;CHILENO;;Millenial;PROVIDENCIA                   ;METROPOLITANA;0;0;0;0;0;0;0;0;0;V-PISCINA MY FIRST FAST SET SPRAY POOL 1.52M X 3;OUTDOOR
13718479;;M;43;CHILENO;;X;RENCA                         ;METROPOLITANA;0;0;0;0;0;0;0;0;0;V-SACO DORMIR TUCSON AZUL NAT GEO S17;OUTDOOR
17429534;;M;32;CHILENO;;Millenial;PROVIDENCIA                   ;METROPOLITANA;0;0;0;0;0;0;0;0;0;Piscina Kids 150 X 110 X 42Cm;OUTDOOR
16290043;;F;36;CHILENO;;Millenial;MOLINA                        ;MAULE;0;0;0;0;0;0;0;0;0;V-PISCINA MY FIRST FAST SET SPRAY POOL 1.52M X 3;OUTDOOR
26045012;;F;50;VENEZOLANO;;Extranjero;SANTIAGO                      ;METROPOLITANA;0;0;0;0;0;0;0;0;0;COLCHON 2 PZA 203X152X22 CM;OUTDOOR
15917438;;F;38;CHILENO;;Millenial;N/D;N/D;0;0;0;0;0;0;0;0;0;COLCHON 2 PZA 203X152X22 CM;OUTDOOR
13215595;Casado;M;44;CHILENO;CONTADOR AUDITOR;X;VILLARICA                     ;ARAUCANIA;0;0;0;0;0;0;0;0;0;PISCINA RECTANGULAR 211CM BESTWAY AZUL;OUTDOOR
14531623;;M;48;CHILENO;;X;ANGOL                         ;ARAUCANIA;0;0;0;0;0;0;0;0;0;V-PISCINA KIDS 190X130X42CM;OUTDOOR
16769694;;F;34;CHILENO;;Millenial;ARICA                         ;ARICA Y PARINACOTA;0;0;0;0;0;0;0;0;0;PATINES EN LINEA T 32-34 ALPACA;OUTDOOR
15518317;;M;41;CHILENO;;X;PROVIDENCIA                   ;METROPOLITANA;0;0;0;0;0;0;0;0;0;PISCINA CIRCULAR STEEL PRO;OUTDOOR
13284692;;F;45;CHILENO;;X;PROVIDENCIA                   ;METROPOLITANA;0;0;0;0;0;0;0;0;0;PISCINA STEEL PRO 300X201X66CM;OUTDOOR
7878412;;F;66;CHILENO;;Boomers;TALCAHUANO                    ;BIO BIO;0;0;0;0;0;0;0;0;0;TACA TACA MADERA EVER GROUP;OUTDOOR
9304615;Casado;M;59;CHILENO;;Boomers;RENCA                         ;METROPOLITANA;0;0;0;0;0;0;0;0;0;PISCINA STEEL PRO C/ESCALERA Y COBERTOR;OUTDOOR
19926876;;F;24;CHILENO;;Z;PROVIDENCIA                   ;METROPOLITANA;0;0;0;0;0;0;0;0;0;PISCINA STEEL PRO C/ESCALERA Y COBERTOR;OUTDOOR
16701252;;M;34;CHILENO;;Millenial;LA LIGUA;VALPARAISO;0;0;0;0;0;0;0;0;0;PISCINA CIRCULAR STEEL PRO;OUTDOOR
5818577;;F;70;CHILENO;;Silencioso;RENCA                         ;METROPOLITANA;0;0;0;0;0;0;0;0;0;PISCINA CIRCULAR STEEL PRO;OUTDOOR
10517541;;F;51;CHILENO;;X;PROVIDENCIA                   ;METROPOLITANA;0;0;0;0;0;0;0;0;0;Piscina Redonda Steel Pro Pool Set 3.96x84;OUTDOOR
13598572;;M;42;CHILENO;;X;PROVIDENCIA                   ;METROPOLITANA;0;0;0;0;0;0;0;0;0;COLCHON 2 PZA 203X152X22 CM;OUTDOOR
12616012;;F;48;CHILENO;;X;ANTOFAGASTA                   ;ANTOFAGASTA;0;0;0;0;0;0;0;0;0;MOTO ELECTRICA LUCES AZUL;OUTDOOR
17225025;;M;33;CHILENO;;Millenial;EL MONTE                      ;METROPOLITANA;0;0;0;0;0;0;0;0;0;PISCINA ESTRUCTURAL STEEL PRO 5700LT;OUTDOOR
7922775;;F;64;CHILENO;;Boomers;N/D;N/D;0;0;0;0;0;0;0;0;0;PISCINA STEEL PRO C/ESCALERA Y COBERTOR;OUTDOOR
16133919;;F;37;CHILENO;;Millenial;PROVIDENCIA                   ;METROPOLITANA;0;0;0;0;0;0;0;0;0;PISCINA CIRCULAR STEEL PRO;OUTDOOR
25078385;;M;41;PERUANO;;Extranjero;SAN PEDRO DE LA PAZ           ;BIO BIO;0;0;0;0;0;0;0;0;0;PISCINA CIRCULAR STEEL PRO;OUTDOOR
6020597;Casado;M;67;CHILENO;;Boomers;PROVIDENCIA                   ;METROPOLITANA;0;0;0;0;0;0;0;0;0;SCOOTER ELECTRICO XIAOMI M365;OUTDOOR
17719398;;F;30;CHILENO;;Millenial;CASTRO                        ;LOS LAGOS;0;0;0;0;0;0;0;0;0;CAMIONETA ELECTRICA TODO TERRENO BLANCO;OUTDOOR
13509794;;F;44;CHILENO;;X;COLINA                        ;METROPOLITANA;0;0;0;0;0;0;0;0;0;PISCINA CIRCULAR STEEL PRO;OUTDOOR
13467168;;F;44;CHILENO;;X;PROVIDENCIA                   ;METROPOLITANA;0;0;0;0;0;0;0;0;0;PISCINA CIRCULAR STEEL PRO;OUTDOOR
11534101;;F;52;CHILENO;;X;CURICO                        ;MAULE;0;0;0;0;0;0;0;0;0;COLCHON INFLABLE 2 PLAZAS CON INFLADOR;OUTDOOR
14262168;Soltero;M;48;CHILENO;;X;RENCA                         ;METROPOLITANA;0;0;0;0;0;0;0;0;0;SET SNORKEL HYDRO-SWIM COZUMEL;OUTDOOR
18094725;;F;30;CHILENO;;Millenial;PUDAHUEL                      ;METROPOLITANA;0;0;0;0;0;0;0;0;0;CAMA ELASTICA (3,05M) CON MALLA GAMEPOWER AZUL;OUTDOOR
19281350;;F;26;CHILENO;;Millenial;N/D;N/D;0;0;0;0;0;0;0;0;0;JUEGO INFLABLE GYM;OUTDOOR
4898834;;M;77;CHILENO;;Silencioso;TEMUCO                        ;ARAUCANIA;0;0;0;0;0;0;0;0;0;PISCINA STEEL PRO C/ESCALERA Y COBERTOR;OUTDOOR
19850598;;F;24;CHILENO;;Z;VILLARICA                     ;ARAUCANIA;0;0;0;0;0;0;0;0;0;SCOOTER LUCES 3 RUEDAS VERDE;OUTDOOR
13731492;;F;44;CHILENO;;X;TEMUCO                        ;ARAUCANIA;0;0;0;0;0;0;0;0;0;TACA TACA MADERA EVER GROUP;OUTDOOR
15983318;;F;34;CHILENO;;Millenial;SAN CARLOS                    ;BIO BIO;0;0;0;0;0;0;0;0;0;PISCINA STEEL PRO 300X201X66CM;OUTDOOR
15549292;;F;38;CHILENO;;Millenial;QUILICURA;METROPOLITANA;0;0;0;0;0;0;0;0;0;PISCINA CIRCULAR STEEL PRO;OUTDOOR
17114135;;F;33;CHILENO;;Millenial;PROVIDENCIA                   ;METROPOLITANA;0;0;0;0;0;0;0;0;0;PISCINA RECTANGULAR 150CM BESTWAY AZUL;OUTDOOR
13617897;;F;42;CHILENO;;X;N/D;N/D;0;0;0;0;0;0;0;0;0;ALFOMBRA DE JUEGO ALFABETO NUMEROS 36PC;OUTDOOR
18442423;;F;29;CHILENO;;Millenial;N/D;N/D;0;0;0;0;0;0;0;0;0;E-SKATE 250W HS-1;OUTDOOR
10375546;Casado;F;57;CHILENO;;Boomers;PROVIDENCIA                   ;METROPOLITANA;0;0;0;0;0;0;0;0;0;TACA TACA MADERA EVER GROUP;OUTDOOR
12259856;;F;49;CHILENO;;X;RECOLETA                      ;METROPOLITANA;0;0;0;0;0;0;0;0;0;PISCINA RECTANGULAR 211CM BESTWAY AZUL;OUTDOOR
16844844;Soltero;F;34;CHILENO;;Millenial;PROVIDENCIA                   ;METROPOLITANA;0;0;0;0;0;0;0;0;0;PISCINA CIRCULAR STEEL PRO;OUTDOOR
17296196;;F;33;CHILENO;;Millenial;"";"";0;0;0;0;0;0;0;0;0;PISCINA RECTANGULAR 150CM BESTWAY AZUL;OUTDOOR
11292792;Casado;F;53;CHILENO;;X;RENCA                         ;METROPOLITANA;0;0;0;0;0;0;0;0;0;MOTO ELECTRICA LUCES AZUL;OUTDOOR
11475957;;M;52;CHILENO;;X;PROVIDENCIA                   ;METROPOLITANA;0;0;0;0;0;0;0;0;0;PISCINA CIRCULAR STEEL PRO;OUTDOOR
15435745;;M;40;CHILENO;;X;PROVIDENCIA                   ;METROPOLITANA;0;0;0;0;0;0;0;0;0;CHALECO SALVAVIDAS INFLABLE FISHER PRICE;OUTDOOR
11745188;Casado;F;50;CHILENO;;X;PROVIDENCIA                   ;METROPOLITANA;0;0;0;0;0;0;0;0;0;MI PRIMER TRAMPOLIN 140CM GAMEPOWER AZUL/AMARILL;OUTDOOR
13789243;;M;42;CHILENO;;X;LINARES                       ;MAULE;0;0;0;0;0;0;0;0;0;PISCINA CIRCULAR STEEL PRO;OUTDOOR
16108478;;F;37;CHILENO;;Millenial;TEMUCO                        ;ARAUCANIA;0;0;0;0;0;0;0;0;0;PISCINA STEEL PRO 300X201X66CM;OUTDOOR
16309345;;M;36;CHILENO;;Millenial;PLACILLA                      ;L.G.B.OÂ´HIGGINS;0;0;0;0;0;0;0;0;0;CAMA ELASTICA (3,66M) CON MALLA GAMEPOWER AZUL;OUTDOOR
13176927;;F;45;CHILENO;;X;RENCA                         ;METROPOLITANA;0;0;0;0;0;0;0;0;0;TACA TACA MADERA EVER GROUP;OUTDOOR
16901809;;M;34;CHILENO;;Millenial;SAN ANTONIO                   ;VALPARAISO;0;0;0;0;0;0;0;0;0;GO-KART PEDALES NEGRO;OUTDOOR
25832080;;M;39;VENEZOLANO;;Extranjero;PUERTO MONTT                  ;LOS LAGOS;0;0;0;0;0;0;0;0;0;AUTO ELECTRICO DESCAPOTABLE BLANCO COUP;OUTDOOR
6873174;Casado;M;59;CHILENO;CIRUJANO DENTISTA;Boomers;PROVIDENCIA                   ;METROPOLITANA;0;0;0;0;0;0;0;0;0;SCOOTER ELECTRICO XIAOMI M365;OUTDOOR
12981414;;F;46;CHILENO;;X;ANTUCO                        ;BIO BIO;0;0;0;0;0;0;0;0;0;PISCINA CIRCULAR STEEL PRO;OUTDOOR
7685483;Casado;F;65;CHILENO;;Boomers;PROVIDENCIA                   ;METROPOLITANA;0;0;0;0;0;0;0;0;0;TOBOGAN DE AGUA H2OGO!;OUTDOOR
13602209;;F;43;CHILENO;;X;CHILLAN VIEJO                 ;BIO BIO;0;0;0;0;0;0;0;0;0;TRCICLO NINO COLOR A PPB TRA;OUTDOOR
16246248;;M;36;CHILENO;;Millenial;ANTOFAGASTA                   ;ANTOFAGASTA;0;0;0;0;0;0;0;0;0;CENTRO DE JUEGOS ACUARIO FANTASTICO;OUTDOOR
14025984;;M;41;CHILENO;;X;PROVIDENCIA                   ;METROPOLITANA;0;0;0;0;0;0;0;0;0;TRCICLO NINO COLOR B PPB-1 TRA;OUTDOOR
18963161;;M;27;CHILENO;;Millenial;N/D;N/D;0;0;0;0;0;0;0;0;0;CUATRIMOTO ELECTRICA SUPER ROJA 6V;OUTDOOR
13389718;;F;44;CHILENO;;X;RENCA                         ;METROPOLITANA;52990;1;1;0;0;0;1;1;52990;Asistencia Salud Integral Familia;GARANTIAS
9021797;;M;61;CHILENO;;Boomers;COQUIMBO                      ;COQUIMBO;279910;4;3;0;0;0;4;3;279910;Asistencia Salud Integral Familia;GARANTIAS
9372633;;M;60;CHILENO;;Boomers;CABILDO                       ;VALPARAISO;642600;8;6;0;0;0;8;6;642600;Asistencia Salud Integral Familia;GARANTIAS
8066038;;F;62;CHILENO;;Boomers;QUILLOTA                      ;VALPARAISO;105980;2;2;0;0;0;2;2;105980;Asistencia Programa Domiciliario;GARANTIAS
27108681;;M;32;EXTRANJERO - NO INFORMA NACIONALIDAD;;Extranjero;SANTIAGO;METROPOLITANA;52990;1;1;0;0;0;1;1;52990;Asistencia Programa Domiciliario;GARANTIAS
8874290;;F;63;CHILENO;;Boomers;PROVIDENCIA                   ;METROPOLITANA;106800;3;1;0;0;0;3;1;106800;GPL 1A X CTA SBI;GARANTIAS
15041827;;F;39;CHILENO;;X;N/D;N/D;312980;2;2;0;0;0;2;2;312980;Asistencia Salud Integral Familia;GARANTIAS
4747716;;F;83;CHILENO;;Silencioso;TALCAHUANO                    ;BIO BIO;149121;5;5;0;0;0;5;5;149121;Asistencia Salud Integral Familia;GARANTIAS
11420577;;M;53;CHILENO;;X;LA PINTANA                    ;METROPOLITANA;217190;4;3;0;0;0;4;3;217190;Asistencia Salud Integral Familia;GARANTIAS
9071218;;M;60;CHILENO;;Boomers;LINARES                       ;MAULE;441439;5;2;0;0;0;5;2;441439;Asistencia Salud Integral Familia;GARANTIAS
26564723;;F;41;EXTRANJERO - NO INFORMA NACIONALIDAD;;Extranjero;N/D;N/D;52990;1;1;0;0;0;1;1;52990;Asistencia Salud Integral Familia;GARANTIAS
9361058;;F;64;CHILENO;;Boomers;CHILLAN                       ;BIO BIO;101972;3;3;0;0;0;3;3;101972;Asistencia Programa Domiciliario;GARANTIAS
27022722;Soltero;M;26;EXTRANJERO - NO INFORMA NACIONALIDAD;;Extranjero;N/D;N/D;52990;1;1;0;0;0;1;1;52990;Asistencia Salud Integral Familia;GARANTIAS
9000680;;F;60;CHILENO;;Boomers;EL BOSQUE                     ;METROPOLITANA;165280;5;3;0;0;0;5;3;165280;GPL 1A X CTA SBI;GARANTIAS
17470364;;F;32;CHILENO;;Millenial;PELLUHUE                      ;MAULE;105980;2;1;0;0;0;2;1;105980;Asistencia de Mascotas;GARANTIAS
16071104;;M;37;CHILENO;;Millenial;CARTAGENA                     ;VALPARAISO;431940;7;4;3;2;266970;4;2;164970;Asistencia Salud Integral Familia;GARANTIAS
4808380;;F;79;CHILENO;;Silencioso;OVALLE                        ;COQUIMBO;212190;4;3;0;0;0;4;3;212190;Asistencia Programa Domiciliario;GARANTIAS
26699742;;M;26;VENEZOLANO;;Extranjero;"";"";52990;1;1;0;0;0;1;1;52990;Asistencia Programa Domiciliario;GARANTIAS
7031006;;F;66;CHILENO;;Boomers;RANCAGUA                      ;L.G.B.OÂ´HIGGINS;411970;3;2;2;1;358980;1;1;52990;Asistencia Salud Integral Familia;GARANTIAS
26195221;;M;40;HAITIANO;;Extranjero;SANTA CRUZ                    ;L.G.B.OÂ´HIGGINS;510950;5;3;0;0;0;5;3;510950;Asistencia Salud Integral Familia;GARANTIAS
11188779;;F;55;CHILENO;;Boomers;VINA DEL MAR                  ;VALPARAISO;373090;4;2;0;0;0;4;2;373090;Asistencia Programa Domiciliario;GARANTIAS
15921098;;M;37;CHILENO;;Millenial;COLBUN                        ;MAULE;500930;8;4;2;1;171980;6;3;328950;Asistencia Programa Domiciliario;GARANTIAS
18050919;;F;30;CHILENO;;Millenial;EL BOSQUE;METROPOLITANA;52990;1;1;0;0;0;1;1;52990;Asistencia Salud Integral Familia;GARANTIAS
6269902;;M;72;CHILENO;;Silencioso;CORONEL                       ;BIO BIO;236309;4;2;0;0;0;4;2;236309;Asistencia Salud Integral Familia;GARANTIAS
12864695;;F;47;CHILENO;;X;CERRILLOS                     ;METROPOLITANA;945910;9;6;8;5;892920;1;1;52990;Asistencia Salud Integral Familia;GARANTIAS
6677405;;M;71;CHILENO;;Silencioso;CURACAVI                      ;METROPOLITANA;791430;6;4;0;0;0;6;4;791430;Asistencia Programa Domiciliario;GARANTIAS
26624885;;F;35;VENEZOLANO;;Extranjero;N/D;N/D;100870;2;2;0;0;0;2;2;100870;Asistencia Salud Integral Familia;GARANTIAS
11785034;;F;51;CHILENO;;X;PETORCA                       ;VALPARAISO;1345940;6;3;0;0;0;6;3;1345940;Asistencia Programa Domiciliario;GARANTIAS
20070888;;M;23;CHILENO;;Z;N/D;N/D;264950;5;2;0;0;0;5;2;264950;Asistencia Salud Integral Familia;GARANTIAS
8763862;;F;64;CHILENO;;Boomers;NUEVA IMPERIAL                ;ARAUCANIA;203852;9;1;0;0;0;9;1;203852;Asistencia Salud Integral Familia;GARANTIAS
10558602;;F;55;CHILENO;;Boomers;CHIGUAYANTE                   ;BIO BIO;52990;1;1;0;0;0;1;1;52990;Asistencia Salud Integral Familia;GARANTIAS
9190854;;F;63;CHILENO;;Boomers;SAN ANTONIO                   ;VALPARAISO;52990;1;1;0;0;0;1;1;52990;Asistencia Programa Domiciliario;GARANTIAS
11007546;;F;57;CHILENO;;Boomers;N/D;N/D;176960;4;3;0;0;0;4;3;176960;Asistencia Salud Integral Familia;GARANTIAS
19921568;;M;23;CHILENO;;Z;"";"";52990;1;1;0;0;0;1;1;52990;Asistencia Salud Integral Familia;GARANTIAS
11855310;;F;51;CHILENO;;X;TALCAHUANO                    ;BIO BIO;827960;5;2;0;0;0;5;2;827960;Asistencia Salud Integral Familia;GARANTIAS
16046892;;F;42;CHILENO;;X;CARAHUE                       ;ARAUCANIA;215970;4;2;0;0;0;4;2;215970;Asistencia Salud Integral Familia;GARANTIAS
8828655;;M;62;CHILENO;;Boomers;PROVIDENCIA                   ;METROPOLITANA;52990;1;1;0;0;0;1;1;52990;Asistencia Salud Integral Familia;GARANTIAS
12346656;;M;49;CHILENO;;X;QUEILEN                       ;LOS LAGOS;105980;2;2;0;0;0;2;2;105980;ASIST. FULL HOGAR Y AUTO INGRAL;GARANTIAS
10609008;;F;58;CHILENO;;Boomers;PARRAL                        ;MAULE;2647650;20;13;0;0;0;20;13;2647650;Asistencia Salud Integral Familia;GARANTIAS
5473247;;F;76;CHILENO;;Silencioso;COLINA                        ;METROPOLITANA;189990;1;3;0;0;0;1;3;189990;Asistencia Salud Integral Familia;GARANTIAS
13353657;;F;44;CHILENO;;X;CURICO                        ;MAULE;105980;2;1;0;0;0;2;1;105980;Asistencia Salud Integral Familia;GARANTIAS
12889526;;F;47;CHILENO;;X;N/D;N/D;52990;1;1;0;0;0;1;1;52990;Asistencia Salud Integral Familia;GARANTIAS
11079803;;F;55;CHILENO;;Boomers;NATALES                       ;MAGALLANES;117980;2;2;0;0;0;2;2;117980;Asistencia Programa Domiciliario;GARANTIAS
8215360;;F;63;CHILENO;;Boomers;SAN PEDRO DE LA PAZ           ;BIO BIO;968070;6;4;0;0;0;6;4;968070;Asistencia Salud Integral Familia;GARANTIAS
11091464;;F;55;CHILENO;;Boomers;OVALLE                        ;COQUIMBO;353850;4;2;0;0;0;4;2;353850;Asistencia Salud Integral Familia;GARANTIAS
14556161;;M;45;CHILENO;;X;VILLA ALEGRE                  ;MAULE;860890;11;4;0;0;0;11;4;860890;Asistencia Salud Integral Familia;GARANTIAS
7115611;;F;68;CHILENO;;Silencioso;ILLAPEL                       ;COQUIMBO;261960;4;4;0;0;0;4;4;261960;Asistencia Programa Domiciliario;GARANTIAS
12601047;;F;47;CHILENO;;X;QUINTERO                      ;VALPARAISO;307950;5;4;0;0;0;5;4;307950;Asistencia Programa Domiciliario;GARANTIAS
12732786;;F;46;CHILENO;;X;CURANILAHUE                   ;BIO BIO;277960;4;3;2;1;171980;2;2;105980;Asistencia Salud Integral Familia;GARANTIAS
16298215;;F;36;CHILENO;;Millenial;TALCA                         ;MAULE;105980;2;1;0;0;0;2;1;105980;Asistencia Salud Integral Familia;GARANTIAS
11840757;;F;51;CHILENO;;X;N/D;N/D;87980;2;2;0;0;0;2;2;87980;Asistencia Salud Integral Familia;GARANTIAS
7944585;;M;63;CHILENO;;Boomers;PUNITAQUI                     ;COQUIMBO;52990;1;1;0;0;0;1;1;52990;Asistencia Salud Integral Familia;GARANTIAS
5770685;;F;72;CHILENO;;Silencioso;IQUIQUE                       ;TARAPACA;90980;2;1;0;0;0;2;1;90980;Asistencia Salud Integral Familia;GARANTIAS
14585991;;M;44;CHILENO;;X;PUERTO MONTT                  ;LOS LAGOS;97980;2;2;0;0;0;2;2;97980;Asistencia Programa Domiciliario;GARANTIAS
16852044;;M;34;CHILENO;;Millenial;LOS ANDES;VALPARAISO;52990;1;1;0;0;0;1;1;52990;Asistencia Salud Integral Familia;GARANTIAS
18884036;;M;27;CHILENO;;Millenial;"";"";52990;1;1;0;0;0;1;1;52990;Asistencia Programa Domiciliario;GARANTIAS
6817627;;F;69;CHILENO;;Silencioso;PLACILLA                      ;L.G.B.OÂ´HIGGINS;600000;10;5;0;0;0;10;5;600000;Asistencia de Mascotas;GARANTIAS
7890124;;M;64;CHILENO;;Boomers;N/D;N/D;50760;3;1;0;0;0;3;1;50760;GM 1A X CTA SBI;GARANTIAS
8798038;;F;60;CHILENO;;Boomers;NATALES                       ;MAGALLANES;0;0;4;0;0;0;0;4;0;GM 1A X CTA SBI;GARANTIAS
20153973;;F;23;CHILENO;;Z;LA FLORIDA;METROPOLITANA;52990;1;1;0;0;0;1;1;52990;Asistencia Salud Integral Familia;GARANTIAS
12052637;;F;46;CHILENO;;X;COLBUN                        ;MAULE;105980;2;1;0;0;0;2;1;105980;Asistencia Salud Integral Familia;GARANTIAS
9987375;Soltero;M;58;CHILENO;;Boomers;RENCA                         ;METROPOLITANA;15470;2;1;0;0;0;2;1;15470;GM 1A X CTA SBI;GARANTIAS
9167380;;F;61;CHILENO;;Boomers;CABILDO                       ;VALPARAISO;158970;3;3;0;0;0;3;3;158970;Asistencia Salud Integral Familia;GARANTIAS
15218709;;M;42;CHILENO;;X;N/D;N/D;140970;3;2;0;0;0;3;2;140970;Asistencia Salud Integral Familia;GARANTIAS
5055039;;F;78;CHILENO;;Silencioso;COQUIMBO                      ;COQUIMBO;52990;1;1;0;0;0;1;1;52990;Asistencia Salud Integral Familia;GARANTIAS
8080862;Soltero;M;61;CHILENO;;Boomers;RENCA                         ;METROPOLITANA;16370;2;1;0;0;0;2;1;16370;GM 1A X CTA SBI;GARANTIAS
10778174;;F;55;CHILENO;;Boomers;COIHUECO                      ;BIO BIO;446970;3;2;2;1;393980;1;1;52990;Asistencia Salud Integral Familia;GARANTIAS
7719396;;M;65;CHILENO;;Boomers;LA SERENA                     ;COQUIMBO;264950;5;3;0;0;0;5;3;264950;Asistencia Salud Integral Familia;GARANTIAS
26126200;;M;27;VENEZOLANO;;Extranjero;QUILLOTA                      ;VALPARAISO;52990;1;1;0;0;0;1;1;52990;Asistencia Salud Integral Familia;GARANTIAS
12749040;;F;46;CHILENO;;X;N/D;N/D;52990;1;1;0;0;0;1;1;52990;Asistencia Salud Integral Familia;GARANTIAS
18295439;;M;28;CHILENO;;Millenial;"";"";52990;1;1;0;0;0;1;1;52990;Asistencia Programa Domiciliario;GARANTIAS
12402483;;F;48;CHILENO;;X;NOGALES                       ;VALPARAISO;369950;5;4;0;0;0;5;4;369950;Asistencia Salud Integral Familia;GARANTIAS
11688390;;M;52;CHILENO;;X;TEMUCO                        ;ARAUCANIA;53000;2;1;0;0;0;2;1;53000;Asistencia Salud Integral Familia;GARANTIAS
7263720;;F;68;CHILENO;;Silencioso;CURANILAHUE                   ;BIO BIO;282959;4;3;0;0;0;4;3;282959;Asistencia Programa Domiciliario;GARANTIAS
10522814;;F;56;CHILENO;;Boomers;CHIGUAYANTE                   ;BIO BIO;52990;1;1;0;0;0;1;1;52990;Asistencia Salud Integral Familia;GARANTIAS
6684078;;M;66;CHILENO;;Boomers;VINA DEL MAR                  ;VALPARAISO;52990;1;1;0;0;0;1;1;52990;Asistencia Salud Integral Familia;GARANTIAS
6744068;;M;67;CHILENO;;Boomers;CHILLAN                       ;BIO BIO;52990;1;1;0;0;0;1;1;52990;Asistencia Salud Integral Familia;GARANTIAS
8948522;;M;58;CHILENO;;Boomers;CHIMBARONGO                   ;L.G.B.OÂ´HIGGINS;96960;4;4;0;0;0;4;4;96960;Asistencia Programa Domiciliario;GARANTIAS
13978954;;F;41;CHILENO;;X;N/D;N/D;633940;7;4;5;2;380960;2;2;252980;Asistencia Salud Integral Familia;GARANTIAS
15328548;;F;40;CHILENO;;X;SANTIAGO                      ;METROPOLITANA;37240;3;1;0;0;0;3;1;37240;GM 1A X CTA SBI;GARANTIAS
9633079;;F;74;CHILENO;;Silencioso;CHIGUAYANTE                   ;BIO BIO;777779;13;5;0;0;0;13;5;777779;Asistencia Salud Integral Familia;GARANTIAS
16116431;;F;37;CHILENO;;Millenial;NIQUEN                        ;BIO BIO;52990;1;1;0;0;0;1;1;52990;Asistencia Salud Integral Familia;GARANTIAS
11350612;;F;54;CHILENO;;X;N/D;N/D;188960;4;4;0;0;0;4;4;188960;Asistencia Salud Integral Familia;GARANTIAS
8702067;;M;63;CHILENO;;Boomers;MELIPILLA                     ;METROPOLITANA;422000;3;2;0;0;0;3;2;422000;Asistencia Salud Integral Familia;GARANTIAS
8769850;;M;62;CHILENO;;Boomers;LINARES                       ;MAULE;422980;2;2;0;0;0;2;2;422980;Asistencia Salud Integral Familia;GARANTIAS
11682958;;F;52;CHILENO;;X;CORONEL                       ;BIO BIO;87980;2;2;0;0;0;2;2;87980;Asistencia Salud Integral Familia;GARANTIAS
5597572;;F;72;CHILENO;;Silencioso;NACIMIENTO                    ;BIO BIO;264950;5;2;0;0;0;5;2;264950;Asistencia Salud Integral Familia;GARANTIAS
17198101;;F;33;CHILENO;;Millenial;N/D;N/D;52990;1;1;0;0;0;1;1;52990;Asistencia Salud Integral Familia;GARANTIAS
7356629;;M;64;CHILENO;;Boomers;LOTA                          ;BIO BIO;522970;3;2;0;0;0;3;2;522970;Asistencia Salud Integral Familia;GARANTIAS
11891579;;F;51;CHILENO;;X;PICHIDEGUA                    ;L.G.B.OÂ´HIGGINS;72980;2;2;0;0;0;2;2;72980;Asistencia Salud Integral Familia;GARANTIAS
14323578;;M;45;CHILENO;;X;COMBARBALA                    ;COQUIMBO;662718;7;4;0;0;0;7;4;662718;ASIST. FULL HOGAR Y AUTO INGRAL;GARANTIAS
8473240;;M;64;CHILENO;;Boomers;LINARES                       ;MAULE;399711;4;2;0;0;0;4;2;399711;Asistencia Programa Domiciliario;GARANTIAS
8593925;;F;64;CHILENO;;Boomers;OVALLE                        ;COQUIMBO;52990;1;1;0;0;0;1;1;52990;Asistencia Programa Domiciliario;GARANTIAS
8728714;;F;63;CHILENO;;Boomers;OVALLE                        ;COQUIMBO;158970;3;3;0;0;0;3;3;158970;ASIST. FULL HOGAR Y AUTO INGRAL;GARANTIAS
5140446;;M;79;CHILENO;;Silencioso;YERBAS BUENAS                 ;MAULE;370930;7;7;0;0;0;7;7;370930;Asistencia Programa Domiciliario;GARANTIAS
8899201;;M;61;CHILENO;;Boomers;MELIPILLA                     ;METROPOLITANA;37990;1;1;0;0;0;1;1;37990;Asistencia Programa Domiciliario;GARANTIAS
13917174;;M;41;CHILENO;;X;PEDRO AGUIRRE CERDA           ;METROPOLITANA;53989;2;2;0;0;0;2;2;53989;Asistencia Programa Domiciliario;GARANTIAS
6944248;;M;69;CHILENO;;Silencioso;LA SERENA                     ;COQUIMBO;190350;5;3;0;0;0;5;3;190350;Asistencia Salud Integral Familia;GARANTIAS
6810927;;F;72;CHILENO;;Silencioso;MAIPU                         ;METROPOLITANA;52990;1;1;0;0;0;1;1;52990;Asistencia Salud Integral Familia;GARANTIAS
21088567;;F;19;CHILENO;;Extranjero;"";"";52990;1;1;0;0;0;1;1;52990;Asistencia Salud Integral Familia;GARANTIAS
26912077;;F;57;EXTRANJERO - NO INFORMA NACIONALIDAD;;Extranjero;LAS CONDES                    ;METROPOLITANA;291970;3;2;0;0;0;3;2;291970;Asistencia Programa Domiciliario;GARANTIAS
9063472;;F;58;CHILENO;;Boomers;TALCAHUANO                    ;BIO BIO;79970;4;3;0;0;0;4;3;79970;GM 1A X CTA SBI;GARANTIAS
12235449;;M;52;CHILENO;;X;N/D;N/D;52990;1;1;0;0;0;1;1;52990;Asistencia Salud Integral Familia;GARANTIAS
5662839;;M;72;CHILENO;;Silencioso;N/D;N/D;52990;1;1;0;0;0;1;1;52990;Asistencia Salud Integral Familia;GARANTIAS
11728995;;M;50;CHILENO;;X;SAN ESTEBAN                   ;VALPARAISO;262980;2;4;0;0;0;2;4;262980;Asistencia Programa Domiciliario;GARANTIAS
7668664;;M;67;CHILENO;;Boomers;LOS ANDES                     ;VALPARAISO;105980;2;2;0;0;0;2;2;105980;ASIST. FULL HOGAR Y AUTO INGRAL;GARANTIAS
13547870;;F;45;CHILENO;;X;PUDAHUEL;METROPOLITANA;52990;1;1;0;0;0;1;1;52990;Asistencia Programa Domiciliario;GARANTIAS
20144558;;M;22;CHILENO;;Z;LOLOL                         ;L.G.B.OÂ´HIGGINS;105980;2;1;0;0;0;2;1;105980;Asistencia Salud Integral Familia;GARANTIAS
9766994;;F;57;CHILENO;;Boomers;QUINTA NORMAL                 ;METROPOLITANA;322950;5;4;0;0;0;5;4;322950;Asistencia Salud Integral Familia;GARANTIAS
20752237;;F;21;CHILENO;;Z;COQUIMBO;COQUIMBO;52990;1;1;0;0;0;1;1;52990;Asistencia Salud Integral Familia;GARANTIAS
6913191;;F;69;CHILENO;;Silencioso;N/D;N/D;224640;5;5;2;1;131980;3;4;92660;Asistencia Salud Integral Familia;GARANTIAS
10085525;;M;57;CHILENO;;Boomers;N/D;N/D;52990;1;1;0;0;0;1;1;52990;ASIST. FULL HOGAR Y AUTO INGRAL;GARANTIAS
22667541;;F;69;PERUANO;;Extranjero;VITACURA                      ;METROPOLITANA;52990;1;1;0;0;0;1;1;52990;Asistencia Programa Domiciliario;GARANTIAS
5284170;;F;76;CHILENO;;Silencioso;VILLARICA                     ;ARAUCANIA;52990;1;1;0;0;0;1;1;52990;Asistencia Salud Integral Familia;GARANTIAS
6411038;;F;78;CHILENO;;Silencioso;CERRILLOS                     ;METROPOLITANA;21360;3;1;0;0;0;3;1;21360;GM 1A X CTA SBI;GARANTIAS
11244025;;F;54;CHILENO;;X;CURANILAHUE                   ;BIO BIO;52990;1;1;0;0;0;1;1;52990;Asistencia Programa Domiciliario;GARANTIAS
11997734;Casado;F;50;CHILENO;;X;RENCA                         ;METROPOLITANA;0;0;2;0;0;0;0;2;0;GPL 1A X CTA SBI;GARANTIAS
7381903;;F;64;CHILENO;;Boomers;LOS ANGELES                   ;BIO BIO;52990;1;1;0;0;0;1;1;52990;Asistencia Programa Domiciliario;GARANTIAS
8744559;;M;62;CHILENO;;Boomers;SAN CLEMENTE                  ;MAULE;268950;5;2;0;0;0;5;2;268950;Asistencia Salud Integral Familia;GARANTIAS
10080870;;F;65;CHILENO;;Boomers;N/D;N/D;415950;5;3;0;0;0;5;3;415950;Asistencia Programa Domiciliario;GARANTIAS
8581168;;M;71;CHILENO;;Silencioso;RENGO                         ;L.G.B.OÂ´HIGGINS;100870;2;2;0;0;0;2;2;100870;Asistencia Salud Integral Familia;GARANTIAS
6517333;;F;71;CHILENO;;Silencioso;FREIRE                        ;ARAUCANIA;52990;1;1;0;0;0;1;1;52990;Asistencia Salud Integral Familia;GARANTIAS
17639226;;M;31;CHILENO;;Millenial;PUERTO VARAS                  ;LOS LAGOS;52990;1;1;0;0;0;1;1;52990;Asistencia Programa Domiciliario;GARANTIAS
13228831;;F;45;CHILENO;;X;VALPARAISO                    ;VALPARAISO;164960;4;3;0;0;0;4;3;164960;Asistencia Salud Integral Familia;GARANTIAS
5257410;;F;75;CHILENO;;Silencioso;ANTOFAGASTA                   ;ANTOFAGASTA;211960;4;3;0;0;0;4;3;211960;Asistencia Programa Domiciliario;GARANTIAS
17745967;;F;31;CHILENO;;Millenial;ANGOL                         ;ARAUCANIA;740940;6;3;0;0;0;6;3;740940;Asistencia Salud Integral Familia;GARANTIAS
6666387;;F;69;CHILENO;;Silencioso;ANDACOLLO                     ;COQUIMBO;52990;1;1;0;0;0;1;1;52990;Asistencia Salud Integral Familia;GARANTIAS
5642328;;M;72;CHILENO;;Silencioso;CURICO                        ;MAULE;105980;2;1;0;0;0;2;1;105980;Asistencia Salud Integral Familia;GARANTIAS
11071020;;F;56;CHILENO;;Boomers;"";"";237740;5;3;0;0;0;5;3;237740;Asistencia Salud Integral Familia;GARANTIAS
10904935;;F;53;CHILENO;;X;DIEGO DE ALMAGRO              ;ATACAMA;105980;2;1;0;0;0;2;1;105980;Asistencia Salud Integral Familia;GARANTIAS
9156398;;M;61;CHILENO;;Boomers;LOTA                          ;BIO BIO;53000;2;1;0;0;0;2;1;53000;Asistencia Programa Domiciliario;GARANTIAS
16707639;;M;36;CHILENO;;Millenial;LA REINA;METROPOLITANA;52990;1;1;0;0;0;1;1;52990;Asistencia Programa Domiciliario;GARANTIAS
7265966;;F;68;CHILENO;;Silencioso;PINTO                         ;BIO BIO;152980;2;2;0;0;0;2;2;152980;Asistencia Programa Domiciliario;GARANTIAS
13041297;;F;50;CHILENO;;X;"";"";52990;1;1;0;0;0;1;1;52990;Asistencia Programa Domiciliario;GARANTIAS
12561246;;M;47;CHILENO;;X;NEGRETE                       ;BIO BIO;246050;4;4;0;0;0;4;4;246050;ASIST. FULL HOGAR Y AUTO INGRAL;GARANTIAS
9116863;;F;59;CHILENO;;Boomers;LOS ALAMOS                    ;BIO BIO;104970;3;3;0;0;0;3;3;104970;Asistencia Salud Integral Familia;GARANTIAS
11269022;;M;54;CHILENO;;X;EL BOSQUE                     ;METROPOLITANA;86980;3;1;0;0;0;3;1;86980;GPL 1A X CTA SBI;GARANTIAS
12732156;;F;47;CHILENO;;X;N/D;N/D;52990;1;1;0;0;0;1;1;52990;Asistencia Programa Domiciliario;GARANTIAS
6730568;;M;70;CHILENO;;Silencioso;OVALLE                        ;COQUIMBO;0;0;4;0;0;0;0;4;0;Asistencia Programa Domiciliario;GARANTIAS
5590148;;M;76;CHILENO;;Silencioso;LOS ANDES                     ;VALPARAISO;52990;1;1;0;0;0;1;1;52990;Asistencia Salud Integral Familia;GARANTIAS
26094828;;M;33;EXTRANJERO - NO INFORMA NACIONALIDAD;;Extranjero;RECOLETA;METROPOLITANA;52990;1;1;0;0;0;1;1;52990;ASIST. FULL HOGAR Y AUTO INGRAL;GARANTIAS
7767465;;M;66;CHILENO;;Boomers;VICTORIA                      ;ARAUCANIA;52990;1;1;0;0;0;1;1;52990;Asistencia Salud Integral Familia;GARANTIAS
13504179;;F;44;CHILENO;;X;SAN VICENTE                   ;L.G.B.OÂ´HIGGINS;52990;1;1;0;0;0;1;1;52990;Asistencia Salud Integral Familia;GARANTIAS
11739019;;M;50;CHILENO;;X;COLINA                        ;METROPOLITANA;342970;3;4;0;0;0;3;4;342970;Asistencia Salud Integral Familia;GARANTIAS
6616357;;M;67;CHILENO;;Boomers;MELIPILLA                     ;METROPOLITANA;105980;2;2;0;0;0;2;2;105980;ASIST. FULL HOGAR Y AUTO INGRAL;GARANTIAS
6077004;;M;71;CHILENO;;Silencioso;LONGAVI                       ;MAULE;105980;2;1;0;0;0;2;1;105980;Asistencia Salud Integral Familia;GARANTIAS
25838068;;M;47;PERUANO;;Extranjero;SANTIAGO                      ;METROPOLITANA;52990;1;1;0;0;0;1;1;52990;ASIST. FULL HOGAR Y AUTO INGRAL;GARANTIAS
13212484;;M;45;CHILENO;;X;ANTOFAGASTA                   ;ANTOFAGASTA;211960;4;1;0;0;0;4;1;211960;Asistencia Programa Domiciliario;GARANTIAS
11378225;;F;52;CHILENO;;X;CALAMA                        ;ANTOFAGASTA;52990;1;1;0;0;0;1;1;52990;Asistencia Salud Integral Familia;GARANTIAS
9028678;;M;58;CHILENO;;Boomers;CABILDO                       ;VALPARAISO;87980;2;2;0;0;0;2;2;87980;Asistencia Salud Integral Familia;GARANTIAS
26821202;Soltero;F;47;EXTRANJERO - NO INFORMA NACIONALIDAD;;Extranjero;"";"";52990;1;1;0;0;0;1;1;52990;Asistencia Programa Domiciliario;GARANTIAS
6710147;;M;68;CHILENO;;Silencioso;PEUMO                         ;L.G.B.OÂ´HIGGINS;52990;1;1;0;0;0;1;1;52990;Asistencia Salud Integral Familia;GARANTIAS
26020301;;F;34;VENEZOLANO;;Extranjero;N/D;N/D;52990;1;1;0;0;0;1;1;52990;Asistencia Programa Domiciliario;GARANTIAS
11306011;;M;53;CHILENO;;X;N/D;N/D;105650;4;2;0;0;0;4;2;105650;Asistencia Salud Integral Familia;GARANTIAS
4711420;;M;82;CHILENO;;Silencioso;CABILDO                       ;VALPARAISO;459530;6;3;0;0;0;6;3;459530;Asistencia Salud Integral Familia;GARANTIAS
26483407;;F;22;EXTRANJERO - NO INFORMA NACIONALIDAD;;Extranjero;ESTACION CENTRAL              ;METROPOLITANA;0;0;2;0;0;0;0;2;0;Asistencia Programa Domiciliario;GARANTIAS
7268934;;F;67;CHILENO;;Boomers;LO PRADO                      ;METROPOLITANA;52990;1;1;0;0;0;1;1;52990;Asistencia Programa Domiciliario;GARANTIAS
7654019;;F;72;CHILENO;;Silencioso;TOCOPILLA                     ;ANTOFAGASTA;272350;4;2;0;0;0;4;2;272350;Asistencia Programa Domiciliario;GARANTIAS
15520765;;M;38;CHILENO;;Millenial;PUMANQUE                      ;L.G.B.OÂ´HIGGINS;52990;1;1;0;0;0;1;1;52990;Asistencia Salud Integral Familia;GARANTIAS
10061541;;F;60;CHILENO;;Boomers;LAS CABRAS                    ;L.G.B.OÂ´HIGGINS;52990;1;1;0;0;0;1;1;52990;Asistencia Salud Integral Familia;GARANTIAS
21882694;;F;50;PERUANO;;Extranjero;N/D;N/D;947920;9;2;0;0;0;9;2;947920;Asistencia Programa Domiciliario;GARANTIAS
26436498;Soltero;F;59;EXTRANJERO - NO INFORMA NACIONALIDAD;;Extranjero;SANTIAGO                      ;METROPOLITANA;52990;1;1;0;0;0;1;1;52990;Asistencia Programa Domiciliario;GARANTIAS
10003693;;F;58;CHILENO;;Boomers;LICANTEN                      ;MAULE;105980;2;1;0;0;0;2;1;105980;Asistencia Programa Domiciliario;GARANTIAS
10039383;;F;59;CHILENO;;Boomers;LA SERENA                     ;COQUIMBO;52990;1;1;0;0;0;1;1;52990;Asistencia Salud Integral Familia;GARANTIAS
7058346;;M;68;CHILENO;;Silencioso;IQUIQUE                       ;TARAPACA;52990;1;1;0;0;0;1;1;52990;Asistencia Salud Integral Familia;GARANTIAS
26019260;;M;30;EXTRANJERO - NO INFORMA NACIONALIDAD;;Extranjero;PROVIDENCIA                   ;METROPOLITANA;52990;1;1;0;0;0;1;1;52990;Asistencia Programa Domiciliario;GARANTIAS
10776438;;F;55;CHILENO;;Boomers;N/D;N/D;52990;1;1;0;0;0;1;1;52990;Asistencia Programa Domiciliario;GARANTIAS
10862133;;F;42;CHILENO;;X;N/D;N/D;52990;1;1;0;0;0;1;1;52990;Asistencia Salud Integral Familia;GARANTIAS
10447916;;F;57;CHILENO;;Boomers;LA LIGUA                      ;VALPARAISO;146160;3;2;0;0;0;3;2;146160;Asistencia Salud Integral Familia;GARANTIAS
9857168;;M;57;CHILENO;;Boomers;"";"";52990;1;1;0;0;0;1;1;52990;ASIST. FULL HOGAR Y AUTO INGRAL;GARANTIAS
10433288;;F;56;CHILENO;;Boomers;ARICA                         ;ARICA Y PARINACOTA;52990;1;1;0;0;0;1;1;52990;Asistencia Salud Integral Familia;GARANTIAS
26506957;Soltero;M;34;CHILENO;;Extranjero;"";"";52990;1;1;0;0;0;1;1;52990;Asistencia Salud Integral Familia;GARANTIAS
18463010;;F;29;CHILENO;;Millenial;PUENTE ALTO                   ;METROPOLITANA;52990;1;1;0;0;0;1;1;52990;Asistencia Salud Integral Familia;GARANTIAS
12828671;;F;47;CHILENO;;X;PROVIDENCIA                   ;METROPOLITANA;15980;2;1;0;0;0;2;1;15980;GM 1A X CTA SBI;GARANTIAS
15914083;;F;41;CHILENO;;X;N/D;N/D;52990;1;1;0;0;0;1;1;52990;Asistencia Salud Integral Familia;GARANTIAS
11518373;;M;52;CHILENO;;X;"";"";52990;1;1;0;0;0;1;1;52990;Asistencia Salud Integral Familia;GARANTIAS
26844088;;F;40;VENEZOLANO;;Extranjero;SAN FELIPE                    ;VALPARAISO;52990;1;1;0;0;0;1;1;52990;Asistencia Salud Integral Familia;GARANTIAS
22756932;;F;27;EXTRANJERO - NO INFORMA NACIONALIDAD;;Extranjero;IQUIQUE                       ;TARAPACA;52990;1;1;0;0;0;1;1;52990;Asistencia Salud Integral Familia;GARANTIAS
7905248;;F;74;CHILENO;;Silencioso;ISLA DE MAIPO                 ;METROPOLITANA;52990;1;1;0;0;0;1;1;52990;Asistencia Programa Domiciliario;GARANTIAS
15822008;;M;37;CHILENO;;Millenial;N/D;N/D;-47880;-1;1;0;0;0;-1;1;-47880;ASIS. SALUD X CTA ASSISTIME;GARANTIAS
8806774;;M;56;CHILENO;;Boomers;PUERTO MONTT                  ;LOS LAGOS;244970;3;2;0;0;0;3;2;244970;Asistencia Salud Integral Familia;GARANTIAS
5998747;;M;72;CHILENO;;Silencioso;TALCA                         ;MAULE;158970;3;2;0;0;0;3;2;158970;ASIST. FULL HOGAR Y AUTO INGRAL;GARANTIAS
12025956;;F;57;CHILENO;;Boomers;SAN JAVIER                    ;MAULE;52990;1;1;0;0;0;1;1;52990;Asistencia Salud Integral Familia;GARANTIAS
14524226;;F;47;CHILENO;;X;N/D;N/D;52990;1;1;0;0;0;1;1;52990;Asistencia Programa Domiciliario;GARANTIAS
8201070;;F;63;CHILENO;;Boomers;SAN BERNARDO                  ;METROPOLITANA;52990;1;1;0;0;0;1;1;52990;Asistencia Salud Integral Familia;GARANTIAS
23858940;;M;38;COLOMBIANO;;Extranjero;COLINA                        ;METROPOLITANA;52990;1;1;0;0;0;1;1;52990;Asistencia de Mascotas;GARANTIAS
25691611;Soltero;M;26;EXTRANJERO - NO INFORMA NACIONALIDAD;;Extranjero;"";"";52990;1;1;0;0;0;1;1;52990;Asistencia de Mascotas;GARANTIAS
9135371;;M;61;CHILENO;;Boomers;TOME                          ;BIO BIO;468950;5;2;0;0;0;5;2;468950;Asistencia Programa Domiciliario;GARANTIAS
25393041;;M;30;COLOMBIANO;;Extranjero;ESTACION CENTRAL              ;METROPOLITANA;52990;1;1;0;0;0;1;1;52990;Asistencia Programa Domiciliario;GARANTIAS
26720829;;F;40;VENEZOLANO;;Extranjero;N/D;N/D;117980;2;2;0;0;0;2;2;117980;Asistencia Salud Integral Familia;GARANTIAS
13107692;;M;45;CHILENO;;X;CHIGUAYANTE                   ;BIO BIO;190000;3;3;0;0;0;3;3;190000;Asistencia Programa Domiciliario;GARANTIAS
16142553;;F;37;CHILENO;;X;VINA DEL MAR                  ;VALPARAISO;52990;1;1;0;0;0;1;1;52990;Asistencia Salud Integral Familia;GARANTIAS
8824760;;M;61;CHILENO;;Boomers;PUDAHUEL                      ;METROPOLITANA;52990;1;1;0;0;0;1;1;52990;Asistencia Programa Domiciliario;GARANTIAS
6925998;;F;72;CHILENO;;Silencioso;"";"";52990;1;1;0;0;0;1;1;52990;Asistencia Programa Domiciliario;GARANTIAS
6783505;;F;70;CHILENO;;Silencioso;SAN BERNARDO                  ;METROPOLITANA;52990;1;1;0;0;0;1;1;52990;Asistencia Programa Domiciliario;GARANTIAS
13979683;;M;41;CHILENO;;X;LA LIGUA                      ;VALPARAISO;52990;1;1;0;0;0;1;1;52990;Asistencia Salud Integral Familia;GARANTIAS
19365807;;F;26;CHILENO;;Z;PUNTA ARENAS                  ;MAGALLANES;52990;1;1;0;0;0;1;1;52990;Asistencia Programa Domiciliario;GARANTIAS
7702273;;F;68;CHILENO;;Silencioso;SAN PEDRO DE LA PAZ           ;BIO BIO;490450;4;2;0;0;0;4;2;490450;Asistencia Salud Integral Familia;GARANTIAS
7047938;;F;58;CHILENO;;Boomers;N/D;N/D;52990;1;1;0;0;0;1;1;52990;Asistencia Programa Domiciliario;GARANTIAS
17903914;;M;31;CHILENO;;Millenial;N/D;N/D;356960;4;2;0;0;0;4;2;356960;Asistencia Salud Integral Familia;GARANTIAS
17232170;;M;32;CHILENO;;Millenial;CONCEPCION                    ;BIO BIO;52990;1;1;0;0;0;1;1;52990;Asistencia Salud Integral Familia;GARANTIAS
16701454;;F;35;CHILENO;;Millenial;N/D;N/D;47880;1;1;0;0;0;1;1;47880;ASIS. SALUD X CTA ASSISTIME;GARANTIAS
14265224;;F;55;CHILENO;;Boomers;CORONEL                       ;BIO BIO;104980;2;2;0;0;0;2;2;104980;Asistencia Salud Integral Familia;GARANTIAS
8620623;;F;61;CHILENO;;Boomers;MAIPU                         ;METROPOLITANA;52990;1;1;0;0;0;1;1;52990;Asistencia Salud Integral Familia;GARANTIAS
26358267;;M;36;CHILENO;;Extranjero;N/D;N/D;59990;1;1;0;0;0;1;1;59990;Asistencia Salud Integral Familia;GARANTIAS
10600861;;M;57;CHILENO;;Boomers;ANGOL                         ;ARAUCANIA;47880;1;1;0;0;0;1;1;47880;ASIS. SALUD X CTA ASSISTIME;GARANTIAS
26783016;;M;31;VENEZOLANO;;Extranjero;N/D;N/D;47880;1;1;0;0;0;1;1;47880;ASIS. SALUD X CTA ASSISTIME;GARANTIAS
5731072;;F;76;CHILENO;;Silencioso;N/D;N/D;47880;1;1;0;0;0;1;1;47880;ASIS. SALUD X CTA ASSISTIME;GARANTIAS
11375782;;M;53;CHILENO;;X;IQUIQUE                       ;TARAPACA;55080;1;1;0;0;0;1;1;55080;Asistencia Programa Domiciliario;GARANTIAS
15147308;;F;37;CHILENO;;Millenial;PELLUHUE                      ;MAULE;0;0;2;0;0;0;0;2;0;ASIS. SALUD X CTA ASSISTIME;GARANTIAS
11950957;;F;50;CHILENO;;X;RENGO                         ;L.G.B.OÂ´HIGGINS;47880;1;1;0;0;0;1;1;47880;ASIS. SALUD X CTA ASSISTIME;GARANTIAS
13966475;;M;45;CHILENO;;X;N/D;N/D;47880;1;1;0;0;0;1;1;47880;ASIS. SALUD X CTA ASSISTIME;GARANTIAS
26042483;;F;26;VENEZOLANO;;Extranjero;SANTIAGO;METROPOLITANA;47880;1;1;0;0;0;1;1;47880;ASIS. SALUD X CTA ASSISTIME;GARANTIAS
9365153;;M;60;CHILENO;;Boomers;SAN BERNARDO                  ;METROPOLITANA;109060;3;2;0;0;0;3;2;109060;Asistencia Programa Domiciliario;GARANTIAS
15001474;;F;35;CHILENO;;Millenial;N/D;N/D;47880;1;1;0;0;0;1;1;47880;ASIS. SALUD X CTA ASSISTIME;GARANTIAS
18361959;;M;28;CHILENO;;Millenial;TOCOPILLA                     ;ANTOFAGASTA;19210;-2;2;-3;1;-28670;1;1;47880;ASIS. SALUD X CTA ASSISTIME;GARANTIAS
7915329;;M;66;CHILENO;;Boomers;LINARES                       ;MAULE;55080;1;1;0;0;0;1;1;55080;Asistencia Programa Domiciliario;GARANTIAS
16389027;;F;35;CHILENO;;Millenial;CUNCO                         ;ARAUCANIA;47880;1;1;0;0;0;1;1;47880;ASIS. SALUD X CTA ASSISTIME;GARANTIAS
24854136;;F;50;COLOMBIANO;;Extranjero;QUINTA NORMAL                 ;METROPOLITANA;47880;1;1;0;0;0;1;1;47880;ASIS. SALUD X CTA ASSISTIME;GARANTIAS
23684333;;M;60;PERUANO;;Extranjero;CALAMA                        ;ANTOFAGASTA;47880;1;1;0;0;0;1;1;47880;ASIS. SALUD X CTA ASSISTIME;GARANTIAS
8191479;;F;63;CHILENO;;Boomers;PUERTO MONTT                  ;LOS LAGOS;47880;1;1;0;0;0;1;1;47880;ASIS. SALUD X CTA ASSISTIME;GARANTIAS
13581425;;M;43;CHILENO;;X;N/D;N/D;-47880;-1;1;0;0;0;-1;1;-47880;ASIS. SALUD X CTA ASSISTIME;GARANTIAS
10861005;;F;56;CHILENO;;Boomers;CANETE                        ;BIO BIO;47880;1;1;0;0;0;1;1;47880;ASIS. SALUD X CTA ASSISTIME;GARANTIAS
9564795;;M;59;CHILENO;;Boomers;N/D;N/D;90960;2;1;0;0;0;2;1;90960;ASIS. SALUD X CTA ASSISTIME;GARANTIAS
13327966;;F;44;CHILENO;;X;N/D;N/D;55080;1;1;0;0;0;1;1;55080;Asistencia Programa Domiciliario;GARANTIAS
11583907;;M;51;CHILENO;;X;N/D;N/D;47880;1;1;0;0;0;1;1;47880;ASIS. SALUD X CTA ASSISTIME;GARANTIAS
11603323;;M;52;CHILENO;;X;CANETE                        ;BIO BIO;47880;1;1;0;0;0;1;1;47880;ASIS. SALUD X CTA ASSISTIME;GARANTIAS
13323206;;M;45;CHILENO;;X;PUERTO MONTT                  ;LOS LAGOS;0;0;0;0;0;0;0;0;0;ASIS. SALUD X CTA ASSISTIME;GARANTIAS
10989781;;F;43;CHILENO;;X;CHILLAN                       ;NUBLE;0;0;0;0;0;0;0;0;0;ASIS. SALUD X CTA ASSISTIME;GARANTIAS
19979486;;M;23;CHILENO;;Z;N/D;N/D;0;0;0;0;0;0;0;0;0;ASIS. SALUD X CTA ASSISTIME;GARANTIAS
17197909;;F;33;CHILENO;;Millenial;N/D;N/D;0;0;0;0;0;0;0;0;0;ASIS. SALUD X CTA ASSISTIME;GARANTIAS
13790715;;M;41;CHILENO;;X;N/D;N/D;0;0;0;0;0;0;0;0;0;ASIS. SALUD X CTA ASSISTIME;GARANTIAS
11696370;;M;50;CHILENO;;X;PUENTE ALTO                   ;METROPOLITANA;0;0;0;0;0;0;0;0;0;ASIS. SALUD X CTA ASSISTIME;GARANTIAS
14082365;;M;41;CHILENO;;X;N/D;N/D;0;0;0;0;0;0;0;0;0;ASIS. SALUD X CTA ASSISTIME;GARANTIAS
12834974;;M;46;CHILENO;;Millenial;"";"";0;0;0;0;0;0;0;0;0;ASIS. SALUD X CTA ASSISTIME;GARANTIAS
10785048;;F;45;CHILENO;;X;PROVIDENCIA                   ;METROPOLITANA;0;0;0;0;0;0;0;0;0;ASIS. SALUD X CTA ASSISTIME;GARANTIAS
26272998;;M;50;EXTRANJERO - NO INFORMA NACIONALIDAD;;Extranjero;CALDERA                       ;ATACAMA;0;0;0;0;0;0;0;0;0;ASIS. SALUD X CTA ASSISTIME;GARANTIAS
27084407;;M;40;VENEZOLANO;;Extranjero;CONCEPCION                    ;BIO BIO;0;0;0;0;0;0;0;0;0;ASIS. SALUD X CTA ASSISTIME;GARANTIAS
17090046;;F;32;CHILENO;;Millenial;PROVIDENCIA                   ;METROPOLITANA;0;0;0;0;0;0;0;0;0;GM 1A X CTA SBI;GARANTIAS
11759332;;M;50;CHILENO;;X;RENGO                         ;L.G.B.OÂ´HIGGINS;0;0;0;0;0;0;0;0;0;ASIS. SALUD X CTA ASSISTIME;GARANTIAS
11455303;;F;53;CHILENO;;X;CHEPICA                       ;L.G.B.OÂ´HIGGINS;0;0;0;0;0;0;0;0;0;ASIS. SALUD X CTA ASSISTIME;GARANTIAS
15809870;;F;37;CHILENO;;Millenial;SAN CARLOS                    ;BIO BIO;0;0;0;0;0;0;0;0;0;GM 1A X CTA SBI;GARANTIAS
16011358;;F;37;CHILENO;;Millenial;TALCAHUANO                    ;BIO BIO;0;0;0;0;0;0;0;0;0;GM 1A X CTA SBI;GARANTIAS
11072391;;F;57;CHILENO;;Boomers;SAN JAVIER                    ;MAULE;0;0;0;0;0;0;0;0;0;ASIS. SALUD X CTA ASSISTIME;GARANTIAS
10235591;;F;56;CHILENO;;Boomers;PROVIDENCIA                   ;METROPOLITANA;0;0;0;0;0;0;0;0;0;ASIS. SALUD X CTA ASSISTIME;GARANTIAS
25354447;;F;29;BOLIVIANO;;Extranjero;N/D;N/D;0;0;0;0;0;0;0;0;0;GM 1A X CTA SBI;GARANTIAS
8511899;;M;59;CHILENO;;Boomers;N/D;N/D;0;0;0;0;0;0;0;0;0;ASIS. SALUD X CTA ASSISTIME;GARANTIAS
14002759;;M;41;CHILENO;;X;SANTO DOMINGO                 ;VALPARAISO;0;0;0;0;0;0;0;0;0;ASIS. SALUD X CTA ASSISTIME;GARANTIAS
18689791;;F;27;CHILENO;;Millenial;RENCA                         ;METROPOLITANA;0;0;0;0;0;0;0;0;0;GPL 1A X CTA SBI;GARANTIAS
15808408;;M;38;CHILENO;;Millenial;N/D;N/D;0;0;0;0;0;0;0;0;0;ASIS. SALUD X CTA ASSISTIME;GARANTIAS
13284171;;M;49;CHILENO;;X;PUENTE ALTO                   ;METROPOLITANA;0;0;0;0;0;0;0;0;0;ASIST. FULL HOGAR X CTA MOK;GARANTIAS
25311554;;F;71;COLOMBIANO;;Extranjero;PUDAHUEL                      ;METROPOLITANA;0;0;0;0;0;0;0;0;0;ASIS. SALUD X CTA ASSISTIME;GARANTIAS
18982745;;F;27;CHILENO;;Z;LINARES                       ;MAULE;0;0;0;0;0;0;0;0;0;ASIS. SALUD X CTA ASSISTIME;GARANTIAS
5993464;;M;74;CHILENO;;Silencioso;ALTO HOSPICIO;TARAPACA;0;0;0;0;0;0;0;0;0;ASIS. SALUD X CTA ASSISTIME;GARANTIAS
16242376;;F;37;CHILENO;;Millenial;N/D;N/D;0;0;0;0;0;0;0;0;0;ASIS. SALUD X CTA ASSISTIME;GARANTIAS
5514310;;F;74;CHILENO;;Silencioso;TALAGANTE                     ;METROPOLITANA;0;0;0;0;0;0;0;0;0;ASIS. SALUD X CTA ASSISTIME;GARANTIAS
15167076;;F;40;CHILENO;;X;PROVIDENCIA                   ;METROPOLITANA;0;0;0;0;0;0;0;0;0;ASIS. SALUD X CTA ASSISTIME;GARANTIAS
13533434;;M;42;CHILENO;;X;VICUNA                        ;COQUIMBO;0;0;0;0;0;0;0;0;0;ASIS. SALUD X CTA ASSISTIME;GARANTIAS
18665848;;M;28;CHILENO;;Millenial;PADRE HURTADO                 ;METROPOLITANA;0;0;0;0;0;0;0;0;0;ASIS. SALUD X CTA ASSISTIME;GARANTIAS
15357245;;F;39;CHILENO;;X;PUENTE ALTO                   ;METROPOLITANA;0;0;0;0;0;0;0;0;0;ASIS. SALUD X CTA ASSISTIME;GARANTIAS
8611182;Casado;M;63;CHILENO;;Boomers;RENCA                         ;METROPOLITANA;0;0;0;0;0;0;0;0;0;GM 1A X CTA SBI;GARANTIAS
26430098;;F;32;VENEZOLANO;;Extranjero;CONCEPCION                    ;BIO BIO;0;0;0;0;0;0;0;0;0;ASIS. SALUD X CTA ASSISTIME;GARANTIAS
13173269;;F;44;CHILENO;;X;QUILPUE                       ;VALPARAISO;0;0;0;0;0;0;0;0;0;ASIS. SALUD X CTA ASSISTIME;GARANTIAS
5852839;;F;71;CHILENO;;Silencioso;COQUIMBO                      ;COQUIMBO;0;0;0;0;0;0;0;0;0;ASIS. SALUD X CTA ASSISTIME;GARANTIAS
26375974;;F;30;VENEZOLANO;;Extranjero;CURICO                        ;MAULE;0;0;0;0;0;0;0;0;0;ASIS. SALUD X CTA ASSISTIME;GARANTIAS
7150468;;M;69;CHILENO;;Silencioso;CABILDO                       ;VALPARAISO;0;0;0;0;0;0;0;0;0;ASIS. SALUD X CTA ASSISTIME;GARANTIAS
10484697;;F;55;CHILENO;;Boomers;SAN RAMON                     ;METROPOLITANA;0;0;0;0;0;0;0;0;0;ASIS. SALUD X CTA ASSISTIME;GARANTIAS
8076637;;F;65;CHILENO;;Boomers;LA SERENA                     ;COQUIMBO;0;0;0;0;0;0;0;0;0;ASIS. SALUD X CTA ASSISTIME;GARANTIAS
13565812;;M;42;CHILENO;;X;QUILICURA                     ;METROPOLITANA;0;0;0;0;0;0;0;0;0;ASIST. FULL HOGAR X CTA MOK;GARANTIAS
10579073;;F;57;CHILENO;;Boomers;PUENTE ALTO                   ;METROPOLITANA;0;0;0;0;0;0;0;0;0;ASIS. SALUD X CTA ASSISTIME;GARANTIAS
10003582;;M;57;CHILENO;;Boomers;CHIGUAYANTE                   ;BIO BIO;0;0;0;0;0;0;0;0;0;ASIS. SALUD X CTA ASSISTIME;GARANTIAS
11361816;;M;53;CHILENO;;X;PENAFLOR                      ;METROPOLITANA;0;0;0;0;0;0;0;0;0;ASIS. SALUD X CTA ASSISTIME;GARANTIAS
14163727;;M;40;CHILENO;;X;HUECHURABA                    ;METROPOLITANA;0;0;0;0;0;0;0;0;0;ASIST. FULL HOGAR X CTA MOK;GARANTIAS
5615377;;F;76;CHILENO;;Silencioso;N/D;N/D;1180671;14;5;0;0;0;14;5;1180671;CELULAR VIVO Y15S WAVE GREEN OPEN;TELEFONIA
5159403;;F;78;CHILENO;;Silencioso;ARICA                         ;ARICA Y PARINACOTA;433160;4;2;0;0;0;4;2;433160;CELULAR REDMI NOTE 10S 128GB ONIX BLACK;TELEFONIA
9646268;;M;59;CHILENO;;Boomers;PELLUHUE                      ;MAULE;222140;4;1;0;0;0;4;1;222140;CELULAR AZUMI HTC E1 PLUS BUNDLE;TELEFONIA
13153128;;F;45;CHILENO;;X;CHOLCHOL;ARAUCANIA;134447;3;1;0;0;0;3;1;134447;CELULAR VIVO Y15S BLUE MOVISTAR;TELEFONIA
18684816;Soltero;F;28;CHILENO;;Millenial;PROVIDENCIA                   ;METROPOLITANA;0;0;2;0;2;0;0;0;0;CELULAR GALAXY S22 PINK GOLD 256GB;TELEFONIA
10532544;Casado;F;52;CHILENO;;X;RENCA                         ;METROPOLITANA;329980;2;2;0;0;0;2;2;329980;CELULAR GALAXY A22 5G 4+128GB GRAY;TELEFONIA
15281661;;F;38;CHILENO;;Millenial;"";"";104613;4;2;0;0;0;4;2;104613;CELULAR VIVO Y21S 128GB BLANCO WOM;TELEFONIA
14341549;;M;44;CHILENO;;X;TALCA                         ;MAULE;637380;7;3;0;0;0;7;3;637380;CELULAR VIVO Y01 AZUL ZAFIRO OPEN;TELEFONIA
12717275;;F;47;CHILENO;;X;MONTE PATRIA                  ;COQUIMBO;512170;5;2;0;0;0;5;2;512170;CELULAR GALAXY A33 5G 6+128GB BLACK OPEN;TELEFONIA
15342401;;M;38;CHILENO;;X;PROVIDENCIA                   ;METROPOLITANA;129990;1;1;0;0;0;1;1;129990;CELULAR REDMI 10A US 32GB CHROME SILVER OPEN;TELEFONIA
18452740;;M;28;CHILENO;;Millenial;N/D;N/D;806470;3;2;0;0;0;3;2;806470;CELULAR VIVO V21 5G DUSK BLUE 128GB OPEN;TELEFONIA
16300041;;F;35;CHILENO;;Millenial;SALAMANCA                     ;COQUIMBO;256000;3;2;0;0;0;3;2;256000;CELULAR GALAXY A13 4+128GB LIGHT BLUE OPEN;TELEFONIA
18802619;;F;27;CHILENO;;Millenial;CORONEL                       ;BIO BIO;224950;6;4;0;0;0;6;4;224950;CELULAR GALAXY A03 CORE 2GB 32GB BLUE OPEN;TELEFONIA
20054673;;F;23;CHILENO;;Millenial;N/D;N/D;511870;8;3;0;0;0;8;3;511870;CELULAR XIAOMI 12 LITE PINK OPEN;TELEFONIA
12984733;;M;46;CHILENO;;X;RENCA                         ;METROPOLITANA;39990;1;1;0;0;0;1;1;39990;CELULAR BMOBILE BS30 BLACK OPEN;TELEFONIA
18439211;;F;28;CHILENO;;Millenial;"";"";122970;3;2;0;0;0;3;2;122970;CELULAR XIAOMI REDMI 9A 32GB GRANITE GRAY TRI WO;TELEFONIA
9636887;;F;57;CHILENO;;Boomers;VICTORIA                      ;ARAUCANIA;910060;6;2;0;0;0;6;2;910060;CELULAR VIVO Y53S FANTASTIC RAINBOW 128GB OPEN;TELEFONIA
9554499;;F;60;CHILENO;;Boomers;TALCA                         ;MAULE;205010;2;1;0;0;0;2;1;205010;CELULAR VIVO Y21S 128GB BLANCO WOM;TELEFONIA
14353814;;M;43;CHILENO;;X;PROVIDENCIA                   ;METROPOLITANA;480320;7;4;0;0;0;7;4;480320;CELULAR VIVO Y15S BLUE MOVISTAR;TELEFONIA
7230442;;M;69;CHILENO;;Silencioso;QUELLON                       ;LOS LAGOS;1352802;13;5;0;0;0;13;5;1352802;CELULAR ALCATEL P1 3080 BLACK MOVISTAR DIRECTO;TELEFONIA
15125138;;M;39;CHILENO;;X;PROVIDENCIA                   ;N/D;109990;1;1;0;0;0;1;1;109990;CELULAR GALAXY A03 4+64GB BLACK OPEN;TELEFONIA
8057788;;F;64;CHILENO;;Boomers;ILLAPEL                       ;COQUIMBO;1064950;5;3;0;0;0;5;3;1064950;CELULAR GALAXY A73 5G 256GB GRAY OPEN;TELEFONIA
13386592;;M;44;CHILENO;;Silencioso;PROVIDENCIA                   ;METROPOLITANA;39990;1;1;0;0;0;1;1;39990;CELULAR BMOBILE BS30 BLACK OPEN;TELEFONIA
16755455;Soltero;M;35;CHILENO;;Millenial;N/D;N/D;2000380;32;20;4;2;253960;28;18;1746420;CELULAR REDMI 9A 32GB AURORA GREEN OPEN;TELEFONIA
15309136;;M;40;CHILENO;;X;LA SERENA                     ;COQUIMBO;1112870;8;5;4;2;428960;4;3;683910;CELULAR GALAXY A73 5G 128GB LIGHT GREEN OPEN;TELEFONIA
15047839;;F;37;CHILENO;;Millenial;SALAMANCA                     ;COQUIMBO;194990;1;1;0;0;0;1;1;194990;CELULAR A32 128 GB BLACK OPEN;TELEFONIA
11938650;;M;49;CHILENO;;X;"";"";254686;4;1;0;0;0;4;1;254686;CELULAR GALAXY A33 5G 6+128GB WHITE OPEN;TELEFONIA
23297724;;F;47;PERUANO;;Extranjero;ARICA                         ;ARICA Y PARINACOTA;281950;5;2;0;0;0;5;2;281950;CELULAR GALAXY A03 128GB BLACK CLARO;TELEFONIA
11007566;Divorciado;F;57;CHILENO;;Boomers;RENCA                         ;METROPOLITANA;129990;1;1;1;1;129990;0;0;0;CELULAR MOTOROLA G30 GRIS WOM 128 GB;TELEFONIA
14339792;;M;45;CHILENO;;X;RENCA                         ;METROPOLITANA;89990;1;1;0;0;0;1;1;89990;CELULAR REDMI 9A 32GB AURORA GREEN OPEN;TELEFONIA
19569202;;F;24;CHILENO;;Z;PROVIDENCIA                   ;METROPOLITANA;759100;8;3;0;0;0;8;3;759100;CELULAR GALAXY A33 5G 6+128GB BLACK OPEN;TELEFONIA
19992229;;F;24;CHILENO;;Z;PROVIDENCIA                   ;METROPOLITANA;112133;2;1;0;0;0;2;1;112133;CELULAR VIVO Y21s 128GB AZUL CLARO;TELEFONIA
18376896;;F;29;CHILENO;;Millenial;PROVIDENCIA                   ;METROPOLITANA;359990;2;1;0;0;0;2;1;359990;CELULAR GALAXY A53 5G 6+128GB WHITE;TELEFONIA
8654334;;M;62;CHILENO;;Boomers;PARRAL                        ;MAULE;39990;1;1;0;0;0;1;1;39990;CELULAR ALCATEL P1 3080 BLACK MOVISTAR DIRECTO;TELEFONIA
11710993;;F;51;CHILENO;;X;PENALOLEN                     ;METROPOLITANA;195010;2;1;0;0;0;2;1;195010;CELULAR GALAXY A13 4+128GB WHITE OPEN;TELEFONIA
15788783;Soltero;F;38;CHILENO;PROFESOR;Millenial;PROVIDENCIA                   ;METROPOLITANA;149990;1;1;1;1;149990;0;0;0;CELULAR GALAXY A13 4+128GB LIGHT BLUE OPEN;TELEFONIA
17300097;;F;33;CHILENO;;Millenial;SANTA MARIA                   ;VALPARAISO;474960;4;3;0;0;0;4;3;474960;CELULAR GALAXY A13 4+128GB BLACK;TELEFONIA
14174960;;M;41;CHILENO;;X;TALCA                         ;MAULE;2253370;13;7;2;1;365480;11;6;1887890;CELULAR SAMSUNG A23 128GB BLACK CLARO;TELEFONIA
7442080;;F;70;CHILENO;;Silencioso;CURICO                        ;MAULE;682880;13;7;11;6;617890;2;1;64990;CELULAR MOTOROLA E30 GRIS CLARO;TELEFONIA
13410067;;M;44;CHILENO;;X;CHONCHI                       ;LOS LAGOS;209990;1;1;0;0;0;1;1;209990;CELULAR VIVO Y53S FANTASTIC RAINBOW 128GB OPEN;TELEFONIA
6786612;;F;69;CHILENO;;Silencioso;MELIPILLA                     ;METROPOLITANA;837900;11;5;0;0;0;11;5;837900;CELULAR MOTOROLA E30 GRIS CLARO;TELEFONIA
9261108;;M;60;CHILENO;;Boomers;GALVARINO                     ;ARAUCANIA;139290;2;1;0;0;0;2;1;139290;CELULAR REDMI 9A 32G GLACIAL BLUE OPEN;TELEFONIA
7108269;;M;65;CHILENO;;Boomers;PROVIDENCIA                   ;METROPOLITANA;1655040;15;5;0;0;0;15;5;1655040;CELULAR GALAXY A23 6+128GB BLACK OPEN;TELEFONIA
11088922;;F;56;CHILENO;;Boomers;PUDAHUEL                      ;METROPOLITANA;705710;11;7;0;0;0;11;7;705710;CELULAR REDMI 9C 64GB SUNRISE ORANGE;TELEFONIA
10572298;;F;48;CHILENO;;X;PAINE                         ;METROPOLITANA;184990;1;1;0;0;0;1;1;184990;CELULAR VIVO Y53S AZUL ENTEL;TELEFONIA
12941072;;M;46;CHILENO;;X;PROVIDENCIA                   ;METROPOLITANA;385960;4;3;0;0;0;4;3;385960;CELULAR POCO M4 PRO 128GB COOL BLUE OPEN;TELEFONIA
10470786;;M;54;CHILENO;;Boomers;COLLIPULLI                    ;ARAUCANIA;200000;3;1;0;0;0;3;1;200000;CELULAR MOTO G50 AZUL 128 GB OPEN;TELEFONIA
22454220;;F;25;CHILENO;;Z;ARICA                         ;TARAPACA;464310;7;2;0;0;0;7;2;464310;CELULAR REDMI NOTE 11 PRO 128GB GRAPHITE;TELEFONIA
18809957;Soltero;M;27;CHILENO;QUIMICO FARMACEUTICO;Millenial;PROVIDENCIA                   ;METROPOLITANA;560810;6;3;3;1;415830;3;2;144980;CELULAR GALAXY A13 4+128GB BLACK;TELEFONIA
7832191;;F;64;CHILENO;;Boomers;PADRE LAS CASAS               ;ARAUCANIA;369980;2;6;0;0;0;2;6;369980;CELULAR BMOBILE W41 AZUL 32GB OPEN;TELEFONIA
22223285;;M;56;BOLIVIANO;;Extranjero;ARICA                         ;ARICA Y PARINACOTA;219968;3;1;0;0;0;3;1;219968;CELULAR VIVO Y15S BLUE MOVISTAR;TELEFONIA
13400550;;F;43;CHILENO;;X;PROVIDENCIA                   ;METROPOLITANA;549990;2;1;2;1;549990;0;0;0;CELULAR IPHONE 12 64GB BLACK CLARO;TELEFONIA
20271969;;F;22;CHILENO;;Z;N/D;N/D;980;2;1;0;0;0;2;1;980;CHIP OPEN ENTEL;TELEFONIA
13346563;;F;44;CHILENO;;X;SAN FERNANDO                  ;L.G.B.OÂ´HIGGINS;974320;13;6;0;0;0;13;6;974320;CELULAR GALAXY A22 5G 4+128GB GRAY;TELEFONIA
16228209;;F;36;CHILENO;;Millenial;NIQUEN                        ;BIO BIO;384540;7;4;0;0;0;7;4;384540;CELULAR GALAXY A33 5G 6+128GB ORANGE OPEN;TELEFONIA
19132733;;M;26;CHILENO;;Z;N/D;N/D;887120;11;3;0;0;0;11;3;887120;CELULAR AZUMI HTC E1 PLUS BUNDLE;TELEFONIA
16976126;Soltero;M;39;CHILENO;;X;RENCA                         ;METROPOLITANA;109990;1;1;0;0;0;1;1;109990;CELULAR VIVO Y01 AZUL ZAFIRO OPEN;TELEFONIA
12484923;;M;49;CHILENO;;Millenial;PUENTE ALTO                   ;METROPOLITANA;70630;4;1;0;0;0;4;1;70630;CELULAR Moto G20 Blue WOM;TELEFONIA
15290010;;M;39;CHILENO;;X;CHONCHI                       ;LOS LAGOS;200980;4;3;0;0;0;4;3;200980;CELULAR VIVO Y15S BLUE MOVISTAR;TELEFONIA
8788470;;M;56;CHILENO;;Boomers;RENCA                         ;METROPOLITANA;192980;2;1;0;0;0;2;1;192980;CELULAR VIVO Y15S BLUE MOVISTAR;TELEFONIA
14511329;;F;49;CHILENO;;X;CARAHUE                       ;ARAUCANIA;852499;4;2;0;0;0;4;2;852499;CELULAR VIVO V21 5G 128GB SUNSET DAZZLE OPEN;TELEFONIA
15692410;;M;39;CHILENO;;X;ARICA                         ;TARAPACA;169990;1;1;0;0;0;1;1;169990;CELULAR A54 OPPO AZUL 128GB;TELEFONIA
15453318;;M;40;CHILENO;;X;MELIPILLA;METROPOLITANA;166970;4;2;2;1;56980;2;1;109990;CELULAR REDMI 9C 64GB SUNRISE ORANGE;TELEFONIA
15306631;;F;40;CHILENO;;X;RENCA                         ;METROPOLITANA;456970;3;2;0;0;0;3;2;456970;CELULAR SMARTPHONE A52S 5G BLACK 128GB;TELEFONIA
8831933;;M;56;CHILENO;;Boomers;PROVIDENCIA                   ;METROPOLITANA;380980;6;3;1;1;159990;5;2;220990;SMARTPHONE A22 BLANCO 128GB;TELEFONIA
13753425;;M;42;CHILENO;;X;CALERA                        ;VALPARAISO;1341890;11;7;0;0;0;11;7;1341890;CELULAR VIVO Y15S BLUE MOVISTAR;TELEFONIA
18488003;Soltero;M;28;CHILENO;;Millenial;MELIPILLA;METROPOLITANA;169660;3;1;0;0;0;3;1;169660;CELULAR MOTO G22 128GB NEGRO WOM;TELEFONIA
13600922;;F;50;CHILENO;;X;PROVIDENCIA                   ;METROPOLITANA;38980;2;1;2;1;38980;0;0;0;CELULAR NOKIA 225 4G BLACK MOVISTAR DIRECTO;TELEFONIA
13157758;;F;45;CHILENO;;X;TEMUCO                        ;ARAUCANIA;708950;5;5;0;0;0;5;5;708950;CELULAR GALAXY S22 BLACK 128GB;TELEFONIA
8300960;;F;73;CHILENO;;Silencioso;VILLARICA                     ;ARAUCANIA;749950;6;9;0;0;0;6;9;749950;CELULAR VIVO Y21S 128GB BLANCO WOM;TELEFONIA
20598467;;F;21;CHILENO;;Millenial;PROVIDENCIA                   ;METROPOLITANA;323970;3;2;3;2;323970;0;0;0;CELULAR A32 128 GB BLUE OPEN;TELEFONIA
17819751;;M;31;CHILENO;;Millenial;QUELLON                       ;LOS LAGOS;103980;2;1;2;1;103980;0;0;0;CELULAR VIVO Y11S 32 GB NEBULA BLUE WOM;TELEFONIA
5993298;;M;74;CHILENO;;Silencioso;TALCA                         ;MAULE;62490;2;1;0;0;0;2;1;62490;CELULAR BMOBILE W41 AZUL 32GB OPEN;TELEFONIA
17798626;;F;31;CHILENO;;Millenial;"";"";149790;3;1;0;0;0;3;1;149790;CELULAR REDMI NOTE 9 128G FOREST GREEN OPEN;TELEFONIA
8297622;;F;61;CHILENO;;Boomers;"";"";393980;2;1;2;1;393980;0;0;0;IPHONE 11 64GB BLACK CLARO;TELEFONIA
3263401;;F;84;CHILENO;;Silencioso;VALDIVIA                      ;LOS RIOS;648840;5;3;0;0;0;5;3;648840;CELULAR REDMI 9A 32G GLACIAL BLUE OPEN;TELEFONIA
19503315;;F;25;CHILENO;;Z;N/D;N/D;448940;6;5;2;2;269980;4;3;178960;CELULAR Moto G20 Rosado WOM;TELEFONIA
7399464;;F;66;CHILENO;;Boomers;COIHAIQUE                     ;AYSEN;1781910;9;7;0;0;0;9;7;1781910;CELULAR REDMI NOTE 11 PRO 128GB WHITE;TELEFONIA
13868068;;M;42;CHILENO;;X;ANTOFAGASTA                   ;ANTOFAGASTA;1158950;14;7;0;0;0;14;7;1158950;CELULAR GALAXY A03 CORE 2GB 32GB BLUE OPEN;TELEFONIA
17795214;Soltero;F;31;CHILENO;;Millenial;PROVIDENCIA                   ;METROPOLITANA;129990;1;1;1;1;129990;0;0;0;CELULAR GALAXY A13 4+128GB LIGHT BLUE OPEN;TELEFONIA
19097581;Soltero;M;26;CHILENO;TECNICO MECANICO;Z;PROVIDENCIA                   ;METROPOLITANA;149640;2;1;0;0;0;2;1;149640;CELULAR GALAXY A03 4+64GB BLACK OPEN;TELEFONIA
18368988;;M;30;CHILENO;;Millenial;RENCA                         ;METROPOLITANA;1610890;11;6;11;6;1610890;0;0;0;CELULAR GALAXY A23 6+128GB LIGHT BLUE OPEN;TELEFONIA
14342575;;M;49;CHILENO;;X;PENAFLOR                      ;METROPOLITANA;245010;2;1;0;0;0;2;1;245010;CELULAR REDMI NOTE 11 4/128GB TWILIGHT BLUE OPEN;TELEFONIA
18161511;;F;30;CHILENO;;Millenial;PROVIDENCIA                   ;METROPOLITANA;109990;1;1;0;0;0;1;1;109990;CELULAR Moto G20 Blue WOM;TELEFONIA
10758847;;F;59;CHILENO;;Boomers;VALPARAISO                    ;VALPARAISO;567940;6;3;0;0;0;6;3;567940;CELULAR Moto G20 Rosado WOM;TELEFONIA
12573210;;F;48;CHILENO;;X;SAN VICENTE                   ;L.G.B.OÂ´HIGGINS;109990;1;1;0;0;0;1;1;109990;CELULAR GALAXY A03 64GB BLACK DIRECTO MOVISTAR;TELEFONIA
13778314;;F;42;CHILENO;;X;REQUINOA                      ;L.G.B.OÂ´HIGGINS;166980;2;1;2;1;166980;0;0;0;CELULAR MOTO G60 4/128 GB NEGRO OPEN;TELEFONIA
20783656;;M;21;CHILENO;;Z;TILTIL;METROPOLITANA;417940;5;2;5;2;417940;0;0;0;CELULAR REDMI NOTE 10 5G 128GB CHROME SILVER OPE;TELEFONIA
16987517;;F;33;CHILENO;;Millenial;EL BOSQUE                     ;METROPOLITANA;109990;1;1;0;0;0;1;1;109990;CELULAR VIVO Y01 AZUL ZAFIRO OPEN;TELEFONIA
5032394;;M;79;CHILENO;;Silencioso;CASTRO                        ;LOS LAGOS;229660;2;1;0;0;0;2;1;229660;CELULAR MOTO G22 128GB NEGRO MOVISTAR;TELEFONIA
16364099;;M;36;CHILENO;;Millenial;COIHAIQUE                     ;AYSEN;524980;2;2;0;0;0;2;2;524980;CELULAR VIVO Y21S MIDNIGHT BLUE 128 GB OPEN;TELEFONIA
16205586;;M;36;CHILENO;;Millenial;VILLARICA                     ;ARAUCANIA;79990;1;1;0;0;0;1;1;79990;CELULAR XIAOMI REDMI 9A 32GB GRANITE GRAY TRI WO;TELEFONIA
11942731;;M;50;CHILENO;;X;RENCA                         ;METROPOLITANA;179990;1;1;0;0;0;1;1;179990;CELULAR REDMI 10C EU 4GB+128GB GRAPHITE GRAY OPE;TELEFONIA
8916067;;F;59;CHILENO;;Boomers;PICHIDEGUA                    ;L.G.B.OÂ´HIGGINS;311310;6;3;2;1;134540;4;2;176770;CELULAR MOTO E20 GRIS CLARO;TELEFONIA
13130385;;M;45;CHILENO;;X;CHILLAN VIEJO                 ;BIO BIO;64990;1;1;0;0;0;1;1;64990;CELULAR AZUMI HTC E1 PLUS BUNDLE;TELEFONIA
8940488;;M;60;CHILENO;;Boomers;RENCA                         ;METROPOLITANA;30000;1;1;0;0;0;1;1;30000;PRODUCTO 2 SELECCION BANDA 2;TELEFONIA
18321080;;F;29;CHILENO;;Millenial;N/D;N/D;750920;8;5;8;5;750920;0;0;0;CELULAR XIAOMI REDMI 9A 32GB GRANITE GRAY TRI WO;TELEFONIA
17693338;;F;32;CHILENO;;Millenial;TALCA                         ;MAULE;329980;2;2;1;1;159990;1;1;169990;CELULAR A32 128 GB BLUE OPEN;TELEFONIA
18986510;;F;26;CHILENO;;Z;N/D;N/D;481850;3;2;0;0;0;3;2;481850;CELULAR REDMI NOTE 11 PRO 128GB WHITE;TELEFONIA
7886366;;M;63;CHILENO;;Boomers;TALCA                         ;MAULE;587830;6;3;0;0;0;6;3;587830;CELULAR A16 CRYSTAL BLACK 64GB;TELEFONIA
7654328;;M;64;CHILENO;;Boomers;VALDIVIA                      ;LOS RIOS;974600;10;6;0;0;0;10;6;974600;CELULAR MOTO G22 128GB NEGRO WOM;TELEFONIA
22593419;;M;44;BOLIVIANO;;Extranjero;INDEPENDENCIA                 ;METROPOLITANA;2214972;5;4;0;0;0;5;4;2214972;CELULAR GALAXY S22 ULTRA BURGUNDY 128GB;TELEFONIA
14074262;;M;40;CHILENO;;Silencioso;PROVIDENCIA                   ;METROPOLITANA;609980;2;2;2;2;609980;0;0;0;CELULAR GALAXY A53 5G BLACK CLARO;TELEFONIA
15355957;;F;39;CHILENO;;X;RENCA                         ;METROPOLITANA;189990;1;1;1;1;189990;0;0;0;CELULAR GALAXY A33 5G 6+128GB ORANGE OPEN;TELEFONIA
14576156;;M;42;CHILENO;;X;RENCA                         ;METROPOLITANA;179990;1;1;0;0;0;1;1;179990;CELULAR GALAXY A23 6+128GB BLACK OPEN;TELEFONIA
12096892;;M;70;CHILENO;;Silencioso;FRUTILLAR                     ;LOS LAGOS;259650;3;2;0;0;0;3;2;259650;CELULAR VIVO Y15S WAVE GREEN OPEN;TELEFONIA
20414135;;F;22;CHILENO;;Z;"";"";251100;3;1;0;0;0;3;1;251100;CELULAR REDMI NOTE 11 4/128GB TWILIGHT BLUE OPEN;TELEFONIA
16043534;;F;37;CHILENO;;Millenial;N/D;N/D;229980;2;2;2;2;229980;0;0;0;CELULAR A32 128 GB BLACK OPEN;TELEFONIA
17036477;;F;33;CHILENO;;Millenial;CURANILAHUE                   ;BIO BIO;279980;2;2;0;0;0;2;2;279980;CELULAR MOTOROLA G20 EDICION ESPECIAL VERDE CLAR;TELEFONIA
10178159;;M;58;CHILENO;;Boomers;NIQUEN                        ;BIO BIO;179990;1;1;0;0;0;1;1;179990;CELULAR SAMSUNG A23 128GB BLACK CLARO;TELEFONIA
17059603;;F;33;CHILENO;;Millenial;"";"";349230;4;3;0;0;0;4;3;349230;CELULAR MOTOROLA G30 GRIS WOM 128 GB;TELEFONIA
16357771;Casado;F;36;CHILENO;PROFESOR;Millenial;LAS CONDES;METROPOLITANA;169990;1;1;1;1;169990;0;0;0;CELULAR GALAXY A23 6+128GB LIGHT BLUE OPEN;TELEFONIA
14107510;;M;40;CHILENO;;X;IQUIQUE                       ;TARAPACA;980;2;1;0;0;0;2;1;980;CHIP OPEN ENTEL;TELEFONIA
9434129;;M;59;CHILENO;;Boomers;PROVIDENCIA                   ;METROPOLITANA;94990;1;1;0;0;0;1;1;94990;SMARTPHONE A03S NEGRO 32GB;TELEFONIA
17136059;;F;33;CHILENO;;Millenial;PROVIDENCIA                   ;METROPOLITANA;49980;2;1;2;1;49980;0;0;0;CELULAR BMOBILE C40 CRIS OPEN;TELEFONIA
18095715;;M;30;CHILENO;;Millenial;N/D;N/D;980;2;1;0;0;0;2;1;980;CHIP OPEN ENTEL;TELEFONIA
17494187;;M;32;CHILENO;;Millenial;"";"";109990;1;1;0;0;0;1;1;109990;CELULAR VIVO Y01 AZUL ZAFIRO OPEN;TELEFONIA
19035709;;F;27;CHILENO;;Millenial;"";"";269990;1;1;1;1;269990;0;0;0;CELULAR GALAXY A53 5G 6+128GB ORANGE;TELEFONIA
19365041;Soltero;F;26;CHILENO;FONOAUDIOLOGA;Z;PROVIDENCIA                   ;METROPOLITANA;113580;4;1;0;0;0;4;1;113580;CELULAR GALAXY A13 4+128GB LIGHT BLUE OPEN;TELEFONIA
26155904;;F;26;BOLIVIANO;;Extranjero;ALTO HOSPICIO;TARAPACA;199980;2;1;2;1;199980;0;0;0;CELULAR REDMI 10A US 32GB CHROME SILVER OPEN;TELEFONIA
24560788;;F;44;BOLIVIANO;;Extranjero;CALAMA                        ;ANTOFAGASTA;384960;5;2;0;0;0;5;2;384960;CELULAR GALAXY A22 5G 4+128GB GRAY;TELEFONIA
7827706;Casado;M;67;CHILENO;;Boomers;RENCA                         ;METROPOLITANA;19990;2;1;0;0;0;2;1;19990;CELULAR GALAXY A03 CORE 2GB 32GB BLUE OPEN;TELEFONIA
8259864;Soltero;M;65;CHILENO;;Boomers;RENCA                         ;METROPOLITANA;119990;1;1;0;0;0;1;1;119990;CELULAR VIVO Y01 AZUL ZAFIRO OPEN;TELEFONIA
6910627;;F;70;CHILENO;;Silencioso;PROVIDENCIA                   ;METROPOLITANA;143810;3;1;0;0;0;3;1;143810;CELULAR XIAOMI REDMI 9A 2/32GB GRANITE GRAY;TELEFONIA
12396502;;M;48;CHILENO;;X;COQUIMBO                      ;COQUIMBO;1465470;9;2;0;0;0;9;2;1465470;CELULAR A32 128 GB BLACK OPEN;TELEFONIA
11995634;;M;50;CHILENO;;X;PROVIDENCIA                   ;METROPOLITANA;99990;1;1;0;0;0;1;1;99990;Celular Y8P ENTEL TRIANGULADO PIEDRA DE LUNA;TELEFONIA
12290311;;M;50;CHILENO;;X;PROVIDENCIA                   ;METROPOLITANA;279990;4;1;0;0;0;4;1;279990;CELULAR GALAXY A53 5G 6+128GB BLUE;TELEFONIA
8731289;;F;62;CHILENO;;Boomers;CUNCO                         ;ARAUCANIA;740950;5;2;0;0;0;5;2;740950;CELULAR GALAXY A53 5G 6+128GB BLUE;TELEFONIA
18488647;;F;28;CHILENO;;Millenial;MELIPILLA                     ;METROPOLITANA;1632960;7;4;0;0;0;7;4;1632960;CELULAR GALAXY A73 5G 128GB LIGHT GREEN OPEN;TELEFONIA
10413175;;F;58;CHILENO;;Boomers;CANETE                        ;BIO BIO;678740;5;3;0;0;0;5;3;678740;CELULAR VIVO Y15S WAVE GREEN OPEN;TELEFONIA
17005149;;M;33;CHILENO;;Millenial;N/D;N/D;433980;2;1;2;1;433980;0;0;0;CELULAR SAMSUNG S21 FE 128GB LIGHT GREEN OPEN;TELEFONIA
16583395;;F;34;CHILENO;;Millenial;CAUQUENES                     ;MAULE;84990;1;1;0;0;0;1;1;84990;CELULAR Moto E7 Rosado WOM;TELEFONIA
14241840;;F;48;CHILENO;;X;RENGO                         ;L.G.B.OÂ´HIGGINS;987540;6;3;0;0;0;6;3;987540;Celular Y8P ENTEL TRIANGULADO NEGRO;TELEFONIA
18818855;;M;27;CHILENO;;Millenial;COCHRANE;AYSEN;279980;2;2;1;1;119990;1;1;159990;CELULAR POCO M4 PRO 128GB COOL BLUE OPEN;TELEFONIA
9632146;;M;60;CHILENO;;Boomers;CHILE CHICO                   ;AYSEN;187980;2;2;0;0;0;2;2;187980;CELULAR GALAXY A23 6+128GB BLACK OPEN;TELEFONIA
18626561;Soltero;F;28;CHILENO;;Millenial;PROVIDENCIA                   ;METROPOLITANA;179990;1;1;1;1;179990;0;0;0;CELULAR POCO M4 PRO 128GB COOL BLUE OPEN;TELEFONIA
15669421;;M;38;CHILENO;;Millenial;QUILICURA;METROPOLITANA;97133;2;1;0;0;0;2;1;97133;CELULAR VIVO Y21S 128GB BLANCO WOM;TELEFONIA
9277120;;M;59;CHILENO;;Boomers;RENCA                         ;METROPOLITANA;244970;3;2;0;0;0;3;2;244970;CELULAR GALAXY A03 CORE 2GB 32GB BLUE OPEN;TELEFONIA
13781078;;M;49;CHILENO;;X;SAN FERNANDO                  ;L.G.B.OÂ´HIGGINS;99980;5;2;0;0;0;5;2;99980;CELULAR XIAOMI REDMI 9A 2/32GB GRANITE GRAY;TELEFONIA
15305983;;M;41;CHILENO;;X;COCHRANE                      ;AYSEN;329980;2;2;0;0;0;2;2;329980;CELULAR REDMI NOTE 10 5G 4/128GB GRAPHITE GRAY O;TELEFONIA
15362921;Casado;M;37;CHILENO;;Millenial;LAMPA                         ;METROPOLITANA;97133;2;1;0;0;0;2;1;97133;CELULAR VIVO Y21S 128GB BLANCO WOM;TELEFONIA
15260128;;M;47;CHILENO;;X;"";"";425950;4;2;2;1;206980;2;1;218970;CELULAR REDMI 10C EU 4GB+128GB GRAPHITE GRAY OPE;TELEFONIA
8197121;;M;64;CHILENO;;Boomers;EL BOSQUE                     ;METROPOLITANA;209220;4;2;0;0;0;4;2;209220;CELULAR VIVO Y01 AZUL ZAFIRO OPEN;TELEFONIA
19101416;;M;27;CHILENO;;Z;PROVIDENCIA                   ;METROPOLITANA;502980;3;1;0;0;0;3;1;502980;CELULAR GALAXY A73 5G 128GB GRAY OPEN;TELEFONIA
17787682;;F;31;CHILENO;;Millenial;N/D;N/D;259730;4;2;0;0;0;4;2;259730;CELULAR SAMSUNG A03 64GB NEGRO WOM;TELEFONIA
16401790;;M;35;CHILENO;;Millenial;N/D;N/D;241980;2;2;0;0;0;2;2;241980;CELULAR POCO M4 PRO 128GB COOL BLUE OPEN;TELEFONIA
10174236;;F;58;CHILENO;;Boomers;VALLENAR;ATACAMA;415460;3;2;0;0;0;3;2;415460;CELULAR GALAXY A23 6+128GB BLACK OPEN;TELEFONIA
13444998;;F;44;CHILENO;;X;RENCA                         ;METROPOLITANA;564960;4;3;0;0;0;4;3;564960;CELULAR VIVO Y21S MIDNIGHT BLUE 128 GB OPEN;TELEFONIA
13911098;;F;42;CHILENO;;X;PROVIDENCIA                   ;METROPOLITANA;67133;2;1;0;0;0;2;1;67133;CELULAR VIVO Y21S 128GB BLANCO WOM;TELEFONIA
16391047;;F;36;CHILENO;;Millenial;TALCA                         ;MAULE;0;0;2;0;0;0;0;2;0;CELULAR REDMI 9C 64GB SUNRISE ORANGE;TELEFONIA
13769260;;M;41;CHILENO;;X;SAN ANTONIO                   ;VALPARAISO;129990;1;1;0;0;0;1;1;129990;CELULAR REDMI NOTE 11 4/128GB TWILIGHT BLUE OPEN;TELEFONIA
19822902;;F;24;CHILENO;;Z;CHILLAN                       ;BIO BIO;299980;3;2;0;0;0;3;2;299980;CELULAR GALAXY A13 4+128GB WHITE OPEN;TELEFONIA
18686107;Soltero;F;27;CHILENO;;Extranjero;PROVIDENCIA                   ;METROPOLITANA;259990;1;1;1;1;259990;0;0;0;CELULAR GALAXY A53 5G 6+128GB ORANGE;TELEFONIA
12856457;;F;47;CHILENO;;X;CASTRO                        ;LOS LAGOS;534980;2;2;0;0;0;2;2;534980;CELULAR GALAXY S21 FE 8GB 256GB GRAY;TELEFONIA
16164899;;F;37;CHILENO;;Millenial;LA SERENA                     ;COQUIMBO;980;2;1;0;0;0;2;1;980;CHIP OPEN ENTEL;TELEFONIA
9106888;;M;58;CHILENO;;Boomers;RENCA                         ;METROPOLITANA;99990;1;1;1;1;99990;0;0;0;CELULAR Moto G20 Rosado WOM;TELEFONIA
7535953;;F;70;CHILENO;;Silencioso;CONCEPCION                    ;BIO BIO;130760;2;1;0;0;0;2;1;130760;CELULAR GALAXY A03 64GB BLACK DIRECTO MOVISTAR;TELEFONIA
5664295;;M;74;CHILENO;;Silencioso;LOS ANGELES                   ;BIO BIO;59990;2;1;0;0;0;2;1;59990;CELULAR Moto G20 Blue WOM;TELEFONIA
12055204;;M;54;CHILENO;;Boomers;CONSTITUCION                  ;MAULE;344980;2;2;0;0;0;2;2;344980;CELULAR POCO M4 PRO 128GB COOL BLUE OPEN;TELEFONIA
13340187;;M;44;CHILENO;;Silencioso;PROVIDENCIA                   ;METROPOLITANA;162980;2;1;0;0;0;2;1;162980;CELULAR Moto G20 Blue WOM;TELEFONIA
26373645;;F;25;NO INFORMA NACIONALIDAD;;Extranjero;PROVIDENCIA                   ;METROPOLITANA;173980;2;1;2;1;173980;0;0;0;CELULAR GALAXY A23 6+128GB BLACK OPEN;TELEFONIA
8148258;;F;59;CHILENO;;Boomers;HIJUELAS                      ;VALPARAISO;301980;3;2;0;0;0;3;2;301980;CELULAR REDMI 10C 128GB GRAPHITE GRAY CLARO;TELEFONIA
17696072;;F;31;CHILENO;;Millenial;SAN CARLOS                    ;BIO BIO;345790;7;4;5;3;333810;2;1;11980;CELULAR GALAXY A22 5G 4+128GB GRAY;TELEFONIA
24358450;;F;41;CHILENO;;Extranjero;ANTOFAGASTA                   ;ANTOFAGASTA;439990;2;1;0;0;0;2;1;439990;CELULAR GALAXY S21 FE 8GB 256GB GRAY;TELEFONIA
14343131;;M;44;CHILENO;;X;PADRE HURTADO;METROPOLITANA;373230;4;2;2;1;193980;2;1;179250;CELULAR MOTO G20 EDICION ESPECIAL 4/128 GB AZUL;TELEFONIA
6155360;;M;68;CHILENO;;Silencioso;QUILPUE                       ;VALPARAISO;549960;6;4;0;0;0;6;4;549960;CELULAR GALAXY A22 5G 4+128GB GRAY;TELEFONIA
19480525;;M;25;CHILENO;;Z;PADRE LAS CASAS               ;ARAUCANIA;980;2;1;0;0;0;2;1;980;CHIP OPEN ENTEL;TELEFONIA
13815137;;F;42;CHILENO;;X;N/D;N/D;445960;4;2;2;1;168980;2;1;276980;CELULAR A32 128 GB BLACK OPEN;TELEFONIA
19052001;;F;26;CHILENO;;Z;N/D;N/D;729850;5;4;0;0;0;5;4;729850;SMARTPHONE A03s 64 GB Red DS;TELEFONIA
9106845;;F;57;CHILENO;;Boomers;CONTULMO                      ;BIO BIO;129990;1;1;0;0;0;1;1;129990;CELULAR GALAXY A13 4+128GB LIGHT BLUE OPEN;TELEFONIA
17187290;;M;32;CHILENO;;Millenial;"";"";381420;3;4;0;0;0;3;4;381420;CELULAR VIVO V21 5G DUSK BLUE 128GB OPEN;TELEFONIA
16447527;;M;35;CHILENO;;Millenial;"";"";490;1;1;0;0;0;1;1;490;CHIP OPEN ENTEL;TELEFONIA
10819728;Soltero;M;55;CHILENO;INGENIERO AGRICOLA;Boomers;RENCA                         ;METROPOLITANA;39990;1;1;0;0;0;1;1;39990;CELULAR NOKIA 225 4G BLACK MOVISTAR DIRECTO;TELEFONIA
18519924;;F;28;CHILENO;;Millenial;PROVIDENCIA                   ;METROPOLITANA;935740;10;5;8;3;860760;2;2;74980;CELULAR MOTOROLA G50 128GB AZUL CLARO;TELEFONIA
16619368;;M;34;CHILENO;;Millenial;MARIA PINTO                   ;METROPOLITANA;576830;6;4;0;0;0;6;4;576830;CELULAR GALAXY A22 5G 4+128GB GRAY;TELEFONIA
15978241;;M;36;CHILENO;;Millenial;"";"";346120;2;1;0;0;0;2;1;346120;CELULAR GALAXY A33 5G 6+128GB ORANGE OPEN;TELEFONIA
26138418;;M;37;HAITIANO;;Extranjero;LOS ANGELES                   ;BIO BIO;119990;1;1;0;0;0;1;1;119990;CELULAR SAMSUNG A03 128GB BLACK CLARO;TELEFONIA
8680064;;F;59;CHILENO;;Boomers;PUENTE ALTO                   ;METROPOLITANA;905380;10;4;2;1;153980;8;3;751400;CELULAR GALAXY A22 5G 4+128GB GRAY;TELEFONIA
11529456;;F;52;CHILENO;;X;PEUMO                         ;L.G.B.OÂ´HIGGINS;156980;2;1;2;1;156980;0;0;0;CELULAR MOTOROLA G50 128GB AZUL CLARO;TELEFONIA
15894022;Soltero;F;37;CHILENO;;Millenial;PROVIDENCIA                   ;METROPOLITANA;179990;1;1;1;1;179990;0;0;0;CELULAR MOTO G60 4/128 GB NEGRO OPEN;TELEFONIA
9021921;;M;69;CHILENO;;Silencioso;CAUQUENES                     ;MAULE;910240;5;3;0;0;0;5;3;910240;CELULAR GALAXY A53 5G 6+128GB BLUE;TELEFONIA
7245925;Casado;F;64;CHILENO;;Boomers;TEMUCO                        ;ARAUCANIA;164980;4;2;0;0;0;4;2;164980;CELULAR XIAOMI REDMI 9A 2/32GB GRANITE GRAY;TELEFONIA
25662910;;F;23;PERUANO;;Extranjero;"";"";0;0;2;0;2;0;0;0;0;CELULAR A52 128 GB WHITE OPEN;TELEFONIA
18723654;;M;25;CHILENO;;Z;LITUECHE                      ;L.G.B.OÂ´HIGGINS;421510;6;3;6;3;421510;0;0;0;CELULAR GALAXY A13 4+128GB LIGHT BLUE OPEN;TELEFONIA
20277858;;F;22;CHILENO;;Silencioso;PROVIDENCIA                   ;METROPOLITANA;603980;2;1;2;1;603980;0;0;0;CELULAR GALAXY S22 WHITE 128GB;TELEFONIA
10374282;;M;53;CHILENO;;X;MELIPILLA                     ;METROPOLITANA;139990;2;1;0;0;0;2;1;139990;CELULAR VIVO Y15S WAVE GREEN OPEN;TELEFONIA
18724483;;M;28;CHILENO;;Silencioso;PROVIDENCIA                   ;METROPOLITANA;1714920;8;3;8;3;1714920;0;0;0;CELULAR GALAXY S22 ULTRA WHITE 128GB;TELEFONIA
26029658;;M;41;VENEZOLANO;;Extranjero;N/D;N/D;379980;2;2;0;0;0;2;2;379980;CELULAR REDMI NOTE 11 4/128GB TWILIGHT BLUE OPEN;TELEFONIA
19218469;Soltero;F;29;CHILENO;TECNICO EN ENFERMERIA DE NIVEL SUPERIOR;Millenial;NUEVA IMPERIAL                ;ARAUCANIA;528280;2;1;0;0;0;2;1;528280;CELULAR SAMSUNG S21 FE 128GB LIGHT VIOLET OPEN;TELEFONIA
15630907;;F;38;CHILENO;;X;CURICO                        ;MAULE;519980;2;1;2;1;519980;0;0;0;CELULAR GALAXY A53 5G 6+128GB BLUE;TELEFONIA
11135837;;F;55;CHILENO;;Boomers;N/D;N/D;712930;7;5;0;0;0;7;5;712930;CELULAR GALAXY A13 4+128GB WHITE OPEN;TELEFONIA
16902370;;F;34;CHILENO;;Millenial;SAN BERNARDO                  ;METROPOLITANA;429990;1;1;1;1;429990;0;0;0;CELULAR GALAXY A73 5G 256GB GRAY OPEN;TELEFONIA
17125776;Soltero;M;36;CHILENO;;Millenial;RENCA                         ;METROPOLITANA;69990;2;1;0;0;0;2;1;69990;CELULAR REDMI 10A US 64GB GRAPHITE GRAY OPEN;TELEFONIA
16630980;;F;35;CHILENO;;Millenial;CALBUCO;LOS LAGOS;990;3;1;0;0;0;3;1;990;CHIP OPEN ENTEL;TELEFONIA
9837396;;M;55;CHILENO;;Boomers;VALLENAR;ATACAMA;394960;6;3;0;0;0;6;3;394960;CELULAR GALAXY A53 5G 6+128GB BLACK;TELEFONIA
6562137;;M;69;CHILENO;;Silencioso;QUINTERO                      ;VALPARAISO;269980;2;2;0;0;0;2;2;269980;CELULAR VIVO Y15S WAVE GREEN OPEN;TELEFONIA
13631044;Soltero;F;43;CHILENO;;X;RENCA                         ;METROPOLITANA;189990;1;1;1;1;189990;0;0;0;CELULAR A52 128 GB BLACK OPEN;TELEFONIA
7890106;;M;65;CHILENO;;Boomers;N/D;N/D;1208340;7;6;0;0;0;7;6;1208340;CELULAR GALAXY A53 5G 6+128GB ORANGE;TELEFONIA
17928240;Soltero;F;30;CHILENO;EDUCADOR DE PARVULO;Millenial;PROVIDENCIA                   ;METROPOLITANA;163980;2;1;2;1;163980;0;0;0;CELULAR RENO5 LITE NEGRO 128GB;TELEFONIA
7908769;Casado;F;63;CHILENO;;Boomers;PARRAL                        ;MAULE;129990;1;1;0;0;0;1;1;129990;CELULAR REDMI 10A US 64GB GRAPHITE GRAY OPEN;TELEFONIA
11767710;;M;51;CHILENO;;X;PROVIDENCIA                   ;METROPOLITANA;178770;2;1;0;0;0;2;1;178770;CELULAR GALAXY A13 4+128GB LIGHT BLUE OPEN;TELEFONIA
7081110;;M;69;CHILENO;;Silencioso;TEMUCO                        ;ARAUCANIA;3038760;11;8;0;0;0;11;8;3038760;IPHONE 11 128GB BLACK CLARO;TELEFONIA
15500883;;F;39;CHILENO;;X;N/D;N/D;315470;3;2;3;2;315470;0;0;0;CELULAR REDMI NOTE 11 4/128GB GRAPHITE GRAY OPEN;TELEFONIA
18369366;Soltero;M;29;CHILENO;;Millenial;PROVIDENCIA                   ;METROPOLITANA;199980;2;2;2;2;199980;0;0;0;CELULAR A52 128 GB BLACK OPEN;TELEFONIA
9618093;;F;58;CHILENO;;Boomers;BUIN                          ;METROPOLITANA;228120;4;1;0;0;0;4;1;228120;CELULAR VIVO Y21S PEARL WHITE 128 GB OPEN;TELEFONIA
9698162;Casado;M;57;CHILENO;;Boomers;CALBUCO                       ;LOS LAGOS;90000;2;1;0;0;0;2;1;90000;CELULAR GALAXY A03 CORE 2GB 32GB BLACK OPEN;TELEFONIA
15548583;;F;38;CHILENO;;X;PROVIDENCIA                   ;METROPOLITANA;578970;4;2;4;2;578970;0;0;0;CELULAR REDMI NOTE 11 4/128GB TWILIGHT BLUE OPEN;TELEFONIA
17463812;Soltero;M;32;CHILENO;TECNICO EN TELECOMUNICACIONES;Millenial;PROVIDENCIA                   ;METROPOLITANA;169990;1;1;1;1;169990;0;0;0;CELULAR A32 128 GB BLACK OPEN;TELEFONIA
26139216;;F;54;VENEZOLANO;;Extranjero;TEMUCO                        ;ARAUCANIA;401950;5;5;1;1;139990;4;4;261960;CELULAR REDMI NOTE 10 5G 4/128GB GRAPHITE GRAY O;TELEFONIA
19493150;;M;25;CHILENO;;Z;PROVIDENCIA                   ;METROPOLITANA;43980;2;1;2;1;43980;0;0;0;CELULAR BMOBILE C40 CRIS OPEN;TELEFONIA
19607509;;F;24;CHILENO;;Z;PROVIDENCIA                   ;METROPOLITANA;449990;1;1;0;0;0;1;1;449990;CELULAR GALAXY A73 5G 128GB GRAY OPEN;TELEFONIA
17885766;;F;30;CHILENO;;Millenial;ALTO HOSPICIO;TARAPACA;320840;6;2;0;0;0;6;2;320840;CELULAR GALAXY A53 5G 6+128GB ORANGE;TELEFONIA
17778874;;F;31;CHILENO;;Millenial;PROVIDENCIA                   ;METROPOLITANA;173980;2;1;2;1;173980;0;0;0;CELULAR A52 128 GB BLACK OPEN;TELEFONIA
18929864;Soltero;F;27;CHILENO;ENFERMERA;Millenial;PROVIDENCIA                   ;METROPOLITANA;657980;2;1;2;1;657980;0;0;0;Galaxy Z Flip3 128GB CREAM;TELEFONIA
15887742;;M;38;CHILENO;;Millenial;LA CISTERNA;METROPOLITANA;258120;2;1;0;0;0;2;1;258120;CELULAR GALAXY A22 5G 4+128GB GRAY;TELEFONIA
17070180;;F;33;CHILENO;;Millenial;PROVIDENCIA                   ;METROPOLITANA;59980;2;1;2;1;59980;0;0;0;CELULAR NOKIA C1 PLUS BLUE;TELEFONIA
10158919;Soltero;M;52;CHILENO;;X;PROVIDENCIA                   ;METROPOLITANA;743950;5;4;5;4;743950;0;0;0;CELULAR A52 128 GB BLACK OPEN;TELEFONIA
6751014;;F;74;CHILENO;;Silencioso;NUEVA IMPERIAL                ;ARAUCANIA;141276;3;3;0;0;0;3;3;141276;SMARTPHONE A03S 32 GB ROJO;TELEFONIA
10046937;;F;57;CHILENO;;Boomers;PINTO                         ;BIO BIO;159990;1;1;0;0;0;1;1;159990;CELULAR REDMI NOTE 11 4/128GB TWILIGHT BLUE OPEN;TELEFONIA
7736696;;F;68;CHILENO;;Boomers;MAIPU                         ;METROPOLITANA;556610;6;2;0;0;0;6;2;556610;CELULAR GALAXY A03 64GB BLACK DIRECTO MOVISTAR;TELEFONIA
18890697;Soltero;M;27;CHILENO;;Z;PROVIDENCIA                   ;METROPOLITANA;575980;2;1;2;1;575980;0;0;0;CELULAR IPHONE 12 64GB BLACK CLARO;TELEFONIA
6318322;;M;71;CHILENO;;Silencioso;RENCA                         ;METROPOLITANA;404810;4;1;0;0;0;4;1;404810;CELULAR SMARTPHONE A52S 5G LIGHT GREEN 128GB;TELEFONIA
17514917;;F;31;CHILENO;;Millenial;N/D;N/D;179990;1;1;0;0;0;1;1;179990;CELULAR REDMI NOTE 11 4/128GB TWILIGHT BLUE OPEN;TELEFONIA
16282302;;F;35;CHILENO;;Extranjero;ARAUCO                        ;BIO BIO;222970;3;2;0;0;0;3;2;222970;CELULAR A32 128 GB BLACK OPEN;TELEFONIA
14005932;;F;41;CHILENO;;X;QUILPUE                       ;VALPARAISO;169990;1;1;0;0;0;1;1;169990;CELULAR VIVO Y21S 128GB BLANCO WOM;TELEFONIA
11771014;;F;51;CHILENO;;X;SAN CARLOS                    ;BIO BIO;490;1;1;0;0;0;1;1;490;CHIP RECARGA CLARO;TELEFONIA
11342655;;F;54;CHILENO;;X;PROVIDENCIA                   ;METROPOLITANA;159990;1;1;0;0;0;1;1;159990;CELULAR VIVO Y21S 128GB BLANCO WOM;TELEFONIA
15064748;;F;39;CHILENO;;X;NOGALES                       ;VALPARAISO;333920;8;6;2;1;51980;6;5;281940;SMARTPHONE A03S NEGRO 32GB;TELEFONIA
18979550;Soltero;M;26;CHILENO;;Z;LAS CABRAS                    ;L.G.B.OÂ´HIGGINS;552980;2;1;0;0;0;2;1;552980;CELULAR GALAXY A73 5G 256GB GRAY OPEN;TELEFONIA
20112028;;F;23;CHILENO;;Z;PROVIDENCIA                   ;METROPOLITANA;189760;3;2;0;0;0;3;2;189760;CELULAR VIVO Y20 BLACK 64GB MOVISTAR;TELEFONIA
4243655;;F;85;CHILENO;;Silencioso;SAN BERNARDO                  ;METROPOLITANA;60710;2;1;0;0;0;2;1;60710;CELULAR BMOBILE C40 CRIS OPEN;TELEFONIA
19991367;;M;23;CHILENO;;Z;PROVIDENCIA                   ;METROPOLITANA;279980;2;1;2;1;279980;0;0;0;CELULAR A32 128 GB BLUE OPEN;TELEFONIA
12385634;;F;49;CHILENO;;X;N/D;N/D;69990;1;1;0;0;0;1;1;69990;CELULAR XIAOMI REDMI 9A 32GB VERDE CLARO;TELEFONIA
16183349;;F;37;CHILENO;;Extranjero;VALLENAR;ATACAMA;918580;8;7;7;6;858590;1;1;59990;CELULAR A32 128 GB BLUE OPEN;TELEFONIA
15028258;Soltero;F;38;CHILENO;TECNICO DE NIVEL SUPERIOR EN ODONTOLOGIA;X;RENCA                         ;METROPOLITANA;0;0;2;1;1;54990;-1;1;-54990;CELULAR NOKIA C1 PLUS BLUE;TELEFONIA
3333146;;M;86;CHILENO;;Silencioso;VILLARICA                     ;ARAUCANIA;942960;5;3;0;0;0;5;3;942960;CELULAR REDMI NOTE 10 5G 4/128GB GRAPHITE GRAY O;TELEFONIA
14905722;;F;40;CHILENO;;X;"";"";627407;8;4;0;0;0;8;4;627407;CELULAR GALAXY A03 CORE 2GB 32GB BLACK OPEN;TELEFONIA
19386914;Soltero;F;26;CHILENO;;Z;CURANILAHUE                   ;BIO BIO;199990;1;1;0;0;0;1;1;199990;CELULAR A32 128 GB BLACK OPEN;TELEFONIA
15714304;;F;38;CHILENO;;X;QUILPUE;VALPARAISO;419970;3;2;2;1;199980;1;1;219990;CELULAR MI 11 LITE 128GB BOBA BLACK OPEN;TELEFONIA
10715309;;M;52;CHILENO;;Millenial;N/D;N/D;444970;4;3;0;0;0;4;3;444970;CELULAR VIVO V21 5G 128GB SUNSET DAZZLE OPEN;TELEFONIA
25231971;;M;48;PERUANO;;Extranjero;N/D;N/D;519980;2;2;0;0;0;2;2;519980;CELULAR GALAXY A22 5G 4+128GB GRAY;TELEFONIA
18533262;;F;28;CHILENO;;Millenial;N/D;N/D;573980;2;3;2;3;573980;0;0;0;CELULAR IPHONE 12 64GB BLACK CLARO;TELEFONIA
10146531;;F;49;CHILENO;;X;RENCA                         ;METROPOLITANA;139990;1;1;0;0;0;1;1;139990;CELULAR GALAXY A13 4+128GB LIGHT BLUE OPEN;TELEFONIA
12263407;Soltero;M;50;CHILENO;LICIADO;X;PROVIDENCIA                   ;METROPOLITANA;573980;2;1;2;1;573980;0;0;0;CELULAR IPHONE 12 64GB BLACK CLARO;TELEFONIA
17496021;;F;32;CHILENO;;Millenial;MAULE                         ;MAULE;340960;4;2;4;2;340960;0;0;0;CELULAR GALAXY A22 5G 4+128GB MINT;TELEFONIA
7155337;;F;68;CHILENO;;Silencioso;SAN FERNANDO                  ;L.G.B.OÂ´HIGGINS;124950;3;2;0;0;0;3;2;124950;Celular SA3 CLARO DIRECTO BLACK;TELEFONIA
10661190;;M;55;CHILENO;;Boomers;PUERTO MONTT                  ;LOS LAGOS;274150;5;2;0;0;0;5;2;274150;CELULAR GALAXY A22 5G 4+128GB GRAY;TELEFONIA
11726475;;M;51;CHILENO;;X;VICUNA                        ;COQUIMBO;590360;6;2;0;0;0;6;2;590360;CELULAR VIVO V21 5G 128GB SUNSET DAZZLE OPEN;TELEFONIA
7799853;;F;62;CHILENO;;Boomers;OVALLE                        ;COQUIMBO;354820;3;1;0;0;0;3;1;354820;CELULAR XIAOMI 11 LITE 5G NE 8/128GB TRUFFLE BLA;TELEFONIA
6469975;;M;71;CHILENO;;Silencioso;VICUNA                        ;COQUIMBO;564980;5;2;0;0;0;5;2;564980;CELULAR VIVO Y53S FANTASTIC RAINBOW 128GB OPEN;TELEFONIA
18419921;;F;30;CHILENO;;Millenial;LOTA;BIO-BIO;148210;3;1;0;0;0;3;1;148210;SMARTPHONE A03S NEGRO 32GB;TELEFONIA
26704957;Soltero;M;27;EXTRANJERO - NO INFORMA NACIONALIDAD;;Extranjero;PROVIDENCIA                   ;METROPOLITANA;857970;3;1;3;1;857970;0;0;0;CELULAR GALAXY S22 ULTRA BURGUNDY 128GB;TELEFONIA
20042951;;M;23;CHILENO;;Z;PROVIDENCIA                   ;METROPOLITANA;419970;3;2;3;2;419970;0;0;0;CELULAR SAMSUNG A52s 128GB BLACK CLARO;TELEFONIA
8805896;;F;61;CHILENO;;Boomers;VINA DEL MAR                  ;VALPARAISO;86745;3;2;0;0;0;3;2;86745;CELULAR BMOBILE C40 CRIS OPEN;TELEFONIA
16463143;;M;35;CHILENO;;Millenial;PARRAL                        ;MAULE;539430;7;5;5;3;379450;2;2;159980;CELULAR REDMI NOTE 10 5G 4/128GB GRAPHITE GRAY O;TELEFONIA
20081575;;F;23;CHILENO;;Z;N/D;N/D;483890;11;10;2;2;51980;9;8;431910;CELULAR GALAXY A23 6+128GB LIGHT BLUE OPEN;TELEFONIA
10955873;;F;51;CHILENO;;X;PUNITAQUI                     ;COQUIMBO;386960;4;3;0;0;0;4;3;386960;CELULAR XIAOMI REDMI 9A 32GB VERDE CLARO;TELEFONIA
7246164;;M;64;CHILENO;;Boomers;PROVIDENCIA                   ;METROPOLITANA;169990;1;1;0;0;0;1;1;169990;CELULAR VIVO Y21S 128GB BLANCO WOM;TELEFONIA
15106012;;F;38;CHILENO;;X;PROVIDENCIA                   ;METROPOLITANA;175980;2;1;2;1;175980;0;0;0;CELULAR A52 128 GB LIGHT VIOLET OPEN;TELEFONIA
12980606;;M;46;CHILENO;;X;RENCA                         ;METROPOLITANA;237480;2;1;2;1;237480;0;0;0;CELULAR SAMSUNG A52s 128GB BLACK CLARO;TELEFONIA
15521137;;F;39;CHILENO;;X;QUILLOTA                      ;VALPARAISO;156409;4;2;0;0;0;4;2;156409;CELULAR VIVO Y01 AZUL ZAFIRO OPEN;TELEFONIA
18271603;;M;29;CHILENO;;Millenial;N/D;N/D;949980;2;2;0;0;0;2;2;949980;CELULAR IPHONE 12 128GB WHITE CLARO;TELEFONIA
25589346;;F;45;BOLIVIANO;;Extranjero;PROVIDENCIA                   ;METROPOLITANA;243980;2;1;2;1;243980;0;0;0;CELULAR 11 LITE 5G NE 8/128GB PEACH PINK OPEN;TELEFONIA
17545278;;F;31;CHILENO;;Millenial;PROVIDENCIA                   ;METROPOLITANA;603980;3;1;3;1;603980;0;0;0;CELULAR IPHONE 12 64GB BLACK CLARO;TELEFONIA
9019573;;F;64;CHILENO;;Boomers;NACIMIENTO                    ;BIO BIO;258120;2;1;0;0;0;2;1;258120;CELULAR REDMI NOTE 10S 128GB ONIX BLACK;TELEFONIA
18832168;;M;29;CHILENO;;Millenial;"";"";11980;2;1;2;1;11980;0;0;0;REPETIDOR MI WIFI RANGE EXTENDER PRO XIAOMI;TELEFONIA
4336187;;M;77;CHILENO;;Silencioso;PROVIDENCIA                   ;METROPOLITANA;448980;2;1;2;1;448980;0;0;0;CELULAR GALAXY A73 5G 256GB GRAY OPEN;TELEFONIA
20571574;;M;21;CHILENO;;Z;PROVIDENCIA                   ;METROPOLITANA;18980;2;1;2;1;18980;0;0;0;Mi Router 4A Giga Version Xiaomi;TELEFONIA
15326364;;M;43;CHILENO;;X;"";"";379490;9;5;0;0;0;9;5;379490;CELULAR A52 128 GB LIGHT VIOLET OPEN;TELEFONIA
19353852;;F;26;CHILENO;;Z;PROVIDENCIA                   ;METROPOLITANA;148200;2;1;0;0;0;2;1;148200;CELULAR GALAXY A03 4+64GB BLACK OPEN;TELEFONIA
15306876;;M;39;CHILENO;;X;N/D;N/D;309980;2;2;2;2;309980;0;0;0;CELULAR REDMI NOTE 11 4/128GB TWILIGHT BLUE OPEN;TELEFONIA
17115236;;F;33;CHILENO;;Millenial;PROVIDENCIA                   ;METROPOLITANA;193980;2;1;2;1;193980;0;0;0;CELULAR POCO M4 PRO 128GB COOL BLUE OPEN;TELEFONIA
16374729;;F;36;CHILENO;;Millenial;"";"";181090;6;1;0;0;0;6;1;181090;CELULAR XIAOMI REDMI 9A 32GB VERDE CLARO;TELEFONIA
20309148;;F;22;CHILENO;;Z;COQUIMBO;COQUIMBO;149990;1;1;1;1;149990;0;0;0;CELULAR REDMI NOTE 11 4/128GB TWILIGHT BLUE OPEN;TELEFONIA
17526773;;F;30;CHILENO;;Millenial;REQUINOA                      ;L.G.B.OÂ´HIGGINS;175550;4;1;0;0;0;4;1;175550;CELULAR REDMI 10A US 64GB GRAPHITE GRAY OPEN;TELEFONIA
7836527;;M;63;CHILENO;;Boomers;PROVIDENCIA                   ;METROPOLITANA;99990;2;1;0;0;0;2;1;99990;CELULAR REDMI 10C EU 4GB+128GB GRAPHITE GRAY OPE;TELEFONIA
12180552;;M;51;CHILENO;;X;PENCO                         ;BIO BIO;259981;3;2;0;0;0;3;2;259981;CELULAR VIVO Y15S WAVE GREEN OPEN;TELEFONIA
19169588;;M;26;CHILENO;;Z;SAN CARLOS                    ;BIO BIO;570960;4;3;0;0;0;4;3;570960;CELULAR VIVO Y21S PEARL WHITE 128 GB OPEN;TELEFONIA
5611066;;M;75;CHILENO;;Silencioso;PUNTA ARENAS                  ;MAGALLANES;133980;2;2;0;0;0;2;2;133980;CELULAR SAMSUNG A03 CORE 32GB BLACK CLARO;TELEFONIA
19705782;;M;24;CHILENO;;Millenial;N/D;N/D;514960;4;2;4;2;514960;0;0;0;CELULAR REDMI NOTE 11 PRO 128GB GRAPHITE;TELEFONIA
9058447;;F;62;CHILENO;;Boomers;PUENTE ALTO                   ;METROPOLITANA;109990;2;1;0;0;0;2;1;109990;CELULAR GALAXY A03 4+64GB BLACK OPEN;TELEFONIA
10833071;;M;40;CHILENO;;X;ARICA                         ;ARICA Y PARINACOTA;134980;3;2;0;0;0;3;2;134980;CELULAR A54 OPPO NEGRO 128GB;TELEFONIA
8097568;;F;65;CHILENO;;Boomers;IQUIQUE                       ;TARAPACA;977360;19;8;0;0;0;19;8;977360;CELULAR A32 128 GB BLACK OPEN;TELEFONIA
9429094;;M;59;CHILENO;;Boomers;QUILLOTA                      ;VALPARAISO;60710;2;1;0;0;0;2;1;60710;CELULAR BMOBILE C40 CRIS OPEN;TELEFONIA
16952875;;M;34;CHILENO;;Millenial;PUDAHUEL                      ;METROPOLITANA;238980;2;1;2;1;238980;0;0;0;CELULAR SAMSUNG A52s 128GB BLACK CLARO;TELEFONIA
8260763;;F;61;CHILENO;;Boomers;VINA DEL MAR                  ;VALPARAISO;187969;3;2;0;0;0;3;2;187969;CELULAR GALAXY A03 4+64GB BLUE OPEN;TELEFONIA
7094757;;F;70;CHILENO;;Silencioso;LA LIGUA                      ;VALPARAISO;498100;5;3;0;0;0;5;3;498100;CELULAR GALAXY A13 4+128GB WHITE OPEN;TELEFONIA
18969040;;M;27;CHILENO;;Z;PUTAENDO                      ;VALPARAISO;406510;5;3;2;1;184980;3;2;221530;CELULAR A32 128 GB BLUE OPEN;TELEFONIA
15111612;;M;39;CHILENO;;X;RENGO                         ;L.G.B.OÂ´HIGGINS;676960;4;3;0;0;0;4;3;676960;CELULAR A32 128 GB BLUE OPEN;TELEFONIA
19886539;;F;23;CHILENO;;Z;RENCA;METROPOLITANA;24983;2;1;2;1;24983;0;0;0;CELULAR BMOBILE BS30 BLACK OPEN;TELEFONIA
18030385;;M;30;CHILENO;;Millenial;PROVIDENCIA                   ;METROPOLITANA;259980;3;2;0;0;0;3;2;259980;CELULAR VIVO Y20S NEBULA 128 GB BLUE OPEN;TELEFONIA
18681166;Soltero;M;28;CHILENO;;Millenial;PROVIDENCIA                   ;METROPOLITANA;435980;2;1;2;1;435980;0;0;0;CELULAR SAMSUNG S21 FE 128GB GRAY OPEN;TELEFONIA
26281634;;F;41;VENEZOLANO;;Extranjero;QUILLOTA                      ;VALPARAISO;601960;6;3;4;2;346970;2;1;254990;CELULAR A52 128 GB WHITE OPEN;TELEFONIA
19068762;Soltero;M;26;CHILENO;;Z;PROVIDENCIA                   ;METROPOLITANA;423970;3;2;3;2;423970;0;0;0;CELULAR SAMSUNG A52s 128GB BLACK CLARO;TELEFONIA
13969155;;F;41;CHILENO;;Silencioso;PROVIDENCIA                   ;METROPOLITANA;139990;1;1;1;1;139990;0;0;0;CELULAR A32 128 GB BLACK OPEN;TELEFONIA
19583531;;F;25;CHILENO;;Z;QUILICURA;METROPOLITANA;439970;3;3;2;2;339980;1;1;99990;CELULAR GALAXY A22 5G 4+128GB MINT;TELEFONIA
9778151;;M;58;CHILENO;;Boomers;CHANCO                        ;MAULE;303070;2;1;0;0;0;2;1;303070;CELULAR A52 128 GB BLACK OPEN;TELEFONIA
5497002;;F;76;CHILENO;;Silencioso;QUILLOTA                      ;VALPARAISO;171980;2;3;0;0;0;2;3;171980;CELULAR GALAXY A53 5G 6+128GB ORANGE;TELEFONIA
16442672;;M;35;CHILENO;;Millenial;"";"";990;3;1;0;0;0;3;1;990;CHIP OPEN ENTEL;TELEFONIA
12368137;;M;49;CHILENO;;X;N/D;N/D;152980;2;2;0;0;0;2;2;152980;CELULAR SAMSUNG A03 CORE 32GB BLACK CLARO;TELEFONIA
13508784;;F;44;CHILENO;;X;"";"";67980;3;2;0;0;0;3;2;67980;CELULAR VIVO Y01 AZUL ZAFIRO OPEN;TELEFONIA
13571097;Casado;F;43;CHILENO;;X;RENCA                         ;METROPOLITANA;119990;1;1;0;0;0;1;1;119990;CELULAR MOTOROLA E30 GRIS CLARO;TELEFONIA
12418270;Casado;M;48;CHILENO;;X;SAN JAVIER                    ;MAULE;169990;1;1;0;0;0;1;1;169990;CELULAR VIVO Y51 CRYSTAL SYMPHONY OPEN;TELEFONIA
13203891;;F;46;CHILENO;;X;SAGRADA FAMILIA               ;MAULE;555980;2;1;2;1;555980;0;0;0;CELULAR IPHONE 12 64GB BLACK CLARO;TELEFONIA
9919589;Casado;M;58;CHILENO;INGENIERO EN REFRIGERACION Y CLIMATIZACION INDUSTRIAL;Boomers;PROVIDENCIA                   ;METROPOLITANA;329980;2;2;2;2;329980;0;0;0;CELULAR GALAXY A22 5G 4+128GB GRAY;TELEFONIA
9258130;;M;58;CHILENO;;Boomers;RECOLETA                      ;METROPOLITANA;173280;3;1;0;0;0;3;1;173280;MOTOROLA MOTO G50 AZUL 128 GB WOM;TELEFONIA
12661526;Divorciado;M;47;CHILENO;INGENIERO;X;RENCA                         ;METROPOLITANA;403980;2;1;2;1;403980;0;0;0;CELULAR XIAOMI 11T PRO 8/256GB CELESTIAL BLUE OP;TELEFONIA
14582727;;M;42;CHILENO;;X;SANTIAGO                      ;METROPOLITANA;379980;2;2;1;1;189990;1;1;189990;CELULAR MOTO G60S 6/128 GB AZUL;TELEFONIA
17469469;;F;31;CHILENO;;Millenial;N/D;N/D;109990;1;1;0;0;0;1;1;109990;CELULAR VIVO Y01 AZUL ZAFIRO OPEN;TELEFONIA
20613387;;M;21;CHILENO;;Z;CORONEL;BIO-BIO;169990;1;1;1;1;169990;0;0;0;CELULAR A52 128 GB LIGHT VIOLET OPEN;TELEFONIA
18162447;Soltero;F;29;CHILENO;;Silencioso;PROVIDENCIA                   ;METROPOLITANA;39990;1;1;1;1;39990;0;0;0;CELULAR BMOBILE C40 CRIS OPEN;TELEFONIA
20466734;;M;22;CHILENO;;Silencioso;PROVIDENCIA                   ;METROPOLITANA;939980;3;1;3;1;939980;0;0;0;SMARTPHONE Z FLIP3 GREEN 128GB;TELEFONIA
18341773;;F;29;CHILENO;;Millenial;CERRILLOS                     ;METROPOLITANA;607960;5;3;4;2;537970;1;1;69990;CELULAR XIAOMI REDMI 9A SE 2/32GB GB PEACOCK GRE;TELEFONIA
19251837;;M;27;CHILENO;;Z;N/D;N/D;426960;4;2;4;2;426960;0;0;0;CELULAR SMARTPHONE A52S 5G LIGHT GREEN 128GB;TELEFONIA
16579153;;F;35;CHILENO;;Millenial;VICTORIA                      ;ARAUCANIA;69990;1;1;0;0;0;1;1;69990;CELULAR GALAXY A03 CORE 2GB 32GB BLACK OPEN;TELEFONIA
17909999;;M;29;CHILENO;;Millenial;PORVENIR                      ;MAGALLANES;990;3;1;0;0;0;3;1;990;CHIP OPEN ENTEL;TELEFONIA
15817061;;F;38;CHILENO;;Millenial;N/D;N/D;75990;1;1;0;0;0;1;1;75990;CELULAR SAMSUNG A03 CORE 32GB BLACK CLARO;TELEFONIA
11779168;;F;52;CHILENO;;X;N/D;N/D;602920;8;5;0;0;0;8;5;602920;CELULAR Xiaomi Redmi 9 64 GB Morado WOM;TELEFONIA
7927207;;F;64;CHILENO;;Boomers;LOS ALAMOS                    ;BIO BIO;209990;1;1;0;0;0;1;1;209990;CELULAR VIVO Y21S MIDNIGHT BLUE 128 GB OPEN;TELEFONIA
8610330;;F;63;CHILENO;;Boomers;ANGOL                         ;ARAUCANIA;167980;2;1;2;1;167980;0;0;0;CELULAR A32 128 GB WHITE OPEN;TELEFONIA
4682021;;F;81;CHILENO;;Silencioso;BUIN                          ;METROPOLITANA;39990;1;1;0;0;0;1;1;39990;CELULAR BMOBILE C40 CRIS OPEN;TELEFONIA
5794785;;F;75;CHILENO;;Silencioso;SAN BERNARDO                  ;METROPOLITANA;189990;1;1;0;0;0;1;1;189990;CELULAR REDMI NOTE 11 4/128GB TWILIGHT BLUE OPEN;TELEFONIA
19089079;;F;27;CHILENO;;Z;N/D;N/D;149990;1;1;0;0;0;1;1;149990;CELULAR VIVO Y15S WAVE GREEN OPEN;TELEFONIA
19887178;;M;24;CHILENO;;Z;PROVIDENCIA                   ;METROPOLITANA;399990;1;1;1;1;399990;0;0;0;CELULAR XIAOMI 11T PRO 8/256GB CELESTIAL BLUE OP;TELEFONIA
19094019;Soltero;M;27;CHILENO;;Silencioso;PROVIDENCIA                   ;METROPOLITANA;783970;3;1;3;1;783970;0;0;0;CELULAR XIAOMI 11T PRO 8/256GB CELESTIAL BLUE KI;TELEFONIA
17660701;;F;31;CHILENO;;Millenial;"";"";219980;2;2;0;0;0;2;2;219980;CELULAR REDMI 9A 32GB SKY BLUE;TELEFONIA
17652211;;M;31;CHILENO;;Millenial;N/D;N/D;899990;3;1;3;1;899990;0;0;0;CELULAR GALAXY S22 ULTRA BURGUNDY 128GB;TELEFONIA
13220063;;M;44;CHILENO;;X;ANTOFAGASTA                   ;ANTOFAGASTA;239030;4;1;0;0;0;4;1;239030;CELULAR VIVO Y15S WAVE GREEN OPEN;TELEFONIA
19503544;;F;25;CHILENO;;Z;PROVIDENCIA                   ;METROPOLITANA;279990;1;1;0;0;0;1;1;279990;CELULAR REDMI NOTE 11 PRO 128GB WHITE;TELEFONIA
14134613;;F;41;CHILENO;;X;"";"";516720;3;2;0;0;0;3;2;516720;CELULAR REDMI NOTE 11 PRO 128GB WHITE;TELEFONIA
15958427;;F;38;CHILENO;;Millenial;VILLARICA                     ;ARAUCANIA;219980;2;2;0;0;0;2;2;219980;CELULAR MOTO G31 4/128 GB GRIS METEORITO OPEN;TELEFONIA
8829072;;M;62;CHILENO;;Boomers;N/D;N/D;299060;2;1;0;0;0;2;1;299060;VIVO Y53S DEEP SEA BLUE 128GB OPEN;TELEFONIA
24886769;;F;51;COLOMBIANO;;Extranjero;N/D;N/D;199980;2;1;0;0;0;2;1;199980;CELULAR VIVO Y11S 32GB NEBULA BLUE OPEN;TELEFONIA
17047590;Casado;M;34;CHILENO;;Millenial;RENCA                         ;METROPOLITANA;159990;1;1;1;1;159990;0;0;0;CELULAR REDMI NOTE 10 5G 4/128GB GRAPHITE GRAY O;TELEFONIA
13526567;;M;44;CHILENO;;X;"";"";774950;5;2;0;0;0;5;2;774950;CELULAR REDMI NOTE 10S 128GB ONIX BLACK;TELEFONIA
18951467;Soltero;M;27;CHILENO;;Z;PROVIDENCIA                   ;METROPOLITANA;223980;2;1;2;1;223980;0;0;0;CELULAR SMARTPHONE A52S 5G LIGHT GREEN 128GB;TELEFONIA
17747058;;F;31;CHILENO;;Millenial;CHIMBARONGO                   ;L.G.B.OÂ´HIGGINS;246950;7;5;0;0;0;7;5;246950;CELULAR VIVO Y11S NEBULA BLUE 32GB OPEN;TELEFONIA
12926460;;M;47;CHILENO;;X;RENCA                         ;METROPOLITANA;189990;1;1;0;0;0;1;1;189990;CELULAR A32 128 GB BLUE OPEN;TELEFONIA
13145950;Casado;M;45;CHILENO;;X;RENCA                         ;METROPOLITANA;149990;1;1;1;1;149990;0;0;0;CELULAR GALAXY A22 5G 4+128GB MINT;TELEFONIA
13688846;;F;43;CHILENO;;X;CAUQUENES                     ;MAULE;139990;1;1;0;0;0;1;1;139990;CELULAR VIVO Y20 BLACK 64GB MOVISTAR;TELEFONIA
8503109;Casado;M;63;CHILENO;CONTADOR GENERAL;Boomers;TALCA                         ;MAULE;177980;2;2;1;1;169990;1;1;7990;CELULAR A52 128 GB BLUE OPEN;TELEFONIA
27130784;;M;27;"";;Extranjero;PROVIDENCIA                   ;METROPOLITANA;219990;3;1;3;1;219990;0;0;0;SMARTPHONE A52S 5G WHITE 128GB;TELEFONIA
15127872;Soltero;M;40;CHILENO;PUBLICISTA;X;PROVIDENCIA                   ;METROPOLITANA;173980;2;1;2;1;173980;0;0;0;CELULAR A52 128 GB LIGHT VIOLET OPEN;TELEFONIA
18126357;;F;30;CHILENO;;Millenial;LAMPA                         ;METROPOLITANA;17990;2;1;0;0;0;2;1;17990;CELULAR NOKIA 110 BLACK OPEN;TELEFONIA
13978858;;F;41;CHILENO;;X;CABILDO                       ;VALPARAISO;59990;2;1;0;0;0;2;1;59990;CELULAR XIAOMI REDMI 9A 2/32GB GRANITE GRAY;TELEFONIA
18822176;;M;26;CHILENO;;Z;CORONEL                       ;BIO BIO;105040;2;1;0;0;0;2;1;105040;CELULAR XIAOMI REDMI 9A 32GB VERDE CLARO;TELEFONIA
16119544;;F;37;CHILENO;;Millenial;PROVIDENCIA                   ;METROPOLITANA;159990;1;1;1;1;159990;0;0;0;CELULAR A32 128 GB BLUE OPEN;TELEFONIA
9171684;;F;62;CHILENO;;Boomers;LOS LAGOS                     ;LOS RIOS;204620;2;1;0;0;0;2;1;204620;CELULAR REDMI NOTE 10 5G 4/128GB GRAPHITE GRAY O;TELEFONIA
16851318;;F;34;CHILENO;;Millenial;PROVIDENCIA                   ;METROPOLITANA;155970;3;2;1;1;119990;2;1;35980;CELULAR GALAXY A03 4+128GB BLACK OPEN;TELEFONIA
20123683;;F;23;CHILENO;;Z;N/D;N/D;631960;5;2;2;1;599990;3;1;31970;CELULAR IPHONE 13 MINI 128GB MIDNIGHT CLARO;TELEFONIA
17161649;;F;33;CHILENO;;Millenial;PROVIDENCIA                   ;METROPOLITANA;219990;1;1;0;0;0;1;1;219990;CELULAR A52 128 GB LIGHT VIOLET OPEN;TELEFONIA
13880228;Casado;M;42;CHILENO;INGENIERO;X;RENCA                         ;METROPOLITANA;169990;1;1;1;1;169990;0;0;0;CELULAR A52 128 GB BLACK OPEN;TELEFONIA
13606197;;M;43;CHILENO;;X;LEBU                          ;BIO BIO;515210;5;3;0;0;0;5;3;515210;CELULAR A52 128 GB BLUE OPEN;TELEFONIA
7507362;;F;68;CHILENO;;Boomers;LO ESPEJO                     ;METROPOLITANA;667300;9;5;0;0;0;9;5;667300;CELULAR XIAOMI REDMI 9A 32 GB BLUE DIRECTO CLARO;TELEFONIA
9130442;;M;61;CHILENO;;Boomers;N/D;N/D;229990;1;1;0;0;0;1;1;229990;CELULAR VIVO Y53S FANTASTIC RAINBOW 128GB OPEN;TELEFONIA
18498916;;M;28;CHILENO;;Millenial;PROVIDENCIA                   ;METROPOLITANA;899990;3;1;3;1;899990;0;0;0;CELULAR GALAXY S22 ULTRA GREEN 128GB;TELEFONIA
10580686;;M;56;CHILENO;;Boomers;RENCA                         ;METROPOLITANA;65090;2;1;0;0;0;2;1;65090;CELULAR REDMI 9C 64GB MIDNIGHT GRAY MOVISTAR;TELEFONIA
14508678;;F;46;CHILENO;;X;N/D;N/D;99990;2;1;0;0;0;2;1;99990;CELULAR VIVO Y15S WAVE GREEN OPEN;TELEFONIA
14572526;;M;43;CHILENO;;X;COIHAIQUE                     ;AYSEN;566960;4;2;4;2;566960;0;0;0;CELULAR REDMI 9A 32GB SKY BLUE;TELEFONIA
14757136;;F;41;EXTRANJERO - NO INFORMA NACIONALIDAD;;X;N/D;N/D;439990;1;1;1;1;439990;0;0;0;CELULAR XIAOMI 11T PRO 8/256GB METEORITE GRAY;TELEFONIA
15212585;;M;39;CHILENO;;X;PROVIDENCIA                   ;METROPOLITANA;86990;1;1;1;1;86990;0;0;0;Celular Y8P ENTEL TRIANGULADO NEGRO;TELEFONIA
9824292;;F;53;CHILENO;;X;CASTRO                        ;LOS LAGOS;104990;1;1;0;0;0;1;1;104990;CELULAR MOTOROLA G8 POWER LITE AZUL WOM;TELEFONIA
17506471;Soltero;F;31;CHILENO;TECNOLOGO MEDICO;Millenial;RENCA                         ;METROPOLITANA;855980;2;1;2;1;855980;0;0;0;CELULAR IPHONE 13 PRO 128GB GRAFITO CLARO;TELEFONIA
15401719;Soltero;M;40;CHILENO;;X;ISLA DE MAIPO                 ;METROPOLITANA;209990;1;1;0;0;0;1;1;209990;CELULAR VIVO Y21S PEARL WHITE 128 GB OPEN;TELEFONIA
19275007;;F;26;CHILENO;;Z;SAN FERNANDO                  ;L.G.B.OÂ´HIGGINS;349970;6;3;0;0;0;6;3;349970;CELULAR REDMI NOTE 10 PRO 6+128GB GRADIENT BRONZ;TELEFONIA
14074690;;M;53;CHILENO;;X;RENCA                         ;METROPOLITANA;556970;3;2;0;0;0;3;2;556970;CELULAR VIVO V21 5G DUSK BLUE 128GB OPEN;TELEFONIA
15659366;Soltero;M;38;CHILENO;;X;PROVIDENCIA                   ;METROPOLITANA;23980;2;2;0;0;0;2;2;23980;CELULAR AZUMI L4G BLACK CLARO;TELEFONIA
5103475;;F;77;CHILENO;;Silencioso;VALLENAR;ATACAMA;226990;2;1;0;0;0;2;1;226990;CELULAR A32 128 GB BLUE OPEN;TELEFONIA
9862316;;M;58;CHILENO;;Boomers;RETIRO                        ;MAULE;288070;2;1;0;0;0;2;1;288070;CELULAR A52 128 GB WHITE OPEN;TELEFONIA
13850182;;M;44;CHILENO;;X;NATALES                       ;MAGALLANES;179990;1;1;0;0;0;1;1;179990;CELULAR A32 128 GB BLACK OPEN;TELEFONIA
18103381;;M;30;CHILENO;;Millenial;COIHAIQUE                     ;AYSEN;664610;4;2;0;0;0;4;2;664610;CELULAR VIVO Y11S NEGRO WOM;TELEFONIA
16829436;;F;34;CHILENO;;Millenial;N/D;N/D;229990;1;1;0;0;0;1;1;229990;CELULAR A52 128 GB LIGHT VIOLET OPEN;TELEFONIA
19413038;;M;25;CHILENO;;Z;PROVIDENCIA                   ;METROPOLITANA;139990;1;1;0;0;0;1;1;139990;CELULAR VIVO Y20S NEBULA 128 GB BLUE OPEN;TELEFONIA
5782992;;M;75;CHILENO;;Silencioso;RENCA                         ;METROPOLITANA;69990;1;1;1;1;69990;0;0;0;CELULAR MOTO E7 32GB ROSA CORAL OPEN;TELEFONIA
20462996;;M;21;CHILENO;;Z;PROVIDENCIA                   ;METROPOLITANA;169990;1;1;1;1;169990;0;0;0;CELULAR REDMI NOTE 11 4/128GB GRAPHITE GRAY OPEN;TELEFONIA
9206918;;F;59;CHILENO;;Boomers;LA PINTANA                    ;METROPOLITANA;453960;4;3;4;3;453960;0;0;0;CELULAR XIAOMI REDMI 9A SE 2/32GB GB PEACOCK GRE;TELEFONIA
26365352;;F;32;VENEZOLANO;;Extranjero;TOME                          ;BIO BIO;175980;2;1;2;1;175980;0;0;0;CELULAR A52 128 GB LIGHT VIOLET OPEN;TELEFONIA
18286768;;M;29;CHILENO;;Millenial;PARRAL;MAULE;157990;3;1;0;0;0;3;1;157990;CELULAR REDMI NOTE 10 5G US 128G NIGHTTIME BLUE;TELEFONIA
9811790;;F;60;CHILENO;;Boomers;ANTUCO                        ;BIO BIO;184990;1;1;0;0;0;1;1;184990;CELULAR GALAXY A22 5G 4+128GB WHITE;TELEFONIA
19445749;;F;25;CHILENO;;Z;PROVIDENCIA                   ;METROPOLITANA;553980;2;1;2;1;553980;0;0;0;CELULAR IPHONE 12 MINI 64GB BLACK CLARO;TELEFONIA
13286546;;M;45;CHILENO;;X;MAIPU;METROPOLITANA;107960;4;2;4;2;107960;0;0;0;CELULAR MOTO E7 32GB GRIS OPEN;TELEFONIA
9578072;;F;57;CHILENO;;Boomers;MELIPILLA                     ;METROPOLITANA;17990;1;1;0;0;0;1;1;17990;CELULAR NOKIA 110 BLACK OPEN;TELEFONIA
8553142;;F;65;CHILENO;;Boomers;N/D;N/D;605960;5;1;0;0;0;5;1;605960;CELULAR SMARTPHONE A52S 5G LIGHT VIOLET 128GB;TELEFONIA
18694404;Soltero;M;28;CHILENO;;Millenial;PROVIDENCIA                   ;METROPOLITANA;139990;1;1;1;1;139990;0;0;0;MOTO G30 LILA PASTEL 128GB MOVISTAR;TELEFONIA
8511633;;F;47;CHILENO;;X;PROVIDENCIA                   ;METROPOLITANA;1109980;4;2;4;2;1109980;0;0;0;Galaxy Z Flip3 128GB CREAM;TELEFONIA
12573314;;F;50;CHILENO;;X;NUEVA IMPERIAL                ;ARAUCANIA;390983;2;2;0;0;0;2;2;390983;CELULAR GALAXY S20FE 128GB CLOUD LAVENDER OPEN;TELEFONIA
19468267;;F;24;CHILENO;;Z;PROVIDENCIA                   ;METROPOLITANA;202980;2;2;1;1;169990;1;1;32990;CELULAR A52 128 GB BLUE OPEN;TELEFONIA
17757396;;F;30;CHILENO;;Millenial;PROVIDENCIA                   ;METROPOLITANA;243280;3;1;0;0;0;3;1;243280;CELULAR GALAXY A22 5G 4+128GB GRAY;TELEFONIA
14205218;;M;40;CHILENO;;X;SAN VICENTE                   ;L.G.B.OÂ´HIGGINS;379980;2;2;0;0;0;2;2;379980;CELULAR A32 128 GB LIGHT VIOLET OPEN;TELEFONIA
16509789;;F;35;CHILENO;;Millenial;PROVIDENCIA                   ;METROPOLITANA;36970;3;1;3;1;36970;0;0;0;CELULAR AZUMI L4G BLACK CLARO;TELEFONIA
7440040;Casado;F;65;CHILENO;;Boomers;CALAMA                        ;ANTOFAGASTA;75990;1;1;0;0;0;1;1;75990;CELULAR XIAOMI REDMI 9C AZUL DIRECTO ENTEL;TELEFONIA
5440956;;F;72;CHILENO;;Silencioso;CONCEPCION                    ;BIO BIO;961250;8;6;0;0;0;8;6;961250;CELULAR REDMI 9A 32GB SKY BLUE;TELEFONIA
7537549;;F;66;CHILENO;;Boomers;N/D;N/D;572450;5;3;0;0;0;5;3;572450;CELULAR XIAOMI REDMI NOTE 10S BLANCO WOM;TELEFONIA
19376815;Soltero;F;26;CHILENO;;Z;ESTACION CENTRAL              ;METROPOLITANA;266790;4;2;0;0;0;4;2;266790;CELULAR XIAOMI REDMI 9A 2/32GB GRANITE GRAY;TELEFONIA
9142199;;F;61;CHILENO;;Boomers;SALAMANCA                     ;COQUIMBO;129990;1;1;0;0;0;1;1;129990;SMARTPHONE A03S 64 GB NEGRO;TELEFONIA
9428385;Casado;F;62;CHILENO;;Boomers;NUEVA IMPERIAL                ;ARAUCANIA;54380;3;1;0;0;0;3;1;54380;CELULAR BMOBILE C40 CRIS OPEN;TELEFONIA
20401977;;M;22;CHILENO;;Z;LEBU                          ;BIO BIO;384980;2;2;0;0;0;2;2;384980;CELULAR VIVO Y53S FANTASTIC RAINBOW 128GB OPEN;TELEFONIA
15677179;;M;38;CHILENO;;X;"";"";299990;1;1;0;0;0;1;1;299990;MOTO EDGE 20 LITE 6/128GB GRIS;TELEFONIA
13692474;;F;43;CHILENO;;X;N/D;N/D;344970;3;2;3;2;344970;0;0;0;CELULAR HUAWEI NOVA 8i BLUE;TELEFONIA
26131335;;M;35;COLOMBIANO;;Extranjero;"";"";990;3;1;0;0;0;3;1;990;CHIP OPEN ENTEL;TELEFONIA
18217913;Soltero;F;29;CHILENO;INGENIERIA EN PREVENCION DE RIESGOS CALIDAD Y AMBIENTE;Millenial;AISEN                         ;AYSEN;289990;1;1;0;0;0;1;1;289990;CELULAR REDMI NOTE 11S 6GB+128GB TWILIGHT BLUE O;TELEFONIA
6336570;;M;69;CHILENO;;Silencioso;OVALLE                        ;COQUIMBO;99991;2;1;0;0;0;2;1;99991;SMARTPHONE A03S 32 GB ROJO;TELEFONIA
10568877;Divorciado;M;56;CHILENO;;Boomers;RENCA                         ;METROPOLITANA;34990;1;1;0;0;0;1;1;34990;CELULAR NOKIA 225 4G BLACK MOVISTAR DIRECTO;TELEFONIA
7709373;;F;63;CHILENO;;Boomers;COIHAIQUE                     ;AYSEN;1338330;8;4;0;0;0;8;4;1338330;CELULAR IPHONE SE 64GB DIRECTO CLARO;TELEFONIA
17258180;;M;32;CHILENO;;Millenial;RENCA                         ;METROPOLITANA;176980;2;1;2;1;176980;0;0;0;CELULAR XIAOMI REDMI NOTE 10S BLANCO WOM;TELEFONIA
21355500;;F;52;PERUANO;;Extranjero;RECOLETA                      ;METROPOLITANA;159990;2;1;2;1;159990;0;0;0;CELULAR XIAOMI REDMI 9A 2/32GB GRANITE GRAY;TELEFONIA
17543865;;M;32;CHILENO;;Millenial;N/D;N/D;980;2;1;0;0;0;2;1;980;CHIP OPEN ENTEL;TELEFONIA
13165218;;M;45;CHILENO;;X;CASTRO                        ;LOS LAGOS;184990;3;2;0;0;0;3;2;184990;CELULAR GALAXY A03 CORE 2GB 32GB BLACK OPEN;TELEFONIA
13594361;;M;42;CHILENO;;X;PROVIDENCIA                   ;METROPOLITANA;25980;2;1;2;1;25980;0;0;0;CELULAR NOKIA 110 BLACK OPEN;TELEFONIA
18678916;Soltero;M;28;CHILENO;;Millenial;PROVIDENCIA                   ;METROPOLITANA;81980;3;2;0;0;0;3;2;81980;CELULAR Moto G20 Rosado WOM;TELEFONIA
18458500;;F;29;CHILENO;;Millenial;QUEILEN                       ;LOS LAGOS;189990;1;1;0;0;0;1;1;189990;CELULAR VIVO Y21S PEARL WHITE 128 GB OPEN;TELEFONIA
17265546;;F;33;CHILENO;;Millenial;PROVIDENCIA                   ;METROPOLITANA;157640;2;1;0;0;0;2;1;157640;CELULAR GALAXY A03 4+64GB BLUE OPEN;TELEFONIA
19271965;;F;26;CHILENO;;Z;PROVIDENCIA                   ;METROPOLITANA;146800;2;1;0;0;0;2;1;146800;CELULAR VIVO Y20 NEBULA BLUE OPEN;TELEFONIA
7498578;;F;76;CHILENO;;Silencioso;COIHAIQUE                     ;AYSEN;179990;1;1;0;0;0;1;1;179990;CELULAR REDMI NOTE 10 5G US 128G NIGHTTIME BLUE;TELEFONIA
6800026;;F;73;CHILENO;;Silencioso;MONTE PATRIA                  ;COQUIMBO;193930;3;1;0;0;0;3;1;193930;CELULAR VIVO Y20S OBSIDIAN BLACK 128GB OPEN;TELEFONIA
10019248;;M;56;CHILENO;;Boomers;LO BARNECHEA                  ;METROPOLITANA;527480;6;3;0;0;0;6;3;527480;CELULAR SAMSUNG GALAXY A03 CORE AZUL WOM;TELEFONIA
15525735;;M;39;CHILENO;;X;COLTAUCO;O HIGGINS;150000;2;1;0;0;0;2;1;150000;CELULAR MOTOROLA G30 GRIS WOM 128 GB;TELEFONIA
16034667;;F;36;CHILENO;;Millenial;N/D;N/D;39991;2;1;0;0;0;2;1;39991;CELULAR BMOBILE C40 CRIS OPEN;TELEFONIA
15868725;;F;37;CHILENO;;Millenial;"";"";189980;2;1;2;1;189980;0;0;0;CELULAR GALAXY A22 5G 4+128GB GRAY;TELEFONIA
17873023;;M;30;CHILENO;;Millenial;PENCO                         ;BIO BIO;209991;2;1;0;0;0;2;1;209991;CELULAR MOTO G60 4/128 GB SILVER OPEN;TELEFONIA
16261297;Soltero;M;36;CHILENO;;Millenial;RENCA                         ;METROPOLITANA;99991;2;1;0;0;0;2;1;99991;CELULAR VIVO Y11s PHANTOM BLACK ENTEL DIRECTO;TELEFONIA
19212996;;F;26;CHILENO;;Z;PROVIDENCIA                   ;METROPOLITANA;373970;3;2;3;2;373970;0;0;0;CELULAR XIAOMI REDMI NOTE 10S BLANCO WOM;TELEFONIA
7125020;;F;68;CHILENO;;Silencioso;SALAMANCA                     ;COQUIMBO;478060;4;2;0;0;0;4;2;478060;CELULAR A52 128 GB BLACK OPEN;TELEFONIA
13149120;;F;45;CHILENO;;X;QUILACO                       ;BIO BIO;209990;1;1;1;1;209990;0;0;0;CELULAR A52 128 GB WHITE OPEN;TELEFONIA
20574202;;F;21;CHILENO;;Z;PROVIDENCIA                   ;METROPOLITANA;169990;2;1;0;0;0;2;1;169990;CELULAR A32 128 GB BLACK OPEN;TELEFONIA
18636914;Soltero;M;28;CHILENO;PSICOLOGO;Millenial;PROVIDENCIA                   ;METROPOLITANA;553980;2;1;2;1;553980;0;0;0;CELULAR XIAOMI 11T PRO 8/256GB MOON WHITE;TELEFONIA
5883307;;F;70;CHILENO;;Silencioso;LOS ANDES                     ;VALPARAISO;220981;6;2;0;0;0;6;2;220981;CELULAR SMARTPHONE A52S 5G LIGHT VIOLET 128GB;TELEFONIA
21918833;;F;56;PERUANO;;Extranjero;RECOLETA                      ;METROPOLITANA;1647350;5;3;0;0;0;5;3;1647350;CELULAR GALAXY S22 ULTRA BURGUNDY 128GB;TELEFONIA
18952518;;F;27;CHILENO;;Z;OVALLE                        ;COQUIMBO;264980;2;2;0;0;0;2;2;264980;SMARTPHONE A03S 32 GB ROJO;TELEFONIA
13324477;Casado;F;44;CHILENO;;X;"";"";163990;3;2;1;1;143990;2;1;20000;CELULAR GALAXY A22 5G 4+128GB GRAY;TELEFONIA
15265921;;F;40;CHILENO;;X;RENCA                         ;METROPOLITANA;188990;1;1;1;1;188990;0;0;0;CELULAR A52 128 GB BLACK OPEN;TELEFONIA
25387334;;F;37;BOLIVIANO;;Extranjero;N/D;N/D;309950;5;2;0;0;0;5;2;309950;CELULAR A52 128 GB BLACK OPEN;TELEFONIA
13801583;;F;42;CHILENO;;X;CHANCO                        ;MAULE;322460;3;2;0;0;0;3;2;322460;CELULAR GALAXY A22 5G 4+128GB MINT;TELEFONIA
12358722;;F;49;CHILENO;;X;SAN CLEMENTE                  ;MAULE;622650;4;3;0;0;0;4;3;622650;CELULAR VIVO Y53S FANTASTIC RAINBOW 128GB OPEN;TELEFONIA
8767206;;F;64;CHILENO;;Boomers;N/D;N/D;259980;2;4;0;0;0;2;4;259980;CELULAR XIAOMI REDMI 9C 64GB GRAY WOM;TELEFONIA
5025693;;M;83;CHILENO;;Silencioso;TRAIGUEN                      ;ARAUCANIA;219980;2;2;0;0;0;2;2;219980;CELULAR BMOBILE BS30 BLACK OPEN;TELEFONIA
20127932;;F;23;CHILENO;;Z;"";"";119990;1;1;1;1;119990;0;0;0;CELULAR A12 128GB Azul OPEN;TELEFONIA
9952905;;F;58;CHILENO;;Boomers;PAINE                         ;METROPOLITANA;369970;3;2;0;0;0;3;2;369970;CELULAR VIVO Y20S NEBULA 128 GB BLUE OPEN;TELEFONIA
19394299;;F;25;CHILENO;;Z;"";"";129990;1;1;0;0;0;1;1;129990;CELULAR MOTOROLA G20 64GB BLUE CLARO;TELEFONIA
14561173;;M;40;CHILENO;;X;SAN JAVIER                    ;MAULE;419980;3;2;0;0;0;3;2;419980;CELULAR MOTO G20 64GB AZUL OPEN;TELEFONIA
19346714;;F;26;CHILENO;;Z;LINARES                       ;MAULE;39990;2;1;0;0;0;2;1;39990;CELULAR VIVO Y20 NEBULA BLUE OPEN;TELEFONIA
12667936;;F;48;CHILENO;;X;RENCA                         ;METROPOLITANA;33990;1;1;0;0;0;1;1;33990;Celular SA3 CLARO DIRECTO BLACK;TELEFONIA
18266925;Soltero;M;29;CHILENO;;Millenial;"";"";249990;1;1;1;1;249990;0;0;0;CELULAR SMARTPHONE A52S 5G LIGHT GREEN 128GB;TELEFONIA
12195626;;M;50;CHILENO;;X;PROVIDENCIA                   ;METROPOLITANA;89990;1;1;0;0;0;1;1;89990;CELULAR SAMSUNG GALAXY A03 CORE AZUL WOM;TELEFONIA
18890315;;F;27;CHILENO;;Millenial;SAN FERNANDO                  ;L.G.B.OÂ´HIGGINS;154980;2;2;0;0;0;2;2;154980;CELULAR VIVO Y20S NEBULA 128 GB BLUE OPEN;TELEFONIA
17592741;Soltero;M;32;CHILENO;;Millenial;COIHAIQUE                     ;AYSEN;223980;2;1;2;1;223980;0;0;0;CELULAR SMARTPHONE A52S 5G LIGHT VIOLET 128GB;TELEFONIA
19769479;;F;31;CHILENO;;Millenial;N/D;N/D;129500;2;1;0;0;0;2;1;129500;CELULAR VIVO Y11S 32 GB NEBULA BLUE WOM;TELEFONIA
19575253;;M;25;CHILENO;;Z;LINARES                       ;MAULE;753310;9;5;0;0;0;9;5;753310;CELULAR A52 128 GB BLUE OPEN;TELEFONIA
11161245;;M;55;CHILENO;;Boomers;N/D;N/D;213280;2;1;0;0;0;2;1;213280;CELULAR GALAXY A22 5G 4+128GB GRAY;TELEFONIA
19817766;;M;24;CHILENO;;Z;PROVIDENCIA                   ;METROPOLITANA;365960;4;3;4;2;305960;0;1;60000;CELULAR REDMI NOTE 11 GRAPHITE GRAY + REDMI BUDS;TELEFONIA
15519838;;M;34;CHILENO;;Millenial;PROVIDENCIA                   ;METROPOLITANA;79990;1;1;1;1;79990;0;0;0;CELULAR XIAOMI REDMI 9A 2/32GB GRANITE GRAY;TELEFONIA
19154881;Soltero;M;26;CHILENO;;Z;PROVIDENCIA                   ;METROPOLITANA;344960;5;2;5;2;344960;0;0;0;CELULAR A12 128GB Azul OPEN;TELEFONIA
25461974;;F;27;PERUANO;;Extranjero;INDEPENDENCIA;METROPOLITANA;631640;8;1;0;0;0;8;1;631640;CELULAR REDMI NOTE 11 GRAPHITE GRAY + REDMI BUDS;TELEFONIA
6956683;;M;68;CHILENO;;Silencioso;TEMUCO                        ;ARAUCANIA;149991;2;1;0;0;0;2;1;149991;CELULAR A12 128GB Negro OPEN;TELEFONIA
15252269;;M;40;CHILENO;;X;CUNCO                         ;ARAUCANIA;109990;1;1;0;0;0;1;1;109990;CELULAR OPPO A15 BLACK 32GB CLARO;TELEFONIA
12040969;Soltero;F;49;CHILENO;CONTADOR AUDITOR;X;PROVIDENCIA                   ;METROPOLITANA;58641;12;1;0;0;0;12;1;58641;CELULAR BMOBILE C40 CRIS OPEN;TELEFONIA
10836989;Casado;M;55;CHILENO;AGROINDUSTRIA;Boomers;PROVIDENCIA                   ;METROPOLITANA;219990;1;1;0;0;0;1;1;219990;CELULAR A52 128 GB BLACK OPEN;TELEFONIA
13369656;;M;44;CHILENO;;X;COLINA                        ;METROPOLITANA;298180;2;1;0;0;0;2;1;298180;CELULAR A52 128 GB BLACK OPEN;TELEFONIA
8686577;;F;70;CHILENO;;Silencioso;PROVIDENCIA                   ;METROPOLITANA;109990;1;1;1;1;109990;0;0;0;SMARTPHONE A03S 32 GB ROJO;TELEFONIA
17259645;;F;36;CHILENO;;Millenial;PADRE LAS CASAS               ;ARAUCANIA;480501;5;3;0;0;0;5;3;480501;CELULAR A52 128 GB BLUE OPEN;TELEFONIA
11747788;;M;51;CHILENO;;X;LINARES                       ;MAULE;179990;1;1;0;0;0;1;1;179990;CELULAR GALAXY A22 5G 4+128GB GRAY;TELEFONIA
13800291;;F;42;CHILENO;;X;CORONEL                       ;BIO BIO;152040;4;1;0;0;0;4;1;152040;CELULAR MOTO E7I POWER 32GB BLUE MOVISTAR;TELEFONIA
12312754;;F;48;CHILENO;;X;ALGARROBO                     ;VALPARAISO;208920;3;2;0;0;0;3;2;208920;CELULAR VIVO Y20 BLACK 64GB MOVISTAR;TELEFONIA
13979760;;F;40;CHILENO;;X;PUCHUNCAVI                    ;VALPARAISO;293960;5;3;0;0;0;5;3;293960;CELULAR POCO X3 PRO 128G PHANTOM BLACK OPEN;TELEFONIA
13027710;;M;46;CHILENO;;X;COIHAIQUE                     ;AYSEN;249990;1;1;1;1;249990;0;0;0;CELULAR REDMI NOTE 10 PRO 6+128GB GRADIENT BRONZ;TELEFONIA
16466422;;M;36;CHILENO;;Millenial;ARICA                         ;ARICA Y PARINACOTA;919980;3;2;0;0;0;3;2;919980;CELULAR SAMSUNG S21 FE 128GB LIGHT GREEN OPEN;TELEFONIA
13217369;Soltero;F;44;CHILENO;;X;RENCA                         ;METROPOLITANA;209990;1;1;0;0;0;1;1;209990;CELULAR A32 128 GB BLACK OPEN;TELEFONIA
14569450;;F;45;CHILENO;;X;LOS ALAMOS                    ;BIO BIO;561092;2;1;0;0;0;2;1;561092;IPHONE 11 128GB BLACK CLARO;TELEFONIA
10536976;;F;54;CHILENO;;X;RENCA                         ;METROPOLITANA;141800;2;1;0;0;0;2;1;141800;CELULAR XIAOMI REDMI 9 MORADO ENTEL;TELEFONIA
19141714;;M;27;CHILENO;;Z;RECOLETA                      ;METROPOLITANA;179990;1;1;0;0;0;1;1;179990;CELULAR REDMI NOTE 10 5G 4/128GB GRAPHITE GRAY O;TELEFONIA
9889763;;M;58;CHILENO;;Boomers;PROVIDENCIA                   ;METROPOLITANA;126800;2;1;0;0;0;2;1;126800;CELULAR XIAOMI REDMI 9A 32GB VERDE CLARO;TELEFONIA
20766902;;F;20;CHILENO;;Z;TEMUCO                        ;ARAUCANIA;980;3;1;0;0;0;3;1;980;CHIP OPEN ENTEL;TELEFONIA
23300247;;F;44;BOLIVIANO;;Extranjero;ANTOFAGASTA                   ;ANTOFAGASTA;55970;4;2;0;0;0;4;2;55970;CELULAR VIVO Y11S NEGRO WOM;TELEFONIA
15774640;;F;38;CHILENO;;Millenial;MAIPU;METROPOLITANA;246140;2;1;0;0;0;2;1;246140;CELULAR GALAXY A22 5G 4+128GB GRAY;TELEFONIA
19870712;;F;23;CHILENO;;Z;PROVIDENCIA                   ;METROPOLITANA;189990;1;1;1;1;189990;0;0;0;CELULAR REDMI NOTE 11 GRAPHITE GRAY + REDMI BUDS;TELEFONIA
11799666;Casado;F;50;CHILENO;;X;PROVIDENCIA                   ;METROPOLITANA;86980;2;1;2;1;86980;0;0;0;CELULAR XIAOMI REDMI 9A 32GB BLACK DIRECTO CLARO;TELEFONIA
18285426;;F;29;CHILENO;;Millenial;CASTRO                        ;LOS LAGOS;250980;2;1;0;0;0;2;1;250980;CELULAR REDMI NOTE 10S 128GB ONIX BLACK;TELEFONIA
19364038;;F;25;CHILENO;;Z;N/D;N/D;255980;2;1;0;0;0;2;1;255980;CELULAR A32 128 GB LIGHT VIOLET OPEN;TELEFONIA
10104939;;F;57;CHILENO;;Boomers;MELIPILLA                     ;METROPOLITANA;882951;6;2;0;0;0;6;2;882951;CELULAR MOTO E7 32GB GRIS OPEN;TELEFONIA
12325869;Soltero;M;49;CHILENO;;X;RENCA                         ;METROPOLITANA;34990;1;1;0;0;0;1;1;34990;CELULAR NOKIA 225 4G BLACK MOVISTAR DIRECTO;TELEFONIA
12418261;;M;48;CHILENO;;X;PROVIDENCIA                   ;METROPOLITANA;89990;1;1;0;0;0;1;1;89990;CELULAR XIAOMI REDMI 9A 2/32GB GRANITE GRAY;TELEFONIA
16869702;;M;34;CHILENO;;Millenial;VICTORIA                      ;ARAUCANIA;129480;2;1;0;0;0;2;1;129480;CELULAR VIVO Y11S PHANTOM BLACK OPEN;TELEFONIA
19353813;;M;26;CHILENO;;Z;PUENTE ALTO;METROPOLITANA;239990;1;1;0;0;0;1;1;239990;CELULAR MOTO G60 4/128 GB SILVER OPEN;TELEFONIA
6004403;;F;70;CHILENO;;Silencioso;LOS ANGELES                   ;BIO BIO;129990;1;1;1;1;129990;0;0;0;CELULAR MOTO G20 EDICION ESPECIAL 4/128 GB AZUL;TELEFONIA
20207377;;F;22;CHILENO;;Z;PROVIDENCIA                   ;METROPOLITANA;32990;1;1;0;0;0;1;1;32990;Celular SA3 CLARO DIRECTO BLACK;TELEFONIA
6536142;;M;70;CHILENO;;Silencioso;RETIRO                        ;MAULE;100980;2;1;0;0;0;2;1;100980;SMARTPHONE A03s 64 GB Red DS;TELEFONIA
6075921;;F;73;CHILENO;;Silencioso;LA PINTANA                    ;METROPOLITANA;164980;2;1;0;0;0;2;1;164980;SMARTPHONE A03S 64 GB NEGRO;TELEFONIA
6905659;;M;69;CHILENO;;Silencioso;MAIPU                         ;METROPOLITANA;352970;3;3;0;0;0;3;3;352970;CELULAR XIAOMI REDMI NOTE 10S BLANCO WOM;TELEFONIA
13259970;;F;45;CHILENO;;X;PROVIDENCIA                   ;METROPOLITANA;61970;3;1;3;1;61970;0;0;0;CELULAR NOKIA QUEEN VALUE BLACK CLARO;TELEFONIA
26279496;;M;47;EXTRANJERO - NO INFORMA NACIONALIDAD;;Extranjero;ANTOFAGASTA                   ;ANTOFAGASTA;359960;4;3;0;0;0;4;3;359960;CELULAR VIVO Y11S PHANTON BLACK 32GB MOVISTAR;TELEFONIA
16272496;;M;36;CHILENO;;Millenial;PROVIDENCIA                   ;METROPOLITANA;199990;1;1;0;0;0;1;1;199990;CELULAR REDMI NOTE 10S 128GB ONIX BLACK;TELEFONIA
16025719;;F;37;CHILENO;;Millenial;CERRO NAVIA;METROPOLITANA;159980;2;1;2;1;159980;0;0;0;CELULAR XIAOMI REDMI 9A 32GB GRANITE GRAY TRI WO;TELEFONIA
13012434;;M;46;CHILENO;;X;RENCA                         ;METROPOLITANA;208980;2;1;2;1;208980;0;0;0;CELULAR MOTO G60S 6/128 GB AZUL;TELEFONIA
16274857;;M;36;CHILENO;;Millenial;LINARES                       ;MAULE;61990;2;1;0;0;0;2;1;61990;CELULAR VIVO Y11S PHANTON BLACK 32GB MOVISTAR;TELEFONIA
19926394;;F;23;CHILENO;;Z;N/D;N/D;841950;5;4;0;0;0;5;4;841950;CELULAR A52 128 GB BLACK OPEN;TELEFONIA
8784825;;F;63;CHILENO;;Boomers;RENCA                         ;METROPOLITANA;149990;2;1;0;0;0;2;1;149990;CELULAR MOTO G60S 6/128 GB AZUL;TELEFONIA
5795267;;F;75;CHILENO;;Silencioso;ALGARROBO                     ;VALPARAISO;255980;2;1;0;0;0;2;1;255980;CELULAR POCO X3 PRO 128G PHANTOM BLACK OPEN;TELEFONIA
26680506;;M;30;VENEZOLANO;;Extranjero;TALCA                         ;MAULE;900960;4;2;2;1;261980;2;1;638980;CELULAR XIAOMI 11T 8/256GB MOONLIGHT WHITE KIT;TELEFONIA
19265675;;M;25;CHILENO;;Z;PROVIDENCIA                   ;METROPOLITANA;155980;3;1;0;0;0;3;1;155980;CELULAR A32 128 GB BLACK OPEN;TELEFONIA
17972933;;F;31;CHILENO;;Millenial;PROVIDENCIA                   ;METROPOLITANA;142980;2;2;2;2;142980;0;0;0;CELULAR A12 128GB Negro OPEN;TELEFONIA
17892176;Soltero;M;29;CHILENO;;Millenial;PROVIDENCIA                   ;METROPOLITANA;146980;2;1;0;0;0;2;1;146980;CELULAR VIVO Y20 NEBULA BLUE OPEN;TELEFONIA
16640416;;M;35;CHILENO;;Millenial;VILLARICA                     ;ARAUCANIA;529970;3;3;3;3;529970;0;0;0;CELULAR RENO5 LITE VIOLETA 128GB;TELEFONIA
19966059;;F;23;CHILENO;;Z;PROVIDENCIA                   ;METROPOLITANA;335970;3;2;0;0;0;3;2;335970;CELULAR A52 128 GB BLACK OPEN;TELEFONIA
8666995;;M;60;CHILENO;;Boomers;RENCA                         ;METROPOLITANA;89990;1;1;0;0;0;1;1;89990;CELULAR XIAOMI REDMI 9A 2/32GB GRANITE GRAY;TELEFONIA
18494445;;M;29;CHILENO;;Millenial;LA SERENA                     ;COQUIMBO;89990;1;1;0;0;0;1;1;89990;CELULAR XIAOMI REDMI 9 MORADO ENTEL;TELEFONIA
15087118;;M;40;CHILENO;;X;PROVIDENCIA                   ;METROPOLITANA;109990;1;1;0;0;0;1;1;109990;SMARTPHONE A03S AZUL 32GB;TELEFONIA
20009758;;M;23;CHILENO;;Z;PROVIDENCIA                   ;METROPOLITANA;199990;1;1;1;1;199990;0;0;0;CELULAR MOTO G60S 6/128 GB AZUL;TELEFONIA
6432827;;M;69;CHILENO;;Silencioso;QUILPUE                       ;VALPARAISO;39990;1;1;0;0;0;1;1;39990;CELULAR BMOBILE C40 CRIS OPEN;TELEFONIA
18965071;;F;27;CHILENO;;Millenial;PROVIDENCIA                   ;METROPOLITANA;652820;4;2;4;2;652820;0;0;0;CELULAR SAMSUNG S21 FE 128GB WHITE OPEN;TELEFONIA
15625100;Casado;M;37;CHILENO;;Millenial;PROVIDENCIA                   ;METROPOLITANA;357960;4;2;4;2;357960;0;0;0;CELULAR MOTO G60S 6/128 GB AZUL;TELEFONIA
17129049;Soltero;F;33;CHILENO;;Millenial;PROVIDENCIA                   ;METROPOLITANA;265480;2;1;2;1;265480;0;0;0;CELULAR REDMI NOTE 10 PRO 128GB AZUL WOM;TELEFONIA
14260519;;M;56;CHILENO;;Boomers;CHIMBARONGO                   ;L.G.B.OÂ´HIGGINS;146981;3;1;0;0;0;3;1;146981;CELULAR VIVO Y11S PHANTOM BLACK OPEN;TELEFONIA
6232806;;F;71;CHILENO;;Silencioso;RENCA                         ;METROPOLITANA;52980;2;1;0;0;0;2;1;52980;CELULAR BMOBILE C40 CRIS OPEN;TELEFONIA
9460078;;M;60;CHILENO;;Boomers;LA CISTERNA                   ;METROPOLITANA;161990;2;1;0;0;0;2;1;161990;CELULAR XIAOMI POCO X3 PRO 128GB PANTHOM BLACK;TELEFONIA
7409208;Viudo;M;68;CHILENO;;Boomers;PROVIDENCIA                   ;METROPOLITANA;163981;3;1;0;0;0;3;1;163981;SMARTPHONE A03S 32 GB ROJO;TELEFONIA
15341225;;F;39;CHILENO;;X;PROVIDENCIA                   ;METROPOLITANA;119990;1;1;0;0;0;1;1;119990;SMARTPHONE A03s 64 GB Red DS;TELEFONIA
10884182;;M;53;CHILENO;;X;PUCON                         ;ARAUCANIA;109990;1;1;0;0;0;1;1;109990;CELULAR XIAOMI REDMI 9 MORADO ENTEL;TELEFONIA
18150936;;M;30;CHILENO;;Millenial;"";"";189990;1;1;1;1;189990;0;0;0;CELULAR REDMI NOTE 10S 128GB OCEAN BLUE;TELEFONIA
17398019;;M;32;CHILENO;;Millenial;N/D;N/D;483960;4;3;2;1;183980;2;2;299980;CELULAR VIVO Y11S 32GB NEBULA BLUE OPEN;TELEFONIA
18563328;;F;28;CHILENO;;Millenial;SAN FELIPE                    ;VALPARAISO;189990;1;1;1;1;189990;0;0;0;CELULAR REDMI NOTE 11 GRAPHITE GRAY + REDMI BUDS;TELEFONIA
7973182;;M;65;CHILENO;;Boomers;LOTA                          ;BIO BIO;483840;5;3;0;0;0;5;3;483840;CELULAR VIVO Y21S PEARL WHITE 128 GB OPEN;TELEFONIA
6750182;;F;71;CHILENO;;Silencioso;CASTRO                        ;LOS LAGOS;626050;7;4;0;0;0;7;4;626050;CELULAR A12 128GB Negro OPEN;TELEFONIA
19647149;;F;25;CHILENO;;Silencioso;PROVIDENCIA                   ;METROPOLITANA;773970;3;2;3;2;773970;0;0;0;CELULAR IPHONE 12 64GB WHITE CLARO;TELEFONIA
5796755;;F;77;CHILENO;;Silencioso;RENCA                         ;METROPOLITANA;44990;2;1;0;0;0;2;1;44990;CELULAR MOTO E7 32GB GRIS OPEN;TELEFONIA
14433595;;F;50;CHILENO;;X;PEDRO AGUIRRE CERDA           ;METROPOLITANA;34140;2;1;0;0;0;2;1;34140;Celular SA3 CLARO DIRECTO BLACK;TELEFONIA
12075077;;F;52;CHILENO;;X;QUILLECO                      ;BIO BIO;129990;1;1;0;0;0;1;1;129990;CELULAR MOTOROLA G20 EDICION ESPECIAL VERDE CLAR;TELEFONIA
7851532;;F;65;CHILENO;;Boomers;LEBU                          ;BIO BIO;99990;1;1;0;0;0;1;1;99990;SMARTPHONE A03s 64 GB Red DS;TELEFONIA
16578961;;F;35;CHILENO;;Millenial;ILLAPEL                       ;COQUIMBO;341970;3;2;0;0;0;3;2;341970;CELULAR BMOBILE BS30 BLACK OPEN;TELEFONIA
11320008;;F;54;CHILENO;;X;SAN JAVIER                    ;MAULE;227460;4;4;0;0;0;4;4;227460;CELULAR VIVO Y20 NEBULA BLUE OPEN;TELEFONIA
8396633;;M;59;CHILENO;;Boomers;RENCA                         ;METROPOLITANA;159980;3;2;0;0;0;3;2;159980;CELULAR VIVO Y11S PHANTOM BLACK OPEN;TELEFONIA
15600639;;F;38;CHILENO;;Millenial;PANGUIPULLI                   ;LOS LAGOS;52980;2;1;0;0;0;2;1;52980;CELULAR BMOBILE C40 CRIS OPEN;TELEFONIA
16903409;Soltero;M;33;CHILENO;;Millenial;BUIN                          ;METROPOLITANA;129980;2;2;0;0;0;2;2;129980;CELULAR VIVO Y20 NEBULA BLUE OPEN;TELEFONIA
20395360;;F;22;CHILENO;;Z;PROVIDENCIA                   ;METROPOLITANA;0;0;2;0;2;0;0;0;0;CELULAR POCO X3 PRO 256 GB FROST BLUE;TELEFONIA
5399812;;F;77;CHILENO;;Silencioso;N/D;N/D;409980;3;4;0;0;0;3;4;409980;CELULAR A52 128 GB LIGHT VIOLET OPEN;TELEFONIA
7534623;;M;67;CHILENO;;Boomers;VALLENAR;ATACAMA;139990;1;1;0;0;0;1;1;139990;CELULAR A12 128GB Negro OPEN;TELEFONIA
10843634;;M;55;CHILENO;;Boomers;PROVIDENCIA                   ;METROPOLITANA;99990;2;1;0;0;0;2;1;99990;CELULAR REDMI 9 64GB CARBON GREY;TELEFONIA
11524916;;M;52;CHILENO;;X;PROVIDENCIA                   ;METROPOLITANA;822970;3;2;0;0;0;3;2;822970;IPHONE 11 128GB BLACK CLARO;TELEFONIA
25532406;Soltero;F;33;COLOMBIANO;;Extranjero;PROVIDENCIA                   ;METROPOLITANA;703980;3;1;3;1;703980;0;0;0;Galaxy Z Flip3 128GB LAVENDER;TELEFONIA
19862146;;F;24;CHILENO;;Z;PROVIDENCIA                   ;METROPOLITANA;527970;3;2;3;2;527970;0;0;0;CELULAR A52 128 GB BLACK OPEN;TELEFONIA
18202989;;F;29;CHILENO;;Millenial;CAUQUENES                     ;MAULE;99990;1;1;0;0;0;1;1;99990;CELULAR VIVO Y20 NEBULA BLUE OPEN;TELEFONIA
15227133;;F;40;CHILENO;;X;ANGOL                         ;ARAUCANIA;441561;4;2;0;0;0;4;2;441561;CELULAR REDMI NOTE 11 4/128GB TWILIGHT BLUE OPEN;TELEFONIA
18145514;;M;29;CHILENO;;Millenial;ANTOFAGASTA                   ;ANTOFAGASTA;189991;2;1;0;0;0;2;1;189991;CELULAR VIVO Y21S MIDNIGHT BLUE 128 GB OPEN;TELEFONIA
15868716;Soltero;M;37;CHILENO;;Millenial;"";"";139990;1;1;0;0;0;1;1;139990;CELULAR VIVO Y20S NEBULA 128 GB BLUE OPEN;TELEFONIA
18757798;;F;28;CHILENO;;Millenial;LA SERENA;COQUIMBO;980;2;1;0;0;0;2;1;980;CHIP OPEN ENTEL;TELEFONIA
14301229;;M;50;CHILENO;;X;AISEN                         ;AYSEN;199990;1;1;0;0;0;1;1;199990;CELULAR A32 128 GB BLACK OPEN;TELEFONIA
17827361;;M;30;CHILENO;;Millenial;PROVIDENCIA                   ;METROPOLITANA;99990;1;1;0;0;0;1;1;99990;SMARTPHONE A03S 32 GB ROJO;TELEFONIA
14907181;;M;41;CHILENO;;X;PUENTE ALTO;METROPOLITANA;219990;1;1;1;1;219990;0;0;0;CELULAR REDMI NOTE 11 4/128GB TWILIGHT BLUE OPEN;TELEFONIA
20196046;;M;22;CHILENO;;Z;CANETE                        ;BIO BIO;683250;5;2;0;0;0;5;2;683250;CELULAR SMARTPHONE A52S 5G BLACK 128GB;TELEFONIA
6610058;Divorciado;M;69;CHILENO;;Silencioso;PROVIDENCIA                   ;METROPOLITANA;223980;2;1;2;1;223980;0;0;0;CELULAR A52 128 GB LIGHT VIOLET OPEN;TELEFONIA
5408176;;M;77;CHILENO;;Silencioso;ILLAPEL                       ;COQUIMBO;32990;1;1;0;0;0;1;1;32990;CELULAR BMOBILE BS30 BLACK OPEN;TELEFONIA
8972310;;F;61;CHILENO;;Boomers;TEMUCO                        ;ARAUCANIA;1704410;9;4;0;0;0;9;4;1704410;IPHONE 12 128GB BLACK CLARO;TELEFONIA
18838019;;F;28;CHILENO;;Millenial;MAIPU                         ;METROPOLITANA;152220;4;2;0;0;0;4;2;152220;CELULAR VIVO Y11S PHANTOM BLACK OPEN;TELEFONIA
16815803;;M;34;CHILENO;;Millenial;SAN CARLOS                    ;BIO BIO;276970;4;2;4;2;276970;0;0;0;CELULAR A12 128GB Negro OPEN;TELEFONIA
12609640;;M;47;CHILENO;;X;ARICA                         ;ARICA Y PARINACOTA;1314920;9;4;4;2;851960;5;2;462960;CELULAR POCO F3 128 GB NIGHT BLACK;TELEFONIA
12174286;;M;50;CHILENO;;X;PROVIDENCIA                   ;METROPOLITANA;94990;1;3;0;0;0;1;3;94990;CELULAR MOTOROLA E7 IPOWER 32GB BLUE CLARO;TELEFONIA
25301419;;F;53;PERUANO;;Extranjero;QUINTA NORMAL                 ;METROPOLITANA;219990;1;1;0;0;0;1;1;219990;CELULAR A52 128 GB BLACK OPEN;TELEFONIA
19192934;;M;26;CHILENO;;Z;N/D;N/D;1319960;5;2;3;1;903980;2;1;415980;CELULAR GALAXY S22 WHITE 128GB;TELEFONIA
16235513;;F;35;CHILENO;;Millenial;ANGOL                         ;ARAUCANIA;79990;1;1;0;0;0;1;1;79990;CELULAR XIAOMI REDMI 9A 32GB GRANITE GRAY TRI WO;TELEFONIA
26895468;;M;44;EXTRANJERO - NO INFORMA NACIONALIDAD ;;Extranjero;ALHUE                         ;METROPOLITANA;198970;3;2;0;0;0;3;2;198970;CELULAR GALAXY A03 4+64GB BLACK OPEN;TELEFONIA
5083263;;F;76;CHILENO;;Silencioso;RENCA                         ;METROPOLITANA;279980;2;2;0;0;0;2;2;279980;CELULAR A32 128 GB BLACK OPEN;TELEFONIA
17960585;;F;30;CHILENO;;Millenial;PROVIDENCIA                   ;METROPOLITANA;237960;4;2;4;2;237960;0;0;0;CELULAR MOTO G20 64GB ROSA FLAMINGO OPEN;TELEFONIA
9159167;;F;61;CHILENO;;Boomers;LLAILLAY                      ;VALPARAISO;344152;5;3;0;0;0;5;3;344152;CELULAR MOTOROLA G20 EDICION ESPECIAL VERDE CLAR;TELEFONIA
25968515;;M;25;HAITIANO;;Extranjero;CONCEPCION                    ;BIO BIO;631111;6;4;0;0;0;6;4;631111;CELULAR MOTO G60S 6/128 GB AZUL;TELEFONIA
26011399;;F;43;COLOMBIANO;;Extranjero;INDEPENDENCIA                 ;METROPOLITANA;390980;2;1;0;0;0;2;1;390980;CELULAR SMARTPHONE A52S 5G LIGHT VIOLET 128GB;TELEFONIA
10002835;;M;55;CHILENO;;Boomers;N/D;N/D;553950;5;4;0;0;0;5;4;553950;SMARTPHONE A03S 32 GB ROJO;TELEFONIA
16533085;;F;35;CHILENO;;Millenial;RENCA                         ;METROPOLITANA;111990;2;1;0;0;0;2;1;111990;CELULAR XIAOMI REDMI 9T TWILIGHT BLUE MOVISTAR;TELEFONIA
12294412;Casado;F;50;CHILENO;;X;PICHIDEGUA                    ;L.G.B.OÂ´HIGGINS;18990;1;1;0;0;0;1;1;18990;Celular SA3 CLARO DIRECTO BLACK;TELEFONIA
17825586;;M;34;CHILENO;;Millenial;PROVIDENCIA                   ;METROPOLITANA;784960;6;2;0;0;0;6;2;784960;CELULAR A52 128 GB BLACK OPEN;TELEFONIA
15486827;;M;48;CHILENO;;X;FREIRE                        ;ARAUCANIA;543961;5;2;0;0;0;5;2;543961;CELULAR REDMI NOTE 10S 128GB ONIX BLACK;TELEFONIA
9064294;Casado;M;55;CHILENO;CONTADOR AUDITOR;Boomers;RENCA                         ;METROPOLITANA;17990;1;1;0;0;0;1;1;17990;TELEFONO PP BINDU ENTEL;TELEFONIA
13594829;;F;44;CHILENO;;X;QUELLON                       ;LOS LAGOS;119990;1;1;0;0;0;1;1;119990;SMARTPHONE A03s 64 GB Red DS;TELEFONIA
16675830;;F;34;CHILENO;;Millenial;N/D;N/D;104990;2;1;0;0;0;2;1;104990;CELULAR A54 OPPO AZUL 128GB;TELEFONIA
12961101;;F;45;CHILENO;;X;PROVIDENCIA                   ;METROPOLITANA;264970;4;3;0;0;0;4;3;264970;CELULAR MOTO G20 EDICION ESPECIAL 4/128 GB VERDE;TELEFONIA
9505314;;M;59;CHILENO;;Boomers;VILLARICA                     ;ARAUCANIA;164980;2;2;0;0;0;2;2;164980;CELULAR A12 128GB Azul OPEN;TELEFONIA
13125657;;F;45;CHILENO;;X;N/D;N/D;179990;1;1;0;0;0;1;1;179990;CELULAR POCO X3 PRO 128G PHANTOM BLACK OPEN;TELEFONIA
11974383;;M;50;CHILENO;;X;PROVIDENCIA                   ;METROPOLITANA;17990;1;1;1;1;17990;0;0;0;CELULAR NOKIA 110 BLACK OPEN;TELEFONIA
18496223;;F;29;CHILENO;;Millenial;N/D;N/D;199970;3;3;0;0;0;3;3;199970;CELULAR XIAOMI REDMI 9A 2/32GB GRANITE GRAY;TELEFONIA
17682806;Soltero;F;31;CHILENO;;Millenial;PROVIDENCIA                   ;METROPOLITANA;56980;2;2;0;0;0;2;2;56980;CELULAR ALCATEL P1 DIRECTO CLARO BLACK;TELEFONIA
9280003;;F;58;CHILENO;;Boomers;RENCA                         ;METROPOLITANA;525970;3;1;0;0;0;3;1;525970;POCO X3 PRO 256 GB PHANTOM BLACK;TELEFONIA
15778745;;F;37;CHILENO;;Millenial;N/D;N/D;199990;1;1;0;0;0;1;1;199990;CELULAR POCO X3 PRO 128G PHANTOM BLACK OPEN;TELEFONIA
10038557;Casado;M;51;CHILENO;;X;RENCA                         ;METROPOLITANA;699990;2;1;0;0;0;2;1;699990;CELULAR SAMSUNG S21 FE 128GB LIGHT VIOLET OPEN;TELEFONIA
16635125;;F;34;CHILENO;;Millenial;PROVIDENCIA                   ;METROPOLITANA;219990;1;1;1;1;219990;0;0;0;Celular P40 LITE LIB OPEN GREEN;TELEFONIA
14497478;;F;47;CHILENO;;X;ALGARROBO                     ;VALPARAISO;120000;2;1;0;0;0;2;1;120000;CELULAR A12 128GB Rojo OPEN;TELEFONIA
10563858;;M;57;CHILENO;;Boomers;NANCAGUA                      ;L.G.B.OÂ´HIGGINS;2435880;12;3;0;0;0;12;3;2435880;CELULAR IPHONE 12 64GB BLACK CLARO;TELEFONIA
18085831;Soltero;M;30;CHILENO;;Millenial;PROVIDENCIA                   ;METROPOLITANA;103980;2;1;2;1;103980;0;0;0;CELULAR HUAWEI Y7P NEGRO ENTEL;TELEFONIA
15687290;;M;37;CHILENO;;Millenial;"";"";25980;2;1;0;0;0;2;1;25980;CELULAR NOKIA 110 BLACK OPEN;TELEFONIA
14913551;Soltero;F;46;CHILENO;;X;RENCA                         ;METROPOLITANA;285980;2;1;0;0;0;2;1;285980;CELULAR A32 128 GB BLACK OPEN;TELEFONIA
12146664;;F;42;CHILENO;;X;MEJILLONES                    ;ANTOFAGASTA;179990;1;1;0;0;0;1;1;179990;CELULAR POCO X3 PRO 128G PHANTOM BLACK OPEN;TELEFONIA
17665939;;F;31;CHILENO;;Millenial;N/D;N/D;1000;2;1;0;0;0;2;1;1000;CHIP OPEN ENTEL;TELEFONIA
14023870;;F;41;CHILENO;;X;PROVIDENCIA                   ;METROPOLITANA;267970;3;2;0;0;0;3;2;267970;CELULAR XIAOMI REDMI 9A 32GB GRANITE GRAY TRI WO;TELEFONIA
17489246;Soltero;M;31;CHILENO;TRABAJO SOCIAL;Millenial;PROVIDENCIA                   ;METROPOLITANA;133980;2;1;2;1;133980;0;0;0;CELULAR A12 128GB Negro OPEN;TELEFONIA
11533562;Casado;M;52;CHILENO;AGRONOMO;X;SAN CARLOS                    ;BIO BIO;139990;1;1;0;0;0;1;1;139990;XIAOMI REDMI 9T GRIS WOM 128 GB;TELEFONIA
7905502;;M;63;CHILENO;;Boomers;PROVIDENCIA                   ;METROPOLITANA;79990;2;1;0;0;0;2;1;79990;CELULAR A12 128GB Azul OPEN;TELEFONIA
11915205;;F;50;CHILENO;;X;CURANILAHUE                   ;BIO BIO;768950;5;4;0;0;0;5;4;768950;CELULAR SMARTPHONE A52S 5G BLACK 128GB;TELEFONIA
19972415;;M;23;CHILENO;;Z;PROVIDENCIA                   ;METROPOLITANA;299990;1;1;1;1;299990;0;0;0;CELULAR SMARTPHONE A52S 5G BLACK 128GB;TELEFONIA
12769012;;M;47;CHILENO;;X;LOS ANGELES                   ;BIO BIO;45670;2;1;0;0;0;2;1;45670;CELULAR BMOBILE BS30 BLACK OPEN;TELEFONIA
19109636;;F;26;CHILENO;;Z;TOME                          ;BIO BIO;151980;3;1;0;0;0;3;1;151980;CELULAR MOTO G20 EDICION ESPECIAL 4/128 GB AZUL;TELEFONIA
23173691;;M;29;NO INFORMA NACIONALIDAD;;Extranjero;ARICA                         ;ARICA Y PARINACOTA;230980;3;1;0;0;0;3;1;230980;VIVO Y53S DEEP SEA BLUE 128GB OPEN;TELEFONIA
19865331;;F;24;CHILENO;;Z;PROVIDENCIA                   ;METROPOLITANA;236960;4;3;3;2;206970;1;1;29990;CELULAR NOKIA 110 BLACK OPEN;TELEFONIA
17815211;;F;31;CHILENO;;Silencioso;PROVIDENCIA                   ;METROPOLITANA;25980;2;1;0;0;0;2;1;25980;CELULAR NOKIA 110 BLACK OPEN;TELEFONIA
14592482;;M;42;CHILENO;;X;"";"";99990;1;1;0;0;0;1;1;99990;CELULAR VIVO Y11S 32GB NEBULA BLUE OPEN;TELEFONIA
4450115;;F;80;CHILENO;;Silencioso;RENCA                         ;METROPOLITANA;31130;3;1;0;0;0;3;1;31130;Celular SA3 CLARO DIRECTO BLACK;TELEFONIA
18496679;;M;29;CHILENO;;Millenial;PROVIDENCIA                   ;METROPOLITANA;1299990;4;1;4;1;1299990;0;0;0;CELULAR GALAXY S22 ULTRA BLACK 128GB;TELEFONIA
16095842;Casado;M;37;CHILENO;INGENIERO;Millenial;PROVIDENCIA                   ;METROPOLITANA;244980;3;1;3;1;244980;0;0;0;CELULAR A12 128GB Rojo OPEN;TELEFONIA
20766562;;M;21;CHILENO;;Z;PROVIDENCIA                   ;METROPOLITANA;216980;2;1;2;1;216980;0;0;0;POCO X3 PRO 256 GB PHANTOM BLACK;TELEFONIA
11135841;;F;54;CHILENO;;Boomers;TALTAL                        ;ANTOFAGASTA;100980;2;1;0;0;0;2;1;100980;SMARTPHONE A03S 32 GB ROJO;TELEFONIA
18009905;;F;31;CHILENO;;Millenial;MONTE PATRIA                  ;COQUIMBO;172970;3;1;0;0;0;3;1;172970;CELULAR A12 128GB Azul OPEN;TELEFONIA
25475299;;F;26;PERUANO;;Extranjero;"";"";139990;2;1;0;0;0;2;1;139990;CELULAR REDMI NOTE 10S 128GB ONIX BLACK;TELEFONIA
12638029;;M;47;CHILENO;;X;PUENTE ALTO                   ;METROPOLITANA;129990;1;1;0;0;0;1;1;129990;CELULAR A12 128GB Negro OPEN;TELEFONIA
20565033;;F;21;CHILENO;;Z;PROVIDENCIA                   ;METROPOLITANA;39990;1;1;0;0;0;1;1;39990;CELULAR ALCATEL P1 DIRECTO CLARO BLACK;TELEFONIA
15866158;;M;38;CHILENO;;X;N/D;N/D;39990;1;1;0;0;0;1;1;39990;CELULAR NOKIA QUEEN VALUE BLACK CLARO;TELEFONIA
11809407;;F;50;CHILENO;;X;SAN IGNACIO                   ;BIO BIO;189980;2;2;0;0;0;2;2;189980;CELULAR A12 128GB Negro OPEN;TELEFONIA
7108603;Viudo;F;68;CHILENO;;Boomers;LA LIGUA                      ;VALPARAISO;62970;3;2;0;0;0;3;2;62970;Celular SA3 CLARO DIRECTO BLACK;TELEFONIA
9239956;;M;60;CHILENO;;Boomers;PAINE                         ;METROPOLITANA;170000;3;1;0;0;0;3;1;170000;CELULAR A12 128GB Azul OPEN;TELEFONIA
16440152;;F;35;CHILENO;;Millenial;ANCUD                         ;LOS LAGOS;219990;1;1;0;0;0;1;1;219990;POCO X3 PRO 256 GB PHANTOM BLACK;TELEFONIA
19132898;;M;26;CHILENO;;Z;COIHAIQUE                     ;AYSEN;191980;3;1;0;0;0;3;1;191980;CELULAR A12 128GB Azul OPEN;TELEFONIA
20320539;;F;22;CHILENO;;Z;PROVIDENCIA                   ;METROPOLITANA;109990;1;1;1;1;109990;0;0;0;SMARTPHONE A03S 64 GB NEGRO;TELEFONIA
11673376;;M;52;CHILENO;;X;SAN FERNANDO                  ;L.G.B.OÂ´HIGGINS;1462970;4;2;0;0;0;4;2;1462970;CELULAR XIAOMI REDMI 9A 32GB BLACK DIRECTO CLARO;TELEFONIA
17872561;;F;30;CHILENO;;Millenial;BUIN                          ;METROPOLITANA;79990;2;1;0;0;0;2;1;79990;CELULAR MOTO G20 EDICION ESPECIAL 4/128 GB VERDE;TELEFONIA
6097461;Soltero;M;73;CHILENO;;Silencioso;PROVIDENCIA                   ;METROPOLITANA;401980;2;1;2;1;401980;0;0;0;IPHONE XS 64GB PLATEADO OPEN;TELEFONIA
6157849;;F;70;CHILENO;;Silencioso;CASTRO                        ;LOS LAGOS;244950;5;2;0;0;0;5;2;244950;Celular SA3 CLARO DIRECTO BLACK;TELEFONIA
5512029;;F;70;CHILENO;;Silencioso;VINA DEL MAR                  ;VALPARAISO;39990;1;1;0;0;0;1;1;39990;CELULAR BMOBILE C40 CRIS OPEN;TELEFONIA
25305606;Soltero;M;41;VENEZOLANO;;Extranjero;PROVIDENCIA                   ;METROPOLITANA;223980;2;1;2;1;223980;0;0;0;CELULAR MOTO G60S 6/128 GB AZUL;TELEFONIA
15961677;Soltero;M;37;CHILENO;;Millenial;CAUQUENES                     ;MAULE;239980;3;2;0;0;0;3;2;239980;CELULAR A12 128GB Negro OPEN;TELEFONIA
7509075;;F;64;CHILENO;;Boomers;COIHAIQUE                     ;AYSEN;199990;1;1;0;0;0;1;1;199990;CELULAR A32 128 GB BLUE OPEN;TELEFONIA
10076894;;M;58;CHILENO;;Boomers;OVALLE                        ;COQUIMBO;139990;1;1;0;0;0;1;1;139990;CELULAR A12 128GB Rojo OPEN;TELEFONIA
18017491;;M;30;CHILENO;;Millenial;N/D;N/D;449970;3;3;0;0;0;3;3;449970;CELULAR MOTO G20 EDICION ESPECIAL 4/128 GB AZUL;TELEFONIA
12650150;;F;47;CHILENO;;X;SANTIAGO                      ;METROPOLITANA;1563840;14;6;13;5;1538850;1;1;24990;CELULAR IPHONE 12 64GB BLACK CLARO;TELEFONIA
14173534;;F;41;CHILENO;;X;PUENTE ALTO                   ;METROPOLITANA;299990;1;1;1;1;299990;0;0;0;CELULAR HUAWEI NOVA 8i BUNDLE;TELEFONIA
26070355;;M;47;EXTRANJERO - NO INFORMA NACIONALIDAD;;Extranjero;SANTIAGO;METROPOLITANA;415970;3;2;0;0;0;3;2;415970;CELULAR SMARTPHONE A52S 5G LIGHT GREEN 128GB;TELEFONIA
7153698;;M;66;CHILENO;;Boomers;ANTOFAGASTA                   ;ANTOFAGASTA;39991;2;1;0;0;0;2;1;39991;CELULAR BMOBILE C40 CRIS OPEN;TELEFONIA
6881367;;M;67;CHILENO;;Boomers;VALDIVIA                      ;LOS LAGOS;576940;6;3;0;0;0;6;3;576940;CELULAR VIVO Y21S PEARL WHITE 128 GB OPEN;TELEFONIA
25258940;Soltero;M;35;CHINO;;Extranjero;PROVIDENCIA                   ;METROPOLITANA;196970;3;3;0;0;0;3;3;196970;CELULAR VIVO Y11S PHANTON BLACK 32GB MOVISTAR;TELEFONIA
10722466;;F;54;CHILENO;;Boomers;VALLENAR;ATACAMA;119990;1;1;0;0;0;1;1;119990;Celular XIAOMI REDMI 9 64 GB DIRECTO CLARO NEGRO;TELEFONIA
11252726;Casado;M;54;CHILENO;;X;NATALES                       ;MAGALLANES;127980;2;1;0;0;0;2;1;127980;CELULAR VIVO Y11S 32 GB NEBULA BLUE WOM;TELEFONIA
12786541;Soltero;F;48;CHILENO;;X;RENCA                         ;METROPOLITANA;14990;1;1;0;0;0;1;1;14990;CELULAR AZUMI L4G BLACK CLARO;TELEFONIA
6616117;;M;69;CHILENO;;Silencioso;LA PINTANA                    ;METROPOLITANA;189990;1;1;0;0;0;1;1;189990;SMARTPHONE A22 VERDE 128GB;TELEFONIA
7391961;;F;67;CHILENO;;Boomers;SAN ANTONIO                   ;VALPARAISO;129990;1;3;0;0;0;1;3;129990;CELULAR A12 128GB Azul OPEN;TELEFONIA
16051500;;M;36;CHILENO;;Millenial;N/D;N/D;1908620;11;6;0;0;0;11;6;1908620;CELULAR IPHONE 12 128GB WHITE CLARO;TELEFONIA
13085193;;F;45;CHILENO;;X;QUILPUE                       ;VALPARAISO;319970;4;2;2;1;199980;2;1;119990;CELULAR MOTOROLA G30 GRIS WOM 128 GB;TELEFONIA
24125007;;M;34;BOLIVIANO;;Extranjero;ESTACION CENTRAL              ;METROPOLITANA;739980;2;2;0;0;0;2;2;739980;CELULAR XIAOMI 11T PRO 8/256GB METEORITE GRAY;TELEFONIA
26099114;;M;26;HAITIANO;;Extranjero;N/D;N/D;309980;3;2;0;0;0;3;2;309980;MOTO EDGE 20 LITE 6/128GB GRIS;TELEFONIA
7048150;;M;63;CHILENO;;Boomers;RENGO                         ;L.G.B.OÂ´HIGGINS;161980;2;1;0;0;0;2;1;161980;CELULAR A12 128GB Azul OPEN;TELEFONIA
7929235;;M;62;CHILENO;;Boomers;LOS LAGOS                     ;LOS LAGOS;156990;3;1;0;0;0;3;1;156990;CELULAR A12 128GB Azul OPEN;TELEFONIA
18334538;;F;29;CHILENO;;Millenial;RENGO                         ;L.G.B.OÂ´HIGGINS;255951;6;3;0;0;0;6;3;255951;SMARTPHONE A03S 32 GB ROJO;TELEFONIA
19059757;;F;25;CHILENO;;Z;CAUQUENES                     ;MAULE;369980;2;2;1;1;269990;1;1;99990;CELULAR SMARTPHONE A52S 5G LIGHT VIOLET 128GB;TELEFONIA
17740692;Soltero;F;31;CHILENO;CIRUJANO DENTISTA;Millenial;PROVIDENCIA                   ;METROPOLITANA;109990;2;1;2;1;109990;0;0;0;CELULAR HUAWEI Y7P NEGRO ENTEL;TELEFONIA
8608247;;F;61;CHILENO;;Boomers;PROVIDENCIA                   ;METROPOLITANA;189990;1;1;0;0;0;1;1;189990;CELULAR REDMI NOTE 10S 128GB ONIX BLACK;TELEFONIA
16409951;;F;35;CHILENO;;Millenial;SAN CARLOS                    ;BIO BIO;229471;4;2;0;0;0;4;2;229471;CELULAR VIVO Y11S 32GB NEBULA BLUE OPEN;TELEFONIA
18735845;;M;27;CHILENO;;Millenial;PUERTO MONTT                  ;LOS LAGOS;219990;1;1;0;0;0;1;1;219990;CELULAR VIVO Y53S FANTASTIC RAINBOW 128GB OPEN;TELEFONIA
11806616;Casado;M;51;CHILENO;;X;PROVIDENCIA                   ;METROPOLITANA;119990;1;1;0;0;0;1;1;119990;CELULAR VIVO Y11S 32GB NEBULA BLUE OPEN;TELEFONIA
13758829;;F;42;CHILENO;;X;PROVIDENCIA                   ;METROPOLITANA;268970;3;2;2;1;223980;1;1;44990;CELULAR MI 11 LITE 128GB BOBA BLACK OPEN;TELEFONIA
7409651;Viudo;M;65;CHILENO;PROFESOR;Boomers;OSORNO                        ;LOS LAGOS;143980;2;1;2;1;143980;0;0;0;CELULAR REDMI 9T 128 GB OCEAN GREEN;TELEFONIA
9341518;;M;56;CHILENO;;Boomers;RENCA                         ;METROPOLITANA;139991;2;1;0;0;0;2;1;139991;SMARTPHONE A03S 64 GB S/SIM NEGRO;TELEFONIA
8568093;;M;50;CHILENO;;Extranjero;"";"";149990;1;1;0;0;0;1;1;149990;CELULAR REDMI NOTE 10 EU 64GB ONIX GRAY OPEN;TELEFONIA
8665063;;M;63;CHILENO;;Millenial;N/D;N/D;79990;1;1;1;1;79990;0;0;0;CELULAR REDMI 9A 32GB PEACOCK GREEN;TELEFONIA
25109272;;M;29;PERUANO;;Extranjero;N/D;N/D;137980;3;2;0;0;0;3;2;137980;CELULAR MOTO G30 128GB GRIS TORNASOL OPEN;TELEFONIA
15463148;;F;39;CHILENO;;X;LO ESPEJO                     ;METROPOLITANA;119990;1;1;0;0;0;1;1;119990;CELULAR Moto G20 Blue WOM;TELEFONIA
15541102;;F;39;CHILENO;;X;PARRAL                        ;MAULE;589980;2;2;0;0;0;2;2;589980;CELULAR XIAOMI 11T 8/256GB CELESTIAL BLUE OPEN;TELEFONIA
17535047;;M;35;CHILENO;;Millenial;PROVIDENCIA                   ;METROPOLITANA;1189980;2;1;0;0;0;2;1;1189980;Celular Galaxy S21 Ultra Phantom Black 128GB;TELEFONIA
16811273;;M;33;CHILENO;;Millenial;CHONCHI                       ;LOS LAGOS;179990;1;1;0;0;0;1;1;179990;CELULAR MOTO G20 EDICION ESPECIAL 4/128 GB AZUL;TELEFONIA
17019162;;M;36;CHILENO;;Millenial;ANTOFAGASTA                   ;ANTOFAGASTA;489980;2;2;0;0;0;2;2;489980;CELULAR VIVO V20 SUNSET MELODY OPEN;TELEFONIA
18016728;Soltero;F;30;CHILENO;;Millenial;ANCUD                         ;LOS LAGOS;666930;7;3;0;0;0;7;3;666930;CELULAR A32 128 GB LIGHT VIOLET OPEN;TELEFONIA
26164983;Soltero;M;34;HAITIANO;;Extranjero;SAN BERNARDO                  ;METROPOLITANA;465210;7;2;0;0;0;7;2;465210;CELULAR SMARTPHONE A52S 5G BLACK 128GB;TELEFONIA
24116121;Soltero;M;36;BOLIVIANO;;Extranjero;ANTOFAGASTA                   ;ANTOFAGASTA;309990;1;1;0;0;0;1;1;309990;CELULAR SMARTPHONE A52S 5G BLACK 128GB;TELEFONIA
12143469;;F;51;CHILENO;;X;"";"";697980;2;1;0;0;0;2;1;697980;Celular Galaxy S21 Plus Phantom Black 128GB;TELEFONIA
15459140;;F;39;CHILENO;;Millenial;N/D;N/D;79990;1;1;1;1;79990;0;0;0;CELULAR CLARO MOTOROLA E7 32GB GRIS;TELEFONIA
17101533;;F;33;CHILENO;;Millenial;"";"";312970;5;2;0;0;0;5;2;312970;VIVO Y53S DEEP SEA BLUE 128GB OPEN;TELEFONIA
18590246;;M;28;CHILENO;;Millenial;N/D;N/D;191980;2;1;0;0;0;2;1;191980;CELULAR MOTOROLA G20 64GB BLUE CLARO;TELEFONIA
24688851;;M;48;CUBANO;;Extranjero;"";"";156980;2;1;0;0;0;2;1;156980;SMARTPHONE A03S NEGRO 32GB;TELEFONIA
13147449;;M;45;CHILENO;;X;PROVIDENCIA                   ;METROPOLITANA;119990;1;1;0;0;0;1;1;119990;CELULAR VIVO Y11S 32GB NEBULA BLUE OPEN;TELEFONIA
14622430;;F;43;CHILENO;;X;VINA DEL MAR                  ;VALPARAISO;299990;1;1;0;0;0;1;1;299990;CELULAR IPHONE SE 64GB DIRECTO CLARO;TELEFONIA
18864077;Soltero;M;26;CHILENO;;Z;PROVIDENCIA                   ;METROPOLITANA;0;0;2;0;0;0;0;2;0;KIT PACK OPEN RETAIL 4G TELEFONICA;TELEFONIA
25287370;;M;47;DOMINICANO;;Extranjero;PROVIDENCIA                   ;METROPOLITANA;214980;3;2;0;0;0;3;2;214980;CELULAR MOTOROLA G20 64GB BLUE CLARO;TELEFONIA
17371351;;F;32;CHILENO;;Millenial;N/D;N/D;166981;3;1;0;0;0;3;1;166981;CELULAR A12 128GB Azul OPEN;TELEFONIA
15907800;;F;37;CHILENO;;Millenial;RECOLETA                      ;METROPOLITANA;519970;3;2;0;0;0;3;2;519970;Celular XIAOMI REDMI 9 64 GB DIRECTO CLARO NEGRO;TELEFONIA
25757468;;F;47;EXTRANJERO - NO INFORMA NACIONALIDAD;;X;RECOLETA                      ;METROPOLITANA;194980;3;2;0;0;0;3;2;194980;CELULAR MOTO G30 GRIS TORNASOL 128GB MOVISTAR;TELEFONIA
25288019;Soltero;F;34;BOLIVIANO;;Extranjero;PROVIDENCIA                   ;METROPOLITANA;139980;2;2;0;0;0;2;2;139980;CELULAR VIVO Y11S 32GB NEBULA BLUE OPEN;TELEFONIA
18466334;Soltero;F;28;CHILENO;;Millenial;PROVIDENCIA                   ;METROPOLITANA;229990;1;1;1;1;229990;0;0;0;CELULAR REDMI NOTE 10S 128GB ONIX BLACK;TELEFONIA
14029568;;M;40;CHILENO;;X;"";"";269990;1;1;1;1;269990;0;0;0;CELULAR SMARTPHONE A52S 5G BLACK 128GB;TELEFONIA
6016886;;M;73;CHILENO;;Silencioso;N/D;N/D;259990;1;1;0;0;0;1;1;259990;POCO X3 PRO 256 GB PHANTOM BLACK;TELEFONIA
20157920;;F;23;CHILENO;;Z;PROVIDENCIA                   ;METROPOLITANA;169990;1;1;0;0;0;1;1;169990;SMARTHPHONE REDMI 10 US 64GB SEA BLUE;TELEFONIA
13386838;Casado;F;44;CHILENO;CONTADOR GENERAL;X;N/D;N/D;0;0;2;0;2;0;0;0;0;CELULAR MOTO ONE FUSION 128GB AZUL OPEN;TELEFONIA
17659828;;F;30;CHILENO;;Millenial;OSORNO                        ;LOS LAGOS;119990;1;1;1;1;119990;0;0;0;CELULAR MOTOROLA G9 PLAY 64GB ELECTRIC BLUE OPEN;TELEFONIA
18199743;;M;29;CHILENO;;Millenial;"";"";339980;2;2;2;2;339980;0;0;0;MOTO G30 LILA PASTEL 128GB MOVISTAR;TELEFONIA
17912945;;F;30;CHILENO;;Millenial;"";"";269990;1;1;0;0;0;1;1;269990;SMARTPHONE A52S 5G WHITE 128GB;TELEFONIA
15254362;;F;41;CHILENO;;X;VILLARICA                     ;ARAUCANIA;129990;1;1;0;0;0;1;1;129990;CELULAR A12 128GB Rojo OPEN;TELEFONIA
16704997;;M;34;CHILENO;;Millenial;N/D;N/D;399280;4;2;4;2;399280;0;0;0;IPHONE 8 64 GB LIB OPEN PLATEADO;TELEFONIA
20087960;;M;22;CHILENO;;Z;"";"";990;1;1;0;0;0;1;1;990;CHIP OPEN ENTEL;TELEFONIA
16449774;;M;36;CHILENO;;Millenial;"";"";189990;1;1;0;0;0;1;1;189990;CELULAR VIVO Y21S PEARL WHITE 128 GB OPEN;TELEFONIA
15108610;;F;40;CHILENO;;X;N/D;N/D;156980;2;1;0;0;0;2;1;156980;CELULAR MOTOROLA E30 GRIS CLARO;TELEFONIA
20118192;;M;23;CHILENO;;Millenial;"";"";299990;1;1;1;1;299990;0;0;0;CELULAR POCO F3 128 GB NIGHT BLACK;TELEFONIA
17834273;;F;31;CHILENO;;Millenial;N/D;N/D;176981;3;1;0;0;0;3;1;176981;CELULAR A12 128GB Negro OPEN;TELEFONIA
26779869;;M;53;VENEZOLANO;;Extranjero;CONCHALI                      ;METROPOLITANA;223980;2;1;2;1;223980;0;0;0;POCO X3 PRO 256 GB PHANTOM BLACK;TELEFONIA
13778133;Soltero;F;42;CHILENO;;X;PROVIDENCIA                   ;METROPOLITANA;169970;3;2;0;0;0;3;2;169970;CELULAR CLARO MOTOROLA E7 32GB GRIS;TELEFONIA
10839489;;M;53;CHILENO;;X;VALLENAR;ATACAMA;517950;5;2;0;0;0;5;2;517950;CELULAR REDMI NOTE 10S 128GB ONIX BLACK;TELEFONIA
16167659;;F;36;CHILENO;;Millenial;N/D;N/D;1466940;6;4;0;0;0;6;4;1466940;IPHONE 11 64GB BLACK CLARO;TELEFONIA
18576367;;F;28;CHILENO;;Millenial;PROVIDENCIA                   ;METROPOLITANA;114990;2;1;0;0;0;2;1;114990;CELULAR MOTOROLA G20 64GB BLUE CLARO;TELEFONIA
15611334;;M;39;CHILENO;;X;N/D;N/D;614980;2;2;0;0;0;2;2;614980;Celular Galaxy S21 Phantom Grey 128GB;TELEFONIA
16701310;Soltero;F;35;CHILENO;TECNICO DE NIVEL SUPERIOR EN ENFERMERIA;Millenial;RENCA                         ;METROPOLITANA;39990;1;1;0;0;0;1;1;39990;CELULAR BMOBILE C40 CRIS OPEN;TELEFONIA
10187253;;M;56;CHILENO;;Boomers;PAPUDO                        ;VALPARAISO;229990;1;1;0;0;0;1;1;229990;CELULAR REDMI NOTE 10S 128GB PEBBLE WHITE;TELEFONIA
16284764;Soltero;F;35;CHILENO;TECNICO LABORATORISTA DENTAL;Millenial;PROVIDENCIA                   ;METROPOLITANA;176980;2;1;0;0;0;2;1;176980;CELULAR MOTO G20 64GB ROSA FLAMINGO OPEN;TELEFONIA
18290552;;F;30;CHILENO;;Millenial;TEMUCO;ARAUCANIA;186980;2;1;2;1;186980;0;0;0;CELULAR A32 128 GB LIGHT VIOLET OPEN;TELEFONIA
12914829;Divorciado;M;46;CHILENO;;X;PROVIDENCIA                   ;METROPOLITANA;799990;1;1;1;1;799990;0;0;0;Celular Galaxy S21 Ultra Phantom Silver 128GB;TELEFONIA
22336083;;M;52;PERUANO;;Extranjero;COLINA;METROPOLITANA;249990;1;1;0;0;0;1;1;249990;POCO X3 PRO 256 GB METAL BRONCE;TELEFONIA
13283744;;M;46;CHILENO;;X;PROVIDENCIA                   ;METROPOLITANA;279980;2;1;0;0;0;2;1;279980;CELULAR A12 128GB Negro OPEN;TELEFONIA
12726442;;F;47;CHILENO;;X;LAS CABRAS                    ;L.G.B.OÂ´HIGGINS;144540;2;1;2;1;144540;0;0;0;CELULAR A12 128GB Rojo OPEN;TELEFONIA
14104063;;F;41;CHILENO;;X;RENCA                         ;METROPOLITANA;561540;2;1;2;1;561540;0;0;0;CELULAR XIAOMI 11T PRO 8/256GB METEORITE GRAY;TELEFONIA
13480966;;F;44;CHILENO;;X;PUENTE ALTO                   ;METROPOLITANA;139990;1;1;0;0;0;1;1;139990;SMARTPHONE A03S 64 GB NEGRO;TELEFONIA
17269050;;F;32;CHILENO;;Millenial;MAIPU                         ;METROPOLITANA;533980;2;1;2;1;533980;0;0;0;CELULAR XIAOMI 11T PRO 8/256GB METEORITE GRAY;TELEFONIA
10789936;;F;55;CHILENO;;Boomers;"";"";117980;2;1;0;0;0;2;1;117980;CELULAR REDMI 9A 32GB PEACOCK GREEN;TELEFONIA
18657370;;M;27;CHILENO;;Millenial;N/D;N/D;678340;5;2;0;0;0;5;2;678340;Celular P40 LITE LIB OPEN BLACK;TELEFONIA
10108112;;M;57;CHILENO;;Boomers;PUERTO MONTT                  ;LOS LAGOS;202980;2;1;0;0;0;2;1;202980;CELULAR MOTOROLA G30 GRIS WOM 128 GB;TELEFONIA
16405632;;F;35;CHILENO;;Millenial;QUILLON                       ;BIO BIO;79980;4;1;0;0;0;4;1;79980;CELULAR XIAOMI REDMI 9A 32GB GRANITE GRAY TRI WO;TELEFONIA
26944734;;F;58;EXTRANJERO - NO INFORMA NACIONALIDAD;;Extranjero;CHILLAN                       ;BIO BIO;119990;1;1;0;0;0;1;1;119990;Celular XIAOMI REDMI 9 64 GB DIRECTO CLARO NEGRO;TELEFONIA
12736883;;F;48;CHILENO;;X;LUMACO                        ;ARAUCANIA;179990;1;1;0;0;0;1;1;179990;POCO X3 PRO US 128G METAL BRONZE;TELEFONIA
13972254;;M;41;CHILENO;;X;CONCEPCION                    ;BIO BIO;18980;2;2;1;1;17990;1;1;990;CHIP OPEN ENTEL;TELEFONIA
20144056;;F;23;CHILENO;;Z;N/D;N/D;259991;2;1;0;0;0;2;1;259991;CELULAR MI 11 LITE 128GB BUBBLEGUM BLUE;TELEFONIA
23463730;Soltero;M;49;PERUANO;;Extranjero;PROVIDENCIA                   ;METROPOLITANA;79990;1;1;0;0;0;1;1;79990;CELULAR XIAOMI REDMI 9A 32GB GRANITE GRAY TRI WO;TELEFONIA
22618317;;F;39;BOLIVIANO;;Extranjero;ARICA                         ;ARICA Y PARINACOTA;384980;4;2;0;0;0;4;2;384980;CELULAR XIAOMI 11 LITE 5G NE 8/128GB TRUFFLE BLA;TELEFONIA
26451732;;M;39;EXTRANJERO - NO INFORMA NACIONALIDAD;;Extranjero;TALCA                         ;MAULE;1143950;5;1;0;0;0;5;1;1143950;Celular Galaxy S21 Plus Phantom Black 128GB;TELEFONIA
17827183;;M;31;CHILENO;;Millenial;LOS LAGOS                     ;LOS LAGOS;239990;1;3;0;0;0;1;3;239990;CELULAR POCO X3 PRO 256 GB FROST BLUE;TELEFONIA
12774161;;M;46;CHILENO;;X;CABILDO                       ;VALPARAISO;228980;2;1;0;0;0;2;1;228980;CELULAR A32 128 GB LIGHT VIOLET OPEN;TELEFONIA
17030637;;F;33;CHILENO;;Millenial;"";"";163980;2;1;2;1;163980;0;0;0;REDMI 10 US 128GB Carbon Gray;TELEFONIA
13644838;;M;42;CHILENO;;X;ALTO HOSPICIO;TARAPACA;159991;2;1;0;0;0;2;1;159991;SMARTHPHONE REDMI 10 US 64GB SEA BLUE;TELEFONIA
7759593;;F;66;CHILENO;;Boomers;COIHAIQUE                     ;AYSEN;129990;1;1;0;0;0;1;1;129990;SMARTPHONE A03S AZUL 32GB;TELEFONIA
9073112;;M;60;CHILENO;;Boomers;PROVIDENCIA                   ;METROPOLITANA;209990;1;1;0;0;0;1;1;209990;POCO X3 PRO US 128G METAL BRONZE;TELEFONIA
5009797;;M;73;CHILENO;;Silencioso;RENCA                         ;METROPOLITANA;26980;2;1;0;0;0;2;1;26980;Celular AL3 CLARO DIRECTO NEGRO;TELEFONIA
18586794;;F;28;CHILENO;;Silencioso;VICTORIA                      ;ARAUCANIA;574960;5;4;0;0;0;5;4;574960;CELULAR REDMI 9T 128GB SUNRISE ORANGE MOVISTAR;TELEFONIA
11335894;Soltero;F;56;CHILENO;;Boomers;PROVIDENCIA                   ;METROPOLITANA;119990;1;1;0;0;0;1;1;119990;SMARTPHONE A03S AZUL 32GB;TELEFONIA
16773563;;F;34;CHILENO;;Millenial;LA SERENA                     ;COQUIMBO;119990;1;1;0;0;0;1;1;119990;Celular XIAOMI REDMI 9 64 GB DIRECTO CLARO NEGRO;TELEFONIA
7292809;;F;70;CHILENO;;Silencioso;PANQUEHUE                     ;VALPARAISO;233980;2;1;0;0;0;2;1;233980;CELULAR XIAOMI REDMI 9T TWILIGHT BLUE MOVISTAR;TELEFONIA
17323227;;F;32;CHILENO;;Millenial;PROVIDENCIA                   ;METROPOLITANA;99970;3;2;0;0;0;3;2;99970;Celular Y6P WOM TRIANGULADO NEGRO;TELEFONIA
17532600;;F;31;CHILENO;;Millenial;OSORNO                        ;LOS LAGOS;99990;1;1;0;0;0;1;1;99990;CELULAR VIVO Y11S 32GB NEBULA BLUE OPEN;TELEFONIA
12218620;Casado;F;50;CHILENO;;X;N/D;N/D;339980;2;2;2;2;339980;0;0;0;POCO X3 PRO 256 GB PHANTOM BLACK;TELEFONIA
13202455;;M;45;CHILENO;;X;PUMANQUE                      ;L.G.B.OÂ´HIGGINS;181980;2;1;0;0;0;2;1;181980;SMARTPHONE A03S NEGRO 32GB;TELEFONIA
5845582;;F;73;CHILENO;;Silencioso;COLINA                        ;METROPOLITANA;129990;1;1;0;0;0;1;1;129990;SMARTPHONE A03S AZUL 32GB;TELEFONIA
13476139;;F;44;CHILENO;;X;N/D;N/D;139990;1;1;0;0;0;1;1;139990;SMARTPHONE A03S 64 GB NEGRO;TELEFONIA
19873242;;F;24;CHILENO;;Z;PROVIDENCIA                   ;METROPOLITANA;153980;2;1;2;1;153980;0;0;0;CELULAR REDMI 9T 128 GB OCEAN GREEN;TELEFONIA
9629935;Soltero;M;44;CHILENO;;X;RANCAGUA                      ;L.G.B.OÂ´HIGGINS;518960;4;1;0;0;0;4;1;518960;CELULAR MOTO G30 128GB GRIS TORNASOL OPEN;TELEFONIA
8569349;;M;68;CHILENO;;Silencioso;PROVIDENCIA                   ;METROPOLITANA;139990;1;1;0;0;0;1;1;139990;CELULAR A12 128GB Negro OPEN;TELEFONIA
6819933;Soltero;F;67;CHILENO;;Boomers;RENCA                         ;METROPOLITANA;149991;2;1;0;0;0;2;1;149991;CELULAR VIVO Y20S NEBULA 128 GB BLUE OPEN;TELEFONIA
9018257;;M;61;CHILENO;;Boomers;QUILICURA                     ;METROPOLITANA;154980;2;1;0;0;0;2;1;154980;VIVO Y20 OBSIDIAN BLACK OPEN;TELEFONIA
20293666;;F;21;CHILENO;;Z;PUERTO MONTT                  ;LOS LAGOS;301980;2;2;0;0;0;2;2;301980;CELULAR SMARTPHONE A52S 5G BLACK 128GB;TELEFONIA
6002842;;F;70;CHILENO;;Silencioso;RETIRO                        ;MAULE;149990;1;1;0;0;0;1;1;149990;SMARTPHONE A03S 64 GB S/SIM NEGRO;TELEFONIA
19615843;;M;23;CHILENO;;Silencioso;PROVIDENCIA                   ;METROPOLITANA;279990;1;1;1;1;279990;0;0;0;CELULAR SMARTPHONE A52S 5G BLACK 128GB;TELEFONIA
16729046;;M;34;CHILENO;;Millenial;RENCA                         ;METROPOLITANA;145980;2;1;0;0;0;2;1;145980;CELULAR VIVO Y11s PHANTOM BLACK ENTEL DIRECTO;TELEFONIA
9611546;;F;57;CHILENO;;Boomers;N/D;N/D;373650;4;2;0;0;0;4;2;373650;CELULAR REDMI NOTE 10S 128GB PEBBLE WHITE;TELEFONIA
9598562;;F;59;CHILENO;;Boomers;N/D;N/D;560930;7;7;0;0;0;7;7;560930;CELULAR XIAOMI REDMI 9T TWILIGHT BLUE MOVISTAR;TELEFONIA
19093500;Soltero;F;27;CHILENO;;Z;CERRO NAVIA;METROPOLITANA;134990;1;1;0;0;0;1;1;134990;CELULAR MOTO G20 EDICION ESPECIAL 4/128 GB VERDE;TELEFONIA
19614614;;F;24;CHILENO;;Z;PROVIDENCIA                   ;METROPOLITANA;279990;1;1;1;1;279990;0;0;0;CELULAR SMARTPHONE A52S 5G BLACK 128GB;TELEFONIA
18448326;;F;28;CHILENO;;Millenial;N/D;N/D;1629940;6;5;0;0;0;6;5;1629940;CELULAR XIAOMI 11T 8/256GB MOONLIGHT WHITE KIT;TELEFONIA
9922237;;M;55;CHILENO;;Boomers;COIHAIQUE                     ;AYSEN;140140;2;1;0;0;0;2;1;140140;CELULAR MOTO G30 128GB LILA PASTEL OPEN;TELEFONIA
16530882;;M;37;CHILENO;;Millenial;NAVIDAD                       ;L.G.B.OÂ´HIGGINS;249990;1;1;0;0;0;1;1;249990;CELULAR SMARTPHONE A52S 5G BLACK 128GB;TELEFONIA
16405342;;M;36;CHILENO;;Millenial;RENCA                         ;METROPOLITANA;803980;2;1;2;1;803980;0;0;0;Celular Galaxy S21 Ultra Phantom Black 128GB;TELEFONIA
8313351;Casado;M;60;CHILENO;MECANICO AUTOMOTRIZ EN MAQUINARIA PESADA;Boomers;PROVIDENCIA                   ;METROPOLITANA;929960;4;2;4;2;929960;0;0;0;CELULAR IPHONE 12 PRO MAX 128GB AZUL CLARO;TELEFONIA
10298661;;F;59;CHILENO;;Boomers;"";"";990;1;1;0;0;0;1;1;990;CHIP OPEN ENTEL;TELEFONIA
11604064;;M;51;CHILENO;;X;ARICA                         ;TARAPACA;354990;2;1;0;0;0;2;1;354990;CELULAR GALAXY S20FE 128GB CLOUD LAVENDER OPEN;TELEFONIA
11411004;;M;53;CHILENO;;X;VALDIVIA                      ;LOS LAGOS;167970;4;1;0;0;0;4;1;167970;CELULAR MOTOROLA MOTO G20 64GB ROSA FLAMINGO;TELEFONIA
17645264;;F;30;CHILENO;;Millenial;VALLENAR;ATACAMA;129990;1;1;0;0;0;1;1;129990;CELULAR HUAWEI Y7P NEGRO ENTEL;TELEFONIA
17321753;;M;33;CHILENO;;Millenial;PROVIDENCIA                   ;METROPOLITANA;828960;4;2;4;2;828960;0;0;0;Celular Galaxy S21 Phantom White 128GB;TELEFONIA
16462528;;F;35;CHILENO;;Millenial;PARRAL                        ;MAULE;189980;2;2;0;0;0;2;2;189980;CELULAR VIVO Y11S PHANTON BLACK 32GB MOVISTAR;TELEFONIA
17986939;;M;30;CHILENO;;Millenial;"";"";705480;2;1;2;1;705480;0;0;0;CELULAR IPHONE 12 128GB WHITE CLARO;TELEFONIA
23937248;;F;52;HAITIANO;;Extranjero;TALCA                         ;MAULE;534520;5;3;0;0;0;5;3;534520;CELULAR VIVO Y21S PEARL WHITE 128 GB OPEN;TELEFONIA
16423661;Soltero;M;35;CHILENO;;Silencioso;PROVIDENCIA                   ;METROPOLITANA;149990;1;1;0;0;0;1;1;149990;CELULAR MOTO G30 128GB GRIS TORNASOL OPEN;TELEFONIA
16561585;;M;35;CHILENO;;Millenial;N/D;N/D;429980;2;2;0;0;0;2;2;429980;CELULAR SMARTPHONE A52S 5G LIGHT GREEN 128GB;TELEFONIA
8366520;Casado;F;64;CHILENO;;Boomers;RENCA                         ;METROPOLITANA;239990;1;1;0;0;0;1;1;239990;CELULAR POCO X3 PRO 256 GB FROST BLUE;TELEFONIA
17152078;;F;34;CHILENO;;Millenial;"";"";261932;8;2;0;0;0;8;2;261932;CELULAR MOTO G30 128GB GRIS TORNASOL OPEN;TELEFONIA
12588943;;M;48;CHILENO;;Silencioso;PROVIDENCIA                   ;METROPOLITANA;261970;3;2;0;0;0;3;2;261970;CELULAR VIVO Y20S NEBULA 128 GB BLUE OPEN;TELEFONIA
24687550;;F;29;COLOMBIANO;;Extranjero;CALDERA                       ;ATACAMA;169990;1;1;0;0;0;1;1;169990;CELULAR MOTO G30 128GB LILA PASTEL OPEN;TELEFONIA
9882089;;F;57;CHILENO;;Boomers;HUALPEN;BIO BIO;189990;1;1;0;0;0;1;1;189990;CELULAR A32 128 GB LIGHT VIOLET OPEN;TELEFONIA
9370684;;F;60;CHILENO;;Boomers;PUDAHUEL                      ;METROPOLITANA;131980;3;1;0;0;0;3;1;131980;CELULAR Xiaomi Redmi 9 64 GB Morado WOM;TELEFONIA
17364691;;F;32;CHILENO;;Millenial;LA SERENA                     ;COQUIMBO;799990;1;1;0;0;0;1;1;799990;IPHONE 12 128GB BLACK CLARO;TELEFONIA
16060277;;F;37;CHILENO;;Millenial;LOS ANGELES                   ;BIO BIO;149990;1;1;1;1;149990;0;0;0;CELULAR XIAOMI REDMI 9T 128GB BLACK CLARO;TELEFONIA
18812832;;F;28;CHILENO;;Millenial;N/D;N/D;333950;7;4;0;0;0;7;4;333950;CELULAR MOTOROLA MOTO G20 64GB ROSA FLAMINGO;TELEFONIA
13393554;;F;44;CHILENO;;X;CANETE                        ;BIO BIO;329930;7;4;0;0;0;7;4;329930;CELULAR AZUMI L4G BLACK CLARO;TELEFONIA
17107183;;F;33;CHILENO;;Millenial;PENALOLEN                     ;METROPOLITANA;525920;8;4;8;4;525920;0;0;0;VIVO Y20 OBSIDIAN BLACK OPEN;TELEFONIA
18967736;;F;26;CHILENO;;Z;N/D;N/D;176980;2;1;0;0;0;2;1;176980;CELULAR A12 128GB Azul OPEN;TELEFONIA
18284198;;F;29;CHILENO;;Millenial;PADRE LAS CASAS               ;ARAUCANIA;174990;2;1;0;0;0;2;1;174990;CELULAR VIVO Y53S FANTASTIC RAINBOW 128GB OPEN;TELEFONIA
18901560;;M;28;CHILENO;;Millenial;TEMUCO                        ;ARAUCANIA;280970;3;2;0;0;0;3;2;280970;CELULAR A32 128 GB LIGHT VIOLET OPEN;TELEFONIA
19210301;;F;26;CHILENO;;Z;RENGO                         ;L.G.B.OÂ´HIGGINS;296970;4;3;0;0;0;4;3;296970;CELULAR MOTO G20 EDICION ESPECIAL 4/128 GB AZUL;TELEFONIA
10959524;;F;54;CHILENO;;X;PARRAL                        ;MAULE;243980;2;1;0;0;0;2;1;243980;CELULAR A32 128 GB LIGHT VIOLET OPEN;TELEFONIA
18469643;;M;29;CHILENO;;Millenial;N/D;N/D;89990;1;2;0;0;0;1;2;89990;CELULAR CLARO MOTOROLA E7 32GB GRIS;TELEFONIA
19718716;;F;24;CHILENO;;Z;LINARES                       ;MAULE;109990;2;2;0;0;0;2;2;109990;CELULAR MOTO G30 128GB LILA PASTEL OPEN;TELEFONIA
11312101;;M;54;CHILENO;;X;SAN CLEMENTE                  ;MAULE;169990;1;1;0;0;0;1;1;169990;CELULAR A54 OPPO NEGRO 128GB;TELEFONIA
14211321;;F;41;CHILENO;;X;PENCO                         ;BIO BIO;417650;4;2;0;0;0;4;2;417650;CELULAR A12 128GB Azul OPEN;TELEFONIA
20342835;;F;26;CHILENO;;Z;N/D;N/D;118970;3;1;0;0;0;3;1;118970;CELULAR VIVO Y11S PHANTON BLACK 32GB MOVISTAR;TELEFONIA
9480592;;F;61;CHILENO;;Boomers;MELIPILLA                     ;METROPOLITANA;593380;4;2;0;0;0;4;2;593380;CELULAR SMARTPHONE A52S 5G LIGHT VIOLET 128GB;TELEFONIA
17819208;;M;30;CHILENO;;Millenial;PROVIDENCIA                   ;METROPOLITANA;189990;1;1;1;1;189990;0;0;0;CELULAR A32 128 GB LIGHT VIOLET OPEN;TELEFONIA
13204410;;F;45;CHILENO;;X;RENCA                         ;METROPOLITANA;55980;2;2;0;0;0;2;2;55980;CELULAR NOKIA 225 4G BLACK MOVISTAR DIRECTO;TELEFONIA
11940313;;F;50;CHILENO;;X;SAN FABIAN                    ;BIO BIO;298950;5;2;0;0;0;5;2;298950;CELULAR VIVO Y11S 32 GB NEBULA BLUE WOM;TELEFONIA
17967339;;F;30;CHILENO;;Millenial;RENGO                         ;L.G.B.OÂ´HIGGINS;149991;2;1;0;0;0;2;1;149991;CELULAR MOTO G30 128GB GRIS TORNASOL OPEN;TELEFONIA
8762321;;M;64;CHILENO;;Boomers;IQUIQUE                       ;TARAPACA;366940;7;3;0;0;0;7;3;366940;POCO X3 PRO 256 GB PHANTOM BLACK;TELEFONIA
6847724;;F;71;CHILENO;;Silencioso;N/D;N/D;36990;1;1;0;0;0;1;1;36990;CELULAR NOKIA 225 4G BLACK MOVISTAR DIRECTO;TELEFONIA
12878610;;F;46;CHILENO;;X;"";"";1021850;4;2;3;1;973970;1;1;47880;IPHONE 12 128GB BLACK CLARO;TELEFONIA
8723096;;M;62;CHILENO;;Boomers;SAN FELIPE                    ;VALPARAISO;129990;1;1;0;0;0;1;1;129990;CELULAR MOTOROLA G9 PLAY 64GB SPRING PINK OPEN;TELEFONIA
6605409;;F;78;CHILENO;;Silencioso;TALCAHUANO                    ;BIO BIO;59990;1;3;0;0;0;1;3;59990;CELULAR NOKIA C1 PLUS BLUE;TELEFONIA
26440481;;M;40;VENEZOLANO;;Extranjero;"";"";314970;3;2;3;2;314970;0;0;0;POCO X3 PRO US 128G METAL BRONZE;TELEFONIA
15173056;;F;40;CHILENO;;X;NATALES                       ;MAGALLANES;111980;2;1;0;0;0;2;1;111980;CELULAR MOTOROLA E7 IPOWER 32GB BLUE CLARO;TELEFONIA
11067170;;F;55;CHILENO;;Boomers;MELIPILLA                     ;METROPOLITANA;957940;7;3;0;0;0;7;3;957940;CELULAR HUAWEI NOVA 9 BLACK + FREEBUDS 4;TELEFONIA
10844515;;M;53;CHILENO;;X;LAMPA                         ;METROPOLITANA;1085100;6;6;2;1;373980;4;5;711120;CELULAR HUAWEI NOVA 9 BLACK + FREEBUDS 4;TELEFONIA
11949915;;M;49;CHILENO;;X;LAS CABRAS                    ;L.G.B.OÂ´HIGGINS;448980;2;1;0;0;0;2;1;448980;CELULAR SMARTPHONE A52S 5G BLACK 128GB;TELEFONIA
7425704;;M;67;CHILENO;;Boomers;ANTOFAGASTA                   ;ANTOFAGASTA;179990;1;1;0;0;0;1;1;179990;CELULAR A32 128 GB LIGHT VIOLET OPEN;TELEFONIA
10816613;;M;55;CHILENO;;Boomers;LOS ANDES                     ;VALPARAISO;947230;7;4;0;0;0;7;4;947230;CELULAR VIVO Y21S MIDNIGHT BLUE 128 GB OPEN;TELEFONIA
12806509;;F;46;CHILENO;;X;LA SERENA                     ;COQUIMBO;79990;2;1;0;0;0;2;1;79990;CELULAR Moto G20 Rosado WOM;TELEFONIA
17127278;;F;33;CHILENO;;Extranjero;CURICO                        ;MAULE;74990;2;1;0;0;0;2;1;74990;CELULAR Moto G20 Rosado WOM;TELEFONIA
15648618;;F;38;CHILENO;;Millenial;"";"";163980;3;1;0;0;0;3;1;163980;CELULAR REDMI 9T 128 GB OCEAN GREEN;TELEFONIA
13978643;;M;40;CHILENO;;X;PROVIDENCIA                   ;METROPOLITANA;229990;1;1;1;1;229990;0;0;0;CELULAR POCO X3 PRO 256 GB FROST BLUE;TELEFONIA
9971715;;F;57;CHILENO;;Boomers;LO PRADO                      ;METROPOLITANA;319990;1;1;0;0;0;1;1;319990;CELULAR SMARTPHONE A52S 5G LIGHT GREEN 128GB;TELEFONIA
10827969;;F;54;CHILENO;;X;RENGO                         ;L.G.B.OÂ´HIGGINS;139990;1;1;0;0;0;1;1;139990;MOTO G20 AZUL CIELO 64GB MOVISTAR;TELEFONIA
18894012;Soltero;F;27;CHILENO;;Z;PROVIDENCIA                   ;METROPOLITANA;186980;3;1;0;0;0;3;1;186980;CELULAR A12 128GB Rojo OPEN;TELEFONIA
15749735;Soltero;F;36;CHILENO;PSICOLOGA;Millenial;RENCA                         ;METROPOLITANA;596960;4;3;3;2;536970;1;1;59990;Celular SAMSUNG A01 CORE BLACK CLARO;TELEFONIA
26700250;;M;30;VENEZOLANO;;Extranjero;TUCAPEL                       ;BIO BIO;1171680;4;2;4;2;1171680;0;0;0;CELULAR IPHONE 12 PRO MAX 128GB AZUL CLARO;TELEFONIA
19710345;;F;25;CHILENO;;Z;PROVIDENCIA                   ;METROPOLITANA;109990;1;1;1;1;109990;0;0;0;SMARTPHONE A03S NEGRO 32GB;TELEFONIA
11343587;Casado;F;54;CHILENO;;Boomers;PROVIDENCIA                   ;METROPOLITANA;95980;2;1;2;1;95980;0;0;0;CELULAR A02 NEGRO 32GB OPEN;TELEFONIA
9322629;;M;60;CHILENO;;Boomers;N/D;N/D;191980;2;1;0;0;0;2;1;191980;CELULAR VIVO Y20S OBSIDIAN BLACK 128GB OPEN;TELEFONIA
16183652;;F;36;CHILENO;;Millenial;PROVIDENCIA                   ;METROPOLITANA;199990;1;1;0;0;0;1;1;199990;CELULAR A32 128 GB LIGHT VIOLET OPEN;TELEFONIA
7611227;Soltero;F;68;CHILENO;;Silencioso;SAAVEDRA                      ;ARAUCANIA;149990;1;1;0;0;0;1;1;149990;CELULAR Moto One Fusion 128GB Blue WOM;TELEFONIA
11141167;;F;57;CHILENO;;Boomers;CHONCHI                       ;LOS LAGOS;248980;2;1;0;0;0;2;1;248980;CELULAR A32 128 GB LIGHT VIOLET OPEN;TELEFONIA
15573206;;F;38;CHILENO;;Millenial;OVALLE                        ;COQUIMBO;749970;3;3;0;0;0;3;3;749970;CELULAR GALAXY S20FE 128GB CLOUD LAVENDER OPEN;TELEFONIA
18805853;;F;27;CHILENO;;Millenial;N/D;N/D;209970;4;2;0;0;0;4;2;209970;CELULAR MOTO G30 128GB GRIS TORNASOL OPEN;TELEFONIA
12354937;;F;49;CHILENO;;X;ARICA                         ;TARAPACA;507860;3;2;0;0;0;3;2;507860;CELULAR VIVO Y53S FANTASTIC RAINBOW 128GB OPEN;TELEFONIA
14901594;;M;41;CHILENO;;X;TALCAHUANO                    ;BIO BIO;605840;2;1;2;1;605840;0;0;0;Celular Galaxy S21 Phantom White 128GB;TELEFONIA
11953044;;F;50;CHILENO;;X;CURICO                        ;MAULE;289990;1;1;0;0;0;1;1;289990;CELULAR SMARTPHONE A52S 5G BLACK 128GB;TELEFONIA
20840501;;M;20;CHILENO;;Z;RENCA                         ;METROPOLITANA;72980;3;1;0;0;0;3;1;72980;CELULAR VIVO Y11S 32GB NEBULA BLUE OPEN;TELEFONIA
17057379;Soltero;F;32;CHILENO;PROFESOR;Millenial;PROVIDENCIA                   ;METROPOLITANA;139990;1;1;0;0;0;1;1;139990;CELULAR A12 128GB Azul OPEN;TELEFONIA
19448513;;F;25;CHILENO;;Z;SAN FELIPE                    ;VALPARAISO;129990;1;1;0;0;0;1;1;129990;VIVO Y20 OBSIDIAN BLACK OPEN;TELEFONIA
12663554;;M;48;CHILENO;;Millenial;"";"";139990;1;1;1;1;139990;0;0;0;CELULAR MOTO ONE FUSION 128GB AZUL OPEN;TELEFONIA
6676283;;F;70;CHILENO;;Silencioso;RENCA                         ;METROPOLITANA;243980;2;1;2;1;243980;0;0;0;IPHONE 8 64 GB LIB OPEN DORADO;TELEFONIA
20398237;;M;22;CHILENO;;Z;RECOLETA;METROPOLITANA;119990;1;1;0;0;0;1;1;119990;CELULAR REDMI 9 64GB CARBON GREY;TELEFONIA
14023769;;F;40;CHILENO;;X;LA PINTANA                    ;METROPOLITANA;194980;2;3;0;0;0;2;3;194980;SMARTHPHONE REDMI 10 US 64GB SEA BLUE;TELEFONIA
16043650;;M;37;CHILENO;;Millenial;SANTIAGO                      ;METROPOLITANA;309990;1;1;0;0;0;1;1;309990;SMARTPHONE A52S 5G WHITE 128GB;TELEFONIA
10922911;;F;54;CHILENO;;Boomers;PUERTO MONTT                  ;LOS LAGOS;129990;1;1;0;0;0;1;1;129990;CELULAR HUAWEI Y7P NEGRO ENTEL;TELEFONIA
13580788;;F;43;CHILENO;;Silencioso;PROVIDENCIA                   ;METROPOLITANA;379990;1;1;0;0;0;1;1;379990;CELULAR GALAXY S20FE 128GB CLOUD LAVENDER OPEN;TELEFONIA
12350874;;M;48;CHILENO;;X;LOS ANDES                     ;VALPARAISO;1;1;2;0;0;0;1;2;1;CELULAR VIVO Y20S OBSIDIAN BLACK 128GB OPEN;TELEFONIA
17421640;;F;32;CHILENO;;Millenial;SAN BERNARDO                  ;METROPOLITANA;199990;1;1;1;1;199990;0;0;0;POCO X3 PRO 256 GB PHANTOM BLACK;TELEFONIA
19097775;;M;26;CHILENO;;Z;PELLUHUE                      ;MAULE;294980;2;1;0;0;0;2;1;294980;CELULAR POCO X3 PRO 128 GB FROST BLUE;TELEFONIA
11499172;;M;53;CHILENO;;X;NUEVA IMPERIAL                ;ARAUCANIA;199990;1;1;0;0;0;1;1;199990;SMARTPHONE A22 VERDE 128GB;TELEFONIA
8473370;;F;59;CHILENO;;Boomers;PROVIDENCIA                   ;METROPOLITANA;149990;1;1;0;0;0;1;1;149990;CELULAR XIAOMI REDMI 9T 128GB BLACK CLARO;TELEFONIA
14076938;;F;40;CHILENO;;X;PROVIDENCIA                   ;METROPOLITANA;84990;2;1;0;0;0;2;1;84990;CELULAR MOTOROLA G9 PLAY 64GB ELECTRIC BLUE OPEN;TELEFONIA
18728081;;M;28;CHILENO;;Extranjero;CARAHUE                       ;ARAUCANIA;86990;2;1;0;0;0;2;1;86990;CELULAR VIVO Y20 BLACK 64GB MOVISTAR;TELEFONIA
19045721;Soltero;F;27;CHILENO;;Z;PROVIDENCIA                   ;METROPOLITANA;189990;1;1;1;1;189990;0;0;0;CELULAR A32 128 GB WHITE OPEN;TELEFONIA
23704748;;F;36;PERUANO;;Extranjero;PROVIDENCIA                   ;METROPOLITANA;449980;2;1;0;0;0;2;1;449980;CELULAR XIAOMI 11 LITE 5G NE 8/128GB BUBBLEGUM K;TELEFONIA
13300515;;M;45;CHILENO;;X;RENCA                         ;METROPOLITANA;139990;1;1;1;1;139990;0;0;0;SMARTPHONE A03S 64 GB S/SIM NEGRO;TELEFONIA
6387676;Casado;F;71;CHILENO;;Silencioso;RENCA                         ;METROPOLITANA;129990;1;1;1;1;129990;0;0;0;CELULAR MOTOROLA G20 64GB BLUE CLARO;TELEFONIA
16273703;;F;36;CHILENO;;Millenial;PROVIDENCIA                   ;METROPOLITANA;129990;1;1;1;1;129990;0;0;0;CELULAR A12 128GB Azul OPEN;TELEFONIA
12523303;;F;49;CHILENO;;X;CHIGUAYANTE                   ;BIO BIO;139990;1;1;0;0;0;1;1;139990;CELULAR VIVO Y20S OBSIDIAN BLACK 128GB OPEN;TELEFONIA
25474757;Soltero;F;31;COLOMBIANO;MEDICO CIRUJANO;Extranjero;INDEPENDENCIA                 ;METROPOLITANA;283970;3;1;3;1;283970;0;0;0;CELULAR HUAWEI Y7A VERDE OPEN;TELEFONIA
14363756;;M;41;CHILENO;;X;"";"";184990;2;1;0;0;0;2;1;184990;CELULAR POCO X3 PRO 128G PHANTOM BLACK OPEN;TELEFONIA
15495903;;M;38;CHILENO;;Millenial;CUNCO                         ;ARAUCANIA;814730;6;2;0;0;0;6;2;814730;CELULAR A32 128 GB BLACK OPEN;TELEFONIA
19616532;;F;24;CHILENO;;Millenial;"";"";233980;2;1;2;1;233980;0;0;0;POCO X3 PRO 256 GB METAL BRONCE;TELEFONIA
16677789;;M;34;CHILENO;;Millenial;QUILPUE                       ;VALPARAISO;189990;1;1;0;0;0;1;1;189990;CELULAR REDMI NOTE 10S 128GB PEBBLE WHITE;TELEFONIA
11281077;Casado;M;53;CHILENO;;X;SANTA CRUZ                    ;L.G.B.OÂ´HIGGINS;184980;2;2;0;0;0;2;2;184980;REDMI 10 US 128GB Carbon Gray;TELEFONIA
14674020;;F;44;PERUANO;;Extranjero;SANTIAGO                      ;METROPOLITANA;163060;3;1;0;0;0;3;1;163060;CELULAR XIAOMI REDMI 9T 128GB BLACK CLARO;TELEFONIA
16456619;;M;35;CHILENO;;Millenial;PROVIDENCIA                   ;METROPOLITANA;119990;1;1;0;0;0;1;1;119990;CELULAR OPPO A15 BLACK 32GB CLARO;TELEFONIA
19252235;;M;26;CHILENO;;Z;TALCAHUANO                    ;BIO BIO;214980;2;1;2;1;214980;0;0;0;CELULAR POCO X3 PRO 128 GB FROST BLUE;TELEFONIA
19871192;;F;23;CHILENO;;Millenial;PROVIDENCIA                   ;METROPOLITANA;189990;1;1;1;1;189990;0;0;0;CELULAR REDMI NOTE 10S 128GB PEBBLE WHITE;TELEFONIA
14621625;;F;45;CHILENO;;X;VALPARAISO;VALPARAISO;554980;2;1;2;1;554980;0;0;0;IPHONE 11 64GB BLACK CLARO;TELEFONIA
12814195;;M;46;CHILENO;;X;RENCA                         ;METROPOLITANA;623980;2;1;2;1;623980;0;0;0;CELULAR IPHONE 12 MINI 64GB BLACK CLARO;TELEFONIA
11748497;;F;51;CHILENO;;X;MONTE PATRIA                  ;COQUIMBO;119990;1;1;0;0;0;1;1;119990;SMARTPHONE A03S NEGRO 32GB;TELEFONIA
26663692;;M;42;VENEZOLANO;;Extranjero;"";"";499990;1;1;1;1;499990;0;0;0;CELULAR GALAXY S20FE 128GB ClOUD NAVY OPEN;TELEFONIA
20020809;;M;23;CHILENO;;Z;LEBU                          ;BIO BIO;89990;1;1;0;0;0;1;1;89990;CELULAR CLARO MOTOROLA E7 32GB GRIS;TELEFONIA
15407027;;M;40;CHILENO;;X;RENCA                         ;METROPOLITANA;109990;1;1;0;0;0;1;1;109990;CELULAR VIVO Y11S NEBULA BLUE 32GB OPEN;TELEFONIA
14700857;;F;48;PERUANO;;X;EL TABO                       ;VALPARAISO;299990;1;1;0;0;0;1;1;299990;CELULAR SMARTPHONE A52S 5G LIGHT GREEN 128GB;TELEFONIA
10585189;Casado;M;52;CHILENO;;X;PROVIDENCIA                   ;METROPOLITANA;64990;1;1;1;1;64990;0;0;0;CELULAR MOTO E6I 32GB GRIS OPEN;TELEFONIA
15248163;;M;41;CHILENO;;X;PROVIDENCIA                   ;METROPOLITANA;114990;1;1;0;0;0;1;1;114990;CELULAR MOTOROLA MOTO G20 64GB ROSA FLAMINGO;TELEFONIA
17951809;;F;32;CHILENO;;X;ANCUD                         ;LOS LAGOS;154970;3;2;0;0;0;3;2;154970;CELULAR REDMI 9C 32GB MIDNIGHT GRAY MOVISTAR;TELEFONIA
22593716;;M;45;PERUANO;;Extranjero;"";"";243060;3;1;0;0;0;3;1;243060;CELULAR REDMI NOTE 10S 128GB PEBBLE WHITE;TELEFONIA
15951653;;F;36;CHILENO;;Millenial;RENCA                         ;METROPOLITANA;189980;2;1;0;0;0;2;1;189980;CELULAR VIVO Y20S OBSIDIAN BLACK 128GB OPEN;TELEFONIA
9986550;;F;58;CHILENO;;Boomers;TIRUA                         ;BIO BIO;159990;1;1;0;0;0;1;1;159990;CELULAR A12 128GB Azul OPEN;TELEFONIA
14527158;;F;48;CHILENO;;X;VILLARICA                     ;ARAUCANIA;149990;1;1;0;0;0;1;1;149990;CELULAR XIAOMI REDMI 9T 128GB VERDE CLARO;TELEFONIA
17752900;;M;31;CHILENO;;Millenial;"";"";1160970;3;3;0;0;0;3;3;1160970;CELULAR XIAOMI 11T PRO 8/256GB MOON WHITE;TELEFONIA
13307552;Soltero;M;44;CHILENO;INGENIERO EN CONSTRUCCION;X;RENCA                         ;METROPOLITANA;59990;1;1;1;1;59990;0;0;0;Celular SAMSUNG A01 CORE BLACK CLARO;TELEFONIA
18773126;;F;27;CHILENO;;Z;N/D;N/D;938820;8;5;0;0;0;8;5;938820;SMARTPHONE A52S 5G WHITE 128GB;TELEFONIA
12498913;;M;49;CHILENO;;X;LA PINTANA                    ;METROPOLITANA;79990;1;1;0;0;0;1;1;79990;CELULAR CLARO MOTOROLA E7 32GB GRIS;TELEFONIA
9916898;;F;58;CHILENO;;Boomers;PROVIDENCIA                   ;METROPOLITANA;109990;1;1;0;0;0;1;1;109990;CELULAR XIAOMI REDMI 9 64GB DIRECTO CLARO MORADO;TELEFONIA
14757681;;M;68;EXTRANJERO - NO INFORMA NACIONALIDAD;;Extranjero;CALAMA                        ;ANTOFAGASTA;32990;1;1;0;0;0;1;1;32990;CELULAR OWN 1026 AZUL ENTEL;TELEFONIA
19692344;;F;24;CHILENO;;Z;ANTOFAGASTA                   ;ANTOFAGASTA;109990;2;1;0;0;0;2;1;109990;CELULAR VIVO Y20S OBSIDIAN BLACK 128GB OPEN;TELEFONIA
13195310;;M;45;CHILENO;;X;SAN ANTONIO                   ;VALPARAISO;69990;1;1;0;0;0;1;1;69990;CELULAR MOTOROLA E7 IPOWER 32GB BLUE CLARO;TELEFONIA
9937051;;F;58;CHILENO;;Boomers;PROVIDENCIA                   ;METROPOLITANA;777800;7;2;0;0;0;7;2;777800;CELULAR MOTOROLA E6 PLAY AZUL TRI WOM;TELEFONIA
14112210;Casado;F;41;CHILENO;;X;PROVIDENCIA                   ;METROPOLITANA;239980;2;1;2;1;239980;0;0;0;CELULAR A12 128GB Azul OPEN;TELEFONIA
18177417;;F;29;CHILENO;;Millenial;N/D;N/D;30000;0;2;0;0;0;0;2;30000;SMARTPHONE A03S 32 GB ROJO;TELEFONIA
8642980;;F;63;CHILENO;;Boomers;ANTOFAGASTA                   ;ANTOFAGASTA;294980;2;1;0;0;0;2;1;294980;VIVO Y53S DEEP SEA BLUE 128GB OPEN;TELEFONIA
18712352;;F;28;CHILENO;;Millenial;"";"";499980;2;1;0;0;0;2;1;499980;CELULAR SMARTPHONE A52S 5G LIGHT VIOLET 128GB;TELEFONIA
10618203;Soltero;M;54;CHILENO;;Boomers;RENCA                         ;METROPOLITANA;31990;2;1;0;0;0;2;1;31990;CELULAR MOTO E7I POWER 32GB BLUE MOVISTAR;TELEFONIA
10798493;;M;53;CHILENO;;X;RENCA                         ;METROPOLITANA;279980;2;1;0;0;0;2;1;279980;CELULAR A12 128GB Negro OPEN;TELEFONIA
27204764;;F;34;EXTRANJERO - NO INFORMA NACIONALIDAD;;Extranjero;VINA DEL MAR;VALPARAISO;89990;2;1;0;0;0;2;1;89990;CELULAR A12 128GB Negro OPEN;TELEFONIA
10446339;;M;59;CHILENO;;Boomers;QUILICURA                     ;METROPOLITANA;344980;2;1;0;0;0;2;1;344980;CELULAR POCO X3 PRO 256 GB FROST BLUE;TELEFONIA
14357754;;F;43;CHILENO;;X;PUTAENDO                      ;VALPARAISO;69990;1;1;0;0;0;1;1;69990;CELULAR ZTE A5 2020 DIRECTO CLARO VERDE;TELEFONIA
10070517;;M;57;CHILENO;;Boomers;MAIPU                         ;METROPOLITANA;185840;2;1;2;1;185840;0;0;0;CELULAR A32 128 GB LIGHT VIOLET OPEN;TELEFONIA
22601928;;F;28;CHILENO;;Millenial;PUENTE ALTO                   ;METROPOLITANA;119990;1;1;0;0;0;1;1;119990;SMARTPHONE A03S NEGRO 32GB;TELEFONIA
19499260;;M;25;CHILENO;;Z;LA CISTERNA                   ;METROPOLITANA;703980;2;1;2;1;703980;0;0;0;CELULAR IPHONE 12 64GB BLACK CLARO;TELEFONIA
13408738;;M;44;CHILENO;;X;NATALES                       ;MAGALLANES;169990;1;1;0;0;0;1;1;169990;CELULAR SAMSUNG A12 128GB BLACK CLARO;TELEFONIA
13177777;;F;44;CHILENO;;X;N/D;N/D;186980;3;1;0;0;0;3;1;186980;CELULAR XIAOMI REDMI 9T TWILIGHT BLUE MOVISTAR;TELEFONIA
15250760;;F;38;CHILENO;;X;PITRUFQUEN;ARAUCANIA;379980;2;2;2;2;379980;0;0;0;CELULAR POCO X3 PRO 256 GB FROST BLUE;TELEFONIA
16946247;Soltero;M;34;CHILENO;;Millenial;MELIPILLA                     ;METROPOLITANA;139990;1;1;0;0;0;1;1;139990;CELULAR VIVO Y20S OBSIDIAN BLACK 128GB OPEN;TELEFONIA
15046514;;F;40;CHILENO;;X;SALAMANCA                     ;COQUIMBO;2;0;3;0;0;0;0;3;2;CELULAR XIAOMI REDMI 9 64GB DIRECTO CLARO MORADO;TELEFONIA
14473054;;F;47;CHILENO;;X;RENAICO                       ;ARAUCANIA;119990;1;1;0;0;0;1;1;119990;CELULAR REDMI 9 64GB CARBON GREY;TELEFONIA
13843740;;M;44;CHILENO;;X;PROVIDENCIA                   ;METROPOLITANA;179990;1;1;0;0;0;1;1;179990;CELULAR MOTOROLA G9 PLUS 128GB AZUL CLARO;TELEFONIA
18015779;;F;31;CHILENO;;Millenial;ANCUD                         ;LOS LAGOS;89990;2;1;0;0;0;2;1;89990;CELULAR A12 128GB Azul OPEN;TELEFONIA
15202004;Soltero;M;39;CHILENO;;X;TALCAHUANO                    ;BIO BIO;299980;2;2;1;1;229990;1;1;69990;CELULAR MOTOROLA E7 IPOWER 32GB BLUE CLARO;TELEFONIA
10799835;;M;55;CHILENO;;Boomers;SAN BERNARDO                  ;METROPOLITANA;510440;5;3;0;0;0;5;3;510440;CELULAR MOTOROLA E7 IPOWER 32GB BLUE CLARO;TELEFONIA
19734983;;F;25;CHILENO;;Z;ALTO HOSPICIO;TARAPACA;179990;1;1;0;0;0;1;1;179990;REDMI 10 US 128GB Carbon Gray;TELEFONIA
10089086;;F;56;CHILENO;;Boomers;N/D;N/D;329990;1;1;1;1;329990;0;0;0;CELULAR IPHONE SE 64GB DIRECTO CLARO;TELEFONIA
17605570;Soltero;M;31;CHILENO;;Millenial;PROVIDENCIA                   ;METROPOLITANA;169990;1;1;1;1;169990;0;0;0;CELULAR MOTOROLA G9 PLUS 128GB AZUL CLARO;TELEFONIA
26972493;;F;25;VENEZOLANO;;Extranjero;N/D;N/D;189990;1;1;0;0;0;1;1;189990;REDMI 10 US 128GB Carbon Gray;TELEFONIA
15147206;Soltero;M;38;CHILENO;;Millenial;PROVIDENCIA                   ;METROPOLITANA;149990;1;1;0;0;0;1;1;149990;CELULAR A12 128GB Negro OPEN;TELEFONIA
6464131;Casado;M;71;CHILENO;;Silencioso;PROVIDENCIA                   ;METROPOLITANA;79480;3;1;0;0;0;3;1;79480;CELULAR Moto E7 Rosado WOM;TELEFONIA
14362806;;F;41;CHILENO;;X;LO PRADO                      ;METROPOLITANA;389970;3;2;2;1;249980;1;1;139990;CELULAR A12 128GB Azul OPEN;TELEFONIA
18401002;Soltero;F;29;CHILENO;TECNICO EN ENFERMERIA DE NIVEL SUPERIOR;Millenial;PROVIDENCIA                   ;METROPOLITANA;229990;1;1;0;0;0;1;1;229990;CELULAR VIVO Y53S FANTASTIC RAINBOW 128GB OPEN;TELEFONIA
11536538;Casado;M;51;CHILENO;TECNICO EN ELECTROMECANICA;X;RENCA                         ;METROPOLITANA;149990;1;1;0;0;0;1;1;149990;CELULAR XIAOMI REDMI 9T 128GB VERDE CLARO;TELEFONIA
13393454;;F;44;CHILENO;;X;LEBU                          ;BIO BIO;420950;5;2;0;0;0;5;2;420950;CELULAR A12 128GB Negro OPEN;TELEFONIA
4766950;;F;79;CHILENO;;Silencioso;VALLENAR;ATACAMA;149990;1;1;0;0;0;1;1;149990;CELULAR A12 128GB Azul OPEN;TELEFONIA
11776123;;M;50;CHILENO;;X;RENCA                         ;METROPOLITANA;86480;2;1;0;0;0;2;1;86480;Celular SAMSUNG A01 CORE BLACK CLARO;TELEFONIA
8896467;;M;60;CHILENO;;Boomers;CHIMBARONGO                   ;L.G.B.OÂ´HIGGINS;109480;2;1;0;0;0;2;1;109480;CELULAR A02 ROJO 32GB OPEN;TELEFONIA
6260667;;M;74;CHILENO;;Silencioso;RENCA                         ;METROPOLITANA;34990;1;1;0;0;0;1;1;34990;CELULAR NOKIA 225 4G BLACK MOVISTAR DIRECTO;TELEFONIA
18867762;;F;27;CHILENO;;Z;VICTORIA                      ;ARAUCANIA;99990;1;1;0;0;0;1;1;99990;CELULAR MOTOROLA G20 64GB BLUE CLARO;TELEFONIA
19120204;Soltero;F;26;CHILENO;;Z;CONCEPCION                    ;BIO BIO;210980;3;1;0;0;0;3;1;210980;VIVO Y53S DEEP SEA BLUE 128GB OPEN;TELEFONIA
8853117;Casado;F;61;CHILENO;;Boomers;RENCA                         ;METROPOLITANA;131990;2;1;0;0;0;2;1;131990;MOTO G30 LILA PASTEL 128GB MOVISTAR;TELEFONIA
9740240;;F;61;CHILENO;;Boomers;CURICO                        ;MAULE;174971;4;1;0;0;0;4;1;174971;CELULAR VIVO Y20S NEBULA 128 GB BLUE OPEN;TELEFONIA
7323818;;M;66;CHILENO;;Boomers;TOCOPILLA                     ;ANTOFAGASTA;18990;1;1;0;0;0;1;1;18990;Celular AL3 CLARO DIRECTO NEGRO;TELEFONIA
11660443;;M;51;CHILENO;;X;N/D;N/D;174980;2;2;0;0;0;2;2;174980;CELULAR REDMI 9T 128 GB OCEAN GREEN;TELEFONIA
20304034;;F;22;CHILENO;;Z;PROVIDENCIA                   ;METROPOLITANA;164540;2;1;2;1;164540;0;0;0;IPHONE 7 LIB OPEN NEGRO;TELEFONIA
14305542;;F;46;CHILENO;;X;SAN FELIPE                    ;VALPARAISO;196980;3;2;0;0;0;3;2;196980;CELULAR XIAOMI REDMI 9T TWILIGHT BLUE MOVISTAR;TELEFONIA
11388596;;M;53;CHILENO;;X;PROVIDENCIA                   ;METROPOLITANA;149990;1;1;0;0;0;1;1;149990;CELULAR XIAOMI REDMI 9T 128GB BLACK CLARO;TELEFONIA
16613835;;M;34;CHILENO;;Millenial;SALAMANCA                     ;COQUIMBO;699980;6;1;0;0;0;6;1;699980;CELULAR SMARTPHONE A52S 5G BLACK 128GB;TELEFONIA
5613826;;F;79;CHILENO;;Silencioso;QUILLOTA                      ;VALPARAISO;583980;2;1;2;1;583980;0;0;0;IPHONE 11 64GB BLACK CLARO;TELEFONIA
16761920;;M;34;CHILENO;;Millenial;GALVARINO                     ;ARAUCANIA;229950;5;2;0;0;0;5;2;229950;REDMI 10 US 128GB Carbon Gray;TELEFONIA
13371262;;M;44;CHILENO;;X;PROVIDENCIA                   ;METROPOLITANA;245480;2;1;2;1;245480;0;0;0;IPHONE 8 64 GB LIB OPEN PLATEADO;TELEFONIA
18040753;;F;30;CHILENO;;Millenial;N/D;N/D;119990;1;1;0;0;0;1;1;119990;CELULAR MOTOROLA G20 64GB BLUE CLARO;TELEFONIA
12733423;;M;47;CHILENO;;X;"";"";184980;2;1;2;1;184980;0;0;0;CELULAR A32 128 GB LIGHT VIOLET OPEN;TELEFONIA
9638830;;F;59;CHILENO;;Boomers;RENCA                         ;METROPOLITANA;197871;3;1;0;0;0;3;1;197871;CELULAR A12 128GB Rojo OPEN;TELEFONIA
18236924;Soltero;M;29;CHILENO;;Millenial;VILLA ALEMANA                 ;VALPARAISO;584980;2;1;2;1;584980;0;0;0;CELULAR NOTE 20 ULTRA MYSTIC BLACK 256GB OPEN;TELEFONIA
6805421;;F;69;CHILENO;;Silencioso;N/D;N/D;608540;2;1;2;1;608540;0;0;0;CELULAR IPHONE 12 MINI 64GB BLACK CLARO;TELEFONIA
25837261;;M;36;HAITIANO;;Extranjero;N/D;N/D;71990;2;1;0;0;0;2;1;71990;CELULAR VIVO Y20 BLACK 64GB MOVISTAR;TELEFONIA
12382509;;F;48;CHILENO;;X;SAN PEDRO DE LA PAZ           ;BIO BIO;179970;3;1;0;0;0;3;1;179970;CELULAR A12 128GB Azul OPEN;TELEFONIA
9848636;;M;59;CHILENO;;Boomers;SAN VICENTE                   ;L.G.B.OÂ´HIGGINS;347560;3;4;0;0;0;3;4;347560;CELULAR CLARO MOTOROLA E7 32GB GRIS;TELEFONIA
5062973;;M;75;CHILENO;;Silencioso;ARAUCO                        ;BIO BIO;34990;1;1;0;0;0;1;1;34990;CELULAR ALCATEL P1 DIRECTO CLARO BLACK;TELEFONIA
13271301;;F;45;CHILENO;;X;PENALOLEN                     ;METROPOLITANA;103980;2;1;2;1;103980;0;0;0;CELULAR HUAWEI Y7P NEGRO ENTEL;TELEFONIA
18073276;;F;29;CHILENO;;Silencioso;PROVIDENCIA                   ;METROPOLITANA;473980;3;1;3;1;473980;0;0;0;CELULAR GALAXY S20FE 128GB CLOUD LAVENDER OPEN;TELEFONIA
5148017;;M;78;CHILENO;;Silencioso;LAMPA                         ;METROPOLITANA;234660;3;2;0;0;0;3;2;234660;SMARTPHONE A03S NEGRO 32GB;TELEFONIA
16599774;;F;35;CHILENO;;Millenial;HUALPEN;BIO BIO;99980;2;2;0;0;0;2;2;99980;CELULAR MOTOROLA E7 IPOWER 32GB BLUE CLARO;TELEFONIA
18404275;Soltero;F;29;CHILENO;;Millenial;PROVIDENCIA                   ;METROPOLITANA;3960;4;1;0;0;0;4;1;3960;CHIP OPEN ENTEL;TELEFONIA
9310181;;M;60;CHILENO;;Boomers;TENO                          ;MAULE;66990;2;1;0;0;0;2;1;66990;CELULAR VIVO Y11S PHANTON BLACK 32GB MOVISTAR;TELEFONIA
6901311;;F;68;CHILENO;;Silencioso;RENCA                         ;METROPOLITANA;106990;2;1;0;0;0;2;1;106990;CELULAR REDMI 9T 128 GB OCEAN GREEN;TELEFONIA
15773681;;F;37;CHILENO;;Millenial;SAN CLEMENTE                  ;MAULE;109990;2;1;0;0;0;2;1;109990;CELULAR REDMI NOTE 10 128GB ONIX GRAY OPEN;TELEFONIA
16579441;;F;35;CHILENO;;Millenial;VICTORIA                      ;ARAUCANIA;247090;4;2;0;0;0;4;2;247090;CELULAR REDMI 9T 128 GB OCEAN GREEN;TELEFONIA
5962398;;M;73;CHILENO;;Silencioso;RENCA                         ;METROPOLITANA;485940;6;3;0;0;0;6;3;485940;CELULAR Galaxy A21s (128GB) Black WOM;TELEFONIA
9511971;;F;62;CHILENO;;Boomers;N/D;N/D;225980;2;1;0;0;0;2;1;225980;SMARTPHONE A22 VERDE 128GB;TELEFONIA
19133204;;M;27;CHILENO;;Silencioso;"";"";281540;2;1;2;1;281540;0;0;0;CELULAR MOTO G50 AZUL 128 GB OPEN;TELEFONIA
6890443;;F;69;CHILENO;;Silencioso;TEMUCO                        ;ARAUCANIA;64990;2;1;0;0;0;2;1;64990;CELULAR MOTO E7 32GB ROSA CORAL OPEN;TELEFONIA
15653979;;F;38;CHILENO;;X;N/D;N/D;93660;1;2;2;1;141540;-1;1;-47880;CELULAR A12 128GB Rojo OPEN;TELEFONIA
12563266;;M;48;CHILENO;;X;ANGOL                         ;ARAUCANIA;144980;2;1;0;0;0;2;1;144980;CELULAR REDMI NOTE 8 2021 64GB MOONLIGHT WHITE;TELEFONIA
15242547;;M;40;CHILENO;;X;FREIRE                        ;ARAUCANIA;69990;1;1;0;0;0;1;1;69990;CELULAR MOTO E7I POWER ORANGE 32GB MOVISTAR;TELEFONIA
13068725;;F;45;CHILENO;;Silencioso;PROVIDENCIA                   ;METROPOLITANA;113980;2;1;2;1;113980;0;0;0;CELULAR REDMI NOTE 8 2021 64GB MOONLIGHT WHITE;TELEFONIA
18416828;;F;29;CHILENO;;Millenial;"";"";235840;2;1;2;1;235840;0;0;0;POCO X3 PRO 256 GB METAL BRONCE;TELEFONIA
12944455;;F;46;CHILENO;;X;MONTE PATRIA                  ;COQUIMBO;119480;2;1;0;0;0;2;1;119480;CELULAR REDMI 9C 32GB MIDNIGHT GRAY;TELEFONIA
20315487;;M;22;CHILENO;;Silencioso;PROVIDENCIA                   ;METROPOLITANA;188540;2;1;2;1;188540;0;0;0;CELULAR POCO X3 PRO 128G PHANTOM BLACK OPEN;TELEFONIA
12431273;;M;49;CHILENO;;X;ALTO HOSPICIO;TARAPACA;119990;1;1;0;0;0;1;1;119990;CELULAR MOTO ONE FUSION 64GB VERDE 64GB OPEN;TELEFONIA
15147974;;F;40;CHILENO;;X;CAUQUENES                     ;MAULE;489990;2;1;0;0;0;2;1;489990;CELULAR GALAXY S20FE 128GB CLOUD LAVENDER OPEN;TELEFONIA
19541225;;F;25;CHILENO;;Z;N/D;N/D;597080;2;1;0;0;0;2;1;597080;CELULAR A72 128 GB BLACK OPEN;TELEFONIA
21107680;;F;31;CHILENO;;Millenial;SAN BERNARDO                  ;METROPOLITANA;233980;2;1;2;1;233980;0;0;0;CELULAR POCO X3 PRO 256 GB FROST BLUE;TELEFONIA
19309082;;M;26;CHILENO;;Silencioso;PROVIDENCIA                   ;METROPOLITANA;477970;3;1;3;1;477970;0;0;0;CELULAR GALAXY S20FE 128GB CLOUD GREEN OPEN;TELEFONIA
15187201;;F;40;CHILENO;;Silencioso;PROVIDENCIA                   ;METROPOLITANA;191980;3;2;0;0;0;3;2;191980;CELULAR VIVO Y11S PHANTON BLACK 32GB MOVISTAR;TELEFONIA
20361031;;F;22;CHILENO;;Z;N/D;N/D;990;1;1;0;0;0;1;1;990;CHIP OPEN ENTEL;TELEFONIA
17951752;Soltero;M;30;CHILENO;INGENIERO MECANICO;Millenial;PROVIDENCIA                   ;METROPOLITANA;106980;2;1;2;1;106980;0;0;0;CELULAR POCO M3 64GB POWER BLACK;TELEFONIA
12597893;Casado;F;48;CHILENO;;X;PROVIDENCIA                   ;METROPOLITANA;57870;2;1;0;0;0;2;1;57870;CELULAR OWN 1026 AZUL ENTEL;TELEFONIA
11124564;;F;54;CHILENO;;Boomers;PROVIDENCIA                   ;METROPOLITANA;129480;2;1;0;0;0;2;1;129480;CELULAR MOTO E7 GRIS MINERAL MOVISTAR;TELEFONIA
19510444;;M;25;CHILENO;;Silencioso;PROVIDENCIA                   ;METROPOLITANA;29990;1;1;1;1;29990;0;0;0;CELULAR ALCATEL P1 DIRECTO CLARO BLACK;TELEFONIA
15056441;Soltero;M;40;CHILENO;INGENIERO EN CONSTRUCCION;X;PROVIDENCIA                   ;METROPOLITANA;399990;1;1;0;0;0;1;1;399990;CELULAR GALAXY S20FE 128GB ClOUD NAVY OPEN;TELEFONIA
17081613;;F;34;CHILENO;;Millenial;N/D;N/D;0;0;2;0;0;0;0;2;0;CELULAR REDMI NOTE 10S 128GB ONIX BLACK;TELEFONIA
10409248;;F;59;CHILENO;;Boomers;PROVIDENCIA                   ;METROPOLITANA;93770;2;1;0;0;0;2;1;93770;CELULAR MOTOROLA E6 PLAY AZUL TRI WOM;TELEFONIA
22520365;;F;41;VENEZOLANO;;Extranjero;N/D;N/D;313980;2;1;2;1;313980;0;0;0;POCO F3 EU Night Black 256GB;TELEFONIA
16691531;;F;35;CHILENO;;Silencioso;PROVIDENCIA                   ;METROPOLITANA;333980;2;1;2;1;333980;0;0;0;CELULAR IPHONE SE 64GB DIRECTO CLARO;TELEFONIA
16676342;;M;37;CHILENO;;Millenial;LOS ANGELES                   ;BIO BIO;149980;2;2;0;0;0;2;2;149980;CELULAR MOTO E7I POWER 32GB BLUE MOVISTAR;TELEFONIA
19299776;Soltero;F;25;CHILENO;;Z;N/D;N/D;475480;2;1;2;1;475480;0;0;0;IPHONE 11 64GB BLACK CLARO;TELEFONIA
13660160;;F;43;CHILENO;;Millenial;ALTO HOSPICIO;TARAPACA;1149960;3;1;3;1;1149960;0;0;0;Celular Galaxy S21 Ultra Phantom Silver 128GB;TELEFONIA
18237764;;F;29;CHILENO;;Millenial;PROVIDENCIA                   ;METROPOLITANA;244980;2;1;2;1;244980;0;0;0;CELULAR MI 11 LITE US 128GB PEACH PINK OPEN;TELEFONIA
18723249;;F;27;CHILENO;;Millenial;PROVIDENCIA                   ;METROPOLITANA;162760;3;2;0;0;0;3;2;162760;CELULAR MOTOROLA E6 PLAY AZUL TRI WOM;TELEFONIA
17803250;;F;31;CHILENO;;Millenial;PROVIDENCIA                   ;METROPOLITANA;179990;1;1;0;0;0;1;1;179990;CELULAR POCO X3 PRO 128 GB FROST BLUE;TELEFONIA
16455341;;F;35;CHILENO;;Millenial;N/D;N/D;399990;3;1;0;0;0;3;1;399990;POCO X3 PRO 256 GB PHANTOM BLACK;TELEFONIA
15531987;;M;38;CHILENO;;Silencioso;PROVIDENCIA                   ;METROPOLITANA;44990;2;1;0;0;0;2;1;44990;CELULAR REDMI NOTE 8 2021 64GB NEPTUNE BLUE;TELEFONIA
13969491;;M;41;CHILENO;;X;COIHAIQUE                     ;AYSEN;139990;1;1;0;0;0;1;1;139990;CELULAR A12 128GB Azul OPEN;TELEFONIA
25917640;;M;35;VENEZOLANO;;Extranjero;SANTIAGO                      ;METROPOLITANA;483980;3;1;3;1;483980;0;0;0;CELULAR GALAXY S20FE 128GB CLOUD LAVENDER OPEN;TELEFONIA
12310020;;M;50;CHILENO;;X;SAN RAMON                     ;METROPOLITANA;179990;1;1;0;0;0;1;1;179990;CELULAR A54 OPPO NEGRO 128GB;TELEFONIA
6686477;Casado;M;70;CHILENO;;Silencioso;PROVIDENCIA                   ;METROPOLITANA;473980;3;1;3;1;473980;0;0;0;CELULAR GALAXY S20FE 128GB ClOUD NAVY OPEN;TELEFONIA
19083239;;F;31;CHILENO;;Millenial;QUILLON                       ;BIO BIO;179982;4;1;0;0;0;4;1;179982;CELULAR MOTO E7 32GB ROSA CORAL OPEN;TELEFONIA
20001548;;M;23;CHILENO;;Silencioso;PROVIDENCIA                   ;METROPOLITANA;827970;3;1;3;1;827970;0;0;0;Celular Galaxy S21 Plus Phantom Black 128GB;TELEFONIA
8686897;;M;62;CHILENO;;Boomers;PARRAL                        ;MAULE;32990;1;1;0;0;0;1;1;32990;CELULAR OWN 1026 AZUL ENTEL;TELEFONIA
9255555;;M;61;CHILENO;;Boomers;SANTIAGO                      ;METROPOLITANA;284980;2;1;0;0;0;2;1;284980;CELULAR MI 11 LITE 128GB BOBA BLACK OPEN;TELEFONIA
16148483;;F;36;CHILENO;;Millenial;COLINA                        ;METROPOLITANA;109990;1;1;0;0;0;1;1;109990;CELULAR XIAOMI REDMI 9 64GB DIRECTO CLARO MORADO;TELEFONIA
18230648;;F;29;CHILENO;;Millenial;LOS ALAMOS                    ;BIO BIO;3789350;13;1;0;0;0;13;1;3789350;CELULAR Galaxy Z Fold3 256GB BLACK OPEN;TELEFONIA
14336566;Soltero;M;44;CHILENO;;X;RENCA                         ;METROPOLITANA;990;1;1;0;0;0;1;1;990;CHIP OPEN ENTEL;TELEFONIA
17153984;;F;33;CHILENO;;Millenial;VICTORIA                      ;ARAUCANIA;69990;1;1;0;0;0;1;1;69990;CELULAR MOTO E7i 32GB AZUL OPEN;TELEFONIA
26689534;;M;54;VENEZOLANO;;Extranjero;N/D;N/D;831690;3;1;3;1;831690;0;0;0;Celular Galaxy S21 Plus Phantom Black 128GB;TELEFONIA
20055820;;F;23;CHILENO;;Z;N/D;N/D;1547960;3;1;3;1;1547960;0;0;0;CELULAR IPHONE 12 128GB WHITE CLARO;TELEFONIA
14015641;;M;41;CHILENO;;X;PROVIDENCIA                   ;METROPOLITANA;164980;3;1;0;0;0;3;1;164980;CELULAR POCO M3 PRO 5G 128GB COOL BLUE;TELEFONIA
20336368;;M;22;CHILENO;;Silencioso;PROVIDENCIA                   ;METROPOLITANA;103980;2;1;2;1;103980;0;0;0;CELULAR POCO M3 64GB POWER BLACK;TELEFONIA
5185476;;F;74;CHILENO;;Silencioso;VALDIVIA                      ;LOS RIOS;119990;1;1;0;0;0;1;1;119990;CELULAR XIAOMI REDMI 9 64GB DIRECTO CLARO MORADO;TELEFONIA
7877489;;M;66;CHILENO;;Boomers;COIHAIQUE                     ;AYSEN;189980;2;1;0;0;0;2;1;189980;CELULAR VIVO Y20 NEGRO DIRECTO ENTEL;TELEFONIA
7462252;;F;67;CHILENO;;Boomers;SAN FERNANDO                  ;L.G.B.OÂ´HIGGINS;32990;1;1;0;0;0;1;1;32990;CELULAR OWN 1026 AZUL ENTEL;TELEFONIA
11877792;;F;50;CHILENO;;X;BUIN                          ;METROPOLITANA;189980;2;1;0;0;0;2;1;189980;CELULAR A21s 128 GB Negro;TELEFONIA
11058712;Casado;F;55;CHILENO;;Boomers;RENCA                         ;METROPOLITANA;539980;2;1;0;0;0;2;1;539980;CELULAR GALAXY S20FE 128GB ClOUD NAVY OPEN;TELEFONIA
15673639;Soltero;F;38;CHILENO;;X;PROVIDENCIA                   ;METROPOLITANA;89990;1;1;0;0;0;1;1;89990;CELULAR Moto E7 Rosado WOM;TELEFONIA
16025184;;F;36;CHILENO;;Millenial;ROMERAL                       ;MAULE;260980;2;1;0;0;0;2;1;260980;CELULAR A32 128 GB BLUE OPEN;TELEFONIA
7496854;;F;75;CHILENO;;Silencioso;PROVIDENCIA                   ;METROPOLITANA;19990;1;1;0;0;0;1;1;19990;Celular AL3 CLARO DIRECTO NEGRO;TELEFONIA
17979627;;M;30;CHILENO;;Millenial;N/D;N/D;199980;2;1;0;0;0;2;1;199980;CELULAR A21s 128 GB AZUL;TELEFONIA
19900207;;F;23;CHILENO;;Millenial;"";"";990;1;1;0;0;0;1;1;990;CHIP OPEN ENTEL;TELEFONIA
11531855;;M;52;CHILENO;;X;LONGAVI                       ;MAULE;109480;2;1;0;0;0;2;1;109480;CELULAR CLARO MOTOROLA E7 32GB GRIS;TELEFONIA
25675027;;F;34;PERUANO;;Extranjero;N/D;N/D;999980;3;1;0;0;0;3;1;999980;CELULAR Galaxy Z Flip3 128GB LAVENDER OPEN;TELEFONIA
18689216;;M;28;CHILENO;;Millenial;OVALLE                        ;COQUIMBO;649990;1;1;1;1;649990;0;0;0;CELULAR MI 11 EU 256G MIDNIGHT GRAY;TELEFONIA
10009494;;M;55;CHILENO;;Boomers;RENCA                         ;METROPOLITANA;149990;1;1;0;0;0;1;1;149990;CELULAR A21s 128 GB AZUL;TELEFONIA
10301597;;M;57;CHILENO;;Boomers;PUENTE ALTO                   ;METROPOLITANA;144980;2;1;0;0;0;2;1;144980;CELULAR VIVO Y11S NEBULA BLUE 32GB OPEN;TELEFONIA
16883513;Soltero;F;33;CHILENO;;Millenial;PROVIDENCIA                   ;METROPOLITANA;134540;2;1;2;1;134540;0;0;0;CELULAR A12 128GB Negro OPEN;TELEFONIA
16411702;;F;35;CHILENO;;Millenial;N/D;N/D;99990;1;1;0;0;0;1;1;99990;CELULAR OPPO A15 BLACK 32GB CLARO;TELEFONIA
12410330;;F;50;CHILENO;;X;LA PINTANA                    ;METROPOLITANA;164980;2;1;0;0;0;2;1;164980;CELULAR A12 128GB Negro OPEN;TELEFONIA
17795232;;M;31;CHILENO;;Millenial;CURICO                        ;MAULE;139990;1;1;0;0;0;1;1;139990;CELULAR A21s 128 GB Negro;TELEFONIA
12516565;;F;49;CHILENO;;X;N/D;N/D;149990;1;1;0;0;0;1;1;149990;CELULAR REDMI 9T 128 GB OCEAN GREEN;TELEFONIA
12718667;;M;48;CHILENO;;X;RINCONADA                     ;VALPARAISO;109990;2;1;0;0;0;2;1;109990;CELULAR A21s 128 GB Negro;TELEFONIA
19716282;;M;24;CHILENO;;Z;N/D;N/D;199990;1;1;1;1;199990;0;0;0;CELULAR POCO X3 PRO 128 GB FROST BLUE;TELEFONIA
18458498;;F;29;CHILENO;;Millenial;CASTRO                        ;LOS LAGOS;129990;1;1;0;0;0;1;1;129990;CELULAR A12 128GB ROJO OPEN;TELEFONIA
6528454;;F;70;CHILENO;;Silencioso;EL MONTE                      ;METROPOLITANA;189990;1;1;0;0;0;1;1;189990;CELULAR MOTOROLA G9 PLUS 128GB AZUL CLARO;TELEFONIA
15180956;;M;40;CHILENO;;X;N/D;N/D;124990;1;1;0;0;0;1;1;124990;CELULAR XIAOMI REDMI 9T 128GB VERDE CLARO;TELEFONIA
13202421;Soltero;F;45;CHILENO;;X;PROVIDENCIA                   ;METROPOLITANA;109990;2;1;0;0;0;2;1;109990;CELULAR REDMI NOTE 8 2021 64GB MOONLIGHT WHITE;TELEFONIA
6097249;;M;71;CHILENO;;Silencioso;COELEMU                       ;BIO BIO;549981;3;1;0;0;0;3;1;549981;CELULAR GALAXY S20FE 128GB CLOUD LAVENDER OPEN;TELEFONIA
15761379;Soltero;M;37;CHILENO;;Millenial;CABILDO                       ;VALPARAISO;119480;2;1;0;0;0;2;1;119480;CELULAR REDMI 9C 32GB MIDNIGHT GRAY;TELEFONIA
17507884;;F;31;CHILENO;;Millenial;RANCAGUA                      ;L.G.B.OÂ´HIGGINS;229990;1;1;0;0;0;1;1;229990;CELULAR POCO X3 PRO 256 GB FROST BLUE;TELEFONIA
18816390;;F;27;CHILENO;;Silencioso;PROVIDENCIA                   ;METROPOLITANA;139990;1;1;0;0;0;1;1;139990;CELULAR POCO M3 128GB POWER BLACK;TELEFONIA
9330602;;F;63;CHILENO;;Boomers;VILLARICA                     ;ARAUCANIA;191660;3;1;0;0;0;3;1;191660;CELULAR A12 128GB Rojo OPEN;TELEFONIA
14284244;Soltero;F;48;CHILENO;;X;CAUQUENES                     ;MAULE;93770;2;1;0;0;0;2;1;93770;CELULAR MOTOROLA E6 PLAY AZUL TRI WOM;TELEFONIA
26321987;;M;30;VENEZOLANO;;Extranjero;N/D;N/D;139990;1;1;0;0;0;1;1;139990;CELULAR MOTO ONE FUSION 128GB AZUL OPEN;TELEFONIA
10603642;;F;57;CHILENO;;Boomers;"";"";431940;4;1;4;1;431940;0;0;0;CELULAR A21s 128 GB Negro;TELEFONIA
13413211;;F;44;CHILENO;;X;ALTO HOSPICIO;TARAPACA;314960;4;1;0;0;0;4;1;314960;CELULAR Samsung Galaxy A02s 32GB Azul WOM;TELEFONIA
16061451;;F;37;CHILENO;;Millenial;PROVIDENCIA                   ;METROPOLITANA;139990;1;1;0;0;0;1;1;139990;CELULAR A12 128GB Negro OPEN;TELEFONIA
14178785;;F;40;CHILENO;;X;N/D;N/D;139990;1;1;0;0;0;1;1;139990;CELULAR A21s 128 GB Negro;TELEFONIA
8876480;;F;63;CHILENO;;Boomers;VALDIVIA                      ;LOS LAGOS;522860;3;4;0;0;0;3;4;522860;CELULAR A72 128 GB BLUE OPEN;TELEFONIA
6267081;;F;74;CHILENO;;Silencioso;TOCOPILLA                     ;ANTOFAGASTA;169980;2;1;0;0;0;2;1;169980;CELULAR Xiaomi Redmi 9 64 GB Morado WOM;TELEFONIA
18698809;;M;27;CHILENO;;Silencioso;PROVIDENCIA                   ;METROPOLITANA;997870;2;1;0;0;0;2;1;997870;Celular Galaxy S21 Ultra Phantom Silver 128GB;TELEFONIA
11174707;;F;54;CHILENO;;Boomers;LINARES                       ;MAULE;129990;1;1;1;1;129990;0;0;0;CELULAR XIAOMI REDMI 9T TWILIGHT BLUE MOVISTAR;TELEFONIA
7559369;;F;69;CHILENO;;Silencioso;VALLENAR;ATACAMA;473948;5;2;0;0;0;5;2;473948;CELULAR A21s 128 GB Rojo;TELEFONIA
13697912;Casado;M;43;CHILENO;;X;SAN ANTONIO                   ;VALPARAISO;179990;1;1;0;0;0;1;1;179990;CELULAR MOTO G9 POWER 128GB MORADO SONICO OPEN;TELEFONIA
13866402;;M;49;CHILENO;;X;PROVIDENCIA                   ;METROPOLITANA;225200;6;2;0;0;0;6;2;225200;CELULAR SAMSUNG A12 128GB BLACK CLARO;TELEFONIA
10138652;;M;57;CHILENO;;Boomers;PROVIDENCIA                   ;METROPOLITANA;59990;1;1;0;0;0;1;1;59990;Celular LG K22 DIRECTO CLARO;TELEFONIA
11803181;;F;51;CHILENO;;X;VILLARICA                     ;ARAUCANIA;79990;1;1;0;0;0;1;1;79990;Celular NOKIA 4.2 ENTEL DIRECTO NEGRO;TELEFONIA
16255440;;M;36;CHILENO;;Millenial;N/D;N/D;294980;2;1;0;0;0;2;1;294980;CELULAR REDMI NOTE 10S 128GB PEBBLE WHITE;TELEFONIA
20157199;;F;23;CHILENO;;Silencioso;PROVIDENCIA                   ;METROPOLITANA;189980;2;1;0;0;0;2;1;189980;CELULAR A12 128GB Rojo OPEN;TELEFONIA
23437845;;F;50;SALVADOREÃO;;Extranjero;N/D;N/D;45991;1;1;0;0;0;1;1;45991;CELULAR POCO M3 PRO 5G 128GB COOL BLUE;TELEFONIA
7861125;;M;63;CHILENO;;Silencioso;PROVIDENCIA                   ;METROPOLITANA;37990;1;3;0;0;0;1;3;37990;CELULAR NOKIA QUEEN VALUE BLACK CLARO;TELEFONIA
14058046;;F;41;CHILENO;;X;PROVIDENCIA                   ;METROPOLITANA;399990;1;1;0;0;0;1;1;399990;CELULAR GALAXY S20FE 128GB CLOUD LAVENDER OPEN;TELEFONIA
19218111;;M;27;CHILENO;;Millenial;PROVIDENCIA                   ;METROPOLITANA;119990;1;1;0;0;0;1;1;119990;CELULAR MOTOROLA G9 PLAY 64GB ELECTRIC BLUE OPEN;TELEFONIA
12983150;;F;45;CHILENO;;X;CURANILAHUE                   ;BIO BIO;168970;3;2;0;0;0;3;2;168970;CELULAR REDMI 9T 128 GB OCEAN GREEN;TELEFONIA
12804407;;F;46;CHILENO;;X;RENCA                         ;METROPOLITANA;229990;1;1;0;0;0;1;1;229990;CELULAR POCO X3 PRO 256 GB FROST BLUE;TELEFONIA
9486433;;F;57;CHILENO;;Boomers;LOS ANGELES                   ;BIO BIO;104990;1;1;0;0;0;1;1;104990;CELULAR MOTOROLA G9 PLAY 64GB ELECTRIC BLUE OPEN;TELEFONIA
8195120;;M;61;CHILENO;;Boomers;PUERTO MONTT                  ;LOS LAGOS;139990;1;3;3;2;278530;-2;1;-138540;CELULAR A21s 128 GB AZUL;TELEFONIA
13884663;;F;42;CHILENO;;X;EL BOSQUE                     ;METROPOLITANA;149980;4;2;0;0;0;4;2;149980;CELULAR MOTOROLA G20 64GB BLUE CLARO;TELEFONIA
18622889;;M;27;CHILENO;;Silencioso;PROVIDENCIA                   ;METROPOLITANA;883980;2;1;2;1;883980;0;0;0;Celular Galaxy S21 Ultra Phantom Black 128GB;TELEFONIA
18741109;Soltero;F;28;CHILENO;;Millenial;PROVIDENCIA                   ;METROPOLITANA;9990;1;1;0;0;0;1;1;9990;PRODUCTO 2 SELECCION BANDA 1;TELEFONIA
17330921;;F;32;CHILENO;;Millenial;PROVIDENCIA                   ;METROPOLITANA;199990;1;1;0;0;0;1;1;199990;CELULAR A32 128 GB BLUE OPEN;TELEFONIA
20211215;;F;23;CHILENO;;Z;PROVIDENCIA                   ;METROPOLITANA;134980;2;1;2;1;134980;0;0;0;CELULAR A12 128GB Rojo OPEN;TELEFONIA
10648728;;M;53;CHILENO;;X;CONSTITUCION                  ;MAULE;205480;2;1;2;1;205480;0;0;0;CELULAR REDMI NOTE 10S 128GB OCEAN BLUE;TELEFONIA
16549369;;F;35;CHILENO;;Extranjero;ANTOFAGASTA                   ;ANTOFAGASTA;129990;1;1;0;0;0;1;1;129990;CELULAR A12 128GB ROJO OPEN;TELEFONIA
16254092;Soltero;M;36;CHILENO;INGENIERIA EN PREVENCION DE RIESGOS CALIDAD Y AMBIENTE;Millenial;RANCAGUA                      ;L.G.B.OÂ´HIGGINS;139990;1;1;0;0;0;1;1;139990;CELULAR MOTO ONE FUSION 128GB AZUL OPEN;TELEFONIA
24258789;;F;41;CHILENO;;X;LOS ANDES                     ;VALPARAISO;229990;1;1;0;0;0;1;1;229990;CELULAR A32 128 GB BLACK OPEN;TELEFONIA
18901749;Soltero;F;29;CHILENO;;Millenial;PROVIDENCIA                   ;METROPOLITANA;129480;2;1;0;0;0;2;1;129480;CELULAR REDMI 9C 64GB SUNRISE ORANGE;TELEFONIA
7307501;;M;68;CHILENO;;Boomers;ANGOL                         ;ARAUCANIA;164980;2;1;0;0;0;2;1;164980;SMARTPHONE A03S AZUL 32GB;TELEFONIA
10461624;;M;56;CHILENO;;Boomers;MULCHEN                       ;BIO BIO;119480;2;1;0;0;0;2;1;119480;Celular A10S LIB OPEN NEGRO;TELEFONIA
12302833;;F;50;CHILENO;;X;N/D;N/D;109480;2;1;0;0;0;2;1;109480;CELULAR CLARO MOTOROLA E7 32GB GRIS;TELEFONIA
24808766;;F;40;PERUANO;;Extranjero;ESTACION CENTRAL              ;METROPOLITANA;89480;3;1;0;0;0;3;1;89480;CELULAR VIVO Y11S PHANTOM BLACK OPEN;TELEFONIA
20230617;;F;22;CHILENO;;Z;PROVIDENCIA                   ;METROPOLITANA;489980;3;1;0;0;0;3;1;489980;CELULAR GALAXY S20FE 128GB CLOUD LAVENDER OPEN;TELEFONIA
20082712;;M;32;CHILENO;;Millenial;N/D;N/D;581980;2;1;0;0;0;2;1;581980;CELULAR SAMSUNG NOTE 20 MYSTIC GRAY OPEN;TELEFONIA
10555630;Soltero;M;49;CHILENO;;X;RENCA                         ;METROPOLITANA;99990;1;1;0;0;0;1;1;99990;CELULAR VIVO Y11S PHANTOM BLACK OPEN;TELEFONIA
18319462;;M;29;CHILENO;;Millenial;ANGOL                         ;ARAUCANIA;141980;2;1;0;0;0;2;1;141980;CELULAR A12 128GB ROJO OPEN;TELEFONIA
15732921;;M;38;CHILENO;;Millenial;N/D;N/D;119990;1;1;0;0;0;1;1;119990;CELULAR POCO M3 64GB COOL BLUE;TELEFONIA
7720334;;F;69;CHILENO;;Silencioso;N/D;N/D;239990;1;3;0;0;0;1;3;239990;POCO X3 PRO 256 GB PHANTOM BLACK;TELEFONIA
13614419;;F;43;CHILENO;;X;CHANCO                        ;MAULE;234990;2;1;0;0;0;2;1;234990;CELULAR POCO X3 PRO 256 GB FROST BLUE;TELEFONIA
14294465;;F;46;CHILENO;;X;CHILLAN                       ;BIO BIO;239990;1;1;0;0;0;1;1;239990;POCO X3 PRO 256 GB PHANTOM BLACK;TELEFONIA
19367058;;M;26;CHILENO;;Silencioso;PROVIDENCIA                   ;METROPOLITANA;0;0;0;0;0;0;0;0;0;CELULAR NOKIA 225 4G BLACK MOVISTAR DIRECTO;TELEFONIA
25919962;;M;35;VENEZOLANO;;Extranjero;SAN MIGUEL                    ;METROPOLITANA;0;0;0;0;0;0;0;0;0;CELULAR MOTO ONE FUSION 64GB VERDE 64GB OPEN;TELEFONIA
19485861;;F;32;CHILENO;;Millenial;PROVIDENCIA                   ;METROPOLITANA;0;0;0;0;0;0;0;0;0;CELULAR MOTOROLA E6 PLAY AZUL TRI WOM;TELEFONIA
7042488;;F;72;CHILENO;;Silencioso;PENAFLOR                      ;METROPOLITANA;0;0;0;0;0;0;0;0;0;CELULAR A02 AZUL 32GB OPEN;TELEFONIA
17236167;;M;32;CHILENO;;Millenial;SALAMANCA                     ;COQUIMBO;0;0;0;0;0;0;0;0;0;CELULAR POCO X3 PRO 128G PHANTOM BLACK OPEN;TELEFONIA
16293367;;M;35;CHILENO;;Millenial;CAUQUENES                     ;MAULE;0;0;0;0;0;0;0;0;0;CELULAR A12 128GB AZUL OPEN;TELEFONIA
11413248;;F;52;CHILENO;;X;RENCA                         ;METROPOLITANA;0;0;0;0;0;0;0;0;0;CELULAR A32 128 GB BLUE OPEN;TELEFONIA
17577015;Soltero;M;32;CHILENO;;Millenial;PROVIDENCIA                   ;METROPOLITANA;0;0;0;0;0;0;0;0;0;CELULAR A32 128 GB BLUE OPEN;TELEFONIA
14064130;Soltero;F;40;CHILENO;;X;RENCA                         ;METROPOLITANA;0;0;0;0;0;0;0;0;0;CELULAR POCO X3 PRO 256 GB FROST BLUE;TELEFONIA
12316637;Casado;M;50;CHILENO;INGENIERO AGRICOLA;X;RENCA                         ;METROPOLITANA;0;0;0;0;0;0;0;0;0;CELULAR A21s 128 GB Negro;TELEFONIA
18409224;;M;28;CHILENO;;Millenial;PROVIDENCIA                   ;METROPOLITANA;0;0;0;0;0;0;0;0;0;IPHONE XS 64GB GRIS REAC;TELEFONIA
15886634;Soltero;M;38;CHILENO;;Millenial;PROVIDENCIA                   ;METROPOLITANA;0;0;0;0;0;0;0;0;0;CELULAR A21s 128 GB AZUL;TELEFONIA
11164290;;F;55;CHILENO;;Boomers;PUENTE ALTO                   ;METROPOLITANA;0;0;0;0;0;0;0;0;0;CELULAR A21s 128 GB Rojo;TELEFONIA
12879101;;M;46;CHILENO;;X;RENCA                         ;METROPOLITANA;0;0;0;0;0;0;0;0;0;CELULAR MOTO G9 POWER 128GB MORADO SONICO OPEN;TELEFONIA
17626722;Soltero;M;31;CHILENO;;Millenial;PROVIDENCIA                   ;METROPOLITANA;0;0;0;0;0;0;0;0;0;CELULAR A32 128 GB BLUE OPEN;TELEFONIA
11338330;;F;54;CHILENO;;X;PROVIDENCIA                   ;METROPOLITANA;0;0;0;0;0;0;0;0;0;CELULAR MOTO ONE FUSION 64GB VERDE 64GB OPEN;TELEFONIA
16381176;;F;36;CHILENO;;Millenial;PROVIDENCIA                   ;METROPOLITANA;0;0;0;0;0;0;0;0;0;Celular Galaxy S21 Ultra Phantom Silver 128GB;TELEFONIA
18666329;;M;28;CHILENO;;Silencioso;PROVIDENCIA                   ;METROPOLITANA;0;0;0;0;0;0;0;0;0;CELULAR SAMSUNG NOTE 20 MYSTIC GRAY OPEN;TELEFONIA
18581562;;F;28;CHILENO;;Millenial;N/D;N/D;0;0;0;0;0;0;0;0;0;CELULAR A72 128 GB LIGHT VIOLET OPEN;TELEFONIA
15907810;;M;37;CHILENO;;Millenial;N/D;N/D;0;0;0;0;0;0;0;0;0;POCO X3 PRO 256 GB PHANTOM BLACK;TELEFONIA
10346035;;M;56;CHILENO;;Boomers;N/D;N/D;0;0;0;0;0;0;0;0;0;CELULAR A02 AZUL 32GB OPEN;TELEFONIA
12128639;;M;50;CHILENO;;X;PROVIDENCIA                   ;METROPOLITANA;0;0;0;0;0;0;0;0;0;CELULAR A21s 128 GB Negro;TELEFONIA
18374289;;M;29;CHILENO;;Millenial;PROVIDENCIA                   ;METROPOLITANA;0;0;0;0;0;0;0;0;0;CELULAR POCO X3 PRO 256 GB FROST BLUE;TELEFONIA
11663744;;M;52;CHILENO;;X;TEODORO SCHMIDT               ;ARAUCANIA;0;0;0;0;0;0;0;0;0;CELULAR XIAOMI REDMI 9C 32GB AZUL WOM;TELEFONIA
13196992;;F;46;CHILENO;;X;PROVIDENCIA                   ;METROPOLITANA;0;0;0;0;0;0;0;0;0;CELULAR MOTO G30 128GB LILA PASTEL OPEN;TELEFONIA
5387056;;M;76;CHILENO;;Silencioso;CASTRO                        ;LOS LAGOS;0;0;0;0;0;0;0;0;0;CELULAR A02 NEGRO 32GB OPEN;TELEFONIA
9526059;;M;60;CHILENO;;Silencioso;PROVIDENCIA                   ;METROPOLITANA;0;0;0;0;0;0;0;0;0;CELULAR OWN 1026 AZUL ENTEL;TELEFONIA
19678492;;M;24;CHILENO;;Z;PROVIDENCIA                   ;METROPOLITANA;0;0;0;0;0;0;0;0;0;CELULAR A12 128GB NEGRO OPEN;TELEFONIA
16194074;;F;35;CHILENO;;Millenial;SAN BERNARDO                  ;METROPOLITANA;0;0;0;0;0;0;0;0;0;CELULAR A12 128GB NEGRO OPEN;TELEFONIA
15211601;;M;38;CHILENO;;X;LAJA                          ;BIO BIO;0;0;0;0;0;0;0;0;0;CELULAR A72 128 GB BLACK OPEN;TELEFONIA
12806858;;F;47;CHILENO;;X;N/D;N/D;0;0;0;0;0;0;0;0;0;CELULAR MOTO G9 POWER PURPLE 128GB MOVISTAR;TELEFONIA
26113423;;M;49;VENEZOLANO;;Extranjero;"";"";0;0;0;0;0;0;0;0;0;CELULAR REDMI NOTE 10 PRO 6+128GB GRADIENT BRONZ;TELEFONIA
12918463;;F;48;CHILENO;;X;N/D;N/D;0;0;0;0;0;0;0;0;0;CELULAR A21s 128 GB Negro;TELEFONIA
5798105;;F;73;CHILENO;;Silencioso;TOCOPILLA                     ;ANTOFAGASTA;0;0;0;0;0;0;0;0;0;CELULAR MOTOROLA E7 IPOWER 32GB BLUE CLARO;TELEFONIA
15916609;;M;37;CHILENO;;Millenial;RENCA                         ;METROPOLITANA;0;0;0;0;0;0;0;0;0;Celular A11 LIB OPEN BLUE;TELEFONIA
16594576;;F;35;CHILENO;;Millenial;PROVIDENCIA                   ;METROPOLITANA;0;0;0;0;0;0;0;0;0;Celular ZTE A3 2020 ENTEL DIRECTO GRIS;TELEFONIA
11030294;;F;56;CHILENO;;Millenial;"";"";0;0;0;0;0;0;0;0;0;CELULAR POCO M3 128GB POWER BLACK;TELEFONIA
6995742;;M;67;CHILENO;;Boomers;SAN BERNARDO                  ;METROPOLITANA;0;0;0;0;0;0;0;0;0;CELULAR A12 128GB AZUL OPEN;TELEFONIA
10619321;Casado;F;53;CHILENO;;X;PROVIDENCIA                   ;METROPOLITANA;0;0;0;0;0;0;0;0;0;CELULAR SAMSUNG A12 128GB BLACK CLARO;TELEFONIA
17627440;;F;32;CHILENO;;Silencioso;PROVIDENCIA                   ;METROPOLITANA;0;0;0;0;0;0;0;0;0;CELULAR MOTO ONE FUSION 128GB AZUL OPEN;TELEFONIA
16956649;;F;33;CHILENO;;Millenial;N/D;N/D;0;0;0;0;0;0;0;0;0;CELULAR CLARO MOTOROLA E7 32GB GRIS;TELEFONIA
8487843;;F;62;CHILENO;;Boomers;CURANILAHUE                   ;BIO BIO;0;0;0;0;0;0;0;0;0;CELULAR A21s 128 GB Negro;TELEFONIA
16707273;Casado;F;34;CHILENO;CONTADOR AUDITOR;Millenial;RENCA                         ;METROPOLITANA;0;0;0;0;0;0;0;0;0;CELULAR NOKIA 225 4G BLACK MOVISTAR DIRECTO;TELEFONIA
18952778;;F;26;CHILENO;;Z;N/D;N/D;0;0;0;0;0;0;0;0;0;IPHONE 5S 16GB DORADO OPEN;TELEFONIA
14340834;;F;44;CHILENO;;X;PUDAHUEL                      ;METROPOLITANA;0;0;0;0;0;0;0;0;0;CELULAR MI 11 LITE 128GB BUBBLEGUM BLUE;TELEFONIA
12947363;Soltero;M;46;CHILENO;;X;RENCA                         ;METROPOLITANA;0;0;0;0;0;0;0;0;0;CELULAR A21s 128 GB AZUL;TELEFONIA
9511233;Casado;M;59;CHILENO;;Boomers;PROVIDENCIA                   ;METROPOLITANA;0;0;0;0;0;0;0;0;0;CELULAR A21s 128 GB Negro;TELEFONIA
17473532;;M;32;CHILENO;;Millenial;PROVIDENCIA                   ;METROPOLITANA;0;0;0;0;0;0;0;0;0;Celular AL3 CLARO DIRECTO NEGRO;TELEFONIA
20076452;;F;23;CHILENO;;Z;LA SERENA;COQUIMBO;0;0;0;0;0;0;0;0;0;CELULAR REDMI NOTE 10 PRO 6+128GB GRADIENT BRONZ;TELEFONIA
19389319;Soltero;M;26;CHILENO;;Z;PROVIDENCIA                   ;METROPOLITANA;0;0;0;0;0;0;0;0;0;CELULAR A21s 128 GB Negro;TELEFONIA
14389521;;M;43;CHILENO;;X;LINARES                       ;MAULE;0;0;0;0;0;0;0;0;0;CELULAR A21s 128 GB Rojo;TELEFONIA
17018609;;F;33;CHILENO;;Millenial;N/D;N/D;0;0;0;0;0;0;0;0;0;CELULAR MOTO E6I 32GB GRIS OPEN;TELEFONIA
5930073;;M;78;CHILENO;;Silencioso;VILLARICA                     ;ARAUCANIA;0;0;0;0;0;0;0;0;0;CELULAR OWN 1026 AZUL ENTEL;TELEFONIA
13015342;;M;46;CHILENO;;X;N/D;N/D;0;0;0;0;0;0;0;0;0;Celular Y9S LIB OPEN BLACK;TELEFONIA
9513785;Soltero;F;60;CHILENO;;Boomers;PROVIDENCIA                   ;METROPOLITANA;0;0;0;0;0;0;0;0;0;CELULAR A12 128GB NEGRO OPEN;TELEFONIA
17305402;;F;32;CHILENO;;Millenial;N/D;N/D;0;0;0;0;0;0;0;0;0;CELULAR A12 128GB AZUL OPEN;TELEFONIA
13398268;;F;43;CHILENO;;Silencioso;PROVIDENCIA                   ;METROPOLITANA;0;0;0;0;0;0;0;0;0;CELULAR A12 128GB NEGRO OPEN;TELEFONIA
14354059;;M;43;CHILENO;;X;RENCA                         ;METROPOLITANA;0;0;0;0;0;0;0;0;0;CELULAR MOTOROLA E6 PLAY AZUL TRI WOM;TELEFONIA
9158958;;M;61;CHILENO;;Boomers;RENCA                         ;METROPOLITANA;0;0;0;0;0;0;0;0;0;CELULAR MOTO ONE FUSION 64GB VERDE 64GB OPEN;TELEFONIA
11306560;;F;54;CHILENO;;X;SANTIAGO                      ;METROPOLITANA;0;0;0;0;0;0;0;0;0;CELULAR BMOBILE AX820 NEGRO TEL;TELEFONIA
15456739;;F;40;CHILENO;;X;N/D;N/D;0;0;0;0;0;0;0;0;0;CELULAR MOTOROLA G9 PLAY 64GB SPRING PINK OPEN;TELEFONIA
16951611;;F;34;CHILENO;;Millenial;PUDAHUEL;METROPOLITANA;0;0;0;0;0;0;0;0;0;CELULAR A21s 128 GB AZUL;TELEFONIA
13643664;;M;44;CHILENO;;X;N/D;N/D;0;0;0;0;0;0;0;0;0;CELULAR NOTE 20 ULTRA MYSTIC BLACK 256GB OPEN;TELEFONIA
14315645;;F;46;CHILENO;;X;VINA DEL MAR                  ;VALPARAISO;0;0;0;0;0;0;0;0;0;Celular LG K22 ENTEL DIRECTO TITAN;TELEFONIA
16306898;;M;36;CHILENO;;Millenial;COQUIMBO                      ;COQUIMBO;0;0;0;0;0;0;0;0;0;CELULAR REDMI NOTE 8 2021 64 GB SPACE BLACK;TELEFONIA
10974408;;F;53;CHILENO;;X;N/D;N/D;0;0;0;0;0;0;0;0;0;CELULAR A12 128GB NEGRO TRIANGULADO CLARO;TELEFONIA
8772589;;F;45;CHILENO;;X;ISLA DE MAIPO                 ;METROPOLITANA;0;0;0;0;0;0;0;0;0;CELULAR A32 128 GB BLUE OPEN;TELEFONIA
13723571;;M;43;CHILENO;;X;PROVIDENCIA                   ;METROPOLITANA;0;0;0;0;0;0;0;0;0;CELULAR SAMSUNG A12 128GB BLACK CLARO;TELEFONIA
18929756;;M;27;CHILENO;;Millenial;N/D;N/D;0;0;0;0;0;0;0;0;0;POCO X3 PRO 256 GB PHANTOM BLACK;TELEFONIA
19585269;;F;25;CHILENO;;Z;PROVIDENCIA                   ;METROPOLITANA;0;0;0;0;0;0;0;0;0;CELULAR REDMI 9 64GB SUNSET PURPLE TRI WOM;TELEFONIA
20387337;;F;22;CHILENO;;Z;N/D;N/D;0;0;0;0;0;0;0;0;0;POCO X3 PRO 256 GB PHANTOM BLACK;TELEFONIA
12936270;;M;46;CHILENO;;X;COIHAIQUE                     ;AYSEN;0;0;0;0;0;0;0;0;0;Celular A12 Negro 128GB Tri Entel;TELEFONIA
7329733;;F;68;CHILENO;;Silencioso;SAN FERNANDO                  ;L.G.B.OÂ´HIGGINS;0;0;0;0;0;0;0;0;0;CELULAR MOTO ONE FUSION 64GB VERDE 64GB OPEN;TELEFONIA
20374504;;F;22;CHILENO;;Z;PROVIDENCIA                   ;METROPOLITANA;0;0;0;0;0;0;0;0;0;CELULAR REDMI NOTE 10 PRO 6+128GB GRADIENT BRONZ;TELEFONIA
7161603;Casado;M;67;CHILENO;;Boomers;SAN BERNARDO                  ;METROPOLITANA;0;0;0;0;0;0;0;0;0;CELULAR Xiaomi Redmi 9 64 GB Morado WOM;TELEFONIA
6588364;Casado;M;66;CHILENO;TECNICO EN ADMINISTRACION DE EMPRESAS;Boomers;RENCA                         ;METROPOLITANA;0;0;0;0;0;0;0;0;0;CELULAR A32 128 GB BLUE OPEN;TELEFONIA
7082594;;M;64;CHILENO;;Boomers;LA PINTANA                    ;METROPOLITANA;0;0;0;0;0;0;0;0;0;Celular LG K22 ENTEL DIRECTO TITAN;TELEFONIA
26034451;;M;26;COLOMBIANO;;Extranjero;PROVIDENCIA                   ;METROPOLITANA;0;0;0;0;0;0;0;0;0;Celular A01 Core Azul Tri Entel;TELEFONIA
7440195;;M;64;CHILENO;;Silencioso;PROVIDENCIA                   ;METROPOLITANA;0;0;0;0;0;0;0;0;0;CELULAR NOKIA 225 4G BLACK MOVISTAR DIRECTO;TELEFONIA
19949502;;M;23;CHILENO;;Silencioso;PROVIDENCIA                   ;METROPOLITANA;0;0;0;0;0;0;0;0;0;CELULAR A12 128GB ROJO OPEN;TELEFONIA
8313966;;M;62;CHILENO;;Boomers;PROVIDENCIA                   ;METROPOLITANA;0;0;0;0;0;0;0;0;0;CELULAR HUAWEI Y9A BLACK OPEN;TELEFONIA
17394829;;F;32;CHILENO;;Millenial;CURANILAHUE                   ;BIO BIO;0;0;0;0;0;0;0;0;0;CELULAR XIAOMI REDMI 9A 32GB BLACK DIRECTO CLARO;TELEFONIA
19253023;;F;26;CHILENO;;Z;CALAMA                        ;ANTOFAGASTA;0;0;0;0;0;0;0;0;0;CELULAR A32 128 GB LIGHT VIOLET OPEN;TELEFONIA
8129162;;M;55;CHILENO;;Boomers;PROVIDENCIA                   ;METROPOLITANA;0;0;0;0;0;0;0;0;0;CELULAR REDMI 9T 128 GB OCEAN GREEN;TELEFONIA
20681319;;F;27;CHILENO;;Z;ALTO HOSPICIO;TARAPACA;0;0;0;0;0;0;0;0;0;CELULAR REDMI NOTE 9 128G FOREST GREEN OPEN;TELEFONIA
9228862;;M;59;CHILENO;;Boomers;N/D;N/D;0;0;0;0;0;0;0;0;0;CELULAR A32 128 GB LIGHT VIOLET OPEN;TELEFONIA
18380488;;F;29;CHILENO;;Millenial;CERRO NAVIA                   ;METROPOLITANA;0;0;0;0;0;0;0;0;0;CELULAR A12 128GB ROJO OPEN;TELEFONIA
17911839;;M;31;CHILENO;;Millenial;PROVIDENCIA                   ;METROPOLITANA;0;0;0;0;0;0;0;0;0;CELULAR NOKIA 225 4G BLACK MOVISTAR DIRECTO;TELEFONIA
18015944;;F;30;CHILENO;;Millenial;N/D;N/D;0;0;0;0;0;0;0;0;0;Celular ZTE A3 2020 WOM DIRECTO NEGRO;TELEFONIA
14004670;;F;48;CHILENO;;X;OLMUE                         ;VALPARAISO;0;0;0;0;0;0;0;0;0;CELULAR A21s 128 GB Rojo;TELEFONIA
11691976;;M;52;CHILENO;;X;RENCA                         ;METROPOLITANA;0;0;0;0;0;0;0;0;0;CELULAR MOTO E6S 32GB GRIS DIRECTO ENTEL;TELEFONIA
19607246;;F;25;CHILENO;;Z;N/D;N/D;0;0;0;0;0;0;0;0;0;CELULAR A32 128 GB LIGHT VIOLET OPEN;TELEFONIA
18230407;;F;34;CHILENO;;Millenial;LEBU                          ;BIO BIO;0;0;0;0;0;0;0;0;0;CELULAR A21s 128 GB Rojo;TELEFONIA
18239125;;M;29;CHILENO;;Millenial;N/D;N/D;0;0;0;0;0;0;0;0;0;CELULAR MOTO ONE FUSION 64GB VERDE 64GB OPEN;TELEFONIA
9448668;;M;59;CHILENO;;Boomers;BUIN                          ;METROPOLITANA;0;0;0;0;0;0;0;0;0;CELULAR MOTO E6I 32GB GRIS OPEN;TELEFONIA
6917107;;F;68;CHILENO;;Silencioso;TOCOPILLA                     ;ANTOFAGASTA;0;0;0;0;0;0;0;0;0;CELULAR A02 ROJO 32GB OPEN;TELEFONIA
18359748;;M;29;CHILENO;;Millenial;PROVIDENCIA                   ;METROPOLITANA;0;0;0;0;0;0;0;0;0;CELULAR REDMI NOTE 9 128 GB MIDNIGHT GREY OPEN;TELEFONIA
13038562;;M;45;CHILENO;;X;N/D;N/D;0;0;0;0;0;0;0;0;0;CELULAR A21s 128 GB Rojo;TELEFONIA
8074800;;M;65;CHILENO;;Boomers;OLIVAR                        ;L.G.B.OÂ´HIGGINS;0;0;0;0;0;0;0;0;0;CELULAR MOTO E7 32GB ROSA CORAL OPEN;TELEFONIA
10206932;Casado;M;54;CHILENO;PROFESOR;X;RENCA                         ;METROPOLITANA;0;0;0;0;0;0;0;0;0;CELULAR A21s 128 GB Negro;TELEFONIA
9812546;;M;56;CHILENO;;Boomers;CURACAVI                      ;METROPOLITANA;0;0;0;0;0;0;0;0;0;CELULAR A21s 128 GB Negro;TELEFONIA
19989255;;M;23;CHILENO;;Z;"";"";0;0;0;0;0;0;0;0;0;CELULAR REDMI NOTE 8 2021 64 GB SPACE BLACK;TELEFONIA
16187665;;F;37;CHILENO;;Millenial;N/D;N/D;0;0;0;0;0;0;0;0;0;CELULAR REDMI NOTE 10 PRO 6+128GB GRADIENT BRONZ;TELEFONIA
6831580;;F;78;CHILENO;;Silencioso;SAN FERNANDO                  ;L.G.B.OÂ´HIGGINS;0;0;0;0;0;0;0;0;0;CELULAR A21s 128 GB Negro;TELEFONIA
19677473;;M;24;CHILENO;;Silencioso;PROVIDENCIA                   ;METROPOLITANA;0;0;0;0;0;0;0;0;0;CELULAR REDMI NOTE 9 128G FOREST GREEN OPEN;TELEFONIA
18867126;Soltero;M;28;CHILENO;;Silencioso;PROVIDENCIA                   ;METROPOLITANA;0;0;0;0;0;0;0;0;0;Celular A11 LIB OPEN WHITE;TELEFONIA
17457518;Soltero;M;32;CHILENO;INGENIERO CIVIL INFORMATICO;Millenial;PROVIDENCIA                   ;METROPOLITANA;0;0;0;0;0;0;0;0;0;CELULAR A32 128 GB BLUE OPEN;TELEFONIA
6693146;Casado;F;70;CHILENO;;Silencioso;PROVIDENCIA                   ;METROPOLITANA;0;0;0;0;0;0;0;0;0;CELULAR OWN 1026 AZUL ENTEL;TELEFONIA
6814520;Casado;F;73;CHILENO;;Silencioso;RENCA                         ;METROPOLITANA;0;0;0;0;0;0;0;0;0;CELULAR REDMI 9A 32GB PEACOCK GREEN;TELEFONIA
17030478;;M;33;CHILENO;;Extranjero;SANTIAGO                      ;METROPOLITANA;0;0;0;0;0;0;0;0;0;REPETIDOR MI WIFI RANGE EXTENDER PRO XIAOMI;TELEFONIA
13052359;;F;46;CHILENO;;Silencioso;PROVIDENCIA                   ;METROPOLITANA;0;0;0;0;0;0;0;0;0;CELULAR GALAXY S20FE 128GB CLOUD LAVENDER OPEN;TELEFONIA
11175264;;F;55;CHILENO;;Boomers;RENCA                         ;METROPOLITANA;0;0;0;0;0;0;0;0;0;Celular A11 LIB OPEN WHITE;TELEFONIA
18794501;;M;28;CHILENO;;Millenial;PROVIDENCIA                   ;METROPOLITANA;0;0;0;0;0;0;0;0;0;CELULAR MI 11 EU 256G Horizon Blue BUNDLE;TELEFONIA
19082490;;F;26;CHILENO;;Z;CABILDO                       ;VALPARAISO;0;0;0;0;0;0;0;0;0;CELULAR NOKIA 110 BLACK OPEN;TELEFONIA
17036081;;M;33;CHILENO;;Extranjero;PROVIDENCIA                   ;METROPOLITANA;0;0;0;0;0;0;0;0;0;CELULAR REDMI NOTE 10 128GB ONIX GRAY OPEN;TELEFONIA
14150031;;F;41;CHILENO;;X;PROVIDENCIA                   ;METROPOLITANA;0;0;0;0;0;0;0;0;0;CELULAR A32 128 GB LIGHT VIOLET OPEN;TELEFONIA
11131882;Casado;F;55;CHILENO;;Boomers;RENCA                         ;METROPOLITANA;0;0;0;0;0;0;0;0;0;CELULAR A32 128 GB LIGHT VIOLET OPEN;TELEFONIA
14026932;;M;41;CHILENO;;Silencioso;PROVIDENCIA                   ;METROPOLITANA;0;0;0;0;0;0;0;0;0;CELULAR A21s 128 GB Rojo;TELEFONIA
17886537;;F;30;CHILENO;;Millenial;ANGOL                         ;ARAUCANIA;0;0;0;0;0;0;0;0;0;CELULAR A02 AZUL 32GB OPEN;TELEFONIA
16614477;;F;34;CHILENO;;Millenial;TOCOPILLA                     ;ANTOFAGASTA;0;0;0;0;0;0;0;0;0;CELULAR A21s 128 GB Negro;TELEFONIA
17868861;Soltero;F;31;CHILENO;ABOGADO;Millenial;PROVIDENCIA                   ;METROPOLITANA;0;0;0;0;0;0;0;0;0;CELULAR A32 128 GB BLUE OPEN;TELEFONIA
10386809;;M;65;CHILENO;;Boomers;CANETE                        ;BIO BIO;0;0;0;0;0;0;0;0;0;CELULAR GALAXY S20FE 128GB ClOUD NAVY OPEN;TELEFONIA
8898571;;M;61;CHILENO;;Boomers;RENCA                         ;METROPOLITANA;0;0;0;0;0;0;0;0;0;CELULAR A12 128GB NEGRO OPEN;TELEFONIA
18932549;Soltero;M;27;CHILENO;;Millenial;PROVIDENCIA                   ;METROPOLITANA;0;0;0;0;0;0;0;0;0;CELULAR MI 10T PRO 256GB AURORA BLUE OPEN;TELEFONIA
20017733;;F;23;CHILENO;;Z;PROVIDENCIA                   ;METROPOLITANA;0;0;0;0;0;0;0;0;0;Celular Galaxy S21 Phantom Grey 128GB;TELEFONIA
12072411;;F;53;CHILENO;;X;RENCA                         ;METROPOLITANA;0;0;0;0;0;0;0;0;0;CELULAR POCO X3 PRO 256 GB FROST BLUE;TELEFONIA
22776945;;M;64;PERUANO;;Extranjero;CALAMA                        ;ANTOFAGASTA;0;0;0;0;0;0;0;0;0;CELULAR NOKIA 225 4G BLACK MOVISTAR DIRECTO;TELEFONIA
16414595;;F;35;CHILENO;;Silencioso;PROVIDENCIA                   ;METROPOLITANA;0;0;0;0;0;0;0;0;0;CELULAR A21s 128 GB Negro;TELEFONIA
6102254;;M;72;CHILENO;;Silencioso;N/D;N/D;0;0;0;0;0;0;0;0;0;CELULAR MOTO ONE FUSION 128GB AZUL OPEN;TELEFONIA
13357610;;M;43;CHILENO;;X;ANTOFAGASTA                   ;ANTOFAGASTA;0;0;0;0;0;0;0;0;0;CELULAR A32 128 GB LIGHT VIOLET OPEN;TELEFONIA
10745893;;F;51;CHILENO;;X;"";"";0;0;0;0;0;0;0;0;0;CELULAR A32 128 GB BLACK OPEN;TELEFONIA
9288789;Casado;M;60;CHILENO;;Boomers;RENCA                         ;METROPOLITANA;0;0;0;0;0;0;0;0;0;CELULAR A02 AZUL 32GB OPEN;TELEFONIA
17881139;;M;30;CHILENO;;Millenial;PROVIDENCIA                   ;METROPOLITANA;0;0;0;0;0;0;0;0;0;CELULAR VIVO Y20 BLACK 64GB MOVISTAR;TELEFONIA
10603524;Divorciado;M;52;CHILENO;;X;PROVIDENCIA                   ;METROPOLITANA;0;0;0;0;0;0;0;0;0;CELULAR MOTO ONE FUSION 64GB VERDE 64GB OPEN;TELEFONIA
17522495;;F;31;CHILENO;;Millenial;PROVIDENCIA                   ;METROPOLITANA;0;0;0;0;0;0;0;0;0;CELULAR MOTO G9 POWER 128GB MORADO SONICO OPEN;TELEFONIA
15522254;;M;37;CHILENO;;Millenial;BUIN                          ;METROPOLITANA;0;0;0;0;0;0;0;0;0;CELULAR A32 128 GB BLUE OPEN;TELEFONIA
17788531;;F;31;CHILENO;;Silencioso;PROVIDENCIA                   ;METROPOLITANA;0;0;0;0;0;0;0;0;0;CELULAR REDMI NOTE 10 128GB PEBBLE WHITE;TELEFONIA
19461143;;M;25;CHILENO;;Silencioso;PROVIDENCIA                   ;METROPOLITANA;0;0;0;0;0;0;0;0;0;CELULAR MOTO G8 POWER LITE TURQUESA TRI ENTEL;TELEFONIA
17210727;;M;32;CHILENO;;Millenial;PROVIDENCIA                   ;METROPOLITANA;0;0;0;0;0;0;0;0;0;Celular G8 POWER LITE MOVISTAR DIRECTO AZUL;TELEFONIA
11551308;;F;51;CHILENO;;X;"";"";0;0;0;0;0;0;0;0;0;CELULAR NOKIA 110 BLACK OPEN;TELEFONIA
12310446;;F;50;CHILENO;;Silencioso;PROVIDENCIA                   ;METROPOLITANA;0;0;0;0;0;0;0;0;0;CELULAR A12 128GB AZUL OPEN;TELEFONIA
16570167;;F;35;CHILENO;;Millenial;N/D;N/D;0;0;0;0;0;0;0;0;0;CELULAR MOTO E6S 32GB GRIS DIRECTO ENTEL;TELEFONIA
14149476;;F;47;CHILENO;;Extranjero;QUINTA NORMAL                 ;METROPOLITANA;0;0;0;0;0;0;0;0;0;CELULAR POCO X3 PRO 256 GB FROST BLUE;TELEFONIA
14017290;;F;40;CHILENO;;X;TALCA                         ;MAULE;0;0;0;0;0;0;0;0;0;CELULAR MOTO E6I 32GB GRIS OPEN;TELEFONIA
8893184;;F;51;CHILENO;;X;VILLARICA                     ;ARAUCANIA;0;0;0;0;0;0;0;0;0;CELULAR A32 128 GB LIGHT VIOLET OPEN;TELEFONIA
5853358;Casado;M;70;CHILENO;;Silencioso;RENCA                         ;METROPOLITANA;0;0;0;0;0;0;0;0;0;CELULAR A21s 128 GB AZUL;TELEFONIA
17211551;Casado;M;33;CHILENO;TECNICO DE NIVEL SUPERIOR EN ENFERMERIA;Millenial;RENCA                         ;METROPOLITANA;0;0;0;0;0;0;0;0;0;CELULAR GALAXY S20FE 128GB CLOUD LAVENDER OPEN;TELEFONIA
13847269;;M;41;CHILENO;;X;VALDIVIA                      ;LOS LAGOS;0;0;0;0;0;0;0;0;0;CELULAR MOTOROLA E6 PLAY AZUL TRI WOM;TELEFONIA
13271299;;M;45;CHILENO;;Silencioso;PROVIDENCIA                   ;METROPOLITANA;0;0;0;0;0;0;0;0;0;CELULAR GALAXY S20FE 128GB CLOUD LAVENDER OPEN;TELEFONIA
5847552;;M;73;CHILENO;;Silencioso;PAPUDO                        ;VALPARAISO;0;0;0;0;0;0;0;0;0;CELULAR REDMI 9 64GB SUNSET PURPLE TRI WOM;TELEFONIA
9863248;;F;59;CHILENO;;Boomers;CHILLAN                       ;NUBLE;0;0;0;0;0;0;0;0;0;CELULAR A02 AZUL 32GB OPEN;TELEFONIA
13715115;;M;42;CHILENO;;X;EL BOSQUE                     ;METROPOLITANA;0;0;0;0;0;0;0;0;0;CELULAR Samsung Galaxy A02s 32GB Azul WOM;TELEFONIA
8066233;;F;62;CHILENO;;Boomers;RENCA                         ;METROPOLITANA;0;0;0;0;0;0;0;0;0;CELULAR NOKIA 110 BLACK OPEN;TELEFONIA
19272167;Soltero;M;26;CHILENO;;Silencioso;PROVIDENCIA                   ;METROPOLITANA;0;0;0;0;0;0;0;0;0;Celular A11 LIB OPEN WHITE;TELEFONIA
18580791;Soltero;M;28;CHILENO;;Millenial;PROVIDENCIA                   ;METROPOLITANA;0;0;0;0;0;0;0;0;0;CELULAR MOTOROLA G9 PLAY 64GB ELECTRIC BLUE OPEN;TELEFONIA
16577889;Soltero;F;37;CHILENO;PROFESOR;Millenial;SAN FERNANDO                  ;L.G.B.OÂ´HIGGINS;0;0;0;0;0;0;0;0;0;CELULAR REDMI 9C 32GB TWILIGHT BLUE MOVISTAR;TELEFONIA
11244874;;F;54;CHILENO;;X;N/D;N/D;0;0;0;0;0;0;0;0;0;CELULAR VIVO Y20S NEBULA 128 GB BLUE OPEN;TELEFONIA
25614416;;M;33;HAITIANO;;Extranjero;MAIPU                         ;METROPOLITANA;0;0;0;0;0;0;0;0;0;CELULAR A12 128GB ROJO OPEN;TELEFONIA
12772909;;F;47;CHILENO;;X;ANGOL                         ;ARAUCANIA;0;0;0;0;0;0;0;0;0;CELULAR A12 128GB AZUL OPEN;TELEFONIA
13205426;;F;45;CHILENO;;X;CONSTITUCION                  ;MAULE;0;0;0;0;0;0;0;0;0;CELULAR REDMI NOTE 9 128G ONYX BLACK OPEN;TELEFONIA
16564890;;M;35;CHILENO;;Millenial;CALAMA                        ;ANTOFAGASTA;0;0;0;0;0;0;0;0;0;CELULAR A21s 128 GB AZUL;TELEFONIA
17112211;;F;33;CHILENO;;Millenial;N/D;N/D;0;0;0;0;0;0;0;0;0;CELULAR POCO X3 PRO 256 GB FROST BLUE;TELEFONIA
4089453;;M;82;CHILENO;;Silencioso;LOS ALAMOS                    ;BIO BIO;0;0;0;0;0;0;0;0;0;CELULAR REDMI NOTE 9 128G FOREST GREEN OPEN;TELEFONIA
8899231;Casado;F;60;CHILENO;;Boomers;RENCA                         ;METROPOLITANA;0;0;0;0;0;0;0;0;0;CELULAR CLARO MOTOROLA E7 32GB GRIS;TELEFONIA
20365714;;F;22;CHILENO;;Z;PROVIDENCIA                   ;METROPOLITANA;0;0;0;0;0;0;0;0;0;CELULAR A32 128 GB BLUE OPEN;TELEFONIA
12324492;Soltero;M;49;CHILENO;AGROINDUSTRIA;X;PROVIDENCIA                   ;METROPOLITANA;0;0;0;0;0;0;0;0;0;CELULAR MOTOROLA G9 PLAY 64GB SPRING PINK OPEN;TELEFONIA
12547375;;M;47;CHILENO;;X;SAN CARLOS                    ;BIO BIO;0;0;0;0;0;0;0;0;0;Celular A01 Core Azul Tri Entel;TELEFONIA
26014253;;F;29;EXTRANJERO - NO INFORMA NACIONALIDAD;;Extranjero;N/D;N/D;0;0;0;0;0;0;0;0;0;CELULAR POCO X3 PRO 256 GB FROST BLUE;TELEFONIA
7485974;Casado;F;66;CHILENO;;Boomers;PROVIDENCIA                   ;METROPOLITANA;0;0;0;0;0;0;0;0;0;CELULAR A12 128GB AZUL OPEN;TELEFONIA
18450269;;F;29;CHILENO;;Millenial;OVALLE                        ;COQUIMBO;0;0;0;0;0;0;0;0;0;CELULAR GALAXY A01 32GB AZUL ENTEL;TELEFONIA
14035992;;F;42;CHILENO;;X;PUERTO MONTT                  ;LOS LAGOS;0;0;0;0;0;0;0;0;0;CELULAR Xiaomi Redmi 9 64 GB Morado WOM;TELEFONIA
17930124;;M;30;CHILENO;;Millenial;OVALLE                        ;COQUIMBO;0;0;0;0;0;0;0;0;0;POCO X3 PRO 256 GB PHANTOM BLACK;TELEFONIA
13783100;;F;41;CHILENO;;X;CURICO                        ;MAULE;0;0;0;0;0;0;0;0;0;CELULAR NOKIA 110 BLACK OPEN;TELEFONIA
10415472;;M;51;CHILENO;;X;N/D;N/D;0;0;0;0;0;0;0;0;0;CELULAR A12 128GB NEGRO OPEN;TELEFONIA
8563464;;F;64;CHILENO;;Boomers;RENCA                         ;METROPOLITANA;0;0;0;0;0;0;0;0;0;Celular XIAOMI REDMI 9 64 GB DIRECTO CLARO NEGRO;TELEFONIA
11822616;;M;51;CHILENO;;X;DIEGO DE ALMAGRO              ;ATACAMA;0;0;0;0;0;0;0;0;0;CELULAR A02 NEGRO 32GB OPEN;TELEFONIA
10632637;;M;47;CHILENO;;X;N/D;N/D;0;0;0;0;0;0;0;0;0;CELULAR GALAXY S20FE 128GB ClOUD NAVY OPEN;TELEFONIA
17930984;;M;31;CHILENO;;Silencioso;PROVIDENCIA                   ;METROPOLITANA;0;0;0;0;0;0;0;0;0;CELULAR MOTO E6I 32GB GRIS OPEN;TELEFONIA
16128992;;F;36;CHILENO;;Millenial;PUENTE ALTO                   ;METROPOLITANA;0;0;0;0;0;0;0;0;0;CELULAR MOTO ONE FUSION 64GB VERDE 64GB OPEN;TELEFONIA
18341477;;F;29;CHILENO;;Millenial;RENAICO                       ;ARAUCANIA;0;0;0;0;0;0;0;0;0;CELULAR MOTO G20 64GB ROSA FLAMINGO OPEN;TELEFONIA
10407813;;F;55;CHILENO;;Boomers;VILLA ALEMANA                 ;VALPARAISO;0;0;0;0;0;0;0;0;0;CELULAR REDMI NOTE 10 128GB ONIX GRAY OPEN;TELEFONIA
16572251;;F;34;CHILENO;;Millenial;SAN BERNARDO                  ;METROPOLITANA;0;0;0;0;0;0;0;0;0;CELULAR MOTOROLA E6 PLAY AZUL TRI WOM;TELEFONIA
12326729;;F;49;CHILENO;;X;LOS ANGELES                   ;BIO BIO;0;0;0;0;0;0;0;0;0;CELULAR SAMSUNG A10S NEGRO WOM;TELEFONIA
13963245;;F;42;CHILENO;;X;RENCA                         ;METROPOLITANA;0;0;0;0;0;0;0;0;0;CELULAR REDMI NOTE 9 128G FOREST GREEN OPEN;TELEFONIA
15506922;Casado;M;39;CHILENO;INGENIERO EN TELECOMUNICACIONES;X;PROVIDENCIA                   ;METROPOLITANA;0;0;0;0;0;0;0;0;0;CELULAR A02 ROJO 32GB OPEN;TELEFONIA
6921771;;F;71;CHILENO;;Silencioso;CARAHUE                       ;ARAUCANIA;0;0;0;0;0;0;0;0;0;CELULAR LG K41S TITAN DIRECTO MOVISTAR;TELEFONIA
11832936;Casado;M;50;CHILENO;INGENIERO ELECTRONICO;X;RENCA                         ;METROPOLITANA;0;0;0;0;0;0;0;0;0;CELULAR A32 128 GB LIGHT VIOLET OPEN;TELEFONIA
13576841;;F;44;CHILENO;;X;LONGAVI                       ;MAULE;0;0;0;0;0;0;0;0;0;CELULAR OWN 1026 AZUL ENTEL;TELEFONIA
16825687;;F;34;CHILENO;;Millenial;LAJA                          ;BIO BIO;0;0;0;0;0;0;0;0;0;CELULAR SAMSUNG A02S DIRECTO CLARO BLACK;TELEFONIA
19417380;;F;25;CHILENO;;Z;PROVIDENCIA                   ;METROPOLITANA;0;0;0;0;0;0;0;0;0;CELULAR MOTO G9 POWER 128GB MORADO SONICO OPEN;TELEFONIA
13937296;;M;43;CHILENO;;X;QUINTA NORMAL                 ;METROPOLITANA;0;0;0;0;0;0;0;0;0;CELULAR A21s 128 GB AZUL;TELEFONIA
16958478;Soltero;M;32;CHILENO;;Silencioso;PROVIDENCIA                   ;METROPOLITANA;0;0;0;0;0;0;0;0;0;IPHONE XR 64GB LIB OPEN NEGRO;TELEFONIA
8617862;Soltero;M;64;CHILENO;;Boomers;PROVIDENCIA                   ;METROPOLITANA;0;0;0;0;0;0;0;0;0;CELULAR A02 ROJO 32GB OPEN;TELEFONIA
13978207;;F;40;CHILENO;;X;N/D;N/D;0;0;0;0;0;0;0;0;0;CELULAR A32 128 GB BLUE OPEN;TELEFONIA
19866581;;F;23;CHILENO;;Millenial;PROVIDENCIA                   ;METROPOLITANA;0;0;0;0;0;0;0;0;0;CELULAR MOTOROLA E6 PLAY AZUL TRI WOM;TELEFONIA
20189691;;F;23;CHILENO;;Z;PROVIDENCIA                   ;METROPOLITANA;0;0;0;0;0;0;0;0;0;CELULAR A21s 128 GB AZUL;TELEFONIA
13464147;;M;44;CHILENO;;X;MAIPU                         ;METROPOLITANA;0;0;0;0;0;0;0;0;0;CELULAR MOTO E6I 32GB GRIS OPEN;TELEFONIA
14601463;Soltero;M;46;CHILENO;;Extranjero;ARICA                         ;ARICA Y PARINACOTA;0;0;0;0;0;0;0;0;0;CELULAR POCO M3 64GB COOL BLUE;TELEFONIA
8568329;;F;63;CHILENO;;Boomers;RENCA                         ;METROPOLITANA;0;0;0;0;0;0;0;0;0;Celular A11 LIB OPEN BLACK;TELEFONIA
9952314;;F;53;CHILENO;;X;PUNTA ARENAS                  ;MAGALLANES;0;0;0;0;0;0;0;0;0;Celular AL3 CLARO DIRECTO NEGRO;TELEFONIA
6118208;;M;70;CHILENO;;Silencioso;PROVIDENCIA                   ;METROPOLITANA;0;0;0;0;0;0;0;0;0;CELULAR REDMI NOTE 9 DIRECTO CLARO BLUE;TELEFONIA
13623653;;M;43;CHILENO;;X;LOS ANGELES                   ;BIO BIO;0;0;0;0;0;0;0;0;0;CELULAR SAMSUNG A02S DIRECTO CLARO BLACK;TELEFONIA
9713343;;M;55;CHILENO;;Boomers;LA LIGUA                      ;VALPARAISO;0;0;0;0;0;0;0;0;0;Celular LG K22 DIRECTO CLARO;TELEFONIA
13385173;;F;44;CHILENO;;X;QUELLON                       ;LOS LAGOS;0;0;0;0;0;0;0;0;0;CELULAR VIVO Y20S NEBULA 128 GB BLUE OPEN;TELEFONIA
9075542;;F;59;CHILENO;;Boomers;SAN JAVIER                    ;MAULE;0;0;0;0;0;0;0;0;0;CELULAR A12 128GB AZUL OPEN;TELEFONIA
6670145;;M;68;CHILENO;;Silencioso;COQUIMBO                      ;COQUIMBO;0;0;0;0;0;0;0;0;0;CELULAR REDMI NOTE 10 128GB ONIX GRAY OPEN;TELEFONIA
12933616;Soltero;F;47;CHILENO;;X;PROVIDENCIA                   ;METROPOLITANA;0;0;0;0;0;0;0;0;0;CELULAR A32 128 GB LIGHT VIOLET OPEN;TELEFONIA
13698250;;M;43;CHILENO;;X;PROVIDENCIA                   ;METROPOLITANA;0;0;0;0;0;0;0;0;0;CELULAR REDMI NOTE 10 128GB PEBBLE WHITE;TELEFONIA
18148775;;F;29;CHILENO;;Millenial;PROVIDENCIA                   ;METROPOLITANA;0;0;0;0;0;0;0;0;0;CELULAR MOTO E6I 32GB GRIS OPEN;TELEFONIA
18214875;;M;30;CHILENO;;Millenial;CHILLAN VIEJO                 ;BIO BIO;0;0;0;0;0;0;0;0;0;CELULAR MOTOROLA G9 PLAY 64GB ELECTRIC BLUE OPEN;TELEFONIA
10319102;;M;56;CHILENO;;Boomers;PROVIDENCIA                   ;METROPOLITANA;0;0;0;0;0;0;0;0;0;CELULAR A21s 128 GB Negro;TELEFONIA
11402325;Soltero;F;54;CHILENO;;Silencioso;PROVIDENCIA                   ;METROPOLITANA;0;0;0;0;0;0;0;0;0;CELULAR REDMI NOTE 10 EU 128G Onyx Gray BUNDLE;TELEFONIA
9835017;;M;58;CHILENO;;Boomers;PENAFLOR                      ;METROPOLITANA;0;0;0;0;0;0;0;0;0;Celular XIAOMI REDMI 9C 64 GB DIRECTO CLARO;TELEFONIA
17935405;;F;31;CHILENO;;Millenial;N/D;N/D;0;0;0;0;0;0;0;0;0;CELULAR A21s 128 GB Rojo;TELEFONIA
5277196;;F;74;CHILENO;;Silencioso;RENCA                         ;METROPOLITANA;0;0;0;0;0;0;0;0;0;TELEFONO PP BINDU ENTEL;TELEFONIA
15811670;;M;38;CHILENO;;Millenial;ANTOFAGASTA                   ;ANTOFAGASTA;0;0;0;0;0;0;0;0;0;Celular A11 LIB OPEN BLACK;TELEFONIA
14094274;Casado;F;42;CHILENO;;X;COIHUECO                      ;BIO BIO;0;0;0;0;0;0;0;0;0;CELULAR OWN 1026 AZUL ENTEL;TELEFONIA
7916646;Soltero;M;62;CHILENO;;Silencioso;PROVIDENCIA                   ;METROPOLITANA;0;0;0;0;0;0;0;0;0;CELULAR OWN 1026 AZUL ENTEL;TELEFONIA
26462304;;M;31;VENEZOLANO;;Extranjero;N/D;N/D;0;0;0;0;0;0;0;0;0;CELULAR GALAXY S20FE 128GB ClOUD NAVY OPEN;TELEFONIA
16328111;;F;36;CHILENO;;Millenial;PROVIDENCIA                   ;METROPOLITANA;0;0;0;0;0;0;0;0;0;CELULAR A21s 128 GB AZUL;TELEFONIA
7764632;;M;65;CHILENO;;Boomers;VALDIVIA                      ;LOS RIOS;0;0;0;0;0;0;0;0;0;Celular A11 LIB OPEN WHITE;TELEFONIA
19004266;Soltero;F;27;CHILENO;;Silencioso;PROVIDENCIA                   ;METROPOLITANA;0;0;0;0;0;0;0;0;0;CELULAR A12 128GB NEGRO OPEN;TELEFONIA
15394336;;F;39;CHILENO;;Millenial;LA GRANJA                     ;METROPOLITANA;0;0;0;0;0;0;0;0;0;CELULAR A21s 128 GB AZUL;TELEFONIA
13968300;Soltero;M;42;CHILENO;;Silencioso;PROVIDENCIA                   ;METROPOLITANA;0;0;0;0;0;0;0;0;0;CELULAR A21s 128 GB Negro;TELEFONIA
13080605;;M;47;CHILENO;;X;LINARES                       ;MAULE;0;0;0;0;0;0;0;0;0;CELULAR A02s AZUL 32GB OPEN;TELEFONIA
9737232;;M;64;CHILENO;;Boomers;PROVIDENCIA                   ;N/D;0;0;0;0;0;0;0;0;0;Celular A11 LIB OPEN WHITE;TELEFONIA
10395647;;M;56;CHILENO;;Boomers;ILLAPEL                       ;COQUIMBO;0;0;0;0;0;0;0;0;0;Celular A11 LIB OPEN BLACK;TELEFONIA
17259924;;F;33;CHILENO;;Millenial;PROVIDENCIA                   ;METROPOLITANA;0;0;0;0;0;0;0;0;0;CELULAR A02s AZUL 32GB OPEN;TELEFONIA
19004595;;F;29;CHILENO;;Millenial;MAIPU                         ;METROPOLITANA;0;0;0;0;0;0;0;0;0;Celular A11 LIB OPEN BLACK;TELEFONIA
8784724;;F;60;CHILENO;;Boomers;ARICA                         ;ARICA Y PARINACOTA;0;0;0;0;0;0;0;0;0;CELULAR MOTOROLA G9 PLAY 64GB BLUE DIRECTO CLAR;TELEFONIA
15232490;;M;39;CHILENO;;Millenial;"";"";0;0;0;0;0;0;0;0;0;CELULAR A32 128 GB WHITE OPEN;TELEFONIA
8941319;;M;62;CHILENO;;Boomers;PROVIDENCIA                   ;METROPOLITANA;0;0;0;0;0;0;0;0;0;Celular A01 LIB OPEN NEGRO;TELEFONIA
6933493;;M;69;CHILENO;;Silencioso;PARRAL                        ;MAULE;0;0;0;0;0;0;0;0;0;Celular AL3 CLARO DIRECTO NEGRO;TELEFONIA
10035734;;M;58;CHILENO;;Boomers;QUILLOTA                      ;VALPARAISO;0;0;0;0;0;0;0;0;0;CELULAR A21s 128 GB AZUL;TELEFONIA
11597409;;F;52;CHILENO;;X;N/D;N/D;0;0;0;0;0;0;0;0;0;CELULAR XIAOMI MI 10T 128GB LUNAR SILVER OPEN;TELEFONIA
20148954;;F;22;CHILENO;;Z;PROVIDENCIA                   ;METROPOLITANA;0;0;0;0;0;0;0;0;0;CELULAR MOTO E6I 32GB GRIS OPEN;TELEFONIA
18041030;Soltero;F;30;CHILENO;;Millenial;PROVIDENCIA                   ;METROPOLITANA;0;0;0;0;0;0;0;0;0;Celular SAMSUNG A01 CORE BLACK CLARO;TELEFONIA
14243853;;M;48;CHILENO;;Silencioso;PROVIDENCIA                   ;METROPOLITANA;0;0;0;0;0;0;0;0;0;Celular A01 Core Azul Tri Entel;TELEFONIA
20146855;;F;23;CHILENO;;Z;PROVIDENCIA                   ;METROPOLITANA;0;0;0;0;0;0;0;0;0;CELULAR A21s 128 GB AZUL;TELEFONIA
14127419;;F;41;CHILENO;;X;N/D;N/D;0;0;0;0;0;0;0;0;0;CELULAR POCO M3 64GB POWER BLACK;TELEFONIA
7450255;;M;62;CHILENO;;Boomers;COIHAIQUE                     ;AYSEN;0;0;0;0;0;0;0;0;0;CELULAR A21s 128 GB Negro;TELEFONIA
16897794;Soltero;F;33;CHILENO;PROFESOR;Millenial;PROVIDENCIA                   ;METROPOLITANA;0;0;0;0;0;0;0;0;0;CELULAR Xiaomi Redmi 9 64 GB Morado WOM;TELEFONIA
18631564;Soltero;F;28;CHILENO;TERAPEUTA OCUPACIONAL;Millenial;PROVIDENCIA                   ;METROPOLITANA;0;0;0;0;0;0;0;0;0;CELULAR MOTOROLA E7 IPOWER 32GB BLUE CLARO;TELEFONIA
7426768;Soltero;F;66;CHILENO;;Boomers;LINARES                       ;MAULE;0;0;0;0;0;0;0;0;0;CELULAR MOTO E6I 32GB GRIS OPEN;TELEFONIA
14318695;;M;46;CHILENO;;Extranjero;N/D;N/D;0;0;0;0;0;0;0;0;0;CELULAR A12 128GB ROJO OPEN;TELEFONIA
17704908;Soltero;F;30;CHILENO;;Millenial;PROVIDENCIA                   ;METROPOLITANA;0;0;0;0;0;0;0;0;0;CELULAR MOTOROLA E6 PLAY AZUL TRI WOM;TELEFONIA
15291263;;F;40;CHILENO;;X;N/D;N/D;0;0;0;0;0;0;0;0;0;CELULAR MOTO G8 POWER LITE AZUL TRI ENTEL;TELEFONIA
12445563;;F;52;CHILENO;;X;PROVIDENCIA                   ;METROPOLITANA;0;0;0;0;0;0;0;0;0;IPHONE 11 64GB BLACK CLARO;TELEFONIA
4908458;;M;81;CHILENO;;Silencioso;LA SERENA                     ;COQUIMBO;0;0;0;0;0;0;0;0;0;CELULAR OWN 1026 AZUL ENTEL;TELEFONIA
20155830;;M;22;CHILENO;;Z;PROVIDENCIA                   ;METROPOLITANA;0;0;0;0;0;0;0;0;0;CELULAR MOTOROLA G9 PLAY 64GB BLUE DIRECTO CLAR;TELEFONIA
16587326;;F;33;CHILENO;;Millenial;N/D;N/D;0;0;0;0;0;0;0;0;0;Celular A01 Core Azul Tri Entel;TELEFONIA
18809430;Soltero;M;27;CHILENO;ANALISTA DE SISTEMAS;Millenial;PROVIDENCIA                   ;METROPOLITANA;0;0;0;0;0;0;0;0;0;CELULAR GALAXY S20FE 128GB ClOUD NAVY OPEN;TELEFONIA
8620566;Soltero;M;63;CHILENO;AGROINDUSTRIA;Boomers;RENCA                         ;METROPOLITANA;0;0;0;0;0;0;0;0;0;CELULAR REDMI 9 32GB CARBON GREY OPEN;TELEFONIA
17296774;Soltero;M;32;CHILENO;GASTRONOMIA INTERNACIONAL;Silencioso;PROVIDENCIA                   ;METROPOLITANA;0;0;0;0;0;0;0;0;0;CELULAR MOTOROLA G9 PLAY 64GB SPRING PINK OPEN;TELEFONIA
25185953;;F;28;BOLIVIANO;;Extranjero;N/D;N/D;0;0;0;0;0;0;0;0;0;Celular P40 LITE LIB OPEN GREEN;TELEFONIA
16314441;;F;36;CHILENO;;Millenial;PROVIDENCIA                   ;METROPOLITANA;0;0;0;0;0;0;0;0;0;CELULAR A21s 128 GB AZUL;TELEFONIA
17824444;;F;30;CHILENO;;Millenial;TALCA                         ;MAULE;0;0;0;0;0;0;0;0;0;Celular A11 LIB OPEN BLACK;TELEFONIA
18540254;Soltero;F;29;CHILENO;;Millenial;PROVIDENCIA                   ;METROPOLITANA;0;0;0;0;0;0;0;0;0;CELULAR POCO M3 64GB COOL BLUE;TELEFONIA
11034254;;F;56;CHILENO;;Boomers;PROVIDENCIA                   ;METROPOLITANA;0;0;0;0;0;0;0;0;0;CELULAR REDMI NOTE 9 128G ONYX BLACK OPEN;TELEFONIA
10974900;;M;50;CHILENO;;X;BULNES                        ;BIO BIO;0;0;0;0;0;0;0;0;0;IPHONE 7 LIB OPEN NEGRO;TELEFONIA
17454852;Soltero;F;32;CHILENO;;Millenial;PROVIDENCIA                   ;METROPOLITANA;0;0;0;0;0;0;0;0;0;CELULAR POCO X3 PRO 128G PHANTOM BLACK OPEN;TELEFONIA
18527183;;F;28;CHILENO;;Millenial;PROVIDENCIA                   ;METROPOLITANA;0;0;0;0;0;0;0;0;0;CELULAR A02s NEGRO 32GB OPEN;TELEFONIA
7994108;;M;65;CHILENO;;Boomers;CANETE                        ;BIO BIO;0;0;0;0;0;0;0;0;0;CELULAR A12 128GB ROJO OPEN;TELEFONIA
16944091;Soltero;F;32;CHILENO;;Millenial;PROVIDENCIA                   ;METROPOLITANA;0;0;0;0;0;0;0;0;0;CELULAR REDMI 9A 32GB SKY BLUE DIRECTO MOVISTAR;TELEFONIA
18288105;;F;29;CHILENO;;Millenial;N/D;N/D;0;0;0;0;0;0;0;0;0;CELULAR A12 128GB NEGRO OPEN;TELEFONIA
13957887;;F;42;CHILENO;;X;PROVIDENCIA                   ;METROPOLITANA;0;0;0;0;0;0;0;0;0;Celular A31 LIB OPEN BLACK;TELEFONIA
6963594;Soltero;M;69;CHILENO;;Silencioso;RENCA                         ;METROPOLITANA;0;0;0;0;0;0;0;0;0;CELULAR VIVO Y11S PHANTOM BLACK OPEN;TELEFONIA
20060030;;M;23;CHILENO;;Silencioso;PROVIDENCIA                   ;METROPOLITANA;0;0;0;0;0;0;0;0;0;CELULAR REDMI NOTE 9 128G FOREST GREEN OPEN;TELEFONIA
22047403;;F;24;CHILENO;;Extranjero;PROVIDENCIA                   ;METROPOLITANA;0;0;0;0;0;0;0;0;0;Celular LG K22 MOVISTAR DIRECTO TITAN;TELEFONIA
13861327;;M;42;CHILENO;;X;ARAUCO                        ;BIO BIO;0;0;0;0;0;0;0;0;0;CELULAR NOKIA 225 4G BLACK MOVISTAR DIRECTO;TELEFONIA
17709885;;M;30;CHILENO;;Millenial;TRAIGUEN                      ;ARAUCANIA;0;0;0;0;0;0;0;0;0;CELULAR A12 128GB NEGRO OPEN;TELEFONIA
17495237;;F;33;CHILENO;;Millenial;COLBUN                        ;MAULE;0;0;0;0;0;0;0;0;0;Celular AL3 CLARO DIRECTO NEGRO;TELEFONIA
19030910;;M;27;CHILENO;;Millenial;CHILLAN VIEJO                 ;BIO BIO;0;0;0;0;0;0;0;0;0;CELULAR MOTO G9 POWER 128GB MORADO SONICO OPEN;TELEFONIA
26093867;;F;36;COLOMBIANO;;Extranjero;N/D;N/D;0;0;0;0;0;0;0;0;0;CELULAR REDMI NOTE 10 128GB ONIX GRAY OPEN;TELEFONIA
19833391;;M;23;CHILENO;;Silencioso;PROVIDENCIA                   ;METROPOLITANA;0;0;0;0;0;0;0;0;0;Celular A11 LIB OPEN BLUE;TELEFONIA
19375551;Soltero;F;26;CHILENO;TECNICO EN ENFERMERIA DE NIVEL SUPERIOR;Silencioso;PROVIDENCIA                   ;METROPOLITANA;0;0;0;0;0;0;0;0;0;CELULAR A32 128 GB LIGHT VIOLET OPEN;TELEFONIA
7282931;Casado;M;68;CHILENO;;Boomers;PROVIDENCIA                   ;METROPOLITANA;0;0;0;0;0;0;0;0;0;CELULAR NOKIA 225 4G BLACK MOVISTAR DIRECTO;TELEFONIA
18862765;Soltero;M;27;CHILENO;;Z;PROVIDENCIA                   ;METROPOLITANA;0;0;0;0;0;0;0;0;0;CELULAR SAMSUNG A02S 32GB NEGRO DIRECTO ENTEL;TELEFONIA
16830127;;M;33;CHILENO;;Millenial;"";"";0;0;0;0;0;0;0;0;0;CELULAR ZTE A5 2020 DIRECTO CLARO VERDE;TELEFONIA
12527609;;F;49;CHILENO;;X;CONCEPCION                    ;BIO BIO;0;0;0;0;0;0;0;0;0;CELULAR MOTOROLA MOTO G20 64GB ROSA FLAMINGO;TELEFONIA
17170515;;F;34;CHILENO;;Millenial;LONGAVI                       ;MAULE;0;0;0;0;0;0;0;0;0;CELULAR GALAXY A01 32GB AZUL ENTEL;TELEFONIA
17222725;;F;32;CHILENO;;Millenial;N/D;N/D;0;0;0;0;0;0;0;0;0;CELULAR MOTO E6I 32GB GRIS OPEN;TELEFONIA
18491402;;M;29;CHILENO;;Millenial;N/D;N/D;0;0;0;0;0;0;0;0;0;CELULAR REDMI NOTE 10 128GB PEBBLE WHITE;TELEFONIA
9644923;;M;56;CHILENO;;Boomers;CALERA                        ;VALPARAISO;0;0;0;0;0;0;0;0;0;CELULAR XIAOMI POCO X3 64G SHADOW GRAY;TELEFONIA
16267820;;F;36;CHILENO;;Millenial;PUENTE ALTO                   ;METROPOLITANA;0;0;0;0;0;0;0;0;0;CELULAR XIAOMI POCO X3 64G SHADOW GRAY;TELEFONIA
9112060;;F;65;CHILENO;;Boomers;COIHAIQUE                     ;AYSEN;0;0;0;0;0;0;0;0;0;CELULAR NOKIA 110 BLACK OPEN;TELEFONIA
16979888;;M;33;CHILENO;;Millenial;PROVIDENCIA                   ;METROPOLITANA;0;0;0;0;0;0;0;0;0;Celular G8 POWER LITE WOM DIRECTO TURQUESA;TELEFONIA
10713243;Casado;M;52;CHILENO;;X;RENCA                         ;METROPOLITANA;0;0;0;0;0;0;0;0;0;CELULAR REDMI NOTE 10 EU 128G Onyx Gray BUNDLE;TELEFONIA
15763105;;M;37;CHILENO;;Millenial;QUILPUE                       ;VALPARAISO;0;0;0;0;0;0;0;0;0;Celular A01 CLARO DIRECTO BLACK;TELEFONIA
11323482;;M;53;CHILENO;;X;VILLARICA                     ;ARAUCANIA;0;0;0;0;0;0;0;0;0;CELULAR REDMI NOTE 9 128G ONYX BLACK OPEN;TELEFONIA
15885557;;M;37;CHILENO;;Millenial;VALLENAR;ATACAMA;0;0;0;0;0;0;0;0;0;CELULAR POCO M3 64GB COOL BLUE;TELEFONIA
12337289;;M;49;CHILENO;;Silencioso;PROVIDENCIA                   ;METROPOLITANA;0;0;0;0;0;0;0;0;0;CELULAR A02s AZUL 32GB OPEN;TELEFONIA
6733637;;M;66;CHILENO;;Boomers;N/D;N/D;0;0;0;0;0;0;0;0;0;CELULAR A12 128GB AZUL OPEN;TELEFONIA
16464517;;M;35;CHILENO;;Silencioso;PROVIDENCIA                   ;METROPOLITANA;0;0;0;0;0;0;0;0;0;Celular SAMSUNG A01 CORE BLACK CLARO;TELEFONIA
9834417;;F;57;CHILENO;;Boomers;YUMBEL                        ;BIO BIO;0;0;0;0;0;0;0;0;0;Celular A51 128GB LIB OPEN AZUL;TELEFONIA
7651259;Casado;M;66;CHILENO;;Boomers;RENCA                         ;METROPOLITANA;0;0;0;0;0;0;0;0;0;Celular SAMSUNG A01 CORE BLACK CLARO;TELEFONIA
3737264;;M;87;CHILENO;;Silencioso;PROVIDENCIA                   ;METROPOLITANA;0;0;0;0;0;0;0;0;0;CELULAR OWN 1026 AZUL ENTEL;TELEFONIA
18648470;Casado;F;28;CHILENO;;Millenial;PROVIDENCIA                   ;METROPOLITANA;0;0;0;0;0;0;0;0;0;CELULAR MOTO G9 POWER 128GB MORADO SONICO OPEN;TELEFONIA
19017505;Soltero;F;27;CHILENO;;Silencioso;PROVIDENCIA                   ;METROPOLITANA;0;0;0;0;0;0;0;0;0;CELULAR A32 128 GB LIGHT VIOLET OPEN;TELEFONIA
20570813;;F;21;CHILENO;;Silencioso;PROVIDENCIA                   ;METROPOLITANA;0;0;0;0;0;0;0;0;0;CELULAR MOTO G9 POWER 128GB MORADO SONICO OPEN;TELEFONIA
19119950;;M;26;CHILENO;;Millenial;N/D;N/D;0;0;0;0;0;0;0;0;0;Celular A51 128GB CLARO TRIANGULADO BLACK;TELEFONIA
4984567;;M;78;CHILENO;;Silencioso;N/D;N/D;0;0;0;0;0;0;0;0;0;IPHONE 8 64 GB LIB OPEN DORADO;TELEFONIA
17521603;;M;31;CHILENO;;Millenial;GRANEROS                      ;L.G.B.OÂ´HIGGINS;0;0;0;0;0;0;0;0;0;CELULAR A52 128 GB BLACK OPEN;TELEFONIA
18209050;Soltero;M;29;CHILENO;;Silencioso;PROVIDENCIA                   ;METROPOLITANA;0;0;0;0;0;0;0;0;0;CELULAR POCO X3 PRO 128G PHANTOM BLACK OPEN;TELEFONIA
18514585;;F;28;CHILENO;;Millenial;PROVIDENCIA                   ;METROPOLITANA;0;0;0;0;0;0;0;0;0;CELULAR REDMI NOTE 9 PRO 128GB GLACIER WHITE;TELEFONIA
14409027;;F;54;CHILENO;;X;VALDIVIA                      ;LOS LAGOS;0;0;0;0;0;0;0;0;0;CELULAR REDMI NOTE 10 EU 64GB ONIX GRAY OPEN;TELEFONIA
16135573;;F;36;CHILENO;;Millenial;N/D;N/D;0;0;0;0;0;0;0;0;0;CELULAR XIAOMI POCO X3 64G SHADOW GRAY;TELEFONIA
18955353;Soltero;M;27;CHILENO;;Z;"";"";0;0;0;0;0;0;0;0;0;CELULAR XIAOMI REDMI 9C 32GB AZUL WOM;TELEFONIA
6952503;;F;75;CHILENO;;Silencioso;OSORNO                        ;LOS LAGOS;0;0;0;0;0;0;0;0;0;CELULAR ALCATEL P1 3080 BLACK MOVISTAR DIRECTO;TELEFONIA
9572481;;F;56;CHILENO;;Boomers;PROVIDENCIA                   ;METROPOLITANA;0;0;0;0;0;0;0;0;0;CELULAR MI 10T PRO 256GB AURORA BLUE OPEN;TELEFONIA
9020985;;M;60;CHILENO;;Boomers;TALCA                         ;MAULE;0;0;0;0;0;0;0;0;0;Celular LG K22 ENTEL DIRECTO TITAN;TELEFONIA
11833681;Soltero;M;51;CHILENO;;X;RENCA                         ;METROPOLITANA;0;0;0;0;0;0;0;0;0;CELULAR A21s 128 GB Rojo;TELEFONIA
11275569;Casado;M;53;CHILENO;PROFESOR;X;RENCA                         ;METROPOLITANA;0;0;0;0;0;0;0;0;0;CELULAR XIAOMI REDMI 9A 32 GB BLUE DIRECTO CLARO;TELEFONIA
19553084;;M;26;CHILENO;;Z;QUELLON                       ;LOS LAGOS;0;0;0;0;0;0;0;0;0;CELULAR A02 NEGRO 32GB OPEN;TELEFONIA
12789200;;F;47;CHILENO;;X;PELLUHUE                      ;MAULE;0;0;0;0;0;0;0;0;0;CELULAR A02s AZUL 32GB OPEN;TELEFONIA
11313083;;M;54;CHILENO;;X;CANELA                        ;COQUIMBO;0;0;0;0;0;0;0;0;0;CELULAR A02s AZUL 32GB OPEN;TELEFONIA
13817128;;F;42;CHILENO;;X;LOS LAGOS                     ;LOS LAGOS;0;0;0;0;0;0;0;0;0;Celular SA3 CLARO DIRECTO BLACK;TELEFONIA
10493300;;M;53;CHILENO;;X;"";"";0;0;0;0;0;0;0;0;0;Celular Y8P ENTEL TRIANGULADO NEGRO;TELEFONIA
11209120;;M;55;CHILENO;;Boomers;COLINA                        ;METROPOLITANA;0;0;0;0;0;0;0;0;0;Celular A10S MOVISTAR DIRECTO BLACK;TELEFONIA
11994978;;M;49;CHILENO;;X;PROVIDENCIA                   ;METROPOLITANA;0;0;0;0;0;0;0;0;0;CELULAR MOTO E6S 32GB GRIS DIRECTO ENTEL;TELEFONIA
9399729;;M;58;CHILENO;;Boomers;LINARES                       ;MAULE;0;0;0;0;0;0;0;0;0;CELULAR MOTOROLA E6 PLAY AZUL TRI WOM;TELEFONIA
12744498;;M;47;CHILENO;;X;POZO ALMONTE                  ;TARAPACA;0;0;0;0;0;0;0;0;0;CELULAR A12 128GB NEGRO OPEN;TELEFONIA
16491273;;F;35;CHILENO;;Silencioso;PROVIDENCIA                   ;METROPOLITANA;0;0;0;0;0;0;0;0;0;CELULAR MOTOROLA G9 PLAY 64GB ELECTRIC BLUE OPEN;TELEFONIA
16425516;;M;35;CHILENO;;Millenial;N/D;N/D;0;0;0;0;0;0;0;0;0;Celular S20 FE LIB OPEN Cloud Green;TELEFONIA
10539310;;F;56;CHILENO;;Boomers;PROVIDENCIA                   ;METROPOLITANA;0;0;0;0;0;0;0;0;0;CELULAR GALAXY S20FE 128GB CLOUD GREEN OPEN;TELEFONIA
14218886;Soltero;F;40;CHILENO;INGENIERO FORESTAL;X;RENCA                         ;METROPOLITANA;0;0;0;0;0;0;0;0;0;CELULAR NOKIA 110 BLACK OPEN;TELEFONIA
12694686;;M;47;CHILENO;;Silencioso;PROVIDENCIA                   ;METROPOLITANA;0;0;0;0;0;0;0;0;0;CELULAR A02s NEGRO 32GB OPEN;TELEFONIA
16378299;;F;36;CHILENO;;Millenial;PLACILLA                      ;L.G.B.OÂ´HIGGINS;0;0;0;0;0;0;0;0;0;Celular A01 LIB OPEN NEGRO;TELEFONIA
16868946;;M;34;CHILENO;;Millenial;RANCAGUA                      ;L.G.B.OÂ´HIGGINS;0;0;0;0;0;0;0;0;0;Celular G8 POWER LITE WOM DIRECTO TURQUESA;TELEFONIA
16035037;;F;36;CHILENO;;Millenial;PROVIDENCIA                   ;METROPOLITANA;0;0;0;0;0;0;0;0;0;Celular A11 LIB OPEN WHITE;TELEFONIA
12382866;;F;49;CHILENO;;Silencioso;PROVIDENCIA                   ;METROPOLITANA;0;0;0;0;0;0;0;0;0;CELULAR SAMSUNG A01 NEGRO DIRECTO WOM;TELEFONIA
19309946;;M;26;CHILENO;;Z;N/D;N/D;0;0;0;0;0;0;0;0;0;CELULAR MOTOROLA G9 PLAY 64GB ELECTRIC BLUE OPEN;TELEFONIA
19651166;;F;24;CHILENO;;Z;PROVIDENCIA                   ;METROPOLITANA;0;0;0;0;0;0;0;0;0;CELULAR A02s NEGRO 32GB OPEN;TELEFONIA
11896781;;F;50;CHILENO;;X;PROVIDENCIA                   ;METROPOLITANA;0;0;0;0;0;0;0;0;0;CELULAR XIAOMI REDMI 9C 32GB AZUL WOM;TELEFONIA
20020476;;F;23;CHILENO;;Millenial;"";"";0;0;0;0;0;0;0;0;0;CELULAR REDMI NOTE 10 128GB ONIX GRAY OPEN;TELEFONIA
10628999;Casado;M;51;CHILENO;INGENIERO;X;PROVIDENCIA                   ;METROPOLITANA;0;0;0;0;0;0;0;0;0;CELULAR A21s 128 GB AZUL;TELEFONIA
19079917;;M;27;CHILENO;;Silencioso;PROVIDENCIA                   ;METROPOLITANA;0;0;0;0;0;0;0;0;0;CELULAR REDMI NOTE 10 EU 128G Lake Green BUNDLE;TELEFONIA
18749105;Soltero;M;28;CHILENO;PROFESOR;Millenial;PROVIDENCIA                   ;METROPOLITANA;0;0;0;0;0;0;0;0;0;Celular A51 128GB LIB OPEN BLACK;TELEFONIA
10576282;;M;66;CHILENO;;Boomers;COIHAIQUE                     ;AYSEN;0;0;0;0;0;0;0;0;0;CELULAR A02s NEGRO 32GB OPEN;TELEFONIA
15103835;;M;40;CHILENO;;Silencioso;PROVIDENCIA                   ;METROPOLITANA;0;0;0;0;0;0;0;0;0;CELULAR XIAOMI POCO X3 64G SHADOW GRAY;TELEFONIA
5833312;Viudo;F;71;CHILENO;;Silencioso;RENCA                         ;METROPOLITANA;0;0;0;0;0;0;0;0;0;CELULAR OWN 1026 AZUL ENTEL;TELEFONIA
19947104;;M;23;CHILENO;;Silencioso;PROVIDENCIA                   ;METROPOLITANA;0;0;0;0;0;0;0;0;0;CELULAR REDMI NOTE 9 PRO 128GB GLACIER WHITE;TELEFONIA
19503038;;M;25;CHILENO;;Z;PADRE HURTADO                 ;METROPOLITANA;0;0;0;0;0;0;0;0;0;Celular A51 128GB LIB OPEN BLACK;TELEFONIA
13026795;;M;46;CHILENO;;X;RENCA                         ;METROPOLITANA;0;0;0;0;0;0;0;0;0;CELULAR A21s 128 GB Negro;TELEFONIA
14343111;;F;45;CHILENO;;X;PROVIDENCIA                   ;METROPOLITANA;0;0;0;0;0;0;0;0;0;CELULAR XIAOMI REDMI 9A 32 GB BLUE DIRECTO CLARO;TELEFONIA
16704066;;M;35;CHILENO;;Millenial;PROVIDENCIA                   ;METROPOLITANA;0;0;0;0;0;0;0;0;0;CELULAR GALAXY S20FE 128GB ClOUD NAVY OPEN;TELEFONIA
11662630;;F;52;CHILENO;;X;PEDRO AGUIRRE CERDA           ;METROPOLITANA;0;0;0;0;0;0;0;0;0;CELULAR A12 128GB ROJO OPEN;TELEFONIA
11347438;;F;53;CHILENO;;X;RENCA                         ;METROPOLITANA;0;0;0;0;0;0;0;0;0;Celular A11 LIB OPEN BLUE;TELEFONIA
19967298;;F;24;CHILENO;;Z;PROVIDENCIA                   ;METROPOLITANA;0;0;0;0;0;0;0;0;0;Celular NOKIA 2.3 WOM DIRECTO CHARCOAL;TELEFONIA
13956371;Casado;M;41;CHILENO;LABORATORISTA DENTAL;Silencioso;PROVIDENCIA                   ;METROPOLITANA;0;0;0;0;0;0;0;0;0;CELULAR REDMI NOTE 9 PRO 128GB GLACIER WHITE;TELEFONIA
15993787;;F;37;CHILENO;;Millenial;PROVIDENCIA                   ;METROPOLITANA;0;0;0;0;0;0;0;0;0;CELULAR XIAOMI REDMI 9C 32GB AZUL WOM;TELEFONIA
11692166;;M;52;CHILENO;;X;N/D;N/D;0;0;0;0;0;0;0;0;0;CELULAR LG K61 Gris OPEN;TELEFONIA
19725248;;F;25;CHILENO;;Z;CHILLAN                       ;BIO BIO;0;0;0;0;0;0;0;0;0;CELULAR MOTOROLA G9 PLAY 64GB SPRING PINK OPEN;TELEFONIA
16759520;;M;34;CHILENO;;Millenial;SAN ANTONIO                   ;VALPARAISO;0;0;0;0;0;0;0;0;0;Celular A01 CLARO DIRECTO BLACK;TELEFONIA
5667588;;M;76;CHILENO;;Silencioso;LINARES                       ;MAULE;0;0;0;0;0;0;0;0;0;CELULAR MOTO E6S 32GB GRIS DIRECTO ENTEL;TELEFONIA
14048202;;M;41;CHILENO;;X;SAN FERNANDO                  ;L.G.B.OÂ´HIGGINS;0;0;0;0;0;0;0;0;0;IPHONE 5S 16GB DORADO OPEN;TELEFONIA
17795749;Soltero;F;31;CHILENO;;Millenial;PROVIDENCIA                   ;METROPOLITANA;0;0;0;0;0;0;0;0;0;CELULAR XIAOMI POCO X3 64G SHADOW GRAY;TELEFONIA
6652780;;F;71;CHILENO;;Silencioso;LOS ALAMOS                    ;BIO BIO;0;0;0;0;0;0;0;0;0;CELULAR A21s 128 GB Negro;TELEFONIA
18226116;Soltero;M;30;CHILENO;;Millenial;PROVIDENCIA                   ;METROPOLITANA;0;0;0;0;0;0;0;0;0;CELULAR A12 128GB ROJO OPEN;TELEFONIA
13005795;;F;46;CHILENO;;X;ARICA                         ;ARICA Y PARINACOTA;0;0;0;0;0;0;0;0;0;CELULAR A02 ROJO 32GB OPEN;TELEFONIA
18827116;;M;27;CHILENO;;Z;N/D;N/D;0;0;0;0;0;0;0;0;0;Celular P40 LITE LIB OPEN GREEN;TELEFONIA
8884695;;M;60;CHILENO;;Silencioso;PROVIDENCIA                   ;METROPOLITANA;0;0;0;0;0;0;0;0;0;Celular NOKIA 6.2 MOVISTAR DIRECTO NEGRO;TELEFONIA
19129547;Soltero;M;26;CHILENO;;Silencioso;PROVIDENCIA                   ;METROPOLITANA;0;0;0;0;0;0;0;0;0;Celular A51 128GB LIB OPEN AZUL;TELEFONIA
16861485;Soltero;M;34;CHILENO;;Millenial;PROVIDENCIA                   ;METROPOLITANA;0;0;0;0;0;0;0;0;0;CELULAR A21s 128 GB AZUL;TELEFONIA
17983847;Soltero;F;28;CHILENO;;Millenial;PROVIDENCIA                   ;METROPOLITANA;0;0;0;0;0;0;0;0;0;Celular XIAOMI REDMI 9C 64 GB DIRECTO CLARO;TELEFONIA
10505341;;M;55;CHILENO;;Boomers;LA CISTERNA                   ;METROPOLITANA;0;0;0;0;0;0;0;0;0;CEULAR NOTE 10 LITE SILVER;TELEFONIA
10647484;Casado;F;40;CHILENO;;Silencioso;PROVIDENCIA                   ;METROPOLITANA;0;0;0;0;0;0;0;0;0;IPHONE 7 LIB OPEN NEGRO;TELEFONIA
9435343;;M;44;CHILENO;;X;RENCA                         ;METROPOLITANA;0;0;0;0;0;0;0;0;0;CELULAR MOTOROLA E6S GRIS 32GB DIRECTO WOM;TELEFONIA
12677920;;F;48;CHILENO;;X;LA PINTANA                    ;METROPOLITANA;0;0;0;0;0;0;0;0;0;CELULAR REDMI NOTE 9 128 GB MIDNIGHT GREY OPEN;TELEFONIA
19547181;;M;25;CHILENO;;Silencioso;PROVIDENCIA                   ;METROPOLITANA;0;0;0;0;0;0;0;0;0;CELULAR GALAXY S20FE 128GB ClOUD NAVY OPEN;TELEFONIA
15974779;;F;37;CHILENO;;Z;PROVIDENCIA                   ;METROPOLITANA;0;0;0;0;0;0;0;0;0;CELULAR A02s ROJO 32GB OPEN;TELEFONIA
9888566;;M;57;CHILENO;;Boomers;COIHAIQUE                     ;AYSEN;0;0;0;0;0;0;0;0;0;Celular A31 LIB OPEN BLACK;TELEFONIA
11593802;;M;52;CHILENO;;X;OSORNO                        ;LOS LAGOS;0;0;0;0;0;0;0;0;0;Celular A10S LIB OPEN NEGRO;TELEFONIA
14318248;;F;46;CHILENO;;X;"";"";0;0;0;0;0;0;0;0;0;CELULAR MOTO G9 POWER 128GB MORADO SONICO OPEN;TELEFONIA
16713012;;M;35;CHILENO;;Millenial;PEDRO AGUIRRE CERDA           ;METROPOLITANA;0;0;0;0;0;0;0;0;0;CELULAR A72 128 GB BLACK OPEN;TELEFONIA
19979677;;F;23;CHILENO;;Silencioso;PROVIDENCIA                   ;METROPOLITANA;0;0;0;0;0;0;0;0;0;Celular A11 LIB OPEN BLUE;TELEFONIA
11341354;;F;53;CHILENO;;X;MAIPU;METROPOLITANA;0;0;0;0;0;0;0;0;0;CELULAR POCO M3 64GB COOL BLUE;TELEFONIA
12212664;;M;50;CHILENO;;X;PROVIDENCIA                   ;METROPOLITANA;0;0;0;0;0;0;0;0;0;CELULAR A02s ROJO 32GB OPEN;TELEFONIA
15688035;;F;39;CHILENO;;X;CARAHUE                       ;ARAUCANIA;0;0;0;0;0;0;0;0;0;CELULAR MOTOROLA E6S GRIS 32GB DIRECTO WOM;TELEFONIA
9121124;;F;60;CHILENO;;Silencioso;PROVIDENCIA                   ;METROPOLITANA;0;0;0;0;0;0;0;0;0;IPHONE 8 64 GB LIB OPEN DORADO;TELEFONIA
13792933;;M;42;CHILENO;;X;NINHUE                        ;BIO BIO;0;0;0;0;0;0;0;0;0;CELULAR A32 128 GB BLACK OPEN;TELEFONIA
18612532;;M;28;CHILENO;;Millenial;N/D;N/D;0;0;0;0;0;0;0;0;0;CELULAR MOTO G8 POWER LITE AZUL TRI ENTEL;TELEFONIA
16477037;Soltero;F;35;CHILENO;TECNICO EN ANALISIS QUIMICO;Millenial;PROVIDENCIA                   ;METROPOLITANA;0;0;0;0;0;0;0;0;0;CELULAR Xiaomi Redmi 9 64 GB Morado WOM;TELEFONIA
16014157;;M;37;CHILENO;;Millenial;PROVIDENCIA                   ;METROPOLITANA;0;0;0;0;0;0;0;0;0;CELULAR GALAXY S20FE 128GB ClOUD NAVY OPEN;TELEFONIA
12466643;Casado;M;49;CHILENO;INGENIERO CIVIL ELECTRONICO;Millenial;PROVIDENCIA                   ;METROPOLITANA;0;0;0;0;0;0;0;0;0;Celular A11 LIB OPEN BLUE;TELEFONIA
12342844;Casado;F;49;CHILENO;;X;PROVIDENCIA                   ;METROPOLITANA;0;0;0;0;0;0;0;0;0;Celular S10+ LIB OPEN NEGRO;TELEFONIA
13911411;;M;42;CHILENO;;X;LO BARNECHEA                  ;METROPOLITANA;0;0;0;0;0;0;0;0;0;CELULAR POCO M3 64GB COOL BLUE;TELEFONIA
16901353;;F;34;CHILENO;;Millenial;PIRQUE;METROPOLITANA;0;0;0;0;0;0;0;0;0;CELULAR MOTOROLA E6 PLAY AZUL TRI WOM;TELEFONIA
8294897;;M;64;CHILENO;;Boomers;RENCA                         ;METROPOLITANA;0;0;0;0;0;0;0;0;0;Celular A11 LIB OPEN BLUE;TELEFONIA
9444198;;M;59;CHILENO;;Boomers;PROVIDENCIA                   ;METROPOLITANA;0;0;0;0;0;0;0;0;0;CELULAR REDMI NOTE 8 64GB SPACE BLACK OPEN;TELEFONIA
12221725;;M;50;CHILENO;;X;PROVIDENCIA                   ;METROPOLITANA;0;0;0;0;0;0;0;0;0;CELULAR XIAOMI POCO X3 64G SHADOW GRAY;TELEFONIA
14356637;;M;43;CHILENO;;X;MALLOA                        ;L.G.B.OÂ´HIGGINS;0;0;0;0;0;0;0;0;0;CELULAR A21s 128 GB AZUL;TELEFONIA
18312549;;F;29;CHILENO;;Millenial;PROVIDENCIA                   ;METROPOLITANA;0;0;0;0;0;0;0;0;0;CELULAR GALAXY S20FE 128GB CLOUD LAVENDER OPEN;TELEFONIA
20686200;;M;21;CHILENO;;Millenial;N/D;N/D;0;0;0;0;0;0;0;0;0;CELULAR A32 128 GB LIGHT VIOLET OPEN;TELEFONIA
8727178;;F;64;CHILENO;;Boomers;IQUIQUE                       ;TARAPACA;0;0;0;0;0;0;0;0;0;Celular SAMSUNG A01 CORE BLACK CLARO;TELEFONIA
12412387;;M;48;CHILENO;;X;MELIPILLA                     ;METROPOLITANA;0;0;0;0;0;0;0;0;0;Celular XIAOMI REDMI 9C 64 GB DIRECTO CLARO;TELEFONIA
17054368;;F;33;CHILENO;;Millenial;"";"";0;0;0;0;0;0;0;0;0;CELULAR A12 128GB NEGRO OPEN;TELEFONIA
19388482;;M;25;CHILENO;;Z;CHILLAN                       ;BIO BIO;0;0;0;0;0;0;0;0;0;CELULAR A02 ROJO 32GB OPEN;TELEFONIA
20380042;;M;22;CHILENO;;Z;PROVIDENCIA                   ;METROPOLITANA;0;0;0;0;0;0;0;0;0;CELULAR REDMI NOTE 9 PRO 128GB GLACIER WHITE;TELEFONIA
5403346;;M;76;CHILENO;;Silencioso;RENCA                         ;METROPOLITANA;0;0;0;0;0;0;0;0;0;CELULAR MOTO E6S 32GB GRIS DIRECTO ENTEL;TELEFONIA
5982051;;F;78;CHILENO;;Silencioso;ALTO HOSPICIO;TARAPACA;0;0;0;0;0;0;0;0;0;CELULAR OWN 1026 AZUL ENTEL;TELEFONIA
17852113;;M;30;CHILENO;;Millenial;PROVIDENCIA                   ;METROPOLITANA;0;0;0;0;0;0;0;0;0;CELULAR REDMI NOTE 10 EU 64GB ONIX GRAY OPEN;TELEFONIA
13765768;;F;42;CHILENO;;X;PROVIDENCIA                   ;METROPOLITANA;0;0;0;0;0;0;0;0;0;Celular A11 LIB OPEN BLUE;TELEFONIA
18710191;;M;29;CHILENO;;Millenial;CALDERA                       ;ATACAMA;0;0;0;0;0;0;0;0;0;CELULAR A21s 128 GB AZUL;TELEFONIA
17446161;;F;35;CHILENO;;Millenial;PROVIDENCIA                   ;METROPOLITANA;0;0;0;0;0;0;0;0;0;Celular A51 128GB LIB OPEN BLANCO;TELEFONIA
20032578;;F;25;CHILENO;;Z;CONTULMO                      ;BIO BIO;0;0;0;0;0;0;0;0;0;Celular SAMSUNG A01 CORE BLACK CLARO;TELEFONIA
15810840;;F;40;CHILENO;;X;PROVIDENCIA                   ;METROPOLITANA;0;0;0;0;0;0;0;0;0;CELULAR A21s 128 GB Negro;TELEFONIA
5586117;;F;73;CHILENO;;Silencioso;PANGUIPULLI                   ;LOS RIOS;0;0;0;0;0;0;0;0;0;Celular A10S LIB OPEN RED;TELEFONIA
8741168;;F;58;CHILENO;;Boomers;QUILLOTA                      ;VALPARAISO;0;0;0;0;0;0;0;0;0;CELULAR MOTO G9 POWER 128GB MORADO SONICO OPEN;TELEFONIA
19975216;;F;23;CHILENO;;Z;PROVIDENCIA                   ;METROPOLITANA;0;0;0;0;0;0;0;0;0;Celular A71 LIB OPEN NEGRO;TELEFONIA
15288034;;M;39;CHILENO;;X;PROVIDENCIA                   ;METROPOLITANA;0;0;0;0;0;0;0;0;0;CELULAR A02s NEGRO 32GB OPEN;TELEFONIA
15928908;;M;37;CHILENO;;Millenial;"";"";0;0;0;0;0;0;0;0;0;Celular A31 LIB OPEN AZUL;TELEFONIA
17167726;;M;33;CHILENO;;Millenial;BUIN;METROPOLITANA;0;0;0;0;0;0;0;0;0;CELULAR POCO M3 64GB POWER BLACK;TELEFONIA
16201323;;F;36;CHILENO;;Silencioso;PROVIDENCIA                   ;METROPOLITANA;0;0;0;0;0;0;0;0;0;IPHONE 8 64 GB LIB OPEN PLATEADO;TELEFONIA
18063447;Soltero;F;30;CHILENO;PROFESOR;Millenial;PROVIDENCIA                   ;METROPOLITANA;0;0;0;0;0;0;0;0;0;Celular A71 LIB OPEN NEGRO;TELEFONIA
17727137;Soltero;M;31;CHILENO;;Silencioso;PROVIDENCIA                   ;METROPOLITANA;0;0;0;0;0;0;0;0;0;Celular XIAOMI REDMI 9 64 GB DIRECTO CLARO NEGRO;TELEFONIA
20224129;;M;23;CHILENO;;Silencioso;PROVIDENCIA                   ;METROPOLITANA;0;0;0;0;0;0;0;0;0;CELULAR REDMI NOTE 9 PRO 128GB TROPICAL GREEN;TELEFONIA
12727965;;M;50;CHILENO;;X;PROVIDENCIA                   ;METROPOLITANA;0;0;0;0;0;0;0;0;0;CELULAR REDMI NOTE 10 128GB LAKE GREEN OPEN;TELEFONIA
5238739;;M;76;CHILENO;;Silencioso;COIHAIQUE                     ;AYSEN;0;0;0;0;0;0;0;0;0;CELULAR NOKIA 110 BLACK OPEN;TELEFONIA
18277367;Soltero;F;29;CHILENO;;Millenial;PROVIDENCIA                   ;METROPOLITANA;0;0;0;0;0;0;0;0;0;Celular A10S LIB OPEN BLUE;TELEFONIA
15306638;;M;40;CHILENO;;X;NATALES                       ;MAGALLANES;0;0;0;0;0;0;0;0;0;Celular A51 128GB LIB OPEN AZUL;TELEFONIA
13547359;;M;43;CHILENO;;X;SANTO DOMINGO                 ;VALPARAISO;0;0;0;0;0;0;0;0;0;CELULAR HUAWEI Y5 NEO NEGRO WOM;TELEFONIA
18169214;Soltero;F;29;CHILENO;PROFESOR;Millenial;PROVIDENCIA                   ;METROPOLITANA;0;0;0;0;0;0;0;0;0;Celular A51 128GB LIB OPEN BLANCO;TELEFONIA
19751461;;F;25;CHILENO;;Silencioso;PROVIDENCIA                   ;METROPOLITANA;0;0;0;0;0;0;0;0;0;CELULAR MOTO G9 POWER 128GB MORADO SONICO OPEN;TELEFONIA
18335900;;F;29;CHILENO;;Millenial;PROVIDENCIA                   ;METROPOLITANA;0;0;0;0;0;0;0;0;0;Celular A51 128GB LIB OPEN BLACK;TELEFONIA
14631586;Soltero;F;61;CHILENO;;Silencioso;PROVIDENCIA                   ;METROPOLITANA;0;0;0;0;0;0;0;0;0;Celular A11 LIB OPEN BLUE;TELEFONIA
18641704;Soltero;M;28;CHILENO;INGENIERIA EN PREVENCION DE RIESGOS CALIDAD Y AMBIENTE;Millenial;PROVIDENCIA                   ;METROPOLITANA;0;0;0;0;0;0;0;0;0;CELULAR SAMSUNG A71 AZUL OPEN;TELEFONIA
13825600;;F;42;CHILENO;;X;DALCAHUE                      ;LOS LAGOS;0;0;0;0;0;0;0;0;0;CELULAR MOTOROLA E6S ROSADO DIRECTO WOM;TELEFONIA
19251993;;M;26;CHILENO;;Z;N/D;N/D;0;0;0;0;0;0;0;0;0;CELULAR HUAWEI Y9S BLACK DIRECTO CLARO;TELEFONIA
17702357;Soltero;M;31;CHILENO;INGENIERO COMERCIAL;Silencioso;PROVIDENCIA                   ;METROPOLITANA;0;0;0;0;0;0;0;0;0;TELEFONO PP BINDU ENTEL;TELEFONIA
18162777;;F;29;CHILENO;;Millenial;SAN ANTONIO                   ;VALPARAISO;0;0;0;0;0;0;0;0;0;CELULAR A02 ROJO 32GB OPEN;TELEFONIA
6779913;;M;69;CHILENO;;Silencioso;RENCA                         ;METROPOLITANA;0;0;0;0;0;0;0;0;0;Celular A71 LIB OPEN NEGRO;TELEFONIA
19979613;;M;23;CHILENO;;Silencioso;PROVIDENCIA                   ;METROPOLITANA;0;0;0;0;0;0;0;0;0;CELULAR A02 NEGRO 32GB OPEN;TELEFONIA
15747362;;M;38;CHILENO;;Millenial;RENCA                         ;METROPOLITANA;0;0;0;0;0;0;0;0;0;CELULAR MOTO G9 POWER 128GB MORADO SONICO OPEN;TELEFONIA
15618705;;F;39;CHILENO;;Silencioso;PROVIDENCIA                   ;METROPOLITANA;0;0;0;0;0;0;0;0;0;CELULAR HUAWEI Y9S BLACK DIRECTO CLARO;TELEFONIA
27145701;;M;23;EXTRANJERO - NO INFORMA NACIONALIDAD;;Extranjero;N/D;N/D;0;0;0;0;0;0;0;0;0;CELULAR MOTO E6S 32GB ROSA OPEN;TELEFONIA
12391543;;F;49;CHILENO;;X;COIHAIQUE                     ;AYSEN;0;0;0;0;0;0;0;0;0;Celular SAMSUNG A01 CORE BLACK CLARO;TELEFONIA
13922997;Casado;F;42;CHILENO;;Silencioso;PROVIDENCIA                   ;METROPOLITANA;0;0;0;0;0;0;0;0;0;CELULAR NOKIA 110 BLACK OPEN;TELEFONIA
18052585;Soltero;F;30;CHILENO;TECNICO DE NIVEL SUPERIOR EN ENFERMERIA;Millenial;PROVIDENCIA                   ;METROPOLITANA;0;0;0;0;0;0;0;0;0;Celular A71 LIB OPEN PLATEADO;TELEFONIA
8576445;;M;64;CHILENO;;Millenial;CURACAVI                      ;METROPOLITANA;0;0;0;0;0;0;0;0;0;CELULAR REDMI NOTE 8 64GB SPACE BLACK OPEN;TELEFONIA
8286440;Casado;M;60;CHILENO;;Boomers;PROVIDENCIA                   ;METROPOLITANA;0;0;0;0;0;0;0;0;0;CELULAR A21s 128 GB AZUL;TELEFONIA
19345746;Soltero;M;26;CHILENO;FONOAUDIOLOGO;Z;PROVIDENCIA                   ;METROPOLITANA;0;0;0;0;0;0;0;0;0;CELULAR MOTO G8 POWER LITE TURQUESA TRI ENTEL;TELEFONIA
8025161;;M;60;CHILENO;;Boomers;LOS SAUCES                    ;ARAUCANIA;0;0;0;0;0;0;0;0;0;Celular SAMSUNG A01 CORE BLACK CLARO;TELEFONIA
20022295;;F;23;CHILENO;;Silencioso;PROVIDENCIA                   ;METROPOLITANA;0;0;0;0;0;0;0;0;0;CELULAR A12 128GB NEGRO OPEN;TELEFONIA
8307319;;M;62;CHILENO;;Boomers;RENCA                         ;METROPOLITANA;0;0;0;0;0;0;0;0;0;CELULAR A21s 128 GB Negro;TELEFONIA
17648204;;M;31;CHILENO;;Millenial;CURANILAHUE                   ;BIO BIO;0;0;0;0;0;0;0;0;0;Celular A31 LIB OPEN ROJO;TELEFONIA
18273712;;F;29;CHILENO;;Millenial;PROVIDENCIA                   ;METROPOLITANA;0;0;0;0;0;0;0;0;0;CELULAR REDMI NOTE 9 128 GB POLAR WHITE OPEN;TELEFONIA
8182886;Casado;F;64;CHILENO;;Silencioso;PROVIDENCIA                   ;METROPOLITANA;0;0;0;0;0;0;0;0;0;CELULAR SAMSUNG A01 NEGRO DIRECTO WOM;TELEFONIA
18122156;;F;29;CHILENO;;Millenial;SAN JOAQUIN                   ;METROPOLITANA;0;0;0;0;0;0;0;0;0;CELULAR MOTO G9 POWER 128GB VERDE GRANITO OPEN;TELEFONIA
19102393;Soltero;F;27;CHILENO;;Z;PROVIDENCIA                   ;METROPOLITANA;0;0;0;0;0;0;0;0;0;CELULAR REDMI 9 32GB CARBON GREY OPEN;TELEFONIA
8184656;Casado;M;63;CHILENO;INGENIERO CIVIL QUIMICO;Silencioso;PROVIDENCIA                   ;METROPOLITANA;0;0;0;0;0;0;0;0;0;Celular A51 128GB LIB OPEN AZUL;TELEFONIA
10573884;;M;55;CHILENO;;Boomers;RENCA                         ;METROPOLITANA;0;0;0;0;0;0;0;0;0;Celular A71 LIB OPEN NEGRO;TELEFONIA
14013379;;M;41;CHILENO;;X;PROVIDENCIA                   ;METROPOLITANA;0;0;0;0;0;0;0;0;0;CELULAR MOTOROLA G9 PLAY ROSADO DIRECTO WOM;TELEFONIA
19042492;Soltero;F;26;CHILENO;;Z;PROVIDENCIA                   ;METROPOLITANA;0;0;0;0;0;0;0;0;0;CELULAR SAMSUNG A71 AZUL OPEN;TELEFONIA
17135368;;M;33;CHILENO;;Millenial;"";"";0;0;0;0;0;0;0;0;0;CELULAR MOTOROLA G9 PLAY ROSADO DIRECTO WOM;TELEFONIA
11442043;Casado;M;52;CHILENO;;X;RENCA                         ;METROPOLITANA;0;0;0;0;0;0;0;0;0;Celular A31 LIB OPEN ROJO;TELEFONIA
17313635;Soltero;F;32;CHILENO;ENFERMERA;Millenial;PROVIDENCIA                   ;METROPOLITANA;0;0;0;0;0;0;0;0;0;Celular A51 128GB LIB OPEN BLACK;TELEFONIA
25920559;;F;62;CHILENO;;Extranjero;SAN MIGUEL                    ;METROPOLITANA;0;0;0;0;0;0;0;0;0;CELULAR A21s 128 GB AZUL;TELEFONIA
6394009;;F;74;CHILENO;;Silencioso;RENCA                         ;METROPOLITANA;0;0;0;0;0;0;0;0;0;Celular SAMSUNG A01 CORE BLACK CLARO;TELEFONIA
13363858;;M;44;CHILENO;;X;SAN ESTEBAN                   ;VALPARAISO;0;0;0;0;0;0;0;0;0;CELULAR MOTO G8 POWER LITE TURQUESA TRI ENTEL;TELEFONIA
16779314;;M;34;CHILENO;;Millenial;PROVIDENCIA                   ;METROPOLITANA;0;0;0;0;0;0;0;0;0;CELULAR REDMI NOTE 9 PRO 128GB TROPICAL GREEN;TELEFONIA
12045085;;F;55;CHILENO;;Boomers;DALCAHUE                      ;LOS LAGOS;0;0;0;0;0;0;0;0;0;CELULAR SAMSUNG A01 NEGRO DIRECTO WOM;TELEFONIA
24052666;;M;40;COLOMBIANO;;Extranjero;ANTOFAGASTA                   ;ANTOFAGASTA;0;0;0;0;0;0;0;0;0;Celular A71 LIB OPEN PLATEADO;TELEFONIA
4854157;;F;81;CHILENO;;Silencioso;COQUIMBO                      ;COQUIMBO;0;0;0;0;0;0;0;0;0;CELULAR REDMI 9 32GB CARBON GREY OPEN;TELEFONIA
16897210;;F;33;CHILENO;;Millenial;N/D;N/D;0;0;0;0;0;0;0;0;0;Celular A71 LIB OPEN PLATEADO;TELEFONIA
12206885;;F;50;CHILENO;;X;PROVIDENCIA                   ;METROPOLITANA;0;0;0;0;0;0;0;0;0;CELULAR MOTOROLA E6S GRIS 32GB DIRECTO WOM;TELEFONIA
18581187;;M;27;CHILENO;;Millenial;N/D;N/D;0;0;0;0;0;0;0;0;0;Celular A51 128GB LIB OPEN AZUL;TELEFONIA
16177715;;F;46;CHILENO;;X;NUEVA IMPERIAL                ;ARAUCANIA;0;0;0;0;0;0;0;0;0;Celular A10S LIB OPEN BLUE;TELEFONIA
7213982;Casado;M;69;CHILENO;AGRONOMO;Silencioso;RENCA                         ;METROPOLITANA;0;0;0;0;0;0;0;0;0;CELULAR NOKIA 110 BLACK OPEN;TELEFONIA
13963919;;F;42;CHILENO;;X;ANGOL                         ;ARAUCANIA;0;0;0;0;0;0;0;0;0;Celular S20 FE LIB OPEN Cloud Lavender;TELEFONIA
19623582;;F;25;CHILENO;;Z;PROVIDENCIA                   ;METROPOLITANA;0;0;0;0;0;0;0;0;0;CELULAR MOTOROLA G9 PLAY ROSADO DIRECTO WOM;TELEFONIA
8503025;;M;64;CHILENO;;Boomers;CALBUCO                       ;LOS LAGOS;0;0;0;0;0;0;0;0;0;Celular ZTE A3 2020 WOM DIRECTO NEGRO;TELEFONIA
14535817;;M;47;CHILENO;;Silencioso;PROVIDENCIA                   ;METROPOLITANA;0;0;0;0;0;0;0;0;0;Celular Galaxy S21 Phantom Grey 128GB;TELEFONIA
8275305;Soltero;M;63;CHILENO;;Silencioso;PROVIDENCIA                   ;METROPOLITANA;0;0;0;0;0;0;0;0;0;Celular VIVO Y11S ENTEL DIRECTO AZUL;TELEFONIA
5348929;;M;77;CHILENO;;Silencioso;RENCA                         ;METROPOLITANA;0;0;0;0;0;0;0;0;0;Celular AL3 CLARO DIRECTO NEGRO;TELEFONIA
13782813;;M;42;CHILENO;;X;CHIMBARONGO                   ;L.G.B.OÂ´HIGGINS;0;0;0;0;0;0;0;0;0;Celular SAMSUNG A11 32GB ENTEL DIRECTO NEGRO;TELEFONIA
17986253;;F;31;CHILENO;;Millenial;MELIPILLA                     ;METROPOLITANA;0;0;0;0;0;0;0;0;0;CELULAR REDMI NOTE 9 128 GB MIDNIGHT GREY OPEN;TELEFONIA
17865874;;M;30;CHILENO;;Millenial;PROVIDENCIA                   ;METROPOLITANA;0;0;0;0;0;0;0;0;0;CELULAR LG K61 Gris OPEN;TELEFONIA
7615381;;M;67;CHILENO;;Boomers;CONSTITUCION                  ;MAULE;0;0;0;0;0;0;0;0;0;Celular A01 Core Azul Tri Entel;TELEFONIA
7750456;Casado;F;67;CHILENO;;Boomers;RENCA                         ;METROPOLITANA;0;0;0;0;0;0;0;0;0;TELEFONO PP BINDU ENTEL;TELEFONIA
15570894;;M;38;CHILENO;;X;SAN JAVIER                    ;MAULE;0;0;0;0;0;0;0;0;0;CELULAR HUAWEI Y9 PRIME BLUE OPEN;TELEFONIA
8437158;Viudo;F;65;CHILENO;;Boomers;RENCA                         ;METROPOLITANA;0;0;0;0;0;0;0;0;0;CELULAR A12 128GB ROJO OPEN;TELEFONIA
10463178;;F;56;CHILENO;;Millenial;SAN CLEMENTE                  ;MAULE;0;0;0;0;0;0;0;0;0;CELULAR HUAWEI Y8S BLACK TRI CLARO;TELEFONIA
17554474;;M;30;CHILENO;;Millenial;ARICA                         ;TARAPACA;0;0;0;0;0;0;0;0;0;Celular SA3 CLARO DIRECTO BLACK;TELEFONIA
9295356;;M;58;CHILENO;;Boomers;SAN JAVIER                    ;MAULE;0;0;0;0;0;0;0;0;0;CELULAR REDMI NOTE 9 PRO 128GB GLACIER WHITE;TELEFONIA
8545846;Casado;F;63;CHILENO;;Silencioso;PROVIDENCIA                   ;METROPOLITANA;0;0;0;0;0;0;0;0;0;Celular A01 CLARO DIRECTO BLACK;TELEFONIA
11128476;;F;55;CHILENO;;Boomers;VILLARICA                     ;ARAUCANIA;0;0;0;0;0;0;0;0;0;CELULAR NOKIA 110 BLACK OPEN;TELEFONIA
15404668;;F;42;CHILENO;;X;MELIPILLA                     ;METROPOLITANA;0;0;0;0;0;0;0;0;0;Celular A11 LIB OPEN BLUE;TELEFONIA
17579979;Soltero;M;31;CHILENO;PROFESOR;Millenial;PROVIDENCIA                   ;METROPOLITANA;0;0;0;0;0;0;0;0;0;CELULAR LG K41S TITAN DIRECTO MOVISTAR;TELEFONIA
9380215;Casado;F;59;CHILENO;PROFESOR;Boomers;PROVIDENCIA                   ;METROPOLITANA;0;0;0;0;0;0;0;0;0;CELULAR MOTOROLA E6S GRIS 32GB DIRECTO WOM;TELEFONIA
8383664;;F;62;CHILENO;;Boomers;PROVIDENCIA                   ;METROPOLITANA;0;0;0;0;0;0;0;0;0;Celular LG K22 MOVISTAR DIRECTO TITAN;TELEFONIA
9562136;;M;58;CHILENO;;Boomers;N/D;N/D;0;0;0;0;0;0;0;0;0;Celular SAMSUNG A01 CORE BLACK CLARO;TELEFONIA
20129043;;F;23;CHILENO;;Z;CONCHALI                      ;METROPOLITANA;0;0;0;0;0;0;0;0;0;CELULAR REDMI NOTE 8 64GB SPACE BLACK OPEN;TELEFONIA
14346366;;F;43;CHILENO;;X;EL BOSQUE                     ;METROPOLITANA;0;0;0;0;0;0;0;0;0;CELULAR REDMI 9 64GB SUNSET PURPLE TRI WOM;TELEFONIA
20375451;;F;21;CHILENO;;Z;PROVIDENCIA                   ;METROPOLITANA;0;0;0;0;0;0;0;0;0;Celular S20 FE LIB OPEN Cloud Navy;TELEFONIA
8762288;Casado;M;62;CHILENO;;Boomers;RENCA                         ;METROPOLITANA;0;0;0;0;0;0;0;0;0;CELULAR MOTOROLA G8 POWER LITE AZUL WOM;TELEFONIA
16545734;;M;35;CHILENO;;Millenial;PROVIDENCIA                   ;METROPOLITANA;0;0;0;0;0;0;0;0;0;Celular A51 128GB LIB OPEN AZUL;TELEFONIA
13477141;;F;44;CHILENO;;Silencioso;"";"";0;0;0;0;0;0;0;0;0;Celular A71 LIB OPEN NEGRO;TELEFONIA
19346146;Soltero;M;26;CHILENO;;Z;PROVIDENCIA                   ;METROPOLITANA;0;0;0;0;0;0;0;0;0;CELULAR REDMI NOTE 9 128 GB MIDNIGHT GREY OPEN;TELEFONIA
12779225;;M;46;CHILENO;;X;PAINE                         ;METROPOLITANA;0;0;0;0;0;0;0;0;0;Celular G8 POWER LITE MOVISTAR DIRECTO AZUL;TELEFONIA
8512754;;F;64;CHILENO;;Boomers;RENCA                         ;METROPOLITANA;0;0;0;0;0;0;0;0;0;Celular A01 CLARO DIRECTO BLACK;TELEFONIA
19584148;;F;25;CHILENO;;Z;PROVIDENCIA                   ;METROPOLITANA;0;0;0;0;0;0;0;0;0;Celular Galaxy S21 Ultra Phantom Black 128GB;TELEFONIA
14236506;;F;50;CHILENO;;X;VINA DEL MAR                  ;VALPARAISO;0;0;0;0;0;0;0;0;0;Celular NOKIA 4.2 ENTEL DIRECTO NEGRO;TELEFONIA
8763053;;M;61;CHILENO;;Boomers;CALAMA                        ;ANTOFAGASTA;0;0;0;0;0;0;0;0;0;CELULAR MOTO G9 POWER 128GB MORADO SONICO OPEN;TELEFONIA
19177867;;F;26;CHILENO;;Z;ALTO HOSPICIO;TARAPACA;0;0;0;0;0;0;0;0;0;CELULAR REDMI NOTE 8 64GB NEPTUNE BLUE OPEN;TELEFONIA
15600456;;F;40;CHILENO;;X;SAN FERNANDO                  ;L.G.B.OÂ´HIGGINS;0;0;0;0;0;0;0;0;0;Celular A01 CLARO DIRECTO BLACK;TELEFONIA
7728531;Casado;M;66;CHILENO;;Boomers;RENCA                         ;METROPOLITANA;0;0;0;0;0;0;0;0;0;Celular LG K22 MOVISTAR DIRECTO TITAN;TELEFONIA
7057647;Casado;M;73;CHILENO;AGROINDUSTRIA;Silencioso;MOLINA                        ;MAULE;0;0;0;0;0;0;0;0;0;CELULAR OWN 1026 AZUL ENTEL;TELEFONIA
13499629;;M;43;CHILENO;;X;SAN MIGUEL                    ;METROPOLITANA;0;0;0;0;0;0;0;0;0;CELULAR A21s 128 GB Negro;TELEFONIA
6483917;Casado;M;72;CHILENO;;Silencioso;RENCA                         ;METROPOLITANA;0;0;0;0;0;0;0;0;0;CELULAR NOKIA 110 BLACK OPEN;TELEFONIA
8221896;;F;67;CHILENO;;Boomers;FRUTILLAR                     ;LOS LAGOS;0;0;0;0;0;0;0;0;0;Celular Y6 2019 CLARO DIRECTO BLACK;TELEFONIA
20573731;;F;21;CHILENO;;Z;"";"";0;0;0;0;0;0;0;0;0;CELULAR REDMI 9 64GB CARBON GREY;TELEFONIA
26296958;;M;31;VENEZOLANO;;Extranjero;N/D;N/D;0;0;0;0;0;0;0;0;0;CELULAR SAMSUNG A71 AZUL OPEN;TELEFONIA
17443937;;M;31;CHILENO;;Silencioso;PROVIDENCIA                   ;METROPOLITANA;0;0;0;0;0;0;0;0;0;Celular S20 FE LIB OPEN Cloud Green;TELEFONIA
6352432;;F;72;CHILENO;;Silencioso;PELARCO                       ;MAULE;0;0;0;0;0;0;0;0;0;Celular A01 CLARO DIRECTO BLACK;TELEFONIA
19216978;Soltero;F;26;CHILENO;;Z;PROVIDENCIA                   ;METROPOLITANA;0;0;0;0;0;0;0;0;0;Celular A71 LIB OPEN PLATEADO;TELEFONIA
12189994;;F;49;CHILENO;;X;PROVIDENCIA                   ;METROPOLITANA;0;0;0;0;0;0;0;0;0;Celular SAMSUNG A01 CORE AZUL ENTEL;TELEFONIA
15092612;;F;39;CHILENO;;X;PROVIDENCIA                   ;METROPOLITANA;0;0;0;0;0;0;0;0;0;CELULAR MOTO G8 POWER LITE AZUL TRI ENTEL;TELEFONIA
14347089;;F;44;CHILENO;;X;MONTE PATRIA                  ;COQUIMBO;0;0;0;0;0;0;0;0;0;CELULAR LG K41S TITAN DIRECTO MOVISTAR;TELEFONIA
11300188;;F;53;CHILENO;;X;PROVIDENCIA                   ;METROPOLITANA;0;0;0;0;0;0;0;0;0;Celular A01 CLARO DIRECTO BLACK;TELEFONIA
18238659;Divorciado;F;42;CHILENO;;X;PROVIDENCIA                   ;METROPOLITANA;0;0;0;0;0;0;0;0;0;CELULAR MOTOROLA E6S GRIS 32GB DIRECTO WOM;TELEFONIA
14062625;;F;40;CHILENO;;Silencioso;PROVIDENCIA                   ;METROPOLITANA;0;0;0;0;0;0;0;0;0;Celular A71 LIB OPEN PLATEADO;TELEFONIA
6579090;Casado;M;71;CHILENO;INGENIERO AGRICOLA;Silencioso;PROVIDENCIA                   ;METROPOLITANA;0;0;0;0;0;0;0;0;0;CELULAR OWN 1026 AZUL ENTEL;TELEFONIA
15991062;;F;37;CHILENO;;Millenial;PROVIDENCIA                   ;METROPOLITANA;0;0;0;0;0;0;0;0;0;CELULAR NOKIA 110 BLACK OPEN;TELEFONIA
15773527;;F;37;CHILENO;;Silencioso;PROVIDENCIA                   ;METROPOLITANA;0;0;0;0;0;0;0;0;0;BAM ZTE MF920 WOM;TELEFONIA
19926009;;F;24;CHILENO;;Z;TEMUCO                        ;ARAUCANIA;0;0;0;0;0;0;0;0;0;CELULAR SAMSUNG A01 CORE BLACK WOM;TELEFONIA
19389220;Soltero;M;26;CHILENO;TECNICO MECANICO;Z;VILLA ALEGRE                  ;MAULE;0;0;0;0;0;0;0;0;0;Celular A31 LIB OPEN BLACK;TELEFONIA
17058720;;M;34;CHILENO;;Millenial;CHIMBARONGO                   ;L.G.B.OÂ´HIGGINS;0;0;0;0;0;0;0;0;0;CELULAR HUAWEI P30 LITE BLACK CLARO;TELEFONIA
18672365;Soltero;F;28;CHILENO;;Millenial;PROVIDENCIA                   ;METROPOLITANA;0;0;0;0;0;0;0;0;0;CELULAR HUAWEI Y5 NEO NEGRO WOM;TELEFONIA
18838899;Soltero;F;27;CHILENO;;Millenial;PROVIDENCIA                   ;METROPOLITANA;0;0;0;0;0;0;0;0;0;CELULAR HUAWEI Y9S BLACK DIRECTO CLARO;TELEFONIA
17432873;Soltero;M;32;CHILENO;;Millenial;PROVIDENCIA                   ;METROPOLITANA;0;0;0;0;0;0;0;0;0;CELULAR SAMSUNG A21S AZUL OPEN;TELEFONIA
17226079;Soltero;M;31;CHILENO;;Silencioso;PROVIDENCIA                   ;METROPOLITANA;0;0;0;0;0;0;0;0;0;Celular Y7P LIB OPEN NEGRO;TELEFONIA
17470181;;M;32;CHILENO;;Z;PROVIDENCIA                   ;METROPOLITANA;0;0;0;0;0;0;0;0;0;CELULAR REDMI NOTE 8 64GB NEPTUNE BLUE OPEN;TELEFONIA
17154748;Soltero;F;34;CHILENO;;Millenial;PROVIDENCIA                   ;METROPOLITANA;0;0;0;0;0;0;0;0;0;CELULAR XIAOMI REDMI 9C 64GB TIWLIGHT BLUE TRI M;TELEFONIA
9595408;;F;60;CHILENO;;Boomers;MAIPU                         ;METROPOLITANA;0;0;0;0;0;0;0;0;0;CELULAR A12 128GB ROJO OPEN;TELEFONIA
16832450;;M;33;CHILENO;;Millenial;PROVIDENCIA                   ;METROPOLITANA;0;0;0;0;0;0;0;0;0;CELULAR REDMI NOTE 9 128 GB MIDNIGHT GREY OPEN;TELEFONIA
12415377;;F;49;CHILENO;;X;RENCA                         ;METROPOLITANA;0;0;0;0;0;0;0;0;0;CELULAR HUAWEI Y8S CLARO DIRECTO BLACK;TELEFONIA
19123930;;F;28;CHILENO;;Millenial;"";"";0;0;0;0;0;0;0;0;0;Celular A10S LIB OPEN RED;TELEFONIA
12350867;;M;48;CHILENO;;X;RENCA                         ;METROPOLITANA;0;0;0;0;0;0;0;0;0;CELULAR REDMI NOTE 8 64GB SPACE BLACK OPEN;TELEFONIA
19694202;Soltero;M;30;CHILENO;;Millenial;PROVIDENCIA                   ;METROPOLITANA;0;0;0;0;0;0;0;0;0;Celular P40 LITE LIB OPEN BLACK;TELEFONIA
14390975;;F;44;CHILENO;;X;TALCAHUANO                    ;BIO BIO;0;0;0;0;0;0;0;0;0;Celular A51 128GB LIB OPEN AZUL;TELEFONIA
11457547;;F;53;CHILENO;;X;RENCA                         ;METROPOLITANA;0;0;0;0;0;0;0;0;0;CELULAR SAMSUNG A21S AZUL OPEN;TELEFONIA
15686531;Soltero;F;38;CHILENO;;Millenial;PROVIDENCIA                   ;METROPOLITANA;0;0;0;0;0;0;0;0;0;CELULAR MOTO G8 POWER LITE AZUL TRI ENTEL;TELEFONIA
14062561;;M;40;CHILENO;;X;N/D;N/D;0;0;0;0;0;0;0;0;0;Celular Y9 PRIME LIB OPEN NEGRO;TELEFONIA
10317819;;M;55;CHILENO;;Boomers;PROVIDENCIA                   ;METROPOLITANA;0;0;0;0;0;0;0;0;0;CELULAR REDMI NOTE 8 64GB SPACE BLACK OPEN;TELEFONIA
7990495;;F;62;CHILENO;;Boomers;EL BOSQUE                     ;METROPOLITANA;0;0;0;0;0;0;0;0;0;CELULAR MOTOROLA E6S GRIS 32GB DIRECTO WOM;TELEFONIA
18004793;Soltero;F;30;CHILENO;TECNICO DE NIVEL SUPERIOR EN ENFERMERIA;Millenial;PROVIDENCIA                   ;METROPOLITANA;0;0;0;0;0;0;0;0;0;Celular A51 128GB LIB OPEN AZUL;TELEFONIA
10219983;Casado;F;57;CHILENO;ARTISTA;Boomers;PROVIDENCIA                   ;METROPOLITANA;0;0;0;0;0;0;0;0;0;CELULAR MOTO G9 POWER 128GB MORADO SONICO OPEN;TELEFONIA
19321011;Soltero;F;26;CHILENO;;Silencioso;PROVIDENCIA                   ;METROPOLITANA;0;0;0;0;0;0;0;0;0;CELULAR MOTO G8 POWER LITE BUNDLE AUDIFONOS TRI;TELEFONIA
13978961;;F;41;CHILENO;;X;PROVIDENCIA                   ;METROPOLITANA;0;0;0;0;0;0;0;0;0;CELULAR A12 128GB NEGRO OPEN;TELEFONIA
19097075;;F;26;CHILENO;;Z;N/D;N/D;0;0;0;0;0;0;0;0;0;CELULAR MOTO G9 POWER 128GB MORADO SONICO OPEN;TELEFONIA
12080930;;F;42;CHILENO;;X;RENCA                         ;METROPOLITANA;0;0;0;0;0;0;0;0;0;CELULAR REDMI NOTE 9 PRO 128GB TROPICAL GREEN;TELEFONIA
19157263;;F;21;CHILENO;;Z;PROVIDENCIA                   ;METROPOLITANA;0;0;0;0;0;0;0;0;0;Celular A51 128GB LIB OPEN BLANCO;TELEFONIA
12671038;;M;47;CHILENO;;X;OVALLE                        ;COQUIMBO;0;0;0;0;0;0;0;0;0;CELULAR MOTO G8 POWER LITE TURQUESA TRI ENTEL;TELEFONIA
6483753;Casado;M;66;CHILENO;;Boomers;PROVIDENCIA                   ;METROPOLITANA;0;0;0;0;0;0;0;0;0;Celular A01 LIB OPEN NEGRO;TELEFONIA
19423198;;M;25;CHILENO;;Silencioso;PROVIDENCIA                   ;METROPOLITANA;0;0;0;0;0;0;0;0;0;CELULAR LG VELVET BLANCO OPEN;TELEFONIA
16840179;;M;34;CHILENO;;Millenial;PROVIDENCIA                   ;METROPOLITANA;0;0;0;0;0;0;0;0;0;Celular A51 128GB LIB OPEN BLACK;TELEFONIA
7096224;;M;66;CHILENO;;Boomers;PROVIDENCIA                   ;METROPOLITANA;0;0;0;0;0;0;0;0;0;Celular LG K22 ENTEL DIRECTO TITAN;TELEFONIA
12563286;Casado;M;48;CHILENO;;X;RENCA                         ;METROPOLITANA;0;0;0;0;0;0;0;0;0;Celular SA3 CLARO DIRECTO BLACK;TELEFONIA
16343314;Divorciado;F;35;CHILENO;;Millenial;RENCA                         ;METROPOLITANA;0;0;0;0;0;0;0;0;0;CELULAR LG K22+ Gris OPEN;TELEFONIA
9799230;Casado;F;57;CHILENO;;Boomers;CURICO                        ;MAULE;0;0;0;0;0;0;0;0;0;Celular LG K22 ENTEL DIRECTO TITAN;TELEFONIA
14135168;;F;40;CHILENO;;X;RENCA                         ;METROPOLITANA;0;0;0;0;0;0;0;0;0;Celular ZTE A3 2020 WOM DIRECTO NEGRO;TELEFONIA
18485995;;M;28;CHILENO;;Millenial;QUILPUE                       ;VALPARAISO;0;0;0;0;0;0;0;0;0;CELULAR XIAOMI REDMI 9A 32GB SKY BLUE TRI WOM;TELEFONIA
17701367;Soltero;F;31;CHILENO;PSICOLOGO;Millenial;N/D;N/D;0;0;0;0;0;0;0;0;0;Celular S20 FE LIB OPEN Cloud Green;TELEFONIA
15999460;;F;37;CHILENO;;Silencioso;PROVIDENCIA                   ;METROPOLITANA;0;0;0;0;0;0;0;0;0;CELULAR MOTO ONE FUSION 64GB VERDE 64GB OPEN;TELEFONIA
9825756;;F;59;CHILENO;;Boomers;PROVIDENCIA                   ;METROPOLITANA;0;0;0;0;0;0;0;0;0;CELULAR REDMI 9 64GB SUNSET PURPLE TRI WOM;TELEFONIA
25098373;;F;37;CHILENO;;Extranjero;OVALLE                        ;COQUIMBO;0;0;0;0;0;0;0;0;0;CELULAR XIAOMI REDMI 9C AZUL DIRECTO ENTEL;TELEFONIA
7054691;;M;68;CHILENO;;Boomers;PROVIDENCIA                   ;METROPOLITANA;0;0;0;0;0;0;0;0;0;Celular LG K22 MOVISTAR DIRECTO TITAN;TELEFONIA
20426591;;F;22;CHILENO;;Millenial;"";"";0;0;0;0;0;0;0;0;0;CELULAR IPHONE SE 64GB DIRECTO CLARO;TELEFONIA
13800086;;F;42;CHILENO;;X;PROVIDENCIA                   ;METROPOLITANA;0;0;0;0;0;0;0;0;0;Celular Galaxy S21 Phantom Violet 128GB;TELEFONIA
19833877;;F;23;CHILENO;;Z;PROVIDENCIA                   ;METROPOLITANA;0;0;0;0;0;0;0;0;0;Celular NOKIA 1.3 NEGRO WOM;TELEFONIA
17708538;;F;30;CHILENO;;Millenial;PROVIDENCIA                   ;METROPOLITANA;0;0;0;0;0;0;0;0;0;Celular A71 LIB OPEN PLATEADO;TELEFONIA
5581505;;M;75;CHILENO;;Silencioso;TALCAHUANO                    ;BIO BIO;0;0;0;0;0;0;0;0;0;Celular A01 Core Azul Tri Entel;TELEFONIA
19091167;Soltero;F;26;CHILENO;;Z;PROVIDENCIA                   ;METROPOLITANA;0;0;0;0;0;0;0;0;0;CELULAR REDMI NOTE 8 64GB NEPTUNE BLUE OPEN;TELEFONIA
18599055;;M;28;CHILENO;;Millenial;PENAFLOR                      ;METROPOLITANA;0;0;0;0;0;0;0;0;0;Celular A11 LIB OPEN WHITE;TELEFONIA
23913192;;F;33;HAITIANO;;Extranjero;SANTIAGO                      ;METROPOLITANA;0;0;0;0;0;0;0;0;0;CELULAR REDMI 9 64GB SUNSET PURPLE TRI WOM;TELEFONIA
8574061;;M;63;CHILENO;;Boomers;LOS ANGELES                   ;BIO BIO;0;0;0;0;0;0;0;0;0;Celular A71 LIB OPEN NEGRO;TELEFONIA
9497118;;M;58;CHILENO;;Boomers;PROVIDENCIA                   ;METROPOLITANA;0;0;0;0;0;0;0;0;0;Celular NOTE 10+ LIB OPEN AURA GLOW;TELEFONIA
19040931;Soltero;M;27;CHILENO;;Silencioso;PROVIDENCIA                   ;METROPOLITANA;0;0;0;0;0;0;0;0;0;CELULAR REDMI NOTE 9 PRO 128GB TROPICAL GREEN;TELEFONIA
19184691;Soltero;M;26;CHILENO;;Silencioso;PROVIDENCIA                   ;METROPOLITANA;0;0;0;0;0;0;0;0;0;CELULAR NOKIA 110 BLACK OPEN;TELEFONIA
12639095;Casado;M;48;CHILENO;;X;RENCA                         ;METROPOLITANA;0;0;0;0;0;0;0;0;0;Celular A31 LIB OPEN AZUL;TELEFONIA
15865583;;F;55;CHILENO;;Boomers;VALDIVIA                      ;LOS LAGOS;0;0;0;0;0;0;0;0;0;Celular Y7P LIB OPEN NEGRO;TELEFONIA
13762705;;M;42;CHILENO;;X;PROVIDENCIA                   ;METROPOLITANA;0;0;0;0;0;0;0;0;0;CELULAR REDMI NOTE 8 64GB SPACE BLACK OPEN;TELEFONIA
15916104;;M;37;CHILENO;;Millenial;PROVIDENCIA                   ;METROPOLITANA;0;0;0;0;0;0;0;0;0;CELULAR MOTOROLA G8 POWER LITE AZUL WOM;TELEFONIA
20034488;;F;23;CHILENO;;Z;PROVIDENCIA                   ;METROPOLITANA;0;0;0;0;0;0;0;0;0;Celular A71 LIB OPEN PLATEADO;TELEFONIA
13182686;Soltero;M;47;CHILENO;;X;RENCA                         ;METROPOLITANA;0;0;0;0;0;0;0;0;0;CELULAR MOTO ONE FUSION 64GB VERDE 64GB OPEN;TELEFONIA
13947879;;M;42;CHILENO;;X;PROVIDENCIA                   ;METROPOLITANA;0;0;0;0;0;0;0;0;0;CELULAR HUAWEI Y9S BLACK DIRECTO CLARO;TELEFONIA
12121344;;F;53;CHILENO;;X;TRAIGUEN                      ;ARAUCANIA;0;0;0;0;0;0;0;0;0;Celular P30 LITE ENTEL DIRECTO NEGRO;TELEFONIA
18689778;;F;27;CHILENO;;Millenial;N/D;N/D;0;0;0;0;0;0;0;0;0;CELULAR NOKIA 5.3 CHARCOAL TRI ENTEL;TELEFONIA
19874846;;M;24;CHILENO;;Silencioso;PROVIDENCIA                   ;METROPOLITANA;0;0;0;0;0;0;0;0;0;Celular SAMSUNG A31 BLACK CLARO;TELEFONIA
9733621;;M;59;CHILENO;;Boomers;RENCA                         ;METROPOLITANA;0;0;0;0;0;0;0;0;0;Celular SAMSUNG A01 CORE BLACK CLARO;TELEFONIA
8735105;Divorciado;F;63;CHILENO;;Boomers;RENCA                         ;METROPOLITANA;0;0;0;0;0;0;0;0;0;CELULAR CLARO HUAWEI Y8S VERDE DIRECTO CLARO;TELEFONIA
20303020;;F;22;CHILENO;;Z;RENCA                         ;METROPOLITANA;0;0;0;0;0;0;0;0;0;IPHONE 7 32GB LIB OPEN NEGRO;TELEFONIA
8978588;Casado;F;64;CHILENO;;Boomers;RENCA                         ;METROPOLITANA;0;0;0;0;0;0;0;0;0;CELULAR MOTOROLA G8 POWER LITE AZUL WOM;TELEFONIA
13329814;;F;44;CHILENO;;X;OVALLE                        ;COQUIMBO;0;0;0;0;0;0;0;0;0;Celular A10S LIB OPEN NEGRO;TELEFONIA
13412640;;F;44;CHILENO;;X;ARICA                         ;TARAPACA;0;0;0;0;0;0;0;0;0;Celular S20 FE LIB OPEN Cloud Green;TELEFONIA
16077124;;M;37;CHILENO;;Millenial;PROVIDENCIA                   ;METROPOLITANA;0;0;0;0;0;0;0;0;0;Celular a11 azul samsung WOM;TELEFONIA
7533001;;M;63;CHILENO;;Boomers;PROVIDENCIA                   ;METROPOLITANA;0;0;0;0;0;0;0;0;0;Celular A11 LIB OPEN BLUE;TELEFONIA
13794567;;F;42;CHILENO;;Extranjero;COELEMU                       ;BIO BIO;0;0;0;0;0;0;0;0;0;CELULAR SAMSUNG A01 NEGRO DIRECTO WOM;TELEFONIA
17619338;Soltero;F;30;CHILENO;;Millenial;PROVIDENCIA                   ;METROPOLITANA;0;0;0;0;0;0;0;0;0;CELULAR IPHONE SE 64GB DIRECTO CLARO;TELEFONIA
7907700;;M;67;CHILENO;;Boomers;PROVIDENCIA                   ;METROPOLITANA;0;0;0;0;0;0;0;0;0;Celular SAMSUNG A11 32GB ENTEL DIRECTO NEGRO;TELEFONIA
25266142;;M;25;PERUANO;;Extranjero;RECOLETA                      ;METROPOLITANA;0;0;0;0;0;0;0;0;0;CELULAR MOTO ONE FUSION 64GB VERDE 64GB OPEN;TELEFONIA
12214454;Casado;M;49;CHILENO;INGENIERO CIVIL INDUSTRIAL;X;PROVIDENCIA                   ;METROPOLITANA;0;0;0;0;0;0;0;0;0;Celular S10+ LIB OPEN NEGRO;TELEFONIA
6652156;;F;68;CHILENO;;Silencioso;QUILLOTA                      ;VALPARAISO;0;0;0;0;0;0;0;0;0;Celular ZTE A3 2020 ENTEL DIRECTO GRIS;TELEFONIA
19354953;;F;26;CHILENO;;Z;PROVIDENCIA                   ;METROPOLITANA;0;0;0;0;0;0;0;0;0;Celular A51 128GB LIB OPEN AZUL;TELEFONIA
10716578;Soltero;M;50;CHILENO;;Silencioso;PROVIDENCIA                   ;METROPOLITANA;0;0;0;0;0;0;0;0;0;Celular A10S LIB OPEN RED;TELEFONIA
18846573;;M;28;CHILENO;;Millenial;PROVIDENCIA                   ;METROPOLITANA;0;0;0;0;0;0;0;0;0;Celular S10+ LIB OPEN NEGRO;TELEFONIA
13680127;;M;43;CHILENO;;X;ANTOFAGASTA                   ;ANTOFAGASTA;0;0;0;0;0;0;0;0;0;Celular LG K22 ENTEL DIRECTO TITAN;TELEFONIA
24049467;;F;32;BOLIVIANO;;Extranjero;CALAMA                        ;ANTOFAGASTA;0;0;0;0;0;0;0;0;0;CELULAR MOTO G8 POWER LITE TURQUESA TRI ENTEL;TELEFONIA
19816695;;M;24;CHILENO;;Z;RENCA                         ;METROPOLITANA;0;0;0;0;0;0;0;0;0;Celular LG K22 ENTEL DIRECTO TITAN;TELEFONIA
12003509;Casado;F;51;CHILENO;GASTRONOMIA INTERNACIONAL;X;RENCA                         ;METROPOLITANA;0;0;0;0;0;0;0;0;0;CELULAR OWN 1026 AZUL ENTEL;TELEFONIA
18879653;;M;28;CHILENO;;Millenial;N/D;N/D;0;0;0;0;0;0;0;0;0;Celular A51 128GB LIB OPEN BLACK;TELEFONIA
11736200;;M;51;CHILENO;;X;PROVIDENCIA                   ;METROPOLITANA;0;0;0;0;0;0;0;0;0;Celular A10S LIB OPEN NEGRO;TELEFONIA
14466465;;M;47;CHILENO;;Extranjero;SAN BERNARDO                  ;METROPOLITANA;0;0;0;0;0;0;0;0;0;CELULAR LG K22 TRIANGULADO WOM;TELEFONIA
9314958;Divorciado;M;59;CHILENO;;Boomers;VALLENAR;ATACAMA;0;0;0;0;0;0;0;0;0;Celular A10S LIB OPEN RED;TELEFONIA
12866002;Casado;M;47;CHILENO;INGENIERO DE EJECUCION EN GESTION PUBLICA;X;PROVIDENCIA                   ;METROPOLITANA;0;0;0;0;0;0;0;0;0;CELULAR MOTO ONE FUSION 64GB VERDE 64GB OPEN;TELEFONIA
20196812;;F;22;CHILENO;;Z;PROVIDENCIA                   ;METROPOLITANA;0;0;0;0;0;0;0;0;0;CELULAR MOTOROLA G9 PLUS CHAMPAGNE ROSE OPEN;TELEFONIA
7666538;Viudo;F;66;CHILENO;AUXILIAR PARAMEDICO DE ALIMENTACION;Boomers;PROVIDENCIA                   ;METROPOLITANA;0;0;0;0;0;0;0;0;0;CELULAR A12 128GB AZUL OPEN;TELEFONIA
19310719;;F;25;CHILENO;;Z;PROVIDENCIA                   ;METROPOLITANA;0;0;0;0;0;0;0;0;0;Celular A31 LIB OPEN AZUL;TELEFONIA
16293289;Soltero;F;35;CHILENO;PROFESOR;Millenial;CAUQUENES                     ;MAULE;0;0;0;0;0;0;0;0;0;CELULAR A02s AZUL 32GB OPEN;TELEFONIA
16406366;;M;36;CHILENO;;Millenial;PROVIDENCIA                   ;METROPOLITANA;0;0;0;0;0;0;0;0;0;Celular A01 CLARO DIRECTO BLACK;TELEFONIA
13519985;;M;43;CHILENO;;Silencioso;PROVIDENCIA                   ;METROPOLITANA;0;0;0;0;0;0;0;0;0;Celular A11 LIB OPEN BLUE;TELEFONIA
18651139;Soltero;F;27;CHILENO;TECNICO EN ADMINISTRACION DE EMPRESAS;Z;PROVIDENCIA                   ;METROPOLITANA;0;0;0;0;0;0;0;0;0;Celular A51 128GB LIB OPEN BLACK;TELEFONIA
7395280;Casado;M;69;CHILENO;;Silencioso;PROVIDENCIA                   ;METROPOLITANA;0;0;0;0;0;0;0;0;0;Celular R340 CLARO DIRECTO NEGRO;TELEFONIA
8696109;;M;63;CHILENO;;Boomers;NUNOA                         ;METROPOLITANA;0;0;0;0;0;0;0;0;0;CELULAR XIAOMI REDMI 9A 32GB BLACK DIRECTO CLARO;TELEFONIA
15771887;Soltero;M;37;CHILENO;;Millenial;PROVIDENCIA                   ;METROPOLITANA;0;0;0;0;0;0;0;0;0;Celular A51 128GB LIB OPEN BLACK;TELEFONIA
19898205;;M;23;CHILENO;;Z;RENCA                         ;METROPOLITANA;0;0;0;0;0;0;0;0;0;CELULAR REDMI NOTE 8 64GB SPACE BLACK OPEN;TELEFONIA
17808297;Soltero;M;31;CHILENO;;Millenial;PROVIDENCIA                   ;METROPOLITANA;0;0;0;0;0;0;0;0;0;Celular A51 128GB CLARO TRIANGULADO BLACK;TELEFONIA
19476553;Soltero;M;25;CHILENO;;Z;PROVIDENCIA                   ;METROPOLITANA;0;0;0;0;0;0;0;0;0;CELULAR REDMI NOTE 8 64GB SPACE BLACK OPEN;TELEFONIA
17614869;;F;32;CHILENO;;Millenial;RENCA                         ;METROPOLITANA;0;0;0;0;0;0;0;0;0;CELULAR XIAOMI REDMI 9C 64GB MIDNIGHT GRAY;TELEFONIA
9517521;;M;59;CHILENO;;Boomers;OLIVAR                        ;L.G.B.OÂ´HIGGINS;0;0;0;0;0;0;0;0;0;Celular NOKIA 1.3 NEGRO WOM;TELEFONIA
24057621;;M;48;PERUANO;;Extranjero;SAN FELIPE                    ;VALPARAISO;0;0;0;0;0;0;0;0;0;Celular A51 128GB LIB OPEN BLACK;TELEFONIA
8722339;Casado;F;63;CHILENO;;Silencioso;PROVIDENCIA                   ;METROPOLITANA;0;0;0;0;0;0;0;0;0;TELEFONO PP BINDU ENTEL;TELEFONIA
8974527;;M;59;CHILENO;;Boomers;RENCA                         ;METROPOLITANA;0;0;0;0;0;0;0;0;0;CELULAR MOTOROLA ONE FUSION 128GB DIRECTO MOVIST;TELEFONIA
13781320;;F;41;CHILENO;;X;RENCA                         ;METROPOLITANA;0;0;0;0;0;0;0;0;0;Celular P30 LITE PLUS LIB OPEN BLACK;TELEFONIA
6266965;;M;73;CHILENO;;Silencioso;RENCA                         ;METROPOLITANA;0;0;0;0;0;0;0;0;0;Celular A11 LIB OPEN BLACK;TELEFONIA
10863130;;M;54;CHILENO;;Boomers;PROVIDENCIA                   ;METROPOLITANA;0;0;0;0;0;0;0;0;0;Celular A01 LIB OPEN ROJO;TELEFONIA
17992359;Soltero;F;30;CHILENO;PROFESOR;Millenial;PROVIDENCIA                   ;METROPOLITANA;0;0;0;0;0;0;0;0;0;CELULAR XIAOMI POCO X3 64G SHADOW GRAY;TELEFONIA
8489274;;F;62;CHILENO;;Silencioso;PROVIDENCIA                   ;METROPOLITANA;0;0;0;0;0;0;0;0;0;CELULAR SAMSUNG A21S AZUL OPEN;TELEFONIA
16254687;;F;35;CHILENO;;Millenial;N/D;N/D;0;0;0;0;0;0;0;0;0;CELULAR MOTOROLA G8 POWER LITE AZUL WOM;TELEFONIA
18005377;;M;30;CHILENO;;Millenial;LA SERENA                     ;COQUIMBO;0;0;0;0;0;0;0;0;0;Celular A51 128GB LIB OPEN BLACK;TELEFONIA
11950841;;M;50;CHILENO;;X;PROVIDENCIA                   ;METROPOLITANA;0;0;0;0;0;0;0;0;0;PRODUCTO 2 SELECCION BANDA 4;TELEFONIA
12058969;;M;53;CHILENO;;X;RENCA                         ;METROPOLITANA;0;0;0;0;0;0;0;0;0;Celular S20 FE LIB OPEN Cloud Green;TELEFONIA
25362525;;M;66;HAITIANO;;Extranjero;SAN BERNARDO                  ;METROPOLITANA;0;0;0;0;0;0;0;0;0;CELULAR SAMSUNG A21S AZUL OPEN;TELEFONIA
16702302;;F;34;CHILENO;;Millenial;SAN FELIPE                    ;VALPARAISO;0;0;0;0;0;0;0;0;0;Celular ZTE A3 2020 ENTEL DIRECTO GRIS;TELEFONIA
10955806;;F;53;CHILENO;;X;RENCA                         ;METROPOLITANA;0;0;0;0;0;0;0;0;0;Celular A01 LIB OPEN AZUL;TELEFONIA
13706190;;M;42;CHILENO;;X;PROVIDENCIA                   ;METROPOLITANA;0;0;0;0;0;0;0;0;0;Celular Y7P LIB OPEN NEGRO;TELEFONIA
12015857;;M;50;CHILENO;;X;RENCA                         ;METROPOLITANA;0;0;0;0;0;0;0;0;0;Celular Y8P ENTEL TRIANGULADO NEGRO;TELEFONIA
17009066;Soltero;M;33;CHILENO;;Millenial;PROVIDENCIA                   ;METROPOLITANA;0;0;0;0;0;0;0;0;0;Celular A10S LIB OPEN BLUE;TELEFONIA
17824366;;F;30;CHILENO;;Millenial;TALCA                         ;MAULE;0;0;0;0;0;0;0;0;0;Celular S10+ LIB OPEN NEGRO;TELEFONIA
15699896;Soltero;M;38;CHILENO;;Millenial;PROVIDENCIA                   ;METROPOLITANA;0;0;0;0;0;0;0;0;0;CELULAR SAMSUNG A01 NEGRO DIRECTO WOM;TELEFONIA
18770685;Soltero;M;28;CHILENO;ENFERMERO;Millenial;PROVIDENCIA                   ;METROPOLITANA;0;0;0;0;0;0;0;0;0;CELULAR REDMI NOTE 8 64GB NEPTUNE BLUE OPEN;TELEFONIA
11258483;;F;53;CHILENO;;X;LA PINTANA                    ;METROPOLITANA;0;0;0;0;0;0;0;0;0;Celular LG K22 ENTEL DIRECTO TITAN;TELEFONIA
14043176;;M;40;CHILENO;;X;COIHAIQUE                     ;AYSEN;0;0;0;0;0;0;0;0;0;Celular E6S MOVISTAR DIRECTO AZUL;TELEFONIA
9082429;Casado;M;57;CHILENO;;Boomers;PROVIDENCIA                   ;METROPOLITANA;0;0;0;0;0;0;0;0;0;CELULAR Y8S MOVISTAR DIRECTO BLACK;TELEFONIA
14292797;;M;47;CHILENO;;X;PROVIDENCIA                   ;METROPOLITANA;0;0;0;0;0;0;0;0;0;Celular A01 LIB OPEN AZUL;TELEFONIA
12728293;Casado;F;47;CHILENO;;X;RENCA                         ;METROPOLITANA;0;0;0;0;0;0;0;0;0;Celular A10S LIB OPEN BLUE;TELEFONIA
11285150;;M;53;CHILENO;;X;PUENTE ALTO                   ;METROPOLITANA;0;0;0;0;0;0;0;0;0;Celular G8 POWER LITE MOVISTAR DIRECTO AZUL;TELEFONIA
15761744;;M;37;CHILENO;;Millenial;N/D;N/D;0;0;0;0;0;0;0;0;0;Celular A20S LIB OPEN ROJO;TELEFONIA
15964802;Soltero;M;37;CHILENO;;Millenial;PROVIDENCIA                   ;METROPOLITANA;0;0;0;0;0;0;0;0;0;Celular A01 Core Azul Tri Entel;TELEFONIA
18222833;Soltero;M;29;CHILENO;INGENIERO EN PREVENCION DE RIESGOS;Millenial;PROVIDENCIA                   ;METROPOLITANA;0;0;0;0;0;0;0;0;0;Celular A10S ENTEL DIRECTO NEGRO;TELEFONIA
25083913;;M;26;HAITIANO;;Extranjero;N/D;N/D;0;0;0;0;0;0;0;0;0;Celular a11 azul samsung WOM;TELEFONIA
7080383;;F;68;CHILENO;;Boomers;N/D;N/D;0;0;0;0;0;0;0;0;0;Celular R340 CLARO DIRECTO NEGRO;TELEFONIA
17962858;;M;30;CHILENO;;Millenial;CABILDO                       ;VALPARAISO;0;0;0;0;0;0;0;0;0;CELULAR HUAWEI Y9S BLACK DIRECTO CLARO;TELEFONIA
17183553;;M;33;CHILENO;;Millenial;TALCA                         ;MAULE;0;0;0;0;0;0;0;0;0;Celular SAMSUNG A11 32GB ENTEL DIRECTO NEGRO;TELEFONIA
13349699;;F;46;CHILENO;;X;CHIMBARONGO                   ;L.G.B.OÂ´HIGGINS;0;0;0;0;0;0;0;0;0;Celular MOTO G8 POWER LITE TURQUESA OPEN;TELEFONIA
12056203;;M;51;CHILENO;;X;LOS ANGELES                   ;BIO BIO;0;0;0;0;0;0;0;0;0;Celular A71 LIB OPEN PLATEADO;TELEFONIA
18154498;Soltero;F;30;CHILENO;TECNICO EN ENFERMERIA DE NIVEL SUPERIOR;Millenial;PROVIDENCIA                   ;METROPOLITANA;0;0;0;0;0;0;0;0;0;Celular A51 128GB LIB OPEN AZUL;TELEFONIA
11996551;;M;49;CHILENO;;X;SAN FERNANDO                  ;L.G.B.OÂ´HIGGINS;0;0;0;0;0;0;0;0;0;Celular ONE FUSION MOVISTAR DIRECTO AZUL;TELEFONIA
8912123;;M;61;CHILENO;;Boomers;MELIPILLA                     ;METROPOLITANA;0;0;0;0;0;0;0;0;0;IPHONE XR 64GB LIB OPEN NEGRO;TELEFONIA
11944438;;F;50;CHILENO;;X;RENCA                         ;METROPOLITANA;0;0;0;0;0;0;0;0;0;Celular G8 POWER LITE MOVISTAR DIRECTO AZUL;TELEFONIA
14568636;;M;42;CHILENO;;X;PROVIDENCIA                   ;METROPOLITANA;0;0;0;0;0;0;0;0;0;Celular A01 LIB OPEN ROJO;TELEFONIA
7807053;Casado;F;66;CHILENO;;Boomers;CONSTITUCION                  ;MAULE;0;0;0;0;0;0;0;0;0;Celular ONE FUSION MOVISTAR DIRECTO AZUL;TELEFONIA
13847306;;M;41;CHILENO;;X;VALDIVIA                      ;LOS RIOS;0;0;0;0;0;0;0;0;0;Celular A01 LIB OPEN ROJO;TELEFONIA
16838378;;F;33;CHILENO;;Millenial;LOS ANGELES                   ;BIO BIO;0;0;0;0;0;0;0;0;0;Celular A51 128GB LIB OPEN BLACK;TELEFONIA
13780582;;M;41;CHILENO;;X;SAN VICENTE                   ;L.G.B.OÂ´HIGGINS;0;0;0;0;0;0;0;0;0;CELULAR MOTO ONE FUSION 64GB VERDE 64GB OPEN;TELEFONIA
14279294;;M;49;CHILENO;;X;RENCA                         ;METROPOLITANA;0;0;0;0;0;0;0;0;0;Celular A31 LIB OPEN AZUL;TELEFONIA
13508989;;M;44;CHILENO;;Millenial;N/D;N/D;0;0;0;0;0;0;0;0;0;Celular SAMSUNG A01 CORE BLACK CLARO;TELEFONIA
8749569;Casado;F;63;CHILENO;;Boomers;RENCA                         ;METROPOLITANA;0;0;0;0;0;0;0;0;0;CELULAR XIAOMI REDMI 9A 32GB GRANITE GRAY TRI WO;TELEFONIA
17829144;;M;36;CHILENO;;Millenial;ARICA                         ;TARAPACA;0;0;0;0;0;0;0;0;0;Celular MOTOROLA G9 PLAY WOM DIRECTO AZUL;TELEFONIA
13841856;;M;42;CHILENO;;X;PROVIDENCIA                   ;METROPOLITANA;0;0;0;0;0;0;0;0;0;IPHONE 7 LIB OPEN NEGRO;TELEFONIA
15109018;;F;39;CHILENO;;X;PROVIDENCIA                   ;METROPOLITANA;0;0;0;0;0;0;0;0;0;Celular A01 LIB OPEN ROJO;TELEFONIA
16793475;;F;34;CHILENO;;Millenial;SAN JAVIER                    ;MAULE;0;0;0;0;0;0;0;0;0;Celular SAMSUNG A11 32GB ENTEL DIRECTO NEGRO;TELEFONIA
10198317;;F;54;CHILENO;;X;ARICA                         ;ARICA Y PARINACOTA;0;0;0;0;0;0;0;0;0;Celular A31 LIB OPEN BLACK;TELEFONIA
17271972;;F;32;CHILENO;;Millenial;TRAIGUEN                      ;ARAUCANIA;0;0;0;0;0;0;0;0;0;Celular R340 CLARO DIRECTO NEGRO;TELEFONIA
19048499;;F;26;CHILENO;;Z;QUILLOTA                      ;VALPARAISO;0;0;0;0;0;0;0;0;0;Celular Y9S LIB OPEN BREATHING CRYSTAL;TELEFONIA
19060103;;F;25;CHILENO;;Z;TALCA                         ;MAULE;0;0;0;0;0;0;0;0;0;CELULAR HUAWEI Y8S BLACK TRI CLARO;TELEFONIA
20517083;;F;21;CHILENO;;Z;PROVIDENCIA                   ;METROPOLITANA;0;0;0;0;0;0;0;0;0;Celular A31 LIB OPEN ROJO;TELEFONIA
17750282;Soltero;M;31;CHILENO;INGENIERO EN AUTOMATIZACION Y CONTROL INDUSTRIAL;Millenial;PROVIDENCIA                   ;METROPOLITANA;0;0;0;0;0;0;0;0;0;Celular A51 128GB LIB OPEN BLACK;TELEFONIA
8972902;;M;59;CHILENO;;Boomers;CHIMBARONGO                   ;L.G.B.OÂ´HIGGINS;0;0;0;0;0;0;0;0;0;Celular SAMSUNG A11 32GB ENTEL DIRECTO NEGRO;TELEFONIA
16090737;;F;36;CHILENO;;Millenial;CONSTITUCION                  ;MAULE;0;0;0;0;0;0;0;0;0;Celular AL3 CLARO DIRECTO NEGRO;TELEFONIA
14905164;;M;41;CHILENO;;X;PROVIDENCIA                   ;METROPOLITANA;0;0;0;0;0;0;0;0;0;Celular Y8P ENTEL TRIANGULADO NEGRO;TELEFONIA
7412678;;F;69;CHILENO;;Silencioso;SAN MIGUEL                    ;METROPOLITANA;0;0;0;0;0;0;0;0;0;CELULAR SAMSUNG A21S AZUL OPEN;TELEFONIA
13827179;;F;42;CHILENO;;X;LOS ANDES                     ;VALPARAISO;0;0;0;0;0;0;0;0;0;Celular A10S LIB OPEN BLUE;TELEFONIA
18125911;Soltero;M;29;CHILENO;;Millenial;PROVIDENCIA                   ;METROPOLITANA;0;0;0;0;0;0;0;0;0;Celular A20S LIB OPEN ROJO;TELEFONIA
11285426;;F;54;CHILENO;;X;COQUIMBO                      ;COQUIMBO;0;0;0;0;0;0;0;0;0;Celular LG K22 ENTEL DIRECTO TITAN;TELEFONIA
11572559;;F;52;CHILENO;;X;SAN IGNACIO                   ;BIO BIO;0;0;0;0;0;0;0;0;0;Celular A20S LIB OPEN NEGRO;TELEFONIA
11717988;;F;51;CHILENO;;X;CASTRO                        ;LOS LAGOS;0;0;0;0;0;0;0;0;0;Celular A11 LIB OPEN BLUE;TELEFONIA
11585342;Soltero;M;54;CHILENO;;Boomers;RENCA                         ;METROPOLITANA;0;0;0;0;0;0;0;0;0;Celular MOTOROLA G9 PLAY WOM DIRECTO AZUL;TELEFONIA
14472862;;F;43;CHILENO;;X;COLINA                        ;METROPOLITANA;0;0;0;0;0;0;0;0;0;CELULAR REDMI 9 64GB SUNSET PURPLE TRI WOM;TELEFONIA
12774975;;F;46;CHILENO;;X;LA LIGUA                      ;VALPARAISO;0;0;0;0;0;0;0;0;0;Celular Y7P LIB OPEN NEGRO;TELEFONIA
18129357;;F;30;CHILENO;;Millenial;PROVIDENCIA                   ;METROPOLITANA;0;0;0;0;0;0;0;0;0;Celular A10S LIB OPEN BLUE;TELEFONIA
11362525;;F;53;CHILENO;;X;TALAGANTE                     ;METROPOLITANA;0;0;0;0;0;0;0;0;0;Celular A11 LIB OPEN BLUE;TELEFONIA
15909735;;F;37;CHILENO;;Millenial;"";"";0;0;0;0;0;0;0;0;0;Celular A11 LIB OPEN BLUE;TELEFONIA
18153281;;F;29;CHILENO;;Extranjero;RANCAGUA                      ;L.G.B.OÂ´HIGGINS;0;0;0;0;0;0;0;0;0;Celular SAMSUNG A11 32GB ENTEL DIRECTO NEGRO;TELEFONIA
9872701;;F;56;CHILENO;;Boomers;LOTA                          ;BIO BIO;0;0;0;0;0;0;0;0;0;Celular A11 LIB OPEN BLUE;TELEFONIA
17361286;;M;33;CHILENO;;Millenial;N/D;N/D;0;0;0;0;0;0;0;0;0;Celular A10S LIB OPEN RED;TELEFONIA
17896413;;M;32;CHILENO;;Millenial;PROVIDENCIA                   ;METROPOLITANA;0;0;0;0;0;0;0;0;0;Celular G8 POWER LITE MOVISTAR DIRECTO AZUL;TELEFONIA
16060091;;M;36;CHILENO;;Extranjero;ILLAPEL                       ;COQUIMBO;0;0;0;0;0;0;0;0;0;Celular A11 LIB OPEN BLUE;TELEFONIA
19443374;;M;25;CHILENO;;Z;PROVIDENCIA                   ;METROPOLITANA;0;0;0;0;0;0;0;0;0;Celular A01 CLARO DIRECTO BLACK;TELEFONIA
15814724;Divorciado;F;37;CHILENO;;Millenial;COLINA                        ;METROPOLITANA;0;0;0;0;0;0;0;0;0;CELULAR MOTOROLA G9 PLAY 64GB ELECTRIC BLUE OPEN;TELEFONIA
7790281;;F;64;CHILENO;;Boomers;LLAILLAY                      ;VALPARAISO;0;0;0;0;0;0;0;0;0;Celular XIAOMI REDMI 9A 32 GB DIRECTO CLARO;TELEFONIA
12247647;;F;49;CHILENO;;X;PROVIDENCIA                   ;METROPOLITANA;0;0;0;0;0;0;0;0;0;CELULAR VIVO Y20 AZUL DIRECTO ENTEL;TELEFONIA
16383257;;M;35;CHILENO;;Millenial;LA FLORIDA                    ;METROPOLITANA;0;0;0;0;0;0;0;0;0;Celular A10S LIB OPEN BLUE;TELEFONIA
17578771;;F;31;CHILENO;;Millenial;PUDAHUEL                      ;METROPOLITANA;0;0;0;0;0;0;0;0;0;Celular A10S LIB OPEN BLUE;TELEFONIA
9084043;;F;60;CHILENO;;Boomers;RENCA                         ;METROPOLITANA;0;0;0;0;0;0;0;0;0;Celular SAMSUNG A01 CORE AZUL ENTEL;TELEFONIA
11432110;;M;53;CHILENO;;X;CALBUCO                       ;LOS LAGOS;0;0;0;0;0;0;0;0;0;Celular Y9S LIB OPEN BREATHING CRYSTAL;TELEFONIA
14558606;;F;46;CHILENO;;X;EL BOSQUE                     ;METROPOLITANA;0;0;0;0;0;0;0;0;0;Celular XIAOMI REDMI 9A 32 GB DIRECTO CLARO;TELEFONIA
13948862;;M;41;CHILENO;;X;SAN VICENTE                   ;L.G.B.OÂ´HIGGINS;0;0;0;0;0;0;0;0;0;Celular A01 Core Azul Tri Entel;TELEFONIA
19364152;;F;35;CHILENO;;Millenial;LEBU                          ;BIO BIO;0;0;0;0;0;0;0;0;0;Celular A51 128GB LIB OPEN AZUL;TELEFONIA
12915708;;M;47;CHILENO;;X;PROVIDENCIA                   ;METROPOLITANA;0;0;0;0;0;0;0;0;0;CELULAR SAMSUNG A21S AZUL OPEN;TELEFONIA
8625649;;M;61;CHILENO;;Boomers;RENCA                         ;METROPOLITANA;0;0;0;0;0;0;0;0;0;Celular A11 LIB OPEN BLUE;TELEFONIA
17000711;;M;32;CHILENO;;Millenial;PROVIDENCIA                   ;METROPOLITANA;0;0;0;0;0;0;0;0;0;CELULAR HUAWEI Y5P BLUE TRIANGULADO WOM;TELEFONIA
8237368;;M;65;CHILENO;;Boomers;ALTO HOSPICIO;TARAPACA;0;0;0;0;0;0;0;0;0;Celular R340 CLARO DIRECTO NEGRO;TELEFONIA
15680969;;F;39;CHILENO;;X;PROVIDENCIA                   ;METROPOLITANA;0;0;0;0;0;0;0;0;0;Celular XIAOMI REDMI 9A 32 GB DIRECTO CLARO;TELEFONIA
19032981;;M;27;CHILENO;;Z;LA PINTANA                    ;METROPOLITANA;0;0;0;0;0;0;0;0;0;Celular SAMSUNG A51 128GB BLACK CLARO;TELEFONIA
12280368;;F;49;CHILENO;;X;LA GRANJA                     ;METROPOLITANA;0;0;0;0;0;0;0;0;0;Celular A51 128GB LIB OPEN BLACK;TELEFONIA
19764570;;M;24;CHILENO;;Z;PROVIDENCIA                   ;METROPOLITANA;0;0;0;0;0;0;0;0;0;CELULAR XIAOMI REDMI 9C 64GB TIWLIGHT BLUE TRI M;TELEFONIA
18895693;;F;27;CHILENO;;Millenial;PROVIDENCIA                   ;METROPOLITANA;0;0;0;0;0;0;0;0;0;Celular P40 LITE LIB OPEN GREEN;TELEFONIA
13799529;;M;42;CHILENO;;X;CABRERO                       ;BIO BIO;0;0;0;0;0;0;0;0;0;Celular A31 LIB OPEN BLACK;TELEFONIA
7345906;;F;67;CHILENO;;Boomers;TALCAHUANO                    ;BIO BIO;0;0;0;0;0;0;0;0;0;Celular R340 CLARO DIRECTO NEGRO;TELEFONIA
10249228;;F;53;CHILENO;;X;CATEMU                        ;VALPARAISO;0;0;0;0;0;0;0;0;0;Celular A10S LIB OPEN BLUE;TELEFONIA
13084476;Casado;F;46;CHILENO;;X;TALAGANTE                     ;METROPOLITANA;0;0;0;0;0;0;0;0;0;CELULAR MOTOROLA G9 PLAY 64GB SPRING PINK OPEN;TELEFONIA
21728858;;M;24;CHILENO;;Z;PROVIDENCIA                   ;METROPOLITANA;0;0;0;0;0;0;0;0;0;CELULAR SAMSUNG A21S ROJO OPEN;TELEFONIA
6394389;;M;67;CHILENO;;Boomers;PROVIDENCIA                   ;METROPOLITANA;0;0;0;0;0;0;0;0;0;Celular Y9 PRIME LIB OPEN VERDE;TELEFONIA
13190050;;F;45;CHILENO;;X;N/D;N/D;0;0;0;0;0;0;0;0;0;Celular R340 CLARO DIRECTO NEGRO;TELEFONIA
15879692;;F;37;CHILENO;;Millenial;PROVIDENCIA                   ;METROPOLITANA;0;0;0;0;0;0;0;0;0;Celular A51 128GB LIB OPEN AZUL;TELEFONIA
19694271;;M;24;CHILENO;;Z;PELLUHUE                      ;MAULE;0;0;0;0;0;0;0;0;0;CELULAR HUAWEI Y8S NEGRO WOM;TELEFONIA
15239693;;F;39;CHILENO;;X;CARAHUE                       ;ARAUCANIA;0;0;0;0;0;0;0;0;0;Celular A31 LIB OPEN BLACK;TELEFONIA
7011643;;F;60;CHILENO;;Boomers;RENCA                         ;METROPOLITANA;0;0;0;0;0;0;0;0;0;Celular XIAOMI REDMI 9 64 GB DIRECTO CLARO NEGRO;TELEFONIA
18328451;;F;29;CHILENO;;Millenial;PLACILLA                      ;L.G.B.OÂ´HIGGINS;0;0;0;0;0;0;0;0;0;Celular Y6P WOM TRIANGULADO NEGRO;TELEFONIA
15223088;;F;39;CHILENO;;X;CONCEPCION                    ;BIO BIO;0;0;0;0;0;0;0;0;0;Celular A10S LIB OPEN NEGRO;TELEFONIA
7340047;Casado;M;67;CHILENO;;Boomers;RENCA                         ;METROPOLITANA;0;0;0;0;0;0;0;0;0;CELULAR HUAWEI Y8S NEGRO WOM;TELEFONIA
19801452;;M;24;CHILENO;;Z;LEBU                          ;BIO BIO;0;0;0;0;0;0;0;0;0;Celular NOKIA 1.3 NEGRO WOM;TELEFONIA
24588309;;M;42;PERUANO;;Extranjero;RECOLETA                      ;METROPOLITANA;0;0;0;0;0;0;0;0;0;CELULAR MOTOROLA G9 PLUS DEEP DIVE OPEN;TELEFONIA
19041509;;M;26;CHILENO;;Z;LA SERENA                     ;COQUIMBO;0;0;0;0;0;0;0;0;0;Celular A11 LIB OPEN BLUE;TELEFONIA
19623718;;F;25;CHILENO;;Z;PROVIDENCIA                   ;METROPOLITANA;0;0;0;0;0;0;0;0;0;CELULAR XIAOMI REDMI 9C 64GB TIWLIGHT BLUE TRI M;TELEFONIA
11900811;;F;50;CHILENO;;X;PROVIDENCIA                   ;METROPOLITANA;0;0;0;0;0;0;0;0;0;Celular XIAOMI REDMI 9A 32 GB DIRECTO CLARO;TELEFONIA
10664415;;F;55;CHILENO;;Boomers;VILLARICA                     ;ARAUCANIA;0;0;0;0;0;0;0;0;0;Celular 2.3 MOVISTAR DIRECTO CHARCOAL;TELEFONIA
13690451;;M;43;CHILENO;;X;N/D;N/D;0;0;0;0;0;0;0;0;0;Celular A01 CORE MOVISTAR DIRECTO BLACK;TELEFONIA
17249008;;F;33;CHILENO;;Millenial;CORONEL                       ;BIO BIO;0;0;0;0;0;0;0;0;0;Celular A10S LIB OPEN RED;TELEFONIA
10443503;;M;55;CHILENO;;Boomers;ARICA                         ;ARICA Y PARINACOTA;0;0;0;0;0;0;0;0;0;CELULAR SAMSUNG A21S ROJO OPEN;TELEFONIA
18707504;;F;30;CHILENO;;Millenial;PROVIDENCIA                   ;METROPOLITANA;0;0;0;0;0;0;0;0;0;Celular A31 LIB OPEN AZUL;TELEFONIA
17186427;;F;32;CHILENO;;Millenial;TALCA                         ;MAULE;0;0;0;0;0;0;0;0;0;CELULAR MOTO ONE FUSION 64GB VERDE 64GB OPEN;TELEFONIA
15864888;;M;38;CHILENO;;Millenial;LA PINTANA                    ;METROPOLITANA;0;0;0;0;0;0;0;0;0;Celular A10S LIB OPEN BLUE;TELEFONIA
19146348;;M;27;CHILENO;;Z;CASTRO                        ;LOS LAGOS;0;0;0;0;0;0;0;0;0;Celular A31 LIB OPEN AZUL;TELEFONIA
11275463;;F;53;CHILENO;;X;RANCAGUA                      ;L.G.B.OÂ´HIGGINS;0;0;0;0;0;0;0;0;0;Celular XIAOMI REDMI 9A 32 GB DIRECTO CLARO;TELEFONIA
18940473;;F;27;CHILENO;;Z;RENGO;O HIGGINS;0;0;0;0;0;0;0;0;0;Celular A10S MOVISTAR DIRECTO BLACK;TELEFONIA
15368257;;F;39;CHILENO;;X;PROVIDENCIA                   ;METROPOLITANA;0;0;0;0;0;0;0;0;0;Celular A01 CLARO DIRECTO BLACK;TELEFONIA
6048945;;F;73;CHILENO;;Silencioso;ANTOFAGASTA                   ;ANTOFAGASTA;0;0;0;0;0;0;0;0;0;Celular A11 LIB OPEN BLACK;TELEFONIA
11534211;;M;51;CHILENO;;X;MAIPU                         ;METROPOLITANA;0;0;0;0;0;0;0;0;0;CELULAR SAMSUNG A21S ROJO OPEN;TELEFONIA
12636648;;M;48;CHILENO;;X;RENCA                         ;METROPOLITANA;0;0;0;0;0;0;0;0;0;Celular SAMSUNG A01 CORE AZUL ENTEL;TELEFONIA
6050691;;F;72;CHILENO;;Silencioso;MELIPILLA                     ;METROPOLITANA;0;0;0;0;0;0;0;0;0;CELULAR MOTO ONE FUSION 64GB VERDE 64GB OPEN;TELEFONIA
19332219;;F;26;CHILENO;;Z;PROVIDENCIA                   ;METROPOLITANA;0;0;0;0;0;0;0;0;0;Celular A11 LIB OPEN BLUE;TELEFONIA
16333498;;M;36;CHILENO;;Millenial;PUTAENDO                      ;VALPARAISO;0;0;0;0;0;0;0;0;0;Celular Y6 2019 WOM DIRECTO BLACK;TELEFONIA
17294547;;M;32;CHILENO;;Millenial;N/D;N/D;0;0;0;0;0;0;0;0;0;CELULAR SAMSUNG A21S AZUL OPEN;TELEFONIA
19618661;;F;24;CHILENO;;Z;PROVIDENCIA                   ;METROPOLITANA;0;0;0;0;0;0;0;0;0;Celular A51 128GB LIB OPEN BLANCO;TELEFONIA
19563939;;F;25;CHILENO;;Z;PROVIDENCIA                   ;METROPOLITANA;0;0;0;0;0;0;0;0;0;Celular A11 LIB OPEN BLUE;TELEFONIA
13507966;Soltero;M;43;CHILENO;;X;PROVIDENCIA                   ;METROPOLITANA;0;0;0;0;0;0;0;0;0;CELULAR SAMSUNG A21S NEGRO OPEN;TELEFONIA
11933319;;F;49;CHILENO;;X;N/D;N/D;0;0;0;0;0;0;0;0;0;Celular A11 LIB OPEN BLACK;TELEFONIA
5086017;;F;80;CHILENO;;Silencioso;RECOLETA                      ;METROPOLITANA;0;0;0;0;0;0;0;0;0;Celular A01 LIB OPEN AZUL;TELEFONIA
16948254;;F;33;CHILENO;;Millenial;RENCA                         ;METROPOLITANA;0;0;0;0;0;0;0;0;0;Celular A01 LIB OPEN ROJO;TELEFONIA
14428681;;F;48;CHILENO;;X;PUENTE ALTO                   ;METROPOLITANA;0;0;0;0;0;0;0;0;0;Celular ONE FUSION MOVISTAR DIRECTO AZUL;TELEFONIA
8872287;;F;62;CHILENO;;Boomers;LEBU                          ;BIO BIO;0;0;0;0;0;0;0;0;0;Celular A10S LIB OPEN RED;TELEFONIA
9707195;;M;58;CHILENO;;Boomers;LO ESPEJO                     ;METROPOLITANA;0;0;0;0;0;0;0;0;0;Celular A11 LIB OPEN BLACK;TELEFONIA
25560357;;M;45;VENEZOLANO;;Extranjero;SANTIAGO                      ;METROPOLITANA;0;0;0;0;0;0;0;0;0;CELULAR SAMSUNG NOTE 20 MYSTIC BRONZE 256 GB OPE;TELEFONIA
14351863;Soltero;F;42;CHILENO;;X;RENCA                         ;METROPOLITANA;0;0;0;0;0;0;0;0;0;Celular A10S ENTEL DIRECTO NEGRO;TELEFONIA
16435023;;F;35;CHILENO;;Millenial;LOS ANGELES                   ;BIO BIO;0;0;0;0;0;0;0;0;0;Celular P30 LITE LIB OPEN AZUL;TELEFONIA
14276775;;F;49;CHILENO;;X;PROVIDENCIA                   ;METROPOLITANA;0;0;0;0;0;0;0;0;0;CELULAR SAMSUNG A21S AZUL OPEN;TELEFONIA
20305413;;F;22;CHILENO;;Z;PROVIDENCIA                   ;METROPOLITANA;0;0;0;0;0;0;0;0;0;CHIP OPEN ENTEL;TELEFONIA
16149570;;M;37;CHILENO;;Millenial;PROVIDENCIA                   ;METROPOLITANA;0;0;0;0;0;0;0;0;0;Celular 1S ENTEL TRIANGULADO NEGRO;TELEFONIA
11959717;;M;49;CHILENO;;X;YUNGAY                        ;BIO BIO;0;0;0;0;0;0;0;0;0;CELULAR A11 CLARO DIRECTO BLACK;TELEFONIA
25311940;;M;45;BOLIVIANO;;Extranjero;N/D;N/D;0;0;0;0;0;0;0;0;0;Celular P40 LITE LIB OPEN GREEN;TELEFONIA
16934759;Soltero;M;33;CHILENO;;Millenial;SAN JOAQUIN                   ;METROPOLITANA;0;0;0;0;0;0;0;0;0;Celular SAMSUNG A21s CLARO DIRECTO BLACK;TELEFONIA
15755640;;M;37;CHILENO;;Millenial;SAN JAVIER                    ;MAULE;0;0;0;0;0;0;0;0;0;Celular A01 LIB OPEN NEGRO;TELEFONIA
13906536;;M;41;CHILENO;;X;PROVIDENCIA                   ;METROPOLITANA;0;0;0;0;0;0;0;0;0;Celular NOKIA 4.2 ENTEL DIRECTO NEGRO;TELEFONIA
10644118;;F;57;CHILENO;;Boomers;CHIMBARONGO                   ;L.G.B.OÂ´HIGGINS;0;0;0;0;0;0;0;0;0;Celular A01 LIB OPEN NEGRO;TELEFONIA
18822332;Soltero;F;27;CHILENO;;Millenial;PROVIDENCIA                   ;METROPOLITANA;0;0;0;0;0;0;0;0;0;Celular A10S LIB OPEN RED;TELEFONIA
6054795;Viudo;F;73;CHILENO;;Silencioso;RENCA                         ;METROPOLITANA;0;0;0;0;0;0;0;0;0;Celular A01 CORE MOVISTAR DIRECTO BLACK;TELEFONIA
11128452;;F;55;CHILENO;;Boomers;RENCA                         ;METROPOLITANA;0;0;0;0;0;0;0;0;0;Celular Y6 2019 CLARO DIRECTO BLACK;TELEFONIA
13163049;;F;45;CHILENO;;X;N/D;N/D;0;0;0;0;0;0;0;0;0;Celular Y9S LIB OPEN BREATHING CRYSTAL;TELEFONIA
13472550;;F;44;CHILENO;;X;"";"";0;0;0;0;0;0;0;0;0;Celular Y5 NEO ENTEL DIRECTO BLACK;TELEFONIA
16276646;;M;36;CHILENO;;Millenial;PUENTE ALTO                   ;METROPOLITANA;0;0;0;0;0;0;0;0;0;Celular Y7P LIB OPEN NEGRO;TELEFONIA
5079334;;F;78;CHILENO;;Silencioso;CONSTITUCION                  ;MAULE;0;0;0;0;0;0;0;0;0;CELULAR SAMSUNG A21S AZUL OPEN;TELEFONIA
19432010;Soltero;F;26;CHILENO;;Silencioso;PROVIDENCIA                   ;METROPOLITANA;0;0;0;0;0;0;0;0;0;CELULAR SAMSUNG A21S ROJO OPEN;TELEFONIA
12064104;;F;58;CHILENO;;Boomers;TALCA                         ;MAULE;0;0;0;0;0;0;0;0;0;CELULAR SAMSUNG A21S AZUL OPEN;TELEFONIA
13785815;;M;42;CHILENO;;X;PROVIDENCIA                   ;METROPOLITANA;0;0;0;0;0;0;0;0;0;CELULAR HUAWEI Y6P BLACK TEL;TELEFONIA
8089695;;F;63;CHILENO;;Boomers;SAN ANTONIO                   ;VALPARAISO;0;0;0;0;0;0;0;0;0;Celular A31 LIB OPEN ROJO;TELEFONIA
12919518;;M;47;CHILENO;;X;SAN PEDRO DE LA PAZ           ;BIO BIO;0;0;0;0;0;0;0;0;0;Celular NOKIA 1.3 NEGRO WOM;TELEFONIA
10251813;;M;57;CHILENO;;Boomers;VICTORIA                      ;ARAUCANIA;0;0;0;0;0;0;0;0;0;Celular AL3 CLARO DIRECTO NEGRO;TELEFONIA
18616676;;F;28;CHILENO;;Millenial;PROVIDENCIA                   ;METROPOLITANA;0;0;0;0;0;0;0;0;0;Celular G8 POWER LITE WOM DIRECTO TURQUESA;TELEFONIA
17399224;;F;32;CHILENO;;Silencioso;PROVIDENCIA                   ;METROPOLITANA;0;0;0;0;0;0;0;0;0;Celular Y9 PRIME LIB OPEN NEGRO;TELEFONIA
5689185;;M;75;CHILENO;;Silencioso;CASTRO                        ;LOS LAGOS;0;0;0;0;0;0;0;0;0;CELULAR HUAWEI P30 LITE BLACK CLARO;TELEFONIA
14041518;;F;41;CHILENO;;X;TEMUCO                        ;ARAUCANIA;0;0;0;0;0;0;0;0;0;Celular Y8P BUNDLE ENTEL TRIANGULADO PIEDRA DE L;TELEFONIA
10395439;Soltero;F;59;CHILENO;;Boomers;PROVIDENCIA                   ;METROPOLITANA;0;0;0;0;0;0;0;0;0;Celular A01 LIB OPEN AZUL;TELEFONIA
19130193;;F;26;CHILENO;;Z;SAN FELIPE                    ;VALPARAISO;0;0;0;0;0;0;0;0;0;CELULAR SAMSUNG A21S AZUL OPEN;TELEFONIA
4675559;;M;78;CHILENO;;Silencioso;CONCEPCION                    ;BIO BIO;0;0;0;0;0;0;0;0;0;CELULAR OWN 1026 AZUL ENTEL;TELEFONIA
16015760;;F;37;CHILENO;;Millenial;MAIPU                         ;METROPOLITANA;0;0;0;0;0;0;0;0;0;Celular A31 LIB OPEN AZUL;TELEFONIA
5841181;;M;76;CHILENO;;Silencioso;SAN CARLOS                    ;BIO BIO;0;0;0;0;0;0;0;0;0;Celular A10S LIB OPEN BLUE;TELEFONIA
12968949;;F;48;CHILENO;;X;N/D;N/D;0;0;0;0;0;0;0;0;0;CELULAR SAMSUNG A21S AZUL OPEN;TELEFONIA
6591589;Casado;F;70;CHILENO;;Silencioso;PROVIDENCIA                   ;METROPOLITANA;0;0;0;0;0;0;0;0;0;Celular A20S WOM TRIANGULADO AZUL;TELEFONIA
15889865;;F;37;CHILENO;;Millenial;SAN BERNARDO                  ;METROPOLITANA;0;0;0;0;0;0;0;0;0;Celular a11 azul samsung WOM;TELEFONIA
6580150;;F;71;CHILENO;;Silencioso;LIMACHE                       ;VALPARAISO;0;0;0;0;0;0;0;0;0;Celular NOKIA 2.3 WOM DIRECTO CHARCOAL;TELEFONIA
5994785;;F;72;CHILENO;;Silencioso;CHANCO                        ;MAULE;0;0;0;0;0;0;0;0;0;Celular A31 LIB OPEN BLACK;TELEFONIA
18354289;;M;28;CHILENO;;Millenial;OVALLE                        ;COQUIMBO;0;0;0;0;0;0;0;0;0;Celular A01 LIB OPEN NEGRO;TELEFONIA
6787929;;M;69;CHILENO;;Silencioso;MONTE PATRIA                  ;COQUIMBO;0;0;0;0;0;0;0;0;0;Celular NOVA 5T LIB OPEN BLACK;TELEFONIA
5383990;;M;78;CHILENO;;Silencioso;PROVIDENCIA                   ;METROPOLITANA;0;0;0;0;0;0;0;0;0;CELULAR OWN 1026 AZUL ENTEL;TELEFONIA
10611632;;M;56;CHILENO;;Boomers;PROVIDENCIA                   ;METROPOLITANA;0;0;0;0;0;0;0;0;0;Celular A11 LIB OPEN BLACK;TELEFONIA
19353095;Soltero;F;26;CHILENO;;Z;PROVIDENCIA                   ;METROPOLITANA;0;0;0;0;0;0;0;0;0;CELULAR SAMSUNG A21S NEGRO OPEN;TELEFONIA
16147561;Soltero;F;36;CHILENO;TECNICO DENTAL DE NIVEL SUPERIOR;Millenial;RENCA                         ;METROPOLITANA;0;0;0;0;0;0;0;0;0;Celular G8 POWER LITE WOM DIRECTO TURQUESA;TELEFONIA
17060120;;F;33;CHILENO;;Millenial;PELLUHUE                      ;MAULE;0;0;0;0;0;0;0;0;0;Celular A11 LIB OPEN BLACK;TELEFONIA
8141545;;F;65;CHILENO;;Boomers;VALLENAR;ATACAMA;0;0;0;0;0;0;0;0;0;Celular A01 LIB OPEN AZUL;TELEFONIA
18679413;Soltero;F;28;CHILENO;;Millenial;PROVIDENCIA                   ;METROPOLITANA;0;0;0;0;0;0;0;0;0;Celular A3 LITE ENTEL TRIANGULADO NEGRO;TELEFONIA
17806393;;M;31;CHILENO;;Millenial;VALPARAISO                    ;VALPARAISO;0;0;0;0;0;0;0;0;0;Celular A20S LIB OPEN ROJO;TELEFONIA
8275061;Casado;F;69;CHILENO;;Silencioso;PROVIDENCIA                   ;METROPOLITANA;0;0;0;0;0;0;0;0;0;Celular A10S LIB OPEN RED;TELEFONIA
25866119;;F;38;VENEZOLANO;;Extranjero;PROVIDENCIA                   ;METROPOLITANA;0;0;0;0;0;0;0;0;0;Celular A11 LIB OPEN BLACK;TELEFONIA
8800266;;M;62;CHILENO;;Boomers;LA FLORIDA                    ;METROPOLITANA;0;0;0;0;0;0;0;0;0;Celular A10S LIB OPEN RED;TELEFONIA
17363757;;F;32;CHILENO;;Millenial;N/D;N/D;0;0;0;0;0;0;0;0;0;Celular Y7P LIB OPEN NEGRO;TELEFONIA
14905397;;F;44;CHILENO;;X;ARAUCO                        ;BIO BIO;0;0;0;0;0;0;0;0;0;Celular A20S LIB OPEN ROJO;TELEFONIA
17613049;;F;31;CHILENO;;Millenial;N/D;N/D;0;0;0;0;0;0;0;0;0;IPHONE 7 32GB LIB OPEN ROSE;TELEFONIA
12247045;;F;49;CHILENO;;X;RENCA                         ;METROPOLITANA;0;0;0;0;0;0;0;0;0;Celular A10S MOVISTAR DIRECTO NEGRO;TELEFONIA
17964937;Soltero;M;30;CHILENO;PROFESOR;Millenial;PROVIDENCIA                   ;METROPOLITANA;0;0;0;0;0;0;0;0;0;Celular A01 LIB OPEN AZUL;TELEFONIA
13328509;;M;43;CHILENO;;X;PROVIDENCIA                   ;METROPOLITANA;0;0;0;0;0;0;0;0;0;Celular A20S LIB OPEN AZUL;TELEFONIA
16185633;;F;37;CHILENO;;Millenial;PROVIDENCIA                   ;METROPOLITANA;0;0;0;0;0;0;0;0;0;Celular F1026 3G ENTEL DIRECTO AZUL;TELEFONIA
17410235;;F;32;CHILENO;;Millenial;SAN JAVIER                    ;MAULE;0;0;0;0;0;0;0;0;0;Celular J2 CORE CLARO DIRECTO NEGRO;TELEFONIA
6794402;Casado;F;66;CHILENO;;Boomers;RENCA                         ;METROPOLITANA;0;0;0;0;0;0;0;0;0;Celular Y6 2019 WOM DIRECTO BLACK;TELEFONIA
25225539;;M;38;HAITIANO;;Extranjero;"";"";0;0;0;0;0;0;0;0;0;Celular A20S LIB OPEN AZUL;TELEFONIA
8651992;;M;63;CHILENO;;Boomers;PROVIDENCIA                   ;METROPOLITANA;0;0;0;0;0;0;0;0;0;IPHONE REAC 8 64GB ROJO OPEN;TELEFONIA
13800083;;F;41;CHILENO;;X;YUMBEL                        ;BIO BIO;0;0;0;0;0;0;0;0;0;Celular A10S LIB OPEN BLUE;TELEFONIA
13730693;;F;43;CHILENO;;X;TEMUCO                        ;ARAUCANIA;0;0;0;0;0;0;0;0;0;Celular A51 128GB LIB OPEN BLANCO;TELEFONIA
5064061;;M;78;CHILENO;;Silencioso;PROVIDENCIA                   ;METROPOLITANA;0;0;0;0;0;0;0;0;0;Celular SA3 CLARO DIRECTO BLACK;TELEFONIA
26395115;;M;31;PERUANO;;Extranjero;CALERA                        ;VALPARAISO;0;0;0;0;0;0;0;0;0;Celular A20S LIB OPEN ROJO;TELEFONIA
17016850;;F;33;CHILENO;;Millenial;LA SERENA                     ;COQUIMBO;0;0;0;0;0;0;0;0;0;CELULAR MOTO ONE MACRO AZUL METAL WOM;TELEFONIA
11174487;;F;55;CHILENO;;Boomers;RENCA                         ;METROPOLITANA;0;0;0;0;0;0;0;0;0;Celular SAMSUNG A01 CORE BLACK CLARO;TELEFONIA
8870209;Divorciado;F;59;CHILENO;;Boomers;RENCA                         ;METROPOLITANA;0;0;0;0;0;0;0;0;0;Celular A31 LIB OPEN BLACK;TELEFONIA
16401724;Soltero;M;35;CHILENO;;Millenial;RENCA                         ;METROPOLITANA;0;0;0;0;0;0;0;0;0;Celular Y7P LIB OPEN NEGRO;TELEFONIA
14321750;;F;45;CHILENO;;X;TALAGANTE                     ;METROPOLITANA;0;0;0;0;0;0;0;0;0;CELULAR SAMSUNG A21S ROJO OPEN;TELEFONIA
9533708;;F;61;CHILENO;;Boomers;PROVIDENCIA                   ;METROPOLITANA;0;0;0;0;0;0;0;0;0;Celular A10S LIB OPEN NEGRO;TELEFONIA
13761456;;F;42;CHILENO;;X;PROVIDENCIA                   ;METROPOLITANA;0;0;0;0;0;0;0;0;0;Celular SAMSUNG A21s CLARO DIRECTO BLACK;TELEFONIA
12397255;;F;49;CHILENO;;X;PROVIDENCIA                   ;METROPOLITANA;0;0;0;0;0;0;0;0;0;CELULAR Y8S MOVISTAR DIRECTO BLACK;TELEFONIA
8957486;Soltero;F;61;CHILENO;;Boomers;RENCA                         ;METROPOLITANA;0;0;0;0;0;0;0;0;0;CELULAR SAMSUNG A21S AZUL OPEN;TELEFONIA
8192393;;F;66;CHILENO;;Boomers;MOLINA                        ;MAULE;0;0;0;0;0;0;0;0;0;Celular A01 LIB OPEN ROJO;TELEFONIA
12066872;;M;63;CHILENO;;Extranjero;CABILDO                       ;VALPARAISO;0;0;0;0;0;0;0;0;0;CELULAR HUAWEI Y5P BLUE TRIANGULADO WOM;TELEFONIA
12315885;;M;49;CHILENO;;X;SAN FERNANDO                  ;L.G.B.OÂ´HIGGINS;0;0;0;0;0;0;0;0;0;Celular A20S LIB OPEN ROJO;TELEFONIA
11448609;Soltero;M;52;CHILENO;INGENIERO AGRICOLA;X;RENCA                         ;METROPOLITANA;0;0;0;0;0;0;0;0;0;Celular Y5 NEO CLARO DIRECTO BLACK;TELEFONIA
6266482;;F;76;CHILENO;;Silencioso;TALCAHUANO                    ;BIO BIO;0;0;0;0;0;0;0;0;0;Celular SA3 CLARO DIRECTO BLACK;TELEFONIA
17634862;;F;31;CHILENO;;Millenial;QUILLOTA                      ;VALPARAISO;0;0;0;0;0;0;0;0;0;Celular A11 LIB OPEN BLUE;TELEFONIA
14330526;;F;44;CHILENO;;X;LA PINTANA                    ;METROPOLITANA;0;0;0;0;0;0;0;0;0;Celular A11 LIB OPEN BLUE;TELEFONIA
17362972;;M;32;CHILENO;;Millenial;PROVIDENCIA                   ;METROPOLITANA;0;0;0;0;0;0;0;0;0;Celular A10S LIB OPEN RED;TELEFONIA
5501855;;F;77;CHILENO;;Silencioso;EL TABO                       ;VALPARAISO;0;0;0;0;0;0;0;0;0;Celular Y8P ENTEL TRIANGULADO PIEDRA DE LUNA;TELEFONIA
13346576;;M;44;CHILENO;;Boomers;SAN FERNANDO                  ;L.G.B.OÂ´HIGGINS;0;0;0;0;0;0;0;0;0;Celular SA3 CLARO DIRECTO BLACK;TELEFONIA
9779404;;M;45;CHILENO;;X;PADRE LAS CASAS               ;ARAUCANIA;0;0;0;0;0;0;0;0;0;CELULAR SAMSUNG A21S NEGRO OPEN;TELEFONIA
7799738;;M;66;CHILENO;;Boomers;RENCA                         ;METROPOLITANA;0;0;0;0;0;0;0;0;0;Celular F1026 3G ENTEL DIRECTO AZUL;TELEFONIA
13806273;;F;42;CHILENO;;X;CANETE                        ;BIO BIO;0;0;0;0;0;0;0;0;0;Celular SA3 CLARO DIRECTO BLACK;TELEFONIA
9317690;Casado;M;60;CHILENO;;Boomers;PROVIDENCIA                   ;METROPOLITANA;0;0;0;0;0;0;0;0;0;Celular A01 CLARO DIRECTO BLACK;TELEFONIA
19198782;;F;26;CHILENO;;Z;N/D;N/D;0;0;0;0;0;0;0;0;0;Celular ALCATEL 1 4G 16GB ENTEL TRIANGULADO NEGR;TELEFONIA
14376322;;F;47;CHILENO;;X;PROVIDENCIA                   ;METROPOLITANA;0;0;0;0;0;0;0;0;0;Celular A20S LIB OPEN NEGRO;TELEFONIA
14451588;;M;45;CHILENO;;X;QUILICURA                     ;METROPOLITANA;0;0;0;0;0;0;0;0;0;CELULAR MOTO ONE FUSION 64GB VERDE 64GB OPEN;TELEFONIA
5103158;Casado;F;69;CHILENO;PROFESOR;Silencioso;RENCA                         ;METROPOLITANA;0;0;0;0;0;0;0;0;0;Celular A11 LIB OPEN BLUE;TELEFONIA
16253805;;F;36;CHILENO;;Millenial;MOSTAZAL                      ;L.G.B.OÂ´HIGGINS;0;0;0;0;0;0;0;0;0;Celular A20S LIB OPEN NEGRO;TELEFONIA
10489504;;F;58;CHILENO;;Boomers;ANDACOLLO                     ;COQUIMBO;0;0;0;0;0;0;0;0;0;Celular Y9S LIB OPEN BLACK;TELEFONIA
20478497;;F;22;CHILENO;;Z;PROVIDENCIA                   ;METROPOLITANA;0;0;0;0;0;0;0;0;0;Celular A31 LIB OPEN ROJO;TELEFONIA
8796175;Casado;F;59;CHILENO;AUXILIAR PARAMEDICO DE ENFERMERIA;Boomers;RENCA                         ;METROPOLITANA;0;0;0;0;0;0;0;0;0;Celular a11 azul samsung WOM;TELEFONIA
8837247;;M;60;CHILENO;;Boomers;"";"";0;0;0;0;0;0;0;0;0;Celular A10S LIB OPEN BLUE;TELEFONIA
8374278;;F;61;CHILENO;;Boomers;PROVIDENCIA                   ;METROPOLITANA;0;0;0;0;0;0;0;0;0;Celular P30 LITE LIB OPEN AZUL;TELEFONIA
5233552;;F;78;CHILENO;;Silencioso;QUILLOTA                      ;VALPARAISO;0;0;0;0;0;0;0;0;0;Celular SAMSUNG A01 CORE BLACK CLARO;TELEFONIA
15150019;;M;39;CHILENO;;X;SAN JAVIER                    ;MAULE;0;0;0;0;0;0;0;0;0;Celular P40 LITE LIB OPEN GREEN;TELEFONIA
25984386;;M;28;HAITIANO;;Extranjero;CURICO                        ;MAULE;0;0;0;0;0;0;0;0;0;Celular A11 MOVISTAR DIRECTO BLACK;TELEFONIA
17715079;;M;31;CHILENO;;Millenial;N/D;N/D;0;0;0;0;0;0;0;0;0;Celular NOKIA 1.3 NEGRO WOM;TELEFONIA
25238084;;M;52;PERUANO;;Extranjero;SAN RAMON                     ;METROPOLITANA;0;0;0;0;0;0;0;0;0;Celular P30 LITE CLARO DIRECTO AZUL;TELEFONIA
11665670;;M;52;CHILENO;;X;PROVIDENCIA                   ;METROPOLITANA;0;0;0;0;0;0;0;0;0;Celular A20S LIB OPEN NEGRO;TELEFONIA
11138260;;F;54;CHILENO;;Boomers;RENCA                         ;METROPOLITANA;0;0;0;0;0;0;0;0;0;CELULAR MOTO ONE FUSION 64GB VERDE 64GB OPEN;TELEFONIA
10589228;;F;53;CHILENO;;X;RENCA                         ;METROPOLITANA;0;0;0;0;0;0;0;0;0;CELULAR MOTO ONE FUSION 64GB VERDE 64GB OPEN;TELEFONIA
15970189;;M;37;CHILENO;;Millenial;PROVIDENCIA                   ;METROPOLITANA;0;0;0;0;0;0;0;0;0;Celular P30 LITE PLUS LIB OPEN BLACK;TELEFONIA
16833259;;M;34;CHILENO;;Millenial;N/D;N/D;0;0;0;0;0;0;0;0;0;Celular A20S LIB OPEN NEGRO;TELEFONIA
10426323;Casado;F;57;CHILENO;;Boomers;LOS ANGELES                   ;BIO BIO;0;0;0;0;0;0;0;0;0;Celular Y7P LIB OPEN AZUL;TELEFONIA
15056919;;F;39;CHILENO;;X;LA LIGUA                      ;VALPARAISO;0;0;0;0;0;0;0;0;0;Celular A11 LIB OPEN BLUE;TELEFONIA
21978921;;M;48;PERUANO;;Extranjero;MAIPU                         ;METROPOLITANA;0;0;0;0;0;0;0;0;0;Celular A51 128GB LIB OPEN AZUL;TELEFONIA
7671525;;M;67;CHILENO;;Boomers;CHOLCHOL;ARAUCANIA;0;0;0;0;0;0;0;0;0;CELULAR HUAWEI Y5 NEO NEGRO WOM;TELEFONIA
9461377;;F;60;CHILENO;;Boomers;MELIPILLA                     ;METROPOLITANA;0;0;0;0;0;0;0;0;0;Celular A71 LIB OPEN PLATEADO;TELEFONIA
9700716;;F;59;CHILENO;;Boomers;RENCA                         ;METROPOLITANA;0;0;0;0;0;0;0;0;0;Celular ALCATEL 1 4G 16GB ENTEL TRIANGULADO NEGR;TELEFONIA
16516280;;F;34;CHILENO;;Millenial;PROVIDENCIA                   ;METROPOLITANA;0;0;0;0;0;0;0;0;0;Celular A51 128GB LIB OPEN BLANCO;TELEFONIA
17490830;;F;31;CHILENO;;Millenial;N/D;N/D;0;0;0;0;0;0;0;0;0;Celular NOKIA 2.3 ENTEL DIRECTO CARBON;TELEFONIA
6351571;;F;79;CHILENO;;Silencioso;LOS ANGELES                   ;BIO BIO;0;0;0;0;0;0;0;0;0;Celular A01 LIB OPEN AZUL;TELEFONIA
23152673;;F;26;PERUANO;;Extranjero;N/D;N/D;0;0;0;0;0;0;0;0;0;Celular Y9S LIB OPEN BREATHING CRYSTAL;TELEFONIA
8441509;Soltero;F;65;CHILENO;;Boomers;PROVIDENCIA                   ;METROPOLITANA;0;0;0;0;0;0;0;0;0;Celular A11 LIB OPEN BLUE;TELEFONIA
5570660;;M;71;CHILENO;;Silencioso;PROVIDENCIA                   ;METROPOLITANA;0;0;0;0;0;0;0;0;0;Celular Y5 NEO CLARO DIRECTO BLACK;TELEFONIA
14199898;;M;41;CHILENO;;X;REQUINOA                      ;L.G.B.OÂ´HIGGINS;0;0;0;0;0;0;0;0;0;Celular A10S MOVISTAR DIRECTO NEGRO;TELEFONIA
10389153;;F;47;CHILENO;;X;RENCA                         ;METROPOLITANA;0;0;0;0;0;0;0;0;0;Celular A51 128GB LIB OPEN BLANCO;TELEFONIA
14338741;Soltero;M;45;CHILENO;;X;PROVIDENCIA                   ;METROPOLITANA;0;0;0;0;0;0;0;0;0;Celular A31 LIB OPEN BLACK;TELEFONIA
13832717;;F;41;CHILENO;;X;MELIPILLA                     ;METROPOLITANA;0;0;0;0;0;0;0;0;0;Celular A20S LIB OPEN NEGRO;TELEFONIA
10210732;;M;55;CHILENO;;Boomers;VICTORIA                      ;ARAUCANIA;0;0;0;0;0;0;0;0;0;Celular SAMSUNG A31 BLACK CLARO;TELEFONIA
17680202;Soltero;M;30;CHILENO;;Millenial;PROVIDENCIA                   ;METROPOLITANA;0;0;0;0;0;0;0;0;0;Celular Y5 NEO CLARO DIRECTO BLACK;TELEFONIA
16717599;;M;34;CHILENO;;Millenial;PROVIDENCIA                   ;METROPOLITANA;0;0;0;0;0;0;0;0;0;Celular A20S LIB OPEN ROJO;TELEFONIA
16687622;;F;35;CHILENO;;Millenial;LA SERENA                     ;COQUIMBO;0;0;0;0;0;0;0;0;0;CELULAR SAMSUNG A80 BLACK OPEN;TELEFONIA
9944278;;F;88;CHILENO;;Silencioso;ISLA DE MAIPO                 ;METROPOLITANA;0;0;0;0;0;0;0;0;0;Celular TIGER V SENIOR CLARO DIRECTO NEGRO;TELEFONIA
19544742;;M;25;CHILENO;;Z;ANTOFAGASTA                   ;ANTOFAGASTA;0;0;0;0;0;0;0;0;0;Celular P30 LITE PLUS LIB OPEN BLACK;TELEFONIA
16121248;;F;37;CHILENO;;Millenial;RENCA                         ;METROPOLITANA;0;0;0;0;0;0;0;0;0;Celular G8 POWER LITE WOM DIRECTO TURQUESA;TELEFONIA
20047735;;F;23;CHILENO;;Z;PROVIDENCIA                   ;METROPOLITANA;0;0;0;0;0;0;0;0;0;Celular G8 POWER LITE WOM DIRECTO TURQUESA;TELEFONIA
13562639;;F;43;CHILENO;;X;PUDAHUEL                      ;METROPOLITANA;0;0;0;0;0;0;0;0;0;Celular A51 128GB LIB OPEN BLACK;TELEFONIA
18651318;;F;28;CHILENO;;Millenial;CABILDO                       ;VALPARAISO;0;0;0;0;0;0;0;0;0;Celular P30 LITE CLARO DIRECTO AZUL;TELEFONIA
6712133;;F;70;CHILENO;;Silencioso;RENCA                         ;METROPOLITANA;0;0;0;0;0;0;0;0;0;Celular E6S ENTEL DIRECTO BLUE;TELEFONIA
8963459;Soltero;M;53;CHILENO;;X;PROVIDENCIA                   ;METROPOLITANA;0;0;0;0;0;0;0;0;0;CELULAR HUAWEI Y5P CLARO DIRECTO BLUE;TELEFONIA
18827121;;F;27;CHILENO;;Z;PROVIDENCIA                   ;METROPOLITANA;0;0;0;0;0;0;0;0;0;Celular A20S LIB OPEN ROJO;TELEFONIA
8939215;;M;58;CHILENO;;Boomers;VILLA ALEMANA                 ;VALPARAISO;0;0;0;0;0;0;0;0;0;Celular A3 LITE ENTEL TRIANGULADO NEGRO;TELEFONIA
11480844;;M;53;CHILENO;;X;RENCA                         ;METROPOLITANA;0;0;0;0;0;0;0;0;0;CELULAR MOTO ONE FUSION 64GB VERDE 64GB OPEN;TELEFONIA
12041192;;F;58;CHILENO;;Boomers;RENCA                         ;METROPOLITANA;6990;1;1;0;0;0;1;1;6990;SOPORTE TV 26-56 KTA02 KIOTO FIJO;ACCESORIOS
20547025;;F;21;CHILENO;;Z;N/D;N/D;11990;1;1;0;0;0;1;1;11990;Teclado Gamer GT M867;ACCESORIOS
13921580;;M;42;CHILENO;;X;PROVIDENCIA                   ;METROPOLITANA;6990;1;1;0;0;0;1;1;6990;SOPORTE TV 26-56 KTA02 KIOTO FIJO;ACCESORIOS
18718023;;F;27;CHILENO;;Millenial;N/D;N/D;41980;2;2;1;1;34990;1;1;6990;SOPORTE TV 26-56 KTA02 KIOTO FIJO;ACCESORIOS
15871620;;M;38;CHILENO;;Millenial;RENCA                         ;METROPOLITANA;19990;1;1;0;0;0;1;1;19990;AUDIFONO GAMER 1 PLUG STEREO CON MICROFONO H220S;ACCESORIOS
13528831;;M;53;CHILENO;;X;CALAMA                        ;ANTOFAGASTA;14990;1;1;0;0;0;1;1;14990;Mouse IdeaPad Gaming M100 RGB;ACCESORIOS
15894836;;M;37;CHILENO;;Millenial;N/D;N/D;1051940;7;5;4;2;970970;3;3;80970;SOPORTE TV 26-56 KTA02 KIOTO FIJO;ACCESORIOS
15119328;;M;39;CHILENO;;Extranjero;CHIMBARONGO                   ;L.G.B.OÂ´HIGGINS;122970;3;3;0;0;0;3;3;122970;Kit 4 en 1 Gamer M501;ACCESORIOS
12921026;;M;47;CHILENO;;X;PROVIDENCIA                   ;METROPOLITANA;15990;1;1;0;0;0;1;1;15990;Parlante Karaoke Blik Screamer 2;ACCESORIOS
16669301;Soltero;M;34;CHILENO;;Millenial;CANETE                        ;BIO BIO;1500055;43;32;1;1;399990;42;31;1100065;ARO DE LUZ LED 10 PULGADAS + TRIPODE PEQUENO;ACCESORIOS
12225301;;F;50;CHILENO;;X;VINA DEL MAR                  ;VALPARAISO;129970;3;3;0;0;0;3;3;129970;MOUSE MICROSOFT Wireless Mbl 1850 Purple;ACCESORIOS
13853013;;F;42;CHILENO;;X;NATALES                       ;MAGALLANES;482960;4;4;0;0;0;4;4;482960;Redmi Buds 3 Lite White;ACCESORIOS
13614294;;F;43;CHILENO;;X;CONSTITUCION                  ;MAULE;612343;7;7;0;0;0;7;7;612343;SOPORTE TV 26-56 KTAT02 KIOTO MOVIL;ACCESORIOS
17183260;Soltero;M;32;CHILENO;;Millenial;PROVIDENCIA                   ;METROPOLITANA;19990;1;1;1;1;19990;0;0;0;KIT PREPAGO HD DIRECTV;ACCESORIOS
14373066;;M;47;CHILENO;;X;"";"";99990;1;1;0;0;0;1;1;99990;Escritorio Gamer Pro RGB;ACCESORIOS
11195398;;F;55;CHILENO;;Boomers;CALERA                        ;VALPARAISO;227970;3;3;0;0;0;3;3;227970;XIAOMI MI CARGADOR 65W FAST CHARGER WITH GAN TE;ACCESORIOS
16310942;;F;34;CHILENO;;Millenial;PLACILLA                      ;L.G.B.OÂ´HIGGINS;12990;1;1;0;0;0;1;1;12990;Audifonos Gamer Ultimate M2026;ACCESORIOS
18905559;;M;27;CHILENO;;Millenial;N/D;N/D;56970;3;1;3;1;56970;0;0;0;Teclado + Mouse Legion KM300 RGB Gaming Combo -;ACCESORIOS
12296575;;F;49;CHILENO;;X;CAUQUENES                     ;MAULE;508950;5;4;0;0;0;5;4;508950;SOPORTE TV 26-56 KTA02 KIOTO FIJO;ACCESORIOS
15031656;;F;38;CHILENO;;Millenial;TIERRA AMARILLA               ;ATACAMA;47973;3;2;0;0;0;3;2;47973;HUAWEI WATCH FIT NEW SAKURA PINK;ACCESORIOS
14342726;;F;45;CHILENO;;X;N/D;N/D;446940;6;5;0;0;0;6;5;446940;GALAXY WATCH ACTIVE4 40 MM SILVER;ACCESORIOS
17245795;;F;33;CHILENO;;Extranjero;LA PINTANA                    ;METROPOLITANA;182980;2;1;0;0;0;2;1;182980;GALAXY WATCH4 42 MM SILVER;ACCESORIOS
16470403;;M;35;CHILENO;INGENIERO EN TELECOMUNICACIONES;Millenial;RENCA                         ;METROPOLITANA;103980;2;1;2;1;103980;0;0;0;Galaxy Watch Active4 40 mm Black;ACCESORIOS
20214472;;M;22;CHILENO;;Z;PROVIDENCIA                   ;METROPOLITANA;1174311;23;21;3;2;335830;20;19;838481;Audifonos Gamer Expert MF6;ACCESORIOS
11226000;;F;53;CHILENO;;X;COIHAIQUE                     ;AYSEN;99990;1;1;0;0;0;1;1;99990;AUDIFONO GALAXY BUDS2 BLACK;ACCESORIOS
20488426;;M;22;CHILENO;;Extranjero;PROVIDENCIA                   ;N/D;9990;1;1;1;1;9990;0;0;0;Mousepad Gamer M905;ACCESORIOS
18017192;;M;30;CHILENO;;Millenial;CURANILAHUE                   ;BIO BIO;618900;10;7;0;0;0;10;7;618900;Headset Legion H300 Stereo Gaming;ACCESORIOS
7466848;;F;66;CHILENO;;Boomers;TOCOPILLA                     ;ANTOFAGASTA;1697870;14;9;2;1;259980;12;8;1437890;Galaxy Watch Active4 40 mm Black;ACCESORIOS
8987744;;F;61;CHILENO;;Boomers;COLINA                        ;METROPOLITANA;854440;20;12;0;0;0;20;12;854440;Parlante Bluetooth Blik Rockwood;ACCESORIOS
13774998;;M;42;CHILENO;;X;PAINE                         ;METROPOLITANA;222930;8;3;6;2;197950;2;1;24980;SAMSUNG TYPE-C EARPHONES BLACK;ACCESORIOS
8571239;;M;62;CHILENO;;Boomers;RENCA                         ;METROPOLITANA;9990;1;1;0;0;0;1;1;9990;AUDIFONO ON SONY ZX110 BLANCO;ACCESORIOS
19311630;;M;25;CHILENO;;Z;PROVIDENCIA                   ;METROPOLITANA;14990;1;1;0;0;0;1;1;14990;SAMSUNG TYPE-C EARPHONES BLACK;ACCESORIOS
14247331;Casado;F;48;CHILENO;;X;PROVIDENCIA                   ;METROPOLITANA;99990;1;1;0;0;0;1;1;99990;Escritorio Gamer Pro RGB;ACCESORIOS
17150715;;M;33;CHILENO;;Millenial;N/D;N/D;313960;4;4;0;0;0;4;4;313960;SOPORTE TV 26-56 KTA02 KIOTO FIJO;ACCESORIOS
19160106;;M;21;CHILENO;;Z;MAIPU;METROPOLITANA;225960;4;2;4;2;225960;0;0;0;ALIMANTADOR DE MASCOTAS SMART NEXXT;ACCESORIOS
26665323;;F;56;COLOMBIANO;;Extranjero;N/D;N/D;21980;2;1;0;0;0;2;1;21980;Teclado Gamer GT M867;ACCESORIOS
27329916;;F;26;VENEZOLANO;;Extranjero;PUERTO MONTT                  ;LOS LAGOS;82960;4;4;0;0;0;4;4;82960;SMART IR, CONTROL REMOTO INTELIGENTE;ACCESORIOS
26822617;;M;46;VENEZOLANO;;Extranjero;"";"";173970;3;2;2;1;166980;1;1;6990;SOPORTE TV 26-56 KTA02 KIOTO FIJO;ACCESORIOS
10109450;;F;59;CHILENO;;Boomers;CANETE                        ;BIO BIO;388020;7;4;0;0;0;7;4;388020;Mi In-Ear Headphones Basic (Black) XIAOMI;ACCESORIOS
18451703;;M;28;CHILENO;;Millenial;CHILLAN                       ;BIO BIO;244981;2;2;1;1;159990;1;1;84991;Escritorio Gamer Pro RGB;ACCESORIOS
19812828;;F;24;CHILENO;;Z;LOS ALAMOS                    ;BIO BIO;530970;3;3;0;0;0;3;3;530970;TRAVEL ADAPTER 15W - FAST CHARGER (TYPE-C CABLE);ACCESORIOS
25697770;Soltero;M;33;VENEZOLANO;;Extranjero;PROVIDENCIA                   ;METROPOLITANA;83980;2;1;2;1;83980;0;0;0;AUDIFONO GALAXY BUDS2 VIOLET;ACCESORIOS
14153688;;M;41;CHILENO;;Silencioso;PROVIDENCIA                   ;METROPOLITANA;125980;2;4;3;2;140970;-1;2;-14990;Mouse 530 Wireless (PlatinumGrey);ACCESORIOS
17936115;;F;32;CHILENO;;Millenial;N/D;N/D;28970;3;7;0;0;0;3;7;28970;Audifono Con Diadema;ACCESORIOS
14901080;;F;41;CHILENO;;X;PROVIDENCIA                   ;METROPOLITANA;76980;2;2;0;0;0;2;2;76980;SOPORTE TV 26-56 KTA02 KIOTO FIJO;ACCESORIOS
19054472;Soltero;M;27;CHILENO;;Z;PROVIDENCIA                   ;METROPOLITANA;23980;2;1;2;1;23980;0;0;0;TECLADO GAMER MECANICO RGB GK100;ACCESORIOS
17312399;;F;32;CHILENO;;Millenial;"";"";98930;5;1;5;1;98930;0;0;0;PARLANTE BLUETOOTH TAS3505;ACCESORIOS
10672320;;M;54;CHILENO;;Millenial;N/D;N/D;64980;3;2;1;1;9990;2;1;54990;PARLANTES GAMER DHS-2101;ACCESORIOS
8333355;;F;64;CHILENO;;Boomers;PROVIDENCIA                   ;METROPOLITANA;10392;1;1;0;0;0;1;1;10392;SOPORTE TV 26-56 KTAT02 KIOTO MOVIL;ACCESORIOS
14255692;Casado;F;48;CHILENO;;X;RENCA                         ;METROPOLITANA;6990;1;1;0;0;0;1;1;6990;SOPORTE TV 26-56 KTA02 KIOTO FIJO;ACCESORIOS
20405157;;F;22;CHILENO;;Z;EL BOSQUE;METROPOLITANA;14990;1;1;0;0;0;1;1;14990;SAMSUNG TYPE-C EARPHONES WHITE;ACCESORIOS
24668624;;M;66;ARGENTINO;;Extranjero;SAN ANTONIO                   ;VALPARAISO;182720;3;4;0;0;0;3;4;182720;MOUSE 200 Inalambrico NEGRO;ACCESORIOS
19987243;;F;23;CHILENO;;Z;PROVIDENCIA                   ;METROPOLITANA;920970;3;2;3;2;920970;0;0;0;SAMSUNG TYPE-C EARPHONES BLACK;ACCESORIOS
18005850;;F;30;CHILENO;;Millenial;IQUIQUE                       ;TARAPACA;28470;2;1;0;0;0;2;1;28470;Parlante Karaoke Blik Screamer 2;ACCESORIOS
18961525;;F;27;CHILENO;;Z;N/D;N/D;2332790;26;13;12;6;931890;14;7;1400900;SOPORTE TV 26-56 KTA02 KIOTO FIJO;ACCESORIOS
13784279;;F;41;CHILENO;;X;MALLOA                        ;L.G.B.OÂ´HIGGINS;164513;4;3;0;0;0;4;3;164513;SOPORTE TV 14-63 CON BRAZO KT-FM 3L;ACCESORIOS
18703161;;F;28;CHILENO;;Millenial;"";"";2000;2;1;0;0;0;2;1;2000;AUDIFONO PANASONIC IN RP-HV096E-K NEGRO;ACCESORIOS
10242708;;F;55;CHILENO;;Boomers;N/D;N/D;214970;3;3;0;0;0;3;3;214970;GALAXY WATCH ACTIVE4 44 MM GREEN;ACCESORIOS
15404510;;F;36;CHILENO;;Millenial;RENCA                         ;METROPOLITANA;14990;1;1;0;0;0;1;1;14990;SAMSUNG TYPE-C EARPHONES WHITE;ACCESORIOS
23187875;Soltero;F;39;ECUATORIANO;;Extranjero;PROVIDENCIA                   ;METROPOLITANA;25980;2;2;2;2;25980;0;0;0;SOPORTE TV 14-63 CON BRAZO KT-FM 3L;ACCESORIOS
9775814;;M;59;CHILENO;;Boomers;CANETE                        ;BIO BIO;49980;2;2;0;0;0;2;2;49980;ALTEC LANSING AUDIFONO HEADBAND BLUETOOTH COMFOR;ACCESORIOS
15366421;;F;41;CHILENO;;Millenial;"";"";12000;2;1;0;0;0;2;1;12000;AUDIFONO MANOS LIBRES MOTOROLA SQUADS 200 ROSADO;ACCESORIOS
15116503;;F;21;CHILENO;;Z;PROVIDENCIA                   ;METROPOLITANA;8990;1;1;0;0;0;1;1;8990;TRAVEL ADAPTER 15W - FAST CHARGER (TYPE-C CABLE);ACCESORIOS
17259506;Soltero;M;33;CHILENO;INGENIERO EN CONSTRUCCION;Millenial;PROVIDENCIA                   ;METROPOLITANA;11990;1;1;0;0;0;1;1;11990;SOPORTE TV 32-65 KTA03 KIOTO FIJO;ACCESORIOS
11607889;;F;52;CHILENO;;X;MELIPILLA                     ;METROPOLITANA;495950;5;4;0;0;0;5;4;495950;AUDIFONO BLUETOOTH PANASONIC RP-HJE120B NEGRO;ACCESORIOS
16902001;;F;34;CHILENO;;Millenial;N/D;N/D;103960;4;3;2;1;53980;2;2;49980;PARLANTES SRS-XB23/LC LA;ACCESORIOS
11768195;;M;51;CHILENO;;X;CAUQUENES                     ;MAULE;467660;7;5;0;0;0;7;5;467660;SOPORTE TV 26-56 KTAT02 KIOTO MOVIL;ACCESORIOS
17681251;;M;30;CHILENO;;Millenial;PUNTA ARENAS                  ;MAGALLANES;7990;1;1;0;0;0;1;1;7990;Funda Reversible Fucsia/Negro 14;ACCESORIOS
20670258;;M;21;CHILENO;;Z;N/D;N/D;18980;2;1;2;1;18980;0;0;0;Mi Portable Bluetooth Speaker -Grey;ACCESORIOS
12728439;;M;47;CHILENO;;X;N/D;N/D;14990;1;1;0;0;0;1;1;14990;Parlante Karaoke Blik Screamer 1;ACCESORIOS
10283873;;M;54;CHILENO;;Silencioso;PROVIDENCIA                   ;METROPOLITANA;14990;1;1;0;0;0;1;1;14990;Cooler Pad M2072;ACCESORIOS
8503110;;M;63;CHILENO;;Boomers;MARIA ELENA                   ;ANTOFAGASTA;307431;7;7;0;0;0;7;7;307431;SOPORTE TV 32-65 KTA03 KIOTO FIJO;ACCESORIOS
13058846;;M;46;CHILENO;;X;"";"";129990;1;1;0;0;0;1;1;129990;GALAXY WATCH4 42 MM BLACK;ACCESORIOS
14620275;;F;42;CHILENO;;X;PUERTO MONTT                  ;LOS LAGOS;551070;10;4;0;0;0;10;4;551070;WATCH GT2 PRO BLACK HUAWEI;ACCESORIOS
11771637;;M;50;CHILENO;;X;SAN CARLOS                    ;BIO BIO;172980;2;2;0;0;0;2;2;172980;Silla Gamer Tyrus Negra;ACCESORIOS
18788559;Soltero;F;28;CHILENO;TECNICO DE NIVEL MEDIO EN ALIMENTACION;Silencioso;PROVIDENCIA                   ;METROPOLITANA;79990;1;1;1;1;79990;0;0;0;AUDIFONO GALAXY BUDS2 VIOLET;ACCESORIOS
15380077;;F;40;CHILENO;;X;PROVIDENCIA                   ;METROPOLITANA;83980;2;1;2;1;83980;0;0;0;Silla Gamer Tyrus Negra;ACCESORIOS
20275286;;F;22;CHILENO;;Z;N/D;N/D;3000;2;1;0;0;0;2;1;3000;AUDIFONO PANASONIC IN RP-HV096E-K NEGRO;ACCESORIOS
19864209;;M;24;CHILENO;;Z;"";"";69990;1;1;1;1;69990;0;0;0;Silla Gamer Tyrus Negra;ACCESORIOS
6215159;;M;70;CHILENO;;Silencioso;RENCA                         ;METROPOLITANA;6990;1;1;0;0;0;1;1;6990;SOPORTE TV 26-56 KTAT02 KIOTO MOVIL;ACCESORIOS
10856550;;F;48;CHILENO;;X;N/D;N/D;7990;1;1;0;0;0;1;1;7990;SOPORTE TV 26-56 KTA02 KIOTO FIJO;ACCESORIOS
19137020;Soltero;M;26;CHILENO;;Silencioso;PROVIDENCIA                   ;METROPOLITANA;27980;2;1;2;1;27980;0;0;0;JBL AUDIFONOS ON-EAR BLUETOOTH TUNE 510BT AZUL;ACCESORIOS
19140146;;M;26;CHILENO;;Z;N/D;N/D;1486920;8;5;2;1;156980;6;4;1329940;GALAXY WATCH ACTIVE4 40 MM GOLD;ACCESORIOS
20412450;;M;22;CHILENO;;Z;N/D;N/D;426320;10;6;8;5;356910;2;1;69410;DISCO DURO CANVIO 1TB BASICS BLACK TOSHIBA;ACCESORIOS
25525923;Soltero;M;27;PERUANO;;Extranjero;PROVIDENCIA                   ;METROPOLITANA;11990;1;1;1;1;11990;0;0;0;SAMSUNG TYPE-C EARPHONES WHITE;ACCESORIOS
18559878;;M;28;CHILENO;;Millenial;PARRAL                        ;MAULE;7990;1;1;0;0;0;1;1;7990;SOPORTE TV 26-56 KTAT02 KIOTO MOVIL;ACCESORIOS
15604066;;F;38;CHILENO;;X;PAINE                         ;METROPOLITANA;24980;2;2;0;0;0;2;2;24980;20000mAh REDMI 18W FAST CHARGE POWER BANK BLACK;ACCESORIOS
17345526;Soltero;M;32;CHILENO;;Millenial;PROVIDENCIA                   ;METROPOLITANA;113980;2;1;2;1;113980;0;0;0;AUDIFONOS GALAXY BUDS PRO BLACK;ACCESORIOS
13464383;;M;44;CHILENO;;X;N/D;N/D;30980;2;1;0;0;0;2;1;30980;Redmi Buds 3 Lite Black;ACCESORIOS
18861018;Soltero;F;27;CHILENO;;Millenial;PROVIDENCIA                   ;METROPOLITANA;14990;1;1;0;0;0;1;1;14990;SOPORTE TV 14-63 CON BRAZO KT-FM 3L;ACCESORIOS
17177779;;F;43;CHILENO;;X;PUDAHUEL;METROPOLITANA;99970;3;1;3;1;99970;0;0;0;HONOR BAND 6 BLACK;ACCESORIOS
25609561;;M;30;VENEZOLANO;;Extranjero;"";"";12980;2;1;2;1;12980;0;0;0;XIAOMI MI TYPE-C TO LIGHTNING CABLE 1M;ACCESORIOS
9322568;;M;46;CHILENO;;X;RENCA                         ;METROPOLITANA;13980;2;1;2;1;13980;0;0;0;Parlante Karaoke Blik Screamer 2;ACCESORIOS
13482694;;F;44;CHILENO;;X;CORONEL                       ;BIO BIO;12990;1;1;1;1;12990;0;0;0;SAMSUNG TYPE-C EARPHONES BLACK;ACCESORIOS
13947502;;M;42;CHILENO;;Extranjero;RENGO                         ;L.G.B.OÂ´HIGGINS;221970;3;4;0;0;0;3;4;221970;SOPORTE TV 32-65 KTA03 KIOTO FIJO;ACCESORIOS
17660830;;M;32;CHILENO;;Millenial;ESTACION CENTRAL;METROPOLITANA;439970;4;4;4;4;439970;0;0;0;Disco Portatil Toshiba Canvio Gaming, Negro 1T;ACCESORIOS
17763000;Soltero;M;31;CHILENO;PSICOLOGO;Millenial;PROVIDENCIA                   ;METROPOLITANA;123980;2;1;2;1;123980;0;0;0;Galaxy Watch Active4 40 mm Black;ACCESORIOS
16973188;;F;34;CHILENO;;Millenial;N/D;N/D;69990;1;1;0;0;0;1;1;69990;Silla Gamer Tyrus Blanco rosadosa;ACCESORIOS
12561587;;M;47;CHILENO;;X;N/D;N/D;6990;1;1;0;0;0;1;1;6990;SOPORTE TV 26-56 KTAT02 KIOTO MOVIL;ACCESORIOS
20368901;;F;22;CHILENO;;Z;PROVIDENCIA                   ;METROPOLITANA;79990;1;1;1;1;79990;0;0;0;Silla Gamer Tyrus Negra;ACCESORIOS
19510790;;F;25;CHILENO;;Z;PROVIDENCIA                   ;METROPOLITANA;10220;2;3;0;0;0;2;3;10220;XIAOMI MI TYPE-C TO LIGHTNING CABLE 1M;ACCESORIOS
16631779;;M;35;CHILENO;;Millenial;PROVIDENCIA                   ;METROPOLITANA;88980;2;1;2;1;88980;0;0;0;Silla Gamer Tyrus Negra;ACCESORIOS
19393764;;F;26;CHILENO;;Silencioso;N/D;N/D;212980;2;2;0;0;0;2;2;212980;SOPORTE TV 14-63 CON BRAZO KT-FM 3L;ACCESORIOS
10732434;Soltero;M;48;CHILENO;;X;RENCA                         ;METROPOLITANA;642520;10;3;0;0;0;10;3;642520;DISCO DURO CANVIO 2TB BASICS BLACK TOSHIBA;ACCESORIOS
15054183;;M;40;CHILENO;;X;N/D;N/D;12990;1;1;0;0;0;1;1;12990;AUDIFONO SONY MDRZX310APLZUC;ACCESORIOS
9455598;;F;61;CHILENO;;Boomers;RENCA                         ;METROPOLITANA;7990;1;1;0;0;0;1;1;7990;SOPORTE TV 26-56 KTAT02 KIOTO MOVIL;ACCESORIOS
16241760;;F;36;CHILENO;;X;"";"";13000;2;1;0;0;0;2;1;13000;MINI PARLANTE BT GO2;ACCESORIOS
8609680;;F;61;CHILENO;;Boomers;N/D;N/D;18980;2;2;0;0;0;2;2;18980;PARLANTE GBASS MICRO;ACCESORIOS
19573852;;M;25;CHILENO;;Millenial;PENALOLEN;METROPOLITANA;22176;3;1;3;1;22176;0;0;0;SAMSUNG TYPE-C EARPHONES BLACK;ACCESORIOS
13042590;;M;46;CHILENO;;X;N/D;N/D;393760;3;2;1;1;39990;2;1;353770;365 Personal Suscripcion Anual QQ2-0008TP;ACCESORIOS
16401742;Casado;F;35;CHILENO;INGENIERO INDUSTRIAL;Millenial;RENCA                         ;METROPOLITANA;13990;1;1;0;0;0;1;1;13990;SOPORTE TV 14-63 CON BRAZO KT-FM 3L;ACCESORIOS
8119413;;M;52;CHILENO;;X;COIHAIQUE                     ;AYSEN;675930;7;5;2;2;519980;5;3;155950;SOPORTE TV 32-65 KTA03 KIOTO FIJO;ACCESORIOS
19255311;;F;26;CHILENO;;Z;CONSTITUCION                  ;MAULE;80000;2;1;0;0;0;2;1;80000;New GAMEPAD - GLAP;ACCESORIOS
15757140;;M;38;CHILENO;;Millenial;PROVIDENCIA                   ;METROPOLITANA;20140;2;1;0;0;0;2;1;20140;ALTEC LANSING AUDIFONO Nano Pods TWS PURPLE 8996;ACCESORIOS
15309668;Soltero;M;40;CHILENO;PROFESOR;X;RENCA                         ;METROPOLITANA;14990;1;1;0;0;0;1;1;14990;SOPORTE TV 14-42 KTAM02 KIOTO C/ BRAZO MOVIL;ACCESORIOS
23623241;;F;37;PERUANO;;Extranjero;SANTIAGO                      ;METROPOLITANA;9990;1;1;0;0;0;1;1;9990;TRAVEL ADAPTER 15W - FAST CHARGER (TYPE-C CABLE);ACCESORIOS
13130754;;F;45;CHILENO;;X;CHILLAN                       ;BIO BIO;12990;1;3;0;0;0;1;3;12990;SOPORTE TV 14-63 CON BRAZO KT-FM 3L;ACCESORIOS
24258255;Casado;M;34;CHILENO;;Extranjero;PROVIDENCIA                   ;METROPOLITANA;184980;2;1;2;1;184980;0;0;0;SILLA GAMER ARMOR S / 3MGC2NXB.0001;ACCESORIOS
17988970;;F;30;CHILENO;;Millenial;CHILLAN;BIO-BIO;41950;5;1;0;0;0;5;1;41950;MOUSE MICROSOFT Wireless Mbl 1850 Black;ACCESORIOS
12473503;;F;49;CHILENO;;X;LA FLORIDA;METROPOLITANA;185940;6;3;6;3;185940;0;0;0;PARLANTE BLUETOOTH TAS1505B;ACCESORIOS
26204868;Soltero;F;32;CUBANO;;Extranjero;PROVIDENCIA                   ;METROPOLITANA;27950;5;1;5;1;27950;0;0;0;Teclado inalambrico multimedia;ACCESORIOS
12667728;;M;48;CHILENO;;X;RENCA                         ;METROPOLITANA;41970;3;2;0;0;0;3;2;41970;AMPOLLETA SMAR MULTICOLOR;ACCESORIOS
18010892;;M;30;CHILENO;;Millenial;N/D;N/D;100950;5;4;0;0;0;5;4;100950;SOPORTE TV 14-63 CON BRAZO KT-FM 3L;ACCESORIOS
19560379;Soltero;F;27;CHILENO;;Z;PINTO                         ;BIO BIO;13000;2;1;0;0;0;2;1;13000;SOPORTE TV 14-63 CON BRAZO KT-FM 3L;ACCESORIOS
13178912;;F;45;CHILENO;;X;OVALLE                        ;COQUIMBO;44990;1;1;0;0;0;1;1;44990;Disco Portatil Toshiba Canvio Gaming, Negro 1T;ACCESORIOS
17098117;;F;33;CHILENO;;Millenial;PAPUDO;VALPARAISO;176980;2;1;2;1;176980;0;0;0;GALAXY WATCH ACTIVE4 40 MM GOLD;ACCESORIOS
18359705;;F;29;CHILENO;;Millenial;SAN JAVIER                    ;MAULE;845931;6;4;0;0;0;6;4;845931;ALTEC LANSING AUDIFONO IN-EAR BLUETOOTH SPORT RU;ACCESORIOS
8729407;;M;63;CHILENO;;Boomers;PROVIDENCIA                   ;METROPOLITANA;239980;3;2;0;0;0;3;2;239980;GALAXY WATCH ACTIVE4 44 MM GREEN;ACCESORIOS
14164740;;M;40;CHILENO;;X;N/D;N/D;11690;1;1;1;1;11690;0;0;0;SAMSUNG TYPE-C EARPHONES BLACK;ACCESORIOS
16376489;;M;35;CHILENO;;Millenial;"";"";99990;1;1;1;1;99990;0;0;0;AUDIFONOS HUAWEI FREEBUDS PRO SILVER;ACCESORIOS
12673218;;F;47;CHILENO;;X;LA PINTANA                    ;METROPOLITANA;8990;1;1;0;0;0;1;1;8990;PARLANTE 7279 MLAB ZUKABASS NEGRO BT;ACCESORIOS
19609316;;F;25;CHILENO;;Z;PROVIDENCIA                   ;METROPOLITANA;33450;5;3;0;0;0;5;3;33450;Mi In-Ear Headphones Basic (Black) XIAOMI;ACCESORIOS
15708718;Casado;M;38;CHILENO;;X;PROVIDENCIA                   ;METROPOLITANA;24990;1;1;0;0;0;1;1;24990;ALTEC LANSING AUDIFONO Nanobuds TWS 2.0 GRAY BLA;ACCESORIOS
13396624;;M;45;CHILENO;;X;NUEVA IMPERIAL                ;ARAUCANIA;15240;2;1;0;0;0;2;1;15240;SOPORTE TV 14-42 KTAM02 KIOTO C/ BRAZO MOVIL;ACCESORIOS
13045801;;F;47;CHILENO;;X;PENALOLEN                     ;METROPOLITANA;293423;5;3;0;0;0;5;3;293423;SILLA GAMER LEGI LBLU;ACCESORIOS
20390523;;M;22;CHILENO;;Z;PROVIDENCIA                   ;METROPOLITANA;13980;2;1;2;1;13980;0;0;0;AUDIFONOS HUAWEI MANOS LIBRES TIPO C CM33;ACCESORIOS
17151022;;F;33;CHILENO;;Millenial;PUDAHUEL;METROPOLITANA;21980;2;1;2;1;21980;0;0;0;KIT GAMER 3 EN 1 LVLUP TECLADO CON LUCES, MOUSE;ACCESORIOS
8061296;;M;63;CHILENO;;Boomers;LOS ANGELES                   ;BIO BIO;56970;3;2;0;0;0;3;2;56970;PARLANTE 6986 MLAB VERTICAL STICKERS BT;ACCESORIOS
15449483;;F;38;CHILENO;;X;PROVIDENCIA                   ;METROPOLITANA;34990;1;1;1;1;34990;0;0;0;Z FLIP3 SILICONE COVER WITH STRAP WHITE;ACCESORIOS
12789804;;F;47;CHILENO;;X;SAN JAVIER                    ;MAULE;173949;5;2;0;0;0;5;2;173949;AUDIFONO MLAB TWS FULLY WIRELESSÂ  WHITE 8721;ACCESORIOS
18718036;;M;27;CHILENO;;Millenial;PROVIDENCIA                   ;METROPOLITANA;128970;3;2;2;1;103980;1;1;24990;AUDIFONOS HUAWEI FREEBUDS PRO SILVER;ACCESORIOS
18860837;Soltero;M;28;CHILENO;;Millenial;PROVIDENCIA                   ;METROPOLITANA;12990;1;1;0;0;0;1;1;12990;MOUSE INAL M187 LOG NEGRO;ACCESORIOS
17395040;;M;32;CHILENO;;Millenial;CALDERA                       ;ATACAMA;10990;1;1;0;0;0;1;1;10990;TRAVEL ADAPTER 15W - FAST CHARGER (TYPE-C CABLE);ACCESORIOS
7880452;Casado;M;65;CHILENO;;Boomers;RENCA                         ;METROPOLITANA;11990;1;1;0;0;0;1;1;11990;SOPORTE TV 32-65 KTA03 KIOTO FIJO;ACCESORIOS
18729304;;F;28;CHILENO;;Millenial;VILCUN                        ;ARAUCANIA;336970;3;3;1;1;219990;2;2;116980;AUDIFONOS GALAXY BUDS PRO SILVER;ACCESORIOS
17465849;;M;31;CHILENO;;Millenial;PROVIDENCIA                   ;METROPOLITANA;15980;2;1;2;1;15980;0;0;0;PARLANTE BLUETOOTH BABYBOOM XL;ACCESORIOS
10915732;;M;55;CHILENO;;Boomers;CALERA                        ;VALPARAISO;32983;2;1;0;0;0;2;1;32983;ALTEC LANSING AUDIFONO HEADBAND BLUETOOTH COMFOR;ACCESORIOS
13500915;;F;44;CHILENO;;X;N/D;N/D;19990;3;2;0;0;0;3;2;19990;Audifono Con Diadema;ACCESORIOS
19861776;;F;24;CHILENO;;Z;ANCUD;LOS LAGOS;54990;1;1;0;0;0;1;1;54990;DISCO DURO CANVIO 1TB BASICS BLACK TOSHIBA;ACCESORIOS
16420604;Soltero;F;36;CHILENO;;Millenial;COLINA;METROPOLITANA;109990;2;1;2;1;109990;0;0;0;AUDIFONOS GALAXY BUDS PRO SILVER;ACCESORIOS
26507254;;M;37;VENEZOLANO;;Extranjero;OSORNO                        ;LOS LAGOS;6990;1;1;0;0;0;1;1;6990;SOPORTE TV 26-56 KTA02 KIOTO FIJO;ACCESORIOS
6506046;Casado;M;71;CHILENO;;Silencioso;PROVIDENCIA                   ;METROPOLITANA;10990;1;1;0;0;0;1;1;10990;TRAVEL ADAPTER 15W - FAST CHARGER (TYPE-C CABLE);ACCESORIOS
19591261;;F;25;CHILENO;;Z;"";"";4990;1;3;1;3;4990;0;0;0;Kit 2-1 Rojo;ACCESORIOS
6243223;;F;75;CHILENO;;Silencioso;MELIPILLA                     ;METROPOLITANA;244980;2;1;0;0;0;2;1;244980;Silla Gamer Tyrus Blanco rosadosa;ACCESORIOS
16267005;;F;36;CHILENO;;Millenial;"";"";473970;4;3;0;0;0;4;3;473970;AUDIFONO BLUETOOTH SPIDERMAN;ACCESORIOS
12029451;;F;42;CHILENO;;X;TALCA                         ;MAULE;147980;2;2;0;0;0;2;2;147980;Smartwatch GT 2 BLACK;ACCESORIOS
16440463;;M;36;CHILENO;;Millenial;PROVIDENCIA                   ;METROPOLITANA;12990;1;1;0;0;0;1;1;12990;TWS EARPHONE WITH CHARGING CASE BLANCO FIDDLER;ACCESORIOS
19884410;;F;24;CHILENO;;Z;N/D;N/D;8000;2;1;0;0;0;2;1;8000;ARO DE LUZ LED 10 PULGADAS + TRIPODE PEQUENO;ACCESORIOS
6947775;;M;70;CHILENO;;Silencioso;CARTAGENA                     ;VALPARAISO;22990;1;1;0;0;0;1;1;22990;SOPORTE TV 14-63 CON BRAZO KT-FM 3L;ACCESORIOS
15196798;;F;38;CHILENO;;X;ARAUCO                        ;BIO BIO;10990;1;1;0;0;0;1;1;10990;MLAB AUDIFONO AIR-ACCES POP-UP CASE HANG UP WHIT;ACCESORIOS
10723759;;M;46;CHILENO;;X;VILLA ALEMANA;VALPARAISO;15980;2;1;2;1;15980;0;0;0;CABLE DE DATOS USB TIPO C HUAWEI SUPER CHARGER A;ACCESORIOS
18526004;;F;28;CHILENO;;Millenial;N/D;N/D;29980;2;2;0;0;0;2;2;29980;SOPORTE TV 14-42 KTAM02 KIOTO C/ BRAZO MOVIL;ACCESORIOS
13906074;;M;41;CHILENO;;X;PROVIDENCIA                   ;METROPOLITANA;7990;1;1;0;0;0;1;1;7990;AUDIFONO MOTOROLA EARBUDS M. LIBRES METAL NEGRO;ACCESORIOS
18808675;;M;28;CHILENO;;Millenial;N/D;N/D;132950;5;3;0;0;0;5;3;132950;AUDIFONO MLAN AIR-WIRELESS CHARGE TOUCH RED;ACCESORIOS
20196446;;F;22;CHILENO;;Z;CONCEPCION                    ;BIO BIO;1066530;8;5;0;0;0;8;5;1066530;PARLANTE BLUETOOTH TAS2505B;ACCESORIOS
17015064;;F;33;CHILENO;;Millenial;LA SERENA;COQUIMBO;15000;2;1;0;0;0;2;1;15000;AUDIFONO BLUETOOTH SPIDERMAN;ACCESORIOS
18165465;;M;30;CHILENO;;Millenial;ANTOFAGASTA                   ;ANTOFAGASTA;468840;5;2;0;0;0;5;2;468840;Mi Smart Band 6 Negra Xiaomi;ACCESORIOS
26394169;;M;46;VENEZOLANO;;Extranjero;"";"";45980;2;1;2;1;45980;0;0;0;AUDIFONO XIAOMI EARPHONES MI TRUE WIRELESS 2 BAS;ACCESORIOS
11774622;;F;51;CHILENO;;X;CHIGUAYANTE                   ;BIO BIO;105840;2;3;2;3;105840;0;0;0;AUDIFONO MLAB TWS IN-AIR WHITE 8533;ACCESORIOS
20231914;;F;37;CHILENO;;Millenial;N/D;N/D;8990;1;1;0;0;0;1;1;8990;Mouse IdeaPad Gaming M100 RGB;ACCESORIOS
18064924;;M;30;CHILENO;;Millenial;"";"";22990;1;1;0;0;0;1;1;22990;AUDIFONO XIAOMI EARPHONES MI TRUE WIRELESS 2 BAS;ACCESORIOS
15620427;;F;38;CHILENO;;Millenial;"";"";5990;1;1;0;0;0;1;1;5990;Mi In-Ear Headphones Basic (Black) XIAOMI;ACCESORIOS
24439713;Soltero;M;33;CHILENO;;Extranjero;PROVIDENCIA                   ;METROPOLITANA;243980;2;1;2;1;243980;0;0;0;GALAXY WATCH4 CLASSIC 46 MM LTE;ACCESORIOS
19749634;;F;24;CHILENO;;Millenial;"";"";6990;1;1;0;0;0;1;1;6990;SOPORTE TV 26-56 KTAT02 KIOTO MOVIL;ACCESORIOS
9517947;;F;52;CHILENO;;X;COIHAIQUE                     ;AYSEN;16990;1;1;0;0;0;1;1;16990;SOPORTE TV 14-63 CON BRAZO KT-FM 3L;ACCESORIOS
15632141;;M;38;CHILENO;;Millenial;SAN FERNANDO                  ;L.G.B.OÂ´HIGGINS;17990;1;1;0;0;0;1;1;17990;SOPORTE TV 14-63 CON BRAZO KT-FM 3L;ACCESORIOS
9246075;;F;60;CHILENO;;Boomers;VALDIVIA                      ;LOS RIOS;19990;1;1;0;0;0;1;1;19990;PARLANTE KARAOKE MGGLADIATOR NEGRO;ACCESORIOS
16343201;;M;35;CHILENO;;Millenial;RIO NEGRO                     ;LOS LAGOS;44990;1;1;0;0;0;1;1;44990;KIT DIRECTV GO BOX;ACCESORIOS
19233318;;M;26;CHILENO;;Z;PUDAHUEL                      ;METROPOLITANA;19990;1;1;0;0;0;1;1;19990;Audifonos Gamer Expert MF6;ACCESORIOS
15694980;;M;38;CHILENO;;Millenial;ARICA                         ;ARICA Y PARINACOTA;12990;1;1;1;1;12990;0;0;0;ITFIT Tripode Selfie Stick;ACCESORIOS
18026088;;F;29;CHILENO;;Millenial;PADRE HURTADO;METROPOLITANA;189990;1;1;1;1;189990;0;0;0;GALAXY WATCH4 42 MM BLACK;ACCESORIOS
7513176;;F;51;CHILENO;;X;COLINA                        ;METROPOLITANA;1994780;7;3;0;0;0;7;3;1994780;Travel Adapter SFC 25W Type C (w/o Cable);ACCESORIOS
16343511;;M;36;CHILENO;;Millenial;PURRANQUE                     ;LOS LAGOS;117840;5;3;0;0;0;5;3;117840;PARLANTE KARAOKE MGGLADIATOR NEGRO;ACCESORIOS
8329277;;F;63;CHILENO;;Boomers;N/D;N/D;66550;4;2;0;0;0;4;2;66550;AUDIFONO XIAOMI EARBUDS MI TRUE WIRELESS BASIC 2;ACCESORIOS
13772631;Soltero;M;42;CHILENO;ANALISTA DE SISTEMAS;X;RENCA                         ;METROPOLITANA;249970;3;2;2;1;239980;1;1;9990;Mouse 530 Wireless (PlatinumGrey);ACCESORIOS
13895578;Casado;M;42;CHILENO;;X;RENCA                         ;METROPOLITANA;199960;4;2;4;2;199960;0;0;0;GALAXY WATCH4 42 MM BLACK;ACCESORIOS
18255263;Soltero;M;29;CHILENO;;Millenial;PROVIDENCIA                   ;METROPOLITANA;48970;3;2;0;0;0;3;2;48970;Mouse G203 LIGHTSYNC Gaming - BLACK;ACCESORIOS
24750808;;F;47;PERUANO;;Extranjero;MELIPILLA                     ;METROPOLITANA;275430;7;5;0;0;0;7;5;275430;AUDIFONO MANOS LIBRES MOTOROLA SQUADS 200 AZUL;ACCESORIOS
18375521;;F;29;CHILENO;;Millenial;N/D;N/D;34980;2;2;0;0;0;2;2;34980;ALTEC LANSING AUDIFONO HEADBAND BLUETOOTH COMFOR;ACCESORIOS
18548461;;M;28;CHILENO;;Millenial;N/D;N/D;199990;1;1;1;1;199990;0;0;0;Galaxy Watch4 46 mm Black;ACCESORIOS
27201239;;M;31;EXTRANJERO - NO INFORMA NACIONALIDAD ;;Extranjero;ANTOFAGASTA                   ;ANTOFAGASTA;163970;3;2;0;0;0;3;2;163970;SOPORTE TV 26-56 KTAT02 KIOTO MOVIL;ACCESORIOS
10991582;;M;57;CHILENO;;Boomers;PANGUIPULLI                   ;LOS RIOS;19990;1;1;0;0;0;1;1;19990;SOPORTE TV 14-63 CON BRAZO KT-FM 3L;ACCESORIOS
19059639;;F;25;CHILENO;;Z;N/D;N/D;524970;3;2;0;0;0;3;2;524970;SOPORTE TV 14-63 CON BRAZO KT-FM 3L;ACCESORIOS
27481489;;M;31;CHILENO;;Extranjero;"";"";39990;1;2;0;0;0;1;2;39990;PARLANTE KARAOKE FD-PKBT82 8 LUCES MIC/FM/BT/USB;ACCESORIOS
13595391;;F;43;CHILENO;;X;SAN BERNARDO                  ;METROPOLITANA;4990;1;1;1;1;4990;0;0;0;AUDIFONO KIDS FROZEN 2 ANNA ALAMBRICO;ACCESORIOS
10474823;Casado;M;52;CHILENO;;X;NANCAGUA                      ;L.G.B.OÂ´HIGGINS;7990;1;1;0;0;0;1;1;7990;PARLANTE BLUETOOTH BABYBOOM XL;ACCESORIOS
10690613;;F;57;CHILENO;;Boomers;ANTOFAGASTA                   ;ANTOFAGASTA;17980;2;1;0;0;0;2;1;17980;AUDIFONO TEEN FROZEN 2 ELSA+ANNA ALAMBRICO;ACCESORIOS
8790408;;F;63;CHILENO;;Boomers;VALDIVIA                      ;LOS RIOS;24970;3;1;0;0;0;3;1;24970;PARLANTE 7279 MLAB ZUKABASS NEGRO BT;ACCESORIOS
26612041;;F;28;CHILENO;;Extranjero;"";"";84980;2;1;2;1;84980;0;0;0;AUDIFONO GALAXY BUDS LIVE COBRE;ACCESORIOS
6438198;;M;71;CHILENO;;Silencioso;IQUIQUE                       ;TARAPACA;19990;1;1;0;0;0;1;1;19990;KARAOKE MLAB TOWER OUTDOOR MIC BT BK 8568;ACCESORIOS
19030003;;F;26;CHILENO;;Z;PROVIDENCIA                   ;METROPOLITANA;104970;3;2;0;0;0;3;2;104970;SMARTBAND XIAOMI MI BAND 5 NEGRO;ACCESORIOS
17305418;Casado;M;32;CHILENO;TOPOGRAFO;Millenial;PROVIDENCIA                   ;METROPOLITANA;189990;2;1;2;1;189990;0;0;0;GALAXY WATCH ACTIVE4 40 MM GOLD;ACCESORIOS
17817448;Soltero;M;32;CHILENO;;Millenial;PROVIDENCIA                   ;METROPOLITANA;14990;1;1;0;0;0;1;1;14990;PARLANTE 8531 MLAB MAX BASS BT;ACCESORIOS
10032489;;M;57;CHILENO;;Boomers;PUDAHUEL                      ;METROPOLITANA;29990;1;1;0;0;0;1;1;29990;Headset Pav Gam 400 Grn CAN/ENG;ACCESORIOS
20023691;;F;23;CHILENO;;Z;CALAMA;ANTOFAGASTA;15990;1;1;0;0;0;1;1;15990;AUDIFONO BLUETOOTH PANASONIC RP-HJE120B NEGRO;ACCESORIOS
17492146;Soltero;F;32;CHILENO;INGENIERO EN ADMINISTRACION DE EMPRESAS;Silencioso;PROVIDENCIA                   ;METROPOLITANA;218640;2;1;2;1;218640;0;0;0;GALAXY WATCH ACTIVE4 40 MM LTE GOLD;ACCESORIOS
14515785;;F;46;CHILENO;;X;SAN VICENTE                   ;L.G.B.OÂ´HIGGINS;246960;4;3;3;2;213970;1;1;32990;AUDIFONO XIAOMI EARPHONES MI TRUE WIRELESS 2 BAS;ACCESORIOS
14262275;Casado;F;48;CHILENO;;X;RENCA                         ;METROPOLITANA;7990;1;1;0;0;0;1;1;7990;AUDIFONO HEADBAND BT BLANCO FIDDLER;ACCESORIOS
15807185;Soltero;M;37;CHILENO;;Millenial;SAN FERNANDO                  ;L.G.B.OÂ´HIGGINS;17990;1;1;0;0;0;1;1;17990;MICROFONO KARAOKE LIL VOICE SOPORTE METAL BLACK;ACCESORIOS
16342226;Soltero;F;35;CHILENO;;Millenial;PROVIDENCIA                   ;METROPOLITANA;18980;2;2;0;0;0;2;2;18980;MOUSE MICROSOFT Wireless Mbl 1850 Black;ACCESORIOS
16005321;;M;35;CHILENO;;Millenial;N/D;N/D;39990;1;1;0;0;0;1;1;39990;BAND 6 PINK HUAWEI;ACCESORIOS
19005576;;F;27;CHILENO;;Z;PROVIDENCIA                   ;METROPOLITANA;14990;1;1;0;0;0;1;1;14990;Kit 2-1 Rojo;ACCESORIOS
17364118;;F;32;CHILENO;;Millenial;N/D;N/D;17980;2;2;0;0;0;2;2;17980;AUDIFONO MLAB TWS IN-AIR WHITE 8533;ACCESORIOS
11188307;;F;55;CHILENO;;Boomers;N/D;N/D;7990;1;1;0;0;0;1;1;7990;SOPORTE TV 26-56 KTAT02 KIOTO MOVIL;ACCESORIOS
19179784;;F;26;CHILENO;;Z;ALTO HOSPICIO;TARAPACA;5990;1;1;0;0;0;1;1;5990;Mi In-Ear Headphones Basic (Black) XIAOMI;ACCESORIOS
17552276;;M;30;CHILENO;;Silencioso;PROVIDENCIA                   ;METROPOLITANA;22980;2;1;0;0;0;2;1;22980;PARLANTE ZUKABASS + MICROFONO MLAB BT ROJO;ACCESORIOS
6696451;;F;65;CHILENO;;Boomers;PROVIDENCIA                   ;METROPOLITANA;18990;1;1;0;0;0;1;1;18990;AUDIFONO XIAOMI EARBUDS MI TRUE WIRELESS BASIC 2;ACCESORIOS
15452795;Casado;M;40;CHILENO;;X;PROVIDENCIA                   ;METROPOLITANA;43970;3;1;3;1;43970;0;0;0;3-PACK TOMACORRIENTE SMART NEXXT;ACCESORIOS
13379051;;M;43;CHILENO;;X;PROVIDENCIA                   ;METROPOLITANA;99990;1;1;0;0;0;1;1;99990;HUAWEI WATCH FIT NEW BLUE;ACCESORIOS
9916139;;M;58;CHILENO;;Boomers;PENCO                         ;BIO BIO;272980;2;2;0;0;0;2;2;272980;Galaxy Watch Active4 44 mm Black;ACCESORIOS
10573378;Casado;M;57;CHILENO;;Boomers;PENCO                         ;BIO BIO;6990;1;1;0;0;0;1;1;6990;Mouse 200 Silver Wireless;ACCESORIOS
15994775;;F;37;CHILENO;;Millenial;PROVIDENCIA                   ;METROPOLITANA;13990;1;1;0;0;0;1;1;13990;AUDIFONO SAMSUNG WIRELESS 103B;ACCESORIOS
17644552;Soltero;M;31;CHILENO;;Millenial;VALLENAR;ATACAMA;44970;3;1;0;0;0;3;1;44970;ALTEC LANSING AUDIFONO HEADBAND BLUETOOTH COMFOR;ACCESORIOS
14227904;;F;40;CHILENO;;X;EL BOSQUE                     ;METROPOLITANA;13990;1;1;0;0;0;1;1;13990;AUDIFONO SAMSUNG WIRELESS 103B;ACCESORIOS
17091600;Soltero;M;33;CHILENO;;Millenial;PROVIDENCIA                   ;METROPOLITANA;99990;1;1;0;0;0;1;1;99990;Silla Gamer Python Roja;ACCESORIOS
18381231;;F;29;CHILENO;;Millenial;VALPARAISO                    ;VALPARAISO;22990;1;1;0;0;0;1;1;22990;AUDIFONO MOTO BUDBS 100 TRUE WIRELESS WHITE;ACCESORIOS
16650051;;F;35;CHILENO;;Millenial;PROVIDENCIA                   ;METROPOLITANA;22990;1;1;0;0;0;1;1;22990;AUDIFONO MOTO BUDBS 100 TRUE WIRELESS BLACK;ACCESORIOS
11598359;;M;51;CHILENO;;X;CALBUCO                       ;LOS LAGOS;20990;1;1;0;0;0;1;1;20990;PARLANTE KARAOKE MGGLADIATOR NEGRO;ACCESORIOS
13593424;;F;43;CHILENO;;X;ANCUD                         ;LOS LAGOS;14990;1;1;1;1;14990;0;0;0;SOPORTE TV 14-42 KTAM02 KIOTO C/ BRAZO MOVIL;ACCESORIOS
11680880;;F;51;CHILENO;;X;PROVIDENCIA                   ;METROPOLITANA;19990;1;1;0;0;0;1;1;19990;PARLANTE KARAOKE MGGLADIATOR NEGRO;ACCESORIOS
16763064;;M;33;CHILENO;;Millenial;CONCEPCION                    ;BIO BIO;189990;1;1;0;0;0;1;1;189990;Galaxy Watch Active4 40 mm Black;ACCESORIOS
12414433;;M;49;CHILENO;;X;RENCA                         ;METROPOLITANA;34990;1;1;0;0;0;1;1;34990;SMARTBAND XIAOMI MI BAND 5 NEGRO;ACCESORIOS
25658557;;M;30;VENEZOLANO;;Extranjero;"";"";21990;1;1;0;0;0;1;1;21990;3-PACK AMPOLLETA SMART MULTICOLOR;ACCESORIOS
20120042;;M;23;CHILENO;;Silencioso;PROVIDENCIA                   ;METROPOLITANA;23980;2;1;2;1;23980;0;0;0;Mouse G203 LIGHTSYNC Gaming - BLACK;ACCESORIOS
14312691;Soltero;M;46;CHILENO;;X;PROVIDENCIA                   ;METROPOLITANA;7990;1;1;0;0;0;1;1;7990;SOPORTE TV 26-56 KTA02 KIOTO FIJO;ACCESORIOS
19797583;;M;24;CHILENO;;Z;PROVIDENCIA                   ;METROPOLITANA;32990;1;1;1;1;32990;0;0;0;HONOR TRUE WIRELESS STEREO EARBUDS;ACCESORIOS
19896688;;M;23;CHILENO;;Z;PROVIDENCIA                   ;METROPOLITANA;6990;1;1;0;0;0;1;1;6990;MOUSE HP Z3700 Black WIRELESS;ACCESORIOS
19599217;;M;25;CHILENO;;Z;PENCO                         ;BIO BIO;85840;2;1;2;1;85840;0;0;0;AUDIFONO GALAXY BUDS LIVE NEGRO;ACCESORIOS
10125917;;F;57;CHILENO;;Boomers;PENAFLOR                      ;METROPOLITANA;109990;1;1;1;1;109990;0;0;0;Smartwatch GT 2 BLACK;ACCESORIOS
19876233;;F;23;CHILENO;;Z;N/D;N/D;20980;2;1;0;0;0;2;1;20980;Headset Gamer Luces RGB;ACCESORIOS
20511682;;F;21;CHILENO;;Z;PROVIDENCIA                   ;METROPOLITANA;5990;1;1;0;0;0;1;1;5990;AUDIFONO IN SAM HS1303C/ MIC NEGRO;ACCESORIOS
13402942;;F;47;CHILENO;;X;"";"";7990;1;1;0;0;0;1;1;7990;AUDIFONO HEADBAND BT BLANCO FIDDLER;ACCESORIOS
18667920;Soltero;F;28;CHILENO;;Silencioso;PROVIDENCIA                   ;METROPOLITANA;233960;4;3;4;3;233960;0;0;0;SMARTWATCH GALAXY WATCH 3 41MM MYSTIC BRONCE;ACCESORIOS
16671684;;F;35;CHILENO;;Millenial;ANTOFAGASTA                   ;ANTOFAGASTA;51980;2;2;0;0;0;2;2;51980;Funda reversible Azul/Negro 14;ACCESORIOS
10130574;;F;58;CHILENO;;Boomers;COLINA                        ;METROPOLITANA;15980;2;1;0;0;0;2;1;15980;AUDIFONO HEADBAND BT NEGRO;ACCESORIOS
18149116;;F;30;CHILENO;;Millenial;VILLA ALEMANA;VALPARAISO;17990;1;1;0;0;0;1;1;17990;AUDIFONO Bluetooth BE7 Azul;ACCESORIOS
15072663;;M;40;CHILENO;;X;RENCA                         ;METROPOLITANA;76940;6;1;0;0;0;6;1;76940;PARLANTE 8247 MLAB SOUNDLAB BLACK;ACCESORIOS
16419042;;F;36;CHILENO;;Millenial;ESTACION CENTRAL              ;METROPOLITANA;34990;1;1;0;0;0;1;1;34990;SMARTBAND XIAOMI MI BAND 5 NEGRO;ACCESORIOS
14191000;;F;41;CHILENO;;X;N/D;N/D;202970;3;2;0;0;0;3;2;202970;AUDIFONO SAMSUNG WIRELESS 103B;ACCESORIOS
15773217;;F;37;CHILENO;;Millenial;RENCA                         ;METROPOLITANA;246060;3;2;0;0;0;3;2;246060;SOPORTE TV 26-56 KTAT02 KIOTO MOVIL;ACCESORIOS
11417297;;F;54;CHILENO;;Boomers;ALTO HOSPICIO;TARAPACA;19990;1;1;0;0;0;1;1;19990;AUDIFONO XIAOMI EARBUDS MI TRUE WIRELESS BASIC 2;ACCESORIOS
18403959;;F;28;CHILENO;;Millenial;N/D;N/D;54640;2;1;2;1;54640;0;0;0;BAND 6 BLACK HUAWEI;ACCESORIOS
11201738;;F;55;CHILENO;;Boomers;RENCA                         ;METROPOLITANA;13990;1;1;0;0;0;1;1;13990;AUDIFONO SAMSUNG WIRELESS A08C;ACCESORIOS
15394440;;M;39;CHILENO;;X;N/D;N/D;194460;4;2;0;0;0;4;2;194460;SMARTBAND SAMSUNG GALAXY FIT 2 NEGRO;ACCESORIOS
9061687;Soltero;F;61;CHILENO;;Boomers;RENCA                         ;METROPOLITANA;9950;5;1;0;0;0;5;1;9950;AUDIFONO IN SAM HS1303C/ MIC BLANCO;ACCESORIOS
15423760;;M;39;CHILENO;;X;MAIPU                         ;METROPOLITANA;2990;1;1;0;0;0;1;1;2990;AUDIFONO PANASONIC IN RP-HV096E-K NEGRO;ACCESORIOS
12597822;;M;47;CHILENO;;X;MONTE PATRIA                  ;COQUIMBO;29990;1;1;0;0;0;1;1;29990;AUDIFONO SAMSUNG WIRELESS 103B;ACCESORIOS
27238612;;M;50;VENEZOLANO;;Extranjero;N/D;N/D;9980;2;1;2;1;9980;0;0;0;MEMORIA MICROSD CLASE 10 32GB SANDISK;ACCESORIOS
15008517;;F;39;CHILENO;;Silencioso;PROVIDENCIA                   ;METROPOLITANA;30980;2;1;2;1;30980;0;0;0;EXPRESS MOD 3930 PURPLE;ACCESORIOS
15493475;;F;39;CHILENO;;X;CASTRO                        ;LOS LAGOS;120970;3;4;0;0;0;3;4;120970;DISCO DURO CANVIO 2TB BASICS BLACK TOSHIBA;ACCESORIOS
8722468;;M;62;CHILENO;;Boomers;PROVIDENCIA                   ;METROPOLITANA;33980;2;2;0;0;0;2;2;33980;SOPORTE TV 26-56 KTAT02 KIOTO MOVIL;ACCESORIOS
19141705;;M;27;CHILENO;;Silencioso;PROVIDENCIA                   ;METROPOLITANA;185970;3;2;0;0;0;3;2;185970;SOPORTE TV 26-56 KTA02 KIOTO FIJO;ACCESORIOS
20210726;;M;23;CHILENO;;Silencioso;PROVIDENCIA                   ;METROPOLITANA;104540;2;1;2;1;104540;0;0;0;Smartwatch GT 2 BLACK;ACCESORIOS
17087979;;F;33;CHILENO;;Millenial;PROVIDENCIA                   ;METROPOLITANA;44990;1;1;1;1;44990;0;0;0;Disco Portatil Toshiba Canvio Gaming, Negro 1T;ACCESORIOS
16113936;Soltero;M;37;CHILENO;INGENIERO EN ADMINISTRACION DE EMPRESAS;Millenial;PROVIDENCIA                   ;METROPOLITANA;26980;2;1;2;1;26980;0;0;0;PARLANTE KARAOKE MGROCKET NEGRO;ACCESORIOS
13634069;;M;43;CHILENO;;Extranjero;PROVIDENCIA                   ;METROPOLITANA;73980;2;1;2;1;73980;0;0;0;AUDIFONO GALAXY BUDS PLUS NEGRO;ACCESORIOS
4588083;;F;80;CHILENO;;Silencioso;COIHAIQUE                     ;AYSEN;35980;2;1;0;0;0;2;1;35980;AUDIFONO XIAOMI EARBUDS MI TRUE WIRELESS BASIC 2;ACCESORIOS
16823562;;M;35;CHILENO;;Millenial;OSORNO                        ;LOS LAGOS;8990;1;1;0;0;0;1;1;8990;PARLANTE 7284 MLAB ZUKABASS NARAN/VERDE BT;ACCESORIOS
13661306;;M;43;CHILENO;;X;MAIPU                         ;METROPOLITANA;14990;1;1;0;0;0;1;1;14990;Mouse Bluetooth Hdwr Black;ACCESORIOS
16275543;;F;35;CHILENO;;Millenial;PROVIDENCIA                   ;METROPOLITANA;7990;1;1;0;0;0;1;1;7990;SOPORTE TV 26-56 KTA02 KIOTO FIJO;ACCESORIOS
14303495;;M;47;CHILENO;;X;REQUINOA                      ;L.G.B.OÂ´HIGGINS;8140;2;1;0;0;0;2;1;8140;AUDIFONO HEADBAND BT BLANCO FIDDLER;ACCESORIOS
13301553;;F;45;CHILENO;;X;RENCA                         ;METROPOLITANA;3990;1;1;0;0;0;1;1;3990;CABLE DE DATOS MICRO HUAWEI USB AP70;ACCESORIOS
10163471;;M;53;CHILENO;;X;RENCA                         ;METROPOLITANA;11990;1;1;0;0;0;1;1;11990;PARLANTE EXTREM-BASS BLACK 8907;ACCESORIOS
9796933;;F;58;CHILENO;;Boomers;LA FLORIDA                    ;METROPOLITANA;162640;5;3;0;0;0;5;3;162640;DISCO DURO CANVIO 1TB BASICS BLACK TOSHIBA;ACCESORIOS
9944153;Casado;F;58;CHILENO;;Boomers;PROVIDENCIA                   ;METROPOLITANA;24990;1;1;0;0;0;1;1;24990;PARLANTE KARAOKE MGROCKET NEGRO;ACCESORIOS
18872059;;M;27;CHILENO;;Silencioso;PROVIDENCIA                   ;METROPOLITANA;303980;2;1;2;1;303980;0;0;0;Galaxy Watch4 46 mm Black;ACCESORIOS
18909067;;F;27;CHILENO;;Z;ESTACION CENTRAL              ;METROPOLITANA;63980;2;1;2;1;63980;0;0;0;DISCO DURO CANVIO 2TB ADVANCE NEGRO;ACCESORIOS
15820146;;M;38;CHILENO;;X;PENALOLEN;METROPOLITANA;9990;1;1;0;0;0;1;1;9990;MINI PARLANTE BT GO2;ACCESORIOS
10460642;;M;53;CHILENO;;X;RENCA                         ;METROPOLITANA;12990;1;1;0;0;0;1;1;12990;PARLANTE 8531 MLAB MAX BASS BT;ACCESORIOS
15198243;;F;39;CHILENO;;X;N/D;N/D;25970;3;1;0;0;0;3;1;25970;TRAVEL ADAPTER 15W - FAST CHARGER (TYPE-C CABLE);ACCESORIOS
14424837;;F;45;CHILENO;;X;RENCA                         ;METROPOLITANA;7990;1;1;0;0;0;1;1;7990;AUDIFONO IN EX15AP SONY NEGRO;ACCESORIOS
20356263;;M;21;CHILENO;;Silencioso;PROVIDENCIA                   ;METROPOLITANA;11990;1;1;1;1;11990;0;0;0;PARLANTE EXTREM-BASS BLACK 8907;ACCESORIOS
14125715;;M;41;CHILENO;;X;PUENTE ALTO                   ;METROPOLITANA;6990;1;1;0;0;0;1;1;6990;AUDIFONO IN EX15LP SONY NEG;ACCESORIOS
13354175;;M;44;CHILENO;;X;CONSTITUCION                  ;MAULE;30980;2;2;0;0;0;2;2;30980;Mi In-Ear Headphones Basic (Black) XIAOMI;ACCESORIOS
17616930;Soltero;M;30;CHILENO;ENFERMERO;Millenial;PROVIDENCIA                   ;METROPOLITANA;20840;2;1;2;1;20840;0;0;0;BATERY PACK TIPO C 10.000 MAH SAMSUNG;ACCESORIOS
13785791;;M;42;CHILENO;;X;RENCA                         ;METROPOLITANA;15990;1;1;0;0;0;1;1;15990;PARLANTE KARAOKE MGPANTERA NEGRO;ACCESORIOS
7729280;;M;61;CHILENO;;Boomers;SAN FELIPE                    ;VALPARAISO;354979;2;1;0;0;0;2;1;354979;GALAXY WATCH ACTIVE4 40 MM SILVER;ACCESORIOS
19198581;;F;26;CHILENO;;Z;N/D;N/D;117870;2;1;0;0;0;2;1;117870;SMARTWATCH HUAWEI WATCH FIT BLACK;ACCESORIOS
9426962;;F;58;CHILENO;;Boomers;RENCA                         ;METROPOLITANA;24980;2;1;2;1;24980;0;0;0;SOPORTE TV 14-63 CON BRAZO KT-FM 3L;ACCESORIOS
14283641;;M;48;CHILENO;;X;RENCA                         ;METROPOLITANA;4990;1;1;0;0;0;1;1;4990;AUDIFONO IN E9LP SONY BZ NEGRO;ACCESORIOS
12970416;;M;45;CHILENO;;X;LO PRADO                      ;METROPOLITANA;18990;1;1;0;0;0;1;1;18990;20000mAh Redmi 18W Fast Charge Power Bank Black;ACCESORIOS
18184080;;M;29;CHILENO;;Millenial;N/D;N/D;19990;1;1;0;0;0;1;1;19990;AUDIFONO ON ZX310AP NEGRO;ACCESORIOS
15091850;;F;43;CHILENO;;X;CALLE LARGA                   ;VALPARAISO;25980;2;1;0;0;0;2;1;25980;MLAB KARAOKE OUTDOOR FUN GREEN 8564;ACCESORIOS
19983919;;M;23;CHILENO;;Z;N/D;N/D;1690;1;1;0;0;0;1;1;1690;AUDIFONO PANASONIC IN RP-HV096E-K NEGRO;ACCESORIOS
24290665;;M;33;COLOMBIANO;;Extranjero;MELIPILLA                     ;METROPOLITANA;7990;1;1;0;0;0;1;1;7990;SOPORTE TV 26-56 KTA02 KIOTO FIJO;ACCESORIOS
20194116;;F;23;CHILENO;;Z;N/D;N/D;18990;1;1;0;0;0;1;1;18990;PARLANTE KARAOKE MGGLADIATOR NEGRO;ACCESORIOS
19205136;;M;26;CHILENO;;Z;"";"";21990;1;1;0;0;0;1;1;21990;KIT PREPAGO HD DIRECTV;ACCESORIOS
12927943;;F;47;CHILENO;;Silencioso;PROVIDENCIA                   ;METROPOLITANA;5990;1;1;0;0;0;1;1;5990;Mi In-Ear Headphones Basic (Black) XIAOMI;ACCESORIOS
19463902;;F;26;CHILENO;;Z;PERQUENCO                     ;ARAUCANIA;8990;1;1;0;0;0;1;1;8990;AUDIFONO IN SAM FIT EG920 BLANCO;ACCESORIOS
13311298;;F;45;CHILENO;;Silencioso;PROVIDENCIA                   ;METROPOLITANA;12990;1;1;0;0;0;1;1;12990;PARLANTE ZUKABASS + MICROFONO MLAB BT;ACCESORIOS
16442726;;F;35;CHILENO;;Millenial;LA SERENA                     ;COQUIMBO;18990;1;1;0;0;0;1;1;18990;PARLANTE KARAOKE MGGLADIATOR NEGRO;ACCESORIOS
19648811;;M;25;CHILENO;;Silencioso;PROVIDENCIA                   ;METROPOLITANA;23980;2;1;2;1;23980;0;0;0;BAND 4 BLACK;ACCESORIOS
19509427;;F;25;CHILENO;;Z;N/D;N/D;109980;2;2;0;0;0;2;2;109980;PARLANTE PL5 XBOOM GO BLUETHOOH 2020;ACCESORIOS
15745231;;M;38;CHILENO;;Millenial;VALLENAR;ATACAMA;368640;2;1;2;1;368640;0;0;0;Galaxy Watch4 46 mm Black;ACCESORIOS
17396554;;M;32;CHILENO;;Millenial;N/D;N/D;94990;1;1;1;1;94990;0;0;0;MI WATCH NEGRO XIAOMI;ACCESORIOS
17469851;;F;32;CHILENO;;Millenial;"";"";7990;1;1;0;0;0;1;1;7990;Audifonos Orejas De Gato Rosado;ACCESORIOS
13772737;;M;41;CHILENO;;X;MELIPILLA                     ;METROPOLITANA;18990;1;1;0;0;0;1;1;18990;PARLANTE KARAOKE MGGLADIATOR NEGRO;ACCESORIOS
10827337;;M;54;CHILENO;;X;VINA DEL MAR                  ;VALPARAISO;18990;1;1;0;0;0;1;1;18990;PARLANTE KARAOKE MGGLADIATOR NEGRO;ACCESORIOS
16205740;;F;36;CHILENO;;Millenial;PROVIDENCIA                   ;METROPOLITANA;48980;2;1;2;1;48980;0;0;0;BAND 6 PINK HUAWEI;ACCESORIOS
19032770;;M;27;CHILENO;;Z;N/D;N/D;53540;2;1;2;1;53540;0;0;0;BAND 6 PINK HUAWEI;ACCESORIOS
10195881;Casado;F;56;CHILENO;;Boomers;RENCA                         ;METROPOLITANA;0;0;0;0;0;0;0;0;0;AUDIFONO IN SAM HS1303C/ MIC NEGRO;ACCESORIOS
17127024;;F;36;CHILENO;;Millenial;PAILLACO                      ;LOS RIOS;0;0;0;0;0;0;0;0;0;AUDIFONO IN SAM HS1303C/ MIC NEGRO;ACCESORIOS
16190072;;F;37;CHILENO;;Millenial;SANTA CRUZ;O HIGGINS;0;0;0;0;0;0;0;0;0;TRAVEL ADAPTER 15W - FAST CHARGER (TYPE-C CABLE);ACCESORIOS
4478538;;M;70;CHILENO;;Silencioso;OSORNO                        ;LOS LAGOS;0;0;0;0;0;0;0;0;0;MOUSE X200 Inalambrico NEGRO;ACCESORIOS
15219544;;M;38;CHILENO;;X;N/D;N/D;0;0;0;0;0;0;0;0;0;AUDIFONO PANASONIC IN RP-HV096E-K NEGRO;ACCESORIOS
18817156;;F;27;CHILENO;;Z;N/D;N/D;0;0;0;0;0;0;0;0;0;AUDIFONO IN EX15LP SONY NEG;ACCESORIOS
12091887;;M;53;CHILENO;;X;SAN CLEMENTE                  ;MAULE;0;0;0;0;0;0;0;0;0;SOPORTE TV 26-56 KTA02 KIOTO FIJO;ACCESORIOS
19141171;;M;28;CHILENO;;Millenial;PROVIDENCIA                   ;METROPOLITANA;0;0;0;0;0;0;0;0;0;MI Bluetooth Speaker (16W) BLUE;ACCESORIOS
14031170;;M;41;CHILENO;;X;PROVIDENCIA                   ;METROPOLITANA;0;0;0;0;0;0;0;0;0;PARLANTE 8247 MLAB SOUNDLAB BLACK;ACCESORIOS
19257080;;M;26;CHILENO;;Z;PROVIDENCIA                   ;METROPOLITANA;0;0;0;0;0;0;0;0;0;BATERY PACK TIPO C 10.000 MAH SAMSUNG;ACCESORIOS
19898469;;M;23;CHILENO;;Z;PROVIDENCIA                   ;METROPOLITANA;0;0;0;0;0;0;0;0;0;HONOR TRUE WIRELESS STEREO EARBUDS;ACCESORIOS
18659642;;M;28;CHILENO;;Millenial;VINA DEL MAR                  ;VALPARAISO;0;0;0;0;0;0;0;0;0;SOPORTE TV 14-63 CON BRAZO KT-FM 3L;ACCESORIOS
19267134;;F;26;CHILENO;;Z;PROVIDENCIA                   ;METROPOLITANA;0;0;0;0;0;0;0;0;0;MOUSE 300 Dual Mode BLACK;ACCESORIOS
15291247;;F;40;CHILENO;;X;DALCAHUE                      ;LOS LAGOS;0;0;0;0;0;0;0;0;0;Mouse 200 Silver Wireless;ACCESORIOS
11990235;;F;49;CHILENO;;X;SAN FELIPE                    ;VALPARAISO;0;0;0;0;0;0;0;0;0;AUDIFONO IN SONY BT WI-C200 BLACK;ACCESORIOS
20112277;;F;23;CHILENO;;Silencioso;PROVIDENCIA                   ;METROPOLITANA;0;0;0;0;0;0;0;0;0;HUAWEI AUDIFONOS MANOS LIBRES AM116;ACCESORIOS
10865164;;F;53;CHILENO;;X;LOS ALAMOS                    ;BIO BIO;0;0;0;0;0;0;0;0;0;SOPORTE TV 26-56 KTA02 KIOTO FIJO;ACCESORIOS
8198230;Casado;F;51;CHILENO;;X;RENCA                         ;METROPOLITANA;0;0;0;0;0;0;0;0;0;20000mAh Redmi 18W Fast Charge Power Bank Black;ACCESORIOS
16685987;;F;35;CHILENO;;Millenial;RENCA                         ;METROPOLITANA;0;0;0;0;0;0;0;0;0;BATERY PACK TIPO C 10.000 MAH SAMSUNG;ACCESORIOS
13070022;;M;46;CHILENO;;X;RENCA                         ;METROPOLITANA;0;0;0;0;0;0;0;0;0;PARLANTE PL7 XBOOM GO BLUETHOOH 2020;ACCESORIOS
12707725;;F;52;CHILENO;;X;RENCA                         ;METROPOLITANA;0;0;0;0;0;0;0;0;0;PARLANTE KARAOKE MGGLADIATOR NEGRO;ACCESORIOS
20079658;;M;24;CHILENO;;Z;PROVIDENCIA                   ;METROPOLITANA;0;0;0;0;0;0;0;0;0;AUDIFONO IN SAM FIT EG920 BLANCO;ACCESORIOS
19642850;;F;24;CHILENO;;Z;QUINTERO                      ;VALPARAISO;0;0;0;0;0;0;0;0;0;RADIO RETRO ANTIQUE 8732;ACCESORIOS
11516688;;F;52;CHILENO;;X;SAN FELIPE                    ;VALPARAISO;0;0;0;0;0;0;0;0;0;PARLANTE GO 2 BLUETOOTH AZUL;ACCESORIOS
19011415;;F;26;CHILENO;;Z;PROVIDENCIA                   ;METROPOLITANA;0;0;0;0;0;0;0;0;0;PARLANTE ZUKABASS 4 BT USB/SD/FM CALACAS;ACCESORIOS
18028941;;F;29;CHILENO;;Millenial;CONSTITUCION                  ;MAULE;0;0;0;0;0;0;0;0;0;PARLANTE 8531 MLAB MAX BASS BT;ACCESORIOS
19414313;;M;26;CHILENO;;Silencioso;PROVIDENCIA                   ;METROPOLITANA;0;0;0;0;0;0;0;0;0;AUDIFONO ON ZX310AP NEGRO;ACCESORIOS
19288310;;F;27;CHILENO;;Silencioso;PROVIDENCIA                   ;METROPOLITANA;0;0;0;0;0;0;0;0;0;PARLANTE 8247 MLAB SOUNDLAB BLACK;ACCESORIOS
16290766;;F;36;CHILENO;;Millenial;MARIA PINTO                   ;METROPOLITANA;0;0;0;0;0;0;0;0;0;PARLANTE ZUKABASS + MICROFONO MLAB BT ROJO;ACCESORIOS
24893014;;F;46;BOLIVIANO;;Extranjero;PROVIDENCIA                   ;METROPOLITANA;0;0;0;0;0;0;0;0;0;AUDIFONO MLAB TWS FULLY WIRELESSÂ  WHITE 8721;ACCESORIOS
19017069;;M;27;CHILENO;;Millenial;ANGOL                         ;ARAUCANIA;0;0;0;0;0;0;0;0;0;SMARTWATCH HUAWEI BAND 4E ACTIVE BLACK;ACCESORIOS
8198823;Soltero;M;49;CHILENO;;X;RENCA                         ;METROPOLITANA;0;0;0;0;0;0;0;0;0;AUDIFONO ON SONY ZX110 BLANCO;ACCESORIOS
15461979;;F;39;CHILENO;;X;N/D;N/D;0;0;0;0;0;0;0;0;0;AUDIFONO IN SAM HS1303C/ MIC BLANCO;ACCESORIOS
15495361;;M;39;CHILENO;;X;RENAICO                       ;ARAUCANIA;0;0;0;0;0;0;0;0;0;KARAOKE MINI MY LIL FIRST SING CON MIC CABLE RED;ACCESORIOS
17466924;;M;31;CHILENO;;Millenial;CASTRO                        ;LOS LAGOS;0;0;0;0;0;0;0;0;0;SOPORTE TV 32-65 KTA03 KIOTO FIJO;ACCESORIOS
18163163;Soltero;M;29;CHILENO;PROFESOR;Silencioso;PROVIDENCIA                   ;METROPOLITANA;0;0;0;0;0;0;0;0;0;ESTUCHE FUELLE FROZEN TOYS;ACCESORIOS
10037269;;M;53;CHILENO;;X;SANTIAGO                      ;METROPOLITANA;0;0;0;0;0;0;0;0;0;PARLANTE 8247 MLAB SOUNDLAB BLACK;ACCESORIOS
16325149;;F;36;CHILENO;;Millenial;PROVIDENCIA                   ;METROPOLITANA;0;0;0;0;0;0;0;0;0;KIT PREPAGO HD DIRECTV;ACCESORIOS
16772230;;M;34;CHILENO;;Millenial;ARICA                         ;ARICA Y PARINACOTA;0;0;0;0;0;0;0;0;0;DISCO DURO EXTERNO WD BLACK P10 GAME DRIVE 5TB;ACCESORIOS
15231864;;M;40;CHILENO;;X;N/D;N/D;0;0;0;0;0;0;0;0;0;AUDIFONO IN EX15AP SONY NEGRO;ACCESORIOS
9602597;;F;59;CHILENO;;Boomers;PADRE HURTADO                 ;METROPOLITANA;0;0;0;0;0;0;0;0;0;PARLANTE KARAOKE MGPANTERA NEGRO;ACCESORIOS
17286045;;F;32;CHILENO;;Millenial;PROVIDENCIA                   ;METROPOLITANA;0;0;0;0;0;0;0;0;0;PARLANTES SRS-XB12/BC LA;ACCESORIOS
7700787;;F;63;CHILENO;;Boomers;SAN FELIPE                    ;VALPARAISO;0;0;0;0;0;0;0;0;0;SOPORTE TV 14-63 CON BRAZO KT-FM 3L;ACCESORIOS
18141245;;M;29;CHILENO;;Silencioso;PROVIDENCIA                   ;METROPOLITANA;0;0;0;0;0;0;0;0;0;Wired Keyboard Wired 600 MS Negro;ACCESORIOS
16222262;;F;37;CHILENO;;Millenial;PROVIDENCIA                   ;METROPOLITANA;0;0;0;0;0;0;0;0;0;HUAWEI Sport Bluetooth Headphones Lite Black AM6;ACCESORIOS
9722964;;F;60;CHILENO;;Boomers;ANTOFAGASTA                   ;ANTOFAGASTA;0;0;0;0;0;0;0;0;0;PARLANTE KARAOKE FD-PKBT82 8 LUCES MIC/FM/BT/USB;ACCESORIOS
14635481;;F;42;CHILENO;;X;PUERTO MONTT                  ;LOS LAGOS;0;0;0;0;0;0;0;0;0;AUDIFONO IN SAM C/ MIC EG920 BLACK;ACCESORIOS
14564837;;F;40;CHILENO;;X;SAN BERNARDO                  ;METROPOLITANA;0;0;0;0;0;0;0;0;0;AUDIFONO PANASONIC IN RP-HV096E-K NEGRO;ACCESORIOS
19571808;Soltero;F;25;CHILENO;PROFESOR;Silencioso;PROVIDENCIA                   ;METROPOLITANA;0;0;0;0;0;0;0;0;0;AUDIFONO XIAOMI EARBUDS MI TRUE WIRELESS BASIC 2;ACCESORIOS
13664452;;M;43;CHILENO;;X;PROVIDENCIA                   ;METROPOLITANA;0;0;0;0;0;0;0;0;0;AUDIFONO IN GALAXI BUDS;ACCESORIOS
10558151;;F;56;CHILENO;;Boomers;PROVIDENCIA                   ;METROPOLITANA;0;0;0;0;0;0;0;0;0;AUDIFONO IN PANASONIC RP-TCM130PPW BLANCO;ACCESORIOS
9657960;;M;55;CHILENO;;Boomers;RENCA                         ;METROPOLITANA;0;0;0;0;0;0;0;0;0;PARLANTE KARAOKE MGPANTERA NEGRO;ACCESORIOS
15169212;;M;37;CHILENO;;Millenial;CHILLAN                       ;BIO BIO;0;0;0;0;0;0;0;0;0;KARAOKE MINI MY LIL FIRST SING CON MIC CABLE RED;ACCESORIOS
18621648;Soltero;M;33;CHILENO;;Millenial;PROVIDENCIA                   ;METROPOLITANA;0;0;0;0;0;0;0;0;0;AUDIFONO IN EX15LP SONY NEG;ACCESORIOS
18990700;;F;27;CHILENO;;Millenial;LA REINA                      ;METROPOLITANA;0;0;0;0;0;0;0;0;0;AUDIFONO SAMSUNG WIRELESS A08C;ACCESORIOS
9836029;;M;51;CHILENO;;X;RENCA                         ;METROPOLITANA;0;0;0;0;0;0;0;0;0;Smartwatch GT 2 BLACK;ACCESORIOS
13785834;;M;42;CHILENO;;X;CONSTITUCION                  ;MAULE;0;0;0;0;0;0;0;0;0;AUDIFONO TWS FULLY WIRELESS 8873;ACCESORIOS
13208394;;F;44;CHILENO;;X;"";"";0;0;0;0;0;0;0;0;0;DISCO DURO CANVIO 2TB BASICS BLACK TOSHIBA;ACCESORIOS
18063205;;F;30;CHILENO;;Millenial;VILLA ALEMANA                 ;VALPARAISO;0;0;0;0;0;0;0;0;0;Kit gamer 3 en 1;ACCESORIOS
18984349;Soltero;F;27;CHILENO;;Millenial;PROVIDENCIA                   ;METROPOLITANA;0;0;0;0;0;0;0;0;0;AUDIFONO ON ZX310AP ROJO;ACCESORIOS
16869543;;F;34;CHILENO;;Millenial;SAN VICENTE;O HIGGINS;0;0;0;0;0;0;0;0;0;Smartwatch GT 2 BLACK;ACCESORIOS
13001054;Casado;M;46;CHILENO;;X;PROVIDENCIA                   ;METROPOLITANA;0;0;0;0;0;0;0;0;0;DISCO DURO CANVIO 2TB BASICS BLACK TOSHIBA;ACCESORIOS
19439948;;M;25;CHILENO;;Z;PROVIDENCIA                   ;METROPOLITANA;0;0;0;0;0;0;0;0;0;Kit gamer 3 en 1;ACCESORIOS
19380937;;F;25;CHILENO;;Z;N/D;N/D;0;0;0;0;0;0;0;0;0;PARLANTE 8247 MLAB SOUNDLAB BLACK;ACCESORIOS
16398361;;M;36;CHILENO;;Millenial;"";"";0;0;0;0;0;0;0;0;0;AUDIFONO XIAOMI EARBUDS MI TRUE WIRELESS BASIC 2;ACCESORIOS
19870819;;M;23;CHILENO;;Silencioso;PROVIDENCIA                   ;METROPOLITANA;0;0;0;0;0;0;0;0;0;Smartwatch GT 2 BLACK;ACCESORIOS
19531533;Soltero;F;25;CHILENO;;Z;PROVIDENCIA                   ;METROPOLITANA;0;0;0;0;0;0;0;0;0;AUDIFONO IN SAM HS1303C/ MIC NEGRO;ACCESORIOS
10719771;;M;55;CHILENO;;Boomers;SAN BERNARDO                  ;METROPOLITANA;0;0;0;0;0;0;0;0;0;AUDIFONO ON ZX110 SONY NEGRO;ACCESORIOS
17910021;;F;29;CHILENO;;Millenial;PROVIDENCIA                   ;METROPOLITANA;0;0;0;0;0;0;0;0;0;KIT PREPAGO HD DIRECTV;ACCESORIOS
19656412;Soltero;M;27;CHILENO;TECNICO EN MANTENIMIENTO INDUSTRIAL;Millenial;PROVIDENCIA                   ;METROPOLITANA;0;0;0;0;0;0;0;0;0;AUDIFONO BLUETOOTH RP-HF410BPUA BT 24HRS AZUL;ACCESORIOS
8966019;;F;61;CHILENO;;Boomers;PENCO                         ;BIO BIO;0;0;0;0;0;0;0;0;0;AUDIFONO ON ZX310AP NEGRO;ACCESORIOS
27218362;;M;51;EXTRANJERO - NO INFORMA NACIONALIDAD;;Extranjero;N/D;N/D;0;0;0;0;0;0;0;0;0;MI WATCH LITE NEGRO XIAOMI;ACCESORIOS
16951231;;F;34;CHILENO;;Millenial;MAIPU                         ;METROPOLITANA;0;0;0;0;0;0;0;0;0;RADIO RETRO MINI WOOGIE 8751;ACCESORIOS
16476905;Soltero;M;35;CHILENO;;Silencioso;PROVIDENCIA                   ;METROPOLITANA;0;0;0;0;0;0;0;0;0;Smartwatch ACTIVE 1 NEGRO;ACCESORIOS
19749483;;F;24;CHILENO;;Z;N/D;N/D;0;0;0;0;0;0;0;0;0;SMARTWATCH HUAWEI BAND 4E ACTIVE MINERAL RED;ACCESORIOS
19856990;;F;24;CHILENO;;Z;N/D;N/D;0;0;0;0;0;0;0;0;0;SOPORTE TV 14-63 CON BRAZO KT-FM 3L;ACCESORIOS
17081484;;M;33;CHILENO;;Silencioso;PROVIDENCIA                   ;METROPOLITANA;0;0;0;0;0;0;0;0;0;Silla Gamer New Borealis Blanca - Azul;ACCESORIOS
13968630;;F;41;CHILENO;;X;N/D;N/D;0;0;0;0;0;0;0;0;0;SOPORTE TV 32-65 KTA03 KIOTO FIJO;ACCESORIOS
17607591;;F;32;CHILENO;;Millenial;N/D;N/D;0;0;0;0;0;0;0;0;0;AUDIFONO IN SONY BT WI-C200 WHITE;ACCESORIOS
19045668;Soltero;M;27;CHILENO;;Z;PROVIDENCIA                   ;METROPOLITANA;0;0;0;0;0;0;0;0;0;AUDIFONO MLAB TWS IN-AIR WHITE 8533;ACCESORIOS
19497090;Soltero;F;25;CHILENO;NUTRICIONISTA;Z;PROVIDENCIA                   ;METROPOLITANA;0;0;0;0;0;0;0;0;0;Smartwatch ACTIVE 1 DORADO;ACCESORIOS
18595550;;M;29;CHILENO;;Silencioso;PROVIDENCIA                   ;METROPOLITANA;0;0;0;0;0;0;0;0;0;Kit gamer 3 en 1;ACCESORIOS
20309109;;F;22;CHILENO;;Z;PROVIDENCIA                   ;METROPOLITANA;0;0;0;0;0;0;0;0;0;TRAVEL ADAPTER 15W - FAST CHARGER (TYPE-C CABLE);ACCESORIOS
14138561;;F;41;CHILENO;;Silencioso;PROVIDENCIA                   ;METROPOLITANA;0;0;0;0;0;0;0;0;0;Kit gamer 3 en 1;ACCESORIOS
17987191;;M;30;CHILENO;;Millenial;MARIA PINTO                   ;METROPOLITANA;0;0;0;0;0;0;0;0;0;PARLANTE ZUKABASS + MICROFONO MLAB BT ROJO;ACCESORIOS
16649150;;F;34;CHILENO;;Millenial;TENO                          ;MAULE;0;0;0;0;0;0;0;0;0;MOUSE HP Z3700 SILVER WIRELESS;ACCESORIOS
20032633;;M;23;CHILENO;;Z;PROVIDENCIA                   ;METROPOLITANA;0;0;0;0;0;0;0;0;0;MEMORIA MICROSD CLASE 10 32GB SANDISK;ACCESORIOS
18537025;Soltero;F;29;CHILENO;QUIMICO FARMACEUTICO;Millenial;PROVIDENCIA                   ;METROPOLITANA;0;0;0;0;0;0;0;0;0;AUDIFONO GALAXY BUDS PLUS NEGRO;ACCESORIOS
16536160;Soltero;M;39;CHILENO;;Silencioso;PROVIDENCIA                   ;METROPOLITANA;0;0;0;0;0;0;0;0;0;MOCHILA DENVER 19 MELANGE BURDEO;ACCESORIOS
15173270;;M;40;CHILENO;;X;N/D;N/D;0;0;0;0;0;0;0;0;0;HUAWEI Sport Bluetooth Headphones Lite Black AM6;ACCESORIOS
19300892;;F;26;CHILENO;;Millenial;N/D;N/D;0;0;0;0;0;0;0;0;0;AUDIFONO IN SAM HS1303C/ MIC ROSADO;ACCESORIOS
13750914;;M;42;CHILENO;;X;N/D;N/D;0;0;0;0;0;0;0;0;0;PARLANTE GO 2 BLUETOOTH ROJO;ACCESORIOS
17601270;Soltero;M;31;CHILENO;TECNOLOGO MEDICO;Silencioso;PROVIDENCIA                   ;METROPOLITANA;0;0;0;0;0;0;0;0;0;AUDIFONO GALAXY BUDS PLUS NEGRO;ACCESORIOS
16031297;;M;37;CHILENO;;Millenial;PROVIDENCIA                   ;METROPOLITANA;0;0;0;0;0;0;0;0;0;Smartwatch ACTIVE 1 DORADO;ACCESORIOS
19089866;Soltero;F;26;CHILENO;;Z;PROVIDENCIA                   ;METROPOLITANA;0;0;0;0;0;0;0;0;0;AUDIFONO IN SAM HS1303C/ MIC AZUL;ACCESORIOS
13609600;;F;43;CHILENO;;Silencioso;PROVIDENCIA                   ;METROPOLITANA;0;0;0;0;0;0;0;0;0;APPLE PENCIL 2ND GEN- (MU8F2AM/A);ACCESORIOS
19819522;;F;24;CHILENO;;Silencioso;PROVIDENCIA                   ;METROPOLITANA;0;0;0;0;0;0;0;0;0;Audifonos Huawei Headphones Lite Silver;ACCESORIOS
9371392;;F;62;CHILENO;;Boomers;RENCA                         ;METROPOLITANA;0;0;0;0;0;0;0;0;0;AUDIFONO IN SONY BT WI-C200 WHITE;ACCESORIOS
15269274;;F;40;CHILENO;;X;N/D;N/D;0;0;0;0;0;0;0;0;0;AUDIFONO BLUETOOTH RP-HF410BPUA BT 24HRS AZUL;ACCESORIOS
12108394;Soltero;M;40;CHILENO;BIOQUIMICO;X;PROVIDENCIA                   ;METROPOLITANA;0;0;0;0;0;0;0;0;0;MEMORIA MICROSD CLASE 10 64GB SANDISK;ACCESORIOS
16519440;;F;35;CHILENO;;Millenial;PENAFLOR                      ;METROPOLITANA;0;0;0;0;0;0;0;0;0;DISCO DURO EXTERNO WD BLACK P10 GAME DRIVE 5TB;ACCESORIOS
5203402;;M;75;CHILENO;;Silencioso;NATALES                       ;MAGALLANES;0;0;0;0;0;0;0;0;0;PARLANTE GBASS MICRO;ACCESORIOS
15089141;;M;39;CHILENO;;Silencioso;PROVIDENCIA                   ;METROPOLITANA;0;0;0;0;0;0;0;0;0;Mouse G203 LIGHTSYNC Gaming - BLACK;ACCESORIOS
16816073;;M;34;CHILENO;;Silencioso;PROVIDENCIA                   ;METROPOLITANA;0;0;0;0;0;0;0;0;0;DISCO DURO CANVIO 2TB BASICS BLACK TOSHIBA;ACCESORIOS
8030404;;M;60;CHILENO;;Boomers;EL BOSQUE                     ;METROPOLITANA;0;0;0;0;0;0;0;0;0;TRAVEL ADAPTER 15W - FAST CHARGER (TYPE-C CABLE);ACCESORIOS
18079891;Soltero;M;30;CHILENO;;Millenial;PROVIDENCIA                   ;METROPOLITANA;0;0;0;0;0;0;0;0;0;True Wireless Philips TAT1215 6+12 Hrs Negro;ACCESORIOS
14134890;;F;41;CHILENO;;X;PROVIDENCIA                   ;METROPOLITANA;0;0;0;0;0;0;0;0;0;AUDIFONO IN PANASONIC RP-TCM130PPW BLANCO;ACCESORIOS
8386260;Casado;F;65;CHILENO;;Boomers;RENCA                         ;METROPOLITANA;0;0;0;0;0;0;0;0;0;MOUSE 300 Dual Mode BLACK;ACCESORIOS
20121661;;M;23;CHILENO;;Z;SANTIAGO;METROPOLITANA;0;0;0;0;0;0;0;0;0;BAND 4 PRO BLACK;ACCESORIOS
16558099;;F;34;CHILENO;;Millenial;"";"";0;0;0;0;0;0;0;0;0;AUDIFONO PANASONIC IN RP-HV096E-K NEGRO;ACCESORIOS
18125501;;F;39;CHILENO;;X;IQUIQUE                       ;TARAPACA;0;0;0;0;0;0;0;0;0;APPLE WATCH SERIE 3 38MM SILVER;ACCESORIOS
12843505;;F;47;CHILENO;;X;RENCA                         ;METROPOLITANA;0;0;0;0;0;0;0;0;0;HUAWEI FREEBUDS 3I BLANCOS;ACCESORIOS
16961086;;F;34;CHILENO;;Millenial;MAIPU                         ;METROPOLITANA;0;0;0;0;0;0;0;0;0;Smartwatch ACTIVE 1 VERDE;ACCESORIOS
5003425;;M;78;CHILENO;;Silencioso;IQUIQUE                       ;TARAPACA;0;0;0;0;0;0;0;0;0;AUDIFONO BLUETOOTH RP-HF410BPUA BT 24HRS AZUL;ACCESORIOS
18531484;;M;28;CHILENO;;Millenial;LA FLORIDA                    ;METROPOLITANA;0;0;0;0;0;0;0;0;0;CABLE DE DATOS USB TIPO C HUAWEI SUPER CHARGER A;ACCESORIOS
12915890;;M;47;CHILENO;;X;RENCA                         ;METROPOLITANA;0;0;0;0;0;0;0;0;0;SMARTWATCH HUAWEI WATCH FIT BLACK;ACCESORIOS
12898272;;F;47;CHILENO;;X;PENALOLEN                     ;METROPOLITANA;0;0;0;0;0;0;0;0;0;AUDIFONO PANASONIC IN RP-HV096E-K NEGRO;ACCESORIOS
14018206;Soltero;F;41;CHILENO;INGENIERO CIVIL INDUSTRIAL;X;RENCA                         ;METROPOLITANA;0;0;0;0;0;0;0;0;0;BAND 4 PRO BLACK;ACCESORIOS
16833239;;M;34;CHILENO;;Millenial;N/D;N/D;0;0;0;0;0;0;0;0;0;AUDIFONO MLAB TWS IN-AIR WHITE 8533;ACCESORIOS
20267911;;F;22;CHILENO;;Silencioso;PROVIDENCIA                   ;METROPOLITANA;0;0;0;0;0;0;0;0;0;MOUSE MICROSOFT Wireless Mbl 1850 Blue;ACCESORIOS
17598459;Soltero;M;32;CHILENO;;Silencioso;PROVIDENCIA                   ;METROPOLITANA;0;0;0;0;0;0;0;0;0;Speaker X50 Logitech Naranjo;ACCESORIOS
17410721;;M;32;CHILENO;;Millenial;CAUQUENES                     ;MAULE;0;0;0;0;0;0;0;0;0;SOPORTE TV 26-56 KTA02 KIOTO FIJO;ACCESORIOS
19185108;Soltero;M;26;CHILENO;;Z;"";"";0;0;0;0;0;0;0;0;0;AUDIFONO IN SAM FIT EG920 BLANCO;ACCESORIOS
15801950;;F;38;CHILENO;;Millenial;PROVIDENCIA                   ;METROPOLITANA;0;0;0;0;0;0;0;0;0;AUDIFONO ON ZX110 SONY ROSA;ACCESORIOS
8476662;Soltero;M;62;CHILENO;;Boomers;RENCA                         ;METROPOLITANA;0;0;0;0;0;0;0;0;0;PARLANTE KARAOKE FD-PKBT82 8 LUCES MIC/FM/BT/USB;ACCESORIOS
10308760;;F;55;CHILENO;;Boomers;RENCA                         ;METROPOLITANA;0;0;0;0;0;0;0;0;0;AUDIFONO IN SAM HS1303C/ MIC NEGRO;ACCESORIOS
14261331;;F;48;CHILENO;;X;RENCA                         ;METROPOLITANA;0;0;0;0;0;0;0;0;0;RADIO RETRO MINI WOOGIE 8751;ACCESORIOS
5817101;;F;71;CHILENO;;Silencioso;VINA DEL MAR                  ;VALPARAISO;0;0;0;0;0;0;0;0;0;Mochila 15.6 Travel USB 3 in 1;ACCESORIOS
13284877;;F;45;CHILENO;;Silencioso;PROVIDENCIA                   ;METROPOLITANA;0;0;0;0;0;0;0;0;0;Smartwatch GALAXY WATCH GOLD;ACCESORIOS
16312370;Soltero;F;36;CHILENO;;Millenial;PROVIDENCIA                   ;METROPOLITANA;0;0;0;0;0;0;0;0;0;AUDIFONO IN SAM FIT EG920 BLANCO;ACCESORIOS
14478727;;F;48;CHILENO;;X;RENCA                         ;METROPOLITANA;0;0;0;0;0;0;0;0;0;AUDIFONO ON ZX110 SONY NEGRO;ACCESORIOS
18284197;;M;29;CHILENO;;Millenial;TRAIGUEN                      ;ARAUCANIA;0;0;0;0;0;0;0;0;0;MEMORIA MICROSD CLASE 10 128GB SANDISK;ACCESORIOS
18108579;;M;30;CHILENO;;Millenial;PROVIDENCIA                   ;METROPOLITANA;0;0;0;0;0;0;0;0;0;AUDIFONO IN SAM FIT EG920 BLANCO;ACCESORIOS
8975438;;F;60;CHILENO;;Boomers;CHAITEN                       ;LOS LAGOS;0;0;0;0;0;0;0;0;0;PARLANTE 8531 MLAB MAX BASS BT;ACCESORIOS
14080775;;F;42;CHILENO;;X;RENCA                         ;METROPOLITANA;0;0;0;0;0;0;0;0;0;AUDIFONO MLAB TWS IN-AIR WHITE 8533;ACCESORIOS
6441803;Casado;M;71;CHILENO;;Silencioso;PROVIDENCIA                   ;METROPOLITANA;0;0;0;0;0;0;0;0;0;PARLANTE 6985 MLAB VERTICAL BRITPOP BT;ACCESORIOS
16904574;;M;34;CHILENO;;Millenial;CAUQUENES                     ;MAULE;0;0;0;0;0;0;0;0;0;SOPORTE TV 26-56 KTA02 KIOTO FIJO;ACCESORIOS
19774111;;F;24;CHILENO;;Z;PROVIDENCIA                   ;METROPOLITANA;0;0;0;0;0;0;0;0;0;AUDIFONO IN HUAWEI BLANCO;ACCESORIOS
9816629;Casado;M;59;CHILENO;;Boomers;RENCA                         ;METROPOLITANA;0;0;0;0;0;0;0;0;0;MOUSE HP Z3700 Black WIRELESS;ACCESORIOS
17620678;;M;30;CHILENO;;Millenial;PROVIDENCIA                   ;METROPOLITANA;0;0;0;0;0;0;0;0;0;POWERBANK MLAB SLIM ALUMINIUM 4400MAH BL 7754;ACCESORIOS
13983713;;F;40;CHILENO;;X;CALERA                        ;VALPARAISO;0;0;0;0;0;0;0;0;0;AUDIFONO IN HUAWEI BLANCO;ACCESORIOS
18923330;;F;27;CHILENO;;Z;COQUIMBO                      ;COQUIMBO;0;0;0;0;0;0;0;0;0;HUAWEI AUDIFONOS MANOS LIBRES AM115;ACCESORIOS
16839596;Soltero;F;34;CHILENO;PERIODISTA;Millenial;PROVIDENCIA                   ;METROPOLITANA;0;0;0;0;0;0;0;0;0;DISCO DURO CANVIO 1TB BASICS BLACK TOSHIBA;ACCESORIOS
13200958;;M;45;CHILENO;;X;PROVIDENCIA                   ;METROPOLITANA;0;0;0;0;0;0;0;0;0;PARLANTE 6986 MLAB VERTICAL STICKERS BT;ACCESORIOS
18993153;;F;28;CHILENO;;Millenial;PENALOLEN;METROPOLITANA;0;0;0;0;0;0;0;0;0;PENDRIVE CRUZERBLADE Z50 SANDISK 32GB;ACCESORIOS
17713121;Soltero;M;31;CHILENO;INGENIERO EN PREVENCION DE RIESGOS;Millenial;PROVIDENCIA                   ;METROPOLITANA;0;0;0;0;0;0;0;0;0;AUDIFONO SONY MDRZX310APLZUC;ACCESORIOS
20136667;;M;23;CHILENO;;Z;RENCA                         ;METROPOLITANA;0;0;0;0;0;0;0;0;0;AUDIFONO ON XB550 AP SONY NEGRO;ACCESORIOS
15053602;;F;39;CHILENO;;X;RENCA                         ;METROPOLITANA;0;0;0;0;0;0;0;0;0;TRAVEL ADAPTER 15W - FAST CHARGER (TYPE-C CABLE);ACCESORIOS
16450849;;M;35;CHILENO;;Millenial;PROVIDENCIA                   ;METROPOLITANA;0;0;0;0;0;0;0;0;0;PARLANTES SRS-XB12/LC LA;ACCESORIOS
18255981;;M;30;CHILENO;;Millenial;VILLA ALEMANA                 ;VALPARAISO;0;0;0;0;0;0;0;0;0;MEMORIA MICROSD CLASE 10 128GB SANDISK;ACCESORIOS
11111200;Soltero;F;54;CHILENO;;Boomers;SAN CARLOS                    ;BIO BIO;0;0;0;0;0;0;0;0;0;PARLANTE 6986 MLAB VERTICAL STICKERS BT;ACCESORIOS
17669925;;F;31;CHILENO;;Millenial;TALCA                         ;MAULE;0;0;0;0;0;0;0;0;0;PARLANTE BT MICRO PINEAPPLE 8647;ACCESORIOS
7431023;;F;70;CHILENO;;Silencioso;ARAUCO                        ;BIO BIO;0;0;0;0;0;0;0;0;0;MEMORIA MICROSD CLASE 10 16GB SANDISK;ACCESORIOS
9081691;;M;61;CHILENO;;Boomers;CONCEPCION                    ;BIO BIO;0;0;0;0;0;0;0;0;0;Smartwatch ACTIVE 1 VERDE;ACCESORIOS
4109443;;F;81;CHILENO;;Silencioso;EL TABO                       ;VALPARAISO;0;0;0;0;0;0;0;0;0;AUDIFONO ON RPHF300E-W BLANCO PNS;ACCESORIOS
22571571;;F;53;PERUANO;;Extranjero;ARICA                         ;ARICA Y PARINACOTA;0;0;0;0;0;0;0;0;0;AUDIFONO SONY MDRZX310APLZUC;ACCESORIOS
10816511;;M;55;CHILENO;;Boomers;N/D;N/D;0;0;0;0;0;0;0;0;0;MOUSE MICROSOFT Wireless Mbl 1850 Blue;ACCESORIOS
19374782;Soltero;F;26;CHILENO;;Z;PROVIDENCIA                   ;METROPOLITANA;0;0;0;0;0;0;0;0;0;AUDIFONO SONY MDRZX310APLZUC;ACCESORIOS
10860648;Casado;M;52;CHILENO;;X;RENCA                         ;METROPOLITANA;0;0;0;0;0;0;0;0;0;SMARTWATCH HUAWEI WATCH FIT BLACK;ACCESORIOS
10747706;;F;52;CHILENO;;X;PROVIDENCIA                   ;METROPOLITANA;0;0;0;0;0;0;0;0;0;SOPORTE TV 26-56 KTA02 KIOTO FIJO;ACCESORIOS
14258241;;M;47;CHILENO;;X;N/D;N/D;0;0;0;0;0;0;0;0;0;KARAOKE MLAB SUITCASE OUTDOOR MIC BT BK 8566;ACCESORIOS
14619151;Casado;F;40;CHILENO;;X;RENCA                         ;METROPOLITANA;0;0;0;0;0;0;0;0;0;AUDIFONO SAMSUNG WIRELESS A08C;ACCESORIOS
16555671;Soltero;M;35;CHILENO;PROFESOR;Millenial;PROVIDENCIA                   ;METROPOLITANA;0;0;0;0;0;0;0;0;0;AUDIFONOS Airpods Pro (MWP22AM/A);ACCESORIOS
17086496;Soltero;M;33;CHILENO;INGENIERO CIVIL INDUSTRIAL;Millenial;PROVIDENCIA                   ;METROPOLITANA;0;0;0;0;0;0;0;0;0;MOCHILA HARVEY MELANGE GR;ACCESORIOS
10367416;;F;55;CHILENO;;Boomers;TALCA                         ;MAULE;0;0;0;0;0;0;0;0;0;PARLANTE ZUKABASS + MICROFONO MLAB BT ROJO;ACCESORIOS
13070661;;F;46;CHILENO;;X;PROVIDENCIA                   ;METROPOLITANA;0;0;0;0;0;0;0;0;0;SOPORTE TV 26-56 KTAT02 KIOTO MOVIL;ACCESORIOS
14459844;;M;49;CHILENO;;X;LO PRADO                      ;METROPOLITANA;0;0;0;0;0;0;0;0;0;AUDIFONO ON ZX110 SONY NEGRO;ACCESORIOS
16442508;Soltero;M;35;CHILENO;TECNOLOGO MEDICO;Millenial;RENCA                         ;METROPOLITANA;0;0;0;0;0;0;0;0;0;MOUSE M170 LOGITECH AZUL;ACCESORIOS
11960939;;F;50;CHILENO;;X;PROVIDENCIA                   ;METROPOLITANA;0;0;0;0;0;0;0;0;0;SOPORTE TV 14-42 KTAM02 KIOTO C/ BRAZO MOVIL;ACCESORIOS
17837163;Soltero;M;31;CHILENO;NUTRICIONISTA;Millenial;PROVIDENCIA                   ;METROPOLITANA;0;0;0;0;0;0;0;0;0;DISCO DURO CANVIO 1TB BASICS BLACK TOSHIBA;ACCESORIOS
12910071;;M;46;CHILENO;;X;PROVIDENCIA                   ;METROPOLITANA;0;0;0;0;0;0;0;0;0;PARLANTE 6985 MLAB VERTICAL BRITPOP BT;ACCESORIOS
19743486;;M;24;CHILENO;;Z;PROVIDENCIA                   ;METROPOLITANA;0;0;0;0;0;0;0;0;0;BATERY PACK TIPO C 10.000 MAH SAMSUNG;ACCESORIOS
17827321;;M;31;CHILENO;;Millenial;PROVIDENCIA                   ;METROPOLITANA;0;0;0;0;0;0;0;0;0;AUDIFONO ON XB550 AP SONY NEGRO;ACCESORIOS
9726165;;M;55;CHILENO;;Boomers;PADRE LAS CASAS               ;ARAUCANIA;0;0;0;0;0;0;0;0;0;HUAWEI FREEBUDS 3I BLANCOS;ACCESORIOS
15380176;Soltero;M;55;CHILENO;PROFESOR;Boomers;PROVIDENCIA                   ;METROPOLITANA;0;0;0;0;0;0;0;0;0;AUDIFONO ON ZX110AP SONY NEGRO;ACCESORIOS
15288006;;M;39;CHILENO;;X;PROVIDENCIA                   ;METROPOLITANA;0;0;0;0;0;0;0;0;0;KIT DIRECTV GO BOX;ACCESORIOS
3930021;;M;80;CHILENO;;Silencioso;RENCA                         ;METROPOLITANA;0;0;0;0;0;0;0;0;0;SOPORTE TV 32-65 KTA03 KIOTO FIJO;ACCESORIOS
13623560;;M;43;CHILENO;;X;PROVIDENCIA                   ;METROPOLITANA;0;0;0;0;0;0;0;0;0;Mochila 17.3 Pavilion Gaming 300;ACCESORIOS
12056481;;M;55;CHILENO;;Boomers;TALCA                         ;MAULE;0;0;0;0;0;0;0;0;0;SOPORTE TV 32-65 KTA03 KIOTO FIJO;ACCESORIOS
17235641;Soltero;F;33;CHILENO;;Millenial;PROVIDENCIA                   ;METROPOLITANA;0;0;0;0;0;0;0;0;0;AUDIFONO MLAB ON STYLE BLACK BT 8240;ACCESORIOS
13793949;Soltero;F;41;CHILENO;;X;PROVIDENCIA                   ;METROPOLITANA;0;0;0;0;0;0;0;0;0;AUDIFONO MLAB TWS FREE IN-AIR TOUCH BLACK 8534;ACCESORIOS
7745125;;M;64;CHILENO;;Boomers;PROVIDENCIA                   ;METROPOLITANA;0;0;0;0;0;0;0;0;0;DISCO DURO CANVIO 2TB BASICS BLACK TOSHIBA;ACCESORIOS
17760883;;M;31;CHILENO;;Millenial;PETORCA                       ;VALPARAISO;0;0;0;0;0;0;0;0;0;MEMORIA MICROSD CLASE 10 64GB SANDISK;ACCESORIOS
13664738;;F;43;CHILENO;;Millenial;N/D;N/D;0;0;0;0;0;0;0;0;0;AUDIFONO IN SONY BT WI-310 BLACK;ACCESORIOS
10887926;Soltero;M;42;CHILENO;INGENIERO EN ADMINISTRACION DE EMPRESAS;X;PROVIDENCIA                   ;METROPOLITANA;0;0;0;0;0;0;0;0;0;SOPORTE TV EE-F01 14-42 ENCORE;ACCESORIOS
15567527;;M;36;CHILENO;;Millenial;PROVIDENCIA                   ;METROPOLITANA;0;0;0;0;0;0;0;0;0;Smartwatch GALAXY WATCH SILVER;ACCESORIOS
17925229;Soltero;M;30;CHILENO;;Millenial;PROVIDENCIA                   ;METROPOLITANA;0;0;0;0;0;0;0;0;0;MEMORIA MICROSD CLASE 10 128GB SANDISK;ACCESORIOS
19935344;;M;31;CHILENO;;Millenial;PROVIDENCIA                   ;METROPOLITANA;0;0;0;0;0;0;0;0;0;TRAVEL ADAPTER 15W - FAST CHARGER (TYPE-C CABLE);ACCESORIOS
12819193;;M;47;CHILENO;;X;CALERA                        ;VALPARAISO;0;0;0;0;0;0;0;0;0;AUDIFONO MLAB TWS IN-AIR WHITE 8533;ACCESORIOS
12226153;;F;50;CHILENO;;X;RENCA                         ;METROPOLITANA;0;0;0;0;0;0;0;0;0;AUDIFONO MLAB ON STYLE BLACK BT 8240;ACCESORIOS
10751817;;M;53;CHILENO;;X;PROVIDENCIA                   ;METROPOLITANA;0;0;0;0;0;0;0;0;0;365 Familia 6 usuarios Anual;ACCESORIOS
20502884;;M;22;CHILENO;;Z;PROVIDENCIA                   ;METROPOLITANA;0;0;0;0;0;0;0;0;0;AUDIFONO IN EX15LP SONY AZL;ACCESORIOS
17521340;;F;31;CHILENO;;Millenial;PROVIDENCIA                   ;METROPOLITANA;0;0;0;0;0;0;0;0;0;365 Personal Suscripcion Anual;ACCESORIOS
11663634;;M;52;CHILENO;;X;PROVIDENCIA                   ;METROPOLITANA;0;0;0;0;0;0;0;0;0;Smartwatch GT 2E GREEN;ACCESORIOS
15967900;;F;37;CHILENO;;Millenial;PROVIDENCIA                   ;METROPOLITANA;0;0;0;0;0;0;0;0;0;AUDIFONO IN GALAXI BUDS;ACCESORIOS
12316128;Casado;F;49;CHILENO;;X;RENCA                         ;METROPOLITANA;0;0;0;0;0;0;0;0;0;AUDIFONO IN SAM FIT EG920 BLANCO;ACCESORIOS
19803950;;F;24;CHILENO;;Z;PROVIDENCIA                   ;METROPOLITANA;0;0;0;0;0;0;0;0;0;MEMORIA MICROSD CLASE 10 128GB SANDISK;ACCESORIOS
13632289;;M;43;CHILENO;;X;COPIAPO                       ;ATACAMA;0;0;0;0;0;0;0;0;0;RADIO DE AUTO PHILIPS CE235BT;ACCESORIOS
16444840;;M;35;CHILENO;;Millenial;VALPARAISO                    ;VALPARAISO;0;0;0;0;0;0;0;0;0;Smartwatch GT 2E RED;ACCESORIOS
13571345;;M;43;CHILENO;;X;CHEPICA                       ;L.G.B.OÂ´HIGGINS;0;0;0;0;0;0;0;0;0;MEMORIA MICROSD CLASE 10 128GB SANDISK;ACCESORIOS
19336873;Soltero;M;29;CHILENO;;Millenial;LA LIGUA                      ;VALPARAISO;0;0;0;0;0;0;0;0;0;HUAWEI Sport Bluetooth Headphones Lite Black AM6;ACCESORIOS
12327841;;F;48;CHILENO;;X;N/D;N/D;0;0;0;0;0;0;0;0;0;MEMORIA MICROSD CLASE 10 128GB SANDISK;ACCESORIOS
9834854;Casado;M;58;CHILENO;;Boomers;RENCA                         ;METROPOLITANA;0;0;0;0;0;0;0;0;0;DISCO DURO CANVIO 4TB BASICS BLACK;ACCESORIOS
13575987;Soltero;M;42;CHILENO;;X;PUDAHUEL                      ;METROPOLITANA;0;0;0;0;0;0;0;0;0;SOPORTE TV 14-63 CON BRAZO KT-FM 3L;ACCESORIOS
26368580;;F;37;VENEZOLANO;;Extranjero;CONCEPCION                    ;BIO BIO;0;0;0;0;0;0;0;0;0;Smartwatch GT 2E BLACK;ACCESORIOS
17100866;;F;33;CHILENO;;Millenial;PADRE HURTADO                 ;METROPOLITANA;0;0;0;0;0;0;0;0;0;MOUSE HP Z3700 Black WIRELESS;ACCESORIOS
14116674;;M;41;CHILENO;;X;N/D;N/D;0;0;0;0;0;0;0;0;0;KARAOKE MLAB TOWER OUTDOOR MIC BT BK 8568;ACCESORIOS
13805375;;F;42;CHILENO;;X;ANGOL                         ;ARAUCANIA;0;0;0;0;0;0;0;0;0;AUDIFONO ON BT IRON MAN BLACK;ACCESORIOS
20390945;;M;22;CHILENO;;Z;PROVIDENCIA                   ;METROPOLITANA;0;0;0;0;0;0;0;0;0;PARLANTE 8531 MLAB MAX BASS BT;ACCESORIOS
18181364;Soltero;F;30;CHILENO;;Millenial;PROVIDENCIA                   ;METROPOLITANA;0;0;0;0;0;0;0;0;0;AUDIFONO ON SONY WH-CH500 BLACK;ACCESORIOS
17703304;Casado;M;31;CHILENO;;Millenial;PROVIDENCIA                   ;METROPOLITANA;0;0;0;0;0;0;0;0;0;TRAVEL ADAPTER 15W - FAST CHARGER (TYPE-C CABLE);ACCESORIOS
10730115;;M;55;CHILENO;;Boomers;RENCA                         ;METROPOLITANA;0;0;0;0;0;0;0;0;0;PARLANTE 8531 MLAB MAX BASS BT;ACCESORIOS
17240922;Soltero;M;32;CHILENO;GASTRONOMIA INTERNACIONAL;Millenial;PROVIDENCIA                   ;METROPOLITANA;0;0;0;0;0;0;0;0;0;AUDIFONO SAMSUNG WIRELESS 103B;ACCESORIOS
17669813;;M;31;CHILENO;;Millenial;N/D;N/D;0;0;0;0;0;0;0;0;0;DISCO DURO CANVIO 2TB BASICS BLACK TOSHIBA;ACCESORIOS
13560439;;F;43;CHILENO;;X;ISLA DE MAIPO                 ;METROPOLITANA;0;0;0;0;0;0;0;0;0;SOPORTE TV 14-63 CON BRAZO KT-FM 3L;ACCESORIOS
19181638;Soltero;M;26;CHILENO;;Z;PROVIDENCIA                   ;METROPOLITANA;0;0;0;0;0;0;0;0;0;AUDIFONO IN E9LP SONY BZ NEGRO;ACCESORIOS
17189872;;F;33;CHILENO;;Millenial;RENCA                         ;METROPOLITANA;0;0;0;0;0;0;0;0;0;DISCO DURO CANVIO 4TB BASICS BLACK;ACCESORIOS
17209385;;F;33;CHILENO;;Millenial;RENCA                         ;METROPOLITANA;0;0;0;0;0;0;0;0;0;SOPORTE TV 26-56 KTAT02 KIOTO MOVIL;ACCESORIOS
13933978;;M;42;CHILENO;;X;RENCA                         ;METROPOLITANA;0;0;0;0;0;0;0;0;0;PARLANTE 6985 MLAB VERTICAL BRITPOP BT;ACCESORIOS
9736680;;M;54;CHILENO;;Boomers;PROVIDENCIA                   ;METROPOLITANA;0;0;0;0;0;0;0;0;0;Smartwatch GALAXY WATCH SILVER;ACCESORIOS
11579239;;F;51;CHILENO;;X;LOS ANGELES                   ;BIO BIO;0;0;0;0;0;0;0;0;0;RADIO RETRO ANTIQUE 8732;ACCESORIOS
26495329;;M;44;VENEZOLANO;;Extranjero;N/D;N/D;0;0;0;0;0;0;0;0;0;AUDIFONO IN SAM C/ MIC EG920 BLACK;ACCESORIOS
15445477;;F;39;CHILENO;;X;TALCAHUANO                    ;BIO BIO;0;0;0;0;0;0;0;0;0;DISCO DURO CANVIO 2TB BASICS BLACK TOSHIBA;ACCESORIOS
14220315;;M;41;CHILENO;;X;TEMUCO                        ;ARAUCANIA;0;0;0;0;0;0;0;0;0;HUAWEI FreeBuds Lite Black;ACCESORIOS
18038125;;F;29;CHILENO;;Millenial;PROVIDENCIA                   ;METROPOLITANA;0;0;0;0;0;0;0;0;0;BAND 4 AMBER SUNRISE;ACCESORIOS
18281094;;F;30;CHILENO;;Millenial;ANCUD                         ;LOS LAGOS;0;0;0;0;0;0;0;0;0;RADIO RETRO ANTIQUE 8732;ACCESORIOS
17477348;;F;32;CHILENO;;Millenial;PROVIDENCIA                   ;METROPOLITANA;0;0;0;0;0;0;0;0;0;Smartwatch GT 2 GOLD ROSE;ACCESORIOS
19451160;;M;25;CHILENO;;Z;N/D;N/D;0;0;0;0;0;0;0;0;0;HUAWEI FreeBuds Lite Black;ACCESORIOS
9948871;;M;56;CHILENO;;Boomers;RENCA                         ;METROPOLITANA;0;0;0;0;0;0;0;0;0;MEMORIA MICROSD CLASE 10 16GB SANDISK;ACCESORIOS
12567596;;F;48;CHILENO;;X;PROVIDENCIA                   ;METROPOLITANA;0;0;0;0;0;0;0;0;0;PENDRIVE CRUZERBLADE Z50 SANDISK 32GB;ACCESORIOS
13451995;;F;44;CHILENO;;X;PENAFLOR                      ;METROPOLITANA;0;0;0;0;0;0;0;0;0;BAND 4 PRO BLACK;ACCESORIOS
15788891;Casado;M;38;CHILENO;PROFESOR;Millenial;PROVIDENCIA                   ;METROPOLITANA;287960;4;2;4;2;287960;0;0;0;BICI RETROPLUS ROSADA 26 V-BRAKE;BICICLETAS
10003086;;F;58;CHILENO;;Boomers;MONTE PATRIA                  ;COQUIMBO;224180;3;1;0;0;0;3;1;224180;BICI SHINEPLUS GRIS 27,5 FRENO DISCO;BICICLETAS
16405620;;F;35;CHILENO;;Millenial;N/D;N/D;578800;6;3;6;3;578800;0;0;0;BICI VIGORPLUS VERDE 27,5 V-BRAKE;BICICLETAS
19835702;;F;24;CHILENO;;Z;N/D;N/D;859640;8;4;8;4;859640;0;0;0;BICI STRIKER AMARILLA 29 V-BRAKE;BICICLETAS
18520288;;M;29;CHILENO;;Millenial;VALLENAR;ATACAMA;180980;2;1;2;1;180980;0;0;0;BICI VIGORPLUS NEGRA 27,5 V-BRAKE;BICICLETAS
14024544;;F;41;CHILENO;;X;SAN CARLOS                    ;BIO BIO;306970;3;2;0;0;0;3;2;306970;BC XTS MTB ALU STRIKER 29 21VEL DISCO NEGRO;BICICLETAS
19821679;;F;23;CHILENO;;Z;NINHUE;BIO-BIO;109990;1;1;0;0;0;1;1;109990;HOTWHEELS 12 NEGRO;BICICLETAS
5758451;Soltero;F;72;CHILENO;;Silencioso;MEJILLONES                    ;ANTOFAGASTA;257980;2;1;0;0;0;2;1;257980;BICICLETA VISION HELIUM CITY ARO 24 ACERO 6V;BICICLETAS
16668917;;M;34;CHILENO;;Millenial;CANETE                        ;BIO BIO;99980;2;1;0;0;0;2;1;99980;BICICLETA INFANTIL ARO 20 ROSADA;BICICLETAS
7299402;;F;67;CHILENO;;Boomers;COIHAIQUE                     ;AYSEN;79990;1;1;0;0;0;1;1;79990;BICICLETA INFANTIL ARO 16 NEGRA;BICICLETAS
8746042;;F;56;CHILENO;;Boomers;PROVIDENCIA                   ;METROPOLITANA;183980;2;1;2;1;183980;0;0;0;BICI VIGORPLUS VERDE 27,5 V-BRAKE;BICICLETAS
6465089;Viudo;F;68;CHILENO;;Boomers;PICHIDEGUA                    ;L.G.B.OÂ´HIGGINS;111980;2;1;0;0;0;2;1;111980;BICICLETA INFANTIL ARO 16 CELESTE;BICICLETAS
26471135;;M;31;HAITIANO;;Extranjero;MELIPILLA                     ;METROPOLITANA;184980;2;2;1;1;149990;1;1;34990;BICI VIGOR NEGRA 24 V-BRAKE;BICICLETAS
8957260;;M;50;CHILENO;;X;RENCA                         ;METROPOLITANA;299990;3;2;0;0;0;3;2;299990;MODELO SUNPEED ZERO ARO 29 ROJA M;BICICLETAS
19788447;;F;23;CHILENO;;Z;N/D;N/D;272980;2;1;0;0;0;2;1;272980;BICI STRIKER BLANCA 27,5 FRENO DISCO;BICICLETAS
17281855;;F;32;CHILENO;;Millenial;PROVIDENCIA                   ;METROPOLITANA;159990;1;1;1;1;159990;0;0;0;BICI SHINEPLUS GRIS 27,5 FRENO DISCO;BICICLETAS
12982879;;F;46;CHILENO;;X;"";"";119980;2;1;2;1;119980;0;0;0;BICI ALLEYCAT NEGRA/TURQUESA 28 FITZER;BICICLETAS
8854272;;M;58;CHILENO;;Boomers;RENCA                         ;METROPOLITANA;229980;2;1;2;1;229980;0;0;0;BICI METROPOLE GRIS 28 CITYBIKE;BICICLETAS
25985717;;F;39;VENEZOLANO;;Extranjero;N/D;N/D;292980;2;1;0;0;0;2;1;292980;BICICLETA MONKEL 29 ALUMINIO AZUL;BICICLETAS
17561306;;F;32;CHILENO;;Millenial;"";"";235980;2;1;0;0;0;2;1;235980;BICI VIGORPLUS VERDE 27,5 V-BRAKE;BICICLETAS
14445498;;F;47;CHILENO;;X;RANCAGUA                      ;L.G.B.OÂ´HIGGINS;148980;2;1;0;0;0;2;1;148980;BICI ALLEYCAT NEGRA/TURQUESA 28 FITZER;BICICLETAS
12821338;;M;46;CHILENO;;X;QUILLOTA                      ;VALPARAISO;189990;1;1;0;0;0;1;1;189990;BICI VIGORPLUS NEGRA 27,5 V-BRAKE;BICICLETAS
16803382;;F;34;CHILENO;;Millenial;PROVIDENCIA                   ;METROPOLITANA;119980;2;1;2;1;119980;0;0;0;BICI ALLEYCAT NEGRA/TURQUESA 28 FITZER;BICICLETAS
13182302;;F;44;CHILENO;;X;LOS VILOS                     ;COQUIMBO;625840;5;2;0;0;0;5;2;625840;BICI VIGORPLUS NEGRA 27,5 V-BRAKE;BICICLETAS
19373109;;F;25;CHILENO;;Millenial;N/D;N/D;119830;3;2;3;2;119830;0;0;0;BICICLETA PLEGABLE BIA;BICICLETAS
19591587;;F;25;CHILENO;;Z;N/D;N/D;109990;1;1;1;1;109990;0;0;0;V-MTB ARO 16 HOMBRE AVENGERS GRIS;BICICLETAS
10991939;;F;47;CHILENO;;X;PROVIDENCIA                   ;METROPOLITANA;221970;3;1;3;1;221970;0;0;0;BICI RETROPLUS VERDE 26 V-BRAKE;BICICLETAS
6544666;;F;67;CHILENO;;Boomers;EL BOSQUE                     ;METROPOLITANA;143080;2;1;0;0;0;2;1;143080;BICICLETA INFANTIL ARO 20 AMARILLA;BICICLETAS
20324091;;F;22;CHILENO;;Z;PROVIDENCIA                   ;METROPOLITANA;173980;2;1;2;1;173980;0;0;0;BICI RETROPLUS VERDE 26 V-BRAKE;BICICLETAS
11237347;;F;54;CHILENO;;X;"";"";85840;2;1;2;1;85840;0;0;0;BICICLETA INFANTIL ARO 16 AZUL;BICICLETAS
17715426;;M;34;CHILENO;;Millenial;PUNITAQUI                     ;COQUIMBO;294980;2;1;0;0;0;2;1;294980;BICICLETA MONKEL 29 ALUMINIO AZUL;BICICLETAS
19224711;Soltero;M;26;CHILENO;;Z;VICTORIA                      ;ARAUCANIA;508047;12;10;0;0;0;12;10;508047;BICI STRIKER AMARILLA 29 V-BRAKE;BICICLETAS
15985313;;M;37;CHILENO;;Millenial;PROVIDENCIA                   ;METROPOLITANA;111980;2;1;2;1;111980;0;0;0;BICICLETA INFANTIL ARO 20 NEGRA;BICICLETAS
17334850;;M;33;CHILENO;;Millenial;PIRQUE;METROPOLITANA;239970;4;2;4;2;239970;0;0;0;BICICLETA INFANTIL ARO 12 ROSADA;BICICLETAS
19411801;Soltero;F;25;CHILENO;;Z;PROVIDENCIA                   ;METROPOLITANA;143980;2;1;2;1;143980;0;0;0;V-BICICLETA PASEO PROVENZA ARO 26;BICICLETAS
19342414;;F;26;CHILENO;;Z;PROVIDENCIA                   ;METROPOLITANA;113980;2;1;2;1;113980;0;0;0;BICICLETA INFANTIL ARO 20 AMARILLA;BICICLETAS
13267598;;M;45;CHILENO;;X;LONGAVI;MAULE;199990;1;1;0;0;0;1;1;199990;BICI VIGORPLUS VERDE 27,5 V-BRAKE;BICICLETAS
16159026;;M;36;CHILENO;;Millenial;SAN JAVIER                    ;MAULE;159990;1;1;0;0;0;1;1;159990;BICI RETROPLUS VERDE 26 V-BRAKE;BICICLETAS
18505752;;F;30;CHILENO;;Millenial;PROVIDENCIA                   ;METROPOLITANA;213980;2;1;2;1;213980;0;0;0;BICI VIGORPLUS VERDE 27,5 V-BRAKE;BICICLETAS
19616420;;M;24;CHILENO;;Millenial;MULCHEN;BIO-BIO;517510;7;3;7;3;517510;0;0;0;BICICLETA INFANTIL ARO 20 NEGRA;BICICLETAS
19460556;;M;24;CHILENO;;Z;N/D;N/D;238980;2;1;0;0;0;2;1;238980;BICI SHINEPLUS BLANCA 27,5 FRENO DISCO;BICICLETAS
20043038;;F;23;CHILENO;;Z;PROVIDENCIA                   ;METROPOLITANA;88980;2;1;2;1;88980;0;0;0;BICICLETA INFANTIL ARO 12 ROJA;BICICLETAS
26315073;;M;26;VENEZOLANO;;Extranjero;ANGOL                         ;ARAUCANIA;249990;1;1;0;0;0;1;1;249990;BC XTS MTB ALU STRIKER 29 21VEL DISCO NEGRO;BICICLETAS
9465889;;M;60;CHILENO;;Boomers;"";"";89990;1;1;0;0;0;1;1;89990;BICICLETA INFANTIL ARO 20 ROSADA;BICICLETAS
13356698;;M;44;CHILENO;;X;CALAMA                        ;ANTOFAGASTA;321960;4;2;0;0;0;4;2;321960;BICI SHINEPLUS BLANCA 27,5 FRENO DISCO;BICICLETAS
14013862;;M;41;CHILENO;;X;PERALILLO                     ;L.G.B.OÂ´HIGGINS;109990;1;1;0;0;0;1;1;109990;BICICLETA INFANTIL ARO 20 AMARILLA;BICICLETAS
13762003;;F;41;CHILENO;;X;ALTO DEL CARMEN               ;ATACAMA;309990;1;1;0;0;0;1;1;309990;V-BICICLETA MTB XT-9003 ARO 27.5;BICICLETAS
15622610;;F;39;CHILENO;;X;N/D;N/D;339990;1;1;0;0;0;1;1;339990;V-BICICLETA MTB XT-9003 ARO 27.5;BICICLETAS
17263408;;M;32;CHILENO;;Silencioso;N/D;N/D;61980;2;2;2;2;61980;0;0;0;BICI RETROPLUS VERDE 26 V-BRAKE;BICICLETAS
11372460;;M;53;CHILENO;;X;CONSTITUCION                  ;MAULE;349990;1;1;0;0;0;1;1;349990;BC XTS MTB ALU STRIKER 29 21VEL DISCO NEGRO;BICICLETAS
17965785;;F;30;CHILENO;;Millenial;PROVIDENCIA                   ;METROPOLITANA;127540;2;1;2;1;127540;0;0;0;V-MTB ARO 12 SPIDERMAN ROJO;BICICLETAS
5212009;;M;77;CHILENO;;Silencioso;SAN CARLOS                    ;BIO BIO;287980;2;2;0;0;0;2;2;287980;BICICLETA MONKEL 29 ALUMINIO GRIS;BICICLETAS
11821298;;M;51;CHILENO;;X;COPIAPO                       ;ATACAMA;139990;1;1;0;0;0;1;1;139990;BICICLETA INFANTIL VENOM ARO 16 NEGRO;BICICLETAS
8072998;;F;64;CHILENO;;Boomers;TENO                          ;MAULE;176080;2;1;0;0;0;2;1;176080;BICICLETA INFANTIL VENOM ARO 16 NEGRO;BICICLETAS
11565681;;M;51;CHILENO;;X;TALCA                         ;MAULE;404960;4;3;0;0;0;4;3;404960;BICICLETA MONKEL 29 ALUMINIO GRIS;BICICLETAS
19149439;;F;26;CHILENO;;Z;ARICA                         ;TARAPACA;329990;1;1;0;0;0;1;1;329990;BIANCHI ADVANTAGE 27,5 SX NEGRO SEMI MATTE/BLANC;BICICLETAS
16839200;;M;34;CHILENO;;Millenial;LOS ANDES                     ;VALPARAISO;154980;2;1;2;1;154980;0;0;0;BARBIE 16 BLANCO;BICICLETAS
18894075;;F;27;CHILENO;;Silencioso;PROVIDENCIA                   ;METROPOLITANA;299990;1;1;0;0;0;1;1;299990;BIANCHI STONE MOUNTAIN 29 SX ALLOY SIZE M PLATA;BICICLETAS
15975280;;M;37;CHILENO;;Millenial;MEJILLONES                    ;ANTOFAGASTA;0;0;0;0;0;0;0;0;0;BICI VIGOR NEGRA 24 V-BRAKE;BICICLETAS
15365678;;M;40;CHILENO;;X;LAS CONDES                    ;METROPOLITANA;0;0;0;0;0;0;0;0;0;MODELO SUNPEED ZERO ARO 27.5 GRIS DISCO L;BICICLETAS
18308939;Soltero;F;30;CHILENO;TECNICO EN ENFERMERIA DE NIVEL SUPERIOR;Silencioso;PROVIDENCIA                   ;METROPOLITANA;0;0;0;0;0;0;0;0;0;COMBO PROTECCION SIMON;BICICLETAS
10481676;;M;56;CHILENO;;Boomers;CASTRO                        ;LOS LAGOS;0;0;0;0;0;0;0;0;0;BIANCHI STONE MOUNT 29 L NEG;BICICLETAS
6745081;;F;69;CHILENO;;Silencioso;CHILLAN                       ;BIO BIO;0;0;0;0;0;0;0;0;0;BICI VIGOR GRIS 24 V-BRAKE;BICICLETAS
18517843;;F;28;CHILENO;;Millenial;PROVIDENCIA                   ;METROPOLITANA;0;0;0;0;0;0;0;0;0;FREESTYLE PRO ARO 20 NEGRA/NARANJA;BICICLETAS
18399711;;F;28;CHILENO;;Millenial;PROVIDENCIA                   ;METROPOLITANA;0;0;0;0;0;0;0;0;0;BICI VIGOR NEGRA 24 V-BRAKE;BICICLETAS
16142497;;M;37;CHILENO;;Millenial;QUILPUE                       ;VALPARAISO;0;0;0;0;0;0;0;0;0;BICI VIGOR GRIS 24 V-BRAKE;BICICLETAS
15226431;Casado;F;38;CHILENO;;X;RENCA                         ;METROPOLITANA;0;0;0;0;0;0;0;0;0;BIANCHI STONE MOUNTAIN 27,5 SX SIZE M NEGRO SEMI;BICICLETAS
16888106;;F;34;CHILENO;;Millenial;CABILDO                       ;VALPARAISO;0;0;0;0;0;0;0;0;0;V-BICICLETA MTB RADAL 4 ARO 27.5;BICICLETAS
10265613;;M;57;CHILENO;;Boomers;RENCA                         ;METROPOLITANA;0;0;0;0;0;0;0;0;0;BICI METROPOLE GRIS 28 CITYBIKE;BICICLETAS
13264733;;F;45;CHILENO;;X;PROVIDENCIA                   ;METROPOLITANA;0;0;0;0;0;0;0;0;0;SET DE PROTECCIONES BIA;BICICLETAS
12910421;;F;46;CHILENO;;X;PUENTE ALTO                   ;METROPOLITANA;0;0;0;0;0;0;0;0;0;BICI STRIKER NEGRA 29 FRENO DISCO;BICICLETAS
15952765;;F;37;CHILENO;;Millenial;RENCA                         ;METROPOLITANA;0;0;0;0;0;0;0;0;0;BIANCHI STONE MOUNTAIN 27,5 SX SIZE M NEGRO SEMI;BICICLETAS
16846996;;M;35;CHILENO;;Millenial;PROVIDENCIA                   ;METROPOLITANA;0;0;0;0;0;0;0;0;0;MTB EXPLORER BICYSTAR ARO 29 AZUL-AMARILLO;BICICLETAS
15058091;;M;39;CHILENO;;X;N/D;N/D;0;0;0;0;0;0;0;0;0;BICI STRIKER AMARILLA 29 V-BRAKE;BICICLETAS
18923146;;M;27;CHILENO;;Millenial;COQUIMBO                      ;COQUIMBO;0;0;0;0;0;0;0;0;0;HOTWHEELS 16 PLATA;BICICLETAS
19009804;;M;27;CHILENO;;Z;SAN JAVIER                    ;MAULE;0;0;0;0;0;0;0;0;0;BICICLETA INFANTIL ARO 20 AMARILLA;BICICLETAS
16283180;;M;35;CHILENO;;Millenial;PROVIDENCIA                   ;METROPOLITANA;0;0;0;0;0;0;0;0;0;BICICLETA INFANTIL ARO 20 ROSADA;BICICLETAS
10845114;Soltero;M;52;CHILENO;AGRONOMO;X;RENCA                         ;METROPOLITANA;0;0;0;0;0;0;0;0;0;BICI BMX FREESTYLE ARO 20 AZUL;BICICLETAS
18980734;;M;27;CHILENO;;Z;VILLA ALEMANA                 ;VALPARAISO;0;0;0;0;0;0;0;0;0;BICICLETA INFANTIL ARO 20 BLANCA;BICICLETAS
11389590;;F;53;CHILENO;;X;RENCA                         ;METROPOLITANA;0;0;0;0;0;0;0;0;0;BIANCHI MTB PRO 26 ST LADY CON CANASTO BLANCO/CE;BICICLETAS
15104683;Soltero;M;40;CHILENO;;X;RENCA                         ;METROPOLITANA;0;0;0;0;0;0;0;0;0;BICI BMX FREESTYLE ARO 20 NEGRA;BICICLETAS
13441272;;M;44;CHILENO;;Silencioso;PROVIDENCIA                   ;METROPOLITANA;0;0;0;0;0;0;0;0;0;BICI RETROPLUS BEIGE 26 V-BRAKE;BICICLETAS
17895130;;F;29;CHILENO;;Millenial;N/D;N/D;0;0;0;0;0;0;0;0;0;SET COVER ASIENTO Y GUANTES BIA;BICICLETAS
12691067;Casado;M;48;CHILENO;;X;PROVIDENCIA                   ;METROPOLITANA;0;0;0;0;0;0;0;0;0;BICICLETA INFANTIL ARO 20 BLANCA;BICICLETAS
17202172;;F;33;CHILENO;;Millenial;N/D;N/D;0;0;0;0;0;0;0;0;0;BICICLETA INFANTIL ARO 16 ROSADA;BICICLETAS
17249330;;F;33;CHILENO;;Millenial;TALAGANTE                     ;METROPOLITANA;0;0;0;0;0;0;0;0;0;BICI VIGORPLUS VERDE 27,5 V-BRAKE;BICICLETAS
13314152;;F;44;CHILENO;;X;PROVIDENCIA                   ;METROPOLITANA;0;0;0;0;0;0;0;0;0;BICI SHINEPLUS BLANCA 27,5 FRENO DISCO;BICICLETAS
19677432;;F;24;CHILENO;;Z;N/D;N/D;0;0;0;0;0;0;0;0;0;BICICLETA INFANTIL ARO 16 CELESTE;BICICLETAS
8781142;;M;49;CHILENO;;X;COIHAIQUE                     ;AYSEN;0;0;0;0;0;0;0;0;0;V-BICICLETA MTB RADAL 3 ARO 27.5;BICICLETAS
16741002;;M;35;CHILENO;;Millenial;MACUL                         ;METROPOLITANA;0;0;0;0;0;0;0;0;0;BICICLETA INFANTIL ARO 16 CELESTE;BICICLETAS
15117272;Soltero;M;40;CHILENO;INGENIERO COMERCIAL;X;PROVIDENCIA                   ;METROPOLITANA;0;0;0;0;0;0;0;0;0;BICI BMX FREESTYLE ARO 20 AZUL;BICICLETAS
2825847;;M;78;CHILENO;;Silencioso;PROVIDENCIA                   ;METROPOLITANA;0;0;0;0;0;0;0;0;0;BICI BMX FREESTYLE ARO 20 AZUL;BICICLETAS
12618011;;F;48;CHILENO;;X;COPIAPO                       ;ATACAMA;0;0;0;0;0;0;0;0;0;BIANCHI STREET 24 LADY AMARILLO CLARO / BURDEO;BICICLETAS
18884964;;F;26;CHILENO;;Z;CALAMA                        ;ANTOFAGASTA;0;0;0;0;0;0;0;0;0;CASCO COMIC;BICICLETAS
19443911;;F;26;CHILENO;;Z;N/D;N/D;0;0;0;0;0;0;0;0;0;CASCO ALPACA;BICICLETAS
15377417;;M;40;CHILENO;;X;PROVIDENCIA                   ;METROPOLITANA;0;0;0;0;0;0;0;0;0;BICICLETA APRENDIZAJE CON CASCO RED;BICICLETAS
17724696;;F;31;CHILENO;;Millenial;ANTOFAGASTA                   ;ANTOFAGASTA;0;0;0;0;0;0;0;0;0;CASCO FISHER PRICE;BICICLETAS
13394423;;M;48;CHILENO;;X;RENCA                         ;METROPOLITANA;0;0;0;0;0;0;0;0;0;MOTOBIKE INFANTIL ROJA ARO 12;BICICLETAS
9012364;;F;61;CHILENO;;Boomers;VINA DEL MAR                  ;VALPARAISO;33970;3;1;0;0;0;3;1;33970;ALMOHADA BAMBOO TECH SERIES 65X45 CM;DORMITORIO
26335047;;M;48;VENEZOLANO;;Extranjero;HUALPEN;BIO BIO;30130;3;3;0;0;0;3;3;30130;PACK 2 ALMOHADAS C+L;DORMITORIO
15482760;;F;40;CHILENO;;X;PROVIDENCIA                   ;METROPOLITANA;305980;2;1;0;0;0;2;1;305980;CE ERGO T 2P 2MT BD;DORMITORIO
10618094;Soltero;F;53;CHILENO;PROFESOR;X;N/D;N/D;399980;2;1;0;0;0;2;1;399980;Camarote 1P Texas Evolution + 2 Al;DORMITORIO
8143813;;M;71;CHILENO;;Silencioso;TEMUCO                        ;ARAUCANIA;667970;5;3;0;0;0;5;3;667970;COLCHON ART 4 2.00X2.00;DORMITORIO
13368563;;F;44;CHILENO;;X;SANTO DOMINGO                 ;VALPARAISO;961030;18;7;0;0;0;18;7;961030;CE ERGO T 2P 2MT BD;DORMITORIO
12562494;;F;48;CHILENO;;X;N/D;N/D;335960;4;1;0;0;0;4;1;335960;COLCHON TERAPEUTIC 2P PILLOW TOP;DORMITORIO
17881705;;F;30;CHILENO;;Millenial;NUEVA IMPERIAL                ;ARAUCANIA;1796476;16;10;0;0;0;16;10;1796476;BOX BAMBOO + Respaldo + 2 Veladores ALICANTE;DORMITORIO
8195223;;M;61;CHILENO;;Boomers;SAN FELIPE                    ;VALPARAISO;1202910;10;4;1;1;189990;9;3;1012920;CE NEW STYLE 2 2P 2MT BD;DORMITORIO
16920294;;F;34;CHILENO;;Millenial;ILLAPEL                       ;COQUIMBO;27980;2;2;0;0;0;2;2;27980;PACK 2 ALMOHADAS C+L;DORMITORIO
9573399;;M;57;CHILENO;;Boomers;SAN PEDRO DE LA PAZ           ;BIO BIO;1433250;10;4;0;0;0;10;4;1433250;CE CAMA NEW STYLE 6 2PL BD RESP. FERRARA;DORMITORIO
14470498;;M;48;CHILENO;;X;TALAGANTE                     ;METROPOLITANA;462950;5;2;0;0;0;5;2;462950;COLCHON BAMBOO 2P FIBRAS BAMBOO;DORMITORIO
6829094;;M;68;CHILENO;;Boomers;IQUIQUE                       ;TARAPACA;169990;1;1;0;0;0;1;1;169990;CE EVOLUTION BLACK 1,5P BN DUAL SIDE;DORMITORIO
10873168;;F;57;CHILENO;;Boomers;TOCOPILLA                     ;ANTOFAGASTA;10990;1;1;0;0;0;1;1;10990;PACK 2 ALMOHADAS C+L;DORMITORIO
13354518;;M;43;CHILENO;;X;"";"";242960;4;3;0;0;0;4;3;242960;PACK 2 ALMOHADAS-D VISCO 60 x 40;DORMITORIO
11905212;;F;51;CHILENO;;X;LA SERENA                     ;COQUIMBO;233960;4;3;0;0;0;4;3;233960;PACK 2 ALMOHADAS C+L;DORMITORIO
16347879;;F;36;CHILENO;;Millenial;ARAUCO                        ;BIO BIO;154980;3;2;0;0;0;3;2;154980;PACK 2 ALMOHADAS C+L;DORMITORIO
16732650;;M;35;CHILENO;;Millenial;RENCA                         ;METROPOLITANA;291980;2;1;0;0;0;2;1;291980;CAMA EUR WAVE 1.50X1.90 BN RESP TABOR G;DORMITORIO
14589879;;F;42;CHILENO;;X;MELIPILLA                     ;METROPOLITANA;1049300;12;6;0;0;0;12;6;1049300;COLCHON ERGO T 2P 150X200;DORMITORIO
9553483;;F;57;CHILENO;;Boomers;LLAILLAY                      ;VALPARAISO;574310;7;5;0;0;0;7;5;574310;CE ERGO T 2P 2MT BD;DORMITORIO
11538269;;F;52;CHILENO;;X;CORONEL                       ;BIO BIO;762730;5;3;2;1;330980;3;2;431750;CAMA EUROPEA SPRING VI 2.0 PL B/D;DORMITORIO
12005050;;F;49;CHILENO;;X;CALERA                        ;VALPARAISO;489950;5;3;0;0;0;5;3;489950;BASE AMERICANA SPRING VI 2.0 PL;DORMITORIO
18240256;;M;31;CHILENO;;Millenial;ARICA                         ;TARAPACA;350970;3;1;3;1;350970;0;0;0;CLOSET 6 PUERTAS 2 CAJONES 1 ZAPATERA BALI BICO;DORMITORIO
14433678;;M;50;CHILENO;;X;SANTIAGO                      ;METROPOLITANA;1254920;7;2;7;2;1254920;0;0;0;CAMA EUR WAVE 1.50X1.90 BN RESP TABOR G;DORMITORIO
15771555;;F;38;CHILENO;;Millenial;N/D;N/D;719950;5;4;0;0;0;5;4;719950;COLCHON NEW ORTOPEDIC 1P;DORMITORIO
9103317;;M;59;CHILENO;;Boomers;LO PRADO                      ;METROPOLITANA;159980;2;1;2;1;159980;0;0;0;CE EVOLUTION BLACK 1P BN DUAL SIDE;DORMITORIO
7404719;;F;68;CHILENO;;Boomers;ILLAPEL                       ;COQUIMBO;504980;2;2;0;0;0;2;2;504980;CE EVOLUTION BLACK 2P BN+RESP+2 VEL;DORMITORIO
18951906;;F;28;CHILENO;;Millenial;PROVIDENCIA                   ;METROPOLITANA;345970;3;2;0;0;0;3;2;345970;ALMOHADA BAMBOO TECH SERIES 65X45 CM;DORMITORIO
10798217;;F;55;CHILENO;;Boomers;RENCA                         ;METROPOLITANA;469980;2;1;0;0;0;2;1;469980;CE EVOLUTION BLACK 2P BN+RESP+2 VEL;DORMITORIO
5841306;;F;76;CHILENO;;Silencioso;SAN ANTONIO                   ;VALPARAISO;454970;4;3;0;0;0;4;3;454970;ALMOHADA VISCO ELASTICA CANNABIS 60X40CM;DORMITORIO
15298340;;F;40;CHILENO;;X;"";"";9990;1;1;0;0;0;1;1;9990;PACK 2 ALMOHADAS C+L;DORMITORIO
9555846;;F;62;CHILENO;;Boomers;TALCA                         ;MAULE;4990;1;1;0;0;0;1;1;4990;PACK 2 ALMOHADAS C+L;DORMITORIO
16673128;;M;35;CHILENO;;Millenial;CARAHUE                       ;ARAUCANIA;950700;9;6;0;0;0;9;6;950700;CE EVOLUTION BLACK 1,5P + RESPALDO CASTILLA;DORMITORIO
19984908;;F;24;CHILENO;;Z;PROVIDENCIA                   ;METROPOLITANA;4990;1;1;1;1;4990;0;0;0;PACK 2 ALMOHADAS C+L;DORMITORIO
19273680;Soltero;M;25;CHILENO;;Z;PROVIDENCIA                   ;METROPOLITANA;29980;2;2;0;0;0;2;2;29980;PACK 2 ALMOHADAS C+L;DORMITORIO
19363327;Soltero;F;26;CHILENO;;Z;PROVIDENCIA                   ;METROPOLITANA;4990;1;1;0;0;0;1;1;4990;PACK 2 ALMOHADAS C+L;DORMITORIO
15145666;;F;39;CHILENO;;X;MAULE                         ;MAULE;400950;6;3;0;0;0;6;3;400950;Almohada Imperial Soft 50x70 cm;DORMITORIO
10776111;;M;56;CHILENO;;Boomers;COIHAIQUE                     ;AYSEN;2524990;38;20;0;0;0;38;20;2524990;SET 2 ALMOHADAS VISCO MEDIUM 60X40 CM;DORMITORIO
10904399;;F;55;CHILENO;;Boomers;LINARES                       ;MAULE;18691;1;1;0;0;0;1;1;18691;ALMOHADA COOL GEL TECH SERIES 60X40 CM;DORMITORIO
14333965;;F;45;CHILENO;;X;SAN CARLOS                    ;BIO BIO;4990;1;1;0;0;0;1;1;4990;PACK 2 ALMOHADAS C+L;DORMITORIO
20143248;;M;22;CHILENO;;Silencioso;PROVIDENCIA                   ;METROPOLITANA;189980;2;1;2;1;189980;0;0;0;BOX AMERICANO EXCELLENCE 2P BASE NORMAL+2ALM;DORMITORIO
17035526;;F;33;CHILENO;;Millenial;"";"";5000;2;1;0;0;0;2;1;5000;PACK 2 ALMOHADAS C+L;DORMITORIO
9517431;;F;60;CHILENO;;Boomers;HUALQUI                       ;BIO BIO;600081;9;5;0;0;0;9;5;600081;CE EVOLUTION BLACK 1P + RESPALDO CASTILLA;DORMITORIO
19000026;;F;27;CHILENO;;Millenial;PROVIDENCIA                   ;METROPOLITANA;1136920;8;5;0;0;0;8;5;1136920;PACK 2 ALMOHADAS C+L;DORMITORIO
9639261;;M;56;CHILENO;;Boomers;FREIRINA                      ;ATACAMA;317979;2;1;0;0;0;2;1;317979;COLCHON IBIZA 2P;DORMITORIO
13779361;;M;42;CHILENO;;X;PICHILEMU                     ;L.G.B.OÂ´HIGGINS;824850;7;4;0;0;0;7;4;824850;COLCHON TERAPEUTIC 2P PILLOW TOP;DORMITORIO
17640128;;F;31;CHILENO;;Millenial;CHILLAN                       ;BIO BIO;9980;2;1;2;1;9980;0;0;0;PACK 2 ALMOHADAS C+L;DORMITORIO
19654168;;M;25;CHILENO;;Z;PROVIDENCIA                   ;METROPOLITANA;357450;5;3;0;0;0;5;3;357450;COLCHON SPRING III 1P;DORMITORIO
18989110;;F;27;CHILENO;;Z;VALPARAISO;VALPARAISO;476960;4;2;4;2;476960;0;0;0;CE EXCEL PLUS 2P BD+RESP+2VEL NEW DUBLIN CHOC;DORMITORIO
10785320;;F;54;CHILENO;;X;EL BOSQUE                     ;METROPOLITANA;339980;2;1;0;0;0;2;1;339980;CAMA EUROPEA IBIZA 1,5 PL;DORMITORIO
12218955;;F;49;CHILENO;;X;PROVIDENCIA                   ;METROPOLITANA;248980;2;1;2;1;248980;0;0;0;CAMA MULTI RETRACTIL 1.5P;DORMITORIO
19286977;;M;25;CHILENO;;Z;LOS ANGELES                   ;BIO BIO;566940;6;3;2;1;169980;4;2;396960;CE EVOLUTION BLACK 1,5P + RESPALDO CASTILLA;DORMITORIO
10764927;;F;59;CHILENO;;Boomers;N/D;N/D;447600;4;1;0;0;0;4;1;447600;CE EVOLUTION BLACK 1,5P BN RESP+VEL;DORMITORIO
8048243;;F;61;CHILENO;;Boomers;CASTRO                        ;LOS LAGOS;366890;4;2;0;0;0;4;2;366890;CE EVOLUTION BLACK 1,5P + RESPALDO CASTILLA;DORMITORIO
12661401;;F;47;CHILENO;;X;MAIPU                         ;METROPOLITANA;248970;3;2;2;1;241980;1;1;6990;DIVAN CAMA ERGO T 1,5P 2 MTS;DORMITORIO
9494805;;F;58;CHILENO;;Boomers;PROVIDENCIA                   ;METROPOLITANA;313980;2;1;2;1;313980;0;0;0;CE ERGO T 2P 2MT BD;DORMITORIO
26761562;;M;31;VENEZOLANO;;Extranjero;N/D;N/D;1274500;8;2;0;0;0;8;2;1274500;ALMOHADA ROSEN SOFT PLUS AMERICANA;DORMITORIO
17724225;;M;31;CHILENO;;Millenial;TOCOPILLA                     ;ANTOFAGASTA;426200;6;3;0;0;0;6;3;426200;Almohadas Isidora Soft 50x90 cm;DORMITORIO
12441075;;M;51;CHILENO;;X;CALAMA                        ;ANTOFAGASTA;492230;4;1;0;0;0;4;1;492230;COLCHON BAMBOO 1,5P FIBRAS BAMBOO;DORMITORIO
6021444;;F;74;CHILENO;;Silencioso;VILLARICA                     ;ARAUCANIA;795260;11;4;0;0;0;11;4;795260;COLCHON BAMBOO 1,5P FIBRAS BAMBOO;DORMITORIO
8159815;;F;65;CHILENO;;Boomers;LA SERENA                     ;COQUIMBO;2715740;27;5;0;0;0;27;5;2715740;ALMOHADA ROSEN SOFT PLUS KING;DORMITORIO
9737332;;F;58;CHILENO;;Boomers;COIHAIQUE                     ;AYSEN;92970;3;2;0;0;0;3;2;92970;PACK 2 ALMOHADAS 100% PLUMA 50 X 70 CM;DORMITORIO
13834589;Soltero;F;42;CHILENO;;X;PROVIDENCIA                   ;METROPOLITANA;169980;2;1;2;1;169980;0;0;0;COLCHON NEW ORTOPEDIC 2P;DORMITORIO
15190068;;M;40;CHILENO;;Millenial;"";"";229990;1;1;0;0;0;1;1;229990;COLCHON NEW ORTOPEDIC 2P;DORMITORIO
16653129;;F;34;CHILENO;;Millenial;PROVIDENCIA                   ;METROPOLITANA;577980;2;1;2;1;577980;0;0;0;CAMA EUROPEA PREMIUM 2PBD + ALM+PL;DORMITORIO
13360829;;F;50;CHILENO;;X;LA SERENA                     ;COQUIMBO;765090;8;3;0;0;0;8;3;765090;CE NEW ORTOPEDIC 2PBD;DORMITORIO
19673973;;M;26;CHILENO;;Z;PROVIDENCIA                   ;METROPOLITANA;428970;3;2;3;2;428970;0;0;0;CAMA EUROPEA THERAPEDIC MAS FULL;DORMITORIO
11715118;;M;50;CHILENO;;X;QUEILEN                       ;LOS LAGOS;603211;4;5;0;0;0;4;5;603211;CE EVOLUTION BLACK 2P BN+RESP+2 VEL;DORMITORIO
19790215;;M;24;CHILENO;;Z;BUIN                          ;METROPOLITANA;512920;8;8;0;0;0;8;8;512920;COLCHON BAMBOO 1,5P FIBRAS BAMBOO;DORMITORIO
20261932;;M;22;CHILENO;;Z;PROVIDENCIA                   ;METROPOLITANA;159960;4;2;2;1;149980;2;1;9980;COLCHON SPRING VI 2P;DORMITORIO
13143356;;F;45;CHILENO;;X;VALPARAISO                    ;VALPARAISO;14970;3;1;0;0;0;3;1;14970;ALMOHADA SOFT MICROGEL;DORMITORIO
18750046;;M;27;CHILENO;;Millenial;"";"";5000;2;1;0;0;0;2;1;5000;PACK 2 ALMOHADAS C+L;DORMITORIO
19789853;;F;23;CHILENO;;Z;PROVIDENCIA                   ;METROPOLITANA;291980;2;1;2;1;291980;0;0;0;CE ERGO T 2P 2MT BD;DORMITORIO
11676647;;F;51;CHILENO;;X;RENCA                         ;METROPOLITANA;188980;2;1;2;1;188980;0;0;0;CLOSET DANUBIO, BICOLOR, 4 PTAS 3 CAJ.;DORMITORIO
6079771;;F;71;CHILENO;;Silencioso;SAN FERNANDO                  ;L.G.B.OÂ´HIGGINS;42970;3;3;0;0;0;3;3;42970;PACK 2 ALMOHADAS C+L;DORMITORIO
14398468;;F;44;CHILENO;;X;"";"";99990;1;1;1;1;99990;0;0;0;COLCHON NEW ORTOPEDIC 1,5P;DORMITORIO
17445917;;F;36;CHILENO;;Millenial;NUEVA IMPERIAL                ;ARAUCANIA;926930;8;6;0;0;0;8;6;926930;COLCHON NEW ORTOPEDIC 1P;DORMITORIO
19907503;;M;24;CHILENO;;Z;ARAUCO                        ;BIO BIO;15990;3;1;0;0;0;3;1;15990;Pack Imperial Soft 45x65 cm.;DORMITORIO
12391205;Casado;M;49;CHILENO;;X;RENCA                         ;METROPOLITANA;743060;4;2;0;0;0;4;2;743060;COLCHON BAMBOO 2P FIBRAS BAMBOO;DORMITORIO
5967831;Casado;M;73;CHILENO;AGROINDUSTRIA;Silencioso;RENCA                         ;METROPOLITANA;365070;3;1;0;0;0;3;1;365070;COLCHON BAMBOO 1,5P FIBRAS BAMBOO;DORMITORIO
12519792;;F;49;CHILENO;;X;TALCA                         ;MAULE;360960;4;3;0;0;0;4;3;360960;ALMOHADA VISCO ELASTICA CANNABIS 60X40CM;DORMITORIO
8555834;;M;63;CHILENO;;Boomers;SAN FERNANDO                  ;L.G.B.OÂ´HIGGINS;852980;5;2;0;0;0;5;2;852980;CE NEW STYLE 6 2P 2MT BD+RESP+2VEL FERRARA;DORMITORIO
9553445;;F;56;CHILENO;;Boomers;QUEILEN                       ;LOS LAGOS;190970;3;1;0;0;0;3;1;190970;COLCHON NEW ORTOPEDIC 1P;DORMITORIO
18996140;;M;27;CHILENO;;Z;PROVIDENCIA                   ;METROPOLITANA;116980;2;1;2;1;116980;0;0;0;COMODA CIPRES MODELO CP25D, COLOR DEMOLICION, 2;DORMITORIO
11821105;;F;51;CHILENO;;X;N/D;N/D;526960;4;4;0;0;0;4;4;526960;COLCHON TERAPEUTIC 2P PILLOW TOP;DORMITORIO
27145284;Soltero;F;30;EXTRANJERO - NO INFORMA NACIONALIDAD;;Extranjero;N/D;N/D;347960;4;2;4;2;347960;0;0;0;COMODA 4C MOD F262 - BLANCO;DORMITORIO
15049291;;M;38;CHILENO;;X;RENCA                         ;METROPOLITANA;136980;2;1;2;1;136980;0;0;0;COMODA POLUX 8CJNS BICOLOR NOGAL - OLMO;DORMITORIO
16372101;;F;36;CHILENO;;Millenial;PUENTE ALTO                   ;METROPOLITANA;209970;3;1;0;0;0;3;1;209970;COLCHON EVOLUTION BLACK 1P DUAL SIDE;DORMITORIO
15326432;;M;51;CHILENO;;X;NATALES                       ;MAGALLANES;541960;4;3;0;0;0;4;3;541960;COLCHON BAMBOO 2P FIBRAS BAMBOO;DORMITORIO
9424827;Casado;M;59;CHILENO;;Boomers;RENCA                         ;METROPOLITANA;303980;2;1;2;1;303980;0;0;0;CAMA NIDO EVOLUTION BLACK 1,5P;DORMITORIO
7201042;Casado;F;67;CHILENO;;Boomers;SAN BERNARDO                  ;METROPOLITANA;242970;3;1;0;0;0;3;1;242970;CE EVOLUTION BLACK 1P BN DUAL SIDE;DORMITORIO
15298564;;F;40;CHILENO;;X;"";"";4990;1;1;0;0;0;1;1;4990;PACK 2 ALMOHADAS C+L;DORMITORIO
4963325;;F;76;CHILENO;;Silencioso;VINA DEL MAR                  ;VALPARAISO;170980;2;1;0;0;0;2;1;170980;COLCHON NEW ORTOPEDIC 1P;DORMITORIO
7449896;;F;68;CHILENO;;Silencioso;SAN FERNANDO                  ;L.G.B.OÂ´HIGGINS;4990;1;1;0;0;0;1;1;4990;PACK 2 ALMOHADAS C+L;DORMITORIO
12447255;;F;48;CHILENO;;X;PROVIDENCIA                   ;METROPOLITANA;709940;5;2;5;2;709940;0;0;0;SET MADERAS BILBAO 1 1/2PL;DORMITORIO
12934944;Casado;F;48;CHILENO;;X;RENCA                         ;METROPOLITANA;356980;2;1;2;1;356980;0;0;0;CE CAMA ERGO T 1.50X2.00 BD + RESP FERRARA;DORMITORIO
18519613;;F;29;CHILENO;;Millenial;PROVIDENCIA                   ;METROPOLITANA;259980;2;1;2;1;259980;0;0;0;CAMA EUROPEA EXCELLENCE PLUS 2 PLAZAS BD;DORMITORIO
15574832;;M;30;CHILENO;;Millenial;MONTE PATRIA                  ;COQUIMBO;878500;5;3;0;0;0;5;3;878500;CE EVOLUTION BLACK 2P BN+RESP+2 VEL;DORMITORIO
8807892;;M;59;CHILENO;;Boomers;RENCA                         ;METROPOLITANA;276970;3;1;3;1;276970;0;0;0;COLCHON NEW ORTOPEDIC 1,5P;DORMITORIO
13833870;;M;43;CHILENO;;X;LA FLORIDA                    ;METROPOLITANA;139980;2;1;2;1;139980;0;0;0;CLOSET M-801 6P+2C ALTO 1,82 BLANCO NATURAL;DORMITORIO
20338894;;M;22;CHILENO;;Z;PROVIDENCIA                   ;METROPOLITANA;209980;2;1;2;1;209980;0;0;0;CE EVOLUTION BLACK 1,5P BN RESP+VEL;DORMITORIO
13324972;;M;45;CHILENO;;X;AISEN                         ;AYSEN;627960;4;3;0;0;0;4;3;627960;COLCHON BAMBOO 2P FIBRAS BAMBOO;DORMITORIO
14266142;Soltero;F;55;CHILENO;;Boomers;PROVIDENCIA                   ;METROPOLITANA;708970;4;1;0;0;0;4;1;708970;CE BAMBOO 2PBD BAMBOO+RES+2V ALICANTE;DORMITORIO
24725607;;M;23;CHILENO;;Extranjero;PROVIDENCIA                   ;METROPOLITANA;214980;2;1;2;1;214980;0;0;0;BOX AMERICANO EXCELLENCE FULL PLAZA +2ALM+PLU;DORMITORIO
8364356;Casado;F;62;CHILENO;;Boomers;RENCA                         ;METROPOLITANA;290980;2;1;0;0;0;2;1;290980;COLCHON ORTOPEDIC ADVANCE 2P;DORMITORIO
6096091;;F;73;CHILENO;;Silencioso;ANDACOLLO                     ;COQUIMBO;129980;2;1;0;0;0;2;1;129980;CLOSET M-803 3P 2C ALTO 1,82 BLANCO NATURAL;DORMITORIO
8234335;;M;50;CHILENO;;X;LANCO                         ;LOS RIOS;115970;3;2;0;0;0;3;2;115970;ALMOHADA SOFT MICROGEL;DORMITORIO
8729732;;F;65;CHILENO;;Boomers;CONSTITUCION                  ;MAULE;16470;3;1;0;0;0;3;1;16470;Almohada Imperial Soft 50x70 cm;DORMITORIO
11523219;;F;52;CHILENO;;X;PUENTE ALTO                   ;METROPOLITANA;16990;1;1;0;0;0;1;1;16990;ALMOHADA BAMBOO TECH SERIES 65X45 CM;DORMITORIO
13686347;Casado;F;46;CHILENO;;X;LOS VILOS                     ;COQUIMBO;179990;1;1;0;0;0;1;1;179990;COLCHON BAMBOO 2P FIBRAS BAMBOO;DORMITORIO
15752167;;M;40;CHILENO;;X;PUNTA ARENAS                  ;MAGALLANES;20990;1;2;0;0;0;1;2;20990;ALMOHADA MEMORY MAX BASIC AMERICANA;DORMITORIO
14553391;Divorciado;F;42;CHILENO;;X;RENCA                         ;METROPOLITANA;330980;2;1;2;1;330980;0;0;0;CE EXCELLENCE PLUS 2P BN+RESP+2VEL NEW MUNICH;DORMITORIO
7085705;;F;67;CHILENO;;Boomers;CALAMA                        ;ANTOFAGASTA;420970;3;2;0;0;0;3;2;420970;CAMA EUROPEA THERAPEDIC MAS 1,5P;DORMITORIO
18877483;;F;27;CHILENO;;Millenial;PROVIDENCIA                   ;METROPOLITANA;344970;3;3;0;0;0;3;3;344970;COLCHON BAMBOO 2P FIBRAS BAMBOO;DORMITORIO
14303549;;F;47;CHILENO;;X;GRANEROS                      ;L.G.B.OÂ´HIGGINS;338970;3;2;0;0;0;3;2;338970;CE EVOLUTION BLACK 1,5P + RESPALDO CASTILLA;DORMITORIO
15749978;;F;38;CHILENO;;Millenial;CALBUCO                       ;LOS LAGOS;59980;2;1;2;1;59980;0;0;0;RACK BELLINI 50;DORMITORIO
10077447;;M;49;CHILENO;;X;PROVIDENCIA                   ;METROPOLITANA;214980;2;1;2;1;214980;0;0;0;Closet MAIPO 6PT 4CJ 180 CM CHOCOLATE;DORMITORIO
17211828;;F;33;CHILENO;;Millenial;CONSTITUCION                  ;MAULE;1285910;10;2;0;0;0;10;2;1285910;CE CANNABIS 2P BD+PILLOW TOP;DORMITORIO
17041248;;F;34;CHILENO;;Millenial;N/D;N/D;1968710;17;7;0;0;0;17;7;1968710;COLCHON NEW ORTOPEDIC 2P;DORMITORIO
15220395;;F;40;CHILENO;;X;RENCA                         ;METROPOLITANA;97980;2;1;2;1;97980;0;0;0;SET RESP+VEL VIENA KING CAFE;DORMITORIO
20137061;;M;23;CHILENO;;Z;ISLA DE MAIPO;METROPOLITANA;477940;6;3;6;3;477940;0;0;0;COLCHON EXCELLENCE 2 PLAZA + 2 ALM;DORMITORIO
15201827;;F;40;CHILENO;;X;TIRUA                         ;BIO BIO;838910;10;6;0;0;0;10;6;838910;PACK 2 ALMOHADAS C+L;DORMITORIO
10968504;Casado;F;49;CHILENO;;X;RENCA                         ;METROPOLITANA;39950;5;1;0;0;0;5;1;39950;Pack Imperial Soft 45x65 cm.;DORMITORIO
9823095;;F;58;CHILENO;;Boomers;TALCAHUANO                    ;BIO BIO;1720760;10;6;6;3;895800;4;3;824960;BOX AMERICANO EXCELLENCE PLUS 2P BD+2ALM ];DORMITORIO
17534756;;F;32;CHILENO;;Millenial;PROVIDENCIA                   ;METROPOLITANA;168960;4;2;4;2;168960;0;0;0;CLOSET ESPANA 6P+4C;DORMITORIO
7219522;;F;74;CHILENO;;Silencioso;PROVIDENCIA                   ;METROPOLITANA;11990;1;1;0;0;0;1;1;11990;PLUMON SINGLE 1,5 PZA ANDES;DORMITORIO
12197914;;F;49;CHILENO;;X;SAN CARLOS                    ;BIO BIO;996930;7;5;0;0;0;7;5;996930;PLUMON 2PZA ANDES;DORMITORIO
16846724;;F;34;CHILENO;;Millenial;SAN CLEMENTE                  ;MAULE;34990;1;1;0;0;0;1;1;34990;SET 2 ALMOHADAS VISCO MEDIUM 60X40 CM;DORMITORIO
17466128;;M;32;CHILENO;;Millenial;PROVIDENCIA                   ;METROPOLITANA;317970;2;1;2;1;317970;0;0;0;BA EXCELLENCE PLUS 2P BD +RESP+VEL OLMO;DORMITORIO
5735978;Casado;M;75;CHILENO;;Silencioso;PUENTE ALTO                   ;METROPOLITANA;313980;2;1;0;0;0;2;1;313980;COLCHON NEW STYLE 6 2P;DORMITORIO
15305029;;F;40;CHILENO;;X;RENCA                         ;METROPOLITANA;49990;1;1;0;0;0;1;1;49990;SET 2 ALMOHADAS VISCO MEDIUM 60X40 CM;DORMITORIO
8590926;;F;62;CHILENO;;Boomers;"";"";321960;3;1;0;0;0;3;1;321960;CAMA EUROPEA EXCELLENCE PLUS 1 PLAZA;DORMITORIO
9685795;;F;59;CHILENO;;Boomers;VILLARICA                     ;ARAUCANIA;-4990;-1;1;0;0;0;-1;1;-4990;PACK 2 ALMOHADAS C+L;DORMITORIO
20335766;;F;22;CHILENO;;Z;PUDAHUEL;METROPOLITANA;299960;4;2;4;2;299960;0;0;0;CLOSET ROMA 8 PUERTAS EXIT NOGAL 1,77X1,32X0,40;DORMITORIO
24264497;;F;48;PERUANO;;Extranjero;ARICA                         ;TARAPACA;125980;2;1;0;0;0;2;1;125980;COLCHON EXCELLENCE 1P;DORMITORIO
6579299;;F;68;CHILENO;;Boomers;TALCAHUANO                    ;BIO BIO;29990;1;1;0;0;0;1;1;29990;Almohada Visco Bamboo Classic Pack 60x40 cm;DORMITORIO
19784447;;F;24;CHILENO;;Z;PROVIDENCIA                   ;METROPOLITANA;201980;2;1;2;1;201980;0;0;0;CAMA AMERICANA BEAT 2 PLAZAS 150 X 190 CM;DORMITORIO
9522092;;F;58;CHILENO;;Boomers;CHIMBARONGO                   ;L.G.B.OÂ´HIGGINS;153470;3;3;0;0;0;3;3;153470;Almohada Imperial Soft 50x70 cm;DORMITORIO
9922751;;F;57;CHILENO;;Boomers;VICTORIA                      ;ARAUCANIA;215980;2;1;0;0;0;2;1;215980;COLCHON CASALINDA CDM 2PL X200;DORMITORIO
17012181;Casado;F;33;CHILENO;PROFESOR;Millenial;ARICA                         ;TARAPACA;784960;4;2;0;0;0;4;2;784960;CE EVOLUTION BLACK 1,5P BN RESP+VEL;DORMITORIO
13028389;;M;45;CHILENO;;Millenial;N/D;N/D;209980;2;1;2;1;209980;0;0;0;CAMA EURO GRIS NEW ENTREE-H FULL BOX;DORMITORIO
18112497;Soltero;F;30;CHILENO;;Millenial;PROVIDENCIA                   ;METROPOLITANA;541820;4;3;3;2;391830;1;1;149990;BS NEW ORTOPEDIC B5 BLACK 2P BD ALM;DORMITORIO
19345619;;M;26;CHILENO;;Z;PROVIDENCIA                   ;METROPOLITANA;289980;2;1;2;1;289980;0;0;0;CE ERGO T 2P 2MT BD;DORMITORIO
17401477;;M;32;CHILENO;;Millenial;SANTA CRUZ                    ;L.G.B.OÂ´HIGGINS;639030;6;3;0;0;0;6;3;639030;BOX AMERICANO MIRAGE 2PBN;DORMITORIO
15131360;;M;39;CHILENO;;X;ROMERAL;MAULE;241980;2;1;2;1;241980;0;0;0;BOX AM NEW ENTREE 1,5P+ Resp + 1 Vel ASTURIAS +;DORMITORIO
18289148;;F;29;CHILENO;;Millenial;PROVIDENCIA                   ;METROPOLITANA;515980;2;1;2;1;515980;0;0;0;CE CAMA SWAG 1.80X2.00;DORMITORIO
16225177;;M;36;CHILENO;;Millenial;ARICA                         ;ARICA Y PARINACOTA;139990;1;1;0;0;0;1;1;139990;COLCHON NEW ORTOPEDIC 1P;DORMITORIO
18011209;Soltero;F;30;CHILENO;PROFESOR;Millenial;PROVIDENCIA                   ;METROPOLITANA;9980;2;1;0;0;0;2;1;9980;PACK 2 ALMOHADAS C+L;DORMITORIO
16274136;;F;36;CHILENO;;Millenial;LONGAVI                       ;MAULE;1037431;8;4;6;3;897440;2;1;139991;CAMA AMERICANA SPRING VI 2.0 PL + ASTURIAS;DORMITORIO
10792907;Casado;F;54;CHILENO;;Boomers;PROVIDENCIA                   ;METROPOLITANA;183970;3;1;3;1;183970;0;0;0;COLCHON SPRING III 1P;DORMITORIO
11157244;Casado;F;54;CHILENO;;Boomers;RENCA                         ;METROPOLITANA;8990;1;1;0;0;0;1;1;8990;ALMOHADA SOFT MICROGEL;DORMITORIO
18656418;Soltero;M;28;CHILENO;;Millenial;LINARES                       ;MAULE;209970;3;1;0;0;0;3;1;209970;COLCHON BAMBOO 2P FIBRAS BAMBOO;DORMITORIO
13171312;;F;45;CHILENO;;X;ANTOFAGASTA                   ;ANTOFAGASTA;1783910;9;3;0;0;0;9;3;1783910;CE NEW STYLE 6 2P 2MT BD+RESP+2VEL FERRARA;DORMITORIO
27061329;;F;35;VENEZOLANO;;Extranjero;PROVIDENCIA                   ;METROPOLITANA;728980;2;1;2;1;728980;0;0;0;Cama Driven Super King;DORMITORIO
19531889;;F;25;CHILENO;;Z;N/D;N/D;13980;2;1;0;0;0;2;1;13980;ALMOHADA ROSEN SOFT PLUS AMERICANA;DORMITORIO
19755666;;F;24;CHILENO;;Z;PROVIDENCIA                   ;METROPOLITANA;239980;2;1;2;1;239980;0;0;0;Cama Europea Active 2PBN;DORMITORIO
5388141;Viudo;F;75;CHILENO;;Silencioso;RENCA                         ;METROPOLITANA;268980;2;1;0;0;0;2;1;268980;COLCHON BAMBOO 2P FIBRAS BAMBOO;DORMITORIO
17877858;;M;31;CHILENO;;Millenial;N/D;N/D;243980;2;1;2;1;243980;0;0;0;BA EXCELL PLUS 1,5P +RESP+1VEL NEW VILLARRICA;DORMITORIO
6699381;;M;65;CHILENO;;Boomers;"";"";339970;3;2;0;0;0;3;2;339970;BOX AMERICANO MIRAGE 2PBN;DORMITORIO
18978756;;F;27;CHILENO;;Z;TOME                          ;BIO BIO;379830;3;1;3;1;379830;0;0;0;CE ERGO T 2P 2MT BD;DORMITORIO
13945807;;F;41;CHILENO;;X;PROVIDENCIA                   ;METROPOLITANA;134540;2;1;2;1;134540;0;0;0;COLCHON EXCELLENCE FULL + 2 ALM;DORMITORIO
14758035;Soltero;M;49;COLOMBIANO;CIRUJANO DENTISTA;Extranjero;AISEN                         ;AYSEN;33970;3;2;0;0;0;3;2;33970;ALMOHADA ROSEN SOFT PLUS AMERICANA;DORMITORIO
13162334;;F;46;CHILENO;;X;OSORNO                        ;LOS LAGOS;533050;7;3;7;3;533050;0;0;0;COLCHON EXCELLENCE 1.5 PLAZA + CUBRECOLCHON;DORMITORIO
15899952;;M;37;CHILENO;;Millenial;N/D;N/D;1104950;5;2;0;0;0;5;2;1104950;CE EVEREST 2P 2MTS BD DUAL SIDE;DORMITORIO
8487717;;M;64;CHILENO;;Extranjero;NACIMIENTO                    ;BIO BIO;129990;1;1;0;0;0;1;1;129990;COLCHON EVOLUTION BLACK 1,5P DUAL SIDE;DORMITORIO
20363461;;F;22;CHILENO;;Silencioso;"";"";155840;2;1;2;1;155840;0;0;0;CLOSET M-801 6P+2C ALTO 1,82 BLANCO NATURAL;DORMITORIO
6269491;Casado;F;72;CHILENO;;Silencioso;RENCA                         ;METROPOLITANA;15980;2;1;0;0;0;2;1;15980;Almohadas Isidora Soft 50x90 cm;DORMITORIO
20196404;;F;22;CHILENO;;Z;VALPARAISO;VALPARAISO;272820;3;1;3;1;272820;0;0;0;COLCHON TERAPEUTIC 2P PILLOW TOP;DORMITORIO
19952745;;F;22;CHILENO;;Z;PROVIDENCIA                   ;METROPOLITANA;188540;2;1;2;1;188540;0;0;0;BOX AMERICANO EXCELLENCE 1.5 PLAZA + ALM;DORMITORIO
10612218;;F;51;CHILENO;;X;PROVIDENCIA                   ;METROPOLITANA;189980;2;1;2;1;189980;0;0;0;CE EVOLUTION BLACK 1,5P + RESPALDO CASTILLA;DORMITORIO
10248524;;F;51;CHILENO;;X;"";"";115970;4;2;2;1;99990;2;1;15980;Almohadas Isidora Soft 50x90 cm;DORMITORIO
13385913;;F;44;CHILENO;;X;LOS ANGELES                   ;BIO BIO;668160;3;1;0;0;0;3;1;668160;CE EVEREST 2P 2MTS BD DUAL SIDE;DORMITORIO
26502865;;F;28;VENEZOLANO;;Extranjero;"";"";1104900;9;5;7;3;1074920;2;2;29980;Almohada Bamboo Classic 70x40;DORMITORIO
7147919;;M;64;CHILENO;;Boomers;TOCOPILLA                     ;ANTOFAGASTA;730930;7;1;0;0;0;7;1;730930;CE EVOLUTION BLACK 2P BN+RESP+2 VEL;DORMITORIO
11829542;;M;51;CHILENO;;X;"";"";49990;1;1;0;0;0;1;1;49990;SET 2 ALMOHADAS VISCO MEDIUM 60X40 CM;DORMITORIO
16003542;;M;37;CHILENO;;Silencioso;PROVIDENCIA                   ;METROPOLITANA;191980;2;1;2;1;191980;0;0;0;CE EVOLUTION BLACK 1,5P + RESPALDO CASTILLA;DORMITORIO
18279093;;F;29;CHILENO;;Millenial;PROVIDENCIA                   ;METROPOLITANA;111980;2;1;2;1;111980;0;0;0;COLCHON EVOLUTION BLACK 1,5P DUAL SIDE;DORMITORIO
15639166;Casado;M;38;CHILENO;PSICOLOGO;X;PROVIDENCIA                   ;METROPOLITANA;179980;3;3;6;2;359960;-3;1;-179980;COLCHON EVOLUTION BLACK 1P DUAL SIDE;DORMITORIO
10357915;;F;58;CHILENO;;Boomers;CANETE                        ;BIO BIO;16980;2;2;0;0;0;2;2;16980;Pack Imperial Soft 45x65 cm.;DORMITORIO
14312229;;F;46;CHILENO;;X;N/D;N/D;233970;3;1;3;1;233970;0;0;0;COLCHON EXCELLENCE PLUS 2 PLAZAS 2M + 2 ALM;DORMITORIO
13515502;;F;44;CHILENO;;X;PROVIDENCIA                   ;METROPOLITANA;194980;2;1;2;1;194980;0;0;0;CE EVOLUTION BLACK 1,5P + RESPALDO ASTURIAS;DORMITORIO
20120918;;M;23;CHILENO;;Silencioso;PROVIDENCIA                   ;METROPOLITANA;73980;2;1;2;1;73980;0;0;0;CLOSET CROACIA BLANCO 4P;DORMITORIO
18081458;;F;30;CHILENO;;Millenial;MELIPILLA                     ;METROPOLITANA;316970;3;1;0;0;0;3;1;316970;CE EVOLUTION BLACK 1,5P BN RESP+VEL;DORMITORIO
16869385;;M;34;CHILENO;;Silencioso;PROVIDENCIA                   ;METROPOLITANA;1444940;6;3;6;3;1444940;0;0;0;CE SUPER PREMIUM KING +RESP+2VEL EUFRATES;DORMITORIO
15097081;;F;40;CHILENO;;X;VINA DEL MAR                  ;VALPARAISO;274980;2;1;2;1;274980;0;0;0;BOX AMERICANO EXCELLENCE PLUS 2P BD+2ALM ];DORMITORIO
13771134;;M;42;CHILENO;;X;TALAGANTE                     ;METROPOLITANA;183980;2;1;0;0;0;2;1;183980;COLCHON NEW STYLE 2 2P;DORMITORIO
19667197;;F;25;CHILENO;;Z;PROVIDENCIA                   ;METROPOLITANA;305980;2;1;2;1;305980;0;0;0;CAMA NIDO EVOLUTION BLACK 1,5P;DORMITORIO
17791406;;F;31;CHILENO;;Millenial;QUILPUE                       ;VALPARAISO;239980;2;1;2;1;239980;0;0;0;COLCHON TERAPEUTIC 2P PILLOW TOP;DORMITORIO
16081382;;F;36;CHILENO;;Millenial;N/D;N/D;265980;2;1;2;1;265980;0;0;0;DIVAN CAMA ERGO T 1,5P 2 MTS;DORMITORIO
26714238;;M;28;PERUANO;;Extranjero;N/D;N/D;444860;3;1;0;0;0;3;1;444860;CE NEW ORTOPEDIC 2PBD;DORMITORIO
10146586;;M;58;CHILENO;;Boomers;IQUIQUE                       ;TARAPACA;290670;2;1;0;0;0;2;1;290670;CE EVOLUTION BLACK 1,5P BN RESP+VEL;DORMITORIO
6754134;;F;67;CHILENO;;Boomers;RENCA                         ;METROPOLITANA;331970;3;1;3;1;331970;0;0;0;CE EVOLUTION BLACK 1,5P BN DUAL SIDE;DORMITORIO
15885442;;M;37;CHILENO;;Millenial;PROVIDENCIA                   ;METROPOLITANA;161980;2;1;2;1;161980;0;0;0;COLCHON 2PZA NEW VERSATILE BY ABCDIN;DORMITORIO
15203306;Casado;M;46;CHILENO;;X;RENCA                         ;METROPOLITANA;219980;2;1;0;0;0;2;1;219980;COLCHON NEW ORTOPEDIC 1,5P;DORMITORIO
10407654;;F;57;CHILENO;;Boomers;N/D;N/D;178960;4;2;4;2;178960;0;0;0;COLCHON SPRING III 1P;DORMITORIO
16849146;;F;34;CHILENO;;Millenial;PROVIDENCIA                   ;METROPOLITANA;195980;2;1;2;1;195980;0;0;0;CE EVOLUTION BLACK 1,5P + RESPALDO CASTILLA;DORMITORIO
8450304;Casado;M;64;CHILENO;;Boomers;PROVIDENCIA                   ;METROPOLITANA;531340;4;2;0;0;0;4;2;531340;CE EVOLUTION BLACK 1,5P BN RESP+VEL;DORMITORIO
11998717;;F;50;CHILENO;;X;LINARES                       ;MAULE;25980;2;1;0;0;0;2;1;25980;Almohada Bamboo Classic 70x40;DORMITORIO
6801579;;F;67;CHILENO;;Millenial;VILLARRICA;ARAUCANIA;13980;2;1;0;0;0;2;1;13980;Almohadas Isidora Soft 50x70 cm;DORMITORIO
15413505;;F;40;CHILENO;;X;PUDAHUEL                      ;METROPOLITANA;563960;3;1;3;1;563960;0;0;0;CE EVOLUTION BLACK 2P BN+RESP+2 VEL;DORMITORIO
6674410;Viudo;F;66;CHILENO;;Boomers;PROVIDENCIA                   ;METROPOLITANA;555930;5;1;0;0;0;5;1;555930;COLCHON BAMBOO 2P FIBRAS BAMBOO;DORMITORIO
19086668;;F;26;CHILENO;;Z;PROVIDENCIA                   ;METROPOLITANA;208540;2;1;2;1;208540;0;0;0;Closet BAKER TV 55 2PT 4CJ CHOCOLATE;DORMITORIO
26298808;;F;40;VENEZOLANO;;Extranjero;SAN FELIPE                    ;VALPARAISO;16980;2;1;0;0;0;2;1;16980;ALMOHADA ROSEN SOFT PLUS AMERICANA;DORMITORIO
15529838;;F;38;CHILENO;;Millenial;ANCUD                         ;LOS LAGOS;231670;5;2;5;2;231670;0;0;0;CLOSET CROACIA BLANCO 4P;DORMITORIO
8885097;;M;61;CHILENO;;Boomers;CARAHUE                       ;ARAUCANIA;627950;5;3;0;0;0;5;3;627950;CE EVOLUTION BLACK 1,5P BN RESP+VEL;DORMITORIO
19720280;;M;25;CHILENO;;Z;PROVIDENCIA                   ;METROPOLITANA;111980;2;1;2;1;111980;0;0;0;COLCHON EVOLUTION BLACK 1,5P DUAL SIDE;DORMITORIO
19548447;;F;25;CHILENO;;Z;PROVIDENCIA                   ;METROPOLITANA;154980;2;1;2;1;154980;0;0;0;CLOSET ESPANA 6P+4C;DORMITORIO
9233782;Casado;M;58;CHILENO;INGENIERO;Boomers;PARRAL                        ;MAULE;347970;3;1;0;0;0;3;1;347970;CE ERGO T 2P 2MT BD;DORMITORIO
17461537;;F;31;CHILENO;;Millenial;ANGOL                         ;ARAUCANIA;329970;3;2;2;1;189980;1;1;139990;CE EVOLUTION BLACK 1,5P BN RESP+VEL;DORMITORIO
13055487;;F;46;CHILENO;;X;CERRO NAVIA                   ;METROPOLITANA;519980;2;1;0;0;0;2;1;519980;COLCHON EVEREST KING 180X200;DORMITORIO
16177733;;F;37;CHILENO;;Millenial;N/D;N/D;227980;2;1;0;0;0;2;1;227980;BOX AMERICANO EXCELLENCE PLUS 1.5 PLAZA;DORMITORIO
13804798;Soltero;F;42;CHILENO;;X;RENCA                         ;METROPOLITANA;999960;4;2;4;2;999960;0;0;0;CE ART 4 BILBAO KING;DORMITORIO
6703666;;F;69;CHILENO;;Silencioso;SAN ANTONIO                   ;VALPARAISO;164980;2;1;0;0;0;2;1;164980;COLCHON ACTIVE 1,5P DUAL SIDE;DORMITORIO
16396388;Casado;F;38;CHILENO;;Millenial;LOS ANGELES                   ;BIO BIO;113980;2;1;2;1;113980;0;0;0;COLCHON EVOLUTION BLACK 1,5P DUAL SIDE;DORMITORIO
8462568;;M;63;CHILENO;;Boomers;COIHAIQUE                     ;AYSEN;9980;2;1;0;0;0;2;1;9980;PACK 2 ALMOHADAS C+L;DORMITORIO
10213846;;F;55;CHILENO;;Boomers;RENCA                         ;METROPOLITANA;247960;3;1;3;1;247960;0;0;0;COLCHON BEAT 1P;DORMITORIO
12284229;;F;50;CHILENO;;X;N/D;N/D;310670;2;1;0;0;0;2;1;310670;COLCHON TERAPEUTIC 2P PILLOW TOP;DORMITORIO
13362308;;M;44;CHILENO;;X;RENCA                         ;METROPOLITANA;212570;2;1;0;0;0;2;1;212570;COLCHON NEW ORTOPEDIC 1,5P;DORMITORIO
11603160;;M;51;CHILENO;;X;CANETE                        ;BIO BIO;23980;2;1;0;0;0;2;1;23980;ALMOHADA ROSEN SOFT PLUS KING;DORMITORIO
17298693;;M;32;CHILENO;;Millenial;N/D;N/D;584310;7;3;0;0;0;7;3;584310;CE ORTOPEDIC ADVANCE 1.5P;DORMITORIO
27041208;;F;37;VENEZOLANO;;Extranjero;"";"";149980;2;1;2;1;149980;0;0;0;COLCHON NEW ORTOPEDIC 2P;DORMITORIO
15040529;;M;40;CHILENO;;Millenial;PROVIDENCIA                   ;METROPOLITANA;935980;2;1;2;1;935980;0;0;0;CE ART 4 1.80X2.00 ISSEY GRAFITO KING;DORMITORIO
9865160;Casado;M;58;CHILENO;;Boomers;MALLOA                        ;L.G.B.OÂ´HIGGINS;259650;4;1;0;0;0;4;1;259650;BA BEAT 2P 2MTS BN;DORMITORIO
10954165;;F;55;CHILENO;;Boomers;PARRAL                        ;MAULE;31960;4;1;0;0;0;4;1;31960;ALMOHADA SOFT MICROGEL;DORMITORIO
19906394;;F;24;CHILENO;;Z;SAN MIGUEL                    ;METROPOLITANA;139980;2;1;2;1;139980;0;0;0;CE EVOLUTION BLACK 1,5P + RESPALDO CASTILLA;DORMITORIO
11400005;;F;53;CHILENO;;X;PROVIDENCIA                   ;METROPOLITANA;84980;2;1;2;1;84980;0;0;0;CLOSET M-803 3P 2C ALTO 1,82 BLANCO NATURAL;DORMITORIO
13288234;;M;44;CHILENO;;X;N/D;N/D;139980;2;1;2;1;139980;0;0;0;CE EVOLUTION BLACK 1,5P + RESPALDO CASTILLA;DORMITORIO
11712595;;F;52;CHILENO;;X;PUERTO MONTT                  ;LOS LAGOS;89970;3;1;0;0;0;3;1;89970;Almohada ViscoGel Cobre 70x40x13 cm;DORMITORIO
17177879;;F;46;CHILENO;;Silencioso;PROVIDENCIA                   ;METROPOLITANA;11970;3;1;0;0;0;3;1;11970;PACK 2 ALMOHADAS C+L;DORMITORIO
15045136;;F;37;CHILENO;;Silencioso;PROVIDENCIA                   ;METROPOLITANA;433520;4;2;4;2;433520;0;0;0;COMODA CIPRES MODELO CP10D, COLOR DEMOLICION, 1;DORMITORIO
13678680;;F;43;CHILENO;;X;MAIPU                         ;METROPOLITANA;3990;1;1;0;0;0;1;1;3990;PACK 2 ALMOHADAS C+L;DORMITORIO
19169139;;M;26;CHILENO;;Z;N/D;N/D;63800;6;1;6;1;63800;0;0;0;ALMOHADA VISCO SLEEP TECH SERIES 65X45 CM;DORMITORIO
12444077;;M;49;CHILENO;;X;LA SERENA                     ;COQUIMBO;274870;2;1;0;0;0;2;1;274870;CAMA EUROPEA THERAPEDIC MAS 1,5P;DORMITORIO
19716311;;F;24;CHILENO;;Silencioso;PROVIDENCIA                   ;METROPOLITANA;213980;2;1;2;1;213980;0;0;0;CE EVOLUTION BLACK 2P BD DUAL SIDE;DORMITORIO
13752071;;F;42;CHILENO;;X;CATEMU                        ;VALPARAISO;309980;2;1;2;1;309980;0;0;0;CE EVOLUTION BLACK 2P BN+RESP+2 VEL;DORMITORIO
15880293;;F;37;CHILENO;;Millenial;TEMUCO                        ;ARAUCANIA;3990;1;1;0;0;0;1;1;3990;PACK 2 ALMOHADAS C+L;DORMITORIO
15016359;;F;39;CHILENO;;X;PROVIDENCIA                   ;METROPOLITANA;269980;2;1;2;1;269980;0;0;0;COLCHON ORTOPEDIC ADVANCE KING 180X200;DORMITORIO
13671044;;M;43;CHILENO;;Millenial;N/D;N/D;525060;3;2;0;0;0;3;2;525060;CE EVOLUTION BLACK 2P BN+RESP+2 VEL;DORMITORIO
13013095;Casado;M;46;CHILENO;;X;PROVIDENCIA                   ;METROPOLITANA;219980;2;1;2;1;219980;0;0;0;CE EVOLUTION BLACK 2P BD DUAL SIDE;DORMITORIO
18135780;;F;29;CHILENO;;Millenial;PROVIDENCIA                   ;METROPOLITANA;326960;4;2;4;2;326960;0;0;0;DIVAN CAMA ERGO T 1,5P 2 MTS;DORMITORIO
6896859;;M;68;CHILENO;;Silencioso;LA CRUZ                       ;VALPARAISO;121360;3;1;0;0;0;3;1;121360;COLCHON EVOLUTION BLACK 1P DUAL SIDE;DORMITORIO
12098178;;F;52;CHILENO;;X;N/D;N/D;0;0;2;0;0;0;0;2;0;COLCHON TERAPEUTIC 2P PILLOW TOP;DORMITORIO
19656036;;M;25;CHILENO;;Silencioso;PROVIDENCIA                   ;METROPOLITANA;124540;2;1;2;1;124540;0;0;0;ESCRITORIO FAVATEX YATES CASTANO-NEGRO;DORMITORIO
11697913;;F;50;CHILENO;;X;PROVIDENCIA                   ;METROPOLITANA;239990;1;1;0;0;0;1;1;239990;COLCHON BAMBOO 2P FIBRAS BAMBOO;DORMITORIO
8008507;;M;61;CHILENO;;Boomers;N/D;N/D;1088140;8;2;8;2;1088140;0;0;0;CLOSET CAJONERA NEW BELGICA M-398-NW;DORMITORIO
14006832;;F;41;CHILENO;;X;MELIPILLA                     ;METROPOLITANA;209980;2;1;0;0;0;2;1;209980;CE EVOLUTION BLACK 1,5P BN RESP+VEL;DORMITORIO
20193493;;F;22;CHILENO;;Z;PROVIDENCIA                   ;METROPOLITANA;5990;1;1;0;0;0;1;1;5990;Almohadas Isidora Soft 50x70 cm;DORMITORIO
11701079;Soltero;F;53;CHILENO;;X;PROVIDENCIA                   ;METROPOLITANA;259990;1;1;0;0;0;1;1;259990;COLCHON TERAPEUTIC 2P PILLOW TOP;DORMITORIO
20318120;;F;23;CHILENO;;Z;PROVIDENCIA                   ;METROPOLITANA;138540;2;1;2;1;138540;0;0;0;COLCHON EXCELLENCE FULL + 2 ALM;DORMITORIO
17705452;;F;31;CHILENO;;Millenial;PROVIDENCIA                   ;METROPOLITANA;339520;3;1;3;1;339520;0;0;0;DIVAN CAMA ERGO T 1,5P 2 MTS;DORMITORIO
6328869;;M;73;CHILENO;;Silencioso;PROVIDENCIA                   ;METROPOLITANA;675650;5;1;5;1;675650;0;0;0;CE EVOLUTION BLACK 2P BD DUAL SIDE;DORMITORIO
20475217;;F;22;CHILENO;;Silencioso;PROVIDENCIA                   ;METROPOLITANA;-84990;-1;1;-1;1;-84990;0;0;0;COMODA ROVERE 1 PUERTA 3 CAJONES BICOLOR;DORMITORIO
15110389;;M;39;CHILENO;;X;N/D;N/D;8490;1;1;0;0;0;1;1;8490;ALMOHADA ROSEN SOFT PLUS AMERICANA;DORMITORIO
12816564;;F;47;CHILENO;;X;CABILDO                       ;VALPARAISO;359980;2;1;2;1;359980;0;0;0;BS NEW ORTOPEDIC B5BLACK 2PBN+RESP+2VEL LEGNO;DORMITORIO
18721794;;M;28;CHILENO;;Millenial;N/D;N/D;3990;1;1;0;0;0;1;1;3990;PACK 2 ALMOHADAS C+L;DORMITORIO
7676809;;F;66;CHILENO;;Boomers;QUILLOTA                      ;VALPARAISO;8490;1;1;0;0;0;1;1;8490;ALMOHADA ROSEN SOFT PLUS AMERICANA;DORMITORIO
18819161;;F;27;CHILENO;;Millenial;PROVIDENCIA                   ;METROPOLITANA;7980;2;1;0;0;0;2;1;7980;PACK 2 ALMOHADAS C+L;DORMITORIO
13741205;Soltero;F;43;CHILENO;ASISTENTE SOCIAL;X;PUNTA ARENAS                  ;MAGALLANES;521980;2;1;0;0;0;2;1;521980;Cama New Style 2PBD + Resp + 2 Vel Ferrara;DORMITORIO
19930951;;F;24;CHILENO;;Z;PROVIDENCIA                   ;METROPOLITANA;12990;1;1;0;0;0;1;1;12990;Almohada Bamboo Classic 70x40;DORMITORIO
11618615;;M;52;CHILENO;;X;RANCAGUA                      ;L.G.B.OÂ´HIGGINS;668980;2;1;2;1;668980;0;0;0;Cama Tempo 2PBD + Resp + 2 Vel Bilbao;DORMITORIO
13445760;;F;44;CHILENO;;X;PROVIDENCIA                   ;METROPOLITANA;509980;2;1;2;1;509980;0;0;0;CE ORTOPEDIC ADVANCE 2PBD+RESP+2VEL NEW GALES;DORMITORIO
14372169;;F;47;CHILENO;;X;CHIGUAYANTE                   ;BIO BIO;290150;4;1;0;0;0;4;1;290150;COLCHON TERAPEUTIC 1,5P PILLOW TOP;DORMITORIO
7812174;;F;63;CHILENO;;Boomers;RENCA                         ;METROPOLITANA;33980;2;1;0;0;0;2;1;33980;Almohada Visco Bamboo Classic Pack 60x40 cm;DORMITORIO
9470340;;F;60;CHILENO;;Boomers;ARICA                         ;ARICA Y PARINACOTA;408470;3;1;0;0;0;3;1;408470;BOX AMERICANO BEAT 1,5 PLAZAS 105 X 190 CM;DORMITORIO
17618455;;M;30;CHILENO;;Millenial;CALERA                        ;VALPARAISO;399980;2;1;2;1;399980;0;0;0;CAMA ERGO T 2PBD + RESP + 2 VEL FERRARA;DORMITORIO
10527654;;M;56;CHILENO;;Boomers;PUENTE ALTO                   ;METROPOLITANA;89970;3;1;0;0;0;3;1;89970;ALMOHADA VISCO ELASTICA CANNABIS 60X40CM;DORMITORIO
10421569;;M;57;CHILENO;;Boomers;MELIPILLA                     ;METROPOLITANA;348040;5;2;0;0;0;5;2;348040;PACK 2 ALMOHADAS C+L;DORMITORIO
15767209;;F;37;CHILENO;;Millenial;PROVIDENCIA                   ;METROPOLITANA;16990;1;1;0;0;0;1;1;16990;ALMOHADA BAMBOO TECH SERIES 65X45 CM;DORMITORIO
15824791;;F;37;CHILENO;;Silencioso;PROVIDENCIA                   ;METROPOLITANA;301980;2;1;2;1;301980;0;0;0;BS NEW ORTOPEDIC B5BLACK 2PBN+RESP+2VEL LEGNO;DORMITORIO
9786777;;F;58;CHILENO;;Boomers;YERBAS BUENAS                 ;MAULE;232570;2;1;0;0;0;2;1;232570;COLCHON THERAPEDIC 2P;DORMITORIO
13392188;;F;44;CHILENO;;X;ANGOL                         ;ARAUCANIA;6660;3;2;0;0;0;3;2;6660;COLCHON BAMBOO 2P FIBRAS BAMBOO;DORMITORIO
9937212;;F;64;CHILENO;;Boomers;PROVIDENCIA                   ;METROPOLITANA;0;0;0;0;0;0;0;0;0;PACK 2 ALMOHADAS C+L;DORMITORIO
20272727;;F;23;CHILENO;;Z;PROVIDENCIA                   ;METROPOLITANA;0;0;0;0;0;0;0;0;0;ALMOHADA ROSEN SOFT PLUS KING;DORMITORIO
16310591;;F;35;CHILENO;;Silencioso;PROVIDENCIA                   ;METROPOLITANA;0;0;0;0;0;0;0;0;0;COLCHON THERAPEDIC 2P;DORMITORIO
8978826;;M;61;CHILENO;;Boomers;PICHIDEGUA                    ;L.G.B.OÂ´HIGGINS;0;0;0;0;0;0;0;0;0;Almohada Visco Bamboo Classic Pack 60x40 cm;DORMITORIO
10159248;;M;57;CHILENO;;Boomers;PROVIDENCIA                   ;METROPOLITANA;0;0;0;0;0;0;0;0;0;CE ERGO T 2P 2MT BD;DORMITORIO
18788906;;F;28;CHILENO;;Millenial;SAN CARLOS                    ;BIO BIO;0;0;0;0;0;0;0;0;0;PACK 2 ALMOHADAS C+L;DORMITORIO
13398189;;F;43;CHILENO;;X;RENCA                         ;METROPOLITANA;0;0;0;0;0;0;0;0;0;SET SABANA MICROFIBRA SAND 2P;DORMITORIO
17573994;;F;31;CHILENO;;Millenial;CHIGUAYANTE                   ;BIO BIO;0;0;0;0;0;0;0;0;0;BOX AMERICANO EXCELLENCE 1.5 PLAZA + ALM;DORMITORIO
17439120;;F;32;CHILENO;;Millenial;ILLAPEL                       ;COQUIMBO;0;0;0;0;0;0;0;0;0;Almohada Bamboo Classic 70x40;DORMITORIO
8288623;;M;64;CHILENO;;Boomers;LA FLORIDA                    ;METROPOLITANA;0;0;0;0;0;0;0;0;0;COLCHON NEW STYLE 6 2P;DORMITORIO
8197595;;M;61;CHILENO;;Boomers;PROVIDENCIA                   ;METROPOLITANA;0;0;0;0;0;0;0;0;0;COLCHON BALANCE 2P;DORMITORIO
17804633;;F;31;CHILENO;;Millenial;PROVIDENCIA                   ;METROPOLITANA;0;0;0;0;0;0;0;0;0;CLOSET M-701 6 PUERTAS 2 CAJONES ALTO 1,82 COLOR;DORMITORIO
12771482;Soltero;F;46;CHILENO;;X;RENCA                         ;METROPOLITANA;0;0;0;0;0;0;0;0;0;Almohada Bamboo Classic 70x40;DORMITORIO
19069907;;F;27;CHILENO;;Z;"";"";0;0;0;0;0;0;0;0;0;CE ERGO T 2P 2MT BD;DORMITORIO
11146299;;F;54;CHILENO;;Boomers;CHIMBARONGO                   ;L.G.B.OÂ´HIGGINS;0;0;0;0;0;0;0;0;0;CE EVOLUTION BLACK 1P + VELADOR CASTILLA;DORMITORIO
18232875;;F;30;CHILENO;;Millenial;CALAMA;ANTOFAGASTA;0;0;0;0;0;0;0;0;0;SET 2 ALMOHADAS VISCO MEDIUM 60X40 CM;DORMITORIO
18608056;;F;28;CHILENO;;Millenial;PROVIDENCIA                   ;METROPOLITANA;0;0;0;0;0;0;0;0;0;CLOSET CAJONERA NEW BELGICA M-398-NW;DORMITORIO
18455669;;M;29;CHILENO;;Millenial;MELIPEUCO                     ;ARAUCANIA;0;0;0;0;0;0;0;0;0;ALMOHADA ROSEN SOFT PLUS AMERICANA;DORMITORIO
18208391;;M;30;CHILENO;;Millenial;PROVIDENCIA                   ;METROPOLITANA;0;0;0;0;0;0;0;0;0;DIVAN NEW ORTOPEDIC BLACK ALM ]DIVAN NEW ORTOPED;DORMITORIO
13219416;;F;45;CHILENO;;X;RENCA                         ;METROPOLITANA;0;0;0;0;0;0;0;0;0;TOCADOR ODIN;DORMITORIO
18354676;;F;29;CHILENO;;Silencioso;PROVIDENCIA                   ;METROPOLITANA;0;0;0;0;0;0;0;0;0;ALMOHADA ROSEN SOFT PLUS AMERICANA;DORMITORIO
12401537;;M;48;CHILENO;;X;QUILPUE                       ;VALPARAISO;0;0;0;0;0;0;0;0;0;ALMOHADA MEMORY MAX BASIC AMERICANA;DORMITORIO
7553423;;F;68;CHILENO;;Silencioso;SAN CLEMENTE                  ;MAULE;0;0;0;0;0;0;0;0;0;ALMOHADA MEMORY MAX BASIC AMERICANA;DORMITORIO
5784296;;F;72;CHILENO;;Silencioso;PROVIDENCIA                   ;METROPOLITANA;0;0;0;0;0;0;0;0;0;COLCHON NEW ORTOPEDIC 2P;DORMITORIO
15881252;;F;37;CHILENO;;Millenial;N/D;N/D;0;0;0;0;0;0;0;0;0;CLOSET ESPANA 6P+4C;DORMITORIO
10470901;;F;59;CHILENO;;Boomers;RENCA                         ;METROPOLITANA;0;0;0;0;0;0;0;0;0;ALMOHADA ROSEN SOFT PLUS AMERICANA;DORMITORIO
12885936;;F;47;CHILENO;;X;N/D;N/D;0;0;0;0;0;0;0;0;0;PACK 2 ALMOHADAS C+L;DORMITORIO
13305558;;M;44;CHILENO;;X;LOS ANGELES                   ;BIO BIO;0;0;0;0;0;0;0;0;0;CE NEW STYLE 6 2P 2MT BD;DORMITORIO
12979149;;F;46;CHILENO;;X;CONCEPCION                    ;BIO BIO;0;0;0;0;0;0;0;0;0;ALMOHADA ROSEN SOFT PLUS AMERICANA;DORMITORIO
17479466;;M;32;CHILENO;;Silencioso;PROVIDENCIA                   ;METROPOLITANA;0;0;0;0;0;0;0;0;0;DIVAN CAMA ERGO T 1,5P 2 MTS;DORMITORIO
9186404;Casado;F;59;CHILENO;SECRETARIA;Boomers;PROVIDENCIA                   ;METROPOLITANA;0;0;0;0;0;0;0;0;0;COLCHON NEW ENTREE 1,5P;DORMITORIO
15013215;;M;35;CHILENO;;Millenial;MONTE PATRIA;COQUIMBO;0;0;0;0;0;0;0;0;0;ALMOHADA SOFT MICROGEL;DORMITORIO
19574580;;M;25;CHILENO;;Z;PUERTO MONTT                  ;LOS LAGOS;0;0;0;0;0;0;0;0;0;Almohada Visco Bamboo Classic Pack 60x40 cm;DORMITORIO
13751406;;M;42;CHILENO;;X;SANTA MARIA                   ;VALPARAISO;0;0;0;0;0;0;0;0;0;BOX BAMBOO + Respaldo + 2 Veladores ALICANTE;DORMITORIO
10322448;;F;56;CHILENO;;Boomers;RENCA                         ;METROPOLITANA;0;0;0;0;0;0;0;0;0;BA EXCELL PLUS 1,5P +RESP+1VEL NEW VILLARRICA;DORMITORIO
9806543;;F;56;CHILENO;;Boomers;N/D;N/D;0;0;0;0;0;0;0;0;0;SET SABANA MICROFIBRA MUSTARD 1,5P;DORMITORIO
4552203;;F;80;CHILENO;;Silencioso;SAN JAVIER                    ;MAULE;0;0;0;0;0;0;0;0;0;COLCHON NEW ORTOPEDIC 1,5P;DORMITORIO
10476412;;F;57;CHILENO;;Boomers;SAN BERNARDO                  ;METROPOLITANA;0;0;0;0;0;0;0;0;0;CE NEW STYLE 6 2P 2MT BD;DORMITORIO
15224212;Casado;M;39;CHILENO;ARQUITECTO;X;PROVIDENCIA                   ;METROPOLITANA;0;0;0;0;0;0;0;0;0;DIVAN CAMA ERGO T 1,5P 2 MTS;DORMITORIO
27073411;;M;36;VENEZOLANO;;Extranjero;N/D;N/D;0;0;0;0;0;0;0;0;0;Cama Ergo T 2PBD + Resp +2 Vel Tabor;DORMITORIO
10239788;;F;58;CHILENO;;Boomers;PLACILLA                      ;L.G.B.OÂ´HIGGINS;0;0;0;0;0;0;0;0;0;PACK 2 ALMOHADAS C+L;DORMITORIO
16577719;Soltero;F;33;CHILENO;TECNICO DE NIVEL SUPERIOR EN ENFERMERIA GINECOOBSTETRICA Y NEONATAL;Millenial;PROVIDENCIA                   ;METROPOLITANA;0;0;0;0;0;0;0;0;0;ALMOHADA SOFT MICROGEL;DORMITORIO
16599386;Soltero;M;35;CHILENO;;Millenial;PROVIDENCIA                   ;METROPOLITANA;0;0;0;0;0;0;0;0;0;CLOSET BALI 8 PUERTAS BICOLOR;DORMITORIO
7026997;;M;64;CHILENO;;Boomers;RENCA                         ;METROPOLITANA;0;0;0;0;0;0;0;0;0;ALMOHADA ROSEN SOFT PLUS AMERICANA;DORMITORIO
19574208;;M;25;CHILENO;;Z;N/D;N/D;0;0;0;0;0;0;0;0;0;BOX SPRING NEOSENSE FULL BLACK;DORMITORIO
12052699;;F;42;CHILENO;;X;TALCAHUANO                    ;BIO BIO;0;0;0;0;0;0;0;0;0;BA EXCEL PLUS 2P BN +RESP+2VEL NEW VILLARRICA;DORMITORIO
18115321;;M;30;CHILENO;;Millenial;PROVIDENCIA                   ;METROPOLITANA;0;0;0;0;0;0;0;0;0;COLCHON SPRING III 1P;DORMITORIO
9688628;;M;57;CHILENO;;Boomers;VILLA ALEMANA                 ;VALPARAISO;0;0;0;0;0;0;0;0;0;CE CANNABIS 1,5P BN+RESP+VEL+PILLOW TOP;DORMITORIO
4114003;;M;83;CHILENO;;Silencioso;N/D;N/D;0;0;0;0;0;0;0;0;0;COLCHON EVOLUTION BLACK 1,5P DUAL SIDE;DORMITORIO
13448804;;M;44;CHILENO;;X;MAIPU                         ;METROPOLITANA;0;0;0;0;0;0;0;0;0;COLCHON BEAT 1,5P;DORMITORIO
13619483;;F;43;CHILENO;;X;PROVIDENCIA                   ;METROPOLITANA;0;0;0;0;0;0;0;0;0;COLCHON TERAPEUTIC 2P PILLOW TOP;DORMITORIO
18628093;Soltero;M;28;CHILENO;;Millenial;PROVIDENCIA                   ;METROPOLITANA;0;0;0;0;0;0;0;0;0;CAMA EUROPEA EXCELLENCE 1.5 PLAZA;DORMITORIO
18193052;;F;29;CHILENO;;Millenial;LA CISTERNA                   ;METROPOLITANA;0;0;0;0;0;0;0;0;0;COLCHON EVEREST 1,5P HILOS DE COBRE;DORMITORIO
8156825;;F;61;CHILENO;;Boomers;ARICA                         ;TARAPACA;0;0;0;0;0;0;0;0;0;CAMA NIDO BAMBOO 1,5P;DORMITORIO
19026049;;F;27;CHILENO;;Z;PROVIDENCIA                   ;METROPOLITANA;0;0;0;0;0;0;0;0;0;SET SABANA MICROFIBRA ROUGE 2P;DORMITORIO
16779102;;M;35;CHILENO;;Millenial;ANCUD                         ;LOS LAGOS;0;0;0;0;0;0;0;0;0;BA EXCELLENCE 2P BN +RESP+2VEL OLMO +2ALM+PL;DORMITORIO
9404777;Casado;F;57;CHILENO;;Boomers;TALAGANTE                     ;METROPOLITANA;0;0;0;0;0;0;0;0;0;COLCHON EVOLUTION BLACK 1,5P DUAL SIDE;DORMITORIO
16667728;;F;34;CHILENO;;Millenial;N/D;N/D;0;0;0;0;0;0;0;0;0;COLCHON IBIZA 2P;DORMITORIO
13473797;;F;48;CHILENO;;X;LA FLORIDA                    ;METROPOLITANA;0;0;0;0;0;0;0;0;0;CAMA EUROPEA IBIZA 2 PL BD;DORMITORIO
6130762;;F;72;CHILENO;;Silencioso;ARICA                         ;ARICA Y PARINACOTA;0;0;0;0;0;0;0;0;0;CAMA EUROPEA THERAPEDIC MAS 1,5P;DORMITORIO
18229299;;F;30;CHILENO;;Millenial;CHIMBARONGO;O HIGGINS;0;0;0;0;0;0;0;0;0;CE EVOLUTION BLACK 1,5P BN RESP+VEL;DORMITORIO
19663000;;M;23;CHILENO;;Z;N/D;N/D;0;0;0;0;0;0;0;0;0;Cama Tempo King;DORMITORIO
14414803;;F;48;CHILENO;;X;VILLA ALEMANA                 ;VALPARAISO;0;0;0;0;0;0;0;0;0;CE EVOLUTION BLACK 1,5P + RESPALDO CASTILLA;DORMITORIO
7581997;;F;66;CHILENO;;Boomers;COIHAIQUE                     ;AYSEN;0;0;0;0;0;0;0;0;0;COLCHON TERAPEUTIC 2P PILLOW TOP;DORMITORIO
16191670;;F;36;CHILENO;;Millenial;PROVIDENCIA                   ;METROPOLITANA;0;0;0;0;0;0;0;0;0;CLOSET CROACIA BLANCO 4P;DORMITORIO
8853207;Casado;F;62;CHILENO;;Boomers;PUERTO MONTT                  ;LOS LAGOS;0;0;0;0;0;0;0;0;0;PACK 2 ALMOHADAS C+L;DORMITORIO
18808547;;F;28;CHILENO;;Millenial;PROVIDENCIA                   ;METROPOLITANA;0;0;0;0;0;0;0;0;0;SET SABANA MICROFIBRA ROUGE 2P;DORMITORIO
19740553;;M;25;CHILENO;;Silencioso;PROVIDENCIA                   ;METROPOLITANA;0;0;0;0;0;0;0;0;0;COLCHON BEAT 1,5P;DORMITORIO
14591613;;M;43;CHILENO;;X;N/D;N/D;0;0;0;0;0;0;0;0;0;CE EVOLUTION BLACK 1,5P + RESPALDO ASTURIAS;DORMITORIO
17502175;;M;32;CHILENO;;Silencioso;PROVIDENCIA                   ;METROPOLITANA;0;0;0;0;0;0;0;0;0;CLOSET NEWCAPRI M-330 AVELLANA/CARVALHO4P3C+ESPE;DORMITORIO
24806320;;M;33;PERUANO;;Extranjero;N/D;N/D;0;0;0;0;0;0;0;0;0;COLCHON NEW STYLE 6 KING LONG;DORMITORIO
19540670;Soltero;M;25;CHILENO;;Silencioso;PROVIDENCIA                   ;METROPOLITANA;0;0;0;0;0;0;0;0;0;Cama Tempo King;DORMITORIO
10166162;;F;58;CHILENO;;Boomers;RENCA                         ;METROPOLITANA;0;0;0;0;0;0;0;0;0;CE EVOLUTION BLACK 1,5P + RESPALDO CASTILLA;DORMITORIO
16407262;;F;36;CHILENO;;Millenial;N/D;N/D;0;0;0;0;0;0;0;0;0;DIVAN CAMA ERGO T 1,5P 2MTS+RESP+1 VEL TABOR;DORMITORIO
26754026;;M;25;VENEZOLANO;;Extranjero;N/D;N/D;0;0;0;0;0;0;0;0;0;CE EVOLUTION BLACK 1,5P BN RESP+VEL;DORMITORIO
9465348;;M;59;CHILENO;;Boomers;CORONEL                       ;BIO BIO;0;0;0;0;0;0;0;0;0;COLCHON BAMBOO 1,5P FIBRAS BAMBOO;DORMITORIO
17453632;;M;32;CHILENO;;Millenial;PROVIDENCIA                   ;METROPOLITANA;0;0;0;0;0;0;0;0;0;CAMA ERGO T KING + RESP + 2 VEL FERRARA;DORMITORIO
19657324;;M;34;CHILENO;;Millenial;CASTRO                        ;LOS LAGOS;0;0;0;0;0;0;0;0;0;CAMA EUROPEA THERAPEDIC MAS 1,5P;DORMITORIO
18089946;;F;30;CHILENO;;Millenial;QUINTA NORMAL                 ;METROPOLITANA;0;0;0;0;0;0;0;0;0;SET SABANA MICROFIBRA BLUE 2P;DORMITORIO
10073879;;M;56;CHILENO;;Boomers;LIMACHE                       ;VALPARAISO;0;0;0;0;0;0;0;0;0;BS NEW ORTOPEDIC B5BLACK 2PBD+RESP+2VEL LEGNO;DORMITORIO
5875872;;F;71;CHILENO;;Silencioso;LOS ANGELES                   ;BIO BIO;0;0;0;0;0;0;0;0;0;COLCHON TERAPEUTIC 2P PILLOW TOP;DORMITORIO
10109892;;F;58;CHILENO;;Boomers;CONCHALI                      ;METROPOLITANA;0;0;0;0;0;0;0;0;0;BA BEAT 2P 2MTS BN;DORMITORIO
19668041;;F;24;CHILENO;;Z;PROVIDENCIA                   ;METROPOLITANA;0;0;0;0;0;0;0;0;0;CE EVOLUTION BLACK 2P BD DUAL SIDE;DORMITORIO
17835296;Soltero;F;31;CHILENO;;Millenial;PROVIDENCIA                   ;METROPOLITANA;0;0;0;0;0;0;0;0;0;SET SABANA MICROFIBRA BLUE 2P;DORMITORIO
18849752;;F;27;CHILENO;;Millenial;CERRO NAVIA                   ;METROPOLITANA;0;0;0;0;0;0;0;0;0;COLCHON EVOLUTION BLACK 1,5P DUAL SIDE;DORMITORIO
16372452;;F;36;CHILENO;;Millenial;PROVIDENCIA                   ;METROPOLITANA;0;0;0;0;0;0;0;0;0;BOX AMERICANO EXCELLENCE 2P BN +2ALM+PLU;DORMITORIO
9981632;;M;45;CHILENO;;Silencioso;PROVIDENCIA                   ;METROPOLITANA;0;0;0;0;0;0;0;0;0;Colchon Resortes Evolution 1p + Almohada Imperia;DORMITORIO
19319268;;M;26;CHILENO;;Z;ESTACION CENTRAL;METROPOLITANA;0;0;0;0;0;0;0;0;0;CE EVOLUTION BLACK 2P BD DUAL SIDE;DORMITORIO
18574464;Soltero;F;28;CHILENO;;Millenial;PROVIDENCIA                   ;METROPOLITANA;0;0;0;0;0;0;0;0;0;CE ERGO T 2P 2MT BD;DORMITORIO
15197686;;M;41;CHILENO;;X;CURANILAHUE;BIO-BIO;0;0;0;0;0;0;0;0;0;COLCHON BEAT 2P;DORMITORIO
10481209;;M;58;CHILENO;;Boomers;PERALILLO                     ;L.G.B.OÂ´HIGGINS;0;0;0;0;0;0;0;0;0;CE NEW ORTOPEDIC 2PBD;DORMITORIO
19362230;;M;25;CHILENO;;Silencioso;PROVIDENCIA                   ;METROPOLITANA;0;0;0;0;0;0;0;0;0;CLOSET ESPANA 6P+4C;DORMITORIO
17352834;;F;33;CHILENO;;Extranjero;LA SERENA                     ;COQUIMBO;0;0;0;0;0;0;0;0;0;CE NEW STYLE 6 2P 2MT BD;DORMITORIO
19257102;;M;26;CHILENO;;Z;"";"";0;0;0;0;0;0;0;0;0;CLOSET 3 PUERTAS MERLIN EBANO ];DORMITORIO
18063910;Soltero;F;30;CHILENO;PSICOLOGA;Silencioso;PROVIDENCIA                   ;METROPOLITANA;0;0;0;0;0;0;0;0;0;Comoda RIGEL CHOCOLATE;DORMITORIO
10723326;;F;55;CHILENO;;Boomers;CALAMA                        ;ANTOFAGASTA;0;0;0;0;0;0;0;0;0;SILLA ESCRITORIO MANCHESTER;DORMITORIO
15439130;;M;40;CHILENO;;X;PROVIDENCIA                   ;METROPOLITANA;0;0;0;0;0;0;0;0;0;CE EVOLUTION BLACK 2P BD DUAL SIDE;DORMITORIO
13668885;;F;43;CHILENO;;Silencioso;PROVIDENCIA                   ;METROPOLITANA;0;0;0;0;0;0;0;0;0;COLCHON ACTIVE 1,5P DUAL SIDE;DORMITORIO
16060564;;M;36;CHILENO;;Silencioso;PROVIDENCIA                   ;METROPOLITANA;0;0;0;0;0;0;0;0;0;BOX AMERICANO EXCELLENCE 1.5 PLAZAS;DORMITORIO
17785794;;F;30;CHILENO;;Millenial;MAIPU;METROPOLITANA;0;0;0;0;0;0;0;0;0;DIVAN NEW ORTOPEDIC BLACK ALM+PL;DORMITORIO
11277856;;F;53;CHILENO;;X;LAS CABRAS                    ;L.G.B.OÂ´HIGGINS;0;0;0;0;0;0;0;0;0;COLCHON SPRING III 1P;DORMITORIO
18514154;;F;30;CHILENO;;Millenial;PROVIDENCIA                   ;METROPOLITANA;0;0;0;0;0;0;0;0;0;CLOSET NIZA 6P+2C;DORMITORIO
19957395;;F;23;CHILENO;;Z;PROVIDENCIA                   ;METROPOLITANA;0;0;0;0;0;0;0;0;0;BOX AMERICANO EXCELLENCE PLUS 2P BN +AL+PLU;DORMITORIO
13409382;;M;44;CHILENO;;X;PROVIDENCIA                   ;METROPOLITANA;0;0;0;0;0;0;0;0;0;BOX AMERICANO EXCELLENCE 2PBN +RESP+2VEL OLMO;DORMITORIO
17334881;Soltero;F;33;CHILENO;;Millenial;PROVIDENCIA                   ;METROPOLITANA;0;0;0;0;0;0;0;0;0;ALMOHADA SOFT MICROGEL;DORMITORIO
18881890;;M;28;CHILENO;;Millenial;PROVIDENCIA                   ;METROPOLITANA;0;0;0;0;0;0;0;0;0;SET SABANA MICROFIBRA BLUE 2P;DORMITORIO
14341078;;F;44;CHILENO;;X;PROVIDENCIA                   ;METROPOLITANA;0;0;0;0;0;0;0;0;0;SET SABANA MICROFIBRA ROUGE 2P;DORMITORIO
13759477;;F;41;CHILENO;;X;ANTOFAGASTA                   ;ANTOFAGASTA;0;0;0;0;0;0;0;0;0;CE EVOLUTION BLACK 1,5P BN DUAL SIDE;DORMITORIO
6753901;;F;68;CHILENO;;Silencioso;RENCA                         ;METROPOLITANA;0;0;0;0;0;0;0;0;0;COMODA ECO 4 CAJONES CAOBA;DORMITORIO
16422875;;M;35;CHILENO;;Silencioso;PROVIDENCIA                   ;METROPOLITANA;0;0;0;0;0;0;0;0;0;CE EVOLUTION BLACK 2P BD+RESP+2 VEL;DORMITORIO
11730318;;M;51;CHILENO;;X;LOS ANDES                     ;VALPARAISO;0;0;0;0;0;0;0;0;0;Closet 6 PTAS. 2 CAJ. 180x165x47cm CEREZO;DORMITORIO
18452924;;F;28;CHILENO;;Millenial;PROVIDENCIA                   ;METROPOLITANA;0;0;0;0;0;0;0;0;0;SET SABANA MICROFIBRA BLUE 2P;DORMITORIO
12681309;;F;49;CHILENO;;X;CHILLAN                       ;BIO BIO;0;0;0;0;0;0;0;0;0;Almohada Bamboo Classic 70x40;DORMITORIO
17199565;;F;32;CHILENO;;Millenial;QUILPUE                       ;VALPARAISO;0;0;0;0;0;0;0;0;0;COLCHON NEW ORTOPEDIC 2P 150X190 + CUBREC;DORMITORIO
16486515;;M;35;CHILENO;;Millenial;VALPARAISO                    ;VALPARAISO;0;0;0;0;0;0;0;0;0;CAMA NEW STYLE 2 KING BD;DORMITORIO
9718968;;M;58;CHILENO;;Boomers;RENCA                         ;METROPOLITANA;0;0;0;0;0;0;0;0;0;PACK 2 ALMOHADAS C+L;DORMITORIO
14585699;;M;41;CHILENO;;X;CALAMA                        ;ANTOFAGASTA;0;0;0;0;0;0;0;0;0;CE ERGO T 2P 2MT BD;DORMITORIO
19445118;;M;25;CHILENO;;Z;N/D;N/D;0;0;0;0;0;0;0;0;0;COLCHON IBIZA 2P;DORMITORIO
17511361;;F;31;CHILENO;;Millenial;PROVIDENCIA                   ;METROPOLITANA;0;0;0;0;0;0;0;0;0;BOX AMERICANO EXCELLENCE 1 PLAZA;DORMITORIO
20120665;;F;23;CHILENO;;Z;PROVIDENCIA                   ;METROPOLITANA;0;0;0;0;0;0;0;0;0;CE EVOLUTION BLACK 2P BD+RESP+2 VEL;DORMITORIO
17607478;Casado;M;32;CHILENO;;Z;PROVIDENCIA                   ;METROPOLITANA;0;0;0;0;0;0;0;0;0;CE ERGO T 2P 2MT BD;DORMITORIO
17368348;;M;33;CHILENO;;Millenial;ARICA                         ;ARICA Y PARINACOTA;0;0;0;0;0;0;0;0;0;CE ERGO T 2P 2MT BD;DORMITORIO
18626473;;F;28;CHILENO;;Silencioso;PROVIDENCIA                   ;METROPOLITANA;0;0;0;0;0;0;0;0;0;CLOSET CROACIA CHOCOLATE 4P;DORMITORIO
16128598;;F;36;CHILENO;;Millenial;PROVIDENCIA                   ;METROPOLITANA;0;0;0;0;0;0;0;0;0;CE EVOLUTION BLACK 1P + RESPALDO CASTILLA;DORMITORIO
18916051;;M;27;CHILENO;;Silencioso;PROVIDENCIA                   ;METROPOLITANA;0;0;0;0;0;0;0;0;0;CE ERGO T 2P 2MT BD;DORMITORIO
11989831;;F;50;CHILENO;;X;SAN FELIPE                    ;VALPARAISO;0;0;0;0;0;0;0;0;0;CAMA EUROPEA EXCELLENCE 2 PLAZAS BASE NORMAL;DORMITORIO
4889774;;F;78;CHILENO;;Silencioso;CONCHALI                      ;METROPOLITANA;0;0;0;0;0;0;0;0;0;Cama Ergo T 2PBD + Resp +2 Vel Tabor;DORMITORIO
8621910;;M;62;CHILENO;;Boomers;RENCA                         ;METROPOLITANA;0;0;0;0;0;0;0;0;0;BOX AMERICANO EXCELLENCE 2P BASE NORMAL;DORMITORIO
19711167;;M;24;CHILENO;;Silencioso;PROVIDENCIA                   ;METROPOLITANA;0;0;0;0;0;0;0;0;0;CAMAROTE TRIPLE CORINA CAFE OSCURO;DORMITORIO
3432150;;F;85;CHILENO;;Silencioso;PROVIDENCIA                   ;METROPOLITANA;0;0;0;0;0;0;0;0;0;COLCHON BEAT 1,5P;DORMITORIO
13935294;;M;43;CHILENO;;X;N/D;N/D;0;0;0;0;0;0;0;0;0;CE NEW ORTOPEDIC 2PBD;DORMITORIO
10853963;;M;55;CHILENO;;Boomers;N/D;N/D;0;0;0;0;0;0;0;0;0;Pack Veladores Italia Cedro/Pinus;DORMITORIO
18484224;Soltero;M;28;CHILENO;;Millenial;RENCA                         ;METROPOLITANA;0;0;0;0;0;0;0;0;0;CE ERGO T 2P 2MT BD;DORMITORIO
19760732;;M;24;CHILENO;;Silencioso;PROVIDENCIA                   ;METROPOLITANA;0;0;0;0;0;0;0;0;0;BOX AMERICANO EXCELLENCE 1 PLAZA;DORMITORIO
26398565;;M;23;CHILENO;;Extranjero;CASTRO                        ;LOS LAGOS;0;0;0;0;0;0;0;0;0;BOX AMERICANO EXCELLENCE PLUS 2P BD+2ALM ];DORMITORIO
17526687;;M;30;CHILENO;;Millenial;RANCAGUA                      ;L.G.B.OÂ´HIGGINS;0;0;0;0;0;0;0;0;0;ALMOHADA SOFT MICROGEL;DORMITORIO
15468255;;F;40;CHILENO;;X;N/D;N/D;0;0;0;0;0;0;0;0;0;PACK 2 ALMOHADAS C+L;DORMITORIO
19463888;Soltero;F;26;CHILENO;;Z;PROVIDENCIA                   ;METROPOLITANA;0;0;0;0;0;0;0;0;0;CLOSET MARITTIMA 6P+2C;DORMITORIO
16447397;;F;35;CHILENO;;Millenial;RENGO                         ;L.G.B.OÂ´HIGGINS;0;0;0;0;0;0;0;0;0;CLOSET NEWCAPRI M-330 AVELLANA/CARVALHO4P3C+ESPE;DORMITORIO
16975810;Soltero;F;33;CHILENO;ENFERMERA;Millenial;PROVIDENCIA                   ;METROPOLITANA;0;0;0;0;0;0;0;0;0;SET 2 ALMOHADAS VISCO MEDIUM 60X40 CM;DORMITORIO
18635989;Soltero;F;28;CHILENO;PREVENCION DE RIESGOS;Silencioso;PROVIDENCIA                   ;METROPOLITANA;0;0;0;0;0;0;0;0;0;RESPALDO 2P CON VELADORES FAVATEX COSMOS;DORMITORIO
15684740;;M;39;CHILENO;;X;RENCA                         ;METROPOLITANA;0;0;0;0;0;0;0;0;0;BOX AMERICANO EXCELLENCE 1.5 PLAZA + ALM;DORMITORIO
22260278;Soltero;F;27;CHILENO;;Extranjero;PROVIDENCIA                   ;METROPOLITANA;0;0;0;0;0;0;0;0;0;CLOSET NEW SLIM M-900 CASTANO;DORMITORIO
11333775;;F;53;CHILENO;;X;PROVIDENCIA                   ;METROPOLITANA;0;0;0;0;0;0;0;0;0;PACK 2 ALMOHADAS C+L;DORMITORIO
15490343;;F;39;CHILENO;;X;"";"";0;0;0;0;0;0;0;0;0;CE ERGO T 2P 2MT BD;DORMITORIO
15615184;;F;38;CHILENO;;Millenial;CONCEPCION                    ;BIO BIO;0;0;0;0;0;0;0;0;0;CAMA EUROPEA EXCELLENCE 2 PLAZAS BASE NORMAL;DORMITORIO
15130584;;M;39;CHILENO;;X;CURICO                        ;MAULE;0;0;0;0;0;0;0;0;0;CAMA ERGO T 2PBD + RESP + 2 VEL FERRARA;DORMITORIO
6799162;;F;76;CHILENO;;Silencioso;SAN FERNANDO                  ;L.G.B.OÂ´HIGGINS;0;0;0;0;0;0;0;0;0;CE ERGO T 2P 2MT BD;DORMITORIO
9903526;;F;58;CHILENO;;Boomers;PROVIDENCIA                   ;METROPOLITANA;0;0;0;0;0;0;0;0;0;PACK 2 ALMOHADAS C+L;DORMITORIO
23675134;;M;33;BOLIVIANO;;Extranjero;COPIAPO                       ;ATACAMA;0;0;0;0;0;0;0;0;0;PACK 2 ALMOHADAS C+L;DORMITORIO
18452934;;F;28;CHILENO;;Millenial;PROVIDENCIA                   ;METROPOLITANA;0;0;0;0;0;0;0;0;0;CLOSET MARITTIMA 6P+2C;DORMITORIO
19075338;Soltero;F;27;CHILENO;;Z;PROVIDENCIA                   ;METROPOLITANA;0;0;0;0;0;0;0;0;0;CAMA EUROPEA EXCELLENCE PLUS 2 PLAZAS BD;DORMITORIO
13559439;;F;43;CHILENO;;X;RENCA                         ;METROPOLITANA;0;0;0;0;0;0;0;0;0;ALMOHADA ROSEN SOFT PLUS AMERICANA;DORMITORIO
19986536;;F;23;CHILENO;;Silencioso;PROVIDENCIA                   ;METROPOLITANA;0;0;0;0;0;0;0;0;0;CLOSET 3 PUERTAS MERLIN EBANO ];DORMITORIO
10725034;;M;55;CHILENO;;Boomers;RENCA                         ;METROPOLITANA;0;0;0;0;0;0;0;0;0;BASE AMERICANA SPRING VI 2.0 PL;DORMITORIO
12680020;;M;48;CHILENO;;X;MELIPILLA                     ;METROPOLITANA;0;0;0;0;0;0;0;0;0;SET 2 ALMOHADAS VISCO MEDIUM 60X40 CM;DORMITORIO
15498321;;F;39;CHILENO;;X;CALERA                        ;VALPARAISO;0;0;0;0;0;0;0;0;0;CLOSET M-803 3P 2C ALTO 1,82 BLANCO NATURAL;DORMITORIO
14905506;Casado;F;40;CHILENO;;X;RENCA                         ;METROPOLITANA;0;0;0;0;0;0;0;0;0;RACK BELLINI 50;DORMITORIO
8001519;;M;63;CHILENO;;Boomers;PROVIDENCIA                   ;METROPOLITANA;0;0;0;0;0;0;0;0;0;PACK 2 ALMOHADAS C+L;DORMITORIO
11991476;Casado;M;49;CHILENO;PROFESOR;Silencioso;PROVIDENCIA                   ;METROPOLITANA;0;0;0;0;0;0;0;0;0;ESCRITORIO ESCOBAR;DORMITORIO
18397966;Soltero;F;29;CHILENO;;Millenial;PROVIDENCIA                   ;METROPOLITANA;0;0;0;0;0;0;0;0;0;CE BAMBOO 2P BD FIBRAS BAMBOO DUAL SIDE;DORMITORIO
15180894;;F;40;CHILENO;;X;SAN PEDRO DE LA PAZ           ;BIO BIO;0;0;0;0;0;0;0;0;0;CE ERGO T 2P 2MT BD;DORMITORIO
13540684;;F;43;CHILENO;;X;CABILDO                       ;VALPARAISO;0;0;0;0;0;0;0;0;0;CE EVOLUTION BLACK 2P BD+RESP+2 VEL;DORMITORIO
12862882;;F;46;CHILENO;;X;TEMUCO                        ;ARAUCANIA;0;0;0;0;0;0;0;0;0;CAMA EUROPEA EXCELLENCE 2 PLAZAS BASE NORMAL;DORMITORIO
17322580;;M;32;CHILENO;;Millenial;CONSTITUCION                  ;MAULE;0;0;0;0;0;0;0;0;0;COLCHON ORTOPEDIC ADVANCE 1,5P;DORMITORIO
26198833;Soltero;M;37;EXTRANJERO - NO INFORMA NACIONALIDAD;;Extranjero;PROVIDENCIA                   ;METROPOLITANA;0;0;0;0;0;0;0;0;0;Cama Tempo 2PBD + Resp + 2 Vel Grafito;DORMITORIO
16078282;;F;36;CHILENO;;Millenial;PROVIDENCIA                   ;METROPOLITANA;0;0;0;0;0;0;0;0;0;BS ORTOPEDIC ADVANCE KING FN +RESPAL EUFRATES;DORMITORIO
19360636;Soltero;F;26;CHILENO;;Silencioso;PROVIDENCIA                   ;METROPOLITANA;0;0;0;0;0;0;0;0;0;TOCADOR BARBARA;DORMITORIO
9862586;;M;57;CHILENO;;Millenial;PROVIDENCIA                   ;METROPOLITANA;0;0;0;0;0;0;0;0;0;COLCHON EXCELLENCE FULL + 2 ALM;DORMITORIO
15075893;;F;43;CHILENO;;X;VALPARAISO                    ;VALPARAISO;0;0;0;0;0;0;0;0;0;PACK 2 ALMOHADAS 100% PLUMA 50 X 70 CM;DORMITORIO
18183697;;F;29;CHILENO;;Millenial;CALAMA                        ;ANTOFAGASTA;0;0;0;0;0;0;0;0;0;BA EXCEL PLUS 2P BD +RESP+2VEL NEW VILLARRICA;DORMITORIO
15698063;;F;38;CHILENO;;X;SAN FERNANDO                  ;L.G.B.OÂ´HIGGINS;0;0;0;0;0;0;0;0;0;CE EVOLUTION BLACK 1,5P BN RESP+VEL;DORMITORIO
15741041;;M;38;CHILENO;;X;CALAMA                        ;ANTOFAGASTA;0;0;0;0;0;0;0;0;0;PACK 2 ALMOHADAS C+L;DORMITORIO
11408010;;M;53;CHILENO;;X;ERCILLA                       ;ARAUCANIA;0;0;0;0;0;0;0;0;0;DIVAN CAMA ERGO T 1,5P 2 MTS;DORMITORIO
17645687;;M;32;CHILENO;;Millenial;RENCA                         ;METROPOLITANA;0;0;0;0;0;0;0;0;0;ALMOHADA SOFT MICROGEL;DORMITORIO
15986854;;F;37;CHILENO;;Millenial;PROVIDENCIA                   ;METROPOLITANA;0;0;0;0;0;0;0;0;0;BOX AMERICANO EXCELLENCE PLUS 2P BN +AL+PLU;DORMITORIO
10847008;;F;56;CHILENO;;Boomers;VALPARAISO                    ;VALPARAISO;0;0;0;0;0;0;0;0;0;BA EXCELLENCE 1.5P +RESP+VEL OLMO +ALM+PL;DORMITORIO
12041345;;M;53;CHILENO;;X;SANTIAGO                      ;METROPOLITANA;0;0;0;0;0;0;0;0;0;Pack Veladores Italia Cedro/Pinus;DORMITORIO
11808379;;M;51;CHILENO;;X;PROVIDENCIA                   ;METROPOLITANA;0;0;0;0;0;0;0;0;0;BOX AMERICANO EXCELLENCE 1.5P +RESP+VEL OLMO;DORMITORIO
7948086;;M;65;CHILENO;;Boomers;VICTORIA                      ;ARAUCANIA;0;0;0;0;0;0;0;0;0;COLCHON NEW ORTOPEDIC 1,5P;DORMITORIO
14548193;;F;47;CHILENO;;X;FUTRONO                       ;LOS RIOS;0;0;0;0;0;0;0;0;0;COLCHON EXCELLENCE 2P;DORMITORIO
19766349;;F;23;CHILENO;;Z;PROVIDENCIA                   ;METROPOLITANA;0;0;0;0;0;0;0;0;0;CLOSET CAJONERA NEW BELGICA M-398-NW;DORMITORIO
13304377;;F;44;CHILENO;;X;RENCA                         ;METROPOLITANA;0;0;0;0;0;0;0;0;0;CLOSET BALI 8 PUERTAS BICOLOR;DORMITORIO
8225988;;M;61;CHILENO;;Boomers;RENCA                         ;METROPOLITANA;0;0;0;0;0;0;0;0;0;CAMA ERGO T 2PBD + RESP + 2 VEL FERRARA;DORMITORIO
19757162;;M;24;CHILENO;;Z;SAN ANTONIO;VALPARAISO;0;0;0;0;0;0;0;0;0;BA EXCELLENCE PLUS 2P BD +RESP+VEL OLMO;DORMITORIO
7213082;;M;67;CHILENO;;Boomers;PUDAHUEL                      ;METROPOLITANA;0;0;0;0;0;0;0;0;0;CE EVOLUTION BLACK 2P BD+RESP+2 VEL;DORMITORIO
7886664;Casado;M;66;CHILENO;;Boomers;LEBU                          ;BIO BIO;0;0;0;0;0;0;0;0;0;BA EXCEL PLUS 2P BN +RESP+2VEL NEW VILLARRICA;DORMITORIO
13948932;;M;47;CHILENO;;X;RENCA                         ;METROPOLITANA;0;0;0;0;0;0;0;0;0;ALMOHADA MEMORY MAX BASIC AMERICANA;DORMITORIO
14091553;;M;41;CHILENO;;X;PROVIDENCIA                   ;METROPOLITANA;0;0;0;0;0;0;0;0;0;SET 2 ALMOHADAS VISCO MEDIUM 60X40 CM;DORMITORIO
10883655;;M;51;CHILENO;;X;PROVIDENCIA                   ;METROPOLITANA;0;0;0;0;0;0;0;0;0;CLOSET CABURGUA 2 PT CORREDERA WALNUT;DORMITORIO
10206603;;F;57;CHILENO;;Boomers;SAN FELIPE                    ;VALPARAISO;0;0;0;0;0;0;0;0;0;CE EVOLUTION BLACK 1P + Vel + Resp ASTURIAS;DORMITORIO
9282498;;M;60;CHILENO;;Boomers;CONSTITUCION                  ;MAULE;0;0;0;0;0;0;0;0;0;PACK 2 ALMOHADAS C+L;DORMITORIO
17410063;;M;31;CHILENO;;Millenial;N/D;N/D;0;0;0;0;0;0;0;0;0;ALMOHADA SOFT MICROGEL;DORMITORIO
10280426;;F;52;CHILENO;;X;RENCA                         ;METROPOLITANA;0;0;0;0;0;0;0;0;0;SET 2 ALMOHADAS VISCO MEDIUM 60X40 CM;DORMITORIO
11590150;;F;52;CHILENO;;X;PANGUIPULLI                   ;LOS RIOS;0;0;0;0;0;0;0;0;0;COLCHON NEW ORTOPEDIC 2P;DORMITORIO
15488343;;M;38;CHILENO;;Millenial;N/D;N/D;0;0;0;0;0;0;0;0;0;ESTANTE SENSACION;DORMITORIO
17749849;;F;31;CHILENO;;Millenial;PROVIDENCIA                   ;METROPOLITANA;0;0;0;0;0;0;0;0;0;CE NEW ORTOPEDIC 2PBD;DORMITORIO
17071410;;F;33;CHILENO;;Millenial;N/D;N/D;0;0;0;0;0;0;0;0;0;COLCHON TERAPEUTIC 2P PILLOW TOP;DORMITORIO
10909083;Casado;F;51;CHILENO;;X;PROVIDENCIA                   ;METROPOLITANA;0;0;0;0;0;0;0;0;0;DIVAN CAMA ERGO T 1,5P 2MTS+RESP+1 VEL TABOR;DORMITORIO
17531189;;M;32;CHILENO;;Millenial;OSORNO                        ;LOS LAGOS;0;0;0;0;0;0;0;0;0;COLCHON EVOLUTION BLACK 2P DUAL SIDE;DORMITORIO
12375981;;M;49;CHILENO;;X;PROVIDENCIA                   ;METROPOLITANA;0;0;0;0;0;0;0;0;0;CE EVOLUTION BLACK 2P BD DUAL SIDE;DORMITORIO
12314969;;M;49;CHILENO;;X;N/D;N/D;0;0;0;0;0;0;0;0;0;CE EVOLUTION BLACK 2P BN+RESP+2 VEL;DORMITORIO
11888992;;M;51;CHILENO;;X;RENCA                         ;METROPOLITANA;0;0;0;0;0;0;0;0;0;BOXET ERGO T 2P;DORMITORIO
12819426;;M;47;CHILENO;;X;PROVIDENCIA                   ;METROPOLITANA;0;0;0;0;0;0;0;0;0;COLCHON EXCELLENCE 1P;DORMITORIO
24590242;;F;24;CHILENO;;Extranjero;N/D;N/D;0;0;0;0;0;0;0;0;0;BOX AAMERICANO EXCELLENCE FULL;DORMITORIO
11559729;Soltero;F;52;CHILENO;;X;RENCA                         ;METROPOLITANA;0;0;0;0;0;0;0;0;0;CE EVOLUTION BLACK 1,5P + RESPALDO CASTILLA;DORMITORIO
14729409;;F;55;PERUANO;;Extranjero;COLINA                        ;METROPOLITANA;0;0;0;0;0;0;0;0;0;BA BEAT 2P 2MTS BN;DORMITORIO
6027452;;F;72;CHILENO;;Silencioso;RENCA                         ;METROPOLITANA;0;0;0;0;0;0;0;0;0;BOX AMERICANO EXCELLENCE 1.5P +RESP+VEL OLMO;DORMITORIO
18328793;Soltero;F;29;CHILENO;;Millenial;PROVIDENCIA                   ;METROPOLITANA;0;0;0;0;0;0;0;0;0;CE THERAPEDIC MAS 2PBD;DORMITORIO
16267935;;M;36;CHILENO;;Millenial;PROVIDENCIA                   ;METROPOLITANA;0;0;0;0;0;0;0;0;0;CE EVOLUTION BLACK 1,5P + RESPALDO CASTILLA;DORMITORIO
3594803;;F;77;CHILENO;;Silencioso;PENALOLEN                     ;METROPOLITANA;0;0;0;0;0;0;0;0;0;COLCHON NEW ORTOPEDIC 1,5P;DORMITORIO
13746687;Soltero;F;42;CHILENO;;X;RENCA                         ;METROPOLITANA;0;0;0;0;0;0;0;0;0;CE BAMBOO 2P BD FIBRAS BAMBOO DUAL SIDE;DORMITORIO
14106540;;M;41;CHILENO;;X;PROVIDENCIA                   ;METROPOLITANA;0;0;0;0;0;0;0;0;0;CE ORTOPEDIC ADVANCE 2PBD;DORMITORIO
13981399;;F;51;CHILENO;;X;RENCA                         ;METROPOLITANA;0;0;0;0;0;0;0;0;0;COLCHON NEW ORTOPEDIC 1,5P;DORMITORIO
13156249;;F;45;CHILENO;;X;TEMUCO                        ;ARAUCANIA;0;0;0;0;0;0;0;0;0;PACK 2 ALMOHADAS C+L;DORMITORIO
17531812;Soltero;F;32;CHILENO;PROFESOR;Millenial;PROVIDENCIA                   ;METROPOLITANA;0;0;0;0;0;0;0;0;0;CAMA EUROPEA IBIZA 1,5 PL + ALMOHADA ROYAL;DORMITORIO
17508327;Soltero;F;32;CHILENO;;Millenial;PROVIDENCIA                   ;METROPOLITANA;0;0;0;0;0;0;0;0;0;BA BEAT 2P 2MTS BN;DORMITORIO
22510793;;M;38;PERUANO;;Extranjero;N/D;N/D;0;0;0;0;0;0;0;0;0;CUBRE COLCHON AQUA REPELENT 2P;DORMITORIO
14236672;;M;50;CHILENO;;X;VILLA ALEMANA                 ;VALPARAISO;0;0;0;0;0;0;0;0;0;COLCHON ACTIVE 2P DUAL SIDE;DORMITORIO
18894445;;M;28;CHILENO;;Millenial;CERRO NAVIA                   ;METROPOLITANA;0;0;0;0;0;0;0;0;0;CE EVOLUTION BLACK FULL+RES+VEL;DORMITORIO
10299422;Casado;F;51;CHILENO;;X;RENCA                         ;METROPOLITANA;0;0;0;0;0;0;0;0;0;BOX AMERICANO EXCELLENCE 1.5 PLAZAS;DORMITORIO
20019924;;F;23;CHILENO;;Z;PROVIDENCIA                   ;METROPOLITANA;0;0;0;0;0;0;0;0;0;CLOSET NIZA 6P+2C;DORMITORIO
15588769;;M;38;CHILENO;;X;PROVIDENCIA                   ;METROPOLITANA;0;0;0;0;0;0;0;0;0;DUPLEX CE EVOLUTION BLACK 1P + 2 RESP + VEL ASTU;DORMITORIO
5600232;Viudo;F;75;CHILENO;;Silencioso;RENCA                         ;METROPOLITANA;0;0;0;0;0;0;0;0;0;CE EVOLUTION BLACK FULL+RES+VEL;DORMITORIO
12653918;;F;48;CHILENO;;X;PROVIDENCIA                   ;METROPOLITANA;0;0;0;0;0;0;0;0;0;COLCHON ERGO T 1P;DORMITORIO
15099750;;M;40;CHILENO;;X;SAN ANTONIO                   ;VALPARAISO;0;0;0;0;0;0;0;0;0;CLOSET ESPANA 6P+4C;DORMITORIO
19287523;;M;26;CHILENO;;Z;PUENTE ALTO                   ;METROPOLITANA;0;0;0;0;0;0;0;0;0;CAMA EUROPEA BAMBOO 1,5P;DORMITORIO
25474614;;M;33;VENEZOLANO;;Extranjero;CALAMA                        ;ANTOFAGASTA;0;0;0;0;0;0;0;0;0;PACK 2 ALMOHADAS C+L;DORMITORIO
24216059;;F;48;BOLIVIANO;;Extranjero;N/D;N/D;0;0;0;0;0;0;0;0;0;BOX AMERICANO EXCELLENCE 2P BASE NORMAL;DORMITORIO
7503081;;F;68;CHILENO;;Boomers;PANQUEHUE                     ;VALPARAISO;0;0;0;0;0;0;0;0;0;COLCHON NEW STYLE 4 2P;DORMITORIO
17363370;;M;32;CHILENO;;Millenial;COMBARBALA                    ;COQUIMBO;0;0;0;0;0;0;0;0;0;CAMA EUROPEA THERAPEDIC MAS 1,5P;DORMITORIO
16947733;;M;34;CHILENO;;Millenial;PROVIDENCIA                   ;METROPOLITANA;0;0;0;0;0;0;0;0;0;CE EVOLUTION BLACK 1,5P BN DUAL SIDE;DORMITORIO
12212808;;F;50;CHILENO;;X;PROVIDENCIA                   ;METROPOLITANA;0;0;0;0;0;0;0;0;0;CLOSET CHOCOLATE 4P;DORMITORIO
7598035;;F;78;CHILENO;;Silencioso;ANGOL                         ;ARAUCANIA;0;0;0;0;0;0;0;0;0;COLCHON NEW ORTOPEDIC 2P;DORMITORIO
17247078;;M;32;CHILENO;;Millenial;LEBU                          ;BIO BIO;0;0;0;0;0;0;0;0;0;CE NEW STYLE 6 2P 2MT BD;DORMITORIO
16192228;;F;36;CHILENO;;Millenial;PROVIDENCIA                   ;METROPOLITANA;0;0;0;0;0;0;0;0;0;CE EVOLUTION BLACK 2P BD+RESP+2 VEL;DORMITORIO
10929071;Casado;M;54;CHILENO;CONSTRUCTOR CIVIL;X;PROVIDENCIA                   ;METROPOLITANA;0;0;0;0;0;0;0;0;0;CLOSET NIZA 6P+2C;DORMITORIO
13845424;;F;41;CHILENO;;X;LOS ANGELES                   ;BIO BIO;0;0;0;0;0;0;0;0;0;PACK 2 ALMOHADAS C+L;DORMITORIO
9106750;;F;58;CHILENO;;Boomers;N/D;N/D;0;0;0;0;0;0;0;0;0;CE EVOLUTION BLACK 1,5P + RESPALDO CASTILLA;DORMITORIO
18852783;Soltero;M;28;CHILENO;INGENIERO DE EJECUCION INDUSTRIAL;Millenial;PROVIDENCIA                   ;METROPOLITANA;0;0;0;0;0;0;0;0;0;CE EVOLUTION BLACK 1,5P + RESPALDO CASTILLA;DORMITORIO
12313017;;F;49;CHILENO;;X;PROVIDENCIA                   ;METROPOLITANA;0;0;0;0;0;0;0;0;0;BS NEW ORTOPEDIC B5 BLACK 2PBN;DORMITORIO
9536278;;M;60;CHILENO;;Boomers;RENCA                         ;METROPOLITANA;0;0;0;0;0;0;0;0;0;CE EVOLUTION BLACK 1,5P + RESPALDO CASTILLA;DORMITORIO
17549703;;F;30;CHILENO;;Millenial;PETORCA                       ;VALPARAISO;0;0;0;0;0;0;0;0;0;CLOSET ARICA TV 32 M302 TEXTURADO;DORMITORIO
12986590;;F;46;CHILENO;;X;CAUQUENES                     ;MAULE;0;0;0;0;0;0;0;0;0;COLCHON IBIZA 2P 2MTS;DORMITORIO
19864776;;F;24;CHILENO;;Z;CHEPICA                       ;L.G.B.OÂ´HIGGINS;0;0;0;0;0;0;0;0;0;ALMOHADA SOFT MICROGEL;DORMITORIO
19822654;;M;23;CHILENO;;Z;TOCOPILLA                     ;ANTOFAGASTA;0;0;0;0;0;0;0;0;0;CE Evolution Black 2PBD + Sabanas Imperial;DORMITORIO
16533696;;M;35;CHILENO;;Millenial;PROVIDENCIA                   ;METROPOLITANA;0;0;0;0;0;0;0;0;0;CAMA EUROPEA IBIZA 1,5 PL + ALMOHADA ROYAL;DORMITORIO
13671943;Casado;M;43;CHILENO;ARQUITECTO;X;PROVIDENCIA                   ;METROPOLITANA;0;0;0;0;0;0;0;0;0;CAMA NEW STYLE 2 1P;DORMITORIO
26565634;;M;40;CHILENO;;Extranjero;"";"";59990;1;1;0;0;0;1;1;59990;Impresora Monocromatica Xerox B210-NDI;COMPUTACION
18892191;Soltero;M;27;CHILENO;PROFESOR;Millenial;PROVIDENCIA                   ;METROPOLITANA;249990;1;1;1;1;249990;0;0;0;TAB S6 Lite (610) 4GB 64GB 10.4P PINK;COMPUTACION
14362446;;F;41;CHILENO;;X;PROVIDENCIA                   ;METROPOLITANA;253980;2;1;2;1;253980;0;0;0;TAB S6 Lite (610) 4GB 64GB 10.4P BLUE;COMPUTACION
15612078;;F;38;CHILENO;;Millenial;N/D;N/D;177970;3;3;0;0;0;3;3;177970;Multifuncional EcoTank L3250 Wifi;COMPUTACION
16325008;;M;36;CHILENO;;Millenial;OVALLE                        ;COQUIMBO;189980;2;2;0;0;0;2;2;189980;TAB Galaxy A7 Lite (8.7, 32GB, WIFI + 4G);COMPUTACION
9517881;;F;60;CHILENO;;Boomers;VINA DEL MAR                  ;VALPARAISO;654669;14;8;0;0;0;14;8;654669;NTBK 250 G8 Ci5-1135G7/8GB/256 SSD/15P/Win10Pro;COMPUTACION
22686047;;M;33;PERUANO;;Extranjero;CERRILLOS                     ;METROPOLITANA;481272;9;3;0;0;0;9;3;481272;NTBK 240 G8 Core i3-1005G1/4GB/1TB/14P;COMPUTACION
13452934;;F;43;CHILENO;;X;N/D;N/D;353230;3;1;0;0;0;3;1;353230;NTBK IP3 Ryzen 3-5300U/8GB/256GB SSD/14P FHD;COMPUTACION
6857649;;F;70;CHILENO;;Silencioso;YERBAS BUENAS                 ;MAULE;238280;3;2;0;0;0;3;2;238280;Multifuncional DCPT520W Wifi;COMPUTACION
26200752;;M;26;HAITIANO;;Extranjero;N/D;N/D;492570;7;4;0;0;0;7;4;492570;TAB MLAB 7 MB4 PLUS 3G 1+16GB WHITE 8762;COMPUTACION
20589025;;M;21;CHILENO;;Z;"";"";406980;2;1;0;0;0;2;1;406980;NTBK IdeaPad 3 Ryzen 5-4500U/12GB/1TB/15P;COMPUTACION
15548403;;M;38;CHILENO;;X;LA SERENA;COQUIMBO;119990;1;1;1;1;119990;0;0;0;Monitor Mi 23.8P Full HD;COMPUTACION
8834548;;F;62;CHILENO;;Boomers;COIHAIQUE                     ;AYSEN;1027590;10;6;0;0;0;10;6;1027590;NTBK 245 G8 R5-5500U/8GB/256GB SSD/14P/Win10Pro;COMPUTACION
12380510;;M;49;CHILENO;;Extranjero;N/D;N/D;193130;3;2;0;0;0;3;2;193130;Multifuncional EcoTank L3210;COMPUTACION
19301418;Soltero;F;27;CHILENO;INGENIERIA EN ADMINISTRACION DE EMPRESAS MENCION GESTION DE PERSONAS;Z;PROVIDENCIA                   ;METROPOLITANA;0;0;2;0;2;0;0;0;0;Multifuncional EcoTank L3210;COMPUTACION
17395773;;M;32;CHILENO;;Millenial;LOTA;BIO-BIO;289970;3;3;0;0;0;3;3;289970;Multifuncional EcoTank L3210;COMPUTACION
17772089;;M;31;CHILENO;;Millenial;PROVIDENCIA                   ;METROPOLITANA;829960;4;2;4;2;829960;0;0;0;NTBK FX506 Ci5-10300H/8GB/512GB SSD/GTX1650 4GB;COMPUTACION
13237562;;F;45;CHILENO;;X;PROVIDENCIA                   ;METROPOLITANA;484980;2;1;2;1;484980;0;0;0;NTBK 15-DY2055LA Ci5-1135G7/8 GB+16GB/256GB/15P;COMPUTACION
4625001;;F;79;CHILENO;;Silencioso;ARICA                         ;ARICA Y PARINACOTA;154290;2;1;0;0;0;2;1;154290;TAB Galaxy A7 Lite (8.7, 32GB, WIFI);COMPUTACION
6814850;;F;69;CHILENO;;Silencioso;ALTO HOSPICIO;TARAPACA;233000;3;2;0;0;0;3;2;233000;Tab M10 Plus FHD 4GB 64GB 10.3P platinum grey;COMPUTACION
18274526;;F;29;CHILENO;;Millenial;PROVIDENCIA                   ;METROPOLITANA;0;0;2;0;2;0;0;0;0;TABLET MLAB 7 MB4 PLUS 1+16GB RED;COMPUTACION
13723086;;M;42;CHILENO;;X;PUNTA ARENAS                  ;MAGALLANES;1648140;17;5;0;0;0;17;5;1648140;Multifuncional EcoTank L3250 Wifi;COMPUTACION
16904699;;F;33;CHILENO;;Millenial;"";"";33991;1;1;0;0;0;1;1;33991;TAB MLAB 7 MB4 PLUS 3G 1+16GB WHITE 8762;COMPUTACION
8081014;;M;64;CHILENO;;Boomers;PUNTA ARENAS;MAGALLANES;269970;3;3;0;0;0;3;3;269970;Multifuncional EcoTank L3210;COMPUTACION
8640231;;M;61;CHILENO;;Boomers;MONTE PATRIA                  ;COQUIMBO;459920;8;5;0;0;0;8;5;459920;NTBK IP3 Core i3-1115G4/4GB/512GB SSD/14P FHD;COMPUTACION
6420757;;M;78;CHILENO;;Silencioso;COCHRANE                      ;AYSEN;530770;3;1;0;0;0;3;1;530770;NTBK 250 G8 Ci5-1135G7/8GB/256 SSD/15P/Win10Pro;COMPUTACION
6534446;;M;71;CHILENO;;Silencioso;ARICA                         ;TARAPACA;429990;1;1;0;0;0;1;1;429990;AIO IC A340 Core i3/4GB/1TB/24P Full HD;COMPUTACION
11797819;Casado;M;53;CHILENO;AGROINDUSTRIA;X;RENCA                         ;METROPOLITANA;212980;2;1;0;0;0;2;1;212980;Tab M10 Plus FHD 4GB 64GB 10.3P platinum grey;COMPUTACION
9698119;;F;57;CHILENO;;Boomers;RENCA                         ;METROPOLITANA;379990;1;1;0;0;0;1;1;379990;NTBK 245 G8 R5-5500U/8GB/256GB SSD/14P/Win10Pro;COMPUTACION
19756974;;F;24;CHILENO;;Z;SAN ANTONIO;VALPARAISO;199970;3;3;2;2;69980;1;1;129990;Multifuncional DCPT220;COMPUTACION
11326609;;M;53;CHILENO;;X;TOCOPILLA                     ;ANTOFAGASTA;1850370;17;10;0;0;0;17;10;1850370;Smart Tab M8 2G-32GB 8 IPS HD WiFi + Docking iro;COMPUTACION
12804250;;F;47;CHILENO;;X;RENCA                         ;METROPOLITANA;232980;2;1;0;0;0;2;1;232980;NTBK 240 G8 Celeron N4020/4GB/500GB/14P;COMPUTACION
13593832;Casado;M;43;CHILENO;;X;QUEMCHI                       ;LOS LAGOS;585410;3;4;0;0;0;3;4;585410;NTBK 348 G7 Core i5-10210U/4GB/1TB/14P;COMPUTACION
13379835;;M;44;CHILENO;;X;PROVIDENCIA                   ;METROPOLITANA;330980;6;2;0;0;0;6;2;330980;NTBK 15-ef1015la Ryzen 3-4300U/4GB/256GBSSD/15P;COMPUTACION
19153396;Soltero;M;26;CHILENO;;Z;PROVIDENCIA                   ;METROPOLITANA;882980;2;1;0;0;0;2;1;882980;NTBK FX506 Ci5-10300H/8GB/512GB SSD/GTX1650 4GB;COMPUTACION
18159747;;F;47;CHILENO;;X;VILLARICA                     ;ARAUCANIA;3280730;27;6;0;0;0;27;6;3280730;NTBK 15-ef1015la Ryzen 3-4300U/4GB/256GBSSD/15P;COMPUTACION
16012067;Soltero;F;36;CHILENO;MEDICO VETERINARIO;Millenial;PROVIDENCIA                   ;METROPOLITANA;143980;2;1;2;1;143980;0;0;0;Tab M10 Plus FHD 4GB 64GB 10.3P platinum grey;COMPUTACION
19817194;;F;24;CHILENO;;Z;LAGO VERDE;AYSEN;343463;4;4;2;2;170483;2;2;172980;Multifuncional EcoTank L3210;COMPUTACION
11917499;;F;52;CHILENO;;X;LONCOCHE                      ;ARAUCANIA;864330;6;4;4;3;464960;2;1;399370;Multifuncional EcoTank L3250 Wifi;COMPUTACION
6776596;;F;70;CHILENO;;Silencioso;PROVIDENCIA                   ;METROPOLITANA;266450;2;1;0;0;0;2;1;266450;NTBK IP S145 AMD A4-9125/4GB/500GB/14P;COMPUTACION
16631068;;F;34;CHILENO;;Millenial;N/D;N/D;49990;2;1;0;0;0;2;1;49990;TAB MLAB MBX 8 QUAD CORE 1G+16G 8716;COMPUTACION
9463345;;F;55;CHILENO;;Boomers;PROVIDENCIA                   ;METROPOLITANA;699990;2;1;0;0;0;2;1;699990;NTBK GAMER L5i Ci5-10300H/8GB/512SSD/GTX1650 4GB;COMPUTACION
13363349;;F;43;CHILENO;;X;SAN FELIPE                    ;VALPARAISO;1399338;8;2;0;0;0;8;2;1399338;TAB Galaxy S7 FE (12.4, 128GB WIFI) SILVER;COMPUTACION
19612993;;M;25;CHILENO;;Z;PROVIDENCIA                   ;METROPOLITANA;224980;2;1;2;1;224980;0;0;0;NTBK Inspiron 3505 Athlon 3050U/12GB/256 SSD/15P;COMPUTACION
26289183;;M;52;EXTRANJERO - NO INFORMA NACIONALIDAD;;Extranjero;"";"";223980;2;1;2;1;223980;0;0;0;NTBK Inspiron 3505 Athlon 3050U/12GB/256 SSD/15P;COMPUTACION
12809768;;F;47;CHILENO;;X;CERRO NAVIA                   ;METROPOLITANA;249990;1;1;0;0;0;1;1;249990;TAB S6 Lite (610) 4GB 64GB 10.4P PINK;COMPUTACION
6577109;;M;72;CHILENO;;Silencioso;OVALLE                        ;COQUIMBO;733750;4;2;0;0;0;4;2;733750;NTBK 245 G8 R5-5500U/8GB/256GB SSD/14P/Win10Pro;COMPUTACION
15192518;;M;39;CHILENO;;Extranjero;LOTA                          ;BIO BIO;49990;1;1;0;0;0;1;1;49990;Multifuncional DeskJet Ink Advantage 2752 Wifi;COMPUTACION
16734539;;F;35;CHILENO;;Millenial;N/D;N/D;504670;4;2;0;0;0;4;2;504670;NTBK Inspiron 3501 Ci3-1115G4/4GB/1TB/14P;COMPUTACION
16492458;;M;35;CHILENO;;Millenial;PROVIDENCIA                   ;METROPOLITANA;519980;2;2;1;1;169990;1;1;349990;Producto segunda seleccion Banda 4;COMPUTACION
8576743;;M;61;CHILENO;;Boomers;CALAMA                        ;ANTOFAGASTA;352980;2;1;0;0;0;2;1;352980;NTBK 15-ef1015la Ryzen 3-4300U/4GB/256GBSSD/15P;COMPUTACION
18061710;Soltero;F;30;CHILENO;;Millenial;PROVIDENCIA                   ;METROPOLITANA;483980;2;1;2;1;483980;0;0;0;NTBK 2en1 Flex5 R5-4500U/8GB/256SSD/14P FHD+Pen;COMPUTACION
9281134;;M;59;CHILENO;;Boomers;RENCA                         ;METROPOLITANA;139990;1;1;0;0;0;1;1;139990;Tab M10 Plus FHD 4GB 64GB 10.3P platinum grey;COMPUTACION
9788674;;M;58;CHILENO;;Boomers;PENALOLEN;METROPOLITANA;313980;2;1;2;1;313980;0;0;0;NTBK IP3 Ryzen 3-5300U/8GB/256GB SSD/14P FHD;COMPUTACION
8016903;;M;62;CHILENO;;Boomers;ANGOL                         ;ARAUCANIA;79990;1;1;0;0;0;1;1;79990;TAB M8 QC 2GB 32GB 8P Gris;COMPUTACION
16975454;;F;34;CHILENO;;Millenial;COIHAIQUE                     ;AYSEN;547960;4;2;2;1;208980;2;1;338980;NTBK Inspiron 3501 Ci3-1115G4/4GB/1TB/14P;COMPUTACION
18913683;Soltero;M;32;CHILENO;;Millenial;ARICA                         ;TARAPACA;319990;1;1;1;1;319990;0;0;0;NTBK IP3 Ryzen 3-5300U/8GB/256GB SSD/14P FHD;COMPUTACION
13243081;;M;45;CHILENO;;X;PUDAHUEL                      ;METROPOLITANA;253980;2;1;2;1;253980;0;0;0;TAB S6 Lite (610) 4GB 64GB 10.4P DARK GREY;COMPUTACION
8232492;;F;62;CHILENO;;Boomers;COQUIMBO                      ;COQUIMBO;159990;1;1;0;0;0;1;1;159990;Multifuncional DCPT520W Wifi;COMPUTACION
18914372;;F;28;CHILENO;;Millenial;QUILPUE                       ;VALPARAISO;106980;2;1;0;0;0;2;1;106980;Monitor 24 FHD 75Hz HDMI VGA/Flat IPS/Black;COMPUTACION
24019308;;F;24;PERUANO;;Extranjero;IQUIQUE;TARAPACA;361980;2;1;2;1;361980;0;0;0;TABLET XIAOMI MI PAD 5 6/126GB;COMPUTACION
15785477;;F;37;CHILENO;;Millenial;ILLAPEL                       ;COQUIMBO;1872880;12;8;2;1;54980;10;7;1817900;Multifuncional DeskJet Ink Advantage 2775 Wifi;COMPUTACION
9757460;;F;59;CHILENO;;Boomers;ARICA                         ;TARAPACA;1627940;4;2;0;0;0;4;2;1627940;NTBK M3500 Ryzen 5 -5600H/8GB/512GB SSD/15P FHD;COMPUTACION
24331690;;F;24;COLOMBIANO;;Extranjero;"";"";267970;3;2;0;0;0;3;2;267970;NTBK 240 G8 Celeron N4020/4GB/500GB/14P;COMPUTACION
19679062;;M;24;CHILENO;;Extranjero;PROVIDENCIA                   ;METROPOLITANA;159990;2;1;2;1;159990;0;0;0;Monitor UltraGear 23.8P 144Hz Full HD IPS;COMPUTACION
19440811;;F;25;CHILENO;;Z;PROVIDENCIA                   ;METROPOLITANA;69990;1;1;1;1;69990;0;0;0;Multifuncional XP-2101 wifi;COMPUTACION
9806468;;F;59;CHILENO;;Boomers;CONSTITUCION                  ;MAULE;782890;6;4;0;0;0;6;4;782890;NTBK 15-ef1015la Ryzen 3-4300U/4GB/256GBSSD/15P;COMPUTACION
18902098;Soltero;F;27;CHILENO;BIOQUIMICO;Millenial;PROVIDENCIA                   ;METROPOLITANA;709980;2;1;2;1;709980;0;0;0;NTBK GAMER GF66 Ci5-11400H/8GB/512GB/GTX1650 4GB;COMPUTACION
18516879;Soltero;M;29;CHILENO;;Millenial;PROVIDENCIA                   ;METROPOLITANA;236980;2;1;2;1;236980;0;0;0;NTBK Inspiron 3501 Ci3-1115G4/4GB/1TB/14P;COMPUTACION
20709898;;F;21;CHILENO;;Z;PROVIDENCIA                   ;METROPOLITANA;308980;2;1;2;1;308980;0;0;0;TAB P11 6G-128GB Case + KB + Pen + Wifi +Â  Slate;COMPUTACION
7568642;;M;61;CHILENO;;Boomers;OVALLE                        ;COQUIMBO;258970;3;2;2;1;229980;1;1;28990;NTBK Inspiron 3501 Ci3-1115G4/4GB/1TB/14P;COMPUTACION
16062734;;M;36;CHILENO;;Millenial;RENCA                         ;METROPOLITANA;348980;2;2;0;0;0;2;2;348980;NTBK IP3 Ryzen 3-5300U/8GB/256GB SSD/14P FHD;COMPUTACION
19599103;;F;25;CHILENO;;Z;PROVIDENCIA                   ;METROPOLITANA;159990;1;1;1;1;159990;0;0;0;Multifuncional EcoTank L3210;COMPUTACION
18205500;;F;29;CHILENO;;Millenial;"";"";169980;2;2;1;1;149990;1;1;19990;Multifuncional EcoTank L3210;COMPUTACION
9749289;;M;58;CHILENO;;Boomers;PIRQUE                        ;METROPOLITANA;179560;2;1;0;0;0;2;1;179560;Tab M10 FHD Plus LTE 10.3IN 2GB 32GB;COMPUTACION
16987445;;F;33;CHILENO;;Millenial;PROVIDENCIA                   ;METROPOLITANA;567960;4;2;4;2;567960;0;0;0;Multifuncional DCPT520W Wifi;COMPUTACION
15641401;;M;38;CHILENO;;Millenial;PANGUIPULLI                   ;LOS LAGOS;770470;3;2;2;1;510480;1;1;259990;NTBK GalaxyBook2 Ci5-1235U/8GB/512GB SSD/15P FHD;COMPUTACION
11124106;;F;54;CHILENO;;Boomers;LEBU                          ;BIO BIO;1608140;12;6;0;0;0;12;6;1608140;Monitor Gamer Redragon Jade 27P 165Hz Full HD;COMPUTACION
9684314;;M;58;CHILENO;;Boomers;COQUIMBO                      ;COQUIMBO;330980;2;1;2;1;330980;0;0;0;NTBK IP3 Ryzen 3-5300U/8GB/256GB SSD/14P FHD;COMPUTACION
18229764;;M;29;CHILENO;;Millenial;SAN FERNANDO                  ;L.G.B.OÂ´HIGGINS;1246871;14;8;0;0;0;14;8;1246871;Multifuncional EcoTank L3210;COMPUTACION
16242727;;M;36;CHILENO;;Millenial;LOTA                          ;BIO BIO;338970;2;1;0;0;0;2;1;338970;NTBK Vivobook Ci3/4GB/128GB SSD/15P W+T Ingl;COMPUTACION
15473255;;M;39;CHILENO;;X;PUENTE ALTO;METROPOLITANA;193980;2;1;2;1;193980;0;0;0;NTBK Inspiron 3501 Ci3-1115G4/4GB/1TB/14P;COMPUTACION
18501952;Soltero;M;28;CHILENO;ABOGADO;Millenial;PROVIDENCIA                   ;METROPOLITANA;382960;4;2;4;2;382960;0;0;0;TABLET XIAOMI MI PAD 5 6/126GB;COMPUTACION
10133539;Casado;M;57;CHILENO;;Boomers;ARAUCO                        ;BIO BIO;95700;2;1;0;0;0;2;1;95700;TAB MBXR 8717 4Core 2GB 16GB 10 Negra;COMPUTACION
18624678;;M;28;CHILENO;;Millenial;N/D;N/D;883980;2;1;2;1;883980;0;0;0;NTBK L5i Ci7-10750H/16GB/128SSD+1TB/RTX2060 6GB;COMPUTACION
10550197;;M;55;CHILENO;;Boomers;IQUIQUE                       ;TARAPACA;161980;2;1;2;1;161980;0;0;0;NTBK Inspiron 3502 Celeron/4GB/128GB SSD/+O365;COMPUTACION
16901468;;M;34;CHILENO;;Millenial;PROVIDENCIA                   ;METROPOLITANA;159990;1;1;0;0;0;1;1;159990;Multifuncional DCPT520W Wifi;COMPUTACION
17358868;;F;33;CHILENO;;Millenial;VALDIVIA;LOS LAGOS;49980;2;1;2;1;49980;0;0;0;Multifuncional Pixma TR4522 Wifi;COMPUTACION
12726397;;F;47;CHILENO;;X;MELIPILLA                     ;METROPOLITANA;174560;2;1;0;0;0;2;1;174560;Tab M10 Plus FHD 4GB 64GB 10.3P platinum grey;COMPUTACION
12948607;;M;46;CHILENO;;X;SAN FELIPE                    ;VALPARAISO;551520;4;3;3;2;411530;1;1;139990;Tab M10 Plus FHD 4GB 64GB 10.3P platinum grey;COMPUTACION
15788771;;M;38;CHILENO;;Millenial;LA PINTANA                    ;METROPOLITANA;369990;1;1;0;0;0;1;1;369990;NTBK IP3 Ryzen 3-5300U/8GB/256GB SSD/14P FHD;COMPUTACION
25757980;;M;30;NO INFORMA NACIONALIDAD;;Extranjero;CONCEPCION;BIO-BIO;115980;2;1;2;1;115980;0;0;0;NTBK 240 G8 Celeron N4020/4GB/500GB/14P;COMPUTACION
16540799;;F;34;CHILENO;;Millenial;QUILLOTA                      ;VALPARAISO;7990;1;1;0;0;0;1;1;7990;T544 DYE BLACK INK BOTTLE (65ml);COMPUTACION
10963924;;M;45;CHILENO;;X;VALDIVIA                      ;LOS RIOS;299980;2;2;0;0;0;2;2;299980;Galaxy Tab A8 (10.5, 32GB, WIFI) Silver;COMPUTACION
11186190;;F;54;CHILENO;;Boomers;PROVIDENCIA                   ;METROPOLITANA;353980;2;1;2;1;353980;0;0;0;NTBK IP3 Ryzen 3-5300U/8GB/256GB SSD/14P FHD;COMPUTACION
17548420;;F;30;CHILENO;;Millenial;N/D;N/D;1218240;15;11;0;0;0;15;11;1218240;Galaxy Tab A8 (10.5, 32GB, WIFI) Silver;COMPUTACION
15201199;;M;40;CHILENO;;X;CANETE                        ;BIO BIO;797030;10;8;10;5;802620;0;3;-5590;Impresora Monocromatica Xerox B210-NDI;COMPUTACION
13527862;;M;43;CHILENO;;X;TALCA                         ;MAULE;215460;2;1;0;0;0;2;1;215460;NTBK 240 G8 Celeron N4020/4GB/500GB/14P;COMPUTACION
20529829;;M;21;CHILENO;;Z;PROVIDENCIA                   ;METROPOLITANA;587970;3;2;1;1;499990;2;1;87980;NTBK Aspire 5 R5-3500U/12GB/256SSD GB/15P FHD;COMPUTACION
8666090;Casado;M;63;CHILENO;;Boomers;RENCA                         ;METROPOLITANA;144990;1;1;0;0;0;1;1;144990;Tab M10 Plus FHD 4GB 64GB 10.3P platinum grey;COMPUTACION
17680361;Soltero;M;31;CHILENO;INGENIERO ELECTRICO;Millenial;PROVIDENCIA                   ;METROPOLITANA;179940;7;4;7;4;179940;0;0;0;NTBK Tecra A30-G Intel Celeron 5205U/ Ram 4GB/ 1;COMPUTACION
15810165;;M;38;CHILENO;;Millenial;LOS ANGELES                   ;BIO BIO;119990;1;1;0;0;0;1;1;119990;Multifuncional Ink Tank 315;COMPUTACION
15416495;;M;39;CHILENO;;X;COLINA                        ;METROPOLITANA;279990;1;1;0;0;0;1;1;279990;NTBK 15-ef1015la Ryzen 3-4300U/4GB/256GBSSD/15P;COMPUTACION
13274943;;M;45;CHILENO;;X;SANTIAGO                      ;METROPOLITANA;594100;6;3;4;2;313960;2;1;280140;Multifuncional Pixma TR4522 Wifi;COMPUTACION
18053418;;F;30;CHILENO;;Millenial;PROVIDENCIA                   ;METROPOLITANA;63980;2;1;2;1;63980;0;0;0;Multifuncional Pixma TR4522 Wifi;COMPUTACION
9609486;Casado;F;55;CHILENO;TECNICO EN MASOTERAPIA;Silencioso;PROVIDENCIA                   ;METROPOLITANA;189980;2;3;2;3;189980;0;0;0;TAB 7 MB4 Plus 4Core 1GB 16GB 7 Plata;COMPUTACION
11514392;Casado;M;52;CHILENO;;X;SALAMANCA                     ;COQUIMBO;497990;3;1;0;0;0;3;1;497990;NTBK 15-eh0006la Ryzen 5-4500U/8GB/512GB/15P;COMPUTACION
13267205;;F;44;CHILENO;;X;PROVIDENCIA                   ;METROPOLITANA;23970;3;1;3;1;23970;0;0;0;TINTA 664 TRI COLOR;COMPUTACION
18112557;Soltero;M;30;CHILENO;;Millenial;PROVIDENCIA                   ;METROPOLITANA;108980;2;2;2;2;108980;0;0;0;Tab M7 1G-8GB 7 IPS HD WiFi onix black;COMPUTACION
8902924;;F;66;CHILENO;;Boomers;N/D;N/D;818910;9;2;0;0;0;9;2;818910;TAB Galaxy A7 Lite (8.7, 32GB, WIFI);COMPUTACION
15569944;;F;39;CHILENO;;X;N/D;N/D;614970;3;2;3;2;614970;0;0;0;NBTK IP3 Core i5-10210U/8GB/512GB SSD/15P;COMPUTACION
10226494;Casado;M;55;CHILENO;;Boomers;RENCA                         ;METROPOLITANA;249990;1;1;0;0;0;1;1;249990;NTBK ASUS Ci3/4GB/128GB Win+Tec Ingles+S/adap;COMPUTACION
15872234;;M;37;CHILENO;;Millenial;CARTAGENA                     ;VALPARAISO;369990;1;1;1;1;369990;0;0;0;NTBK 348 G7 Core i5-10210U/4GB/1TB/14P;COMPUTACION
12230244;Casado;M;49;CHILENO;;X;RENCA                         ;METROPOLITANA;279990;1;1;0;0;0;1;1;279990;NTBK 15-ef1015la Ryzen 3-4300U/4GB/256GBSSD/15P;COMPUTACION
26796268;Soltero;M;32;VENEZOLANO;;Extranjero;PROVIDENCIA                   ;METROPOLITANA;48980;2;1;2;1;48980;0;0;0;Impresora Laser HL-1202 Monocromatica;COMPUTACION
16342476;;M;35;CHILENO;;Millenial;TALAGANTE                     ;METROPOLITANA;389970;3;4;0;2;0;3;2;389970;TAB MLAB MBX 8 QUAD CORE 1G+16G 8716;COMPUTACION
17804325;;M;31;CHILENO;;Millenial;PROVIDENCIA                   ;METROPOLITANA;288980;2;1;2;1;288980;0;0;0;TAB S6 Lite (610) 4GB 64GB 10.4P DARK GREY;COMPUTACION
12101129;;M;53;CHILENO;;X;PUERTO MONTT                  ;LOS LAGOS;1043959;7;5;0;0;0;7;5;1043959;Multifuncional DCPT220;COMPUTACION
16205523;;F;36;CHILENO;;Millenial;N/D;N/D;146970;3;2;3;2;146970;0;0;0;Multifuncional DeskJet Ink Advantage 2775 Wifi;COMPUTACION
8244082;;F;61;CHILENO;;Boomers;EL MONTE                      ;METROPOLITANA;291661;3;2;0;0;0;3;2;291661;Multifuncional DeskJet Ink Advantage 2752 Wifi;COMPUTACION
14389047;;F;44;CHILENO;;X;MAULE                         ;MAULE;516940;6;5;5;4;500950;1;1;15990;NTBK XH02 Celeron 4GB/64GB eMMC/11P/T+W ingles;COMPUTACION
20124164;;M;23;CHILENO;;Z;PROVIDENCIA                   ;METROPOLITANA;259990;1;1;1;1;259990;0;0;0;NTBK 15-ef1015la Ryzen 3-4300U/4GB/256GBSSD/15P;COMPUTACION
19472994;Soltero;M;25;CHILENO;;Z;PROVIDENCIA                   ;METROPOLITANA;686980;2;1;2;1;686980;0;0;0;NTBK FX506 Ci5-10300H/8GB/512GB SSD/GTX1650 4GB;COMPUTACION
6303155;Casado;M;73;CHILENO;TOPOGRAFIA TECNICA DEL ESTADOTITULADO;Silencioso;PROVIDENCIA                   ;METROPOLITANA;149990;1;1;0;0;0;1;1;149990;Multifuncional EcoTank L3210;COMPUTACION
18466286;Casado;F;28;CHILENO;PSICOLOGA;Silencioso;PROVIDENCIA                   ;METROPOLITANA;153980;2;1;2;1;153980;0;0;0;Multifuncional DCPT520W Wifi;COMPUTACION
5618841;;F;77;CHILENO;;Silencioso;RENCA                         ;METROPOLITANA;376990;3;1;0;0;0;3;1;376990;NTBK 15-ef1015la Ryzen 3-4300U/4GB/256GBSSD/15P;COMPUTACION
20448935;;F;22;CHILENO;;Z;SAN RAMON;METROPOLITANA;89990;1;1;1;1;89990;0;0;0;NTBK BR11 Celeron N4500/4GB/64GB eMMC/11P;COMPUTACION
19180011;;M;26;CHILENO;;Millenial;"";"";423520;4;2;4;2;423520;0;0;0;Multifuncional DCPT720DW Wifi, Duplex y ADF;COMPUTACION
17635269;;F;31;CHILENO;;Millenial;QUILLOTA                      ;VALPARAISO;159990;1;1;0;0;0;1;1;159990;Multifuncional EcoTank L3210;COMPUTACION
25730778;Soltero;F;29;CUBANO;;Extranjero;PROVIDENCIA                   ;METROPOLITANA;33980;2;1;2;1;33980;0;0;0;TAB 7 MB4 Plus 4Core 1GB 16GB 7 Plata;COMPUTACION
19499991;;M;25;CHILENO;;Silencioso;PROVIDENCIA                   ;METROPOLITANA;203970;3;1;3;1;203970;0;0;0;NTBK DATACHABLE IDEAPAD D330 N4020 4G 128G W10PR;COMPUTACION
17307737;;F;32;CHILENO;;Millenial;PROVIDENCIA                   ;METROPOLITANA;153980;2;1;2;1;153980;0;0;0;Multifuncional DCPT520W Wifi;COMPUTACION
19410857;;F;25;CHILENO;;Z;SAN JAVIER                    ;MAULE;449940;6;3;6;3;449940;0;0;0;Multifuncional DeskJet Ink Advantage 2775 Wifi;COMPUTACION
12398009;Casado;M;48;CHILENO;INGENIERO;X;RENCA                         ;METROPOLITANA;62990;1;1;1;1;62990;0;0;0;365 Familia 6 usuarios Anual 6GQ-01604;COMPUTACION
6188658;;M;68;CHILENO;;Silencioso;PANGUIPULLI                   ;LOS LAGOS;515450;5;4;2;1;105480;3;3;409970;NTBK DATACHABLE IDEAPAD D330 N4020 4G 128G W10PR;COMPUTACION
15252517;;M;50;CHILENO;;X;RANCAGUA                      ;L.G.B.OÂ´HIGGINS;349980;2;2;0;0;0;2;2;349980;Monitor Gamer Redragon Jade 27P 165Hz Full HD;COMPUTACION
18817155;;M;27;CHILENO;;Z;CORONEL                       ;BIO BIO;1332530;8;4;2;1;686980;6;3;645550;NTBK FX506 Ci5-10300H/8GB/512GB SSD/GTX1650 4GB;COMPUTACION
13626114;;M;42;CHILENO;;X;N/D;N/D;453870;6;3;0;0;0;6;3;453870;NTBK 240 G8 Celeron N4020/4GB/500GB/14P;COMPUTACION
21367892;Soltero;M;33;CHILENO;QUIMICO FARMACEUTICO;Extranjero;PROVIDENCIA                   ;METROPOLITANA;103980;2;1;2;1;103980;0;0;0;TAB Galaxy A7 Lite (8.7, 32GB, WIFI);COMPUTACION
17849865;;M;31;CHILENO;;Millenial;PROVIDENCIA                   ;METROPOLITANA;147980;2;1;2;1;147980;0;0;0;Multifuncional DCPT220;COMPUTACION
17947388;;F;33;CHILENO;;Millenial;PROVIDENCIA                   ;METROPOLITANA;57480;2;1;2;1;57480;0;0;0;Impresora Laser HL-1202 Monocromatica;COMPUTACION
19576995;;M;24;CHILENO;;Z;SAN JAVIER                    ;MAULE;225470;3;2;2;1;75480;1;1;149990;Multifuncional EcoTank L3210;COMPUTACION
15515875;;F;39;CHILENO;;X;COIHAIQUE                     ;AYSEN;337950;5;5;0;0;0;5;5;337950;Impresora Monofuncional Laser 107w;COMPUTACION
16127383;;F;36;CHILENO;;Millenial;TRAIGUEN                      ;ARAUCANIA;183290;3;1;0;0;0;3;1;183290;Tab M10 Plus FHD 4GB 64GB 10.3P platinum grey;COMPUTACION
10358451;;M;57;CHILENO;;Boomers;N/D;N/D;79990;1;1;1;1;79990;0;0;0;TAB M7 3ra Gen MT8766 2+32GB 7 Wifi Iron grey;COMPUTACION
8691849;;F;56;CHILENO;;Boomers;LA CISTERNA                   ;METROPOLITANA;473530;4;2;0;0;0;4;2;473530;NTBK Aspire 3 Athlon 3020e/8GB/256GB SSD/14P;COMPUTACION
18265709;;F;30;CHILENO;;Millenial;SAGRADA FAMILIA               ;MAULE;324940;6;2;0;0;0;6;2;324940;TINTA EPSON T504 NG BOTELLA C13T03N12A;COMPUTACION
14087527;;M;42;CHILENO;;X;RENCA                         ;METROPOLITANA;68440;3;1;0;0;0;3;1;68440;TAB MLAB MBX 8 QUAD CORE 1G+16G 8716;COMPUTACION
11531623;;F;51;CHILENO;;X;VILLA ALEGRE                  ;MAULE;220970;3;4;1;1;114990;2;3;105980;Monitor Mi 23.8P Full HD;COMPUTACION
22834927;;F;48;PERUANO;;Extranjero;ANTOFAGASTA                   ;ANTOFAGASTA;299260;4;3;0;0;0;4;3;299260;Tab M10 Plus FHD 4GB 64GB 10.3P platinum grey;COMPUTACION
19880109;;F;24;CHILENO;;Z;N/D;N/D;64980;2;2;0;0;0;2;2;64980;Multifuncional Pixma TR4522 Wifi;COMPUTACION
22600483;;F;50;PERUANO;;Extranjero;ARICA                         ;ARICA Y PARINACOTA;402980;2;1;0;0;0;2;1;402980;NTBK M!4 Core i3-10110U/8GB/256GB SSD/14P FHD;COMPUTACION
17864630;;M;30;CHILENO;;Millenial;TALCA;MAULE;139990;1;1;1;1;139990;0;0;0;Tab M10 Plus FHD 4GB 64GB 10.3P platinum grey;COMPUTACION
18289938;;M;29;CHILENO;;Millenial;N/D;N/D;354980;2;2;0;0;0;2;2;354980;Multifuncional EcoTank L3250 Wifi;COMPUTACION
10955880;;M;51;CHILENO;;X;LA PINTANA                    ;METROPOLITANA;1049470;2;1;0;0;0;2;1;1049470;Galaxy Tab S8 (11, 256GB, WIFI) Dark Gray;COMPUTACION
13473296;Casado;M;43;CHILENO;MEDICO CIRUJANO;X;PROVIDENCIA                   ;METROPOLITANA;403980;2;1;2;1;403980;0;0;0;PC OMG! Serie IRX560BSO;COMPUTACION
9743556;;M;59;CHILENO;;Boomers;MACHALI                       ;L.G.B.OÂ´HIGGINS;64990;1;1;0;0;0;1;1;64990;Multifuncional Pixma TR4522 Wifi;COMPUTACION
25575587;;M;35;VENEZOLANO;;Extranjero;PROVIDENCIA                   ;METROPOLITANA;149990;1;1;1;1;149990;0;0;0;Multifuncional EcoTank L3210;COMPUTACION
13386911;;F;44;CHILENO;;X;TOCOPILLA                     ;ANTOFAGASTA;274990;1;1;0;0;0;1;1;274990;NTBK 15-ef1015la Ryzen 3-4300U/4GB/256GBSSD/15P;COMPUTACION
12154675;;M;52;CHILENO;;X;SALAMANCA                     ;COQUIMBO;1767940;6;4;4;2;1392960;2;2;374980;AIO IC A340 Core i5/4GB/256GB SSD+1TB/23.8P FHD;COMPUTACION
13922365;Casado;M;42;CHILENO;ABOGADO;X;CASTRO                        ;LOS LAGOS;679970;3;3;2;2;349980;1;1;329990;NTBK HT14 Celeron N4020 4GB/128GB SSD/14P;COMPUTACION
16775363;;M;34;CHILENO;;Millenial;ILLAPEL                       ;COQUIMBO;109980;2;1;2;1;109980;0;0;0;NTBK DATACHABLE IDEAPAD D330 N4020 4G 128G W10PR;COMPUTACION
11180475;;F;55;CHILENO;;Boomers;CANELA                        ;COQUIMBO;354990;1;1;0;0;0;1;1;354990;NTBK 14-dq2025la Ci3-1115G4/4GB/256GB+16GB/14P;COMPUTACION
4645860;;M;81;CHILENO;;Silencioso;VALLENAR;ATACAMA;1276240;6;3;0;0;0;6;3;1276240;NTBK 255 G8 Ryzen 5-5500U/8GB/256GB SSD/15P;COMPUTACION
15049513;Soltero;F;38;CHILENO;;X;PROVIDENCIA                   ;METROPOLITANA;236800;2;1;0;0;0;2;1;236800;NTBK 15-dw1080la Celeron N4020/4GB/1TB/15P;COMPUTACION
14129106;;F;40;CHILENO;;X;RENCA                         ;METROPOLITANA;7990;1;1;0;0;0;1;1;7990;TINTA BOTELLA EPSON T664120 NEGRA SERIE L;COMPUTACION
13169543;;F;45;CHILENO;;X;CHONCHI                       ;LOS LAGOS;239980;2;2;0;0;0;2;2;239980;NTBK 15-dw1080la Celeron N4020/4GB/1TB/15P;COMPUTACION
15107747;;M;39;CHILENO;;X;MOSTAZAL                      ;L.G.B.OÂ´HIGGINS;42990;1;1;0;0;0;1;1;42990;TAB MLAB MBX 8 QUAD CORE 1G+16G 8716;COMPUTACION
12708782;;M;48;CHILENO;;X;TEMUCO                        ;ARAUCANIA;316790;3;2;0;0;0;3;2;316790;TAB Galaxy A7 Lite (8.7, 32GB, WIFI + 4G);COMPUTACION
20133276;;M;23;CHILENO;;Z;LOS ANDES                     ;VALPARAISO;356140;2;1;0;0;0;2;1;356140;NTBK 15-ef1015la Ryzen 3-4300U/4GB/256GBSSD/15P;COMPUTACION
20277452;;F;22;CHILENO;;Z;PROVIDENCIA                   ;METROPOLITANA;434980;2;1;2;1;434980;0;0;0;TAB Galaxy S7 FE (12.4, 128GB WIFI) SILVER;COMPUTACION
26504195;;M;48;PERUANO;;Extranjero;N/D;N/D;419950;5;3;0;0;0;5;3;419950;Multifuncional EcoTank L3210;COMPUTACION
13768716;;F;41;CHILENO;;X;PUENTE ALTO                   ;METROPOLITANA;149990;1;1;0;0;0;1;1;149990;Multifuncional EcoTank L3210;COMPUTACION
18100496;;F;30;CHILENO;;Millenial;LOS ANGELES                   ;BIO BIO;22990;1;1;1;1;22990;0;0;0;TONER NEGRO TN1060;COMPUTACION
16927179;;M;34;CHILENO;;Millenial;TOCOPILLA                     ;ANTOFAGASTA;149990;1;1;0;0;0;1;1;149990;Multifuncional EcoTank L3210;COMPUTACION
4856639;;F;76;CHILENO;;Silencioso;LO ESPEJO                     ;METROPOLITANA;953120;9;4;0;0;0;9;4;953120;NTBK IP3i Celeron N4020/4G/500GB/14P/Rojo;COMPUTACION
11811670;Casado;M;52;CHILENO;;X;"";"";99990;1;1;0;0;0;1;1;99990;TAB Galaxy A7 Lite (8.7, 32GB, WIFI);COMPUTACION
18921017;Soltero;F;27;CHILENO;TECNICO DE NIVEL MEDIO EN ALIMENTACION;Millenial;PROVIDENCIA                   ;METROPOLITANA;99990;1;1;0;0;0;1;1;99990;TAB Galaxy A7 Lite (8.7, 32GB, WIFI);COMPUTACION
17280766;;F;32;CHILENO;;Millenial;TALCA;MAULE;169990;1;1;1;1;169990;0;0;0;NTBK D330 Celeron N4020/4GB/64GB/10P+OfficeHS;COMPUTACION
8524075;;F;49;CHILENO;;X;NATALES                       ;MAGALLANES;99990;1;1;1;1;99990;0;0;0;TAB Galaxy A7 Lite (8.7, 32GB, WIFI);COMPUTACION
19458262;Soltero;M;25;CHILENO;;Silencioso;PROVIDENCIA                   ;METROPOLITANA;191980;2;1;2;1;191980;0;0;0;NTBK 15-dw1080la Celeron N4020/4GB/1TB/15P;COMPUTACION
13993267;;M;43;CHILENO;;X;RENCA                         ;METROPOLITANA;204980;2;1;2;1;204980;0;0;0;Multifuncional DCPT720DW Wifi, Duplex y ADF;COMPUTACION
15045148;;M;37;CHILENO;;Millenial;COQUIMBO                      ;COQUIMBO;289990;1;1;0;0;0;1;1;289990;NTBK 15-ef1015la Ryzen 3-4300U/4GB/256GBSSD/15P;COMPUTACION
14312375;;F;47;CHILENO;;X;MELIPILLA                     ;METROPOLITANA;159990;1;1;1;1;159990;0;0;0;Multifuncional EcoTank L3210;COMPUTACION
18535628;;M;28;CHILENO;;Millenial;N/D;N/D;149990;1;1;0;0;0;1;1;149990;Multifuncional DCPT520W Wifi;COMPUTACION
12530825;;M;49;CHILENO;;X;LOTA                          ;BIO BIO;192730;2;1;0;0;0;2;1;192730;Multifuncional EcoTank L3210;COMPUTACION
8537178;;M;49;CHILENO;;X;MAIPU;METROPOLITANA;344980;2;2;2;2;344980;0;0;0;Multifuncional EcoTank L3250 Wifi;COMPUTACION
26058957;;M;37;VENEZOLANO;;Extranjero;PROVIDENCIA                   ;METROPOLITANA;178980;2;1;2;1;178980;0;0;0;Multifuncional EcoTank L3250 Wifi;COMPUTACION
18409886;;M;29;CHILENO;;Millenial;LOS ALAMOS;BIO-BIO;179990;1;1;0;0;0;1;1;179990;NTBK 15-dw1080la Celeron N4020/4GB/1TB/15P;COMPUTACION
17849830;;F;33;CHILENO;;Millenial;MAULE;MAULE;179992;1;2;1;1;179990;0;1;2;NTBK 15-dw1080la Celeron N4020/4GB/1TB/15P;COMPUTACION
22054047;;F;42;PERUANO;;Extranjero;ESTACION CENTRAL              ;METROPOLITANA;403980;2;1;0;0;0;2;1;403980;TAB Galaxy S7 FE (12.4, 64GB WIFI) SILVER;COMPUTACION
8865920;;M;62;CHILENO;;Z;PROVIDENCIA                   ;METROPOLITANA;119990;1;3;0;0;0;1;3;119990;TAB Galaxy A7 Lite (8.7, 32GB, WIFI + 4G);COMPUTACION
4916847;;F;71;CHILENO;;Silencioso;PROVIDENCIA                   ;METROPOLITANA;186980;2;1;2;1;186980;0;0;0;NTBK 15-dw1080la Celeron N4020/4GB/1TB/15P;COMPUTACION
12049909;;F;43;CHILENO;;X;TALCA                         ;MAULE;159990;1;1;0;0;0;1;1;159990;Multifuncional EcoTank L3210;COMPUTACION
21190084;Soltero;F;47;URUGUAYO;MEDICO CIRUJANO;Extranjero;PROVIDENCIA                   ;METROPOLITANA;732980;2;1;0;0;0;2;1;732980;NTBK Aspire 5 R5-3500U/12GB/256SSD GB/15P FHD;COMPUTACION
16993051;Soltero;M;32;CHILENO;;Millenial;BULNES                        ;BIO BIO;419990;1;1;0;0;0;1;1;419990;NTBK 14-dq2025la Ci3-1115G4/4GB/256GB+16GB/14P;COMPUTACION
15787915;;F;38;CHILENO;;Millenial;PIRQUE                        ;METROPOLITANA;183980;2;1;0;0;0;2;1;183980;Multifuncional EcoTank L3250 Wifi;COMPUTACION
14471497;;F;50;SALVADOREÃO;;Extranjero;N/D;N/D;209970;3;1;0;0;0;3;1;209970;TAB Matepad T10S 3GB 64GB 10P;COMPUTACION
10444065;;F;54;CHILENO;;Boomers;AISEN                         ;AYSEN;284980;2;1;0;0;0;2;1;284980;NTBK IP Chromebook Octacore/4GB/128GB/10P FHD;COMPUTACION
5827529;;M;74;CHILENO;;Silencioso;LA SERENA                     ;COQUIMBO;532970;3;2;0;0;0;3;2;532970;Multifuncional EcoTank L3210;COMPUTACION
18702577;;F;28;CHILENO;;Millenial;CASTRO                        ;LOS LAGOS;509950;5;3;0;0;0;5;3;509950;NTBK HT14 Celeron N4020 4GB/128GB SSD/14P;COMPUTACION
14287850;;F;48;CHILENO;;X;LEBU                          ;BIO BIO;251980;2;1;0;0;0;2;1;251980;Galaxy Tab A8 (10.5, 32GB, WIFI) Gray;COMPUTACION
16551546;;F;35;CHILENO;;Millenial;FRESIA                        ;LOS LAGOS;304970;3;2;1;1;169990;2;1;134980;TAB Galaxy A7 Lite (8.7, 32GB, WIFI);COMPUTACION
8797489;;F;64;CHILENO;;Boomers;TRAIGUEN                      ;ARAUCANIA;144990;1;1;0;0;0;1;1;144990;Multifuncional EcoTank L3210;COMPUTACION
17519996;;F;31;CHILENO;;Millenial;PROVIDENCIA                   ;METROPOLITANA;159990;1;1;0;0;0;1;1;159990;Multifuncional EcoTank L3210;COMPUTACION
6921029;;F;69;CHILENO;;Silencioso;SAN BERNARDO                  ;METROPOLITANA;1693861;17;6;0;0;0;17;6;1693861;TAB Galaxy A7 Lite (8.7, 32GB, WIFI + 4G);COMPUTACION
18643757;Soltero;F;28;CHILENO;TECNICO DE NIVEL SUPERIOR EN ENFERMERIA;Millenial;PROVIDENCIA                   ;METROPOLITANA;286970;3;2;3;2;286970;0;0;0;NTBK D330 Celeron N4020/4GB/64GB/10P+OfficeHS;COMPUTACION
18738376;;M;28;CHILENO;;Millenial;IQUIQUE                       ;TARAPACA;46980;2;1;2;1;46980;0;0;0;TAB 7 MB4 Plus 4Core 1GB 16GB 7 Negra;COMPUTACION
15490668;;F;39;CHILENO;;X;PUNTA ARENAS                  ;MAGALLANES;570930;7;2;2;1;296980;5;1;273950;NTBK 15-dw1080la Celeron N4020/4GB/1TB/15P;COMPUTACION
18721061;;F;27;CHILENO;;Millenial;TEODORO SCHMIDT               ;ARAUCANIA;433980;2;1;2;1;433980;0;0;0;TAB Galaxy S7 FE (12.4, 128GB WIFI) SILVER;COMPUTACION
8205149;;F;64;CHILENO;;Boomers;CAUQUENES                     ;MAULE;160470;3;2;3;2;160470;0;0;0;TAB MLAB MBX 8 QUAD CORE 1G+16G 8716;COMPUTACION
18845936;;M;27;CHILENO;;Millenial;PUENTE ALTO;METROPOLITANA;149990;1;1;0;0;0;1;1;149990;Multifuncional EcoTank L3210;COMPUTACION
16119013;;F;36;CHILENO;;Millenial;VICTORIA                      ;ARAUCANIA;717940;7;4;0;0;0;7;4;717940;NTBK IP1 AMD 3020e/4GB/64GB eMMC/14P;COMPUTACION
12005531;;F;53;CHILENO;;X;PROVIDENCIA                   ;METROPOLITANA;203980;2;1;0;0;0;2;1;203980;Multifuncional Smart tank 530 WiFi ADF;COMPUTACION
8053862;;M;60;CHILENO;;Boomers;HIJUELAS                      ;VALPARAISO;836970;3;2;3;2;836970;0;0;0;AIO 3 Ryzen5 4500u 8G-1T+128SSD 24IN FHD;COMPUTACION
11410960;;F;52;CHILENO;;X;VILLARICA                     ;ARAUCANIA;529990;1;1;0;0;0;1;1;529990;NTBK M!4 Core i3-10110U/8GB/256GB SSD/14P FHD;COMPUTACION
18235549;;M;29;CHILENO;;Millenial;PROVIDENCIA                   ;METROPOLITANA;440480;2;1;2;1;440480;0;0;0;TAB Galaxy S7 FE (12.4, 128GB WIFI) LIGHT PINK;COMPUTACION
12060132;;F;59;CHILENO;;Boomers;MARCHIHUE                     ;L.G.B.OÂ´HIGGINS;521980;2;1;0;0;0;2;1;521980;NTBK 255 G8 Ryzen 5-5500U/8GB/256GB SSD/15P;COMPUTACION
7277644;;M;66;CHILENO;;Boomers;OVALLE                        ;COQUIMBO;251990;3;1;0;0;0;3;1;251990;NTBK IP S145 AMD A4-9125/4GB/500GB/14P;COMPUTACION
11932116;;M;50;CHILENO;;X;PROVIDENCIA                   ;METROPOLITANA;179990;1;1;0;0;0;1;1;179990;NTBK 15-dw1080la Celeron N4020/4GB/1TB/15P;COMPUTACION
14106918;;F;41;CHILENO;;X;LOS ANGELES                   ;BIO BIO;433980;2;1;2;1;433980;0;0;0;TAB Galaxy S7+ FE 4G (12.4, 64GB WIFI + 4G);COMPUTACION
17933824;;M;30;CHILENO;;Millenial;NEGRETE                       ;BIO BIO;335970;4;2;2;1;225980;2;1;109990;NTBK IP1 AMD 3020e/4GB/64GB eMMC/14P;COMPUTACION
18900853;;F;27;CHILENO;;Z;LA LIGUA                      ;VALPARAISO;129980;2;2;2;2;129980;0;0;0;TAB Galaxy A7 Lite (8.7, 32GB, WIFI);COMPUTACION
6823873;;M;66;CHILENO;;Boomers;RANQUIL                       ;BIO BIO;499990;1;1;0;0;0;1;1;499990;NTBK 14-dy0501laCi3-1125G4/8GB/256SSD/FHD/Pen;COMPUTACION
7929825;;M;62;CHILENO;;Boomers;SAN ANTONIO                   ;VALPARAISO;159990;1;1;0;0;0;1;1;159990;Multifuncional EcoTank L3210;COMPUTACION
20156998;;F;23;CHILENO;;Z;PUENTE ALTO;METROPOLITANA;444980;2;2;1;1;44990;1;1;399990;NTBK 14-dy0501laCi3-1125G4/8GB/256SSD/FHD/Pen;COMPUTACION
16618744;;M;34;CHILENO;;Millenial;"";"";79990;1;3;2;1;58980;-1;2;21010;TAB M8 QC 2GB 32GB 8P Gris;COMPUTACION
26676726;;F;31;VENEZOLANO;;Extranjero;"";"";272230;3;1;0;0;0;3;1;272230;NTBK HT14 Celeron N4020 4GB/128GB SSD/14P;COMPUTACION
9042322;;M;62;CHILENO;;Boomers;PROVIDENCIA                   ;METROPOLITANA;369990;3;3;0;0;0;3;3;369990;NTBK 240 G8 Celeron N4020/4GB/500GB/14P;COMPUTACION
8810814;;F;58;CHILENO;;Boomers;N/D;N/D;414970;3;2;0;0;0;3;2;414970;NTBK IP1 AMD 3020e/4GB/64GB eMMC/14P;COMPUTACION
26391300;;M;29;VENEZOLANO;;Extranjero;N/D;N/D;357950;5;3;0;0;0;5;3;357950;NTBK HT14 Celeron N4020 4GB/128GB SSD/14P;COMPUTACION
17789872;;F;32;CHILENO;;Silencioso;PROVIDENCIA                   ;METROPOLITANA;114980;2;1;2;1;114980;0;0;0;IMPRESORA EPSON L120;COMPUTACION
13750578;;F;42;CHILENO;;X;CANELA                        ;COQUIMBO;392560;3;2;0;0;0;3;2;392560;Multifuncional DCPT220;COMPUTACION
11079560;;F;56;CHILENO;;Boomers;N/D;N/D;1744050;14;2;0;0;0;14;2;1744050;NTBK Aspire 5 R5-3500U/12GB/256SSD GB/15P FHD;COMPUTACION
8630982;;M;61;CHILENO;;Boomers;NATALES                       ;MAGALLANES;279990;3;3;0;0;0;3;3;279990;NTBK 240 G8 Celeron N4020/4GB/500GB/14P;COMPUTACION
17635894;;F;31;CHILENO;;Millenial;N/D;N/D;189990;1;1;0;0;0;1;1;189990;NTBK IP S145 AMD A4-9125/4GB/500GB/14P;COMPUTACION
7820398;;F;66;CHILENO;;Boomers;LA LIGUA                      ;VALPARAISO;484970;3;2;0;0;0;3;2;484970;NTBK 240 G8 Core i3-1005G1/4GB/1TB/14P;COMPUTACION
14100243;;M;41;CHILENO;;X;N/D;N/D;349990;1;1;1;1;349990;0;0;0;NTBK 14-dy0501laCi3-1125G4/8GB/256SSD/FHD/Pen;COMPUTACION
13807010;Soltero;M;46;CHILENO;INGENIERO COMERCIAL;X;RENCA                         ;METROPOLITANA;893940;6;2;6;2;893940;0;0;0;NTBK IP3i Celeron N4020/4G/500GB/14P/Rojo;COMPUTACION
17234414;;F;34;CHILENO;;Millenial;COCHRANE                      ;AYSEN;139990;1;1;0;0;0;1;1;139990;TAB Galaxy A7 Lite (8.7, 32GB, WIFI);COMPUTACION
17274304;;F;33;CHILENO;;Millenial;QUILPUE                       ;VALPARAISO;533800;9;6;4;2;205350;5;4;328450;TAB MLAB MBX 8 QUAD CORE 1G+16G 8716;COMPUTACION
17684647;;M;32;CHILENO;;Millenial;CHANCO                        ;MAULE;229980;2;2;0;0;0;2;2;229980;Multifuncional DeskJet Ink Advantage 2752 Wifi;COMPUTACION
6639783;;M;70;CHILENO;;Silencioso;PROVIDENCIA                   ;METROPOLITANA;471980;2;1;0;0;0;2;1;471980;NTBK IP3 Ryzen 3-3250U/8GB/1TB/15P;COMPUTACION
26621370;;M;33;VENEZOLANO;;Extranjero;OSORNO                        ;LOS LAGOS;209990;1;1;0;0;0;1;1;209990;NTBK IP1 AMD 3020e/4GB/64GB eMMC/14P;COMPUTACION
20321759;;F;22;CHILENO;;Millenial;"";"";226470;3;2;0;0;0;3;2;226470;Multifuncional EcoTank L3210;COMPUTACION
20643255;;M;21;CHILENO;;Z;PROVIDENCIA                   ;METROPOLITANA;405840;2;1;2;1;405840;0;0;0;TABLET MatePad Pro 10.8 + M-Pencil;COMPUTACION
17541445;;F;31;CHILENO;;Millenial;N/D;N/D;513970;3;3;0;0;0;3;3;513970;NTBK Aspire 3 Athlon 3020e/8GB/256GB SSD/14P;COMPUTACION
13965519;;M;41;CHILENO;;X;PROVIDENCIA                   ;METROPOLITANA;103530;3;2;3;2;103530;0;0;0;TAB MLAB MBX 8 QUAD CORE 1G+16G 8716;COMPUTACION
25400028;;F;35;CHILENO;;Extranjero;RANCAGUA                      ;L.G.B.OÂ´HIGGINS;114980;2;3;0;0;0;2;3;114980;TAB M8 QC 2GB 32GB 8P Gris;COMPUTACION
19265379;;F;25;CHILENO;;Millenial;"";"";309980;3;4;3;4;309980;0;0;0;NTBK IP3 Core i3-1115G4/4GB/512GB SSD/14P FHD;COMPUTACION
18127126;;F;30;CHILENO;;Millenial;N/D;N/D;138970;3;2;3;2;138970;0;0;0;Tab M7 1G-16GB 7 IPS HD LTE/4G;COMPUTACION
19865128;;F;24;CHILENO;;Z;SANTA CRUZ                    ;L.G.B.OÂ´HIGGINS;234980;2;2;0;0;0;2;2;234980;NTBK 240 G8 Celeron N4020/4GB/500GB/14P;COMPUTACION
14525384;;F;48;CHILENO;;X;RENCA                         ;METROPOLITANA;203980;2;1;2;1;203980;0;0;0;NTBK IP3i Celeron N4020/4G/500GB/14P/Rojo;COMPUTACION
25983001;;M;41;EXTRANJERO - NO INFORMA NACIONALIDAD;;Extranjero;"";"";316550;4;3;0;0;0;4;3;316550;BUNDLE TAB P11 6GB 128SSD Slate Grey;COMPUTACION
12400579;;M;49;CHILENO;;X;LA FLORIDA                    ;METROPOLITANA;469970;3;3;3;3;469970;0;0;0;TAB Galaxy A7 Lite (8.7, 32GB, WIFI);COMPUTACION
7207631;;F;67;CHILENO;;Boomers;PROVIDENCIA                   ;METROPOLITANA;59990;1;1;0;0;0;1;1;59990;Multifuncional DeskJet Ink Advantage 3775 Wifi;COMPUTACION
11518761;;M;52;CHILENO;;X;HIJUELAS                      ;VALPARAISO;427530;6;2;0;0;0;6;2;427530;TAB M8 QC 2GB 32GB 8P Gris;COMPUTACION
14008052;Soltero;F;40;CHILENO;;X;RENCA                         ;METROPOLITANA;59990;1;1;0;0;0;1;1;59990;TAB GAMER 7 QUAD CORE 2G+16G 8715;COMPUTACION
6508887;;M;71;CHILENO;;Silencioso;RENCA                         ;METROPOLITANA;199990;1;1;0;0;0;1;1;199990;NTBK 240 G8 Celeron N4020/4GB/500GB/14P;COMPUTACION
12367877;Casado;F;49;CHILENO;;X;LAS CABRAS                    ;L.G.B.OÂ´HIGGINS;300000;2;1;0;0;0;2;1;300000;NTBK 240 G8 Celeron N4020/4GB/500GB/14P;COMPUTACION
19377582;;M;25;CHILENO;;Z;"";"";192350;4;2;0;0;0;4;2;192350;TAB MLAB MBX 8 QUAD CORE 1G+16G 8716;COMPUTACION
16178499;;F;36;CHILENO;;Millenial;RENCA                         ;METROPOLITANA;219990;1;1;1;1;219990;0;0;0;NTBK D330 Celeron N4020/4GB/64GB/10P+OfficeHS;COMPUTACION
23714273;;F;52;DOMINICANO;;Extranjero;TALAGANTE                     ;METROPOLITANA;359990;1;1;0;0;0;1;1;359990;NTBK Aspire 3 Athlon 3020e/8GB/256GB SSD/14P;COMPUTACION
11784457;Soltero;M;51;CHILENO;;X;RENCA                         ;METROPOLITANA;113990;1;1;0;0;0;1;1;113990;TAB Galaxy Tab A 8 4G 4Core 2GB 32GB 8 Gris;COMPUTACION
13030478;;M;46;CHILENO;;X;PUENTE ALTO                   ;METROPOLITANA;337960;4;2;4;2;337960;0;0;0;NTBK IP Chromebook Octacore/4GB/128GB/10P FHD;COMPUTACION
15940407;;M;37;CHILENO;;Millenial;ALTO HOSPICIO;TARAPACA;449990;1;1;0;0;0;1;1;449990;NTBK 14-dy0501laCi3-1125G4/8GB/256SSD/FHD/Pen;COMPUTACION
16951087;;M;34;CHILENO;;Millenial;PUDAHUEL                      ;METROPOLITANA;173980;2;1;2;1;173980;0;0;0;MONITOR LC27F390FHLXZS 1920X1080 CURVO;COMPUTACION
9972001;Casado;M;57;CHILENO;;Boomers;RENGO                         ;L.G.B.OÂ´HIGGINS;84990;1;1;0;0;0;1;1;84990;TAB M8 QC 2GB 32GB 8P Gris;COMPUTACION
6908024;;F;79;CHILENO;;Silencioso;PARRAL                        ;MAULE;144980;2;1;0;0;0;2;1;144980;TAB M8 4G QC 2GB 16GB 8P Gris;COMPUTACION
27067933;;M;34;EXTRANJERO - NO INFORMA NACIONALIDAD;;Extranjero;INDEPENDENCIA                 ;METROPOLITANA;203980;2;1;2;1;203980;0;0;0;NTBK IP Chromebook Octacore/4GB/128GB/10P FHD;COMPUTACION
15412442;;F;40;CHILENO;;X;RENCA                         ;METROPOLITANA;664970;3;1;0;0;0;3;1;664970;TAB S6 Lite (610) 4GB 64GB 10.4P DARK GREY;COMPUTACION
20310682;;F;22;CHILENO;;Z;N/D;N/D;171970;3;2;0;0;0;3;2;171970;Tablet HMS Matepad T10;COMPUTACION
9983411;;M;54;CHILENO;;X;"";"";300980;2;1;0;0;0;2;1;300980;NTBK IP3i Celeron N4020/4G/500GB/14P/Rojo;COMPUTACION
12156597;;M;52;CHILENO;;X;RENCA                         ;METROPOLITANA;529990;1;1;0;0;0;1;1;529990;NTBK M14 Ryzen 5-5500U 8GB/256GB SSD/14P FHD;COMPUTACION
22083380;;M;48;CUBANO;;Extranjero;N/D;N/D;505080;4;2;4;2;505080;0;0;0;NTBK 240 G8 Celeron N4020/4GB/500GB/14P;COMPUTACION
11729327;;M;51;CHILENO;;X;RENCA                         ;METROPOLITANA;124990;1;1;0;0;0;1;1;124990;TAB Galaxy Tab A+SPen 8Core 3GB 32GB 8 Gris;COMPUTACION
5425307;;F;78;CHILENO;;Silencioso;N/D;N/D;255840;5;3;4;2;207960;1;1;47880;Matepad T10S WIFI 2+32 GB;COMPUTACION
18891282;;M;28;CHILENO;;Millenial;TALCA                         ;MAULE;499990;1;1;0;0;0;1;1;499990;NTBK M14 Ryzen 5-5500U 8GB/256GB SSD/14P FHD;COMPUTACION
18342909;;F;30;CHILENO;;Millenial;N/D;N/D;199990;1;1;1;1;199990;0;0;0;NTBK 240 G8 Celeron N4020/4GB/500GB/14P;COMPUTACION
25477585;;M;41;COLOMBIANO;;Extranjero;LO PRADO                      ;METROPOLITANA;2088020;12;2;0;0;0;12;2;2088020;NTBK 240 G8 Celeron N4020/4GB/500GB/14P;COMPUTACION
23094957;;M;45;PERUANO;;Extranjero;INDEPENDENCIA                 ;METROPOLITANA;322970;3;1;0;0;0;3;1;322970;NTBK 14-cf2097la Pentium Gold 6405U/8GB/256GB/14;COMPUTACION
17458284;;F;32;CHILENO;;Millenial;"";"";199990;1;1;1;1;199990;0;0;0;NTBK IP3i Celeron N4020/4G/500GB/14P/Rojo;COMPUTACION
12347960;;F;49;CHILENO;;X;CALAMA                        ;ANTOFAGASTA;299990;1;1;0;0;0;1;1;299990;NTBK Herobook Celeron N4020/8GB/256SSD/14P FHD;COMPUTACION
19374543;Soltero;M;26;CHILENO;;Z;PROVIDENCIA                   ;METROPOLITANA;603980;2;1;2;1;603980;0;0;0;NTBK M14 Core i5-1155G7/8GB/256GB SSD/14P FHD;COMPUTACION
15885395;;F;37;CHILENO;;Millenial;PROVIDENCIA                   ;METROPOLITANA;335970;3;1;0;0;0;3;1;335970;Monitor Emerald 27P 165Hz Full HD;COMPUTACION
18261243;;F;30;CHILENO;;Millenial;"";"";84990;1;3;0;0;0;1;3;84990;TAB M8 QC 2GB 32GB 8P Gris;COMPUTACION
13142264;;F;45;CHILENO;;X;LAJA                          ;BIO BIO;129990;1;1;0;0;0;1;1;129990;TAB Galaxy A7 Lite (8.7, 32GB, WIFI + 4G);COMPUTACION
8449448;;F;65;CHILENO;;Boomers;RENCA                         ;METROPOLITANA;126980;2;1;2;1;126980;0;0;0;TAB Galaxy A7 Lite (8.7, 64GB, WIFI);COMPUTACION
18313536;;F;29;CHILENO;;Millenial;"";"";243980;2;1;0;0;0;2;1;243980;Galaxy Tab A7 (10.4 ,32GB, WIFI) Dark Gray;COMPUTACION
8297645;;F;63;CHILENO;;Boomers;ANCUD                         ;LOS LAGOS;146970;3;1;0;0;0;3;1;146970;TAB M8 QC 2GB 32GB 8P Gris;COMPUTACION
13221941;;F;45;CHILENO;;X;COPIAPO                       ;ATACAMA;282960;4;3;0;0;0;4;3;282960;NTBK 240 G8 Celeron N4020/4GB/500GB/14P;COMPUTACION
6106401;;F;68;CHILENO;;Boomers;VINA DEL MAR                  ;VALPARAISO;59980;2;1;0;0;0;2;1;59980;TAB MLAB 7 MB4 PLUS 3G 1+16GB WHITE 8762;COMPUTACION
16385070;Casado;F;35;CHILENO;;Millenial;PROVIDENCIA                   ;METROPOLITANA;38980;2;1;2;1;38980;0;0;0;TABLET MLAB 7 MB4 PLUS 1+16GB RED;COMPUTACION
8261388;;F;65;CHILENO;;Boomers;TALCAHUANO                    ;BIO BIO;360240;2;1;0;0;0;2;1;360240;NTBK Aspire 3 Athlon 3020e/8GB/256GB SSD/14P;COMPUTACION
6169130;;M;74;CHILENO;;Silencioso;VALLENAR;ATACAMA;274970;3;2;0;0;0;3;2;274970;Tab M10 HD 2G-32GB 10.1 Iron grey WiFi;COMPUTACION
8823924;;F;53;CHILENO;;X;RENCA                         ;METROPOLITANA;482460;3;2;0;0;0;3;2;482460;TAB Galaxy A7 Lite (8.7, 32GB, WIFI);COMPUTACION
17830351;;F;31;CHILENO;;Millenial;N/D;N/D;699980;2;1;0;0;0;2;1;699980;NTBK IP3 Ryzen 3-3250U/8GB/1TB/15P;COMPUTACION
12091678;;F;54;CHILENO;;X;PEUMO                         ;L.G.B.OÂ´HIGGINS;194980;2;2;0;0;0;2;2;194980;Multifuncional Ink Tank 415 Wifi;COMPUTACION
17059353;;F;33;CHILENO;;Millenial;PROVIDENCIA                   ;METROPOLITANA;0;0;2;0;2;0;0;0;0;TAB Galaxy A7 Lite (8.7, 32GB, WIFI);COMPUTACION
20463853;;M;21;CHILENO;;Z;SAN FERNANDO                  ;L.G.B.OÂ´HIGGINS;10280;0;2;0;0;0;0;2;10280;TAB Matepad 10.4;COMPUTACION
25978352;;M;35;VENEZOLANO;;Extranjero;SANTIAGO                      ;METROPOLITANA;89990;2;1;2;1;89990;0;0;0;TAB Galaxy A7 Lite (8.7, 32GB, WIFI);COMPUTACION
12110403;;F;48;CHILENO;;X;LA PINTANA                    ;METROPOLITANA;149990;1;1;0;0;0;1;1;149990;TAB Galaxy A7 Lite (8.7, 32GB, WIFI + 4G);COMPUTACION
13621286;;F;43;CHILENO;;X;PROVIDENCIA                   ;METROPOLITANA;165570;2;1;0;0;0;2;1;165570;Multifuncional DCPT220;COMPUTACION
13282585;;F;44;CHILENO;;X;EL BOSQUE                     ;METROPOLITANA;467070;2;1;0;0;0;2;1;467070;AIO/Athlon 3050U/4GB/1TB + 256GB/UMA/White;COMPUTACION
18959924;Soltero;F;27;CHILENO;TECNICO DE NIVEL SUPERIOR EN ENFERMERIA;Millenial;PROVIDENCIA                   ;METROPOLITANA;223980;2;1;2;1;223980;0;0;0;MULTIFUNCIONAL ECOTANK L5190 Wifi/ Fax;COMPUTACION
17434279;;F;32;CHILENO;;Millenial;PROVIDENCIA                   ;METROPOLITANA;99990;1;1;0;0;0;1;1;99990;Tab M10 HD 2G-32GB 10.1 Iron grey WiFi;COMPUTACION
8920699;;M;60;CHILENO;;Boomers;RENCA                         ;METROPOLITANA;306980;2;1;2;1;306980;0;0;0;NTBK 240 G8 Core i3-1005G1/4GB/1TB/14P;COMPUTACION
5011547;Soltero;F;71;CHILENO;ABOGADO;Silencioso;PROVIDENCIA                   ;METROPOLITANA;64990;1;1;0;0;0;1;1;64990;Multifuncional DeskJet Ink Advantage 3775 Wifi;COMPUTACION
13368641;;M;44;CHILENO;;X;SAN ANTONIO                   ;VALPARAISO;99990;1;1;0;0;0;1;1;99990;TAB Galaxy A7 Lite (8.7, 32GB, WIFI);COMPUTACION
19782587;;F;24;CHILENO;;Millenial;PROVIDENCIA                   ;METROPOLITANA;202990;4;3;4;3;202990;0;0;0;TAB Galaxy A7 Lite (8.7, 32GB, WIFI);COMPUTACION
19049305;Soltero;F;26;CHILENO;;Z;N/D;N/D;469930;7;3;2;1;184980;5;2;284950;Multifuncional DCPT220;COMPUTACION
25618532;;M;55;VENEZOLANO;;Extranjero;PROVIDENCIA                   ;METROPOLITANA;337960;4;2;4;2;337960;0;0;0;TAB Galaxy A7 Lite (8.7, 32GB, WIFI);COMPUTACION
16454857;;F;35;CHILENO;;Millenial;RENCA                         ;METROPOLITANA;119980;2;1;2;1;119980;0;0;0;TAB MLAB MBX 8 QUAD CORE 1G+16G 8716;COMPUTACION
16401637;Soltero;F;37;CHILENO;INGENIERO AGRICOLA;Millenial;PROVIDENCIA                   ;METROPOLITANA;59990;1;1;1;1;59990;0;0;0;Multifuncional DeskJet Ink Advantage 3775 Wifi;COMPUTACION
10826283;;F;52;CHILENO;;X;N/D;N/D;619980;4;2;4;2;619980;0;0;0;NTBK IP3i Celeron N4020/4G/500GB/14P/Rojo;COMPUTACION
13765060;;M;42;CHILENO;;X;N/D;N/D;215330;6;1;0;0;0;6;1;215330;TAB MLAB MBX 8 QUAD CORE 1G+16G 8716;COMPUTACION
23748236;;F;42;PERUANO;;Extranjero;N/D;N/D;554170;2;1;0;0;0;2;1;554170;NTBK 255 G8 Ryzen 5-5500U/8GB/256GB SSD/15P;COMPUTACION
26352230;;M;31;VENEZOLANO;;Extranjero;LA SERENA                     ;COQUIMBO;499990;2;1;2;1;499990;0;0;0;NTBK 14-dy0501laCi3-1125G4/8GB/256SSD/FHD/Pen;COMPUTACION
13979386;Soltero;F;41;CHILENO;;X;PROVIDENCIA                   ;METROPOLITANA;524980;2;1;2;1;524980;0;0;0;TAB Galaxy S7 FE (12.4, 128GB WIFI) LIGHT PINK;COMPUTACION
10866460;;M;53;CHILENO;;X;RENCA                         ;METROPOLITANA;455480;2;1;2;1;455480;0;0;0;NTBK CoreBook X i5-8259U/ 8GB/ 512GB SSD/ 14/ W1;COMPUTACION
11341837;;F;54;CHILENO;;Silencioso;PROVIDENCIA                   ;METROPOLITANA;629990;1;1;1;1;629990;0;0;0;NTBK Gaming 3 Ryzen 5 4600H 8GB 512SSD G1650 4GB;COMPUTACION
15875070;;F;38;CHILENO;;Millenial;COIHAIQUE                     ;AYSEN;486980;2;1;2;1;486980;0;0;0;NTBK D14 Core i3-10110U/8GB/256SSD/14P FHD;COMPUTACION
9719916;;F;58;CHILENO;;Boomers;LA LIGUA                      ;VALPARAISO;634980;2;1;2;1;634980;0;0;0;NTBK Gaming 3 Ryzen 5 4600H 8GB 512SSD G1650 4GB;COMPUTACION
8846509;;F;66;CHILENO;;Boomers;PROVIDENCIA                   ;METROPOLITANA;165220;2;1;0;0;0;2;1;165220;Galaxy Tab A7 (10.4 ,32GB, WIFI) Dark Gray;COMPUTACION
19351889;;M;25;CHILENO;;Z;N/D;N/D;299990;1;1;1;1;299990;0;0;0;NTBK IP3 Athlon 3050U/8GB/1TB/14P;COMPUTACION
16912271;;F;33;CHILENO;;Millenial;MAIPU;METROPOLITANA;229990;2;1;2;1;229990;0;0;0;NTBK 240 G8 Celeron N4020/4GB/500GB/14P;COMPUTACION
9978365;;M;42;CHILENO;;Silencioso;PROVIDENCIA                   ;METROPOLITANA;133980;2;1;2;1;133980;0;0;0;Galaxy Tab A7 (10.4 ,32GB, WIFI) Silver;COMPUTACION
5315045;Divorciado;F;72;CHILENO;TECNICO JURIDICO;Silencioso;RENCA                         ;METROPOLITANA;89990;2;1;2;1;89990;0;0;0;TAB Galaxy A7 Lite (8.7, 32GB, WIFI);COMPUTACION
14196569;;M;41;CHILENO;;Silencioso;PROVIDENCIA                   ;METROPOLITANA;53980;2;1;2;1;53980;0;0;0;Router Huawei AX3 WIFI Quad core;COMPUTACION
26962820;;M;31;VENEZOLANO;;Extranjero;LINARES                       ;MAULE;89990;1;1;0;0;0;1;1;89990;Tab M10 HD 2G-32GB 10.1 Iron grey WiFi;COMPUTACION
9367520;;M;58;CHILENO;;Boomers;RENCA                         ;METROPOLITANA;654980;2;1;2;1;654980;0;0;0;NTBK 2en1 Ci5-1135G7/8GB/256GB SSD/13P FHD TOUCH;COMPUTACION
19918870;;F;23;CHILENO;;Z;SAN BERNARDO;METROPOLITANA;153980;2;1;2;1;153980;0;0;0;Multifuncional DCPT720DW Wifi, Duplex y ADF;COMPUTACION
15604097;;F;38;CHILENO;;X;PROVIDENCIA                   ;METROPOLITANA;249990;1;1;1;1;249990;0;0;0;NTBK IP1 AMD 3020e/4GB/64GB eMMC/14P;COMPUTACION
18870757;;M;27;CHILENO;;Silencioso;PROVIDENCIA                   ;METROPOLITANA;633980;2;1;2;1;633980;0;0;0;NTBK Gaming 3 Ryzen 5 4600H 8GB 512SSD G1650 4GB;COMPUTACION
13607987;;M;43;CHILENO;;X;LONCOCHE                      ;ARAUCANIA;379360;2;1;0;0;0;2;1;379360;NTBK Herobook Celeron N4020/8GB/256SSD/14P FHD;COMPUTACION
18542263;;M;29;CHILENO;;Millenial;PROVIDENCIA                   ;METROPOLITANA;145840;3;1;3;1;145840;0;0;0;Multifuncional DCPT520W Wifi;COMPUTACION
16938030;;M;34;CHILENO;;Silencioso;PROVIDENCIA                   ;METROPOLITANA;483980;2;1;2;1;483980;0;0;0;NTBK CoreBook X i5-8259U/ 8GB/ 512GB SSD/ 14/ W1;COMPUTACION
17943456;;F;30;CHILENO;;Millenial;PROVIDENCIA                   ;METROPOLITANA;267960;3;1;3;1;267960;0;0;0;Galaxy Tab A7 (10.4 ,32GB, WIFI) Dark Gray;COMPUTACION
19929016;;M;24;CHILENO;;Z;REQUINOA                      ;L.G.B.OÂ´HIGGINS;79990;1;1;1;1;79990;0;0;0;TAB Galaxy A7 Lite (8.7, 32GB, WIFI);COMPUTACION
16329631;;M;35;CHILENO;;Millenial;N/D;N/D;1474600;3;1;0;0;0;3;1;1474600;MBA 13.3 SPG/8C CPU/8C GPU/8GB/512GB-BES;COMPUTACION
6609590;;M;65;CHILENO;;Boomers;N/D;N/D;132470;2;1;0;0;0;2;1;132470;Tab M10 HD 2G-32GB 10.1 Iron grey WiFi;COMPUTACION
10467300;Casado;M;41;CHILENO;PSICOLOGO;Silencioso;PROVIDENCIA                   ;METROPOLITANA;38980;2;1;2;1;38980;0;0;0;Impresora Laser HL-1202 Monocromatica;COMPUTACION
10870011;;M;55;CHILENO;;Boomers;VINA DEL MAR                  ;VALPARAISO;543070;2;1;0;0;0;2;1;543070;AIO/Ryzen 5 3500U/4GB/SSD 512GB/UMA/Black;COMPUTACION
13235171;Soltero;M;45;CHILENO;INGENIERO EN TELECOMUNICACIONES;Silencioso;PROVIDENCIA                   ;METROPOLITANA;53980;2;1;2;1;53980;0;0;0;Impresora Monofuncional Laser 107w;COMPUTACION
9510755;Casado;M;59;CHILENO;CONSTRUCTOR CIVIL;Boomers;RENCA                         ;METROPOLITANA;94980;2;1;2;1;94980;0;0;0;TAB Galaxy A7 Lite (8.7, 32GB, WIFI);COMPUTACION
20380611;;M;22;CHILENO;;Silencioso;PROVIDENCIA                   ;METROPOLITANA;99990;1;1;1;1;99990;0;0;0;TAB Galaxy A7 Lite (8.7, 32GB, WIFI + 4G);COMPUTACION
19350428;;M;26;CHILENO;;Silencioso;PROVIDENCIA                   ;METROPOLITANA;638540;2;1;2;1;638540;0;0;0;NTBK Gaming 3 Ryzen 5 4600H 8GB 512SSD G1650 4GB;COMPUTACION
19525819;;M;25;CHILENO;;Silencioso;PROVIDENCIA                   ;METROPOLITANA;89990;2;1;2;1;89990;0;0;0;TAB Galaxy A7 Lite (8.7, 32GB, WIFI);COMPUTACION
18719445;;M;27;CHILENO;;Silencioso;PROVIDENCIA                   ;METROPOLITANA;239980;2;1;2;1;239980;0;0;0;TAB Galaxy A 8 + S Pen (8, 32GB, WIFI);COMPUTACION
14156882;Casado;M;41;CHILENO;PSICOLOGO;X;PROVIDENCIA                   ;METROPOLITANA;94540;2;1;2;1;94540;0;0;0;TAB Galaxy A7 Lite (8.7, 32GB, WIFI);COMPUTACION
15755349;;M;38;CHILENO;;Millenial;SAN JAVIER                    ;MAULE;389990;1;1;0;0;0;1;1;389990;AIO/Athlon 3050U/4GB/1TB + 256GB/UMA/White;COMPUTACION
6409116;;F;69;CHILENO;;Silencioso;PROVIDENCIA                   ;METROPOLITANA;203980;2;1;2;1;203980;0;0;0;MULTIFUNCIONAL ECOTANK L5190 Wifi/ Fax;COMPUTACION
18072134;;F;30;CHILENO;;Millenial;PROVIDENCIA                   ;METROPOLITANA;143980;2;1;2;1;143980;0;0;0;Multifuncional DCPT520W Wifi;COMPUTACION
10893213;;M;52;CHILENO;;Silencioso;PROVIDENCIA                   ;METROPOLITANA;163980;2;1;2;1;163980;0;0;0;Multifuncional DCPT720DW Wifi, Duplex y ADF;COMPUTACION
16517910;;M;35;CHILENO;;Silencioso;PROVIDENCIA                   ;METROPOLITANA;76000;1;1;1;1;76000;0;0;0;Tab M10 HD 2G-32GB 10.1 Iron grey WiFi;COMPUTACION
18820419;Soltero;F;26;CHILENO;;Z;PROVIDENCIA                   ;METROPOLITANA;528540;2;1;2;1;528540;0;0;0;TAB Galaxy S7 FE (12.4, 128GB WIFI) LIGHT GREEN;COMPUTACION
26059076;;F;36;VENEZOLANO;;Extranjero;TALCA                         ;MAULE;5990;1;1;0;0;0;1;1;5990;TINTA BOTELLA MAGENTA BT5001M;COMPUTACION
8606280;Casado;F;61;CHILENO;INGENIERO COMERCIAL;Boomers;RENCA                         ;METROPOLITANA;179990;1;1;0;0;0;1;1;179990;MULTIFUNCIONAL ECOTANK L3150 Wifi;COMPUTACION
15149776;;F;39;CHILENO;;X;PROVIDENCIA                   ;METROPOLITANA;153980;2;1;2;1;153980;0;0;0;Multifuncional DCPT520W Wifi;COMPUTACION
19325011;Soltero;F;26;CHILENO;;Z;PROVIDENCIA                   ;METROPOLITANA;149990;1;1;0;0;0;1;1;149990;TAB-X306X 10-INCH 4G+64G HD WIFI+4G LTE;COMPUTACION
16142524;;M;37;CHILENO;;Millenial;CONCON;VALPARAISO;149990;1;1;0;0;0;1;1;149990;Tab M10 Plus FHD 4GB 64GB 10.3P platinum grey;COMPUTACION
16811668;;M;34;CHILENO;;Millenial;N/D;N/D;1854150;5;1;0;0;0;5;1;1854150;NTBK M14 Ryzen 5-5500U 8GB/256GB SSD/14P FHD;COMPUTACION
17394856;;F;32;CHILENO;;Millenial;N/D;N/D;1476940;5;2;0;0;0;5;2;1476940;NTBK 15-dk1043la i5-10300H 8GB512SSD4V W10H;COMPUTACION
14030794;;F;40;CHILENO;;X;N/D;N/D;217980;2;1;0;0;0;2;1;217980;Galaxy Tab A7 (10.4 ,32GB, WIFI + 4G) Dark Gray;COMPUTACION
10515422;Casado;M;54;CHILENO;;X;RENCA                         ;METROPOLITANA;159990;1;1;0;0;0;1;1;159990;TAB-X306X 10-INCH 4G+64G HD WIFI+4G LTE;COMPUTACION
25947297;;F;41;COLOMBIANO;;Extranjero;N/D;N/D;152100;2;1;0;0;0;2;1;152100;TAB M8 QC 2GB 32GB 8P Gris;COMPUTACION
18359849;;F;29;CHILENO;;Millenial;SAN VICENTE                   ;L.G.B.OÂ´HIGGINS;142100;2;1;0;0;0;2;1;142100;Tab M10 HD 2G-32GB 10.1 Iron grey WiFi;COMPUTACION
16161239;;M;36;CHILENO;;Millenial;VALDIVIA                      ;LOS RIOS;199990;1;1;0;0;0;1;1;199990;Galaxy Tab A7 (10.4 ,32GB, WIFI + 4G) Dark Gray;COMPUTACION
11676807;;M;51;CHILENO;;X;TALCA                         ;MAULE;389970;4;1;0;0;0;4;1;389970;Galaxy Tab A7 (10.4 ,32GB, WIFI + 4G) Dark Gray;COMPUTACION
19799891;;M;24;CHILENO;;Z;PROVIDENCIA                   ;METROPOLITANA;139990;1;1;1;1;139990;0;0;0;TAB Galaxy Tab A+SPen 8Core 3GB 32GB 8 Gris;COMPUTACION
13711092;;F;43;CHILENO;;X;PUERTO MONTT                  ;LOS LAGOS;214980;3;1;0;0;0;3;1;214980;Galaxy Tab A7 (10.4 ,32GB, WIFI) Dark Gray;COMPUTACION
7739925;;F;68;CHILENO;;Silencioso;N/D;N/D;109990;1;1;0;0;0;1;1;109990;Impresora Monocromatica Xerox B210-NDI;COMPUTACION
15763827;;M;37;CHILENO;;Millenial;PROVIDENCIA                   ;METROPOLITANA;149990;2;1;2;1;149990;0;0;0;Multifuncional DCPT520W Wifi;COMPUTACION
12801154;;M;49;CHILENO;;X;SAN PEDRO DE ATACAMA          ;ANTOFAGASTA;448829;5;3;0;0;0;5;3;448829;TAB-X306X 10-INCH 4G+64G HD WIFI+4G LTE;COMPUTACION
17153792;;M;33;CHILENO;;Millenial;N/D;N/D;0;0;0;0;0;0;0;0;0;Tab Yoga Smart;COMPUTACION
17261156;;F;33;CHILENO;;Millenial;PROVIDENCIA                   ;METROPOLITANA;0;0;0;0;0;0;0;0;0;NTBK 240 G8 Core i3-1005G1/4GB/1TB/14P;COMPUTACION
7507268;;F;68;CHILENO;;Silencioso;COIHAIQUE                     ;AYSEN;0;0;0;0;0;0;0;0;0;TAB Galaxy Tab A+SPen 8Core 3GB 32GB 8 Gris;COMPUTACION
17188329;;F;33;CHILENO;;Silencioso;PROVIDENCIA                   ;METROPOLITANA;0;0;0;0;0;0;0;0;0;NTBK 348G7 i3-10110U 14 4GB/1T PC WHOME;COMPUTACION
7665702;;M;59;CHILENO;;Boomers;ARICA                         ;ARICA Y PARINACOTA;0;0;0;0;0;0;0;0;0;Tab M10 HD 2G-32GB 10.1 Iron grey WiFi;COMPUTACION
10006940;;F;48;CHILENO;;X;ILLAPEL                       ;COQUIMBO;0;0;0;0;0;0;0;0;0;TAB Galaxy A7 Lite (8.7, 32GB, WIFI + 4G);COMPUTACION
19861286;;F;23;CHILENO;;Extranjero;PROVIDENCIA                   ;METROPOLITANA;0;0;0;0;0;0;0;0;0;TAB 7 MB4 Plus 4Core 1GB 16GB 7 Negra;COMPUTACION
19624244;;M;25;CHILENO;;Z;PROVIDENCIA                   ;METROPOLITANA;0;0;0;0;0;0;0;0;0;TAB Galaxy Tab A+SPen 8Core 3GB 32GB 8 Gris;COMPUTACION
8468558;;F;57;CHILENO;;Boomers;SAN FERNANDO                  ;L.G.B.OÂ´HIGGINS;0;0;0;0;0;0;0;0;0;NTBK 14-ck2091la i3-10110U 4GB 128GB 14 HD;COMPUTACION
26094137;;F;31;VENEZOLANO;;Extranjero;"";"";0;0;0;0;0;0;0;0;0;Impresora Monofuncional Laser 107w;COMPUTACION
14082178;;F;41;CHILENO;;X;VALDIVIA                      ;LOS LAGOS;0;0;0;0;0;0;0;0;0;Galaxy Tab A7 (10.4 ,32GB, WIFI) Dark Gray;COMPUTACION
14069409;;F;40;CHILENO;;X;TEMUCO                        ;ARAUCANIA;0;0;0;0;0;0;0;0;0;MULTIFUNCIONAL G2110 TINTA CONT;COMPUTACION
8505481;;F;67;CHILENO;;Boomers;TALCAHUANO                    ;BIO BIO;0;0;0;0;0;0;0;0;0;Galaxy Tab A7 (10.4 ,32GB, WIFI + 4G) Dark Gray;COMPUTACION
13827097;;M;42;CHILENO;;X;PROVIDENCIA                   ;METROPOLITANA;0;0;0;0;0;0;0;0;0;Multifuncional DCPT720DW Wifi, Duplex y ADF;COMPUTACION
9228744;;M;61;CHILENO;;Boomers;RENCA                         ;METROPOLITANA;0;0;0;0;0;0;0;0;0;Tab M10 Plus FHD 4GB 64GB 10.3P platinum grey;COMPUTACION
7450530;;F;65;CHILENO;;Boomers;COPIAPO                       ;ATACAMA;0;0;0;0;0;0;0;0;0;NTBK 14-ck2091la i3-10110U 4GB 128GB 14 HD;COMPUTACION
12697378;Casado;F;48;CHILENO;PROFESOR;X;RENCA                         ;METROPOLITANA;0;0;0;0;0;0;0;0;0;MULTIFUNCIONAL ECOTANK L3150 Wifi;COMPUTACION
16837694;Casado;F;34;CHILENO;PODOLOGA;Millenial;PROVIDENCIA                   ;METROPOLITANA;0;0;0;0;0;0;0;0;0;Multifuncional DCPT520W Wifi;COMPUTACION
14481612;Casado;M;40;CHILENO;PSICOLOGO;Silencioso;PROVIDENCIA                   ;METROPOLITANA;0;0;0;0;0;0;0;0;0;Monitor 24fw con audio;COMPUTACION
20400743;;M;22;CHILENO;;Silencioso;N/D;N/D;0;0;0;0;0;0;0;0;0;TAB-X306X 10-INCH 4G+64G HD WIFI+4G LTE;COMPUTACION
19047443;;M;27;CHILENO;;Z;LA CRUZ;VALPARAISO;0;0;0;0;0;0;0;0;0;NTBK 15-dk1028la Ci5-10300H/8GB/256SSD/1050 3GB;COMPUTACION
19225354;;F;26;CHILENO;;Silencioso;PROVIDENCIA                   ;METROPOLITANA;0;0;0;0;0;0;0;0;0;TINTA 664 NEGRA;COMPUTACION
16071027;;F;36;CHILENO;;Millenial;SAN MIGUEL                    ;METROPOLITANA;0;0;0;0;0;0;0;0;0;Monitor 24 FHD 75Hz HDMI VGA/Flat IPS/Black;COMPUTACION
23629516;;F;49;DOMINICANO;;Extranjero;"";"";0;0;0;0;0;0;0;0;0;NTBK 14-ck2091la i3-10110U 4GB 128GB 14 HD;COMPUTACION
15695083;;M;38;CHILENO;;Millenial;N/D;N/D;0;0;0;0;0;0;0;0;0;AIO/Athlon 3050U/4GB/1TB + 256GB/UMA/White;COMPUTACION
18214455;;F;30;CHILENO;;Millenial;CHILLAN                       ;BIO BIO;0;0;0;0;0;0;0;0;0;MULTIFUNCIONAL ECOTANK L4160 Wifi;COMPUTACION
26436742;;M;35;EXTRANJERO - NO INFORMA NACIONALIDAD;;Extranjero;SAN MIGUEL                    ;METROPOLITANA;0;0;0;0;0;0;0;0;0;TAB Galaxy Tab A+SPen 8Core 3GB 32GB 8 Gris;COMPUTACION
12981318;;F;46;CHILENO;;X;LOS ANGELES                   ;BIO BIO;0;0;0;0;0;0;0;0;0;NTBK 15-dk1043la i5-10300H 8GB512SSD4V W10H;COMPUTACION
18284977;;F;30;CHILENO;;Millenial;N/D;N/D;0;0;0;0;0;0;0;0;0;Monitor Gamer Optix G241VC 23.8;COMPUTACION
16012345;;M;36;CHILENO;;Millenial;N/D;N/D;0;0;0;0;0;0;0;0;0;AIO IC Athlon 3050U 4GB 1TB 21.5P;COMPUTACION
26570696;;M;56;BRASILEÃO;;Extranjero;TALCAHUANO                    ;BIO BIO;0;0;0;0;0;0;0;0;0;TAB Galaxy A7 Lite (8.7, 32GB, WIFI + 4G);COMPUTACION
7539883;;M;67;CHILENO;;Boomers;ANTOFAGASTA                   ;ANTOFAGASTA;0;0;0;0;0;0;0;0;0;TABLET GALAXY TAB S5e (720) Black;COMPUTACION
19818016;;F;23;CHILENO;;Silencioso;PROVIDENCIA                   ;METROPOLITANA;0;0;0;0;0;0;0;0;0;NTBK 240 G8 Core i3-1005G1/4GB/1TB/14P;COMPUTACION
17976297;;F;30;CHILENO;;Millenial;QUILLOTA                      ;VALPARAISO;0;0;0;0;0;0;0;0;0;Multifuncional Smart tank 530 WiFi ADF;COMPUTACION
16470538;;F;35;CHILENO;;Millenial;N/D;N/D;0;0;0;0;0;0;0;0;0;MULTIFUNCIONAL ECOTANK L4160 Wifi;COMPUTACION
10338967;;M;58;CHILENO;;Boomers;SAN FELIPE                    ;VALPARAISO;0;0;0;0;0;0;0;0;0;NTBK 15-dk1043la i5-10300H 8GB512SSD4V W10H;COMPUTACION
11874050;;M;51;CHILENO;;X;RANCAGUA                      ;L.G.B.OÂ´HIGGINS;0;0;0;0;0;0;0;0;0;AIO/Athlon 3050U/4GB/1TB + 256GB/UMA/White;COMPUTACION
20135643;;M;24;CHILENO;;Silencioso;PROVIDENCIA                   ;METROPOLITANA;0;0;0;0;0;0;0;0;0;Tab M10 HD 2G-32GB 10.1 Iron grey WiFi;COMPUTACION
19071175;Soltero;F;26;CHILENO;;Z;PROVIDENCIA                   ;METROPOLITANA;0;0;0;0;0;0;0;0;0;AIO 21-b0021la Pentium J5040 8GB 1TB;COMPUTACION
18625794;;M;28;CHILENO;;Millenial;COLINA                        ;METROPOLITANA;0;0;0;0;0;0;0;0;0;NTBK 15-dk1028la Ci5-10300H/8GB/256SSD/1050 3GB;COMPUTACION
18413665;;F;28;CHILENO;;Millenial;N/D;N/D;0;0;0;0;0;0;0;0;0;MULTIFUNCIONAL ECOTANK L3110;COMPUTACION
5647834;;F;71;CHILENO;;Silencioso;CORONEL                       ;BIO BIO;0;0;0;0;0;0;0;0;0;MULTIFUNCIONAL ECOTANK L3150 Wifi;COMPUTACION
17849657;;F;31;CHILENO;;Millenial;PROVIDENCIA                   ;METROPOLITANA;0;0;0;0;0;0;0;0;0;TAB Matepad 10.4;COMPUTACION
10134262;;F;56;CHILENO;;Boomers;PROVIDENCIA                   ;METROPOLITANA;0;0;0;0;0;0;0;0;0;TAB Galaxy A7 Lite (8.7, 32GB, WIFI);COMPUTACION
12731106;;M;47;CHILENO;;X;CHILLAN                       ;BIO BIO;0;0;0;0;0;0;0;0;0;NTBK 14-ck2091la i3-10110U 4GB 128GB 14 HD;COMPUTACION
19910678;;F;24;CHILENO;;Z;VALLENAR;ATACAMA;0;0;0;0;0;0;0;0;0;Multifuncional Ink Tank 315;COMPUTACION
15759311;;F;38;CHILENO;;Silencioso;PROVIDENCIA                   ;METROPOLITANA;0;0;0;0;0;0;0;0;0;Multifuncional DCPT220;COMPUTACION
10773270;Casado;M;54;CHILENO;CONTADOR GENERAL;Boomers;PROVIDENCIA                   ;METROPOLITANA;0;0;0;0;0;0;0;0;0;AIO 21-b0021la Pentium J5040 8GB 1TB;COMPUTACION
12609440;;F;48;CHILENO;;X;ARICA                         ;ARICA Y PARINACOTA;0;0;0;0;0;0;0;0;0;NTBK Aspire 5 Ci3-10110U/12GB/512GB SSD/15P FHD;COMPUTACION
19194174;Soltero;M;26;CHILENO;;Z;PROVIDENCIA                   ;METROPOLITANA;0;0;0;0;0;0;0;0;0;MULTIFUNCIONAL ECOTANK L4160 Wifi;COMPUTACION
6751463;;M;67;CHILENO;;Boomers;RANCAGUA                      ;L.G.B.OÂ´HIGGINS;0;0;0;0;0;0;0;0;0;NTBK 14-cf2051la i3-10110U 4GB 256GB+16GB 14 HD;COMPUTACION
20064456;;F;24;CHILENO;;Z;PROVIDENCIA                   ;METROPOLITANA;0;0;0;0;0;0;0;0;0;Tab M10 HD 2G-32GB 10.1 Iron grey WiFi;COMPUTACION
20229366;;F;23;CHILENO;;Z;PROVIDENCIA                   ;METROPOLITANA;0;0;0;0;0;0;0;0;0;TAB MLAB MBX 8 QUAD CORE 1G+16G 8716;COMPUTACION
15803688;;M;37;CHILENO;;Millenial;PADRE HURTADO                 ;METROPOLITANA;0;0;0;0;0;0;0;0;0;Multifuncional Smart Tank 515 Wifi;COMPUTACION
18747840;Soltero;F;28;CHILENO;QUIMICO FARMACEUTICO;Millenial;PROVIDENCIA                   ;METROPOLITANA;0;0;0;0;0;0;0;0;0;NTBK 15-dk1028la Ci5-10300H/8GB/256SSD/1050 3GB;COMPUTACION
12676266;;F;48;CHILENO;;Silencioso;PROVIDENCIA                   ;METROPOLITANA;0;0;0;0;0;0;0;0;0;NTBK 14-cf2051la i3-10110U 4GB 256GB+16GB 14 HD;COMPUTACION
15360376;;M;38;CHILENO;;Silencioso;PROVIDENCIA                   ;METROPOLITANA;0;0;0;0;0;0;0;0;0;Galaxy Tab A7 (10.4 ,32GB, WIFI) Silver;COMPUTACION
19093236;;F;27;CHILENO;;Extranjero;"";"";0;0;0;0;0;0;0;0;0;NTBK 15-da2031la OPP i5-10210U 4GB 1TB 15IN Silv;COMPUTACION
26298542;Soltero;M;34;EXTRANJERO - NO INFORMA NACIONALIDAD;;Extranjero;"";"";0;0;0;0;0;0;0;0;0;NTBK GemiBook Celeron/12GB/256GB/2K/Tec-Ingles;COMPUTACION
17017063;;F;33;CHILENO;;Millenial;PROVIDENCIA                   ;METROPOLITANA;0;0;0;0;0;0;0;0;0;TAB Galaxy Tab A 8 4G 4Core 2GB 32GB 8 Gris;COMPUTACION
14384601;;F;48;CHILENO;;X;N/D;N/D;0;0;0;0;0;0;0;0;0;NTBK Y11 11.6 Intel Celeron 8GB RAM + 256GB SDD;COMPUTACION
18706719;Soltero;M;27;CHILENO;;Millenial;PROVIDENCIA                   ;METROPOLITANA;0;0;0;0;0;0;0;0;0;Tab M10 HD 2G-32GB 10.1 Iron grey WiFi;COMPUTACION
16467047;;F;35;CHILENO;;Millenial;RENCA                         ;METROPOLITANA;0;0;0;0;0;0;0;0;0;NTBK 14-ck2091la i3-10110U 4GB 128GB 14 HD;COMPUTACION
17489988;;M;31;CHILENO;;Millenial;EL MONTE;METROPOLITANA;0;0;0;0;0;0;0;0;0;NTBK INSPIRON 3505 AMD R3 3250U 8GB 1TB;COMPUTACION
20314759;;F;22;CHILENO;;Silencioso;PROVIDENCIA                   ;METROPOLITANA;0;0;0;0;0;0;0;0;0;Tab M10 HD 2G-32GB 10.1 Iron grey WiFi;COMPUTACION
10547256;;F;51;CHILENO;;X;RENCA                         ;METROPOLITANA;0;0;0;0;0;0;0;0;0;NTBK 15-dk1028la Ci5-10300H/8GB/256SSD/1050 3GB;COMPUTACION
17070621;;F;33;CHILENO;;Millenial;PROVIDENCIA                   ;METROPOLITANA;0;0;0;0;0;0;0;0;0;Galaxy Tab A7 (10.4 ,32GB, WIFI) Dark Gray;COMPUTACION
9906964;;F;56;CHILENO;;Silencioso;PROVIDENCIA                   ;METROPOLITANA;0;0;0;0;0;0;0;0;0;Galaxy Tab A7 (10.4 ,32GB, WIFI) Dark Gray;COMPUTACION
6448609;Viudo;F;68;CHILENO;;Silencioso;RENCA                         ;METROPOLITANA;0;0;0;0;0;0;0;0;0;NTBK 14-ck2091la i3-10110U 4GB 128GB 14 HD;COMPUTACION
12338745;;M;48;CHILENO;;X;PROVIDENCIA                   ;METROPOLITANA;0;0;0;0;0;0;0;0;0;AIO 21-b0021la Pentium J5040 8GB 1TB;COMPUTACION
13975745;;F;41;CHILENO;;X;RENCA                         ;METROPOLITANA;0;0;0;0;0;0;0;0;0;TABLET 7 KIDS + KID CASE 1+16;COMPUTACION
18503824;Soltero;M;27;CHILENO;FONOAUDIOLOGO;Z;PROVIDENCIA                   ;METROPOLITANA;0;0;0;0;0;0;0;0;0;NTBK 15-dk1028la Ci5-10300H/8GB/256SSD/1050 3GB;COMPUTACION
11322447;;F;54;CHILENO;;X;LOS ANGELES                   ;BIO BIO;0;0;0;0;0;0;0;0;0;NTBK 240 G8 Core i3-1005G1/4GB/1TB/14P;COMPUTACION
16012335;;F;36;CHILENO;;Millenial;HUALPEN;BIO-BIO;0;0;0;0;0;0;0;0;0;Tab M10 HD 2G-32GB 10.1 Iron grey WiFi;COMPUTACION
18590241;Soltero;F;28;CHILENO;;Silencioso;PROVIDENCIA                   ;METROPOLITANA;0;0;0;0;0;0;0;0;0;TAB Galaxy Tab A 8 4G 4Core 2GB 32GB 8 Gris;COMPUTACION
13831965;;F;41;CHILENO;;X;LAS CONDES;METROPOLITANA;0;0;0;0;0;0;0;0;0;TAB M7 7 1GB RAM 8 GB ROM Platinum Grey;COMPUTACION
27158283;;M;30;"";;Extranjero;"";"";0;0;0;0;0;0;0;0;0;Tab M10 HD 2G-32GB 10.1 Iron grey WiFi;COMPUTACION
20242092;;F;22;CHILENO;;Z;PROVIDENCIA                   ;METROPOLITANA;0;0;0;0;0;0;0;0;0;NTBK Herobook Celeron N4020/8GB/256SSD/14P FHD;COMPUTACION
10442541;;M;55;CHILENO;;Boomers;RENCA                         ;METROPOLITANA;0;0;0;0;0;0;0;0;0;NTBK INSPIRON 15 3505 AMD ATHLON SILVER 8GB 256G;COMPUTACION
16995173;;M;33;CHILENO;;Millenial;PROVIDENCIA                   ;METROPOLITANA;0;0;0;0;0;0;0;0;0;Tab M10 HD 2G-32GB 10.1 Iron grey WiFi;COMPUTACION
15579689;;M;37;CHILENO;;Silencioso;PROVIDENCIA                   ;METROPOLITANA;0;0;0;0;0;0;0;0;0;TABLET 7 KIDS + KID CASE 1+16;COMPUTACION
4716543;;M;79;CHILENO;;Silencioso;PROVIDENCIA                   ;METROPOLITANA;0;0;0;0;0;0;0;0;0;NTBK 14-ck2096la CeleronN4020 4GB500GB W10H;COMPUTACION
13362666;;M;44;CHILENO;;X;SAN FELIPE                    ;VALPARAISO;0;0;0;0;0;0;0;0;0;IMPRESORA EPSON L120;COMPUTACION
16314906;Soltero;M;36;CHILENO;TECNICO EN ENFERMERA;Silencioso;PROVIDENCIA                   ;METROPOLITANA;0;0;0;0;0;0;0;0;0;NTBK 14-ck2096la CeleronN4020 4GB500GB W10H;COMPUTACION
20218618;;F;23;CHILENO;;Z;EL BOSQUE                     ;METROPOLITANA;0;0;0;0;0;0;0;0;0;NTBK 14-dq1004la Core i5-1035G1 8GB 256SSD 14P;COMPUTACION
19043331;;F;26;CHILENO;;Z;PROVIDENCIA                   ;METROPOLITANA;0;0;0;0;0;0;0;0;0;TAB Galaxy Tab A 8 4G 4Core 2GB 32GB 8 Gris;COMPUTACION
12815393;;F;47;CHILENO;;X;LA SERENA                     ;COQUIMBO;0;0;0;0;0;0;0;0;0;NTBK 14-cf2051la i3-10110U 4GB 256GB+16GB 14 HD;COMPUTACION
17757816;;M;31;CHILENO;;Silencioso;PROVIDENCIA                   ;METROPOLITANA;0;0;0;0;0;0;0;0;0;Multifuncional DCPT220;COMPUTACION
20158237;;F;22;CHILENO;;Silencioso;PROVIDENCIA                   ;METROPOLITANA;0;0;0;0;0;0;0;0;0;IMPRESORA EPSON L120;COMPUTACION
25888687;;M;34;VENEZOLANO;;Extranjero;ESTACION CENTRAL              ;METROPOLITANA;0;0;0;0;0;0;0;0;0;NTBK 14-ck2091la i3-10110U 4GB 128GB 14 HD;COMPUTACION
16299413;Soltero;M;36;CHILENO;;Millenial;RENCA                         ;METROPOLITANA;0;0;0;0;0;0;0;0;0;AIO 21-b0021la Pentium J5040 8GB 1TB;COMPUTACION
19315974;Soltero;F;25;CHILENO;;Silencioso;PROVIDENCIA                   ;METROPOLITANA;0;0;0;0;0;0;0;0;0;NTBK 14-dk1004la OPP R3-3250U DC 4GB 1TB 14INHD;COMPUTACION
13233296;Soltero;F;45;CHILENO;PROFESOR;X;PROVIDENCIA                   ;METROPOLITANA;0;0;0;0;0;0;0;0;0;NTBK 15-dy2051la i3-1115G4 8GB 256GB+16GB 15IN S;COMPUTACION
18270256;Soltero;M;30;CHILENO;;Silencioso;PROVIDENCIA                   ;METROPOLITANA;0;0;0;0;0;0;0;0;0;NTBK G3 3500 Core i5-10300 8GB 256SSD 1650 4GB;COMPUTACION
22933287;;F;59;CHINO;;Extranjero;ANTOFAGASTA                   ;ANTOFAGASTA;0;0;0;0;0;0;0;0;0;NTBK 14-ck2091la i3-10110U 4GB 128GB 14 HD;COMPUTACION
15836185;;M;37;CHILENO;;Millenial;RENCA                         ;METROPOLITANA;0;0;0;0;0;0;0;0;0;MULTIFUNCIONAL ECOTANK L4160 Wifi;COMPUTACION
15851156;;F;37;CHILENO;;Millenial;CATEMU                        ;VALPARAISO;0;0;0;0;0;0;0;0;0;TAB Galaxy Tab A 8 4Core 2GB 32GB 8 Gris;COMPUTACION
17414639;;M;32;CHILENO;;Millenial;LA REINA                      ;METROPOLITANA;0;0;0;0;0;0;0;0;0;TAB S6 Lite (610) 4GB 64GB 10.4P DARK GREY;COMPUTACION
10892521;Casado;M;52;CHILENO;INGENIERO CIVIL INDUSTRIAL;Silencioso;PROVIDENCIA                   ;METROPOLITANA;0;0;0;0;0;0;0;0;0;TAB Galaxy Tab A 8 4Core 2GB 32GB 8 Gris;COMPUTACION
24798789;Soltero;M;32;PERUANO;;Millenial;PROVIDENCIA                   ;METROPOLITANA;0;0;0;0;0;0;0;0;0;NTBK 15-dk1043la i5-10300H 8GB512SSD4V W10H;COMPUTACION
16466069;;F;36;CHILENO;;Millenial;RENCA                         ;METROPOLITANA;0;0;0;0;0;0;0;0;0;Tablet HMS Matepad T10;COMPUTACION
18501996;Soltero;M;28;CHILENO;;Silencioso;PROVIDENCIA                   ;METROPOLITANA;0;0;0;0;0;0;0;0;0;MONITOR 22x 21.5-inch Display;COMPUTACION
18598343;;F;28;CHILENO;;Millenial;LO PRADO                      ;METROPOLITANA;0;0;0;0;0;0;0;0;0;MULTIFUNCIONAL ECOTANK L4160 Wifi;COMPUTACION
16623649;;M;35;CHILENO;;Millenial;N/D;N/D;0;0;0;0;0;0;0;0;0;TAB Galaxy Tab A 8 4Core 2GB 32GB 8 Gris;COMPUTACION
19052214;Soltero;F;26;CHILENO;;Z;PROVIDENCIA                   ;METROPOLITANA;0;0;0;0;0;0;0;0;0;NTBK 14-ck2096la CeleronN4020 4GB500GB W10H;COMPUTACION
20232747;;M;22;CHILENO;;Silencioso;PROVIDENCIA                   ;METROPOLITANA;0;0;0;0;0;0;0;0;0;Router Huawei AX3 WIFI Quad core;COMPUTACION
17598209;Soltero;F;32;CHILENO;TERAPEUTA OCUPACIONAL;Millenial;PROVIDENCIA                   ;METROPOLITANA;0;0;0;0;0;0;0;0;0;NTBK Core i3/8GB/512SSD;COMPUTACION
10518427;Casado;F;54;CHILENO;;Boomers;RENCA                         ;METROPOLITANA;0;0;0;0;0;0;0;0;0;Galaxy Tab A7 (10.4 ,32GB, WIFI) Dark Gray;COMPUTACION
15507925;;F;36;CHILENO;;Millenial;LAUTARO                       ;ARAUCANIA;0;0;0;0;0;0;0;0;0;NTBK Core i3/8GB/512SSD;COMPUTACION
16169393;Soltero;F;37;CHILENO;PROFESOR;Silencioso;PROVIDENCIA                   ;METROPOLITANA;0;0;0;0;0;0;0;0;0;NTBK 15-dy2051la i3-1115G4 8GB 256GB+16GB 15IN S;COMPUTACION
12663271;;F;48;CHILENO;;X;PROVIDENCIA                   ;METROPOLITANA;0;0;0;0;0;0;0;0;0;NTBK 14-dq1004la Core i5-1035G1 8GB 256SSD 14P;COMPUTACION
16866243;;M;33;CHILENO;;Millenial;IQUIQUE                       ;TARAPACA;0;0;0;0;0;0;0;0;0;NTBK 14-dk1004la OPP R3-3250U DC 4GB 1TB 14INHD;COMPUTACION
17833567;;F;31;CHILENO;;Millenial;COLINA                        ;METROPOLITANA;0;0;0;0;0;0;0;0;0;TAB MBX Cinema 8866 OctaCore 2GB 32GB 10P;COMPUTACION
19436058;;M;25;CHILENO;;Extranjero;OVALLE                        ;COQUIMBO;0;0;0;0;0;0;0;0;0;NTBK 14-ck2091la i3-10110U 4GB 128GB 14 HD;COMPUTACION
18348859;Soltero;M;29;CHILENO;;Millenial;PROVIDENCIA                   ;METROPOLITANA;0;0;0;0;0;0;0;0;0;NTBK 15-dk1028la Ci5-10300H/8GB/256SSD/1050 3GB;COMPUTACION
12359992;;M;49;CHILENO;;X;PROVIDENCIA                   ;METROPOLITANA;0;0;0;0;0;0;0;0;0;Galaxy Tab A7 (10.4 ,32GB, WIFI) Dark Gray;COMPUTACION
17472357;;F;32;CHILENO;;Millenial;VALPARAISO                    ;VALPARAISO;0;0;0;0;0;0;0;0;0;Galaxy Tab A7 (10.4 ,32GB, WIFI + 4G) Dark Gray;COMPUTACION
14321588;;F;46;CHILENO;;X;N/D;N/D;0;0;0;0;0;0;0;0;0;TAB 7 MB4 Plus 4Core 1GB 16GB 7 Negra;COMPUTACION
19635219;;F;25;CHILENO;;Silencioso;PROVIDENCIA                   ;METROPOLITANA;0;0;0;0;0;0;0;0;0;NTBK 15-dy2051la i3-1115G4 8GB 256GB+16GB 15IN S;COMPUTACION
12884611;;F;46;CHILENO;;X;PROVIDENCIA                   ;METROPOLITANA;0;0;0;0;0;0;0;0;0;NTBK INSPIRON 15 3505 AMD ATHLON SILVER 8GB 256G;COMPUTACION
19993321;;F;24;CHILENO;;Z;PROVIDENCIA                   ;METROPOLITANA;0;0;0;0;0;0;0;0;0;TAB M7 7 1GB RAM 8 GB ROM Platinum Grey;COMPUTACION
17822881;;F;31;CHILENO;;Millenial;"";"";0;0;0;0;0;0;0;0;0;NTBK 14-ck2096la CeleronN4020 4GB500GB W10H;COMPUTACION
19528410;;F;25;CHILENO;;Z;PROVIDENCIA                   ;METROPOLITANA;0;0;0;0;0;0;0;0;0;Notebook Ideapad Flex 5 i3;COMPUTACION
18831014;Soltero;M;28;CHILENO;PROFESOR;Silencioso;PROVIDENCIA                   ;METROPOLITANA;0;0;0;0;0;0;0;0;0;TAB M8 QC 2GB 32GB 8P Gris;COMPUTACION
12909085;;F;46;CHILENO;;X;PROVIDENCIA                   ;METROPOLITANA;0;0;0;0;0;0;0;0;0;NTBK INSPIRON 3505 AMD Athlon Silver 3050U 4GB 1;COMPUTACION
19064453;;F;26;CHILENO;;Z;QUILICURA                     ;METROPOLITANA;0;0;0;0;0;0;0;0;0;TAB S6 Lite (610) 4GB 64GB 10.4P PINK;COMPUTACION
12582677;Casado;M;48;CHILENO;;X;RENCA                         ;METROPOLITANA;0;0;0;0;0;0;0;0;0;MULTIFUNCIONAL ECOTANK L3110;COMPUTACION
8437423;;F;64;CHILENO;;Boomers;MULCHEN                       ;BIO BIO;0;0;0;0;0;0;0;0;0;NTBK A515-43-R7RU-3 15 Ryzen 7/8GB/256SSD;COMPUTACION
12298143;;F;50;CHILENO;;X;TALCA                         ;MAULE;0;0;0;0;0;0;0;0;0;NTBK HP 240 G7 Ci5-8250U 4GB 1TB 14P;COMPUTACION
26007175;;F;24;COLOMBIANO;;Extranjero;N/D;N/D;0;0;0;0;0;0;0;0;0;NTBK 245 G7 AMD Ryzen 5 3500U 8GB 1TB 14P;COMPUTACION
14580943;;M;42;CHILENO;;Silencioso;PROVIDENCIA                   ;METROPOLITANA;0;0;0;0;0;0;0;0;0;Impresora Laser HL-1202 Monocromatica;COMPUTACION
20180572;;F;22;CHILENO;;Silencioso;PROVIDENCIA                   ;METROPOLITANA;0;0;0;0;0;0;0;0;0;NTBK 14-dq1004la Core i5-1035G1 8GB 256SSD 14P;COMPUTACION
6226990;;F;70;CHILENO;;Silencioso;PROVIDENCIA                   ;METROPOLITANA;0;0;0;0;0;0;0;0;0;TAB GAMER 7 QUAD CORE 2G+16G 8715;COMPUTACION
16274502;;F;36;CHILENO;;Millenial;PARRAL                        ;MAULE;0;0;0;0;0;0;0;0;0;MULTIFUNCIONAL ECOTANK L5190 Wifi/ Fax;COMPUTACION
19151015;;F;27;CHILENO;;Silencioso;PROVIDENCIA                   ;METROPOLITANA;0;0;0;0;0;0;0;0;0;IPAD WI-FI 32GB GOLD (MYLC2CI/A);COMPUTACION
18815454;;M;27;CHILENO;;Millenial;SAN PEDRO DE LA PAZ           ;BIO BIO;0;0;0;0;0;0;0;0;0;MULTIFUNCIONAL ECOTANK L3150 Wifi;COMPUTACION
26097960;;M;72;EXTRANJERO - NO INFORMA NACIONALIDAD;;Extranjero;QUINTA NORMAL                 ;METROPOLITANA;0;0;0;0;0;0;0;0;0;Tab M7 1G-16GB 7 IPS HD LTE/4G;COMPUTACION
15092855;;F;39;CHILENO;;X;N/D;N/D;0;0;0;0;0;0;0;0;0;TINTA 664 NEGRA;COMPUTACION
18653773;;F;28;CHILENO;;Millenial;PROVIDENCIA                   ;METROPOLITANA;0;0;0;0;0;0;0;0;0;TAB S6 Lite (610) 4GB 64GB 10.4P PINK;COMPUTACION
10609971;;F;54;CHILENO;;Boomers;LOS ANGELES                   ;BIO BIO;0;0;0;0;0;0;0;0;0;NTBK A314-22-R7EL-1 Ryzen 3-3250U 8GB 256SSD 14P;COMPUTACION
15569838;Soltero;F;39;CHILENO;;X;LA SERENA                     ;COQUIMBO;0;0;0;0;0;0;0;0;0;MULTIFUNCIONAL ECOTANK L3150 Wifi;COMPUTACION
19167319;;M;26;CHILENO;;Z;LAS CONDES                    ;METROPOLITANA;0;0;0;0;0;0;0;0;0;NTBK G7 240 Intel Celeron 4GB 500GB 14;COMPUTACION
17067265;;F;33;CHILENO;;Millenial;PROVIDENCIA                   ;METROPOLITANA;0;0;0;0;0;0;0;0;0;MULTIFUNCIONAL ECOTANK L4160 Wifi;COMPUTACION
7493903;;M;66;CHILENO;;Boomers;ARICA                         ;TARAPACA;0;0;0;0;0;0;0;0;0;Galaxy Tab A7 (10.4 ,32GB, WIFI) Silver;COMPUTACION
15947354;Casado;F;37;CHILENO;PROFESOR;Millenial;RENCA                         ;METROPOLITANA;0;0;0;0;0;0;0;0;0;NTBK 15-cw1006la Ryzen 7-3700U 8GB 512SSD 15P;COMPUTACION
15164668;;F;40;CHILENO;;X;PENALOLEN                     ;METROPOLITANA;0;0;0;0;0;0;0;0;0;NTBK 14-DQ1001 Core i3-1005G1 4+16 256SSD 14;COMPUTACION
11553344;;F;51;CHILENO;;X;RENCA                         ;METROPOLITANA;0;0;0;0;0;0;0;0;0;NTBK 14-DQ1001 Core i3-1005G1 4+16 256SSD 14;COMPUTACION
17595789;;M;30;CHILENO;;Millenial;PROVIDENCIA                   ;METROPOLITANA;0;0;0;0;0;0;0;0;0;MULTIFUNCIONAL ECOTANK L3110;COMPUTACION
13818226;;F;42;CHILENO;;X;N/D;N/D;0;0;0;0;0;0;0;0;0;NTBK 15-DA2034LA PENTIUM GOLD 6405U 8GB1TB W10;COMPUTACION
18621136;;M;28;CHILENO;;Silencioso;PROVIDENCIA                   ;METROPOLITANA;0;0;0;0;0;0;0;0;0;Router Huawei AX3 WIFI Quad core;COMPUTACION
19212105;;F;26;CHILENO;;Z;TALAGANTE                     ;METROPOLITANA;0;0;0;0;0;0;0;0;0;NTBK 14-DQ1001 Core i3-1005G1 4+16 256SSD 14;COMPUTACION
10300270;;F;58;CHILENO;;Boomers;COPIAPO                       ;ATACAMA;0;0;0;0;0;0;0;0;0;TAB MLAB MBX 8 QUAD CORE 1G+16G 8716;COMPUTACION
15399208;Soltero;M;39;CHILENO;;X;PROVIDENCIA                   ;METROPOLITANA;0;0;0;0;0;0;0;0;0;NTBK 14-CF3028LA OPP i51035G1 4GB 1TB 14 HDÂ W10;COMPUTACION
10915676;;M;49;CHILENO;;X;COIHAIQUE                     ;AYSEN;0;0;0;0;0;0;0;0;0;TAB Galaxy Tab A+SPen 8Core 3GB 32GB 8 Gris;COMPUTACION
26957261;;M;40;EXTRANJERO - NO INFORMA NACIONALIDAD;;Extranjero;ESTACION CENTRAL              ;METROPOLITANA;0;0;0;0;0;0;0;0;0;MULTIFUNCIONAL ECOTANK L3150 Wifi;COMPUTACION
20026327;;F;23;CHILENO;;Silencioso;PROVIDENCIA                   ;METROPOLITANA;0;0;0;0;0;0;0;0;0;TAB Galaxy Tab A 8 4G 4Core 2GB 32GB 8 Gris;COMPUTACION
10350033;;F;54;CHILENO;;X;PROVIDENCIA                   ;METROPOLITANA;0;0;0;0;0;0;0;0;0;TAB Galaxy Tab A 8 4G 4Core 2GB 32GB 8 Gris;COMPUTACION
16709340;Soltero;F;35;CHILENO;INGENIERO EN ALIMENTOS;Millenial;PROVIDENCIA                   ;METROPOLITANA;0;0;0;0;0;0;0;0;0;Multifuncional Smart Tank 515 Wifi;COMPUTACION
8140862;Casado;M;63;CHILENO;PROFESOR;Boomers;RENCA                         ;METROPOLITANA;0;0;0;0;0;0;0;0;0;NTBK 14-dw0005la Core i7-1065G7 8GB 512SSD 14P;COMPUTACION
14384888;;F;43;CHILENO;;Silencioso;PROVIDENCIA                   ;METROPOLITANA;0;0;0;0;0;0;0;0;0;TAB Galaxy Tab A 8 4G 4Core 2GB 32GB 8 Gris;COMPUTACION
12694192;Casado;M;47;CHILENO;;Silencioso;PROVIDENCIA                   ;METROPOLITANA;0;0;0;0;0;0;0;0;0;NTBK 14-dq1004la Core i5-1035G1 8GB 256SSD 14P;COMPUTACION
12377115;;M;49;CHILENO;;X;PINTO                         ;NUBLE;0;0;0;0;0;0;0;0;0;NTBK 15-cw1020la Ryzen 5-3500U 8GB 256GB 15P;COMPUTACION
15036018;;M;37;CHILENO;;Millenial;OVALLE;COQUIMBO;0;0;0;0;0;0;0;0;0;TAB M7 QC 1GB 8GB 7P Gris;COMPUTACION
14513100;;M;47;CHILENO;;X;CHILLAN VIEJO                 ;BIO BIO;0;0;0;0;0;0;0;0;0;NTBK G7 240 Intel Celeron 4GB 500GB 14;COMPUTACION
11732648;Soltero;F;51;CHILENO;;X;PROVIDENCIA                   ;METROPOLITANA;0;0;0;0;0;0;0;0;0;Galaxy Tab A7 (10.4 ,32GB, WIFI) Dark Gray;COMPUTACION
16342004;;M;36;CHILENO;;Millenial;PROVIDENCIA                   ;METROPOLITANA;0;0;0;0;0;0;0;0;0;NTBK 15-DA2034LA PENTIUM GOLD 6405U 8GB1TB W10;COMPUTACION
17837055;;M;31;CHILENO;;Millenial;N/D;N/D;0;0;0;0;0;0;0;0;0;MULTIFUNCIONAL ECOTANK L3150 Wifi;COMPUTACION
10248678;Casado;M;41;CHILENO;PROFESOR;X;PROVIDENCIA                   ;METROPOLITANA;0;0;0;0;0;0;0;0;0;TAB Galaxy Tab A 8 4Core 2GB 32GB 8 Negra;COMPUTACION
18777537;Soltero;F;28;CHILENO;TECNICO DE NIVEL SUPERIOR EN ENFERMERIA;Millenial;PROVIDENCIA                   ;METROPOLITANA;0;0;0;0;0;0;0;0;0;MULTIFUNCIONAL ECOTANK L3110;COMPUTACION
5801415;;M;75;CHILENO;;Silencioso;BUIN                          ;METROPOLITANA;0;0;0;0;0;0;0;0;0;NTBK 15-cw1020la Ryzen 5-3500U 8GB 256GB 15P;COMPUTACION
26895608;;M;37;HAITIANO;;Extranjero;N/D;N/D;0;0;0;0;0;0;0;0;0;TAB GAMER 7 QUAD CORE 2G+16G 8715;COMPUTACION
17856580;;F;30;CHILENO;;Millenial;PROVIDENCIA                   ;METROPOLITANA;0;0;0;0;0;0;0;0;0;MULTIFUNCIONAL ECOTANK L3110;COMPUTACION
16014029;;F;37;CHILENO;;Millenial;LA FLORIDA;METROPOLITANA;0;0;0;0;0;0;0;0;0;TAB Mediapad T3 10 4Core 2GB 16GB 9,6 Gris;COMPUTACION
19118795;Soltero;M;26;CHILENO;;Silencioso;PROVIDENCIA                   ;METROPOLITANA;0;0;0;0;0;0;0;0;0;NTBK Matebook D15 AMD Ryzen 5 8GB 256SSD 15P;COMPUTACION
9327952;;M;62;CHILENO;;Boomers;REQUINOA                      ;L.G.B.OÂ´HIGGINS;0;0;0;0;0;0;0;0;0;Tab M7 1G-16GB 7 IPS HD LTE/4G;COMPUTACION
11170863;;F;55;CHILENO;;Boomers;N/D;N/D;0;0;0;0;0;0;0;0;0;TAB Galaxy Tab A 8 4G 4Core 2GB 32GB 8 Gris;COMPUTACION
12869719;;M;47;CHILENO;;X;RENCA                         ;METROPOLITANA;0;0;0;0;0;0;0;0;0;NTBK 240 G7 Core i3-1005G1 4GB 1TB 14P;COMPUTACION
12229117;;F;50;CHILENO;;X;QUILPUE                       ;VALPARAISO;0;0;0;0;0;0;0;0;0;NTBK IP3 Ryzen 3-3250U/8GB/1TB/15P;COMPUTACION
15386520;;F;36;CHILENO;;Millenial;RENCA                         ;METROPOLITANA;0;0;0;0;0;0;0;0;0;TAB Mediapad T3 10 4Core 2GB 16GB 9,6 Gris;COMPUTACION
12774818;Casado;F;47;CHILENO;ENFERMERA;X;RENCA                         ;METROPOLITANA;0;0;0;0;0;0;0;0;0;NTBK 14-DQ1001 Core i3-1005G1 4+16 256SSD 14;COMPUTACION
18595149;;F;27;CHILENO;;Silencioso;PROVIDENCIA                   ;METROPOLITANA;0;0;0;0;0;0;0;0;0;NTBK Inspiron 5301 Intel Core i7 11TH 8GB 512SSD;COMPUTACION
16097220;;M;37;CHILENO;;Silencioso;PROVIDENCIA                   ;METROPOLITANA;0;0;0;0;0;0;0;0;0;Impresora Monofuncional Laser 107w;COMPUTACION
14139121;;M;41;CHILENO;;X;PROVIDENCIA                   ;METROPOLITANA;0;0;0;0;0;0;0;0;0;TAB 7 PLAY AND LEARN PLUS BLUE 8868;COMPUTACION
6964390;Casado;M;68;CHILENO;;Boomers;RENCA                         ;METROPOLITANA;0;0;0;0;0;0;0;0;0;NTBK G7 240 Intel Celeron 4GB 500GB 14;COMPUTACION
11438280;;M;53;CHILENO;;X;PROVIDENCIA                   ;METROPOLITANA;0;0;0;0;0;0;0;0;0;NTBK A315-42-R0W1-1 Ryzen 7-3700U 8GB 256SSD 15P;COMPUTACION
17100307;;F;33;CHILENO;;Millenial;RENCA                         ;METROPOLITANA;0;0;0;0;0;0;0;0;0;IPAD PRO 11 WIFI 512GB SPACE GRAY (MXDE2CI/A);COMPUTACION
19355227;;M;26;CHILENO;;Z;N/D;N/D;0;0;0;0;0;0;0;0;0;NTBK 15-cw1021la Ryzen 3-3300U 12GB 256SSD 15P;COMPUTACION
19679464;;F;24;CHILENO;;Z;PROVIDENCIA                   ;METROPOLITANA;0;0;0;0;0;0;0;0;0;Tab M10 Plus FHD 4GB 64GB 10.3P platinum grey;COMPUTACION
19876739;;F;25;CHILENO;;Silencioso;PROVIDENCIA                   ;METROPOLITANA;0;0;0;0;0;0;0;0;0;MULTIFUNCIONAL ECOTANK L3110;COMPUTACION
10281656;;M;57;CHILENO;;Boomers;ARICA                         ;ARICA Y PARINACOTA;0;0;0;0;0;0;0;0;0;NTBK IP3 Athlon 3050U/4GB/500GB/15P;COMPUTACION
17094228;Soltero;F;33;CHILENO;MATRONA;Millenial;PROVIDENCIA                   ;METROPOLITANA;0;0;0;0;0;0;0;0;0;Tab M10 Plus FHD 4GB 64GB 10.3P platinum grey;COMPUTACION
12372965;;M;49;CHILENO;;X;RENCA                         ;METROPOLITANA;0;0;0;0;0;0;0;0;0;NTBK A314-22-R7EL-1 Ryzen 3-3250U 8GB 256SSD 14P;COMPUTACION
17290811;;F;33;CHILENO;;Millenial;PROVIDENCIA                   ;METROPOLITANA;0;0;0;0;0;0;0;0;0;TINTA 664 NEGRA;COMPUTACION
18259242;;F;29;CHILENO;;Millenial;PROVIDENCIA                   ;METROPOLITANA;0;0;0;0;0;0;0;0;0;IMPRESORA HP NEVERSTOP LASER 1200W;COMPUTACION
11489708;;M;52;CHILENO;;X;PROVIDENCIA                   ;METROPOLITANA;0;0;0;0;0;0;0;0;0;TAB S6 Lite (610) 4GB 64GB 10.4P BLUE;COMPUTACION
17387558;;F;32;CHILENO;;Millenial;N/D;N/D;0;0;0;0;0;0;0;0;0;TAB Galaxy Tab A 8 4Core 2GB 32GB 8 Gris;COMPUTACION
19329317;;F;25;CHILENO;;Z;PROVIDENCIA                   ;METROPOLITANA;0;0;0;0;0;0;0;0;0;TAB S6 Lite (610) 4GB 64GB 10.4P DARK GREY;COMPUTACION
10537898;Casado;F;55;CHILENO;PSICOLOGO;Boomers;PROVIDENCIA                   ;METROPOLITANA;0;0;0;0;0;0;0;0;0;NTBK A314-22-R7EL-1 Ryzen 3-3250U 8GB 256SSD 14P;COMPUTACION
17068391;;F;33;CHILENO;;Millenial;PROVIDENCIA                   ;METROPOLITANA;0;0;0;0;0;0;0;0;0;NTBK A514-53-59FH-1 Core i5 8GB 512SSD 14P;COMPUTACION
9309526;;M;47;CHILENO;;X;RENCA                         ;METROPOLITANA;0;0;0;0;0;0;0;0;0;Impresora Laser HL-1202 Monocromatica;COMPUTACION
11230220;;M;54;CHILENO;;X;EL BOSQUE                     ;METROPOLITANA;0;0;0;0;0;0;0;0;0;TAB Matepad 10.4;COMPUTACION
14189786;;F;45;CHILENO;;X;SAN PEDRO DE LA PAZ           ;BIO BIO;0;0;0;0;0;0;0;0;0;Galaxy Tab A7 (10.4 ,32GB, WIFI) Silver;COMPUTACION
13158925;;F;45;CHILENO;;X;PROVIDENCIA                   ;METROPOLITANA;0;0;0;0;0;0;0;0;0;NTBK 240 Core i5-1035G1 4GB 1TB 14P;COMPUTACION
13944954;Casado;M;41;CHILENO;;X;RENCA                         ;METROPOLITANA;0;0;0;0;0;0;0;0;0;Galaxy Tab A7 (10.4 ,32GB, WIFI) Dark Gray;COMPUTACION
18885415;;F;28;CHILENO;;Millenial;PROVIDENCIA                   ;METROPOLITANA;0;0;0;0;0;0;0;0;0;NTBK IP3 Athlon 3050U/4GB/500GB/15P;COMPUTACION
19277966;;M;26;CHILENO;;Z;N/D;N/D;0;0;0;0;0;0;0;0;0;NTBK Gaming 3i Core i5-10300H 8GB 1TB 1650 4GB;COMPUTACION
9388090;;F;55;CHILENO;;Boomers;PROVIDENCIA                   ;METROPOLITANA;0;0;0;0;0;0;0;0;0;TINTA EPSON T504 NG BOTELLA C13T03N12A;COMPUTACION
16899275;;F;34;CHILENO;;Millenial;NUEVA IMPERIAL;ARAUCANIA;0;0;0;0;0;0;0;0;0;Tab M10 Plus FHD 4GB 64GB 10.3P platinum grey;COMPUTACION
19604085;;M;25;CHILENO;;Z;N/D;N/D;0;0;0;0;0;0;0;0;0;NTBK 16-a0001 Core i5-10300H 8GB 512SSD 1650 4GB;COMPUTACION
14257528;Casado;F;48;CHILENO;TECNICO EN ANALISIS QUIMICO;X;PROVIDENCIA                   ;METROPOLITANA;0;0;0;0;0;0;0;0;0;MULTIFUNCIONAL MFC-T910 Wifi/ ADF / DUPLEX;COMPUTACION
11692105;;F;52;CHILENO;;X;COIHAIQUE                     ;AYSEN;0;0;0;0;0;0;0;0;0;AIO 330 A6-9200 4GB 500GB 19,5;COMPUTACION
17625051;;F;31;CHILENO;;Millenial;PROVIDENCIA                   ;METROPOLITANA;0;0;0;0;0;0;0;0;0;TAB M5 Lite Octa Core 32GB 10P FHD;COMPUTACION
18089984;;F;30;CHILENO;;Millenial;PROVIDENCIA                   ;METROPOLITANA;0;0;0;0;0;0;0;0;0;NTBK Gaming 3i Core i5-10300H 8GB 1TB 1650 4GB;COMPUTACION
10752486;;M;54;CHILENO;;Boomers;PUENTE ALTO                   ;METROPOLITANA;0;0;0;0;0;0;0;0;0;AIO IC Athlon 3050U 4GB 1TB 21.5P;COMPUTACION
15737556;;M;38;CHILENO;;X;RENCA                         ;METROPOLITANA;0;0;0;0;0;0;0;0;0;TAB GAMER 7 QUAD CORE 2G+16G 8715;COMPUTACION
16195405;Soltero;F;36;CHILENO;INGENIERO EN COMERCIO INTERNACIONAL;Millenial;PROVIDENCIA                   ;METROPOLITANA;0;0;0;0;0;0;0;0;0;NTBK IP3 Athlon 3050U/4GB/500GB/15P;COMPUTACION
13250270;;F;45;CHILENO;;Silencioso;PROVIDENCIA                   ;METROPOLITANA;0;0;0;0;0;0;0;0;0;TAB Galaxy Tab A 8 4Core 2GB 32GB 8 Gris;COMPUTACION
15027808;;M;40;CHILENO;;X;RENCA                         ;METROPOLITANA;0;0;0;0;0;0;0;0;0;TAB Matepad 10.4;COMPUTACION
16980640;;M;33;CHILENO;;Millenial;N/D;N/D;0;0;0;0;0;0;0;0;0;Galaxy Tab A7 (10.4 ,32GB, WIFI) Dark Gray;COMPUTACION
10651515;;F;46;CHILENO;;X;PROVIDENCIA                   ;METROPOLITANA;0;0;0;0;0;0;0;0;0;TAB S6 Lite (610) 4GB 64GB 10.4P DARK GREY;COMPUTACION
17531557;;M;32;CHILENO;;Millenial;MAIPU                         ;METROPOLITANA;0;0;0;0;0;0;0;0;0;NTBK Matebook D15 AMD Ryzen 5 8GB 256SSD 15P;COMPUTACION
9801257;;F;61;CHILENO;;Boomers;LOTA                          ;BIO BIO;0;0;0;0;0;0;0;0;0;NTBK HP 15-cw1010la Ryzen 5/8GB/512SSD/15P;COMPUTACION
13338374;;M;46;CHILENO;;Extranjero;PENAFLOR                      ;METROPOLITANA;0;0;0;0;0;0;0;0;0;TAB 7 MB4 Plus 4Core 1GB 16GB 7 Plata;COMPUTACION
15642140;;M;38;CHILENO;;Millenial;PROVIDENCIA                   ;METROPOLITANA;0;0;0;0;0;0;0;0;0;NTBK G7 240 Intel Celeron 4GB 500GB 14;COMPUTACION
11279745;;F;53;CHILENO;;X;SAN FERNANDO                  ;L.G.B.OÂ´HIGGINS;0;0;0;0;0;0;0;0;0;AIO A340 A9-9425 4GB 1TB 21,5;COMPUTACION
8644115;;M;61;CHILENO;;Boomers;PROVIDENCIA                   ;METROPOLITANA;0;0;0;0;0;0;0;0;0;NTBK 15-cw1020la Ryzen 5-3500U 8GB 256GB 15P;COMPUTACION
7248126;;F;70;CHILENO;;Silencioso;LINARES                       ;MAULE;0;0;0;0;0;0;0;0;0;TAB MBXR 8717 4Core 2GB 16GB 10 Negra;COMPUTACION
17815983;Soltero;M;31;CHILENO;;Millenial;PROVIDENCIA                   ;METROPOLITANA;0;0;0;0;0;0;0;0;0;NTBK Gaming 3i Core i5-10300H 8GB 1TB 1650 4GB;COMPUTACION
13934488;;M;44;CHILENO;;X;PROVIDENCIA                   ;METROPOLITANA;0;0;0;0;0;0;0;0;0;TAB Matepad T8 wifi 2GB 16GB;COMPUTACION
13305252;;M;44;CHILENO;;X;TALCA                         ;MAULE;0;0;0;0;0;0;0;0;0;NTBK 240 G7 Core i3-1005G1 4GB 1TB 14P;COMPUTACION
8924200;;M;59;CHILENO;;Boomers;QUILLOTA                      ;VALPARAISO;0;0;0;0;0;0;0;0;0;NTBK IP3 Ryzen 3-3250U/8GB/1TB/15P;COMPUTACION
17232159;Soltero;M;32;CHILENO;;Millenial;PROVIDENCIA                   ;METROPOLITANA;0;0;0;0;0;0;0;0;0;TAB Galaxy Tab A 8 4Core 2GB 32GB 8 Negra;COMPUTACION
10720918;;M;54;CHILENO;;Boomers;IQUIQUE                       ;TARAPACA;0;0;0;0;0;0;0;0;0;TAB Galaxy Tab A 10.1 4G 8Core 2GB 32GB 10 Gold;COMPUTACION
15349125;Soltero;M;40;CHILENO;;X;PROVIDENCIA                   ;METROPOLITANA;0;0;0;0;0;0;0;0;0;NTBK IP3 Athlon 3050U/4GB/500GB/15P;COMPUTACION
14700077;;M;46;CHILENO;;Extranjero;ARICA                         ;TARAPACA;0;0;0;0;0;0;0;0;0;MULTIFUNCIONAL DCP-T510 Wifi;COMPUTACION
18162966;Soltero;M;29;CHILENO;;Millenial;ALGARROBO                     ;VALPARAISO;0;0;0;0;0;0;0;0;0;NTBK HP 15-da0082la Pentium 4GB 500GB 15P;COMPUTACION
6605401;Soltero;M;62;CHILENO;ABOGADO;Boomers;RENCA                         ;METROPOLITANA;0;0;0;0;0;0;0;0;0;TAB Galaxy Tab A 8 4Core 2GB 32GB 8 Negra;COMPUTACION
12642730;;M;47;CHILENO;;X;PROVIDENCIA                   ;METROPOLITANA;0;0;0;0;0;0;0;0;0;TAB S6 Lite (610) 4GB 64GB 10.4P PINK;COMPUTACION
17826305;Soltero;M;31;CHILENO;;Millenial;PROVIDENCIA                   ;METROPOLITANA;0;0;0;0;0;0;0;0;0;NTBK 14-DQ1001 Core i3-1005G1 4+16 256SSD 14;COMPUTACION
17184032;;M;33;CHILENO;;Millenial;N/D;N/D;0;0;0;0;0;0;0;0;0;TAB Matepad 10.4;COMPUTACION
15587551;;F;38;CHILENO;;X;RENCA                         ;METROPOLITANA;0;0;0;0;0;0;0;0;0;TAB 7 MB4 Plus 4Core 1GB 16GB 7 Plata;COMPUTACION
15910550;;F;37;CHILENO;;Millenial;MULCHEN                       ;BIO BIO;0;0;0;0;0;0;0;0;0;NTBK G7 240 Intel Celeron 4GB 500GB 14;COMPUTACION
18697115;;F;28;CHILENO;;Millenial;SAN MIGUEL                    ;METROPOLITANA;0;0;0;0;0;0;0;0;0;TAB Galaxy Tab A 10.1 8Core 2GB 32GB 10 Negra;COMPUTACION
16394929;;M;36;CHILENO;;Millenial;PROVIDENCIA                   ;METROPOLITANA;0;0;0;0;0;0;0;0;0;MULTIFUNCIONAL ECOTANK L3110;COMPUTACION
11697994;;F;52;CHILENO;;X;N/D;N/D;0;0;0;0;0;0;0;0;0;NTBK IP3 Athlon 3050U/4GB/500GB/15P;COMPUTACION
12402691;;F;48;CHILENO;;X;CALERA                        ;VALPARAISO;0;0;0;0;0;0;0;0;0;NTBK 240 Core i3-7020U 4GB 1TB 14;COMPUTACION
9791996;Casado;M;59;CHILENO;;Boomers;RENCA                         ;METROPOLITANA;0;0;0;0;0;0;0;0;0;NTBK Matebook D15 AMD Ryzen 5 8GB 256SSD 15P;COMPUTACION
13431854;;M;43;CHILENO;;X;PROVIDENCIA                   ;METROPOLITANA;0;0;0;0;0;0;0;0;0;TAB 7 MB4 PLUS 3G 1+16GB BLACK 8761;COMPUTACION
12302469;;F;49;CHILENO;;X;CHIGUAYANTE                   ;BIO BIO;0;0;0;0;0;0;0;0;0;NTBK IP3 Ryzen 3-3250U/8GB/1TB/15P;COMPUTACION
18560483;;M;26;CHILENO;;Millenial;PROVIDENCIA                   ;METROPOLITANA;0;0;0;0;0;0;0;0;0;Impresora Monofuncional Laser 107w;COMPUTACION
10128148;;M;58;CHILENO;;Boomers;RANCAGUA                      ;L.G.B.OÂ´HIGGINS;0;0;0;0;0;0;0;0;0;TAB Matepad 10.4;COMPUTACION
14481704;;M;50;CHILENO;;X;PROVIDENCIA                   ;METROPOLITANA;0;0;0;0;0;0;0;0;0;TAB Galaxy Tab A 10.1 4G 8Core 2GB 32GB 10 Gold;COMPUTACION
18231364;Soltero;M;29;CHILENO;;Millenial;PROVIDENCIA                   ;METROPOLITANA;0;0;0;0;0;0;0;0;0;NTBK Matebook D14 AMD Ryzen 5 8GB 256SSD 14P;COMPUTACION
7483828;;F;63;CHILENO;;Boomers;QUILPUE                       ;VALPARAISO;0;0;0;0;0;0;0;0;0;NTBK 240 Core i5-1035G1 4GB 1TB 14P;COMPUTACION
9401859;Casado;F;57;CHILENO;CONTADOR GENERAL;Boomers;PROVIDENCIA                   ;METROPOLITANA;0;0;0;0;0;0;0;0;0;TAB Matepad T8 Wifi 2GB 32GB 8P;COMPUTACION
25571954;;M;44;HAITIANO;;Extranjero;LO ESPEJO                     ;METROPOLITANA;0;0;0;0;0;0;0;0;0;TAB Matepad T8 4G LTE 2GB 16GB;COMPUTACION
11472220;;M;53;CHILENO;;X;PROVIDENCIA                   ;METROPOLITANA;0;0;0;0;0;0;0;0;0;Multifuncional Smart tank 530 WiFi ADF;COMPUTACION
9429300;;F;61;CHILENO;;Boomers;SAN ANTONIO                   ;VALPARAISO;0;0;0;0;0;0;0;0;0;NTBK 15-dw1051la Core i5-10210U 8GB 256SSD 15P;COMPUTACION
15581544;Soltero;F;38;CHILENO;;X;PROVIDENCIA                   ;METROPOLITANA;0;0;0;0;0;0;0;0;0;NTBK Matebook D15 AMD Ryzen 5 8GB 256SSD+1TB 15P;COMPUTACION
12946754;;F;45;CHILENO;;X;SALAMANCA                     ;COQUIMBO;0;0;0;0;0;0;0;0;0;NTBK IP S340 Core I5-1035G4 4GB 256GB SSD 14P;COMPUTACION
17959238;;M;30;CHILENO;;Millenial;PROVIDENCIA                   ;METROPOLITANA;0;0;0;0;0;0;0;0;0;NTBK IP3 AMD Ryzen 5-4500U 8GB 1TB 15P;COMPUTACION
14341995;;F;45;CHILENO;;X;SAN JAVIER                    ;MAULE;0;0;0;0;0;0;0;0;0;TAB Galaxy Tab A 8 4Core 2GB 32GB 8 Gris;COMPUTACION
13778894;;M;41;CHILENO;;X;QUINTA DE TILCOCO             ;L.G.B.OÂ´HIGGINS;0;0;0;0;0;0;0;0;0;TAB Galaxy Tab A 8 4G 4Core 2GB 32GB 8 Gris;COMPUTACION
17096922;;F;33;CHILENO;;Millenial;PROVIDENCIA                   ;METROPOLITANA;0;0;0;0;0;0;0;0;0;NTBK G7 240 Intel Celeron 4GB 500GB 14;COMPUTACION
8355616;Divorciado;M;63;CHILENO;PROFESOR;Boomers;RENCA                         ;METROPOLITANA;0;0;0;0;0;0;0;0;0;Macbook Pro Core i5 16GB 512SSD (MWP72CI/A);COMPUTACION
12964878;;F;46;CHILENO;;X;QUILICURA                     ;METROPOLITANA;0;0;0;0;0;0;0;0;0;TAB Galaxy Tab A 8 4Core 2GB 32GB 8 Gris;COMPUTACION
6795325;Viudo;F;69;CHILENO;;Silencioso;PROVIDENCIA                   ;METROPOLITANA;0;0;0;0;0;0;0;0;0;TAB Galaxy Tab A 10.1 8Core 2GB 32GB 10 Negra;COMPUTACION
10607109;Casado;F;55;CHILENO;ADMINISTRADOR PUBLICO;Boomers;RENCA                         ;METROPOLITANA;0;0;0;0;0;0;0;0;0;NTBK IP3 Athlon 3050U/4GB/500GB/15P;COMPUTACION
17639309;Soltero;M;31;CHILENO;INGENIERO EN ADMINISTRACION DE EMPRESAS;Millenial;N/D;N/D;0;0;0;0;0;0;0;0;0;NTBK 15-dk0015 Core i5-9300H 8GB 256SSD 1050 3GB;COMPUTACION
5843618;Casado;F;71;CHILENO;PROFESOR;Silencioso;PROVIDENCIA                   ;METROPOLITANA;0;0;0;0;0;0;0;0;0;MULTIFUNCIONAL ECOTANK L3110;COMPUTACION
18068840;;F;30;CHILENO;;Millenial;TALCAHUANO                    ;BIO BIO;0;0;0;0;0;0;0;0;0;NTBK G7 240 Intel Celeron 4GB 500GB 14;COMPUTACION
16012276;;M;36;CHILENO;;Millenial;LOS ANGELES                   ;BIO BIO;0;0;0;0;0;0;0;0;0;NTBK 15-dk0015 Core i5-9300H 8GB 256SSD 1050 3GB;COMPUTACION
7319856;;M;66;CHILENO;;Boomers;MAIPU                         ;METROPOLITANA;0;0;0;0;0;0;0;0;0;NTBK G7 240 Intel Celeron 4GB 500GB 14;COMPUTACION
18401949;;M;28;CHILENO;;Millenial;PAINE                         ;METROPOLITANA;0;0;0;0;0;0;0;0;0;TAB 7 MB4 PLUS 3G 1+16GB BLACK 8761;COMPUTACION
8476565;;M;54;CHILENO;;X;PROVIDENCIA                   ;METROPOLITANA;0;0;0;0;0;0;0;0;0;Impresora Monofuncional Laser 107w;COMPUTACION
13716211;;M;42;CHILENO;;X;VINA DEL MAR                  ;VALPARAISO;0;0;0;0;0;0;0;0;0;NTBK IP S145 AMD A4-9125/4GB/500GB/14P;COMPUTACION
9975071;;F;55;CHILENO;;Boomers;RENCA                         ;METROPOLITANA;0;0;0;0;0;0;0;0;0;TAB Galaxy Tab A+SPen 8Core 3GB 32GB 8 Gris;COMPUTACION
15253452;;M;38;CHILENO;;X;PROVIDENCIA                   ;METROPOLITANA;0;0;0;0;0;0;0;0;0;TAB Galaxy Tab A 8 4Core 2GB 32GB 8 Negra;COMPUTACION
11654657;Soltero;F;51;CHILENO;PROFESOR;X;PROVIDENCIA                   ;METROPOLITANA;0;0;0;0;0;0;0;0;0;MULTIFUNCIONAL ECOTANK L3110;COMPUTACION
19950358;;F;24;CHILENO;;Z;PROVIDENCIA                   ;METROPOLITANA;0;0;0;0;0;0;0;0;0;TABLET GALAXY S7+ (T970) 256GB 12.4P Cooper;COMPUTACION
14426804;Soltero;F;41;CHILENO;;X;PEDRO AGUIRRE CERDA           ;METROPOLITANA;0;0;0;0;0;0;0;0;0;TABLET LENOVO Tab 7 4G/1GB/16GB/7P;COMPUTACION
6092293;;M;68;CHILENO;;Silencioso;CONCHALI                      ;METROPOLITANA;0;0;0;0;0;0;0;0;0;MULTIFUNCIONAL DCP-T510 Wifi;COMPUTACION
19302930;Soltero;F;25;CHILENO;;Z;PROVIDENCIA                   ;METROPOLITANA;0;0;0;0;0;0;0;0;0;NTBK S150 AMD A4-9120e 4GB 64GB eMMc 14P;COMPUTACION
7951373;;M;65;CHILENO;;Boomers;PLACILLA                      ;L.G.B.OÂ´HIGGINS;0;0;0;0;0;0;0;0;0;TAB M8 QC 2GB 32GB 8P Gris;COMPUTACION
19449818;;F;25;CHILENO;;Z;PROVIDENCIA                   ;METROPOLITANA;0;0;0;0;0;0;0;0;0;NTBK 15-gw0016la AMD Athlon 8GB 256GBSSD 15P;COMPUTACION
13085058;;F;45;CHILENO;;X;PROVIDENCIA                   ;METROPOLITANA;0;0;0;0;0;0;0;0;0;TAB Galaxy Tab A 8 4Core 2GB 32GB 8 Gris;COMPUTACION
9655228;;M;57;CHILENO;;Boomers;RENCA                         ;METROPOLITANA;0;0;0;0;0;0;0;0;0;NTBK S150 AMD A4-9120e 4GB 64GB eMMc 14P;COMPUTACION
11738708;;M;50;CHILENO;;X;SANTO DOMINGO                 ;VALPARAISO;0;0;0;0;0;0;0;0;0;Multifuncional Smart Tank 515 Wifi;COMPUTACION
19381708;;M;26;CHILENO;;Z;"";"";0;0;0;0;0;0;0;0;0;TAB Galaxy Tab A 10.1 8Core 2GB 32GB 10 Negra;COMPUTACION
13369308;Casado;M;43;CHILENO;;X;RENCA                         ;METROPOLITANA;0;0;0;0;0;0;0;0;0;MULTIFUNCIONAL ECOTANK L3150 Wifi;COMPUTACION
18558424;;M;28;CHILENO;;Millenial;PROVIDENCIA                   ;METROPOLITANA;0;0;0;0;0;0;0;0;0;TAB M7 QC 1GB 8GB 7P Gris;COMPUTACION
9889915;;F;58;CHILENO;;Boomers;QUILLOTA                      ;VALPARAISO;0;0;0;0;0;0;0;0;0;TAB Galaxy Tab A 10.1 8Core 2GB 32GB 10 Negra;COMPUTACION
18490674;;F;28;CHILENO;;Millenial;PROVIDENCIA                   ;METROPOLITANA;0;0;0;0;0;0;0;0;0;NTBK 14-dq1004la Core i5-1035G1 8GB 256SSD 14P;COMPUTACION
14491203;;M;49;CHILENO;;X;PROVIDENCIA                   ;METROPOLITANA;0;0;0;0;0;0;0;0;0;NTBK G7 240 Intel Celeron 4GB 500GB 14;COMPUTACION
7945212;;M;64;CHILENO;;Boomers;LOS VILOS                     ;COQUIMBO;0;0;0;0;0;0;0;0;0;TAB Galaxy Tab A 8 4Core 2GB 32GB 8 Negra;COMPUTACION
6881450;;F;71;CHILENO;;Silencioso;VALPARAISO                    ;VALPARAISO;0;0;0;0;0;0;0;0;0;NTBK S150 AMD A4-9120e 4GB 64GB eMMc 14P;COMPUTACION
18830494;;M;28;CHILENO;;Millenial;VALDIVIA                      ;LOS RIOS;0;0;0;0;0;0;0;0;0;TAB MLAB MBX 8 QUAD CORE 1G+16G 8716;COMPUTACION
10002871;;F;53;CHILENO;;X;ANCUD                         ;LOS LAGOS;0;0;0;0;0;0;0;0;0;TAB Galaxy Tab A 10.1 4G 8Core 2GB 32GB 10 Gold;COMPUTACION
13637373;;F;43;CHILENO;;Millenial;N/D;N/D;0;0;0;0;0;0;0;0;0;TAB Galaxy Tab A 8 4Core 2GB 32GB 8 Gris;COMPUTACION
15179941;;M;39;CHILENO;;X;N/D;N/D;0;0;0;0;0;0;0;0;0;NTBK IP S145 AMD A4-9125/4GB/500GB/14P;COMPUTACION
6286391;Casado;F;74;CHILENO;PROFESOR;Silencioso;RENCA                         ;METROPOLITANA;0;0;0;0;0;0;0;0;0;NTBK HP 14-cf0011la Ci3-8130U 4GB 128SSD 14P;COMPUTACION
14171049;;F;41;CHILENO;;X;PROVIDENCIA                   ;METROPOLITANA;0;0;0;0;0;0;0;0;0;NTBK 14-DQ1001 Core i3-1005G1 4+16 256SSD 14;COMPUTACION
16880037;Soltero;M;34;CHILENO;;Millenial;PROVIDENCIA                   ;METROPOLITANA;0;0;0;0;0;0;0;0;0;Multifuncional Smart Tank 515 Wifi;COMPUTACION
17994052;;F;30;CHILENO;;Millenial;QUILPUE                       ;VALPARAISO;0;0;0;0;0;0;0;0;0;IPAD 10.2 WiFi 32Â GB Gris espacial 7 Gen;COMPUTACION
12815468;;M;47;CHILENO;;X;TOCOPILLA                     ;ANTOFAGASTA;0;0;0;0;0;0;0;0;0;NTBK 16-a0001 Core i5-10300H 8GB 512SSD 1650 4GB;COMPUTACION
20564983;;F;21;CHILENO;;Z;PROVIDENCIA                   ;METROPOLITANA;0;0;0;0;0;0;0;0;0;MULTIFUNCIONAL ECOTANK L3110;COMPUTACION
11728239;;M;51;CHILENO;;X;RENCA                         ;METROPOLITANA;0;0;0;0;0;0;0;0;0;MULTIFUNCIONAL ECOTANK L3150 Wifi;COMPUTACION
13549653;Casado;M;43;CHILENO;PROFESOR;X;PROVIDENCIA                   ;METROPOLITANA;0;0;0;0;0;0;0;0;0;TAB GALAXY S6 (T865) 6GB 128GB 10.5 4G;COMPUTACION
12440062;Casado;M;49;CHILENO;TECNICO MECANICO;X;ANTOFAGASTA                   ;ANTOFAGASTA;0;0;0;0;0;0;0;0;0;TAB 7 MB4 Plus 4Core 1GB 16GB 7 Negra;COMPUTACION
16418827;;F;36;CHILENO;;Millenial;RENCA                         ;METROPOLITANA;0;0;0;0;0;0;0;0;0;NTBK HP 240 G7 Ci5-8250U 4GB 1TB 14P;COMPUTACION
14094807;;M;46;CHILENO;;X;CHOLCHOL;ARAUCANIA;0;0;0;0;0;0;0;0;0;NTBK G7 240 Intel Celeron 4GB 500GB 14;COMPUTACION
16360667;;F;35;CHILENO;;Millenial;PROVIDENCIA                   ;METROPOLITANA;0;0;0;0;0;0;0;0;0;NTBK HP 14-cf0011la Ci3-8130U 4GB 128SSD 14P;COMPUTACION
18059222;;M;30;CHILENO;;Millenial;PROVIDENCIA                   ;METROPOLITANA;0;0;0;0;0;0;0;0;0;NTBK 15-DA0039 Pentium Gold 4GB 500GB 15,6;COMPUTACION
17070587;;F;33;CHILENO;;Millenial;CERRO NAVIA                   ;METROPOLITANA;129980;2;1;2;1;129980;0;0;0;Comedor Campo 4 sillas Madera Maciza Canela 100x;MERCADO ABC
8772535;Soltero;F;59;CHILENO;CONTADOR GENERAL;Boomers;NUNOA                         ;METROPOLITANA;26980;2;1;2;1;26980;0;0;0;CORREPASILLOS MOTONETA C SONIDO Y LUCES AZUL;MERCADO ABC
11719869;;F;51;CHILENO;;X;PROVIDENCIA                   ;METROPOLITANA;78980;2;1;2;1;78980;0;0;0;Estante Match Roble/Off White 63x32x166cm;MERCADO ABC
8561546;;M;64;CHILENO;;Boomers;N/D;N/D;630940;6;3;6;3;630940;0;0;0;Camara IP Wifi Exterior Modelo IP850;MERCADO ABC
16380622;;F;36;CHILENO;;Extranjero;PENALOLEN;METROPOLITANA;26980;2;1;2;1;26980;0;0;0;Sabana Polar Est. 2 P Grosso;MERCADO ABC
19751245;;F;24;CHILENO;;Extranjero;"";"";103980;2;1;0;0;0;2;1;103980;Juego comedor Perola Blanco 4 sillas Nicoli Blan;MERCADO ABC
15734961;;F;38;CHILENO;;X;PUNITAQUI                     ;COQUIMBO;156970;3;2;0;0;0;3;2;156970;KIT COCINA 120 PORRA;MERCADO ABC
5101752;;F;78;CHILENO;;Silencioso;RENCA                         ;METROPOLITANA;258960;4;3;2;1;173980;2;2;84980;C Travel Sys Fenix Azul;MERCADO ABC
17080177;;M;36;CHILENO;;Millenial;N/D;N/D;56980;2;1;2;1;56980;0;0;0;Soldadora Krafter Dw-105black;MERCADO ABC
23474063;;M;40;ARGENTINO;;Extranjero;N/D;N/D;1689463;10;5;10;5;1689463;0;0;0;ESTACION DE TRABAJO MONARCA 120 (2C) NEG ENG 495;MERCADO ABC
13995119;Soltero;F;41;CHILENO;;X;PROVIDENCIA                   ;METROPOLITANA;59970;3;1;3;1;59970;0;0;0;Plumon Rell. Single Mickey Original;MERCADO ABC
11846968;;F;50;CHILENO;;X;PROVIDENCIA                   ;METROPOLITANA;22980;2;1;2;1;22980;0;0;0;ALZA ROPA CURVO;MERCADO ABC
10703122;;M;52;CHILENO;;X;RENCA                         ;METROPOLITANA;167980;2;1;2;1;167980;0;0;0;ARMARIO ARCHIVADOR BILBAO - MIEL / WENGUE AMW 43;MERCADO ABC
19918180;;M;23;CHILENO;;Z;LA GRANJA;METROPOLITANA;224960;4;2;4;2;224960;0;0;0;VELADOR KAIA Z-41 1 CAJON / 1 PUERTA - WENGUE /;MERCADO ABC
17813706;;F;37;CHILENO;;Millenial;NUEVA IMPERIAL                ;ARAUCANIA;1384890;10;4;0;0;0;10;4;1384890;JGO LIVING IRLANDA 3.2 C/AZUL;MERCADO ABC
15191822;;M;40;CHILENO;;X;CORONEL                       ;BIO BIO;310980;2;1;2;1;310980;0;0;0;JGO LIVING FRANCIA 3,1,1 NEGRO;MERCADO ABC
13156766;Casado;M;45;CHILENO;;X;PROVIDENCIA                   ;METROPOLITANA;67980;2;1;2;1;67980;0;0;0;Set Mancuernas Con Barra Ajustable 50Kg K-FIT;MERCADO ABC
19317868;Soltero;M;26;CHILENO;;Z;PROVIDENCIA                   ;METROPOLITANA;208980;2;1;2;1;208980;0;0;0;Estante modelo vivaz tv hasta 65 color canela/bl;MERCADO ABC
9363923;;F;59;CHILENO;;Boomers;LA SERENA                     ;COQUIMBO;4990;1;1;0;0;0;1;1;4990;PRODUCTO 2A JUGUETES BANDA 5;MERCADO ABC
19884163;;M;24;CHILENO;;Z;PROVIDENCIA                   ;METROPOLITANA;37980;2;1;2;1;37980;0;0;0;BATERIA 12 PZ. MONTERREY INOX;MERCADO ABC
14039973;;F;40;CHILENO;;X;QUELLON;LOS LAGOS;462960;4;2;4;2;462960;0;0;0;Seccional Intercambiable Bugambilia By Essenza B;MERCADO ABC
17438256;;F;32;CHILENO;;Millenial;ANTOFAGASTA;ANTOFAGASTA;75480;2;1;2;1;75480;0;0;0;ESPEJO SCALA ART Z 120 CONAC 60 X 120 ESQ4009Z12;MERCADO ABC
19362291;;M;25;CHILENO;;Silencioso;PROVIDENCIA                   ;METROPOLITANA;999930;6;2;6;2;999930;0;0;0;BAR ALTO FRAKTAL - HABANO / MIEL BHM 4461;MERCADO ABC
14028055;Soltero;F;40;CHILENO;INGENIERO COMERCIAL;X;PROVIDENCIA                   ;METROPOLITANA;517980;2;3;2;3;517980;0;0;0;COMEDOR MARTINA 1+4+2 C/E;MERCADO ABC
17020050;;F;33;CHILENO;;Millenial;N/D;N/D;716490;13;5;13;5;716490;0;0;0;Plumon Est Geometrico king Crudo;MERCADO ABC
26550755;Soltero;F;36;EXTRANJERO - NO INFORMA NACIONALIDAD;;Extranjero;PROVIDENCIA                   ;METROPOLITANA;42980;2;1;2;1;42980;0;0;0;Alfombra Frise 1.6k Venecia 150x200 Verona;MERCADO ABC
27197620;;M;43;"";;Extranjero;PROVIDENCIA                   ;METROPOLITANA;59980;2;1;2;1;59980;0;0;0;OLLA A PRESION STAR 6L INOX;MERCADO ABC
11698870;;M;51;CHILENO;;X;RENCA                         ;METROPOLITANA;367980;2;1;2;1;367980;0;0;0;SOFA MIRA 2 CPO TELA VISON RSN;MERCADO ABC
13984805;;F;40;CHILENO;;X;LLAY LLAY;VALPARAISO;18980;2;1;2;1;18980;0;0;0;Balanza Corporal Digital Smart Negra;MERCADO ABC
10828866;;M;53;CHILENO;;X;N/D;N/D;936970;3;1;0;0;0;3;1;936970;SOFA ANDALUCIA RECLINABLE 3 CUERPOS CHOCOLATE;MERCADO ABC
7461514;;M;61;CHILENO;;Boomers;VICTORIA                      ;ARAUCANIA;52980;2;1;2;1;52980;0;0;0;Maquina Abdominales Six Pack K-FIT;MERCADO ABC
15531433;;F;39;CHILENO;;X;"";"";85970;3;1;3;1;85970;0;0;0;Cortina Roller Garden Beige 200x250cm;MERCADO ABC
18654578;Soltero;M;28;CHILENO;;Millenial;PROVIDENCIA                   ;METROPOLITANA;37970;3;1;3;1;37970;0;0;0;ARCO FUTBOLL PLEGABLE;MERCADO ABC
13842216;Divorciado;F;41;CHILENO;ASISTENTE DE PARVULOS;X;RETIRO                        ;MAULE;238960;4;2;4;2;238960;0;0;0;BAR BAJO MARSELLA - GALES / DUNA BGD 4297;MERCADO ABC
13335391;;F;44;CHILENO;;X;RENCA;METROPOLITANA;153980;2;1;2;1;153980;0;0;0;Bicicleta De Spinning Strong Pro-Fit K-FIT;MERCADO ABC
18963241;;F;27;CHILENO;;Z;OSORNO                        ;LOS LAGOS;237080;4;2;4;2;237080;0;0;0;Set Mancuernas Con Barra Ajustable 30Kg K-FIT;MERCADO ABC
17902670;Soltero;F;31;CHILENO;;Millenial;PROVIDENCIA                   ;METROPOLITANA;-386360;2;3;2;3;-386360;0;0;0;Set Mancuernas Con Barra Ajustable 30Kg K-FIT;MERCADO ABC
15696844;;F;38;CHILENO;;X;PROVIDENCIA                   ;METROPOLITANA;394960;4;2;4;2;394960;0;0;0;Plumon 1,5P Frozen Happiness;MERCADO ABC
16515749;;M;34;CHILENO;;Millenial;PROVIDENCIA                   ;METROPOLITANA;35980;2;1;2;1;35980;0;0;0;Parrilla Set Nino 25 Accesorios Paradiso;MERCADO ABC
18091570;;F;30;CHILENO;;Millenial;HUECHURABA                    ;METROPOLITANA;17980;2;1;2;1;17980;0;0;0;Raton de juguete con Control Remoto para gatos c;MERCADO ABC
19380475;Soltero;F;25;CHILENO;;Z;PROVIDENCIA                   ;METROPOLITANA;108960;4;2;4;2;108960;0;0;0;Mesa Plegable Tipo Maleta + 4 Pisos 120Cms;MERCADO ABC
25655733;Soltero;M;41;VENEZOLANO;;Extranjero;PROVIDENCIA                   ;METROPOLITANA;179980;2;1;2;1;179980;0;0;0;PANEL TV 65 plg ESSENCE COLOR NATURAL/BLANCO;MERCADO ABC
17023465;;F;33;CHILENO;;Millenial;PUDAHUEL                      ;METROPOLITANA;19980;2;1;2;1;19980;0;0;0;AUTO RADIO CONTROL 3 RUEDAS;MERCADO ABC
15608950;;M;37;CHILENO;;Millenial;MAIPU                         ;METROPOLITANA;19980;3;1;3;1;19980;0;0;0;BUGGIE RADIO CONTROL 111086;MERCADO ABC
16835930;;M;34;CHILENO;;Millenial;LINARES                       ;MAULE;54480;2;1;2;1;54480;0;0;0;Coche Twister Gri5224SXG;MERCADO ABC
9581420;;M;56;CHILENO;;Boomers;PROVIDENCIA                   ;METROPOLITANA;28980;2;1;2;1;28980;0;0;0;Set Mancuernas Con Barra Ajustable 10Kg K-FIT;MERCADO ABC
15173232;;F;40;CHILENO;;X;CONCEPCION                    ;BIO BIO;175840;2;1;2;1;175840;0;0;0;BAR SINTRA - WENGUE;MERCADO ABC
10992041;;F;49;CHILENO;;X;COPIAPO                       ;ATACAMA;28485;2;2;0;0;0;2;2;28485;Simon Microserie;MERCADO ABC
13912342;;F;42;CHILENO;;X;N/D;N/D;169960;3;1;3;1;169960;0;0;0;BAR SYRAH - WENGUE;MERCADO ABC
10719871;;M;55;CHILENO;;Boomers;RENCA                         ;METROPOLITANA;83970;3;1;3;1;83970;0;0;0;Silla Auto Tauru8280Azul;MERCADO ABC
11754301;;F;50;CHILENO;;X;QUINTA NORMAL;METROPOLITANA;26990;2;1;2;1;26990;0;0;0;CORREPASILLO ROJO CON TOLDO Y LUCES;MERCADO ABC
11845246;;F;51;CHILENO;;Silencioso;PROVIDENCIA                   ;METROPOLITANA;16980;2;1;2;1;16980;0;0;0;BATERIA INFANTIL C LUCES Y SONIDOS;MERCADO ABC
18557113;;M;28;CHILENO;;Millenial;"";"";18990;1;1;0;0;0;1;1;18990;BATMAN REALIDAD VIRTUAL 765 FYF;MERCADO ABC
14040047;;F;40;CHILENO;;X;PUERTO MONTT;LOS LAGOS;69540;2;1;2;1;69540;0;0;0;S.AUTO ORBIT 1029 ROSA;MERCADO ABC
17857523;;M;31;CHILENO;;Millenial;PROVIDENCIA                   ;METROPOLITANA;46980;2;1;2;1;46980;0;0;0;Set Mancuernas Con Barra Ajustable 20Kg K-FIT;MERCADO ABC
17029483;Soltero;M;33;CHILENO;;Millenial;PROVIDENCIA                   ;METROPOLITANA;113980;2;1;2;1;113980;0;0;0;Plataforma Vibratoria FullFit 2000 Bluetooth;MERCADO ABC
20029201;;F;23;CHILENO;;Z;PROVIDENCIA                   ;METROPOLITANA;670820;14;3;14;3;670820;0;0;0;OPTIMIZADOR BANO BATH 26 - BLANCO;MERCADO ABC
19062445;;F;27;CHILENO;;Z;PROVIDENCIA                   ;METROPOLITANA;319980;2;1;2;1;319980;0;0;0;Trotadora Electrica Baldini 1,5HP;MERCADO ABC
10668135;;F;54;CHILENO;;X;ANTOFAGASTA                   ;ANTOFAGASTA;99640;2;1;2;1;99640;0;0;0;MESA COMEDOR TORINO 1 - HABANO;MERCADO ABC
17825196;;M;31;CHILENO;;Millenial;CONSTITUCION                  ;MAULE;181980;2;1;2;1;181980;0;0;0;Bicicleta De Spinning Strong Pro-Fit K-FIT;MERCADO ABC
16562079;;F;35;CHILENO;;Millenial;PEDRO AGUIRRE CERDA           ;METROPOLITANA;351940;4;1;4;1;351940;0;0;0;Bicicleta De Spinning Strong Pro-Fit K-FIT;MERCADO ABC
26494024;;M;36;VENEZOLANO;;Extranjero;N/D;N/D;195980;2;1;2;1;195980;0;0;0;Bicicleta De Spinning Boonen K-FIT;MERCADO ABC
17397504;Soltero;F;32;CHILENO;NUTRICIONISTA;Millenial;PROVIDENCIA                   ;METROPOLITANA;108980;2;1;2;1;108980;0;0;0;Bateria de Cocina Ollas 10 Piezas Ceramica Berri;MERCADO ABC
16838840;;M;34;CHILENO;;Millenial;PUENTE ALTO                   ;METROPOLITANA;309980;2;1;2;1;309980;0;0;0;Trotadora Electrica Baldini 1,5HP;MERCADO ABC
8335092;;M;62;CHILENO;;Boomers;TEMUCO                        ;ARAUCANIA;109980;2;1;2;1;109980;0;0;0;MUEBLE DE COCINA KITCHEN 90 - BLANCO / WENGUE;MERCADO ABC
19634359;;M;25;CHILENO;;Silencioso;PROVIDENCIA                   ;METROPOLITANA;58980;2;1;2;1;58980;0;0;0;TECLADO NU003 61 TECLAS NEGRO POLIFONICO;MERCADO ABC
18032377;;F;31;CHILENO;;Millenial;PROVIDENCIA                   ;METROPOLITANA;909600;4;1;4;1;909600;0;0;0;SOFA MIRA 3 CPO CUE BITONO RSN;MERCADO ABC
16732403;;F;45;CHILENO;;X;IQUIQUE                       ;TARAPACA;0;0;0;0;0;0;0;0;0;SOFA MIRA 2 CPO BITONO RSN;MERCADO ABC
17136906;Soltero;M;33;CHILENO;;Millenial;PROVIDENCIA                   ;METROPOLITANA;0;0;0;0;0;0;0;0;0;CAMARA DE ACCION HDR-AS300R SONY;MERCADO ABC
15402249;;F;39;CHILENO;;X;TOCOPILLA                     ;ANTOFAGASTA;0;0;0;0;0;0;0;0;0;TECLADO MONOFONICO NINO;MERCADO ABC
16112890;;M;36;CHILENO;;Millenial;OSORNO                        ;LOS LAGOS;0;0;0;0;0;0;0;0;0;CAMA ACOLCHADA MASCOTA T/S;MERCADO ABC
12254629;;M;50;CHILENO;;X;RENCA                         ;METROPOLITANA;0;0;0;0;0;0;0;0;0;Sarten Freidora Cuadrada Con Tapa 28 cm Copper;MERCADO ABC
15623336;;F;38;CHILENO;;X;CERRILLOS                     ;METROPOLITANA;0;0;0;0;0;0;0;0;0;Casa Para Perro Xl Con Ventilacion Coolpets 103.;MERCADO ABC
18164197;Soltero;F;30;CHILENO;TECNICO EN ADMINISTRACION DE EMPRESAS;Silencioso;PROVIDENCIA                   ;METROPOLITANA;0;0;0;0;0;0;0;0;0;TECLADO MINI SA-47AH2;MERCADO ABC
17683137;;F;31;CHILENO;;Millenial;N/D;N/D;0;0;0;0;0;0;0;0;0;TRICICLO METALICO YELLOW;MERCADO ABC
12640805;;F;48;CHILENO;;X;MAIPU;METROPOLITANA;0;0;0;0;0;0;0;0;0;CORREPASILLO AUTO AZUL;MERCADO ABC
17640570;Soltero;F;32;CHILENO;;Millenial;PROVIDENCIA                   ;METROPOLITANA;0;0;0;0;0;0;0;0;0;CORREPASILLO CARITA PINK;MERCADO ABC
18176630;;F;29;CHILENO;;Millenial;OSORNO                        ;LOS LAGOS;0;0;0;0;0;0;0;0;0;SILLA COMEDOR TERRAZA;MERCADO ABC
15257383;Casado;F;40;CHILENO;CIRUJANO DENTISTA;X;PROVIDENCIA                   ;METROPOLITANA;0;0;0;0;0;0;0;0;0;TECLADO CT-S100 61 TECLAS CON TRANSFORMADOR;MERCADO ABC
16881769;;F;34;CHILENO;;Millenial;PROVIDENCIA                   ;METROPOLITANA;0;0;0;0;0;0;0;0;0;BERGER SAVERNE TELA CHEX CAFE RSN;MERCADO ABC
8033369;;F;64;CHILENO;;Boomers;ARAUCO                        ;BIO BIO;0;0;0;0;0;0;0;0;0;PACK 2 ALMOHADAS AFAMILY 50X70;MERCADO ABC
17943658;Soltero;M;31;CHILENO;;Millenial;PROVIDENCIA                   ;METROPOLITANA;0;0;0;0;0;0;0;0;0;TECLADO CT-S200BKC2 ESTANDAR CASIOTONE C/ TRANSF;MERCADO ABC
16612158;Casado;F;33;CHILENO;PROFESOR;Millenial;PROVIDENCIA                   ;METROPOLITANA;0;0;0;0;0;0;0;0;0;SILLA COMEDOR TERRAZA;MERCADO ABC
7768952;;F;68;CHILENO;;Silencioso;SAN FERNANDO                  ;L.G.B.OÂ´HIGGINS;0;0;0;0;0;0;0;0;0;Colchoneta Outback Eva Aluminizada;MERCADO ABC
19477691;;F;25;CHILENO;;Z;PROVIDENCIA                   ;METROPOLITANA;0;0;0;0;0;0;0;0;0;CORREPASILLO AUTO ROJO;MERCADO ABC
17433004;;F;32;CHILENO;;Millenial;IQUIQUE                       ;TARAPACA;0;0;0;0;0;0;0;0;0;PACK FRAZADAS STONE 2P;MERCADO ABC
12904311;;M;47;CHILENO;;X;PROVIDENCIA                   ;METROPOLITANA;0;0;0;0;0;0;0;0;0;SILLA METALICA ACERO;MERCADO ABC
16866701;;M;33;CHILENO;;Millenial;PROVIDENCIA                   ;METROPOLITANA;0;0;0;0;0;0;0;0;0;ENCHANTIMALS SURTIDO MUNECAS BASICAS;MERCADO ABC
11477052;Casado;M;53;CHILENO;INGENIERO;X;PROVIDENCIA                   ;METROPOLITANA;0;0;0;0;0;0;0;0;0;CAMARA DIGITAL ASD-DCA1010 AZUL;MERCADO ABC
7604663;;F;55;CHILENO;;Boomers;PROVIDENCIA                   ;METROPOLITANA;0;0;0;0;0;0;0;0;0;QUITASOL LATERAL D293CMxH265CM;MERCADO ABC
13710348;;F;43;CHILENO;;X;PROVIDENCIA                   ;METROPOLITANA;0;0;0;0;0;0;0;0;0;JUEGO DE PESCA;MERCADO ABC
26480662;;M;32;VENEZOLANO;;Extranjero;N/D;N/D;0;0;0;0;0;0;0;0;0;TECLADO CTK-2550K2 ESTANDAR C/TRANSFORMADOR;MERCADO ABC
9366199;;F;63;CHILENO;;Boomers;PROVIDENCIA                   ;METROPOLITANA;0;0;0;0;0;0;0;0;0;TETERA NOVA BOLOCCO 3 LTS.;MERCADO ABC
16712648;;F;30;CHILENO;;Millenial;ARICA                         ;ARICA Y PARINACOTA;0;0;0;0;0;0;0;0;0;SURT. TOY STORY FIGURAS BASICAS PELICULA;MERCADO ABC
16596806;;M;35;CHILENO;;Millenial;PROVIDENCIA                   ;METROPOLITANA;0;0;0;0;0;0;0;0;0;CAJA BLOQUES 90 PCS VERDE;MERCADO ABC
16076345;;F;36;CHILENO;;Millenial;PROVIDENCIA                   ;METROPOLITANA;0;0;0;0;0;0;0;0;0;COJIN CORAZONES-FLECOS 30X50 CM;MERCADO ABC
9413308;;M;59;CHILENO;;Boomers;LA SERENA                     ;COQUIMBO;0;0;0;0;0;0;0;0;0;PUF GRECO METALICO BEIGE;MERCADO ABC
19867377;;F;23;CHILENO;;Z;PROVIDENCIA                   ;METROPOLITANA;0;0;0;0;0;0;0;0;0;SET ESTACIONAMIENTO 5 NIVELES;MERCADO ABC
14185390;;F;41;CHILENO;;X;MELIPILLA                     ;METROPOLITANA;0;0;0;0;0;0;0;0;0;PERGOLA 295x295x265CM;MERCADO ABC
8440770;;F;61;CHILENO;;Boomers;RENCA                         ;METROPOLITANA;0;0;0;0;0;0;0;0;0;BANDEJA PARA HORNO 24x24 CM FERRO ROJO;MERCADO ABC
11010288;Casado;F;57;CHILENO;;Boomers;RENCA                         ;METROPOLITANA;0;0;0;0;0;0;0;0;0;ESTACIONAMIENTO EVOLUTION PRO 5 PISOS;MERCADO ABC
12019167;;F;46;CHILENO;;X;RENCA                         ;METROPOLITANA;0;0;0;0;0;0;0;0;0;CUCHILLERIA 24P ACERO AUSTRIA;MERCADO ABC
7312753;Casado;F;67;CHILENO;TEC DISENADOR VESTUARIO;Silencioso;MAIPU                         ;METROPOLITANA;0;0;0;0;0;0;0;0;0;QUILT REVERSIBLE ONDAS C/ FLECOS 2P;MERCADO ABC
17766165;;F;31;CHILENO;;Millenial;PROVIDENCIA                   ;METROPOLITANA;0;0;0;0;0;0;0;0;0;TECLADO MINI SA-77AH2;MERCADO ABC
13465519;;M;44;CHILENO;;X;PROVIDENCIA                   ;METROPOLITANA;0;0;0;0;0;0;0;0;0;PARRILLA A GAS 2 QUEMADORES;MERCADO ABC
19160644;;F;27;CHILENO;;Z;PROVIDENCIA                   ;METROPOLITANA;0;0;0;0;0;0;0;0;0;QUILT REVERSIBLE ONDAS C/ FLECOS 2P;MERCADO ABC
13001983;;F;45;CHILENO;;X;N/D;N/D;0;0;0;0;0;0;0;0;0;BATERIA ACERO 5P;MERCADO ABC
8837890;Casado;M;62;CHILENO;;Boomers;CONSTITUCION                  ;MAULE;0;0;0;0;0;0;0;0;0;PLUMON BICOLOR ROUGE 1,5P;MERCADO ABC
8496273;Soltero;F;63;CHILENO;;Boomers;RENCA                         ;METROPOLITANA;259130;3;1;0;0;0;3;1;259130;Secadora Electrica SEM101BDBY Blanca 10 KG;LINEA BLANCA
18320126;;F;30;CHILENO;;Millenial;"";"";736950;5;3;2;1;366980;3;2;369970;Cocina CMC20AXX-1 4P Inox;LINEA BLANCA
15808508;;F;38;CHILENO;;Millenial;N/D;N/D;1185580;14;8;12;6;1160600;2;2;24980;Lavadora Secadora MLSF-13510SC01I 13,5Kg/10Kg Gr;LINEA BLANCA
25452074;;F;42;PERUANO;;Extranjero;PROVIDENCIA                   ;METROPOLITANA;1129980;8;3;0;0;0;8;3;1129980;Lavadora WT16DSBP 16Kg Silver;LINEA BLANCA
19796950;;F;25;CHILENO;;Z;CHILLAN;BIO-BIO;168980;2;1;2;1;168980;0;0;0;Refrigerador 167Lts Frio Directo 1700-S;LINEA BLANCA
9995101;;M;58;CHILENO;;Boomers;CONSTITUCION                  ;MAULE;396970;3;2;0;0;0;3;2;396970;Refrigerador 290LTS No Frost RMB302PXLRS0;LINEA BLANCA
18894221;Soltero;F;27;CHILENO;;Z;VILLA ALEGRE                  ;MAULE;415950;5;2;2;1;186980;3;1;228970;Freezer 142Lts MFH-1430B186C Horizontal;LINEA BLANCA
11756357;;M;51;CHILENO;;X;MELIPILLA                     ;METROPOLITANA;294200;3;1;0;0;0;3;1;294200;Lavadora Efficace SZG 17,5Kg Silver;LINEA BLANCA
7026371;;F;72;CHILENO;;Silencioso;COPIAPO                       ;ATACAMA;294200;3;1;0;0;0;3;1;294200;REFRIGERADOR TOP MOUNT NO FROST RD-32WRD 246L;LINEA BLANCA
13355228;;F;46;CHILENO;;X;TALCA                         ;MAULE;196980;2;1;0;0;0;2;1;196980;Lavadora 9,5Kg BZG Blanca;LINEA BLANCA
12325875;;F;49;CHILENO;;Millenial;N/D;N/D;211980;2;1;0;0;0;2;1;211980;Refrigerador 180Lts BF Frio Directo MDRB275FGF42;LINEA BLANCA
8227066;;M;62;CHILENO;;Boomers;PUNTA ARENAS                  ;MAGALLANES;319990;3;1;0;0;0;3;1;319990;Refrigerador 241Lts BF Frio Directo Nordik 415;LINEA BLANCA
15880643;;M;46;CHILENO;;X;LA PINTANA                    ;METROPOLITANA;287980;2;2;0;0;0;2;2;287980;Lavadora Efficace SZG 17,5Kg Silver;LINEA BLANCA
13635034;;F;43;CHILENO;;X;QUILPUE                       ;VALPARAISO;216970;3;2;0;0;0;3;2;216970;Lavadora 9,5Kg BZG Blanca;LINEA BLANCA
19973651;;F;23;CHILENO;;Z;N/D;N/D;942700;11;6;0;0;0;11;6;942700;Refrigerador 262Lts No Frost MRFI-2760S349RW-DA;LINEA BLANCA
4299263;;M;82;CHILENO;;Silencioso;N/D;N/D;824310;9;4;2;1;20980;7;3;803330;Refrigerador 251Lts No Frost Altus 1250;LINEA BLANCA
17544330;;F;32;CHILENO;;Millenial;LA PINTANA                    ;METROPOLITANA;249990;1;1;0;0;0;1;1;249990;Lavadora Efficace SZG 17,5Kg Silver;LINEA BLANCA
10799003;;M;55;CHILENO;;Boomers;MAULE                         ;MAULE;349990;1;1;0;0;0;1;1;349990;Cocina MCG-5QI30NS 5P;LINEA BLANCA
16783918;;M;34;CHILENO;;Millenial;CHILLAN                       ;BIO BIO;565770;9;5;0;0;0;9;5;565770;Lavadora MLS-160BSC03T 16Kg Blanca;LINEA BLANCA
12391184;;M;48;CHILENO;;X;QUEMCHI                       ;LOS LAGOS;906510;8;3;0;0;0;8;3;906510;Cocina MCG-5QI30NS 5P;LINEA BLANCA
17673957;Soltero;M;31;CHILENO;INGENIERO CIVIL QUIMICO;Silencioso;PROVIDENCIA                   ;METROPOLITANA;209980;2;1;2;1;209980;0;0;0;Lavadora Efficace BZG 11,5Kg Blanca;LINEA BLANCA
10765094;;F;57;CHILENO;;Boomers;CURICO                        ;MAULE;192140;2;1;0;0;0;2;1;192140;Secadora 7Kg 7D BZG Ventilacion Blanca;LINEA BLANCA
7398031;;F;67;CHILENO;;Boomers;LA LIGUA                      ;VALPARAISO;892520;7;4;0;0;0;7;4;892520;Calefon ionizado 7 litros GL AS0;LINEA BLANCA
18835553;;M;28;CHILENO;;Millenial;"";"";300980;2;1;0;0;0;2;1;300980;Refrigerador 244Lts Frio Directo Progress 3100;LINEA BLANCA
15553453;;F;34;CHILENO;;Millenial;N/D;N/D;329980;2;1;2;1;329980;0;0;0;Lavadora Premium Care 20SZ 20Kg Silver;LINEA BLANCA
8460649;;F;63;CHILENO;;Boomers;PADRE HURTADO                 ;METROPOLITANA;461770;4;2;0;0;0;4;2;461770;Refrigerador 255Lts No Frost RT25FARADS8/ZS;LINEA BLANCA
17639082;;M;31;CHILENO;;Millenial;PUERTO VARAS                  ;LOS LAGOS;59970;3;2;1;1;34990;2;1;24980;CANASTO TEXTURA RATAN TAPA ABATIBLE;LINEA BLANCA
15873367;;F;37;CHILENO;;Millenial;SAN ANTONIO                   ;VALPARAISO;219990;1;1;0;0;0;1;1;219990;Cocina CH-7400 4P;LINEA BLANCA
12747569;;F;47;CHILENO;;X;VALDIVIA                      ;LOS RIOS;870450;7;3;2;1;179980;5;2;690470;Lavadora WA80H4200SW1ZS 8Kg Blanca;LINEA BLANCA
12364975;Casado;F;48;CHILENO;;X;RENCA                         ;METROPOLITANA;123980;2;1;2;1;123980;0;0;0;Calefont 8Lts GL Essenetial ECO;LINEA BLANCA
8223355;;F;64;CHILENO;;Boomers;SAN BERNARDO                  ;METROPOLITANA;342970;3;2;0;0;0;3;2;342970;Lavadora Premium Care 20SZ 20Kg Silver;LINEA BLANCA
12730726;Casado;M;47;CHILENO;;X;PROVIDENCIA                   ;METROPOLITANA;257170;2;1;0;0;0;2;1;257170;Lavadora 9,5Kg BZG Blanca;LINEA BLANCA
21061892;;F;20;CHILENO;;Extranjero;PROVIDENCIA                   ;METROPOLITANA;739970;5;5;0;0;0;5;5;739970;Cocina MCG-5QI30NS 5P;LINEA BLANCA
7365011;;M;66;CHILENO;;Boomers;RECOLETA                      ;METROPOLITANA;277110;5;3;0;0;0;5;3;277110;Cocina CH-7400 4P;LINEA BLANCA
15503628;;F;39;CHILENO;;X;RENCA                         ;METROPOLITANA;411980;2;1;2;1;411980;0;0;0;Refrigerador Side by side Multidoor DM64S;LINEA BLANCA
15125891;Soltero;M;39;CHILENO;ARQUITECTO;X;PROVIDENCIA                   ;METROPOLITANA;211970;3;2;3;2;211970;0;0;0;Freezer 145 Lts FDHM150BY0 Horizontal;LINEA BLANCA
18212215;;M;30;CHILENO;;Millenial;MELIPILLA                     ;METROPOLITANA;414560;5;1;0;0;0;5;1;414560;Lavadora Efficace SZG 19,5Kg Silver;LINEA BLANCA
9930945;;M;57;CHILENO;;Boomers;LEBU                          ;BIO BIO;1608740;15;9;0;0;0;15;9;1608740;Refrigerador 244Lts Frio Directo Progress 3100;LINEA BLANCA
7489744;;F;67;CHILENO;;Boomers;N/D;N/D;1130930;7;4;0;0;0;7;4;1130930;Secadora 9 Kg 9D BZG Ventilacion Blanca;LINEA BLANCA
6967546;;F;64;CHILENO;;Boomers;BUIN                          ;METROPOLITANA;569960;4;3;0;0;0;4;3;569960;Lavadora MLS-190GC03N 19Kg Gris;LINEA BLANCA
4968477;;M;80;CHILENO;;Silencioso;TILTIL                        ;METROPOLITANA;24024598;149;111;0;0;0;149;111;24024598;Secadora 7Kg 7D BZG Ventilacion Blanca;LINEA BLANCA
12923373;;F;47;CHILENO;;X;CORONEL                       ;BIO BIO;1073929;9;6;0;0;0;9;6;1073929;Cocina CH-9500 NG 4P;LINEA BLANCA
6844025;;F;70;CHILENO;;Silencioso;TALCA                         ;MAULE;428960;4;2;0;0;0;4;2;428960;Freezer Horizontal M 150 142Lts;LINEA BLANCA
22696339;;F;35;EXTRANJERO - NO INFORMA NACIONALIDAD;;Extranjero;PROVIDENCIA                   ;METROPOLITANA;294160;3;1;0;0;0;3;1;294160;Secadora Electrica SEM101BDBY Blanca 10 KG;LINEA BLANCA
12502722;;F;48;CHILENO;;X;LONGAVI                       ;MAULE;734580;9;3;0;0;0;9;3;734580;Cocina CH-9400 4P SILVER;LINEA BLANCA
11895884;;M;51;CHILENO;;X;QUILICURA                     ;METROPOLITANA;837900;10;4;0;0;0;10;4;837900;Cocina F 2608 T 4P Reflex Silver;LINEA BLANCA
11796452;;F;51;CHILENO;;X;CANETE                        ;BIO BIO;679970;3;4;0;0;0;3;4;679970;Refrigerador RB27N4020S8/ZS BF 257Lts;LINEA BLANCA
15229443;;M;39;CHILENO;;X;LUMACO                        ;ARAUCANIA;552110;6;2;0;0;0;6;2;552110;Secadora 7Kg 7D BZG Ventilacion Blanca;LINEA BLANCA
7812292;;M;62;CHILENO;;Boomers;PUENTE ALTO                   ;METROPOLITANA;1205100;11;6;0;0;0;11;6;1205100;Refrigerador 251Lts No Frost Altus 1250;LINEA BLANCA
5648588;;F;74;CHILENO;;Silencioso;COIHAIQUE                     ;AYSEN;405760;5;3;0;0;0;5;3;405760;Lavadora WT13WSBP 13Kg Blanca;LINEA BLANCA
6044660;;M;73;CHILENO;;Silencioso;RENCA                         ;METROPOLITANA;329980;2;2;0;0;0;2;2;329980;Cocina CMC20AXX-1 4P Inox;LINEA BLANCA
9821410;;M;58;CHILENO;;Boomers;TALCA                         ;MAULE;302573;3;3;0;0;0;3;3;302573;Freezer Horizontal M100 99Lts;LINEA BLANCA
26516916;;M;41;EXTRANJERO - NO INFORMA NACIONALIDAD;;Extranjero;SANTIAGO                      ;METROPOLITANA;169980;2;1;0;0;0;2;1;169980;Lavadora LMA0920WGCL0 9,5Kg Gris;LINEA BLANCA
7486345;Casado;F;69;CHILENO;;Silencioso;PROVIDENCIA                   ;METROPOLITANA;372980;2;1;0;0;0;2;1;372980;Cocina F 2608 T 4P Reflex Silver;LINEA BLANCA
22379603;;F;65;PERUANO;;Extranjero;N/D;N/D;404070;4;2;0;0;0;4;2;404070;Lavadora Efficace SZG 19,5Kg Silver;LINEA BLANCA
17145561;;F;33;CHILENO;;Millenial;N/D;N/D;459960;4;3;2;1;161980;2;2;297980;Lavadora Efficace SZG 17,5Kg Silver;LINEA BLANCA
6449815;;F;69;CHILENO;;Silencioso;BUIN                          ;METROPOLITANA;359970;3;2;0;0;0;3;2;359970;Lavadora Efficace SZG 17,5Kg Silver;LINEA BLANCA
7480931;;F;68;CHILENO;;Boomers;PROVIDENCIA                   ;N/D;340980;2;1;0;0;0;2;1;340980;Cocina MCG-5QI30NS 5P;LINEA BLANCA
7491249;;F;68;CHILENO;;Silencioso;CANETE                        ;BIO BIO;527190;7;5;0;0;0;7;5;527190;Refrigerador 300Lts No Frost RT29K500JS8/ZS;LINEA BLANCA
5954930;Casado;M;73;CHILENO;;Silencioso;PROVIDENCIA                   ;METROPOLITANA;144390;2;1;0;0;0;2;1;144390;CENTRIFUGA C-752;LINEA BLANCA
6802028;;M;66;CHILENO;;Boomers;LA CISTERNA                   ;METROPOLITANA;295960;4;2;0;0;0;4;2;295960;Secadora 9 Kg 9D BZG Ventilacion Blanca;LINEA BLANCA
9152279;;F;60;CHILENO;;Boomers;PROVIDENCIA                   ;METROPOLITANA;494960;4;2;4;2;494960;0;0;0;Lavadora Secadora MLSF-13510SC01I 13,5Kg/10Kg Gr;LINEA BLANCA
7111899;Casado;F;70;CHILENO;;Silencioso;BUIN                          ;METROPOLITANA;269980;2;1;0;0;0;2;1;269980;Lavadora Efficace SZG 17,5Kg Silver;LINEA BLANCA
14071916;;F;41;CHILENO;;X;LEBU                          ;BIO BIO;835320;7;4;0;0;0;7;4;835320;Cocina CH-7400 4P;LINEA BLANCA
15476408;;M;39;CHILENO;;X;N/D;N/D;305970;3;2;0;0;0;3;2;305970;REFRIGERADOR BOTTOM FREEZER FD RD-35DCD 262L;LINEA BLANCA
12122960;;F;47;CHILENO;;X;QUELLON                       ;LOS LAGOS;595960;4;3;0;0;0;4;3;595960;Secadora 9 Kg 9D BZG Ventilacion Blanca;LINEA BLANCA
8915971;;M;62;CHILENO;;Boomers;N/D;N/D;179990;1;1;0;0;0;1;1;179990;Cocina CH-7400 4P;LINEA BLANCA
21185640;;M;43;PERUANO;;Extranjero;"";"";189980;2;1;2;1;189980;0;0;0;Secadora Ropa MD100A90/W 9Kg Ventilacion Blanca;LINEA BLANCA
16511077;;F;35;CHILENO;;Millenial;N/D;N/D;1237190;12;8;0;0;0;12;8;1237190;Cocina MCG-5QI30NS 5P;LINEA BLANCA
8299972;;F;49;CHILENO;;X;COIHAIQUE                     ;AYSEN;339970;3;3;0;0;0;3;3;339970;Lavadora WA90H4400SW1ZS 9Kg Blanca;LINEA BLANCA
7245058;;F;64;CHILENO;;Boomers;PARRAL                        ;MAULE;570210;3;2;0;0;0;3;2;570210;Cocina F 5500 T 5P Reflex Silver;LINEA BLANCA
26793183;;F;43;VENEZOLANO;;Extranjero;PROVIDENCIA                   ;METROPOLITANA;257950;5;2;2;1;236980;3;1;20970;Refrigerador MDRT385MTF46 266 Lts No Frost;LINEA BLANCA
9926603;;F;59;CHILENO;;Boomers;QUILLOTA                      ;VALPARAISO;809950;5;3;0;0;0;5;3;809950;Cocina F 2608 T 4P Reflex Silver;LINEA BLANCA
7672394;;F;65;CHILENO;;Boomers;PUDAHUEL                      ;METROPOLITANA;924410;12;5;0;0;0;12;5;924410;Secadora Ropa MD100A90/W 9Kg Ventilacion Blanca;LINEA BLANCA
5282025;;F;73;CHILENO;;Silencioso;ARICA                         ;ARICA Y PARINACOTA;668040;5;3;0;0;0;5;3;668040;Lavadora 9 Kg Carga Superior Blanca;LINEA BLANCA
11973638;;F;50;CHILENO;;X;PAINE                         ;METROPOLITANA;910930;7;3;0;0;0;7;3;910930;Lavadora Premium Care 20SZ 20Kg Silver;LINEA BLANCA
16851729;;M;34;CHILENO;;Millenial;RENCA                         ;METROPOLITANA;430980;2;1;2;1;430980;0;0;0;Lavadora Secadora MLSF-13510SC01I 13,5Kg/10Kg Gr;LINEA BLANCA
12769607;;F;47;CHILENO;;X;SAN BERNARDO                  ;METROPOLITANA;829820;6;3;3;1;339960;3;2;489860;Lavadora Efficace SZG 17,5Kg Silver;LINEA BLANCA
26299415;Soltero;F;36;NO INFORMA NACIONALIDAD;;Extranjero;TALCAHUANO;BIO-BIO;329990;2;1;2;1;329990;0;0;0;Lavadora Premium Care 20SZ 20Kg Silver;LINEA BLANCA
5802409;;F;73;CHILENO;;Silencioso;EL BOSQUE                     ;METROPOLITANA;444860;4;1;0;0;0;4;1;444860;Lavadora MLS-160BSC03T 16Kg Blanca;LINEA BLANCA
4477977;;F;79;CHILENO;;Silencioso;TALCA                         ;MAULE;2236300;16;3;0;0;0;16;3;2236300;Refrigerador 251Lts No Frost Altus 1250;LINEA BLANCA
12961213;;M;45;CHILENO;;X;N/D;N/D;1015860;13;7;0;0;0;13;7;1015860;Lavadora MLS-090GE04N 9Kg Gris;LINEA BLANCA
10048526;;F;54;CHILENO;;Boomers;RECOLETA                      ;METROPOLITANA;269792;5;2;0;0;0;5;2;269792;Secadora Ropa MD100A90/W 9Kg Ventilacion Blanca;LINEA BLANCA
12200242;;F;50;CHILENO;;X;VALDIVIA                      ;LOS LAGOS;333790;4;2;0;0;0;4;2;333790;Cocina CMC20AXX-1 4P Inox;LINEA BLANCA
9815234;;M;61;CHILENO;;Boomers;SAN RAFAEL                    ;MAULE;325340;2;1;0;0;0;2;1;325340;Lavadora MLS-160BSC03T 16Kg Blanca;LINEA BLANCA
16857043;;F;34;CHILENO;;Millenial;"";"";475950;5;4;0;0;0;5;4;475950;Lavadora Efficace SZG 17,5Kg Silver;LINEA BLANCA
9238528;;M;60;CHILENO;;Boomers;COLLIPULLI;ARAUCANIA;216980;2;1;2;1;216980;0;0;0;Refrigerador 167Lts MRFI-1700R234RN F.Direc Rojo;LINEA BLANCA
18331340;Soltero;F;28;CHILENO;;Millenial;SANTIAGO;METROPOLITANA;149980;2;1;2;1;149980;0;0;0;Lavadora MLS-090GE04N 9Kg Gris;LINEA BLANCA
16152594;;F;39;CHILENO;;X;N/D;N/D;649980;2;1;0;0;0;2;1;649980;Refrigerador 525Lts Side by Side SFX500;LINEA BLANCA
18103836;;M;29;CHILENO;;Millenial;"";"";405980;2;2;0;0;0;2;2;405980;Refrigerador 303Lts BF Frio Directo Nordik 480;LINEA BLANCA
27060795;;F;30;VENEZOLANO;;Extranjero;PROVIDENCIA                   ;METROPOLITANA;214980;2;2;1;1;179990;1;1;34990;Lavadora WA90H4400SW1ZS 9Kg Blanca;LINEA BLANCA
12650001;;F;47;CHILENO;;X;CONCHALI                      ;METROPOLITANA;369950;5;6;5;6;369950;0;0;0;Lavadora MLS-090GE04N 9Kg Gris;LINEA BLANCA
15198089;;F;39;CHILENO;;X;CURANILAHUE                   ;BIO BIO;728290;5;4;0;0;0;5;4;728290;Lavadora WT16DSBP 16Kg Silver;LINEA BLANCA
17848332;;F;31;CHILENO;;Millenial;PROVIDENCIA                   ;METROPOLITANA;133980;2;1;2;1;133980;0;0;0;Calefon ionizado 7 litros GL AS0;LINEA BLANCA
19860843;;M;24;CHILENO;;Z;DONIHUE                       ;L.G.B.OÂ´HIGGINS;1095940;6;4;0;0;0;6;4;1095940;Secadora Ropa MD100A90/W 9Kg Ventilacion Blanca;LINEA BLANCA
15886326;;F;37;CHILENO;;Millenial;COQUIMBO                      ;COQUIMBO;297960;4;5;1;3;16990;3;2;280970;Cocina F 2608 T 4P Reflex Silver;LINEA BLANCA
9759859;;M;59;CHILENO;;Boomers;QUELLON                       ;LOS LAGOS;630500;5;2;5;2;630500;0;0;0;Lavadora MLS-090GE04N 9Kg Gris;LINEA BLANCA
9431248;Casado;M;54;CHILENO;;X;RENCA                         ;METROPOLITANA;178980;2;1;2;1;178980;0;0;0;Refrigerador 180Lts BF Frio Directo MDRB275FGF42;LINEA BLANCA
8090600;;M;63;CHILENO;;Boomers;RENGO                         ;L.G.B.OÂ´HIGGINS;257870;3;2;0;0;0;3;2;257870;Lavadora WA80H4200SW1ZS 8Kg Blanca;LINEA BLANCA
18181040;;F;32;CHILENO;;Millenial;LOS ANGELES                   ;BIO BIO;483930;8;4;0;0;0;8;4;483930;Secadora Electrica SEM101BDBY Blanca 10 KG;LINEA BLANCA
12460261;;M;49;CHILENO;;X;RANCAGUA                      ;L.G.B.OÂ´HIGGINS;312970;3;3;0;0;0;3;3;312970;Lavadora Efficace SZG 17,5Kg Silver;LINEA BLANCA
15567624;;M;36;CHILENO;;Millenial;COLBUN                        ;MAULE;129990;1;1;0;0;0;1;1;129990;Calefont 10Lts GL Essenetial ECO;LINEA BLANCA
20202585;;M;22;CHILENO;;Z;PROVIDENCIA                   ;METROPOLITANA;401780;8;4;8;4;401780;0;0;0;Lavadora MLS-140GSC03T 14Kg Gris;LINEA BLANCA
7665447;;F;60;CHILENO;;Boomers;QUILPUE                       ;VALPARAISO;333934;6;2;0;0;0;6;2;333934;Refrigerador 260Lts BF Frio Direc MRFI2660SR346W;LINEA BLANCA
10423282;;M;56;CHILENO;;Boomers;CANETE                        ;BIO BIO;550960;4;4;0;0;0;4;4;550960;Lavadora Superior WA17T6260BY/ZS 17Kg;LINEA BLANCA
8752951;;F;63;CHILENO;;Boomers;CURICO                        ;MAULE;640800;9;5;0;0;0;9;5;640800;Cocina MCG-4QI24NS 4P;LINEA BLANCA
17094424;;F;33;CHILENO;;Millenial;ALTO HOSPICIO;TARAPACA;430360;4;2;2;1;319980;2;1;110380;Lavadora Brilliant SG 15Kg Silver;LINEA BLANCA
19451218;;F;25;CHILENO;;Z;CONCEPCION                    ;BIO BIO;549960;4;2;4;2;549960;0;0;0;Refrigerador 180Lts BF Frio Directo MDRB275FGF42;LINEA BLANCA
8599017;;F;62;CHILENO;;Boomers;VALLENAR;ATACAMA;1678950;10;6;0;0;0;10;6;1678950;Refrigerador 527Lts Side by Side MRSBS5300G689WE;LINEA BLANCA
19440175;;M;25;CHILENO;;Z;PROVIDENCIA                   ;METROPOLITANA;499970;3;2;3;2;499970;0;0;0;Refrigerador MDRT414FGE02 294 Lts Frio Directo;LINEA BLANCA
8788327;;M;60;CHILENO;;Boomers;COIHAIQUE                     ;AYSEN;998600;11;6;0;0;0;11;6;998600;Lavadora WT16DSBP 16Kg Silver;LINEA BLANCA
6253810;;F;68;CHILENO;;Silencioso;SAN FERNANDO                  ;L.G.B.OÂ´HIGGINS;205110;4;2;0;0;0;4;2;205110;CENTRIFUGA C-752;LINEA BLANCA
6650617;;F;70;CHILENO;;Silencioso;SAN PEDRO                     ;METROPOLITANA;310980;2;1;0;0;0;2;1;310980;Cocina F 2608 T 4P Reflex Silver;LINEA BLANCA
13367885;;F;45;CHILENO;;X;SAN ANTONIO                   ;VALPARAISO;149990;1;1;0;0;0;1;1;149990;Calefont 8Lts GL Essenetial ECO;LINEA BLANCA
10744611;;M;54;CHILENO;;X;HUECHURABA                    ;METROPOLITANA;1765480;8;3;1;1;899990;7;2;865490;Lavadora Efficace SZG 17,5Kg Silver;LINEA BLANCA
17217552;;M;32;CHILENO;;Millenial;"";"";283530;3;1;0;0;0;3;1;283530;Lavadora Efficace SZG 17,5Kg Silver;LINEA BLANCA
13807786;;F;43;CHILENO;;X;N/D;N/D;1898630;16;7;12;6;1256880;4;1;641750;Refrigerador 527Lts Side by Side MRSBS5300G689WE;LINEA BLANCA
18128190;;F;29;CHILENO;;Millenial;PROVIDENCIA                   ;METROPOLITANA;289980;2;1;2;1;289980;0;0;0;Refrigerador 290LTS No Frost RMB302PXLRS0;LINEA BLANCA
12350788;;M;49;CHILENO;;X;LOS ANDES                     ;VALPARAISO;423980;2;2;0;0;0;2;2;423980;Lavadora WA17T6260BW/ZS 17Kg Blanca;LINEA BLANCA
10414141;;F;57;CHILENO;;Boomers;NUEVA IMPERIAL                ;ARAUCANIA;1060750;21;17;0;0;0;21;17;1060750;Secadora Ropa MSV-90 9K Blanca Ventilacion;LINEA BLANCA
11278215;;F;54;CHILENO;;X;SAN VICENTE                   ;L.G.B.OÂ´HIGGINS;526860;3;1;0;0;0;3;1;526860;Refrigerador 527Lts Side by Side MRSBS5300G689WE;LINEA BLANCA
6189809;;F;70;CHILENO;;Silencioso;VINA DEL MAR                  ;VALPARAISO;336930;13;3;0;0;0;13;3;336930;Campana Cocina FXU6160 60CM;LINEA BLANCA
12760805;Soltero;F;46;CHILENO;;X;CASTRO                        ;LOS LAGOS;1706117;18;7;0;0;0;18;7;1706117;Secadora Ropa MSV-90 9K Blanca Ventilacion;LINEA BLANCA
14203678;;M;40;CHILENO;;X;LAS CONDES                    ;METROPOLITANA;315520;3;3;0;0;0;3;3;315520;Cocina F 2608 T 4P Reflex Silver;LINEA BLANCA
12909350;;F;46;CHILENO;;X;MAIPU                         ;METROPOLITANA;281100;5;1;0;0;0;5;1;281100;Secadora Ropa MD100A90/W 9Kg Ventilacion Blanca;LINEA BLANCA
20644937;;F;22;CHILENO;;Z;TEMUCO                        ;ARAUCANIA;169990;1;1;0;0;0;1;1;169990;Secadora Ropa MSV-90 9K Blanca Ventilacion;LINEA BLANCA
11530236;;M;52;CHILENO;;X;REQUINOA                      ;L.G.B.OÂ´HIGGINS;859029;8;6;0;0;0;8;6;859029;Calefont 5Lts GL Essenetial ECO;LINEA BLANCA
20580744;;F;21;CHILENO;;Z;PROVIDENCIA                   ;METROPOLITANA;438960;4;2;4;2;438960;0;0;0;Secadora 9 Kg 9D SZG Silver;LINEA BLANCA
11482604;;F;53;CHILENO;;X;CASTRO                        ;LOS LAGOS;270990;3;2;0;0;0;3;2;270990;Lavadora MLS-160BSC03T 16Kg Blanca;LINEA BLANCA
4558161;;F;80;CHILENO;;Silencioso;SAN ANTONIO                   ;VALPARAISO;462660;6;3;0;0;0;6;3;462660;Cocina Andes60TX4 4P Inox;LINEA BLANCA
12744820;;F;47;CHILENO;;X;N/D;N/D;2371300;17;5;0;0;0;17;5;2371300;Secadora Ropa MD100A90/W 9Kg Ventilacion Blanca;LINEA BLANCA
8173453;;F;60;CHILENO;;Boomers;CABILDO                       ;VALPARAISO;319190;3;2;0;0;0;3;2;319190;Lavadora Efficace SZG 17,5Kg Silver;LINEA BLANCA
14083448;;M;40;CHILENO;;X;N/D;N/D;2160920;8;5;3;2;514970;5;3;1645950;COCINA COMBUSTION LENTA S-800 BURDEO 82X56;LINEA BLANCA
18418681;;F;28;CHILENO;;Millenial;"";"";554440;10;4;2;1;125980;8;3;428460;Secadora 9 Kg Premium Care Pro 9D;LINEA BLANCA
6986226;;F;68;CHILENO;;Boomers;ANTOFAGASTA                   ;ANTOFAGASTA;566950;5;4;2;1;393980;3;3;172970;Refrigerador 432Lts Side by Side MDRS619FGE46;LINEA BLANCA
14509532;;M;48;CHILENO;;X;N/D;N/D;335950;3;1;0;0;0;3;1;335950;Lavadora Efficace SZG 17,5Kg Silver;LINEA BLANCA
12055323;;F;47;CHILENO;;X;LO ESPEJO                     ;METROPOLITANA;259970;3;2;1;1;129990;2;1;129980;Centrifuga Primma 5B 5,5Kilos;LINEA BLANCA
19918972;;F;23;CHILENO;;Z;PUENTE ALTO                   ;METROPOLITANA;183980;2;1;0;0;0;2;1;183980;Cocina CMC20AXX-1 4P Inox;LINEA BLANCA
19157175;;F;22;CHILENO;;Z;PENCO;BIO-BIO;246960;4;2;4;2;246960;0;0;0;Secadora 7Kg 7D BZG Ventilacion Blanca;LINEA BLANCA
9958026;;M;57;CHILENO;;Boomers;N/D;N/D;730060;7;4;0;0;0;7;4;730060;Lavadora WA90H4400SW1ZS 9Kg Blanca;LINEA BLANCA
6996815;;F;66;CHILENO;;Boomers;CURANILAHUE                   ;BIO BIO;229750;5;2;0;0;0;5;2;229750;CENTRIFUGA C-752;LINEA BLANCA
7243839;Casado;M;55;CHILENO;INGENIERO COMERCIAL;Boomers;VALPARAISO                    ;VALPARAISO;239480;2;1;0;0;0;2;1;239480;Refrigerador 260Lts BF Frio Direc MRFI2660SR346W;LINEA BLANCA
19411180;;F;27;CHILENO;;Z;N/D;N/D;127980;2;2;0;0;0;2;2;127980;Calefont 5Lts GL Essenetial ECO;LINEA BLANCA
19742240;;F;24;CHILENO;;Z;PROVIDENCIA                   ;METROPOLITANA;169990;1;1;0;0;0;1;1;169990;Lavadora Semiautomatica Twister 5300 4Kg;LINEA BLANCA
15945911;;M;38;CHILENO;;Silencioso;PROVIDENCIA                   ;METROPOLITANA;369990;1;1;0;0;0;1;1;369990;Lavadora MLS-190GC03N 19Kg Gris;LINEA BLANCA
18987572;;F;26;CHILENO;;Z;CURANILAHUE                   ;BIO BIO;411410;4;3;0;0;0;4;3;411410;Secadora 7Kg 7D BZG Ventilacion Blanca;LINEA BLANCA
9050582;;F;61;CHILENO;;Boomers;ANTOFAGASTA                   ;ANTOFAGASTA;650940;6;3;5;2;625950;1;1;24990;Lavadora MLS-080BE04N 8Kg Blanca;LINEA BLANCA
19791563;;F;24;CHILENO;;Z;N/D;N/D;176670;2;1;0;0;0;2;1;176670;Calefont 8Lts GL Essenetial ECO;LINEA BLANCA
5248199;;M;74;CHILENO;;Silencioso;PROVIDENCIA                   ;METROPOLITANA;778860;5;2;0;0;0;5;2;778860;Refrigerador 525Lts Side by Side SFX500;LINEA BLANCA
17539203;;F;32;CHILENO;;Millenial;LA SERENA                     ;COQUIMBO;477520;4;2;4;2;477520;0;0;0;Lavadora Secadora MLSF-13510SC01I 13,5Kg/10Kg Gr;LINEA BLANCA
14239015;;M;49;CHILENO;;X;COQUIMBO                      ;COQUIMBO;662480;8;4;8;4;662480;0;0;0;ENCIMERA A GAS 4 PLATOS CEG-4600 INOX;LINEA BLANCA
15966454;Soltero;M;37;CHILENO;;Millenial;PROVIDENCIA                   ;METROPOLITANA;471960;4;2;4;2;471960;0;0;0;Lavadora Secadora MLSF-13510SC01I 13,5Kg/10Kg Gr;LINEA BLANCA
10189215;;M;56;CHILENO;;Boomers;RENCA                         ;METROPOLITANA;609970;3;2;0;0;0;3;2;609970;Calefont 8Lts GL Essenetial ECO;LINEA BLANCA
9862853;;M;59;CHILENO;;Boomers;CALAMA                        ;ANTOFAGASTA;309980;3;1;0;0;0;3;1;309980;Lavadora Premium Care Pro 16Kg Silver;LINEA BLANCA
25565183;Soltero;M;42;VENEZOLANO;;Extranjero;PROVIDENCIA                   ;METROPOLITANA;309980;2;1;2;1;309980;0;0;0;Lavadora WA17T6260BW/ZS 17Kg Blanca;LINEA BLANCA
13779232;;F;48;CHILENO;;X;PEUMO                         ;L.G.B.OÂ´HIGGINS;215410;4;1;0;0;0;4;1;215410;Secadora Ropa MSV-90 9K Blanca Ventilacion;LINEA BLANCA
8212924;;M;61;CHILENO;;Boomers;NACIMIENTO                    ;BIO BIO;226980;2;2;0;0;0;2;2;226980;Lavadora MLS-090GE04N 9Kg Gris;LINEA BLANCA
25912921;;F;25;PERUANO;;Extranjero;SANTIAGO                      ;METROPOLITANA;399730;3;1;0;0;0;3;1;399730;Cocina MCG-5QI30NS 5P;LINEA BLANCA
18416222;;M;29;CHILENO;;Millenial;PROVIDENCIA                   ;METROPOLITANA;219980;2;1;2;1;219980;0;0;0;Refrigerador 166 Lts Frio Directo BF MED165;LINEA BLANCA
18604699;;F;29;CHILENO;;Millenial;PROVIDENCIA                   ;METROPOLITANA;329990;1;1;0;0;0;1;1;329990;Lavadora WA17T6260BW/ZS 17Kg Blanca;LINEA BLANCA
16751281;;M;34;CHILENO;;Millenial;ANTOFAGASTA                   ;ANTOFAGASTA;69980;2;1;2;1;69980;0;0;0;SECADORA SR-10 8KG GRIS SINDELEN;LINEA BLANCA
15464408;;M;39;CHILENO;;X;PROVIDENCIA                   ;METROPOLITANA;363980;2;1;2;1;363980;0;0;0;Lavadora Secadora MLSF-13510SC01I 13,5Kg/10Kg Gr;LINEA BLANCA
7902576;;M;65;CHILENO;;Boomers;CALAMA                        ;ANTOFAGASTA;219990;1;1;0;0;0;1;1;219990;Lavadora WA90H4400SW1ZS 9Kg Blanca;LINEA BLANCA
13184060;;F;44;CHILENO;;X;SAN FELIPE                    ;VALPARAISO;328520;3;1;0;0;0;3;1;328520;Refrigerador 255Lts No Frost RT25FARADS8/ZS;LINEA BLANCA
14186178;;F;41;CHILENO;;X;PROVIDENCIA                   ;METROPOLITANA;530120;6;4;0;2;0;6;2;530120;Secadora Electrica SEM101BDBY Blanca 10 KG;LINEA BLANCA
6871976;;F;67;CHILENO;;Boomers;CAUQUENES                     ;MAULE;667650;4;2;0;0;0;4;2;667650;Refrigerador 400 Lts No Frost RMP400FHUG1;LINEA BLANCA
11337443;;F;53;CHILENO;;X;N/D;N/D;1060870;13;5;0;0;0;13;5;1060870;Calefont 5Lts GL Essenetial ECO;LINEA BLANCA
16399867;;M;35;CHILENO;;Millenial;CABILDO                       ;VALPARAISO;578950;5;5;0;0;0;5;5;578950;Lavadora WMF-RP200XT Rear Panel 20 Kg Black Inox;LINEA BLANCA
16715950;;F;34;CHILENO;;Millenial;LA GRANJA;METROPOLITANA;445940;6;3;6;3;445940;0;0;0;Lavadora MLS-090GE04N 9Kg Gris;LINEA BLANCA
13955423;;F;42;CHILENO;;X;CONCEPCION                    ;BIO BIO;177980;2;1;2;1;177980;0;0;0;Lavadora Semiautomatica Twister 5300 4Kg;LINEA BLANCA
17467438;;F;32;CHILENO;;Extranjero;VICTORIA                      ;ARAUCANIA;119990;1;1;0;0;0;1;1;119990;Calefont 5Lts GL Essenetial ECO;LINEA BLANCA
8755310;;M;62;CHILENO;;Boomers;RETIRO                        ;MAULE;484400;5;3;0;0;0;5;3;484400;Lavadora WA90H4400SW1ZS 9Kg Blanca;LINEA BLANCA
11729519;;M;51;CHILENO;;X;SAN FELIPE                    ;VALPARAISO;424960;4;2;0;0;0;4;2;424960;Refrigerador 260Lts BF Frio Direc MRFI2660SR346W;LINEA BLANCA
14314108;;M;46;CHILENO;;X;"";"";280990;3;1;0;0;0;3;1;280990;Cocina M 775 ST 4P Silver;LINEA BLANCA
8915235;;F;63;CHILENO;;Boomers;QUEMCHI                       ;LOS LAGOS;143980;2;1;0;0;0;2;1;143980;Centrifuga Primma 5B 5,5Kilos;LINEA BLANCA
11450301;Casado;F;52;CHILENO;;X;RENAICO                       ;ARAUCANIA;340960;4;1;0;0;0;4;1;340960;Refrigerador 255Lts No Frost RT25FARADS8/ZS;LINEA BLANCA
13790671;;F;41;CHILENO;;X;TALAGANTE                     ;METROPOLITANA;597880;5;3;3;2;381970;2;1;215910;Secadora 7Kg 7D BZG Ventilacion Blanca;LINEA BLANCA
12553235;;F;47;CHILENO;;X;HUECHURABA                    ;METROPOLITANA;287980;2;1;2;1;287980;0;0;0;Refrigerador RB27N4020S8/ZS BF 257Lts;LINEA BLANCA
10061401;;F;57;CHILENO;;Boomers;RENCA                         ;METROPOLITANA;529970;3;2;0;0;0;3;2;529970;Cocina F 5500 T 5P Reflex Silver;LINEA BLANCA
16306019;;M;36;CHILENO;;Millenial;LOS ANDES                     ;VALPARAISO;349990;1;1;0;0;0;1;1;349990;Refrigerador 290Lts BF No Frost RB30N4020S8;LINEA BLANCA
16687593;;M;34;CHILENO;;Millenial;COQUIMBO                      ;COQUIMBO;219980;2;1;2;1;219980;0;0;0;Freezer Horizontal M 150 142Lts;LINEA BLANCA
16392843;;M;35;CHILENO;;Silencioso;PROVIDENCIA                   ;METROPOLITANA;159980;2;1;2;1;159980;0;0;0;Lavadora WA80H4200SW1ZS 8Kg Blanca;LINEA BLANCA
16379527;;F;36;CHILENO;;Millenial;LA SERENA;COQUIMBO;361920;5;1;5;1;361920;0;0;0;Secadora 9 Kg 9D BZG Ventilacion Blanca;LINEA BLANCA
11200962;;F;55;CHILENO;;Boomers;N/D;N/D;504920;4;2;0;0;0;4;2;504920;Lavadora MLS-160BSC03T 16Kg Blanca;LINEA BLANCA
18519527;Soltero;M;29;CHILENO;TECNICO DE NIVEL SUPERIOR EN ENFERMERIA;Millenial;PROVIDENCIA                   ;METROPOLITANA;176980;2;1;2;1;176980;0;0;0;Refrigerador 166 Lts Frio Directo BF MED165;LINEA BLANCA
8920970;Casado;F;66;CHILENO;;Boomers;CASTRO                        ;LOS LAGOS;282960;4;2;0;0;0;4;2;282960;Freezer 99Lts MFH-1000B131CN Horizontal;LINEA BLANCA
18256991;Soltero;F;29;CHILENO;;Millenial;PROVIDENCIA                   ;METROPOLITANA;176980;2;1;2;1;176980;0;0;0;Lavadora WA80H4200SW1ZS 8Kg Blanca;LINEA BLANCA
17968977;;M;30;CHILENO;;Millenial;ILLAPEL                       ;COQUIMBO;839970;3;3;0;0;0;3;3;839970;Refrigerador 252Lts No Frost MRFS-2700G333FW;LINEA BLANCA
10523087;;F;42;CHILENO;;X;PUERTO MONTT;LOS LAGOS;294980;2;1;2;1;294980;0;0;0;Refrigerador 244Lts Frio Directo Progress 3100;LINEA BLANCA
15702865;;F;38;CHILENO;;X;LA PINTANA;METROPOLITANA;299980;2;1;0;0;0;2;1;299980;Lavadora Efficace SZG 19,5Kg Silver;LINEA BLANCA
17715844;;M;31;CHILENO;;Millenial;PALMILLA                      ;L.G.B.OÂ´HIGGINS;350190;3;1;0;0;0;3;1;350190;Lavadora Efficace SZG 17,5Kg Silver;LINEA BLANCA
18087626;;M;29;CHILENO;;Millenial;BUIN                          ;METROPOLITANA;579970;3;2;0;0;0;3;2;579970;Refrigerador 527Lts Side by Side MRSBS5300G689WE;LINEA BLANCA
16484816;;F;35;CHILENO;;Millenial;VILLA ALEMANA                 ;VALPARAISO;241960;4;2;4;2;241960;0;0;0;Lavadora WA80H4200SW1ZS 8Kg Blanca;LINEA BLANCA
10628773;;F;52;CHILENO;;X;ARICA                         ;ARICA Y PARINACOTA;213900;3;1;0;0;0;3;1;213900;Lavadora Semiautomatica Twister 5300 4Kg;LINEA BLANCA
8813060;;F;59;CHILENO;;Boomers;ARAUCO                        ;BIO BIO;466730;5;1;0;0;0;5;1;466730;Cocina CH-7400 4P;LINEA BLANCA
5325127;;M;71;CHILENO;;Silencioso;PROVIDENCIA                   ;METROPOLITANA;299990;2;1;2;1;299990;0;0;0;Cocina F 2808 T 4P Reflex Silver;LINEA BLANCA
7877637;Divorciado;M;65;CHILENO;;Boomers;RENCA                         ;METROPOLITANA;206980;2;1;2;1;206980;0;0;0;Secadora 9 Kg 9D BZG Ventilacion Blanca;LINEA BLANCA
11895150;Divorciado;M;50;CHILENO;;X;PROVIDENCIA                   ;METROPOLITANA;107980;2;1;2;1;107980;0;0;0;Campana Slim CA-635PNG;LINEA BLANCA
9993139;;F;58;CHILENO;;Boomers;INDEPENDENCIA                 ;METROPOLITANA;209980;2;1;0;0;0;2;1;209980;Cocina CH-9400 4P SILVER;LINEA BLANCA
9349842;;M;56;CHILENO;;Boomers;RENCA                         ;METROPOLITANA;359990;3;1;0;0;0;3;1;359990;Lavadora Efficace SZG 15,5Kg Silver;LINEA BLANCA
13302364;;M;44;CHILENO;;X;RENGO                         ;L.G.B.OÂ´HIGGINS;664950;5;5;4;2;364960;1;3;299990;Lavadora WT16DSBP 16Kg Silver;LINEA BLANCA
16538760;;M;34;CHILENO;;Millenial;COLBUN                        ;MAULE;405970;3;2;2;1;388980;1;1;16990;Refrigerador 432Lts Side by Side MDRS619FGE46;LINEA BLANCA
12399146;;F;48;CHILENO;;X;COQUIMBO                      ;COQUIMBO;359980;3;1;0;0;0;3;1;359980;Lavadora Premium Care 20SZ 20Kg Silver;LINEA BLANCA
9260839;Soltero;M;60;CHILENO;;Boomers;SAN VICENTE                   ;L.G.B.OÂ´HIGGINS;418500;3;1;0;0;0;3;1;418500;Lavadora WT16DSBP 16Kg Silver;LINEA BLANCA
19820349;;F;24;CHILENO;;Millenial;N/D;N/D;349970;4;2;4;2;349970;0;0;0;Secadora 9 Kg 9D BZG Ventilacion Blanca;LINEA BLANCA
7733305;;F;68;CHILENO;;Silencioso;LOS ALAMOS                    ;BIO BIO;725980;2;1;0;0;0;2;1;725980;Refrigerador 535Lts Side by Side RS54N3003SL/ZS;LINEA BLANCA
10802426;;M;51;CHILENO;;X;ARICA                         ;ARICA Y PARINACOTA;510461;4;3;2;1;458980;2;2;51481;Refrigerador DW44S 400Lts Dispen No Frost;LINEA BLANCA
20530143;;M;21;CHILENO;;Millenial;CABILDO                       ;VALPARAISO;227900;3;1;0;0;0;3;1;227900;Lavadora MLS-090GE04N 9Kg Gris;LINEA BLANCA
18181678;;F;29;CHILENO;;Millenial;RANCAGUA                      ;L.G.B.OÂ´HIGGINS;419151;6;4;0;0;0;6;4;419151;Freezer 99Lts MFH-1000B131CN Horizontal;LINEA BLANCA
14097807;;F;41;CHILENO;;X;AISEN                         ;AYSEN;581980;2;1;2;1;581980;0;0;0;Lavadora Secadora Frontal 12 / 7Kg Inox Titan;LINEA BLANCA
9943711;;F;55;CHILENO;;Boomers;RENCA                         ;METROPOLITANA;191980;2;1;2;1;191980;0;0;0;Lavadora WA80H4200SW1ZS 8Kg Blanca;LINEA BLANCA
20776741;;M;22;CHILENO;;Z;N/D;N/D;371430;3;2;0;0;0;3;2;371430;Lavadora MLS-160BSC03T 16Kg Blanca;LINEA BLANCA
11786267;;M;50;CHILENO;;X;ISLA DE MAIPO                 ;METROPOLITANA;861910;9;7;0;0;0;9;7;861910;Secadora Electrica SEM101BDBY Blanca 10 KG;LINEA BLANCA
19432564;Soltero;M;26;CHILENO;;Z;PROVIDENCIA                   ;METROPOLITANA;209980;2;1;2;1;209980;0;0;0;Refrigerador 166 Lts Frio Directo BF MED165;LINEA BLANCA
7851755;;M;65;CHILENO;;Boomers;CURANILAHUE                   ;BIO BIO;740810;5;6;2;1;375840;3;5;364970;Refrigerador 241Lts BF Frio Directo Nordik 415;LINEA BLANCA
10421162;;M;56;CHILENO;;Boomers;ARICA                         ;TARAPACA;707450;6;3;0;0;0;6;3;707450;Lavadora Efficace SZG 19,5Kg Silver;LINEA BLANCA
8313284;;F;62;CHILENO;;Boomers;PEDRO AGUIRRE CERDA;METROPOLITANA;296843;6;3;6;3;296843;0;0;0;Lavadora Brilliant SG 11,5Kg Silver;LINEA BLANCA
17398053;;F;33;CHILENO;;Millenial;MELIPILLA                     ;METROPOLITANA;190000;2;1;0;0;0;2;1;190000;Secadora Ropa MD100A90/W 9Kg Ventilacion Blanca;LINEA BLANCA
9601988;;F;60;CHILENO;;Boomers;LOLOL                         ;L.G.B.OÂ´HIGGINS;370970;3;1;0;0;0;3;1;370970;Lavadora Premium Care 20SZ 20Kg Silver;LINEA BLANCA
14389403;;F;43;CHILENO;;X;VILLA ALEGRE                  ;MAULE;223940;6;3;0;0;0;6;3;223940;Calefont 5Lts GL Essenetial ECO;LINEA BLANCA
10078050;;M;57;CHILENO;;Boomers;LO ESPEJO                     ;METROPOLITANA;370960;4;2;4;2;370960;0;0;0;Secadora Ropa MSV-90 9K Blanca Ventilacion;LINEA BLANCA
16271476;;F;42;CHILENO;;X;LANCO                         ;LOS LAGOS;656960;4;3;0;0;0;4;3;656960;Refrigerador 523 Lts Side by Side MSC525SERBS0;LINEA BLANCA
6075032;;F;71;CHILENO;;Silencioso;GRANEROS                      ;L.G.B.OÂ´HIGGINS;463970;3;1;0;0;0;3;1;463970;Lavadora Efficace BZG 11,5Kg Blanca;LINEA BLANCA
13578834;;M;43;CHILENO;;X;CURANILAHUE                   ;BIO BIO;683715;6;4;0;0;0;6;4;683715;Lavadora WA17T6260BW/ZS 17Kg Blanca;LINEA BLANCA
17183432;;F;33;CHILENO;;Millenial;SAN CARLOS                    ;BIO BIO;449980;2;4;0;0;0;2;4;449980;Cocina CMC20AXX 4P Inox;LINEA BLANCA
18722334;;M;28;CHILENO;;Millenial;SAN FERNANDO                  ;L.G.B.OÂ´HIGGINS;388750;2;1;0;0;0;2;1;388750;Lavadora WA17T6260BW/ZS 17Kg Blanca;LINEA BLANCA
5797803;;M;76;CHILENO;;Silencioso;SAN FERNANDO                  ;L.G.B.OÂ´HIGGINS;125910;2;1;0;0;0;2;1;125910;Calefon ionizado 5 litros GL AS0;LINEA BLANCA
5152388;;F;78;CHILENO;;Silencioso;RENGO                         ;L.G.B.OÂ´HIGGINS;340170;5;1;0;0;0;5;1;340170;Lavadora MLS-160BSC03T 16Kg Blanca;LINEA BLANCA
12276720;;M;50;CHILENO;;X;PROVIDENCIA                   ;METROPOLITANA;219980;2;1;2;1;219980;0;0;0;Lavadora WA90H4400SW1ZS 9Kg Blanca;LINEA BLANCA
25809033;;M;29;VENEZOLANO;;Extranjero;VINA DEL MAR                  ;VALPARAISO;246980;2;1;2;1;246980;0;0;0;Secadora 9 Kg Premium Care Pro 9D;LINEA BLANCA
18779350;;F;28;CHILENO;;Millenial;PAINE                         ;METROPOLITANA;471430;9;4;9;4;471430;0;0;0;Lavadora 9 Kg Carga Superior Blanca;LINEA BLANCA
10589232;;F;55;CHILENO;;Boomers;PICHILEMU                     ;L.G.B.OÂ´HIGGINS;193980;2;1;2;1;193980;0;0;0;Secadora Ropa MD100A90/W 9Kg Ventilacion Blanca;LINEA BLANCA
18435254;;F;30;CHILENO;;Millenial;N/D;N/D;209980;2;2;0;0;0;2;2;209980;Freezer 142Lts MFH-1430B186C Horizontal;LINEA BLANCA
14576686;;M;45;CHILENO;;X;ARICA                         ;ARICA Y PARINACOTA;759940;6;5;0;0;0;6;5;759940;Lavadora MLS-160BSC03T 16Kg Blanca;LINEA BLANCA
18174535;;F;28;CHILENO;;Millenial;VALDIVIA                      ;LOS RIOS;232510;3;2;0;0;0;3;2;232510;Freezer 142Lts MFH-1430B186C Horizontal;LINEA BLANCA
25432406;;F;40;COLOMBIANO;;Extranjero;ESTACION CENTRAL              ;METROPOLITANA;630810;5;1;0;0;0;5;1;630810;Refrigerador 322Lts No Frost BF DB60S;LINEA BLANCA
13395104;;F;46;CHILENO;;X;N/D;N/D;266500;4;2;0;0;0;4;2;266500;Lavadora MLS-090GE04N 9Kg Gris;LINEA BLANCA
19996354;;M;23;CHILENO;;Z;LA FLORIDA;METROPOLITANA;223500;4;2;0;0;0;4;2;223500;Lavadora MLS-090GE04N 9Kg Gris;LINEA BLANCA
21817282;;F;27;NO INFORMA NACIONALIDAD;;Extranjero;PROVIDENCIA                   ;METROPOLITANA;359980;2;1;2;1;359980;0;0;0;Lavadora Efficace SZG 19,5Kg Silver;LINEA BLANCA
19123171;;M;26;CHILENO;;Z;N/D;N/D;245970;4;1;0;0;0;4;1;245970;Secadora Ropa MD100A90/W 9Kg Ventilacion Blanca;LINEA BLANCA
10429085;Soltero;M;55;CHILENO;;Boomers;ARICA                         ;ARICA Y PARINACOTA;408670;3;1;0;0;0;3;1;408670;Lavadora Premium Care 20SZ 20Kg Silver;LINEA BLANCA
9681100;;F;62;CHILENO;;Boomers;SANTA CRUZ                    ;L.G.B.OÂ´HIGGINS;414670;3;2;0;0;0;3;2;414670;Lavadora Secadora MLSF-1108BN05N 11Kg/8Kg Blanca;LINEA BLANCA
7521791;;F;64;CHILENO;;Boomers;COLINA                        ;METROPOLITANA;422440;5;3;0;0;0;5;3;422440;Lavadora Premium Care 20SZ 20Kg Silver;LINEA BLANCA
12315976;;M;48;CHILENO;;X;N/D;N/D;352960;3;2;0;0;0;3;2;352960;Refrigerador 300Lts No Frost RT29K500JS8/ZS;LINEA BLANCA
26087627;Soltero;M;28;EXTRANJERO - NO INFORMA NACIONALIDAD;;Extranjero;SAN JAVIER                    ;MAULE;821530;9;6;2;1;184980;7;5;636550;Lavadora MLS-080BE04N 8Kg Blanca;LINEA BLANCA
9433194;;M;59;CHILENO;;Boomers;VICTORIA                      ;ARAUCANIA;302550;2;1;0;0;0;2;1;302550;Lavadora Efficace SZG 15,5Kg Silver;LINEA BLANCA
11059538;;F;56;CHILENO;;Boomers;OLIVAR                        ;L.G.B.OÂ´HIGGINS;352980;2;1;0;0;0;2;1;352980;Lavadora Premium Care 20SZ 20Kg Silver;LINEA BLANCA
26161972;;F;47;VENEZOLANO;;Extranjero;RANCAGUA                      ;L.G.B.OÂ´HIGGINS;687620;8;3;0;0;0;8;3;687620;Lavadora WA17T6260BW/ZS 17Kg Blanca;LINEA BLANCA
17370075;Soltero;F;32;CHILENO;TECNICO EN PREVENCION DE RIESGOS;Millenial;PROVIDENCIA                   ;METROPOLITANA;398970;3;2;3;2;398970;0;0;0;Refrigerador 322Lts No Frost BF DB60S;LINEA BLANCA
19127488;;F;26;CHILENO;;Z;RETIRO                        ;MAULE;1247410;8;4;8;4;1247410;0;0;0;Freezer Vertical M165V 165Lts;LINEA BLANCA
14030930;Casado;M;41;CHILENO;;X;PUENTE ALTO                   ;METROPOLITANA;769463;6;5;2;1;469990;4;4;299473;Refrigerador 527Lts Side by Side MRSBS5300G689WE;LINEA BLANCA
18696514;;F;28;CHILENO;;Millenial;PROVIDENCIA                   ;METROPOLITANA;671920;7;3;7;3;671920;0;0;0;Encimera Gas MCE 435E T 4P;LINEA BLANCA
12566113;;F;52;CHILENO;;X;PANGUIPULLI                   ;LOS RIOS;561180;7;4;0;0;0;7;4;561180;Cocina CMC20AXX 4P Inox;LINEA BLANCA
16907230;;F;34;CHILENO;;Millenial;PROVIDENCIA                   ;METROPOLITANA;489680;2;1;0;0;0;2;1;489680;Lavadora WT19DSBP 19Kg Silver;LINEA BLANCA
10152944;;M;57;CHILENO;;Boomers;TOCOPILLA                     ;ANTOFAGASTA;180580;4;3;0;0;0;4;3;180580;Calefont 5Lts GL Essenetial ECO;LINEA BLANCA
9510563;;F;47;CHILENO;;X;TEMUCO                        ;ARAUCANIA;257970;3;1;0;0;0;3;1;257970;Secadora Electrica SEM101BDBY Blanca 10 KG;LINEA BLANCA
8206364;;M;65;CHILENO;;Boomers;TALAGANTE                     ;METROPOLITANA;359980;2;1;0;0;0;2;1;359980;Lavadora Premium Care 20SZ 20Kg Silver;LINEA BLANCA
16845628;;M;33;CHILENO;;Millenial;"";"";659940;6;3;6;3;659940;0;0;0;Secadora 9 Kg 9D SZG Silver;LINEA BLANCA
6200006;;F;78;CHILENO;;Silencioso;"";"";337810;3;1;0;0;0;3;1;337810;Cocina M 775 ST 4P Silver;LINEA BLANCA
17645567;Soltero;M;32;CHILENO;ACTOR;Millenial;PROVIDENCIA                   ;METROPOLITANA;149980;2;1;2;1;149980;0;0;0;Lavadora Semiautomatica Twister 5100 4Kg;LINEA BLANCA
15965154;;F;36;CHILENO;;Millenial;N/D;N/D;2198920;8;5;0;0;0;8;5;2198920;Refrigerador 527Lts Side by Side MRSBS5300G689WE;LINEA BLANCA
17769113;;F;31;CHILENO;;Millenial;N/D;N/D;409950;5;3;0;0;0;5;3;409950;Cocina CMC20AXX 4P Inox;LINEA BLANCA
7642778;;F;66;CHILENO;;Boomers;PROVIDENCIA                   ;METROPOLITANA;394960;4;2;0;0;0;4;2;394960;Lavadora MLS-090GE04N 9Kg Gris;LINEA BLANCA
17166074;;F;33;CHILENO;;Millenial;LINARES                       ;MAULE;274980;2;1;0;0;0;2;1;274980;Cocina CH-6900IN 4P;LINEA BLANCA
11732884;;F;50;CHILENO;;X;RENCA                         ;METROPOLITANA;149980;2;1;2;1;149980;0;0;0;Lavadora Semiautomatica Twister 5100 4Kg;LINEA BLANCA
5398488;;F;76;CHILENO;;Silencioso;SAN JOAQUIN                   ;METROPOLITANA;437440;10;4;0;0;0;10;4;437440;Cocina M 775 ST 4P Silver;LINEA BLANCA
15665097;;F;38;CHILENO;;X;PROVIDENCIA                   ;METROPOLITANA;269990;2;1;2;1;269990;0;0;0;Refrigerador 241Lts BF Frio Directo Nordik 415;LINEA BLANCA
15237295;;F;41;CHILENO;;X;NUEVA IMPERIAL                ;ARAUCANIA;687220;5;4;0;0;0;5;4;687220;Lavadora MLS-160BSC03T 16Kg Blanca;LINEA BLANCA
7695571;;M;63;CHILENO;;Boomers;PENALOLEN                     ;METROPOLITANA;240970;3;1;0;0;0;3;1;240970;Lavadora MLS-080BE04N 8Kg Blanca;LINEA BLANCA
11690385;;M;52;CHILENO;;X;N/D;N/D;-25000;0;2;0;2;-25000;0;0;0;TERMO ATD-50 1,5 KW ALBIN TROTTER;LINEA BLANCA
9028788;;F;63;CHILENO;;Boomers;N/D;N/D;1274930;7;7;0;0;0;7;7;1274930;Cocina F 5500 T 5P Reflex Silver;LINEA BLANCA
20515673;;F;23;CHILENO;;Z;TIRUA                         ;BIO BIO;643800;4;2;0;0;0;4;2;643800;Refrigerador 260Lts BF Frio Direc MRFI2660SR346W;LINEA BLANCA
10915791;;M;52;CHILENO;;X;ARICA                         ;TARAPACA;620980;2;1;0;0;0;2;1;620980;Refrigerador 527Lts Side by Side MRSBS5300G689WE;LINEA BLANCA
8582532;;F;70;CHILENO;;Silencioso;NUEVA IMPERIAL                ;ARAUCANIA;332250;2;1;0;0;0;2;1;332250;Lavadora MLS-160BSC03T 16Kg Blanca;LINEA BLANCA
16533128;;F;35;CHILENO;;Millenial;SANTIAGO;METROPOLITANA;69980;2;1;2;1;69980;0;0;0;SECADORA SR-10 8KG GRIS SINDELEN;LINEA BLANCA
12835585;;F;47;CHILENO;;X;ARICA                         ;TARAPACA;1194670;10;6;0;0;0;10;6;1194670;Lavadora WT16DSBP 16Kg Silver;LINEA BLANCA
15146823;;F;39;CHILENO;;X;CHANCO                        ;MAULE;302550;2;1;0;0;0;2;1;302550;Lavadora Efficace SZG 17,5Kg Silver;LINEA BLANCA
5766810;Casado;F;70;CHILENO;;Silencioso;TALCAHUANO                    ;BIO BIO;285980;2;1;0;0;0;2;1;285980;Cocina CH-6900IN 4P;LINEA BLANCA
10210200;;M;56;CHILENO;;Boomers;VICTORIA                      ;ARAUCANIA;602540;3;4;0;0;0;3;4;602540;Refrigerador 244Lts Frio Directo Progress 3100;LINEA BLANCA
8300701;;M;57;CHILENO;;Boomers;PUERTO MONTT                  ;LOS LAGOS;394670;3;1;0;0;0;3;1;394670;Lavadora Superior WA13T5260BY/ZS 13Kg;LINEA BLANCA
16525425;Soltero;F;35;CHILENO;NUTRICIONISTA;Millenial;PROVIDENCIA                   ;METROPOLITANA;137980;2;1;2;1;137980;0;0;0;Centrifuga Primma 5B 5,5Kilos;LINEA BLANCA
15867115;;M;37;CHILENO;;Millenial;MARIA PINTO                   ;METROPOLITANA;99990;1;1;0;0;0;1;1;99990;Calefont 5Lts GL Essenetial ECO;LINEA BLANCA
8035966;;M;65;CHILENO;;Boomers;SAN FELIPE                    ;VALPARAISO;350980;2;1;0;0;0;2;1;350980;Cocina M 920 T 5P Silver;LINEA BLANCA
17966488;;M;30;CHILENO;;Millenial;N/D;N/D;470500;5;4;0;0;0;5;4;470500;Cocina CH-7400 4P;LINEA BLANCA
19388878;;F;26;CHILENO;;Silencioso;PROVIDENCIA                   ;METROPOLITANA;378940;6;4;0;0;0;6;4;378940;Lavadora Semiautomatica Twister 5100 4Kg;LINEA BLANCA
19054001;;F;27;CHILENO;;Z;PROVIDENCIA                   ;METROPOLITANA;199980;2;1;2;1;199980;0;0;0;Cocina CMC20AXX 4P Inox;LINEA BLANCA
12769115;;F;47;CHILENO;;X;NEGRETE                       ;BIO BIO;409980;2;1;0;0;0;2;1;409980;Cocina PRO 523 5P Inox - Serie 2 HSK18C20SE;LINEA BLANCA
7925353;;F;64;CHILENO;;Boomers;IQUIQUE                       ;TARAPACA;230980;2;1;0;0;0;2;1;230980;Lavadora WA90H4400SW1ZS 9Kg Blanca;LINEA BLANCA
5567865;;F;77;CHILENO;;Silencioso;ANCUD                         ;LOS LAGOS;740940;6;6;0;0;0;6;6;740940;Cocina Diva 820 6P;LINEA BLANCA
13721185;;F;43;CHILENO;;X;SAN VICENTE                   ;L.G.B.OÂ´HIGGINS;210980;2;1;2;1;210980;0;0;0;Secadora Electrica SEM101BDBY Blanca 10 KG;LINEA BLANCA
25265737;;M;32;HAITIANO;;Extranjero;PROVIDENCIA                   ;METROPOLITANA;269990;1;1;0;0;0;1;1;269990;Refrigerador 260Lts BF Frio Direc MRFI2660SR346W;LINEA BLANCA
11573946;;F;52;CHILENO;;X;RENCA                         ;METROPOLITANA;187990;2;2;0;0;0;2;2;187990;Freezer 142Lts MFH-1430B186C Horizontal;LINEA BLANCA
13793773;;M;41;CHILENO;;X;NIQUEN                        ;BIO BIO;274980;2;1;0;0;0;2;1;274980;Lavadora Efficace SZG 17,5Kg Blanca;LINEA BLANCA
11457058;;F;53;CHILENO;;X;CONSTITUCION                  ;MAULE;226970;3;2;0;0;0;3;2;226970;Freezer 142Lts MFH-1430B186C Horizontal;LINEA BLANCA
16390221;;F;36;CHILENO;;Millenial;SANTIAGO;METROPOLITANA;179980;2;1;2;1;179980;0;0;0;Refrigerador 167Lts Frio Directo 1700-S;LINEA BLANCA
13082852;;M;46;CHILENO;;X;SAN BERNARDO                  ;METROPOLITANA;379980;2;1;0;0;0;2;1;379980;Lavadora MLS-190GC03N 19Kg Gris;LINEA BLANCA
15337563;;M;40;CHILENO;;X;N/D;N/D;913960;4;2;4;2;913960;0;0;0;Secadora Electrica SEM101BDBY Blanca 10 KG;LINEA BLANCA
15298430;;M;40;CHILENO;;X;N/D;N/D;190980;2;1;2;1;190980;0;0;0;Secadora Ropa MD100A90/W 9Kg Ventilacion Blanca;LINEA BLANCA
13361701;;F;44;CHILENO;;X;PICHIDEGUA                    ;L.G.B.OÂ´HIGGINS;540050;7;4;4;2;179080;3;2;360970;Lavadora MLS-160BSC03T 16Kg Blanca;LINEA BLANCA
11442949;;M;52;CHILENO;;X;CAUQUENES                     ;MAULE;421970;4;2;0;0;0;4;2;421970;Lavadora Efficace SZG 17,5Kg Blanca;LINEA BLANCA
11373548;;M;56;CHILENO;;Boomers;RENCA                         ;METROPOLITANA;199990;1;1;0;0;0;1;1;199990;Secadora Ropa MD100A90/W 9Kg Ventilacion Blanca;LINEA BLANCA
18567494;;F;29;CHILENO;;Millenial;PANGUIPULLI                   ;LOS RIOS;283970;5;2;0;0;0;5;2;283970;Secadora Ropa MD100A90/W 9Kg Ventilacion Blanca;LINEA BLANCA
10053340;;M;54;CHILENO;;Boomers;OLIVAR                        ;L.G.B.OÂ´HIGGINS;406970;3;1;0;0;0;3;1;406970;Cocina MCG-5QI30NS 5P;LINEA BLANCA
11439748;;F;52;CHILENO;;X;LA SERENA                     ;COQUIMBO;250980;2;1;0;0;0;2;1;250980;Secadora Electrica SEM101BDBY Blanca 10 KG;LINEA BLANCA
18685993;;M;27;CHILENO;;Millenial;TALCAHUANO                    ;BIO BIO;367980;2;1;0;0;0;2;1;367980;Lavadora WA17T6260BW/ZS 17Kg Blanca;LINEA BLANCA
7108807;;F;79;CHILENO;;Silencioso;SAN BERNARDO                  ;METROPOLITANA;260970;3;1;0;0;0;3;1;260970;Refrigerador 167Lts MRFI-1700R234RN F.Direc Rojo;LINEA BLANCA
9185560;;M;47;CHILENO;;X;NATALES                       ;MAGALLANES;229980;2;1;0;0;0;2;1;229980;Lavadora WA90H4400SW1ZS 9Kg Blanca;LINEA BLANCA
16634594;;F;34;CHILENO;;Millenial;N/D;N/D;381960;5;3;2;1;178980;3;2;202980;Secadora Ropa MD100A90/W 9Kg Ventilacion Blanca;LINEA BLANCA
5602100;;F;78;CHILENO;;Silencioso;TALCAHUANO                    ;BIO BIO;404970;3;1;0;0;0;3;1;404970;Lavadora WT16DSBP 16Kg Silver;LINEA BLANCA
24406191;Soltero;M;39;COLOMBIANO;;Extranjero;PROVIDENCIA                   ;METROPOLITANA;454970;3;2;2;1;419980;1;1;34990;Lavadora Secadora WD11TA046BE/ZS 11Kg/7Kg Blanca;LINEA BLANCA
5821693;;F;70;CHILENO;;Silencioso;SAN CARLOS                    ;BIO BIO;415600;10;7;0;0;0;10;7;415600;Calefont 8Lts GL Essenetial ECO;LINEA BLANCA
10621778;;F;52;CHILENO;;X;COIHAIQUE                     ;AYSEN;559980;2;1;0;0;0;2;1;559980;Lavadora WT16DSBP 16Kg Silver;LINEA BLANCA
18995117;Soltero;M;27;CHILENO;;Millenial;LUMACO                        ;ARAUCANIA;206990;3;1;0;0;0;3;1;206990;Freezer 145 Lts FDHM150BY0 Horizontal;LINEA BLANCA
19145509;;F;26;CHILENO;;Z;"";"";240960;4;2;0;0;0;4;2;240960;Calefont 5Lts GL Essenetial ECO;LINEA BLANCA
15075747;;M;35;CHILENO;;Millenial;BUIN                          ;METROPOLITANA;416980;2;1;0;0;0;2;1;416980;Lavadora WT16DSBP 16Kg Silver;LINEA BLANCA
7807107;;F;65;CHILENO;;Boomers;ILLAPEL                       ;COQUIMBO;855490;11;5;0;0;0;11;5;855490;Lavadora WT16DSBP 16Kg Silver;LINEA BLANCA
14495126;;F;46;CHILENO;;X;PANGUIPULLI                   ;LOS LAGOS;324980;2;2;0;0;0;2;2;324980;Lavadora Efficace SZG 17,5Kg Blanca;LINEA BLANCA
12274502;;F;51;CHILENO;;X;"";"";839960;4;2;2;1;459980;2;1;379980;Lavadora 19 Kg Carga Superior Negro;LINEA BLANCA
8907500;;M;46;CHILENO;;X;LAGO VERDE                    ;AYSEN;239990;1;1;0;0;0;1;1;239990;Freezer 200 Lts FDHM200BY0 Horizontal;LINEA BLANCA
8294403;;M;56;CHILENO;;Boomers;N/D;N/D;535939;6;3;0;0;0;6;3;535939;Cocina CH-7400 4P;LINEA BLANCA
17930499;;F;30;CHILENO;;Millenial;SAN FERNANDO                  ;L.G.B.OÂ´HIGGINS;310980;2;1;0;0;0;2;1;310980;Lavadora Efficace SZG 19,5Kg Silver;LINEA BLANCA
4713615;;F;83;CHILENO;;Silencioso;CURICO                        ;MAULE;291980;2;1;0;0;0;2;1;291980;Lavadora MLS-160BSC03T 16Kg Blanca;LINEA BLANCA
8430539;;M;50;CHILENO;;X;N/D;N/D;269990;1;1;0;0;0;1;1;269990;Refrigerador 260Lts BF Frio Direc MRFI2660SR346W;LINEA BLANCA
5744032;Soltero;F;74;CHILENO;;Silencioso;RENCA                         ;METROPOLITANA;222970;3;2;0;0;0;3;2;222970;Lavadora MLS-090GE04N 9Kg Gris;LINEA BLANCA
22607038;;F;59;PERUANO;;Extranjero;ALHUE                         ;METROPOLITANA;425970;3;1;0;0;0;3;1;425970;Cocina MCG-5QI30NS 5P;LINEA BLANCA
10498027;;F;56;CHILENO;;Boomers;PROVIDENCIA                   ;METROPOLITANA;331980;2;1;2;1;331980;0;0;0;Lavadora WT16DSBP 16Kg Silver;LINEA BLANCA
19802494;;F;24;CHILENO;;Z;PROVIDENCIA                   ;METROPOLITANA;663930;7;4;6;3;563940;1;1;99990;Cocina CH-9810IN 4P Inox;LINEA BLANCA
10744770;;F;55;CHILENO;;Boomers;PADRE HURTADO                 ;METROPOLITANA;209980;2;1;0;0;0;2;1;209980;Freezer 145 Lts FDHM150BY0 Horizontal;LINEA BLANCA
12808091;;F;47;CHILENO;;X;CURICO;MAULE;401970;3;2;0;0;0;3;2;401970;Lavadora WA13T5260BW/ZS 13Kg Blanca;LINEA BLANCA
17604658;;F;32;CHILENO;;Millenial;"";"";974710;7;3;0;0;0;7;3;974710;Cocina CH-7400 4P;LINEA BLANCA
12521773;;F;49;CHILENO;;X;SAN CLEMENTE                  ;MAULE;1574920;8;4;0;0;0;8;4;1574920;Freezer 99Lts MFH-1000B131CN Horizontal;LINEA BLANCA
8077980;;F;63;CHILENO;;Boomers;TOCOPILLA                     ;ANTOFAGASTA;172970;3;1;0;0;0;3;1;172970;Calefont 5Lts GL Essenetial ECO;LINEA BLANCA
13279346;Casado;M;44;CHILENO;TECNICO EN MICROBIOLOGIA INDUSTRIAL DE ALIMENTOS;X;PROVIDENCIA                   ;METROPOLITANA;313980;2;1;2;1;313980;0;0;0;CALEFON 16L MODULANTE DIGITAL TIRO FORZADO GN;LINEA BLANCA
18418007;;F;28;CHILENO;;Millenial;N/D;N/D;346980;2;1;0;0;0;2;1;346980;Refrigerador 254Lts No Frost GT29WPPDC;LINEA BLANCA
15305208;;F;39;CHILENO;;X;COIHAIQUE                     ;AYSEN;189990;1;1;0;0;0;1;1;189990;Cocina CMC20AXX 4P Inox;LINEA BLANCA
18965998;;M;26;CHILENO;;Z;N/D;N/D;1070480;11;4;0;0;0;11;4;1070480;Lavadora WA17T6260BW/ZS 17Kg Blanca;LINEA BLANCA
8077672;;M;63;CHILENO;;Boomers;N/D;N/D;322960;4;2;4;2;322960;0;0;0;Secadora Electrica SEM101BDBY Blanca 10 KG;LINEA BLANCA
6419425;;F;73;CHILENO;;Silencioso;N/D;N/D;606930;7;4;0;0;0;7;4;606930;Cocina Andes7650FX 5P Inox;LINEA BLANCA
17291761;;F;36;CHILENO;;Millenial;N/D;N/D;1175942;6;5;2;1;349980;4;4;825962;Cocina F-2808 4P;LINEA BLANCA
12883582;;M;53;CHILENO;;X;RANCAGUA                      ;L.G.B.OÂ´HIGGINS;181980;2;1;0;0;0;2;1;181980;Lavadora MLS-090GE04N 9Kg Gris;LINEA BLANCA
6535323;;M;71;CHILENO;;Silencioso;PROVIDENCIA                   ;METROPOLITANA;179990;1;1;0;0;0;1;1;179990;Lavadora MLS-090GE04N 9Kg Gris;LINEA BLANCA
20343291;;M;33;CHILENO;;Z;CONSTITUCION                  ;MAULE;232970;3;3;0;0;0;3;3;232970;Freezer FDHM150BY1 150Lts Horizontal;LINEA BLANCA
7086873;;F;73;CHILENO;;Silencioso;OVALLE                        ;COQUIMBO;352970;3;2;0;0;0;3;2;352970;Freezer 200 Lts FDHM200BY0 Horizontal;LINEA BLANCA
5073073;;F;79;CHILENO;;Silencioso;SAN ANTONIO                   ;VALPARAISO;510980;2;1;0;0;0;2;1;510980;Refrigerador 527Lts Side by Side MRSBS5300G689WE;LINEA BLANCA
26555442;;M;33;VENEZOLANO;;Extranjero;TEMUCO                        ;ARAUCANIA;134980;2;1;2;1;134980;0;0;0;Freezer 99Lts MFH-1000B131CN Horizontal;LINEA BLANCA
10478404;;F;51;CHILENO;;X;N/D;N/D;191980;2;1;2;1;191980;0;0;0;Secadora Ropa MD100A90/W 9Kg Ventilacion Blanca;LINEA BLANCA
13605531;;F;43;CHILENO;;X;PROVIDENCIA                   ;METROPOLITANA;595961;5;2;0;0;0;5;2;595961;Freezer 145 Lts FDHM150BY0 Horizontal;LINEA BLANCA
13750124;;M;44;CHILENO;;X;RENCA                         ;METROPOLITANA;149990;1;1;0;0;0;1;1;149990;Freezer 99Lts MFH-1000B131CN Horizontal;LINEA BLANCA
10214225;;M;48;CHILENO;;X;TALCAHUANO                    ;BIO BIO;657950;5;2;0;0;0;5;2;657950;Lavadora Efficace SZG 17,5Kg Silver;LINEA BLANCA
18571478;;F;29;CHILENO;;Millenial;"";"";206960;4;2;0;0;0;4;2;206960;Freezer 99Lts MFH-1000B131CN Horizontal;LINEA BLANCA
16272429;;M;36;CHILENO;;Millenial;PAINE;METROPOLITANA;300970;3;2;0;0;0;3;2;300970;Refrigerador 260Lts BF Frio Direc MRFI2660SR346W;LINEA BLANCA
7639097;;F;64;CHILENO;;Boomers;ARICA                         ;TARAPACA;494860;5;1;0;0;0;5;1;494860;Freezer 200 Lts FDHM200BY0 Horizontal;LINEA BLANCA
16047150;;M;42;CHILENO;;X;N/D;N/D;335970;3;1;0;0;0;3;1;335970;Freezer 145 Lts FDHM150BY0 Horizontal;LINEA BLANCA
9342801;;M;60;CHILENO;;Boomers;CURANILAHUE                   ;BIO BIO;802800;8;4;0;0;0;8;4;802800;Lavadora MLS-090GE04N 9Kg Gris;LINEA BLANCA
16825208;;F;34;CHILENO;;Millenial;PROVIDENCIA                   ;METROPOLITANA;169990;1;1;0;0;0;1;1;169990;Cocina CMC20AXX 4P Inox;LINEA BLANCA
16837653;;M;34;CHILENO;;Millenial;LAMPA                         ;METROPOLITANA;309980;2;1;2;1;309980;0;0;0;Lavadora Secadora MLSF-1108BN05N 11Kg/8Kg Blanca;LINEA BLANCA
11865772;;F;53;CHILENO;;X;PARRAL                        ;MAULE;250980;2;1;0;0;0;2;1;250980;Lavadora LMA0920WGCL0 9,5Kg Gris;LINEA BLANCA
13570674;;M;42;CHILENO;;X;SAN FERNANDO                  ;L.G.B.OÂ´HIGGINS;280980;2;1;0;0;0;2;1;280980;Refrigerador 260Lts BF Frio Direc MRFI2660SR346W;LINEA BLANCA
8733131;;F;65;CHILENO;;Boomers;ALTO HOSPICIO;TARAPACA;199980;2;1;0;0;0;2;1;199980;Cocina CH-7400 4P;LINEA BLANCA
13254345;Casado;F;46;CHILENO;;X;LA REINA;METROPOLITANA;389980;2;1;2;1;389980;0;0;0;Lavadora Secadora WD10WVC4S6 10,5/6Kg Blanca;LINEA BLANCA
17497288;;F;31;CHILENO;;Millenial;TALCA                         ;MAULE;271980;2;1;0;0;0;2;1;271980;Refrigerador 260Lts BF Frio Direc MRFI2660SR346W;LINEA BLANCA
26436292;;M;29;VENEZOLANO;;Extranjero;LOS ANGELES                   ;BIO BIO;493030;7;3;3;1;171680;4;2;321350;Refrigerador 260Lts BF Frio Direc MRFI2660SR346W;LINEA BLANCA
5513541;;F;76;CHILENO;;Silencioso;PROVIDENCIA                   ;METROPOLITANA;233980;2;1;0;0;0;2;1;233980;Cocina CH-9400 4P SILVER;LINEA BLANCA
5305598;;M;80;CHILENO;;Silencioso;CARAHUE                       ;ARAUCANIA;299990;1;1;0;0;0;1;1;299990;Lavadora Efficace SZG 17,5Kg Silver;LINEA BLANCA
17774717;Soltero;F;30;CHILENO;PROFESOR;Millenial;PROVIDENCIA                   ;METROPOLITANA;409980;2;2;1;1;359990;1;1;49990;Lavadora Secadora WD10WVC4S6 10,5/6Kg Blanca;LINEA BLANCA
5705483;;F;78;CHILENO;;Silencioso;TEMUCO                        ;ARAUCANIA;326970;3;1;0;0;0;3;1;326970;Refrigerador 252Lts No Frost MRFS-2700G333FW;LINEA BLANCA
8847833;;M;62;CHILENO;;Boomers;RENCA                         ;METROPOLITANA;229970;3;1;0;0;0;3;1;229970;Lavadora LMA0920WGCL0 9,5Kg Gris;LINEA BLANCA
13559568;;F;43;CHILENO;;X;N/D;N/D;456970;3;1;0;0;0;3;1;456970;Lavadora WT16DSBP 16Kg Silver;LINEA BLANCA
16585641;;F;35;CHILENO;;Millenial;CARAHUE                       ;ARAUCANIA;455950;5;2;0;0;0;5;2;455950;Lavadora MLS-080BE04N 8Kg Blanca;LINEA BLANCA
9261827;;M;61;CHILENO;;Boomers;VILLARICA                     ;ARAUCANIA;309990;1;1;0;0;0;1;1;309990;Cocina F-2808 4P;LINEA BLANCA
10367735;Divorciado;F;59;CHILENO;;Boomers;PROVIDENCIA                   ;METROPOLITANA;229980;2;1;0;0;0;2;1;229980;Cocina CMC20AXX 4P Inox;LINEA BLANCA
15558187;;F;39;CHILENO;;X;QUILPUE                       ;VALPARAISO;301980;2;1;0;0;0;2;1;301980;Lavadora MLS-160BSC03T 16Kg Blanca;LINEA BLANCA
10761414;;F;50;CHILENO;;X;RENCA                         ;METROPOLITANA;197980;2;1;2;1;197980;0;0;0;Secadora Ropa MD100A90/W 9Kg Ventilacion Blanca;LINEA BLANCA
20508927;;F;22;CHILENO;;Z;PROVIDENCIA                   ;METROPOLITANA;262460;4;2;4;2;262460;0;0;0;Lavadora WA90H4400SW1ZS 9Kg Blanca;LINEA BLANCA
8725512;;F;62;CHILENO;;Boomers;ALGARROBO                     ;VALPARAISO;1061950;5;2;0;0;0;5;2;1061950;Refrigerador 400 Lts No Frost RMP400FHUG1;LINEA BLANCA
10504953;;F;59;CHILENO;;Boomers;N/D;N/D;736362;4;3;0;0;0;4;3;736362;Refrigerador 303Lts BF Frio Directo Nordik 480;LINEA BLANCA
24539400;;M;38;ECUATORIANO;;Extranjero;N/D;N/D;259980;2;1;0;0;0;2;1;259980;Refrigerador 252Lts No Frost MRFS-2700G333FW;LINEA BLANCA
3905300;;M;72;CHILENO;;Silencioso;COIHAIQUE                     ;AYSEN;359990;1;1;0;0;0;1;1;359990;Lavadora Secadora WD95T4046CE/ZS 9,5Kg/6Kg Blanc;LINEA BLANCA
19215550;Soltero;F;26;CHILENO;;Z;PROVIDENCIA                   ;METROPOLITANA;263980;2;1;2;1;263980;0;0;0;Secadora Electrica SEM101BDBY Blanca 10 KG;LINEA BLANCA
18597698;Soltero;F;29;CHILENO;;Millenial;PROVIDENCIA                   ;METROPOLITANA;651960;4;2;4;2;651960;0;0;0;Refrigerador 244Lts Frio Directo Progress 3100;LINEA BLANCA
9905244;;M;56;CHILENO;;Boomers;PROVIDENCIA                   ;METROPOLITANA;269990;1;1;0;0;0;1;1;269990;Lavadora MLS-160BSC03T 16Kg Blanca;LINEA BLANCA
9969650;;F;56;CHILENO;;Boomers;N/D;N/D;820580;11;5;0;0;0;11;5;820580;Lavadora Semiautomatica LC-6550 6,5Kg;LINEA BLANCA
4626293;;F;82;CHILENO;;Silencioso;ARICA                         ;ARICA Y PARINACOTA;229980;2;1;0;0;0;2;1;229980;Lavadora WA90H4400SW1ZS 9Kg Blanca;LINEA BLANCA
17162002;;F;36;CHILENO;;Millenial;VINA DEL MAR                  ;VALPARAISO;543940;6;2;0;0;0;6;2;543940;Lavadora WA13T5260BW/ZS 13Kg Blanca;LINEA BLANCA
13884440;;F;42;CHILENO;;Millenial;"";"";385970;3;2;2;1;371980;1;1;13990;Refrigerador 290Lts BF No Frost RB30N4020S8;LINEA BLANCA
19011344;;F;26;CHILENO;;Z;PROVIDENCIA                   ;METROPOLITANA;214980;2;1;0;0;0;2;1;214980;Refrigerador 210Lts Rojo Frio Dir MRFS2100R273FN;LINEA BLANCA
13294609;;F;45;CHILENO;;X;PAINE                         ;METROPOLITANA;788960;3;1;0;0;0;3;1;788960;Refrigerador 535Lts Side by Side RS54N3003SL/ZS;LINEA BLANCA
13174565;;F;45;CHILENO;;X;VALLENAR;ATACAMA;668950;5;5;0;0;0;5;5;668950;Freezer 99Lts MFH-1000B131CN Horizontal;LINEA BLANCA
10783535;;F;54;CHILENO;;X;ANCUD                         ;LOS LAGOS;433970;3;1;0;0;0;3;1;433970;Lavadora MLS-190GC03N 19Kg Gris;LINEA BLANCA
13317224;;M;45;CHILENO;;X;PROVIDENCIA                   ;METROPOLITANA;326980;2;1;2;1;326980;0;0;0;Lavadora C Frontal 12K WM12WVC4S6 Inverter Dire;LINEA BLANCA
10506526;;F;56;CHILENO;;Boomers;PUENTE ALTO                   ;METROPOLITANA;319980;2;1;0;0;0;2;1;319980;Lavadora WA15T5260BW/ZS 15Kg Blanca;LINEA BLANCA
9735051;;M;59;CHILENO;;Boomers;RENCA                         ;METROPOLITANA;58660;0;2;0;2;58660;0;0;0;Lavadora MLS-090GE04N 9Kg Gris;LINEA BLANCA
9895182;;M;54;CHILENO;;X;CONCEPCION                    ;BIO BIO;397970;3;1;0;0;0;3;1;397970;Lavadora WA17T6260BW/ZS 17Kg Blanca;LINEA BLANCA
7681292;;F;68;CHILENO;;Boomers;LINARES                       ;MAULE;311970;3;1;0;0;0;3;1;311970;Freezer 145 Lts FDHM150BY0 Horizontal;LINEA BLANCA
15231682;;F;45;CHILENO;;X;VICTORIA                      ;ARAUCANIA;731920;6;3;0;0;0;6;3;731920;Freezer 145 Lts FDHM150BY0 Horizontal;LINEA BLANCA
18163087;;M;29;CHILENO;;Millenial;CARTAGENA                     ;VALPARAISO;201980;2;2;0;0;0;2;2;201980;Cocina CH-9050SI 4P;LINEA BLANCA
16398707;;M;34;CHILENO;;Millenial;SALAMANCA                     ;COQUIMBO;165840;2;1;2;1;165840;0;0;0;Freezer 142Lts MFH-1430B186C Horizontal;LINEA BLANCA
19232548;;F;26;CHILENO;;Z;PUENTE ALTO                   ;METROPOLITANA;209980;2;1;2;1;209980;0;0;0;Freezer Horizontal MFH-1990B258CN 198Lts;LINEA BLANCA
16876760;Soltero;F;34;CHILENO;PROFESOR;Millenial;PROVIDENCIA                   ;METROPOLITANA;400980;2;1;0;0;0;2;1;400980;Refrigerador 255Lts No Frost RT25FARADS8/ZS;LINEA BLANCA
18909251;;F;34;CHILENO;;Millenial;N/D;N/D;1394890;11;7;0;0;0;11;7;1394890;Refrigerador 400 Lts No Frost RMP410FZUC Negro;LINEA BLANCA
25939413;Soltero;F;34;NO INFORMA NACIONALIDAD;;Extranjero;PROVIDENCIA                   ;METROPOLITANA;163980;2;1;2;1;163980;0;0;0;Freezer 142Lts MFH-1430B186C Horizontal;LINEA BLANCA
16811113;Soltero;F;33;CHILENO;;Millenial;PROVIDENCIA                   ;METROPOLITANA;173980;2;1;2;1;173980;0;0;0;Frigobar 85 Lts FB-95 BL;LINEA BLANCA
15030926;Soltero;M;39;CHILENO;;X;COPIAPO                       ;ATACAMA;176980;2;1;0;0;0;2;1;176980;Lavadora/Centrifuga LC4550 4,5Kg Blanca;LINEA BLANCA
16937026;;M;34;CHILENO;;Millenial;PROVIDENCIA                   ;METROPOLITANA;452970;3;1;0;0;0;3;1;452970;Refrigerador 290Lts BF No Frost RB30N4020S8;LINEA BLANCA
3077615;;M;89;CHILENO;;Silencioso;PAINE                         ;METROPOLITANA;299980;2;1;0;0;0;2;1;299980;Cocina F-2808 4P;LINEA BLANCA
15672563;;M;38;CHILENO;;X;CONSTITUCION                  ;MAULE;296980;2;1;0;0;0;2;1;296980;Lavadora Efficace SZG 15,5Kg Silver;LINEA BLANCA
18342159;;F;29;CHILENO;;Millenial;LINARES                       ;MAULE;284980;2;1;0;0;0;2;1;284980;Freezer 196Lts M200 Horizontal;LINEA BLANCA
14151021;;F;41;CHILENO;;X;QUILICURA                     ;METROPOLITANA;133980;2;1;2;1;133980;0;0;0;Freezer 99Lts MFH-1000B131CN Horizontal;LINEA BLANCA
12240755;;M;49;CHILENO;;X;SAN ANTONIO                   ;VALPARAISO;595430;6;3;0;0;0;6;3;595430;Freezer 142Lts MFH-1430B186C Horizontal;LINEA BLANCA
18286656;;M;29;CHILENO;;Millenial;PARRAL                        ;MAULE;369640;5;4;0;0;0;5;4;369640;Cocina CH-9400 4P SILVER;LINEA BLANCA
6226821;;M;69;CHILENO;;Silencioso;PAINE                         ;METROPOLITANA;477960;4;2;0;0;0;4;2;477960;Refrigerador 303Lts BF Frio Directo Nordik 480;LINEA BLANCA
7606850;;M;66;CHILENO;;Boomers;VALLENAR;ATACAMA;200980;2;1;0;0;0;2;1;200980;Freezer 99Lts MFH-1000B131CN Horizontal;LINEA BLANCA
7827362;;M;61;CHILENO;;Boomers;ANTOFAGASTA                   ;ANTOFAGASTA;397980;2;1;0;0;0;2;1;397980;Refrigerador 300Lts No Frost RT29K500JS8/ZS;LINEA BLANCA
14394968;;F;44;CHILENO;;X;HUALANE                       ;MAULE;211980;2;1;2;1;211980;0;0;0;Freezer 160 Lts MFV-1600B208FN vertical;LINEA BLANCA
11760066;;F;50;CHILENO;;X;MARCHIHUE                     ;L.G.B.OÂ´HIGGINS;333970;3;2;0;0;0;3;2;333970;Refrigerador 303Lts BF Frio Directo Nordik 480;LINEA BLANCA
17195474;;F;32;CHILENO;;Silencioso;COPIAPO                       ;ATACAMA;178640;2;1;2;1;178640;0;0;0;Lavadora MLS-090GE04N 9Kg Gris;LINEA BLANCA
14467309;;F;50;CHILENO;;X;RENCA                         ;METROPOLITANA;289990;1;1;0;0;0;1;1;289990;Lavadora MLS-160BSC03T 16Kg Blanca;LINEA BLANCA
11180736;;M;55;CHILENO;;Boomers;CALERA                        ;VALPARAISO;820621;8;3;0;0;0;8;3;820621;Secadora Ropa Solare 7100 7K Ventilacion;LINEA BLANCA
17259346;;F;32;CHILENO;;Millenial;SAN FERNANDO                  ;L.G.B.OÂ´HIGGINS;429490;7;5;3;1;224530;4;4;204960;Freezer 150 Lts SFH-151 BL Horizontal;LINEA BLANCA
25008644;;F;32;BOLIVIANO;;Extranjero;COLINA                        ;METROPOLITANA;573950;5;5;0;0;0;5;5;573950;Refrigerador 250 Lts No Frost RMA250PHUG1;LINEA BLANCA
11812727;;F;50;CHILENO;;X;SANTA CRUZ                    ;L.G.B.OÂ´HIGGINS;338982;2;2;0;0;0;2;2;338982;Refrigerador 311Lts Frio Direct Nordik Inox 3900;LINEA BLANCA
17124005;Casado;F;33;CHILENO;;Millenial;ANCUD                         ;LOS LAGOS;789980;3;2;0;0;0;3;2;789980;Cocina Andes7650FX 5P Inox;LINEA BLANCA
18730740;;F;28;CHILENO;;Millenial;"";"";311960;3;1;3;1;311960;0;0;0;Refrigerador 167Lts MRFI-1700R234RN F.Direc Rojo;LINEA BLANCA
15319786;;M;40;CHILENO;;X;CHILLAN                       ;BIO BIO;409980;2;1;2;1;409980;0;0;0;Refrigerador RB31K3210S9/ZS 311 LTRS No Frost;LINEA BLANCA
13750865;Soltero;F;42;CHILENO;;X;RENCA                         ;METROPOLITANA;319980;2;1;0;0;0;2;1;319980;Freezer horizontal 142Lts lfh-151 blanco;LINEA BLANCA
11226500;;F;53;CHILENO;;X;MAIPU;METROPOLITANA;238970;3;2;2;1;213980;1;1;24990;Encimera FDV Design 60 2.0 BUT;LINEA BLANCA
16943928;Soltero;F;33;CHILENO;;Millenial;PROVIDENCIA                   ;METROPOLITANA;328980;2;1;2;1;328980;0;0;0;Refrigerador RT43K6231SL/ZS 440Lts No Frost;LINEA BLANCA
13861532;;M;41;CHILENO;;X;PROVIDENCIA                   ;METROPOLITANA;199990;1;1;0;0;0;1;1;199990;Freezer 145 Lts FDHM150BY0 Horizontal;LINEA BLANCA
13354256;;F;44;CHILENO;;X;CONSTITUCION                  ;MAULE;159990;1;1;0;0;0;1;1;159990;Cocina CH-7400 4P;LINEA BLANCA
19094794;Soltero;M;27;CHILENO;INGENIERO ELECTRONICOS, ELECTRICOS;Z;PROVIDENCIA                   ;METROPOLITANA;245840;2;1;2;1;245840;0;0;0;Encimera a Gas F GC75V A 5P;LINEA BLANCA
18671335;;F;29;CHILENO;;Millenial;N/D;N/D;546470;3;1;0;0;0;3;1;546470;Lavadora Secadora Perfect Care 11/7Kg Blanca;LINEA BLANCA
8325164;;F;62;CHILENO;;Boomers;PAILLACO                      ;LOS RIOS;356970;3;1;0;0;0;3;1;356970;Lavadora Efficace SZG 17,5Kg Silver;LINEA BLANCA
15457172;;F;40;CHILENO;;X;LA CISTERNA                   ;METROPOLITANA;319980;2;1;0;0;0;2;1;319980;Cocina CH-6900IN 4P;LINEA BLANCA
10220393;Casado;F;58;CHILENO;;Boomers;PROVIDENCIA                   ;METROPOLITANA;169990;1;1;0;0;0;1;1;169990;Freezer horizontal 142Lts lfh-151 blanco;LINEA BLANCA
4592426;;M;81;CHILENO;;Silencioso;TIERRA AMARILLA               ;ATACAMA;189980;2;1;0;0;0;2;1;189980;Freezer 142Lts MFH-1430B186C Horizontal;LINEA BLANCA
17883325;;M;30;CHILENO;;Millenial;N/D;N/D;205480;2;1;2;1;205480;0;0;0;Secadora Ropa MSV-90 9K Blanca Ventilacion;LINEA BLANCA
14283884;;F;48;CHILENO;;X;CAUQUENES                     ;MAULE;474980;2;1;0;0;0;2;1;474980;Refrigerador DW44S 400Lts Dispen No Frost;LINEA BLANCA
18417279;;F;28;CHILENO;;Millenial;N/D;N/D;395830;3;2;2;1;255840;1;1;139990;Cocina CH-9950NG-1 6P Negro;LINEA BLANCA
5652063;;F;77;CHILENO;;Silencioso;PROVIDENCIA                   ;METROPOLITANA;274970;3;2;0;0;0;3;2;274970;Freezer 150 Lts SFH-151 BL Horizontal;LINEA BLANCA
18626287;;M;28;CHILENO;;Millenial;CONCHALI                      ;METROPOLITANA;60480;2;1;2;1;60480;0;0;0;CAMPANA AT-XN REIN 60 INOX;LINEA BLANCA
16440851;;F;36;CHILENO;;Millenial;N/D;N/D;954970;3;1;0;0;0;3;1;954970;Refrigerador 527Lts Side by Side MRSBS5300G689WE;LINEA BLANCA
12546174;;F;47;CHILENO;;X;RETIRO                        ;MAULE;159990;1;1;0;0;0;1;1;159990;Freezer 142Lts MFH-1430B186C Horizontal;LINEA BLANCA
10384193;;M;57;CHILENO;;Boomers;SAN ANTONIO                   ;VALPARAISO;169990;1;1;0;0;0;1;1;169990;Freezer 142Lts MFH-1430B186C Horizontal;LINEA BLANCA
8424435;;F;62;CHILENO;;Boomers;PENAFLOR                      ;METROPOLITANA;279980;2;1;0;0;0;2;1;279980;Cocina Andes60TX4 4P Inox;LINEA BLANCA
12562049;;F;48;CHILENO;;X;ZAPALLAR                      ;VALPARAISO;341360;3;1;0;0;0;3;1;341360;REFRIGERADOR 234Lt TMF RT22FARADS8/ZS;LINEA BLANCA
10107614;;M;57;CHILENO;;Boomers;SAN FERNANDO                  ;L.G.B.OÂ´HIGGINS;221980;2;1;0;0;0;2;1;221980;Cocina CH-9500 NG 4P;LINEA BLANCA
13567369;;M;42;CHILENO;;X;SANTO DOMINGO                 ;VALPARAISO;250980;2;1;0;0;0;2;1;250980;Freezer 196Lts M200 Horizontal;LINEA BLANCA
12281662;;F;50;CHILENO;;Silencioso;PROVIDENCIA                   ;METROPOLITANA;199990;1;1;0;0;0;1;1;199990;Lavadora WA90H4400SW/ZS 9Kg Blanca;LINEA BLANCA
18453362;;F;29;CHILENO;;Millenial;N/D;N/D;439080;4;2;4;2;439080;0;0;0;KIT-138 HORNO HE-7200IN+CEG-4600IN+CA-610EIN;LINEA BLANCA
10001488;Casado;M;57;CHILENO;AGROINDUSTRIA;Boomers;RENCA                         ;METROPOLITANA;229980;2;1;0;0;0;2;1;229980;Freezer 145 Lts FDHM150BY0 Horizontal;LINEA BLANCA
12799512;;M;47;CHILENO;;X;N/D;N/D;309980;2;1;0;0;0;2;1;309980;REFRIGERADOR TOP MOUNT GT29BPPK NO FROST 254 Lt;LINEA BLANCA
8381921;;F;64;CHILENO;;Boomers;COLINA                        ;METROPOLITANA;390970;3;2;0;0;0;3;2;390970;Lavadora Efficace BZG 9,5Kg Blanca;LINEA BLANCA
12802924;;M;47;CHILENO;;Millenial;N/D;N/D;183980;2;1;0;0;0;2;1;183980;Lavadora MLS-090GE04N 9Kg Gris;LINEA BLANCA
10372859;;F;53;CHILENO;;X;COIHAIQUE                     ;AYSEN;199990;1;1;0;0;0;1;1;199990;Lavadora WA90H4400SW/ZS 9Kg Blanca;LINEA BLANCA
7684619;;M;67;CHILENO;;Boomers;PUENTE ALTO                   ;METROPOLITANA;159980;2;1;0;0;0;2;1;159980;Lavadora MLS-090GE04N 9Kg Gris;LINEA BLANCA
13945454;;M;41;CHILENO;;X;PROVIDENCIA                   ;METROPOLITANA;176980;2;1;2;1;176980;0;0;0;Freezer 142Lts MFH-1430B186C Horizontal;LINEA BLANCA
10426237;Casado;F;56;CHILENO;;Boomers;PUNTA ARENAS                  ;MAGALLANES;391980;2;1;0;0;0;2;1;391980;Cocina F-5500 Premium 5P;LINEA BLANCA
12732051;;F;47;CHILENO;;X;CURANILAHUE                   ;BIO BIO;359990;1;1;0;0;0;1;1;359990;Lavadora Superior WA17T6260BY/ZS 17Kg;LINEA BLANCA
14283584;;F;48;CHILENO;;X;CONSTITUCION                  ;MAULE;0;0;2;0;0;0;0;2;0;Lavadora Efficace SZG 15,5Kg Silver;LINEA BLANCA
6295049;;F;70;CHILENO;;Silencioso;PITRUFQUEN                    ;ARAUCANIA;187550;5;1;0;0;0;5;1;187550;Freezer 142Lts MFH-1430B186C Horizontal;LINEA BLANCA
19873557;;F;27;CHILENO;;Z;ALTO HOSPICIO;TARAPACA;271540;2;1;2;1;271540;0;0;0;Cocina 785FX 4P;LINEA BLANCA
10434462;;F;58;CHILENO;;Boomers;N/D;N/D;293570;2;1;0;0;0;2;1;293570;Lavadora MLS-160BSC03T 16Kg Blanca;LINEA BLANCA
15622979;;F;39;CHILENO;;Silencioso;MELIPILLA                     ;METROPOLITANA;256980;2;1;0;0;0;2;1;256980;Refrigerador 260Lts BF Frio Direc MRFI2660SR346W;LINEA BLANCA
18542144;;F;29;CHILENO;;Millenial;PROVIDENCIA                   ;METROPOLITANA;82530;3;2;2;1;54540;1;1;27990;CAMPANA ESSENTIAL 601 BLANCA ALBIN TROTTER;LINEA BLANCA
14025398;;F;48;CHILENO;;X;LA CISTERNA                   ;METROPOLITANA;362060;3;1;0;0;0;3;1;362060;Cocina CMC20AXX 4P Inox;LINEA BLANCA
6101097;;F;72;CHILENO;;Silencioso;BUIN                          ;METROPOLITANA;299980;2;1;0;0;0;2;1;299980;Cocina F-2808 4P;LINEA BLANCA
15741830;;F;38;CHILENO;;Millenial;SAN FELIPE                    ;VALPARAISO;299980;2;1;0;0;0;2;1;299980;Lavadora WT13WSBP 13Kg Blanca;LINEA BLANCA
16613032;;F;34;CHILENO;;Millenial;CHONCHI                       ;LOS LAGOS;0;0;4;0;0;0;0;4;0;Cocina CH-9600RJ 4P;LINEA BLANCA
18332961;;F;29;CHILENO;;Millenial;NUEVA IMPERIAL                ;ARAUCANIA;159970;3;1;3;1;159970;0;0;0;Lavadora MLS-090GE04N 9Kg Gris;LINEA BLANCA
7899697;;F;64;CHILENO;;Boomers;N/D;N/D;465060;3;1;0;0;0;3;1;465060;Cocina F-5500 Premium 5P;LINEA BLANCA
10729746;Casado;F;54;CHILENO;;Boomers;PUDAHUEL                      ;METROPOLITANA;438380;6;2;0;0;0;6;2;438380;Lavadora WT16DSBP 16Kg Silver;LINEA BLANCA
8605326;Casado;M;64;CHILENO;;Boomers;RENCA                         ;METROPOLITANA;279980;2;1;2;1;279980;0;0;0;Cocina Andes60TX4 4P Inox;LINEA BLANCA
11538174;;F;51;CHILENO;;X;PROVIDENCIA                   ;METROPOLITANA;256980;2;1;0;0;0;2;1;256980;Cocina CMC5515GCH-1 4P;LINEA BLANCA
18630182;;F;28;CHILENO;;Millenial;PROVIDENCIA                   ;METROPOLITANA;210570;2;1;0;0;0;2;1;210570;Freezer 142Lts MFH-1430B186C Horizontal;LINEA BLANCA
6988678;;M;68;CHILENO;;Silencioso;HUALPEN;BIO BIO;196980;2;1;0;0;0;2;1;196980;Cocina CH-9050SI 4P;LINEA BLANCA
14400016;;F;44;CHILENO;;X;VICUNA                        ;COQUIMBO;285980;2;1;2;1;285980;0;0;0;Lavadora Efficace SZG 17,5Kg Silver;LINEA BLANCA
13768805;;M;41;CHILENO;;X;SAN ANTONIO                   ;VALPARAISO;315970;3;1;0;0;0;3;1;315970;Lavadora Efficace SZG 17,5Kg Silver;LINEA BLANCA
9873990;Casado;M;59;CHILENO;;Boomers;PENAFLOR                      ;METROPOLITANA;299360;3;1;0;0;0;3;1;299360;Refrigerador 241Lts BF Frio Directo Nordik 415;LINEA BLANCA
17412619;;M;32;CHILENO;;Millenial;PROVIDENCIA                   ;METROPOLITANA;479980;2;1;2;1;479980;0;0;0;COCINA UT EURO 80 PRO GL;LINEA BLANCA
17223652;;M;32;CHILENO;;Millenial;N/D;N/D;320960;4;2;4;2;320960;0;0;0;Refrigerador 260Lts BF Frio Direc MRFI2660SR346W;LINEA BLANCA
8440033;;F;57;CHILENO;;X;QUILPUE                       ;VALPARAISO;211980;2;1;0;0;0;2;1;211980;Cocina MV 220 4P;LINEA BLANCA
10840828;;M;54;CHILENO;;X;RENCA                         ;METROPOLITANA;588980;2;1;2;1;588980;0;0;0;Refrigerador 525Lts Side by Side SFX500;LINEA BLANCA
14452497;;F;51;CHILENO;;X;HIJUELAS                      ;VALPARAISO;159990;1;1;0;0;0;1;1;159990;Freezer 142Lts MFH-1430B186C Horizontal;LINEA BLANCA
26461960;;F;58;VENEZOLANO;;Extranjero;LOS ANGELES                   ;BIO BIO;201960;3;1;0;0;0;3;1;201960;Freezer 99Lts MFH-1000B131CN Horizontal;LINEA BLANCA
16131724;;M;36;CHILENO;;Millenial;N/D;N/D;439980;2;1;0;0;0;2;1;439980;Lavadora Secadora MF100D110B/T 11Kg/8KG Gris;LINEA BLANCA
25090098;;F;38;ECUATORIANO;;Extranjero;SAN MIGUEL                    ;METROPOLITANA;0;0;2;0;0;0;0;2;0;Lavadora WT13WSBP 13Kg Blanca;LINEA BLANCA
18516856;;F;29;CHILENO;;Millenial;N/D;N/D;316560;3;1;0;0;0;3;1;316560;Refrigerador 260Lts BF Frio Direc MRFI2660SR346W;LINEA BLANCA
15472040;;F;39;CHILENO;;X;PROVIDENCIA                   ;METROPOLITANA;369980;2;1;2;1;369980;0;0;0;Refrigerador LB33MPP 306Lts Bottom No Frost;LINEA BLANCA
5931229;;M;72;CHILENO;;Silencioso;TALCAHUANO                    ;BIO BIO;299370;2;1;0;0;0;2;1;299370;Lavadora MLS-140GSC03T 14Kg Gris;LINEA BLANCA
18886326;;F;28;CHILENO;;Millenial;MARIQUINA                     ;LOS LAGOS;365060;3;1;0;0;0;3;1;365060;Lavadora Efficace SZG 17,5Kg Silver;LINEA BLANCA
12101500;;M;51;CHILENO;;X;CATEMU                        ;VALPARAISO;447450;4;2;0;0;0;4;2;447450;Refrigerador 254Lts No Frost GT29WPPDC;LINEA BLANCA
4865184;;M;80;CHILENO;;Silencioso;VALLENAR;ATACAMA;261560;3;1;0;0;0;3;1;261560;Lavadora Efficace BZG 9,5Kg Blanca;LINEA BLANCA
13781338;;M;41;CHILENO;;X;NANCAGUA                      ;L.G.B.OÂ´HIGGINS;427450;4;2;0;0;0;4;2;427450;Cocina Diva 920 5P;LINEA BLANCA
17879533;;M;30;CHILENO;;Millenial;N/D;N/D;359980;2;1;2;1;359980;0;0;0;Lavadora Premium Care 20SZ 20Kg Silver;LINEA BLANCA
17852821;;M;31;CHILENO;;Millenial;PROVIDENCIA                   ;METROPOLITANA;449980;2;1;2;1;449980;0;0;0;Refrigerador 527Lts Side by Side MRSBS5300G689WE;LINEA BLANCA
13374275;;M;44;CHILENO;;X;PARRAL                        ;MAULE;119990;1;1;0;0;0;1;1;119990;Calefon 10Lts GL ATMD;LINEA BLANCA
12092445;;M;53;CHILENO;;X;PUENTE ALTO                   ;METROPOLITANA;329990;1;1;0;0;0;1;1;329990;Cocina Diva 920 5P;LINEA BLANCA
6781613;;F;71;CHILENO;;Silencioso;N/D;N/D;690570;2;1;0;0;0;2;1;690570;Refrigerador 525Lts Side by Side SFX500;LINEA BLANCA
17423632;Soltero;M;32;CHILENO;;Millenial;RENCA                         ;METROPOLITANA;269990;1;1;0;0;0;1;1;269990;Refrigerador 252Lts No Frost MRFS-2700G333FW;LINEA BLANCA
13273885;;F;53;CHILENO;;X;CARAHUE                       ;ARAUCANIA;791480;9;2;0;0;0;9;2;791480;Refrigerador 300Lts No Frost RT29K500JS8/ZS;LINEA BLANCA
11473127;;M;53;CHILENO;;X;PROVIDENCIA                   ;METROPOLITANA;88980;2;1;2;1;88980;0;0;0;ENCIMERA CE4-600 INOX 4P SINDELEN;LINEA BLANCA
17541466;;M;31;CHILENO;;Millenial;N/D;N/D;925650;5;1;5;1;925650;0;0;0;Cocina CH-8900IN 5P;LINEA BLANCA
18899178;Soltero;F;27;CHILENO;INGENIERO EN ADMINISTRACION DE EMPRESAS;Z;PROVIDENCIA                   ;METROPOLITANA;315980;2;1;2;1;315980;0;0;0;REFRIGERADOR TOP MOUNT GT29BPPK NO FROST 254 Lt;LINEA BLANCA
18468906;;F;29;CHILENO;;Millenial;N/D;N/D;402760;3;1;0;0;0;3;1;402760;Lavadora Efficace SZG 19,5Kg Silver;LINEA BLANCA
9708047;;M;59;CHILENO;;Boomers;RENCA                         ;METROPOLITANA;251980;2;1;2;1;251980;0;0;0;Lavadora WT13WSBP 13Kg Blanca;LINEA BLANCA
11853854;;M;50;CHILENO;;X;RENCA                         ;METROPOLITANA;187370;2;1;0;0;0;2;1;187370;Calefon 11Lts GL Master;LINEA BLANCA
16057124;;F;36;CHILENO;;Millenial;N/D;N/D;285980;2;1;2;1;285980;0;0;0;Lavadora Efficace SZG 17,5Kg Silver;LINEA BLANCA
10545377;Divorciado;M;53;CHILENO;TECNICO EN ADMINISTRACION DE EMPRESAS;X;TEMUCO                        ;ARAUCANIA;277980;2;1;0;0;0;2;1;277980;Lavadora Brilliant SG 11,5Kg Silver;LINEA BLANCA
12513983;Soltero;F;48;CHILENO;;X;RENCA                         ;METROPOLITANA;239980;2;1;2;1;239980;0;0;0;Refrigerador 252Lts No Frost MRFS-2700G333FW;LINEA BLANCA
19325270;;F;25;CHILENO;;Z;"";"";493980;2;1;2;1;493980;0;0;0;Refrigerador Side by side Multidoor DM64S;LINEA BLANCA
16583334;;F;34;CHILENO;;Millenial;CAUQUENES                     ;MAULE;811970;3;1;3;1;811970;0;0;0;Refrigerador Side by side Multidoor DM64S;LINEA BLANCA
9736133;;F;59;CHILENO;;Boomers;N/D;N/D;325470;2;1;0;0;0;2;1;325470;Lavadora Efficace SZG 15,5Kg Silver;LINEA BLANCA
10287723;;M;55;CHILENO;;Boomers;CORONEL                       ;BIO BIO;257360;3;2;0;0;0;3;2;257360;Lavadora WA90H4400SW/ZS 9Kg Blanca;LINEA BLANCA
8165671;;M;65;CHILENO;;Boomers;N/D;N/D;319290;6;2;2;1;189640;4;1;129650;Cocina MV 120 4 Platos;LINEA BLANCA
3888308;;M;86;CHILENO;;Silencioso;ARICA                         ;TARAPACA;218480;2;1;0;0;0;2;1;218480;Cocina CH-9050SI 4P;LINEA BLANCA
17407799;;F;32;CHILENO;;Millenial;PROVIDENCIA                   ;METROPOLITANA;269980;2;1;2;1;269980;0;0;0;Refrigerador 244Lts Frio Directo Progress 3100;LINEA BLANCA
18543684;;M;28;CHILENO;;Silencioso;N/D;N/D;203980;2;1;2;1;203980;0;0;0;Lavadora superior MLS-110GE04N 11Kg;LINEA BLANCA
16833789;;F;34;CHILENO;;Millenial;ILLAPEL                       ;COQUIMBO;215980;2;1;2;1;215980;0;0;0;Freezer 200 Lts FDHM200BY0 Horizontal;LINEA BLANCA
17374694;;F;32;CHILENO;;Millenial;LOS ALAMOS                    ;BIO BIO;493970;3;2;2;1;363980;1;1;129990;Lavadora WT19DSBP 19Kg Silver;LINEA BLANCA
11526374;;F;51;CHILENO;;X;RENCA                         ;METROPOLITANA;301980;2;1;0;0;0;2;1;301980;Cocina 795XF 4P;LINEA BLANCA
8687054;;F;61;CHILENO;;Boomers;ARICA                         ;TARAPACA;215980;2;1;0;0;0;2;1;215980;Cocina CMC20AXX 4P Inox;LINEA BLANCA
8202957;;F;65;CHILENO;;Boomers;VALPARAISO                    ;VALPARAISO;715630;5;3;0;0;0;5;3;715630;Cocina Andes60TX4 4P Inox;LINEA BLANCA
19897495;;F;23;CHILENO;;Z;N/D;N/D;284980;3;1;0;0;0;3;1;284980;Refrigerador 249Lts No Frost RMA250PHUG;LINEA BLANCA
15433135;;M;40;CHILENO;;X;PROVIDENCIA                   ;METROPOLITANA;473960;3;1;3;1;473960;0;0;0;Cocina CH-8900IN 5P;LINEA BLANCA
19249919;;F;26;CHILENO;;Z;N/D;N/D;269990;1;1;0;0;0;1;1;269990;Refrigerador 249Lts No Frost RMA250PHUG;LINEA BLANCA
17746926;;M;31;CHILENO;;Millenial;N/D;N/D;519980;2;2;0;0;0;2;2;519980;Lavadora MLS-160BSC03T 16Kg Blanca;LINEA BLANCA
18688678;;F;28;CHILENO;;Millenial;OVALLE                        ;COQUIMBO;155980;2;1;2;1;155980;0;0;0;Cocina CMC20AXX 4P Inox;LINEA BLANCA
18213396;;F;29;CHILENO;;Millenial;MELIPILLA                     ;METROPOLITANA;233980;2;1;2;1;233980;0;0;0;Lavadora MLS-160BSC03T 16Kg Blanca;LINEA BLANCA
12184639;;M;49;CHILENO;;X;CHILLAN                       ;BIO BIO;475350;4;1;0;0;0;4;1;475350;Refrigerador 249Lts No Frost RMA250PHUG;LINEA BLANCA
5927845;;F;73;CHILENO;;Silencioso;ESTACION CENTRAL              ;METROPOLITANA;269980;2;1;0;0;0;2;1;269980;Cocina 775X 4P;LINEA BLANCA
21448845;;M;38;ECUATORIANO;;Extranjero;N/D;N/D;303980;2;1;2;1;303980;0;0;0;Cocina Andes76HG0 6P Inox;LINEA BLANCA
7612428;;F;63;CHILENO;;Boomers;SAN FELIPE                    ;VALPARAISO;379980;2;1;0;0;0;2;1;379980;Refrigerador 300Lts No Frost RT29K500JS8/ZS;LINEA BLANCA
18664022;;M;28;CHILENO;;Silencioso;PROVIDENCIA                   ;METROPOLITANA;267960;4;2;4;2;267960;0;0;0;HORNO EMPOTRABLE HE-7200 INOX 2250W 57L SINDELEN;LINEA BLANCA
13235417;;F;45;CHILENO;;Silencioso;PROVIDENCIA                   ;METROPOLITANA;336980;2;1;2;1;336980;0;0;0;Cocina MCG-4QI24AME4 4P Inox;LINEA BLANCA
18453463;;F;28;CHILENO;;Millenial;PROVIDENCIA                   ;METROPOLITANA;369981;2;2;0;0;0;2;2;369981;Lavadora Secadora WD90M4453JW/ZS 9/5Kg Blanca;LINEA BLANCA
3177107;;F;87;CHILENO;;Silencioso;CURICO                        ;MAULE;219370;2;1;0;0;0;2;1;219370;Lavadora WA90H4400SW/ZS 9Kg Blanca;LINEA BLANCA
12445037;;F;49;CHILENO;;X;PROVIDENCIA                   ;METROPOLITANA;351980;2;1;2;1;351980;0;0;0;KIT-138 HORNO HE-7200IN+CEG-4600IN+CA-610EIN;LINEA BLANCA
20371368;;M;22;CHILENO;;Z;N/D;N/D;188980;2;1;2;1;188980;0;0;0;Refrigerador 210Lts Rojo Frio Dir MRFS2100R273FN;LINEA BLANCA
11315774;;M;54;CHILENO;;Silencioso;PROVIDENCIA                   ;METROPOLITANA;414760;3;1;0;0;0;3;1;414760;Lavadora Premium Care 20SZ 20Kg Silver;LINEA BLANCA
15821554;;F;37;CHILENO;;Millenial;RECOLETA                      ;METROPOLITANA;313980;2;1;2;1;313980;0;0;0;Secadora Ropa MSC-90 9K Blanca Condensacion;LINEA BLANCA
10253101;;M;55;CHILENO;;Boomers;PAINE                         ;METROPOLITANA;179670;2;1;0;0;0;2;1;179670;Calefon 10Lts GL ATMD;LINEA BLANCA
18752130;;M;27;CHILENO;;Millenial;PROVIDENCIA                   ;METROPOLITANA;118640;2;1;2;1;118640;0;0;0;Lavadora Semiautomatica LS-6100 6Kg Gris;LINEA BLANCA
13117449;;M;46;CHILENO;;Silencioso;PROVIDENCIA                   ;METROPOLITANA;289990;1;1;0;0;0;1;1;289990;Lavadora MLS-160BSC03T 16Kg Blanca;LINEA BLANCA
11252400;;F;54;CHILENO;;X;ANCUD                         ;LOS LAGOS;556740;4;1;0;0;0;4;1;556740;Cocina F-2808 4P;LINEA BLANCA
20166500;;F;22;CHILENO;;Z;PROVIDENCIA                   ;METROPOLITANA;227540;2;1;2;1;227540;0;0;0;Refrigerador 167Lts Frio Directo 1700-S;LINEA BLANCA
19033207;;F;27;CHILENO;;Silencioso;PROVIDENCIA                   ;METROPOLITANA;909970;3;1;3;1;909970;0;0;0;Secadora LG DF9WPN por condensacion 9K con Smart;LINEA BLANCA
9998985;;F;56;CHILENO;;Boomers;SAN CARLOS                    ;BIO BIO;380470;2;1;0;0;0;2;1;380470;Cocina F-5500 Premium 5P;LINEA BLANCA
4668023;;F;78;CHILENO;;Silencioso;ESTACION CENTRAL              ;METROPOLITANA;279980;2;1;0;0;0;2;1;279980;Cocina F-2608 4P Inox;LINEA BLANCA
12537692;;M;48;CHILENO;;X;N/D;N/D;397980;2;1;0;0;0;2;1;397980;Cocina Andes7650FX 5P Inox;LINEA BLANCA
7009544;;F;73;CHILENO;;Silencioso;MARIQUINA                     ;LOS LAGOS;374460;3;1;0;0;0;3;1;374460;Cocina Andes76HG0 6P Inox;LINEA BLANCA
11051281;;F;55;CHILENO;;Boomers;CALAMA                        ;ANTOFAGASTA;244360;3;1;0;0;0;3;1;244360;Cocina MV 110 4 Platos;LINEA BLANCA
25830666;;M;26;COLOMBIANO;;Extranjero;SANTIAGO                      ;METROPOLITANA;279980;2;1;0;0;0;2;1;279980;Cocina 785FX 4P;LINEA BLANCA
19745754;;F;24;CHILENO;;Z;N/D;N/D;173980;2;1;2;1;173980;0;0;0;Lavadora WA80H4200SW/ZS 8Kg Blanca;LINEA BLANCA
5402033;Casado;M;71;CHILENO;PROFESOR;Silencioso;LA LIGUA                      ;VALPARAISO;312360;3;1;0;0;0;3;1;312360;Lavadora Brilliant SG 15Kg Silver;LINEA BLANCA
15849655;Soltero;F;37;CHILENO;TECNICO DE NIVEL SUPERIOR EN ARSENALERIA QUIRURGICA;Millenial;PROVIDENCIA                   ;METROPOLITANA;219990;2;1;2;1;219990;0;0;0;Secadora Ropa Reverplus 6470 7Kg Gris Ventilacio;LINEA BLANCA
10527537;;F;56;CHILENO;;Boomers;CARTAGENA                     ;VALPARAISO;139980;2;1;2;1;139980;0;0;0;FRIGOBAR 93 LTS MFB-930S121LN;LINEA BLANCA
7005792;;M;70;CHILENO;;Silencioso;N/D;N/D;452770;2;1;0;0;0;2;1;452770;Refrigerador 290Lts BF No Frost RB30N4020S8;LINEA BLANCA
6829260;;F;70;CHILENO;;Silencioso;PROVIDENCIA                   ;METROPOLITANA;60000;1;1;0;0;0;1;1;60000;Producto Segunda Seleccion Banda 2;LINEA BLANCA
7229265;;M;64;CHILENO;;Boomers;PAINE                         ;METROPOLITANA;839970;3;3;0;0;0;3;3;839970;Refrigerador DW44S 400Lts Dispen No Frost;LINEA BLANCA
10553288;Casado;M;55;CHILENO;AGROINDUSTRIA;Boomers;CARAHUE                       ;ARAUCANIA;278980;2;1;0;0;0;2;1;278980;Lavadora MLS-140GSC03T 14Kg Gris;LINEA BLANCA
12760907;;M;46;CHILENO;;X;CALBUCO                       ;LOS LAGOS;245560;3;1;0;0;0;3;1;245560;Lavadora MLS-090GE04N 9Kg Gris;LINEA BLANCA
19198109;;M;26;CHILENO;;Z;TEMUCO                        ;ARAUCANIA;394980;2;1;2;1;394980;0;0;0;Lavadora 13 Kg Carga Superior;LINEA BLANCA
11448433;;F;53;CHILENO;;X;CONCEPCION                    ;BIO BIO;316360;3;1;0;0;0;3;1;316360;Refrigerador 241Lts BF Frio Directo Nordik 415;LINEA BLANCA
12794632;;F;47;CHILENO;;X;RENCA                         ;METROPOLITANA;592450;5;1;0;0;0;5;1;592450;Lavadora WT19DSBP 19Kg Silver;LINEA BLANCA
15146291;;M;39;CHILENO;;X;CONSTITUCION                  ;MAULE;362750;4;2;0;0;0;4;2;362750;Refrigerador 260Lts BF Frio Direc MRFI2660SR346W;LINEA BLANCA
5093707;;M;77;CHILENO;;Silencioso;PROVIDENCIA                   ;METROPOLITANA;345470;2;1;0;0;0;2;1;345470;Refrigerador 252Lts No Frost MRFS-2700G333FW;LINEA BLANCA
19276228;;M;26;CHILENO;;Z;PAINE                         ;METROPOLITANA;224990;2;1;0;0;0;2;1;224990;Freezer 142Lts EFC14A5MNW Horizontal;LINEA BLANCA
16725145;;M;34;CHILENO;;Millenial;"";"";173980;2;1;2;1;173980;0;0;0;Lavadora WA80H4200SW/ZS 8Kg Blanca;LINEA BLANCA
6688737;Viudo;F;69;CHILENO;;Silencioso;RENCA                         ;METROPOLITANA;355470;2;1;0;0;0;2;1;355470;Refrigerador 244Lts Frio Directo Progress 3100;LINEA BLANCA
16136039;;F;36;CHILENO;;Millenial;N/D;N/D;267870;2;1;0;0;0;2;1;267870;Cocina CMC5515GCH-1 4P;LINEA BLANCA
15305175;;F;39;CHILENO;;X;CHILE CHICO                   ;AYSEN;262980;2;1;2;1;262980;0;0;0;Freezer Horizonal SFH-101BL 99Lts;LINEA BLANCA
22568097;;M;46;BOLIVIANO;;Extranjero;ARICA                         ;TARAPACA;358970;3;2;0;0;0;3;2;358970;Lavadora Efficace SZG 15,5Kg Silver;LINEA BLANCA
7527245;;F;67;CHILENO;;Boomers;CURICO                        ;MAULE;286250;3;1;0;0;0;3;1;286250;Cocina CH-9500 NG 4P;LINEA BLANCA
17622345;;M;33;CHILENO;;Millenial;PROVIDENCIA                   ;METROPOLITANA;0;0;0;0;0;0;0;0;0;COCINA CH-6700IN 4P;LINEA BLANCA
12752344;;M;47;CHILENO;;Silencioso;PROVIDENCIA                   ;METROPOLITANA;0;0;0;0;0;0;0;0;0;Campana Cocina FXU6160 60CM;LINEA BLANCA
16460477;;F;36;CHILENO;;Millenial;RENCA                         ;METROPOLITANA;0;0;0;0;0;0;0;0;0;Lavadora Efficace SZG 9,5Kg Silver;LINEA BLANCA
20105309;;F;23;CHILENO;;Millenial;"";"";0;0;0;0;0;0;0;0;0;Lavadora MLS-160BSC03T 16Kg Blanca;LINEA BLANCA
21822005;;F;59;PERUANO;;Extranjero;N/D;N/D;0;0;0;0;0;0;0;0;0;Refrigerador 425Lts No Frost Altus 1430W;LINEA BLANCA
16262712;;M;36;CHILENO;;Millenial;N/D;N/D;0;0;0;0;0;0;0;0;0;Cocina F-2808 4P;LINEA BLANCA
17360707;;F;32;CHILENO;;Silencioso;PROVIDENCIA                   ;METROPOLITANA;0;0;0;0;0;0;0;0;0;Secadora Ropa MSBC-90BCH02 9K Blanca Bomba Calor;LINEA BLANCA
8974672;;M;62;CHILENO;;Boomers;ILLAPEL                       ;COQUIMBO;0;0;0;0;0;0;0;0;0;Lavadora MLS-160BSC03T 16Kg Blanca;LINEA BLANCA
19090886;;F;26;CHILENO;;Z;CONCEPCION                    ;BIO BIO;0;0;0;0;0;0;0;0;0;REFRIGERADOR 234Lt TMF RT22FARADS8/ZS;LINEA BLANCA
19264027;;M;26;CHILENO;;Z;LAS CABRAS                    ;L.G.B.OÂ´HIGGINS;0;0;0;0;0;0;0;0;0;Secadora Ropa MSV-90 9K Blanca Ventilacion;LINEA BLANCA
14060868;;M;41;CHILENO;;X;PROVIDENCIA                   ;METROPOLITANA;0;0;0;0;0;0;0;0;0;Cocina MV 110 4 Platos;LINEA BLANCA
7624336;;M;64;CHILENO;;Silencioso;PROVIDENCIA                   ;METROPOLITANA;0;0;0;0;0;0;0;0;0;Refrigerador 252Lts No Frost MRFS-2700G333FW;LINEA BLANCA
8854770;;M;61;CHILENO;;Boomers;SAAVEDRA                      ;ARAUCANIA;0;0;0;0;0;0;0;0;0;Refrigerador 254Lts No Frost GT29WPPDC;LINEA BLANCA
11931153;;F;50;CHILENO;;X;RENCA                         ;METROPOLITANA;0;0;0;0;0;0;0;0;0;Lavadora WA17T6260BW/ZS 17Kg Blanca;LINEA BLANCA
8622690;;F;63;CHILENO;;Boomers;PICHILEMU                     ;L.G.B.OÂ´HIGGINS;0;0;0;0;0;0;0;0;0;Lavadora WA13T5260BW/ZS 13Kg Blanca;LINEA BLANCA
17103980;;F;33;CHILENO;;Millenial;"";"";0;0;0;0;0;0;0;0;0;Refrigerador 241Lts BF Frio Directo Nordik 415;LINEA BLANCA
12875126;;M;47;CHILENO;;X;"";"";0;0;0;0;0;0;0;0;0;COCINA CH-5700SI 4P;LINEA BLANCA
8087091;;F;66;CHILENO;;Boomers;MELIPILLA                     ;METROPOLITANA;0;0;0;0;0;0;0;0;0;Lavadora Premium Care 20SZ 20Kg Silver;LINEA BLANCA
5377499;;F;78;CHILENO;;Silencioso;EL MONTE                      ;METROPOLITANA;0;0;0;0;0;0;0;0;0;Cocina Diva 840 6P;LINEA BLANCA
11772253;;M;50;CHILENO;;X;COIHUECO                      ;BIO BIO;0;0;0;0;0;0;0;0;0;Lavadora MLS-140GSC03T 14Kg Gris;LINEA BLANCA
16790998;;F;33;CHILENO;;Millenial;N/D;N/D;0;0;0;0;0;0;0;0;0;Refrigerador 262Lts No Frost MRFI-2760S349RW-DA;LINEA BLANCA
18944382;;M;27;CHILENO;;Silencioso;PROVIDENCIA                   ;METROPOLITANA;0;0;0;0;0;0;0;0;0;Lavadora Secadora MF100D110B/T 11Kg/8KG Gris;LINEA BLANCA
16971752;;F;33;CHILENO;;Silencioso;PROVIDENCIA                   ;METROPOLITANA;0;0;0;0;0;0;0;0;0;Cocina CH-9600RJ 4P;LINEA BLANCA
4939879;;F;81;CHILENO;;Silencioso;ARICA                         ;ARICA Y PARINACOTA;0;0;0;0;0;0;0;0;0;Refrigerador 252Lts No Frost MRFS-2700G333FW;LINEA BLANCA
19963956;;F;23;CHILENO;;Z;PROVIDENCIA                   ;METROPOLITANA;0;0;0;0;0;0;0;0;0;Refrigerador 244Lts Frio Directo Progress 3100;LINEA BLANCA
13797379;;F;42;CHILENO;;X;N/D;N/D;0;0;0;0;0;0;0;0;0;Refrigerador 260Lts BF Frio Direc MRFI2660SR346W;LINEA BLANCA
6570756;;M;67;CHILENO;;Boomers;RENCA                         ;METROPOLITANA;0;0;0;0;0;0;0;0;0;Lavadora Premium Care Pro 16Kg Silver;LINEA BLANCA
13651619;;M;43;CHILENO;;Millenial;"";"";0;0;0;0;0;0;0;0;0;Lavadora Secadora MLSF-1108BN05N 11Kg/8Kg Blanca;LINEA BLANCA
8577877;;F;64;CHILENO;;Boomers;PADRE HURTADO                 ;METROPOLITANA;0;0;0;0;0;0;0;0;0;Cocina 775X 4P;LINEA BLANCA
19072782;;F;26;CHILENO;;Silencioso;PROVIDENCIA                   ;METROPOLITANA;0;0;0;0;0;0;0;0;0;Refrigerador 251Lts No Frost Altus 1250;LINEA BLANCA
15963303;;F;37;CHILENO;;Millenial;PROVIDENCIA                   ;METROPOLITANA;0;0;0;0;0;0;0;0;0;CENTRIFUGA C-752;LINEA BLANCA
16171794;;F;37;CHILENO;;Silencioso;N/D;N/D;0;0;0;0;0;0;0;0;0;ENCIMERA GAS FCE-2HF MADEMSA;LINEA BLANCA
5560689;;F;71;CHILENO;;Silencioso;QUILPUE                       ;VALPARAISO;0;0;0;0;0;0;0;0;0;Cocina CH-7400 4P;LINEA BLANCA
19974697;;F;23;CHILENO;;Z;SAN ANTONIO                   ;VALPARAISO;0;0;0;0;0;0;0;0;0;Cocina 5Q ANDES7670FX0 Acero Inox;LINEA BLANCA
18174617;Soltero;M;28;CHILENO;INGENIERO EJECUCION FORESTAL;Silencioso;PROVIDENCIA                   ;METROPOLITANA;0;0;0;0;0;0;0;0;0;Campana FDV Prime 60;LINEA BLANCA
19714329;;F;24;CHILENO;;Z;PROVIDENCIA                   ;METROPOLITANA;0;0;0;0;0;0;0;0;0;Lavadora WA90H4400SW/ZS 9Kg Blanca;LINEA BLANCA
6625769;;M;66;CHILENO;;Boomers;TALCAHUANO                    ;BIO BIO;0;0;0;0;0;0;0;0;0;Lavadora WT13WSBP 13Kg Blanca;LINEA BLANCA
6302440;;F;71;CHILENO;;Silencioso;ARICA                         ;ARICA Y PARINACOTA;0;0;0;0;0;0;0;0;0;Lavadora Efficace SZG 17,5Kg Silver;LINEA BLANCA
11432807;;F;53;CHILENO;;X;PUNTA ARENAS                  ;MAGALLANES;0;0;0;0;0;0;0;0;0;Refrigerador 260Lts BF Frio Direc MRFI2660SR346W;LINEA BLANCA
10011119;;M;58;CHILENO;;Boomers;ANCUD                         ;LOS LAGOS;0;0;0;0;0;0;0;0;0;Refrigerador 252Lts No Frost MRFS-2700G333FW;LINEA BLANCA
5778873;;M;70;CHILENO;;Silencioso;VALDIVIA                      ;LOS LAGOS;0;0;0;0;0;0;0;0;0;Secadora Ropa Solare 7100 7K Ventilacion;LINEA BLANCA
15466599;;F;40;CHILENO;;X;LO ESPEJO                     ;METROPOLITANA;0;0;0;0;0;0;0;0;0;Calefont Essential 11 ECO GL;LINEA BLANCA
19277794;Soltero;F;26;CHILENO;;Z;PROVIDENCIA                   ;METROPOLITANA;0;0;0;0;0;0;0;0;0;Lavadora Efficace BZG 9,5Kg Blanca;LINEA BLANCA
8733044;;F;61;CHILENO;;Millenial;N/D;N/D;0;0;0;0;0;0;0;0;0;Lavadora MLS-090GE04N 9Kg Gris;LINEA BLANCA
7875503;;F;79;CHILENO;;Silencioso;PAINE                         ;METROPOLITANA;0;0;0;0;0;0;0;0;0;Lavadora Efficace SZG 15,5Kg Silver;LINEA BLANCA
14753864;;F;40;PERUANO;;Extranjero;LA FLORIDA                    ;METROPOLITANA;0;0;0;0;0;0;0;0;0;Refrigerador 244Lts Frio Directo Progress 3100;LINEA BLANCA
19047000;Soltero;M;27;CHILENO;PROFESOR;Z;PROVIDENCIA                   ;METROPOLITANA;0;0;0;0;0;0;0;0;0;Refrigerador 290Lts BF No Frost RB30N4020S8;LINEA BLANCA
17858099;Soltero;M;31;CHILENO;;Millenial;PROVIDENCIA                   ;METROPOLITANA;0;0;0;0;0;0;0;0;0;Freezer Vertical MFV-2400S312FW 227Lts;LINEA BLANCA
11685618;;F;51;CHILENO;;X;RIO CLARO                     ;MAULE;0;0;0;0;0;0;0;0;0;Refrigerador 254Lts No Frost GT29WPPDC;LINEA BLANCA
17494775;;M;32;CHILENO;;Millenial;PROVIDENCIA                   ;METROPOLITANA;0;0;0;0;0;0;0;0;0;Cocina 775X 4P;LINEA BLANCA
14614021;;F;41;CHILENO;;X;COQUIMBO                      ;COQUIMBO;0;0;0;0;0;0;0;0;0;Lavadora WD10J6410AX/ZS 10,5Kg;LINEA BLANCA
5976906;;M;68;CHILENO;;Boomers;NOGALES                       ;VALPARAISO;0;0;0;0;0;0;0;0;0;Lavadora Premium Care 20SZ 20Kg Silver;LINEA BLANCA
19599307;;F;24;CHILENO;;Z;SAN MIGUEL                    ;METROPOLITANA;0;0;0;0;0;0;0;0;0;Lavadora MLS-090GE04N 9Kg Gris;LINEA BLANCA
15393976;;M;40;CHILENO;;Silencioso;PROVIDENCIA                   ;METROPOLITANA;0;0;0;0;0;0;0;0;0;Lavadora Premium Care Pro 16Kg Silver;LINEA BLANCA
16445227;;F;36;CHILENO;;Millenial;CHILLAN                       ;BIO BIO;0;0;0;0;0;0;0;0;0;Lavadora LMA0920WGCL0 9,5Kg Gris;LINEA BLANCA
17751954;;F;31;CHILENO;;Silencioso;N/D;N/D;0;0;0;0;0;0;0;0;0;FREEZERSFV-200 SILVER 183L SINDELEN;LINEA BLANCA
17167997;;F;33;CHILENO;;Millenial;N/D;N/D;0;0;0;0;0;0;0;0;0;Lavadora MLS-160BSC03T 16Kg Blanca;LINEA BLANCA
7436857;Casado;M;65;CHILENO;;Boomers;RENCA                         ;METROPOLITANA;0;0;0;0;0;0;0;0;0;Encimera CE2-435I 2P Inox;LINEA BLANCA
16802663;;F;34;CHILENO;;Millenial;CONCHALI                      ;METROPOLITANA;0;0;0;0;0;0;0;0;0;Lavadora MLS-160BSC03T 16Kg Blanca;LINEA BLANCA
12632806;;F;48;CHILENO;;X;MAIPU                         ;METROPOLITANA;0;0;0;0;0;0;0;0;0;Lavadora Secadora WD12N64FR 12/7Kg;LINEA BLANCA
13752204;;F;42;CHILENO;;X;SANTA MARIA                   ;VALPARAISO;0;0;0;0;0;0;0;0;0;Refrigerador 290Lts BF No Frost RB30N4020S8;LINEA BLANCA
23633811;;M;42;DOMINICANO;;Extranjero;TALAGANTE                     ;METROPOLITANA;0;0;0;0;0;0;0;0;0;Lavadora WT16DSBP 16Kg Silver;LINEA BLANCA
18475745;;M;28;CHILENO;;Millenial;TALCA                         ;MAULE;0;0;0;0;0;0;0;0;0;Lavadora Efficace BZG 9,5Kg Blanca;LINEA BLANCA
16710023;;F;35;CHILENO;;Millenial;CONSTITUCION                  ;MAULE;0;0;0;0;0;0;0;0;0;Cocina CH-8700IN 5P;LINEA BLANCA
7453511;;F;77;CHILENO;;Silencioso;SAN PEDRO DE LA PAZ           ;BIO BIO;0;0;0;0;0;0;0;0;0;Lavadora MLS-140GSC03T 14Kg Gris;LINEA BLANCA
10624104;Soltero;F;52;CHILENO;INGENIERO;X;RENCA                         ;METROPOLITANA;0;0;0;0;0;0;0;0;0;Lavadora Efficace SZG 9,5Kg Silver;LINEA BLANCA
16313301;;F;36;CHILENO;;Millenial;TOME                          ;BIO BIO;0;0;0;0;0;0;0;0;0;Lavadora Efficace SZG 19,5Kg Silver;LINEA BLANCA
9421187;;F;60;CHILENO;;Boomers;RANCAGUA                      ;L.G.B.OÂ´HIGGINS;0;0;0;0;0;0;0;0;0;Secadora Ropa Solare 7100 7K Ventilacion;LINEA BLANCA
19532098;;F;25;CHILENO;;Silencioso;PROVIDENCIA                   ;METROPOLITANA;0;0;0;0;0;0;0;0;0;Cocina CMC20AXX 4P Inox;LINEA BLANCA
8421201;;M;65;CHILENO;;Boomers;VALDIVIA                      ;LOS RIOS;0;0;0;0;0;0;0;0;0;Lavadora MLS-090GE04N 9Kg Gris;LINEA BLANCA
6505789;;F;70;CHILENO;;Silencioso;CONCEPCION                    ;BIO BIO;0;0;0;0;0;0;0;0;0;Cocina CH-7400 4P;LINEA BLANCA
18793048;;M;27;CHILENO;;Extranjero;"";"";0;0;0;0;0;0;0;0;0;Refrigerador 341Lts BF No Frost GB37MPD;LINEA BLANCA
17292124;;F;33;CHILENO;;Silencioso;PROVIDENCIA                   ;METROPOLITANA;0;0;0;0;0;0;0;0;0;ENCIMERA A GAS 4 PLATOS CEG-4600 INOX;LINEA BLANCA
13523859;;F;46;CHILENO;;X;OSORNO                        ;LOS LAGOS;0;0;0;0;0;0;0;0;0;CENTRIFUGA C-752;LINEA BLANCA
15113768;;M;40;CHILENO;;X;COLTAUCO                      ;L.G.B.OÂ´HIGGINS;0;0;0;0;0;0;0;0;0;Secadora Electrica SEM101BDBY Blanca 10 KG;LINEA BLANCA
12710549;;M;47;CHILENO;;X;RENCA                         ;METROPOLITANA;0;0;0;0;0;0;0;0;0;Refrigerador 244Lts Frio Directo Progress 3100;LINEA BLANCA
6119247;;M;73;CHILENO;;Silencioso;GRANEROS                      ;L.G.B.OÂ´HIGGINS;0;0;0;0;0;0;0;0;0;Secadora Ropa Solare 7100 7K Ventilacion;LINEA BLANCA
17225334;;F;32;CHILENO;;Millenial;N/D;N/D;0;0;0;0;0;0;0;0;0;Secadora Ropa Reverplus 6470 7Kg Gris Ventilacio;LINEA BLANCA
8370675;;F;53;CHILENO;;X;RENCA                         ;METROPOLITANA;0;0;0;0;0;0;0;0;0;Campana Cocina CA610EIN 60Cms Inox;LINEA BLANCA
12367791;;F;49;CHILENO;;X;LAS CABRAS                    ;L.G.B.OÂ´HIGGINS;0;0;0;0;0;0;0;0;0;Refrigerador 527Lts Side by Side MRSBS5300G689WE;LINEA BLANCA
14177303;;M;40;CHILENO;;X;N/D;N/D;0;0;0;0;0;0;0;0;0;Lavadora WA80H4200SW/ZS 8Kg Blanca;LINEA BLANCA
19596847;;M;25;CHILENO;;Z;PROVIDENCIA                   ;METROPOLITANA;0;0;0;0;0;0;0;0;0;Refrigerador 241Lts BF Frio Directo Nordik 415;LINEA BLANCA
11765828;;M;51;CHILENO;;X;N/D;N/D;0;0;0;0;0;0;0;0;0;Lavadora Premium Care 20SZ 20Kg Silver;LINEA BLANCA
10857657;;F;55;CHILENO;;Boomers;RENCA                         ;METROPOLITANA;0;0;0;0;0;0;0;0;0;Cocina Andes76HG0 6P Inox;LINEA BLANCA
18120030;Soltero;F;30;CHILENO;;Silencioso;PROVIDENCIA                   ;METROPOLITANA;0;0;0;0;0;0;0;0;0;Lavadora WT16DSBP 16Kg Silver;LINEA BLANCA
20063268;;F;23;CHILENO;;Extranjero;"";"";0;0;0;0;0;0;0;0;0;Lavadora Efficace BZG 9,5Kg Blanca;LINEA BLANCA
17986498;;F;30;CHILENO;;Millenial;MELIPILLA                     ;METROPOLITANA;0;0;0;0;0;0;0;0;0;CENTRIFUGA C-752;LINEA BLANCA
16260684;;F;36;CHILENO;;Millenial;RENCA                         ;METROPOLITANA;0;0;0;0;0;0;0;0;0;Secadora Ropa MSV-90 9K Blanca Ventilacion;LINEA BLANCA
19641668;;M;24;CHILENO;;Silencioso;PROVIDENCIA                   ;METROPOLITANA;0;0;0;0;0;0;0;0;0;Refrigerador 167Lts Frio Directo 1700-S;LINEA BLANCA
17135926;Soltero;M;33;CHILENO;;Silencioso;PROVIDENCIA                   ;METROPOLITANA;0;0;0;0;0;0;0;0;0;Lavadora WA80H4200SW/ZS 8Kg Blanca;LINEA BLANCA
14033083;;F;40;CHILENO;;X;PROVIDENCIA                   ;METROPOLITANA;0;0;0;0;0;0;0;0;0;Cocina CH-9400 4P SILVER;LINEA BLANCA
11959264;;M;50;CHILENO;;X;CABRERO                       ;BIO BIO;0;0;0;0;0;0;0;0;0;Refrigerador BFX70 454Lts No Frost;LINEA BLANCA
19996112;;F;24;CHILENO;;Z;PEUMO                         ;L.G.B.OÂ´HIGGINS;0;0;0;0;0;0;0;0;0;Refrigerador 241Lts BF Frio Directo Nordik 415;LINEA BLANCA
14734248;;F;44;CHILENO;;Extranjero;MAIPU                         ;METROPOLITANA;0;0;0;0;0;0;0;0;0;Refrigerador 241Lts BF Frio Directo Nordik 415;LINEA BLANCA
10308038;;M;53;CHILENO;;X;N/D;N/D;0;0;0;0;0;0;0;0;0;Refrigerador 244Lts Frio Directo Progress 3100;LINEA BLANCA
6896049;;F;70;CHILENO;;Silencioso;VILLA ALEMANA                 ;VALPARAISO;0;0;0;0;0;0;0;0;0;Refrigerador 254Lts No Frost GT29WPPDC;LINEA BLANCA
10935100;;F;53;CHILENO;;X;PROVIDENCIA                   ;METROPOLITANA;0;0;0;0;0;0;0;0;0;Refrigerador 244Lts Frio Directo Progress 3100;LINEA BLANCA
7489995;Casado;M;65;CHILENO;INGENIERO;Silencioso;PROVIDENCIA                   ;METROPOLITANA;0;0;0;0;0;0;0;0;0;Frigobar RMF04LRX0 93Lts Inox;LINEA BLANCA
26275768;;F;39;HAITIANO;;Extranjero;"";"";0;0;0;0;0;0;0;0;0;Cocina MCG-5QI30AME5 5P Inox;LINEA BLANCA
16899634;;F;34;CHILENO;;Millenial;PROVIDENCIA                   ;METROPOLITANA;0;0;0;0;0;0;0;0;0;Lavadora MLS-080BE04N 8Kg Blanca;LINEA BLANCA
13265740;;M;45;CHILENO;;X;MAIPU                         ;METROPOLITANA;0;0;0;0;0;0;0;0;0;Lavadora WA80H4200SW/ZS 8Kg Blanca;LINEA BLANCA
6914119;Casado;F;71;CHILENO;;Silencioso;PROVIDENCIA                   ;METROPOLITANA;0;0;0;0;0;0;0;0;0;Calefon ionizado 7 litros GN HydroSense;LINEA BLANCA
15666801;;M;39;CHILENO;;X;PROVIDENCIA                   ;METROPOLITANA;0;0;0;0;0;0;0;0;0;Refrigerador 252Lts No Frost MRFS-2700G333FW;LINEA BLANCA
14457609;;F;42;CHILENO;;X;N/D;N/D;0;0;0;0;0;0;0;0;0;Secadora Electrica SEM101BDBY Blanca 10 KG;LINEA BLANCA
12176671;;F;51;CHILENO;;X;TALAGANTE                     ;METROPOLITANA;0;0;0;0;0;0;0;0;0;Secadora Ropa Solare 7100 7K Ventilacion;LINEA BLANCA
19913520;;M;24;CHILENO;;Extranjero;PROVIDENCIA                   ;METROPOLITANA;0;0;0;0;0;0;0;0;0;Lavadora MLS-160BSC03T 16Kg Blanca;LINEA BLANCA
19991477;;M;23;CHILENO;;Z;PROVIDENCIA                   ;METROPOLITANA;0;0;0;0;0;0;0;0;0;Lavadora WA13T5260BW/ZS 13Kg Blanca;LINEA BLANCA
16627327;;F;34;CHILENO;;Millenial;PROVIDENCIA                   ;METROPOLITANA;0;0;0;0;0;0;0;0;0;Cava de vino Winecool12 12Botellas;LINEA BLANCA
7633446;;F;66;CHILENO;;Boomers;N/D;N/D;0;0;0;0;0;0;0;0;0;Cocina CMC20AXX 4P Inox;LINEA BLANCA
10833596;Casado;F;53;CHILENO;;X;PUENTE ALTO                   ;METROPOLITANA;0;0;0;0;0;0;0;0;0;Lavadora Efficace SZG 19,5Kg Silver;LINEA BLANCA
13364576;;F;43;CHILENO;;X;N/D;N/D;0;0;0;0;0;0;0;0;0;Lavadora MLS-140GSC03T 14Kg Gris;LINEA BLANCA
8405713;;F;62;CHILENO;;Boomers;LA FLORIDA                    ;METROPOLITANA;0;0;0;0;0;0;0;0;0;Freezer FDHM150BY1 150Lts Horizontal;LINEA BLANCA
10732082;;F;54;CHILENO;;Boomers;CONCEPCION                    ;BIO BIO;0;0;0;0;0;0;0;0;0;Lavadora Efficace SZG 9,5Kg Silver;LINEA BLANCA
25911094;;M;42;VENEZOLANO;;Extranjero;SAN RAMON                     ;METROPOLITANA;0;0;0;0;0;0;0;0;0;Lavadora MLS-160BSC03T 16Kg Blanca;LINEA BLANCA
8274963;;M;66;CHILENO;;Boomers;PORTEZUELO                    ;BIO BIO;0;0;0;0;0;0;0;0;0;Lavadora Semiautomatica LC-6550 6,5Kg;LINEA BLANCA
20044967;;M;23;CHILENO;;Silencioso;PROVIDENCIA                   ;METROPOLITANA;0;0;0;0;0;0;0;0;0;COCINA CH-5490NI 4P;LINEA BLANCA
10064923;;F;55;CHILENO;;Boomers;RENCA                         ;METROPOLITANA;0;0;0;0;0;0;0;0;0;Secadora Ropa MSV-90 9K Blanca Ventilacion;LINEA BLANCA
12105294;;F;52;CHILENO;;X;PROVIDENCIA                   ;METROPOLITANA;0;0;0;0;0;0;0;0;0;Lavadora Efficace SZG 9,5Kg Silver;LINEA BLANCA
7265155;;F;68;CHILENO;;Silencioso;N/D;N/D;0;0;0;0;0;0;0;0;0;Campana Cocina CA610EIN 60Cms Inox;LINEA BLANCA
17787715;Soltero;F;31;CHILENO;;Millenial;PROVIDENCIA                   ;METROPOLITANA;0;0;0;0;0;0;0;0;0;Cocina Andes76HG0 6P Inox;LINEA BLANCA
11536639;;F;51;CHILENO;;X;CHILLAN                       ;BIO BIO;0;0;0;0;0;0;0;0;0;Secadora Ropa Solare 7100 7K Ventilacion;LINEA BLANCA
17530153;;F;35;CHILENO;;Millenial;N/D;N/D;0;0;0;0;0;0;0;0;0;Refrigerador 241Lts BF Frio Directo Nordik 415;LINEA BLANCA
5415759;;F;81;CHILENO;;Silencioso;ARAUCO                        ;BIO BIO;0;0;0;0;0;0;0;0;0;Cocina F-5500 Premium 5P;LINEA BLANCA
14374479;;M;47;CHILENO;;X;PROVIDENCIA                   ;METROPOLITANA;0;0;0;0;0;0;0;0;0;Cocina Andes76HG0 6P Inox;LINEA BLANCA
10607696;;M;51;CHILENO;;X;MAIPU                         ;METROPOLITANA;0;0;0;0;0;0;0;0;0;Lavadora MLS-090GE04N 9Kg Gris;LINEA BLANCA
19152528;Soltero;F;26;CHILENO;;Silencioso;PROVIDENCIA                   ;METROPOLITANA;0;0;0;0;0;0;0;0;0;Cocina 775X 4P;LINEA BLANCA
10572197;;M;50;CHILENO;;X;PAINE                         ;METROPOLITANA;0;0;0;0;0;0;0;0;0;Cocina Diva 920 5P;LINEA BLANCA
13339654;;M;43;CHILENO;;X;TALAGANTE                     ;METROPOLITANA;0;0;0;0;0;0;0;0;0;Cocina F-2808 4P;LINEA BLANCA
5947270;;F;75;CHILENO;;Silencioso;LIMACHE                       ;VALPARAISO;0;0;0;0;0;0;0;0;0;Refrigerador 311Lts Frio Direct Nordik Inox 3900;LINEA BLANCA
20129773;;M;23;CHILENO;;Z;PROVIDENCIA                   ;METROPOLITANA;0;0;0;0;0;0;0;0;0;Cocina F-5500 Premium 5P;LINEA BLANCA
15142392;;F;40;CHILENO;;X;N/D;N/D;0;0;0;0;0;0;0;0;0;Secadora Ropa MSV-90 9K Blanca Ventilacion;LINEA BLANCA
17054643;;M;33;CHILENO;;Millenial;PROVIDENCIA                   ;METROPOLITANA;0;0;0;0;0;0;0;0;0;Lavadora MLS-190GC03N 19Kg Gris;LINEA BLANCA
13007397;;M;45;CHILENO;;X;ARICA                         ;ARICA Y PARINACOTA;0;0;0;0;0;0;0;0;0;Refrigerador 255Lts No Frost RT25FARADS8/ZS;LINEA BLANCA
8579201;;F;66;CHILENO;;Boomers;MELIPILLA                     ;METROPOLITANA;0;0;0;0;0;0;0;0;0;Cocina MCG-5QI30AME5 5P Inox;LINEA BLANCA
10026015;;F;58;CHILENO;;Boomers;VALLENAR;ATACAMA;0;0;0;0;0;0;0;0;0;Lavadora MLS-160BSC03T 16Kg Blanca;LINEA BLANCA
19986230;;F;23;CHILENO;;Silencioso;PROVIDENCIA                   ;METROPOLITANA;0;0;0;0;0;0;0;0;0;Refrigerador 254Lts No Frost GT29WPPDC;LINEA BLANCA
14037683;;F;40;CHILENO;;X;RIO BUENO                     ;LOS LAGOS;0;0;0;0;0;0;0;0;0;Cocina Diva 920 5P;LINEA BLANCA
15737469;Casado;F;38;CHILENO;;X;PROVIDENCIA                   ;METROPOLITANA;0;0;0;0;0;0;0;0;0;Cocina CH-9950NG-1 6P Negro;LINEA BLANCA
26175513;;M;35;CHILENO;;Extranjero;TEMUCO                        ;ARAUCANIA;0;0;0;0;0;0;0;0;0;Lavadora Efficace SZG 17,5Kg Blanca;LINEA BLANCA
6201652;;M;73;CHILENO;;Silencioso;PROVIDENCIA                   ;METROPOLITANA;0;0;0;0;0;0;0;0;0;Lavadora Efficace SZG 17,5Kg Silver;LINEA BLANCA
12017054;;F;47;CHILENO;;X;VINA DEL MAR                  ;VALPARAISO;0;0;0;0;0;0;0;0;0;Refrigerador 527Lts Side by Side MRSBS5300G689WE;LINEA BLANCA
8840022;;F;62;CHILENO;;Boomers;ARICA                         ;ARICA Y PARINACOTA;0;0;0;0;0;0;0;0;0;Refrigerador 252Lts No Frost MRFS-2700G333FW;LINEA BLANCA
13217364;;F;45;CHILENO;;X;N/D;N/D;0;0;0;0;0;0;0;0;0;Refrigerador 260Lts BF Frio Direc MRFI2660SR346W;LINEA BLANCA
11903279;;M;50;CHILENO;;X;RENCA                         ;METROPOLITANA;0;0;0;0;0;0;0;0;0;Refrigerador 322Lts No Frost BF DB60S;LINEA BLANCA
8798391;;M;62;CHILENO;;Boomers;PROVIDENCIA                   ;METROPOLITANA;0;0;0;0;0;0;0;0;0;Lavadora WA17T6260BW/ZS 17Kg Blanca;LINEA BLANCA
6603259;;F;66;CHILENO;;Boomers;PELLUHUE                      ;MAULE;0;0;0;0;0;0;0;0;0;Refrigerador 244Lts Frio Directo Progress 3100;LINEA BLANCA
4425606;;M;80;CHILENO;;Silencioso;EL MONTE                      ;METROPOLITANA;0;0;0;0;0;0;0;0;0;Secadora Ropa MSV-90 9K Blanca Ventilacion;LINEA BLANCA
11276069;;M;53;CHILENO;;X;LAS CABRAS                    ;L.G.B.OÂ´HIGGINS;0;0;0;0;0;0;0;0;0;Lavadora WT16DSBP 16Kg Silver;LINEA BLANCA
10582876;;M;52;CHILENO;;Silencioso;PROVIDENCIA                   ;METROPOLITANA;0;0;0;0;0;0;0;0;0;Cocina CMC20AXX 4P Inox;LINEA BLANCA
19619731;;F;24;CHILENO;;Z;PROVIDENCIA                   ;METROPOLITANA;0;0;0;0;0;0;0;0;0;Cocina 775X 4P;LINEA BLANCA
17170187;Soltero;M;33;CHILENO;INGENIERO CIVIL;Silencioso;PROVIDENCIA                   ;METROPOLITANA;0;0;0;0;0;0;0;0;0;Lavadora Secadora WD10WVC4S6 10,5/6Kg Blanca;LINEA BLANCA
9605233;;M;58;CHILENO;;Boomers;PROVIDENCIA                   ;METROPOLITANA;0;0;0;0;0;0;0;0;0;CALEFON 10 LITROS MASTER GL (SPLENDID);LINEA BLANCA
8556940;;F;64;CHILENO;;Boomers;CABILDO                       ;VALPARAISO;0;0;0;0;0;0;0;0;0;Lavadora Efficace SZG 19,5Kg Silver;LINEA BLANCA
18017109;Soltero;F;31;CHILENO;;Millenial;PROVIDENCIA                   ;METROPOLITANA;0;0;0;0;0;0;0;0;0;Cocina MV 220 4P;LINEA BLANCA
8380455;;F;67;CHILENO;;Extranjero;QUILPUE                       ;VALPARAISO;0;0;0;0;0;0;0;0;0;Lavadora Efficace SZG 17,5Kg Silver;LINEA BLANCA
13659954;;M;46;CHILENO;;X;PUNTA ARENAS;MAGALLANES;0;0;0;0;0;0;0;0;0;Lavadora Efficace SZG 15,5Kg Silver;LINEA BLANCA
20024940;;F;23;CHILENO;;Z;RENGO                         ;L.G.B.OÂ´HIGGINS;0;0;0;0;0;0;0;0;0;Refrigerador 244Lts Frio Directo Progress 3100;LINEA BLANCA
20377007;;F;22;CHILENO;;Z;BUIN;METROPOLITANA;0;0;0;0;0;0;0;0;0;Secadora Ropa MSV-90 9K Blanca Ventilacion;LINEA BLANCA
18272309;Soltero;M;29;CHILENO;TECNICO DE NIVEL SUPERIOR EN ODONTOLOGIA;Millenial;PROVIDENCIA                   ;METROPOLITANA;0;0;0;0;0;0;0;0;0;Refrigerador 322Lts No Frost BF DB60S;LINEA BLANCA
10970917;;F;54;CHILENO;;X;PROVIDENCIA                   ;METROPOLITANA;0;0;0;0;0;0;0;0;0;TERMO ATD-30 1,5 KW ALBIN TROTTER;LINEA BLANCA
19411253;;F;26;CHILENO;;Z;MELIPILLA                     ;METROPOLITANA;0;0;0;0;0;0;0;0;0;Refrigerador MRFI1800S234RN 180Lts BF Frio Direc;LINEA BLANCA
19286668;;M;26;CHILENO;;Z;PROVIDENCIA                   ;METROPOLITANA;0;0;0;0;0;0;0;0;0;Refrigerador 260Lts BF Frio Direc MRFI2660SR346W;LINEA BLANCA
16135414;Soltero;M;36;CHILENO;;Millenial;PROVIDENCIA                   ;METROPOLITANA;0;0;0;0;0;0;0;0;0;Lavadora Efficace SZG 19,5Kg Silver;LINEA BLANCA
9264488;;F;61;CHILENO;;Boomers;PROVIDENCIA                   ;METROPOLITANA;0;0;0;0;0;0;0;0;0;Refrigerador MRFI1800R234RN 180Lts BF Frio Dir;LINEA BLANCA
13648068;;M;42;CHILENO;;X;N/D;N/D;0;0;0;0;0;0;0;0;0;Cocina CH-7400 4P;LINEA BLANCA
12478066;;F;48;CHILENO;;Silencioso;PROVIDENCIA                   ;METROPOLITANA;0;0;0;0;0;0;0;0;0;Lavadora WT13WSBP 13Kg Blanca;LINEA BLANCA
11325666;;F;54;CHILENO;;X;PROVIDENCIA                   ;METROPOLITANA;0;0;0;0;0;0;0;0;0;Refrigerador 300Lts No Frost RT29K500JS8/ZS;LINEA BLANCA
7673795;;F;65;CHILENO;;Boomers;PUNTA ARENAS                  ;MAGALLANES;0;0;0;0;0;0;0;0;0;Cocina F-2808 4P;LINEA BLANCA
16780365;;F;34;CHILENO;;Millenial;PROVIDENCIA                   ;METROPOLITANA;0;0;0;0;0;0;0;0;0;Cocina CH-9950NG-1 6P Negro;LINEA BLANCA
17224673;;F;32;CHILENO;;Millenial;PROVIDENCIA                   ;METROPOLITANA;0;0;0;0;0;0;0;0;0;Lavadora Efficace SZG 19,5Kg Silver;LINEA BLANCA
6298663;Casado;M;73;CHILENO;AGRONOMO;Silencioso;RENCA                         ;METROPOLITANA;0;0;0;0;0;0;0;0;0;Refrigerador 252Lts No Frost MRFS-2700G333FW;LINEA BLANCA
18284506;Soltero;F;29;CHILENO;MATRONA;Millenial;PROVIDENCIA                   ;METROPOLITANA;0;0;0;0;0;0;0;0;0;Refrigerador 331Lts No Frost BF RB34T632FSA/ZS;LINEA BLANCA
12591778;;F;48;CHILENO;;X;CHILLAN                       ;BIO BIO;0;0;0;0;0;0;0;0;0;Lavadora Secadora WD10WVC4S6 10,5/6Kg Blanca;LINEA BLANCA
19668496;;F;24;CHILENO;;Z;PROVIDENCIA                   ;METROPOLITANA;0;0;0;0;0;0;0;0;0;Lavadora Efficace SZG 9,5Kg Silver;LINEA BLANCA
18946762;;M;27;CHILENO;;Millenial;N/D;N/D;0;0;0;0;0;0;0;0;0;Secadora Ropa Solare 7100 7K Ventilacion;LINEA BLANCA
10943223;;F;49;CHILENO;;X;CASTRO                        ;LOS LAGOS;0;0;0;0;0;0;0;0;0;Lavadora Secadora WD10WVC4S6 10,5/6Kg Blanca;LINEA BLANCA
19875072;;F;24;CHILENO;;Z;N/D;N/D;0;0;0;0;0;0;0;0;0;Refrigerador 254Lts No Frost GT29WPPDC;LINEA BLANCA
23862377;;M;44;BOLIVIANO;;Extranjero;CALAMA                        ;ANTOFAGASTA;0;0;0;0;0;0;0;0;0;Lavadora WA13T5260BW/ZS 13Kg Blanca;LINEA BLANCA
16214560;;M;36;CHILENO;;Millenial;N/D;N/D;0;0;0;0;0;0;0;0;0;Secadora Ropa Reverplus 6470 7Kg Gris Ventilacio;LINEA BLANCA
19534519;;F;24;CHILENO;;Z;PROVIDENCIA                   ;METROPOLITANA;0;0;0;0;0;0;0;0;0;Secadora Ropa MSV-90 9K Blanca Ventilacion;LINEA BLANCA
17540672;;F;31;CHILENO;;Millenial;PROVIDENCIA                   ;METROPOLITANA;0;0;0;0;0;0;0;0;0;Refrigerador 244Lts Frio Directo Progress 3100;LINEA BLANCA
26599475;;M;38;CHILENO;;Extranjero;PUERTO MONTT                  ;LOS LAGOS;0;0;0;0;0;0;0;0;0;Lavadora Superior WA15T5260BY/ZS 15 Kg;LINEA BLANCA
12903064;;M;47;CHILENO;;X;ARICA                         ;TARAPACA;0;0;0;0;0;0;0;0;0;Cocina MCG-4QI24AME4 4P Inox;LINEA BLANCA
19236790;Soltero;F;25;CHILENO;MATRONA;Silencioso;PROVIDENCIA                   ;METROPOLITANA;0;0;0;0;0;0;0;0;0;Campana Cocina CA-910EIN 90Cms;LINEA BLANCA
7512224;;F;66;CHILENO;;Boomers;EL QUISCO                     ;VALPARAISO;0;0;0;0;0;0;0;0;0;Refrigerador RT22FARADSP/ZS 236Lts No Frost;LINEA BLANCA
5792651;;M;72;CHILENO;;Silencioso;VINA DEL MAR                  ;VALPARAISO;0;0;0;0;0;0;0;0;0;Cocina CMC20AXX 4P Inox;LINEA BLANCA
17964405;;M;31;CHILENO;;Millenial;N/D;N/D;0;0;0;0;0;0;0;0;0;Cocina CH-9800 GLP 4P Negra;LINEA BLANCA
15525377;;F;39;CHILENO;;X;RANCAGUA                      ;L.G.B.OÂ´HIGGINS;0;0;0;0;0;0;0;0;0;Horno Empotrado Spazio 140 66Lts Silver;LINEA BLANCA
15702248;;F;38;CHILENO;;Millenial;"";"";0;0;0;0;0;0;0;0;0;HORNO EMPOTRABLE HE-7200 INOX 2250W 57L SINDELEN;LINEA BLANCA
17930103;Soltero;F;30;CHILENO;TECNICO DE NIVEL SUPERIOR EN ENFERMERIA;Silencioso;PROVIDENCIA                   ;METROPOLITANA;0;0;0;0;0;0;0;0;0;Cocina CH-7400 4P;LINEA BLANCA
13494981;Soltero;F;44;CHILENO;;Silencioso;PROVIDENCIA                   ;METROPOLITANA;0;0;0;0;0;0;0;0;0;Lavadora/Centrifuga LC4550 4,5Kg Blanca;LINEA BLANCA
9442775;;F;57;CHILENO;;Boomers;GORBEA                        ;ARAUCANIA;0;0;0;0;0;0;0;0;0;Lavadora Efficace BZG 15,5Kg Blanca;LINEA BLANCA
9714908;;F;58;CHILENO;;Boomers;CALBUCO                       ;LOS LAGOS;0;0;0;0;0;0;0;0;0;Lavadora Efficace SZG 15,5Kg Silver;LINEA BLANCA
13178924;;F;45;CHILENO;;X;PROVIDENCIA                   ;METROPOLITANA;0;0;0;0;0;0;0;0;0;Lavadora Secadora Perfect Care 8Kg/5Kg Blanca;LINEA BLANCA
6824819;;M;69;CHILENO;;Silencioso;PROVIDENCIA                   ;METROPOLITANA;0;0;0;0;0;0;0;0;0;Cocina CH-7400 4P;LINEA BLANCA
7399542;;F;66;CHILENO;;Boomers;LOS ANGELES                   ;BIO BIO;0;0;0;0;0;0;0;0;0;Secadora Ropa Solare 9100 9K Ventilacion;LINEA BLANCA
7377533;;F;63;CHILENO;;Boomers;PROVIDENCIA                   ;METROPOLITANA;0;0;0;0;0;0;0;0;0;Campana Cocina CA610EIN 60Cms Inox;LINEA BLANCA
15831334;;M;39;CHILENO;;Silencioso;PROVIDENCIA                   ;METROPOLITANA;0;0;0;0;0;0;0;0;0;Refrigerador 303Lts BF Frio Directo Nordik 480;LINEA BLANCA
17018586;;F;33;CHILENO;;Millenial;"";"";0;0;0;0;0;0;0;0;0;Lavadora Secadora WD10WVC4S6 10,5/6Kg Blanca;LINEA BLANCA
16049407;;M;36;CHILENO;;Silencioso;PROVIDENCIA                   ;METROPOLITANA;0;0;0;0;0;0;0;0;0;Refrigerador SBS LS64SXP Instaview 592L;LINEA BLANCA
17653296;;F;35;CHILENO;;Millenial;N/D;N/D;0;0;0;0;0;0;0;0;0;Lavadora Secadora MLSF-1108BN05N 11Kg/8Kg Blanca;LINEA BLANCA
15726299;Soltero;F;38;CHILENO;PROFESOR;X;RENCA                         ;METROPOLITANA;0;0;0;0;0;0;0;0;0;Refrigerador RMN222PXLRS0 222LTS No Frost;LINEA BLANCA
15305651;Soltero;F;39;CHILENO;CONTADOR AUDITOR;X;RENCA                         ;METROPOLITANA;0;0;0;0;0;0;0;0;0;Cocina 785FX 4P;LINEA BLANCA
6764194;;F;69;CHILENO;;Silencioso;ANTOFAGASTA                   ;ANTOFAGASTA;0;0;0;0;0;0;0;0;0;Cocina CMC20AXX 4P Inox;LINEA BLANCA
15919185;;F;37;CHILENO;;Millenial;PROVIDENCIA                   ;METROPOLITANA;0;0;0;0;0;0;0;0;0;Lavadora Secadora WD12N64FR 12/7Kg;LINEA BLANCA
12108188;;F;43;CHILENO;;X;MAIPU                         ;METROPOLITANA;0;0;0;0;0;0;0;0;0;Refrigerador No Frost TMF 197 Lts FRT-220;LINEA BLANCA
18526768;;M;29;CHILENO;;Millenial;CHONCHI                       ;LOS LAGOS;0;0;0;0;0;0;0;0;0;Lavadora WA17T6260BW/ZS 17Kg Blanca;LINEA BLANCA
18242698;;F;30;CHILENO;;Millenial;N/D;N/D;0;0;0;0;0;0;0;0;0;Cocina CH-7400 4P;LINEA BLANCA
17162332;;M;33;CHILENO;;Millenial;PROVIDENCIA                   ;METROPOLITANA;0;0;0;0;0;0;0;0;0;Cocina 795XF 4P;LINEA BLANCA
10525185;Casado;F;56;CHILENO;;Boomers;PROVIDENCIA                   ;METROPOLITANA;0;0;0;0;0;0;0;0;0;Lavadora Efficace SZG 17,5Kg Silver;LINEA BLANCA
12786142;;F;46;CHILENO;;X;CURICO                        ;MAULE;0;0;0;0;0;0;0;0;0;Lavadora MLS-160BSC03T 16Kg Blanca;LINEA BLANCA
19315044;Soltero;M;26;CHILENO;;Silencioso;PROVIDENCIA                   ;METROPOLITANA;0;0;0;0;0;0;0;0;0;Campana Cocina CA-630PP Piramidal 60Cms Inox;LINEA BLANCA
19802637;;F;24;CHILENO;;Z;N/D;N/D;0;0;0;0;0;0;0;0;0;Lavadora Efficace SZG 17,5Kg Blanca;LINEA BLANCA
8383113;;M;62;CHILENO;;Boomers;"";"";0;0;0;0;0;0;0;0;0;Lavadora Efficace SZG 17,5Kg Silver;LINEA BLANCA
6313825;;M;72;CHILENO;;Silencioso;CHILLAN VIEJO                 ;BIO BIO;0;0;0;0;0;0;0;0;0;Lavadora Efficace SZG 15,5Kg Silver;LINEA BLANCA
15130182;;F;40;CHILENO;;X;CURICO                        ;MAULE;0;0;0;0;0;0;0;0;0;Cocina 76DXR Doble Horno;LINEA BLANCA
7410271;;F;67;CHILENO;;Millenial;N/D;N/D;0;0;0;0;0;0;0;0;0;Freezer FDHM150BY1 150Lts Horizontal;LINEA BLANCA
7234820;;M;68;CHILENO;;Boomers;OSORNO                        ;LOS LAGOS;0;0;0;0;0;0;0;0;0;Refrigerador 260Lts BF Frio Direc MRFI2660SR346W;LINEA BLANCA
19138888;Soltero;F;25;CHILENO;;Z;PROVIDENCIA                   ;METROPOLITANA;0;0;0;0;0;0;0;0;0;Refrigerador LRT-200DFI 168Lts Frio Directo;LINEA BLANCA
10835007;;M;54;CHILENO;;Boomers;PROVIDENCIA                   ;METROPOLITANA;0;0;0;0;0;0;0;0;0;Lavadora 9 Kg Carga Superior Blanca;LINEA BLANCA
17937702;;M;31;CHILENO;;Millenial;ANTOFAGASTA                   ;ANTOFAGASTA;0;0;0;0;0;0;0;0;0;Lavadora Efficace SZG 15,5Kg Silver;LINEA BLANCA
9570187;Casado;M;56;CHILENO;;Boomers;PROVIDENCIA                   ;METROPOLITANA;0;0;0;0;0;0;0;0;0;Cocina F-2608 4P Inox;LINEA BLANCA
19425791;Soltero;M;26;CHILENO;;Z;PROVIDENCIA                   ;METROPOLITANA;0;0;0;0;0;0;0;0;0;Lavadora 9 Kg Carga Superior Blanca;LINEA BLANCA
10148925;Soltero;F;59;CHILENO;;Boomers;PROVIDENCIA                   ;METROPOLITANA;0;0;0;0;0;0;0;0;0;Refrigerador 251Lts No Frost Altus 1250;LINEA BLANCA
10161712;;M;56;CHILENO;;Boomers;RENCA                         ;METROPOLITANA;0;0;0;0;0;0;0;0;0;Lavadora WA17T6260BW/ZS 17Kg Blanca;LINEA BLANCA
16804381;;F;34;CHILENO;;Silencioso;PROVIDENCIA                   ;METROPOLITANA;0;0;0;0;0;0;0;0;0;Secadora Ropa MSV-90 9K Blanca Ventilacion;LINEA BLANCA
19510360;;M;25;CHILENO;;Z;PROVIDENCIA                   ;METROPOLITANA;0;0;0;0;0;0;0;0;0;Lavadora Secadora Perfect Care 8Kg/5Kg Blanca;LINEA BLANCA
9777983;;F;57;CHILENO;;Boomers;TALCAHUANO                    ;BIO BIO;0;0;0;0;0;0;0;0;0;Refrigerador 244Lts Frio Directo Progress 3100;LINEA BLANCA
6376831;Soltero;F;67;CHILENO;PROFESOR;Boomers;PROVIDENCIA                   ;METROPOLITANA;0;0;0;0;0;0;0;0;0;Refrigerador RT22FARADSP/ZS 236Lts No Frost;LINEA BLANCA
18061952;Soltero;F;30;CHILENO;TECNICO EN FINANZAS;Millenial;PROVIDENCIA                   ;METROPOLITANA;0;0;0;0;0;0;0;0;0;Lavadora Efficace BZG 15,5Kg Blanca;LINEA BLANCA
7111424;;F;75;CHILENO;;Silencioso;NUEVA IMPERIAL                ;ARAUCANIA;0;0;0;0;0;0;0;0;0;Refrigerador 249Lts No Frost RMA250PHUG;LINEA BLANCA
6321900;;M;72;CHILENO;;Silencioso;VILLARICA                     ;ARAUCANIA;0;0;0;0;0;0;0;0;0;Lavadora MLS-160BSC03T 16Kg Blanca;LINEA BLANCA
6812793;Casado;F;66;CHILENO;DISENADOR GRAFICO;Boomers;RENCA                         ;METROPOLITANA;0;0;0;0;0;0;0;0;0;Refrigerador 252Lts No Frost MRFS-2700G333FW;LINEA BLANCA
16082312;;F;37;CHILENO;;Silencioso;PROVIDENCIA                   ;METROPOLITANA;0;0;0;0;0;0;0;0;0;Refrigerador 400Lts No Frost RMP400FHUG;LINEA BLANCA
12155912;;F;41;CHILENO;;X;NUNOA                         ;METROPOLITANA;0;0;0;0;0;0;0;0;0;Lavadora Efficace BZG 9,5Kg Blanca;LINEA BLANCA
16508505;;F;34;CHILENO;;X;PROVIDENCIA                   ;METROPOLITANA;0;0;0;0;0;0;0;0;0;Cocina CH-7400 4P;LINEA BLANCA
7867692;;M;62;CHILENO;;Boomers;PUENTE ALTO                   ;METROPOLITANA;0;0;0;0;0;0;0;0;0;Cocina 785FX 4P;LINEA BLANCA
12692602;;M;48;CHILENO;;X;RENCA                         ;METROPOLITANA;0;0;0;0;0;0;0;0;0;Secadora Ropa Solare 9100 9K Ventilacion;LINEA BLANCA
19169766;;F;26;CHILENO;;Z;SAN CARLOS                    ;BIO BIO;0;0;0;0;0;0;0;0;0;Refrigerador LRB-270IW 244Lts Frio Directo;LINEA BLANCA
12502603;;F;49;CHILENO;;X;PROVIDENCIA                   ;METROPOLITANA;0;0;0;0;0;0;0;0;0;REFRIGERADOR FD RD-2000 200 LT SILVER SIND;LINEA BLANCA
9021546;Casado;F;61;CHILENO;;Silencioso;PROVIDENCIA                   ;METROPOLITANA;0;0;0;0;0;0;0;0;0;Freezer Vertical MFV-2400S312FW 227Lts;LINEA BLANCA
10893620;;F;53;CHILENO;;Silencioso;RENGO                         ;L.G.B.OÂ´HIGGINS;0;0;0;0;0;0;0;0;0;Refrigerador 525Lts Side by Side SFX500;LINEA BLANCA
11326449;;M;53;CHILENO;;X;VALLENAR;ATACAMA;0;0;0;0;0;0;0;0;0;Refrigerador MRFI1800S234RN 180Lts BF Frio Direc;LINEA BLANCA
8734251;;M;62;CHILENO;;Boomers;VILLA ALEGRE                  ;MAULE;0;0;0;0;0;0;0;0;0;Lavadora MLS-160BSC03T 16Kg Blanca;LINEA BLANCA
5953411;;M;72;CHILENO;;Silencioso;CERRO NAVIA                   ;METROPOLITANA;0;0;0;0;0;0;0;0;0;Lavadora Efficace BZG 9,5Kg Blanca;LINEA BLANCA
17563128;Divorciado;M;32;CHILENO;;Millenial;PROVIDENCIA                   ;METROPOLITANA;0;0;0;0;0;0;0;0;0;Lavadora Efficace BZG 9,5Kg Blanca;LINEA BLANCA
18243595;;M;30;CHILENO;;Silencioso;PROVIDENCIA                   ;METROPOLITANA;0;0;0;0;0;0;0;0;0;Refrigerador 535Lts Side by Side RS54N3003SL/ZS;LINEA BLANCA
8557954;;M;49;CHILENO;;X;SAN RAMON                     ;METROPOLITANA;0;0;0;0;0;0;0;0;0;Lavadora MLS-160BSC03T 16Kg Blanca;LINEA BLANCA
21198329;;F;35;CHILENO;;Millenial;SANTIAGO                      ;METROPOLITANA;0;0;0;0;0;0;0;0;0;Refrigerador LRT-200DFI 168Lts Frio Directo;LINEA BLANCA
15220661;;F;40;CHILENO;;X;PROVIDENCIA                   ;METROPOLITANA;0;0;0;0;0;0;0;0;0;Refrigerador 251Lts No Frost Altus 1250;LINEA BLANCA
9026023;;M;61;CHILENO;;Boomers;LOS ANDES                     ;VALPARAISO;0;0;0;0;0;0;0;0;0;Lavadora Efficace SZG 19,5Kg Silver;LINEA BLANCA
15978760;;F;36;CHILENO;;Millenial;PUREN                         ;ARAUCANIA;0;0;0;0;0;0;0;0;0;CONGELADOR LFH-300 TAPA DURA 300L;LINEA BLANCA
10836194;;F;56;CHILENO;;Boomers;PICHIDEGUA                    ;L.G.B.OÂ´HIGGINS;0;0;0;0;0;0;0;0;0;Refrigerador 303Lts BF Frio Directo Nordik 480;LINEA BLANCA
6821923;;F;75;CHILENO;;Silencioso;RENCA                         ;METROPOLITANA;0;0;0;0;0;0;0;0;0;CALEFON 8 LITROS MASTER GL (SPLENDID);LINEA BLANCA
18441674;;F;29;CHILENO;;Millenial;PROVIDENCIA                   ;METROPOLITANA;0;0;0;0;0;0;0;0;0;Lavadora MLS-160BSC03T 16Kg Blanca;LINEA BLANCA
9926566;;M;55;CHILENO;;Boomers;RENCA                         ;METROPOLITANA;0;0;0;0;0;0;0;0;0;Refrigerador 241Lts BF Frio Directo Nordik 415;LINEA BLANCA
8730313;;F;59;CHILENO;;Boomers;N/D;N/D;0;0;0;0;0;0;0;0;0;Lavadora MLS-160BSC03T 16Kg Blanca;LINEA BLANCA
13274894;;F;45;CHILENO;;X;PROVIDENCIA                   ;METROPOLITANA;0;0;0;0;0;0;0;0;0;Freezer Vertical SFV-100 SILVER 100Lts;LINEA BLANCA
8471671;;F;64;CHILENO;;Boomers;LIMACHE                       ;VALPARAISO;0;0;0;0;0;0;0;0;0;Secadora Ropa MSV-90 9K Blanca Ventilacion;LINEA BLANCA
7824029;;F;64;CHILENO;;Boomers;CORONEL                       ;BIO BIO;0;0;0;0;0;0;0;0;0;Refrigerador 260Lts BF Frio Direc MRFI2660SR346W;LINEA BLANCA
5013770;Casado;M;75;CHILENO;;Silencioso;VILLA ALEMANA                 ;VALPARAISO;0;0;0;0;0;0;0;0;0;Lavadora MLS-160BSC03T 16Kg Blanca;LINEA BLANCA
17552735;Soltero;M;31;CHILENO;;Millenial;ARICA                         ;TARAPACA;0;0;0;0;0;0;0;0;0;Refrigerador 251Lts No Frost Altus 1250;LINEA BLANCA
11264182;;F;54;CHILENO;;X;PENALOLEN                     ;METROPOLITANA;0;0;0;0;0;0;0;0;0;Secadora Ropa MSV-90 9K Blanca Ventilacion;LINEA BLANCA
8880235;Casado;M;62;CHILENO;;Boomers;HIJUELAS                      ;VALPARAISO;0;0;0;0;0;0;0;0;0;Refrigerador 290Lts BF No Frost RB30N4020S8;LINEA BLANCA
14316710;Casado;F;46;CHILENO;;X;QUINTA DE TILCOCO             ;L.G.B.OÂ´HIGGINS;0;0;0;0;0;0;0;0;0;Refrigerador 244Lts Frio Directo Progress 3100;LINEA BLANCA
6911149;Casado;F;71;CHILENO;;Silencioso;MELIPILLA                     ;METROPOLITANA;0;0;0;0;0;0;0;0;0;Lavadora Efficace BZG 9,5Kg Blanca;LINEA BLANCA
16318627;;F;35;CHILENO;;Millenial;"";"";0;0;0;0;0;0;0;0;0;Lavadora WA80H4200SW/ZS 8Kg Blanca;LINEA BLANCA
5725700;;F;79;CHILENO;;Silencioso;PUENTE ALTO                   ;METROPOLITANA;0;0;0;0;0;0;0;0;0;Calefon Neckar 10 litros GL;LINEA BLANCA
17494838;;F;32;CHILENO;;Silencioso;TALCA                         ;MAULE;0;0;0;0;0;0;0;0;0;Lavadora WA80H4200SW/ZS 8Kg Blanca;LINEA BLANCA
18403473;;M;31;CHILENO;;Millenial;PROVIDENCIA                   ;METROPOLITANA;0;0;0;0;0;0;0;0;0;Cocina CH-7400 4P;LINEA BLANCA
14307796;;F;46;CHILENO;;X;RENCA                         ;METROPOLITANA;0;0;0;0;0;0;0;0;0;Encimera CE2-435I 2P Inox;LINEA BLANCA
16063923;;F;36;CHILENO;;Millenial;PROVIDENCIA                   ;METROPOLITANA;0;0;0;0;0;0;0;0;0;Refrigerador 254Lts No Frost GT29WPPDC;LINEA BLANCA
18513039;;F;29;CHILENO;;Millenial;RENCA                         ;METROPOLITANA;0;0;0;0;0;0;0;0;0;Lavadora Superior WA13T5260BY/ZS 13Kg;LINEA BLANCA
10880345;;F;56;CHILENO;;Boomers;SAN CARLOS                    ;BIO BIO;0;0;0;0;0;0;0;0;0;Lavadora WA17T6260BW/ZS 17Kg Blanca;LINEA BLANCA
13247339;;M;45;CHILENO;;X;BUIN                          ;METROPOLITANA;0;0;0;0;0;0;0;0;0;Refrigerador 251Lts No Frost Altus 1250;LINEA BLANCA
10225810;;F;56;CHILENO;;Boomers;VALLENAR;ATACAMA;0;0;0;0;0;0;0;0;0;Lavadora WA80H4200SW/ZS 8Kg Blanca;LINEA BLANCA
19968836;;F;23;CHILENO;;Z;ANTOFAGASTA                   ;ANTOFAGASTA;0;0;0;0;0;0;0;0;0;Refrigerador 260Lts BF Frio Direc MRFI2660SR346W;LINEA BLANCA
9397743;Viudo;F;59;CHILENO;;Boomers;PROVIDENCIA                   ;METROPOLITANA;0;0;0;0;0;0;0;0;0;Calefon 5Lts GL Master;LINEA BLANCA
6538232;Casado;M;67;CHILENO;CONSTRUCTOR CIVIL;Boomers;PROVIDENCIA                   ;METROPOLITANA;0;0;0;0;0;0;0;0;0;Refrigerador LB37MPGK 341Lts No Frost;LINEA BLANCA
14323945;;M;49;CHILENO;;Silencioso;PROVIDENCIA                   ;METROPOLITANA;0;0;0;0;0;0;0;0;0;Calefon 7Lts GL Master;LINEA BLANCA
15401838;Soltero;M;40;CHILENO;;Silencioso;PROVIDENCIA                   ;METROPOLITANA;0;0;0;0;0;0;0;0;0;Lavadora WA80H4200SW/ZS 8Kg Blanca;LINEA BLANCA
14088004;;F;41;CHILENO;;X;ANCUD                         ;LOS LAGOS;0;0;0;0;0;0;0;0;0;Cocina CH-7400 4P;LINEA BLANCA
10087646;Casado;M;58;CHILENO;;Boomers;PROVIDENCIA                   ;METROPOLITANA;0;0;0;0;0;0;0;0;0;Lavadora WA90H4400SW/ZS 9Kg Blanca;LINEA BLANCA
20583942;;M;21;CHILENO;;Z;PROVIDENCIA                   ;METROPOLITANA;0;0;0;0;0;0;0;0;0;Freezer FDHM200BY1 200Lts Horizontal;LINEA BLANCA
11924139;;F;49;CHILENO;;X;PROVIDENCIA                   ;METROPOLITANA;0;0;0;0;0;0;0;0;0;Refrigerador 252Lts No Frost MRFS-2700G333FW;LINEA BLANCA
9713005;Casado;M;56;CHILENO;PROFESOR;Boomers;N/D;N/D;0;0;0;0;0;0;0;0;0;Refrigerador 249Lts No Frost RMA250PHUG;LINEA BLANCA
7588630;;M;65;CHILENO;;Boomers;RANCAGUA                      ;L.G.B.OÂ´HIGGINS;0;0;0;0;0;0;0;0;0;Lavadora Efficace BZG 11,5Kg Blanca;LINEA BLANCA
19435042;;M;25;CHILENO;;Silencioso;PROVIDENCIA                   ;METROPOLITANA;0;0;0;0;0;0;0;0;0;Refrigerador 251Lts No Frost Altus 1250;LINEA BLANCA
12965499;;M;45;CHILENO;;X;CAUQUENES                     ;MAULE;0;0;0;0;0;0;0;0;0;Refrigerador 290Lts BF No Frost RB30N4020S8;LINEA BLANCA
8227393;;M;61;CHILENO;;Boomers;NATALES                       ;MAGALLANES;0;0;0;0;0;0;0;0;0;Refrigerador Combi RD-2600IN 262Lts;LINEA BLANCA
11301768;;M;54;CHILENO;;X;N/D;N/D;0;0;0;0;0;0;0;0;0;Lavadora Efficace SZG 17,5Kg Silver;LINEA BLANCA
18857285;;M;26;CHILENO;;Z;PROVIDENCIA                   ;METROPOLITANA;0;0;0;0;0;0;0;0;0;Cocina MV 220 4P;LINEA BLANCA
10909059;;F;55;CHILENO;;Boomers;EL BOSQUE                     ;METROPOLITANA;0;0;0;0;0;0;0;0;0;Cocina MCG-4QI24AME4 4P Inox;LINEA BLANCA
19212644;Soltero;M;26;CHILENO;;Z;PROVIDENCIA                   ;METROPOLITANA;0;0;0;0;0;0;0;0;0;Cocina F-2525 4P;LINEA BLANCA
5043899;;M;77;CHILENO;;Silencioso;RENCA                         ;METROPOLITANA;0;0;0;0;0;0;0;0;0;Lavadora Semiautomatica Twister 5100 4Kg;LINEA BLANCA
7659442;;F;63;CHILENO;;Boomers;LOS ANDES                     ;VALPARAISO;0;0;0;0;0;0;0;0;0;Freezer Horizonal SFH-101BL 99Lts;LINEA BLANCA
10261389;;F;59;CHILENO;;Boomers;TALCAHUANO                    ;BIO BIO;0;0;0;0;0;0;0;0;0;Refrigerador 525Lts Side by Side SFX500;LINEA BLANCA
11657561;;M;51;CHILENO;;Silencioso;PROVIDENCIA                   ;METROPOLITANA;0;0;0;0;0;0;0;0;0;REFRIGERADOR FD RD-2000 200 LT SILVER SIND;LINEA BLANCA
14545529;;F;43;CHILENO;;X;"";"";0;0;0;0;0;0;0;0;0;Refrigerador 260Lts BF Frio Direc MRFI2660SR346W;LINEA BLANCA
10314545;;F;50;CHILENO;;X;PROVIDENCIA                   ;METROPOLITANA;0;0;0;0;0;0;0;0;0;Refrigerador SBS LS64SXP Instaview 592L;LINEA BLANCA
15932899;;F;36;CHILENO;;Millenial;PROVIDENCIA                   ;METROPOLITANA;0;0;0;0;0;0;0;0;0;FRIGOBAR 93 LTS MFB-930S121LN;LINEA BLANCA
18266183;;M;29;CHILENO;;Millenial;VILLA ALEMANA                 ;VALPARAISO;0;0;0;0;0;0;0;0;0;Lavadora MLS-090GE04N 9Kg Gris;LINEA BLANCA
15616827;;F;38;CHILENO;;Millenial;RENCA                         ;METROPOLITANA;0;0;0;0;0;0;0;0;0;FRIGOBAR 93 LTS MFB-930S121LN;LINEA BLANCA
17843147;Soltero;M;31;CHILENO;ENFERMERO;Millenial;PROVIDENCIA                   ;METROPOLITANA;0;0;0;0;0;0;0;0;0;Cocina Andes60TX4 4P Inox;LINEA BLANCA
13145770;Soltero;M;44;CHILENO;;X;PROVIDENCIA                   ;METROPOLITANA;0;0;0;0;0;0;0;0;0;Refrigerador Altus 1350W 342Lts No Frost;LINEA BLANCA
16109943;Soltero;M;37;CHILENO;INGENIERO EN ADMINISTRACION DE EMPRESAS;Millenial;PROVIDENCIA                   ;METROPOLITANA;0;0;0;0;0;0;0;0;0;Refrigerador RT25FARADSP/ZS 260Lts No Frost;LINEA BLANCA
7462805;;F;67;CHILENO;;Boomers;PUCHUNCAVI                    ;VALPARAISO;0;0;0;0;0;0;0;0;0;Lavadora WA17T6260BW/ZS 17Kg Blanca;LINEA BLANCA
7752125;Viudo;M;65;CHILENO;;Boomers;TEMUCO                        ;ARAUCANIA;0;0;0;0;0;0;0;0;0;Refrigerador 244Lts Frio Directo Progress 3100;LINEA BLANCA
5349887;;F;76;CHILENO;;Silencioso;EL MONTE                      ;METROPOLITANA;0;0;0;0;0;0;0;0;0;Cocina Andes76HG0 6P Inox;LINEA BLANCA
11078582;;F;56;CHILENO;;Boomers;N/D;N/D;0;0;0;0;0;0;0;0;0;Lavadora WA80H4200SW/ZS 8Kg Blanca;LINEA BLANCA
13802072;;M;41;CHILENO;;X;QUILLECO                      ;BIO BIO;0;0;0;0;0;0;0;0;0;Lavadora Efficace SZG 17,5Kg Silver;LINEA BLANCA
15885975;;M;37;CHILENO;;Millenial;ANTOFAGASTA                   ;ANTOFAGASTA;0;0;0;0;0;0;0;0;0;Refrigerador 241Lts BF Frio Directo Nordik 415;LINEA BLANCA
15663271;;M;38;CHILENO;;X;PROVIDENCIA                   ;METROPOLITANA;0;0;0;0;0;0;0;0;0;Lavadora MLS-090GE04N 9Kg Gris;LINEA BLANCA
7861073;Casado;M;66;CHILENO;;Boomers;RENCA                         ;METROPOLITANA;0;0;0;0;0;0;0;0;0;Calefon 5Lts GL Master;LINEA BLANCA
6589162;;F;71;CHILENO;;Silencioso;RENCA                         ;METROPOLITANA;0;0;0;0;0;0;0;0;0;Frigobar LFB-90R 90Lts Retro Rojo;LINEA BLANCA
8338603;;M;64;CHILENO;;Boomers;ALTO HOSPICIO;TARAPACA;0;0;0;0;0;0;0;0;0;Refrigerador 290LTS No Frost RMB302PXLRS0;LINEA BLANCA
17665891;;M;31;CHILENO;;Millenial;PROVIDENCIA                   ;METROPOLITANA;0;0;0;0;0;0;0;0;0;Lavadora Efficace SZG 19,5Kg Silver;LINEA BLANCA
7016763;;F;59;CHILENO;;Boomers;RENCA                         ;METROPOLITANA;0;0;0;0;0;0;0;0;0;Lavadora WA90H4400SW/ZS 9Kg Blanca;LINEA BLANCA
18508063;;M;28;CHILENO;;Millenial;RENCA                         ;METROPOLITANA;0;0;0;0;0;0;0;0;0;Lavadora Efficace SZG 17,5Kg Blanca;LINEA BLANCA
20379538;;F;23;CHILENO;;Z;PUENTE ALTO;METROPOLITANA;0;0;0;0;0;0;0;0;0;Cocina 775X 4P;LINEA BLANCA
15247316;;M;40;CHILENO;;X;PROVIDENCIA                   ;METROPOLITANA;0;0;0;0;0;0;0;0;0;Refrigerador MRFI1800S234RN 180Lts BF Frio Direc;LINEA BLANCA
8352335;;M;65;CHILENO;;Boomers;CHILLAN                       ;BIO BIO;0;0;0;0;0;0;0;0;0;Lavadora superior MLS-110GE04N 11Kg;LINEA BLANCA
18001331;;M;30;CHILENO;;Millenial;SANTA CRUZ                    ;L.G.B.OÂ´HIGGINS;0;0;0;0;0;0;0;0;0;Lavadora Efficace SZG 17,5Kg Silver;LINEA BLANCA
18036095;;F;30;CHILENO;;Millenial;N/D;N/D;0;0;0;0;0;0;0;0;0;Lavadora superior MLS-110GE04N 11Kg;LINEA BLANCA
17288272;;M;32;CHILENO;;Millenial;CURICO                        ;MAULE;0;0;0;0;0;0;0;0;0;Freezer 99Lts MFH-1000B131CN Horizontal;LINEA BLANCA
26163830;;M;38;EXTRANJERO - NO INFORMA NACIONALIDAD;;Extranjero;"";"";0;0;0;0;0;0;0;0;0;Lavadora MLS-090GE04N 9Kg Gris;LINEA BLANCA
16844613;;M;34;CHILENO;;Millenial;SAN CARLOS                    ;BIO BIO;0;0;0;0;0;0;0;0;0;Refrigerador 290LTS No Frost RMB302PXLRS0;LINEA BLANCA
19040650;;M;27;CHILENO;;Z;LA SERENA                     ;COQUIMBO;0;0;0;0;0;0;0;0;0;Lavadora Efficace SZG 15,5Kg Silver;LINEA BLANCA
9173152;;F;58;CHILENO;;Boomers;LOS ANDES                     ;VALPARAISO;0;0;0;0;0;0;0;0;0;Refrigerador 241Lts BF Frio Directo Nordik 415;LINEA BLANCA
9283401;;M;57;CHILENO;;Boomers;SAN PEDRO                     ;METROPOLITANA;0;0;0;0;0;0;0;0;0;Freezer 99Lts MFH-1000B131CN Horizontal;LINEA BLANCA
10932788;;M;52;CHILENO;;X;PROVIDENCIA                   ;METROPOLITANA;0;0;0;0;0;0;0;0;0;Refrigerador 535Lts Side by Side RS54N3003SL/ZS;LINEA BLANCA
3490319;;F;85;CHILENO;;Silencioso;TOCOPILLA                     ;ANTOFAGASTA;0;0;0;0;0;0;0;0;0;Calefon 5Lts GL Master;LINEA BLANCA
11813629;;F;51;CHILENO;;X;PROVIDENCIA                   ;METROPOLITANA;0;0;0;0;0;0;0;0;0;Refrigerador 254Lts No Frost GT29WPPDC;LINEA BLANCA
12776326;;F;47;CHILENO;;X;TALCAHUANO                    ;BIO BIO;0;0;0;0;0;0;0;0;0;Lavadora Efficace SZG 19,5Kg Silver;LINEA BLANCA
13744487;;M;42;CHILENO;;X;TOCOPILLA                     ;ANTOFAGASTA;0;0;0;0;0;0;0;0;0;FREEZER SFH-200 200L BLANCO SINDELEN;LINEA BLANCA
9884026;;F;54;CHILENO;;X;CONCEPCION                    ;BIO BIO;0;0;0;0;0;0;0;0;0;Lavadora Efficace SZG 17,5Kg Silver;LINEA BLANCA
10027861;;F;54;CHILENO;;X;VALLENAR;ATACAMA;0;0;0;0;0;0;0;0;0;Lavadora Efficace SZG 15,5Kg Silver;LINEA BLANCA
13043765;;F;46;CHILENO;;X;PUENTE ALTO                   ;METROPOLITANA;0;0;0;0;0;0;0;0;0;Lavadora Semiautomatica Twister 5300 4Kg;LINEA BLANCA
7918066;;F;66;CHILENO;;Boomers;TEODORO SCHMIDT               ;ARAUCANIA;0;0;0;0;0;0;0;0;0;Lavadora Efficace SZG 17,5Kg Silver;LINEA BLANCA
15124579;;M;39;CHILENO;;X;PROVIDENCIA                   ;METROPOLITANA;0;0;0;0;0;0;0;0;0;Lavadora Efficace SZG 17,5Kg Silver;LINEA BLANCA
9908374;;F;53;CHILENO;;X;SANTIAGO                      ;METROPOLITANA;0;0;0;0;0;0;0;0;0;Refrigerador Altus 1350W 342Lts No Frost;LINEA BLANCA
10642454;;M;52;CHILENO;;X;RENCA                         ;METROPOLITANA;0;0;0;0;0;0;0;0;0;Lavadora Efficace SZG 19,5Kg Silver;LINEA BLANCA
9513613;Casado;M;59;CHILENO;;Boomers;PROVIDENCIA                   ;METROPOLITANA;0;0;0;0;0;0;0;0;0;Refrigerador 525Lts Side by Side SFX500;LINEA BLANCA
8835506;;M;60;CHILENO;;Boomers;RENCA                         ;METROPOLITANA;0;0;0;0;0;0;0;0;0;Refrigerador 241Lts BF Frio Directo Nordik 415;LINEA BLANCA
18511688;;F;28;CHILENO;;Millenial;PROVIDENCIA                   ;METROPOLITANA;0;0;0;0;0;0;0;0;0;Frigobar LFB-90R 90Lts Retro Rojo;LINEA BLANCA
6513402;;F;68;CHILENO;;Silencioso;PANGUIPULLI                   ;LOS LAGOS;0;0;0;0;0;0;0;0;0;Refrigerador RT25FARADSP/ZS 260Lts No Frost;LINEA BLANCA
19498290;;F;25;CHILENO;;Z;SAN JOAQUIN;METROPOLITANA;0;0;0;0;0;0;0;0;0;Cocina Nova CH9850NG 6P;LINEA BLANCA
10356908;Soltero;M;55;CHILENO;;Boomers;RENCA                         ;METROPOLITANA;0;0;0;0;0;0;0;0;0;Refrigerador 249Lts No Frost RMA250PHUG;LINEA BLANCA
13128318;;F;44;CHILENO;;X;TREGUACO                      ;BIO BIO;0;0;0;0;0;0;0;0;0;Refrigerador 260Lts BF Frio Direc MRFI2660SR346W;LINEA BLANCA
14393630;;F;44;CHILENO;;X;CARAHUE                       ;ARAUCANIA;0;0;0;0;0;0;0;0;0;Lavadora Semiautomatica Twister 5300 4Kg;LINEA BLANCA
17243840;;M;32;CHILENO;;Millenial;RENCA                         ;METROPOLITANA;0;0;0;0;0;0;0;0;0;Lavadora MLS-090GE04N 9Kg Gris;LINEA BLANCA
26594883;;M;39;VENEZOLANO;;Extranjero;COPIAPO                       ;ATACAMA;0;0;0;0;0;0;0;0;0;Lavadora superior MLS-110GE04N 11Kg;LINEA BLANCA
8283769;;M;63;CHILENO;;Boomers;PARRAL                        ;MAULE;0;0;0;0;0;0;0;0;0;Cocina CH-7400 4P;LINEA BLANCA
8192915;Soltero;F;69;CHILENO;;Silencioso;RENCA                         ;METROPOLITANA;0;0;0;0;0;0;0;0;0;Freezer MFH-2950B384CN 295 lts blanco;LINEA BLANCA
4611622;;M;78;CHILENO;;Silencioso;RENCA                         ;METROPOLITANA;0;0;0;0;0;0;0;0;0;Calefont 8Lts GL Essenetial ECO;LINEA BLANCA
16549728;;M;34;CHILENO;;Millenial;ANTOFAGASTA                   ;ANTOFAGASTA;0;0;0;0;0;0;0;0;0;Cocina 56DXQ 4P Doble Horno;LINEA BLANCA
12820302;;M;47;CHILENO;;X;RENCA                         ;METROPOLITANA;0;0;0;0;0;0;0;0;0;Lavadora WT19DSBP 19Kg Silver;LINEA BLANCA
13879706;;F;43;CHILENO;;X;VINA DEL MAR                  ;VALPARAISO;0;0;0;0;0;0;0;0;0;Freezer 142Lts MFH-1430B186C Horizontal;LINEA BLANCA
11860664;Casado;M;51;CHILENO;RELACIONADOR PUBLICO;X;RENCA                         ;METROPOLITANA;0;0;0;0;0;0;0;0;0;Frigobar LFB-101S 85Lts Inox;LINEA BLANCA
15408257;;M;39;CHILENO;;X;PROVIDENCIA                   ;METROPOLITANA;0;0;0;0;0;0;0;0;0;Lavadora Efficace SZG 17,5Kg Silver;LINEA BLANCA
16156420;;M;35;CHILENO;;Millenial;PROVIDENCIA                   ;METROPOLITANA;0;0;0;0;0;0;0;0;0;Cocina F-5500 Premium 5P;LINEA BLANCA
9517196;;F;59;CHILENO;;Boomers;RENCA                         ;METROPOLITANA;0;0;0;0;0;0;0;0;0;Lavadora Efficace SZG 15,5Kg Silver;LINEA BLANCA
12017465;;F;47;CHILENO;;X;QUIRIHUE                      ;BIO BIO;0;0;0;0;0;0;0;0;0;Lavadora Efficace SZG 17,5Kg Silver;LINEA BLANCA
8088864;;M;61;CHILENO;;Boomers;RENGO                         ;L.G.B.OÂ´HIGGINS;0;0;0;0;0;0;0;0;0;Freezaer Vertical MFV 545B 165Lts;LINEA BLANCA
9899462;Divorciado;F;43;CHILENO;MEDICO VETERINARIO;X;PROVIDENCIA                   ;METROPOLITANA;0;0;0;0;0;0;0;0;0;Microondas Empotrado ME3EP;LINEA BLANCA
13430372;;M;44;CHILENO;;X;N/D;N/D;0;0;0;0;0;0;0;0;0;Freezer 99Lts MFH-1000B131CN Horizontal;LINEA BLANCA
12376679;;F;49;CHILENO;;X;N/D;N/D;0;0;0;0;0;0;0;0;0;Lavadora MLS-090GE04N 9Kg Gris;LINEA BLANCA
3471942;;M;87;CHILENO;;Silencioso;CALERA                        ;VALPARAISO;0;0;0;0;0;0;0;0;0;Centrifuga Primma 5B 5,5Kilos;LINEA BLANCA
10341632;;M;56;CHILENO;;Boomers;RENCA                         ;METROPOLITANA;0;0;0;0;0;0;0;0;0;Cocina 775X 4P;LINEA BLANCA
17882385;;F;30;CHILENO;;Millenial;"";"";0;0;0;0;0;0;0;0;0;Lavadora Efficace BZG 9,5Kg Blanca;LINEA BLANCA
16532291;;M;35;CHILENO;;Millenial;PROVIDENCIA                   ;METROPOLITANA;0;0;0;0;0;0;0;0;0;Refrigerador 244Lts Frio Directo Progress 3100;LINEA BLANCA
10471754;Casado;M;54;CHILENO;;Boomers;PAINE                         ;METROPOLITANA;0;0;0;0;0;0;0;0;0;Calefon Vitality G/L 5Lts;LINEA BLANCA
15151180;;F;35;CHILENO;;Millenial;RENCA                         ;METROPOLITANA;0;0;0;0;0;0;0;0;0;Refrigerador RT25FARADSP/ZS 260Lts No Frost;LINEA BLANCA
14451318;;M;40;CHILENO;;X;PROVIDENCIA                   ;METROPOLITANA;0;0;0;0;0;0;0;0;0;Refrigerador 400Lts No Frost RMP400FHUG;LINEA BLANCA
10141039;;F;62;CHILENO;;Boomers;CURACAVI                      ;METROPOLITANA;0;0;0;0;0;0;0;0;0;Refrigerador DW44S 400Lts Dispen No Frost;LINEA BLANCA
10670157;;F;57;CHILENO;;Boomers;TEMUCO                        ;ARAUCANIA;0;0;0;0;0;0;0;0;0;Refrigerador 244Lts Frio Directo Progress 3100;LINEA BLANCA
18191616;;M;29;CHILENO;;Millenial;PROVIDENCIA                   ;METROPOLITANA;0;0;0;0;0;0;0;0;0;ENCIMERA CE4-600 INOX 4P SINDELEN;LINEA BLANCA
6894415;;F;79;CHILENO;;Silencioso;N/D;N/D;0;0;0;0;0;0;0;0;0;Lavadora LMA0920WGCL0 9,5Kg Gris;LINEA BLANCA
14437433;;F;48;CHILENO;;X;PUREN                         ;ARAUCANIA;0;0;0;0;0;0;0;0;0;Refrigerador 303Lts BF Frio Directo Nordik 480;LINEA BLANCA
6859783;;M;68;CHILENO;;Silencioso;TOCOPILLA                     ;ANTOFAGASTA;0;0;0;0;0;0;0;0;0;Cocina MCG-5QI30AME5 5P Inox;LINEA BLANCA
12672428;;F;48;CHILENO;;X;PROVIDENCIA                   ;METROPOLITANA;0;0;0;0;0;0;0;0;0;Lavadora Impressive 20SZ 20Kg Silver;LINEA BLANCA
13266861;;M;45;CHILENO;;X;PROVIDENCIA                   ;METROPOLITANA;0;0;0;0;0;0;0;0;0;Calefon 7Lts GL Master;LINEA BLANCA
18637878;;M;28;CHILENO;;Millenial;IQUIQUE                       ;TARAPACA;0;0;0;0;0;0;0;0;0;ENCIMERA CE4-600 INOX 4P SINDELEN;LINEA BLANCA
14413635;;M;51;CHILENO;;X;VALDIVIA                      ;LOS RIOS;0;0;0;0;0;0;0;0;0;Cocina CH-9400 4P SILVER;LINEA BLANCA
7905210;Soltero;F;67;CHILENO;;Boomers;PROVIDENCIA                   ;METROPOLITANA;0;0;0;0;0;0;0;0;0;Refrigerador 244Lts Frio Directo Progress 3100;LINEA BLANCA
7469028;Casado;F;66;CHILENO;;Boomers;SAN FERNANDO                  ;L.G.B.OÂ´HIGGINS;0;0;0;0;0;0;0;0;0;Cocina F-2808 4P;LINEA BLANCA
10011525;;F;59;CHILENO;;Boomers;RENCA                         ;METROPOLITANA;0;0;0;0;0;0;0;0;0;Lavadora Efficace SZG 15,5Kg Silver;LINEA BLANCA
9850089;;M;58;CHILENO;;Silencioso;PROVIDENCIA                   ;METROPOLITANA;0;0;0;0;0;0;0;0;0;Cocina Andes60TX3 4P Inox;LINEA BLANCA
7113251;;M;67;CHILENO;;Boomers;COPIAPO                       ;ATACAMA;0;0;0;0;0;0;0;0;0;Cocina CMC20AXX 4P Inox;LINEA BLANCA
11576934;;M;53;CHILENO;;X;TUCAPEL                       ;BIO BIO;0;0;0;0;0;0;0;0;0;Lavadora MLS-160BSC03T 16Kg Blanca;LINEA BLANCA
15084908;;F;40;CHILENO;;X;OLMUE                         ;VALPARAISO;0;0;0;0;0;0;0;0;0;Lavadora WT16DSBP 16Kg Silver;LINEA BLANCA
8003333;Casado;M;61;CHILENO;;Boomers;PROVIDENCIA                   ;METROPOLITANA;0;0;0;0;0;0;0;0;0;Freezer Vertical MFV-2400S312FW 227Lts;LINEA BLANCA
15130949;;F;39;CHILENO;;X;CURICO                        ;MAULE;0;0;0;0;0;0;0;0;0;Lavadora WT13WSBP 13Kg Blanca;LINEA BLANCA
14073873;;F;43;CHILENO;;X;VICTORIA                      ;ARAUCANIA;0;0;0;0;0;0;0;0;0;Lavadora MLS-090GE04N 9Kg Gris;LINEA BLANCA
18229928;Casado;M;30;CHILENO;INGENIERO EN PREVENCION DE RIESGOS;Millenial;PROVIDENCIA                   ;METROPOLITANA;0;0;0;0;0;0;0;0;0;Lavadora Efficace SZG 17,5Kg Silver;LINEA BLANCA
19587912;;F;24;CHILENO;;Z;CURICO                        ;MAULE;0;0;0;0;0;0;0;0;0;Lavadora Efficace SZG 17,5Kg Silver;LINEA BLANCA
9839074;;F;58;CHILENO;;Boomers;PUENTE ALTO                   ;METROPOLITANA;0;0;0;0;0;0;0;0;0;Refrigerador LB37MPGK 341Lts No Frost;LINEA BLANCA
9930656;Soltero;M;58;CHILENO;INGENIERO AGRICOLA;Boomers;PROVIDENCIA                   ;METROPOLITANA;0;0;0;0;0;0;0;0;0;Refrigerador 244Lts Frio Directo Progress 3100;LINEA BLANCA
18526598;;F;27;CHILENO;;Millenial;PELLUHUE                      ;MAULE;0;0;0;0;0;0;0;0;0;Cocina Diva 920 5P;LINEA BLANCA
20026787;;F;23;CHILENO;;Z;N/D;N/D;0;0;0;0;0;0;0;0;0;Lavadora MLS-090GE04N 9Kg Gris;LINEA BLANCA
19972616;;F;24;CHILENO;;Z;PROVIDENCIA                   ;METROPOLITANA;0;0;0;0;0;0;0;0;0;Cocina CH-7400 4P;LINEA BLANCA
10130124;Viudo;F;57;CHILENO;INGENIERO CIVIL;Boomers;PROVIDENCIA                   ;METROPOLITANA;0;0;0;0;0;0;0;0;0;Lavadora Efficace SZG 19,5Kg Silver;LINEA BLANCA
14623129;;F;53;CHILENO;;X;LAS CONDES                    ;METROPOLITANA;0;0;0;0;0;0;0;0;0;Freezer FDHM150BY1 150Lts Horizontal;LINEA BLANCA
4723509;;F;79;CHILENO;;Silencioso;ISLA DE MAIPO                 ;METROPOLITANA;0;0;0;0;0;0;0;0;0;Lavadora Secadora WD10J6410AW/ZS 10,5/6Kg Blanca;LINEA BLANCA
7374165;Casado;F;66;CHILENO;;Boomers;RENCA                         ;METROPOLITANA;0;0;0;0;0;0;0;0;0;Refrigerador RT25FARADSP/ZS 260Lts No Frost;LINEA BLANCA
11373200;;F;56;CHILENO;;Boomers;PENALOLEN                     ;METROPOLITANA;0;0;0;0;0;0;0;0;0;Refrigerador 626Lt Side by Side GS65MPP1 APZPECL;LINEA BLANCA
10046201;;F;61;CHILENO;;Boomers;RENCA                         ;METROPOLITANA;0;0;0;0;0;0;0;0;0;Refrigerador 244Lts Frio Directo Progress 3100;LINEA BLANCA
11668545;Divorciado;F;51;CHILENO;TECNICO DE NIVEL SUPERIOR EN ENFERMERIA;X;SAN BERNARDO                  ;METROPOLITANA;0;0;0;0;0;0;0;0;0;Refrigerador 249Lts No Frost RMA250PHUG;LINEA BLANCA
10320676;;M;56;CHILENO;;Boomers;COLINA                        ;METROPOLITANA;0;0;0;0;0;0;0;0;0;Cocina CH-7400 4P;LINEA BLANCA
16905533;;M;34;CHILENO;;Millenial;PROVIDENCIA                   ;METROPOLITANA;0;0;0;0;0;0;0;0;0;Cocina 775X 4P;LINEA BLANCA
12447912;Casado;F;49;CHILENO;AUXILIAR PARAMEDICO DE ENFERMERIA;X;RENCA                         ;METROPOLITANA;0;0;0;0;0;0;0;0;0;Cocina 56DXQ 4P Doble Horno;LINEA BLANCA
17854072;;F;30;CHILENO;;Millenial;N/D;N/D;570940;4;2;0;0;0;4;2;570940;Consola PlayStation 4 500GB;VIDEO JUEGOS
19096924;;M;26;CHILENO;;Z;RENCA                         ;METROPOLITANA;1077300;6;3;4;2;585830;2;1;491470;Consola PlayStation 4 500GB;VIDEO JUEGOS
11881476;;M;51;CHILENO;;X;RENCA                         ;METROPOLITANA;64990;1;1;0;0;0;1;1;64990;PS5 DUALSENSE;VIDEO JUEGOS
14351016;;M;42;CHILENO;;X;RENCA                         ;METROPOLITANA;65970;3;1;3;1;65970;0;0;0;CONTROL NINTENDO SWITCH PRO CONTROLLER;VIDEO JUEGOS
17119365;;M;33;CHILENO;;Millenial;PROVIDENCIA                   ;METROPOLITANA;23970;3;1;3;1;23970;0;0;0;ACC ENWIRED CONTROLLER MARIO PUNCH;VIDEO JUEGOS
17816670;Soltero;F;30;CHILENO;ASISTENTE SOCIAL;Millenial;SAN ANTONIO;VALPARAISO;513930;7;3;5;2;429950;2;1;83980;Juego SWITCH SM 3D WORLD AND BOWSERS FURY;VIDEO JUEGOS
16173813;;F;36;CHILENO;;Millenial;PROVIDENCIA                   ;METROPOLITANA;44490;2;1;2;1;44490;0;0;0;JGO FIFA 22 ROLA PS5;VIDEO JUEGOS
6549705;;F;71;CHILENO;;Silencioso;N/D;N/D;516970;3;2;2;1;499980;1;1;16990;Consola PlayStation 4 500GB;VIDEO JUEGOS
6838949;;M;68;CHILENO;;Silencioso;ISLA DE MAIPO                 ;METROPOLITANA;3636730;10;7;0;0;0;10;7;3636730;Consola PlayStation 5 con Disco (Internacional);VIDEO JUEGOS
17763756;;F;31;CHILENO;;Millenial;N/D;N/D;1054660;9;4;0;0;0;9;4;1054660;Consola PlayStation 4 500GB;VIDEO JUEGOS
12029679;;M;46;CHILENO;;X;SAN RAMON;METROPOLITANA;649990;2;1;0;0;0;2;1;649990;Consola PlayStation 5 con Disco (Internacional);VIDEO JUEGOS
19488454;;F;25;CHILENO;;Z;QUILPUE;VALPARAISO;349990;1;1;1;1;349990;0;0;0;Consola PlayStation 4 500GB;VIDEO JUEGOS
7708635;;M;64;CHILENO;;Boomers;N/D;N/D;1049990;1;1;0;0;0;1;1;1049990;Consola PlayStation 5 con Disco (Internacional);VIDEO JUEGOS
12350460;;F;49;CHILENO;;X;PROVIDENCIA                   ;METROPOLITANA;999990;1;1;0;0;0;1;1;999990;Consola PlayStation 5 con Disco (Internacional);VIDEO JUEGOS
15682869;;F;38;CHILENO;;X;QUILLOTA;VALPARAISO;55980;2;1;2;1;55980;0;0;0;JGO FIFA 22 ROLA PS4;VIDEO JUEGOS
16380968;;M;36;CHILENO;;Silencioso;"";"";55980;2;1;2;1;55980;0;0;0;Control Robot White + Skin Fortnite;VIDEO JUEGOS
16306604;;F;35;CHILENO;;Millenial;LOS ANDES                     ;VALPARAISO;247960;4;2;4;2;247960;0;0;0;JUEGO SWITCH Mario Kart 8 Deluxe;VIDEO JUEGOS
17058231;;M;33;CHILENO;;Millenial;RENCA                         ;METROPOLITANA;37990;1;1;0;0;0;1;1;37990;JUEGO SWITCH Super Smash Bros Ultimate;VIDEO JUEGOS
7978945;;M;59;CHILENO;;Boomers;VITACURA                      ;METROPOLITANA;45980;2;1;2;1;45980;0;0;0;SW SWITCH POKEMON BRILLIANT DIAMONT;VIDEO JUEGOS
8759962;;F;63;CHILENO;;Boomers;SAN CLEMENTE                  ;MAULE;1257970;3;2;0;0;0;3;2;1257970;Consola PlayStation 5 con Disco (Internacional);VIDEO JUEGOS
26668618;;F;39;VENEZOLANO;;Extranjero;ESTACION CENTRAL;METROPOLITANA;41980;2;1;2;1;41980;0;0;0;JUEGO SWITCH Super Mario Party;VIDEO JUEGOS
18125654;;F;30;CHILENO;;Millenial;N/D;N/D;544960;4;2;4;2;544960;0;0;0;CONSOLA SWITCH LT2 NEON;VIDEO JUEGOS
16458769;;F;35;CHILENO;;Millenial;RENCA                         ;METROPOLITANA;764980;2;1;0;0;0;2;1;764980;Consola PlayStation 5 con Disco;VIDEO JUEGOS
17048060;;F;33;CHILENO;;Millenial;PROVIDENCIA                   ;METROPOLITANA;63980;2;1;2;1;63980;0;0;0;CONTROL PS4 Midnight Blue;VIDEO JUEGOS
13452730;;F;43;CHILENO;;X;MELIPILLA                     ;METROPOLITANA;44980;2;1;2;1;44980;0;0;0;F1 2021 PS4 - CHILE;VIDEO JUEGOS
17272396;;M;32;CHILENO;;Silencioso;PROVIDENCIA                   ;METROPOLITANA;303980;2;1;2;1;303980;0;0;0;Consola Xbox Series S 512GB;VIDEO JUEGOS
15557811;;M;39;CHILENO;;X;VILLA ALEMANA                 ;VALPARAISO;324990;1;1;0;0;0;1;1;324990;CONSOLA SWITCH LT2 NEON;VIDEO JUEGOS
16955595;;F;33;CHILENO;;Millenial;MELIPILLA                     ;METROPOLITANA;58980;2;1;2;1;58980;0;0;0;Control inalambrico Xbox + cable USB-C Negro;VIDEO JUEGOS
13744674;;F;42;CHILENO;;X;ANTOFAGASTA                   ;ANTOFAGASTA;0;0;0;0;0;0;0;0;0;CONSOLA SWITCH LT2 NEON;VIDEO JUEGOS
17853178;;M;31;CHILENO;;Millenial;TOME                          ;BIO BIO;0;0;0;0;0;0;0;0;0;Consola PlayStation 5 con Disco;VIDEO JUEGOS
8806526;;F;58;CHILENO;;Boomers;LA SERENA                     ;COQUIMBO;0;0;0;0;0;0;0;0;0;CONSOLA SWITCH LT2 NEON;VIDEO JUEGOS
16315745;;F;36;CHILENO;;Millenial;N/D;N/D;0;0;0;0;0;0;0;0;0;PS4 HW 1TB MEGA 18 - R C, GOT, GOW BNDL;VIDEO JUEGOS
20142012;;M;22;CHILENO;;Z;PROVIDENCIA                   ;METROPOLITANA;0;0;0;0;0;0;0;0;0;Control inalambrico Xbox + cable USB-C Negro;VIDEO JUEGOS
14261343;Casado;M;48;CHILENO;DISENADOR GRAFICO;Silencioso;PROVIDENCIA                   ;METROPOLITANA;0;0;0;0;0;0;0;0;0;Control inalambrico Xbox + cable USB-C Negro;VIDEO JUEGOS
16211651;;M;35;CHILENO;;Silencioso;PROVIDENCIA                   ;METROPOLITANA;0;0;0;0;0;0;0;0;0;Consola Xbox Series S 512GB;VIDEO JUEGOS
18265780;Soltero;M;29;CHILENO;KINESIOLOGO;Silencioso;PROVIDENCIA                   ;METROPOLITANA;0;0;0;0;0;0;0;0;0;Consola Xbox Series S 512GB;VIDEO JUEGOS
19802168;;F;24;CHILENO;;Z;PROVIDENCIA                   ;METROPOLITANA;0;0;0;0;0;0;0;0;0;Juego Switch Ring Fit Adventure;VIDEO JUEGOS
18778150;;M;27;CHILENO;;Silencioso;PROVIDENCIA                   ;METROPOLITANA;0;0;0;0;0;0;0;0;0;PS4 HW 1TB MEGA 15 - SPDMN GOTY, R C, HZDCE BNDL;VIDEO JUEGOS
16359862;Soltero;M;35;CHILENO;;Silencioso;PROVIDENCIA                   ;METROPOLITANA;0;0;0;0;0;0;0;0;0;ACC CONTROL PS4 DUALSHOCK;VIDEO JUEGOS
13007666;;M;45;CHILENO;;X;PROVIDENCIA                   ;METROPOLITANA;0;0;0;0;0;0;0;0;0;PS4 HW 1TB MEGA 15 - SPDMN GOTY, R C, HZDCE BNDL;VIDEO JUEGOS
16134874;;M;36;CHILENO;;Silencioso;PROVIDENCIA                   ;METROPOLITANA;0;0;0;0;0;0;0;0;0;PS5 PULSE 3D HEADSET;VIDEO JUEGOS
20245189;;M;22;CHILENO;;Silencioso;PROVIDENCIA                   ;METROPOLITANA;0;0;0;0;0;0;0;0;0;JUEGO SWITCH Super Mario Odyssey;VIDEO JUEGOS
18544576;;M;29;CHILENO;;Millenial;PENALOLEN                     ;METROPOLITANA;0;0;0;0;0;0;0;0;0;CONSOLA NINTENDO SWITCH + ANIMAL CROSSING;VIDEO JUEGOS
25853408;;M;36;VENEZOLANO;;Extranjero;"";"";0;0;0;0;0;0;0;0;0;ACC CONTROL PS4 DUALSHOCK;VIDEO JUEGOS
13771197;;M;42;CHILENO;;X;PROVIDENCIA                   ;METROPOLITANA;0;0;0;0;0;0;0;0;0;CONTROL PS4 CAMOUFLAGE;VIDEO JUEGOS
20442112;;M;22;CHILENO;;Silencioso;PROVIDENCIA                   ;METROPOLITANA;0;0;0;0;0;0;0;0;0;Control inalambrico Xbox + cable USB-C Negro;VIDEO JUEGOS
16007324;;M;36;CHILENO;;Millenial;MAIPU                         ;METROPOLITANA;0;0;0;0;0;0;0;0;0;CONSOLA PS4 HW 1TB MEGA 16 - R6, HZD UCC;VIDEO JUEGOS
12501734;;M;49;CHILENO;;X;PROVIDENCIA                   ;METROPOLITANA;0;0;0;0;0;0;0;0;0;Consola PlayStation 5 con Disco;VIDEO JUEGOS
14280131;;F;48;CHILENO;;X;MAIPU                         ;METROPOLITANA;0;0;0;0;0;0;0;0;0;CONSOLA GAME WATCH SUPER MARIO BROS;VIDEO JUEGOS
15610429;Soltero;F;39;CHILENO;TECNICO DE NIVEL SUPERIOR EN ENFERMERIA;X;PROVIDENCIA                   ;METROPOLITANA;0;0;0;0;0;0;0;0;0;JUEGO MARVELS AVENGERS - LATAM XBONE;VIDEO JUEGOS
15565436;;F;38;CHILENO;;X;MAIPU                         ;METROPOLITANA;0;0;0;0;0;0;0;0;0;CONSOLA ONE S XBOX BLANCA;VIDEO JUEGOS
17902969;;M;31;CHILENO;;Millenial;PROVIDENCIA                   ;METROPOLITANA;0;0;0;0;0;0;0;0;0;CONSOLA SWITCH LITE TURQUOISE;VIDEO JUEGOS
9863893;;F;50;CHILENO;;X;PROVIDENCIA                   ;METROPOLITANA;0;0;0;0;0;0;0;0;0;JUEGO SW SWITCH POKEMON SWORD;VIDEO JUEGOS
15167547;;F;48;CHILENO;;X;RENCA                         ;METROPOLITANA;0;0;0;0;0;0;0;0;0;JUEGO PS4 God OF War;VIDEO JUEGOS
11900783;;F;50;CHILENO;;X;SAN PEDRO DE LA PAZ           ;BIO BIO;0;0;0;0;0;0;0;0;0;PS4 SLIM 1TB MEGAPACK HIT 13;VIDEO JUEGOS
12781254;;F;46;CHILENO;;X;PUMANQUE                      ;L.G.B.OÂ´HIGGINS;0;0;0;0;0;0;0;0;0;CONSOLA PS4 SLIM 1TB HITS 5;VIDEO JUEGOS
18039218;;M;30;CHILENO;;Millenial;PROVIDENCIA                   ;METROPOLITANA;0;0;0;0;0;0;0;0;0;CONSOLA ONE S XBOX BLANCA;VIDEO JUEGOS
9463395;;M;59;CHILENO;;Boomers;BUIN                          ;METROPOLITANA;0;0;0;0;0;0;0;0;0;CONSOLA PS4 1TB MEGA 6 3 Juegos 3M PS Plus;VIDEO JUEGOS
13752378;Soltero;M;41;CHILENO;INGENIERO EN CONSTRUCCION;X;RENCA                         ;METROPOLITANA;0;0;0;0;0;0;0;0;0;Control inalambrico + cable USB-C Negro;VIDEO JUEGOS
26180784;;M;31;VENEZOLANO;;Extranjero;SANTIAGO                      ;METROPOLITANA;0;0;0;0;0;0;0;0;0;CONSOLA SWITCH LT2 NEON;VIDEO JUEGOS
15802346;;F;38;CHILENO;;Millenial;OVALLE                        ;COQUIMBO;0;0;0;0;0;0;0;0;0;CONSOLA PS4 1TB MEGA 6 3 Juegos 3M PS Plus;VIDEO JUEGOS
26345736;;M;46;VENEZOLANO;;Extranjero;CONCEPCION                    ;BIO BIO;0;0;0;0;0;0;0;0;0;CONSOLA PS4 1TB MEGA 6 3 Juegos 3M PS Plus;VIDEO JUEGOS
18199790;;M;29;CHILENO;;Millenial;N/D;N/D;0;0;0;0;0;0;0;0;0;CONSOLA PS4 1TB MEGA 6 3 Juegos 3M PS Plus;VIDEO JUEGOS
14533673;;M;46;CHILENO;;X;TALCA;MAULE;0;0;0;0;0;0;0;0;0;DUALSHOCK 4 (CUH-ZCT2U) - ELECTRIC PURPLE - LATA;VIDEO JUEGOS
17699009;Soltero;M;31;CHILENO;PUBLICISTA;Silencioso;PROVIDENCIA                   ;METROPOLITANA;0;0;0;0;0;0;0;0;0;ACC CONTROL PS4 DUALSHOCK;VIDEO JUEGOS
11639265;;F;52;CHILENO;;X;MAIPU                         ;METROPOLITANA;0;0;0;0;0;0;0;0;0;CONSOLA SWITCH LT2 NEON;VIDEO JUEGOS
6748531;;M;57;CHILENO;;Boomers;CASABLANCA                    ;VALPARAISO;93470;3;2;0;0;0;3;2;93470;ESTUFA CUARZO KIOTO 800W KTE-011A;CLIMATIZACION
17201257;;M;32;CHILENO;;Millenial;VALDIVIA                      ;LOS LAGOS;12990;1;3;1;1;12990;0;2;0;CALIENTACAMA KIOTO ANALOGO 1 PLAZA KTC-1004;CLIMATIZACION
18480333;;F;29;CHILENO;;Millenial;PROVIDENCIA                   ;METROPOLITANA;93980;2;1;2;1;93980;0;0;0;V-VENTILADOR TORRE BLANCO C/CONTROL REMOTO;CLIMATIZACION
14262540;;F;48;CHILENO;;X;EL MONTE                      ;METROPOLITANA;907910;6;3;0;0;0;6;3;907910;ESTUFA CUARZO KIOTO 800W KTE-011A;CLIMATIZACION
18048777;;M;30;CHILENO;;Millenial;PROVIDENCIA                   ;METROPOLITANA;0;0;2;1;1;7990;-1;1;-7990;ESTUFA CUARZO KIOTO 800W KTE-011A;CLIMATIZACION
18559336;;F;28;CHILENO;;Millenial;PARRAL                        ;MAULE;26980;2;2;0;0;0;2;2;26980;ESTUFA CUARZO KIOTO 800W KTE-011A;CLIMATIZACION
10687834;;F;56;CHILENO;;Boomers;LOS ANDES                     ;VALPARAISO;9990;1;1;0;0;0;1;1;9990;ESTUFA CUARZO KIOTO 800W KTE-011A;CLIMATIZACION
16877791;;M;33;CHILENO;;Millenial;PADRE HURTADO                 ;METROPOLITANA;27970;3;2;3;2;27970;0;0;0;ESTUFA CUARZO KIOTO 800W KTE-011A;CLIMATIZACION
10487592;;F;58;CHILENO;;Boomers;MAIPU                         ;METROPOLITANA;9990;1;1;0;0;0;1;1;9990;ESTUFA CUARZO KIOTO 800W KTE-011A;CLIMATIZACION
11849383;;F;51;CHILENO;;X;PROVIDENCIA                   ;METROPOLITANA;19980;2;1;0;0;0;2;1;19980;ESTUFA CUARZO KIOTO 800W KTE-011A;CLIMATIZACION
19237659;;F;26;CHILENO;;Z;LAS CONDES                    ;METROPOLITANA;116480;2;2;0;0;0;2;2;116480;ESTUFA CUARZO KIOTO 800W KTE-011A;CLIMATIZACION
9702592;Casado;F;55;CHILENO;PSICOPEDAGOGO;Boomers;PROVIDENCIA                   ;METROPOLITANA;0;0;2;0;2;0;0;0;0;ESTUFA ELECTRICA CUARZO KIOTO 1200W KTE 1033;CLIMATIZACION
8819426;;M;59;CHILENO;;Z;ANTOFAGASTA                   ;ANTOFAGASTA;14000;1;1;0;0;0;1;1;14000;ESTUFA CUARZO KIOTO 800W KTE-011A;CLIMATIZACION
16579107;;F;35;CHILENO;;Millenial;VICTORIA                      ;ARAUCANIA;138970;4;2;0;0;0;4;2;138970;CALIENTACAMA KIOTO DIGITAL 2 PLAZAS KTC-1006;CLIMATIZACION
25880828;;F;28;EXTRANJERO - NO INFORMA NACIONALIDAD;;Extranjero;LA SERENA                     ;COQUIMBO;185950;7;4;0;0;0;7;4;185950;ESTUFA CUARZO KIOTO 800W KTE-011A;CLIMATIZACION
18423208;;F;29;CHILENO;;Millenial;LAMPA                         ;METROPOLITANA;99960;4;2;4;2;99960;0;0;0;ESTUFA CUARZO KIOTO 800W KTE-011A;CLIMATIZACION
17733490;;M;31;CHILENO;;Millenial;LAS CONDES;METROPOLITANA;9990;1;1;0;0;0;1;1;9990;ESTUFA CUARZO KIOTO 800W KTE-011A;CLIMATIZACION
11382521;;M;53;CHILENO;;X;MONTE PATRIA                  ;COQUIMBO;375980;4;2;0;0;0;4;2;375980;ESTUFA CUARZO KIOTO 800W KTE-011A;CLIMATIZACION
18204692;;F;30;CHILENO;;Millenial;PUERTO MONTT;LOS LAGOS;106980;4;3;0;0;0;4;3;106980;ESTUFA CUARZO KIOTO 800W KTE-011A;CLIMATIZACION
18819448;;F;27;CHILENO;;Z;COIHAIQUE                     ;AYSEN;6490;1;1;0;0;0;1;1;6490;ESTUFA CUARZO KIOTO 800W KTE-011A;CLIMATIZACION
6531482;;M;72;CHILENO;;Silencioso;CHILLAN                       ;BIO BIO;144250;4;2;0;0;0;4;2;144250;CALIENTACAMAS DIGITAL TIMER SG-5151 2PL;CLIMATIZACION
18895202;;M;27;CHILENO;;Z;CONSTITUCION                  ;MAULE;0;0;2;0;2;0;0;0;0;TERMOVENTILADOR KIOTO BLANCO 2000W KTE-1028B;CLIMATIZACION
11761739;;M;51;CHILENO;;X;N/D;N/D;33095;1;2;0;0;0;1;2;33095;TERMOVENTILADOR CERAMICO HTC 2013 OSCILANTE;CLIMATIZACION
9427014;;F;59;CHILENO;;Boomers;NUEVA IMPERIAL                ;ARAUCANIA;896830;9;6;0;0;0;9;6;896830;ESTUFA CUARZO KIOTO 800W KTE-011A;CLIMATIZACION
9734734;Soltero;M;51;CHILENO;INGENIERO COMERCIAL;Silencioso;PROVIDENCIA                   ;METROPOLITANA;35950;5;1;5;1;35950;0;0;0;TERMOVENTILADOR KIOTO NEGRO 2000W KTE-1028N;CLIMATIZACION
16331574;;M;35;CHILENO;;Millenial;QUILPUE                       ;VALPARAISO;397310;5;3;0;0;0;5;3;397310;ESTUFA CUARZO KIOTO 800W KTE-011A;CLIMATIZACION
17148697;;F;34;CHILENO;;Millenial;PROVIDENCIA                   ;METROPOLITANA;10990;1;1;1;1;10990;0;0;0;CALIENTACAMA KIOTO ANALOGO 1 PLAZA KTC-1004;CLIMATIZACION
15882771;;M;37;CHILENO;;Millenial;N/D;N/D;415960;4;3;3;2;405970;1;1;9990;TERMOVENTILADOR KIOTO NEGRO 2000W KTE-1028N;CLIMATIZACION
16451929;;F;36;CHILENO;;Millenial;SANTIAGO;METROPOLITANA;23980;2;1;2;1;23980;0;0;0;TERMOVENTILADOR CERAMICO TH-CH40;CLIMATIZACION
18057919;Soltero;F;30;CHILENO;INGENIERO COMERCIAL;Millenial;PROVIDENCIA                   ;METROPOLITANA;343950;5;2;5;2;343950;0;0;0;CONVECTOR ELECTRICO UT MC -20 WIFI;CLIMATIZACION
18947581;;M;28;CHILENO;;Millenial;PROVIDENCIA                   ;METROPOLITANA;7240;2;2;0;0;0;2;2;7240;ESTUFA CUARZO KIOTO 800W KTE-011A;CLIMATIZACION
5346005;;F;78;CHILENO;;Silencioso;LOS ANDES                     ;VALPARAISO;322730;3;2;0;0;0;3;2;322730;ESTUFA A GAS CALMA 15 KG HELIUS;CLIMATIZACION
15722800;Soltero;F;38;CHILENO;MEDICO CIRUJANO;X;N/D;N/D;25970;3;1;3;1;25970;0;0;0;CALIENTACAMA KIOTO ANALOGO 1 PLAZA KTC-1004;CLIMATIZACION
13206695;;F;45;CHILENO;;X;PROVIDENCIA                   ;METROPOLITANA;17980;2;1;0;0;0;2;1;17980;TERMOVENTILADOR KIOTO BLANCO 2000W KTE-1028B;CLIMATIZACION
19863877;;F;23;CHILENO;;Z;PUERTO MONTT;LOS LAGOS;217940;6;4;6;4;217940;0;0;0;CALIENTACAMA KIOTO ANALOGO 1 PLAZA KTC-1004;CLIMATIZACION
16078119;;F;36;CHILENO;;Millenial;SAN FELIPE                    ;VALPARAISO;39980;2;2;2;2;39980;0;0;0;CALIENTACAMA KIOTO ANALOGO 1 PLAZA KTC-1004;CLIMATIZACION
12802400;;M;46;CHILENO;;X;ILLAPEL                       ;COQUIMBO;125470;7;2;0;0;0;7;2;125470;CALIENTACAMA KIOTO ANALOGO 1 PLAZA KTC-1004;CLIMATIZACION
19107655;;F;26;CHILENO;;Millenial;"";"";49990;1;1;1;1;49990;0;0;0;CHIMENEA ELECTRICA KIOTO 2000W KTE-1101;CLIMATIZACION
15842053;;F;37;CHILENO;;Extranjero;ANTOFAGASTA                   ;ANTOFAGASTA;79980;3;2;3;2;79980;0;0;0;ESTUFA CUARZO KIOTO 800W KTE-011A;CLIMATIZACION
13004647;;F;45;CHILENO;;X;"";"";6990;1;1;0;0;0;1;1;6990;ESTUFA CUARZO KIOTO 800W KTE-011A;CLIMATIZACION
11632509;Soltero;M;52;CHILENO;PSICOLOGO;X;PROVIDENCIA                   ;METROPOLITANA;201880;3;2;0;0;0;3;2;201880;ESTUFA GAS EH5300 15K BURDEOS;CLIMATIZACION
7904567;;M;65;CHILENO;;Boomers;SAN BERNARDO                  ;METROPOLITANA;199980;2;2;0;0;0;2;2;199980;TERMOVENTILADOR KIOTO NEGRO 2000W KTE-1028N;CLIMATIZACION
16346916;;F;35;CHILENO;;Millenial;PROVIDENCIA                   ;METROPOLITANA;15980;2;2;2;2;15980;0;0;0;TERMOVENTILADOR KIOTO BLANCO 2000W KTE-1028B;CLIMATIZACION
13154205;Soltero;M;48;CHILENO;;X;BUIN                          ;METROPOLITANA;65900;2;1;0;0;0;2;1;65900;CHIMENEA ELECTRICA KIOTO 2000W KTE-1101;CLIMATIZACION
19541652;;M;25;CHILENO;;Z;PROVIDENCIA                   ;METROPOLITANA;7990;1;1;1;1;7990;0;0;0;TERMOVENTILADOR KIOTO BLANCO 2000W KTE-1028B;CLIMATIZACION
8136696;;F;68;CHILENO;;Boomers;PROVIDENCIA                   ;METROPOLITANA;535930;7;4;0;0;0;7;4;535930;ESTUFA ELECTRICA CUARZO KIOTO 1200W KTE 1033;CLIMATIZACION
7595650;;M;65;CHILENO;;Boomers;PROVIDENCIA                   ;METROPOLITANA;201970;4;4;0;0;0;4;4;201970;ESTUFA CUARZO KIOTO 800W KTE-011A;CLIMATIZACION
11058459;;F;56;CHILENO;;Boomers;RECOLETA                      ;METROPOLITANA;627950;6;4;5;3;157960;1;1;469990;CALIENTACAMA KIOTO ANALOGO 1 PLAZA KTC-1004;CLIMATIZACION
13836511;;F;42;CHILENO;;X;N/D;N/D;467340;5;3;2;1;14980;3;2;452360;CALIENTACAMA KIOTO ANALOGO 1 PLAZA KTC-1004;CLIMATIZACION
15934863;;M;37;CHILENO;;Millenial;LA FLORIDA                    ;METROPOLITANA;9990;1;1;0;0;0;1;1;9990;TERMOVENTILADOR KIOTO NEGRO 2000W KTE-1028N;CLIMATIZACION
23526912;Soltero;F;47;BRASILEÃO;;Extranjero;RECOLETA;METROPOLITANA;9990;1;1;1;1;9990;0;0;0;ESTUFA CUARZO KIOTO 800W KTE-011A;CLIMATIZACION
12210001;;F;50;CHILENO;;X;IQUIQUE                       ;TARAPACA;95440;6;3;1;1;9990;5;2;85450;ESTUFA CUARZO KIOTO 800W KTE-011A;CLIMATIZACION
9802488;;F;55;CHILENO;;Boomers;CURICO                        ;MAULE;19990;1;1;0;0;0;1;1;19990;CALIENTACAMA KIOTO DIGITAL 1 PLAZA KTC-1005;CLIMATIZACION
18565745;Soltero;F;28;CHILENO;;Millenial;PROVIDENCIA                   ;METROPOLITANA;30980;2;2;2;2;30980;0;0;0;CALIENTACAMA KIOTO ANALOGO 1 PLAZA KTC-1004;CLIMATIZACION
19971040;;F;23;CHILENO;;Z;PROVIDENCIA                   ;METROPOLITANA;7990;1;1;1;1;7990;0;0;0;ESTUFA CUARZO KIOTO 800W KTE-011A;CLIMATIZACION
15820604;;M;38;CHILENO;;Millenial;MAIPU                         ;METROPOLITANA;69980;2;2;1;1;49990;1;1;19990;CHIMENEA ELECTRICA KIOTO 2000W KTE-1101;CLIMATIZACION
12103823;Casado;M;53;CHILENO;INGENIERO COMERCIAL;X;"";"";35950;5;1;5;1;35950;0;0;0;TERMOVENTILADOR KIOTO BLANCO 2000W KTE-1028B;CLIMATIZACION
25467447;;F;46;PERUANO;;Extranjero;SANTIAGO                      ;METROPOLITANA;24980;2;3;0;0;0;2;3;24980;CALIENTACAMA KIOTO ANALOGO 1 PLAZA KTC-1004;CLIMATIZACION
18045776;;F;30;CHILENO;;Millenial;N/D;N/D;37980;2;2;0;0;0;2;2;37980;CALIENTACAMA KIOTO DIGITAL 1 PLAZA KTC-1005;CLIMATIZACION
16384254;;F;35;CHILENO;;Millenial;PROVIDENCIA                   ;METROPOLITANA;22980;2;2;1;1;9990;1;1;12990;TERMOVENTILADOR KIOTO NEGRO 2000W KTE-1028N;CLIMATIZACION
18581736;;F;28;CHILENO;;Millenial;NUEVA IMPERIAL                ;ARAUCANIA;54372;3;1;0;0;0;3;1;54372;CALIENTACAMA KIOTO DIGITAL 2 PLAZAS KTC-1006;CLIMATIZACION
18213813;Casado;F;29;CHILENO;;Millenial;PROVIDENCIA                   ;METROPOLITANA;9990;1;1;0;0;0;1;1;9990;TERMOVENTILADOR KIOTO NEGRO 2000W KTE-1028N;CLIMATIZACION
14557243;;F;43;CHILENO;;X;N/D;N/D;257960;4;2;0;0;0;4;2;257960;CALIENTACAMA KIOTO ANALOGO 1 PLAZA KTC-1004;CLIMATIZACION
17238054;Soltero;M;33;CHILENO;LICIADO;Millenial;PROVIDENCIA                   ;METROPOLITANA;18470;2;1;0;0;0;2;1;18470;TERMOVENTILADOR KIOTO NEGRO 2000W KTE-1028N;CLIMATIZACION
7743149;;M;64;CHILENO;;Boomers;LA PINTANA                    ;METROPOLITANA;153540;5;3;0;0;0;5;3;153540;CALIENTACAMA KIOTO DIGITAL 1 PLAZA KTC-1005;CLIMATIZACION
13567186;;F;42;CHILENO;;X;PUNTA ARENAS                  ;MAGALLANES;23980;2;2;2;2;23980;0;0;0;CALIENTACAMA KIOTO ANALOGO 1 PLAZA KTC-1004;CLIMATIZACION
9462032;;F;60;CHILENO;;Boomers;LINARES                       ;MAULE;26982;2;1;0;0;0;2;1;26982;CALIENTACAMA KIOTO ANALOGO 1 PLAZA KTC-1004;CLIMATIZACION
19139170;;F;27;CHILENO;;Z;PROVIDENCIA                   ;METROPOLITANA;10990;1;1;0;0;0;1;1;10990;ESTUFA CUARZO KIOTO 800W KTE-011A;CLIMATIZACION
9545011;;F;62;CHILENO;;Boomers;CASTRO                        ;LOS LAGOS;594950;5;3;0;0;0;5;3;594950;MINI OLEOELECTRICA KIOTO 500W NEGRO KTE-1081N;CLIMATIZACION
13669110;;F;42;CHILENO;;X;N/D;N/D;138890;22;4;22;4;138890;0;0;0;TERMOVENTILADOR KIOTO BLANCO 2000W KTE-1028B;CLIMATIZACION
19946184;;F;24;CHILENO;;Z;PROVIDENCIA                   ;METROPOLITANA;7990;1;1;1;1;7990;0;0;0;TERMOVENTILADOR KIOTO BLANCO 2000W KTE-1028B;CLIMATIZACION
19091969;;F;26;CHILENO;;Z;N/D;N/D;21980;2;1;0;0;0;2;1;21980;TERMOVENTILADOR KIOTO NEGRO 2000W KTE-1028N;CLIMATIZACION
11389483;;F;53;CHILENO;;X;VILLA ALEMANA                 ;VALPARAISO;49990;1;1;0;0;0;1;1;49990;CHIMENEA ELECTRICA KIOTO 2000W KTE-1101;CLIMATIZACION
9518532;;F;58;CHILENO;;Boomers;PAINE                         ;METROPOLITANA;634890;11;7;0;0;0;11;7;634890;ESTUFA CUARZO KIOTO 800W KTE-011A;CLIMATIZACION
11659135;;F;52;CHILENO;;X;N/D;N/D;6993;1;1;0;0;0;1;1;6993;ESTUFA CUARZO KIOTO 800W KTE-011A;CLIMATIZACION
17432729;;F;32;CHILENO;;Millenial;ALTO HOSPICIO;TARAPACA;49990;1;1;0;0;0;1;1;49990;CHIMENEA ELECTRICA KIOTO 2000W KTE-1101;CLIMATIZACION
19224133;;M;34;CHILENO;;Millenial;LO PRADO;METROPOLITANA;477940;6;3;6;3;477940;0;0;0;CALEFACTOR INFRAROJO GR2800 R NEGRO;CLIMATIZACION
26095344;Soltero;F;31;VENEZOLANO;;Extranjero;SANTIAGO;METROPOLITANA;366970;4;3;3;2;359980;1;1;6990;ESTUFA CUARZO KIOTO 800W KTE-011A;CLIMATIZACION
17973433;;M;30;CHILENO;;Millenial;PROVIDENCIA                   ;METROPOLITANA;10990;1;1;0;0;0;1;1;10990;TERMOVENTILADOR KIOTO BLANCO 2000W KTE-1028B;CLIMATIZACION
19865007;;F;24;CHILENO;;Z;CHEPICA                       ;L.G.B.OÂ´HIGGINS;29970;3;1;0;0;0;3;1;29970;TERMOVENTILADOR KIOTO BLANCO 2000W KTE-1028B;CLIMATIZACION
10625197;;M;51;CHILENO;;X;PUENTE ALTO                   ;METROPOLITANA;152980;2;2;0;0;0;2;2;152980;Radioconvector Electrico Rb2018T;CLIMATIZACION
16207782;Soltero;F;36;CHILENO;;Silencioso;PROVIDENCIA                   ;METROPOLITANA;163970;3;1;3;1;163970;0;0;0;CONVECTOR ELECTRICO UT MD-20 D;CLIMATIZACION
7950441;;M;60;CHILENO;;Boomers;COIHAIQUE                     ;AYSEN;1228910;19;11;0;0;0;19;11;1228910;ESTUFA CUARZO KIOTO 800W KTE-011A;CLIMATIZACION
16789596;;M;34;CHILENO;;Millenial;RENCA                         ;METROPOLITANA;19970;3;1;3;1;19970;0;0;0;TERMOVENTILADOR KIOTO BLANCO 2000W KTE-1028B;CLIMATIZACION
16697938;;F;34;CHILENO;;Millenial;"";"";49990;1;1;0;0;0;1;1;49990;CHIMENEA ELECTRICA KIOTO 2000W KTE-1101;CLIMATIZACION
15732642;;F;38;CHILENO;;X;"";"";91970;3;3;0;0;0;3;3;91970;ESTUFA CUARZO KIOTO 800W KTE-011A;CLIMATIZACION
5845680;;F;74;CHILENO;;Silencioso;OVALLE                        ;COQUIMBO;119990;1;1;0;0;0;1;1;119990;ESTUFA INFRAROJA TH-IR60;CLIMATIZACION
19726936;;F;25;CHILENO;;Z;N/D;N/D;291560;5;4;0;0;0;5;4;291560;ESTUFA ELECTRICA CUARZO KIOTO 1200W KTE 1033;CLIMATIZACION
24289276;Casado;F;30;COLOMBIANO;;Extranjero;PROVIDENCIA                   ;METROPOLITANA;15980;2;1;2;1;15980;0;0;0;ESTUFA CUARZO KIOTO 800W KTE-011A;CLIMATIZACION
18771533;;M;28;CHILENO;;Millenial;CHILLAN VIEJO;BIO-BIO;25990;1;1;1;1;25990;0;0;0;CALIENTACAMA KIOTO DIGITAL 2 PLAZAS KTC-1006;CLIMATIZACION
17305655;;F;32;CHILENO;;Millenial;SANTIAGO                      ;METROPOLITANA;89980;2;2;0;0;0;2;2;89980;TERMOVENTILADOR KIOTO BLANCO 2000W KTE-1028B;CLIMATIZACION
12846177;;F;47;CHILENO;;X;PROVIDENCIA                   ;METROPOLITANA;7990;1;1;1;1;7990;0;0;0;TERMOVENTILADOR KIOTO BLANCO 2000W KTE-1028B;CLIMATIZACION
16636685;Soltero;M;34;CHILENO;;Silencioso;PROVIDENCIA                   ;METROPOLITANA;9990;1;1;1;1;9990;0;0;0;ESTUFA CUARZO KIOTO 800W KTE-011A;CLIMATIZACION
6415036;;F;72;CHILENO;;Silencioso;PLACILLA                      ;L.G.B.OÂ´HIGGINS;1415310;19;14;0;0;0;19;14;1415310;ESTUFA CUARZO KIOTO 800W KTE-011A;CLIMATIZACION
11055326;;F;56;CHILENO;;Boomers;RENCA                         ;METROPOLITANA;29990;1;1;0;0;0;1;1;29990;CALIENTACAMA KIOTO DIGITAL 2 PLAZAS KTC-1006;CLIMATIZACION
26713566;;M;32;ECUATORIANO;;Extranjero;"";"";55130;3;3;0;0;0;3;3;55130;CHIMENEA ELECTRICA KIOTO 2000W KTE-1101;CLIMATIZACION
6933011;;F;73;CHILENO;;Silencioso;RENCA                         ;METROPOLITANA;29990;1;1;0;0;0;1;1;29990;CALEFACTOR CARBONO 800W EEC-3000 NEGRO;CLIMATIZACION
18420026;;F;28;CHILENO;;Millenial;TALCAHUANO;BIO-BIO;65220;4;2;0;0;0;4;2;65220;CALIENTACAMA KIOTO DIGITAL 2 PLAZAS KTC-1006;CLIMATIZACION
13502787;;M;43;CHILENO;;X;N/D;N/D;29980;2;1;0;0;0;2;1;29980;CALIENTACAMA KIOTO DIGITAL 1 PLAZA KTC-1005;CLIMATIZACION
18249056;;M;29;CHILENO;;Silencioso;PROVIDENCIA                   ;METROPOLITANA;23960;4;2;4;2;23960;0;0;0;TERMOVENTILADOR KIOTO BLANCO 2000W KTE-1028B;CLIMATIZACION
10250520;;F;56;CHILENO;;Boomers;PROVIDENCIA                   ;METROPOLITANA;49980;2;1;0;0;0;2;1;49980;CALIENTACAMA KIOTO DIGITAL 2 PLAZAS KTC-1006;CLIMATIZACION
17961415;;F;30;CHILENO;;Millenial;PROVIDENCIA                   ;METROPOLITANA;15980;2;1;2;1;15980;0;0;0;TERMOVENTILADOR KIOTO BLANCO 2000W KTE-1028B;CLIMATIZACION
15605986;Casado;F;38;CHILENO;;Millenial;PROVIDENCIA                   ;METROPOLITANA;25970;3;1;3;1;25970;0;0;0;CALIENTACAMA KIOTO ANALOGO 1 PLAZA KTC-1004;CLIMATIZACION
14218214;;M;41;CHILENO;;X;"";"";549960;4;2;0;0;0;4;2;549960;ESTUFA CUARZO KIOTO 800W KTE-011A;CLIMATIZACION
19277637;;F;26;CHILENO;;Z;N/D;N/D;10990;1;1;1;1;10990;0;0;0;CALIENTACAMA KIOTO ANALOGO 1 PLAZA KTC-1004;CLIMATIZACION
23320132;;F;24;ECUATORIANO;;Extranjero;PROVIDENCIA                   ;METROPOLITANA;31960;4;2;1;1;7990;3;1;23970;TERMOVENTILADOR KIOTO BLANCO 2000W KTE-1028B;CLIMATIZACION
17824518;;F;30;CHILENO;;Millenial;TALCA                         ;MAULE;20980;2;2;2;2;20980;0;0;0;ESTUFA CUARZO KIOTO 800W KTE-011A;CLIMATIZACION
17295566;;F;32;CHILENO;;Millenial;LA SERENA                     ;COQUIMBO;16980;2;1;0;0;0;2;1;16980;TERMOVENTILADOR KIOTO BLANCO 2000W KTE-1028B;CLIMATIZACION
19780743;;F;23;CHILENO;;Millenial;"";"";12980;2;1;2;1;12980;0;0;0;TERMOVENTILADOR KIOTO BLANCO 2000W KTE-1028B;CLIMATIZACION
16675953;Soltero;M;34;CHILENO;PROFESOR;Millenial;PROVIDENCIA                   ;METROPOLITANA;337480;2;1;2;1;337480;0;0;0;ESTUFA PARAFINA KPL-36;CLIMATIZACION
18434077;;M;28;CHILENO;;Millenial;"";"";398960;4;3;0;0;0;4;3;398960;TERMOVENTILADOR CALMA IPX1 T2000;CLIMATIZACION
12058095;;M;54;CHILENO;;X;VALLENAR;ATACAMA;722950;5;5;0;0;0;5;5;722950;ESTUFA CUARZO KIOTO 800W KTE-011A;CLIMATIZACION
12852847;;F;47;CHILENO;;X;PROVIDENCIA                   ;METROPOLITANA;6990;1;1;0;0;0;1;1;6990;ESTUFA CUARZO KIOTO 800W KTE-011A;CLIMATIZACION
16975948;;F;33;CHILENO;;Millenial;N/D;N/D;229980;2;2;0;0;0;2;2;229980;TERMOVENTILADOR CALMA PTC DIGITAL T3000;CLIMATIZACION
13147207;;F;45;CHILENO;;Silencioso;PROVIDENCIA                   ;METROPOLITANA;15990;1;1;0;0;0;1;1;15990;CALIENTACAMA KIOTO ANALOGO 1 PLAZA KTC-1004;CLIMATIZACION
17324364;;F;33;CHILENO;;Millenial;CALBUCO                       ;LOS LAGOS;19980;2;1;0;0;0;2;1;19980;TERMOVENTILADOR KIOTO BLANCO 2000W KTE-1028B;CLIMATIZACION
15277070;;F;48;CHILENO;;X;PUYEHUE                       ;LOS LAGOS;66970;3;2;0;0;0;3;2;66970;ESTUFA CUARZO KIOTO 800W KTE-011A;CLIMATIZACION
20353208;;F;22;CHILENO;;Z;NUEVA IMPERIAL                ;ARAUCANIA;1125094;13;8;0;0;0;13;8;1125094;CALIENTACAMA KIOTO DIGITAL 2 PLAZAS KTC-1006;CLIMATIZACION
11515886;;F;52;CHILENO;;X;RENCA                         ;METROPOLITANA;9990;1;1;1;1;9990;0;0;0;TERMOVENTILADOR KIOTO BLANCO 2000W KTE-1028B;CLIMATIZACION
9508832;;M;56;CHILENO;;Boomers;PROVIDENCIA                   ;METROPOLITANA;562800;6;4;4;2;461820;2;2;100980;TERMOVENTILADOR KIOTO NEGRO 2000W KTE-1028N;CLIMATIZACION
6176266;Viudo;F;73;CHILENO;AGROINDUSTRIA;Silencioso;RENCA                         ;METROPOLITANA;214690;3;2;0;0;0;3;2;214690;ESTUFA CALMA TORRE PTC FLAME PTC4000;CLIMATIZACION
18446879;;M;29;CHILENO;;Millenial;SAN ANTONIO                   ;VALPARAISO;9990;1;1;0;0;0;1;1;9990;TERMOVENTILADOR KIOTO NEGRO 2000W KTE-1028N;CLIMATIZACION
18409104;;M;28;CHILENO;;Millenial;LO ESPEJO                     ;METROPOLITANA;11980;2;1;2;1;11980;0;0;0;TERMOVENTILADOR KIOTO BLANCO 2000W KTE-1028B;CLIMATIZACION
14396005;;F;44;CHILENO;;X;PEDRO AGUIRRE CERDA           ;METROPOLITANA;8990;1;1;0;0;0;1;1;8990;ESTUFA CUARZO KIOTO 800W KTE-011A;CLIMATIZACION
6487598;;F;71;CHILENO;;Silencioso;BUIN                          ;METROPOLITANA;38980;2;2;0;0;0;2;2;38980;TERMOVENTILADOR KIOTO BLANCO 2000W KTE-1028B;CLIMATIZACION
15681598;Casado;F;39;CHILENO;TECNICO DE NIVEL SUPERIOR EN ODONTOLOGIA;X;VICTORIA                      ;ARAUCANIA;53970;3;1;0;0;0;3;1;53970;CALIENTACAMA KIOTO DIGITAL 1 PLAZA KTC-1005;CLIMATIZACION
6996386;;F;70;CHILENO;;Silencioso;PADRE HURTADO                 ;METROPOLITANA;519700;5;4;0;0;0;5;4;519700;ESTUFA FIAMMA PRO;CLIMATIZACION
17137851;;F;33;CHILENO;;Millenial;PROVIDENCIA                   ;METROPOLITANA;384950;6;2;6;2;384950;0;0;0;CALIENTACAMA KIOTO ANALOGO 1 PLAZA KTC-1004;CLIMATIZACION
10347919;;M;55;CHILENO;;Boomers;ARAUCO                        ;BIO BIO;43970;3;3;0;0;0;3;3;43970;TERMOVENTILADOR KIOTO NEGRO 2000W KTE-1028N;CLIMATIZACION
14107069;;M;41;CHILENO;;X;IQUIQUE                       ;TARAPACA;31980;2;2;0;0;0;2;2;31980;CALIENTACAMA KIOTO ANALOGO 1 PLAZA KTC-1004;CLIMATIZACION
19191321;Soltero;F;25;CHILENO;;Z;PROVIDENCIA                   ;METROPOLITANA;11980;2;1;2;1;11980;0;0;0;ESTUFA CUARZO KIOTO 800W KTE-011A;CLIMATIZACION
9613486;;F;63;CHILENO;;Boomers;COLINA                        ;METROPOLITANA;9990;1;1;0;0;0;1;1;9990;TERMOVENTILADOR KIOTO BLANCO 2000W KTE-1028B;CLIMATIZACION
16725867;;M;35;CHILENO;;Millenial;PENCAHUE                      ;MAULE;190970;3;2;0;0;0;3;2;190970;CALIENTACAMA KIOTO DIGITAL 2 PLAZAS KTC-1006;CLIMATIZACION
16030921;;F;37;CHILENO;;Millenial;N/D;N/D;57990;1;1;0;0;0;1;1;57990;CALIENTACAMAS MANUAL 2N SG-5121D4 2PL;CLIMATIZACION
22167207;;F;56;PERUANO;;Extranjero;PROVIDENCIA                   ;METROPOLITANA;15980;2;1;2;1;15980;0;0;0;TERMOVENTILADOR KIOTO BLANCO 2000W KTE-1028B;CLIMATIZACION
12956252;;M;46;CHILENO;;X;PROVIDENCIA                   ;METROPOLITANA;24970;3;1;3;1;24970;0;0;0;TERMOVENTILADOR KIOTO BLANCO 2000W KTE-1028B;CLIMATIZACION
18384563;;F;29;CHILENO;;Millenial;RENCA                         ;METROPOLITANA;19970;3;1;3;1;19970;0;0;0;ESTUFA CUARZO KIOTO 800W KTE-011A;CLIMATIZACION
20237919;;F;23;CHILENO;;Z;N/D;N/D;3054710;23;3;0;0;0;23;3;3054710;CALIENTACAMA KIOTO ANALOGO 1 PLAZA KTC-1004;CLIMATIZACION
5832765;;F;80;CHILENO;;Silencioso;LA FLORIDA                    ;METROPOLITANA;430420;7;4;0;0;0;7;4;430420;CALIENTACAMA KIOTO DIGITAL 1 PLAZA KTC-1005;CLIMATIZACION
13951887;;F;42;CHILENO;;Silencioso;PROVIDENCIA                   ;METROPOLITANA;154960;4;4;0;0;0;4;4;154960;ESTUFA ELECTRICA CUARZO KIOTO 1200W KTE 1033;CLIMATIZACION
17282004;Soltero;M;32;CHILENO;;Millenial;PROVIDENCIA                   ;METROPOLITANA;8990;1;1;0;0;0;1;1;8990;TERMOVENTILADOR KIOTO NEGRO 2000W KTE-1028N;CLIMATIZACION
8330740;;F;62;CHILENO;;Boomers;LO ESPEJO                     ;METROPOLITANA;100950;5;4;2;1;25980;3;3;74970;TERMOVENTILADOR KIOTO NEGRO 2000W KTE-1028N;CLIMATIZACION
17446503;;F;32;CHILENO;;Millenial;NUEVA IMPERIAL                ;ARAUCANIA;471920;8;6;0;0;0;8;6;471920;TERMOVENTILADOR KIOTO NEGRO 2000W KTE-1028N;CLIMATIZACION
17558579;;F;32;CHILENO;;Millenial;PAINE                         ;METROPOLITANA;20980;2;2;2;2;20980;0;0;0;TERMOVENTILADOR KIOTO BLANCO 2000W KTE-1028B;CLIMATIZACION
10623312;;F;54;CHILENO;;X;AISEN                         ;AYSEN;149990;1;1;0;0;0;1;1;149990;ESTUFA PARAFINA KPM-3300;CLIMATIZACION
15331221;;F;40;CHILENO;;X;PROVIDENCIA                   ;METROPOLITANA;9990;1;1;1;1;9990;0;0;0;TERMOVENTILADOR KIOTO NEGRO 2000W KTE-1028N;CLIMATIZACION
26310765;;F;26;HAITIANO;;Extranjero;SAN BERNARDO                  ;METROPOLITANA;8990;1;1;0;0;0;1;1;8990;TERMOVENTILADOR KIOTO BLANCO 2000W KTE-1028B;CLIMATIZACION
17754530;;F;32;CHILENO;;Millenial;PROVIDENCIA                   ;METROPOLITANA;15980;2;1;2;1;15980;0;0;0;ESTUFA CUARZO KIOTO 800W KTE-011A;CLIMATIZACION
20613890;;F;21;CHILENO;;Z;SAN MIGUEL;METROPOLITANA;85970;3;1;0;0;0;3;1;85970;CALIENTACAMA KIOTO DIGITAL 2 PLAZAS KTC-1006;CLIMATIZACION
6947201;;F;69;CHILENO;;Silencioso;SAN CARLOS                    ;BIO BIO;207360;3;2;0;0;0;3;2;207360;TERMOVENTILADOR KIOTO BLANCO 2000W KTE-1028B;CLIMATIZACION
11467805;;F;53;CHILENO;;X;PROVIDENCIA                   ;METROPOLITANA;2010700;22;19;0;0;0;22;19;2010700;TERMOVENTILADOR KIOTO NEGRO 2000W KTE-1028N;CLIMATIZACION
16375535;;F;35;CHILENO;;Millenial;PROVIDENCIA                   ;METROPOLITANA;45950;5;2;5;2;45950;0;0;0;ESTUFA ELECTRICA CUARZO KIOTO 1200W KTE 1033;CLIMATIZACION
13059992;;F;47;CHILENO;;X;RECOLETA                      ;METROPOLITANA;143630;6;5;4;4;97960;2;1;45670;ESTUFA A GAS CALMA 5 KG COMPAK;CLIMATIZACION
5537238;;F;74;CHILENO;;Silencioso;LOS ANGELES                   ;BIO BIO;260970;3;2;0;0;0;3;2;260970;CALIENTACAMA KIOTO DIGITAL 2 PLAZAS KTC-1006;CLIMATIZACION
17971237;Soltero;M;30;CHILENO;TECNOLOGO MEDICO;Millenial;SAN VICENTE                   ;L.G.B.OÂ´HIGGINS;12990;1;1;1;1;12990;0;0;0;CALIENTACAMA KIOTO ANALOGO 1 PLAZA KTC-1004;CLIMATIZACION
19430799;Soltero;M;25;CHILENO;;Z;CALERA DE TANGO;METROPOLITANA;177960;4;2;4;2;177960;0;0;0;ESTUFA FOGUITA PRO;CLIMATIZACION
7724958;;F;63;CHILENO;;Boomers;LOS ANGELES                   ;BIO BIO;98590;5;4;0;0;0;5;4;98590;ESTUFA ELECTRICA CUARZO KIOTO 1200W KTE 1033;CLIMATIZACION
7984680;;M;62;CHILENO;;Boomers;ARICA                         ;ARICA Y PARINACOTA;1043470;7;4;1;1;129990;6;3;913480;ESTUFA A GAS CALMA 5 KG COMPAK;CLIMATIZACION
11545146;;M;52;CHILENO;;X;CALBUCO                       ;LOS LAGOS;17980;2;1;0;0;0;2;1;17980;TERMOVENTILADOR KIOTO NEGRO 2000W KTE-1028N;CLIMATIZACION
15609001;;M;37;CHILENO;;Millenial;SAN BERNARDO                  ;METROPOLITANA;59990;1;1;0;0;0;1;1;59990;TERMOVENTILADOR CURVE TOWER;CLIMATIZACION
10127098;;F;57;CHILENO;;Boomers;RENCA                         ;METROPOLITANA;17990;1;1;0;0;0;1;1;17990;CALIENTACAMA KIOTO DIGITAL 1 PLAZA KTC-1005;CLIMATIZACION
15482793;;M;40;CHILENO;;X;PROVIDENCIA                   ;METROPOLITANA;29980;2;2;0;0;0;2;2;29980;CALIENTACAMA KIOTO ANALOGO 1 PLAZA KTC-1004;CLIMATIZACION
7289847;;F;70;CHILENO;;Silencioso;RENCA                         ;METROPOLITANA;55980;2;1;2;1;55980;0;0;0;CALIENTACAMA KIOTO DIGITAL 2 PLAZAS KTC-1006;CLIMATIZACION
17972977;Soltero;M;30;CHILENO;;Millenial;PROVIDENCIA                   ;METROPOLITANA;28360;3;1;0;0;0;3;1;28360;TERMOVENTILADOR KIOTO BLANCO 2000W KTE-1028B;CLIMATIZACION
15259736;;M;39;CHILENO;;X;PROVIDENCIA                   ;METROPOLITANA;8990;1;1;1;1;8990;0;0;0;TERMOVENTILADOR KIOTO NEGRO 2000W KTE-1028N;CLIMATIZACION
8078422;;F;57;CHILENO;;Boomers;SAN VICENTE                   ;L.G.B.OÂ´HIGGINS;103990;3;2;0;0;0;3;2;103990;TERMOVENTILADOR KIOTO NEGRO 2000W KTE-1028N;CLIMATIZACION
13055610;;M;46;CHILENO;;X;N/D;N/D;337960;4;4;0;0;0;4;4;337960;ESTUFA ELECTRICA CUARZO KIOTO 1200W KTE 1033;CLIMATIZACION
26082636;Soltero;F;37;VENEZOLANO;;Extranjero;SANTIAGO                      ;METROPOLITANA;0;0;2;0;2;0;0;0;0;TERMOVENTILADOR KIOTO NEGRO 2000W KTE-1028N;CLIMATIZACION
26297022;;M;31;HAITIANO;;Extranjero;HIJUELAS                      ;VALPARAISO;199450;4;3;0;0;0;4;3;199450;TERMOVENTILADOR CALMA IPX1 T2000;CLIMATIZACION
10334684;;F;58;CHILENO;;Boomers;PROVIDENCIA                   ;METROPOLITANA;89990;1;1;1;1;89990;0;0;0;ESTUFA INFRARROJA ELECTRICA KIOTO 1500W KTE-1045;CLIMATIZACION
15854635;;M;37;CHILENO;;Millenial;CANETE                        ;BIO BIO;8990;1;1;0;0;0;1;1;8990;TERMOVENTILADOR KIOTO BLANCO 2000W KTE-1028B;CLIMATIZACION
10610761;Soltero;M;54;CHILENO;DISENADOR GRAFICO;Silencioso;PROVIDENCIA                   ;METROPOLITANA;49940;6;2;6;2;49940;0;0;0;CALIENTACAMA KIOTO ANALOGO 1 PLAZA KTC-1004;CLIMATIZACION
18920247;;F;25;CHILENO;;Z;N/D;N/D;358930;7;4;0;0;0;7;4;358930;ESTUFA CUARZO KIOTO 800W KTE-011A;CLIMATIZACION
19268193;;F;26;CHILENO;;Z;SAN ESTEBAN                   ;VALPARAISO;495960;4;3;0;0;0;4;3;495960;ESTUFA ELECTRICA CUARZO KIOTO 1200W KTE 1033;CLIMATIZACION
26680571;;M;35;NO INFORMA NACIONALIDAD;;Extranjero;"";"";37970;3;2;3;2;37970;0;0;0;TERMOVENTILADOR KIOTO BLANCO 2000W KTE-1028B;CLIMATIZACION
20051070;;F;23;CHILENO;;Z;SANTIAGO;METROPOLITANA;25980;2;2;2;2;25980;0;0;0;TERMOVENTILADOR KIOTO BLANCO 2000W KTE-1028B;CLIMATIZACION
10282990;;M;52;CHILENO;;X;RENCA                         ;METROPOLITANA;8990;1;1;0;0;0;1;1;8990;TERMOVENTILADOR KIOTO BLANCO 2000W KTE-1028B;CLIMATIZACION
12545479;;F;49;CHILENO;;X;RENCA                         ;METROPOLITANA;20990;1;1;0;0;0;1;1;20990;ESTUFA ELECTRICA CUARZO KIOTO 1200W KTE 1033;CLIMATIZACION
19180747;Soltero;M;26;CHILENO;KINESIOLOGO;Z;PROVIDENCIA                   ;METROPOLITANA;22980;2;2;2;2;22980;0;0;0;ESTUFA ELECTRICA CUARZO KIOTO 1200W KTE 1033;CLIMATIZACION
18696989;;M;28;CHILENO;;Millenial;N/D;N/D;557440;5;4;2;3;61980;3;1;495460;CALIENTACAMAS MANUAL 2N SG-5121D4 2PL;CLIMATIZACION
15772415;;F;37;CHILENO;;Millenial;PROVIDENCIA                   ;METROPOLITANA;19980;2;1;0;0;0;2;1;19980;CALIENTACAMA KIOTO ANALOGO 1 PLAZA KTC-1004;CLIMATIZACION
19142577;;F;26;CHILENO;;Z;SAN ANTONIO;VALPARAISO;94970;3;2;3;2;94970;0;0;0;CHIMENEA ELECTRICA KIOTO 2000W KTE-1101;CLIMATIZACION
16898374;;M;33;CHILENO;;Millenial;TALCAHUANO                    ;BIO BIO;283970;3;2;3;2;283970;0;0;0;CALIENTACAMA KIOTO DIGITAL 2 PLAZAS KTC-1006;CLIMATIZACION
10570679;;M;54;CHILENO;;X;CALAMA                        ;ANTOFAGASTA;1612351;11;6;0;0;0;11;6;1612351;ESTUFA VITTALE-40 15K;CLIMATIZACION
14172231;Casado;F;41;CHILENO;;X;PANGUIPULLI                   ;LOS LAGOS;180300;10;9;0;0;0;10;9;180300;CHIMENEA ELECTRICA KIOTO 2000W KTE-1101;CLIMATIZACION
11889176;;M;51;CHILENO;;X;SAN VICENTE                   ;L.G.B.OÂ´HIGGINS;8990;1;1;0;0;0;1;1;8990;TERMOVENTILADOR KIOTO NEGRO 2000W KTE-1028N;CLIMATIZACION
19555975;;M;25;CHILENO;;Z;N/D;N/D;50713;2;1;0;0;0;2;1;50713;TERMOVENTILADOR CALMA IPX1 T2000;CLIMATIZACION
14017614;;F;40;CHILENO;;X;TALCA                         ;MAULE;215120;4;2;0;0;0;4;2;215120;ESTUFA INFRARROJA ELECTRICA KIOTO 1500W KTE-1045;CLIMATIZACION
16843249;;F;34;CHILENO;;Millenial;MAIPU                         ;METROPOLITANA;38223;3;1;0;0;0;3;1;38223;CALIENTACAMA KIOTO ANALOGO 1 PLAZA KTC-1004;CLIMATIZACION
11975413;;F;50;CHILENO;;X;CERRO NAVIA                   ;METROPOLITANA;8990;1;1;0;0;0;1;1;8990;ESTUFA CUARZO KIOTO 800W KTE-011A;CLIMATIZACION
6921280;;F;67;CHILENO;;Boomers;EL BOSQUE                     ;METROPOLITANA;70238;2;2;0;0;0;2;2;70238;CHIMENEA ELECTRICA KIOTO 2000W KTE-1101;CLIMATIZACION
14305906;;F;47;CHILENO;;X;SANTA CRUZ                    ;L.G.B.OÂ´HIGGINS;27990;1;1;0;0;0;1;1;27990;CALIENTACAMA KIOTO DIGITAL 2 PLAZAS KTC-1006;CLIMATIZACION
12464470;;M;48;CHILENO;;X;MAIPU                         ;METROPOLITANA;23980;2;1;0;0;0;2;1;23980;CALIENTACAMA KIOTO ANALOGO 1 PLAZA KTC-1004;CLIMATIZACION
5936654;;F;78;CHILENO;;Silencioso;LONGAVI                       ;MAULE;139990;1;1;0;0;0;1;1;139990;ESTUFA GAS EH2500 5K NEGRO;CLIMATIZACION
16198685;;F;36;CHILENO;;Millenial;N/D;N/D;29990;1;1;1;1;29990;0;0;0;CALIENTACAMA KIOTO DIGITAL 2 PLAZAS KTC-1006;CLIMATIZACION
16846559;;M;34;CHILENO;;Millenial;PROVIDENCIA                   ;METROPOLITANA;13980;2;1;2;1;13980;0;0;0;ESTUFA ELECTRICA CUARZO KIOTO 1200W KTE 1033;CLIMATIZACION
19586787;;F;25;CHILENO;;Z;QUINTA NORMAL;METROPOLITANA;57970;3;1;0;0;0;3;1;57970;CALIENTACAMA KIOTO DIGITAL 2 PLAZAS KTC-1006;CLIMATIZACION
15361947;;F;37;CHILENO;;Millenial;PROVIDENCIA                   ;METROPOLITANA;22990;1;1;1;1;22990;0;0;0;CALIENTACAMA KIOTO DIGITAL 1 PLAZA KTC-1005;CLIMATIZACION
12515275;;F;49;CHILENO;;X;RENCA                         ;METROPOLITANA;24990;1;3;1;1;8990;0;2;16000;TERMOVENTILADOR TH-FH30 BLANCO 1000W-2000W;CLIMATIZACION
14235872;;F;51;CHILENO;;X;N/D;N/D;822900;10;5;0;0;0;10;5;822900;ESTUFA ELECTRICA CUARZO KIOTO 1200W KTE 1033;CLIMATIZACION
16106242;;F;36;CHILENO;;Millenial;VALPARAISO                    ;VALPARAISO;9990;1;1;0;0;0;1;1;9990;TERMOVENTILADOR KIOTO NEGRO 2000W KTE-1028N;CLIMATIZACION
9288257;;M;58;CHILENO;;Boomers;RENCA                         ;METROPOLITANA;96980;2;2;0;0;0;2;2;96980;CALIENTACAMA KIOTO DIGITAL 2 PLAZAS KTC-1006;CLIMATIZACION
27039983;;M;35;VENEZOLANO;;Extranjero;PROVIDENCIA                   ;METROPOLITANA;187970;3;2;3;2;187970;0;0;0;TERMOVENTILADOR KIOTO BLANCO 2000W KTE-1028B;CLIMATIZACION
26917251;;M;38;EXTRANJERO - NO INFORMA NACIONALIDAD;;Extranjero;"";"";9990;1;1;1;1;9990;0;0;0;TERMOVENTILADOR KIOTO BLANCO 2000W KTE-1028B;CLIMATIZACION
7814529;;F;64;CHILENO;;Boomers;MELIPILLA                     ;METROPOLITANA;74960;4;3;0;0;0;4;3;74960;ESTUFA ELECTRICA CUARZO KIOTO 1200W KTE 1033;CLIMATIZACION
20186808;;M;23;CHILENO;;Z;N/D;N/D;387940;7;3;7;3;387940;0;0;0;ESTUFA CUARZO KIOTO 800W KTE-011A;CLIMATIZACION
16002079;Soltero;F;37;CHILENO;PSICOLOGO;Millenial;PROVIDENCIA                   ;METROPOLITANA;0;0;2;0;0;0;0;2;0;TERMOVENTILADOR KIOTO BLANCO 2000W KTE-1028B;CLIMATIZACION
19132774;Soltero;F;26;CHILENO;INGENIERO AGRICOLA;Z;COYHAIQUE;AYSEN;350950;5;4;4;3;337960;1;1;12990;CALIENTACAMA KIOTO DIGITAL 2 PLAZAS KTC-1006;CLIMATIZACION
13508863;Soltero;M;44;CHILENO;PROFESOR;X;RENCA                         ;METROPOLITANA;25980;2;2;2;2;25980;0;0;0;CALIENTACAMA KIOTO ANALOGO 1 PLAZA KTC-1004;CLIMATIZACION
19898562;;F;24;CHILENO;;Z;PROVIDENCIA                   ;METROPOLITANA;17990;1;1;0;0;0;1;1;17990;CALIENTACAMA KIOTO DIGITAL 1 PLAZA KTC-1005;CLIMATIZACION
15072989;;M;40;CHILENO;;Millenial;N/D;N/D;9990;1;1;0;0;0;1;1;9990;TERMOVENTILADOR KIOTO NEGRO 2000W KTE-1028N;CLIMATIZACION
9308897;;F;63;CHILENO;;Boomers;RIO NEGRO                     ;LOS LAGOS;1376900;15;9;0;0;0;15;9;1376900;ESTUFA ELECTRICA CUARZO KIOTO 1200W KTE 1033;CLIMATIZACION
19924811;;F;23;CHILENO;;Z;PROVIDENCIA                   ;METROPOLITANA;58980;2;1;2;1;58980;0;0;0;CHIMENEA ELECTRICA KIOTO 2000W KTE-1101;CLIMATIZACION
19656558;;F;37;CHILENO;;Millenial;PROVIDENCIA                   ;METROPOLITANA;9990;1;1;0;0;0;1;1;9990;TERMOVENTILADOR KIOTO BLANCO 2000W KTE-1028B;CLIMATIZACION
15470868;;F;40;CHILENO;;X;PROVIDENCIA                   ;METROPOLITANA;27990;1;1;1;1;27990;0;0;0;CALIENTACAMA KIOTO DIGITAL 2 PLAZAS KTC-1006;CLIMATIZACION
8699992;Divorciado;F;63;CHILENO;;Boomers;RENCA                         ;METROPOLITANA;23460;2;1;0;0;0;2;1;23460;ESTUFA ELECTRICA CUARZO KIOTO 1200W KTE 1033;CLIMATIZACION
24689446;;F;51;COLOMBIANO;;Extranjero;RECOLETA                      ;METROPOLITANA;7990;1;1;1;1;7990;0;0;0;TERMOVENTILADOR KIOTO BLANCO 2000W KTE-1028B;CLIMATIZACION
19068118;;M;27;CHILENO;;Z;PROVIDENCIA                   ;METROPOLITANA;9990;1;1;1;1;9990;0;0;0;ESTUFA ELECTRICA CUARZO KIOTO 1200W KTE 1033;CLIMATIZACION
19895610;;F;24;CHILENO;;Z;LINARES                       ;MAULE;39980;2;1;0;0;0;2;1;39980;CALIENTACAMA KIOTO DIGITAL 2 PLAZAS KTC-1006;CLIMATIZACION
24947522;;M;37;HAITIANO;;Extranjero;SAN BERNARDO                  ;METROPOLITANA;9990;1;1;0;0;0;1;1;9990;ESTUFA CUARZO KIOTO 800W KTE-011A;CLIMATIZACION
12606234;;M;47;CHILENO;;X;PROVIDENCIA                   ;METROPOLITANA;27990;1;1;1;1;27990;0;0;0;CALIENTACAMA KIOTO DIGITAL 2 PLAZAS KTC-1006;CLIMATIZACION
17316626;;M;32;CHILENO;;Millenial;RENCA;METROPOLITANA;169990;1;1;1;1;169990;0;0;0;ESTUFA A GAS UT GRX-6200 ET ROJA 15 KILOS;CLIMATIZACION
7676108;;F;67;CHILENO;;Boomers;PUERTO MONTT                  ;LOS LAGOS;29990;1;1;0;0;0;1;1;29990;CALIENTACAMA KIOTO DIGITAL 2 PLAZAS KTC-1006;CLIMATIZACION
17074475;;F;33;CHILENO;;Millenial;N/D;N/D;23980;2;1;2;1;23980;0;0;0;CALIENTACAMA KIOTO ANALOGO 1 PLAZA KTC-1004;CLIMATIZACION
18108957;;F;30;CHILENO;;Millenial;PROVIDENCIA                   ;METROPOLITANA;87980;2;1;2;1;87980;0;0;0;ESTUFA GAS EH2500 5K NEGRO;CLIMATIZACION
15767224;;M;37;CHILENO;;Millenial;HUASCO                        ;ATACAMA;9990;1;1;0;0;0;1;1;9990;TERMOVENTILADOR KIOTO NEGRO 2000W KTE-1028N;CLIMATIZACION
17590560;;F;31;CHILENO;;Millenial;PROVIDENCIA                   ;METROPOLITANA;386940;6;3;6;3;386940;0;0;0;TERMOVENTILADOR KIOTO NEGRO 2000W KTE-1028N;CLIMATIZACION
9783898;;F;59;CHILENO;;Boomers;PROVIDENCIA                   ;METROPOLITANA;86970;3;3;0;0;0;3;3;86970;TERMOVENTILADOR KIOTO NEGRO 2000W KTE-1028N;CLIMATIZACION
11662488;;M;52;CHILENO;;X;N/D;N/D;129990;1;1;0;0;0;1;1;129990;ESTUFA PARAFINA KPM-3300;CLIMATIZACION
17260412;;F;33;CHILENO;;Millenial;NUEVA IMPERIAL                ;ARAUCANIA;28460;2;1;0;0;0;2;1;28460;ESTUFA ELECTRICA CUARZO KIOTO 1200W KTE 1033;CLIMATIZACION
11317598;;M;54;CHILENO;;X;LA GRANJA                     ;METROPOLITANA;483970;3;2;2;1;343980;1;1;139990;ESTUFA PARAFINA KPL-36;CLIMATIZACION
12390896;;F;49;CHILENO;;X;ANCUD                         ;LOS LAGOS;19980;2;1;0;0;0;2;1;19980;TERMOVENTILADOR KIOTO BLANCO 2000W KTE-1028B;CLIMATIZACION
18836304;;F;27;CHILENO;;Millenial;PUDAHUEL                      ;METROPOLITANA;35970;3;1;0;0;0;3;1;35970;CALIENTACAMA KIOTO DIGITAL 1 PLAZA KTC-1005;CLIMATIZACION
16843260;;F;34;CHILENO;;Millenial;PALMILLA                      ;L.G.B.OÂ´HIGGINS;451940;6;3;3;1;49970;3;2;401970;CALIENTACAMA KIOTO DIGITAL 2 PLAZAS KTC-1006;CLIMATIZACION
13928318;;M;42;CHILENO;;X;PROVIDENCIA                   ;METROPOLITANA;54980;2;2;0;0;0;2;2;54980;CALIENTACAMA KIOTO DIGITAL 2 PLAZAS KTC-1006;CLIMATIZACION
11156834;;F;55;CHILENO;;Boomers;LEBU                          ;BIO BIO;177203;4;3;0;0;0;4;3;177203;ESTUFA ELECTRICA CUARZO KIOTO 1200W KTE 1033;CLIMATIZACION
13329311;;F;44;CHILENO;;X;RENCA                         ;METROPOLITANA;17980;2;1;0;0;0;2;1;17980;TERMOVENTILADOR KIOTO NEGRO 2000W KTE-1028N;CLIMATIZACION
8943292;;F;62;CHILENO;;Boomers;PROVIDENCIA                   ;METROPOLITANA;8990;1;1;0;0;0;1;1;8990;ESTUFA CUARZO KIOTO 800W KTE-011A;CLIMATIZACION
17243310;;M;33;CHILENO;;Millenial;PROVIDENCIA                   ;METROPOLITANA;19990;1;1;1;1;19990;0;0;0;CALIENTACAMA KIOTO DIGITAL 1 PLAZA KTC-1005;CLIMATIZACION
12881180;;F;46;CHILENO;;X;SAN BERNARDO                  ;METROPOLITANA;472950;5;3;2;1;201980;3;2;270970;ESTUFA FIAMMA PRO;CLIMATIZACION
13569313;;M;43;CHILENO;;X;N/D;N/D;132980;2;2;0;0;0;2;2;132980;ESTUFA GAS KG5 5K NEGRO EUROPEA;CLIMATIZACION
8774692;;F;62;CHILENO;;Boomers;MELIPILLA                     ;METROPOLITANA;47990;1;1;0;0;0;1;1;47990;ESTUFA FIBRA DE CARBONO KFC 90 - NEGRA ROJA;CLIMATIZACION
12048125;;M;54;CHILENO;;X;PROVIDENCIA                   ;METROPOLITANA;183980;2;1;2;1;183980;0;0;0;ESTUFA POTENZA;CLIMATIZACION
13701266;;F;43;CHILENO;;X;PROVIDENCIA                   ;METROPOLITANA;9990;1;1;0;0;0;1;1;9990;TERMOVENTILADOR KIOTO NEGRO 2000W KTE-1028N;CLIMATIZACION
4242854;;F;83;CHILENO;;Silencioso;RENCA                         ;METROPOLITANA;179990;1;1;0;0;0;1;1;179990;ESTUFA A GAS UT GRX-4200 15 KILOS;CLIMATIZACION
4507305;;M;76;CHILENO;;Silencioso;RENCA                         ;METROPOLITANA;59980;2;1;2;1;59980;0;0;0;CALIENTACAMA KIOTO DIGITAL 2 PLAZAS KTC-1006;CLIMATIZACION
18574256;Soltero;M;28;CHILENO;;Millenial;CONSTITUCION                  ;MAULE;453410;5;2;0;0;0;5;2;453410;TERMOVENTILADOR KIOTO BLANCO 2000W KTE-1028B;CLIMATIZACION
15149745;Soltero;F;39;CHILENO;;X;RENCA                         ;METROPOLITANA;426950;5;3;0;0;0;5;3;426950;ESTUFA VITTALE-40 15K;CLIMATIZACION
15766498;;M;37;CHILENO;;Millenial;VINA DEL MAR                  ;VALPARAISO;59990;1;1;0;0;0;1;1;59990;ESTUFA ELECTRICA CUARZO KC 220 ROJA;CLIMATIZACION
17950031;;M;37;CHILENO;;Millenial;N/D;N/D;168940;6;2;0;0;0;6;2;168940;CALIENTACAMA KIOTO ANALOGO 1 PLAZA KTC-1004;CLIMATIZACION
12728650;;F;46;CHILENO;;X;PROVIDENCIA                   ;METROPOLITANA;54990;1;1;0;0;0;1;1;54990;CHIMENEA ELECTRICA KIOTO 2000W KTE-1101;CLIMATIZACION
15177743;;F;39;CHILENO;;X;N/D;N/D;59990;1;1;0;0;0;1;1;59990;ESTUFA ELECTRICA CUARZO KC 220 ROJA;CLIMATIZACION
14026662;Casado;M;41;CHILENO;INGENIERO CIVIL INDUSTRIAL;X;PROVIDENCIA                   ;METROPOLITANA;9990;1;1;1;1;9990;0;0;0;TERMOVENTILADOR KIOTO NEGRO 2000W KTE-1028N;CLIMATIZACION
9643562;;M;58;CHILENO;;Boomers;DALCAHUE                      ;LOS LAGOS;478950;6;5;0;0;0;6;5;478950;TERMOVENTILADOR KIOTO BLANCO 2000W KTE-1028B;CLIMATIZACION
12666087;;F;48;CHILENO;;X;RENCA                         ;METROPOLITANA;33970;3;1;3;1;33970;0;0;0;CALIENTACAMA KIOTO ANALOGO 1 PLAZA KTC-1004;CLIMATIZACION
19270395;;F;25;CHILENO;;Z;PROVIDENCIA                   ;METROPOLITANA;39980;2;2;0;0;0;2;2;39980;ESTUFA CUARZO KIOTO 800W KTE-011A;CLIMATIZACION
13150940;;F;45;CHILENO;;X;LOLOL                         ;L.G.B.OÂ´HIGGINS;841780;9;6;0;0;0;9;6;841780;ESTUFA KEROSENE 720+;CLIMATIZACION
14379625;;M;45;CHILENO;;X;RENCA                         ;METROPOLITANA;44990;1;1;0;0;0;1;1;44990;TERMOVENTILADOR CERAMICO HTC 2013 OSCILANTE;CLIMATIZACION
20325253;;F;22;CHILENO;;Z;PROVIDENCIA                   ;METROPOLITANA;8990;1;1;1;1;8990;0;0;0;ESTUFA CUARZO KIOTO 800W KTE-011A;CLIMATIZACION
8469979;;F;64;CHILENO;;Boomers;SAN BERNARDO                  ;METROPOLITANA;302960;4;2;0;0;0;4;2;302960;ESTUFA CUARZO KIOTO 800W KTE-011A;CLIMATIZACION
14294300;;F;48;CHILENO;;X;CHILLAN                       ;BIO BIO;279950;5;3;4;2;264960;1;1;14990;TERMOVENTILADOR NICROM VFH300 BL 1800W;CLIMATIZACION
19346895;Soltero;M;25;CHILENO;;Z;PROVIDENCIA                   ;METROPOLITANA;9990;1;1;1;1;9990;0;0;0;TERMOVENTILADOR KIOTO NEGRO 2000W KTE-1028N;CLIMATIZACION
19272837;;F;26;CHILENO;;Z;CANETE                        ;BIO BIO;67970;3;2;0;0;0;3;2;67970;TERMOVENTILADOR KIOTO NEGRO 2000W KTE-1028N;CLIMATIZACION
19575288;;M;25;CHILENO;;Silencioso;PROVIDENCIA                   ;METROPOLITANA;29990;1;1;1;1;29990;0;0;0;CALIENTACAMA KIOTO DIGITAL 2 PLAZAS KTC-1006;CLIMATIZACION
19097357;;F;27;CHILENO;;Z;CAUQUENES                     ;MAULE;9990;1;1;0;0;0;1;1;9990;TERMOVENTILADOR KIOTO NEGRO 2000W KTE-1028N;CLIMATIZACION
17498411;;M;31;CHILENO;;Millenial;SAN JAVIER                    ;MAULE;236960;4;3;0;0;0;4;3;236960;CALIENTACAMAS MANUAL 3N SG-5011 2PL;CLIMATIZACION
10868333;;F;56;CHILENO;;Boomers;PELARCO                       ;MAULE;34980;2;1;0;0;0;2;1;34980;MINI OLEOELECTRICA KIOTO 500W NEGRO KTE-1081N;CLIMATIZACION
12360255;;F;48;CHILENO;;X;PARRAL                        ;MAULE;346952;5;4;0;0;0;5;4;346952;CALEFACTOR CUARZO 1600W EEH-1300 NEGRO;CLIMATIZACION
19887772;;F;24;CHILENO;;Z;RINCONADA;VALPARAISO;19990;1;1;0;0;0;1;1;19990;ESTUFA ELECTRICA CUARZO KIOTO 1200W KTE 1033;CLIMATIZACION
17037667;;M;34;CHILENO;;Millenial;CALBUCO                       ;LOS LAGOS;19990;1;1;0;0;0;1;1;19990;ESTUFA ELECTRICA CUARZO KIOTO 1200W KTE 1033;CLIMATIZACION
15408561;;F;39;CHILENO;;X;PROVIDENCIA                   ;METROPOLITANA;8990;1;1;0;0;0;1;1;8990;TERMOVENTILADOR KIOTO NEGRO 2000W KTE-1028N;CLIMATIZACION
17594633;;F;32;CHILENO;;Millenial;PROVIDENCIA                   ;METROPOLITANA;54990;1;1;0;0;0;1;1;54990;CHIMENEA ELECTRICA KIOTO 2000W KTE-1101;CLIMATIZACION
12071203;;M;48;CHILENO;;X;N/D;N/D;79990;1;1;0;0;0;1;1;79990;ESTUFA INFRARROJA ELECTRICA KIOTO 1500W KTE-1045;CLIMATIZACION
16599151;Soltero;M;35;CHILENO;CONTADOR GENERAL;Silencioso;PROVIDENCIA                   ;METROPOLITANA;39960;4;3;4;3;39960;0;0;0;TERMOVENTILADOR KIOTO NEGRO 2000W KTE-1028N;CLIMATIZACION
9992085;;M;56;CHILENO;;Boomers;PROVIDENCIA                   ;METROPOLITANA;9990;1;1;0;0;0;1;1;9990;ESTUFA CUARZO KIOTO 800W KTE-011A;CLIMATIZACION
17647915;;M;31;CHILENO;;Millenial;CURANILAHUE                   ;BIO BIO;189980;2;2;0;0;0;2;2;189980;ESTUFA KEROSENE F 1120+;CLIMATIZACION
16295297;;M;36;CHILENO;;Millenial;PROVIDENCIA                   ;METROPOLITANA;35970;3;3;0;0;0;3;3;35970;TERMOVENTILADOR KIOTO NEGRO 2000W KTE-1028N;CLIMATIZACION
4873455;;M;76;CHILENO;;Silencioso;CAUQUENES                     ;MAULE;29990;1;1;0;0;0;1;1;29990;CALIENTACAMA KIOTO DIGITAL 2 PLAZAS KTC-1006;CLIMATIZACION
17572388;;M;31;CHILENO;;Millenial;LOS ANGELES                   ;BIO BIO;153980;2;1;2;1;153980;0;0;0;ESTUFA PARAFINA KPM-23;CLIMATIZACION
20148231;;F;22;CHILENO;;Z;PROVIDENCIA                   ;METROPOLITANA;448100;4;3;1;1;279990;3;2;168110;ESTUFA ELECTRICA CUARZO KIOTO 1200W KTE 1033;CLIMATIZACION
4820900;;M;79;CHILENO;;Silencioso;PROVIDENCIA                   ;METROPOLITANA;9990;1;1;0;0;0;1;1;9990;ESTUFA CUARZO KIOTO 800W KTE-011A;CLIMATIZACION
18512453;Soltero;F;29;CHILENO;ADMINISTRADOR GASTRONOMICO;Millenial;PROVIDENCIA                   ;METROPOLITANA;19980;2;1;0;0;0;2;1;19980;TERMOVENTILADOR KIOTO NEGRO 2000W KTE-1028N;CLIMATIZACION
18136542;;F;29;CHILENO;;Millenial;LOS ANDES                     ;VALPARAISO;354970;3;2;2;1;334980;1;1;19990;ESTUFA ELECTRICA CUARZO KIOTO 1200W KTE 1033;CLIMATIZACION
7134124;Casado;F;67;CHILENO;;Boomers;PELLUHUE                      ;MAULE;21000;2;1;0;0;0;2;1;21000;ESTUFA ELECTRICA CUARZO KIOTO 1200W KTE 1033;CLIMATIZACION
12328851;;M;49;CHILENO;;X;PROVIDENCIA                   ;METROPOLITANA;21990;1;1;0;0;0;1;1;21990;ESTUFA ELECTRICA CUARZO KIOTO 1200W KTE 1033;CLIMATIZACION
18221132;;F;30;CHILENO;;Millenial;"";"";51970;3;1;3;1;51970;0;0;0;CALIENTACAMA KIOTO DIGITAL 2 PLAZAS KTC-1006;CLIMATIZACION
6120880;;M;73;CHILENO;;Silencioso;QUILLOTA                      ;VALPARAISO;748940;6;3;0;0;0;6;3;748940;TURBO CALEFACTOR VERT. TC-2100V BLANCO;CLIMATIZACION
13864002;;M;42;CHILENO;;X;N/D;N/D;26990;1;1;0;0;0;1;1;26990;CALEFACTOR CARBONO 800W EEC-3000 NEGRO;CLIMATIZACION
9090368;;M;61;CHILENO;;Boomers;LA PINTANA                    ;METROPOLITANA;508950;5;4;0;0;0;5;4;508950;ESTUFA A GAS UT GRX-6200 ET ROJA 15 KILOS;CLIMATIZACION
15808471;;F;38;CHILENO;;Millenial;RENCA                         ;METROPOLITANA;14990;1;1;0;0;0;1;1;14990;CALIENTACAMA KIOTO ANALOGO 1 PLAZA KTC-1004;CLIMATIZACION
6897061;;F;70;CHILENO;;Silencioso;CERRO NAVIA                   ;METROPOLITANA;44990;1;1;0;0;0;1;1;44990;CALIENTACAMAS MANUAL 2N SG-5120D4 1PL;CLIMATIZACION
9062575;Casado;M;58;CHILENO;;Boomers;RENCA                         ;METROPOLITANA;8990;1;1;0;0;0;1;1;8990;ESTUFA CUARZO KIOTO 800W KTE-011A;CLIMATIZACION
6016772;;M;72;CHILENO;;Silencioso;PROVIDENCIA                   ;METROPOLITANA;299971;4;3;0;0;0;4;3;299971;VITTALE 8;CLIMATIZACION
8150964;Casado;F;65;CHILENO;;Boomers;RENCA                         ;METROPOLITANA;20990;1;1;0;0;0;1;1;20990;ESTUFA ELECTRICA CUARZO KIOTO 1200W KTE 1033;CLIMATIZACION
8891666;Casado;M;59;CHILENO;ASISTENTE SOCIAL;Boomers;RENCA                         ;METROPOLITANA;41280;3;2;0;0;0;3;2;41280;TERMOVENTILADOR KIOTO BLANCO 2000W KTE-1028B;CLIMATIZACION
11983744;Casado;F;49;CHILENO;;X;CONSTITUCION                  ;MAULE;282960;4;3;0;0;0;4;3;282960;CALIENTACAMA KIOTO DIGITAL 2 PLAZAS KTC-1006;CLIMATIZACION
8569093;;F;64;CHILENO;;Boomers;TEMUCO                        ;ARAUCANIA;34990;1;1;0;0;0;1;1;34990;CALIENTACAMAS ANALOGO BASICO 1PL;CLIMATIZACION
17096449;;F;33;CHILENO;;Millenial;N/D;N/D;108630;3;2;2;1;98640;1;1;9990;ESTUFA ELECTRICA CUARZO KIOTO 1200W KTE 1033;CLIMATIZACION
17612241;;F;31;CHILENO;;Millenial;PUENTE ALTO                   ;METROPOLITANA;0;0;2;0;0;0;0;2;0;CONVECTOR TH-CV51 BL 750W - 1250W - 2000W;CLIMATIZACION
18836459;Soltero;F;28;CHILENO;;Millenial;PROVIDENCIA                   ;METROPOLITANA;10240;2;1;0;0;0;2;1;10240;TERMOVENTILADOR KIOTO BLANCO 2000W KTE-1028B;CLIMATIZACION
19300052;;F;25;CHILENO;;Z;N/D;N/D;28970;3;2;3;2;28970;0;0;0;TERMOVENTILADOR KIOTO NEGRO 2000W KTE-1028N;CLIMATIZACION
6949709;;F;67;CHILENO;;Boomers;ISLA DE MAIPO                 ;METROPOLITANA;57990;1;1;0;0;0;1;1;57990;CALIENTACAMAS MANUAL 2N SG-5121D4 2PL;CLIMATIZACION
17194222;;M;33;CHILENO;;Millenial;COPIAPO                       ;ATACAMA;161162;4;2;0;0;0;4;2;161162;CHIMENEA ELECTRICA KIOTO 2000W KTE-1101;CLIMATIZACION
17561207;;M;32;CHILENO;;Millenial;PROVIDENCIA                   ;METROPOLITANA;18990;1;1;0;0;0;1;1;18990;CALEFACTOR HALOGENO 1200W EEH-1210 GRIS;CLIMATIZACION
7155969;;F;68;CHILENO;;Boomers;PUDAHUEL                      ;METROPOLITANA;19990;1;1;0;0;0;1;1;19990;CALIENTACAMA KIOTO DIGITAL 1 PLAZA KTC-1005;CLIMATIZACION
12195158;;M;49;CHILENO;;X;PROVIDENCIA                   ;METROPOLITANA;12990;1;1;1;1;12990;0;0;0;ESTUFA CUARZO KIOTO 800W KTE-011A;CLIMATIZACION
6247405;;M;71;CHILENO;;Silencioso;HUECHURABA                    ;METROPOLITANA;192980;2;2;0;0;0;2;2;192980;ESTUFA FOGUITA PRO;CLIMATIZACION
13138574;;F;49;CHILENO;;X;PUDAHUEL                      ;METROPOLITANA;44990;1;1;0;0;0;1;1;44990;TERMOVENTILADOR CERAMICO HTC 2013 OSCILANTE;CLIMATIZACION
11313166;;F;54;CHILENO;;X;LOS ANDES                     ;VALPARAISO;665940;6;5;0;0;0;6;5;665940;ESTUFA CUARZO KIOTO 800W KTE-011A;CLIMATIZACION
11175774;;F;54;CHILENO;;Boomers;RENCA                         ;METROPOLITANA;14990;1;1;0;0;0;1;1;14990;CALIENTACAMA KIOTO ANALOGO 1 PLAZA KTC-1004;CLIMATIZACION
14283667;Casado;F;48;CHILENO;;X;CAUQUENES                     ;MAULE;10990;1;1;0;0;0;1;1;10990;TERMOVENTILADOR KIOTO NEGRO 2000W KTE-1028N;CLIMATIZACION
11244745;;F;54;CHILENO;;X;CURANILAHUE                   ;BIO BIO;918880;10;5;6;2;495670;4;3;423210;CHIMENEA ELECTRICA KIOTO 2000W KTE-1101;CLIMATIZACION
16046972;;F;37;CHILENO;;Millenial;VALDIVIA;LOS LAGOS;29980;2;1;2;1;29980;0;0;0;TERMOVENTILADOR CERAMICO TH-CH40;CLIMATIZACION
10016300;Casado;M;56;CHILENO;;Boomers;RENCA                         ;METROPOLITANA;9990;1;1;0;0;0;1;1;9990;TERMOVENTILADOR KIOTO BLANCO 2000W KTE-1028B;CLIMATIZACION
18963589;;M;27;CHILENO;;Extranjero;OSORNO                        ;LOS LAGOS;19980;2;1;0;0;0;2;1;19980;TERMOVENTILADOR KIOTO NEGRO 2000W KTE-1028N;CLIMATIZACION
11571751;;M;52;CHILENO;;X;RENCA                         ;METROPOLITANA;62990;1;1;0;0;0;1;1;62990;CALIENTACAMAS ANALOGO BASICO 2 PL;CLIMATIZACION
11697657;;F;50;CHILENO;;X;MELIPILLA                     ;METROPOLITANA;21990;1;1;0;0;0;1;1;21990;Termoventilador Ht 2014 R;CLIMATIZACION
12688821;;M;47;CHILENO;;X;RAUCO                         ;MAULE;227380;6;3;0;0;0;6;3;227380;ESTUFA ELECTRICA CUARZO KIOTO 1200W KTE 1033;CLIMATIZACION
16289974;;M;36;CHILENO;;Millenial;MOLINA                        ;MAULE;19990;1;1;0;0;0;1;1;19990;ESTUFA ELECTRICA CUARZO KIOTO 1200W KTE 1033;CLIMATIZACION
16532571;Soltero;F;35;CHILENO;MEDICO CIRUJANO;Millenial;RENCA                         ;METROPOLITANA;117980;2;1;2;1;117980;0;0;0;ESTUFA FOGUITA PRO;CLIMATIZACION
9076720;;F;59;CHILENO;;Boomers;ANCUD                         ;LOS LAGOS;44970;3;2;0;0;0;3;2;44970;TERMOVENTILADOR KIOTO BLANCO 2000W KTE-1028B;CLIMATIZACION
13249827;;F;45;CHILENO;;X;"";"";149990;1;3;1;1;149990;0;2;0;ESTUFA PARAFINA KPM-23;CLIMATIZACION
17850881;;F;31;CHILENO;;Millenial;N/D;N/D;8990;1;1;0;0;0;1;1;8990;TERMOVENTILADOR KIOTO NEGRO 2000W KTE-1028N;CLIMATIZACION
20139199;;F;23;CHILENO;;Silencioso;PROVIDENCIA                   ;METROPOLITANA;183980;2;1;2;1;183980;0;0;0;ESTUFA VITTALE-40 15K;CLIMATIZACION
5959261;;M;74;CHILENO;;Silencioso;COIHAIQUE                     ;AYSEN;130970;3;1;0;0;0;3;1;130970;CALIENTACAMAS MANUAL 2N SG-5121D4 2PL;CLIMATIZACION
15520975;;M;39;CHILENO;;Millenial;"";"";165970;3;2;0;0;0;3;2;165970;ESTUFA GAS KG5 5K NEGRO EUROPEA;CLIMATIZACION
19896552;;M;23;CHILENO;;Z;LINARES                       ;MAULE;184970;3;3;0;0;0;3;3;184970;CALEFACTOR CARBONO EEC-6000NW;CLIMATIZACION
18362930;Soltero;F;28;CHILENO;TECNICO DE NIVEL SUPERIOR EN ENFERMERIA;Millenial;CHILLAN VIEJO                 ;NUBLE;9990;1;1;0;0;0;1;1;9990;TERMOVENTILADOR KIOTO BLANCO 2000W KTE-1028B;CLIMATIZACION
14103663;;F;41;CHILENO;;Silencioso;PROVIDENCIA                   ;METROPOLITANA;69990;1;1;0;0;0;1;1;69990;CALEFACTOR CARBONO EEC-6000NW;CLIMATIZACION
13311311;;M;45;CHILENO;;X;CORONEL                       ;BIO BIO;474780;12;3;0;0;0;12;3;474780;ESTUFA ELEC. FIBRA DE CARBONO NSB120K5 SILVER;CLIMATIZACION
26547466;;M;48;EXTRANJERO - NO INFORMA NACIONALIDAD;;Extranjero;"";"";76970;3;2;2;1;23980;1;1;52990;TERMOVENTILADOR TH-FH30 BLANCO 1000W-2000W;CLIMATIZACION
20151244;;F;22;CHILENO;;Millenial;N/D;N/D;34990;1;1;0;0;0;1;1;34990;CALIENTACAMAS MANUAL 3N SG-5010 1PL;CLIMATIZACION
20028067;;F;23;CHILENO;;Z;PROVIDENCIA                   ;METROPOLITANA;12990;1;1;0;0;0;1;1;12990;CALIENTACAMA KIOTO ANALOGO 1 PLAZA KTC-1004;CLIMATIZACION
12481157;;M;49;CHILENO;;X;RINCONADA                     ;VALPARAISO;69990;1;1;0;0;0;1;1;69990;CHIMENEA ELECTRICA KIOTO 2000W KTE-1101;CLIMATIZACION
17427320;;F;32;CHILENO;;Millenial;RENCA                         ;METROPOLITANA;19990;1;1;0;0;0;1;1;19990;TURBO CALEFACTOR VERT. TC-2100V BLANCO;CLIMATIZACION
12596207;Soltero;M;48;CHILENO;;X;RENCA                         ;METROPOLITANA;46980;2;1;0;0;0;2;1;46980;TERMOVENTILADOR TH-FH30 BLANCO 1000W-2000W;CLIMATIZACION
8678915;;F;61;CHILENO;;Boomers;BUIN                          ;METROPOLITANA;179990;1;1;0;0;0;1;1;179990;ESTUFA A GAS UT GRX-4200 15 KILOS;CLIMATIZACION
11312249;;F;53;CHILENO;;X;SAN CLEMENTE                  ;MAULE;12990;1;1;0;0;0;1;1;12990;CALIENTACAMA KIOTO ANALOGO 1 PLAZA KTC-1004;CLIMATIZACION
26731189;;F;52;CHILENO;;Extranjero;TALCA                         ;MAULE;35980;2;1;2;1;35980;0;0;0;TERMOVENTILADOR CERAMICO TH-CH40;CLIMATIZACION
15162692;;F;40;CHILENO;;X;CHILLAN                       ;BIO BIO;51980;2;2;1;1;16990;1;1;34990;CALIENTACAMA KIOTO DIGITAL 1 PLAZA KTC-1005;CLIMATIZACION
10112898;;F;59;CHILENO;;Boomers;CHILLAN                       ;BIO BIO;69990;1;1;0;0;0;1;1;69990;CHIMENEA ELECTRICA KIOTO 2000W KTE-1101;CLIMATIZACION
8630245;;M;61;CHILENO;;Silencioso;PROVIDENCIA                   ;METROPOLITANA;266540;6;2;0;0;0;6;2;266540;ESTUFA INFRARROJA ELECTRICA KIOTO 1500W KTE-1045;CLIMATIZACION
17819665;Soltero;F;31;CHILENO;ENFERMERA;Millenial;PROVIDENCIA                   ;METROPOLITANA;128980;2;1;2;1;128980;0;0;0;ESTUFA ELEC. CHIMENEA TH-FP75 NG 1000W-2000W;CLIMATIZACION
18560177;Soltero;F;28;CHILENO;PSICOLOGO;Millenial;PROVIDENCIA                   ;METROPOLITANA;142970;3;2;0;0;0;3;2;142970;CHIMENEA ELECTRICA KIOTO 2000W KTE-1101;CLIMATIZACION
20010080;;M;23;CHILENO;;Z;DALCAHUE                      ;LOS LAGOS;114980;2;2;0;0;0;2;2;114980;CALEFACTOR CARBONO EEC-6000NW;CLIMATIZACION
4579110;;F;83;CHILENO;;Silencioso;SAN ANTONIO                   ;VALPARAISO;296290;5;2;0;0;0;5;2;296290;CALIENTACAMAS MANUAL 3N SG-5011 2PL;CLIMATIZACION
10472446;;F;58;CHILENO;;Boomers;"";"";133301;4;2;0;0;0;4;2;133301;CHIMENEA ELECTRICA KIOTO 2000W KTE-1101;CLIMATIZACION
16876904;;F;34;CHILENO;;Millenial;PROVIDENCIA                   ;METROPOLITANA;29990;1;1;0;0;0;1;1;29990;VENTILADOR PEDESTAL KTP-1015;CLIMATIZACION
15569619;;M;39;CHILENO;;X;PROVIDENCIA                   ;METROPOLITANA;36980;2;2;0;0;0;2;2;36980;Ventilador Sobremesa Plastico KF 12D;CLIMATIZACION
9467636;Casado;F;59;CHILENO;AUXILIAR DE ENFERMERIA;Boomers;VALLENAR;ATACAMA;33000;2;1;0;0;0;2;1;33000;V-VENTILADOR PISO/MESA 12 C/CONTROL Y TIMER;CLIMATIZACION
18505461;;F;29;CHILENO;;Millenial;N/D;N/D;24990;1;1;0;0;0;1;1;24990;VENTILADOR PEDESTAL KTP-1015;CLIMATIZACION
3578989;;M;84;CHILENO;;Silencioso;VALLENAR;ATACAMA;69990;1;1;0;0;0;1;1;69990;VENTILADOR PEDESTAL16 PLG MODELO CPE 160 3 EN 1;CLIMATIZACION
12951374;;F;45;CHILENO;;X;CALERA                        ;VALPARAISO;318050;4;3;0;0;0;4;3;318050;VENTILADOR PEDESTAL KTP-1015;CLIMATIZACION
16450923;;F;35;CHILENO;;Millenial;VALLENAR;ATACAMA;383970;3;2;0;0;0;3;2;383970;ENFRIADOR Y HUMIFICADOR THOMAS Blanco/Negro;CLIMATIZACION
18657492;;M;27;CHILENO;;Millenial;LINARES                       ;MAULE;245650;4;2;0;0;0;4;2;245650;VENTILADOR PEDESTAL KTP-1015;CLIMATIZACION
9767560;;F;59;CHILENO;;Boomers;VILLARICA                     ;ARAUCANIA;32990;1;1;0;0;0;1;1;32990;VENTILADOR PEDESTAL KTP-1015;CLIMATIZACION
14527731;;M;42;CHILENO;;X;N/D;N/D;500960;4;2;0;0;0;4;2;500960;A/C FRIO/CALOR PORTATI 9000BTU;CLIMATIZACION
10164505;;M;57;CHILENO;;Boomers;TALCA                         ;MAULE;34990;1;1;0;0;0;1;1;34990;VENTILADOR PEDESTAL KTP-1015;CLIMATIZACION
16322324;;M;36;CHILENO;;Millenial;LA LIGUA                      ;VALPARAISO;39990;1;1;0;0;0;1;1;39990;V-VENTILADOR PISO/MESA 12 C/CONTROL Y TIMER;CLIMATIZACION
17975890;Soltero;M;30;CHILENO;;Millenial;PROVIDENCIA                   ;METROPOLITANA;255840;2;1;2;1;255840;0;0;0;V-AIRE PORTATIL MIDEA MPPD-12KHRN1;CLIMATIZACION
17565760;;F;31;CHILENO;;Millenial;N/D;N/D;89860;3;2;0;0;0;3;2;89860;V-VENTILADOR SOBREMESA 12 AIROLITE;CLIMATIZACION
6189573;Casado;M;74;CHILENO;;Silencioso;RENCA                         ;METROPOLITANA;35980;2;2;0;0;0;2;2;35980;VENTILADOR PEDESTAL KTP-1015;CLIMATIZACION
9608404;;F;62;CHILENO;;Boomers;SAN BERNARDO                  ;METROPOLITANA;54980;2;2;0;0;0;2;2;54980;VENTILADOR PEDESTAL KTP-1015;CLIMATIZACION
16992837;;M;33;CHILENO;;Millenial;BULNES;BIO-BIO;24990;1;1;0;0;0;1;1;24990;VENTILADOR PEDESTAL KF-16P;CLIMATIZACION
8749006;;F;60;CHILENO;;Boomers;VINA DEL MAR                  ;VALPARAISO;109990;1;1;0;0;0;1;1;109990;VENTILADOR PISO 20PLG CP 20 MULTIFLOW C/ SOP;CLIMATIZACION
26684336;;F;41;VENEZOLANO;;Extranjero;LOS ANDES                     ;VALPARAISO;439970;3;3;0;0;0;3;3;439970;A/C FRIO/CALOR PORTATIL 12000BTU;CLIMATIZACION
14149865;;F;46;CHILENO;;X;COLINA                        ;METROPOLITANA;94960;4;2;4;2;94960;0;0;0;VENTILADOR DE PEDESTAL F804;CLIMATIZACION
26630660;;F;45;VENEZOLANO;;Extranjero;N/D;N/D;46980;2;1;2;1;46980;0;0;0;VENTILADOR INDUSTRIAL KTI-1013;CLIMATIZACION
7347422;;M;68;CHILENO;;Boomers;RETIRO                        ;MAULE;240970;3;2;0;0;0;3;2;240970;VENTILADOR PEDESTAL KTP-1015;CLIMATIZACION
15600299;;F;38;CHILENO;;X;N/D;N/D;57980;2;2;0;0;0;2;2;57980;VENTILADOR PEDESTAL KTP-1015;CLIMATIZACION
26067101;;F;32;VENEZOLANO;;Extranjero;N/D;N/D;63980;2;1;2;1;63980;0;0;0;V-VENTILADOR TORRE GRIS C/CONTROL REMOTO;CLIMATIZACION
16586269;;F;35;CHILENO;;Millenial;LOS MUERMOS                   ;LOS LAGOS;24980;2;2;0;0;0;2;2;24980;Ventilador Sobremesa Plastico KF 12D;CLIMATIZACION
8032537;;F;59;CHILENO;;Boomers;LOS ANGELES                   ;BIO BIO;279990;1;1;0;0;0;1;1;279990;AIRE AC. PORTATIL 10000BTU TCL-10CHPA;CLIMATIZACION
9682393;;F;58;CHILENO;;Boomers;CURICO                        ;MAULE;119980;2;2;0;0;0;2;2;119980;VENTILADOR PEDESTAL KTP-1015;CLIMATIZACION
14020984;;M;41;CHILENO;;X;SAN JAVIER                    ;MAULE;34990;1;1;0;0;0;1;1;34990;VENTILADOR PEDESTAL KTP-1015;CLIMATIZACION
16147501;;M;36;CHILENO;;Millenial;PROVIDENCIA                   ;METROPOLITANA;40980;2;1;2;1;40980;0;0;0;V-VENTILADOR 16 C/CONTROL REMOTO Y TIMER;CLIMATIZACION
18851396;;F;27;CHILENO;;Z;RANCAGUA                      ;L.G.B.OÂ´HIGGINS;34990;1;1;0;0;0;1;1;34990;VENTILADOR PEDESTAL KTP-1015;CLIMATIZACION
6546422;;M;70;CHILENO;;Silencioso;OVALLE                        ;COQUIMBO;22990;1;1;0;0;0;1;1;22990;Ventilador BOX 12 Plastico KF-12B3;CLIMATIZACION
6926891;Casado;F;71;CHILENO;;Silencioso;PROVIDENCIA                   ;METROPOLITANA;27990;1;1;0;0;0;1;1;27990;VENTILADOR PEDESTAL KTP-1015;CLIMATIZACION
17100062;Soltero;M;33;CHILENO;;Millenial;PROVIDENCIA                   ;METROPOLITANA;1056970;3;2;3;2;1056970;0;0;0;CALEFACTOR PELLET ITALY8100 NEGRA;CLIMATIZACION
19345789;;M;26;CHILENO;;Z;YERBAS BUENAS                 ;MAULE;94980;2;1;0;0;0;2;1;94980;VENTILADOR THOMAS TH-16CP Pedestal 16;CLIMATIZACION
8945596;;F;62;CHILENO;;Boomers;TALAGANTE                     ;METROPOLITANA;63670;2;1;0;0;0;2;1;63670;Ventilador BOX 20 Metalico FE-45 20Â¿;CLIMATIZACION
14635558;;M;44;CHILENO;;X;"";"";19990;1;1;0;0;0;1;1;19990;VENTILADOR PEDESTAL KTP-1015;CLIMATIZACION
13728651;Casado;F;43;CHILENO;;X;TRAIGUEN                      ;ARAUCANIA;46980;2;1;0;0;0;2;1;46980;VENTILADOR INDUSTRIAL KTI-1013;CLIMATIZACION
17034691;Soltero;F;33;CHILENO;;Millenial;N/D;N/D;467080;4;2;4;2;467080;0;0;0;CALEFACTOR LENA SCANTEK360 GRIS CHARCOAL;CLIMATIZACION
13951355;;M;42;CHILENO;;Silencioso;PROVIDENCIA                   ;METROPOLITANA;9980;2;3;2;3;9980;0;0;0;ESTUFA CUARZO KIOTO 800W KTE-011A;CLIMATIZACION
26653808;;F;22;VENEZOLANO;;Extranjero;N/D;N/D;24990;1;1;0;0;0;1;1;24990;VENTILADOR PEDESTAL KTP-1015;CLIMATIZACION
10162872;;M;54;CHILENO;;X;N/D;N/D;24990;1;1;0;0;0;1;1;24990;V-VENTILADOR SOBREMESA 12 AIROLITE;CLIMATIZACION
19776468;;F;23;CHILENO;;Silencioso;PROVIDENCIA                   ;METROPOLITANA;-8990;-1;1;-1;1;-8990;0;0;0;TERMOVENTILADOR KIOTO NEGRO 2000W KTE-1028N;CLIMATIZACION
20248965;;F;22;CHILENO;;Silencioso;PROVIDENCIA                   ;METROPOLITANA;-39990;-1;1;-1;1;-39990;0;0;0;ESTUFA ELEC. FIBRA DE CARBONO NSB120K5 ROJA;CLIMATIZACION
16876380;;F;34;CHILENO;;Millenial;NUNOA                         ;METROPOLITANA;186940;5;2;5;2;186940;0;0;0;CONVECTOR INFRAROJO EEC-1550NG;CLIMATIZACION
17456565;;F;31;CHILENO;;Millenial;SAN ANTONIO                   ;VALPARAISO;-29990;-1;1;-1;1;-29990;0;0;0;CALIENTACAMAS MANUAL 2N SG-5121D4 2PL;CLIMATIZACION
16135361;;F;36;CHILENO;;Millenial;PROVIDENCIA                   ;METROPOLITANA;0;0;0;0;0;0;0;0;0;CALEFACTOR LENA LIMIT350 CHARCOAL;CLIMATIZACION
5594917;;F;78;CHILENO;;Silencioso;PROVIDENCIA                   ;METROPOLITANA;0;0;0;0;0;0;0;0;0;ESTUFA CUARZO KIOTO 800W KTE-011A;CLIMATIZACION
12365180;;M;49;CHILENO;;X;PROVIDENCIA                   ;METROPOLITANA;0;0;0;0;0;0;0;0;0;ESTUFA CUARZO KIOTO 800W KTE-011A;CLIMATIZACION
20651182;;F;21;CHILENO;;Millenial;"";"";0;0;0;0;0;0;0;0;0;CHIMENEA ELECTRICA KIOTO 2000W KTE-1101;CLIMATIZACION
8011796;;F;58;CHILENO;;Boomers;PROVIDENCIA                   ;METROPOLITANA;0;0;0;0;0;0;0;0;0;A/C FRIO/CALOR PORTATIL 12000BTU;CLIMATIZACION
15465533;;F;40;CHILENO;;X;PROVIDENCIA                   ;METROPOLITANA;0;0;0;0;0;0;0;0;0;CALIENTACAMAS DIGITAL SUBLIME MAXI 1.5PL;CLIMATIZACION
6126549;;F;72;CHILENO;;Silencioso;COIHAIQUE                     ;AYSEN;0;0;0;0;0;0;0;0;0;ESTUFA KEROSENE 720+;CLIMATIZACION
12710276;;F;47;CHILENO;;X;TEMUCO                        ;ARAUCANIA;0;0;0;0;0;0;0;0;0;CALEFACTOR LENA LIMIT350 CHARCOAL;CLIMATIZACION
10878218;;F;56;CHILENO;;Boomers;RENCA                         ;METROPOLITANA;0;0;0;0;0;0;0;0;0;CALIENTACAMA KIOTO DIGITAL 1 PLAZA KTC-1005;CLIMATIZACION
17453947;;F;31;CHILENO;;Silencioso;PROVIDENCIA                   ;METROPOLITANA;0;0;0;0;0;0;0;0;0;CALIENTACAMA KIOTO ANALOGO 1 PLAZA KTC-1004;CLIMATIZACION
19156503;;F;24;CHILENO;;Silencioso;PROVIDENCIA                   ;METROPOLITANA;0;0;0;0;0;0;0;0;0;CALIENTACAMA KIOTO ANALOGO 1 PLAZA KTC-1004;CLIMATIZACION
20403284;;F;22;CHILENO;;Z;PROVIDENCIA                   ;METROPOLITANA;0;0;0;0;0;0;0;0;0;CALIENTACAMA KIOTO DIGITAL 2 PLAZAS KTC-1006;CLIMATIZACION
16879637;;M;34;CHILENO;;Millenial;PROVIDENCIA                   ;METROPOLITANA;0;0;0;0;0;0;0;0;0;ESTUFA INFRARROJA ELECTRICA KIOTO 1500W KTE-1045;CLIMATIZACION
14364471;;F;41;CHILENO;;X;SAN MIGUEL                    ;METROPOLITANA;0;0;0;0;0;0;0;0;0;ESTUFA CUARZO KIOTO 800W KTE-011A;CLIMATIZACION
9639932;;M;58;CHILENO;;Boomers;RENCA                         ;METROPOLITANA;0;0;0;0;0;0;0;0;0;CALIENTACAMA KIOTO ANALOGO 1 PLAZA KTC-1004;CLIMATIZACION
15708800;;M;38;CHILENO;;Silencioso;PROVIDENCIA                   ;METROPOLITANA;0;0;0;0;0;0;0;0;0;ESTUFA CUARZO KIOTO 800W KTE-011A;CLIMATIZACION
18652710;;F;28;CHILENO;;Millenial;PROVIDENCIA                   ;METROPOLITANA;0;0;0;0;0;0;0;0;0;CHIMENEA ELECTRICA ROBLE NEGRA;CLIMATIZACION
8812798;;M;62;CHILENO;;Boomers;COBQUECURA                    ;BIO BIO;0;0;0;0;0;0;0;0;0;ESTUFA CUARZO KIOTO 800W KTE-011A;CLIMATIZACION
17444330;;M;32;CHILENO;;Millenial;PROVIDENCIA                   ;METROPOLITANA;0;0;0;0;0;0;0;0;0;ESTUFA ELECTRICA CUARZO KIOTO 1200W KTE 1033;CLIMATIZACION
14300098;;F;47;CHILENO;;Millenial;PROVIDENCIA                   ;METROPOLITANA;0;0;0;0;0;0;0;0;0;CHIMENEA ELECTRICA KIOTO 2000W KTE-1101;CLIMATIZACION
12041914;Soltero;M;40;CHILENO;;X;PROVIDENCIA                   ;METROPOLITANA;0;0;0;0;0;0;0;0;0;TERMOVENTILADOR VERTICAL SUN05 PURP.;CLIMATIZACION
10094589;;F;56;CHILENO;;Boomers;SANTA JUANA                   ;BIO BIO;0;0;0;0;0;0;0;0;0;CONVECTOR KCH 2010F BL 2000W;CLIMATIZACION
19492879;;F;25;CHILENO;;Z;N/D;N/D;0;0;0;0;0;0;0;0;0;ESTUFA CUARZO KIOTO 800W KTE-011A;CLIMATIZACION
10418382;Casado;F;58;CHILENO;INGENIERIA EN ADMINISTRACION DE EMPRESAS MENCION FINANZAS;Boomers;PROVIDENCIA                   ;METROPOLITANA;0;0;0;0;0;0;0;0;0;CHIMENEA ELECTRICA ROBLE NEGRA;CLIMATIZACION
15620586;;F;38;CHILENO;;Silencioso;PROVIDENCIA                   ;METROPOLITANA;0;0;0;0;0;0;0;0;0;CALIENTACAMA KIOTO ANALOGO 1 PLAZA KTC-1004;CLIMATIZACION
24398618;;F;59;BOLIVIANO;;Extranjero;CALAMA                        ;ANTOFAGASTA;0;0;0;0;0;0;0;0;0;TERMOVENTILADOR TH-FH30 BLANCO 1000W-2000W;CLIMATIZACION
7437590;;F;69;CHILENO;;Silencioso;PROVIDENCIA                   ;METROPOLITANA;0;0;0;0;0;0;0;0;0;ESTUFA CUARZO KIOTO 800W KTE-011A;CLIMATIZACION
20517266;;M;22;CHILENO;;Z;PROVIDENCIA                   ;METROPOLITANA;0;0;0;0;0;0;0;0;0;TERMOVENTILADOR KIOTO NEGRO 2000W KTE-1028N;CLIMATIZACION
16821572;;M;33;CHILENO;;Millenial;LOS ANDES                     ;VALPARAISO;0;0;0;0;0;0;0;0;0;CALIENTACAMAS ANALOGO 2 PL;CLIMATIZACION
17286778;Soltero;F;32;CHILENO;;Silencioso;PROVIDENCIA                   ;METROPOLITANA;0;0;0;0;0;0;0;0;0;TERMOVENTILADOR KIOTO BLANCO 2000W KTE-1028B;CLIMATIZACION
19380657;;F;25;CHILENO;;Z;PROVIDENCIA                   ;METROPOLITANA;0;0;0;0;0;0;0;0;0;CALIENTACAMAS MANUAL 2N SG-5121D4 2PL;CLIMATIZACION
16870547;;M;34;CHILENO;;Millenial;PROVIDENCIA                   ;METROPOLITANA;0;0;0;0;0;0;0;0;0;CALIENTACAMAS DIGITAL TIMER SG-5350 1PL;CLIMATIZACION
18628840;;F;28;CHILENO;;Millenial;PROVIDENCIA                   ;METROPOLITANA;0;0;0;0;0;0;0;0;0;ESTUFA CUARZO KIOTO 800W KTE-011A;CLIMATIZACION
16793183;;F;34;CHILENO;;Millenial;PROVIDENCIA                   ;METROPOLITANA;0;0;0;0;0;0;0;0;0;CALIENTACAMA KIOTO DIGITAL 2 PLAZAS KTC-1006;CLIMATIZACION
17078197;;F;33;CHILENO;;Millenial;NOGALES                       ;VALPARAISO;0;0;0;0;0;0;0;0;0;ESTUFA CUARZO KIOTO 800W KTE-011A;CLIMATIZACION
7468528;;F;65;CHILENO;;Boomers;EL MONTE                      ;METROPOLITANA;0;0;0;0;0;0;0;0;0;CONVECTOR ELECTRICO KIOTO 2000W KTE-1105;CLIMATIZACION
4566366;;F;80;CHILENO;;Silencioso;IQUIQUE                       ;TARAPACA;0;0;0;0;0;0;0;0;0;ESTUFA CUARZO KIOTO 800W KTE-011A;CLIMATIZACION
10203824;;M;54;CHILENO;;Boomers;RENCA                         ;METROPOLITANA;0;0;0;0;0;0;0;0;0;ESTUFA INFRARROJA ELECTRICA KIOTO 1500W KTE-1045;CLIMATIZACION
13556675;;M;42;CHILENO;;X;PROVIDENCIA                   ;METROPOLITANA;0;0;0;0;0;0;0;0;0;CALIENTACAMA KIOTO ANALOGO 1 PLAZA KTC-1004;CLIMATIZACION
14351233;;F;42;CHILENO;;X;RENCA                         ;METROPOLITANA;0;0;0;0;0;0;0;0;0;CALIENTACAMAS ANALOGO 2 PL;CLIMATIZACION
13167954;Casado;F;45;CHILENO;;X;PROVIDENCIA                   ;METROPOLITANA;0;0;0;0;0;0;0;0;0;ESTUFA ELEC. FIBRA DE CARBONO NSB120K5 ROJA;CLIMATIZACION
10592102;;F;54;CHILENO;;Silencioso;PROVIDENCIA                   ;METROPOLITANA;0;0;0;0;0;0;0;0;0;CALIENTACAMAS ANALOGO BASICO 2 PL;CLIMATIZACION
16411915;;M;35;CHILENO;;Millenial;N/D;N/D;0;0;0;0;0;0;0;0;0;TERMOVENTILADOR KIOTO NEGRO 2000W KTE-1028N;CLIMATIZACION
14272713;;F;47;CHILENO;;Silencioso;PROVIDENCIA                   ;METROPOLITANA;0;0;0;0;0;0;0;0;0;TERMOVENTILADOR KIOTO NEGRO 2000W KTE-1028N;CLIMATIZACION
10327638;;F;56;CHILENO;;Boomers;PARRAL                        ;MAULE;0;0;0;0;0;0;0;0;0;CALIENTACAMA KIOTO DIGITAL 1 PLAZA KTC-1005;CLIMATIZACION
8787171;;F;57;CHILENO;;Boomers;LEBU                          ;BIO BIO;0;0;0;0;0;0;0;0;0;CHIMENEA ELECTRICA KIOTO 2000W KTE-1101;CLIMATIZACION
13908487;;F;42;CHILENO;;X;"";"";0;0;0;0;0;0;0;0;0;CHIMENEA ELECTRICA ROBLE NEGRA;CLIMATIZACION
6209870;Casado;F;72;CHILENO;;Silencioso;NUEVA IMPERIAL                ;ARAUCANIA;0;0;0;0;0;0;0;0;0;CHIMENEA ELECTRICA ROBLE NEGRA;CLIMATIZACION
12587724;;F;48;CHILENO;;X;TALCA                         ;MAULE;0;0;0;0;0;0;0;0;0;CALIENTACAMA KIOTO DIGITAL 2 PLAZAS KTC-1006;CLIMATIZACION
7047778;;M;62;CHILENO;;Boomers;ANGOL                         ;ARAUCANIA;0;0;0;0;0;0;0;0;0;ESTUFA A GAS UT GRX-6200 ET ROJA 15 KILOS;CLIMATIZACION
11623241;;F;52;CHILENO;;X;VILLA ALEMANA                 ;VALPARAISO;0;0;0;0;0;0;0;0;0;CALIENTACAMA KIOTO DIGITAL 2 PLAZAS KTC-1006;CLIMATIZACION
13981712;;F;41;CHILENO;;X;LOS ANDES                     ;VALPARAISO;0;0;0;0;0;0;0;0;0;ESTUFA INFRARROJA UT-IRH-S1500;CLIMATIZACION
13850861;;F;41;CHILENO;;X;RENCA                         ;METROPOLITANA;0;0;0;0;0;0;0;0;0;CALIENTACAMA KIOTO ANALOGO 1 PLAZA KTC-1004;CLIMATIZACION
18873057;Soltero;F;27;CHILENO;;Silencioso;PROVIDENCIA                   ;METROPOLITANA;0;0;0;0;0;0;0;0;0;ESTUFA FIBRA DE CARBONO KFB 90;CLIMATIZACION
12635020;;F;47;CHILENO;;X;LA FLORIDA                    ;METROPOLITANA;0;0;0;0;0;0;0;0;0;ESTUFA FIBRA DE CARBONO KFC 90 - NEGRA ROJA;CLIMATIZACION
14377830;;M;44;CHILENO;;X;BUIN                          ;METROPOLITANA;0;0;0;0;0;0;0;0;0;ESTUFA INFRARROJA UT-IRH-S1500;CLIMATIZACION
14332660;;F;44;CHILENO;;X;MELIPILLA                     ;METROPOLITANA;0;0;0;0;0;0;0;0;0;ESTUFA FIBRA DE CARBONO KFC 90 - NEGRA ROJA;CLIMATIZACION
17446839;Soltero;F;32;CHILENO;;Millenial;PROVIDENCIA                   ;METROPOLITANA;0;0;0;0;0;0;0;0;0;CALIENTACAMA KIOTO ANALOGO 1 PLAZA KTC-1004;CLIMATIZACION
8043008;Casado;M;64;CHILENO;LABORATORISTA DENTAL;Boomers;RENCA                         ;METROPOLITANA;0;0;0;0;0;0;0;0;0;CALIENTACAMA KIOTO DIGITAL 2 PLAZAS KTC-1006;CLIMATIZACION
15969435;;F;37;CHILENO;;Millenial;PROVIDENCIA                   ;METROPOLITANA;0;0;0;0;0;0;0;0;0;PANEL CALEFACTOR BIO 800 WIFI;CLIMATIZACION
11636578;;M;51;CHILENO;;X;PROVIDENCIA                   ;METROPOLITANA;0;0;0;0;0;0;0;0;0;ESTUFA CUARZO KIOTO 800W KTE-011A;CLIMATIZACION
25899176;;M;30;BOLIVIANO;;Extranjero;CALAMA                        ;ANTOFAGASTA;0;0;0;0;0;0;0;0;0;ESTUFA CUARZO KIOTO 800W KTE-011A;CLIMATIZACION
5824848;;F;76;CHILENO;;Silencioso;RENCA                         ;METROPOLITANA;0;0;0;0;0;0;0;0;0;Estufa a gas Kaly 15;CLIMATIZACION
8922371;;F;63;CHILENO;;Boomers;MONTE PATRIA                  ;COQUIMBO;0;0;0;0;0;0;0;0;0;MINI OLEOELECTRICA KIOTO 500W NEGRO KTE-1081N;CLIMATIZACION
9595444;;F;62;CHILENO;;Boomers;PROVIDENCIA                   ;METROPOLITANA;0;0;0;0;0;0;0;0;0;TERMOVENTILADOR CURVE TOWER;CLIMATIZACION
15223276;;F;39;CHILENO;;X;CHIGUAYANTE                   ;BIO BIO;0;0;0;0;0;0;0;0;0;CALIENTACAMA KIOTO DIGITAL 2 PLAZAS KTC-1006;CLIMATIZACION
13313859;;F;45;CHILENO;;X;TRAIGUEN                      ;ARAUCANIA;0;0;0;0;0;0;0;0;0;CALIENTACAMA KIOTO DIGITAL 2 PLAZAS KTC-1006;CLIMATIZACION
16755526;;M;35;CHILENO;;Millenial;PROVIDENCIA                   ;METROPOLITANA;0;0;0;0;0;0;0;0;0;CALEFACTOR CONVECTOR EEP-2100BL;CLIMATIZACION
13251791;;F;44;CHILENO;;X;PROVIDENCIA                   ;METROPOLITANA;0;0;0;0;0;0;0;0;0;TERMOVENTILADOR KIOTO NEGRO 2000W KTE-1028N;CLIMATIZACION
25730025;;M;33;PERUANO;;Extranjero;QUINTA NORMAL                 ;METROPOLITANA;0;0;0;0;0;0;0;0;0;CHIMENEA ELECTRICA KIOTO 2000W KTE-1101;CLIMATIZACION
18536815;Soltero;F;29;CHILENO;;Millenial;PROVIDENCIA                   ;METROPOLITANA;0;0;0;0;0;0;0;0;0;ESTUFA FIAMMA PRO;CLIMATIZACION
17059348;Soltero;M;33;CHILENO;;Millenial;PROVIDENCIA                   ;METROPOLITANA;0;0;0;0;0;0;0;0;0;CALIENTACAMA KIOTO ANALOGO 1 PLAZA KTC-1004;CLIMATIZACION
4846189;;M;75;CHILENO;;Silencioso;RENCA                         ;METROPOLITANA;0;0;0;0;0;0;0;0;0;TERMOVENTILADOR KIOTO NEGRO 2000W KTE-1028N;CLIMATIZACION
15532517;;M;27;CHILENO;;Z;RANCAGUA                      ;L.G.B.OÂ´HIGGINS;0;0;0;0;0;0;0;0;0;ESTUFA ELEC. RADIADOR TH-RFC50 800W-1600W-2000W;CLIMATIZACION
18496478;Soltero;M;29;CHILENO;;Millenial;PROVIDENCIA                   ;METROPOLITANA;0;0;0;0;0;0;0;0;0;ESTUFA CUARZO KIOTO 800W KTE-011A;CLIMATIZACION
16612454;;F;35;CHILENO;;Millenial;PROVIDENCIA                   ;METROPOLITANA;0;0;0;0;0;0;0;0;0;ESTUFA ELECTRICA CUARZO KIOTO 1200W KTE 1033;CLIMATIZACION
19789752;;M;24;CHILENO;;Z;SAN VICENTE                   ;L.G.B.OÂ´HIGGINS;0;0;0;0;0;0;0;0;0;TERMOVENTILADOR KIOTO NEGRO 2000W KTE-1028N;CLIMATIZACION
16533249;;M;36;CHILENO;;Millenial;PROVIDENCIA                   ;METROPOLITANA;0;0;0;0;0;0;0;0;0;MINI OLEOELECTRICA KIOTO 500W BLANCO KTE-1081B;CLIMATIZACION
9076348;;F;60;CHILENO;;Boomers;PROVIDENCIA                   ;METROPOLITANA;0;0;0;0;0;0;0;0;0;ESTUFA ELECTRICA CUARZO KIOTO 1200W KTE 1033;CLIMATIZACION
8896192;;M;62;CHILENO;;Boomers;RANCAGUA                      ;L.G.B.OÂ´HIGGINS;0;0;0;0;0;0;0;0;0;TERMOVENTILADOR KIOTO NEGRO 2000W KTE-1028N;CLIMATIZACION
15145965;;F;39;CHILENO;;X;PROVIDENCIA                   ;METROPOLITANA;0;0;0;0;0;0;0;0;0;ESTUFA INFRARROJA ELECTRICA KIOTO 1500W KTE-1045;CLIMATIZACION
15025956;;M;38;CHILENO;;Millenial;IQUIQUE                       ;TARAPACA;0;0;0;0;0;0;0;0;0;ESTUFA CUARZO KIOTO 800W KTE-011A;CLIMATIZACION
9298505;;F;61;CHILENO;;Boomers;ANDACOLLO                     ;COQUIMBO;0;0;0;0;0;0;0;0;0;CHIMENEA ELECTRICA KIOTO 2000W KTE-1101;CLIMATIZACION
18137189;;F;30;CHILENO;;Millenial;PROVIDENCIA                   ;METROPOLITANA;0;0;0;0;0;0;0;0;0;ESTUFA CUARZO KIOTO 800W KTE-011A;CLIMATIZACION
20140899;;F;23;CHILENO;;Z;N/D;N/D;0;0;0;0;0;0;0;0;0;ESTUFA GAS SR-6250NG;CLIMATIZACION
18214970;Soltero;F;30;CHILENO;;Millenial;PROVIDENCIA                   ;METROPOLITANA;0;0;0;0;0;0;0;0;0;CALIENTACAMA KIOTO ANALOGO 1 PLAZA KTC-1004;CLIMATIZACION
9542844;;F;59;CHILENO;;Boomers;CALAMA                        ;ANTOFAGASTA;0;0;0;0;0;0;0;0;0;CHIMENEA ELECTRICA KIOTO 2000W KTE-1101;CLIMATIZACION
10086212;Casado;F;53;CHILENO;;X;RENCA                         ;METROPOLITANA;0;0;0;0;0;0;0;0;0;ESTUFA ELECTRICA CUARZO KIOTO 1200W KTE 1033;CLIMATIZACION
17316930;Soltero;M;32;CHILENO;;Silencioso;PROVIDENCIA                   ;METROPOLITANA;0;0;0;0;0;0;0;0;0;ESTUFA GAS KG5 5K NEGRO EUROPEA;CLIMATIZACION
11994096;;M;50;CHILENO;;X;N/D;N/D;0;0;0;0;0;0;0;0;0;ESTUFA A GAS VALORY NEW BLACK 15K;CLIMATIZACION
12964922;;M;46;CHILENO;;X;CAUQUENES                     ;MAULE;0;0;0;0;0;0;0;0;0;ESTUFA FIAMMA PRO;CLIMATIZACION
20106652;;F;23;CHILENO;;Z;PROVIDENCIA                   ;METROPOLITANA;0;0;0;0;0;0;0;0;0;CALIENTACAMA KIOTO ANALOGO 1 PLAZA KTC-1004;CLIMATIZACION
15240291;;F;38;CHILENO;;X;SANTA CRUZ                    ;L.G.B.OÂ´HIGGINS;0;0;0;0;0;0;0;0;0;CALEFACTOR LENA SCANTEK380 GRIS CHARCOAL;CLIMATIZACION
15253235;;M;39;CHILENO;;X;PROVIDENCIA                   ;METROPOLITANA;0;0;0;0;0;0;0;0;0;TERMOVENTILADOR CERAMICO TH-CH40;CLIMATIZACION
5929238;;M;73;CHILENO;;Silencioso;N/D;N/D;0;0;0;0;0;0;0;0;0;TERMOVENTILADOR NICROM VFH300 BL 1800W;CLIMATIZACION
11396468;;F;53;CHILENO;;X;RENCA                         ;METROPOLITANA;0;0;0;0;0;0;0;0;0;TERMOVENTILADOR KIOTO NEGRO 2000W KTE-1028N;CLIMATIZACION
15705547;;M;38;CHILENO;;X;CAUQUENES                     ;MAULE;0;0;0;0;0;0;0;0;0;CALEFACTOR LENA SCANTEK380 GRIS CHARCOAL;CLIMATIZACION
11184567;;M;54;CHILENO;;Boomers;RENCA                         ;METROPOLITANA;0;0;0;0;0;0;0;0;0;TERMOVENTILADOR CERAMICO TH-CH42 NG 1000W-2000W;CLIMATIZACION
17509600;Soltero;F;32;CHILENO;;Millenial;PROVIDENCIA                   ;METROPOLITANA;0;0;0;0;0;0;0;0;0;ESTUFA A GAS UT GRX-4200 15 KILOS;CLIMATIZACION
8088847;Casado;M;65;CHILENO;;Boomers;PROVIDENCIA                   ;METROPOLITANA;0;0;0;0;0;0;0;0;0;CONVECTOR UT N10;CLIMATIZACION
18267334;Soltero;M;30;CHILENO;;Millenial;PROVIDENCIA                   ;METROPOLITANA;0;0;0;0;0;0;0;0;0;ESTUFA CUARZO KIOTO 800W KTE-011A;CLIMATIZACION
17244349;;F;32;CHILENO;;Millenial;PUENTE ALTO                   ;METROPOLITANA;0;0;0;0;0;0;0;0;0;ESTUFA ELECTRICA PORTATIL EEP-2200BLBLANCA;CLIMATIZACION
14016015;Casado;F;41;CHILENO;;X;PROVIDENCIA                   ;METROPOLITANA;0;0;0;0;0;0;0;0;0;ESTUFA ELECTRICA CUARZO KIOTO 1200W KTE 1033;CLIMATIZACION
11662267;;F;52;CHILENO;;X;PROVIDENCIA                   ;METROPOLITANA;0;0;0;0;0;0;0;0;0;CONVECTOR TH-CV51 BL 750W - 1250W - 2000W;CLIMATIZACION
18323783;;M;29;CHILENO;;Millenial;LONCOCHE                      ;ARAUCANIA;0;0;0;0;0;0;0;0;0;ESTUFA ELECTRICA CARBONO ECOHEATEH1000 1000W;CLIMATIZACION
18662129;;M;28;CHILENO;;Silencioso;PROVIDENCIA                   ;METROPOLITANA;0;0;0;0;0;0;0;0;0;KIT INSTALACION PLUS 5PULGADAS ACERO;CLIMATIZACION
11483227;;M;53;CHILENO;;X;PROVIDENCIA                   ;METROPOLITANA;0;0;0;0;0;0;0;0;0;TERMOVENTILADOR KIOTO BLANCO 2000W KTE-1028B;CLIMATIZACION
12701900;;F;47;CHILENO;;X;CONCEPCION                    ;BIO BIO;0;0;0;0;0;0;0;0;0;CALIENTACAMAS MANUAL 3N SG-5011 2PL;CLIMATIZACION
19299888;;F;25;CHILENO;;Z;CURICO                        ;MAULE;0;0;0;0;0;0;0;0;0;TERMOVENTILADOR KIOTO BLANCO 2000W KTE-1028B;CLIMATIZACION
19383180;Soltero;F;26;CHILENO;PROFESOR;Silencioso;PROVIDENCIA                   ;METROPOLITANA;0;0;0;0;0;0;0;0;0;TERMOVENTILADOR KIOTO NEGRO 2000W KTE-1028N;CLIMATIZACION
12289308;Casado;M;49;CHILENO;;X;RENCA                         ;METROPOLITANA;0;0;0;0;0;0;0;0;0;ESTUFA GAS KGQ15N 15K NEGRO EUROPEA;CLIMATIZACION
17564484;Soltero;F;32;CHILENO;EDUCADOR DE PARVULO;Millenial;PROVIDENCIA                   ;METROPOLITANA;0;0;0;0;0;0;0;0;0;ESTUFA FOGUITA PRO;CLIMATIZACION
18170050;;F;29;CHILENO;;Millenial;PROVIDENCIA                   ;METROPOLITANA;0;0;0;0;0;0;0;0;0;CALIENTACAMA KIOTO ANALOGO 1 PLAZA KTC-1004;CLIMATIZACION
10413114;;F;55;CHILENO;;Boomers;QUILLOTA                      ;VALPARAISO;0;0;0;0;0;0;0;0;0;ESTUFA PARAFINA KPM-3300;CLIMATIZACION
19802601;;F;24;CHILENO;;Z;SANTIAGO                      ;METROPOLITANA;0;0;0;0;0;0;0;0;0;ESTUFA FIAMMA PRO;CLIMATIZACION
19766768;;M;25;CHILENO;;Z;N/D;N/D;0;0;0;0;0;0;0;0;0;ESTUFA CUARZO KIOTO 800W KTE-011A;CLIMATIZACION
13128945;;M;45;CHILENO;;X;N/D;N/D;0;0;0;0;0;0;0;0;0;CHIMENEA ELECTRICA KIOTO 2000W KTE-1101;CLIMATIZACION
12166013;Divorciado;M;44;CHILENO;;Silencioso;PROVIDENCIA                   ;METROPOLITANA;0;0;0;0;0;0;0;0;0;CHIMENEA ELECTRICA KIOTO 2000W KTE-1101;CLIMATIZACION
26067279;;F;28;VENEZOLANO;;Extranjero;PROVIDENCIA                   ;METROPOLITANA;0;0;0;0;0;0;0;0;0;TERMOVENTILADOR NICROM VFH300 BL 1800W;CLIMATIZACION
6272652;;F;70;CHILENO;;Silencioso;PARRAL                        ;MAULE;0;0;0;0;0;0;0;0;0;ESTUFA VITTALE-40 15K;CLIMATIZACION
11502017;;F;53;CHILENO;;X;RENCA                         ;METROPOLITANA;0;0;0;0;0;0;0;0;0;TERMOVENTILADOR NICROM VFH1000 BL 2000W;CLIMATIZACION
13850164;;M;42;CHILENO;;X;RENCA                         ;METROPOLITANA;0;0;0;0;0;0;0;0;0;TERMOVENTILADOR NICROM VFH300 BL 1800W;CLIMATIZACION
19929523;;F;24;CHILENO;;Silencioso;PROVIDENCIA                   ;METROPOLITANA;0;0;0;0;0;0;0;0;0;ESTUFA FOGUITA PRO;CLIMATIZACION
11558842;;F;51;CHILENO;;X;CURICO                        ;MAULE;0;0;0;0;0;0;0;0;0;ESTUFA CUARZO KIOTO 800W KTE-011A;CLIMATIZACION
26530505;;M;31;VENEZOLANO;;Extranjero;"";"";0;0;0;0;0;0;0;0;0;TERMOVENTILADOR KFH-18 BL 2000W;CLIMATIZACION
20258385;;F;22;CHILENO;;Z;PROVIDENCIA                   ;METROPOLITANA;0;0;0;0;0;0;0;0;0;TERMOVENTILADOR KIOTO BLANCO 2000W KTE-1028B;CLIMATIZACION
8914856;Casado;F;65;CHILENO;;Silencioso;PROVIDENCIA                   ;METROPOLITANA;0;0;0;0;0;0;0;0;0;ESTUFA ELECTRICA CUARZO KIOTO 1200W KTE 1033;CLIMATIZACION
16864494;Soltero;F;34;CHILENO;MATRONA;Silencioso;PROVIDENCIA                   ;METROPOLITANA;0;0;0;0;0;0;0;0;0;CALIENTACAMA KIOTO ANALOGO 1 PLAZA KTC-1004;CLIMATIZACION
9220753;;M;59;CHILENO;;Boomers;RENCA                         ;METROPOLITANA;0;0;0;0;0;0;0;0;0;CHIMENEA ELECTRICA KIOTO 2000W KTE-1101;CLIMATIZACION
17211811;;F;33;CHILENO;;Silencioso;PROVIDENCIA                   ;METROPOLITANA;0;0;0;0;0;0;0;0;0;ESTUFA ELECTRICA CUARZO KIOTO 1200W KTE 1033;CLIMATIZACION
7827815;;F;66;CHILENO;;Boomers;N/D;N/D;0;0;0;0;0;0;0;0;0;CALIENTACAMAS DIGITAL TIMER SG-5151 2PL;CLIMATIZACION
10762980;;M;56;CHILENO;;Boomers;PROVIDENCIA                   ;METROPOLITANA;0;0;0;0;0;0;0;0;0;ESTUFA ELECTRICA CARBONO ECOHEATEH1000 1000W;CLIMATIZACION
18747908;;M;28;CHILENO;;Millenial;"";"";0;0;0;0;0;0;0;0;0;KIT INSTALACION PLUS 5PULGADAS ACERO;CLIMATIZACION
9005906;;F;61;CHILENO;;X;PROVIDENCIA                   ;METROPOLITANA;0;0;0;0;0;0;0;0;0;CHIMENEA ELECTRICA KIOTO 2000W KTE-1101;CLIMATIZACION
10045353;;M;55;CHILENO;;Boomers;PROVIDENCIA                   ;METROPOLITANA;0;0;0;0;0;0;0;0;0;ESTUFA PARAFINA KPM-3300;CLIMATIZACION
19142169;Soltero;F;27;CHILENO;;Silencioso;PROVIDENCIA                   ;METROPOLITANA;0;0;0;0;0;0;0;0;0;CALEFACTOR LENA LIMIT350 CHARCOAL;CLIMATIZACION
12565636;Casado;F;48;CHILENO;;Silencioso;PROVIDENCIA                   ;METROPOLITANA;0;0;0;0;0;0;0;0;0;KIT INSTALACION PLUS 6PULGADAS ACERO;CLIMATIZACION
19965782;;M;23;CHILENO;;Silencioso;PROVIDENCIA                   ;METROPOLITANA;0;0;0;0;0;0;0;0;0;ESTUFA FIAMMA PRO;CLIMATIZACION
16509277;;F;35;CHILENO;;Millenial;MELIPILLA                     ;METROPOLITANA;0;0;0;0;0;0;0;0;0;ESTUFA CUARZO KIOTO 800W KTE-011A;CLIMATIZACION
17642499;Soltero;F;31;CHILENO;;Millenial;RENCA                         ;METROPOLITANA;0;0;0;0;0;0;0;0;0;ESTUFA KEROSENE F 1120+;CLIMATIZACION
13046880;;F;46;CHILENO;;X;PROVIDENCIA                   ;METROPOLITANA;0;0;0;0;0;0;0;0;0;TERMOVENTILADOR KIOTO BLANCO 2000W KTE-1028B;CLIMATIZACION
17816911;Soltero;F;30;CHILENO;TECNICO DE NIVEL SUPERIOR EN ENFERMERIA;Millenial;PROVIDENCIA                   ;METROPOLITANA;0;0;0;0;0;0;0;0;0;TERMOVENTILADOR KIOTO BLANCO 2000W KTE-1028B;CLIMATIZACION
10004315;;M;55;CHILENO;;Boomers;RENCA                         ;METROPOLITANA;0;0;0;0;0;0;0;0;0;ESTUFA POTENZA;CLIMATIZACION
15955176;;M;37;CHILENO;;Millenial;CORONEL                       ;BIO BIO;0;0;0;0;0;0;0;0;0;ESTUFA PARAFINA KPM-3300;CLIMATIZACION
23587726;;F;24;CHILENO;;Extranjero;TEMUCO                        ;ARAUCANIA;0;0;0;0;0;0;0;0;0;ESTUFA ELECTRICA CARBONO ECOHEATEH1000 1000W;CLIMATIZACION
15483282;;M;40;CHILENO;;X;RENCA                         ;METROPOLITANA;0;0;0;0;0;0;0;0;0;ESTUFA FOGUITA PRO;CLIMATIZACION
13849949;;F;41;CHILENO;;Millenial;PROVIDENCIA                   ;METROPOLITANA;0;0;0;0;0;0;0;0;0;MINI OLEOELECTRICA KIOTO 500W NEGRO KTE-1081N;CLIMATIZACION
16600935;;F;34;CHILENO;;Millenial;PROVIDENCIA                   ;METROPOLITANA;0;0;0;0;0;0;0;0;0;CALEFACTOR PELLET HERA + CHARCOAL;CLIMATIZACION
15426162;;F;39;CHILENO;;X;PROVIDENCIA                   ;METROPOLITANA;0;0;0;0;0;0;0;0;0;CALEFACTOR INFRAROJO GR2800 ET;CLIMATIZACION
16263511;;F;36;CHILENO;;Millenial;PROVIDENCIA                   ;METROPOLITANA;0;0;0;0;0;0;0;0;0;ESTUFA GAS EH2500 5K NEGRO;CLIMATIZACION
6008541;Casado;F;70;CHILENO;;Silencioso;PROVIDENCIA                   ;METROPOLITANA;0;0;0;0;0;0;0;0;0;VENTILADOR PEDESTAL KTP-1015;CLIMATIZACION
14101410;Casado;F;40;CHILENO;;X;PROVIDENCIA                   ;METROPOLITANA;0;0;0;0;0;0;0;0;0;TERMOVENTILADOR CERAMICO TH-CH41 NG 1000W-2000W;CLIMATIZACION
16197887;;F;37;CHILENO;;Millenial;RENCA                         ;METROPOLITANA;0;0;0;0;0;0;0;0;0;VENTILADOR INDUSTRIAL KTI-1013;CLIMATIZACION
7506529;Soltero;F;70;CHILENO;;Silencioso;PROVIDENCIA                   ;METROPOLITANA;0;0;0;0;0;0;0;0;0;Ventilador Sobremesa Plastico KF 9D;CLIMATIZACION
20682864;Soltero;F;39;CHILENO;PROFESOR;X;PROVIDENCIA                   ;METROPOLITANA;0;0;0;0;0;0;0;0;0;Ventilador Sobremesa Plastico KF 12D;CLIMATIZACION
18577971;Soltero;F;28;CHILENO;TECNICO DE NIVEL SUPERIOR EN ENFERMERIA;Silencioso;PROVIDENCIA                   ;METROPOLITANA;0;0;0;0;0;0;0;0;0;ENFRIADOR Y HUMIFICADOR THOMAS Blanco/Negro;CLIMATIZACION
16441491;;F;35;CHILENO;;Millenial;LA PINTANA                    ;METROPOLITANA;0;0;0;0;0;0;0;0;0;VENTILADOR PEDESTAL KTP-1016;CLIMATIZACION
18134172;;F;30;CHILENO;;Millenial;PROVIDENCIA                   ;METROPOLITANA;0;0;0;0;0;0;0;0;0;VENTILADOR PEDESTAL KTP-1015;CLIMATIZACION
10490242;;M;56;CHILENO;;Boomers;VILLARICA                     ;ARAUCANIA;0;0;0;0;0;0;0;0;0;ENFRIADOR AIR COOLER AC2000;CLIMATIZACION
17856136;Soltero;F;31;CHILENO;KINESIOLOGO;Millenial;PROVIDENCIA                   ;METROPOLITANA;0;0;0;0;0;0;0;0;0;TERMOVENTILADOR KIOTO BLANCO 2000W KTE-1028B;CLIMATIZACION
6199714;Soltero;F;73;CHILENO;;Silencioso;PROVIDENCIA                   ;METROPOLITANA;0;0;0;0;0;0;0;0;0;CALEFACTOR INFRAROJO GR2800 ET;CLIMATIZACION
16563929;;M;35;CHILENO;;Millenial;N/D;N/D;0;0;0;0;0;0;0;0;0;VENTILADOR PEDESTAL KTP-1015;CLIMATIZACION
20350418;;F;22;CHILENO;;Z;INDEPENDENCIA;METROPOLITANA;0;0;0;0;0;0;0;0;0;VENTILADOR PEDESTAL KTP-1015;CLIMATIZACION
9345229;;F;59;CHILENO;;Boomers;LAS CABRAS                    ;L.G.B.OÂ´HIGGINS;0;0;0;0;0;0;0;0;0;Enfriador KSH-16R;CLIMATIZACION
8902853;;F;62;CHILENO;;Boomers;PROVIDENCIA                   ;METROPOLITANA;0;0;0;0;0;0;0;0;0;VENTILADOR POWER BREEZE (120T);CLIMATIZACION
12060220;;F;57;CHILENO;;Boomers;MAIPU                         ;METROPOLITANA;0;0;0;0;0;0;0;0;0;V-VENTILADOR SOBREMESA 12 AIROLITE;CLIMATIZACION
19060064;;F;25;CHILENO;;Z;PROVIDENCIA                   ;METROPOLITANA;0;0;0;0;0;0;0;0;0;VENTILADOR PEDESTAL KTP-1015;CLIMATIZACION
15742111;;M;38;CHILENO;;X;PENAFLOR                      ;METROPOLITANA;0;0;0;0;0;0;0;0;0;AC PORTATIL ECO II 10000;CLIMATIZACION
9946162;;F;56;CHILENO;;Boomers;PROVIDENCIA                   ;METROPOLITANA;0;0;0;0;0;0;0;0;0;VENTILADOR VALORY VSF 9 SOBREMESA 9Â¿ 35W;CLIMATIZACION
9741325;;F;60;CHILENO;;Boomers;PROVIDENCIA                   ;METROPOLITANA;0;0;0;0;0;0;0;0;0;V-VENTILADOR SOBREMESA 16 AIROLITE;CLIMATIZACION
16018098;Soltero;M;37;CHILENO;;Silencioso;PROVIDENCIA                   ;METROPOLITANA;0;0;0;0;0;0;0;0;0;VENTILADOR WIND BREEZE (160S);CLIMATIZACION
12138271;;M;51;CHILENO;;X;RANCAGUA                      ;L.G.B.OÂ´HIGGINS;0;0;0;0;0;0;0;0;0;VENTILADOR WIND BREEZE (160S);CLIMATIZACION
11567087;;M;52;CHILENO;;X;RENCA                         ;METROPOLITANA;0;0;0;0;0;0;0;0;0;ENFRIADOR AIR COOLER AC2000;CLIMATIZACION
16918195;Casado;M;32;CHILENO;CIRUJANO DENTISTA;Millenial;PROVIDENCIA                   ;METROPOLITANA;0;0;0;0;0;0;0;0;0;Enfriador KSH-16R;CLIMATIZACION
14025051;Soltero;F;40;CHILENO;TECNICO EN ADMINISTRACION DE EMPRESAS;X;CHILLAN                       ;BIO BIO;0;0;0;0;0;0;0;0;0;VENTILADOR PEDESTAL KTP-1015;CLIMATIZACION
14416289;;F;42;CHILENO;;X;QUILPUE                       ;VALPARAISO;0;0;0;0;0;0;0;0;0;VENTILADOR TURBO NVB802EA 8P;CLIMATIZACION
19745150;;F;25;CHILENO;;Z;PROVIDENCIA                   ;METROPOLITANA;0;0;0;0;0;0;0;0;0;VENTILADOR PEDESTAL KF-16P;CLIMATIZACION
18660981;;M;28;CHILENO;;Millenial;PROVIDENCIA                   ;METROPOLITANA;0;0;0;0;0;0;0;0;0;VENTILADOR PEDESTAL KTP-1015;CLIMATIZACION
8998049;;M;61;CHILENO;;Boomers;SAN PEDRO                     ;METROPOLITANA;0;0;0;0;0;0;0;0;0;VENTILADOR BOX 16 PLASTIC;CLIMATIZACION
11163280;;M;54;CHILENO;;Boomers;PROVIDENCIA                   ;METROPOLITANA;0;0;0;0;0;0;0;0;0;Ventilador BOX 12 Plastico KF-12B3;CLIMATIZACION
18733780;;M;28;CHILENO;;Millenial;PUERTO MONTT                  ;LOS LAGOS;0;0;0;0;0;0;0;0;0;CHIMENEA ELECTRICA KIOTO 2000W KTE-1101;CLIMATIZACION
9870901;;M;59;CHILENO;;Boomers;PROVIDENCIA                   ;METROPOLITANA;0;0;0;0;0;0;0;0;0;VENTILADOR WIND BREEZE (160S);CLIMATIZACION
7843325;;F;64;CHILENO;;Boomers;MAIPU                         ;METROPOLITANA;0;0;0;0;0;0;0;0;0;VENTILADOR PEDESTAL KTP-1015;CLIMATIZACION
9852456;;F;59;CHILENO;;Boomers;PROVIDENCIA                   ;METROPOLITANA;0;0;0;0;0;0;0;0;0;TERMOVENTILADOR KIOTO BLANCO 2000W KTE-1028B;CLIMATIZACION
10496145;;M;56;CHILENO;;Boomers;RENCA                         ;METROPOLITANA;0;0;0;0;0;0;0;0;0;TERMOVENTILADOR KIOTO BLANCO 2000W KTE-1028B;CLIMATIZACION
13007347;Casado;M;45;CHILENO;ABOGADO;X;VALLENAR;ATACAMA;0;0;0;0;0;0;0;0;0;ESTUFA ELECTRICA CUARZO KIOTO 1200W KTE 1033;CLIMATIZACION
8523970;Casado;F;63;CHILENO;;Boomers;RENCA                         ;METROPOLITANA;0;0;0;0;0;0;0;0;0;CHIMENEA ELECTRICA KIOTO 2000W KTE-1101;CLIMATIZACION
11780514;;M;50;CHILENO;;X;RENCA                         ;METROPOLITANA;0;0;0;0;0;0;0;0;0;CALIENTACAMA KIOTO DIGITAL 2 PLAZAS KTC-1006;CLIMATIZACION
7140697;Soltero;F;73;CHILENO;;Silencioso;PROVIDENCIA                   ;METROPOLITANA;0;0;0;0;0;0;0;0;0;TERMOVENTILADOR KIOTO BLANCO 2000W KTE-1028B;CLIMATIZACION
12795189;Casado;M;47;CHILENO;;X;RENCA                         ;METROPOLITANA;0;0;0;0;0;0;0;0;0;TERMOVENTILADOR CERAMICO TH-CH42 NG 1000W-2000W;CLIMATIZACION
7390214;;M;68;CHILENO;;Silencioso;QUINTA DE TILCOCO             ;L.G.B.OÂ´HIGGINS;0;0;0;0;0;0;0;0;0;ESTUFA KEROSENE F 1120+;CLIMATIZACION
19577312;;F;25;CHILENO;;Z;N/D;N/D;229960;4;3;2;1;184980;2;2;44980;SECADOR DE PELO SG-3049 NEGRO;PERSONAL CARE
10679238;;F;54;CHILENO;;Boomers;RENCA                         ;METROPOLITANA;53990;2;1;0;0;0;2;1;53990;AFEITADORA SG-7250 NEGRO;PERSONAL CARE
19169204;;F;26;CHILENO;;Z;N/D;N/D;12990;1;1;0;0;0;1;1;12990;ONDULADOR SIEGEN SG-2352;PERSONAL CARE
12713416;;M;48;CHILENO;;X;CASTRO                        ;LOS LAGOS;0;0;2;0;0;0;0;2;0;AFEITADORA GAMA SH 1527 WD;PERSONAL CARE
18016435;;M;30;CHILENO;;Millenial;ANCUD;LOS LAGOS;491960;4;4;0;0;0;4;4;491960;CORTA PELO SG-8520;PERSONAL CARE
13347817;;F;43;CHILENO;;X;PALMILLA                      ;L.G.B.OÂ´HIGGINS;316940;6;4;0;0;0;6;4;316940;SECADOR DE PELO SG-3012 NEGRO;PERSONAL CARE
19978002;;F;23;CHILENO;;Z;PROVIDENCIA                   ;METROPOLITANA;48980;2;1;0;0;0;2;1;48980;SECADOR DE PELO SG-3049 NEGRO;PERSONAL CARE
16215738;;F;36;CHILENO;;Millenial;N/D;N/D;376930;7;5;2;1;173980;5;4;202950;ALISADOR +SECADOR PELO;PERSONAL CARE
14368443;;F;48;CHILENO;;X;PROVIDENCIA                   ;METROPOLITANA;12990;1;1;0;0;0;1;1;12990;SECADOR DE PELO SG-3012C29 MORADO;PERSONAL CARE
8758790;;F;63;CHILENO;;Boomers;VALLENAR;ATACAMA;265970;3;3;1;1;199990;2;2;65980;SECADOR DE PELO SG-3051;PERSONAL CARE
20232163;;F;22;CHILENO;;Z;LEBU                          ;BIO BIO;222980;2;2;0;0;0;2;2;222980;ALISADOR +SECADOR PELO;PERSONAL CARE
27035107;Soltero;M;52;EXTRANJERO - NO INFORMA NACIONALIDAD;;X;N/D;N/D;17990;1;1;0;0;0;1;1;17990;ALISADOR DE PELO HP8321;PERSONAL CARE
9822108;;F;58;CHILENO;;Boomers;SAN ANTONIO                   ;VALPARAISO;114210;5;3;0;0;0;5;3;114210;ALISADOR AQUA THERAPY LED;PERSONAL CARE
14250887;;F;52;CHILENO;;X;RENGO                         ;L.G.B.OÂ´HIGGINS;254960;4;3;0;0;0;4;3;254960;ALISADOR ELEGANCE LED BLOOM OE;PERSONAL CARE
10087619;;F;60;CHILENO;;Boomers;CHILLAN                       ;BIO BIO;84963;4;3;0;0;0;4;3;84963;SECADOR DE PELO SIEGEN SG-3035;PERSONAL CARE
18718046;;F;27;CHILENO;;Millenial;N/D;N/D;12990;1;1;0;0;0;1;1;12990;SECADOR DE PELO SG-3012C29 MORADO;PERSONAL CARE
17000820;Soltero;F;32;CHILENO;;Millenial;PROVIDENCIA                   ;METROPOLITANA;13990;1;1;0;0;0;1;1;13990;SECADOR DE PELO SG-3012 NEGRO;PERSONAL CARE
16220726;;M;36;CHILENO;;Millenial;PROVIDENCIA                   ;METROPOLITANA;816054;7;5;0;0;0;7;5;816054;ALISADOR DE PELO SG-4651 ROJO;PERSONAL CARE
15956472;;F;37;CHILENO;;Millenial;PROVIDENCIA                   ;METROPOLITANA;264980;3;2;0;0;0;3;2;264980;DEPILADORA BRE285/00 CONVENCIONAL;PERSONAL CARE
19843098;;F;24;CHILENO;;Z;CHILLAN VIEJO                 ;BIO BIO;13990;1;1;0;0;0;1;1;13990;SECADOR DE PELO SG-3012C23 VERDE;PERSONAL CARE
18373805;Soltero;F;29;CHILENO;;Millenial;PROVIDENCIA                   ;METROPOLITANA;302040;7;5;3;1;119080;4;4;182960;CORTA PELO GC-615;PERSONAL CARE
17222166;;F;33;CHILENO;;Millenial;TALCAHUANO                    ;BIO BIO;36990;1;1;0;0;0;1;1;36990;ALISADOR AQUA THERAPY LED;PERSONAL CARE
15796405;;M;38;CHILENO;;Millenial;"";"";16990;1;1;0;0;0;1;1;16990;SECADOR DE PELO SG-3025 SILVER;PERSONAL CARE
19337428;;F;26;CHILENO;;Z;LA LIGUA                      ;VALPARAISO;366951;7;6;0;0;0;7;6;366951;AFEITADORA S1223/41 ELECTRICA;PERSONAL CARE
19539289;;F;25;CHILENO;;Z;"";"";41980;2;1;0;0;0;2;1;41980;ALISADOR DE PELO SG-3510 FUCSIA;PERSONAL CARE
18150107;Soltero;F;30;CHILENO;NUTRICIONISTA;Millenial;PROVIDENCIA                   ;METROPOLITANA;562972;4;3;0;0;0;4;3;562972;TRICOMBO SECADOR+ALISADOR+ONDULAD;PERSONAL CARE
18487712;;F;29;CHILENO;;Millenial;N/D;N/D;18990;1;1;0;0;0;1;1;18990;SECADOR GAMA BRILLIAN AQUA;PERSONAL CARE
9526107;;M;58;CHILENO;;Boomers;"";"";1042500;9;5;0;0;0;9;5;1042500;CORTAPELO GAMA MG 566;PERSONAL CARE
12367700;;F;49;CHILENO;;X;PROVIDENCIA                   ;METROPOLITANA;12990;1;1;0;0;0;1;1;12990;SECADOR DE PELO SG-3012C29 MORADO;PERSONAL CARE
17885869;Soltero;M;30;CHILENO;;Millenial;PROVIDENCIA                   ;METROPOLITANA;1007951;7;3;0;0;0;7;3;1007951;CORTA PELO SPORT GCX 623 BVT;PERSONAL CARE
11449272;;F;53;CHILENO;;X;ARAUCO                        ;BIO BIO;94815;4;2;0;0;0;4;2;94815;Pack depiladoras HP6306/00 + BRE225/00;PERSONAL CARE
16109658;Casado;F;37;CHILENO;;Millenial;OVALLE                        ;COQUIMBO;179970;3;3;0;0;0;3;3;179970;CORTA PELO HC-5850;PERSONAL CARE
16903147;;F;33;CHILENO;;Millenial;SAN BERNARDO                  ;METROPOLITANA;204940;6;4;2;1;26980;4;3;177960;ALISADOR DE PELO SG-3540 MORADO MORADO;PERSONAL CARE
18599942;;F;29;CHILENO;;Extranjero;ARICA                         ;ARICA Y PARINACOTA;60230;3;1;0;0;0;3;1;60230;ALISADOR DE PELO SG-3540 MORADO MORADO;PERSONAL CARE
10250522;;F;56;CHILENO;;Boomers;LINARES                       ;MAULE;294950;5;4;0;0;0;5;4;294950;CORTA PELO GC-615;PERSONAL CARE
16320403;Soltero;F;35;CHILENO;PROFESOR;Millenial;N/D;N/D;39990;2;1;2;1;39990;0;0;0;ALISADOR DE PELO I X-WIDE ST TITAN KERATIN GRIS;PERSONAL CARE
15230285;Soltero;F;40;CHILENO;;X;LUMACO                        ;ARAUCANIA;29990;1;1;0;0;0;1;1;29990;SECADOR TEMPO TITAN KERATIN;PERSONAL CARE
15469045;;F;40;CHILENO;;Millenial;PROVIDENCIA                   ;METROPOLITANA;21990;1;1;0;0;0;1;1;21990;AFEITADORA SG-7210 NEGRO;PERSONAL CARE
10800572;;F;54;CHILENO;;Boomers;NATALES                       ;MAGALLANES;16990;1;1;0;0;0;1;1;16990;SECADOR DE PELO SG-3025 SILVER;PERSONAL CARE
10087524;;F;56;CHILENO;;Boomers;PROVIDENCIA                   ;METROPOLITANA;18990;1;1;0;0;0;1;1;18990;SECADOR DIAMOND STD;PERSONAL CARE
13813987;;F;42;CHILENO;;X;RENCA                         ;METROPOLITANA;14990;1;1;0;0;0;1;1;14990;SECADOR DE PELO SG-3012C29 MORADO;PERSONAL CARE
10928329;;F;55;CHILENO;;Boomers;RANCAGUA                      ;L.G.B.OÂ´HIGGINS;359970;3;2;2;1;339980;1;1;19990;SECADOR DE PELO SIEGEN SG-3035;PERSONAL CARE
23598860;;F;33;PERUANO;;Extranjero;N/D;N/D;135960;4;4;0;0;0;4;4;135960;TRICOMBO SECADOR+ALISADOR+ONDULAD;PERSONAL CARE
13560332;;M;42;CHILENO;;X;PROVIDENCIA                   ;METROPOLITANA;26990;1;1;0;0;0;1;1;26990;SECADOR DE PELO SG-3049 NEGRO;PERSONAL CARE
19273354;;M;26;CHILENO;;Z;CANETE                        ;BIO BIO;632970;3;3;0;0;0;3;3;632970;CORTA PELO SG-8520;PERSONAL CARE
16156671;;F;37;CHILENO;;Millenial;LOTA                          ;BIO BIO;58083;2;2;0;0;0;2;2;58083;COMBO GAMA SECADOR+ALISADOR+CEPILLO;PERSONAL CARE
11109889;;F;54;CHILENO;;Boomers;RENCA                         ;METROPOLITANA;17990;1;1;0;0;0;1;1;17990;SECADOR DIAMOND STD;PERSONAL CARE
12879975;;F;48;CHILENO;;X;LA PINTANA                    ;METROPOLITANA;194600;6;2;0;0;0;6;2;194600;ALISADOR MATCHA;PERSONAL CARE
10381239;;M;57;CHILENO;;Boomers;PUDAHUEL                      ;METROPOLITANA;35232;3;1;0;0;0;3;1;35232;SECADOR TEMPO TITAN KERATIN;PERSONAL CARE
20229861;;F;22;CHILENO;;Z;VILLA ALEGRE;MAULE;13990;1;1;0;0;0;1;1;13990;SECADOR DE PELO SG-3012C23 VERDE;PERSONAL CARE
14521305;;F;46;CHILENO;;X;RENCA                         ;METROPOLITANA;13140;2;1;0;0;0;2;1;13140;SECADOR DE PELO SG-3012 NEGRO;PERSONAL CARE
12586509;;M;48;CHILENO;;X;PROVIDENCIA                   ;METROPOLITANA;109980;2;2;0;0;0;2;2;109980;SECADOR DE PELO SG-3051;PERSONAL CARE
18031423;;F;29;CHILENO;;Millenial;EL MONTE                      ;METROPOLITANA;691760;10;5;8;4;641920;2;1;49840;AFEITADORA SG-7250 NEGRO;PERSONAL CARE
16731102;;M;34;CHILENO;;Millenial;N/D;N/D;44990;1;1;0;0;0;1;1;44990;COMBO SIEGEN AFEITADORA + MULTISTYLER SG-8440;PERSONAL CARE
11389088;;F;55;CHILENO;;Boomers;QUILPUE                       ;VALPARAISO;28990;1;1;0;0;0;1;1;28990;ALISADOR +SECADOR PELO;PERSONAL CARE
10692357;;F;56;CHILENO;;Boomers;OLIVAR                        ;L.G.B.OÂ´HIGGINS;20980;2;2;0;0;0;2;2;20980;SECADOR DE PELO SIEGEN SG-3035;PERSONAL CARE
19805490;;F;24;CHILENO;;Z;PROVIDENCIA                   ;METROPOLITANA;12990;1;1;0;0;0;1;1;12990;SECADOR GAMA EOLIC MINI TRAVEL;PERSONAL CARE
9745129;;F;55;CHILENO;;Boomers;CONSTITUCION                  ;MAULE;23990;1;1;0;0;0;1;1;23990;SECADOR DE PELO SG-3043 DC CAFE 2200 WATTS;PERSONAL CARE
17547465;;F;31;CHILENO;;Millenial;COCHRANE                      ;AYSEN;258970;3;2;2;1;208980;1;1;49990;COMBO SIEGEN AFEITADORA + MULTISTYLER SG-8440;PERSONAL CARE
17422417;;F;32;CHILENO;;Millenial;PROVIDENCIA                   ;METROPOLITANA;24990;1;1;0;0;0;1;1;24990;SECADOR DE PELO SE-3049C01 FUCSIA;PERSONAL CARE
10882899;;F;54;CHILENO;;Boomers;TEMUCO                        ;ARAUCANIA;745970;5;4;0;0;0;5;4;745970;DEPILADORA SG-9004EX;PERSONAL CARE
18761451;;F;27;CHILENO;;Z;"";"";29980;2;2;0;0;0;2;2;29980;ALISADOR GAMA BELLA SHINE;PERSONAL CARE
24827422;;F;36;COLOMBIANO;;Extranjero;SAN MIGUEL;METROPOLITANA;103980;2;1;0;0;0;2;1;103980;DEPILADORA IPL MAGNA PK;PERSONAL CARE
9014359;;F;60;CHILENO;;Boomers;ARICA                         ;ARICA Y PARINACOTA;24990;1;1;0;0;0;1;1;24990;SPA PARA PIES SG-1560;PERSONAL CARE
16985593;;F;33;CHILENO;;Millenial;PROVIDENCIA                   ;METROPOLITANA;30980;2;1;0;0;0;2;1;30980;Secador de Pelo 3000 Series Philips BHD340/10;PERSONAL CARE
10945237;Casado;F;51;CHILENO;;X;RENCA                         ;METROPOLITANA;13990;1;1;0;0;0;1;1;13990;SECADOR GAMA EOLIC MINI TRAVEL;PERSONAL CARE
13982739;;M;40;CHILENO;;X;CALLE LARGA                   ;VALPARAISO;269981;3;5;0;0;0;3;5;269981;AFEITADORA GAMA SH 1527 WD;PERSONAL CARE
18028957;;F;29;CHILENO;;Extranjero;N/D;N/D;29990;1;1;0;0;0;1;1;29990;CORTA PELO GC-615;PERSONAL CARE
5377597;;M;78;CHILENO;;Boomers;PARRAL                        ;MAULE;40980;2;2;0;0;0;2;2;40980;DEPILADORA SG-9003;PERSONAL CARE
14909125;;M;41;CHILENO;;X;N/D;N/D;15990;1;3;0;0;0;1;3;15990;SECADOR DE PELO MISTRAL STD;PERSONAL CARE
15112066;;F;37;CHILENO;;Millenial;N/D;N/D;336960;4;4;0;0;0;4;4;336960;SECADOR DE PELO SG-3043 DC CAFE 2200 WATTS;PERSONAL CARE
17567979;;M;31;CHILENO;;Millenial;VILLA ALEMANA                 ;VALPARAISO;82980;3;2;0;0;0;3;2;82980;SECADOR DE PELO SG-3012 NEGRO;PERSONAL CARE
15801688;;M;38;CHILENO;;Millenial;N/D;N/D;82980;2;2;0;0;0;2;2;82980;DEPILADORA SG-9004;PERSONAL CARE
9572025;;M;58;CHILENO;;Silencioso;PROVIDENCIA                   ;METROPOLITANA;13990;1;1;0;0;0;1;1;13990;SECADOR DE PELO SG-3012 NEGRO;PERSONAL CARE
6451516;;M;68;CHILENO;;Boomers;MAIPU                         ;METROPOLITANA;39230;3;2;0;0;0;3;2;39230;SECADOR DE PELO SIEGEN SG-3035;PERSONAL CARE
15576850;;M;38;CHILENO;;X;CHONCHI                       ;LOS LAGOS;141970;3;3;0;0;0;3;3;141970;SECADOR GAMA BORA KERATION;PERSONAL CARE
10579494;;F;59;CHILENO;;Boomers;CALAMA                        ;ANTOFAGASTA;270961;5;3;0;0;0;5;3;270961;SECADOR DE PELO SG-3012 NEGRO;PERSONAL CARE
18791803;Soltero;M;27;CHILENO;PROFESOR;Millenial;PROVIDENCIA                   ;METROPOLITANA;19990;1;1;0;0;0;1;1;19990;SECADOR DE PELO SIEGEN SG-3035;PERSONAL CARE
18352195;;F;29;CHILENO;;Millenial;OVALLE                        ;COQUIMBO;12990;1;1;0;0;0;1;1;12990;CORTAPELO GAMA MG 566;PERSONAL CARE
13950483;;M;41;CHILENO;;X;TALCA;MAULE;442970;3;3;0;0;0;3;3;442970;SECADOR GAMA BRILLIAN AQUA;PERSONAL CARE
10928098;;M;49;CHILENO;;X;N/D;N/D;461463;4;4;0;0;0;4;4;461463;CORTA PELO SG-8200;PERSONAL CARE
12826675;;F;46;CHILENO;;Extranjero;SANTO DOMINGO                 ;VALPARAISO;21990;1;1;0;0;0;1;1;21990;AFEITADORA SPORT;PERSONAL CARE
15423876;;F;39;CHILENO;;X;PROVIDENCIA                   ;METROPOLITANA;12990;1;1;0;0;0;1;1;12990;SECADOR GAMA EOLIC MINI TRAVEL;PERSONAL CARE
9263186;;F;59;CHILENO;;Boomers;ANCUD                         ;LOS LAGOS;24990;1;1;0;0;0;1;1;24990;AFEITADORA SG-7210 NEGRO;PERSONAL CARE
16603252;;F;34;CHILENO;;Millenial;ANCUD                         ;LOS LAGOS;112950;5;5;1;1;19990;4;4;92960;SECADOR DE PELO SIEGEN SG-3035;PERSONAL CARE
6150646;;F;76;CHILENO;;Silencioso;CONCEPCION                    ;BIO BIO;25140;2;1;0;0;0;2;1;25140;CORTA PELO SPORT GCX 623 BVT;PERSONAL CARE
9823668;;M;56;CHILENO;;Boomers;PROVIDENCIA                   ;METROPOLITANA;19990;1;1;0;0;0;1;1;19990;AFEITADORA SG-7210 NEGRO;PERSONAL CARE
16313950;Casado;F;35;CHILENO;;Millenial;ILLAPEL                       ;COQUIMBO;26460;2;1;0;0;0;2;1;26460;SECADOR DE PELO MISTRAL STD;PERSONAL CARE
11783235;;F;51;CHILENO;;X;VILLARICA                     ;ARAUCANIA;38990;1;1;0;0;0;1;1;38990;AFEITADORA SH 887 WD BAT;PERSONAL CARE
17140190;Soltero;F;33;CHILENO;;Millenial;RENCA                         ;METROPOLITANA;34990;1;1;0;0;0;1;1;34990;ALISADOR AQUA THERAPY LED;PERSONAL CARE
16163975;;F;36;CHILENO;;Millenial;CANETE                        ;BIO BIO;54980;2;1;0;0;0;2;1;54980;ALISADOR DE PELO SG-3540 MORADO MORADO;PERSONAL CARE
15698428;;F;38;CHILENO;;Millenial;RENCA                         ;METROPOLITANA;24990;1;1;0;0;0;1;1;24990;SECADOR DE PELO SE-3049C01 FUCSIA;PERSONAL CARE
17897688;;F;31;CHILENO;;Millenial;LOS ANGELES;BIO-BIO;39990;1;1;0;0;0;1;1;39990;COMBO GAMA SECADOR+ALISADOR+CEPILLO;PERSONAL CARE
16887480;Soltero;F;34;CHILENO;TECNICO DE NIVEL SUPERIOR EN ENFERMERIA;Millenial;PROVIDENCIA                   ;METROPOLITANA;60960;4;3;0;0;0;4;3;60960;Secador de Pelo 3000 Series Philips BHD340/10;PERSONAL CARE
9662449;;M;59;CHILENO;;Boomers;PROVIDENCIA                   ;METROPOLITANA;16990;1;1;0;0;0;1;1;16990;SECADOR DIAMOND STD;PERSONAL CARE
13144954;;M;44;CHILENO;;X;"";"";24990;1;1;0;0;0;1;1;24990;CORTA PELO SPORT GCX 623 BVT;PERSONAL CARE
15915619;Soltero;M;38;CHILENO;;Millenial;RENCA                         ;METROPOLITANA;31990;1;1;0;0;0;1;1;31990;CORTA PELO SG-8520;PERSONAL CARE
9075310;;M;47;CHILENO;;X;PROVIDENCIA                   ;METROPOLITANA;74970;3;3;0;0;0;3;3;74970;TRICOMBO SECADOR+ALISADOR+ONDULAD;PERSONAL CARE
15681955;;M;38;CHILENO;;Millenial;PROVIDENCIA                   ;METROPOLITANA;229760;4;3;1;1;119990;3;2;109770;SECADOR DE PELO SG-3012 NEGRO;PERSONAL CARE
17970975;;F;31;CHILENO;;Millenial;N/D;N/D;12990;1;1;0;0;0;1;1;12990;SECADOR GAMA EOLIC MINI TRAVEL;PERSONAL CARE
12171234;;F;50;CHILENO;;X;DIEGO DE ALMAGRO              ;ATACAMA;153630;5;1;0;0;0;5;1;153630;DEPILADORA BRE700/00 MID-END CLOSED BOX;PERSONAL CARE
20293847;;M;22;CHILENO;;Millenial;LOS LAGOS;LOS LAGOS;19000;2;1;0;0;0;2;1;19000;KIT CORTABARBA MG3711;PERSONAL CARE
19552996;Soltero;M;25;CHILENO;;Z;PAILLACO;LOS LAGOS;29480;2;1;2;1;29480;0;0;0;AFEITADORA SPORT;PERSONAL CARE
16672989;;F;34;CHILENO;;Millenial;PROVIDENCIA                   ;METROPOLITANA;24990;1;1;0;0;0;1;1;24990;ALISADOR GAMA BELLA SHINE;PERSONAL CARE
16140413;;F;36;CHILENO;;Millenial;PROVIDENCIA                   ;METROPOLITANA;24990;1;1;0;0;0;1;1;24990;CORTA PELO SG-8410;PERSONAL CARE
9458754;Soltero;F;59;CHILENO;;Boomers;TEMUCO                        ;ARAUCANIA;19990;3;1;0;0;0;3;1;19990;SECADOR DE PELO MISTRAL STD;PERSONAL CARE
7133624;Casado;F;64;CHILENO;;Boomers;CALERA                        ;VALPARAISO;34990;1;1;0;0;0;1;1;34990;COMBO SIEGEN AFEITADORA + MULTISTYLER SG-8440;PERSONAL CARE
14312947;;M;45;CHILENO;;Millenial;N/D;N/D;44990;1;1;0;0;0;1;1;44990;AFEITADORA SH 1525 USB;PERSONAL CARE
18004523;Soltero;M;30;CHILENO;;Millenial;PROVIDENCIA                   ;METROPOLITANA;24990;1;1;0;0;0;1;1;24990;KIT CORTABARBA MG3711;PERSONAL CARE
10874121;;M;54;CHILENO;;X;LA LIGUA                      ;VALPARAISO;118960;4;3;0;0;0;4;3;118960;CORTA PELO HC3520;PERSONAL CARE
15135310;;F;40;CHILENO;;X;TALCA                         ;MAULE;26990;1;1;0;0;0;1;1;26990;SECADOR DE PELO SG-3049 NEGRO;PERSONAL CARE
14071817;;M;41;CHILENO;;X;CANETE                        ;BIO BIO;389980;2;2;0;0;0;2;2;389980;COMBO SIEGEN AFEITADORA + MULTISTYLER SG-8440;PERSONAL CARE
17233394;;F;33;CHILENO;;Millenial;COIHAIQUE                     ;AYSEN;295950;5;4;0;0;0;5;4;295950;ALISADOR SIEGEN SG-4716;PERSONAL CARE
15514950;;M;38;CHILENO;;X;PROVIDENCIA                   ;METROPOLITANA;21990;1;1;0;0;0;1;1;21990;Secador de Pelo 3000 Series Philips BHD340/10;PERSONAL CARE
14022712;Soltero;F;40;CHILENO;;X;RETIRO                        ;MAULE;19990;1;1;0;0;0;1;1;19990;AFEITADORA SG-7210 NEGRO;PERSONAL CARE
15536011;;M;39;CHILENO;;X;EL BOSQUE;METROPOLITANA;96980;2;2;2;2;96980;0;0;0;SECADOR GAMA BORA KERATION;PERSONAL CARE
20106025;;F;23;CHILENO;;Z;PROVIDENCIA                   ;METROPOLITANA;249980;2;2;2;2;249980;0;0;0;ALISADOR REMIG. WET2 S27A (BV) R;PERSONAL CARE
13519345;;M;44;CHILENO;;X;N/D;N/D;24990;1;1;0;0;0;1;1;24990;KIT CORTABARBA MG3711;PERSONAL CARE
14009387;;M;41;CHILENO;;X;RENCA                         ;METROPOLITANA;34990;1;3;0;0;0;1;3;34990;Pack Depiladora BRE255/00 + Recortador HP6389/00;PERSONAL CARE
7132364;Soltero;F;71;CHILENO;;Silencioso;PARRAL                        ;MAULE;20990;1;1;0;0;0;1;1;20990;SECADOR DE PELO SG-3043 DC CAFE 2200 WATTS;PERSONAL CARE
7388080;;F;62;CHILENO;;Silencioso;PROVIDENCIA                   ;METROPOLITANA;29990;1;1;0;0;0;1;1;29990;COMBO GAMA SECADOR+ALISADOR+CEPILLO;PERSONAL CARE
17847877;Soltero;F;30;CHILENO;INGENIERO COMERCIAL;Millenial;PROVIDENCIA                   ;METROPOLITANA;21990;1;1;0;0;0;1;1;21990;SECADOR DE PELO SIEGEN SG-3035;PERSONAL CARE
19581385;;F;25;CHILENO;;Z;PROVIDENCIA                   ;METROPOLITANA;34990;1;1;0;0;0;1;1;34990;Pack Depiladora BRE255/00 + Recortador HP6389/00;PERSONAL CARE
20376818;;F;21;CHILENO;;Z;CURICO;MAULE;31980;2;1;2;1;31980;0;0;0;CEPILLO ALISADOR SIEGEN SG-2805;PERSONAL CARE
12203334;;M;49;CHILENO;;X;CASTRO                        ;LOS LAGOS;559650;7;4;0;0;0;7;4;559650;COMBO GAMA SECADOR+ALISADOR+CEPILLO;PERSONAL CARE
8577303;;F;65;CHILENO;;Boomers;RENCA                         ;METROPOLITANA;26990;1;1;0;0;0;1;1;26990;SECADOR DE PELO SG-3049 NEGRO;PERSONAL CARE
15639447;;F;41;CHILENO;;X;COIHAIQUE                     ;AYSEN;324280;3;2;0;0;0;3;2;324280;ONDULADOR SIEGEN SG-2352;PERSONAL CARE
8720314;;M;59;CHILENO;;Boomers;SAN CARLOS                    ;BIO BIO;591770;9;5;9;5;591770;0;0;0;ALISADOR AQUA THERAPY LED;PERSONAL CARE
14027962;;F;40;CHILENO;;X;CHILLAN                       ;NUBLE;105970;3;3;0;0;0;3;3;105970;ALISADOR DE PELO SG-3540 MORADO MORADO;PERSONAL CARE
9075077;Casado;F;62;CHILENO;;Boomers;RENCA                         ;METROPOLITANA;11990;1;1;0;0;0;1;1;11990;CORTA PELO SPORT GC 542 BVT;PERSONAL CARE
12377674;;F;48;CHILENO;;X;CHILLAN                       ;BIO BIO;25230;3;3;0;0;0;3;3;25230;SECADOR DE PELO SG-3012C29 MORADO;PERSONAL CARE
8840125;;F;62;CHILENO;;Boomers;BUIN                          ;METROPOLITANA;343970;3;2;0;0;0;3;2;343970;SECADOR DE PELO SG-3025 SILVER;PERSONAL CARE
15877989;;F;38;CHILENO;;Millenial;RENCA                         ;METROPOLITANA;14990;1;1;0;0;0;1;1;14990;SECADOR DE PELO SG-3025 SILVER;PERSONAL CARE
5604498;Casado;M;75;CHILENO;;Silencioso;SAN JAVIER                    ;MAULE;34990;1;1;0;0;0;1;1;34990;AFEITADORA SG-7250 NEGRO;PERSONAL CARE
9688516;;M;56;CHILENO;;Boomers;MAIPU                         ;METROPOLITANA;1571400;15;7;0;0;0;15;7;1571400;CORTA PELO HC3505;PERSONAL CARE
13200752;;F;45;CHILENO;;X;PROVIDENCIA                   ;METROPOLITANA;20980;2;1;2;1;20980;0;0;0;SECADOR GAMA BORA KERATION;PERSONAL CARE
12112503;;F;53;CHILENO;;X;PROVIDENCIA                   ;METROPOLITANA;17990;1;1;0;0;0;1;1;17990;SECADOR DE PELO MISTRAL STD;PERSONAL CARE
19871291;;F;23;CHILENO;;Z;CAMARONES                     ;TARAPACA;74340;3;1;0;0;0;3;1;74340;ALISADOR DE PELO SG-3540 MORADO MORADO;PERSONAL CARE
17866803;;F;31;CHILENO;;Millenial;PELLUHUE                      ;MAULE;367930;7;3;0;0;0;7;3;367930;SECADOR DE PELO SG-3043 DC CAFE 2200 WATTS;PERSONAL CARE
18647008;;F;28;CHILENO;;Millenial;PROVIDENCIA                   ;METROPOLITANA;19980;2;2;2;2;19980;0;0;0;SECADOR DE PELO SG-3012 NEGRO;PERSONAL CARE
13661662;;M;43;CHILENO;;X;COLINA;METROPOLITANA;414970;3;3;1;1;189990;2;2;224980;SPA PARA PIES SG-1560;PERSONAL CARE
17814609;Soltero;F;31;CHILENO;INGENIERO CONSTRUCCION;Millenial;PROVIDENCIA                   ;METROPOLITANA;17990;1;1;0;0;0;1;1;17990;ALISADOR DE PELO SG-3510 FUCSIA;PERSONAL CARE
16817987;Soltero;M;34;CHILENO;KINESIOLOGO;Silencioso;PROVIDENCIA                   ;METROPOLITANA;27490;3;2;0;0;0;3;2;27490;ALISADOR DE PELO S6300 GRIS;PERSONAL CARE
20231626;;M;23;CHILENO;;Z;PROVIDENCIA                   ;METROPOLITANA;36980;2;1;2;1;36980;0;0;0;MULTIGROOM MG5730 SERIE 5000;PERSONAL CARE
14079914;;F;41;CHILENO;;X;N/D;N/D;181940;6;5;0;0;0;6;5;181940;ALISADOR ELEGANCE LED KER;PERSONAL CARE
19592439;;F;25;CHILENO;;Z;N/D;N/D;241341;4;2;0;0;0;4;2;241341;ALISADOR DE PELO SG-3512D1 ROSA;PERSONAL CARE
12879649;;M;49;CHILENO;;X;SAN BERNARDO                  ;METROPOLITANA;147220;4;3;0;0;0;4;3;147220;ALISADOR DE PELO SG-4651 ROJO;PERSONAL CARE
17934070;;F;30;CHILENO;;Millenial;FUTRONO                       ;LOS RIOS;15130;3;1;0;0;0;3;1;15130;SECADOR DE PELO SG-3012 NEGRO;PERSONAL CARE
17163741;;F;33;CHILENO;;Millenial;PROVIDENCIA                   ;METROPOLITANA;24990;1;1;0;0;0;1;1;24990;ALISADOR MATCHA;PERSONAL CARE
15927091;Divorciado;M;37;CHILENO;;Millenial;RENCA                         ;METROPOLITANA;63970;3;1;0;0;0;3;1;63970;AFEITADORA 3000BT NEGRA;PERSONAL CARE
20310677;;F;22;CHILENO;;Z;MELIPILLA                     ;METROPOLITANA;258090;4;2;0;0;0;4;2;258090;CORTAPELO GAMA MG 566;PERSONAL CARE
9861165;;M;56;CHILENO;;Boomers;PARRAL                        ;MAULE;29990;1;1;0;0;0;1;1;29990;ALISADOR DE PELO SG-3540 MORADO MORADO;PERSONAL CARE
11970708;;F;50;CHILENO;;X;TEMUCO                        ;ARAUCANIA;16990;1;1;0;0;0;1;1;16990;SECADOR DE PELO MISTRAL STD;PERSONAL CARE
19764573;;F;28;CHILENO;;Millenial;N/D;N/D;58980;2;1;0;0;0;2;1;58980;DEPILADORA SG-9004;PERSONAL CARE
19155975;;F;29;CHILENO;;Millenial;"";"";14990;1;1;1;1;14990;0;0;0;SECADOR DE PELO MISTRAL STD;PERSONAL CARE
10688872;;M;50;CHILENO;;X;N/D;N/D;482770;2;4;0;0;0;2;4;482770;SECADOR DE PELO SG-3051;PERSONAL CARE
17161281;Soltero;M;33;CHILENO;;Millenial;PROVIDENCIA                   ;METROPOLITANA;114970;3;2;3;2;114970;0;0;0;ALISADOR DE PELO SG-3540 MORADO MORADO;PERSONAL CARE
12345156;;F;49;CHILENO;;X;ANCUD                         ;LOS LAGOS;46980;2;1;0;0;0;2;1;46980;ALISADOR DE PELO SG-3510 FUCSIA;PERSONAL CARE
14607727;Soltero;F;42;CHILENO;;X;PROVIDENCIA                   ;METROPOLITANA;19990;1;1;0;0;0;1;1;19990;ALISADOR SG-3510C11 VERDE;PERSONAL CARE
10823383;Casado;F;56;CHILENO;;Boomers;PROVIDENCIA                   ;METROPOLITANA;30980;2;2;0;0;0;2;2;30980;SECADOR GAMA EOLIC MINI TRAVEL;PERSONAL CARE
6896374;;F;74;CHILENO;;Silencioso;N/D;N/D;92980;2;2;0;0;0;2;2;92980;ALISADOR DE PELO SG-4651 ROJO;PERSONAL CARE
19090508;Soltero;F;26;CHILENO;KINESIOLOGA;Z;PROVIDENCIA                   ;METROPOLITANA;24160;2;1;0;0;0;2;1;24160;ONDULADOR SIEGEN SG-2352;PERSONAL CARE
14128534;;F;41;CHILENO;;X;PROVIDENCIA                   ;METROPOLITANA;104980;2;2;0;0;0;2;2;104980;DEPILADORA OASIS SENSATION;PERSONAL CARE
16178331;;F;36;CHILENO;;Millenial;RENCA                         ;METROPOLITANA;90960;4;3;0;0;0;4;3;90960;AFEITADORA SH 887 WD BAT;PERSONAL CARE
14463828;Casado;F;45;CHILENO;;X;PROVIDENCIA                   ;METROPOLITANA;24990;1;1;0;0;0;1;1;24990;KIT CORTABARBA MG3731;PERSONAL CARE
6222799;;F;70;CHILENO;;Silencioso;PROVIDENCIA                   ;METROPOLITANA;9990;1;1;0;0;0;1;1;9990;SECADOR DE PELO SG-3012 NEGRO;PERSONAL CARE
7663350;;M;64;CHILENO;;Boomers;CHIMBARONGO                   ;L.G.B.OÂ´HIGGINS;16990;1;1;0;0;0;1;1;16990;SECADOR DE PELO MISTRAL STD;PERSONAL CARE
13792378;Casado;M;42;CHILENO;;X;PROVIDENCIA                   ;METROPOLITANA;199980;2;2;0;0;0;2;2;199980;SECADOR DE PELO SG-3012 NEGRO;PERSONAL CARE
17183929;;F;33;CHILENO;;Millenial;TALCA;MAULE;204980;2;4;0;0;0;2;4;204980;AFEITADORA SH 1525 USB;PERSONAL CARE
17817213;;F;30;CHILENO;;Millenial;PROVIDENCIA                   ;METROPOLITANA;10990;1;1;0;0;0;1;1;10990;SECADOR GAMA EOLIC MINI TRAVEL;PERSONAL CARE
19827018;;F;24;CHILENO;;Z;PROVIDENCIA                   ;METROPOLITANA;9990;1;1;0;0;0;1;1;9990;SECADOR DE PELO SG-3012 NEGRO;PERSONAL CARE
11332136;;F;53;CHILENO;;X;VALPARAISO                    ;VALPARAISO;56980;2;2;0;0;0;2;2;56980;SECADOR TEMPO TITAN KERATIN;PERSONAL CARE
10058511;;F;55;CHILENO;;Boomers;LLAILLAY                      ;VALPARAISO;2632070;12;5;0;0;0;12;5;2632070;SECADOR DE PELO SG-3012 NEGRO;PERSONAL CARE
26309785;Soltero;M;28;HAITIANO;;Extranjero;RENGO                         ;L.G.B.OÂ´HIGGINS;55000;2;1;0;0;0;2;1;55000;COMBO SIEGEN AFEITADORA + MULTISTYLER SG-8440;PERSONAL CARE
26121143;;M;33;VENEZOLANO;;Extranjero;MELIPILLA                     ;METROPOLITANA;195980;2;2;0;0;0;2;2;195980;CORTA PELO SG-8520;PERSONAL CARE
11280910;;F;54;CHILENO;;X;PROVIDENCIA                   ;METROPOLITANA;19990;1;1;0;0;0;1;1;19990;SECADOR DE PELO SG-3043 DC CAFE 2200 WATTS;PERSONAL CARE
9411177;;M;58;CHILENO;;Boomers;PITRUFQUEN                    ;ARAUCANIA;162640;5;3;0;0;0;5;3;162640;ALISADOR CP14 Titanio D 4D Bvt.;PERSONAL CARE
23973557;;M;41;BOLIVIANO;;Extranjero;COPIAPO                       ;ATACAMA;18990;1;1;0;0;0;1;1;18990;CORTA PELO HC3505;PERSONAL CARE
18067148;;M;30;CHILENO;;Millenial;TALCAHUANO                    ;BIO BIO;20990;1;1;0;0;0;1;1;20990;SECADOR DE PELO SG-3043 DC CAFE 2200 WATTS;PERSONAL CARE
8898666;;M;62;CHILENO;;Boomers;RENCA                         ;METROPOLITANA;16990;1;1;0;0;0;1;1;16990;CORTAPELO GAMA MG 566;PERSONAL CARE
18971263;;M;27;CHILENO;;Z;ILLAPEL                       ;COQUIMBO;134980;2;2;0;0;0;2;2;134980;COMBO SIEGEN AFEITADORA + MULTISTYLER SG-8440;PERSONAL CARE
11385127;;M;53;CHILENO;;X;"";"";15000;2;1;0;0;0;2;1;15000;CORTAPELO GAMA TITANIUM T827;PERSONAL CARE
8026581;Soltero;F;63;CHILENO;;Millenial;N/D;N/D;743090;8;3;0;0;0;8;3;743090;SECADOR GAMA EOLIC MINI TRAVEL;PERSONAL CARE
17274666;;F;32;CHILENO;;Millenial;N/D;N/D;95250;2;1;0;0;0;2;1;95250;DEPILADORA IPL MAGNA PK;PERSONAL CARE
19717841;;F;25;CHILENO;;Z;COLLIPULLI                    ;ARAUCANIA;142473;3;2;0;0;0;3;2;142473;SPA PARA PIES SG-1560;PERSONAL CARE
15109280;;M;38;CHILENO;;X;RENCA                         ;METROPOLITANA;14990;1;3;0;0;0;1;3;14990;CORTAPELO GAMA TITANIUM T827;PERSONAL CARE
20038163;;M;22;CHILENO;;Silencioso;PROVIDENCIA                   ;METROPOLITANA;24990;1;1;1;1;24990;0;0;0;SECADOR DE PELO SG-3051;PERSONAL CARE
10696006;;F;55;CHILENO;;Boomers;LA LIGUA                      ;VALPARAISO;45933;2;2;0;0;0;2;2;45933;SECADOR DE PELO SE-3049C01 FUCSIA;PERSONAL CARE
18505678;Soltero;F;28;CHILENO;;Millenial;PROVIDENCIA                   ;METROPOLITANA;215970;3;2;2;1;187980;1;1;27990;ALISADOR DE PELO S6300 GRIS;PERSONAL CARE
15659401;;F;38;CHILENO;;Millenial;CANETE                        ;BIO BIO;174830;3;2;2;1;155840;1;1;18990;CORTA PELO SG-8200;PERSONAL CARE
16395111;;F;36;CHILENO;;Millenial;N/D;N/D;272980;2;2;0;0;0;2;2;272980;ALISADOR ELEGANCE LED KER;PERSONAL CARE
13159236;;F;45;CHILENO;;X;VALDIVIA                      ;LOS RIOS;49980;2;2;0;0;0;2;2;49980;ALISADOR GAMA BELLA SHINE;PERSONAL CARE
10586749;;F;51;CHILENO;;X;N/D;N/D;147970;3;3;0;0;0;3;3;147970;AFEITADORA S1323/41 ELECTRICA;PERSONAL CARE
13173236;;F;44;CHILENO;;X;COPIAPO                       ;ATACAMA;12990;1;1;0;0;0;1;1;12990;SECADOR DE PELO SG-3012 NEGRO;PERSONAL CARE
14206437;;F;41;CHILENO;;X;N/D;N/D;53990;3;1;0;0;0;3;1;53990;DEPILADORA SG-9004EX;PERSONAL CARE
13207578;;F;45;CHILENO;;X;PARRAL                        ;MAULE;21980;2;2;0;0;0;2;2;21980;SECADOR DE PELO SG-3012 NEGRO;PERSONAL CARE
10468881;;M;56;CHILENO;;Boomers;RENCA                         ;METROPOLITANA;20990;1;1;0;0;0;1;1;20990;KIT CORTABARBA MG3711;PERSONAL CARE
13501815;;F;44;CHILENO;;X;DONIHUE                       ;L.G.B.OÂ´HIGGINS;203040;7;2;7;2;203040;0;0;0;SECADOR GAMA BORA KERATION;PERSONAL CARE
14028696;;F;42;CHILENO;;X;RENCA                         ;METROPOLITANA;24990;1;1;0;0;0;1;1;24990;SECADOR DE PELO SG-3051;PERSONAL CARE
15450681;;F;40;CHILENO;;X;LO ESPEJO;METROPOLITANA;24990;1;1;0;0;0;1;1;24990;CORTA PELO SPORT GCX 623 BVT;PERSONAL CARE
20317870;;F;22;CHILENO;;Z;PROVIDENCIA                   ;METROPOLITANA;34230;3;1;0;0;0;3;1;34230;ALISADOR DE PELO HP8321;PERSONAL CARE
15866607;;F;37;CHILENO;;Millenial;MELIPILLA                     ;METROPOLITANA;16990;1;1;0;0;0;1;1;16990;SECADOR DIAMOND STD;PERSONAL CARE
16215674;;M;36;CHILENO;;Millenial;N/D;N/D;33980;2;1;0;0;0;2;1;33980;SECADOR GAMA BRILLIAN AQUA;PERSONAL CARE
15658552;;M;38;CHILENO;;Millenial;TIRUA                         ;BIO BIO;195140;5;3;0;0;0;5;3;195140;CORTA PELO SG-8410;PERSONAL CARE
17064192;;M;34;CHILENO;;Millenial;N/D;N/D;16990;1;1;0;0;0;1;1;16990;CORTAPELO GAMA MG 566;PERSONAL CARE
9553951;;F;59;CHILENO;;Boomers;RENCA                         ;METROPOLITANA;14990;1;1;0;0;0;1;1;14990;SECADOR DE PELO SG-3012 NEGRO;PERSONAL CARE
11985391;;M;50;CHILENO;;X;RENCA                         ;METROPOLITANA;56980;2;1;0;0;0;2;1;56980;DEPILADORA SG-9004EX;PERSONAL CARE
13027465;;M;46;CHILENO;;Millenial;"";"";14990;1;1;0;0;0;1;1;14990;CORTAPELO GAMA TITANIUM T827;PERSONAL CARE
8678351;;M;63;CHILENO;;Boomers;LINARES                       ;MAULE;21990;1;1;0;0;0;1;1;21990;SECADOR DE PELO SG-3049 NEGRO;PERSONAL CARE
19207849;Casado;F;26;CHILENO;;Z;PROVIDENCIA                   ;METROPOLITANA;14990;1;1;0;0;0;1;1;14990;SECADOR DE PELO SG-3012 NEGRO;PERSONAL CARE
18224217;;F;30;CHILENO;;Millenial;LA LIGUA                      ;VALPARAISO;16990;1;1;0;0;0;1;1;16990;CORTA PELO SPORT GCX 623 BVT;PERSONAL CARE
19986612;;F;23;CHILENO;;Z;SANTIAGO                      ;METROPOLITANA;60230;3;1;0;0;0;3;1;60230;DEPILADORA SG-9004EX;PERSONAL CARE
13540531;;F;43;CHILENO;;X;RENCA                         ;METROPOLITANA;10990;1;1;0;0;0;1;1;10990;SECADOR GAMA EOLIC MINI TRAVEL;PERSONAL CARE
11154680;;F;55;CHILENO;;Boomers;PUENTE ALTO                   ;METROPOLITANA;15990;1;1;0;0;0;1;1;15990;SECADOR DIAMOND STD;PERSONAL CARE
14076598;;M;40;CHILENO;;X;RENCA                         ;METROPOLITANA;24990;1;1;0;0;0;1;1;24990;CORTA PELO SG-8520;PERSONAL CARE
19590809;;M;25;CHILENO;;Z;N/D;N/D;34980;2;1;2;1;34980;0;0;0;TRICOMBO SECADOR+ALISADOR+ONDULADOR;PERSONAL CARE
18571902;;M;29;CHILENO;;Millenial;TALCA                         ;MAULE;14990;1;1;0;0;0;1;1;14990;CORTAPELO GAMA TITANIUM T827;PERSONAL CARE
10578025;;M;51;CHILENO;;X;RIO HURTADO                   ;COQUIMBO;236960;4;3;0;0;0;4;3;236960;AFEITADORA SPORT;PERSONAL CARE
14376650;;F;45;CHILENO;;X;N/D;N/D;24990;1;1;0;0;0;1;1;24990;SECADOR DE PELO SE-3049C01 FUCSIA;PERSONAL CARE
12530094;;F;49;CHILENO;;X;CORONEL                       ;BIO BIO;73970;3;1;0;0;0;3;1;73970;TRICOMBO SECADOR+ALISADOR+ONDULADOR;PERSONAL CARE
15421373;;F;40;CHILENO;;X;PUENTE ALTO                   ;METROPOLITANA;109980;2;2;0;0;0;2;2;109980;DEPILADORA IPL MAGNA PK;PERSONAL CARE
14164672;;F;40;CHILENO;;X;"";"";40230;3;2;0;0;0;3;2;40230;SECADOR DE PELO DIVA NEGRO;PERSONAL CARE
10854870;;F;55;CHILENO;;Boomers;PROVIDENCIA                   ;METROPOLITANA;23990;1;1;0;0;0;1;1;23990;SECADOR TEMPO TITAN KERATIN;PERSONAL CARE
14262227;;F;48;CHILENO;;X;SANTA CRUZ                    ;L.G.B.OÂ´HIGGINS;44990;1;1;0;0;0;1;1;44990;ALISADOR DE PELO S12A(220) Shine Therapy PALTA M;PERSONAL CARE
18819134;;M;27;CHILENO;;Millenial;N/D;N/D;39980;2;1;0;0;0;2;1;39980;CORTA PELO SG-8410;PERSONAL CARE
18443405;Soltero;F;29;CHILENO;;Silencioso;PROVIDENCIA                   ;METROPOLITANA;29990;1;1;0;0;0;1;1;29990;TRICOMBO SECADOR+ALISADOR+ONDULADOR;PERSONAL CARE
17619016;;F;29;CHILENO;;Millenial;CALERA                        ;VALPARAISO;324960;4;3;0;0;0;4;3;324960;ALISADOR REMIG. WET2 S27A (BV) R;PERSONAL CARE
18670970;;F;28;CHILENO;;Millenial;N/D;N/D;226970;3;3;2;2;176980;1;1;49990;ALISADOR DE PELO S12A(220) Shine Therapy PALTA M;PERSONAL CARE
18748981;;M;28;CHILENO;;Millenial;CHEPICA                       ;L.G.B.OÂ´HIGGINS;14990;1;1;0;0;0;1;1;14990;CORTAPELO GAMA TITANIUM T827;PERSONAL CARE
18347577;Soltero;F;29;CHILENO;;Millenial;TALAGANTE                     ;METROPOLITANA;45140;2;1;0;0;0;2;1;45140;DEPILADORA OASIS SENSATION;PERSONAL CARE
15065104;;M;39;CHILENO;;X;PROVIDENCIA                   ;METROPOLITANA;29990;1;1;0;0;0;1;1;29990;TRICOMBO SECADOR+ALISADOR+ONDULADOR;PERSONAL CARE
15635670;;F;38;CHILENO;;X;"";"";77970;3;1;0;0;0;3;1;77970;ALISADOR DE PELO SG-3540 MORADO MORADO;PERSONAL CARE
16425965;;F;35;CHILENO;;Millenial;"";"";-17990;-1;3;0;2;0;-1;1;-17990;ALISADOR DE PELO SG-3512D1 ROSA;PERSONAL CARE
15040191;;M;40;CHILENO;;X;RENCA                         ;METROPOLITANA;39980;2;2;0;0;0;2;2;39980;SECADOR GAMA BORA KERATION;PERSONAL CARE
17284439;Soltero;M;32;CHILENO;;Millenial;PROVIDENCIA                   ;METROPOLITANA;12990;1;1;0;0;0;1;1;12990;SECADOR DE PELO SG-3012 NEGRO;PERSONAL CARE
18010553;;F;30;CHILENO;;Millenial;N/D;N/D;164980;2;2;0;0;0;2;2;164980;DEPILADORA OASIS SENSATION;PERSONAL CARE
18135210;;M;31;CHILENO;;Millenial;LOTA                          ;BIO BIO;26990;1;1;0;0;0;1;1;26990;ALISADOR +SECADOR PELO;PERSONAL CARE
12821268;;M;46;CHILENO;;X;SANTIAGO                      ;METROPOLITANA;34990;1;1;0;0;0;1;1;34990;TRICOMBO SECADOR+ALISADOR+ONDULADOR;PERSONAL CARE
14413904;;F;47;CHILENO;;X;SAN FELIPE                    ;VALPARAISO;51980;2;4;0;0;0;2;4;51980;SECADOR DE PELO SE-3049C01 FUCSIA;PERSONAL CARE
14528704;;F;48;CHILENO;;X;VINA DEL MAR                  ;VALPARAISO;18990;1;1;0;0;0;1;1;18990;SECADOR GAMA BORA KERATION;PERSONAL CARE
12801896;;F;46;CHILENO;;X;PROVIDENCIA                   ;METROPOLITANA;312961;5;3;1;1;119990;4;2;192971;DEPILADORA SG-9004EX;PERSONAL CARE
16776292;;F;34;CHILENO;;Millenial;VINA DEL MAR;VALPARAISO;204970;3;2;2;1;189980;1;1;14990;ONDULADOR GAMA 33MM TURMALINA;PERSONAL CARE
20172942;;F;23;CHILENO;;Z;TALCA                         ;MAULE;34990;1;3;0;0;0;1;3;34990;COMBO GAMA SECADOR+ALISADOR+CEPILLO;PERSONAL CARE
15795354;;F;38;CHILENO;;Millenial;N/D;N/D;39990;1;1;0;0;0;1;1;39990;ALISADOR DE PELO SG-3540 MORADO MORADO;PERSONAL CARE
8206458;;M;59;CHILENO;;Boomers;TEMUCO                        ;ARAUCANIA;29990;1;1;0;0;0;1;1;29990;CORTA PELO SG-8520;PERSONAL CARE
18068935;;F;30;CHILENO;;Millenial;PROVIDENCIA                   ;METROPOLITANA;27990;1;1;0;0;0;1;1;27990;ALISADOR DE PELO S6300 GRIS;PERSONAL CARE
17062285;;F;35;CHILENO;;Millenial;PROVIDENCIA                   ;METROPOLITANA;39990;1;1;0;0;0;1;1;39990;ALISADOR ELEGANCE W L IT 3D BLUE BVT;PERSONAL CARE
18028336;Casado;M;29;CHILENO;INGENIERIA EN MAQUINARIA VEHICULOS AUTOMOTRICES Y SISTEMAS ELECTRONICOS;Millenial;PROVIDENCIA                   ;METROPOLITANA;24990;1;1;0;0;0;1;1;24990;ALISADOR ELEGANCE LED BLOOM VT;PERSONAL CARE
7918509;;F;61;CHILENO;;Boomers;LOS ALAMOS                    ;BIO BIO;14990;1;1;0;0;0;1;1;14990;SECADOR DE PELO SG-3012 NEGRO;PERSONAL CARE
9715247;;M;58;CHILENO;;Boomers;RENCA                         ;METROPOLITANA;14990;1;1;0;0;0;1;1;14990;ONDULADOR GAMA 33MM TURMALINA;PERSONAL CARE
17954456;Soltero;M;31;CHILENO;;Millenial;RENCA                         ;METROPOLITANA;23990;1;1;0;0;0;1;1;23990;SECADOR DE PELO SE-3049C01 FUCSIA;PERSONAL CARE
7447628;;F;69;CHILENO;;Silencioso;N/D;N/D;46883;2;2;0;0;0;2;2;46883;AFEITADORA SH 887 WD BAT;PERSONAL CARE
15104216;;F;40;CHILENO;;X;RANCAGUA                      ;L.G.B.OÂ´HIGGINS;63530;3;1;3;1;63530;0;0;0;ALISADOR DE PELO I X-WIDE ST TITAN KERATIN GRIS;PERSONAL CARE
10151538;;F;57;CHILENO;;Boomers;RENCA                         ;METROPOLITANA;21990;1;1;0;0;0;1;1;21990;SECADOR TEMPO TITAN KERATIN;PERSONAL CARE
10420387;;M;57;CHILENO;;Boomers;SALAMANCA                     ;COQUIMBO;29980;2;1;0;0;0;2;1;29980;DEPILADORA BRE225/00;PERSONAL CARE
19826918;;F;24;CHILENO;;Z;RENCA                         ;METROPOLITANA;17990;1;1;0;0;0;1;1;17990;AFEITADORA SPORT;PERSONAL CARE
9396648;;F;61;CHILENO;;Boomers;SAN IGNACIO                   ;BIO BIO;137850;4;3;0;0;0;4;3;137850;ALISADOR +SECADOR PELO;PERSONAL CARE
19161204;Soltero;F;27;CHILENO;TECNICO DE NIVEL SUPERIOR EN ENFERMERIA GINECOOBSTETRICA Y NEONATAL;Z;PROVIDENCIA                   ;METROPOLITANA;24990;1;1;1;1;24990;0;0;0;AFEITADORA QP2521/50 ONE BLADE GRAFITO;PERSONAL CARE
9813320;;F;56;CHILENO;;Boomers;VALLENAR;ATACAMA;38990;1;1;0;0;0;1;1;38990;DEPILADORA BRE255/00;PERSONAL CARE
8367027;;F;61;CHILENO;;Boomers;ANGOL                         ;ARAUCANIA;77970;3;1;0;0;0;3;1;77970;AFEITADORA QP2521/50 ONE BLADE GRAFITO;PERSONAL CARE
6255574;;F;68;CHILENO;;Silencioso;PROVIDENCIA                   ;METROPOLITANA;23990;1;1;0;0;0;1;1;23990;SECADOR DE PELO SE-3049C01 FUCSIA;PERSONAL CARE
10011852;;F;59;CHILENO;;Boomers;CASTRO                        ;LOS LAGOS;10990;1;1;0;0;0;1;1;10990;SECADOR DE PELO SG-3012 NEGRO;PERSONAL CARE
9583147;;M;56;CHILENO;;Boomers;"";"";14990;1;1;0;0;0;1;1;14990;CORTAPELO GAMA TITANIUM T827;PERSONAL CARE
13627652;;F;43;CHILENO;;X;NACIMIENTO                    ;BIO BIO;80970;3;2;0;0;0;3;2;80970;DEPILADORA BRE285/00 CONVENCIONAL;PERSONAL CARE
10007594;;F;50;CHILENO;;X;PROVIDENCIA                   ;METROPOLITANA;24990;1;1;0;0;0;1;1;24990;ALISADOR DE PELO SG-3512D1 ROSA;PERSONAL CARE
24341392;;F;34;BOLIVIANO;;Extranjero;CALAMA                        ;ANTOFAGASTA;31992;1;1;0;0;0;1;1;31992;ALISADOR DE PELO I X-WIDE ST TITAN KERATIN GRIS;PERSONAL CARE
18711276;;M;27;CHILENO;;Millenial;COPIAPO                       ;ATACAMA;239970;3;3;0;0;0;3;3;239970;DEPILADORA IPL MAGNA PK;PERSONAL CARE
20114391;;F;22;CHILENO;;Z;N/D;N/D;40280;4;1;0;0;0;4;1;40280;CORTA PELO SG-8520;PERSONAL CARE
9313427;Casado;M;59;CHILENO;;Boomers;RENCA                         ;METROPOLITANA;20990;1;1;0;0;0;1;1;20990;CORTA PELO SG-8410;PERSONAL CARE
10145248;;F;57;CHILENO;;Boomers;COIHAIQUE                     ;AYSEN;34990;1;1;0;0;0;1;1;34990;ALISADOR DE PELO S12A(220) Shine Therapy PALTA M;PERSONAL CARE
11159775;;F;55;CHILENO;;Boomers;N/D;N/D;39990;1;1;0;0;0;1;1;39990;ALISADOR DE PELO S12A(220) Shine Therapy PALTA M;PERSONAL CARE
10270266;;F;56;CHILENO;;Boomers;OVALLE                        ;COQUIMBO;405970;3;2;0;0;0;3;2;405970;ALISADOR AQUA THERAPY LED;PERSONAL CARE
17900388;;F;30;CHILENO;;Millenial;PROVIDENCIA                   ;METROPOLITANA;34990;1;1;1;1;34990;0;0;0;ALISADOR DE PELO S12A(220) Shine Therapy PALTA M;PERSONAL CARE
9781495;;F;58;CHILENO;;Boomers;PARRAL                        ;MAULE;54990;1;1;0;0;0;1;1;54990;ALISADOR DE PELO SG-4651 ROJO;PERSONAL CARE
10278810;;F;58;CHILENO;;Boomers;PROVIDENCIA                   ;METROPOLITANA;31990;1;1;0;0;0;1;1;31990;DEPILADORA OASIS LOOK BVT;PERSONAL CARE
13902987;;F;42;CHILENO;;X;PROVIDENCIA                   ;METROPOLITANA;36970;3;1;0;0;0;3;1;36970;ALISADOR DE PELO SG-3510 FUCSIA;PERSONAL CARE
13001951;;F;45;CHILENO;;X;QUINCHAO                      ;LOS LAGOS;15990;1;1;0;0;0;1;1;15990;ONDULADOR GAMA 33MM TURMALINA;PERSONAL CARE
8411016;;M;64;CHILENO;;Boomers;CASTRO                        ;LOS LAGOS;27980;2;1;0;0;0;2;1;27980;AFEITADORA SPORT;PERSONAL CARE
15930469;;M;36;CHILENO;;Millenial;PROVIDENCIA                   ;METROPOLITANA;35980;2;2;1;1;16990;1;1;18990;CORTABARBA BT3206;PERSONAL CARE
13571377;;F;43;CHILENO;;X;RENCA                         ;METROPOLITANA;65980;2;1;0;0;0;2;1;65980;COMBO SIEGEN AFEITADORA + MULTISTYLER SG-8440;PERSONAL CARE
11964932;;F;50;CHILENO;;X;N/D;N/D;86970;3;1;0;0;0;3;1;86970;COMBO GAMA SECADOR+ALISADOR+CEPILLO;PERSONAL CARE
11363054;Soltero;M;53;CHILENO;;X;BUIN                          ;METROPOLITANA;29980;2;2;0;0;0;2;2;29980;AFEITADORA SPORT;PERSONAL CARE
17365276;Soltero;F;32;CHILENO;TECNICO DE NIVEL SUPERIOR EN PODOLOGIA;Millenial;PROVIDENCIA                   ;METROPOLITANA;55980;2;2;0;0;0;2;2;55980;CORTA PELO SG-8520;PERSONAL CARE
9823186;;F;58;CHILENO;;Boomers;RENCA                         ;METROPOLITANA;32990;1;1;0;0;0;1;1;32990;CORTAPELOS GM 596;PERSONAL CARE
16348601;;F;35;CHILENO;;Millenial;LOTA                          ;BIO BIO;55980;2;1;0;0;0;2;1;55980;DEPILADORA SG-9004;PERSONAL CARE
18782148;Soltero;F;28;CHILENO;;Millenial;PROVIDENCIA                   ;METROPOLITANA;21990;1;1;0;0;0;1;1;21990;ALISADOR PHILIPS BHS376;PERSONAL CARE
17976693;Soltero;F;30;CHILENO;;Millenial;"";"";19990;1;1;0;0;0;1;1;19990;ALISADORA SIEGEN SG-3512D2;PERSONAL CARE
10718323;;M;52;CHILENO;;X;PETORCA                       ;VALPARAISO;36980;2;3;0;0;0;2;3;36980;AFEITADORA SG-7210 NEGRO;PERSONAL CARE
8416487;;F;65;CHILENO;;Boomers;RANCAGUA                      ;L.G.B.OÂ´HIGGINS;44990;1;1;0;0;0;1;1;44990;DEPILADORA 3170 BRAUN;PERSONAL CARE
5890989;Divorciado;F;70;CHILENO;;Silencioso;PEDRO AGUIRRE CERDA           ;METROPOLITANA;49990;1;1;0;0;0;1;1;49990;COMBO SIEGEN AFEITADORA + MULTISTYLER SG-8440;PERSONAL CARE
10896616;;F;57;CHILENO;;Boomers;PROVIDENCIA                   ;METROPOLITANA;24990;1;1;0;0;0;1;1;24990;ALISADOR +SECADOR PELO;PERSONAL CARE
12693446;;F;47;CHILENO;;X;RANCAGUA                      ;L.G.B.OÂ´HIGGINS;29990;1;1;0;0;0;1;1;29990;AFEITADORA S1223/41 ELECTRICA;PERSONAL CARE
16928285;;F;33;CHILENO;;Millenial;ILLAPEL                       ;COQUIMBO;29990;1;1;0;0;0;1;1;29990;AFEITADORA SG-7250 NEGRO;PERSONAL CARE
17157788;;F;37;CHILENO;;Millenial;VILLA ALEMANA                 ;VALPARAISO;44990;1;1;0;0;0;1;1;44990;DEPILADORA OASIS SENSATION;PERSONAL CARE
11917608;;F;50;CHILENO;;X;RENCA                         ;METROPOLITANA;24990;1;1;0;0;0;1;1;24990;ALISADOR ELEGANCE LED BLOOM VT;PERSONAL CARE
14176848;;F;40;CHILENO;;X;PUENTE ALTO                   ;METROPOLITANA;57960;4;2;4;2;57960;0;0;0;COMBO GAMA SECADOR+ALISADOR+CEPILLO;PERSONAL CARE
16547816;;F;35;CHILENO;;Millenial;PROVIDENCIA                   ;METROPOLITANA;17990;1;1;0;0;0;1;1;17990;AFEITADORA SPORT;PERSONAL CARE
10276509;;F;59;CHILENO;;Boomers;LINARES                       ;MAULE;44990;1;1;0;0;0;1;1;44990;DEPILADORA OASIS SENSATION;PERSONAL CARE
13364069;;F;44;CHILENO;;X;RENCA                         ;METROPOLITANA;39990;1;1;1;1;39990;0;0;0;ALISADOR DE PELO S12A(220) Shine Therapy PALTA M;PERSONAL CARE
9599003;;M;59;CHILENO;;Boomers;PROVIDENCIA                   ;METROPOLITANA;23570;2;1;0;0;0;2;1;23570;CORTA PELO HC3520;PERSONAL CARE
25786441;;M;44;VENEZOLANO;;Extranjero;PUERTO MONTT                  ;LOS LAGOS;33980;2;1;0;0;0;2;1;33980;AFEITADORA SPORT;PERSONAL CARE
11142961;;F;54;CHILENO;;Boomers;RANCAGUA                      ;L.G.B.OÂ´HIGGINS;215570;10;2;0;0;0;10;2;215570;ALISADOR DE PELO SG-3540 MORADO MORADO;PERSONAL CARE
18052473;;F;30;CHILENO;;Millenial;LO ESPEJO                     ;METROPOLITANA;75740;6;2;0;0;0;6;2;75740;ALISADOR REMIG. WET2 S27A (BV) R;PERSONAL CARE
19758196;;F;24;CHILENO;;Z;SAN ANTONIO                   ;VALPARAISO;51982;2;3;0;0;0;2;3;51982;ALISADOR REMIG. WET2 S27A (BV) R;PERSONAL CARE
17972218;;F;31;CHILENO;;Millenial;N/D;N/D;102980;2;2;0;0;0;2;2;102980;SECADOR PELO SG-3012C19;PERSONAL CARE
17804690;;M;31;CHILENO;;Millenial;QUILLOTA                      ;VALPARAISO;52980;2;1;0;0;0;2;1;52980;ALISADOR DE PELO S12A(220) Shine Therapy PALTA M;PERSONAL CARE
13430989;;M;43;CHILENO;;Millenial;IQUIQUE                       ;TARAPACA;14990;1;1;0;0;0;1;1;14990;CORTAPELO GAMA TITANIUM T827;PERSONAL CARE
18619572;;F;24;CHILENO;;Z;PROVIDENCIA                   ;METROPOLITANA;31980;2;1;0;0;0;2;1;31980;SECADOR DE PELO SE-3049C01 FUCSIA;PERSONAL CARE
17334537;;F;34;CHILENO;;Millenial;TALCA                         ;MAULE;64980;2;2;0;0;0;2;2;64980;ALISADOR DE PELO SG-4651 ROJO;PERSONAL CARE
12104793;;F;42;CHILENO;;Millenial;N/D;N/D;42980;2;1;2;1;42980;0;0;0;AFEITADORA SG-7250 NEGRO;PERSONAL CARE
16295260;;F;36;CHILENO;;X;LOS ALAMOS                    ;BIO BIO;204970;3;2;0;0;0;3;2;204970;CORTAPELOS GM 596;PERSONAL CARE
16719555;;F;34;CHILENO;;Millenial;BUIN                          ;METROPOLITANA;32990;1;1;0;0;0;1;1;32990;ALISADOR ELEGANCE LED KER;PERSONAL CARE
17379746;;M;32;CHILENO;;Millenial;SANTIAGO                      ;METROPOLITANA;288970;3;2;2;1;263980;1;1;24990;SECADOR DE PELO DIVA NEGRO;PERSONAL CARE
18510953;;F;28;CHILENO;;Millenial;PROVIDENCIA                   ;METROPOLITANA;21990;1;3;0;0;0;1;3;21990;SECADOR DE PELO SG-3051;PERSONAL CARE
13390615;;M;44;CHILENO;;X;RENCA                         ;METROPOLITANA;27990;1;1;0;0;0;1;1;27990;CORTA PELO SG-8520;PERSONAL CARE
16890010;;F;31;CHILENO;;Millenial;PETORCA                       ;VALPARAISO;14990;1;1;0;0;0;1;1;14990;DEPILADORA SG-9003;PERSONAL CARE
18750611;Soltero;F;28;CHILENO;;Millenial;PROVIDENCIA                   ;METROPOLITANA;46980;2;1;0;0;0;2;1;46980;SECADOR DE PELO SG-3051;PERSONAL CARE
13935349;Casado;F;42;CHILENO;;X;RENCA                         ;METROPOLITANA;40980;2;1;2;1;40980;0;0;0;ALISADOR ELEGANCE W L IT 3D BLUE BVT;PERSONAL CARE
10080511;Soltero;F;56;CHILENO;;Boomers;RENCA                         ;METROPOLITANA;9990;1;1;0;0;0;1;1;9990;CORTA PELO SG-8200;PERSONAL CARE
17565129;;M;32;CHILENO;;Millenial;LA GRANJA                     ;METROPOLITANA;9990;1;1;0;0;0;1;1;9990;SECADOR GAMA EOLIC MINI TRAVEL;PERSONAL CARE
18476095;Soltero;F;28;CHILENO;ABOGADO;Millenial;PROVIDENCIA                   ;METROPOLITANA;34990;1;1;0;0;0;1;1;34990;SECADOR DE PELO SG-3051;PERSONAL CARE
16552724;;F;35;CHILENO;;Millenial;LLAILLAY                      ;VALPARAISO;24990;1;1;0;0;0;1;1;24990;SPA PARA PIES SG-1560;PERSONAL CARE
18947626;;F;27;CHILENO;;Millenial;N/D;N/D;39990;1;1;0;0;0;1;1;39990;TRICOMBO SECADOR+ALISADOR+ONDULADOR;PERSONAL CARE
15501177;Soltero;M;39;CHILENO;PSICOLOGO;X;RENCA                         ;METROPOLITANA;34990;1;1;0;0;0;1;1;34990;ALISADOR DE PELO SG-3540 MORADO MORADO;PERSONAL CARE
7372401;;M;68;CHILENO;;Boomers;LOS ANGELES                   ;BIO BIO;182860;3;2;0;0;0;3;2;182860;CORTA PELO SG-8520;PERSONAL CARE
14183789;;F;41;CHILENO;;X;PROVIDENCIA                   ;METROPOLITANA;18980;2;1;2;1;18980;0;0;0;Depiladora E SkinPro Go Bvt;PERSONAL CARE
12526924;Casado;F;49;CHILENO;;X;RENCA                         ;METROPOLITANA;16990;1;1;0;0;0;1;1;16990;AFEITADORA SG-7210 NEGRO;PERSONAL CARE
10411079;Casado;F;57;CHILENO;;Boomers;PROVIDENCIA                   ;METROPOLITANA;29990;1;1;0;0;0;1;1;29990;COMBO GAMA SECADOR+ALISADOR+CEPILLO;PERSONAL CARE
10296749;;M;51;CHILENO;;Millenial;"";"";16990;1;1;1;1;16990;0;0;0;KIT CORTABARBA MG3711;PERSONAL CARE
16929047;;M;33;CHILENO;;Millenial;PROVIDENCIA                   ;METROPOLITANA;193980;2;1;2;1;193980;0;0;0;DEPILADORA BRI920/00 IPL LUMEA ADVANCE;PERSONAL CARE
9995300;Casado;F;43;CHILENO;;X;CASTRO                        ;LOS LAGOS;10990;1;1;0;0;0;1;1;10990;SECADOR DE PELO SG-3012 NEGRO;PERSONAL CARE
8272024;;F;64;CHILENO;;Boomers;RENCA                         ;METROPOLITANA;85480;2;1;2;1;85480;0;0;0;DEPILADORA IPL Verina Bvt;PERSONAL CARE
17804197;;F;30;CHILENO;;Millenial;PROVIDENCIA                   ;METROPOLITANA;-24990;-1;1;0;0;0;-1;1;-24990;SECADOR DE PELO DIVA NEGRO;PERSONAL CARE
5652640;;M;71;CHILENO;;Extranjero;LA SERENA                     ;COQUIMBO;13990;1;1;0;0;0;1;1;13990;SECADOR DE PELO MISTRAL STD;PERSONAL CARE
15733032;;F;38;CHILENO;;Millenial;PAINE                         ;METROPOLITANA;69980;2;1;0;0;0;2;1;69980;DEPILADORA SG-9040;PERSONAL CARE
12436848;;F;48;CHILENO;;X;N/D;N/D;44990;1;1;0;0;0;1;1;44990;ALISADOR DE PELO S12A(220) Shine Therapy PALTA M;PERSONAL CARE
7180768;;F;70;CHILENO;;Silencioso;COIHAIQUE                     ;AYSEN;16990;1;1;0;0;0;1;1;16990;Secador de Pelo 3000 Series Philips BHD302/00;PERSONAL CARE
15015539;;F;39;CHILENO;;X;N/D;N/D;69970;3;2;0;0;0;3;2;69970;AFEITADORA SG-7210 NEGRO;PERSONAL CARE
13403188;;F;43;CHILENO;;X;RENCA                         ;METROPOLITANA;79981;3;2;0;0;0;3;2;79981;ONDULADOR SIEGEN SG-2352;PERSONAL CARE
11052435;Casado;M;56;CHILENO;AGRONOMO;Silencioso;PROVIDENCIA                   ;METROPOLITANA;12990;1;1;0;0;0;1;1;12990;SECADOR DIAMOND STD;PERSONAL CARE
17236182;;M;32;CHILENO;;Millenial;SALAMANCA                     ;COQUIMBO;259960;4;2;2;1;239980;2;1;19980;SECADOR GAMA EOLIC MINI TRAVEL;PERSONAL CARE
17425984;;M;32;CHILENO;;Millenial;PROVIDENCIA                   ;METROPOLITANA;42980;2;2;0;0;0;2;2;42980;CORTA PELO SG-8520;PERSONAL CARE
5029236;;M;77;CHILENO;;Silencioso;PROVIDENCIA                   ;METROPOLITANA;29990;1;1;0;0;0;1;1;29990;AFEITADORA SG-7250 NEGRO;PERSONAL CARE
7097058;;M;68;CHILENO;;Boomers;N/D;N/D;59980;2;2;1;1;24990;1;1;34990;COMBO SIEGEN AFEITADORA + MULTISTYLER SG-8440;PERSONAL CARE
16464868;Soltero;M;35;CHILENO;;Millenial;PROVIDENCIA                   ;METROPOLITANA;24990;1;1;0;0;0;1;1;24990;DEPILADORA SG-9004;PERSONAL CARE
10151758;;M;56;CHILENO;;Boomers;RENCA                         ;METROPOLITANA;29990;1;1;0;0;0;1;1;29990;AFEITADORA SG-7250 NEGRO;PERSONAL CARE
10475712;;F;57;CHILENO;;Boomers;ARICA                         ;TARAPACA;27980;2;1;0;0;0;2;1;27980;ALISADORA SIEGEN SG-3512D2;PERSONAL CARE
6809674;;F;68;CHILENO;;Boomers;RENCA                         ;METROPOLITANA;23570;2;1;0;0;0;2;1;23570;ALISADOR GAMA BELLA SHINE;PERSONAL CARE
6149707;;M;71;CHILENO;;Silencioso;SAN BERNARDO                  ;METROPOLITANA;239970;3;2;2;1;209980;1;1;29990;AFEITADORA SG-7250 NEGRO;PERSONAL CARE
15372904;Soltero;F;40;CHILENO;PROFESOR;X;RENCA                         ;METROPOLITANA;21990;1;1;0;0;0;1;1;21990;ALISADOR DE PELO HP8321;PERSONAL CARE
9003524;;F;53;CHILENO;;Silencioso;PROVIDENCIA                   ;METROPOLITANA;18990;1;1;0;0;0;1;1;18990;SECADOR DE PELO DIVA NEGRO;PERSONAL CARE
20454254;;F;21;CHILENO;;Silencioso;PROVIDENCIA                   ;METROPOLITANA;9990;1;1;0;0;0;1;1;9990;Trimmer Gama GT 527;PERSONAL CARE
17569289;;F;31;CHILENO;;Millenial;PROVIDENCIA                   ;METROPOLITANA;21990;1;1;0;0;0;1;1;21990;SECADOR TEMPO TITAN KERATIN;PERSONAL CARE
18014474;;M;30;CHILENO;;Millenial;PROVIDENCIA                   ;METROPOLITANA;18990;1;1;1;1;18990;0;0;0;SECADOR DE PELO DIVA NEGRO;PERSONAL CARE
9384383;;F;58;CHILENO;;Boomers;RENCA                         ;METROPOLITANA;143970;3;2;2;1;133980;1;1;9990;SECADOR GAMA EOLIC MINI TRAVEL;PERSONAL CARE
19395563;;F;25;CHILENO;;Z;N/D;N/D;154980;2;1;2;1;154980;0;0;0;DEPILADORA BRI920/00 IPL LUMEA ADVANCE;PERSONAL CARE
18772901;;F;27;CHILENO;;Millenial;PROVIDENCIA                   ;METROPOLITANA;24990;1;1;0;0;0;1;1;24990;ALISADOR +SECADOR PELO;PERSONAL CARE
15147337;;F;37;CHILENO;;Millenial;N/D;N/D;19990;1;1;0;0;0;1;1;19990;SECADOR DE PELO SG-3043 DC CAFE 2200 WATTS;PERSONAL CARE
17776245;;F;31;CHILENO;;Silencioso;PROVIDENCIA                   ;METROPOLITANA;19990;1;1;0;0;0;1;1;19990;SECADOR DE PELO SG-3043 DC CAFE 2200 WATTS;PERSONAL CARE
15051490;;F;40;CHILENO;;X;PROVIDENCIA                   ;METROPOLITANA;14990;1;1;0;0;0;1;1;14990;SECADOR DIAMOND STD;PERSONAL CARE
15049354;;F;32;CHILENO;;Millenial;PROVIDENCIA                   ;METROPOLITANA;14990;1;1;0;0;0;1;1;14990;SECADOR DE PELO MISTRAL STD;PERSONAL CARE
17802542;;M;31;CHILENO;;Silencioso;PROVIDENCIA                   ;METROPOLITANA;38980;2;1;2;1;38980;0;0;0;MULTIGROOM MG5730 SERIE 5000;PERSONAL CARE
11504790;;F;53;CHILENO;;X;RENCA                         ;METROPOLITANA;15990;1;1;0;0;0;1;1;15990;SECADOR DE PELO MISTRAL STD;PERSONAL CARE
17276058;Soltero;M;32;CHILENO;;Millenial;ILLAPEL                       ;COQUIMBO;39670;2;1;0;0;0;2;1;39670;CORTAPELOS GM 596;PERSONAL CARE
20097523;;M;23;CHILENO;;Silencioso;PROVIDENCIA                   ;METROPOLITANA;29990;1;1;1;1;29990;0;0;0;TRICOMBO SECADOR+ALISADOR+ONDULADOR;PERSONAL CARE
19138868;Soltero;M;25;CHILENO;;Z;PROVIDENCIA                   ;METROPOLITANA;40670;2;1;0;0;0;2;1;40670;TRICOMBO SECADOR+ALISADOR+ONDULADOR;PERSONAL CARE
19997967;;F;24;CHILENO;;Silencioso;PROVIDENCIA                   ;METROPOLITANA;24990;1;1;0;0;0;1;1;24990;ALISADOR ELEGANCE LED BLOOM VT;PERSONAL CARE
12981856;;F;46;CHILENO;;X;LOS ANGELES                   ;BIO BIO;24990;1;1;0;0;0;1;1;24990;SECADOR DE PELO DIVA NEGRO;PERSONAL CARE
16974197;;F;34;CHILENO;;Millenial;N/D;N/D;54980;2;1;0;0;0;2;1;54980;ALISADOR REMIG. WET2 S27A (BV) R;PERSONAL CARE
7925384;;F;64;CHILENO;;Boomers;CHIMBARONGO                   ;L.G.B.OÂ´HIGGINS;23990;1;1;0;0;0;1;1;23990;SECADOR DE PELO SE-3049C01 FUCSIA;PERSONAL CARE
14563072;Casado;M;45;CHILENO;;X;PROVIDENCIA                   ;METROPOLITANA;29990;1;1;0;0;0;1;1;29990;AFEITADORA SPORT SH 886 BAT;PERSONAL CARE
8447860;;F;49;CHILENO;;X;PANGUIPULLI                   ;LOS RIOS;27990;1;1;0;0;0;1;1;27990;ALISADOR DE PELO S6300 GRIS;PERSONAL CARE
16815859;;M;34;CHILENO;;Millenial;SAN FABIAN                    ;BIO BIO;31990;1;1;0;0;0;1;1;31990;AFEITADORA SG-7250 NEGRO;PERSONAL CARE
5646039;;F;74;CHILENO;;Silencioso;ARICA                         ;TARAPACA;40670;2;1;0;0;0;2;1;40670;AFEITADORA SG-7250 NEGRO;PERSONAL CARE
18651478;;F;27;CHILENO;;Millenial;CABILDO                       ;VALPARAISO;15990;1;1;0;0;0;1;1;15990;CORTA PELO GM 562;PERSONAL CARE
19060181;;F;25;CHILENO;;Z;PROVIDENCIA                   ;METROPOLITANA;24990;1;1;0;0;0;1;1;24990;SECADOR DE PELO DIVA NEGRO;PERSONAL CARE
20009667;;F;24;CHILENO;;Z;PROVIDENCIA                   ;METROPOLITANA;54990;1;1;0;0;0;1;1;54990;ALISADOR DE PELO S12A(220) Shine Therapy PALTA M;PERSONAL CARE
11663704;;F;52;CHILENO;;X;LA PINTANA                    ;METROPOLITANA;14990;1;1;0;0;0;1;1;14990;CORTA PELO GM 562;PERSONAL CARE
10924476;;F;55;CHILENO;;Boomers;CASTRO                        ;LOS LAGOS;23990;1;1;0;0;0;1;1;23990;SECADOR TEMPO TITAN KERATIN;PERSONAL CARE
19876131;;M;23;CHILENO;;Z;N/D;N/D;14990;1;1;0;0;0;1;1;14990;CORTA PELO GM 562;PERSONAL CARE
18721257;;F;27;CHILENO;;Millenial;PROVIDENCIA                   ;METROPOLITANA;0;0;0;0;0;0;0;0;0;ALISADOR DE PELO SG-3540 MORADO MORADO;PERSONAL CARE
9056446;;M;57;CHILENO;;Silencioso;PROVIDENCIA                   ;METROPOLITANA;0;0;0;0;0;0;0;0;0;AFEITADORA S1323/41 ELECTRICA;PERSONAL CARE
16676967;;F;35;CHILENO;;Millenial;VILLA ALEMANA                 ;VALPARAISO;0;0;0;0;0;0;0;0;0;CORTA PELO HC3505;PERSONAL CARE
10768895;;F;41;CHILENO;;X;COLINA                        ;METROPOLITANA;0;0;0;0;0;0;0;0;0;ALISADOR DE PELO HP8321;PERSONAL CARE
16045693;;F;36;CHILENO;;X;PROVIDENCIA                   ;METROPOLITANA;0;0;0;0;0;0;0;0;0;SECADOR DE PELO SIEGEN SG-3049C02;PERSONAL CARE
16591524;;F;35;CHILENO;;Millenial;ILLAPEL                       ;COQUIMBO;0;0;0;0;0;0;0;0;0;DEPILADORA OASIS SENSATION;PERSONAL CARE
12900340;;F;46;CHILENO;;Silencioso;PROVIDENCIA                   ;METROPOLITANA;0;0;0;0;0;0;0;0;0;SECADOR DE PELO SG-3051;PERSONAL CARE
13375308;Casado;F;44;CHILENO;;X;SAN CARLOS                    ;BIO BIO;0;0;0;0;0;0;0;0;0;ALISADOR +SECADOR PELO;PERSONAL CARE
8509128;;F;64;CHILENO;;Boomers;PROVIDENCIA                   ;METROPOLITANA;0;0;0;0;0;0;0;0;0;PACK AFEITADORA S1223/41+CORTA PELO HC3505/15;PERSONAL CARE
16733082;;F;34;CHILENO;;Millenial;N/D;N/D;0;0;0;0;0;0;0;0;0;SECADOR DE PELO SG-3025 SILVER;PERSONAL CARE
14496755;;M;46;CHILENO;;X;CANETE                        ;BIO BIO;0;0;0;0;0;0;0;0;0;AFEITADORA SH 887 WD BAT;PERSONAL CARE
19128817;;F;26;CHILENO;;Z;PROVIDENCIA                   ;METROPOLITANA;0;0;0;0;0;0;0;0;0;Trimmer Gama GT 527;PERSONAL CARE
11386021;Soltero;M;53;CHILENO;;X;RENCA                         ;METROPOLITANA;0;0;0;0;0;0;0;0;0;SECADOR DE PELO SIEGEN SG-3049C02;PERSONAL CARE
9892420;;F;58;CHILENO;;Boomers;RENCA                         ;METROPOLITANA;0;0;0;0;0;0;0;0;0;AFEITADORA S1121/41 ELECTRICA;PERSONAL CARE
7858963;;M;65;CHILENO;;Boomers;CURACAVI                      ;METROPOLITANA;0;0;0;0;0;0;0;0;0;AFEITADORA SPORT SH 886 BAT;PERSONAL CARE
20269605;;F;22;CHILENO;;Silencioso;CURICO                        ;MAULE;0;0;0;0;0;0;0;0;0;ALISADOR SG3510C09 MORADO PLACAS DE CERAMICA 21;PERSONAL CARE
17583554;Soltero;F;31;CHILENO;TECNICO EN ENFERMERIA DE NIVEL SUPERIOR;Millenial;PROVIDENCIA                   ;METROPOLITANA;0;0;0;0;0;0;0;0;0;ALISADOR DE PELO SG-3540 MORADO MORADO;PERSONAL CARE
19553323;;F;25;CHILENO;;Z;PROVIDENCIA                   ;METROPOLITANA;0;0;0;0;0;0;0;0;0;SECADOR DE PELO DIVA NEGRO;PERSONAL CARE
12739748;;F;51;CHILENO;;X;GALVARINO                     ;ARAUCANIA;0;0;0;0;0;0;0;0;0;SECADOR DE PELO SIEGEN SG-3049C02;PERSONAL CARE
13129924;;F;47;CHILENO;;X;CHILLAN                       ;BIO BIO;0;0;0;0;0;0;0;0;0;ALISADOR DE PELO SG-3540 MORADO MORADO;PERSONAL CARE
10008113;;F;57;CHILENO;;Boomers;MELIPILLA                     ;METROPOLITANA;0;0;0;0;0;0;0;0;0;ALISADORA SG-3510C02 MORADO;PERSONAL CARE
19010342;;F;27;CHILENO;;Z;PROVIDENCIA                   ;METROPOLITANA;0;0;0;0;0;0;0;0;0;SECADOR PELO SG-3012C19;PERSONAL CARE
8444767;;F;64;CHILENO;;Boomers;COIHAIQUE                     ;AYSEN;0;0;0;0;0;0;0;0;0;AFEITADORA SPORT SH 886 BAT;PERSONAL CARE
18979024;;M;31;CHILENO;;Millenial;TOME                          ;BIO BIO;0;0;0;0;0;0;0;0;0;ALISADOR SIEGEN SG-4716;PERSONAL CARE
13170812;;M;44;CHILENO;;X;PROVIDENCIA                   ;METROPOLITANA;0;0;0;0;0;0;0;0;0;CORTA PELO HC3505;PERSONAL CARE
12547757;;F;47;CHILENO;;X;SAN CARLOS                    ;BIO BIO;0;0;0;0;0;0;0;0;0;ALISADOR DE PELO S12A(220) Shine Therapy PALTA M;PERSONAL CARE
20340501;;F;25;CHILENO;;Z;N/D;N/D;0;0;0;0;0;0;0;0;0;AFEITADORA QP2521/50 ONE BLADE GRAFITO;PERSONAL CARE
18558601;;M;28;CHILENO;;Millenial;MALLOA                        ;L.G.B.OÂ´HIGGINS;0;0;0;0;0;0;0;0;0;SECADOR DE PELO MISTRAL STD;PERSONAL CARE
14022772;;M;45;CHILENO;;X;RENCA                         ;METROPOLITANA;0;0;0;0;0;0;0;0;0;CORTA PELO SG-8410;PERSONAL CARE
9853314;;F;56;CHILENO;;Boomers;COIHAIQUE                     ;AYSEN;0;0;0;0;0;0;0;0;0;CORTAPELOS GM 596;PERSONAL CARE
15685677;;M;38;CHILENO;;X;PROVIDENCIA                   ;METROPOLITANA;0;0;0;0;0;0;0;0;0;SECADOR DIAMOND STD;PERSONAL CARE
19992282;;M;24;CHILENO;;Z;PROVIDENCIA                   ;METROPOLITANA;0;0;0;0;0;0;0;0;0;TRICOMBO SECADOR+ALISADOR+ONDULADOR;PERSONAL CARE
15587060;;F;41;CHILENO;;X;EL BOSQUE                     ;METROPOLITANA;0;0;0;0;0;0;0;0;0;ALISADOR DE PELO S12A(220) Shine Therapy PALTA M;PERSONAL CARE
12500906;;M;49;CHILENO;;X;RENCA                         ;METROPOLITANA;0;0;0;0;0;0;0;0;0;SECADOR DIAMOND STD;PERSONAL CARE
23394343;;M;38;BOLIVIANO;;Extranjero;SAN JOAQUIN                   ;METROPOLITANA;0;0;0;0;0;0;0;0;0;CORTA PELO GC-615;PERSONAL CARE
18983037;Soltero;F;26;CHILENO;ENFERMERA;Z;PROVIDENCIA                   ;METROPOLITANA;0;0;0;0;0;0;0;0;0;SECADOR GAMA EOLIC MINI TRAVEL;PERSONAL CARE
15256603;;F;40;CHILENO;;X;N/D;N/D;0;0;0;0;0;0;0;0;0;DEPILADORA CYBELE IPL GOLD 200 MIL PULSACIONES;PERSONAL CARE
19914544;;F;24;CHILENO;;Silencioso;PROVIDENCIA                   ;METROPOLITANA;0;0;0;0;0;0;0;0;0;TRICOMBO SECADOR+ALISADOR+ONDULADOR;PERSONAL CARE
17638497;;M;31;CHILENO;;Millenial;N/D;N/D;0;0;0;0;0;0;0;0;0;Trimmer Gama GT 527;PERSONAL CARE
26382083;;F;41;VENEZOLANO;;Extranjero;PENAFLOR                      ;METROPOLITANA;0;0;0;0;0;0;0;0;0;ALISADOR DE PELO S12A(220) Shine Therapy PALTA M;PERSONAL CARE
18477449;Soltero;F;28;CHILENO;;Millenial;PROVIDENCIA                   ;METROPOLITANA;0;0;0;0;0;0;0;0;0;AFEITADORA SG-7250 NEGRO;PERSONAL CARE
7878284;;F;65;CHILENO;;Boomers;PUENTE ALTO                   ;METROPOLITANA;0;0;0;0;0;0;0;0;0;SECADOR DE PELO SG-3025 SILVER;PERSONAL CARE
15434978;Casado;M;40;CHILENO;MEDICO CIRUJANO;X;PROVIDENCIA                   ;METROPOLITANA;0;0;0;0;0;0;0;0;0;SECADOR DE PELO SG-3049 NEGRO;PERSONAL CARE
16878739;;F;33;CHILENO;;Millenial;PROVIDENCIA                   ;METROPOLITANA;0;0;0;0;0;0;0;0;0;SECADOR PELO SG-3012C20;PERSONAL CARE
14386611;;M;44;CHILENO;;X;RENCA                         ;METROPOLITANA;0;0;0;0;0;0;0;0;0;AFEITADORA SG-7250 NEGRO;PERSONAL CARE
13859040;;F;42;CHILENO;;X;CHILLAN                       ;BIO BIO;0;0;0;0;0;0;0;0;0;ALISADOR SIEGEN SG-4716;PERSONAL CARE
14126314;;F;41;CHILENO;;X;N/D;N/D;0;0;0;0;0;0;0;0;0;DEPILADORA BRE225/00;PERSONAL CARE
19389048;Soltero;F;26;CHILENO;;Z;PROVIDENCIA                   ;METROPOLITANA;0;0;0;0;0;0;0;0;0;DEPILADORA SG-9004EX;PERSONAL CARE
19990232;;F;24;CHILENO;;Z;PROVIDENCIA                   ;METROPOLITANA;0;0;0;0;0;0;0;0;0;SECADOR DE PELO SG-3051;PERSONAL CARE
19074626;Soltero;F;26;CHILENO;PSICOLOGA;Z;PROVIDENCIA                   ;METROPOLITANA;0;0;0;0;0;0;0;0;0;ALISADOR SIEGEN SG-4716;PERSONAL CARE
7675043;;F;66;CHILENO;;Boomers;ANTOFAGASTA                   ;ANTOFAGASTA;0;0;0;0;0;0;0;0;0;SECADOR PELO SG-3012C19;PERSONAL CARE
13149554;;M;45;CHILENO;;X;LA PINTANA                    ;METROPOLITANA;0;0;0;0;0;0;0;0;0;AFEITADORA SG-7250 NEGRO;PERSONAL CARE
25049815;;F;37;PARAGUAYO;;Extranjero;ESTACION CENTRAL              ;METROPOLITANA;0;0;0;0;0;0;0;0;0;ALISADOR DE PELO SG-3540 MORADO MORADO;PERSONAL CARE
26531119;;F;28;EXTRANJERO - NO INFORMA NACIONALIDAD;;Extranjero;PROVIDENCIA                   ;METROPOLITANA;0;0;0;0;0;0;0;0;0;SECADOR PELO SG-3012C19;PERSONAL CARE
8278279;;F;61;CHILENO;;Boomers;PROVIDENCIA                   ;METROPOLITANA;0;0;0;0;0;0;0;0;0;SECADOR DE PELO SIEGEN SG-3035;PERSONAL CARE
19312804;;F;26;CHILENO;;Silencioso;N/D;N/D;0;0;0;0;0;0;0;0;0;ALISADOR +SECADOR PELO;PERSONAL CARE
18471020;;F;28;CHILENO;;Silencioso;PROVIDENCIA                   ;METROPOLITANA;0;0;0;0;0;0;0;0;0;SECADOR DE VIAJE REMINGTON D2400;PERSONAL CARE
14603296;Casado;F;41;CHILENO;;X;RENCA                         ;METROPOLITANA;0;0;0;0;0;0;0;0;0;AFEITADORA SG-7250 NEGRO;PERSONAL CARE
18510693;;F;29;CHILENO;;Millenial;PROVIDENCIA                   ;METROPOLITANA;0;0;0;0;0;0;0;0;0;SECADOR PELO SG-3012C20;PERSONAL CARE
11203922;Casado;M;54;CHILENO;;Boomers;PROVIDENCIA                   ;METROPOLITANA;0;0;0;0;0;0;0;0;0;SECADOR GAMA EOLIC MINI TRAVEL;PERSONAL CARE
20098891;;F;23;CHILENO;;Z;N/D;N/D;0;0;0;0;0;0;0;0;0;CORTA PELO GC-615;PERSONAL CARE
7979891;;M;61;CHILENO;;Boomers;VICTORIA                      ;ARAUCANIA;0;0;0;0;0;0;0;0;0;AFEITADORA SG-7250 NEGRO;PERSONAL CARE
17254336;;F;32;CHILENO;;Millenial;PROVIDENCIA                   ;METROPOLITANA;0;0;0;0;0;0;0;0;0;SECADOR DE PELO SIEGEN SG-3035;PERSONAL CARE
15102437;;M;39;CHILENO;;X;N/D;N/D;0;0;0;0;0;0;0;0;0;ALISADOR AQUA THERAPY LED;PERSONAL CARE
18485156;;M;29;CHILENO;;Millenial;TEMUCO                        ;ARAUCANIA;0;0;0;0;0;0;0;0;0;AFEITADORA PR1342 ROTATIVA RECARGABLE;PERSONAL CARE
18870199;Soltero;F;28;CHILENO;;Millenial;PROVIDENCIA                   ;METROPOLITANA;0;0;0;0;0;0;0;0;0;SECADOR DE PELO SG-3025 SILVER;PERSONAL CARE
4729882;;M;83;CHILENO;;Silencioso;CANETE                        ;BIO BIO;0;0;0;0;0;0;0;0;0;AFEITADORA XR1430 NEGRO;PERSONAL CARE
19604451;;F;24;CHILENO;;Z;N/D;N/D;0;0;0;0;0;0;0;0;0;SECADOR DE PELO D3019 PRO TITANIO;PERSONAL CARE
13610610;;F;43;CHILENO;;X;COIHAIQUE                     ;AYSEN;0;0;0;0;0;0;0;0;0;SECADOR PELO SG-3012C20;PERSONAL CARE
8232141;;F;59;CHILENO;;Boomers;PROVIDENCIA                   ;METROPOLITANA;0;0;0;0;0;0;0;0;0;SECADOR PELO SG-3012C20;PERSONAL CARE
13762922;;F;42;CHILENO;;X;PROVIDENCIA                   ;METROPOLITANA;0;0;0;0;0;0;0;0;0;AFEITADORA SG-7210 NEGRO;PERSONAL CARE
25404131;;M;37;HAITIANO;;Extranjero;N/D;N/D;0;0;0;0;0;0;0;0;0;CORTA PELO GM 562;PERSONAL CARE
14413536;;M;49;CHILENO;;X;PROVIDENCIA                   ;METROPOLITANA;0;0;0;0;0;0;0;0;0;CORTA PELO GM 562;PERSONAL CARE
19541303;;M;25;CHILENO;;Z;PROVIDENCIA                   ;METROPOLITANA;0;0;0;0;0;0;0;0;0;CORTA PELO SG-8520;PERSONAL CARE
12668629;;F;48;CHILENO;;X;EL MONTE                      ;METROPOLITANA;0;0;0;0;0;0;0;0;0;CORTA PELO SG-8200;PERSONAL CARE
19800244;;F;23;CHILENO;;Z;PROVIDENCIA                   ;METROPOLITANA;0;0;0;0;0;0;0;0;0;SECADOR DE PELO SE-3049C01 FUCSIA;PERSONAL CARE
10487277;;M;56;CHILENO;;Boomers;N/D;N/D;0;0;0;0;0;0;0;0;0;KIT CORTABARBA MG3731;PERSONAL CARE
13123994;;M;46;CHILENO;;X;COIHAIQUE                     ;AYSEN;0;0;0;0;0;0;0;0;0;AFEITADORA S1323/41 ELECTRICA;PERSONAL CARE
16205548;;M;36;CHILENO;;Millenial;N/D;N/D;0;0;0;0;0;0;0;0;0;AFEITADORA SPORT SH 886 BAT;PERSONAL CARE
13136670;;F;44;CHILENO;;X;PROVIDENCIA                   ;METROPOLITANA;0;0;0;0;0;0;0;0;0;CORTA PELO PG6025 KIT RECORTE;PERSONAL CARE
18961336;;F;27;CHILENO;;Z;N/D;N/D;0;0;0;0;0;0;0;0;0;DEPILADORA BRE225/00;PERSONAL CARE
10108821;;F;56;CHILENO;;Boomers;CURICO                        ;MAULE;0;0;0;0;0;0;0;0;0;SECADOR DE PELO D13A-220-R PLATA;PERSONAL CARE
8441414;;M;53;CHILENO;;X;QUILPUE                       ;VALPARAISO;0;0;0;0;0;0;0;0;0;CORTA PELO GM 562;PERSONAL CARE
9534172;;M;59;CHILENO;;Boomers;RENCA                         ;METROPOLITANA;0;0;0;0;0;0;0;0;0;AFEITADORA GSH930 CHI NEGRA;PERSONAL CARE
13554757;;M;43;CHILENO;;X;SAN BERNARDO                  ;METROPOLITANA;0;0;0;0;0;0;0;0;0;SECADOR DE PELO SG-3025 SILVER;PERSONAL CARE
11939303;;F;49;CHILENO;;X;N/D;N/D;0;0;0;0;0;0;0;0;0;Depiladora E SkinPro Go Bvt;PERSONAL CARE
17067364;;F;33;CHILENO;;Millenial;PROVIDENCIA                   ;METROPOLITANA;0;0;0;0;0;0;0;0;0;CORTA PELO SG-8200;PERSONAL CARE
11063255;;F;56;CHILENO;;Boomers;PUENTE ALTO                   ;METROPOLITANA;0;0;0;0;0;0;0;0;0;AFEITADORA SG-7210 NEGRO;PERSONAL CARE
18050667;;F;30;CHILENO;;Millenial;PROVIDENCIA                   ;METROPOLITANA;0;0;0;0;0;0;0;0;0;DEPILADORA EP7020A (220) DE 40 PINZAS R;PERSONAL CARE
17037201;;M;33;CHILENO;;Millenial;LA SERENA                     ;COQUIMBO;0;0;0;0;0;0;0;0;0;Afeitadora Corporal Serie 3000 Philips BG105/11;PERSONAL CARE
20308956;;F;22;CHILENO;;Silencioso;PROVIDENCIA                   ;METROPOLITANA;0;0;0;0;0;0;0;0;0;ALISADOR ELEGANCE LED KER;PERSONAL CARE
7458545;;M;65;CHILENO;;Boomers;CALERA                        ;VALPARAISO;0;0;0;0;0;0;0;0;0;CORTA PELO SG-8520;PERSONAL CARE
11043691;;F;56;CHILENO;;Boomers;LA CRUZ                       ;VALPARAISO;0;0;0;0;0;0;0;0;0;SECADOR DE PELO SIEGEN SG-3035;PERSONAL CARE
14003331;;F;42;CHILENO;;X;SAN ANTONIO                   ;VALPARAISO;0;0;0;0;0;0;0;0;0;SECADOR DE PELO SG-3051;PERSONAL CARE
18777450;;F;28;CHILENO;;Millenial;PROVIDENCIA                   ;METROPOLITANA;0;0;0;0;0;0;0;0;0;SECADOR DE PELO DIAMOND ST BLOOM VT 220;PERSONAL CARE
18512971;;F;29;CHILENO;;Millenial;PROVIDENCIA                   ;METROPOLITANA;0;0;0;0;0;0;0;0;0;ALISADOR +SECADOR PELO;PERSONAL CARE
17705657;;M;31;CHILENO;;Millenial;PROVIDENCIA                   ;METROPOLITANA;0;0;0;0;0;0;0;0;0;SECADOR DE PELO MISTRAL STD;PERSONAL CARE
11376236;;M;52;CHILENO;;X;RENCA                         ;METROPOLITANA;0;0;0;0;0;0;0;0;0;SECADOR DE PELO MISTRAL STD;PERSONAL CARE
9788824;;F;54;CHILENO;;X;N/D;N/D;0;0;0;0;0;0;0;0;0;SECADOR DE PELO TEMPO 3D 220 BLACK;PERSONAL CARE
17900080;;M;30;CHILENO;;Millenial;PROVIDENCIA                   ;METROPOLITANA;0;0;0;0;0;0;0;0;0;KIT CORTABARBA MG3711;PERSONAL CARE
18553750;;F;28;CHILENO;;Millenial;VILLA ALEMANA                 ;VALPARAISO;0;0;0;0;0;0;0;0;0;SECADOR DIAMOND STD;PERSONAL CARE
17669677;;F;31;CHILENO;;Millenial;CAUQUENES                     ;MAULE;0;0;0;0;0;0;0;0;0;SECADOR DE PELO SE-3049C01 FUCSIA;PERSONAL CARE
14069778;;M;40;CHILENO;;X;LOS ANGELES                   ;BIO BIO;0;0;0;0;0;0;0;0;0;DEPILADORA SG-9040;PERSONAL CARE
15343024;;F;38;CHILENO;;X;PUDAHUEL                      ;METROPOLITANA;0;0;0;0;0;0;0;0;0;DEPILADORA SG-9201;PERSONAL CARE
18267233;;F;29;CHILENO;;Millenial;CALBUCO                       ;LOS LAGOS;0;0;0;0;0;0;0;0;0;SECADOR DE PELO SE-3049C01 FUCSIA;PERSONAL CARE
19520522;;F;25;CHILENO;;Z;PROVIDENCIA                   ;METROPOLITANA;0;0;0;0;0;0;0;0;0;ALISADOR DE PELO SG-3512D1 ROSA;PERSONAL CARE
20279697;;M;22;CHILENO;;Z;PROVIDENCIA                   ;METROPOLITANA;0;0;0;0;0;0;0;0;0;ALISADOR DE PELO ERGOSTYLER ION DUO ROJO;PERSONAL CARE
15501499;Soltero;F;39;CHILENO;;Silencioso;PROVIDENCIA                   ;METROPOLITANA;0;0;0;0;0;0;0;0;0;ALISADOR CP9 MIDI MY STYLE;PERSONAL CARE
16514466;;F;35;CHILENO;;Silencioso;PROVIDENCIA                   ;METROPOLITANA;0;0;0;0;0;0;0;0;0;CORTA PELO GM 562;PERSONAL CARE
8979901;;M;60;CHILENO;;Boomers;ANCUD                         ;LOS LAGOS;0;0;0;0;0;0;0;0;0;AFEITADORA SG-7210 NEGRO;PERSONAL CARE
16685085;;M;35;CHILENO;;Silencioso;PROVIDENCIA                   ;METROPOLITANA;0;0;0;0;0;0;0;0;0;KIT CORTABARBA MG3711;PERSONAL CARE
12958152;;M;45;CHILENO;;X;PROVIDENCIA                   ;METROPOLITANA;0;0;0;0;0;0;0;0;0;SECADOR DE PELO PEGABLE D1500 NEGRO;PERSONAL CARE
25213507;;M;49;CUBANO;;Extranjero;HUECHURABA                    ;METROPOLITANA;0;0;0;0;0;0;0;0;0;CORTA PELO PG6025 KIT RECORTE;PERSONAL CARE
18956105;;F;27;CHILENO;;Silencioso;PROVIDENCIA                   ;METROPOLITANA;0;0;0;0;0;0;0;0;0;ALISADOR DE PELO ERGOSTYLER ION DUO ROJO;PERSONAL CARE
18786081;;F;28;CHILENO;;Millenial;SAN VICENTE                   ;L.G.B.OÂ´HIGGINS;0;0;0;0;0;0;0;0;0;CORTA PELO GM 562;PERSONAL CARE
14309117;;M;45;CHILENO;;X;PROVIDENCIA                   ;METROPOLITANA;0;0;0;0;0;0;0;0;0;AFEITADORA S1223/41 ELECTRICA;PERSONAL CARE
19067079;Soltero;M;26;CHILENO;;Z;PROVIDENCIA                   ;METROPOLITANA;0;0;0;0;0;0;0;0;0;AFEITADORA QP2521/50 ONE BLADE GRAFITO;PERSONAL CARE
6473810;;M;66;CHILENO;;Boomers;ALTO HOSPICIO;TARAPACA;0;0;0;0;0;0;0;0;0;SECADOR DE PELO SG-3012 NEGRO;PERSONAL CARE
19753689;;F;24;CHILENO;;Silencioso;PROVIDENCIA                   ;METROPOLITANA;0;0;0;0;0;0;0;0;0;ALISADOR DE PELO SG-3510 FUCSIA;PERSONAL CARE
10151171;;F;56;CHILENO;;Boomers;N/D;N/D;0;0;0;0;0;0;0;0;0;CORTA PELO GC-625;PERSONAL CARE
13352823;;F;44;CHILENO;;X;MOLINA                        ;MAULE;0;0;0;0;0;0;0;0;0;COMBO SIEGEN AFEITADORA + MULTISTYLER SG-8440;PERSONAL CARE
19005083;Soltero;F;27;CHILENO;PSICOLOGA;Millenial;PROVIDENCIA                   ;METROPOLITANA;0;0;0;0;0;0;0;0;0;SECADOR DE PELO SE-3049C01 FUCSIA;PERSONAL CARE
12554759;;M;48;CHILENO;;X;CHIGUAYANTE                   ;BIO BIO;0;0;0;0;0;0;0;0;0;DEPILADORA SG-9004EX;PERSONAL CARE
16128490;Casado;F;36;CHILENO;MATRONA;Millenial;PROVIDENCIA                   ;METROPOLITANA;0;0;0;0;0;0;0;0;0;SECADOR PELO SIEGEN SG-3042;PERSONAL CARE
18440727;;F;29;CHILENO;;Millenial;"";"";0;0;0;0;0;0;0;0;0;CORTA PELO SG-8200;PERSONAL CARE
15759065;;F;38;CHILENO;;Millenial;PUDAHUEL                      ;METROPOLITANA;0;0;0;0;0;0;0;0;0;ALISADOR ELEGANCE W L IT 3D BLUE BVT;PERSONAL CARE
16590069;;F;35;CHILENO;;Millenial;N/D;N/D;0;0;0;0;0;0;0;0;0;DEPILADORA GAMA ESSENCIAL;PERSONAL CARE
10402125;;F;56;CHILENO;;Boomers;RENCA                         ;METROPOLITANA;0;0;0;0;0;0;0;0;0;SECADOR DE PELO SG-3025 SILVER;PERSONAL CARE
11892096;Casado;F;50;CHILENO;;X;PROVIDENCIA                   ;METROPOLITANA;0;0;0;0;0;0;0;0;0;AFEITADORA S1223/41 ELECTRICA;PERSONAL CARE
25688073;;F;29;VENEZOLANO;;Extranjero;NUNOA                         ;METROPOLITANA;0;0;0;0;0;0;0;0;0;ALISADOR DE PELO S8607 DE COCO VERDE;PERSONAL CARE
13191776;;F;45;CHILENO;;X;RENCA                         ;METROPOLITANA;0;0;0;0;0;0;0;0;0;SECADOR DE PELO TEMPO MORADO;PERSONAL CARE
7195784;;M;65;CHILENO;;Boomers;EL BOSQUE                     ;METROPOLITANA;0;0;0;0;0;0;0;0;0;AFEITADORA S1121/41 ELECTRICA;PERSONAL CARE
18643795;;F;28;CHILENO;;Extranjero;"";"";0;0;0;0;0;0;0;0;0;ALISADOR DE PELO SG-3540 MORADO MORADO;PERSONAL CARE
16206795;Soltero;F;36;CHILENO;PROFESOR;Millenial;PROVIDENCIA                   ;METROPOLITANA;0;0;0;0;0;0;0;0;0;COMBO BALANZA NEGRA+SECADOR DIAMOND ST NEGRO;PERSONAL CARE
7292807;Casado;M;67;CHILENO;INGENIERO AGRICOLA;Boomers;SAN JAVIER                    ;MAULE;0;0;0;0;0;0;0;0;0;AFEITADORA SPORT SH 886 BAT;PERSONAL CARE
11940763;;F;50;CHILENO;;X;LA SERENA                     ;COQUIMBO;0;0;0;0;0;0;0;0;0;AFEITADORA SG-7250 NEGRO;PERSONAL CARE
19058029;Soltero;F;26;CHILENO;;Z;PROVIDENCIA                   ;METROPOLITANA;0;0;0;0;0;0;0;0;0;SECADOR DE PELO SG-3035 NEGRO;PERSONAL CARE
16815682;;F;33;CHILENO;;Millenial;PROVIDENCIA                   ;METROPOLITANA;0;0;0;0;0;0;0;0;0;DEPILADORA SG-9003;PERSONAL CARE
16179314;Casado;F;35;CHILENO;;Millenial;PROVIDENCIA                   ;METROPOLITANA;0;0;0;0;0;0;0;0;0;DEPILADORA SG-9004EX;PERSONAL CARE
11742054;;F;51;CHILENO;;X;PROVIDENCIA                   ;METROPOLITANA;0;0;0;0;0;0;0;0;0;AFEITADORA XR1430 NEGRO;PERSONAL CARE
10804730;Casado;M;53;CHILENO;INGENIERO AGRICOLA;X;RENCA                         ;METROPOLITANA;0;0;0;0;0;0;0;0;0;SECADOR DE PELO HP8204/10 THERMOPROTECT 2100W FR;PERSONAL CARE
13572458;;M;43;CHILENO;;X;CHIMBARONGO                   ;L.G.B.OÂ´HIGGINS;0;0;0;0;0;0;0;0;0;CORTA PELO SPORT GC 542 BVT;PERSONAL CARE
20570139;;M;21;CHILENO;;Z;PROVIDENCIA                   ;METROPOLITANA;0;0;0;0;0;0;0;0;0;AFEITADORA GAMA 900;PERSONAL CARE
18064078;;F;30;CHILENO;;Millenial;RENCA                         ;METROPOLITANA;0;0;0;0;0;0;0;0;0;CORTA PELO GM 562;PERSONAL CARE
6602405;;M;59;CHILENO;;Boomers;VALPARAISO                    ;VALPARAISO;0;0;0;0;0;0;0;0;0;SECADOR GAMA EOLIC MINI TRAVEL;PERSONAL CARE
18574010;;F;28;CHILENO;;Millenial;CONSTITUCION                  ;MAULE;0;0;0;0;0;0;0;0;0;ALISADOR SIEGEN SG-4716;PERSONAL CARE
11152251;;F;54;CHILENO;;Boomers;PROVIDENCIA                   ;METROPOLITANA;0;0;0;0;0;0;0;0;0;ALISADOR SIEGEN SG-4716;PERSONAL CARE
12356132;;F;49;CHILENO;;X;PROVIDENCIA                   ;METROPOLITANA;0;0;0;0;0;0;0;0;0;ALISADOR DE PELO SG-3540 MORADO MORADO;PERSONAL CARE
13159756;Casado;F;45;CHILENO;;X;RENCA                         ;METROPOLITANA;0;0;0;0;0;0;0;0;0;SECADOR DE PELO TEMPO 3D 220 BLACK;PERSONAL CARE
14441767;;F;47;CHILENO;;X;RINCONADA                     ;VALPARAISO;0;0;0;0;0;0;0;0;0;ALISADOR ELEGANCE LED QUINOA BVT;PERSONAL CARE
10645268;;F;53;CHILENO;;X;PROVIDENCIA                   ;METROPOLITANA;0;0;0;0;0;0;0;0;0;Secador Potenza Keration;PERSONAL CARE
13194900;;F;44;CHILENO;;X;QUILPUE                       ;VALPARAISO;0;0;0;0;0;0;0;0;0;ALISADOR ELEGANCE LED QUINOA BVT;PERSONAL CARE
10992438;Soltero;M;42;CHILENO;INTERPRETE DE IDIOMAS;X;PROVIDENCIA                   ;METROPOLITANA;0;0;0;0;0;0;0;0;0;Secador Potenza Keration;PERSONAL CARE
15633075;;F;39;CHILENO;;X;LA SERENA                     ;COQUIMBO;0;0;0;0;0;0;0;0;0;AFEITADORA SPORT SH 886 BAT;PERSONAL CARE
19504259;;F;25;CHILENO;;Extranjero;N/D;N/D;0;0;0;0;0;0;0;0;0;ALISADOR GAMA BELLA SHINE;PERSONAL CARE
19132411;Soltero;F;26;CHILENO;;Z;PROVIDENCIA                   ;METROPOLITANA;0;0;0;0;0;0;0;0;0;ALISADOR DE PELO SG-3510 FUCSIA;PERSONAL CARE
19065581;Soltero;F;27;CHILENO;;Z;PROVIDENCIA                   ;METROPOLITANA;0;0;0;0;0;0;0;0;0;SECADOR DE PELO TEMPO MORADO;PERSONAL CARE
19141638;Soltero;F;27;CHILENO;;Z;SAN ANTONIO                   ;VALPARAISO;0;0;0;0;0;0;0;0;0;ALISADOR ELEGANCE LED BLOOM VT;PERSONAL CARE
8961253;Soltero;F;70;CHILENO;;Silencioso;PROVIDENCIA                   ;METROPOLITANA;0;0;0;0;0;0;0;0;0;SECADOR DE PELO SG-3012 NEGRO;PERSONAL CARE
15891562;;M;37;CHILENO;;Millenial;LA CISTERNA                   ;METROPOLITANA;0;0;0;0;0;0;0;0;0;DEPILADORA EP7020A (220) DE 40 PINZAS R;PERSONAL CARE
8922175;;F;51;CHILENO;;X;TEMUCO                        ;ARAUCANIA;0;0;0;0;0;0;0;0;0;DEPILADORA SG-9004;PERSONAL CARE
8969945;;F;59;CHILENO;;Boomers;MELIPILLA                     ;METROPOLITANA;0;0;0;0;0;0;0;0;0;AFEITADORA PR1342 ROTATIVA RECARGABLE;PERSONAL CARE
15056982;;M;39;CHILENO;;X;LA LIGUA                      ;VALPARAISO;0;0;0;0;0;0;0;0;0;CORTA PELO SPORT GCX 623 BVT;PERSONAL CARE
14380258;;F;44;CHILENO;;X;RENCA                         ;METROPOLITANA;0;0;0;0;0;0;0;0;0;DEPILADORA SG-9004;PERSONAL CARE
16150140;;F;36;CHILENO;;Millenial;LA PINTANA                    ;METROPOLITANA;0;0;0;0;0;0;0;0;0;ALISADOR +SECADOR PELO;PERSONAL CARE
12351696;;F;49;CHILENO;;X;PROVIDENCIA                   ;METROPOLITANA;0;0;0;0;0;0;0;0;0;ALISADORA SG-4653;PERSONAL CARE
26065172;;M;52;VENEZOLANO;;Extranjero;"";"";0;0;0;0;0;0;0;0;0;AFEITADORA S1121/41 ELECTRICA;PERSONAL CARE
19289416;Soltero;M;26;CHILENO;;Z;PROVIDENCIA                   ;METROPOLITANA;0;0;0;0;0;0;0;0;0;CORTA PELO MGK3220 BLACK BOX MN;PERSONAL CARE
11092072;;F;56;CHILENO;;Boomers;RENCA                         ;METROPOLITANA;0;0;0;0;0;0;0;0;0;CORTA PELO GM 562;PERSONAL CARE
24104157;;F;40;BOLIVIANO;;Extranjero;N/D;N/D;0;0;0;0;0;0;0;0;0;ONDULADOR DE PELO TURMALINA 25MM;PERSONAL CARE
14145048;Casado;F;41;CHILENO;PROFESOR;X;PROVIDENCIA                   ;METROPOLITANA;0;0;0;0;0;0;0;0;0;CORTA PELO SPORT GCX 623 BVT;PERSONAL CARE
18061196;Soltero;F;30;CHILENO;AGRONOMO;Millenial;PROVIDENCIA                   ;METROPOLITANA;0;0;0;0;0;0;0;0;0;SECADOR DE PELO TEMPO MORADO;PERSONAL CARE
24804178;;F;43;BOLIVIANO;;Extranjero;PUENTE ALTO                   ;METROPOLITANA;0;0;0;0;0;0;0;0;0;ALISADOR +SECADOR PELO;PERSONAL CARE
14560987;Soltero;F;40;CHILENO;TRABAJADOR SOCIAL;X;PROVIDENCIA                   ;METROPOLITANA;0;0;0;0;0;0;0;0;0;DEPILADORA BRE255/00;PERSONAL CARE
25586873;;M;43;VENEZOLANO;;Extranjero;TALAGANTE                     ;METROPOLITANA;0;0;0;0;0;0;0;0;0;ALISADOR GAMA BELLA SHINE;PERSONAL CARE
14007767;;M;41;CHILENO;;X;PROVIDENCIA                   ;METROPOLITANA;0;0;0;0;0;0;0;0;0;ALISADOR ELEGANCE LED KER;PERSONAL CARE
18648679;Soltero;F;27;CHILENO;TECNICO DE NIVEL SUPERIOR EN ENFERMERIA;Millenial;PROVIDENCIA                   ;METROPOLITANA;0;0;0;0;0;0;0;0;0;CORTAPELOS GM 596;PERSONAL CARE
10092883;;M;57;CHILENO;;Boomers;PROVIDENCIA                   ;METROPOLITANA;0;0;0;0;0;0;0;0;0;CORTAPELOS GM 596;PERSONAL CARE
6873289;;F;71;CHILENO;;Silencioso;RENCA                         ;METROPOLITANA;0;0;0;0;0;0;0;0;0;SECADOR DE PELO SG-3012 NEGRO;PERSONAL CARE
11893444;;F;50;CHILENO;;X;RENCA                         ;METROPOLITANA;0;0;0;0;0;0;0;0;0;DEPILADORA SG-9004;PERSONAL CARE
14380508;;F;44;CHILENO;;X;EL MONTE                      ;METROPOLITANA;0;0;0;0;0;0;0;0;0;CORTA PELO GM 562;PERSONAL CARE
14153980;Soltero;F;41;CHILENO;;X;PROVIDENCIA                   ;METROPOLITANA;0;0;0;0;0;0;0;0;0;CORTA PELO SG-8200;PERSONAL CARE
7426031;;M;64;CHILENO;;Boomers;PROVIDENCIA                   ;METROPOLITANA;0;0;0;0;0;0;0;0;0;AFEITADORA SG-7210 NEGRO;PERSONAL CARE
18827805;Soltero;F;28;CHILENO;;Millenial;PROVIDENCIA                   ;METROPOLITANA;0;0;0;0;0;0;0;0;0;ALISADOR DE PELO SG-3512D1 ROSA;PERSONAL CARE
10800155;;M;51;CHILENO;;X;RENCA                         ;METROPOLITANA;0;0;0;0;0;0;0;0;0;ALISADOR ELEGANCE LED BLOOM VT;PERSONAL CARE
17538848;;M;32;CHILENO;;Millenial;PROVIDENCIA                   ;METROPOLITANA;0;0;0;0;0;0;0;0;0;DEPILADORA OASIS LOOK BVT;PERSONAL CARE
10685032;Casado;M;54;CHILENO;ADMINISTRADOR PUBLICO;X;RENCA                         ;METROPOLITANA;0;0;0;0;0;0;0;0;0;SECADOR PELO SG-3012C19;PERSONAL CARE
19130403;;F;26;CHILENO;;Z;PROVIDENCIA                   ;METROPOLITANA;0;0;0;0;0;0;0;0;0;SECADOR DE PELO SG-3012C17 NARANJO;PERSONAL CARE
10781427;;M;48;CHILENO;;X;TALCAHUANO                    ;BIO BIO;0;0;0;0;0;0;0;0;0;Secador Potenza Keration;PERSONAL CARE
16288273;;M;36;CHILENO;;Millenial;QUILLOTA                      ;VALPARAISO;0;0;0;0;0;0;0;0;0;TRICOMBO SECADOR+ALISADOR+ONDULAD;PERSONAL CARE
10160745;;M;56;CHILENO;;Boomers;RENCA                         ;METROPOLITANA;0;0;0;0;0;0;0;0;0;CORTA PELO GM 562;PERSONAL CARE
16178203;Soltero;F;36;CHILENO;;Millenial;RENCA                         ;METROPOLITANA;0;0;0;0;0;0;0;0;0;CORTA PELO GM 562;PERSONAL CARE
10067258;;F;56;CHILENO;;Boomers;RENCA                         ;METROPOLITANA;0;0;0;0;0;0;0;0;0;TOMA PRESION BP-309 BAT MUNECA;PERSONAL CARE
15106331;Soltero;M;35;CHILENO;;Millenial;PROVIDENCIA                   ;METROPOLITANA;0;0;0;0;0;0;0;0;0;DEPILADORA HP-6543;PERSONAL CARE
11517119;;F;51;CHILENO;;X;RANCAGUA                      ;L.G.B.OÂ´HIGGINS;0;0;0;0;0;0;0;0;0;DEPILADORA BRE640;PERSONAL CARE
19808426;;M;24;CHILENO;;Z;TALCA                         ;MAULE;0;0;0;0;0;0;0;0;0;AFEITADORA GAMA 890;PERSONAL CARE
12601782;;M;48;CHILENO;;X;RENCA                         ;METROPOLITANA;0;0;0;0;0;0;0;0;0;DEPILADORA HP-6543;PERSONAL CARE
8366443;;F;53;CHILENO;;X;LLAILLAY                      ;VALPARAISO;0;0;0;0;0;0;0;0;0;SECADOR DE PELO SG-3035 NEGRO;PERSONAL CARE
9565019;;F;60;CHILENO;;Boomers;PROVIDENCIA                   ;METROPOLITANA;0;0;0;0;0;0;0;0;0;CORTAPELOS GM 596;PERSONAL CARE
18988056;;F;27;CHILENO;;Millenial;SAN FERNANDO                  ;L.G.B.OÂ´HIGGINS;0;0;0;0;0;0;0;0;0;SECADOR DE PELO SG-3051;PERSONAL CARE
18972800;;F;27;CHILENO;;Millenial;RENCA                         ;METROPOLITANA;0;0;0;0;0;0;0;0;0;DEPILADORA HP-6543;PERSONAL CARE
7959334;;M;64;CHILENO;;Boomers;PROVIDENCIA                   ;METROPOLITANA;0;0;0;0;0;0;0;0;0;CORTA PELO GM 562;PERSONAL CARE
9005622;;M;62;CHILENO;;Boomers;LA LIGUA                      ;VALPARAISO;0;0;0;0;0;0;0;0;0;CORTA PELO GM 562;PERSONAL CARE
15755324;Soltero;F;38;CHILENO;TECNICO DE NIVEL SUPERIOR EN ENFERMERIA;Millenial;RENCA                         ;METROPOLITANA;0;0;0;0;0;0;0;0;0;CORTA PELO MGK3220 BLACK BOX MN;PERSONAL CARE
19580593;;F;25;CHILENO;;Z;PROVIDENCIA                   ;METROPOLITANA;0;0;0;0;0;0;0;0;0;COMBO SECADOR+ALISADOR+ONDULADOR DE PELO;PERSONAL CARE
7084994;;M;69;CHILENO;;Silencioso;PROVIDENCIA                   ;METROPOLITANA;0;0;0;0;0;0;0;0;0;AFEITADORA S1121/41 ELECTRICA;PERSONAL CARE
20474834;;M;21;CHILENO;;Z;PROVIDENCIA                   ;METROPOLITANA;0;0;0;0;0;0;0;0;0;CORTAPELO SPORT 544;PERSONAL CARE
25683837;;F;31;PERUANO;;Extranjero;PROVIDENCIA                   ;METROPOLITANA;0;0;0;0;0;0;0;0;0;DEPILADORA BRI 863/00 IPL;PERSONAL CARE
10350037;;F;55;CHILENO;;Boomers;QUINTA NORMAL                 ;METROPOLITANA;0;0;0;0;0;0;0;0;0;ALISADOR DE PELO ERGOSTYLER ION DUO ROJO;PERSONAL CARE
15483805;;M;40;CHILENO;;X;RENCA                         ;METROPOLITANA;0;0;0;0;0;0;0;0;0;ALISADOR DE PELO S7740 TRIPLE INFUSION;PERSONAL CARE
10650290;;F;52;CHILENO;;X;SAN MIGUEL                    ;METROPOLITANA;230220;4;2;0;0;0;4;2;230220;HERVIDOR TH-4340;ELECTRODOMESTICOS
8172969;;F;61;CHILENO;;Boomers;CANETE                        ;BIO BIO;380970;5;3;0;0;0;5;3;380970;Hervidor Inox One Midea;ELECTRODOMESTICOS
12942617;Soltero;F;46;CHILENO;TECNICO AGROPECUARIO;X;RENCA                         ;METROPOLITANA;1153940;7;3;7;3;1153940;0;0;0;Batidora Berry Mixer (KM3000) 1300 watts;ELECTRODOMESTICOS
7332852;;F;66;CHILENO;;Boomers;PENCO                         ;BIO BIO;455620;5;2;0;0;0;5;2;455620;Batidora de Mano y Pedestal 3612;ELECTRODOMESTICOS
9931271;;M;53;CHILENO;;X;PENALOLEN                     ;METROPOLITANA;179980;2;2;0;0;0;2;2;179980;BATIDORA PEDESTAL RENANIA 5 LITROS;ELECTRODOMESTICOS
10687948;;F;53;CHILENO;;X;TALCAHUANO                    ;BIO BIO;52970;3;2;2;1;35980;1;1;16990;Sandwichera TH-952 2 Panes Blanca;ELECTRODOMESTICOS
12547951;;M;48;CHILENO;;X;CHILLAN                       ;BIO BIO;598118;9;5;0;0;0;9;5;598118;Picadora UT-PETRUS320 1Lts Vaso Vidrio;ELECTRODOMESTICOS
22625662;;F;34;BOLIVIANO;;Extranjero;ARICA                         ;ARICA Y PARINACOTA;790900;10;6;0;0;0;10;6;790900;Hervidor Family Kettle HE500;ELECTRODOMESTICOS
5459291;;F;71;CHILENO;;Silencioso;LA LIGUA                      ;VALPARAISO;20990;1;1;0;0;0;1;1;20990;Plancha UT-KERAMIK1 2200Watts Base Ceramica;ELECTRODOMESTICOS
7489515;;F;68;CHILENO;;Boomers;HIJUELAS                      ;VALPARAISO;49990;1;1;0;0;0;1;1;49990;Parrilla Electrica TH-224;ELECTRODOMESTICOS
17911516;;F;30;CHILENO;;Millenial;"";"";19240;2;1;0;0;0;2;1;19240;HERVIDOR BERLIN 1,7 LITROS;ELECTRODOMESTICOS
11556728;;M;52;CHILENO;;X;RENCA                         ;METROPOLITANA;24990;1;1;0;0;0;1;1;24990;Hervidor Electrico TH-5407i 2Lts;ELECTRODOMESTICOS
8893886;;F;59;CHILENO;;Boomers;PROVIDENCIA                   ;N/D;101060;2;1;0;0;0;2;1;101060;Horno Microondas Digital TH20DM 20Lts Espejado;ELECTRODOMESTICOS
4809404;;M;80;CHILENO;;Silencioso;SAN RAMON                     ;METROPOLITANA;44990;1;1;0;0;0;1;1;44990;Freidora de Aire 18M Oster;ELECTRODOMESTICOS
4943980;;M;77;CHILENO;;Silencioso;N/D;N/D;104890;3;2;0;0;0;3;2;104890;Plancha TH-7052 2000Watts Base Inox;ELECTRODOMESTICOS
12284781;;M;50;CHILENO;;X;N/D;N/D;643150;7;3;0;0;0;7;3;643150;Aspiradora TH1870 Arrastre 1800Watts Gris;ELECTRODOMESTICOS
13209925;;F;45;CHILENO;;X;RIO CLARO                     ;MAULE;99990;1;1;0;0;0;1;1;99990;FREIDORA DE AIRE THOMAS TH-AF60Mi;ELECTRODOMESTICOS
12724273;;F;47;CHILENO;;X;N/D;N/D;32980;2;2;0;0;0;2;2;32980;HERVIDOR COLONIA 1,7 LITROS;ELECTRODOMESTICOS
17012495;;F;34;CHILENO;;Millenial;N/D;N/D;13990;1;1;0;0;0;1;1;13990;Batidora Vertical Stick Mixer 2609;ELECTRODOMESTICOS
14527017;;F;46;CHILENO;;X;SAN RAFAEL                    ;MAULE;108200;6;3;0;0;0;6;3;108200;Batidora Manual TH-8830;ELECTRODOMESTICOS
11349391;;M;53;CHILENO;;X;RANCAGUA                      ;L.G.B.OÂ´HIGGINS;34990;1;1;0;0;0;1;1;34990;Plancha UT-SHANGRILA Inalambrica 2200Watss;ELECTRODOMESTICOS
12595532;;F;47;CHILENO;;X;CASTRO                        ;LOS LAGOS;649850;4;3;0;0;0;4;3;649850;Aspiradora TH1870 Arrastre 1800Watts Gris;ELECTRODOMESTICOS
15224407;;F;39;CHILENO;;X;HUALPEN;BIO BIO;27990;1;1;0;0;0;1;1;27990;Licuadora L2000VNG 1,5Lts Vaso Vidrio;ELECTRODOMESTICOS
6626217;;F;71;CHILENO;;Silencioso;RENCA                         ;METROPOLITANA;24990;1;1;0;0;0;1;1;24990;Hervidor Electrico TH-5407i 2Lts;ELECTRODOMESTICOS
8362178;;F;66;CHILENO;;Boomers;CALERA                        ;VALPARAISO;338560;3;2;0;0;0;3;2;338560;FREIDORA DE AIRE HESSIA 2,0 LITROS;ELECTRODOMESTICOS
5177453;;M;79;CHILENO;;Silencioso;LOS ANDES                     ;VALPARAISO;79283;3;2;0;0;0;3;2;79283;HORNO ELECTRICO 16N01 16LTS NEGRO;ELECTRODOMESTICOS
19942878;;M;24;CHILENO;;Z;N/D;N/D;227980;2;2;0;0;0;2;2;227980;Horno Electrico TH-25N01 25Lts;ELECTRODOMESTICOS
5709813;;M;73;CHILENO;;Silencioso;PROVIDENCIA                   ;METROPOLITANA;715660;6;4;0;0;0;6;4;715660;Horno Electrico TH62I 60Lts;ELECTRODOMESTICOS
15629241;;M;38;CHILENO;;X;PROVIDENCIA                   ;METROPOLITANA;568240;6;4;0;0;0;6;4;568240;Horno Electrico TH-25N01 25Lts;ELECTRODOMESTICOS
10977893;;M;50;CHILENO;;X;PAINE                         ;METROPOLITANA;186860;3;1;0;0;0;3;1;186860;Maquina de Coser XB-2500CL Rosado;ELECTRODOMESTICOS
26265060;;F;29;BOLIVIANO;;Extranjero;LA SERENA                     ;COQUIMBO;153970;3;2;0;0;0;3;2;153970;Exprimidor de Jugo 407W 1Lts;ELECTRODOMESTICOS
12166771;;M;45;CHILENO;;X;TOCOPILLA                     ;ANTOFAGASTA;144170;9;5;0;0;0;9;5;144170;Hervidor Electrico TH-4515N 2Lts Negro;ELECTRODOMESTICOS
12842110;;F;47;CHILENO;;X;LONQUIMAY                     ;ARAUCANIA;603822;7;4;0;0;0;7;4;603822;TOSTADOR OLDEMBURGO 2 REBANADAS;ELECTRODOMESTICOS
20642383;;M;24;CHILENO;;Z;CALBUCO                       ;LOS LAGOS;1104305;29;25;2;1;289980;27;24;814325;Licuadora TH-501V 1,5Lts Vaso Vidrio;ELECTRODOMESTICOS
15785518;;M;38;CHILENO;;Millenial;PROVIDENCIA                   ;METROPOLITANA;19990;1;1;1;1;19990;0;0;0;Combo Hervidor + Batidora;ELECTRODOMESTICOS
6414533;;M;72;CHILENO;;Silencioso;PLACILLA                      ;L.G.B.OÂ´HIGGINS;11193;1;1;0;0;0;1;1;11193;Hervidor Electrico UT-MANLY17 1,7Lts Negro;ELECTRODOMESTICOS
12178867;;F;50;CHILENO;;X;MELIPILLA                     ;METROPOLITANA;47980;2;4;0;0;0;2;4;47980;Batidora Vertical Multimixer TH-8720;ELECTRODOMESTICOS
8499552;Casado;M;65;CHILENO;;Boomers;RENCA                         ;METROPOLITANA;79990;1;1;0;0;0;1;1;79990;HORNO ELECTRICO MUNICH 60 LITROS;ELECTRODOMESTICOS
19705737;;F;24;CHILENO;;Z;PROVIDENCIA                   ;METROPOLITANA;36980;2;1;2;1;36980;0;0;0;Extractor de Jugo EX800 1,4Lts;ELECTRODOMESTICOS
12013798;Casado;F;57;CHILENO;;Boomers;PROVIDENCIA                   ;METROPOLITANA;123980;2;2;0;0;0;2;2;123980;Plancha a Vapor 5001;ELECTRODOMESTICOS
26264805;;M;51;VENEZOLANO;;Extranjero;"";"";689820;18;8;17;7;680830;1;1;8990;MAQ. COSER K 408A;ELECTRODOMESTICOS
16334232;;M;35;CHILENO;;Millenial;RENCA                         ;METROPOLITANA;83970;3;2;0;0;0;3;2;83970;Licuadora L-1630V Negra 1,5Lts Vaso Vidrio;ELECTRODOMESTICOS
16896219;;M;34;CHILENO;;Millenial;N/D;N/D;1164780;12;7;0;0;0;12;7;1164780;Hervidor Electrico TH-4212N 1,7Lts Negro;ELECTRODOMESTICOS
9779052;;M;59;CHILENO;;Boomers;ILLAPEL                       ;COQUIMBO;1571580;10;5;0;0;0;10;5;1571580;Horno Microondas Digital L UT-25KROMM 25Lts;ELECTRODOMESTICOS
12562808;;M;48;CHILENO;;X;ANGOL                         ;ARAUCANIA;89820;4;3;0;0;0;4;3;89820;Hervidor Family Kettle HE500;ELECTRODOMESTICOS
6755585;Casado;F;73;CHILENO;;Silencioso;RENCA                         ;METROPOLITANA;29990;1;1;0;0;0;1;1;29990;Hervidor Electrico Tetera HA-4100 4Lts Iox;ELECTRODOMESTICOS
10846023;;M;55;CHILENO;;Boomers;COLINA                        ;METROPOLITANA;206060;4;3;0;0;0;4;3;206060;Hervidor Electrico Tetera TH-6505RT 1,7Lts Rojo;ELECTRODOMESTICOS
25014941;;F;25;EXTRANJERO - NO INFORMA NACIONALIDAD;;Extranjero;TOCOPILLA                     ;ANTOFAGASTA;1223790;13;9;10;7;1188560;3;2;35230;FREIDORA DE AIRE BAVIERA 3,8 LITROS;ELECTRODOMESTICOS
9802178;;F;69;CHILENO;;Silencioso;RENCA                         ;METROPOLITANA;209970;3;3;0;0;0;3;3;209970;Licuadora Berry Blender Roja 1400 Vaso Vidrio;ELECTRODOMESTICOS
20124752;;F;23;CHILENO;;Z;PROVIDENCIA                   ;METROPOLITANA;22990;1;1;0;0;0;1;1;22990;Licuadora Berry Blender Roja 1400 Vaso Vidrio;ELECTRODOMESTICOS
20041135;;F;23;CHILENO;;Silencioso;PROVIDENCIA                   ;METROPOLITANA;58980;2;2;0;0;0;2;2;58980;Combo Juguera + Hervidor;ELECTRODOMESTICOS
19607861;;F;24;CHILENO;;Z;N/D;N/D;457730;12;9;0;0;0;12;9;457730;Horno Electrico TH62I 60Lts;ELECTRODOMESTICOS
8693386;;F;63;CHILENO;;Boomers;VILLA ALEMANA                 ;VALPARAISO;207870;2;1;0;0;0;2;1;207870;Maquina de coser Singer 024;ELECTRODOMESTICOS
14077312;;F;42;CHILENO;;X;FREIRE                        ;ARAUCANIA;34990;1;1;1;1;34990;0;0;0;Aspiradora AP1700 Arrastre 1700Watts;ELECTRODOMESTICOS
19713990;;M;24;CHILENO;;Z;"";"";484950;7;6;0;0;0;7;6;484950;Licuadora L-1630V Negra 1,5Lts Vaso Vidrio;ELECTRODOMESTICOS
7679449;;F;69;CHILENO;;Silencioso;ARAUCO                        ;BIO BIO;13591;1;1;0;0;0;1;1;13591;Plancha a Vapor 5001;ELECTRODOMESTICOS
16887746;;F;35;CHILENO;;Millenial;VILLARICA                     ;ARAUCANIA;941812;8;13;0;0;0;8;13;941812;Batidora Manual 3532;ELECTRODOMESTICOS
7535097;;F;64;CHILENO;;Boomers;QUILPUE                       ;VALPARAISO;136040;4;3;0;0;0;4;3;136040;FREIDORA DE AIRE THOMAS TH-AF60Mi;ELECTRODOMESTICOS
11535926;;M;51;CHILENO;;X;RENCA                         ;METROPOLITANA;153060;4;1;0;0;0;4;1;153060;Horno Microondas Digital TH-25DM 25Lts;ELECTRODOMESTICOS
15307336;;M;38;CHILENO;;Millenial;NATALES                       ;MAGALLANES;124980;2;1;0;0;0;2;1;124980;Aspiradora VCC4190V3E/XZS Arrastre 2000Watts;ELECTRODOMESTICOS
8734085;;F;63;CHILENO;;Boomers;VALDIVIA                      ;LOS RIOS;179481;2;2;0;0;0;2;2;179481;Aspiradora UT-SILENT1804 Arrastre 1800Watts;ELECTRODOMESTICOS
19870093;;F;45;CHILENO;;X;ARICA                         ;ARICA Y PARINACOTA;18990;1;1;0;0;0;1;1;18990;PLANCHA A VAPOR 6953 BASE AEROCERAMICA AUTAPA.22;ELECTRODOMESTICOS
9168807;;F;60;CHILENO;;Boomers;QUILLOTA                      ;VALPARAISO;17990;1;1;0;0;0;1;1;17990;Hervidor Family Kettle HE500;ELECTRODOMESTICOS
6735091;Casado;M;70;CHILENO;;Silencioso;OSORNO                        ;LOS LAGOS;30000;1;1;0;0;0;1;1;30000;Producto Segunda Seleccion Banda 6;ELECTRODOMESTICOS
7298733;;F;68;CHILENO;;Boomers;CANETE                        ;BIO BIO;86970;3;2;0;0;0;3;2;86970;Hervidor Electrico UT-DUNKEL17P 2Lts Negro;ELECTRODOMESTICOS
12080731;;F;42;CHILENO;;X;COLINA                        ;METROPOLITANA;18990;1;1;0;0;0;1;1;18990;PLANCHA A VAPOR 6953 BASE AEROCERAMICA AUTAPA.22;ELECTRODOMESTICOS
17586535;Soltero;F;31;CHILENO;NUTRICIONISTA;Millenial;PROVIDENCIA                   ;METROPOLITANA;83970;3;2;3;2;83970;0;0;0;HORNO ELECTRICO 16N01 16LTS NEGRO;ELECTRODOMESTICOS
19503815;;F;25;CHILENO;;Z;TALAGANTE                     ;METROPOLITANA;54970;3;3;3;3;54970;0;0;0;Hervidor Electrico TH-4212N 1,7Lts Negro;ELECTRODOMESTICOS
16056751;;F;37;CHILENO;;Millenial;"";"";118551;3;2;0;0;0;3;2;118551;Batidora Pedestal TH910PN 4,6Lts 1300Watts;ELECTRODOMESTICOS
10759018;;F;53;CHILENO;;X;PUENTE ALTO                   ;METROPOLITANA;16990;1;1;0;0;0;1;1;16990;HERVIDOR TH-4340;ELECTRODOMESTICOS
19442195;;M;25;CHILENO;;Z;RENGO                         ;L.G.B.OÂ´HIGGINS;12990;1;1;0;0;0;1;1;12990;HERVIDOR BERLIN 1,7 LITROS;ELECTRODOMESTICOS
15249847;;F;43;CHILENO;;X;PROVIDENCIA                   ;METROPOLITANA;19990;1;1;0;0;0;1;1;19990;Batidora Manual TH-8830;ELECTRODOMESTICOS
13993329;;M;41;CHILENO;;X;PROVIDENCIA                   ;METROPOLITANA;119990;1;1;0;0;0;1;1;119990;Horno Electrico UT-BACKOFEN60 60Lts;ELECTRODOMESTICOS
12630705;;F;48;CHILENO;;X;CERRO NAVIA                   ;METROPOLITANA;280950;5;4;0;0;0;5;4;280950;Licuadora Berry Blender Roja 1400 Vaso Vidrio;ELECTRODOMESTICOS
6047053;;M;73;CHILENO;;Silencioso;PICHIDEGUA                    ;L.G.B.OÂ´HIGGINS;267130;3;2;0;0;0;3;2;267130;Horno Electrico TH-80i 80Lts;ELECTRODOMESTICOS
5789291;;F;77;CHILENO;;Extranjero;SAN BERNARDO                  ;METROPOLITANA;210960;4;2;0;0;0;4;2;210960;Hervidor Electrico TH-4212N 1,7Lts Negro;ELECTRODOMESTICOS
17937626;;F;30;CHILENO;;Millenial;"";"";34990;1;1;0;0;0;1;1;34990;Aspiradora TH1407 Arrastre 1400Watts;ELECTRODOMESTICOS
13031115;;F;46;CHILENO;;Millenial;BUIN                          ;METROPOLITANA;227490;6;2;0;0;0;6;2;227490;Horno Electrico TH-48N 48Lts;ELECTRODOMESTICOS
11539957;;M;52;CHILENO;;X;VICTORIA                      ;ARAUCANIA;1094820;7;3;0;0;0;7;3;1094820;Hervidor Electrico TH-4515N 2Lts Negro;ELECTRODOMESTICOS
9207143;;M;61;CHILENO;;Boomers;CURICO                        ;MAULE;21990;1;1;0;0;0;1;1;21990;Plancha TH-7052 2000Watts Base Inox;ELECTRODOMESTICOS
18904733;;M;27;CHILENO;;Millenial;CERRILLOS                     ;METROPOLITANA;320970;3;2;2;1;309980;1;1;10990;Hervidor Inox One Midea;ELECTRODOMESTICOS
10111307;;M;58;CHILENO;;Boomers;TILTIL                        ;METROPOLITANA;1368540;21;10;0;0;0;21;10;1368540;Horno Electrico TH62I 60Lts;ELECTRODOMESTICOS
7176459;;F;69;CHILENO;;Silencioso;REQUINOA                      ;L.G.B.OÂ´HIGGINS;61330;5;1;0;0;0;5;1;61330;HERVIDOR ELECTRICO UT-STARK18;ELECTRODOMESTICOS
7945180;;M;60;CHILENO;;Boomers;ARICA                         ;ARICA Y PARINACOTA;27990;1;1;0;0;0;1;1;27990;Hervidor Electrico Tetera UT-LECKER18R 1,8Lts;ELECTRODOMESTICOS
17290028;;F;35;CHILENO;;Millenial;CARAHUE                       ;ARAUCANIA;379970;3;3;0;0;0;3;3;379970;Horno Electrico TH62I 60Lts;ELECTRODOMESTICOS
17543430;;F;32;CHILENO;;Millenial;PROVIDENCIA                   ;METROPOLITANA;196980;2;2;0;0;0;2;2;196980;Hervidor Electrico TH-4515N 2Lts Negro;ELECTRODOMESTICOS
5431415;;F;74;CHILENO;;Silencioso;SAN BERNARDO                  ;METROPOLITANA;288971;4;3;0;0;0;4;3;288971;Aspiradora Handy Clean Black 1400;ELECTRODOMESTICOS
16329915;;F;35;CHILENO;;Millenial;N/D;N/D;89990;1;1;0;0;0;1;1;89990;Horno Microondas Digital TH-25DM 25Lts;ELECTRODOMESTICOS
9839740;;F;58;CHILENO;;Boomers;CERRO NAVIA                   ;METROPOLITANA;21990;1;1;0;0;0;1;1;21990;Hervidor Electrico TH-4515N 2Lts Negro;ELECTRODOMESTICOS
6291333;;M;71;CHILENO;;Silencioso;RENCA                         ;METROPOLITANA;82980;2;1;0;0;0;2;1;82980;Horno Electrico UT-BACKOFEN26 26Lts;ELECTRODOMESTICOS
17285511;;F;33;CHILENO;;Millenial;VILLARICA                     ;ARAUCANIA;444960;6;3;0;0;0;6;3;444960;Horno Microondas Digital UT-CLASSY720 20Lts;ELECTRODOMESTICOS
13334549;Soltero;F;44;CHILENO;;X;RENCA                         ;METROPOLITANA;32990;1;1;0;0;0;1;1;32990;Combo Juguera + Hervidor;ELECTRODOMESTICOS
18448545;;F;28;CHILENO;;Millenial;N/D;N/D;654920;8;4;6;2;544940;2;2;109980;Batidora Manual TH-8830;ELECTRODOMESTICOS
10694094;;F;55;CHILENO;;Boomers;N/D;N/D;96060;2;1;0;0;0;2;1;96060;Aspiradora UT-SILENT1804 Arrastre 1800Watts;ELECTRODOMESTICOS
5258676;;M;74;CHILENO;;Silencioso;PENCO                         ;BIO BIO;571340;8;6;0;0;0;8;6;571340;Hervidor Electrico Tetera HA-4100 4Lts Iox;ELECTRODOMESTICOS
6432623;;M;71;CHILENO;;Silencioso;PUERTO MONTT                  ;LOS LAGOS;64980;2;2;0;0;0;2;2;64980;Hervidor Inox One Midea;ELECTRODOMESTICOS
7354370;;F;66;CHILENO;;Boomers;TALCA                         ;MAULE;129980;2;2;0;0;0;2;2;129980;Horno Electrico TH62I 60Lts;ELECTRODOMESTICOS
14033675;;F;42;CHILENO;;X;CANETE                        ;BIO BIO;572959;4;2;0;0;0;4;2;572959;Horno Microondas Digital ME0113MB1/XZS 32Lts;ELECTRODOMESTICOS
18712130;;M;27;CHILENO;;Millenial;"";"";96980;2;1;0;0;0;2;1;96980;Horno Electrico TH-38N 38Lts;ELECTRODOMESTICOS
7685065;;F;65;CHILENO;;Boomers;PROVIDENCIA                   ;METROPOLITANA;43980;2;1;0;0;0;2;1;43980;HERVIDOR TH-6070Vi 1.8L;ELECTRODOMESTICOS
16649557;;F;34;CHILENO;;Millenial;LEBU                          ;BIO BIO;437110;6;3;0;0;0;6;3;437110;Licuadora Roja 550W 1,5Lts Vaso Vidrio;ELECTRODOMESTICOS
15789526;;F;38;CHILENO;;Millenial;SAN BERNARDO;METROPOLITANA;49980;2;1;0;0;0;2;1;49980;Plancha UT-PLATTEISEN 2000Watts Base Ceramica;ELECTRODOMESTICOS
12867240;;F;46;CHILENO;;X;ALTO HOSPICIO;TARAPACA;64990;1;1;0;0;0;1;1;64990;ASPIRADORA THOMAS TH-1640;ELECTRODOMESTICOS
5133586;;M;75;CHILENO;;Silencioso;N/D;N/D;69980;2;1;0;0;0;2;1;69980;Aspiradora TH1415 Arrastre 1500Watts;ELECTRODOMESTICOS
26108740;;M;30;VENEZOLANO;;Extranjero;N/D;N/D;29393;1;1;0;0;0;1;1;29393;LICUADORA CROMADA CON TECLAS PLUS;ELECTRODOMESTICOS
6853298;;M;69;CHILENO;;Silencioso;NANCAGUA                      ;L.G.B.OÂ´HIGGINS;17493;1;1;0;0;0;1;1;17493;Hervidor Electrico TH-5407i 2Lts;ELECTRODOMESTICOS
5559926;;M;76;CHILENO;;Silencioso;PROVIDENCIA                   ;METROPOLITANA;15990;1;1;0;0;0;1;1;15990;Hervidor Electrico UT-MANLY17 1,7Lts Negro;ELECTRODOMESTICOS
14191814;;F;41;CHILENO;;X;EL MONTE                      ;METROPOLITANA;218580;3;2;0;0;0;3;2;218580;Hervidor Family Kettle HE500;ELECTRODOMESTICOS
11728229;;M;51;CHILENO;;X;LA LIGUA                      ;VALPARAISO;132980;2;2;0;0;0;2;2;132980;Horno Electrico TH-38N 38Lts;ELECTRODOMESTICOS
13303046;;F;44;CHILENO;;X;PROVIDENCIA                   ;METROPOLITANA;343960;4;3;0;0;0;4;3;343960;Hervidor Electrico TH-4515N 2Lts Negro;ELECTRODOMESTICOS
14192191;;F;41;CHILENO;;X;LA PINTANA                    ;METROPOLITANA;15990;1;1;0;0;0;1;1;15990;Hervidor Electrico Tetera UT-LECKER18R 1,8Lts;ELECTRODOMESTICOS
15304648;;M;40;CHILENO;;Silencioso;PROVIDENCIA                   ;METROPOLITANA;52980;2;1;2;1;52980;0;0;0;Horno Microondas Mecanico Fancy 20Lts;ELECTRODOMESTICOS
16310625;;F;35;CHILENO;;Millenial;SAN FERNANDO                  ;L.G.B.OÂ´HIGGINS;321134;7;6;0;0;0;7;6;321134;Plancha a Vapor 5001;ELECTRODOMESTICOS
15045167;;F;37;CHILENO;;Millenial;COMBARBALA                    ;COQUIMBO;39990;1;1;0;0;0;1;1;39990;Licuadora Kaliman Negra con Teclas;ELECTRODOMESTICOS
8736264;;M;63;CHILENO;;Boomers;TALCA                         ;MAULE;574930;12;4;0;0;0;12;4;574930;Batidora Pedestal UT-KLEIN700;ELECTRODOMESTICOS
6222793;;M;69;CHILENO;;Silencioso;N/D;N/D;260973;3;2;2;1;239980;1;1;20993;Combo Licuadora + Batidora;ELECTRODOMESTICOS
18918109;;F;28;CHILENO;;Millenial;PROVIDENCIA                   ;METROPOLITANA;63980;2;1;2;1;63980;0;0;0;Olla Multiuso TH-40PC 0,5Lts;ELECTRODOMESTICOS
11252531;;M;54;CHILENO;;X;ANCUD                         ;LOS LAGOS;683920;8;6;0;0;0;8;6;683920;Tostador de Pan TH-116 2 Rebanadas Negro;ELECTRODOMESTICOS
27652576;;F;29;CHILENO;;Extranjero;"";"";49970;3;1;0;0;0;3;1;49970;Freidora de Aire 18M Oster;ELECTRODOMESTICOS
8054224;;F;64;CHILENO;;Boomers;CANETE                        ;BIO BIO;115980;2;2;0;0;0;2;2;115980;Extractor de Jugo EX800 1,4Lts;ELECTRODOMESTICOS
7114730;;F;75;CHILENO;;Silencioso;N/D;N/D;1237110;14;5;0;0;0;14;5;1237110;Plancha THOMAS TH-7170 2200Watts Base Ceramica;ELECTRODOMESTICOS
16830950;;F;34;CHILENO;;Millenial;N/D;N/D;198970;3;2;0;0;0;3;2;198970;Licuadora Roja 550W 1,5Lts Vaso Vidrio;ELECTRODOMESTICOS
4655287;;F;79;CHILENO;;Silencioso;COLBUN                        ;MAULE;143920;4;2;0;0;0;4;2;143920;Batidora Manual 3532;ELECTRODOMESTICOS
15908496;;F;37;CHILENO;;Millenial;LA SERENA;COQUIMBO;944930;7;3;7;3;944930;0;0;0;Olla Multiuso TH-40PC 0,5Lts;ELECTRODOMESTICOS
5247270;;M;84;CHILENO;;Silencioso;CASTRO                        ;LOS LAGOS;122890;3;2;0;0;0;3;2;122890;Horno Microondas Digital TH-20S01 20Lts;ELECTRODOMESTICOS
18452145;Soltero;F;28;CHILENO;INGENIERIA EN PREVENCION DE RIESGOS CALIDAD Y AMBIENTE;Millenial;PROVIDENCIA                   ;METROPOLITANA;159970;3;2;0;0;0;3;2;159970;Horno Electrico UT-BACKOFEN60 60Lts;ELECTRODOMESTICOS
6206111;;F;72;CHILENO;;Silencioso;SAN JAVIER                    ;MAULE;215380;4;2;0;0;0;4;2;215380;Horno Electrico TH-48N 48Lts;ELECTRODOMESTICOS
6145234;;F;73;CHILENO;;Silencioso;ARICA                         ;ARICA Y PARINACOTA;40980;2;2;0;0;0;2;2;40980;HERVIDOR BERLIN 1,7 LITROS;ELECTRODOMESTICOS
10263431;;M;58;CHILENO;;Boomers;CHILLAN                       ;BIO BIO;438300;4;2;0;0;0;4;2;438300;Horno Electrico TH-38N 38Lts;ELECTRODOMESTICOS
10277450;;M;55;CHILENO;;Boomers;QUINTERO                      ;VALPARAISO;10990;1;1;0;0;0;1;1;10990;Hervidor Inox One Midea;ELECTRODOMESTICOS
17887933;Soltero;M;31;CHILENO;TECNICO MECANICO;Millenial;PROVIDENCIA                   ;METROPOLITANA;14990;1;1;0;0;0;1;1;14990;HERVIDOR COLONIA 1,7 LITROS;ELECTRODOMESTICOS
13344943;;F;43;CHILENO;;X;RENCA                         ;METROPOLITANA;20980;2;1;0;0;0;2;1;20980;HERVIDOR COLONIA 1,7 LITROS;ELECTRODOMESTICOS
8835516;;F;60;CHILENO;;Boomers;ARICA                         ;ARICA Y PARINACOTA;348950;5;3;2;1;208980;3;2;139970;Horno Microondas Mecanico Easy Wave 20Lts;ELECTRODOMESTICOS
17644132;;F;32;CHILENO;;Millenial;VALLENAR;ATACAMA;-252510;1;3;1;3;-252510;0;0;0;ASPIRADORA POLVO Y AGUA APA-1150 IN;ELECTRODOMESTICOS
13399258;;M;44;CHILENO;;X;PROVIDENCIA                   ;METROPOLITANA;89990;1;1;0;0;0;1;1;89990;Horno Electrico TH62I 60Lts;ELECTRODOMESTICOS
16156891;;F;36;CHILENO;;Millenial;CORONEL                       ;BIO BIO;622960;4;3;3;2;242970;1;1;379990;Licuadora Personal TH-300PB;ELECTRODOMESTICOS
7590500;;F;67;CHILENO;;Boomers;PUNTA ARENAS                  ;MAGALLANES;38990;1;1;0;0;0;1;1;38990;Picadora 1-2-3 AD6011CL 750W;ELECTRODOMESTICOS
19792193;;F;24;CHILENO;;Z;PROVIDENCIA                   ;METROPOLITANA;121820;2;1;0;0;0;2;1;121820;Horno Electrico TH62I 60Lts;ELECTRODOMESTICOS
7358351;Casado;M;66;CHILENO;;Boomers;"";"";256960;4;2;4;2;256960;0;0;0;Olla Multiuso TH-40PC 0,5Lts;ELECTRODOMESTICOS
11607828;;F;52;CHILENO;;X;EL MONTE                      ;METROPOLITANA;554940;6;4;0;0;0;6;4;554940;Hervidor Electrico UT-DUNKEL17P 2Lts Negro;ELECTRODOMESTICOS
20280704;;F;22;CHILENO;;Z;PUENTE ALTO;METROPOLITANA;46980;2;2;0;0;0;2;2;46980;Licuadora UT-METALLEK505P 1,5Lts Vaso Vidrio;ELECTRODOMESTICOS
4156246;;M;72;CHILENO;;Silencioso;SAN JAVIER                    ;MAULE;281611;4;3;0;0;0;4;3;281611;Plancha UT-DUNST 2200Watts Base Ceramica;ELECTRODOMESTICOS
16331652;;M;35;CHILENO;;Millenial;"";"";109990;1;1;0;0;0;1;1;109990;Horno Microondas Digital L UT-25KROMM 25Lts;ELECTRODOMESTICOS
16685899;;F;33;CHILENO;;Millenial;AISEN                         ;AYSEN;21990;1;1;0;0;0;1;1;21990;Hervidor Electrico TH-4515N 2Lts Negro;ELECTRODOMESTICOS
8283922;;F;55;CHILENO;;Boomers;SAN ANTONIO                   ;VALPARAISO;259970;3;3;0;0;0;3;3;259970;Aspiradora TH1407 Arrastre 1400Watts;ELECTRODOMESTICOS
13394408;;M;44;CHILENO;;X;RENCA                         ;METROPOLITANA;290760;2;1;0;0;0;2;1;290760;Maquina de Coser ST-371HD Heavy Duty;ELECTRODOMESTICOS
11319283;;M;54;CHILENO;;Boomers;SAN JAVIER                    ;MAULE;290443;6;5;0;0;0;6;5;290443;Hervidor Electrico TH-5407i 2Lts;ELECTRODOMESTICOS
18795449;;M;28;CHILENO;;Millenial;PEDRO AGUIRRE CERDA           ;METROPOLITANA;154970;3;2;0;0;0;3;2;154970;Horno Microondas Mecanico Fancy 20Lts;ELECTRODOMESTICOS
13581413;;M;42;CHILENO;;X;CANETE                        ;BIO BIO;34980;2;2;0;0;0;2;2;34980;Hervidor Electrico TH-4515N 2Lts Negro;ELECTRODOMESTICOS
14634087;;F;45;CHILENO;;X;TALCA                         ;MAULE;354240;8;2;0;0;0;8;2;354240;HORNO ELECTRICO HE-600IN INOX SINDELEN;ELECTRODOMESTICOS
10178627;;F;60;CHILENO;;Boomers;SAN FERNANDO                  ;L.G.B.OÂ´HIGGINS;15990;1;1;0;0;0;1;1;15990;Plancha UT-KERAMIK1 2200Watts Base Ceramica;ELECTRODOMESTICOS
7170655;;F;68;CHILENO;;Silencioso;ARICA                         ;ARICA Y PARINACOTA;484950;5;2;0;0;0;5;2;484950;FREIDORA DE AIRE THOMAS TH-AF60Mi;ELECTRODOMESTICOS
18230643;Soltero;M;29;CHILENO;;Millenial;PROVIDENCIA                   ;METROPOLITANA;24990;1;2;0;0;0;1;2;24990;Plancha UT-DUNST 2200Watts Base Ceramica;ELECTRODOMESTICOS
5468971;;M;77;CHILENO;;Silencioso;PROVIDENCIA                   ;METROPOLITANA;15990;1;1;0;0;0;1;1;15990;Plancha Easy Steam (PV4500);ELECTRODOMESTICOS
5572677;;M;71;CHILENO;;Silencioso;PROVIDENCIA                   ;METROPOLITANA;69990;1;1;0;0;0;1;1;69990;HORNO ELECTRICO MUNICH 60 LITROS;ELECTRODOMESTICOS
15847004;;M;44;CHILENO;;X;TRAIGUEN                      ;ARAUCANIA;87980;2;2;0;0;0;2;2;87980;Horno Microondas Digital UT-CLASSY720 20Lts;ELECTRODOMESTICOS
6428558;;M;70;CHILENO;;Silencioso;CALERA                        ;VALPARAISO;26316;5;1;0;0;0;5;1;26316;Exprimidor Fauna 500 cc;ELECTRODOMESTICOS
11543105;;F;52;CHILENO;;X;N/D;N/D;79990;1;1;1;1;79990;0;0;0;HORNO ELECTRICO THOMAS TH-38i;ELECTRODOMESTICOS
16088944;;M;36;CHILENO;;Millenial;"";"";120970;3;3;0;0;0;3;3;120970;Hervidor Electrico Tetera UT-LECKER18R 1,8Lts;ELECTRODOMESTICOS
12577318;Casado;F;48;CHILENO;;X;RENCA                         ;METROPOLITANA;16990;1;1;0;0;0;1;1;16990;Set Hervidor Valory VK330 Blanco + Tostador de;ELECTRODOMESTICOS
10018327;;F;58;CHILENO;;Boomers;N/D;N/D;131811;5;2;0;0;0;5;2;131811;HORNO ELECTRICO BREMEN 23 LITROS;ELECTRODOMESTICOS
8705285;;F;64;CHILENO;;Boomers;SAN VICENTE                   ;L.G.B.OÂ´HIGGINS;11990;1;1;0;0;0;1;1;11990;Exprimidor de Jugo CJ-2000 1Lts;ELECTRODOMESTICOS
16928119;Soltero;M;33;CHILENO;;Millenial;RENCA                         ;METROPOLITANA;95900;2;1;0;0;0;2;1;95900;Horno Microondas Mecanico M-2020NG 20Lts;ELECTRODOMESTICOS
8568223;;F;65;CHILENO;;Boomers;VALDIVIA                      ;LOS RIOS;22990;1;1;0;0;0;1;1;22990;Tostador de PanTH-120R 2 Rebanadas Rojo;ELECTRODOMESTICOS
13786439;;M;41;CHILENO;;X;PROVIDENCIA                   ;METROPOLITANA;59990;1;1;0;0;0;1;1;59990;Licuadora L-25000NG;ELECTRODOMESTICOS
16076528;;M;36;CHILENO;;Millenial;QUINTA NORMAL                 ;METROPOLITANA;397950;5;3;0;0;0;5;3;397950;Horno Microondas Digital ME0113MB1/XZS 32Lts;ELECTRODOMESTICOS
8037866;;M;60;CHILENO;;Boomers;COIHAIQUE                     ;AYSEN;504950;5;5;0;0;0;5;5;504950;FREIDORA DE AIRE THOMAS TH-AF60Mi;ELECTRODOMESTICOS
15155933;;F;39;CHILENO;;X;"";"";373972;3;2;0;0;0;3;2;373972;ASPIRADORA THOMAS TH-1640;ELECTRODOMESTICOS
16503829;;F;37;CHILENO;;Millenial;LOTA                          ;BIO BIO;156980;2;2;0;0;0;2;2;156980;HORNO ELECTRICO HE-600IN INOX SINDELEN;ELECTRODOMESTICOS
14188591;;F;40;CHILENO;;X;"";"";181940;6;5;1;1;59990;5;4;121950;Parrilla Electrica TH-180;ELECTRODOMESTICOS
8989998;;F;61;CHILENO;;Boomers;PROVIDENCIA                   ;METROPOLITANA;29990;1;1;0;0;0;1;1;29990;Combo Licuadora + Batidora;ELECTRODOMESTICOS
12479028;;F;49;CHILENO;;X;PUENTE ALTO                   ;METROPOLITANA;43980;2;1;2;1;43980;0;0;0;Horno Microondas Mecanico C1700N 17Lts Blanco;ELECTRODOMESTICOS
8616738;;F;61;CHILENO;;Boomers;YUMBEL                        ;BIO BIO;105900;2;1;0;0;0;2;1;105900;Horno Electrico UT-BACKOFEN48 48Lts;ELECTRODOMESTICOS
11303495;;M;53;CHILENO;;X;CARAHUE                       ;ARAUCANIA;39240;2;1;0;0;0;2;1;39240;Hervidor Electrico Tetera TH-6505RT 1,7Lts Rojo;ELECTRODOMESTICOS
18363746;Soltero;F;28;CHILENO;INTERPRETE DE IDIOMAS;Millenial;PROVIDENCIA                   ;METROPOLITANA;13990;1;1;0;0;0;1;1;13990;Plancha Easy Steam (PV4500);ELECTRODOMESTICOS
6924149;;F;68;CHILENO;;Silencioso;NUEVA IMPERIAL                ;ARAUCANIA;499960;5;2;0;0;0;5;2;499960;Horno Electrico TH-100i 100Lts;ELECTRODOMESTICOS
13613066;;M;42;CHILENO;;X;TALCA                         ;MAULE;115900;2;1;0;0;0;2;1;115900;Horno Electrico TH62I 60Lts;ELECTRODOMESTICOS
10955821;;M;52;CHILENO;;X;SANTIAGO;METROPOLITANA;142980;2;2;0;0;0;2;2;142980;Horno Microondas Digital L UT-25KROMM 25Lts;ELECTRODOMESTICOS
17003449;;M;33;CHILENO;;Millenial;ARICA                         ;ARICA Y PARINACOTA;711510;5;3;2;1;591540;3;2;119970;Horno Microondas Mecanico M-2020NG 20Lts;ELECTRODOMESTICOS
16221913;;F;36;CHILENO;;Millenial;PROVIDENCIA                   ;METROPOLITANA;12990;1;1;0;0;0;1;1;12990;Hervidor Electrico TH-4212N 1,7Lts Negro;ELECTRODOMESTICOS
8506238;;F;64;CHILENO;;Boomers;RENCA                         ;METROPOLITANA;12990;1;1;0;0;0;1;1;12990;HERVIDOR BERLIN 1,7 LITROS;ELECTRODOMESTICOS
19723786;;M;24;CHILENO;;Z;PROVIDENCIA                   ;METROPOLITANA;16990;1;1;0;0;0;1;1;16990;HERVIDOR TH-4340;ELECTRODOMESTICOS
13035538;;F;46;CHILENO;;X;PAPUDO                        ;VALPARAISO;439940;6;6;0;0;0;6;6;439940;Horno Microondas Digital UT-CLASSY720 20Lts;ELECTRODOMESTICOS
27065682;;F;26;VENEZOLANO;;Extranjero;CURICO                        ;MAULE;77960;4;3;2;1;19980;2;2;57980;LICUADORA CROMADA CON TECLAS PLUS;ELECTRODOMESTICOS
7856197;;F;66;CHILENO;;Boomers;COIHAIQUE                     ;AYSEN;89990;1;1;0;0;0;1;1;89990;Aspiradora TH1870 Arrastre 1800Watts Gris;ELECTRODOMESTICOS
13263226;;M;45;CHILENO;;X;PEDRO AGUIRRE CERDA           ;METROPOLITANA;125480;5;1;0;0;0;5;1;125480;Licuadora Oster Clasica Azul 4134 1,25 lt;ELECTRODOMESTICOS
16545470;;F;35;CHILENO;;Millenial;PROVIDENCIA                   ;METROPOLITANA;24990;1;1;0;0;0;1;1;24990;Batidora Vertical Multimixer TH-8720;ELECTRODOMESTICOS
25667594;;F;29;VENEZOLANO;;Extranjero;"";"";17980;3;2;2;1;10990;1;1;6990;Hervidor Inox One Midea;ELECTRODOMESTICOS
7566622;;M;65;CHILENO;;Boomers;PROVIDENCIA                   ;METROPOLITANA;39990;1;1;0;0;0;1;1;39990;Horno Electrico TH-25N01 25Lts;ELECTRODOMESTICOS
9617610;;M;58;CHILENO;;Boomers;CASTRO                        ;LOS LAGOS;59990;1;1;0;0;0;1;1;59990;Horno Electrico TH-25N01 25Lts;ELECTRODOMESTICOS
12426863;;M;49;CHILENO;;X;OVALLE                        ;COQUIMBO;300970;3;3;0;0;0;3;3;300970;Plancha Easy Steam (PV4500);ELECTRODOMESTICOS
23983446;;F;26;PERUANO;;Extranjero;CONCHALI;METROPOLITANA;149990;1;1;0;0;0;1;1;149990;Maquina de coser Singer 024;ELECTRODOMESTICOS
11745672;;F;51;CHILENO;;X;LINARES                       ;MAULE;32990;1;1;0;0;0;1;1;32990;Combo Juguera + Hervidor;ELECTRODOMESTICOS
16701153;;F;34;CHILENO;;Millenial;LA GRANJA                     ;METROPOLITANA;15990;1;1;0;0;0;1;1;15990;Hervidor Electrico 3101 1,7Lts Negro;ELECTRODOMESTICOS
17389684;;M;33;CHILENO;;Millenial;SAN BERNARDO                  ;METROPOLITANA;82970;3;3;0;0;0;3;3;82970;Hervidor Electrico UT-KLAR20PW 2Lts Blanco;ELECTRODOMESTICOS
15953241;;F;38;CHILENO;;Millenial;SAN CARLOS                    ;BIO BIO;125854;13;4;0;0;0;13;4;125854;Exprimidor Fauna 500 cc;ELECTRODOMESTICOS
8077255;Viudo;F;61;CHILENO;;Boomers;RENCA                         ;METROPOLITANA;24990;1;1;0;0;0;1;1;24990;PLANCHA VAPOR TH-7146;ELECTRODOMESTICOS
12961166;Casado;F;45;CHILENO;SECRETARIA;X;RENCA                         ;METROPOLITANA;14990;1;1;0;0;0;1;1;14990;Plancha a Vapor 5001;ELECTRODOMESTICOS
16310435;;M;35;CHILENO;;Millenial;RENCA                         ;METROPOLITANA;79980;2;2;0;0;0;2;2;79980;Licuadora Oster Clasica Azul 4134 1,25 lt;ELECTRODOMESTICOS
25405028;;M;34;VENEZOLANO;;Extranjero;SANTIAGO;METROPOLITANA;33980;2;1;2;1;33980;0;0;0;Licuadora Roja 550W 1,5Lts Vaso Vidrio;ELECTRODOMESTICOS
16345519;;M;36;CHILENO;;Millenial;CERRO NAVIA;METROPOLITANA;93919;6;2;6;2;93919;0;0;0;Cafetera UT-KAFFEEKLASSIK;ELECTRODOMESTICOS
7314760;;F;62;CHILENO;;Boomers;SAN BERNARDO                  ;METROPOLITANA;58980;2;2;1;1;23990;1;1;34990;Licuadora Kaliman Negra con Teclas;ELECTRODOMESTICOS
26906935;;M;38;EXTRANJERO - NO INFORMA NACIONALIDAD;;Extranjero;"";"";49990;1;1;1;1;49990;0;0;0;FREIDORA DE AIRE BAVIERA 3,8 LITROS;ELECTRODOMESTICOS
13547660;;F;43;CHILENO;;X;EL MONTE                      ;METROPOLITANA;151080;3;2;0;0;0;3;2;151080;Maquina de coser Singer 1605;ELECTRODOMESTICOS
11170563;;F;54;CHILENO;;Boomers;RENCA                         ;METROPOLITANA;25990;1;1;0;0;0;1;1;25990;Plancha UT-KERAMIKTOP 2200Watts Base Ceramica;ELECTRODOMESTICOS
25417083;Soltero;F;31;PERUANO;;Extranjero;PROVIDENCIA                   ;METROPOLITANA;44980;2;1;2;1;44980;0;0;0;Extractor de Jugo EX800 1,4Lts;ELECTRODOMESTICOS
9376796;;F;61;CHILENO;;Boomers;PADRE LAS CASAS               ;ARAUCANIA;86980;2;2;0;0;0;2;2;86980;Licuadora L2000VNG 1,5Lts Vaso Vidrio;ELECTRODOMESTICOS
12279537;;M;49;CHILENO;;X;CARTAGENA                     ;VALPARAISO;300950;5;3;0;0;0;5;3;300950;Olla Multiuso 6801 5,7Lts;ELECTRODOMESTICOS
18482305;;F;29;CHILENO;;Millenial;PROVIDENCIA                   ;METROPOLITANA;129990;1;1;1;1;129990;0;0;0;CAFETERA PRIMA LATTE 6603 ROJA;ELECTRODOMESTICOS
11738386;;M;50;CHILENO;;X;VALDIVIA                      ;LOS RIOS;109990;1;1;0;0;0;1;1;109990;Horno Electrico TH62I 60Lts;ELECTRODOMESTICOS
5721320;;M;71;CHILENO;;Silencioso;RENCA                         ;METROPOLITANA;119990;1;1;0;0;0;1;1;119990;Horno Microondas Digital L UT-25KROMM 25Lts;ELECTRODOMESTICOS
12242854;;M;50;CHILENO;;X;N/D;N/D;456950;5;3;4;2;423960;1;1;32990;Combo Juguera + Hervidor;ELECTRODOMESTICOS
11618014;;F;52;CHILENO;;X;COPIAPO                       ;ATACAMA;138171;8;5;0;0;0;8;5;138171;LICUADORA HANOVER 1,5 LITROS;ELECTRODOMESTICOS
19224598;;F;26;CHILENO;;Z;N/D;N/D;59980;2;2;2;2;59980;0;0;0;Hervidor Electrico TH-4515N 2Lts Negro;ELECTRODOMESTICOS
12541591;;F;49;CHILENO;;X;NATALES                       ;MAGALLANES;116970;3;3;0;0;0;3;3;116970;Aspiradora TH1870 Arrastre 1800Watts Gris;ELECTRODOMESTICOS
12201558;;F;51;CHILENO;;X;PUENTE ALTO                   ;METROPOLITANA;31980;2;2;0;0;0;2;2;31980;Hervidor Family Kettle HE500;ELECTRODOMESTICOS
25843128;;F;47;VENEZOLANO;;Extranjero;SAN JAVIER                    ;MAULE;85697;4;2;0;0;0;4;2;85697;Horno Microondas Mecanico Easy Wave 20Lts;ELECTRODOMESTICOS
5292017;;M;78;CHILENO;;Silencioso;N/D;N/D;309980;2;2;1;1;249990;1;1;59990;Aspiradora UT-SILENT1603 Arrastre 1600Watts;ELECTRODOMESTICOS
6948382;;M;63;CHILENO;;Boomers;VICTORIA                      ;ARAUCANIA;139990;1;1;0;0;0;1;1;139990;Horno Electrico UT-BACKOFEN60 60Lts;ELECTRODOMESTICOS
15463022;;F;39;CHILENO;;X;PROVIDENCIA                   ;METROPOLITANA;92980;2;2;0;0;0;2;2;92980;Aspiradora UT-SILENT1804 Arrastre 1800Watts;ELECTRODOMESTICOS
19897518;;M;24;CHILENO;;Z;CANETE                        ;BIO BIO;70990;3;1;0;0;0;3;1;70990;ASPIRADORA ROBOT WIFI FIDDLER HOME BLANCA;ELECTRODOMESTICOS
13705174;;M;42;CHILENO;;X;PROVIDENCIA                   ;METROPOLITANA;508960;4;2;4;2;508960;0;0;0;Maquina para Hacer Pan MPP-600 BL;ELECTRODOMESTICOS
20970875;;F;20;CHILENO;;Z;"";"";98950;5;1;0;0;0;5;1;98950;Combo Hervidor + Tostador + Sandwichera;ELECTRODOMESTICOS
12974448;;F;45;CHILENO;;X;LOS ANGELES                   ;BIO BIO;68710;2;3;0;0;0;2;3;68710;Aspiradora UT-SILENT1804 Arrastre 1800Watts;ELECTRODOMESTICOS
10491391;;F;57;CHILENO;;Boomers;RENCA                         ;METROPOLITANA;96980;2;1;0;0;0;2;1;96980;Horno Microondas Digital MS23K3513AK/ZS 23Lts;ELECTRODOMESTICOS
17190559;;F;32;CHILENO;;Millenial;NATALES                       ;MAGALLANES;55980;2;2;0;0;0;2;2;55980;HORNO 10 LITROS OSTER ROJO;ELECTRODOMESTICOS
16887695;;F;34;CHILENO;;Millenial;VILLA ALEMANA;VALPARAISO;59990;1;1;0;0;0;1;1;59990;Aspiradora UT-SILENT1603 Arrastre 1600Watts;ELECTRODOMESTICOS
18661443;;M;28;CHILENO;;Millenial;PROVIDENCIA                   ;METROPOLITANA;109990;1;1;1;1;109990;0;0;0;Horno Electrico TH-80i 80Lts;ELECTRODOMESTICOS
7098844;Viudo;F;73;CHILENO;PROFESOR;Silencioso;VILLARICA                     ;ARAUCANIA;129990;1;1;0;0;0;1;1;129990;Maquina de coser Singer 1605;ELECTRODOMESTICOS
8867762;Soltero;M;61;CHILENO;MEDICO CIRUJANO;Boomers;PROVIDENCIA                   ;METROPOLITANA;19990;1;1;0;0;0;1;1;19990;Hervidor Electrico TH-4515N 2Lts Negro;ELECTRODOMESTICOS
11849828;;M;51;CHILENO;;X;RENCA                         ;METROPOLITANA;93980;2;1;2;1;93980;0;0;0;Multiolla Bioceramic Oster;ELECTRODOMESTICOS
6000725;;F;72;CHILENO;;Millenial;OVALLE                        ;COQUIMBO;598300;19;5;0;0;0;19;5;598300;HORNO ELECTRICO 16 LITROS HE-16NG;ELECTRODOMESTICOS
26609314;;M;30;VENEZOLANO;;Extranjero;N/D;N/D;79970;3;2;0;0;0;3;2;79970;Batidora Pedestal TH910PN 4,6Lts 1300Watts;ELECTRODOMESTICOS
13397969;;F;44;CHILENO;;X;RENCA                         ;METROPOLITANA;71980;2;2;0;0;0;2;2;71980;Picadora TH-9020V Vaso Vidrio 2Lts;ELECTRODOMESTICOS
17034721;;F;33;CHILENO;;Millenial;N/D;N/D;35240;4;2;0;0;0;4;2;35240;HORNO ELECTRICO BREMEN 23 LITROS;ELECTRODOMESTICOS
16440895;;F;52;CHILENO;;X;PUENTE ALTO                   ;METROPOLITANA;64990;1;1;0;0;0;1;1;64990;Horno Microondas Mecanico TH-18B05 18Lts;ELECTRODOMESTICOS
12693878;;F;47;CHILENO;;X;PROVIDENCIA                   ;METROPOLITANA;14990;1;1;0;0;0;1;1;14990;Hervidor Inox One Midea;ELECTRODOMESTICOS
19295846;Soltero;M;26;CHILENO;;Z;COQUIMBO                      ;COQUIMBO;182970;5;4;0;0;0;5;4;182970;FREIDORA DE AIRE BAVIERA 3,8 LITROS;ELECTRODOMESTICOS
8407802;Viudo;F;62;CHILENO;;Boomers;PROVIDENCIA                   ;METROPOLITANA;64990;1;1;0;0;0;1;1;64990;Horno Microondas Mecanico TH-18B05 18Lts;ELECTRODOMESTICOS
11283139;;F;53;CHILENO;;X;SAGRADA FAMILIA               ;MAULE;12990;1;1;0;0;0;1;1;12990;Exprimidor Fauna 500 cc;ELECTRODOMESTICOS
7164020;;F;79;CHILENO;;Silencioso;RENCA                         ;METROPOLITANA;49990;1;1;0;0;0;1;1;49990;Horno Electrico UT-BACKOFEN26 26Lts;ELECTRODOMESTICOS
8102001;;M;64;CHILENO;;Boomers;RENGO                         ;L.G.B.OÂ´HIGGINS;82980;2;2;0;0;0;2;2;82980;Plancha THOMAS TH-7170 2200Watts Base Ceramica;ELECTRODOMESTICOS
23857402;;F;30;BOLIVIANO;;Extranjero;"";"";29990;1;1;0;0;0;1;1;29990;Combo Licuadora + Batidora;ELECTRODOMESTICOS
16327479;;M;36;CHILENO;;Millenial;N/D;N/D;26230;3;1;0;0;0;3;1;26230;TOSTADOR OLDEMBURGO 2 REBANADAS;ELECTRODOMESTICOS
10644238;Soltero;F;57;CHILENO;PROF ED ESPEC;Boomers;RENCA                         ;METROPOLITANA;36990;1;1;0;0;0;1;1;36990;HORNO ELECTRICO 16N01 16LTS NEGRO;ELECTRODOMESTICOS
18017874;;M;31;CHILENO;;Millenial;CANETE                        ;BIO BIO;17990;1;1;0;0;0;1;1;17990;Hervidor Electrico UT-MANLY17 1,7Lts Negro;ELECTRODOMESTICOS
9531676;;M;56;CHILENO;;Boomers;CANETE                        ;BIO BIO;174970;3;3;0;0;0;3;3;174970;Batidora Vertical Stick Mixer 2609;ELECTRODOMESTICOS
11438342;;M;53;CHILENO;;X;PENCAHUE                      ;MAULE;179980;2;2;0;0;0;2;2;179980;Aspiradora TH1870 Arrastre 1800Watts Gris;ELECTRODOMESTICOS
8061218;;F;67;CHILENO;;Boomers;VILLA ALEMANA                 ;VALPARAISO;319590;5;3;0;0;0;5;3;319590;LICUADORA CROMADA CON TECLAS PLUS;ELECTRODOMESTICOS
18289907;Soltero;F;29;CHILENO;;Millenial;PROVIDENCIA                   ;METROPOLITANA;84990;1;1;0;0;0;1;1;84990;Horno Electrico UT-BACKOFEN38 38Lts;ELECTRODOMESTICOS
16524703;;M;35;CHILENO;;Millenial;CHILLAN VIEJO                 ;BIO BIO;974090;11;4;0;0;0;11;4;974090;Batidora Pedestal TH910PN 4,6Lts 1300Watts;ELECTRODOMESTICOS
14271418;Casado;F;48;CHILENO;;X;PROVIDENCIA                   ;METROPOLITANA;53980;2;1;2;1;53980;0;0;0;Horno Microondas Digital TH-20S01 20Lts;ELECTRODOMESTICOS
12718285;Soltero;M;47;CHILENO;;X;ILLAPEL                       ;COQUIMBO;80710;2;1;0;0;0;2;1;80710;Horno Microondas Mecanico TH-18B05 18Lts;ELECTRODOMESTICOS
13309246;Casado;M;45;CHILENO;ARQUITECTO;X;LAS CONDES                    ;METROPOLITANA;133980;2;1;0;0;0;2;1;133980;CAFETERA PRIMA LATTE 6603 ROJA;ELECTRODOMESTICOS
23598042;;F;66;PERUANO;;Extranjero;TALAGANTE                     ;METROPOLITANA;9990;1;1;0;0;0;1;1;9990;HERVIDOR COLONIA 1,7 LITROS;ELECTRODOMESTICOS
7026264;;M;69;CHILENO;;Silencioso;CAUQUENES                     ;MAULE;396970;3;3;0;0;0;3;3;396970;Licuadora L-1630V Negra 1,5Lts Vaso Vidrio;ELECTRODOMESTICOS
10539425;;F;53;CHILENO;;X;TALAGANTE                     ;METROPOLITANA;41632;2;1;0;0;0;2;1;41632;Combo Hervidor + Tostador + Sandwichera;ELECTRODOMESTICOS
9570077;;M;56;CHILENO;;Boomers;PUENTE ALTO                   ;METROPOLITANA;298920;7;6;6;5;285930;1;1;12990;Hervidor Electrico Tetera HA-4100 4Lts Iox;ELECTRODOMESTICOS
9108236;;F;61;CHILENO;;Boomers;N/D;N/D;249450;5;6;0;0;0;5;6;249450;Batidora Vertical Stick Mixer 2609;ELECTRODOMESTICOS
15312317;;F;40;CHILENO;;X;N/D;N/D;10240;2;1;0;0;0;2;1;10240;Batidora Vertical Stick Mixer 2609;ELECTRODOMESTICOS
11939881;;F;49;CHILENO;;X;OVALLE                        ;COQUIMBO;224980;2;2;0;0;0;2;2;224980;Hervidor Electrico TH-4515N 2Lts Negro;ELECTRODOMESTICOS
17073795;;M;33;CHILENO;;Millenial;PROVIDENCIA                   ;METROPOLITANA;608930;7;5;0;0;0;7;5;608930;HERVIDOR COLONIA 1,7 LITROS;ELECTRODOMESTICOS
17102434;;M;33;CHILENO;;Millenial;"";"";64970;3;2;0;0;0;3;2;64970;PLANCHA A VAPOR 6953 BASE AEROCERAMICA AUTAPA.22;ELECTRODOMESTICOS
10620512;;F;49;CHILENO;;X;N/D;N/D;112980;2;2;0;0;0;2;2;112980;Horno Microondas Mecanico TH-18B05 18Lts;ELECTRODOMESTICOS
8995375;;M;58;CHILENO;;Boomers;CALERA                        ;VALPARAISO;12990;1;1;0;0;0;1;1;12990;PLANCHA A VAPOR 4070 SUELA CERAMICA 2500W;ELECTRODOMESTICOS
25686500;;M;45;COLOMBIANO;;Extranjero;N/D;N/D;79461;2;1;0;0;0;2;1;79461;Horno Microondas Mecanico M-2020NG 20Lts;ELECTRODOMESTICOS
12635764;;F;47;CHILENO;;X;SAN ANTONIO                   ;VALPARAISO;364952;5;4;1;1;99990;4;3;264962;CAFETERA PRIMA LATTE 6603 ROJA;ELECTRODOMESTICOS
10271459;;M;58;CHILENO;;Boomers;CURANILAHUE                   ;BIO BIO;287980;2;2;0;0;0;2;2;287980;LICUADORA HANOVER 1,5 LITROS;ELECTRODOMESTICOS
18102549;;F;29;CHILENO;;Millenial;N/D;N/D;131200;8;7;1;3;6990;7;4;124210;HERVIDOR COLONIA 1,7 LITROS;ELECTRODOMESTICOS
25525259;;M;47;BOLIVIANO;;Extranjero;IQUIQUE                       ;TARAPACA;796930;7;7;0;0;0;7;7;796930;Hervidor Electrico TH-4212N 1,7Lts Negro;ELECTRODOMESTICOS
18509355;;F;29;CHILENO;;Millenial;LA PINTANA                    ;METROPOLITANA;21990;1;1;0;0;0;1;1;21990;Hervidor Electrico TH-4515N 2Lts Negro;ELECTRODOMESTICOS
15702114;;F;38;CHILENO;;X;PUENTE ALTO                   ;METROPOLITANA;453940;6;5;0;0;0;6;5;453940;Horno Microondas Digital TH-25DM 25Lts;ELECTRODOMESTICOS
6832174;;M;66;CHILENO;;Boomers;LOTA                          ;BIO BIO;273970;3;2;0;0;0;3;2;273970;Batidora Pedestal TH910PN 4,6Lts 1300Watts;ELECTRODOMESTICOS
12943508;;F;45;CHILENO;;X;LA SERENA                     ;COQUIMBO;1440830;14;4;0;0;0;14;4;1440830;Horno Electrico TH-38N 38Lts;ELECTRODOMESTICOS
15190289;;F;40;CHILENO;;X;PROVIDENCIA                   ;N/D;102970;3;2;0;0;0;3;2;102970;Horno Microondas Digital MS23K3513AK/ZS 23Lts;ELECTRODOMESTICOS
9203318;;M;60;CHILENO;;Boomers;SAN FERNANDO                  ;L.G.B.OÂ´HIGGINS;129990;1;1;0;0;0;1;1;129990;SUPER FREIDORA DE AIRE OV3;ELECTRODOMESTICOS
15333881;;F;38;CHILENO;;Millenial;PROVIDENCIA                   ;METROPOLITANA;18990;1;1;1;1;18990;0;0;0;Licuadora Berry Blender Roja 1400 Vaso Vidrio;ELECTRODOMESTICOS
19399660;Soltero;F;26;CHILENO;;Z;PROVIDENCIA                   ;METROPOLITANA;26990;1;1;0;0;0;1;1;26990;Licuadora L-1630V Negra 1,5Lts Vaso Vidrio;ELECTRODOMESTICOS
15823202;;F;37;CHILENO;;Millenial;PUDAHUEL;METROPOLITANA;112450;4;1;4;1;112450;0;0;0;Freidora electrica Ut-KeramikAir;ELECTRODOMESTICOS
10152863;;M;57;CHILENO;;Boomers;PROVIDENCIA                   ;METROPOLITANA;66970;3;2;2;1;46980;1;1;19990;Olla a Presion Multiolla Daily Food 6L;ELECTRODOMESTICOS
15993873;;F;37;CHILENO;;Millenial;VILLA ALEGRE                  ;MAULE;29990;1;1;0;0;0;1;1;29990;Licuadora BL1500 Silver 1,75Lts Vaso Vidrio;ELECTRODOMESTICOS
14259821;;M;47;CHILENO;;X;EL BOSQUE                     ;METROPOLITANA;302320;7;5;0;0;0;7;5;302320;HERVIDOR COLONIA 1,7 LITROS;ELECTRODOMESTICOS
16095522;;F;37;CHILENO;;Millenial;PROVIDENCIA                   ;METROPOLITANA;28990;1;1;1;1;28990;0;0;0;Combo Licuadora + Batidora;ELECTRODOMESTICOS
19722743;;F;24;CHILENO;;Z;N/D;N/D;84970;3;1;3;1;84970;0;0;0;FREIDORA DE AIRE BAVIERA 3,8 LITROS;ELECTRODOMESTICOS
7850770;;F;66;CHILENO;;Boomers;N/D;N/D;12990;1;1;0;0;0;1;1;12990;HERVIDOR COLONIA 1,7 LITROS;ELECTRODOMESTICOS
8785846;;M;60;CHILENO;;Boomers;RENCA                         ;METROPOLITANA;596960;4;2;0;0;0;4;2;596960;HERVIDOR BERLIN 1,7 LITROS;ELECTRODOMESTICOS
10407442;Soltero;F;58;CHILENO;;Boomers;MELIPILLA                     ;METROPOLITANA;45000;2;1;0;0;0;2;1;45000;Horno Microondas Mecanico Fancy 20Lts;ELECTRODOMESTICOS
11450337;;M;54;CHILENO;;X;RENCA                         ;METROPOLITANA;29990;1;1;0;0;0;1;1;29990;HORNO ELECTRICO BREMEN 23 LITROS;ELECTRODOMESTICOS
16776487;;M;34;CHILENO;;Millenial;VINA DEL MAR                  ;VALPARAISO;166980;3;2;0;0;0;3;2;166980;Horno Microondas Mecanico Fancy 20Lts;ELECTRODOMESTICOS
12984330;;F;46;CHILENO;;X;ANGOL                         ;ARAUCANIA;44970;3;2;0;0;0;3;2;44970;Hervidor Electrico UT-MANLY17 1,7Lts Negro;ELECTRODOMESTICOS
11440891;;M;53;CHILENO;;X;RENCA                         ;METROPOLITANA;49990;1;1;0;0;0;1;1;49990;Horno Microondas Mecanico Easy Wave 20Lts;ELECTRODOMESTICOS
10624752;;F;56;CHILENO;;Boomers;RENCA                         ;METROPOLITANA;89990;1;1;0;0;0;1;1;89990;Horno Microondas Digital TH-25DM 25Lts;ELECTRODOMESTICOS
13372115;;M;43;CHILENO;;X;PAINE                         ;METROPOLITANA;143610;7;4;0;0;0;7;4;143610;FREIDORA DE AIRE HESSIA 2,0 LITROS;ELECTRODOMESTICOS
18984738;;F;30;CHILENO;;Millenial;N/D;N/D;29990;1;1;0;0;0;1;1;29990;BATIDORA INMERSION S MIX 2616;ELECTRODOMESTICOS
11487267;;F;53;CHILENO;;X;N/D;N/D;35970;3;2;0;0;0;3;2;35970;Hervidor Electrico 3101 1,7Lts Negro;ELECTRODOMESTICOS
13948645;;F;44;CHILENO;;X;PROVIDENCIA                   ;METROPOLITANA;179970;3;2;0;0;0;3;2;179970;Hervidor Electrico TH-4515N 2Lts Negro;ELECTRODOMESTICOS
15655955;;M;38;CHILENO;;X;TEMUCO;ARAUCANIA;84990;1;1;0;0;0;1;1;84990;Horno Microondas Digital MS23K3513AK/ZS 23Lts;ELECTRODOMESTICOS
10328875;;M;54;CHILENO;;X;RENCA                         ;METROPOLITANA;114990;1;1;0;0;0;1;1;114990;Horno Microondas Digital ME0113MB1/XZS 32Lts;ELECTRODOMESTICOS
10360958;;F;55;CHILENO;;Boomers;SAN CARLOS                    ;BIO BIO;89990;1;1;0;0;0;1;1;89990;Horno Electrico TH-48N 48Lts;ELECTRODOMESTICOS
12878026;;F;47;CHILENO;;X;PROVIDENCIA                   ;METROPOLITANA;126980;2;2;0;0;0;2;2;126980;Horno Microondas Digital TH-25DM 25Lts;ELECTRODOMESTICOS
17386178;;F;32;CHILENO;;Millenial;PROVIDENCIA                   ;METROPOLITANA;103980;2;1;2;1;103980;0;0;0;Maquina de coser Singer 1605;ELECTRODOMESTICOS
20475183;;M;21;CHILENO;;Z;PROVIDENCIA                   ;METROPOLITANA;19990;1;1;0;0;0;1;1;19990;Licuadora L-1630V Negra 1,5Lts Vaso Vidrio;ELECTRODOMESTICOS
6547408;;F;65;CHILENO;;Boomers;LINARES                       ;MAULE;380732;7;5;2;1;44980;5;4;335752;Aspiradora Handy Clean Black 1400;ELECTRODOMESTICOS
11254934;;M;54;CHILENO;;Boomers;"";"";129430;4;1;0;0;0;4;1;129430;Licuadora Reversible Roja;ELECTRODOMESTICOS
13096461;;M;46;CHILENO;;X;RANCAGUA                      ;L.G.B.OÂ´HIGGINS;37990;1;1;1;1;37990;0;0;0;Horno Electrico TH-25N01 25Lts;ELECTRODOMESTICOS
18748560;;F;28;CHILENO;;Millenial;SAN BERNARDO                  ;METROPOLITANA;145650;4;3;0;0;0;4;3;145650;Plancha THOMAS TH-7170 2200Watts Base Ceramica;ELECTRODOMESTICOS
18789989;Soltero;M;27;CHILENO;;Z;PROVIDENCIA                   ;METROPOLITANA;39990;1;1;1;1;39990;0;0;0;HORNO ELECTRICO BREMEN 23 LITROS;ELECTRODOMESTICOS
25479008;Soltero;F;35;VENEZOLANO;;Extranjero;PROVIDENCIA                   ;METROPOLITANA;63980;2;1;2;1;63980;0;0;0;ASPIRADORA VCC4580V3K/XZS SAMSUNG BLACK;ELECTRODOMESTICOS
10432660;;F;56;CHILENO;;Boomers;RENCA                         ;METROPOLITANA;133980;2;1;0;0;0;2;1;133980;SUPER FREIDORA DE AIRE OV3;ELECTRODOMESTICOS
10375048;;F;58;CHILENO;;Boomers;PROVIDENCIA                   ;METROPOLITANA;15990;1;1;0;0;0;1;1;15990;Hervidor Electrico UT-MANLY17 1,7Lts Negro;ELECTRODOMESTICOS
19097627;Soltero;M;26;CHILENO;;Z;CAUQUENES                     ;MAULE;220970;6;4;0;0;0;6;4;220970;Wafflera time blanca WJ170112 700W;ELECTRODOMESTICOS
8808014;;M;60;CHILENO;;Boomers;SAN FELIPE;VALPARAISO;104980;2;2;2;2;104980;0;0;0;PLANCHA A VAPOR 6003 BASE ANTIADHERENTE 1600W;ELECTRODOMESTICOS
13575503;;F;42;CHILENO;;X;CONSTITUCION                  ;MAULE;54990;1;1;0;0;0;1;1;54990;Horno Electrico UT-BACKOFEN26 26Lts;ELECTRODOMESTICOS
11884109;;F;51;CHILENO;;X;SAN BERNARDO                  ;METROPOLITANA;44990;1;1;0;0;0;1;1;44990;Horno Electrico TH-25N01 25Lts;ELECTRODOMESTICOS
13520281;;F;44;CHILENO;;X;N/D;N/D;534940;6;4;0;0;0;6;4;534940;Exprimidor Fauna 500 cc;ELECTRODOMESTICOS
11181705;;F;54;CHILENO;;Boomers;RENCA                         ;METROPOLITANA;197810;2;1;0;0;0;2;1;197810;Maquina de Coser 311;ELECTRODOMESTICOS
11498149;;M;53;CHILENO;;X;CORONEL                       ;BIO BIO;39990;1;1;0;0;0;1;1;39990;Freidora de Aire 18M Oster;ELECTRODOMESTICOS
20597759;;F;21;CHILENO;;Z;SAN BERNARDO;METROPOLITANA;36230;3;2;1;1;19990;2;1;16240;Hervidor Electrico UT-MANLY17 1,7Lts Negro;ELECTRODOMESTICOS
17453360;Soltero;F;32;CHILENO;PSICOLOGO;Millenial;PROVIDENCIA                   ;METROPOLITANA;75980;2;1;2;1;75980;0;0;0;Freidora FDV Airflow;ELECTRODOMESTICOS
14027597;;M;40;CHILENO;;X;N/D;N/D;274980;2;2;0;0;0;2;2;274980;Horno Electrico TH-100i 100Lts;ELECTRODOMESTICOS
7741477;;F;67;CHILENO;;Boomers;COLINA                        ;METROPOLITANA;259970;3;3;0;0;0;3;3;259970;Licuadora TH-501V 1,5Lts Vaso Vidrio;ELECTRODOMESTICOS
12745447;;M;46;CHILENO;;X;PROVIDENCIA                   ;METROPOLITANA;153690;2;1;0;0;0;2;1;153690;Horno Microondas Digital L UT-25KROMM 25Lts;ELECTRODOMESTICOS
4989945;;M;77;CHILENO;;Silencioso;CANETE                        ;BIO BIO;273970;3;3;0;0;0;3;3;273970;SUPER FREIDORA DE AIRE OV3;ELECTRODOMESTICOS
16669871;;F;34;CHILENO;;Millenial;N/D;N/D;507880;12;8;3;2;176970;9;6;330910;Licuadora L2000VNG 1,5Lts Vaso Vidrio;ELECTRODOMESTICOS
19847859;;F;24;CHILENO;;Z;"";"";189970;3;2;0;0;0;3;2;189970;Batidora Pedestal TH910PN 4,6Lts 1300Watts;ELECTRODOMESTICOS
17398566;;F;32;CHILENO;;Millenial;PROVIDENCIA                   ;METROPOLITANA;37980;2;1;0;0;0;2;1;37980;Set Hervidor Valory VK330 Blanco + Tostador de;ELECTRODOMESTICOS
17507297;Soltero;F;31;CHILENO;;Millenial;PROVIDENCIA                   ;METROPOLITANA;32990;1;1;0;0;0;1;1;32990;Licuadora Personal TH-300PB;ELECTRODOMESTICOS
13046798;;F;45;CHILENO;;X;N/D;N/D;14990;1;1;0;0;0;1;1;14990;PLANCHA A VAPOR 6003 BASE ANTIADHERENTE 1600W;ELECTRODOMESTICOS
18256655;Soltero;M;29;CHILENO;;Millenial;PROVIDENCIA                   ;METROPOLITANA;38980;2;2;0;0;0;2;2;38980;Plancha Easy Steam (PV4500);ELECTRODOMESTICOS
9895808;Soltero;F;57;CHILENO;;Boomers;RENCA                         ;METROPOLITANA;39990;1;1;0;0;0;1;1;39990;Aspiradora TH1407 Arrastre 1400Watts;ELECTRODOMESTICOS
10900171;;F;58;CHILENO;;Boomers;PUCON                         ;ARAUCANIA;129980;2;2;0;0;0;2;2;129980;Batidora Pedestal TH910PN 4,6Lts 1300Watts;ELECTRODOMESTICOS
12900476;;F;46;CHILENO;;X;CODEGUA                       ;L.G.B.OÂ´HIGGINS;154980;2;2;0;0;0;2;2;154980;Hervidor Inox One Midea;ELECTRODOMESTICOS
18174721;;M;31;CHILENO;;Millenial;N/D;N/D;30980;2;1;0;0;0;2;1;30980;Licuadora Berry Blender Roja 1400 Vaso Vidrio;ELECTRODOMESTICOS
5577882;Casado;M;73;CHILENO;;Silencioso;PROVIDENCIA                   ;METROPOLITANA;12990;1;1;0;0;0;1;1;12990;Exprimidor Fauna 500 cc;ELECTRODOMESTICOS
14622737;;F;43;CHILENO;;X;N/D;N/D;903920;8;3;0;0;0;8;3;903920;TOSTADOR OLDEMBURGO 2 REBANADAS;ELECTRODOMESTICOS
5750814;;F;77;CHILENO;;Silencioso;OVALLE                        ;COQUIMBO;12990;1;1;0;0;0;1;1;12990;PLANCHA A VAPOR 4070 SUELA CERAMICA 2500W;ELECTRODOMESTICOS
10008629;;M;57;CHILENO;;Boomers;TOCOPILLA                     ;ANTOFAGASTA;506940;6;2;0;0;0;6;2;506940;Horno Electrico TH-80i 80Lts;ELECTRODOMESTICOS
5296436;;M;77;CHILENO;;Silencioso;CHILLAN                       ;BIO BIO;56970;3;3;0;0;0;3;3;56970;Batidora Manual TH-8830;ELECTRODOMESTICOS
12108259;;F;46;CHILENO;;X;QUILPUE                       ;VALPARAISO;49990;1;1;0;0;0;1;1;49990;Horno Microondas Mecanico Easy Wave 20Lts;ELECTRODOMESTICOS
10699903;;F;54;CHILENO;;Boomers;RENCA                         ;METROPOLITANA;186960;4;3;0;0;0;4;3;186960;Aspiradora UT-SILENT1603 Arrastre 1600Watts;ELECTRODOMESTICOS
25947259;;M;38;VENEZOLANO;;Extranjero;N/D;N/D;481970;3;2;1;1;409990;2;1;71980;Licuadora L-25000NG;ELECTRODOMESTICOS
13768010;;M;42;CHILENO;;X;SAN ANTONIO                   ;VALPARAISO;34990;1;1;1;1;34990;0;0;0;Freidora de Aire 18M Oster;ELECTRODOMESTICOS
12354400;;F;49;CHILENO;;X;PROVIDENCIA                   ;METROPOLITANA;49990;1;1;0;0;0;1;1;49990;Horno Microondas Mecanico Easy Wave 20Lts;ELECTRODOMESTICOS
11927894;;F;54;CHILENO;;Boomers;PROVIDENCIA                   ;METROPOLITANA;36990;1;1;0;0;0;1;1;36990;Licuadora TH-401V Roja 1,75Lts Vaso Vidrio;ELECTRODOMESTICOS
17240684;;F;32;CHILENO;;Millenial;CASTRO                        ;LOS LAGOS;726870;13;9;8;6;563920;5;3;162950;Aspiradora Tambor APA1000 1000Watts;ELECTRODOMESTICOS
26334981;;F;32;EXTRANJERO - NO INFORMA NACIONALIDAD;;Extranjero;"";"";125390;4;2;0;0;0;4;2;125390;Licuadora Roja 550W 1,5Lts Vaso Vidrio;ELECTRODOMESTICOS
19213838;;F;26;CHILENO;;Z;LA LIGUA                      ;VALPARAISO;469970;3;3;0;0;0;3;3;469970;PICADORA 123 SILHQUETTE;ELECTRODOMESTICOS
18908830;Soltero;F;27;CHILENO;ENFERMERA;Millenial;PROVIDENCIA                   ;METROPOLITANA;765960;5;2;5;2;765960;0;0;0;Maquina de Coser 3008 Janome Blanco;ELECTRODOMESTICOS
14072094;;M;40;CHILENO;;X;CANETE                        ;BIO BIO;996422;10;5;8;3;929640;2;2;66782;Horno Microondas Digital MS23K3513AK/ZS 23Lts;ELECTRODOMESTICOS
13308408;;F;45;CHILENO;;X;SANTIAGO                      ;METROPOLITANA;12990;1;1;0;0;0;1;1;12990;PLANCHA A VAPOR 4070 SUELA CERAMICA 2500W;ELECTRODOMESTICOS
14297361;;F;47;CHILENO;;X;LEBU                          ;BIO BIO;53980;2;2;0;0;0;2;2;53980;Licuadora Berry Blender Roja 1400 Vaso Vidrio;ELECTRODOMESTICOS
16071953;;F;36;CHILENO;;Millenial;PROVIDENCIA                   ;METROPOLITANA;142960;4;2;4;2;142960;0;0;0;ASPIRADORA VC21K5130VB/ZS SAMSUNG BLUE;ELECTRODOMESTICOS
14472152;;F;41;CHILENO;;X;MAIPU;METROPOLITANA;0;0;2;0;2;0;0;0;0;Exprimidor Fauna 500 cc;ELECTRODOMESTICOS
16822508;;M;34;CHILENO;;Millenial;N/D;N/D;51980;2;1;0;0;0;2;1;51980;Aspiradora UT-MEINER1803 Arrastre 1800Watts;ELECTRODOMESTICOS
5761737;;F;73;CHILENO;;Silencioso;RENCA                         ;METROPOLITANA;49980;2;1;0;0;0;2;1;49980;FREIDORA DE AIRE HESSIA 2,0 LITROS;ELECTRODOMESTICOS
4092899;;F;87;CHILENO;;Silencioso;CURICO                        ;MAULE;49990;1;1;0;0;0;1;1;49990;Horno Electrico UT-BACKOFEN26 26Lts;ELECTRODOMESTICOS
14080432;;F;42;CHILENO;;X;LANCO                         ;LOS RIOS;225970;3;2;2;1;195980;1;1;29990;FREIDORA DE AIRE HESSIA 2,0 LITROS;ELECTRODOMESTICOS
10858446;;M;50;CHILENO;;X;COIHAIQUE                     ;AYSEN;393960;4;3;0;0;0;4;3;393960;Hervidor Electrico Tetera TH-6505RT 1,7Lts Rojo;ELECTRODOMESTICOS
6803837;;F;68;CHILENO;;Silencioso;HUALPEN;BIO BIO;14990;1;1;0;0;0;1;1;14990;Batidora Vertical Stick Mixer 2609;ELECTRODOMESTICOS
11915069;;M;50;CHILENO;;X;CANETE                        ;BIO BIO;171970;3;3;0;0;0;3;3;171970;Combo Juguera + Hervidor;ELECTRODOMESTICOS
14408514;;M;50;CHILENO;;X;PADRE LAS CASAS               ;ARAUCANIA;78970;3;3;0;0;0;3;3;78970;Combo Licuadora + Batidora;ELECTRODOMESTICOS
5331407;;F;75;CHILENO;;Silencioso;OVALLE                        ;COQUIMBO;107980;2;2;0;0;0;2;2;107980;Batidora Manual 3532;ELECTRODOMESTICOS
2558487;;M;83;CHILENO;;Silencioso;CALAMA                        ;ANTOFAGASTA;558910;6;3;0;0;0;6;3;558910;Licuadora L2000VNG 1,5Lts Vaso Vidrio;ELECTRODOMESTICOS
10853082;;F;49;CHILENO;;X;RENCA                         ;METROPOLITANA;19990;1;1;0;0;0;1;1;19990;Licuadora Berry Blender Roja 1400 Vaso Vidrio;ELECTRODOMESTICOS
12301033;;M;50;CHILENO;;X;PENCO                         ;BIO BIO;147980;2;1;2;1;147980;0;0;0;MICROONDAS 30L MG30T5018CK/ZS SAMSUNG;ELECTRODOMESTICOS
11205278;;F;54;CHILENO;;Boomers;ANTOFAGASTA                   ;ANTOFAGASTA;452970;3;2;0;0;0;3;2;452970;Horno Microondas Mecanico TH-18B05 18Lts;ELECTRODOMESTICOS
17159220;;M;32;CHILENO;;Millenial;N/D;N/D;21980;2;1;2;1;21980;0;0;0;HERVIDOR ELECTRICO TELEFUNKEN TF PE800;ELECTRODOMESTICOS
9346011;;F;56;CHILENO;;Boomers;PROVIDENCIA                   ;METROPOLITANA;113980;2;1;2;1;113980;0;0;0;SUPER FREIDORA DE AIRE OV3;ELECTRODOMESTICOS
26028312;;M;32;VENEZOLANO;;Extranjero;"";"";103980;2;1;2;1;103980;0;0;0;SUPER FREIDORA DE AIRE OV3;ELECTRODOMESTICOS
15572671;;F;38;CHILENO;;X;OVALLE                        ;COQUIMBO;129990;1;1;0;0;0;1;1;129990;SUPER FREIDORA DE AIRE OV3;ELECTRODOMESTICOS
10110364;Casado;F;57;CHILENO;PROFESOR;Boomers;SAN VICENTE                   ;L.G.B.OÂ´HIGGINS;320470;7;2;0;0;0;7;2;320470;BATIDORA PEDESTAL RENANIA 5 LITROS;ELECTRODOMESTICOS
13149323;;F;44;CHILENO;;X;PUDAHUEL                      ;METROPOLITANA;24990;1;1;0;0;0;1;1;24990;Licuadora TH-320 Roja/Negro 1,5 Lts Vaso Vidrio;ELECTRODOMESTICOS
6742459;;M;71;CHILENO;;Silencioso;SAN JAVIER                    ;MAULE;11990;1;1;0;0;0;1;1;11990;Hervidor Electrico TH-4212N 1,7Lts Negro;ELECTRODOMESTICOS
11587456;;F;51;CHILENO;;X;RENCA                         ;METROPOLITANA;159980;2;1;2;1;159980;0;0;0;MICROONDAS 30L MG30T5018CN/ZS SAMSUNG.;ELECTRODOMESTICOS
9155910;;M;60;CHILENO;;Boomers;CHILLAN                       ;BIO BIO;13990;2;1;0;0;0;2;1;13990;Batidora Vertical Stick Mixer 2609;ELECTRODOMESTICOS
9108647;Casado;F;61;CHILENO;;Silencioso;PROVIDENCIA                   ;METROPOLITANA;12990;1;1;0;0;0;1;1;12990;Batidora Vertical Stick Mixer 2609;ELECTRODOMESTICOS
11527160;;M;51;CHILENO;;X;EL MONTE                      ;METROPOLITANA;249980;2;2;1;1;19990;1;1;229990;Licuadora Berry Blender Roja 1400 Vaso Vidrio;ELECTRODOMESTICOS
13084560;;F;45;CHILENO;;X;N/D;N/D;119990;1;1;0;0;0;1;1;119990;SUPER FREIDORA DE AIRE OV3;ELECTRODOMESTICOS
9975890;;M;52;CHILENO;;X;SAN ANTONIO                   ;VALPARAISO;49990;1;1;0;0;0;1;1;49990;Horno Microondas Mecanico Easy Wave 20Lts;ELECTRODOMESTICOS
18825627;;M;28;CHILENO;;Millenial;N/D;N/D;60460;3;1;0;0;0;3;1;60460;Horno Electrico TH-25N01 25Lts;ELECTRODOMESTICOS
13782373;;M;41;CHILENO;;X;PROVIDENCIA                   ;METROPOLITANA;14990;1;1;0;0;0;1;1;14990;TOSTADOR OLDEMBURGO 2 REBANADAS;ELECTRODOMESTICOS
14378248;;F;43;CHILENO;;X;CHONCHI                       ;LOS LAGOS;1369920;8;4;0;0;0;8;4;1369920;HERVIDOR HAMBURGO 2,0 LITROS;ELECTRODOMESTICOS
11876492;Divorciado;F;50;CHILENO;;X;RENCA                         ;METROPOLITANA;19990;1;1;0;0;0;1;1;19990;Hervidor Electrico UT-DUNKEL17P 2Lts Negro;ELECTRODOMESTICOS
20540607;;M;22;CHILENO;;Z;PUERTO MONTT                  ;LOS LAGOS;79990;1;1;0;0;0;1;1;79990;Batidora Pedestal TH910PN 4,6Lts 1300Watts;ELECTRODOMESTICOS
4942253;;M;75;CHILENO;;Silencioso;RENCA                         ;METROPOLITANA;47350;2;3;0;0;0;2;3;47350;Licuadora Roja 550W 1,5Lts Vaso Vidrio;ELECTRODOMESTICOS
27399724;;M;28;VENEZOLANO;;Extranjero;SANTIAGO;METROPOLITANA;62990;3;2;0;0;0;3;2;62990;Licuadora Oster Clasica Azul 4134 1,25 lt;ELECTRODOMESTICOS
22486720;Soltero;F;28;CHILENO;ENFERMERA;Extranjero;PROVIDENCIA                   ;METROPOLITANA;43980;2;1;2;1;43980;0;0;0;Horno Microondas Mecanico C1700N 17Lts Blanco;ELECTRODOMESTICOS
27121349;;F;31;VENEZOLANO;;Extranjero;PUERTO MONTT                  ;LOS LAGOS;250930;7;4;4;2;188960;3;2;61970;Batidora Pedestal TH910PN 4,6Lts 1300Watts;ELECTRODOMESTICOS
25762628;;F;45;CHILENO;;Extranjero;N/D;N/D;49990;1;1;1;1;49990;0;0;0;Aspiradora VCC4190V3E/XZS Arrastre 2000Watts;ELECTRODOMESTICOS
11242191;;M;54;CHILENO;;X;LOS ANGELES                   ;BIO BIO;41280;3;1;0;0;0;3;1;41280;Hervidor Electrico TH-4515N 2Lts Negro;ELECTRODOMESTICOS
17216085;;F;33;CHILENO;;Millenial;PROVIDENCIA                   ;METROPOLITANA;28990;1;1;0;0;0;1;1;28990;Tostador de Pan TP-1400 4 Rebanadas Inox;ELECTRODOMESTICOS
6079325;;F;70;CHILENO;;Silencioso;SAN JAVIER                    ;MAULE;99980;2;2;1;1;39990;1;1;59990;Freidora de Aire 18M Oster;ELECTRODOMESTICOS
10879371;;M;54;CHILENO;;X;PROVIDENCIA                   ;METROPOLITANA;39990;1;1;0;0;0;1;1;39990;Licuadora TH-501V 1,5Lts Vaso Vidrio;ELECTRODOMESTICOS
20041548;;F;23;CHILENO;;Z;CALERA DE TANGO;METROPOLITANA;53980;2;1;2;1;53980;0;0;0;BATIDORA PEDESTAL RENANIA 5 LITROS;ELECTRODOMESTICOS
26422446;Soltero;F;52;EXTRANJERO - NO INFORMA NACIONALIDAD;;Extranjero;CHILLAN                       ;BIO BIO;84980;2;1;0;0;0;2;1;84980;ASPIRADORA THOMAS TH-1640;ELECTRODOMESTICOS
8273894;;M;63;CHILENO;;Boomers;ANCUD                         ;LOS LAGOS;107980;2;1;0;0;0;2;1;107980;Horno Electrico TH62I 60Lts;ELECTRODOMESTICOS
19848909;;M;24;CHILENO;;Millenial;"";"";429970;3;2;2;1;389980;1;1;39990;Licuadora TH-501V 1,5Lts Vaso Vidrio;ELECTRODOMESTICOS
26642115;Soltero;F;46;HAITIANO;;Extranjero;CHILLAN                       ;NUBLE;248710;9;2;0;0;0;9;2;248710;Horno Microondas Mecanico Fancy 20Lts;ELECTRODOMESTICOS
18610378;Soltero;M;28;CHILENO;;Millenial;PROVIDENCIA                   ;METROPOLITANA;1219920;8;3;8;3;1219920;0;0;0;SUPER FREIDORA DE AIRE OV3;ELECTRODOMESTICOS
17646246;Casado;M;31;CHILENO;;Millenial;PROVIDENCIA                   ;METROPOLITANA;139990;1;1;1;1;139990;0;0;0;SUPER FREIDORA DE AIRE OV3;ELECTRODOMESTICOS
9359577;;F;60;CHILENO;;Boomers;PUENTE ALTO                   ;METROPOLITANA;21990;1;1;0;0;0;1;1;21990;Licuadora Berry Blender Roja 1400 Vaso Vidrio;ELECTRODOMESTICOS
15395863;;M;40;CHILENO;;X;PROVIDENCIA                   ;METROPOLITANA;0;0;2;0;0;0;0;2;0;Horno Microondas Digital UT-CLASSY720 20Lts;ELECTRODOMESTICOS
26839121;;M;38;VENEZOLANO;;Extranjero;N/D;N/D;73950;5;3;0;0;0;5;3;73950;Hervidor Electrico TH-4212N 1,7Lts Negro;ELECTRODOMESTICOS
12825206;Casado;F;46;CHILENO;;X;RENCA                         ;METROPOLITANA;12990;1;1;0;0;0;1;1;12990;Hervidor Electrico TH-4212N 1,7Lts Negro;ELECTRODOMESTICOS
16206720;;F;36;CHILENO;;Millenial;N/D;N/D;270950;6;4;3;2;116970;3;2;153980;Aspiradora AP1700 Arrastre 1700Watts;ELECTRODOMESTICOS
14211999;;M;40;CHILENO;;X;N/D;N/D;89980;2;2;0;0;0;2;2;89980;Hervidor Electrico TH-4515N 2Lts Negro;ELECTRODOMESTICOS
16255315;Soltero;M;35;CHILENO;;Millenial;PROVIDENCIA                   ;METROPOLITANA;85980;2;1;2;1;85980;0;0;0;Batidora Berry Mixer (KM3000) 1300 watts;ELECTRODOMESTICOS
6887028;;M;71;CHILENO;;Silencioso;RENCA                         ;METROPOLITANA;55980;2;2;0;0;0;2;2;55980;Plancha TH-7052 2000Watts Base Inox;ELECTRODOMESTICOS
16648055;;M;34;CHILENO;;Millenial;MELIPILLA                     ;METROPOLITANA;49990;1;1;0;0;0;1;1;49990;FREIDORA DE AIRE BAVIERA 3,8 LITROS;ELECTRODOMESTICOS
7116957;;M;66;CHILENO;;Boomers;CHILLAN                       ;BIO BIO;32990;1;1;0;0;0;1;1;32990;Licuadora Personal TH-300PB;ELECTRODOMESTICOS
15996300;;M;36;CHILENO;;Extranjero;RANCAGUA                      ;L.G.B.OÂ´HIGGINS;19990;1;1;0;0;0;1;1;19990;Hervidor Electrico TH-4515N 2Lts Negro;ELECTRODOMESTICOS
16389304;;M;36;CHILENO;;Millenial;N/D;N/D;237960;4;3;0;0;0;4;3;237960;Hervidor Electrico HA-3300 2,5Lts Blanco;ELECTRODOMESTICOS
20126636;;F;23;CHILENO;;Z;NOGALES                       ;VALPARAISO;11990;1;1;0;0;0;1;1;11990;Plancha a Vapor 5001;ELECTRODOMESTICOS
14313804;;M;46;CHILENO;;X;OVALLE                        ;COQUIMBO;45970;3;1;0;0;0;3;1;45970;Batidora Manual 3532;ELECTRODOMESTICOS
9818699;;M;58;CHILENO;;Boomers;FREIRE                        ;ARAUCANIA;553310;6;4;0;0;0;6;4;553310;Tostador de Pan TH-126 4 Rebanadas Negro;ELECTRODOMESTICOS
8970220;;F;63;CHILENO;;Boomers;OVALLE                        ;COQUIMBO;50981;3;2;0;0;0;3;2;50981;Hervidor Electrico Tetera HA-4100 4Lts Iox;ELECTRODOMESTICOS
14305117;;F;47;CHILENO;;X;SAN FELIPE                    ;VALPARAISO;19990;1;1;0;0;0;1;1;19990;Hervidor Electrico TH-4515N 2Lts Negro;ELECTRODOMESTICOS
19607570;;F;24;CHILENO;;Z;ANCUD                         ;LOS LAGOS;152970;3;1;0;0;0;3;1;152970;Horno Electrico TH-38N 38Lts;ELECTRODOMESTICOS
15295158;;M;40;CHILENO;;X;PROVIDENCIA                   ;METROPOLITANA;28990;1;1;0;0;0;1;1;28990;Licuadora L2000VNG 1,5Lts Vaso Vidrio;ELECTRODOMESTICOS
7345885;Divorciado;M;66;CHILENO;;Boomers;PROVIDENCIA                   ;METROPOLITANA;19990;1;1;0;0;0;1;1;19990;Combo Hervidor + Batidora;ELECTRODOMESTICOS
10378762;;F;52;CHILENO;;X;ARICA                         ;TARAPACA;49410;2;1;0;0;0;2;1;49410;Licuadora Roja 550W 1,5Lts Vaso Vidrio;ELECTRODOMESTICOS
17668002;;M;31;CHILENO;;Millenial;RINCONADA;VALPARAISO;16990;1;1;0;0;0;1;1;16990;Hervidor Electrico HA-3300 2,5Lts Blanco;ELECTRODOMESTICOS
15904430;;F;37;CHILENO;;Millenial;PUERTO MONTT                  ;LOS LAGOS;419980;2;2;0;0;0;2;2;419980;Horno Electrico TH-80i 80Lts;ELECTRODOMESTICOS
24259047;;F;33;CHILENO;;Millenial;PROVIDENCIA                   ;METROPOLITANA;65250;2;1;0;0;0;2;1;65250;Licuadora Oster Clasica Azul 4134 1,25 lt;ELECTRODOMESTICOS
12844500;;F;46;CHILENO;;X;PROVIDENCIA                   ;METROPOLITANA;29990;1;1;0;0;0;1;1;29990;Cafetera TH-138i;ELECTRODOMESTICOS
13254784;;M;45;CHILENO;;X;MELIPILLA                     ;METROPOLITANA;506970;3;2;2;1;483980;1;1;22990;Tostador de PanTH-120R 2 Rebanadas Rojo;ELECTRODOMESTICOS
16412961;;M;35;CHILENO;;Millenial;N/D;N/D;69980;2;1;0;0;0;2;1;69980;Aspiradora UT-SILENT1603 Arrastre 1600Watts;ELECTRODOMESTICOS
9462394;Casado;F;61;CHILENO;;Boomers;RENCA                         ;METROPOLITANA;407970;3;2;0;0;0;3;2;407970;Aspiradora UT-SILENT1603 Arrastre 1600Watts;ELECTRODOMESTICOS
7989124;;F;62;CHILENO;;Boomers;LA FLORIDA                    ;METROPOLITANA;65800;4;2;0;0;0;4;2;65800;Licuadora Roja 550W 1,5Lts Vaso Vidrio;ELECTRODOMESTICOS
11090091;;F;56;CHILENO;;Boomers;DONIHUE                       ;L.G.B.OÂ´HIGGINS;423960;4;2;0;0;0;4;2;423960;Aspiradora Trapeadora Robot Ut-Excellenza (B);ELECTRODOMESTICOS
20508565;;F;22;CHILENO;;Z;PROVIDENCIA                   ;METROPOLITANA;151470;4;2;1;1;49990;3;1;101480;Horno Electrico UT-BACKOFEN26 26Lts;ELECTRODOMESTICOS
14733443;;M;51;COLOMBIANO;;Extranjero;COIHAIQUE                     ;AYSEN;377940;6;5;0;0;0;6;5;377940;Aspiradora AP1700 Arrastre 1700Watts;ELECTRODOMESTICOS
17664400;;M;31;CHILENO;;Silencioso;NUNOA                         ;METROPOLITANA;59990;2;3;2;1;59990;0;2;0;Maquina de pan FDV Notre-Dame;ELECTRODOMESTICOS
13342359;;M;45;CHILENO;;X;PUENTE ALTO                   ;METROPOLITANA;84990;1;1;0;0;0;1;1;84990;Horno Electrico TH-48N 48Lts;ELECTRODOMESTICOS
17811548;;M;30;CHILENO;;Millenial;"";"";143960;4;3;3;2;63970;1;1;79990;FREIDORA DE AIRE HESSIA 2,0 LITROS;ELECTRODOMESTICOS
16551010;Soltero;F;35;CHILENO;;Millenial;PROVIDENCIA                   ;METROPOLITANA;56980;2;2;1;1;29990;1;1;26990;HORNO ELECTRICO 16N01 16LTS NEGRO;ELECTRODOMESTICOS
4812815;;F;81;CHILENO;;Silencioso;CERRO NAVIA                   ;METROPOLITANA;54230;2;1;0;0;0;2;1;54230;Licuadora Kaliman Negra con Teclas;ELECTRODOMESTICOS
12091137;;F;59;CHILENO;;Boomers;SAN JAVIER                    ;MAULE;70250;2;1;0;0;0;2;1;70250;Aspiradora VCC4190V3E/XZS Arrastre 2000Watts;ELECTRODOMESTICOS
18503668;Soltero;F;28;CHILENO;;Millenial;PROVIDENCIA                   ;METROPOLITANA;43980;2;1;2;1;43980;0;0;0;Freidora de Aire 18M Oster;ELECTRODOMESTICOS
13361584;;M;44;CHILENO;;X;LA LIGUA                      ;VALPARAISO;70970;3;3;0;0;0;3;3;70970;Licuadora Roja 550W 1,5Lts Vaso Vidrio;ELECTRODOMESTICOS
3763913;;M;86;CHILENO;;Silencioso;QUILPUE                       ;VALPARAISO;19990;1;1;0;0;0;1;1;19990;Hervidor Electrico UT-DUNKEL17P 2Lts Negro;ELECTRODOMESTICOS
13504231;;M;44;CHILENO;;X;N/D;N/D;19990;1;1;0;0;0;1;1;19990;Hervidor Electrico TH-4515N 2Lts Negro;ELECTRODOMESTICOS
8396874;;F;50;CHILENO;;X;COIHAIQUE                     ;AYSEN;138970;3;2;3;2;138970;0;0;0;Freidora de Aire Healty Fryer 3.5L;ELECTRODOMESTICOS
10042824;;F;58;CHILENO;;Boomers;LA PINTANA                    ;METROPOLITANA;29990;1;1;0;0;0;1;1;29990;Licuadora Roja 550W 1,5Lts Vaso Vidrio;ELECTRODOMESTICOS
9871952;;F;58;CHILENO;;Boomers;PROVIDENCIA                   ;METROPOLITANA;19990;1;1;0;0;0;1;1;19990;MULTIMIXER THOMAS TH- 8706;ELECTRODOMESTICOS
16451204;Soltero;F;36;CHILENO;;Millenial;PROVIDENCIA                   ;METROPOLITANA;451570;10;5;9;4;406580;1;1;44990;Horno Electrico TH-38N 38Lts;ELECTRODOMESTICOS
19068371;;F;27;CHILENO;;Z;PROVIDENCIA                   ;METROPOLITANA;29990;1;1;0;0;0;1;1;29990;Combo Juguera + Hervidor;ELECTRODOMESTICOS
19990283;;M;23;CHILENO;;Z;PARRAL                        ;MAULE;139990;1;1;0;0;0;1;1;139990;Horno Electrico TH-80i 80Lts;ELECTRODOMESTICOS
8105354;;M;63;CHILENO;;Boomers;RENCA                         ;METROPOLITANA;27990;1;3;0;0;0;1;3;27990;Aspiradora TH1415 Arrastre 1500Watts;ELECTRODOMESTICOS
13852389;;F;49;CHILENO;;X;PROVIDENCIA                   ;METROPOLITANA;135970;3;1;3;1;135970;0;0;0;Maquina para Hacer Pan MPP-600 BL;ELECTRODOMESTICOS
7045497;;M;60;CHILENO;;Boomers;LA PINTANA                    ;METROPOLITANA;19990;1;1;0;0;0;1;1;19990;Hervidor Electrico TH-4515N 2Lts Negro;ELECTRODOMESTICOS
12931339;;F;46;CHILENO;;X;RENCA                         ;METROPOLITANA;85970;3;2;0;0;0;3;2;85970;Horno Microondas Mecanico TH-18B05 18Lts;ELECTRODOMESTICOS
6780562;;M;70;CHILENO;;Silencioso;LA HIGUERA                    ;COQUIMBO;74990;1;1;0;0;0;1;1;74990;Horno Electrico UT-BACKOFEN38 38Lts;ELECTRODOMESTICOS
14351890;;F;42;CHILENO;;X;LOS SAUCES                    ;ARAUCANIA;1040950;5;6;0;0;0;5;6;1040950;Licuadora TH-501V 1,5Lts Vaso Vidrio;ELECTRODOMESTICOS
15968847;;F;37;CHILENO;;Millenial;"";"";145970;3;2;1;1;89990;2;1;55980;FREIDORA DE AIRE HESSIA 2,0 LITROS;ELECTRODOMESTICOS
19651057;;F;24;CHILENO;;Z;CONSTITUCION                  ;MAULE;456481;2;2;0;0;0;2;2;456481;Horno Electrico UT-BACKOFEN48 48Lts;ELECTRODOMESTICOS
8273378;Casado;F;61;CHILENO;PROFESOR;Boomers;RENCA                         ;METROPOLITANA;15990;1;1;0;0;0;1;1;15990;Batidora Vertical Stick Mixer 2609;ELECTRODOMESTICOS
15006902;;M;39;CHILENO;;X;ARICA                         ;ARICA Y PARINACOTA;27990;1;1;0;0;0;1;1;27990;Plancha THOMAS TH-7170 2200Watts Base Ceramica;ELECTRODOMESTICOS
6578953;;M;67;CHILENO;;Boomers;SAN ANTONIO                   ;VALPARAISO;28990;1;3;0;0;0;1;3;28990;HERVIDOR TH-4340;ELECTRODOMESTICOS
16077046;;M;37;CHILENO;;Millenial;SAN FELIPE                    ;VALPARAISO;64990;1;1;0;0;0;1;1;64990;Horno electrico Black Oven 42lts;ELECTRODOMESTICOS
15991119;;F;37;CHILENO;;Millenial;PROVIDENCIA                   ;METROPOLITANA;99990;1;1;0;0;0;1;1;99990;FREIDORA DE AIRE THOMAS TH-AF60Mi;ELECTRODOMESTICOS
6286091;;M;69;CHILENO;;Silencioso;RENCA                         ;METROPOLITANA;90340;2;1;0;0;0;2;1;90340;Enceradora EA-5000;ELECTRODOMESTICOS
16364268;;M;36;CHILENO;;Millenial;COYHAIQUE;AYSEN;72950;5;4;0;0;0;5;4;72950;Tostador de Pan TH-116 2 Rebanadas Negro;ELECTRODOMESTICOS
5994630;;F;80;CHILENO;;Silencioso;DALCAHUE                      ;LOS LAGOS;141970;3;3;0;0;0;3;3;141970;Combo Licuadora + Batidora;ELECTRODOMESTICOS
17371128;;F;32;CHILENO;;Millenial;"";"";93240;3;1;0;0;0;3;1;93240;Horno Electrico TH-48N 48Lts;ELECTRODOMESTICOS
3550618;;F;87;CHILENO;;Silencioso;EL MONTE                      ;METROPOLITANA;15990;1;1;0;0;0;1;1;15990;Hervidor Electrico UT-MANLY17 1,7Lts Negro;ELECTRODOMESTICOS
17765474;;F;30;CHILENO;;Millenial;N/D;N/D;27160;2;1;0;0;0;2;1;27160;Batidora Manual 3532;ELECTRODOMESTICOS
18503268;;M;28;CHILENO;;Millenial;"";"";29990;1;1;1;1;29990;0;0;0;Hervidor Electrico Tetera HA-4100 4Lts Iox;ELECTRODOMESTICOS
5236460;;M;76;CHILENO;;Silencioso;QUILLOTA                      ;VALPARAISO;32990;1;1;0;0;0;1;1;32990;Batidora Vertical Multimixer TH-8720;ELECTRODOMESTICOS
10413352;;F;54;CHILENO;;Boomers;CURICO                        ;MAULE;12990;1;1;0;0;0;1;1;12990;Exprimidor de Jugo CJ-2000 1Lts;ELECTRODOMESTICOS
11645421;;F;51;CHILENO;;X;PANGUIPULLI                   ;LOS LAGOS;79990;1;1;0;0;0;1;1;79990;Horno Microondas Digital UT-CLASSY720 20Lts;ELECTRODOMESTICOS
25224312;Soltero;F;42;BOLIVIANO;;Extranjero;PROVIDENCIA                   ;METROPOLITANA;12990;1;1;1;1;12990;0;0;0;PLANCHA A VAPOR 4070 SUELA CERAMICA 2500W;ELECTRODOMESTICOS
25964124;;M;30;HAITIANO;;Extranjero;"";"";113140;4;1;0;0;0;4;1;113140;Horno Microondas Mecanico Easy Wave 20Lts;ELECTRODOMESTICOS
17166874;;F;33;CHILENO;;Millenial;PROVIDENCIA                   ;METROPOLITANA;19240;2;1;0;0;0;2;1;19240;Cafetera TH-130;ELECTRODOMESTICOS
6908797;;F;69;CHILENO;;Silencioso;ARICA                         ;ARICA Y PARINACOTA;26990;1;1;0;0;0;1;1;26990;Licuadora L2000VNG 1,5Lts Vaso Vidrio;ELECTRODOMESTICOS
16284235;;F;35;CHILENO;;Millenial;PROVIDENCIA                   ;METROPOLITANA;74980;2;2;0;0;0;2;2;74980;Aspiradora VCC4190V3E/XZS Arrastre 2000Watts;ELECTRODOMESTICOS
26577833;;M;44;VENEZOLANO;;Extranjero;LAUTARO                       ;ARAUCANIA;29990;1;1;0;0;0;1;1;29990;Licuadora Roja 550W 1,5Lts Vaso Vidrio;ELECTRODOMESTICOS
12807514;;M;48;CHILENO;;X;PUNITAQUI                     ;COQUIMBO;44990;1;1;0;0;0;1;1;44990;Horno Electrico TH-25N01 25Lts;ELECTRODOMESTICOS
18670725;;M;28;CHILENO;;Millenial;CANETE                        ;BIO BIO;66980;2;1;0;0;0;2;1;66980;Combo Juguera + Hervidor;ELECTRODOMESTICOS
11674139;;M;51;CHILENO;;X;CHIMBARONGO                   ;L.G.B.OÂ´HIGGINS;606710;7;3;0;0;0;7;3;606710;HORNO ELECTRICO DORTMUND 45 LITROS;ELECTRODOMESTICOS
6403813;;F;71;CHILENO;;Silencioso;CABILDO                       ;VALPARAISO;68960;5;2;0;0;0;5;2;68960;Hervidor Inox One Midea;ELECTRODOMESTICOS
11327524;;M;54;CHILENO;;X;N/D;N/D;689610;5;3;4;2;672620;1;1;16990;Aspiradora UT-SILENT1804 Arrastre 1800Watts;ELECTRODOMESTICOS
10197643;;M;57;CHILENO;;Boomers;LA CISTERNA;METROPOLITANA;29990;1;1;0;0;0;1;1;29990;Licuadora BL1500 Silver 1,75Lts Vaso Vidrio;ELECTRODOMESTICOS
18499705;;F;28;CHILENO;;Millenial;PROVIDENCIA                   ;METROPOLITANA;12990;1;1;1;1;12990;0;0;0;PLANCHA A VAPOR 4070 SUELA CERAMICA 2500W;ELECTRODOMESTICOS
7373854;;F;63;CHILENO;;Boomers;PROVIDENCIA                   ;METROPOLITANA;10990;1;1;0;0;0;1;1;10990;Plancha a Vapor Oster 3803;ELECTRODOMESTICOS
16660485;;F;35;CHILENO;;Millenial;PROVIDENCIA                   ;METROPOLITANA;89970;3;1;0;0;0;3;1;89970;Aspiradora VCC4190V3E/XZS Arrastre 2000Watts;ELECTRODOMESTICOS
10554106;;F;57;CHILENO;;Boomers;PROVIDENCIA                   ;METROPOLITANA;19990;1;1;0;0;0;1;1;19990;Licuadora Berry Blender Roja 1400 Vaso Vidrio;ELECTRODOMESTICOS
13984631;;F;40;CHILENO;;X;LLAILLAY                      ;VALPARAISO;12990;1;1;0;0;0;1;1;12990;Plancha Easy Steam (PV4500);ELECTRODOMESTICOS
8478829;;F;61;CHILENO;;Boomers;QUILPUE                       ;VALPARAISO;49990;1;1;0;0;0;1;1;49990;Horno Electrico UT-BACKOFEN26 26Lts;ELECTRODOMESTICOS
15300178;;F;40;CHILENO;;X;N/D;N/D;34990;1;1;0;0;0;1;1;34990;Combo Hervidor + Tostador + Sandwichera;ELECTRODOMESTICOS
11993011;;M;49;CHILENO;;X;RENCA                         ;METROPOLITANA;29990;1;1;1;1;29990;0;0;0;Hervidor Electrico Tetera TH-6505RT 1,7Lts Rojo;ELECTRODOMESTICOS
19298738;Soltero;F;26;CHILENO;;Z;PROVIDENCIA                   ;METROPOLITANA;702930;7;4;7;4;702930;0;0;0;FREIDORA DE AIRE BAVIERA 3,8 LITROS;ELECTRODOMESTICOS
19272188;;F;26;CHILENO;;Z;PANGUIPULLI                   ;LOS LAGOS;32990;1;1;0;0;0;1;1;32990;Hervidor Electrico Tetera HA-4100 4Lts Iox;ELECTRODOMESTICOS
6631244;;M;67;CHILENO;;Boomers;PROVIDENCIA                   ;METROPOLITANA;14990;1;1;0;0;0;1;1;14990;Batidora Vertical Stick Mixer 2609;ELECTRODOMESTICOS
11652632;;M;52;CHILENO;;X;N/D;N/D;609160;4;2;0;0;0;4;2;609160;SUPER FREIDORA DE AIRE OV3;ELECTRODOMESTICOS
17218178;Soltero;F;32;CHILENO;;Silencioso;PROVIDENCIA                   ;METROPOLITANA;54990;1;1;0;0;0;1;1;54990;Horno Microondas Mecanico Easy Wave 20Lts;ELECTRODOMESTICOS
9480494;;M;58;CHILENO;;Boomers;PROVIDENCIA                   ;METROPOLITANA;16990;1;1;0;0;0;1;1;16990;HERVIDOR BERLIN 1,7 LITROS;ELECTRODOMESTICOS
18015204;;F;30;CHILENO;;Millenial;BUIN                          ;METROPOLITANA;55980;2;2;0;0;0;2;2;55980;Plancha THOMAS TH-7170 2200Watts Base Ceramica;ELECTRODOMESTICOS
16679168;;F;35;CHILENO;;Millenial;CONSTITUCION                  ;MAULE;249970;3;2;0;0;0;3;2;249970;HORNO ELECTRICO 16N01 16LTS NEGRO;ELECTRODOMESTICOS
17445357;;M;32;CHILENO;;Millenial;CONCEPCION                    ;BIO BIO;40240;2;1;0;0;0;2;1;40240;Freidora de Aire 18M Oster;ELECTRODOMESTICOS
12014446;;M;54;CHILENO;;Boomers;N/D;N/D;561800;8;3;0;0;0;8;3;561800;Maquina de Coser BM-3850CL Lila;ELECTRODOMESTICOS
15806119;;F;38;CHILENO;;Millenial;RANCAGUA                      ;L.G.B.OÂ´HIGGINS;59990;1;1;0;0;0;1;1;59990;Aspiradora TH1870 Arrastre 1800Watts Gris;ELECTRODOMESTICOS
24430466;;F;48;COLOMBIANO;;Extranjero;N/D;N/D;64980;2;1;2;1;64980;0;0;0;ASPIRADORA THOMAS TH-1022C;ELECTRODOMESTICOS
9837834;;F;59;CHILENO;;Boomers;RETIRO                        ;MAULE;162960;4;4;0;0;0;4;4;162960;Plancha THOMAS TH-7170 2200Watts Base Ceramica;ELECTRODOMESTICOS
12596469;Casado;M;47;CHILENO;INGENIERO CIVIL INDUSTRIAL;X;RENCA                         ;METROPOLITANA;38980;2;1;2;1;38980;0;0;0;Aspiradora Handy Clean Black 1400;ELECTRODOMESTICOS
8071822;;F;61;CHILENO;;Boomers;PROVIDENCIA                   ;METROPOLITANA;26990;1;1;0;0;0;1;1;26990;Cafetera TH-138i;ELECTRODOMESTICOS
10431828;;M;56;CHILENO;;Boomers;TEMUCO                        ;ARAUCANIA;12990;1;1;0;0;0;1;1;12990;Exprimidor de Jugo CJ-2000 1Lts;ELECTRODOMESTICOS
9427397;;F;58;CHILENO;;Boomers;ARICA                         ;ARICA Y PARINACOTA;534290;7;3;0;0;0;7;3;534290;Enceradora EA-5000;ELECTRODOMESTICOS
16661559;Casado;M;34;CHILENO;;Millenial;PROVIDENCIA                   ;METROPOLITANA;98980;2;1;2;1;98980;0;0;0;Horno Microondas Digital MS28F303TAS/ZS 28Lts;ELECTRODOMESTICOS
8165028;Soltero;M;65;CHILENO;;Boomers;CORONEL                       ;BIO BIO;93980;2;2;0;0;0;2;2;93980;Horno Electrico UT-BACKOFEN48 48Lts;ELECTRODOMESTICOS
7801572;Soltero;F;66;CHILENO;SECRETARIA;Boomers;PROVIDENCIA                   ;METROPOLITANA;318980;3;2;2;1;299990;1;1;18990;MULTIMIXER THOMAS TH- 8706;ELECTRODOMESTICOS
9176876;;F;61;CHILENO;;Boomers;PAILLACO                      ;LOS RIOS;71140;4;1;0;0;0;4;1;71140;Licuadora TH-320 Roja/Negro 1,5 Lts Vaso Vidrio;ELECTRODOMESTICOS
2516515;;M;87;CHILENO;;Silencioso;BUIN                          ;METROPOLITANA;16990;1;1;0;0;0;1;1;16990;HERVIDOR TH-4340;ELECTRODOMESTICOS
13358105;;M;44;CHILENO;;X;PROVIDENCIA                   ;METROPOLITANA;34990;1;1;0;0;0;1;1;34990;Cafetera UT-KAFFEEKLASSIK;ELECTRODOMESTICOS
16454800;;F;35;CHILENO;;Millenial;TEMUCO                        ;ARAUCANIA;122964;4;3;1;1;89990;3;2;32974;Batidora Manual 3532;ELECTRODOMESTICOS
18374159;;F;29;CHILENO;;Millenial;EL BOSQUE                     ;METROPOLITANA;294980;3;2;0;0;0;3;2;294980;Horno Microondas Digital TH-25DM 25Lts;ELECTRODOMESTICOS
17992934;;F;30;CHILENO;;Millenial;CHIMBARONGO                   ;L.G.B.OÂ´HIGGINS;186940;6;4;1;1;19990;5;3;166950;Licuadora L-1630V Negra 1,5Lts Vaso Vidrio;ELECTRODOMESTICOS
27200915;;F;31;CHILENO;;Extranjero;VINA DEL MAR                  ;VALPARAISO;275970;3;2;0;0;0;3;2;275970;Licuadora Sport Blender BSE10;ELECTRODOMESTICOS
8166052;;F;63;CHILENO;;Boomers;LOS ANDES                     ;VALPARAISO;627970;3;3;0;0;0;3;3;627970;Plancha THOMAS TH-7170 2200Watts Base Ceramica;ELECTRODOMESTICOS
16884680;;F;33;CHILENO;;Millenial;PROVIDENCIA                   ;METROPOLITANA;12990;1;1;0;0;0;1;1;12990;PLANCHA A VAPOR 4070 SUELA CERAMICA 2500W;ELECTRODOMESTICOS
22381405;;F;42;PERUANO;;Extranjero;MACUL                         ;METROPOLITANA;46980;2;1;2;1;46980;0;0;0;Horno Microondas Mecanico C1700N 17Lts Blanco;ELECTRODOMESTICOS
12670730;;F;47;CHILENO;;X;PROVIDENCIA                   ;METROPOLITANA;16980;2;1;2;1;16980;0;0;0;PLANCHA A VAPOR 4070 SUELA CERAMICA 2500W;ELECTRODOMESTICOS
6224055;;M;70;CHILENO;;Millenial;N/D;N/D;148960;4;2;0;0;0;4;2;148960;Horno Electrico UT-LEIF36 36Lts;ELECTRODOMESTICOS
19679679;;M;24;CHILENO;;Z;DONIHUE                       ;L.G.B.OÂ´HIGGINS;515950;5;2;0;0;0;5;2;515950;Cafetera TH-138i;ELECTRODOMESTICOS
11436404;;M;53;CHILENO;;X;N/D;N/D;12990;1;1;0;0;0;1;1;12990;Exprimidor Fauna 500 cc;ELECTRODOMESTICOS
7874936;;M;66;CHILENO;;Boomers;PROVIDENCIA                   ;METROPOLITANA;31990;1;1;0;0;0;1;1;31990;Licuadora TH-320 Roja/Negro 1,5 Lts Vaso Vidrio;ELECTRODOMESTICOS
15988342;;F;37;CHILENO;;Millenial;TEMUCO                        ;ARAUCANIA;49990;1;1;0;0;0;1;1;49990;Aspiradora Tambor APA1000 1000Watts;ELECTRODOMESTICOS
14059155;;M;41;CHILENO;;X;TALCAHUANO;BIO-BIO;29990;1;1;1;1;29990;0;0;0;HORNO ELECTRICO 16N01 16LTS NEGRO;ELECTRODOMESTICOS
13450577;;F;44;CHILENO;;X;CHONCHI                       ;LOS LAGOS;399960;4;3;0;0;0;4;3;399960;Batidora Manual 3532;ELECTRODOMESTICOS
9543852;;F;59;CHILENO;;Boomers;ANCUD                         ;LOS LAGOS;339450;5;2;0;0;0;5;2;339450;Batidora Manual 3532;ELECTRODOMESTICOS
13841847;;F;42;CHILENO;;X;PARRAL                        ;MAULE;142470;3;2;2;1;105480;1;1;36990;Hervidor Electrico Tetera TH-6505RT 1,7Lts Rojo;ELECTRODOMESTICOS
26477963;;F;29;EXTRANJERO - NO INFORMA NACIONALIDAD;;Extranjero;N/D;N/D;39971;3;2;0;0;0;3;2;39971;Plancha TH-7052 2000Watts Base Inox;ELECTRODOMESTICOS
10068424;;F;59;CHILENO;;Boomers;PANGUIPULLI                   ;LOS RIOS;24990;1;1;0;0;0;1;1;24990;Licuadora L2000VNG 1,5Lts Vaso Vidrio;ELECTRODOMESTICOS
13949619;;F;42;CHILENO;;X;LA FLORIDA                    ;METROPOLITANA;64990;1;1;0;0;0;1;1;64990;Horno Electrico UT-LEIF36 36Lts;ELECTRODOMESTICOS
25790074;;M;44;HAITIANO;;Extranjero;SAN ANTONIO                   ;VALPARAISO;54990;1;1;0;0;0;1;1;54990;Licuadora L-25000NG;ELECTRODOMESTICOS
12744735;;F;47;CHILENO;;X;PADRE LAS CASAS               ;ARAUCANIA;129980;2;2;0;0;0;2;2;129980;Hervidor Electrico TH-4515N 2Lts Negro;ELECTRODOMESTICOS
13937041;;F;42;CHILENO;;X;"";"";16990;1;1;0;0;0;1;1;16990;Batidora Manual 3532;ELECTRODOMESTICOS
7878066;;F;67;CHILENO;;Boomers;VILLARICA                     ;ARAUCANIA;59990;1;1;0;0;0;1;1;59990;Aspiradora TH1870 Arrastre 1800Watts Gris;ELECTRODOMESTICOS
11514189;;M;51;CHILENO;;X;RENCA                         ;METROPOLITANA;526960;4;4;0;0;0;4;4;526960;Hervidor Electrico Tetera HA-4100 4Lts Iox;ELECTRODOMESTICOS
15517663;Casado;F;39;CHILENO;;X;PROVIDENCIA                   ;METROPOLITANA;10990;1;1;0;0;0;1;1;10990;Plancha a Vapor Oster 3803;ELECTRODOMESTICOS
12071085;;M;51;CHILENO;;Silencioso;PROVIDENCIA                   ;METROPOLITANA;59990;1;1;0;0;0;1;1;59990;Licuadora Reversible Roja;ELECTRODOMESTICOS
10318114;;F;48;CHILENO;;X;TOCOPILLA                     ;ANTOFAGASTA;81960;4;3;0;0;0;4;3;81960;HERVIDOR HAMBURGO 2,0 LITROS;ELECTRODOMESTICOS
6066208;;F;69;CHILENO;;Silencioso;COLINA                        ;METROPOLITANA;49990;1;1;0;0;0;1;1;49990;Licuadora Osterizer 4112/72 1,25Lts Vaso Vidrio;ELECTRODOMESTICOS
8593578;;F;54;CHILENO;;X;IQUIQUE                       ;TARAPACA;798891;12;6;0;0;0;12;6;798891;Licuadora Kaliman Negra con Teclas;ELECTRODOMESTICOS
9925041;Casado;F;59;CHILENO;;Boomers;PROVIDENCIA                   ;METROPOLITANA;27990;1;1;0;0;0;1;1;27990;Plancha THOMAS TH-7170 2200Watts Base Ceramica;ELECTRODOMESTICOS
7926783;;F;61;CHILENO;;Boomers;RENCA                         ;METROPOLITANA;169980;2;1;0;0;0;2;1;169980;MAQUINA COSER 2250;ELECTRODOMESTICOS
19723839;;F;24;CHILENO;;Z;N/D;N/D;49990;1;1;0;0;0;1;1;49990;Horno Microondas Mecanico Easy Wave 20Lts;ELECTRODOMESTICOS
9565507;Casado;F;61;CHILENO;;Boomers;RENCA                         ;METROPOLITANA;29990;1;1;0;0;0;1;1;29990;PICADORA 123 SILHQUETTE;ELECTRODOMESTICOS
15200214;;F;41;CHILENO;;X;PROVIDENCIA                   ;METROPOLITANA;196980;2;2;0;0;0;2;2;196980;Licuadora Sport Blender BSE10;ELECTRODOMESTICOS
17611585;;F;31;CHILENO;;Millenial;N/D;N/D;194970;3;2;0;0;0;3;2;194970;CAFETERA PRIMA LATTE 6603 ROJA;ELECTRODOMESTICOS
16277002;;M;36;CHILENO;;Millenial;LO ESPEJO                     ;METROPOLITANA;33230;3;1;0;0;0;3;1;33230;Plancha UT-DUNST 2200Watts Base Ceramica;ELECTRODOMESTICOS
5322838;;F;83;CHILENO;;Silencioso;EL BOSQUE                     ;METROPOLITANA;45980;2;1;0;0;0;2;1;45980;Hervidor Electrico Tetera HA-4100 4Lts Iox;ELECTRODOMESTICOS
19178242;;M;27;CHILENO;;Z;PICHILEMU;O HIGGINS;35990;1;1;0;0;0;1;1;35990;Batidora Vertical Minipimer UT-KLOT800SS;ELECTRODOMESTICOS
12315838;;F;49;CHILENO;;X;PIRQUE;METROPOLITANA;132960;3;1;3;1;132960;0;0;0;Maquina de pan FDV Notre-Dame;ELECTRODOMESTICOS
13786089;Soltero;M;42;CHILENO;;X;RENCA                         ;METROPOLITANA;110980;2;2;0;0;0;2;2;110980;Horno Microondas Mecanico M-2030 NG 20Lts;ELECTRODOMESTICOS
11635607;;F;51;CHILENO;;X;N/D;N/D;143980;2;1;2;1;143980;0;0;0;MICROONDAS 40L MG402MADXBB/ZS SAMSUNG;ELECTRODOMESTICOS
10918462;;M;55;CHILENO;;Boomers;PROVIDENCIA                   ;METROPOLITANA;24990;1;1;0;0;0;1;1;24990;Licuadora L2000VNG 1,5Lts Vaso Vidrio;ELECTRODOMESTICOS
6255080;;F;67;CHILENO;;Boomers;OVALLE                        ;COQUIMBO;94960;4;3;0;0;0;4;3;94960;Plancha a Vapor Oster 3803;ELECTRODOMESTICOS
16851905;;F;34;CHILENO;;Millenial;PROVIDENCIA                   ;METROPOLITANA;149990;1;1;0;0;0;1;1;149990;Horno Electrico TH-80i 80Lts;ELECTRODOMESTICOS
15962890;;F;37;CHILENO;;Millenial;ARAUCO                        ;BIO BIO;860790;7;4;4;2;719820;3;2;140970;Batidora Manual UT-TEKLA300;ELECTRODOMESTICOS
15414245;;F;39;CHILENO;;X;"";"";161940;6;2;5;1;108950;1;1;52990;Maquina para Hacer Pan MPP-600 BL;ELECTRODOMESTICOS
11964688;;F;50;CHILENO;;X;LEBU                          ;BIO BIO;49980;2;2;0;0;0;2;2;49980;Hervidor Electrico Tetera UT-LECKER18R 1,8Lts;ELECTRODOMESTICOS
9641057;;M;58;CHILENO;;Boomers;PROVIDENCIA                   ;METROPOLITANA;109980;2;1;0;0;0;2;1;109980;Horno Microondas Digital UT-CLASSY720 20Lts;ELECTRODOMESTICOS
9773986;;F;59;CHILENO;;Boomers;PAINE                         ;METROPOLITANA;29990;1;1;0;0;0;1;1;29990;PICADORA 123 SILHQUETTE;ELECTRODOMESTICOS
15755301;;M;38;CHILENO;;Millenial;TALCA;MAULE;59980;2;1;0;0;0;2;1;59980;ASPIRADORA THOMAS TH-1640;ELECTRODOMESTICOS
14044027;;M;41;CHILENO;;X;CHILLAN VIEJO                 ;BIO BIO;54990;1;1;0;0;0;1;1;54990;Licuadora L-25000NG;ELECTRODOMESTICOS
3854073;;M;85;CHILENO;;Silencioso;QUINTERO                      ;VALPARAISO;183221;3;4;1;1;149990;2;3;33231;Licuadora L2000VNG 1,5Lts Vaso Vidrio;ELECTRODOMESTICOS
16473237;Soltero;M;35;CHILENO;;Millenial;PROVIDENCIA                   ;METROPOLITANA;39990;1;1;1;1;39990;0;0;0;Freidora de Aire 18M Oster;ELECTRODOMESTICOS
11147415;;F;55;CHILENO;;Boomers;YERBAS BUENAS                 ;MAULE;303980;2;2;0;0;0;2;2;303980;Olla Arrocera OA-400NG 1,8Lts;ELECTRODOMESTICOS
19400577;;M;23;CHILENO;;Z;PROVIDENCIA                   ;METROPOLITANA;39990;1;1;0;0;0;1;1;39990;Aspiradora TH1407 Arrastre 1400Watts;ELECTRODOMESTICOS
13305036;;F;45;CHILENO;;X;TALCA                         ;MAULE;16990;1;1;0;0;0;1;1;16990;HERVIDOR BERLIN 1,7 LITROS;ELECTRODOMESTICOS
18496933;;F;29;CHILENO;;Silencioso;PROVIDENCIA                   ;METROPOLITANA;64980;2;2;2;2;64980;0;0;0;Aspiradora TH1407 Arrastre 1400Watts;ELECTRODOMESTICOS
7256914;;F;69;CHILENO;;Silencioso;PROVIDENCIA                   ;METROPOLITANA;41980;2;1;0;0;0;2;1;41980;BATIDORA INMERSION S MIX 2616;ELECTRODOMESTICOS
6165019;;F;72;CHILENO;;Silencioso;PANGUIPULLI                   ;LOS RIOS;452850;4;2;0;0;0;4;2;452850;ASPIRADORA THOMAS TH-1640;ELECTRODOMESTICOS
5831419;;F;73;CHILENO;;Silencioso;LA SERENA                     ;COQUIMBO;54990;2;1;0;0;0;2;1;54990;Horno Electrico UT-BACKOFEN26 26Lts;ELECTRODOMESTICOS
6226121;;M;72;CHILENO;;Silencioso;COLINA                        ;METROPOLITANA;79980;2;2;0;0;0;2;2;79980;Aspiradora TH1407 Arrastre 1400Watts;ELECTRODOMESTICOS
17409042;;F;31;CHILENO;;Millenial;PROVIDENCIA                   ;METROPOLITANA;139990;1;1;0;0;0;1;1;139990;CAFETERA PRIMA LATTE 6603 ROJA;ELECTRODOMESTICOS
17690035;;F;31;CHILENO;;Millenial;VILLARICA                     ;ARAUCANIA;339940;6;7;0;0;0;6;7;339940;Horno Microondas Mecanico Easy Wave 20Lts;ELECTRODOMESTICOS
17307690;;F;32;CHILENO;;Millenial;LAMPA;METROPOLITANA;30000;2;1;0;0;0;2;1;30000;Combo Licuadora + Batidora;ELECTRODOMESTICOS
7399270;;M;66;CHILENO;;Boomers;CALAMA                        ;ANTOFAGASTA;16991;1;1;0;0;0;1;1;16991;Hervidor Electrico TH-4515N 2Lts Negro;ELECTRODOMESTICOS
14248803;;F;47;CHILENO;;X;CURICO                        ;MAULE;22990;1;1;0;0;0;1;1;22990;Tostador de PanTH-120R 2 Rebanadas Rojo;ELECTRODOMESTICOS
10995277;;F;48;CHILENO;;X;RENCA                         ;METROPOLITANA;28230;3;3;0;2;0;3;1;28230;HERVIDOR HAMBURGO 2,0 LITROS;ELECTRODOMESTICOS
16927934;;M;33;CHILENO;;Millenial;ILLAPEL                       ;COQUIMBO;448955;5;5;0;0;0;5;5;448955;PLANCHA A VAPOR 6953 BASE AEROCERAMICA AUTAPA.22;ELECTRODOMESTICOS
15186665;;M;39;CHILENO;;X;LINARES                       ;MAULE;29990;1;1;0;0;0;1;1;29990;HORNO ELECTRICO 16N01 16LTS NEGRO;ELECTRODOMESTICOS
13121668;;F;46;CHILENO;;X;PUENTE ALTO                   ;METROPOLITANA;94970;3;3;0;0;0;3;3;94970;Freidora de Aire 18M Oster;ELECTRODOMESTICOS
7762905;;M;66;CHILENO;;Boomers;CANETE                        ;BIO BIO;99970;3;3;0;0;0;3;3;99970;Licuadora TH-401V Roja 1,75Lts Vaso Vidrio;ELECTRODOMESTICOS
9486249;;F;61;CHILENO;;Boomers;PROVIDENCIA                   ;METROPOLITANA;54990;1;1;0;0;0;1;1;54990;Aspiradora UT-SILENT1804 Arrastre 1800Watts;ELECTRODOMESTICOS
16771443;;F;34;CHILENO;;Millenial;N/D;N/D;398510;5;3;2;1;231540;3;2;166970;Licuadora Berry Blender Roja 1400 Vaso Vidrio;ELECTRODOMESTICOS
10810915;;F;56;CHILENO;;Boomers;TALCA                         ;MAULE;59990;1;1;0;0;0;1;1;59990;PROCESADOR DE ALIMENTOS UT-PROCESSOR750;ELECTRODOMESTICOS
6907390;;M;68;CHILENO;;Boomers;ILLAPEL                       ;COQUIMBO;73471;3;2;0;0;0;3;2;73471;Horno Electrico UT-BACKOFEN26 26Lts;ELECTRODOMESTICOS
7471724;Casado;F;68;CHILENO;PROFESOR;Boomers;RENCA                         ;METROPOLITANA;21990;1;1;0;0;0;1;1;21990;Batidora Manual BA-5010 Inox;ELECTRODOMESTICOS
12227010;;M;49;CHILENO;;X;PROVIDENCIA                   ;METROPOLITANA;16990;1;1;0;0;0;1;1;16990;Batidora Manual 3532;ELECTRODOMESTICOS
16851703;;F;34;CHILENO;;Millenial;N/D;N/D;229980;2;4;1;1;109990;1;3;119990;SUPER FREIDORA DE AIRE OV3;ELECTRODOMESTICOS
12402317;;F;49;CHILENO;;X;HIJUELAS                      ;VALPARAISO;27990;1;1;0;0;0;1;1;27990;Plancha THOMAS TH-7170 2200Watts Base Ceramica;ELECTRODOMESTICOS
19806891;;F;24;CHILENO;;Z;SAN CLEMENTE                  ;MAULE;9990;1;1;0;0;0;1;1;9990;Plancha a Vapor Oster 3803;ELECTRODOMESTICOS
8230797;Casado;F;65;CHILENO;;Boomers;VINA DEL MAR                  ;VALPARAISO;59990;1;1;0;0;0;1;1;59990;Aspiradora UT-SILENT1603 Arrastre 1600Watts;ELECTRODOMESTICOS
20157514;;M;23;CHILENO;;Silencioso;PROVIDENCIA                   ;METROPOLITANA;29990;1;1;0;0;0;1;1;29990;HORNO ELECTRICO 16N01 16LTS NEGRO;ELECTRODOMESTICOS
6678766;;F;68;CHILENO;;Silencioso;ILLAPEL                       ;COQUIMBO;77980;2;4;0;0;0;2;4;77980;Picadora TH-9020V Vaso Vidrio 2Lts;ELECTRODOMESTICOS
11812595;;F;50;CHILENO;;X;NANCAGUA                      ;L.G.B.OÂ´HIGGINS;714152;5;4;0;0;0;5;4;714152;Hervidor Electrico UT-REIN17SS;ELECTRODOMESTICOS
7947180;Casado;F;63;CHILENO;;Boomers;PROVIDENCIA                   ;METROPOLITANA;64990;1;1;0;0;0;1;1;64990;Horno Microondas Mecanico UT-SYDNEY18 18Lts;ELECTRODOMESTICOS
7114655;;F;68;CHILENO;;Silencioso;CANELA                        ;COQUIMBO;84980;2;2;0;0;0;2;2;84980;Licuadora L1000 Inox 1,7LtsVaso Vidrio;ELECTRODOMESTICOS
8244805;;M;66;CHILENO;;Boomers;CONCEPCION                    ;BIO BIO;561960;4;3;0;0;0;4;3;561960;Licuadora L1000 Inox 1,7LtsVaso Vidrio;ELECTRODOMESTICOS
10829645;;M;55;CHILENO;;Boomers;LUMACO                        ;ARAUCANIA;19990;1;1;0;0;0;1;1;19990;Licuadora Berry Blender Roja 1400 Vaso Vidrio;ELECTRODOMESTICOS
20208935;;M;22;CHILENO;;Z;ANGOL                         ;ARAUCANIA;165970;3;3;0;0;0;3;3;165970;MULTIMIXER THOMAS TH- 8706;ELECTRODOMESTICOS
8591912;;M;63;CHILENO;;Boomers;VILLARICA                     ;ARAUCANIA;59990;1;1;0;0;0;1;1;59990;Aspiradora AP3400 Arrastre 2000Watts;ELECTRODOMESTICOS
13203569;Casado;F;44;CHILENO;;X;RENCA                         ;METROPOLITANA;34990;1;1;0;0;0;1;1;34990;Cafetera UT-KAFFEEKLASSIK;ELECTRODOMESTICOS
15992312;;F;37;CHILENO;;Millenial;QUINTA DE TILCOCO             ;L.G.B.OÂ´HIGGINS;493960;4;2;2;1;151980;2;1;341980;Horno Electrico French Door con Air Fryer;ELECTRODOMESTICOS
12900772;;F;46;CHILENO;;X;MELIPILLA                     ;METROPOLITANA;54990;1;1;0;0;0;1;1;54990;Aspiradora UT-SILENT1804 Arrastre 1800Watts;ELECTRODOMESTICOS
5752526;;M;75;CHILENO;;Silencioso;RENCA                         ;METROPOLITANA;24990;1;3;0;0;0;1;3;24990;Tostador de Pan TP-1400 4 Rebanadas Inox;ELECTRODOMESTICOS
17416450;;M;32;CHILENO;;Millenial;N/D;N/D;119980;2;1;0;0;0;2;1;119980;Horno Microondas Digital TH-25DM 25Lts;ELECTRODOMESTICOS
11259050;;F;54;CHILENO;;X;SAN FERNANDO                  ;L.G.B.OÂ´HIGGINS;133970;3;3;0;0;0;3;3;133970;Plancha a Vapor Oster 3803;ELECTRODOMESTICOS
15031889;;F;37;CHILENO;;Millenial;COPIAPO                       ;ATACAMA;39980;2;1;0;0;0;2;1;39980;Licuadora Berry Blender Roja 1400 Vaso Vidrio;ELECTRODOMESTICOS
8837094;;F;61;CHILENO;;Boomers;CAUQUENES                     ;MAULE;13990;1;1;0;0;0;1;1;13990;PLANCHA A VAPOR 4070 SUELA CERAMICA 2500W;ELECTRODOMESTICOS
15625508;;M;38;CHILENO;;X;PROVIDENCIA                   ;METROPOLITANA;26990;1;1;0;0;0;1;1;26990;Hervidor Electrico UT-REIN17SS;ELECTRODOMESTICOS
17559524;;F;31;CHILENO;;Millenial;NATALES                       ;MAGALLANES;469980;2;3;0;0;0;2;3;469980;Maquina de Coser 311;ELECTRODOMESTICOS
10686514;;F;51;CHILENO;;X;PROVIDENCIA                   ;METROPOLITANA;15990;1;1;0;0;0;1;1;15990;Hervidor Electrico UT-MANLY17 1,7Lts Negro;ELECTRODOMESTICOS
13375090;;M;49;CHILENO;;X;CONSTITUCION                  ;MAULE;149990;1;1;0;0;0;1;1;149990;Horno Electrico TH-100i 100Lts;ELECTRODOMESTICOS
10770513;;F;55;CHILENO;;Boomers;N/D;N/D;119980;2;1;0;0;0;2;1;119980;Batidora Pedestal TH910PN 4,6Lts 1300Watts;ELECTRODOMESTICOS
19059954;;F;25;CHILENO;;Z;CAUQUENES                     ;MAULE;144970;5;3;0;0;0;5;3;144970;Horno Microondas Mecanico TH-18B05 18Lts;ELECTRODOMESTICOS
8664282;;F;61;CHILENO;;Boomers;PROVIDENCIA                   ;METROPOLITANA;16990;1;1;0;0;0;1;1;16990;Hervidor Electrico HA-3300 2,5Lts Blanco;ELECTRODOMESTICOS
19603934;;F;25;CHILENO;;Z;PROVIDENCIA                   ;METROPOLITANA;16980;2;1;2;1;16980;0;0;0;PLANCHA A VAPOR 4070 SUELA CERAMICA 2500W;ELECTRODOMESTICOS
13583338;;F;43;CHILENO;;X;"";"";159990;1;1;0;0;0;1;1;159990;Horno Electrico TH-80i 80Lts;ELECTRODOMESTICOS
16309751;;F;36;CHILENO;;Millenial;QUELLON                       ;LOS LAGOS;159990;1;1;0;0;0;1;1;159990;Horno Electrico TH-100i 100Lts;ELECTRODOMESTICOS
12128169;;F;58;CHILENO;;Boomers;SAN PEDRO DE LA PAZ           ;BIO BIO;8990;1;1;0;0;0;1;1;8990;Plancha a Vapor Oster 3803;ELECTRODOMESTICOS
7099918;Casado;F;68;CHILENO;;Boomers;TOCOPILLA                     ;ANTOFAGASTA;443960;4;3;0;0;0;4;3;443960;Batidora Manual 3532;ELECTRODOMESTICOS
16843865;;M;36;CHILENO;;Millenial;RENCA                         ;METROPOLITANA;69990;1;1;0;0;0;1;1;69990;Aspiradora TH1870 Arrastre 1800Watts Gris;ELECTRODOMESTICOS
12198135;Casado;F;49;CHILENO;;X;RENCA                         ;METROPOLITANA;69990;1;1;0;0;0;1;1;69990;Horno Electrico TH-38N 38Lts;ELECTRODOMESTICOS
10484399;;F;58;CHILENO;;Boomers;PROVIDENCIA                   ;METROPOLITANA;43990;1;1;0;0;0;1;1;43990;Licuadora TH-401V Roja 1,75Lts Vaso Vidrio;ELECTRODOMESTICOS
17475996;;F;32;CHILENO;;Millenial;PROVIDENCIA                   ;METROPOLITANA;147980;2;1;2;1;147980;0;0;0;CAFETERA PRIMA LATTE 6603 ROJA;ELECTRODOMESTICOS
25847612;;M;27;HAITIANO;;Extranjero;RANCAGUA                      ;L.G.B.OÂ´HIGGINS;386960;4;2;0;0;0;4;2;386960;Licuadora TH-320 Roja/Negro 1,5 Lts Vaso Vidrio;ELECTRODOMESTICOS
11570662;;M;52;CHILENO;;X;TALCAHUANO                    ;BIO BIO;34990;1;1;0;0;0;1;1;34990;Parrilla Electrica M18W;ELECTRODOMESTICOS
13302557;;F;44;CHILENO;;X;REQUINOA                      ;L.G.B.OÂ´HIGGINS;79990;1;1;0;0;0;1;1;79990;Batidora Pedestal UT-KLEIN700;ELECTRODOMESTICOS
19756560;;F;25;CHILENO;;Z;SAN ANTONIO                   ;VALPARAISO;389950;5;3;3;1;249970;2;2;139980;Horno Electrico UT-BACKOFEN60 60Lts;ELECTRODOMESTICOS
16823522;;F;34;CHILENO;;Millenial;NUEVA IMPERIAL                ;ARAUCANIA;518970;3;2;0;0;0;3;2;518970;Batidora Vertical Stick Mixer 2609;ELECTRODOMESTICOS
5861519;;F;78;CHILENO;;Silencioso;EL BOSQUE                     ;METROPOLITANA;16990;1;1;0;0;0;1;1;16990;HERVIDOR TH-4340;ELECTRODOMESTICOS
15747566;;F;38;CHILENO;;Millenial;SAN FERNANDO                  ;L.G.B.OÂ´HIGGINS;181970;3;3;0;0;0;3;3;181970;PROCESADOR DE ALIMENTOS UT-PROCESSOR750;ELECTRODOMESTICOS
12421090;Casado;F;49;CHILENO;;X;PROVIDENCIA                   ;METROPOLITANA;49990;1;1;0;0;0;1;1;49990;Horno Electrico TH-25N01 25Lts;ELECTRODOMESTICOS
5835106;;F;80;CHILENO;;Silencioso;LOS ANGELES                   ;BIO BIO;73170;2;1;0;0;0;2;1;73170;Horno Electrico UT-LEIF36 36Lts;ELECTRODOMESTICOS
7340572;;F;65;CHILENO;;Boomers;ANTOFAGASTA                   ;ANTOFAGASTA;67980;2;2;0;0;0;2;2;67980;Sandwichera TH-952 2 Panes Blanca;ELECTRODOMESTICOS
13382146;Casado;M;44;CHILENO;;X;RENCA                         ;METROPOLITANA;22990;1;1;0;0;0;1;1;22990;Tostador de PanTH-120R 2 Rebanadas Rojo;ELECTRODOMESTICOS
17034111;;F;34;CHILENO;;Millenial;PUERTO MONTT                  ;LOS LAGOS;48990;1;1;0;0;0;1;1;48990;Aspiradora TH1415 Arrastre 1500Watts;ELECTRODOMESTICOS
6468669;;M;72;CHILENO;;Silencioso;QUILPUE                       ;VALPARAISO;21990;1;1;0;0;0;1;1;21990;Licuadora L-1630V Negra 1,5Lts Vaso Vidrio;ELECTRODOMESTICOS
17130606;;F;33;CHILENO;;Millenial;CHILLAN                       ;BIO BIO;179990;1;1;0;0;0;1;1;179990;Horno Electrico TH-100i 100Lts;ELECTRODOMESTICOS
18687852;Soltero;F;28;CHILENO;;Millenial;PROVIDENCIA                   ;METROPOLITANA;39990;1;1;0;0;0;1;1;39990;Batidora Pedestal Bowl 300 Inox;ELECTRODOMESTICOS
18536304;;F;28;CHILENO;;Millenial;LOS ANGELES                   ;BIO BIO;34990;1;1;1;1;34990;0;0;0;Combo Hervidor + Tostador + Sandwichera;ELECTRODOMESTICOS
17352007;;F;32;CHILENO;;Millenial;"";"";411450;5;4;5;4;411450;0;0;0;Aspiradora AP1700 Arrastre 1700Watts;ELECTRODOMESTICOS
8089012;;M;66;CHILENO;;Boomers;PROVIDENCIA                   ;METROPOLITANA;9990;1;1;0;0;0;1;1;9990;Exprimidor Fauna 500 cc;ELECTRODOMESTICOS
21150475;Soltero;F;64;CHILENO;MEDICO CIRUJANO;Extranjero;PROVIDENCIA                   ;METROPOLITANA;29990;1;1;0;0;0;1;1;29990;Cafetera TH-138i;ELECTRODOMESTICOS
10747828;;F;56;CHILENO;;Boomers;N/D;N/D;260130;6;5;0;0;0;6;5;260130;Batidora Pedestal UT-KLEIN700;ELECTRODOMESTICOS
11458923;Casado;M;53;CHILENO;;X;RENCA                         ;METROPOLITANA;24990;1;1;0;0;0;1;1;24990;Licuadora L2000VNG 1,5Lts Vaso Vidrio;ELECTRODOMESTICOS
11603528;;F;54;CHILENO;;Boomers;ANGOL                         ;ARAUCANIA;296660;3;2;0;0;0;3;2;296660;MULTIMIXER THOMAS TH- 8706;ELECTRODOMESTICOS
12186912;Soltero;F;50;CHILENO;;X;RENCA                         ;METROPOLITANA;26990;1;1;0;0;0;1;1;26990;Licuadora L2000VNG 1,5Lts Vaso Vidrio;ELECTRODOMESTICOS
9746113;;M;59;CHILENO;;Boomers;PROVIDENCIA                   ;METROPOLITANA;29990;1;1;0;0;0;1;1;29990;Combo Juguera + Hervidor;ELECTRODOMESTICOS
7844530;;M;70;CHILENO;;Silencioso;PROVIDENCIA                   ;METROPOLITANA;39990;1;1;1;1;39990;0;0;0;Freidora de Aire 18M Oster;ELECTRODOMESTICOS
11685347;Soltero;F;52;CHILENO;;X;RENCA                         ;METROPOLITANA;16990;1;1;0;0;0;1;1;16990;Batidora Manual TH-8830;ELECTRODOMESTICOS
15495509;;M;39;CHILENO;;X;RENCA                         ;METROPOLITANA;64990;1;1;0;0;0;1;1;64990;Aspiradora TH1870 Arrastre 1800Watts Gris;ELECTRODOMESTICOS
17261211;;F;33;CHILENO;;Millenial;TEMUCO                        ;ARAUCANIA;14990;1;1;0;0;0;1;1;14990;Batidora Vertical Stick Mixer 2609;ELECTRODOMESTICOS
18265813;Soltero;F;29;CHILENO;;Millenial;PROVIDENCIA                   ;METROPOLITANA;14990;1;1;1;1;14990;0;0;0;Cafetera TH-130;ELECTRODOMESTICOS
17968401;;F;29;CHILENO;;Millenial;PROVIDENCIA                   ;METROPOLITANA;39990;1;1;1;1;39990;0;0;0;Horno Electrico TH-25N01 25Lts;ELECTRODOMESTICOS
13890102;;F;44;CHILENO;;X;COLLIPULLI                    ;ARAUCANIA;429190;5;5;0;0;0;5;5;429190;Combo Hervidor + Tostador + Sandwichera;ELECTRODOMESTICOS
7060512;;F;62;CHILENO;;Boomers;TEMUCO                        ;ARAUCANIA;16990;1;1;0;0;0;1;1;16990;Hervidor Electrico UT-MANLY17 1,7Lts Negro;ELECTRODOMESTICOS
10091974;;M;56;CHILENO;;Boomers;ANGOL                         ;ARAUCANIA;44990;1;1;0;0;0;1;1;44990;Aspiradora TH1407 Arrastre 1400Watts;ELECTRODOMESTICOS
7433871;;M;64;CHILENO;;Boomers;SANTIAGO                      ;METROPOLITANA;377180;8;5;0;0;0;8;5;377180;Licuadora L-1630V Negra 1,5Lts Vaso Vidrio;ELECTRODOMESTICOS
15297602;;M;39;CHILENO;;X;PROVIDENCIA                   ;METROPOLITANA;34990;1;1;1;1;34990;0;0;0;Aspiradora AP1700 Arrastre 1700Watts;ELECTRODOMESTICOS
5758086;;M;75;CHILENO;;Silencioso;PROVIDENCIA                   ;METROPOLITANA;26990;1;1;0;0;0;1;1;26990;Licuadora L2000VNG 1,5Lts Vaso Vidrio;ELECTRODOMESTICOS
12621365;;F;48;CHILENO;;X;N/D;N/D;216910;8;1;8;1;216910;0;0;0;H MICROONDA MMP-25GE3D 25L;ELECTRODOMESTICOS
9515267;;M;57;CHILENO;;Boomers;CORONEL                       ;BIO BIO;119990;1;1;0;0;0;1;1;119990;FREIDORA DE AIRE THOMAS TH-AF60Mi;ELECTRODOMESTICOS
14749878;;F;52;PERUANO;;Extranjero;SANTIAGO                      ;METROPOLITANA;42980;2;1;0;0;0;2;1;42980;Licuadora Kaliman Negra con Teclas;ELECTRODOMESTICOS
18401651;;F;28;CHILENO;;Millenial;N/D;N/D;992940;6;5;0;0;0;6;5;992940;Horno Microondas Digital TH-25DM 25Lts;ELECTRODOMESTICOS
6448591;;F;72;CHILENO;;Silencioso;QUINTA NORMAL                 ;METROPOLITANA;45240;2;1;0;0;0;2;1;45240;Licuadora TH-501V 1,5Lts Vaso Vidrio;ELECTRODOMESTICOS
19060086;;F;25;CHILENO;;Z;"";"";109990;1;1;1;1;109990;0;0;0;Horno Electrico TH-80i 80Lts;ELECTRODOMESTICOS
17717981;Soltero;F;30;CHILENO;KINESIOLOGO;Silencioso;PROVIDENCIA                   ;METROPOLITANA;226960;4;3;4;3;226960;0;0;0;Batidora Berry Mixer (KM3000) 1300 watts;ELECTRODOMESTICOS
4954639;;F;84;CHILENO;;Silencioso;CASTRO                        ;LOS LAGOS;26980;2;1;0;0;0;2;1;26980;Hervidor Electrico UT-MANLY17 1,7Lts Negro;ELECTRODOMESTICOS
15372503;;F;40;CHILENO;;X;PROVIDENCIA                   ;METROPOLITANA;23980;2;1;2;1;23980;0;0;0;ARROCERA ROJA 4723;ELECTRODOMESTICOS
6531132;Casado;F;66;CHILENO;;Boomers;RENCA                         ;METROPOLITANA;19990;1;1;0;0;0;1;1;19990;Hervidor Electrico UT-DUNKEL17P 2Lts Negro;ELECTRODOMESTICOS
9103690;;F;59;CHILENO;;Boomers;RENCA                         ;METROPOLITANA;29990;1;1;0;0;0;1;1;29990;Licuadora L-5500IN 1,5Lts;ELECTRODOMESTICOS
5789558;Casado;F;68;CHILENO;;Boomers;PROVIDENCIA                   ;METROPOLITANA;24990;1;1;0;0;0;1;1;24990;Hervidor Electrico TH-4515N 2Lts Negro;ELECTRODOMESTICOS
4326778;;M;81;CHILENO;;Silencioso;RANCAGUA                      ;L.G.B.OÂ´HIGGINS;12990;1;1;0;0;0;1;1;12990;PLANCHA A VAPOR 4070 SUELA CERAMICA 2500W;ELECTRODOMESTICOS
16576606;Soltero;M;35;CHILENO;AUXILIAR PARAMEDICO DE ENFERMERIA;Millenial;PROVIDENCIA                   ;METROPOLITANA;32990;1;1;0;0;0;1;1;32990;Licuadora Personal TH-300PB;ELECTRODOMESTICOS
10933079;;F;44;CHILENO;;X;NATALES                       ;MAGALLANES;139990;1;1;0;0;0;1;1;139990;Horno Electrico TH-80i 80Lts;ELECTRODOMESTICOS
18011210;;F;31;CHILENO;;Millenial;"";"";29990;1;1;0;0;0;1;1;29990;Licuadora L-5500IN 1,5Lts;ELECTRODOMESTICOS
6275738;;M;71;CHILENO;;Silencioso;PROVIDENCIA                   ;METROPOLITANA;9990;1;3;0;0;0;1;3;9990;Licuadora Personal TH-300PB;ELECTRODOMESTICOS
12687858;;F;47;CHILENO;;X;LA PINTANA                    ;METROPOLITANA;84980;2;1;0;0;0;2;1;84980;Batidora Vertical Minipimer UT-KLOT800SS;ELECTRODOMESTICOS
6718066;;M;72;CHILENO;;Silencioso;PUERTO MONTT                  ;LOS LAGOS;29990;1;1;0;0;0;1;1;29990;Licuadora L-5500IN 1,5Lts;ELECTRODOMESTICOS
13995262;;M;41;CHILENO;;X;PROVIDENCIA                   ;METROPOLITANA;24990;1;1;0;0;0;1;1;24990;Hervidor Electrico TH-4515N 2Lts Negro;ELECTRODOMESTICOS
10154308;;F;59;CHILENO;;Boomers;TALCAHUANO                    ;BIO BIO;34990;1;1;0;0;0;1;1;34990;Licuadora Personal TH-300PB;ELECTRODOMESTICOS
15711276;;F;38;CHILENO;;X;PEDRO AGUIRRE CERDA           ;METROPOLITANA;28980;2;1;2;1;28980;0;0;0;Tostador de Pan TH-126 4 Rebanadas Negro;ELECTRODOMESTICOS
6421297;;M;72;CHILENO;;Silencioso;PENAFLOR                      ;METROPOLITANA;116970;3;1;0;0;0;3;1;116970;Horno Electrico UT-BACKOFEN60 60Lts;ELECTRODOMESTICOS
16497892;Casado;F;35;CHILENO;PROFESOR;Millenial;PROVIDENCIA                   ;METROPOLITANA;100840;2;1;2;1;100840;0;0;0;ASPIRADORA ROBOT THOMAS TH-1060SC;ELECTRODOMESTICOS
7560368;;F;76;CHILENO;;Silencioso;PUERTO MONTT                  ;LOS LAGOS;174980;2;2;0;0;0;2;2;174980;Licuadora TH-320 Roja/Negro 1,5 Lts Vaso Vidrio;ELECTRODOMESTICOS
13428771;;F;44;CHILENO;;X;LA LIGUA                      ;VALPARAISO;54990;1;1;0;0;0;1;1;54990;Horno Microondas Mecanico Easy Wave 20Lts;ELECTRODOMESTICOS
14519860;;M;48;CHILENO;;X;EL BOSQUE                     ;METROPOLITANA;77980;2;2;0;0;0;2;2;77980;Licuadora L-25000NG;ELECTRODOMESTICOS
25659843;;M;36;VENEZOLANO;;Extranjero;NUNOA                         ;METROPOLITANA;68980;2;1;2;1;68980;0;0;0;ASPIRADORA VCC4580V3K/XZS SAMSUNG BLACK;ELECTRODOMESTICOS
18653785;;F;28;CHILENO;;Millenial;N/D;N/D;186980;2;3;2;1;184980;0;2;2000;PLANCHA A VAPOR 6953 BASE AEROCERAMICA AUTAPA.22;ELECTRODOMESTICOS
13723540;;F;43;CHILENO;;X;PROVIDENCIA                   ;METROPOLITANA;34980;2;1;2;1;34980;0;0;0;Hervidor Termo BA-6928 Rojo 2,8Lts;ELECTRODOMESTICOS
13110762;;F;45;CHILENO;;X;SAN BERNARDO                  ;METROPOLITANA;29990;1;1;0;0;0;1;1;29990;HORNO ELECTRICO 16N01 16LTS NEGRO;ELECTRODOMESTICOS
9502935;;F;61;CHILENO;;Boomers;MELIPILLA                     ;METROPOLITANA;103980;2;1;0;0;0;2;1;103980;Horno Electrico TH-48N 48Lts;ELECTRODOMESTICOS
17514923;;F;31;CHILENO;;Millenial;NATALES                       ;MAGALLANES;72980;2;2;0;0;0;2;2;72980;Horno Microondas Digital TH-20S01 20Lts;ELECTRODOMESTICOS
4777489;;M;73;CHILENO;;Silencioso;PROVIDENCIA                   ;METROPOLITANA;44990;1;1;0;0;0;1;1;44990;Licuadora TH-501V 1,5Lts Vaso Vidrio;ELECTRODOMESTICOS
12982041;;M;46;CHILENO;;X;RENCA                         ;METROPOLITANA;417960;4;4;0;0;0;4;4;417960;Picadora TH-9020V Vaso Vidrio 2Lts;ELECTRODOMESTICOS
19006747;;F;26;CHILENO;;Millenial;N/D;N/D;117960;4;3;0;0;0;4;3;117960;ASPIRADORA ROBOT WIFI FIDDLER HOME BLANCA;ELECTRODOMESTICOS
12314744;;F;48;CHILENO;;X;RENCA                         ;METROPOLITANA;56980;2;1;0;0;0;2;1;56980;Licuadora TH-401V Roja 1,75Lts Vaso Vidrio;ELECTRODOMESTICOS
13150257;;F;45;CHILENO;;X;CANETE                        ;BIO BIO;225830;3;2;2;1;25840;1;1;199990;Combo Hervidor + Batidora;ELECTRODOMESTICOS
17630667;;F;31;CHILENO;;Millenial;PUERTO MONTT                  ;LOS LAGOS;0;0;2;0;2;0;0;0;0;Cafetera TH-130;ELECTRODOMESTICOS
9812086;;F;63;CHILENO;;Boomers;PROVIDENCIA                   ;METROPOLITANA;34990;1;1;0;0;0;1;1;34990;Licuadora TH-401V Roja 1,75Lts Vaso Vidrio;ELECTRODOMESTICOS
20010120;;F;23;CHILENO;;Z;PROVIDENCIA                   ;METROPOLITANA;57980;2;1;0;0;0;2;1;57980;Horno Electrico UT-BACKOFEN26 26Lts;ELECTRODOMESTICOS
11538296;;M;52;CHILENO;;X;TOCOPILLA                     ;ANTOFAGASTA;72980;2;1;0;0;0;2;1;72980;Aspiradora Tambor APA1000 1000Watts;ELECTRODOMESTICOS
5961823;Casado;F;74;CHILENO;;Silencioso;PROVIDENCIA                   ;METROPOLITANA;0;0;2;0;0;0;0;2;0;Picadora TH-9020V Vaso Vidrio 2Lts;ELECTRODOMESTICOS
14046584;;F;41;CHILENO;;X;RENCA                         ;METROPOLITANA;199990;2;1;2;1;199990;0;0;0;Apiradora Mi Robot Vacuum-Mop XIAOMI;ELECTRODOMESTICOS
13116238;;M;46;CHILENO;;X;VILCUN                        ;ARAUCANIA;94990;1;1;0;0;0;1;1;94990;Batidora Pedestal TH910PN 4,6Lts 1300Watts;ELECTRODOMESTICOS
6679150;;F;71;CHILENO;;Silencioso;CALERA                        ;VALPARAISO;16990;1;1;0;0;0;1;1;16990;HERVIDOR TH-4340;ELECTRODOMESTICOS
18477102;;M;29;CHILENO;;Millenial;CALBUCO                       ;LOS LAGOS;79980;2;1;0;0;0;2;1;79980;Horno Electrico TH-25N01 25Lts;ELECTRODOMESTICOS
12645280;;F;48;CHILENO;;X;PROVIDENCIA                   ;METROPOLITANA;64990;1;1;0;0;0;1;1;64990;Horno Microondas Mecanico UT-SYDNEY18 18Lts;ELECTRODOMESTICOS
17940178;;M;30;CHILENO;;Millenial;CASTRO                        ;LOS LAGOS;224950;5;1;0;0;0;5;1;224950;Horno Electrico UT-BACKOFEN48 48Lts;ELECTRODOMESTICOS
17059893;;F;32;CHILENO;;Millenial;PROVIDENCIA                   ;METROPOLITANA;23990;1;1;0;0;0;1;1;23990;Hervidor Electrico TH-4515N 2Lts Negro;ELECTRODOMESTICOS
10805701;;F;56;CHILENO;;Boomers;"";"";183930;7;3;4;2;140960;3;1;42970;Extractor de Jugo EX800 1,4Lts;ELECTRODOMESTICOS
15149606;;M;39;CHILENO;;X;SAN JAVIER                    ;MAULE;49990;1;1;1;1;49990;0;0;0;Aspiradora TH1415 Arrastre 1500Watts;ELECTRODOMESTICOS
9148100;;F;60;CHILENO;;Boomers;N/D;N/D;14990;1;1;0;0;0;1;1;14990;Batidora Vertical Stick Mixer 2609;ELECTRODOMESTICOS
25562858;;F;56;COLOMBIANO;;Extranjero;ESTACION CENTRAL              ;METROPOLITANA;17990;1;1;0;0;0;1;1;17990;Hervidor Electrico UT-KLAR20PW 2Lts Blanco;ELECTRODOMESTICOS
18320381;;F;29;CHILENO;;Millenial;N/D;N/D;32990;1;1;0;0;0;1;1;32990;Cafetera TH-138i;ELECTRODOMESTICOS
15881428;;F;38;CHILENO;;Millenial;PROVIDENCIA                   ;METROPOLITANA;54990;1;1;0;0;0;1;1;54990;Aspiradora VCC4190V3E/XZS Arrastre 2000Watts;ELECTRODOMESTICOS
10771174;;M;54;CHILENO;;X;VILLA ALEMANA                 ;VALPARAISO;114980;4;1;0;0;0;4;1;114980;Horno Microondas Mecanico TH-18B05 18Lts;ELECTRODOMESTICOS
11522601;;F;52;CHILENO;;X;SAN ANTONIO                   ;VALPARAISO;18990;1;1;0;0;0;1;1;18990;Batidora Manual UT-TEKLA300;ELECTRODOMESTICOS
17709435;Soltero;M;30;CHILENO;ASISTENTE SOCIAL;Millenial;RENCA                         ;METROPOLITANA;18990;1;1;0;0;0;1;1;18990;Plancha UT-DUNST 2200Watts Base Ceramica;ELECTRODOMESTICOS
5477501;Casado;F;74;CHILENO;;Silencioso;RENCA                         ;METROPOLITANA;54990;1;1;0;0;0;1;1;54990;Horno Microondas Mecanico Fancy 20Lts;ELECTRODOMESTICOS
16417647;;F;35;CHILENO;;Millenial;EL BOSQUE                     ;METROPOLITANA;30240;2;1;0;0;0;2;1;30240;Licuadora L-5500IN 1,5Lts;ELECTRODOMESTICOS
12400054;;F;52;CHILENO;;X;LA LIGUA                      ;VALPARAISO;13990;1;1;0;0;0;1;1;13990;Exprimidor Fauna 500 cc;ELECTRODOMESTICOS
18687904;Soltero;M;28;CHILENO;INGENIERIA EN MAQUINARIA VEHICULOS AUTOMOTRICES Y SISTEMAS ELECTRONICOS;Millenial;PROVIDENCIA                   ;METROPOLITANA;157540;2;1;2;1;157540;0;0;0;Robot aspirador Roomba 614;ELECTRODOMESTICOS
26384470;;F;47;EXTRANJERO - NO INFORMA NACIONALIDAD;;Extranjero;PROVIDENCIA                   ;METROPOLITANA;26990;1;1;0;0;0;1;1;26990;Hervidor Electrico UT-REIN17SS;ELECTRODOMESTICOS
15151112;;M;37;CHILENO;;Millenial;LINARES                       ;MAULE;231950;5;1;0;0;0;5;1;231950;Horno Microondas Digital UT-CLASSY720 20Lts;ELECTRODOMESTICOS
26180986;;F;42;VENEZOLANO;;Extranjero;N/D;N/D;97720;3;1;3;1;97720;0;0;0;ASPIRADORA TH-1025 HANDY2VAC;ELECTRODOMESTICOS
10526417;;F;53;CHILENO;;X;PETORCA                       ;VALPARAISO;125970;3;1;0;0;0;3;1;125970;Horno Microondas Mecanico UT-SYDNEY18 18Lts;ELECTRODOMESTICOS
15711863;;F;38;CHILENO;;X;PUERTO MONTT;LOS LAGOS;36990;1;1;1;1;36990;0;0;0;Aspiradora AP1700 Arrastre 1700Watts;ELECTRODOMESTICOS
6463331;;M;72;CHILENO;;Silencioso;RENCA                         ;METROPOLITANA;44990;1;1;0;0;0;1;1;44990;Licuadora L-25000NG;ELECTRODOMESTICOS
13755248;;M;42;CHILENO;;X;PROVIDENCIA                   ;METROPOLITANA;63970;3;1;3;1;63970;0;0;0;Aspiradora Handy Clean Black 1400;ELECTRODOMESTICOS
16090277;;F;37;CHILENO;;Millenial;N/D;N/D;64990;1;1;0;0;0;1;1;64990;PARRILLA ELECTRICA UT-ECOKERAMIK;ELECTRODOMESTICOS
9792196;;M;58;CHILENO;;Boomers;NUEVA IMPERIAL                ;ARAUCANIA;38990;1;1;0;0;0;1;1;38990;Licuadora TH-501V 1,5Lts Vaso Vidrio;ELECTRODOMESTICOS
20276539;;F;23;CHILENO;;Z;PROVIDENCIA                   ;METROPOLITANA;119980;2;1;0;0;0;2;1;119980;Horno Electrico UT-BACKOFEN60 60Lts;ELECTRODOMESTICOS
15659630;Divorciado;F;38;CHILENO;;Millenial;PROVIDENCIA                   ;METROPOLITANA;12990;1;1;0;0;0;1;1;12990;Plancha Easy Steam (PV4500);ELECTRODOMESTICOS
10379239;Casado;F;51;CHILENO;;X;RENCA                         ;METROPOLITANA;55840;2;1;2;1;55840;0;0;0;Batidora de Pedestal FDV Venus Grey;ELECTRODOMESTICOS
9822701;;M;58;CHILENO;;Boomers;RANCAGUA                      ;L.G.B.OÂ´HIGGINS;600799;17;12;0;0;0;17;12;600799;Parrilla Electrica TH-180;ELECTRODOMESTICOS
8838229;;F;62;CHILENO;;Boomers;N/D;N/D;88980;2;1;0;0;0;2;1;88980;Horno Electrico TH-48N 48Lts;ELECTRODOMESTICOS
8312166;;M;65;CHILENO;;Boomers;PROVIDENCIA                   ;METROPOLITANA;195980;2;1;0;0;0;2;1;195980;Maquina de Coser 311;ELECTRODOMESTICOS
20136420;;F;23;CHILENO;;Z;PROVIDENCIA                   ;METROPOLITANA;43970;3;1;3;1;43970;0;0;0;Licuadora Berry Blender Roja 1400 Vaso Vidrio;ELECTRODOMESTICOS
9663529;;F;60;CHILENO;;Boomers;LINARES                       ;MAULE;17990;1;1;0;0;0;1;1;17990;Hervidor Electrico TH-4515N 2Lts Negro;ELECTRODOMESTICOS
15000131;;F;40;CHILENO;;X;PROVIDENCIA                   ;METROPOLITANA;44990;1;1;0;0;0;1;1;44990;Horno Electrico UT-BACKOFEN26 26Lts;ELECTRODOMESTICOS
11927346;;F;49;CHILENO;;X;PUERTO VARAS                  ;LOS LAGOS;144910;9;2;0;0;0;9;2;144910;Batidora Pedestal TH910PN 4,6Lts 1300Watts;ELECTRODOMESTICOS
12964923;;F;46;CHILENO;;X;CAUQUENES                     ;MAULE;18990;1;1;0;0;0;1;1;18990;Hervidor Electrico TH-4515N 2Lts Negro;ELECTRODOMESTICOS
9872120;;F;55;CHILENO;;Boomers;CORONEL                       ;BIO BIO;59990;1;1;0;0;0;1;1;59990;Aspiradora TH1870 Arrastre 1800Watts Gris;ELECTRODOMESTICOS
14440399;;F;46;CHILENO;;X;OVALLE                        ;COQUIMBO;242980;3;2;0;0;0;3;2;242980;Hervidor Electrico HA-2650NG;ELECTRODOMESTICOS
18789541;;F;27;CHILENO;;Millenial;PROVIDENCIA                   ;METROPOLITANA;71980;2;1;0;0;0;2;1;71980;Licuadora TH-401V Roja 1,75Lts Vaso Vidrio;ELECTRODOMESTICOS
19287534;;F;26;CHILENO;;Millenial;"";"";19980;2;1;2;1;19980;0;0;0;Exprimidor de Jugo CJ-2000 1Lts;ELECTRODOMESTICOS
16557463;Soltero;M;35;CHILENO;COMUNICADOR AUDIOVISUAL;Silencioso;PROVIDENCIA                   ;METROPOLITANA;99990;1;1;1;1;99990;0;0;0;Horno Electrico UT-BACKOFEN60 60Lts;ELECTRODOMESTICOS
18156132;;M;29;CHILENO;;Millenial;"";"";74990;1;1;0;0;0;1;1;74990;Horno Microondas Digital UT-CLASSY720 20Lts;ELECTRODOMESTICOS
20139942;;F;23;CHILENO;;Z;N/D;N/D;36990;1;1;0;0;0;1;1;36990;Licuadora TH-501V 1,5Lts Vaso Vidrio;ELECTRODOMESTICOS
18112515;;F;30;CHILENO;;Millenial;PROVIDENCIA                   ;METROPOLITANA;0;0;2;0;2;0;0;0;0;Combo Hervidor + Batidora;ELECTRODOMESTICOS
10260094;;M;55;CHILENO;;Boomers;ARAUCO                        ;BIO BIO;34990;1;1;0;0;0;1;1;34990;Licuadora TH-501V 1,5Lts Vaso Vidrio;ELECTRODOMESTICOS
5499647;;M;76;CHILENO;;Silencioso;HUASCO                        ;ATACAMA;83980;2;1;0;0;0;2;1;83980;Enceradora EA-5000;ELECTRODOMESTICOS
12451084;;F;49;CHILENO;;X;VALPARAISO                    ;VALPARAISO;134980;2;1;2;1;134980;0;0;0;MAQ. DE COSER REMINGTON STF16;ELECTRODOMESTICOS
13169311;;M;44;CHILENO;;X;QUELLON                       ;LOS LAGOS;31990;1;1;0;0;0;1;1;31990;Licuadora Personal TH-300PB;ELECTRODOMESTICOS
17212776;;F;32;CHILENO;;Millenial;PROVIDENCIA                   ;METROPOLITANA;44990;1;1;1;1;44990;0;0;0;Horno Microondas Mecanico Easy Wave 20Lts;ELECTRODOMESTICOS
13084069;;M;46;CHILENO;;X;N/D;N/D;64970;3;1;0;0;0;3;1;64970;Aspiradora Handy Clean Black 1400;ELECTRODOMESTICOS
9013916;;F;59;CHILENO;;Boomers;RENCA                         ;METROPOLITANA;195980;2;1;0;0;0;2;1;195980;Maquina de Coser 311;ELECTRODOMESTICOS
12897674;;M;47;CHILENO;;X;N/D;N/D;26990;1;1;0;0;0;1;1;26990;Hervidor Electrico UT-REIN17SS;ELECTRODOMESTICOS
16486887;;M;35;CHILENO;;Millenial;N/D;N/D;84970;3;1;3;1;84970;0;0;0;Horno Microondas Digital Deli (2017 DM) 20Lts;ELECTRODOMESTICOS
11758637;;F;51;CHILENO;;X;PROVIDENCIA                   ;METROPOLITANA;13990;1;1;0;0;0;1;1;13990;Exprimidor de Jugo CJ-2000 1Lts;ELECTRODOMESTICOS
4744808;;F;77;CHILENO;;Silencioso;VALLENAR;ATACAMA;12990;1;1;0;0;0;1;1;12990;Exprimidor de Jugo CJ-2000 1Lts;ELECTRODOMESTICOS
11508311;;M;52;CHILENO;;X;N/D;N/D;84990;1;1;0;0;0;1;1;84990;Batidora Pedestal TH910PN 4,6Lts 1300Watts;ELECTRODOMESTICOS
18106095;;M;30;CHILENO;;Millenial;PROVIDENCIA                   ;METROPOLITANA;29990;1;1;0;0;0;1;1;29990;Licuadora Personal TH-300PB;ELECTRODOMESTICOS
13463287;;M;44;CHILENO;;X;MACUL                         ;METROPOLITANA;179990;1;3;1;3;179990;0;0;0;Hervidor Electrico Tetera HA-4100 4Lts Iox;ELECTRODOMESTICOS
20304764;;M;23;CHILENO;;Z;TALCA                         ;MAULE;232960;4;1;0;0;0;4;1;232960;Batidora Pedestal UT-KLEIN700;ELECTRODOMESTICOS
17214094;;F;31;CHILENO;;Millenial;"";"";14990;1;1;1;1;14990;0;0;0;Cafetera TH-130;ELECTRODOMESTICOS
10498297;Casado;F;58;CHILENO;;Boomers;RENCA                         ;METROPOLITANA;33980;2;1;0;0;0;2;1;33980;Batidora Manual UT-TEKLA300;ELECTRODOMESTICOS
7375751;;M;66;CHILENO;;Boomers;ANTOFAGASTA                   ;ANTOFAGASTA;5000;0;2;0;0;0;0;2;5000;Parrilla Electrica TH-224;ELECTRODOMESTICOS
10527028;Casado;F;56;CHILENO;PROFESOR;Boomers;RENCA                         ;METROPOLITANA;124980;2;1;0;0;0;2;1;124980;Horno electrico Black Oven 42lts;ELECTRODOMESTICOS
6011709;;M;73;CHILENO;;Silencioso;RENCA                         ;METROPOLITANA;36980;2;2;0;0;0;2;2;36980;Licuadora Berry Blender Roja 1400 Vaso Vidrio;ELECTRODOMESTICOS
19510345;;M;25;CHILENO;;Z;PROVIDENCIA                   ;METROPOLITANA;29990;1;1;1;1;29990;0;0;0;Combo Licuadora + Batidora;ELECTRODOMESTICOS
15576943;;F;38;CHILENO;;X;PROVIDENCIA                   ;METROPOLITANA;19990;1;1;0;0;0;1;1;19990;Tostador de PanTH-120R 2 Rebanadas Rojo;ELECTRODOMESTICOS
25792154;;M;44;HAITIANO;;Extranjero;SAN RAMON                     ;METROPOLITANA;64990;1;1;0;0;0;1;1;64990;Horno Microondas Digital TH-20S01 20Lts;ELECTRODOMESTICOS
18319437;;F;29;CHILENO;;Millenial;ANGOL                         ;ARAUCANIA;441919;8;5;0;0;0;8;5;441919;Licuadora TH-501V 1,5Lts Vaso Vidrio;ELECTRODOMESTICOS
6584468;;M;71;CHILENO;;Silencioso;RENCA                         ;METROPOLITANA;38990;1;1;0;0;0;1;1;38990;Licuadora TH-401V Roja 1,75Lts Vaso Vidrio;ELECTRODOMESTICOS
12346687;;F;48;CHILENO;;X;CASTRO                        ;LOS LAGOS;109990;1;1;0;0;0;1;1;109990;Horno Electrico UT-BACKOFEN60 60Lts;ELECTRODOMESTICOS
17373913;;M;32;CHILENO;;Millenial;QUINTA NORMAL;METROPOLITANA;53980;2;1;2;1;53980;0;0;0;Batidora de Pedestal FDV Venus Grey;ELECTRODOMESTICOS
13723530;;M;43;CHILENO;;Silencioso;PROVIDENCIA                   ;METROPOLITANA;199990;2;1;2;1;199990;0;0;0;Apiradora Mi Robot Vacuum-Mop XIAOMI;ELECTRODOMESTICOS
11050962;;F;55;CHILENO;;Boomers;CURICO                        ;MAULE;58960;4;2;0;0;0;4;2;58960;Batidora Manual UT-TEKLA300;ELECTRODOMESTICOS
14600595;;F;47;CHILENO;;X;N/D;N/D;53980;2;1;0;0;0;2;1;53980;Aspiradora AP1700 Arrastre 1700Watts;ELECTRODOMESTICOS
12718450;;F;46;CHILENO;;X;ILLAPEL                       ;COQUIMBO;24990;1;1;0;0;0;1;1;24990;Combo Licuadora + Batidora;ELECTRODOMESTICOS
17240430;;F;32;CHILENO;;Millenial;PAINE                         ;METROPOLITANA;53980;2;1;2;1;53980;0;0;0;Molinillo de Cafe Delonghi KG89;ELECTRODOMESTICOS
11070222;;F;56;CHILENO;;Boomers;RAUCO                         ;MAULE;77972;3;2;0;0;0;3;2;77972;PLANCHA VAPOR TH-7146;ELECTRODOMESTICOS
10085903;;F;54;CHILENO;;Boomers;OVALLE                        ;COQUIMBO;63120;3;2;0;0;0;3;2;63120;Combo Hervidor + Batidora;ELECTRODOMESTICOS
11514217;;F;51;CHILENO;;X;ILLAPEL                       ;COQUIMBO;20990;1;1;0;0;0;1;1;20990;Plancha TH-7052 2000Watts Base Inox;ELECTRODOMESTICOS
19875465;;F;24;CHILENO;;Z;SAN FERNANDO                  ;L.G.B.OÂ´HIGGINS;16990;1;1;0;0;0;1;1;16990;Batidora Manual UT-TEKLA300;ELECTRODOMESTICOS
8003663;;M;49;CHILENO;;Millenial;N/D;N/D;39990;1;1;0;0;0;1;1;39990;LICUADORA CROMADA CON TECLAS PLUS;ELECTRODOMESTICOS
19138010;;M;26;CHILENO;;Z;CHILLAN                       ;BIO BIO;34990;1;1;0;0;0;1;1;34990;Licuadora L1000 Inox 1,7LtsVaso Vidrio;ELECTRODOMESTICOS
5488053;;M;76;CHILENO;;Silencioso;RENCA                         ;METROPOLITANA;0;0;2;0;0;0;0;2;0;Horno Electrico UT-LEIF36 36Lts;ELECTRODOMESTICOS
7138930;;F;69;CHILENO;;Silencioso;RENCA                         ;METROPOLITANA;12990;1;1;0;0;0;1;1;12990;Hervidor Electrico TH-4212N 1,7Lts Negro;ELECTRODOMESTICOS
14482931;;F;45;CHILENO;;X;LOS ANGELES                   ;BIO BIO;305830;3;2;3;2;305830;0;0;0;MAQUINA DE COSER BSQ MOD 990;ELECTRODOMESTICOS
7777224;;M;62;CHILENO;;Boomers;N/D;N/D;191450;5;3;0;0;0;5;3;191450;Maquina de Coser Remington J011;ELECTRODOMESTICOS
16836033;;M;34;CHILENO;;Millenial;N/D;N/D;79980;2;1;0;0;0;2;1;79980;Olla Arrocera TH38IF 1,8Lts;ELECTRODOMESTICOS
17593501;;F;32;CHILENO;;Millenial;N/D;N/D;59670;2;1;0;0;0;2;1;59670;Aspiradora Handy Clean Black 1400;ELECTRODOMESTICOS
14408637;;F;48;CHILENO;;X;N/D;N/D;324960;4;3;2;1;305980;2;2;18980;Hervidor Electrico HA-3300 2,5Lts Blanco;ELECTRODOMESTICOS
7125611;Viudo;F;71;CHILENO;;Silencioso;PROVIDENCIA                   ;METROPOLITANA;16990;1;1;0;0;0;1;1;16990;Batidora Manual UT-TEKLA300;ELECTRODOMESTICOS
10177321;;F;53;CHILENO;;X;RENCA                         ;METROPOLITANA;44990;1;1;0;0;0;1;1;44990;Horno Electrico TH-25N01 25Lts;ELECTRODOMESTICOS
10825415;;F;56;CHILENO;;Boomers;PICHIDEGUA                    ;L.G.B.OÂ´HIGGINS;105330;5;1;0;0;0;5;1;105330;LICUADORA CROMADA CON TECLAS PLUS;ELECTRODOMESTICOS
12431853;;F;49;CHILENO;;X;"";"";44990;1;1;0;0;0;1;1;44990;Picadora TH-9020V Vaso Vidrio 2Lts;ELECTRODOMESTICOS
16736052;;F;34;CHILENO;;Millenial;N/D;N/D;39980;2;2;0;0;0;2;2;39980;Hervidor Electrico TH-5407i 2Lts;ELECTRODOMESTICOS
8928942;Viudo;F;60;CHILENO;;Boomers;RENCA                         ;METROPOLITANA;43990;1;1;0;0;0;1;1;43990;Aspiradora TH1407 Arrastre 1400Watts;ELECTRODOMESTICOS
12676239;;M;48;CHILENO;;X;EL MONTE                      ;METROPOLITANA;71980;2;1;0;0;0;2;1;71980;Parrilla Electrica TH-224;ELECTRODOMESTICOS
8824605;;F;66;CHILENO;;Boomers;OVALLE                        ;COQUIMBO;87980;2;2;0;0;0;2;2;87980;Hervidor Acero Inoxidable 40989-CL Hamilton Beac;ELECTRODOMESTICOS
10178087;;F;58;CHILENO;;Boomers;PROVIDENCIA                   ;METROPOLITANA;18990;1;1;0;0;0;1;1;18990;Tostador de PanTH-120R 2 Rebanadas Rojo;ELECTRODOMESTICOS
4713998;;M;76;CHILENO;;Silencioso;TALCAHUANO                    ;BIO BIO;64990;1;1;0;0;0;1;1;64990;Aspiradora TH1415 Arrastre 1500Watts;ELECTRODOMESTICOS
18711566;Soltero;M;27;CHILENO;;Millenial;COPIAPO                       ;ATACAMA;20240;2;1;0;0;0;2;1;20240;Plancha TH-7052 2000Watts Base Inox;ELECTRODOMESTICOS
5686433;Casado;M;74;CHILENO;;Silencioso;PROVIDENCIA                   ;METROPOLITANA;179970;3;1;0;0;0;3;1;179970;Horno Electrico UT-BACKOFEN60 60Lts;ELECTRODOMESTICOS
9669389;Casado;M;59;CHILENO;;Boomers;RENCA                         ;METROPOLITANA;29990;1;1;0;0;0;1;1;29990;Combo Juguera + Hervidor;ELECTRODOMESTICOS
12577949;;M;48;CHILENO;;X;N/D;N/D;134980;2;2;1;1;14990;1;1;119990;Hervidor Electrico TH-4515N 2Lts Negro;ELECTRODOMESTICOS
16765503;;M;34;CHILENO;;Millenial;N/D;N/D;29990;1;1;0;0;0;1;1;29990;Hervidor Electrico UT-REIN17SS;ELECTRODOMESTICOS
9317774;;M;54;CHILENO;;X;ANTOFAGASTA                   ;ANTOFAGASTA;34990;1;1;0;0;0;1;1;34990;Licuadora TH-501V 1,5Lts Vaso Vidrio;ELECTRODOMESTICOS
20234223;;F;22;CHILENO;;Z;PROVIDENCIA                   ;METROPOLITANA;66980;2;2;1;1;39990;1;1;26990;Tostador de Pan TH-126 4 Rebanadas Negro;ELECTRODOMESTICOS
19023612;;F;27;CHILENO;;Z;PROVIDENCIA                   ;METROPOLITANA;78970;3;2;3;2;78970;0;0;0;Plancha Paninis 2880;ELECTRODOMESTICOS
11630732;;F;52;CHILENO;;X;PROVIDENCIA                   ;METROPOLITANA;162980;2;1;0;0;0;2;1;162980;Maquina de Coser ME9100;ELECTRODOMESTICOS
15404747;;F;40;CHILENO;;X;RENCA                         ;METROPOLITANA;19990;1;1;0;0;0;1;1;19990;Hervidor Electrico TH-5407i 2Lts;ELECTRODOMESTICOS
7646042;;M;63;CHILENO;;Boomers;ANTOFAGASTA                   ;ANTOFAGASTA;16990;1;1;0;0;0;1;1;16990;Tostador de Pan TH-116 2 Rebanadas Negro;ELECTRODOMESTICOS
9937719;;F;58;CHILENO;;Silencioso;PROVIDENCIA                   ;METROPOLITANA;281960;4;1;0;0;0;4;1;281960;Maquina de Coser 311;ELECTRODOMESTICOS
15633014;;F;39;CHILENO;;X;PROVIDENCIA                   ;METROPOLITANA;36990;1;1;1;1;36990;0;0;0;Aspiradora AP1700 Arrastre 1700Watts;ELECTRODOMESTICOS
13169618;;M;45;CHILENO;;X;RENCA                         ;METROPOLITANA;59990;1;1;0;0;0;1;1;59990;Aspiradora TH1870 Arrastre 1800Watts Gris;ELECTRODOMESTICOS
7705257;;F;62;CHILENO;;Boomers;TOCOPILLA                     ;ANTOFAGASTA;28990;1;1;0;0;0;1;1;28990;Plancha UT-KERAMIKTOP 2200Watts Base Ceramica;ELECTRODOMESTICOS
4619905;;F;83;CHILENO;;Silencioso;TEMUCO                        ;ARAUCANIA;59990;1;1;0;0;0;1;1;59990;Aspiradora TH1870 Arrastre 1800Watts Gris;ELECTRODOMESTICOS
9338889;Casado;M;59;CHILENO;;Boomers;RENCA                         ;METROPOLITANA;29990;1;1;0;0;0;1;1;29990;Licuadora Personal TH-300PB;ELECTRODOMESTICOS
25788984;;F;52;CHILENO;;Extranjero;"";"";49990;1;1;0;0;0;1;1;49990;Freidora de Aire 18M Oster;ELECTRODOMESTICOS
6646756;;F;63;CHILENO;;Boomers;"";"";119980;2;1;0;0;0;2;1;119980;Horno Microondas Digital L UT-25KROMM 25Lts;ELECTRODOMESTICOS
25984356;;M;36;VENEZOLANO;;Extranjero;N/D;N/D;384960;4;5;1;1;299990;3;4;84970;Licuadora Kaliman Negra con Teclas;ELECTRODOMESTICOS
8688508;Soltero;F;64;CHILENO;;Boomers;RENCA                         ;METROPOLITANA;21990;1;1;0;0;0;1;1;21990;Licuadora TH-320 Roja/Negro 1,5 Lts Vaso Vidrio;ELECTRODOMESTICOS
4713868;;M;80;CHILENO;;Silencioso;QUINTA NORMAL                 ;METROPOLITANA;34990;1;1;0;0;0;1;1;34990;Licuadora TH-501V 1,5Lts Vaso Vidrio;ELECTRODOMESTICOS
5053164;;F;80;CHILENO;;Silencioso;N/D;N/D;38540;2;1;2;1;38540;0;0;0;Plancha THOMAS TH-7170 2200Watts Base Ceramica;ELECTRODOMESTICOS
8118680;;F;61;CHILENO;;Boomers;RENCA                         ;METROPOLITANA;16990;1;1;0;0;0;1;1;16990;Batidora Manual 3532;ELECTRODOMESTICOS
8670922;Divorciado;F;61;CHILENO;TECNICO EN ENFERMERIA DE NIVEL SUPERIOR;Boomers;LONCOCHE                      ;ARAUCANIA;79980;2;1;0;0;0;2;1;79980;Aspiradora TH1870 Arrastre 1800Watts Gris;ELECTRODOMESTICOS
18107828;;F;30;CHILENO;;Millenial;N/D;N/D;99990;1;1;0;0;0;1;1;99990;Horno Electrico UT-BACKOFEN60 60Lts;ELECTRODOMESTICOS
10017372;Soltero;F;58;CHILENO;;Boomers;PROVIDENCIA                   ;METROPOLITANA;64990;1;1;0;0;0;1;1;64990;Horno Microondas Mecanico UT-SYDNEY18 18Lts;ELECTRODOMESTICOS
19773437;;M;24;CHILENO;;Z;RENAICO                       ;ARAUCANIA;47670;2;1;0;0;0;2;1;47670;LICUADORA CROMADA CON TECLAS PLUS;ELECTRODOMESTICOS
18184168;Soltero;M;29;CHILENO;INGENIERO METALURGICO;Millenial;PROVIDENCIA                   ;METROPOLITANA;36980;2;1;0;0;0;2;1;36980;Hervidor Electrico Tetera HA-4100 4Lts Iox;ELECTRODOMESTICOS
15295331;;F;40;CHILENO;;X;PROVIDENCIA                   ;METROPOLITANA;54990;1;1;0;0;0;1;1;54990;Horno Microondas Mecanico TH-18B05 18Lts;ELECTRODOMESTICOS
10523800;;M;54;CHILENO;;X;PROVIDENCIA                   ;METROPOLITANA;3010;-1;2;0;0;0;-1;2;3010;Aspiradora Tambor APA1000 1000Watts;ELECTRODOMESTICOS
19719080;;F;25;CHILENO;;Z;ANGOL                         ;ARAUCANIA;38990;1;1;0;0;0;1;1;38990;Combo Hervidor + Tostador + Sandwichera;ELECTRODOMESTICOS
19519495;;M;25;CHILENO;;Z;ANGOL                         ;ARAUCANIA;389560;3;2;0;0;0;3;2;389560;Aspiradora TH1415 Arrastre 1500Watts;ELECTRODOMESTICOS
15743143;;M;38;CHILENO;;X;MAIPU;METROPOLITANA;79990;1;1;0;0;0;1;1;79990;Batidora Pedestal UT-KLEIN700;ELECTRODOMESTICOS
10533593;Divorciado;M;55;CHILENO;;Boomers;RENCA                         ;METROPOLITANA;19990;1;1;0;0;0;1;1;19990;Licuadora Sport Blender BSE10;ELECTRODOMESTICOS
9504307;;F;59;CHILENO;;Boomers;LINARES                       ;MAULE;775550;4;2;0;0;0;4;2;775550;Horno Electrico TH-25N01 25Lts;ELECTRODOMESTICOS
23112994;Casado;F;34;EXTRANJERO - NO INFORMA NACIONALIDAD;;Extranjero;"";"";139990;1;1;1;1;139990;0;0;0;Horno Electrico TH-80i 80Lts;ELECTRODOMESTICOS
17152307;;M;33;CHILENO;;Millenial;PROVIDENCIA                   ;METROPOLITANA;94980;2;1;2;1;94980;0;0;0;Cafetera P65 Silver;ELECTRODOMESTICOS
13385722;Casado;F;52;CHILENO;;X;PROVIDENCIA                   ;METROPOLITANA;149990;1;1;0;0;0;1;1;149990;Maquina de Coser ME9100;ELECTRODOMESTICOS
14503100;;F;48;CHILENO;;X;N/D;N/D;28990;1;1;0;0;0;1;1;28990;PICADORA 123 SILHQUETTE;ELECTRODOMESTICOS
13135293;;F;45;CHILENO;;X;PROVIDENCIA                   ;METROPOLITANA;24990;1;1;0;0;0;1;1;24990;Tostador de Pan TH-126 4 Rebanadas Negro;ELECTRODOMESTICOS
12631180;;M;48;CHILENO;;X;CERRO NAVIA                   ;METROPOLITANA;29980;2;2;0;0;0;2;2;29980;HERVIDOR TH-4340;ELECTRODOMESTICOS
8964988;;M;49;CHILENO;;X;N/D;N/D;59980;2;2;0;0;0;2;2;59980;Licuadora Personal TH-300PB;ELECTRODOMESTICOS
18125775;;F;30;CHILENO;;Millenial;PROVIDENCIA                   ;METROPOLITANA;9990;1;1;0;0;0;1;1;9990;Plancha a Vapor Oster 3803;ELECTRODOMESTICOS
15240719;;F;39;CHILENO;;X;CARAHUE                       ;ARAUCANIA;19990;1;1;0;0;0;1;1;19990;Hervidor Electrico UT-DUNKEL17P 2Lts Negro;ELECTRODOMESTICOS
6909456;;F;65;CHILENO;;Boomers;VINA DEL MAR                  ;VALPARAISO;116980;2;1;0;0;0;2;1;116980;Horno Electrico UT-BACKOFEN38 38Lts;ELECTRODOMESTICOS
13768441;;F;42;CHILENO;;X;RENCA                         ;METROPOLITANA;25990;1;1;0;0;0;1;1;25990;Plancha UT-KERAMIKTOP 2200Watts Base Ceramica;ELECTRODOMESTICOS
18764199;;F;27;CHILENO;;Millenial;TILTIL                        ;METROPOLITANA;53980;2;1;2;1;53980;0;0;0;Horno Microondas Mecanico Easy Wave 20Lts;ELECTRODOMESTICOS
13043243;;F;46;CHILENO;;X;N/D;N/D;21980;2;1;2;1;21980;0;0;0;Hervidor Electrico TH-4515N 2Lts Negro;ELECTRODOMESTICOS
10681933;;M;54;CHILENO;;Extranjero;PUCON                         ;ARAUCANIA;94990;1;1;0;0;0;1;1;94990;Horno Microondas Digital TH-25DM 25Lts;ELECTRODOMESTICOS
11903415;;M;51;CHILENO;;X;N/D;N/D;312980;2;2;0;0;0;2;2;312980;Hervidor Electrico 3101 1,7Lts Negro;ELECTRODOMESTICOS
25683528;Soltero;F;48;PERUANO;;Extranjero;PROVIDENCIA                   ;METROPOLITANA;35670;2;1;0;0;0;2;1;35670;Licuadora Roja 550W 1,5Lts Vaso Vidrio;ELECTRODOMESTICOS
8741304;;M;63;CHILENO;;Boomers;LAMPA                         ;METROPOLITANA;97980;2;2;0;0;0;2;2;97980;Hervidor Electrico UT-KLAR20PW 2Lts Blanco;ELECTRODOMESTICOS
5704650;Divorciado;F;69;CHILENO;;Silencioso;RENCA                         ;METROPOLITANA;26990;1;1;0;0;0;1;1;26990;HORNO ELECTRICO 16N01 16LTS NEGRO;ELECTRODOMESTICOS
18287400;;M;28;CHILENO;;Millenial;YERBAS BUENAS                 ;MAULE;59990;1;1;0;0;0;1;1;59990;PARRILLA ELECTRICA UT-ECOKERAMIK;ELECTRODOMESTICOS
16076098;;F;36;CHILENO;;Millenial;PROVIDENCIA                   ;METROPOLITANA;163980;2;1;2;1;163980;0;0;0;MICROONDAS 30L MG30T5018CN/ZS SAMSUNG.;ELECTRODOMESTICOS
17229928;;F;33;CHILENO;;Millenial;N/D;N/D;27990;1;1;0;0;0;1;1;27990;Combo Juguera + Hervidor;ELECTRODOMESTICOS
15169348;;F;37;CHILENO;;Millenial;EL CARMEN                     ;BIO BIO;164980;2;2;0;0;0;2;2;164980;Horno Electrico UT-BACKOFEN60 60Lts;ELECTRODOMESTICOS
8062316;;F;67;CHILENO;;Boomers;PROVIDENCIA                   ;METROPOLITANA;169990;1;1;0;0;0;1;1;169990;Maquina de Coser 311;ELECTRODOMESTICOS
9788464;;F;57;CHILENO;;Boomers;OVALLE                        ;COQUIMBO;26990;1;1;0;0;0;1;1;26990;Licuadora TH-320 Roja/Negro 1,5 Lts Vaso Vidrio;ELECTRODOMESTICOS
20587726;;F;21;CHILENO;;Z;COIHAIQUE                     ;AYSEN;169972;3;3;0;0;0;3;3;169972;Horno Electrico TH-48N 48Lts;ELECTRODOMESTICOS
7868259;Casado;M;64;CHILENO;;Boomers;SAN CARLOS                    ;BIO BIO;108270;2;1;0;0;0;2;1;108270;Horno Electrico TH62I 60Lts;ELECTRODOMESTICOS
20049647;;F;23;CHILENO;;Silencioso;PROVIDENCIA                   ;METROPOLITANA;41970;3;1;3;1;41970;0;0;0;Licuadora Roja 550W 1,5Lts Vaso Vidrio;ELECTRODOMESTICOS
6406471;;F;74;CHILENO;;Silencioso;CATEMU                        ;VALPARAISO;49670;2;1;0;0;0;2;1;49670;Licuadora Osterizer 4112/72 1,25Lts Vaso Vidrio;ELECTRODOMESTICOS
8841776;;M;62;CHILENO;;Boomers;MELIPILLA                     ;METROPOLITANA;63970;3;2;2;1;48980;1;1;14990;PROCESADOR THOMAS TH-9160;ELECTRODOMESTICOS
9400286;;F;60;CHILENO;;Boomers;BULNES                        ;BIO BIO;149980;2;1;0;0;0;2;1;149980;Batidora Pedestal TH910PN 4,6Lts 1300Watts;ELECTRODOMESTICOS
13942651;;M;41;CHILENO;;X;"";"";54990;1;1;0;0;0;1;1;54990;Aspiradora VCC4190V3E/XZS Arrastre 2000Watts;ELECTRODOMESTICOS
20408513;;F;22;CHILENO;;Z;N/D;N/D;172860;3;3;0;0;0;3;3;172860;Combo Juguera + Hervidor;ELECTRODOMESTICOS
19837124;;F;23;CHILENO;;Silencioso;PROVIDENCIA                   ;METROPOLITANA;21990;1;1;0;0;0;1;1;21990;Licuadora L-1630V Negra 1,5Lts Vaso Vidrio;ELECTRODOMESTICOS
13390287;;M;43;CHILENO;;X;N/D;N/D;50384;2;1;0;0;0;2;1;50384;Licuadora L-5500IN 1,5Lts;ELECTRODOMESTICOS
3940577;;F;87;CHILENO;;Silencioso;VICTORIA                      ;ARAUCANIA;14990;1;1;0;0;0;1;1;14990;Hervidor Electrico 3101 1,7Lts Negro;ELECTRODOMESTICOS
5770514;Casado;M;72;CHILENO;;Silencioso;RENCA                         ;METROPOLITANA;25240;2;1;0;0;0;2;1;25240;Batidora Manual BA-5010 Inox;ELECTRODOMESTICOS
6730671;;F;77;CHILENO;;Silencioso;PUNTA ARENAS                  ;MAGALLANES;17493;1;1;0;0;0;1;1;17493;Licuadora L2000VNG 1,5Lts Vaso Vidrio;ELECTRODOMESTICOS
13411389;;F;43;CHILENO;;X;SANTA JUANA                   ;BIO BIO;482540;5;3;0;0;0;5;3;482540;Horno Electrico TH-48N 48Lts;ELECTRODOMESTICOS
17427575;Soltero;M;32;CHILENO;TECNICO ADMINISTRATIVO;Millenial;PROVIDENCIA                   ;METROPOLITANA;75840;2;1;2;1;75840;0;0;0;Cafetera Dolce Gusto Piccolo XS 0,8 Lts Negra;ELECTRODOMESTICOS
8889168;;M;61;CHILENO;;Boomers;SAN ESTEBAN                   ;VALPARAISO;30980;2;2;0;0;0;2;2;30980;Batidora Manual TH-8830;ELECTRODOMESTICOS
19967612;;M;23;CHILENO;;Z;"";"";17990;1;1;0;0;0;1;1;17990;Hervidor Electrico UT-KLAR20PW 2Lts Blanco;ELECTRODOMESTICOS
17498183;;M;32;CHILENO;;Millenial;N/D;N/D;16990;1;1;0;0;0;1;1;16990;Plancha Easy Steam (PV4500);ELECTRODOMESTICOS
19990120;;F;22;CHILENO;;Z;PROVIDENCIA                   ;METROPOLITANA;24990;1;1;0;0;0;1;1;24990;Licuadora Roja 550W 1,5Lts Vaso Vidrio;ELECTRODOMESTICOS
9453017;;F;58;CHILENO;;Boomers;TALCA                         ;MAULE;292860;3;1;0;0;0;3;1;292860;Maquina de coser computarizada SH7700;ELECTRODOMESTICOS
17817494;;M;30;CHILENO;;Millenial;CALBUCO                       ;LOS LAGOS;26990;1;1;0;0;0;1;1;26990;Hervidor Electrico Tetera HA-4100 4Lts Iox;ELECTRODOMESTICOS
16500501;;F;36;CHILENO;;Millenial;VINA DEL MAR                  ;VALPARAISO;124980;2;1;2;1;124980;0;0;0;CAFETERA PRIMA LATTE 6603 ROJA;ELECTRODOMESTICOS
16904854;Soltero;M;33;CHILENO;;Millenial;RENCA                         ;METROPOLITANA;129990;1;1;1;1;129990;0;0;0;Horno Electrico TH-80i 80Lts;ELECTRODOMESTICOS
17080774;;F;33;CHILENO;;Millenial;QUINCHAO                      ;LOS LAGOS;113150;4;2;0;0;0;4;2;113150;Aspiradora AP3400 Arrastre 2000Watts;ELECTRODOMESTICOS
14226112;;F;52;CHILENO;;X;RENCA                         ;METROPOLITANA;27990;1;1;0;0;0;1;1;27990;Combo Juguera + Hervidor;ELECTRODOMESTICOS
15662802;;F;39;CHILENO;;X;COLLIPULLI                    ;ARAUCANIA;21990;1;1;0;0;0;1;1;21990;HERVIDOR ELECTRICO UT-STARK18;ELECTRODOMESTICOS
7486507;;F;66;CHILENO;;Boomers;NUEVA IMPERIAL                ;ARAUCANIA;62980;2;2;0;0;0;2;2;62980;MULTIMIXER THOMAS TH- 8706;ELECTRODOMESTICOS
5719830;;F;71;CHILENO;;Silencioso;CONCHALI                      ;METROPOLITANA;76660;3;2;0;0;0;3;2;76660;Hervidor Electrico UT-KLAR20PW 2Lts Blanco;ELECTRODOMESTICOS
13269354;;F;44;CHILENO;;Silencioso;"";"";73980;2;1;2;1;73980;0;0;0;Enceradora EA-5000;ELECTRODOMESTICOS
19976426;;F;24;CHILENO;;Z;PROVIDENCIA                   ;METROPOLITANA;12990;1;1;0;0;0;1;1;12990;Hervidor Electrico 3101 1,7Lts Negro;ELECTRODOMESTICOS
13753685;;F;47;CHILENO;;X;QUILLOTA                      ;VALPARAISO;21990;1;1;0;0;0;1;1;21990;Plancha UT-KERAMIK1 2200Watts Base Ceramica;ELECTRODOMESTICOS
11240688;;F;54;CHILENO;;X;ARAUCO                        ;BIO BIO;38670;2;1;0;0;0;2;1;38670;Hervidor Electrico Tetera TH-6505RT 1,7Lts Rojo;ELECTRODOMESTICOS
9348663;;F;58;CHILENO;;Boomers;RENCA                         ;METROPOLITANA;133980;2;1;2;1;133980;0;0;0;CAFETERA PRIMA LATTE 6603 NEGRA;ELECTRODOMESTICOS
12565287;;F;47;CHILENO;;X;COIHAIQUE                     ;AYSEN;33670;2;1;0;0;0;2;1;33670;Batidora Manual BA-5010 Inox;ELECTRODOMESTICOS
13864306;;F;41;CHILENO;;X;PROVIDENCIA                   ;METROPOLITANA;139990;1;1;0;0;0;1;1;139990;Maquina de Coser Remington J011;ELECTRODOMESTICOS
5296993;;F;79;CHILENO;;Silencioso;LOS ANGELES                   ;BIO BIO;29990;1;1;0;0;0;1;1;29990;Licuadora L1000 Inox 1,7LtsVaso Vidrio;ELECTRODOMESTICOS
10799847;;M;56;CHILENO;;Boomers;ISLA DE MAIPO                 ;METROPOLITANA;-113990;-1;1;0;0;0;-1;1;-113990;Horno Electrico UT-BACKOFEN60 60Lts;ELECTRODOMESTICOS
6646484;;F;67;CHILENO;;Boomers;CONSTITUCION                  ;MAULE;74990;1;1;0;0;0;1;1;74990;Horno Microondas Digital ME0113MB1/XZS 32Lts;ELECTRODOMESTICOS
17134990;;M;33;CHILENO;;Millenial;VALPARAISO;VALPARAISO;149960;3;1;3;1;149960;0;0;0;Olla a Presion Multiolla Daily Food 6L;ELECTRODOMESTICOS
8795364;;F;63;CHILENO;;Silencioso;PROVIDENCIA                   ;METROPOLITANA;17990;1;1;0;0;0;1;1;17990;Hervidor Electrico UT-KLAR20PW 2Lts Blanco;ELECTRODOMESTICOS
12375254;;M;50;CHILENO;;Silencioso;PROVIDENCIA                   ;METROPOLITANA;19990;1;1;0;0;0;1;1;19990;Batidora Manual BA-5010 Inox;ELECTRODOMESTICOS
8339841;Casado;M;60;CHILENO;;Boomers;RENCA                         ;METROPOLITANA;29990;1;1;0;0;0;1;1;29990;Hervidor Electrico Tetera HA-4100 4Lts Iox;ELECTRODOMESTICOS
13345765;;M;44;CHILENO;;X;PROVIDENCIA                   ;METROPOLITANA;39990;2;1;0;0;0;2;1;39990;Licuadora L2000VNG 1,5Lts Vaso Vidrio;ELECTRODOMESTICOS
5235437;;F;80;CHILENO;;Silencioso;ANCUD                         ;LOS LAGOS;59990;3;1;0;0;0;3;1;59990;Horno Electrico TH-25N01 25Lts;ELECTRODOMESTICOS
12226857;;F;49;CHILENO;;X;PROVIDENCIA                   ;METROPOLITANA;133980;2;1;2;1;133980;0;0;0;CAFETERA PRIMA LATTE 6603 NEGRA;ELECTRODOMESTICOS
15341135;;M;39;CHILENO;;Silencioso;PROVIDENCIA                   ;METROPOLITANA;103980;2;1;2;1;103980;0;0;0;Cafetera De Longhi Active Line Blanca ECP 33.21W;ELECTRODOMESTICOS
17287196;Soltero;F;32;CHILENO;TECNICO TOPOGRAFO;Millenial;SALAMANCA                     ;COQUIMBO;31980;2;1;0;0;0;2;1;31980;Hervidor Electrico TH-5407i 2Lts;ELECTRODOMESTICOS
6178719;;F;69;CHILENO;;Silencioso;MAIPU                         ;METROPOLITANA;156980;2;1;0;0;0;2;1;156980;Horno Electrico TH-80i 80Lts;ELECTRODOMESTICOS
16509804;Casado;M;35;CHILENO;;Millenial;SAN ANTONIO                   ;VALPARAISO;54990;1;1;0;0;0;1;1;54990;Horno Microondas Mecanico Easy Wave 20Lts;ELECTRODOMESTICOS
15578542;;M;39;CHILENO;;X;VILLARICA                     ;ARAUCANIA;54990;1;1;0;0;0;1;1;54990;PROCESADOR DE ALIMENTOS UT-PROCESSOR750;ELECTRODOMESTICOS
20196609;;M;22;CHILENO;;Z;CANETE                        ;BIO BIO;83160;3;1;0;0;0;3;1;83160;Aspiradora VCC4190V3E/XZS Arrastre 2000Watts;ELECTRODOMESTICOS
13742188;Casado;M;43;CHILENO;;X;RENCA                         ;METROPOLITANA;68170;2;1;0;0;0;2;1;68170;Horno Microondas Mecanico TH-18B05 18Lts;ELECTRODOMESTICOS
12495668;;F;48;CHILENO;;X;PROVIDENCIA                   ;METROPOLITANA;58980;2;1;2;1;58980;0;0;0;ASPIRADORA THOR POWER CYCLONIC;ELECTRODOMESTICOS
13246175;;M;44;CHILENO;;X;RENCA                         ;METROPOLITANA;54990;1;1;0;0;0;1;1;54990;ASPIRADORA THOMAS TH-1640;ELECTRODOMESTICOS
8384576;;F;75;CHILENO;;Silencioso;LINARES                       ;MAULE;24493;1;1;0;0;0;1;1;24493;HORNO ELECTRICO 16N01 16LTS NEGRO;ELECTRODOMESTICOS
14099602;;F;40;CHILENO;;Silencioso;PROVIDENCIA                   ;METROPOLITANA;69640;2;1;2;1;69640;0;0;0;ASPIRADORA VCC4580V3K/XZS SAMSUNG BLACK;ELECTRODOMESTICOS
6935794;;M;66;CHILENO;;Boomers;PELLUHUE                      ;MAULE;73270;2;1;0;0;0;2;1;73270;Horno Microondas Digital TH-20S01 20Lts;ELECTRODOMESTICOS
13169799;;F;45;CHILENO;;X;CHONCHI                       ;LOS LAGOS;15990;1;1;0;0;0;1;1;15990;Licuadora L-1630V Negra 1,5Lts Vaso Vidrio;ELECTRODOMESTICOS
12225499;;F;50;CHILENO;;X;RENCA                         ;METROPOLITANA;19990;1;1;0;0;0;1;1;19990;Hervidor Electrico TH-5407i 2Lts;ELECTRODOMESTICOS
9181098;;F;61;CHILENO;;Boomers;PROVIDENCIA                   ;METROPOLITANA;95840;2;1;2;1;95840;0;0;0;Horno Electrico TH-80i 80Lts;ELECTRODOMESTICOS
17324173;;F;32;CHILENO;;Millenial;N/D;N/D;69990;1;1;0;0;0;1;1;69990;Batidora Pedestal TH910PN 4,6Lts 1300Watts;ELECTRODOMESTICOS
13281203;;F;44;CHILENO;;X;MAIPU                         ;METROPOLITANA;15990;1;1;0;0;0;1;1;15990;Hervidor Electrico HA-3300 2,5Lts Blanco;ELECTRODOMESTICOS
13571818;;M;42;CHILENO;;Silencioso;PROVIDENCIA                   ;METROPOLITANA;10240;2;1;0;0;0;2;1;10240;Exprimidor de Jugo CJ-2000 1Lts;ELECTRODOMESTICOS
14340819;;F;44;CHILENO;;X;PROVIDENCIA                   ;METROPOLITANA;9990;1;1;0;0;0;1;1;9990;Exprimidor de Jugo CJ-2000 1Lts;ELECTRODOMESTICOS
16446398;;F;35;CHILENO;;Z;CHILLAN VIEJO                 ;BIO BIO;90640;5;1;0;0;0;5;1;90640;Plancha THOMAS TH-7170 2200Watts Base Ceramica;ELECTRODOMESTICOS
25177440;;F;32;VENEZOLANO;;Extranjero;SANTIAGO                      ;METROPOLITANA;59990;1;1;0;0;0;1;1;59990;Horno Microondas Mecanico Fancy 20Lts;ELECTRODOMESTICOS
16433284;;F;35;CHILENO;;Millenial;NANCAGUA                      ;L.G.B.OÂ´HIGGINS;44990;1;1;0;0;0;1;1;44990;Licuadora L-25000NG;ELECTRODOMESTICOS
8973338;;F;64;CHILENO;;Boomers;VILLARICA                     ;ARAUCANIA;154990;1;1;0;0;0;1;1;154990;Maquina de Coser 311;ELECTRODOMESTICOS
5021628;;F;74;CHILENO;;Silencioso;PROVIDENCIA                   ;METROPOLITANA;26990;1;1;0;0;0;1;1;26990;Hervidor Electrico UT-REIN17SS;ELECTRODOMESTICOS
8981822;;F;60;CHILENO;;Silencioso;PROVIDENCIA                   ;METROPOLITANA;34990;1;1;1;1;34990;0;0;0;ASPIRADORA THOMAS TH-1640;ELECTRODOMESTICOS
17109234;;F;33;CHILENO;;Millenial;MELIPILLA                     ;METROPOLITANA;43980;2;1;2;1;43980;0;0;0;Horno Microonda Columba 1700;ELECTRODOMESTICOS
15586086;;F;39;CHILENO;;X;PUDAHUEL;METROPOLITANA;107960;4;2;4;2;107960;0;0;0;Aspiradora VCC4190V3E/XZS Arrastre 2000Watts;ELECTRODOMESTICOS
8230119;;F;66;CHILENO;;Boomers;TEMUCO                        ;ARAUCANIA;990;1;2;0;0;0;1;2;990;Batidora Manual TH-8830;ELECTRODOMESTICOS
12205350;;F;49;CHILENO;;X;SAN CARLOS                    ;BIO BIO;35980;2;1;2;1;35980;0;0;0;Tostador de Pan TP-1400 4 Rebanadas Inox;ELECTRODOMESTICOS
12319908;;M;49;CHILENO;;Silencioso;PROVIDENCIA                   ;METROPOLITANA;63980;2;1;2;1;63980;0;0;0;ASPIRADORA VCC4580V3K/XZS SAMSUNG BLACK;ELECTRODOMESTICOS
17268731;;F;32;CHILENO;;Silencioso;PROVIDENCIA                   ;METROPOLITANA;53980;2;1;2;1;53980;0;0;0;Cafetera P65 Silver;ELECTRODOMESTICOS
9341621;;F;60;CHILENO;;Boomers;LANCO                         ;LOS RIOS;49990;1;1;0;0;0;1;1;49990;ASPIRADORA THOMAS TH-1640;ELECTRODOMESTICOS
7841911;;F;64;CHILENO;;Boomers;EL BOSQUE                     ;METROPOLITANA;15990;1;1;0;0;0;1;1;15990;Hervidor Electrico HA-3300 2,5Lts Blanco;ELECTRODOMESTICOS
11632190;;M;52;CHILENO;;Silencioso;PROVIDENCIA                   ;METROPOLITANA;113980;2;1;2;1;113980;0;0;0;Aspiradora Trapeadora Robot Ut-Excellenza (B);ELECTRODOMESTICOS
26202009;;F;28;VENEZOLANO;;Extranjero;CONCEPCION                    ;BIO BIO;12990;1;1;0;0;0;1;1;12990;Hervidor Acero Inoxidable 40989-CL Hamilton Beac;ELECTRODOMESTICOS
16689521;;F;35;CHILENO;;Millenial;RENCA                         ;METROPOLITANA;40840;2;1;2;1;40840;0;0;0;ASPIRADORA THOMAS TH-1640;ELECTRODOMESTICOS
16496388;;M;35;CHILENO;;Millenial;SAN CARLOS                    ;BIO BIO;49980;2;1;0;0;0;2;1;49980;Licuadora Personal TH-300PB;ELECTRODOMESTICOS
14265903;;M;53;CHILENO;;X;LOS LAGOS                     ;LOS LAGOS;78170;2;1;0;0;0;2;1;78170;Aspiradora TH1870 Arrastre 1800Watts Gris;ELECTRODOMESTICOS
9393591;;M;59;CHILENO;;Boomers;RENCA                         ;METROPOLITANA;64990;1;1;0;0;0;1;1;64990;Aspiradora TH1870 Arrastre 1800Watts Gris;ELECTRODOMESTICOS
13623070;;M;43;CHILENO;;Boomers;TEMUCO                        ;ARAUCANIA;112970;3;1;0;0;0;3;1;112970;Horno Electrico TH-38N 38Lts;ELECTRODOMESTICOS
9158133;;F;60;CHILENO;;Boomers;PROVIDENCIA                   ;METROPOLITANA;149990;1;1;0;0;0;1;1;149990;Maquina de Coser ME9100;ELECTRODOMESTICOS
16834979;;F;34;CHILENO;;Millenial;PROVIDENCIA                   ;METROPOLITANA;53980;2;1;2;1;53980;0;0;0;Horno Microondas Mecanico Fancy 20Lts;ELECTRODOMESTICOS
13471187;;F;44;CHILENO;;X;PROVIDENCIA                   ;METROPOLITANA;103980;2;1;2;1;103980;0;0;0;Aspiradora Trapeadora Robot Ut-Excellenza (B);ELECTRODOMESTICOS
16478464;;F;35;CHILENO;;Millenial;PROVIDENCIA                   ;METROPOLITANA;38980;2;1;2;1;38980;0;0;0;Mi Vacuum Cleaner mini - 31492;ELECTRODOMESTICOS
19489081;Soltero;M;25;CHILENO;;Z;PROVIDENCIA                   ;METROPOLITANA;48980;2;1;2;1;48980;0;0;0;Horno Microondas Mecanico Easy Wave 20Lts;ELECTRODOMESTICOS
18722998;;F;28;CHILENO;;Millenial;SAN FERNANDO                  ;L.G.B.OÂ´HIGGINS;17990;1;1;0;0;0;1;1;17990;Hervidor Electrico UT-KLAR20PW 2Lts Blanco;ELECTRODOMESTICOS
17554916;;F;30;CHILENO;;Millenial;N/D;N/D;3000;0;2;0;0;0;0;2;3000;Hervidor Electrico UT-MANLY17 1,7Lts Negro;ELECTRODOMESTICOS
17924989;;M;31;CHILENO;;Millenial;N/D;N/D;80840;2;1;2;1;80840;0;0;0;Horno Microondas Digital MS23K3513AK/ZS 23Lts;ELECTRODOMESTICOS
9630821;;F;62;CHILENO;;Boomers;RENCA                         ;METROPOLITANA;34990;1;1;0;0;0;1;1;34990;Procesador TH-9010 Multimixer 1,5Lts Vaso Vidrio;ELECTRODOMESTICOS
9923364;;F;54;CHILENO;;X;ANCUD                         ;LOS LAGOS;119980;2;1;0;0;0;2;1;119980;Batidora Pedestal TH910PN 4,6Lts 1300Watts;ELECTRODOMESTICOS
12725820;;F;47;CHILENO;;X;RENGO                         ;L.G.B.OÂ´HIGGINS;38990;1;1;0;0;0;1;1;38990;Aspiradora AP1700 Arrastre 1700Watts;ELECTRODOMESTICOS
14282333;Casado;M;47;CHILENO;;X;RENCA                         ;METROPOLITANA;93980;2;1;2;1;93980;0;0;0;Horno Electrico TH-80i 80Lts;ELECTRODOMESTICOS
18775277;;M;27;CHILENO;;Silencioso;PROVIDENCIA                   ;METROPOLITANA;38980;2;1;2;1;38980;0;0;0;ASPIRADORA THOMAS TH-1640;ELECTRODOMESTICOS
26030471;;M;50;HAITIANO;;Extranjero;RECOLETA                      ;METROPOLITANA;17990;1;1;0;0;0;1;1;17990;Hervidor Electrico UT-KLAR20PW 2Lts Blanco;ELECTRODOMESTICOS
6139978;;F;71;CHILENO;;Silencioso;RENCA                         ;METROPOLITANA;16990;1;1;0;0;0;1;1;16990;HERVIDOR TH-4340;ELECTRODOMESTICOS
26624155;;F;48;VENEZOLANO;;Extranjero;QUILLOTA                      ;VALPARAISO;169470;3;2;0;0;0;3;2;169470;ASPIRADORA THOMAS TH-1640;ELECTRODOMESTICOS
5178205;;F;78;CHILENO;;Silencioso;PROVIDENCIA                   ;METROPOLITANA;19990;1;1;0;0;0;1;1;19990;Hervidor Electrico TH-5407i 2Lts;ELECTRODOMESTICOS
8438180;;F;64;CHILENO;;Silencioso;PROVIDENCIA                   ;METROPOLITANA;69990;1;1;0;0;0;1;1;69990;Horno Microondas Digital TH-20S01 20Lts;ELECTRODOMESTICOS
11298422;;F;53;CHILENO;;X;VINA DEL MAR                  ;VALPARAISO;81980;2;1;0;0;0;2;1;81980;Aspiradora TH1870 Arrastre 1800Watts Gris;ELECTRODOMESTICOS
18178223;;M;30;CHILENO;;Millenial;PROVIDENCIA                   ;METROPOLITANA;119990;1;1;0;0;0;1;1;119990;Horno Electrico UT-BACKOFEN60 60Lts;ELECTRODOMESTICOS
9102721;;F;58;CHILENO;;Boomers;COIHAIQUE                     ;AYSEN;26990;1;1;0;0;0;1;1;26990;Licuadora L2000VNG 1,5Lts Vaso Vidrio;ELECTRODOMESTICOS
9240923;;M;61;CHILENO;;Boomers;RENCA                         ;METROPOLITANA;79990;1;1;0;0;0;1;1;79990;Horno Microondas Digital UT-CLASSY720 20Lts;ELECTRODOMESTICOS
18980919;Soltero;M;27;CHILENO;;Millenial;CABILDO;VALPARAISO;174970;3;2;3;2;174970;0;0;0;Plancha a Vapor Oster 3803;ELECTRODOMESTICOS
17163632;;M;33;CHILENO;;Silencioso;PROVIDENCIA                   ;METROPOLITANA;139990;1;1;1;1;139990;0;0;0;Maquina de Coser 311;ELECTRODOMESTICOS
9812740;;F;57;CHILENO;;Boomers;RENCA                         ;METROPOLITANA;14990;1;1;0;0;0;1;1;14990;HERVIDOR TH-4340;ELECTRODOMESTICOS
10270576;;F;54;CHILENO;;Boomers;ANGOL                         ;ARAUCANIA;106980;2;1;0;0;0;2;1;106980;Horno electrico Black Oven 42lts;ELECTRODOMESTICOS
17225997;;F;31;CHILENO;;Millenial;CHILLAN                       ;BIO BIO;85840;2;1;2;1;85840;0;0;0;HORNO ELECTRICO THOMAS TH-38i;ELECTRODOMESTICOS
13544102;;M;42;CHILENO;;X;QUILPUE                       ;VALPARAISO;89980;2;1;0;0;0;2;1;89980;Horno Electrico TH-48N 48Lts;ELECTRODOMESTICOS
9964212;;F;58;CHILENO;;Silencioso;PROVIDENCIA                   ;METROPOLITANA;26990;1;1;0;0;0;1;1;26990;Licuadora Roja 550W 1,5Lts Vaso Vidrio;ELECTRODOMESTICOS
11565486;Casado;F;51;CHILENO;;X;PROVIDENCIA                   ;METROPOLITANA;12990;1;1;0;0;0;1;1;12990;Exprimidor de Jugo CJ-2000 1Lts;ELECTRODOMESTICOS
5154273;;M;75;CHILENO;;Silencioso;ARICA                         ;TARAPACA;21990;1;1;0;0;0;1;1;21990;Licuadora L-1630V Negra 1,5Lts Vaso Vidrio;ELECTRODOMESTICOS
11771870;;M;51;CHILENO;;X;PROVIDENCIA                   ;METROPOLITANA;121040;5;2;0;0;0;5;2;121040;Plancha a vapor 6052 Oster;ELECTRODOMESTICOS
18190589;;F;29;CHILENO;;Millenial;PROVIDENCIA                   ;METROPOLITANA;299980;4;2;4;2;299980;0;0;0;Aspiradora Mi Robot Vacuum-Mop Essential;ELECTRODOMESTICOS
15020841;;F;40;CHILENO;;Millenial;ANTOFAGASTA                   ;ANTOFAGASTA;14990;1;1;0;0;0;1;1;14990;Hervidor Electrico UT-MANLY17 1,7Lts Negro;ELECTRODOMESTICOS
12351311;;F;49;CHILENO;;X;LA CRUZ                       ;VALPARAISO;17990;1;1;0;0;0;1;1;17990;Hervidor Electrico TH-4515N 2Lts Negro;ELECTRODOMESTICOS
10278867;;F;58;CHILENO;;Boomers;CONCEPCION                    ;BIO BIO;354970;3;3;0;0;0;3;3;354970;Aspiradora TH1415 Arrastre 1500Watts;ELECTRODOMESTICOS
14039666;;F;40;CHILENO;;X;OSORNO                        ;LOS LAGOS;12990;1;1;0;0;0;1;1;12990;Exprimidor de Jugo CJ-2000 1Lts;ELECTRODOMESTICOS
17122233;;F;33;CHILENO;;Silencioso;PROVIDENCIA                   ;METROPOLITANA;126980;2;1;2;1;126980;0;0;0;Maquina de Coser 3008 Janome Blanco;ELECTRODOMESTICOS
6958725;;M;70;CHILENO;;Silencioso;PROVIDENCIA                   ;METROPOLITANA;169540;5;2;0;0;0;5;2;169540;Horno Electrico UT-BACKOFEN48 48Lts;ELECTRODOMESTICOS
16227887;;F;38;CHILENO;;Millenial;PROVIDENCIA                   ;METROPOLITANA;33990;1;1;0;0;0;1;1;33990;Extractor de Jugo EX800 1,4Lts;ELECTRODOMESTICOS
16301258;;M;36;CHILENO;;Silencioso;PROVIDENCIA                   ;METROPOLITANA;49980;2;1;2;1;49980;0;0;0;Aspiradora VCC4190V3E/XZS Arrastre 2000Watts;ELECTRODOMESTICOS
18341855;;F;29;CHILENO;;Millenial;COPIAPO                       ;ATACAMA;39990;1;1;0;0;0;1;1;39990;Horno Microondas Mecanico TH-18B05 18Lts;ELECTRODOMESTICOS
13113034;;F;45;CHILENO;;X;TEMUCO                        ;ARAUCANIA;53970;3;2;0;0;0;3;2;53970;Hervidor Electrico Tetera TH-6505RT 1,7Lts Rojo;ELECTRODOMESTICOS
8605339;;F;55;CHILENO;;Boomers;RENCA                         ;METROPOLITANA;59990;1;1;0;0;0;1;1;59990;Batidora Vertical Minipimer UT-KLOT800SS;ELECTRODOMESTICOS
13126941;;F;45;CHILENO;;X;SAN CARLOS                    ;BIO BIO;49990;1;1;0;0;0;1;1;49990;Horno Microondas Mecanico Easy Wave 20Lts;ELECTRODOMESTICOS
12088013;;F;48;CHILENO;;X;VALDIVIA                      ;LOS RIOS;43540;2;1;2;1;43540;0;0;0;Aspiradora TH1407 Arrastre 1400Watts;ELECTRODOMESTICOS
19178037;;M;26;CHILENO;;Z;ANTOFAGASTA                   ;ANTOFAGASTA;59990;1;1;0;0;0;1;1;59990;Horno Microondas Mecanico UT-SYDNEY18 18Lts;ELECTRODOMESTICOS
10442565;Casado;F;59;CHILENO;;Boomers;PROVIDENCIA                   ;METROPOLITANA;44980;2;2;0;0;0;2;2;44980;Plancha UT-DUNST 2200Watts Base Ceramica;ELECTRODOMESTICOS
18964622;;F;26;CHILENO;;Z;OSORNO                        ;LOS LAGOS;36990;1;1;0;0;0;1;1;36990;Aspiradora AP1700 Arrastre 1700Watts;ELECTRODOMESTICOS
13617320;;M;43;CHILENO;;X;SAN CARLOS                    ;BIO BIO;59990;1;1;0;0;0;1;1;59990;Aspiradora UT-SILENT1603 Arrastre 1600Watts;ELECTRODOMESTICOS
16771554;;F;34;CHILENO;;Millenial;N/D;N/D;151540;2;1;2;1;151540;0;0;0;MAQUINA DE COSER ALFA MOD STYLE 40;ELECTRODOMESTICOS
7401846;;F;66;CHILENO;;Boomers;N/D;N/D;27980;2;2;0;0;0;2;2;27980;Hervidor Electrico TH-5407i 2Lts;ELECTRODOMESTICOS
18458630;Soltero;F;29;CHILENO;CIRUJANO DENTISTA;Millenial;PROVIDENCIA                   ;METROPOLITANA;99990;1;1;1;1;99990;0;0;0;Horno Electrico UT-BACKOFEN60 60Lts;ELECTRODOMESTICOS
12108187;;M;43;CHILENO;;Silencioso;PROVIDENCIA                   ;METROPOLITANA;19990;1;1;1;1;19990;0;0;0;Licuadora Berry Blender Roja 1400 Vaso Vidrio;ELECTRODOMESTICOS
9505448;;F;61;CHILENO;;Boomers;MAIPU                         ;METROPOLITANA;26990;1;1;0;0;0;1;1;26990;Hervidor Electrico UT-REIN17SS;ELECTRODOMESTICOS
4507098;;F;82;CHILENO;;Silencioso;RANCAGUA                      ;L.G.B.OÂ´HIGGINS;17990;1;1;0;0;0;1;1;17990;Hervidor Electrico TH-4515N 2Lts Negro;ELECTRODOMESTICOS
15877578;;F;38;CHILENO;;Millenial;CHILLAN                       ;NUBLE;54990;1;1;0;0;0;1;1;54990;Horno Microondas Mecanico UT-SYDNEY18 18Lts;ELECTRODOMESTICOS
6115190;;F;75;CHILENO;;Silencioso;SALAMANCA                     ;COQUIMBO;17990;1;1;0;0;0;1;1;17990;Hervidor Electrico TH-4515N 2Lts Negro;ELECTRODOMESTICOS
18197751;;F;29;CHILENO;;Millenial;SAN VICENTE                   ;L.G.B.OÂ´HIGGINS;26990;1;1;0;0;0;1;1;26990;Licuadora TH-320 Roja/Negro 1,5 Lts Vaso Vidrio;ELECTRODOMESTICOS
9934638;;M;50;CHILENO;;X;FLORIDA                       ;BIO BIO;89990;1;1;1;1;89990;0;0;0;Horno Electrico TH-80i 80Lts;ELECTRODOMESTICOS
10880243;;F;55;CHILENO;;Boomers;RENCA                         ;METROPOLITANA;18990;1;1;0;0;0;1;1;18990;Batidora Manual TH-8830;ELECTRODOMESTICOS
19550715;;F;25;CHILENO;;Z;N/D;N/D;164080;3;1;3;1;164080;0;0;0;LICUADORA MULTIFUNCION LCM-18000 GF;ELECTRODOMESTICOS
8871098;Casado;F;59;CHILENO;;Boomers;LAJA                          ;BIO BIO;17990;1;1;0;0;0;1;1;17990;Hervidor Electrico TH-4515N 2Lts Negro;ELECTRODOMESTICOS
19713858;;F;25;CHILENO;;Z;PROVIDENCIA                   ;METROPOLITANA;16990;1;1;0;0;0;1;1;16990;Tostador de Pan TH-116 2 Rebanadas Negro;ELECTRODOMESTICOS
5529505;;F;73;CHILENO;;Silencioso;N/D;N/D;33980;2;1;2;1;33980;0;0;0;Hervidor Electrico Tetera HA-4100 4Lts Iox;ELECTRODOMESTICOS
9729687;;F;58;CHILENO;;Boomers;LOS ANDES                     ;VALPARAISO;155860;3;2;0;0;0;3;2;155860;Batidora Pedestal TH910PN 4,6Lts 1300Watts;ELECTRODOMESTICOS
8094882;;M;64;CHILENO;;Boomers;SAN CARLOS                    ;BIO BIO;27990;1;1;0;0;0;1;1;27990;Plancha UT-KERAMIKTOP 2200Watts Base Ceramica;ELECTRODOMESTICOS
12430343;;F;53;CHILENO;;X;"";"";29990;1;1;0;0;0;1;1;29990;Batidora Pedestal B5300 Inox;ELECTRODOMESTICOS
18761660;Soltero;F;27;CHILENO;;Z;PROVIDENCIA                   ;METROPOLITANA;16990;1;1;0;0;0;1;1;16990;Plancha a vapor 6052 Oster;ELECTRODOMESTICOS
16077693;;F;37;CHILENO;;Millenial;PROVIDENCIA                   ;METROPOLITANA;17070;2;1;0;0;0;2;1;17070;PLANCHA A VAPOR 2501 BASE CERAMICA 2200w;ELECTRODOMESTICOS
17854493;;F;30;CHILENO;;Millenial;PROVIDENCIA                   ;METROPOLITANA;14990;1;1;0;0;0;1;1;14990;HERVIDOR TH-4340;ELECTRODOMESTICOS
19274187;;F;26;CHILENO;;Z;PROVIDENCIA                   ;METROPOLITANA;39990;1;1;0;0;0;1;1;39990;Horno Electrico TH-25N01 25Lts;ELECTRODOMESTICOS
18156032;;M;29;CHILENO;;Millenial;N/D;N/D;79990;1;1;0;0;0;1;1;79990;Cafetera P65 Silver;ELECTRODOMESTICOS
12653276;;M;48;CHILENO;;X;RECOLETA                      ;METROPOLITANA;69990;1;1;0;0;0;1;1;69990;Horno Microondas Mecanico M-2030 NG 20Lts;ELECTRODOMESTICOS
15252691;;F;40;CHILENO;;X;LONCOCHE                      ;ARAUCANIA;18990;1;1;0;0;0;1;1;18990;Batidora Manual TH-8830;ELECTRODOMESTICOS
4526551;;M;79;CHILENO;;Silencioso;COLINA                        ;METROPOLITANA;39990;1;1;0;0;0;1;1;39990;Aspiradora TH1407 Arrastre 1400Watts;ELECTRODOMESTICOS
10613432;;F;53;CHILENO;;X;RENCA                         ;METROPOLITANA;39070;2;1;0;0;0;2;1;39070;Licuadora Kaliman Negra con Teclas;ELECTRODOMESTICOS
6185338;;F;67;CHILENO;;Boomers;RENCA                         ;METROPOLITANA;14990;1;1;0;0;0;1;1;14990;Hervidor Electrico UT-MANLY17 1,7Lts Negro;ELECTRODOMESTICOS
16285806;;F;35;CHILENO;;Millenial;PROVIDENCIA                   ;METROPOLITANA;14990;1;1;0;0;0;1;1;14990;Hervidor Electrico HE420 2lts Negro;ELECTRODOMESTICOS
15817390;;M;38;CHILENO;;Millenial;PROVIDENCIA                   ;METROPOLITANA;19990;1;1;0;0;0;1;1;19990;Hervidor Electrico TH-5407i 2Lts;ELECTRODOMESTICOS
18851210;;F;27;CHILENO;;Z;PROVIDENCIA                   ;METROPOLITANA;63980;3;2;3;2;63980;0;0;0;Horno Microondas Mecanico TH-18B05 18Lts;ELECTRODOMESTICOS
7984571;Casado;M;63;CHILENO;;Boomers;PROVIDENCIA                   ;METROPOLITANA;34990;1;1;0;0;0;1;1;34990;Licuadora UT-METALLEK505P 1,5Lts Vaso Vidrio;ELECTRODOMESTICOS
6865471;;M;68;CHILENO;;Silencioso;PROVIDENCIA                   ;METROPOLITANA;15990;1;1;0;0;0;1;1;15990;Hervidor Electrico HA-3300 2,5Lts Blanco;ELECTRODOMESTICOS
11952505;;F;49;CHILENO;;X;RENCA                         ;METROPOLITANA;113170;2;1;0;0;0;2;1;113170;Horno Electrico TH62I 60Lts;ELECTRODOMESTICOS
8977577;;F;59;CHILENO;;Silencioso;PROVIDENCIA                   ;METROPOLITANA;94990;1;1;0;0;0;1;1;94990;Horno Electrico UT-BACKOFEN48 48Lts;ELECTRODOMESTICOS
11601825;Casado;F;52;CHILENO;CONTADOR AUDITOR;X;RENCA                         ;METROPOLITANA;84990;1;1;1;1;84990;0;0;0;Batidora Pedestal TH910PN 4,6Lts 1300Watts;ELECTRODOMESTICOS
6919006;;M;68;CHILENO;;Silencioso;N/D;N/D;173980;2;1;2;1;173980;0;0;0;Maquina de coser computarizada SH7700;ELECTRODOMESTICOS
13148747;;F;44;CHILENO;;X;LOS ANGELES                   ;BIO BIO;119990;1;1;0;0;0;1;1;119990;Horno Electrico UT-BACKOFEN60 60Lts;ELECTRODOMESTICOS
16851164;;F;34;CHILENO;;Millenial;PROVIDENCIA                   ;METROPOLITANA;144980;2;1;2;1;144980;0;0;0;CAFETERA PRIMA LATTE 6603 NEGRA;ELECTRODOMESTICOS
12365534;Casado;F;48;CHILENO;;X;RENCA                         ;METROPOLITANA;14990;1;1;0;0;0;1;1;14990;Exprimidor de Jugo 407W 1Lts;ELECTRODOMESTICOS
6411416;;F;70;CHILENO;;Silencioso;RENCA                         ;METROPOLITANA;19990;1;1;0;0;0;1;1;19990;Licuadora L-1630V Negra 1,5Lts Vaso Vidrio;ELECTRODOMESTICOS
14125506;;F;41;CHILENO;;X;N/D;N/D;13990;1;2;0;0;0;1;2;13990;Hervidor Electrico HA-2650NG;ELECTRODOMESTICOS
23922469;;M;36;BOLIVIANO;;Extranjero;CALAMA                        ;ANTOFAGASTA;27980;2;2;0;0;0;2;2;27980;HERVIDOR TH-4340;ELECTRODOMESTICOS
14164664;Soltero;F;40;CHILENO;;X;PROVIDENCIA                   ;METROPOLITANA;30990;1;1;0;0;0;1;1;30990;Plancha THOMAS TH-7170 2200Watts Base Ceramica;ELECTRODOMESTICOS
6528949;;M;71;CHILENO;;Silencioso;CHILLAN VIEJO                 ;BIO BIO;45173;2;1;0;0;0;2;1;45173;Aspiradora Handy Clean Black 1400;ELECTRODOMESTICOS
14525710;;F;47;CHILENO;;X;PROVIDENCIA                   ;METROPOLITANA;69970;3;1;0;0;0;3;1;69970;Hervidor Electrico UT-REIN17SS;ELECTRODOMESTICOS
17300135;;F;33;CHILENO;;Millenial;PROVIDENCIA                   ;METROPOLITANA;44980;2;2;0;0;0;2;2;44980;Hervidor Electrico Tetera HA-4100 4Lts Iox;ELECTRODOMESTICOS
16367484;;F;35;CHILENO;;Silencioso;PROVIDENCIA                   ;METROPOLITANA;14990;1;1;0;0;0;1;1;14990;Tostador de Pan TH-116 2 Rebanadas Negro;ELECTRODOMESTICOS
11022362;;F;56;CHILENO;;Boomers;N/D;N/D;29990;1;1;0;0;0;1;1;29990;Licuadora Roja 550W 1,5Lts Vaso Vidrio;ELECTRODOMESTICOS
6708511;;F;73;CHILENO;;Silencioso;ALGARROBO                     ;VALPARAISO;74990;1;1;0;0;0;1;1;74990;Horno Electrico UT-LEIF36 36Lts;ELECTRODOMESTICOS
18097628;;M;30;CHILENO;;Millenial;"";"";22990;1;1;0;0;0;1;1;22990;PLANCHA VAPOR TH-7146;ELECTRODOMESTICOS
20342300;;M;28;CHILENO;;Millenial;N/D;N/D;29990;1;1;0;0;0;1;1;29990;Hervidor Electrico UT-REIN17SS;ELECTRODOMESTICOS
11666643;;F;52;CHILENO;;X;LA CISTERNA                   ;METROPOLITANA;88980;2;1;2;1;88980;0;0;0;Batidora Pedestal TH910PN 4,6Lts 1300Watts;ELECTRODOMESTICOS
12197447;Soltero;F;52;CHILENO;;X;RENCA                         ;METROPOLITANA;79990;1;1;0;0;0;1;1;79990;Horno Electrico UT-LEIF36 36Lts;ELECTRODOMESTICOS
17910667;;F;30;CHILENO;;Millenial;N/D;N/D;59990;1;1;0;0;0;1;1;59990;Horno Microondas Digital TH-20S01 20Lts;ELECTRODOMESTICOS
16971002;;M;33;CHILENO;;Millenial;N/D;N/D;74990;1;1;0;0;0;1;1;74990;Horno Electrico TH-48N 48Lts;ELECTRODOMESTICOS
18456252;Soltero;M;29;CHILENO;INGENIERIA MECANICO EN PRODUCCION INDUSTRIAL;Extranjero;LO PRADO                      ;METROPOLITANA;88980;2;1;2;1;88980;0;0;0;ASPIRADORA THOMAS TH-2230;ELECTRODOMESTICOS
16296104;;M;36;CHILENO;;X;PROVIDENCIA                   ;METROPOLITANA;104990;1;1;0;0;0;1;1;104990;Horno Microondas Digital ME0113MB1/XZS 32Lts;ELECTRODOMESTICOS
7249442;;F;66;CHILENO;;Boomers;EL BOSQUE                     ;METROPOLITANA;12990;1;1;0;0;0;1;1;12990;Hervidor Electrico 3101 1,7Lts Negro;ELECTRODOMESTICOS
26827238;;M;37;EXTRANJERO - NO INFORMA NACIONALIDAD;;Extranjero;N/D;N/D;165530;3;2;2;1;117540;1;1;47990;FREIDORA DE AIRE CKSTAF55 1700W;ELECTRODOMESTICOS
6745908;;F;71;CHILENO;;Silencioso;LA SERENA                     ;COQUIMBO;49990;1;1;0;0;0;1;1;49990;Horno Electrico UT-BACKOFEN26 26Lts;ELECTRODOMESTICOS
10020391;;F;55;CHILENO;;Boomers;VALLENAR;ATACAMA;24990;1;1;0;0;0;1;1;24990;Batidora Manual BA-5010 Inox;ELECTRODOMESTICOS
15343849;;M;47;CHILENO;;X;RENCA                         ;METROPOLITANA;287960;3;1;3;1;287960;0;0;0;SUPER FREIDORA DE AIRE OV3;ELECTRODOMESTICOS
11500698;;M;53;CHILENO;;X;VILCUN                        ;ARAUCANIA;0;0;2;0;0;0;0;2;0;Horno Electrico TH62I 60Lts;ELECTRODOMESTICOS
7442709;;F;66;CHILENO;;Millenial;"";"";21990;1;1;0;0;0;1;1;21990;HERVIDOR ELECTRICO UT-STARK18;ELECTRODOMESTICOS
14369364;;F;47;CHILENO;;Silencioso;PROVIDENCIA                   ;METROPOLITANA;21990;1;1;0;0;0;1;1;21990;Plancha TH-7052 2000Watts Base Inox;ELECTRODOMESTICOS
10862375;Casado;M;54;CHILENO;;X;RENCA                         ;METROPOLITANA;15990;1;1;0;0;0;1;1;15990;Hervidor Electrico HA-3300 2,5Lts Blanco;ELECTRODOMESTICOS
12416487;;M;49;CHILENO;;X;PROVIDENCIA                   ;METROPOLITANA;17990;1;1;0;0;0;1;1;17990;Hervidor Electrico TH-4515N 2Lts Negro;ELECTRODOMESTICOS
26494419;;F;34;EXTRANJERO - NO INFORMA NACIONALIDAD;;Extranjero;"";"";146650;4;1;0;0;0;4;1;146650;Horno Microondas Digital TH-25DM 25Lts;ELECTRODOMESTICOS
6037183;Viudo;F;74;CHILENO;;Silencioso;RENCA                         ;METROPOLITANA;19990;1;1;0;0;0;1;1;19990;Hervidor Electrico TH-5407i 2Lts;ELECTRODOMESTICOS
8703270;;M;62;CHILENO;;Boomers;CANELA                        ;COQUIMBO;79340;4;1;0;0;0;4;1;79340;Licuadora Personal TH-300PB;ELECTRODOMESTICOS
16110559;;F;36;CHILENO;;Millenial;PROVIDENCIA                   ;METROPOLITANA;12990;1;1;0;0;0;1;1;12990;Hervidor Acero Inoxidable 40989-CL Hamilton Beac;ELECTRODOMESTICOS
27395783;;M;30;"";;Extranjero;"";"";18990;1;1;0;0;0;1;1;18990;Plancha UT-DUNST 2200Watts Base Ceramica;ELECTRODOMESTICOS
6951794;;F;74;CHILENO;;Silencioso;TOCOPILLA                     ;ANTOFAGASTA;38990;1;1;0;0;0;1;1;38990;HORNO ELECTRICO 16N01 16LTS NEGRO;ELECTRODOMESTICOS
12121343;;M;51;CHILENO;;X;LUMACO                        ;ARAUCANIA;0;0;0;0;0;0;0;0;0;Hervidor Electrico UT-MANLY17 1,7Lts Negro;ELECTRODOMESTICOS
10897265;;M;56;CHILENO;;Boomers;LEBU                          ;BIO BIO;0;0;0;0;0;0;0;0;0;Plancha a vapor 6052 Oster;ELECTRODOMESTICOS
15307399;;M;38;CHILENO;;Millenial;NATALES                       ;MAGALLANES;0;0;0;0;0;0;0;0;0;Hervidor Electrico TH-4515N 2Lts Negro;ELECTRODOMESTICOS
19499213;;F;25;CHILENO;;Z;N/D;N/D;0;0;0;0;0;0;0;0;0;Horno Microondas Digital TH20DM 20Lts Espejado;ELECTRODOMESTICOS
14340709;;F;44;CHILENO;;X;SAN BERNARDO                  ;METROPOLITANA;0;0;0;0;0;0;0;0;0;Hervidor Electrico 3100 1,7Lts Negro;ELECTRODOMESTICOS
13928720;;M;42;CHILENO;;X;N/D;N/D;0;0;0;0;0;0;0;0;0;PROCESADOR THOMAS TH-9160;ELECTRODOMESTICOS
10460197;;M;54;CHILENO;;Boomers;LA CISTERNA                   ;METROPOLITANA;0;0;0;0;0;0;0;0;0;Hervidor Electrico UT-DUNKEL17P 2Lts Negro;ELECTRODOMESTICOS
11918778;;M;49;CHILENO;;Silencioso;PROVIDENCIA                   ;METROPOLITANA;0;0;0;0;0;0;0;0;0;Licuadora Personal TH-300PB;ELECTRODOMESTICOS
4845890;;M;75;CHILENO;;Silencioso;TALCA                         ;MAULE;0;0;0;0;0;0;0;0;0;Hervidor Electrico TH-5407i 2Lts;ELECTRODOMESTICOS
26637553;;M;37;VENEZOLANO;;Extranjero;LO PRADO                      ;METROPOLITANA;0;0;0;0;0;0;0;0;0;Horno Microondas Mecanico Easy Wave 20Lts;ELECTRODOMESTICOS
14348299;;M;42;CHILENO;;X;COYHAIQUE;AYSEN;0;0;0;0;0;0;0;0;0;Horno Electrico UT-BACKOFEN26 26Lts;ELECTRODOMESTICOS
6655666;Casado;F;66;CHILENO;;Boomers;RENCA                         ;METROPOLITANA;0;0;0;0;0;0;0;0;0;Hervidor Electrico TH-4515N 2Lts Negro;ELECTRODOMESTICOS
18507918;;F;28;CHILENO;;Millenial;PROVIDENCIA                   ;METROPOLITANA;0;0;0;0;0;0;0;0;0;BATIDORA INMERSION S MIX 2616;ELECTRODOMESTICOS
25030432;;M;49;COLOMBIANO;;Extranjero;"";"";0;0;0;0;0;0;0;0;0;Horno Microondas Digital MS23K3513AK/ZS 23Lts;ELECTRODOMESTICOS
16625821;;F;34;CHILENO;;Silencioso;PROVIDENCIA                   ;METROPOLITANA;0;0;0;0;0;0;0;0;0;Maquina de Coser 311;ELECTRODOMESTICOS
19328061;;M;25;CHILENO;;Z;N/D;N/D;0;0;0;0;0;0;0;0;0;Hervidor Electrico UT-MANLY17 1,7Lts Negro;ELECTRODOMESTICOS
6351987;;F;68;CHILENO;;Silencioso;PROVIDENCIA                   ;METROPOLITANA;0;0;0;0;0;0;0;0;0;Hervidor Electrico UT-DUNKEL17P 2Lts Negro;ELECTRODOMESTICOS
13749623;;F;42;CHILENO;;X;QUILLOTA                      ;VALPARAISO;0;0;0;0;0;0;0;0;0;Exprimidor Fauna 500 cc;ELECTRODOMESTICOS
6212592;;F;72;CHILENO;;Silencioso;VALDIVIA                      ;LOS LAGOS;0;0;0;0;0;0;0;0;0;Picadora UT-PETRUS320 1Lts Vaso Vidrio;ELECTRODOMESTICOS
6255706;;F;69;CHILENO;;Silencioso;RENGO                         ;L.G.B.OÂ´HIGGINS;0;0;0;0;0;0;0;0;0;LICUADORA CROMADA CON TECLAS PLUS;ELECTRODOMESTICOS
18041089;;F;30;CHILENO;;Millenial;DONIHUE                       ;L.G.B.OÂ´HIGGINS;0;0;0;0;0;0;0;0;0;Horno Electrico TH-80i 80Lts;ELECTRODOMESTICOS
12000219;;F;54;CHILENO;;X;TEMUCO                        ;ARAUCANIA;0;0;0;0;0;0;0;0;0;Procesador TH-9010 Multimixer 1,5Lts Vaso Vidrio;ELECTRODOMESTICOS
7921413;;F;64;CHILENO;;Boomers;TRAIGUEN                      ;ARAUCANIA;0;0;0;0;0;0;0;0;0;Freidora de Aire 18M Oster;ELECTRODOMESTICOS
16877795;;M;33;CHILENO;;X;TEMUCO                        ;ARAUCANIA;0;0;0;0;0;0;0;0;0;Aspiradora Polvo AP-700 GR;ELECTRODOMESTICOS
19118020;;F;26;CHILENO;;Silencioso;PROVIDENCIA                   ;METROPOLITANA;0;0;0;0;0;0;0;0;0;Maquina de Coser Overlock MY8002D;ELECTRODOMESTICOS
11326784;;F;54;CHILENO;;X;LA SERENA                     ;COQUIMBO;0;0;0;0;0;0;0;0;0;Horno Electrico UT-BACKOFEN38 38Lts;ELECTRODOMESTICOS
26796301;;M;34;VENEZOLANO;;Extranjero;LA SERENA                     ;COQUIMBO;0;0;0;0;0;0;0;0;0;Combo Hervidor + Tostador + Sandwichera;ELECTRODOMESTICOS
15203221;;F;38;CHILENO;;Millenial;PROVIDENCIA                   ;METROPOLITANA;0;0;0;0;0;0;0;0;0;Horno Electrico TH-25N01 25Lts;ELECTRODOMESTICOS
9697607;Soltero;F;57;CHILENO;CIRUJANO DENTISTA;Boomers;RENCA                         ;METROPOLITANA;0;0;0;0;0;0;0;0;0;Horno Microondas Mecanico UT-SYDNEY18 18Lts;ELECTRODOMESTICOS
20326264;;F;23;CHILENO;;Z;PROVIDENCIA                   ;METROPOLITANA;0;0;0;0;0;0;0;0;0;Horno Electrico TH-25N01 25Lts;ELECTRODOMESTICOS
19853960;;F;23;CHILENO;;Z;PROVIDENCIA                   ;METROPOLITANA;0;0;0;0;0;0;0;0;0;H. Microondas Fancy (2000rd);ELECTRODOMESTICOS
19020929;;F;26;CHILENO;;Z;RANCAGUA                      ;L.G.B.OÂ´HIGGINS;0;0;0;0;0;0;0;0;0;ASPIRADORA THOMAS TH-1640;ELECTRODOMESTICOS
9542565;;F;64;CHILENO;;Boomers;RENCA                         ;METROPOLITANA;0;0;0;0;0;0;0;0;0;Procesador TH-9010 Multimixer 1,5Lts Vaso Vidrio;ELECTRODOMESTICOS
24249714;;M;45;BOLIVIANO;;Extranjero;CALAMA                        ;ANTOFAGASTA;0;0;0;0;0;0;0;0;0;Horno Electrico TH-25N01 25Lts;ELECTRODOMESTICOS
5025075;;F;76;CHILENO;;Silencioso;PROVIDENCIA                   ;METROPOLITANA;0;0;0;0;0;0;0;0;0;Exprimidor Fauna 500 cc;ELECTRODOMESTICOS
11279484;;F;53;CHILENO;;X;SAN FERNANDO                  ;L.G.B.OÂ´HIGGINS;0;0;0;0;0;0;0;0;0;Licuadora Kaliman Negra con Teclas;ELECTRODOMESTICOS
11262461;;F;56;CHILENO;;Boomers;PROVIDENCIA                   ;METROPOLITANA;0;0;0;0;0;0;0;0;0;Exprimidor Fauna 500 cc;ELECTRODOMESTICOS
13069109;;M;45;CHILENO;;X;RENCA                         ;METROPOLITANA;0;0;0;0;0;0;0;0;0;Combo Juguera + Hervidor;ELECTRODOMESTICOS
16004951;;M;35;CHILENO;;Millenial;PROVIDENCIA                   ;METROPOLITANA;0;0;0;0;0;0;0;0;0;Plancha UT-KERAMIK1 2200Watts Base Ceramica;ELECTRODOMESTICOS
18012864;;F;30;CHILENO;;Millenial;LONQUIMAY                     ;ARAUCANIA;0;0;0;0;0;0;0;0;0;Batidora Manual UT-TEKLA300;ELECTRODOMESTICOS
16249971;;M;36;CHILENO;;Silencioso;PROVIDENCIA                   ;METROPOLITANA;0;0;0;0;0;0;0;0;0;Batidora Vertical Minipimer UT-KLOT400P;ELECTRODOMESTICOS
5779991;;F;73;CHILENO;;Silencioso;RENCA                         ;METROPOLITANA;0;0;0;0;0;0;0;0;0;Licuadora TH-501V 1,5Lts Vaso Vidrio;ELECTRODOMESTICOS
6078178;;F;73;CHILENO;;Silencioso;PARRAL                        ;MAULE;0;0;0;0;0;0;0;0;0;Horno Microondas Mecanico Easy Wave 20Lts;ELECTRODOMESTICOS
18320069;Casado;F;28;CHILENO;;Millenial;ANGOL                         ;ARAUCANIA;0;0;0;0;0;0;0;0;0;Horno Microondas Mecanico Easy Wave 20Lts;ELECTRODOMESTICOS
16889496;;F;32;CHILENO;;Millenial;ANCUD                         ;LOS LAGOS;0;0;0;0;0;0;0;0;0;Hervidor Electrico TH-4515N 2Lts Negro;ELECTRODOMESTICOS
15153304;;M;40;CHILENO;;X;COLBUN                        ;MAULE;0;0;0;0;0;0;0;0;0;Hervidor Electrico HA-2650NG;ELECTRODOMESTICOS
18393258;;M;29;CHILENO;;Silencioso;PROVIDENCIA                   ;METROPOLITANA;0;0;0;0;0;0;0;0;0;Hervidor Electrico HA-2650NG;ELECTRODOMESTICOS
11413123;;F;53;CHILENO;;X;OSORNO                        ;LOS LAGOS;0;0;0;0;0;0;0;0;0;Plancha Vertical UT-TURBOSTEAMER 1400Watts;ELECTRODOMESTICOS
18702316;;F;28;CHILENO;;Millenial;N/D;N/D;0;0;0;0;0;0;0;0;0;CAFETERA PRIMA LATTE 6603 NEGRA;ELECTRODOMESTICOS
12482976;Casado;F;48;CHILENO;;X;RENCA                         ;METROPOLITANA;0;0;0;0;0;0;0;0;0;HERVIDOR THOMAS TH-5525C;ELECTRODOMESTICOS
12646861;;F;47;CHILENO;;X;RENCA                         ;METROPOLITANA;0;0;0;0;0;0;0;0;0;MICROONDAS 40L MG402MADXBB/ZS SAMSUNG;ELECTRODOMESTICOS
19121091;;M;26;CHILENO;;Z;SAN FERNANDO                  ;L.G.B.OÂ´HIGGINS;0;0;0;0;0;0;0;0;0;Horno Microondas Mecanico Easy Wave 20Lts;ELECTRODOMESTICOS
20031214;;M;22;CHILENO;;Silencioso;PROVIDENCIA                   ;METROPOLITANA;0;0;0;0;0;0;0;0;0;Exprimidor de Jugo 407W 1Lts;ELECTRODOMESTICOS
15571851;;F;39;CHILENO;;X;OVALLE                        ;COQUIMBO;0;0;0;0;0;0;0;0;0;Batidora Pedestal TH910PN 4,6Lts 1300Watts;ELECTRODOMESTICOS
9557923;;F;61;CHILENO;;Boomers;ALTO HOSPICIO;TARAPACA;0;0;0;0;0;0;0;0;0;Horno Microondas Mecanico UT-SYDNEY18 18Lts;ELECTRODOMESTICOS
16896488;;M;34;CHILENO;;Millenial;N/D;N/D;0;0;0;0;0;0;0;0;0;Plancha OSTER 4801T 1200Watts Base Ceramica;ELECTRODOMESTICOS
26082523;;F;52;VENEZOLANO;;Extranjero;N/D;N/D;0;0;0;0;0;0;0;0;0;Aspiradora UT-SILENT1603 Arrastre 1600Watts;ELECTRODOMESTICOS
15161465;;F;39;CHILENO;;X;PROVIDENCIA                   ;METROPOLITANA;0;0;0;0;0;0;0;0;0;Horno Microondas Mecanico M-2030 NG 20Lts;ELECTRODOMESTICOS
12837143;Casado;M;48;CHILENO;;X;RENCA                         ;METROPOLITANA;0;0;0;0;0;0;0;0;0;Horno Microondas Digital TH20DM 20Lts Espejado;ELECTRODOMESTICOS
18690634;;M;28;CHILENO;;Millenial;"";"";0;0;0;0;0;0;0;0;0;Batidora Manual 3532;ELECTRODOMESTICOS
16708070;;F;35;CHILENO;;Millenial;RENCA                         ;METROPOLITANA;0;0;0;0;0;0;0;0;0;Hervidor Electrico Tetera TH-6505RT 1,7Lts Rojo;ELECTRODOMESTICOS
6901897;;F;73;CHILENO;;Silencioso;RENCA                         ;METROPOLITANA;0;0;0;0;0;0;0;0;0;Aspiradora AP1700 Arrastre 1700Watts;ELECTRODOMESTICOS
13640074;;F;43;CHILENO;;X;N/D;N/D;0;0;0;0;0;0;0;0;0;Olla Multiuso 6801 5,7Lts;ELECTRODOMESTICOS
12673452;;F;53;CHILENO;;X;PUENTE ALTO                   ;METROPOLITANA;0;0;0;0;0;0;0;0;0;Batidora Vertical Stick Mixer 2609;ELECTRODOMESTICOS
9173802;;F;63;CHILENO;;Boomers;RENCA                         ;METROPOLITANA;0;0;0;0;0;0;0;0;0;Horno Electrico TH-48N 48Lts;ELECTRODOMESTICOS
9306401;;M;60;CHILENO;;Boomers;RENCA                         ;METROPOLITANA;0;0;0;0;0;0;0;0;0;Horno Electrico TH-100i 100Lts;ELECTRODOMESTICOS
15238758;;F;39;CHILENO;;X;NUEVA IMPERIAL                ;ARAUCANIA;0;0;0;0;0;0;0;0;0;Hervidor Electrico TH-4515N 2Lts Negro;ELECTRODOMESTICOS
14016979;;F;41;CHILENO;;Silencioso;PROVIDENCIA                   ;METROPOLITANA;0;0;0;0;0;0;0;0;0;Horno Microondas Mecanico Easy Wave 20Lts;ELECTRODOMESTICOS
7491578;;M;63;CHILENO;;Boomers;PROVIDENCIA                   ;METROPOLITANA;0;0;0;0;0;0;0;0;0;Procesador TH-9010 Multimixer 1,5Lts Vaso Vidrio;ELECTRODOMESTICOS
11990911;;F;50;CHILENO;;X;RENCA                         ;METROPOLITANA;0;0;0;0;0;0;0;0;0;Plancha UT-DUNST 2200Watts Base Ceramica;ELECTRODOMESTICOS
10715729;;F;55;CHILENO;;Boomers;QUILPUE                       ;VALPARAISO;0;0;0;0;0;0;0;0;0;Licuadora Roja 550W 1,5Lts Vaso Vidrio;ELECTRODOMESTICOS
23625449;;M;42;PERUANO;;Extranjero;CONCHALI                      ;METROPOLITANA;0;0;0;0;0;0;0;0;0;Hervidor Electrico TH-4515N 2Lts Negro;ELECTRODOMESTICOS
9424242;;M;59;CHILENO;;Boomers;LIMACHE                       ;VALPARAISO;0;0;0;0;0;0;0;0;0;Horno Microondas Digital TH-25DM 25Lts;ELECTRODOMESTICOS
9604351;;M;59;CHILENO;;Boomers;LA GRANJA                     ;METROPOLITANA;0;0;0;0;0;0;0;0;0;Horno Microondas Mecanico M-2030 NG 20Lts;ELECTRODOMESTICOS
17911144;;F;31;CHILENO;;Millenial;ALTO BIO BIO;BIO BIO;0;0;0;0;0;0;0;0;0;Aspiradora Handy Clean Black 1400;ELECTRODOMESTICOS
11420375;Soltero;F;53;CHILENO;;X;RENCA                         ;METROPOLITANA;0;0;0;0;0;0;0;0;0;Batidora Vertical Stick Mixer 2609;ELECTRODOMESTICOS
14212578;;M;41;CHILENO;;X;PROVIDENCIA                   ;METROPOLITANA;0;0;0;0;0;0;0;0;0;SUPER FREIDORA DE AIRE OV3;ELECTRODOMESTICOS
8803240;;F;61;CHILENO;;Boomers;SALAMANCA                     ;COQUIMBO;0;0;0;0;0;0;0;0;0;Horno Electrico TH-100i 100Lts;ELECTRODOMESTICOS
12818633;;F;47;CHILENO;;X;QUILLOTA                      ;VALPARAISO;0;0;0;0;0;0;0;0;0;Batidora Vertical Stick Mixer 2609;ELECTRODOMESTICOS
17149359;;F;33;CHILENO;;Millenial;N/D;N/D;0;0;0;0;0;0;0;0;0;Maquina de coser Singer 024;ELECTRODOMESTICOS
16480090;;F;35;CHILENO;;Millenial;VALLENAR;ATACAMA;0;0;0;0;0;0;0;0;0;ARROCERA ROJA 4723;ELECTRODOMESTICOS
15407403;;F;40;CHILENO;;X;PUENTE ALTO                   ;METROPOLITANA;0;0;0;0;0;0;0;0;0;Horno Microondas Mecanico UT-SYDNEY18 18Lts;ELECTRODOMESTICOS
5743824;;F;74;CHILENO;;Silencioso;PROVIDENCIA                   ;METROPOLITANA;0;0;0;0;0;0;0;0;0;Batidora Manual 3532;ELECTRODOMESTICOS
15487032;;F;46;CHILENO;;X;CALBUCO                       ;LOS LAGOS;0;0;0;0;0;0;0;0;0;Horno Electrico TH-38N 38Lts;ELECTRODOMESTICOS
8157308;;M;63;CHILENO;;Boomers;RENCA                         ;METROPOLITANA;0;0;0;0;0;0;0;0;0;Maquina de Coser ME9100;ELECTRODOMESTICOS
15610470;;F;39;CHILENO;;Silencioso;PROVIDENCIA                   ;METROPOLITANA;0;0;0;0;0;0;0;0;0;Batidora Manual BA-5010 Inox;ELECTRODOMESTICOS
7116464;;F;67;CHILENO;;Boomers;VILLARICA                     ;ARAUCANIA;0;0;0;0;0;0;0;0;0;Maquina de Coser 311;ELECTRODOMESTICOS
7924099;;F;66;CHILENO;;Boomers;PROVIDENCIA                   ;METROPOLITANA;0;0;0;0;0;0;0;0;0;Extractor de Jugo EX800 1,4Lts;ELECTRODOMESTICOS
10677876;;F;47;CHILENO;;X;VILLA ALEMANA                 ;VALPARAISO;0;0;0;0;0;0;0;0;0;Horno Electrico TH-48N 48Lts;ELECTRODOMESTICOS
10472719;;F;58;CHILENO;;Boomers;N/D;N/D;0;0;0;0;0;0;0;0;0;Aspiradora UT-KRAFT(DIG) Arrastre 2200Watts;ELECTRODOMESTICOS
5785286;;F;73;CHILENO;;Silencioso;CHIMBARONGO                   ;L.G.B.OÂ´HIGGINS;0;0;0;0;0;0;0;0;0;Horno Microondas Mecanico UT-SYDNEY18 18Lts;ELECTRODOMESTICOS
13171003;;M;44;CHILENO;;X;RENCA                         ;METROPOLITANA;0;0;0;0;0;0;0;0;0;Horno Electrico HE-300NG 30Lts;ELECTRODOMESTICOS
12544692;;F;47;CHILENO;;X;RENCA                         ;METROPOLITANA;0;0;0;0;0;0;0;0;0;Batidora Manual TH-8830;ELECTRODOMESTICOS
19966108;;M;23;CHILENO;;Z;CUREPTO                       ;MAULE;0;0;0;0;0;0;0;0;0;Horno Microondas Mecanico TH-18B05 18Lts;ELECTRODOMESTICOS
10759725;;F;56;CHILENO;;Boomers;PROVIDENCIA                   ;N/D;0;0;0;0;0;0;0;0;0;Licuadora Osterizer 4112/72 1,25Lts Vaso Vidrio;ELECTRODOMESTICOS
11246774;;F;54;CHILENO;;Silencioso;PROVIDENCIA                   ;METROPOLITANA;0;0;0;0;0;0;0;0;0;Hervidor Electrico UT-KLAR20PW 2Lts Blanco;ELECTRODOMESTICOS
10975383;;F;57;CHILENO;;Boomers;LAS CABRAS                    ;L.G.B.OÂ´HIGGINS;0;0;0;0;0;0;0;0;0;Horno Microondas Mecanico Fancy 20Lts;ELECTRODOMESTICOS
18877399;;F;27;CHILENO;;Millenial;PROVIDENCIA                   ;METROPOLITANA;0;0;0;0;0;0;0;0;0;Exprimidor de Jugo CJ-2000 1Lts;ELECTRODOMESTICOS
18781522;Soltero;M;28;CHILENO;CIRUJANO DENTISTA;Millenial;PROVIDENCIA                   ;METROPOLITANA;0;0;0;0;0;0;0;0;0;Hervidor Oster 4410sg Silver Gold;ELECTRODOMESTICOS
7175114;;F;74;CHILENO;;Silencioso;CALAMA                        ;ANTOFAGASTA;0;0;0;0;0;0;0;0;0;HERVIDOR ELECTRICO UT-STARK18;ELECTRODOMESTICOS
10058640;;F;56;CHILENO;;Boomers;LAMPA                         ;METROPOLITANA;0;0;0;0;0;0;0;0;0;Horno Microondas Mecanico C1700N 17Lts Blanco;ELECTRODOMESTICOS
15846745;;F;42;CHILENO;;X;COELEMU                       ;BIO BIO;0;0;0;0;0;0;0;0;0;Parrilla Electrica M18W;ELECTRODOMESTICOS
15045055;Soltero;F;38;CHILENO;;Millenial;PROVIDENCIA                   ;METROPOLITANA;0;0;0;0;0;0;0;0;0;Horno Microondas Digital TH20DM 20Lts Espejado;ELECTRODOMESTICOS
18391223;Soltero;M;29;CHILENO;;Silencioso;PROVIDENCIA                   ;METROPOLITANA;0;0;0;0;0;0;0;0;0;Horno Electrico UT-BACKOFEN26 26Lts;ELECTRODOMESTICOS
9251725;;M;60;CHILENO;;Boomers;RENCA                         ;METROPOLITANA;0;0;0;0;0;0;0;0;0;Aspiradora Trapeadora Robot Ut-Excellenza (B);ELECTRODOMESTICOS
15183626;;M;40;CHILENO;;X;N/D;N/D;0;0;0;0;0;0;0;0;0;Enceradora EA-5000;ELECTRODOMESTICOS
18698543;;F;28;CHILENO;;Millenial;CERRO NAVIA                   ;METROPOLITANA;0;0;0;0;0;0;0;0;0;Hervidor Electrico UT-MANLY17 1,7Lts Negro;ELECTRODOMESTICOS
5290776;;M;76;CHILENO;;Silencioso;RENCA                         ;METROPOLITANA;0;0;0;0;0;0;0;0;0;Hervidor Electrico UT-MANLY17 1,7Lts Negro;ELECTRODOMESTICOS
20619638;;M;21;CHILENO;;Z;PROVIDENCIA                   ;METROPOLITANA;0;0;0;0;0;0;0;0;0;Horno Electrico TH62I 60Lts;ELECTRODOMESTICOS
11644852;;M;52;CHILENO;;X;PUENTE ALTO                   ;METROPOLITANA;0;0;0;0;0;0;0;0;0;Cafetera TH-138i;ELECTRODOMESTICOS
16096581;Casado;F;37;CHILENO;INGENIERO COMERCIAL;Silencioso;PROVIDENCIA                   ;METROPOLITANA;0;0;0;0;0;0;0;0;0;Combo Hervidor + Tostador + Sandwichera;ELECTRODOMESTICOS
14426509;;M;42;CHILENO;;X;VINA DEL MAR                  ;VALPARAISO;0;0;0;0;0;0;0;0;0;Horno Electrico UT-BACKOFEN48 48Lts;ELECTRODOMESTICOS
9260327;;F;65;CHILENO;;Boomers;RENCA                         ;METROPOLITANA;0;0;0;0;0;0;0;0;0;Batidora Vertical Minipimer UT-KLOT400P;ELECTRODOMESTICOS
10465358;;F;54;CHILENO;;Boomers;PUENTE ALTO                   ;METROPOLITANA;0;0;0;0;0;0;0;0;0;Exprimidor de Jugo CJ-2000 1Lts;ELECTRODOMESTICOS
15600932;;F;38;CHILENO;;Silencioso;PROVIDENCIA                   ;METROPOLITANA;0;0;0;0;0;0;0;0;0;Horno Microondas Digital L UT-25KROMM 25Lts;ELECTRODOMESTICOS
13454298;Soltero;M;44;CHILENO;PSICOLOGO;Silencioso;PROVIDENCIA                   ;METROPOLITANA;0;0;0;0;0;0;0;0;0;FREIDORA DE AIRE THOMAS TH-AF60Mi;ELECTRODOMESTICOS
6501041;;M;68;CHILENO;;Silencioso;COPIAPO                       ;ATACAMA;0;0;0;0;0;0;0;0;0;Licuadora TH-320 Roja/Negro 1,5 Lts Vaso Vidrio;ELECTRODOMESTICOS
18920063;Soltero;F;27;CHILENO;;Z;PROVIDENCIA                   ;METROPOLITANA;0;0;0;0;0;0;0;0;0;Hervidor Electrico TH-4515N 2Lts Negro;ELECTRODOMESTICOS
6096644;;F;71;CHILENO;;Silencioso;QUILPUE                       ;VALPARAISO;0;0;0;0;0;0;0;0;0;Picadora TH-9020V Vaso Vidrio 2Lts;ELECTRODOMESTICOS
12062236;;F;56;CHILENO;;Boomers;COLINA                        ;METROPOLITANA;0;0;0;0;0;0;0;0;0;Horno Microondas Mecanico Easy Wave 20Lts;ELECTRODOMESTICOS
26985643;;F;28;VENEZOLANO;;Extranjero;ILLAPEL;COQUIMBO;0;0;0;0;0;0;0;0;0;Batidora Vertical Minipimer UT-KLOT800SS;ELECTRODOMESTICOS
17220596;;M;32;CHILENO;;Millenial;TEMUCO;ARAUCANIA;0;0;0;0;0;0;0;0;0;Freidora de Aire 18M Oster;ELECTRODOMESTICOS
12028175;;M;54;CHILENO;;Boomers;"";"";0;0;0;0;0;0;0;0;0;Horno Microondas Mecanico TH-18B05 18Lts;ELECTRODOMESTICOS
10699011;;M;57;CHILENO;;Boomers;SANTA JUANA                   ;BIO BIO;0;0;0;0;0;0;0;0;0;Batidora Vertical Minipimer UT-KLOT400P;ELECTRODOMESTICOS
8488868;;F;63;CHILENO;;Boomers;RENCA                         ;METROPOLITANA;0;0;0;0;0;0;0;0;0;ARROCERA ROJA 4723;ELECTRODOMESTICOS
15128262;Casado;F;39;CHILENO;;Silencioso;PROVIDENCIA                   ;METROPOLITANA;0;0;0;0;0;0;0;0;0;Hervidor Oster 4410sg Silver Gold;ELECTRODOMESTICOS
10493666;Casado;F;70;CHILENO;;Silencioso;RENCA                         ;METROPOLITANA;0;0;0;0;0;0;0;0;0;Batidora Manual BA-5010 Inox;ELECTRODOMESTICOS
18722270;;M;28;CHILENO;;Millenial;SAN FERNANDO                  ;L.G.B.OÂ´HIGGINS;0;0;0;0;0;0;0;0;0;Hervidor Electrico TH-4212N 1,7Lts Negro;ELECTRODOMESTICOS
13115367;;F;45;CHILENO;;Silencioso;PROVIDENCIA                   ;METROPOLITANA;0;0;0;0;0;0;0;0;0;Tostador de Pan TH-126 4 Rebanadas Negro;ELECTRODOMESTICOS
22420906;;M;66;PERUANO;;Extranjero;CONCHALI                      ;METROPOLITANA;0;0;0;0;0;0;0;0;0;LICUADORA CROMADA CON TECLAS PLUS;ELECTRODOMESTICOS
20071555;;F;23;CHILENO;;Z;PROVIDENCIA                   ;METROPOLITANA;0;0;0;0;0;0;0;0;0;Aspiradora AP1700 Arrastre 1700Watts;ELECTRODOMESTICOS
7662739;;M;66;CHILENO;;Boomers;CHILLAN                       ;BIO BIO;0;0;0;0;0;0;0;0;0;Aspiradora Tambor APA1000 1000Watts;ELECTRODOMESTICOS
8793732;;M;48;CHILENO;;X;RENCA                         ;METROPOLITANA;0;0;0;0;0;0;0;0;0;Tostador de Pan TP-1400 4 Rebanadas Inox;ELECTRODOMESTICOS
9882849;;M;56;CHILENO;;Boomers;RENCA                         ;METROPOLITANA;0;0;0;0;0;0;0;0;0;Horno Electrico TH-80i 80Lts;ELECTRODOMESTICOS
12493127;;M;49;CHILENO;;X;TALCAHUANO                    ;BIO BIO;0;0;0;0;0;0;0;0;0;Tostador de Pan TH-126 4 Rebanadas Negro;ELECTRODOMESTICOS
7032107;Soltero;F;64;CHILENO;;Boomers;PROVIDENCIA                   ;METROPOLITANA;0;0;0;0;0;0;0;0;0;Horno Electrico TH-48N 48Lts;ELECTRODOMESTICOS
7581933;;F;72;CHILENO;;Silencioso;COPIAPO                       ;ATACAMA;0;0;0;0;0;0;0;0;0;Batidora Vertical Minipimer UT-KLOT400P;ELECTRODOMESTICOS
27320062;;F;46;VENEZOLANO;;Extranjero;CONCEPCION                    ;BIO BIO;0;0;0;0;0;0;0;0;0;Maquina de Coser 3008 Janome Blanco;ELECTRODOMESTICOS
15196232;;M;40;CHILENO;;X;RENCA                         ;METROPOLITANA;0;0;0;0;0;0;0;0;0;BATIDORA MANUAL 260R;ELECTRODOMESTICOS
6396212;;F;77;CHILENO;;Silencioso;ARICA                         ;ARICA Y PARINACOTA;0;0;0;0;0;0;0;0;0;Aspiradora VCC4190V3E/XZS Arrastre 2000Watts;ELECTRODOMESTICOS
15159782;;F;40;CHILENO;;X;N/D;N/D;0;0;0;0;0;0;0;0;0;Batidora Vertical Minipimer UT-KLOT400P;ELECTRODOMESTICOS
20374890;;F;22;CHILENO;;Millenial;N/D;N/D;0;0;0;0;0;0;0;0;0;Maquina de Coser ME9100;ELECTRODOMESTICOS
16870042;;F;33;CHILENO;;Silencioso;PROVIDENCIA                   ;METROPOLITANA;0;0;0;0;0;0;0;0;0;Licuadora Osterizer 4112/72 1,25Lts Vaso Vidrio;ELECTRODOMESTICOS
11743504;;F;51;CHILENO;;X;MALLOA                        ;L.G.B.OÂ´HIGGINS;0;0;0;0;0;0;0;0;0;Aspiradora TH1415 Arrastre 1500Watts;ELECTRODOMESTICOS
17656257;Soltero;M;32;CHILENO;PROFESOR;Millenial;PROVIDENCIA                   ;METROPOLITANA;0;0;0;0;0;0;0;0;0;Licuadora TH-320 Roja/Negro 1,5 Lts Vaso Vidrio;ELECTRODOMESTICOS
9140493;;F;57;CHILENO;;Boomers;RENCA                         ;METROPOLITANA;0;0;0;0;0;0;0;0;0;Hervidor Electrico TH-4212N 1,7Lts Negro;ELECTRODOMESTICOS
12945786;;F;46;CHILENO;;X;ISLA DE MAIPO                 ;METROPOLITANA;0;0;0;0;0;0;0;0;0;Batidora Manual TH-8830;ELECTRODOMESTICOS
10510865;;F;55;CHILENO;;Boomers;CONSTITUCION                  ;MAULE;0;0;0;0;0;0;0;0;0;Hervidor Electrico UT-MANLY17 1,7Lts Negro;ELECTRODOMESTICOS
17584799;Soltero;F;31;CHILENO;;Millenial;TEMUCO                        ;ARAUCANIA;0;0;0;0;0;0;0;0;0;ASPIRADORA ROBOT VR05R5050WK/ZS;ELECTRODOMESTICOS
13280012;;M;44;CHILENO;;X;NUNOA                         ;METROPOLITANA;0;0;0;0;0;0;0;0;0;HERVIDOR TH-4340;ELECTRODOMESTICOS
19696899;;F;24;CHILENO;;Z;PROVIDENCIA                   ;METROPOLITANA;0;0;0;0;0;0;0;0;0;Aspiradora UT-KRAFT(DIG) Arrastre 2200Watts;ELECTRODOMESTICOS
18209405;;M;29;CHILENO;;Millenial;N/D;N/D;0;0;0;0;0;0;0;0;0;Horno Microondas Digital TH-25DM 25Lts;ELECTRODOMESTICOS
18198294;;F;29;CHILENO;;Millenial;TEMUCO                        ;ARAUCANIA;0;0;0;0;0;0;0;0;0;Aspiradora TH1870 Arrastre 1800Watts Gris;ELECTRODOMESTICOS
9385644;;F;59;CHILENO;;Boomers;"";"";0;0;0;0;0;0;0;0;0;MAQUINA DE COSER ME 3B FULL MERRITT;ELECTRODOMESTICOS
10194568;;M;57;CHILENO;;Boomers;RENCA                         ;METROPOLITANA;0;0;0;0;0;0;0;0;0;Tostador de Pan TP-1400 4 Rebanadas Inox;ELECTRODOMESTICOS
6188055;;M;73;CHILENO;;Silencioso;SAN JAVIER                    ;MAULE;0;0;0;0;0;0;0;0;0;Licuadora TH-320 Roja/Negro 1,5 Lts Vaso Vidrio;ELECTRODOMESTICOS
20168148;;F;22;CHILENO;;Z;PROVIDENCIA                   ;METROPOLITANA;0;0;0;0;0;0;0;0;0;Licuadora L2000VNG 1,5Lts Vaso Vidrio;ELECTRODOMESTICOS
16713972;;F;35;CHILENO;;Millenial;N/D;N/D;0;0;0;0;0;0;0;0;0;Hervidor Electrico UT-DUNKEL17P 2Lts Negro;ELECTRODOMESTICOS
9289361;;M;57;CHILENO;;Boomers;ANTOFAGASTA                   ;ANTOFAGASTA;0;0;0;0;0;0;0;0;0;Horno Microondas Digital TH-25DM 25Lts;ELECTRODOMESTICOS
18716799;Soltero;F;28;CHILENO;TECNICO DE NIVEL SUPERIOR EN ENFERMERIA E INSTRUMENTACION QUIRURGICA;Millenial;PAINE                         ;METROPOLITANA;0;0;0;0;0;0;0;0;0;Hervidor Electrico Tetera UT-LECKER18R 1,8Lts;ELECTRODOMESTICOS
9170574;;M;61;CHILENO;;Boomers;"";"";0;0;0;0;0;0;0;0;0;Horno Microondas Mecanico TH-18B05 18Lts;ELECTRODOMESTICOS
16932008;;M;34;CHILENO;;Millenial;PROVIDENCIA                   ;METROPOLITANA;0;0;0;0;0;0;0;0;0;Aspiradora Tambor APA1000 1000Watts;ELECTRODOMESTICOS
7003013;;F;75;CHILENO;;Silencioso;LEBU                          ;BIO BIO;0;0;0;0;0;0;0;0;0;Aspiradora VCC4190V3E/XZS Arrastre 2000Watts;ELECTRODOMESTICOS
16763156;;F;33;CHILENO;;Millenial;"";"";0;0;0;0;0;0;0;0;0;Aspiradora TH1407 Arrastre 1400Watts;ELECTRODOMESTICOS
17497727;;F;31;CHILENO;;Millenial;PROVIDENCIA                   ;METROPOLITANA;0;0;0;0;0;0;0;0;0;Aspiradora Tambor APA1000 1000Watts;ELECTRODOMESTICOS
27010701;;M;36;VENEZOLANO;;Extranjero;SAN MIGUEL                    ;METROPOLITANA;0;0;0;0;0;0;0;0;0;Horno Microondas Mecanico Easy Wave 20Lts;ELECTRODOMESTICOS
12782129;;M;47;CHILENO;;X;CHIMBARONGO                   ;L.G.B.OÂ´HIGGINS;0;0;0;0;0;0;0;0;0;HERVIDOR TETERA RELOJ 900R 2,5L ROJO;ELECTRODOMESTICOS
7191550;;M;67;CHILENO;;Boomers;PROVIDENCIA                   ;METROPOLITANA;0;0;0;0;0;0;0;0;0;Cafetera UT-KAFFEEKLASSIK;ELECTRODOMESTICOS
5875713;;M;74;CHILENO;;Silencioso;TEMUCO                        ;ARAUCANIA;0;0;0;0;0;0;0;0;0;ASPIRADORA THOMAS TH-1640;ELECTRODOMESTICOS
18113169;;F;30;CHILENO;;Millenial;PROVIDENCIA                   ;METROPOLITANA;0;0;0;0;0;0;0;0;0;Licuadora TH-320 Roja/Negro 1,5 Lts Vaso Vidrio;ELECTRODOMESTICOS
18012481;;F;29;CHILENO;;Millenial;PROVIDENCIA                   ;METROPOLITANA;0;0;0;0;0;0;0;0;0;HERVIDOR TH-4340;ELECTRODOMESTICOS
18519177;Soltero;F;28;CHILENO;FONOAUDIOLOGA;Silencioso;PROVIDENCIA                   ;METROPOLITANA;0;0;0;0;0;0;0;0;0;Batidora Vertical Minipimer UT-KLOT400P;ELECTRODOMESTICOS
14342493;;F;45;CHILENO;;X;SAN PEDRO                     ;METROPOLITANA;0;0;0;0;0;0;0;0;0;Hervidor Electrico TH-5407i 2Lts;ELECTRODOMESTICOS
18982257;;F;27;CHILENO;;Z;RENCA                         ;METROPOLITANA;0;0;0;0;0;0;0;0;0;Hervidor Electrico HA-2650NG;ELECTRODOMESTICOS
17183365;;F;33;CHILENO;;Millenial;PROVIDENCIA                   ;METROPOLITANA;0;0;0;0;0;0;0;0;0;Horno Microondas Digital TH20DM 20Lts Espejado;ELECTRODOMESTICOS
20199960;;F;23;CHILENO;;Millenial;"";"";0;0;0;0;0;0;0;0;0;Aspiradora Tambor APA1000 1000Watts;ELECTRODOMESTICOS
19039651;;F;37;CHILENO;;Millenial;RENCA                         ;METROPOLITANA;0;0;0;0;0;0;0;0;0;Batidora Vertical Stick Mixer 2609;ELECTRODOMESTICOS
18455768;;F;29;CHILENO;;Millenial;PROVIDENCIA                   ;METROPOLITANA;0;0;0;0;0;0;0;0;0;Parrilla Electrica TH-224;ELECTRODOMESTICOS
11056469;;F;56;CHILENO;;Boomers;ISLA DE MAIPO                 ;METROPOLITANA;0;0;0;0;0;0;0;0;0;Hervidor Electrico UT-MANLY17 1,7Lts Negro;ELECTRODOMESTICOS
8419032;Casado;F;63;CHILENO;;Boomers;RENCA                         ;METROPOLITANA;0;0;0;0;0;0;0;0;0;Hervidor Electrico TH-5407i 2Lts;ELECTRODOMESTICOS
7210950;;F;66;CHILENO;;Boomers;VILLARICA                     ;ARAUCANIA;0;0;0;0;0;0;0;0;0;LICUADORA MA-4210;ELECTRODOMESTICOS
5971250;Soltero;M;74;CHILENO;;Silencioso;RENCA                         ;METROPOLITANA;0;0;0;0;0;0;0;0;0;Hervidor Electrico UT-DUNKEL17P 2Lts Negro;ELECTRODOMESTICOS
7248634;;M;65;CHILENO;;Boomers;SAN FELIPE                    ;VALPARAISO;0;0;0;0;0;0;0;0;0;Horno Microondas Digital MS23K3513AK/ZS 23Lts;ELECTRODOMESTICOS
19302486;;M;25;CHILENO;;Z;OVALLE                        ;COQUIMBO;0;0;0;0;0;0;0;0;0;Licuadora TH-320 Roja/Negro 1,5 Lts Vaso Vidrio;ELECTRODOMESTICOS
11336923;Casado;F;54;CHILENO;;X;SAN BERNARDO                  ;METROPOLITANA;0;0;0;0;0;0;0;0;0;Batidora Manual UT-TEKLA300;ELECTRODOMESTICOS
16294975;;M;36;CHILENO;;Millenial;PROVIDENCIA                   ;METROPOLITANA;0;0;0;0;0;0;0;0;0;Hervidor Electrico UT-DUNKEL17P 2Lts Negro;ELECTRODOMESTICOS
13797232;;F;43;CHILENO;;X;SAN PEDRO DE LA PAZ           ;BIO BIO;0;0;0;0;0;0;0;0;0;Hervidor Electrico UT-REIN17SS;ELECTRODOMESTICOS
11660621;;F;51;CHILENO;;X;PROVIDENCIA                   ;METROPOLITANA;0;0;0;0;0;0;0;0;0;Licuadora Kaliman Negra con Teclas;ELECTRODOMESTICOS
17137372;;F;33;CHILENO;;Millenial;GRANEROS                      ;L.G.B.OÂ´HIGGINS;0;0;0;0;0;0;0;0;0;Batidora Pedestal TH910PN 4,6Lts 1300Watts;ELECTRODOMESTICOS
19896298;;M;24;CHILENO;;Silencioso;YERBAS BUENAS                 ;MAULE;0;0;0;0;0;0;0;0;0;Licuadora TH-501V 1,5Lts Vaso Vidrio;ELECTRODOMESTICOS
12694146;;M;47;CHILENO;;X;RANCAGUA                      ;L.G.B.OÂ´HIGGINS;0;0;0;0;0;0;0;0;0;Horno Microondas Digital L UT-25KROMM 25Lts;ELECTRODOMESTICOS
9650490;;M;60;CHILENO;;Boomers;COPIAPO                       ;ATACAMA;0;0;0;0;0;0;0;0;0;Horno Electrico TH62I 60Lts;ELECTRODOMESTICOS
15360273;;F;38;CHILENO;;X;MAIPU                         ;METROPOLITANA;0;0;0;0;0;0;0;0;0;Horno Electrico TH-25N01 25Lts;ELECTRODOMESTICOS
16275210;Soltero;M;36;CHILENO;;Millenial;PROVIDENCIA                   ;METROPOLITANA;0;0;0;0;0;0;0;0;0;Plancha UT-DUNST 2200Watts Base Ceramica;ELECTRODOMESTICOS
13030380;;F;46;CHILENO;;X;RENCA                         ;METROPOLITANA;0;0;0;0;0;0;0;0;0;Horno Electrico TH-38N 38Lts;ELECTRODOMESTICOS
15876490;;F;37;CHILENO;;Millenial;PROVIDENCIA                   ;METROPOLITANA;0;0;0;0;0;0;0;0;0;Horno Electrico TH62I 60Lts;ELECTRODOMESTICOS
7196335;;F;66;CHILENO;;Boomers;LA FLORIDA                    ;METROPOLITANA;0;0;0;0;0;0;0;0;0;HERVIDOR ELECTRICO UT-STARK18;ELECTRODOMESTICOS
17271833;Soltero;M;32;CHILENO;CIRUJANO DENTISTA;Millenial;PROVIDENCIA                   ;METROPOLITANA;0;0;0;0;0;0;0;0;0;Aspiradora Trapeadora Robot Ut-Excellenza (B);ELECTRODOMESTICOS
11721268;;F;50;CHILENO;;X;RENCA                         ;METROPOLITANA;0;0;0;0;0;0;0;0;0;COMBO ALFA MAQ COSER STYLE 20 + OV MOD 8708;ELECTRODOMESTICOS
18530491;Soltero;F;28;CHILENO;;Millenial;PROVIDENCIA                   ;METROPOLITANA;0;0;0;0;0;0;0;0;0;Parrilla Electrica TH-180;ELECTRODOMESTICOS
7649428;;M;67;CHILENO;;Boomers;LOS ANGELES                   ;BIO BIO;0;0;0;0;0;0;0;0;0;Horno Electrico TH62I 60Lts;ELECTRODOMESTICOS
20031970;;F;23;CHILENO;;Z;PROVIDENCIA                   ;METROPOLITANA;0;0;0;0;0;0;0;0;0;Licuadora L2000VNG 1,5Lts Vaso Vidrio;ELECTRODOMESTICOS
7850246;Casado;M;64;CHILENO;;Boomers;RENCA                         ;METROPOLITANA;0;0;0;0;0;0;0;0;0;Batidora Pedestal UT-KLEIN700;ELECTRODOMESTICOS
13059993;Casado;F;46;CHILENO;;X;PROVIDENCIA                   ;METROPOLITANA;0;0;0;0;0;0;0;0;0;Horno Microondas Digital MS23K3513AK/ZS 23Lts;ELECTRODOMESTICOS
5501460;Casado;F;73;CHILENO;;Silencioso;RENCA                         ;METROPOLITANA;0;0;0;0;0;0;0;0;0;Freidora de Aire 18M Oster;ELECTRODOMESTICOS
15585636;;F;39;CHILENO;;X;PENAFLOR                      ;METROPOLITANA;0;0;0;0;0;0;0;0;0;Hervidor Electrico UT-DUNKEL17P 2Lts Negro;ELECTRODOMESTICOS
15993726;;M;37;CHILENO;;Millenial;N/D;N/D;0;0;0;0;0;0;0;0;0;Hervidor Electrico HA-2650NG;ELECTRODOMESTICOS
13390881;;F;44;CHILENO;;X;NEGRETE                       ;BIO BIO;0;0;0;0;0;0;0;0;0;Plancha TH-7052 2000Watts Base Inox;ELECTRODOMESTICOS
11281481;Viudo;F;53;CHILENO;;X;CHEPICA                       ;L.G.B.OÂ´HIGGINS;0;0;0;0;0;0;0;0;0;Hervidor Electrico Tetera TH-6505RT 1,7Lts Rojo;ELECTRODOMESTICOS
15582465;Soltero;M;38;CHILENO;INGENIERIA EN ADMINISTRACION DE EMPRESAS MENCION MARKETING;Millenial;PROVIDENCIA                   ;METROPOLITANA;0;0;0;0;0;0;0;0;0;PLANCHA VERTICAL V-1600VBL;ELECTRODOMESTICOS
14532420;;F;41;CHILENO;;X;SAN PEDRO DE ATACAMA          ;ANTOFAGASTA;0;0;0;0;0;0;0;0;0;Horno Microondas Mecanico TH-18B05 18Lts;ELECTRODOMESTICOS
12137087;Soltero;M;53;CHILENO;;X;RENCA                         ;METROPOLITANA;0;0;0;0;0;0;0;0;0;MICROONDAS ME83X/XZS SAMSUNG MIRROR;ELECTRODOMESTICOS
10227045;;M;52;CHILENO;;X;N/D;N/D;0;0;0;0;0;0;0;0;0;Batidora Vertical Minipimer UT-KLOT400P;ELECTRODOMESTICOS
8637587;;F;58;CHILENO;;Boomers;IQUIQUE                       ;TARAPACA;0;0;0;0;0;0;0;0;0;Licuadora UT-METALLEK605P 1,55Lts;ELECTRODOMESTICOS
15569588;;F;39;CHILENO;;X;LINARES                       ;MAULE;0;0;0;0;0;0;0;0;0;Hervidor Electrico HA-3300 2,5Lts Blanco;ELECTRODOMESTICOS
19576427;;M;24;CHILENO;;Silencioso;PROVIDENCIA                   ;METROPOLITANA;0;0;0;0;0;0;0;0;0;Batidora Vertical Multimixer TH-8720;ELECTRODOMESTICOS
7454546;;M;66;CHILENO;;Boomers;PROVIDENCIA                   ;METROPOLITANA;0;0;0;0;0;0;0;0;0;Horno Electrico TH-25N01 25Lts;ELECTRODOMESTICOS
6575036;;M;69;CHILENO;;Silencioso;VILLARICA                     ;ARAUCANIA;0;0;0;0;0;0;0;0;0;Horno Microondas Digital ME0113MB1/XZS 32Lts;ELECTRODOMESTICOS
12185373;;F;50;CHILENO;;X;"";"";0;0;0;0;0;0;0;0;0;Horno Electrico TH-38N 38Lts;ELECTRODOMESTICOS
26409787;;M;35;EXTRANJERO - NO INFORMA NACIONALIDAD;;Extranjero;SANTIAGO;METROPOLITANA;0;0;0;0;0;0;0;0;0;Horno Microondas Mecanico TH-18B05 18Lts;ELECTRODOMESTICOS
17566566;;M;32;CHILENO;;Silencioso;N/D;N/D;0;0;0;0;0;0;0;0;0;Horno Microondas Digital L UT-25KROMM 25Lts;ELECTRODOMESTICOS
15413058;;M;40;CHILENO;;Silencioso;PROVIDENCIA                   ;METROPOLITANA;0;0;0;0;0;0;0;0;0;FREIDORA DE AIRE THOMAS TH-AF60Mi;ELECTRODOMESTICOS
15573400;Soltero;F;38;CHILENO;;Millenial;PROVIDENCIA                   ;METROPOLITANA;0;0;0;0;0;0;0;0;0;Batidora Pedestal Desmontable 64650-CL;ELECTRODOMESTICOS
16216621;Casado;M;36;CHILENO;TRABAJO SOCIAL;Silencioso;PROVIDENCIA                   ;METROPOLITANA;0;0;0;0;0;0;0;0;0;Aspiradora Mi Robot Vacuum-Mop P Black XIAOMI;ELECTRODOMESTICOS
17707593;;M;31;CHILENO;;Millenial;N/D;N/D;0;0;0;0;0;0;0;0;0;Aspiradora UT-MEINER1803 Arrastre 1800Watts;ELECTRODOMESTICOS
20048586;;M;23;CHILENO;;Silencioso;PROVIDENCIA                   ;METROPOLITANA;0;0;0;0;0;0;0;0;0;Horno Electrico UT-BACKOFEN26 26Lts;ELECTRODOMESTICOS
16534710;Soltero;F;35;CHILENO;MATRONA;Millenial;RENCA                         ;METROPOLITANA;0;0;0;0;0;0;0;0;0;Aspiradora TH1415 Arrastre 1500Watts;ELECTRODOMESTICOS
14676555;;F;51;PERUANO;;Extranjero;ESTACION CENTRAL              ;METROPOLITANA;0;0;0;0;0;0;0;0;0;Licuadora TH-501V 1,5Lts Vaso Vidrio;ELECTRODOMESTICOS
9018741;;M;61;CHILENO;;Boomers;QUILLECO                      ;BIO BIO;0;0;0;0;0;0;0;0;0;Licuadora Kaliman Negra con Teclas;ELECTRODOMESTICOS
15730696;Soltero;M;38;CHILENO;MATRON;X;PROVIDENCIA                   ;METROPOLITANA;0;0;0;0;0;0;0;0;0;Hervidor Electrico HA-3300 2,5Lts Blanco;ELECTRODOMESTICOS
18280821;;M;29;CHILENO;;Millenial;PICHILEMU                     ;L.G.B.OÂ´HIGGINS;0;0;0;0;0;0;0;0;0;Licuadora TH-501V 1,5Lts Vaso Vidrio;ELECTRODOMESTICOS
17152002;;F;33;CHILENO;;Millenial;PROVIDENCIA                   ;METROPOLITANA;0;0;0;0;0;0;0;0;0;Licuadora TH-501V 1,5Lts Vaso Vidrio;ELECTRODOMESTICOS
16013905;;M;37;CHILENO;;Silencioso;PROVIDENCIA                   ;METROPOLITANA;0;0;0;0;0;0;0;0;0;BATIDORA PEDESTAL THOMAS TH-910PB;ELECTRODOMESTICOS
13257181;;M;44;CHILENO;;X;PROVIDENCIA                   ;METROPOLITANA;0;0;0;0;0;0;0;0;0;Horno Electrico TH62I 60Lts;ELECTRODOMESTICOS
5566811;;M;74;CHILENO;;Millenial;"";"";0;0;0;0;0;0;0;0;0;Batidora Vertical Minipimer UT-KLOT400P;ELECTRODOMESTICOS
15603443;Soltero;M;38;CHILENO;AUXILIAR PARAMEDICO DE FARMACIA;X;PROVIDENCIA                   ;METROPOLITANA;0;0;0;0;0;0;0;0;0;Maquina Bordadora MC550E;ELECTRODOMESTICOS
17268496;Casado;F;32;CHILENO;;Silencioso;PROVIDENCIA                   ;METROPOLITANA;0;0;0;0;0;0;0;0;0;BATIDORA PEDESTAL THOMAS TH-910PB;ELECTRODOMESTICOS
18113356;;F;30;CHILENO;;Millenial;PROVIDENCIA                   ;METROPOLITANA;0;0;0;0;0;0;0;0;0;Aspiradora Trapeadora Robot Ut-Excellenza (B);ELECTRODOMESTICOS
16458682;;M;35;CHILENO;;Silencioso;PROVIDENCIA                   ;METROPOLITANA;0;0;0;0;0;0;0;0;0;Horno Microondas Digital UT-CLASSY720 20Lts;ELECTRODOMESTICOS
17576805;;F;32;CHILENO;;Millenial;QUINTA NORMAL                 ;METROPOLITANA;0;0;0;0;0;0;0;0;0;Horno Electrico TH-16N 16Lts;ELECTRODOMESTICOS
4317589;;M;84;CHILENO;;Silencioso;PROVIDENCIA                   ;METROPOLITANA;0;0;0;0;0;0;0;0;0;Licuadora UT-METALLEK605P 1,55Lts;ELECTRODOMESTICOS
18875270;;M;27;CHILENO;;Z;TEMUCO                        ;ARAUCANIA;0;0;0;0;0;0;0;0;0;Hervidor Electrico UT-MANLY17 1,7Lts Negro;ELECTRODOMESTICOS
15835792;;M;38;CHILENO;;Millenial;N/D;N/D;0;0;0;0;0;0;0;0;0;Horno Electrico TH62I 60Lts;ELECTRODOMESTICOS
17866702;;M;31;CHILENO;;Millenial;EMPEDRADO                     ;MAULE;0;0;0;0;0;0;0;0;0;HERVIDOR TH-4340;ELECTRODOMESTICOS
17782594;Soltero;F;31;CHILENO;;Silencioso;PROVIDENCIA                   ;METROPOLITANA;0;0;0;0;0;0;0;0;0;TERMOHERVIDOR 3,1L ELECTRON BA6932 INX;ELECTRODOMESTICOS
16862413;;F;34;CHILENO;;Millenial;PROVIDENCIA                   ;METROPOLITANA;0;0;0;0;0;0;0;0;0;Parrilla Electrica TH-224;ELECTRODOMESTICOS
10400964;;F;57;CHILENO;;Boomers;PROVIDENCIA                   ;METROPOLITANA;0;0;0;0;0;0;0;0;0;Horno Microondas Mecanico UT-SYDNEY18 18Lts;ELECTRODOMESTICOS
17378280;;F;34;CHILENO;;Millenial;PROVIDENCIA                   ;METROPOLITANA;0;0;0;0;0;0;0;0;0;Aspiradora UT-KRAFT(DIG) Arrastre 2200Watts;ELECTRODOMESTICOS
15867257;;F;37;CHILENO;;Millenial;MELIPILLA                     ;METROPOLITANA;0;0;0;0;0;0;0;0;0;Horno Electrico UT-BACKOFEN26 26Lts;ELECTRODOMESTICOS
8737922;;M;59;CHILENO;;Boomers;RENCA                         ;METROPOLITANA;0;0;0;0;0;0;0;0;0;Freidora FDV Airflow;ELECTRODOMESTICOS
14116233;;F;41;CHILENO;;X;SALAMANCA                     ;COQUIMBO;0;0;0;0;0;0;0;0;0;Hervidor Electrico TH-4515N 2Lts Negro;ELECTRODOMESTICOS
20042630;;F;23;CHILENO;;Z;N/D;N/D;0;0;0;0;0;0;0;0;0;Horno Electrico TH-100i 100Lts;ELECTRODOMESTICOS
14571166;;M;42;CHILENO;;X;VINA DEL MAR                  ;VALPARAISO;0;0;0;0;0;0;0;0;0;Horno Electrico UT-BACKOFEN60 60Lts;ELECTRODOMESTICOS
12235170;Casado;F;50;CHILENO;;X;RENCA                         ;METROPOLITANA;0;0;0;0;0;0;0;0;0;Batidora Pedestal Bowl 300 Inox;ELECTRODOMESTICOS
19484231;;M;25;CHILENO;;Z;N/D;N/D;0;0;0;0;0;0;0;0;0;Horno Microondas Digital TH-20S01 20Lts;ELECTRODOMESTICOS
15624115;;F;38;CHILENO;;Millenial;MELIPILLA                     ;METROPOLITANA;0;0;0;0;0;0;0;0;0;Aspiradora VCC4190V3E/XZS Arrastre 2000Watts;ELECTRODOMESTICOS
7725733;Casado;M;67;CHILENO;;Silencioso;PROVIDENCIA                   ;METROPOLITANA;0;0;0;0;0;0;0;0;0;Licuadora L1000 Inox 1,7LtsVaso Vidrio;ELECTRODOMESTICOS
14459282;;F;49;CHILENO;;X;PUENTE ALTO                   ;METROPOLITANA;0;0;0;0;0;0;0;0;0;Hervidor Electrico Tetera UT-LECKER18R 1,8Lts;ELECTRODOMESTICOS
8236577;;F;51;CHILENO;;X;PROVIDENCIA                   ;METROPOLITANA;0;0;0;0;0;0;0;0;0;Batidora Vertical Minipimer UT-KLOT400P;ELECTRODOMESTICOS
17439114;;F;32;CHILENO;;Silencioso;PROVIDENCIA                   ;METROPOLITANA;0;0;0;0;0;0;0;0;0;BATIDORA PEDESTAL THOMAS TH-910PB;ELECTRODOMESTICOS
19692869;;F;24;CHILENO;;Z;PROVIDENCIA                   ;METROPOLITANA;0;0;0;0;0;0;0;0;0;Freidora de Aire 18M Oster;ELECTRODOMESTICOS
13179933;;F;44;CHILENO;;X;RENCA                         ;METROPOLITANA;0;0;0;0;0;0;0;0;0;Batidora Manual BA-5010 Inox;ELECTRODOMESTICOS
17778757;;F;31;CHILENO;;Millenial;PROVIDENCIA                   ;METROPOLITANA;0;0;0;0;0;0;0;0;0;BATIDORA INMERSION S MIX 2616;ELECTRODOMESTICOS
9433340;;M;60;CHILENO;;Boomers;OSORNO                        ;LOS LAGOS;0;0;0;0;0;0;0;0;0;Aspiradora TH1870 Arrastre 1800Watts Gris;ELECTRODOMESTICOS
18428441;;F;29;CHILENO;;Millenial;PROVIDENCIA                   ;METROPOLITANA;0;0;0;0;0;0;0;0;0;Sandwichera TH-952 2 Panes Blanca;ELECTRODOMESTICOS
9441223;;F;54;CHILENO;;X;HUALPEN;BIO BIO;0;0;0;0;0;0;0;0;0;Licuadora TH-320 Roja/Negro 1,5 Lts Vaso Vidrio;ELECTRODOMESTICOS
13929909;;F;42;CHILENO;;Silencioso;PROVIDENCIA                   ;METROPOLITANA;0;0;0;0;0;0;0;0;0;Horno Electrico Steel Oven 50lts;ELECTRODOMESTICOS
10404926;;F;57;CHILENO;;Boomers;PROVIDENCIA                   ;METROPOLITANA;0;0;0;0;0;0;0;0;0;Horno Microondas Mecanico UT-SYDNEY18 18Lts;ELECTRODOMESTICOS
20233068;;M;23;CHILENO;;Z;PROVIDENCIA                   ;METROPOLITANA;0;0;0;0;0;0;0;0;0;ASPIRADORA POLVO Y AGUA APA-1150 IN;ELECTRODOMESTICOS
9889006;;F;54;CHILENO;;Boomers;RENCA                         ;METROPOLITANA;0;0;0;0;0;0;0;0;0;Aspiradora TH1415 Arrastre 1500Watts;ELECTRODOMESTICOS
6234804;;F;73;CHILENO;;Silencioso;SAN JAVIER                    ;MAULE;0;0;0;0;0;0;0;0;0;Cafetera TH-130;ELECTRODOMESTICOS
15567479;;M;36;CHILENO;;Millenial;CURICO                        ;MAULE;0;0;0;0;0;0;0;0;0;H MICROONDA ONDE 31G;ELECTRODOMESTICOS
18538766;;F;29;CHILENO;;Millenial;PROVIDENCIA                   ;METROPOLITANA;0;0;0;0;0;0;0;0;0;Horno Microondas Digital TH-20S01 20Lts;ELECTRODOMESTICOS
17813126;;M;31;CHILENO;;Millenial;LA HIGUERA                    ;COQUIMBO;0;0;0;0;0;0;0;0;0;Aspiradora Trapeadora Robot Ut-Excellenza (B);ELECTRODOMESTICOS
14546901;;F;46;CHILENO;;X;ISLA DE MAIPO                 ;METROPOLITANA;0;0;0;0;0;0;0;0;0;Batidora Manual TH-8830;ELECTRODOMESTICOS
11569486;;M;51;CHILENO;;X;CHILLAN                       ;BIO BIO;0;0;0;0;0;0;0;0;0;Licuadora UT-METALLEK605P 1,55Lts;ELECTRODOMESTICOS
17153417;;M;33;CHILENO;;Millenial;N/D;N/D;0;0;0;0;0;0;0;0;0;Aspiradora TH1415 Arrastre 1500Watts;ELECTRODOMESTICOS
9833444;;M;58;CHILENO;;Boomers;RENCA                         ;METROPOLITANA;0;0;0;0;0;0;0;0;0;Horno Electrico TH-48N 48Lts;ELECTRODOMESTICOS
8594389;Soltero;F;62;CHILENO;;Boomers;RENCA                         ;METROPOLITANA;0;0;0;0;0;0;0;0;0;Combo Juguera + Hervidor;ELECTRODOMESTICOS
9365406;;F;58;CHILENO;;Boomers;PAINE                         ;METROPOLITANA;0;0;0;0;0;0;0;0;0;Aspiradora TH1870 Arrastre 1800Watts Gris;ELECTRODOMESTICOS
9118800;;M;56;CHILENO;;Boomers;PROVIDENCIA                   ;METROPOLITANA;0;0;0;0;0;0;0;0;0;Horno Electrico Steel Oven 50lts;ELECTRODOMESTICOS
13447475;Soltero;F;43;CHILENO;;X;PROVIDENCIA                   ;METROPOLITANA;0;0;0;0;0;0;0;0;0;Horno Electrico UT-LEIF36 36Lts;ELECTRODOMESTICOS
11122629;;F;56;CHILENO;;Boomers;RENCA                         ;METROPOLITANA;0;0;0;0;0;0;0;0;0;Hervidor Electrico UT-DUNKEL17P 2Lts Negro;ELECTRODOMESTICOS
19685019;;M;25;CHILENO;;Z;LA SERENA                     ;COQUIMBO;0;0;0;0;0;0;0;0;0;Horno Microondas Mecanico M-2030 NG 20Lts;ELECTRODOMESTICOS
10887676;;F;53;CHILENO;;X;RENCA                         ;METROPOLITANA;0;0;0;0;0;0;0;0;0;Parrilla Electrica TH-224;ELECTRODOMESTICOS
18450094;;M;36;CHILENO;;Millenial;LA SERENA                     ;COQUIMBO;0;0;0;0;0;0;0;0;0;Plancha OSTER 4801T 1200Watts Base Ceramica;ELECTRODOMESTICOS
8307351;Casado;M;62;CHILENO;;Boomers;RENCA                         ;METROPOLITANA;0;0;0;0;0;0;0;0;0;Hervidor Electrico TH-6200 R 1,7Lts Rojo;ELECTRODOMESTICOS
13084589;Soltero;M;45;CHILENO;;X;PROVIDENCIA                   ;METROPOLITANA;0;0;0;0;0;0;0;0;0;Plancha UT-KERAMIKTOP 2200Watts Base Ceramica;ELECTRODOMESTICOS
5777183;;F;76;CHILENO;;Silencioso;CONCEPCION                    ;BIO BIO;0;0;0;0;0;0;0;0;0;Exprimidor de Jugo CJ-2000 1Lts;ELECTRODOMESTICOS
25830061;;F;46;HAITIANO;;Extranjero;CERRO NAVIA                   ;METROPOLITANA;0;0;0;0;0;0;0;0;0;PLANCHA A VAPOR 6953 BASE AEROCERAMICA AUTAPA.22;ELECTRODOMESTICOS
23642876;;M;35;PERUANO;;Extranjero;ARICA                         ;ARICA Y PARINACOTA;0;0;0;0;0;0;0;0;0;Licuadora Roja 550W 1,5Lts Vaso Vidrio;ELECTRODOMESTICOS
9029367;Casado;F;61;CHILENO;;Boomers;RENCA                         ;METROPOLITANA;0;0;0;0;0;0;0;0;0;Procesador TH-9010 Multimixer 1,5Lts Vaso Vidrio;ELECTRODOMESTICOS
26402567;;M;26;HAITIANO;;Extranjero;ANGOL                         ;ARAUCANIA;0;0;0;0;0;0;0;0;0;Licuadora TH-501V 1,5Lts Vaso Vidrio;ELECTRODOMESTICOS
19582168;;F;25;CHILENO;;Z;N/D;N/D;0;0;0;0;0;0;0;0;0;Batidora Pedestal Desmontable 64650-CL;ELECTRODOMESTICOS
6834641;;F;73;CHILENO;;Silencioso;LOS LAGOS                     ;LOS RIOS;0;0;0;0;0;0;0;0;0;Licuadora Kaliman Negra con Teclas;ELECTRODOMESTICOS
16931875;;F;34;CHILENO;;Millenial;"";"";0;0;0;0;0;0;0;0;0;HERVIDOR ELECTRICO UT-STARK18;ELECTRODOMESTICOS
18224735;;M;29;CHILENO;;Millenial;LA LIGUA                      ;VALPARAISO;0;0;0;0;0;0;0;0;0;Horno Electrico TH-100i 100Lts;ELECTRODOMESTICOS
10968117;Casado;M;52;CHILENO;;X;RENCA                         ;METROPOLITANA;0;0;0;0;0;0;0;0;0;Aspiradora VCC4190V3E/XZS Arrastre 2000Watts;ELECTRODOMESTICOS
13235959;Casado;F;45;CHILENO;CARTOGRAFO;X;PROVIDENCIA                   ;METROPOLITANA;0;0;0;0;0;0;0;0;0;Horno Electrico TH-48N 48Lts;ELECTRODOMESTICOS
13377007;;M;44;CHILENO;;X;CHILLAN                       ;BIO BIO;0;0;0;0;0;0;0;0;0;Horno Electrico UT-BACKOFEN60 60Lts;ELECTRODOMESTICOS
17475900;;M;32;CHILENO;;Silencioso;PROVIDENCIA                   ;METROPOLITANA;0;0;0;0;0;0;0;0;0;Hervidor Electrico 3100 1,7Lts Negro;ELECTRODOMESTICOS
10156366;;M;57;CHILENO;;Boomers;TOCOPILLA                     ;ANTOFAGASTA;0;0;0;0;0;0;0;0;0;Hervidor Electrico HA-3300 2,5Lts Blanco;ELECTRODOMESTICOS
18245461;;F;30;CHILENO;;Millenial;PROVIDENCIA                   ;METROPOLITANA;0;0;0;0;0;0;0;0;0;Batidora Vertical Minipimer UT-KLOT400P;ELECTRODOMESTICOS
17432434;;M;32;CHILENO;;Millenial;PROVIDENCIA                   ;METROPOLITANA;0;0;0;0;0;0;0;0;0;Batidora Vertical Minipimer UT-KLOT400P;ELECTRODOMESTICOS
18163806;;F;30;CHILENO;;Millenial;CALBUCO                       ;LOS LAGOS;0;0;0;0;0;0;0;0;0;HERVIDOR TH-4340;ELECTRODOMESTICOS
12986187;;F;46;CHILENO;;X;SAN BERNARDO                  ;METROPOLITANA;0;0;0;0;0;0;0;0;0;Horno Electrico TH-16N 16Lts;ELECTRODOMESTICOS
10064004;;M;56;CHILENO;;Boomers;PROVIDENCIA                   ;METROPOLITANA;0;0;0;0;0;0;0;0;0;Extractor de Jugo EX800 1,4Lts;ELECTRODOMESTICOS
15154860;;M;38;CHILENO;;X;PROVIDENCIA                   ;METROPOLITANA;0;0;0;0;0;0;0;0;0;Horno Electrico TH-48N 48Lts;ELECTRODOMESTICOS
9021828;;F;60;CHILENO;;Boomers;COIHAIQUE                     ;AYSEN;0;0;0;0;0;0;0;0;0;Batidora Vertical Stick Mixer 2609;ELECTRODOMESTICOS
11072082;;F;56;CHILENO;;Boomers;PROVIDENCIA                   ;METROPOLITANA;0;0;0;0;0;0;0;0;0;Batidora Pedestal TH910PN 4,6Lts 1300Watts;ELECTRODOMESTICOS
5979351;;M;72;CHILENO;;Silencioso;RENCA                         ;METROPOLITANA;0;0;0;0;0;0;0;0;0;Horno Microondas Digital TH-25DM 25Lts;ELECTRODOMESTICOS
10316115;;F;52;CHILENO;;X;RENCA                         ;METROPOLITANA;0;0;0;0;0;0;0;0;0;Aspiradora AP1700 Arrastre 1700Watts;ELECTRODOMESTICOS
9579275;;F;59;CHILENO;;Boomers;PROVIDENCIA                   ;METROPOLITANA;0;0;0;0;0;0;0;0;0;Batidora Vertical Minipimer UT-KLOT400P;ELECTRODOMESTICOS
8193048;Soltero;F;62;CHILENO;;Silencioso;PROVIDENCIA                   ;METROPOLITANA;0;0;0;0;0;0;0;0;0;Licuadora TH-501V 1,5Lts Vaso Vidrio;ELECTRODOMESTICOS
12311645;Casado;M;50;CHILENO;;Silencioso;PROVIDENCIA                   ;METROPOLITANA;0;0;0;0;0;0;0;0;0;Cafetera TH-138i;ELECTRODOMESTICOS
10633647;;F;55;CHILENO;;Boomers;COIHUECO                      ;BIO BIO;0;0;0;0;0;0;0;0;0;Horno Electrico UT-BACKOFEN60 60Lts;ELECTRODOMESTICOS
15139380;;F;39;CHILENO;;X;"";"";0;0;0;0;0;0;0;0;0;Batidora Pedestal TH910PN 4,6Lts 1300Watts;ELECTRODOMESTICOS
9136632;;F;60;CHILENO;;Boomers;RENCA                         ;METROPOLITANA;0;0;0;0;0;0;0;0;0;Batidora Manual TH-8830;ELECTRODOMESTICOS
11630301;;M;51;CHILENO;;X;QUILLOTA                      ;VALPARAISO;0;0;0;0;0;0;0;0;0;COMBO ALFA MAQ COSER STYLE 20 + OV MOD 8708;ELECTRODOMESTICOS
4874437;;M;80;CHILENO;;Silencioso;CURICO                        ;MAULE;0;0;0;0;0;0;0;0;0;Hervidor Electrico HA-3300 2,5Lts Blanco;ELECTRODOMESTICOS
13617968;;F;47;CHILENO;;X;N/D;N/D;0;0;0;0;0;0;0;0;0;FREIDORA DE AIRE CKSTAF15B 1850W;ELECTRODOMESTICOS
5748383;;M;73;CHILENO;;Silencioso;LAS CABRAS                    ;L.G.B.OÂ´HIGGINS;0;0;0;0;0;0;0;0;0;Licuadora Berry Blender Roja 1400 Vaso Vidrio;ELECTRODOMESTICOS
20267148;;F;23;CHILENO;;Z;PROVIDENCIA                   ;METROPOLITANA;0;0;0;0;0;0;0;0;0;Batidora Vertical Minipimer UT-KLOT400P;ELECTRODOMESTICOS
16914723;;M;33;CHILENO;;X;PROVIDENCIA                   ;METROPOLITANA;0;0;0;0;0;0;0;0;0;Licuadora Personal TH-300PB;ELECTRODOMESTICOS
14196276;Casado;M;41;CHILENO;PROFESOR;X;PROVIDENCIA                   ;METROPOLITANA;0;0;0;0;0;0;0;0;0;Freidora de Aire 18M Oster;ELECTRODOMESTICOS
23995720;;F;39;PERUANO;;Extranjero;QUINTA NORMAL                 ;METROPOLITANA;0;0;0;0;0;0;0;0;0;Batidora Manual BA-5010 Inox;ELECTRODOMESTICOS
19486071;;M;25;CHILENO;;Millenial;N/D;N/D;0;0;0;0;0;0;0;0;0;Enceradora EA-5000;ELECTRODOMESTICOS
25392228;;F;39;HAITIANO;;Extranjero;SAN BERNARDO                  ;METROPOLITANA;0;0;0;0;0;0;0;0;0;Horno Microondas Digital TH-25DM 25Lts;ELECTRODOMESTICOS
17217939;Soltero;F;33;CHILENO;TECNICO DE NIVEL SUPERIOR EN ENFERMERIA;Millenial;COELEMU;BIO-BIO;0;0;0;0;0;0;0;0;0;Licuadora L2000VNG 1,5Lts Vaso Vidrio;ELECTRODOMESTICOS
19523831;Soltero;M;25;CHILENO;NUTRICIONISTA;Silencioso;PROVIDENCIA                   ;METROPOLITANA;0;0;0;0;0;0;0;0;0;Picadora TH-9020V Vaso Vidrio 2Lts;ELECTRODOMESTICOS
13159294;;M;45;CHILENO;;X;PANGUIPULLI                   ;LOS LAGOS;0;0;0;0;0;0;0;0;0;Horno Microondas Digital UT-CLASSY720 20Lts;ELECTRODOMESTICOS
5521273;;M;75;CHILENO;;Silencioso;PROVIDENCIA                   ;METROPOLITANA;0;0;0;0;0;0;0;0;0;BATIDORA INMERSION S MIX 2616;ELECTRODOMESTICOS
13507375;Soltero;M;44;CHILENO;ABOGADO;X;PROVIDENCIA                   ;METROPOLITANA;0;0;0;0;0;0;0;0;0;CAFETERA CF-4600 NG;ELECTRODOMESTICOS
17994845;;F;30;CHILENO;;Silencioso;PROVIDENCIA                   ;METROPOLITANA;0;0;0;0;0;0;0;0;0;Horno Electrico TH-16N 16Lts;ELECTRODOMESTICOS
18753136;Soltero;F;27;CHILENO;MEDICO CIRUJANO;Silencioso;PROVIDENCIA                   ;METROPOLITANA;0;0;0;0;0;0;0;0;0;Aspiradora VCC4190V3E/XZS Arrastre 2000Watts;ELECTRODOMESTICOS
13290477;Soltero;F;48;CHILENO;;X;SAN NICOLAS                   ;BIO BIO;0;0;0;0;0;0;0;0;0;Batidora Manual TH-8830;ELECTRODOMESTICOS
12337505;;M;49;CHILENO;;Millenial;VALDIVIA                      ;LOS RIOS;0;0;0;0;0;0;0;0;0;Horno Microondas Digital L UT-25KROMM 25Lts;ELECTRODOMESTICOS
12687082;;M;48;CHILENO;;X;PROVIDENCIA                   ;METROPOLITANA;0;0;0;0;0;0;0;0;0;Batidora de Pedestal FDV Venus Grey;ELECTRODOMESTICOS
13583955;Casado;F;42;CHILENO;;Silencioso;PROVIDENCIA                   ;METROPOLITANA;0;0;0;0;0;0;0;0;0;Horno Electrico UT-BACKOFEN60 60Lts;ELECTRODOMESTICOS
1883108;;M;91;CHILENO;;Silencioso;PROVIDENCIA                   ;METROPOLITANA;0;0;0;0;0;0;0;0;0;Aspiradora UT-KRAFT(DIG) Arrastre 2200Watts;ELECTRODOMESTICOS
9839045;;F;58;CHILENO;;Boomers;PROVIDENCIA                   ;METROPOLITANA;0;0;0;0;0;0;0;0;0;Licuadora L-1630V Negra 1,5Lts Vaso Vidrio;ELECTRODOMESTICOS
17202574;;F;33;CHILENO;;Millenial;N/D;N/D;0;0;0;0;0;0;0;0;0;Horno Electrico TH-16N 16Lts;ELECTRODOMESTICOS
16857049;;M;33;CHILENO;;Millenial;PROVIDENCIA                   ;METROPOLITANA;0;0;0;0;0;0;0;0;0;Horno Microondas Mecanico Easy Wave 20Lts;ELECTRODOMESTICOS
16550248;;F;35;CHILENO;;Millenial;N/D;N/D;0;0;0;0;0;0;0;0;0;Batidora Pedestal TH910PN 4,6Lts 1300Watts;ELECTRODOMESTICOS
5623205;;F;74;CHILENO;;Silencioso;PROVIDENCIA                   ;METROPOLITANA;0;0;0;0;0;0;0;0;0;Plancha THOMAS TH-7170 2200Watts Base Ceramica;ELECTRODOMESTICOS
14329121;;F;45;CHILENO;;Silencioso;PROVIDENCIA                   ;METROPOLITANA;0;0;0;0;0;0;0;0;0;Horno Microondas Digital TH20DM 20Lts Espejado;ELECTRODOMESTICOS
14305314;Casado;M;47;CHILENO;CONTADOR AUDITOR;X;RENCA                         ;METROPOLITANA;0;0;0;0;0;0;0;0;0;Plancha UT-SHANGRILA Inalambrica 2200Watss;ELECTRODOMESTICOS
13865535;;M;42;CHILENO;;X;N/D;N/D;0;0;0;0;0;0;0;0;0;Licuadora L-25000NG;ELECTRODOMESTICOS
17072421;Soltero;F;33;CHILENO;;Millenial;PROVIDENCIA                   ;METROPOLITANA;0;0;0;0;0;0;0;0;0;Aspiradora UT-SILENT1804 Arrastre 1800Watts;ELECTRODOMESTICOS
8173027;Soltero;F;67;CHILENO;;Boomers;RENCA                         ;METROPOLITANA;0;0;0;0;0;0;0;0;0;Horno Electrico UT-BACKOFEN26 26Lts;ELECTRODOMESTICOS
14406499;Casado;F;46;CHILENO;;Silencioso;PROVIDENCIA                   ;METROPOLITANA;0;0;0;0;0;0;0;0;0;MICROONDAS ME83X/XZS SAMSUNG MIRROR;ELECTRODOMESTICOS
14018126;;F;41;CHILENO;;X;N/D;N/D;0;0;0;0;0;0;0;0;0;Hervidor Termo BA-6928 Inox 2,8Lts;ELECTRODOMESTICOS
7807652;;F;60;CHILENO;;Boomers;RENCA                         ;METROPOLITANA;0;0;0;0;0;0;0;0;0;Hervidor Electrico HE420 2lts Negro;ELECTRODOMESTICOS
18723800;;F;29;CHILENO;;Silencioso;PROVIDENCIA                   ;METROPOLITANA;0;0;0;0;0;0;0;0;0;Horno Electrico TH-25N01 25Lts;ELECTRODOMESTICOS
13760682;;M;43;CHILENO;;X;PROVIDENCIA                   ;METROPOLITANA;0;0;0;0;0;0;0;0;0;Horno Microondas Mecanico TH-18B05 18Lts;ELECTRODOMESTICOS
17454854;;F;32;CHILENO;;Millenial;LEBU                          ;BIO BIO;0;0;0;0;0;0;0;0;0;Batidora Manual 2532;ELECTRODOMESTICOS
6520502;Casado;F;73;CHILENO;;Silencioso;PROVIDENCIA                   ;METROPOLITANA;0;0;0;0;0;0;0;0;0;Hervidor Termo TH-5440TK 1,5Lts Inox;ELECTRODOMESTICOS
14358417;Casado;F;42;CHILENO;;X;RENCA                         ;METROPOLITANA;0;0;0;0;0;0;0;0;0;Horno Electrico TH-25N01 25Lts;ELECTRODOMESTICOS
13695785;;M;42;CHILENO;;X;PROVIDENCIA                   ;METROPOLITANA;0;0;0;0;0;0;0;0;0;Horno Microondas Mecanico UT-SYDNEY18 18Lts;ELECTRODOMESTICOS
15710876;Soltero;M;38;CHILENO;PSICOLOGO;X;RENCA                         ;METROPOLITANA;0;0;0;0;0;0;0;0;0;Horno Electrico UT-BACKOFEN26 26Lts;ELECTRODOMESTICOS
18227876;Soltero;F;29;CHILENO;TECNICO DE NIVEL SUPERIOR EN ODONTOLOGIA;Silencioso;PROVIDENCIA                   ;METROPOLITANA;0;0;0;0;0;0;0;0;0;Horno Electrico TH-25N01 25Lts;ELECTRODOMESTICOS
10184447;Soltero;M;41;CHILENO;;X;PROVIDENCIA                   ;METROPOLITANA;0;0;0;0;0;0;0;0;0;Batidora Manual BA-5010 Inox;ELECTRODOMESTICOS
13407232;;F;45;CHILENO;;Silencioso;PROVIDENCIA                   ;METROPOLITANA;0;0;0;0;0;0;0;0;0;Batidora Manual 2532;ELECTRODOMESTICOS
9750047;;M;57;CHILENO;;Boomers;VALPARAISO                    ;VALPARAISO;0;0;0;0;0;0;0;0;0;Maquina para Hacer Pan MPP-600 BL;ELECTRODOMESTICOS
4304839;;M;82;CHILENO;;Silencioso;PROVIDENCIA                   ;METROPOLITANA;0;0;0;0;0;0;0;0;0;Plancha OSTER 4801T 1200Watts Base Ceramica;ELECTRODOMESTICOS
12931286;;F;46;CHILENO;;Silencioso;PROVIDENCIA                   ;METROPOLITANA;0;0;0;0;0;0;0;0;0;Maquina de Coser JS-2135CL Calipso;ELECTRODOMESTICOS
25656920;;M;34;VENEZOLANO;;Extranjero;RENCA                         ;METROPOLITANA;0;0;0;0;0;0;0;0;0;Licuadora Roja 550W 1,5Lts Vaso Vidrio;ELECTRODOMESTICOS
19942672;;M;24;CHILENO;;Z;N/D;N/D;0;0;0;0;0;0;0;0;0;Horno Electrico TH62I 60Lts;ELECTRODOMESTICOS
16797798;;F;34;CHILENO;;Millenial;SANTIAGO                      ;METROPOLITANA;0;0;0;0;0;0;0;0;0;Horno Electrico UT-BACKOFEN26 26Lts;ELECTRODOMESTICOS
18080432;;F;30;CHILENO;;Silencioso;PROVIDENCIA                   ;METROPOLITANA;0;0;0;0;0;0;0;0;0;Aspiradora UT-MEINER1803 Arrastre 1800Watts;ELECTRODOMESTICOS
6627868;;F;68;CHILENO;;Silencioso;PROVIDENCIA                   ;METROPOLITANA;0;0;0;0;0;0;0;0;0;Horno Electrico UT-LEIF36 36Lts;ELECTRODOMESTICOS
8611598;;F;59;CHILENO;;Boomers;PROVIDENCIA                   ;METROPOLITANA;0;0;0;0;0;0;0;0;0;Plancha UT-KERAMIK1 2200Watts Base Ceramica;ELECTRODOMESTICOS
14164152;;F;40;CHILENO;;X;ESTACION CENTRAL              ;METROPOLITANA;0;0;0;0;0;0;0;0;0;Horno Microondas Digital MS28F303TAS/ZS 28Lts;ELECTRODOMESTICOS
19515464;Soltero;M;25;CHILENO;;Silencioso;PROVIDENCIA                   ;METROPOLITANA;0;0;0;0;0;0;0;0;0;Batidora de Pedestal FDV Venus Red;ELECTRODOMESTICOS
6785218;;F;69;CHILENO;;Silencioso;IQUIQUE                       ;TARAPACA;0;0;0;0;0;0;0;0;0;Hervidor Electrico HA-3300 2,5Lts Blanco;ELECTRODOMESTICOS
18998716;;M;26;CHILENO;;Z;PROVIDENCIA                   ;METROPOLITANA;0;0;0;0;0;0;0;0;0;Licuadora L2000VNG 1,5Lts Vaso Vidrio;ELECTRODOMESTICOS
16146804;;M;36;CHILENO;;Millenial;PROVIDENCIA                   ;METROPOLITANA;0;0;0;0;0;0;0;0;0;ASPIRADORA POLVO Y AGUA APA-1150 IN;ELECTRODOMESTICOS
10928351;;M;54;CHILENO;;Boomers;RENCA                         ;METROPOLITANA;0;0;0;0;0;0;0;0;0;Horno Electrico TH62I 60Lts;ELECTRODOMESTICOS
17547344;Soltero;F;30;CHILENO;;Millenial;PROVIDENCIA                   ;METROPOLITANA;0;0;0;0;0;0;0;0;0;Plancha Vertical TH-7300 1200Watts;ELECTRODOMESTICOS
12946111;;M;47;CHILENO;;X;ILLAPEL                       ;COQUIMBO;0;0;0;0;0;0;0;0;0;Horno Microondas Digital TH20DM 20Lts Espejado;ELECTRODOMESTICOS
10213415;;F;59;CHILENO;;Boomers;LLAILLAY                      ;VALPARAISO;0;0;0;0;0;0;0;0;0;Enceradora EA-5000;ELECTRODOMESTICOS
15803617;;M;37;CHILENO;;Millenial;SANTA CRUZ                    ;L.G.B.OÂ´HIGGINS;0;0;0;0;0;0;0;0;0;Horno Electrico TH-38N 38Lts;ELECTRODOMESTICOS
15573177;;F;38;CHILENO;;X;PROVIDENCIA                   ;METROPOLITANA;0;0;0;0;0;0;0;0;0;BATIDORA PEDESTAL THOMAS TH-910PB;ELECTRODOMESTICOS
18103466;;M;29;CHILENO;;Millenial;AISEN                         ;AYSEN;0;0;0;0;0;0;0;0;0;Licuadora TH-320 Roja/Negro 1,5 Lts Vaso Vidrio;ELECTRODOMESTICOS
18581430;;F;29;CHILENO;;Millenial;NUEVA IMPERIAL                ;ARAUCANIA;0;0;0;0;0;0;0;0;0;Hervidor Electrico HE420 2lts Negro;ELECTRODOMESTICOS
4946668;;F;76;CHILENO;;Silencioso;PROVIDENCIA                   ;METROPOLITANA;0;0;0;0;0;0;0;0;0;Horno Electrico UT-BACKOFEN26 26Lts;ELECTRODOMESTICOS
15954149;;F;37;CHILENO;;Silencioso;PROVIDENCIA                   ;METROPOLITANA;0;0;0;0;0;0;0;0;0;HORNO 10 LITROS OSTER ROJO;ELECTRODOMESTICOS
15013237;;M;35;CHILENO;;Millenial;PROVIDENCIA                   ;METROPOLITANA;0;0;0;0;0;0;0;0;0;Horno Electrico UT-LEIF36 36Lts;ELECTRODOMESTICOS
17371990;;M;32;CHILENO;;Millenial;PROVIDENCIA                   ;METROPOLITANA;0;0;0;0;0;0;0;0;0;Horno Electrico TH-48N 48Lts;ELECTRODOMESTICOS
6595295;Casado;M;68;CHILENO;;Silencioso;RENCA                         ;METROPOLITANA;0;0;0;0;0;0;0;0;0;Horno Electrico UT-BACKOFEN48 48Lts;ELECTRODOMESTICOS
9563465;;F;58;CHILENO;;Boomers;CHILLAN                       ;BIO BIO;0;0;0;0;0;0;0;0;0;Batidora Pedestal TH910PN 4,6Lts 1300Watts;ELECTRODOMESTICOS
19938086;;M;24;CHILENO;;Z;PROVIDENCIA                   ;METROPOLITANA;0;0;0;0;0;0;0;0;0;Batidora Manual TH-8830;ELECTRODOMESTICOS
18402758;;F;28;CHILENO;;Millenial;N/D;N/D;0;0;0;0;0;0;0;0;0;Batidora Vertical Minipimer UT-KLOT400P;ELECTRODOMESTICOS
10207496;Casado;F;54;CHILENO;;Boomers;PROVIDENCIA                   ;METROPOLITANA;0;0;0;0;0;0;0;0;0;Maquina para Hacer Pan MPP-600 BL;ELECTRODOMESTICOS
18161455;Soltero;M;30;CHILENO;KINESIOLOGO;Millenial;PROVIDENCIA                   ;METROPOLITANA;0;0;0;0;0;0;0;0;0;Cafetera W12B;ELECTRODOMESTICOS
19829074;;F;24;CHILENO;;Silencioso;PROVIDENCIA                   ;METROPOLITANA;0;0;0;0;0;0;0;0;0;Aspiradora Polvo AP-700 GR;ELECTRODOMESTICOS
15232683;;F;39;CHILENO;;X;PROVIDENCIA                   ;METROPOLITANA;0;0;0;0;0;0;0;0;0;Aspiradora AP1700 Arrastre 1700Watts;ELECTRODOMESTICOS
22820211;;F;41;PERUANO;;Extranjero;OVALLE                        ;COQUIMBO;0;0;0;0;0;0;0;0;0;Licuadora Roja 550W 1,5Lts Vaso Vidrio;ELECTRODOMESTICOS
19145237;Soltero;F;26;CHILENO;;Z;VALLENAR;ATACAMA;0;0;0;0;0;0;0;0;0;Horno Electrico TH-25N01 25Lts;ELECTRODOMESTICOS
18739481;;F;28;CHILENO;;Millenial;RENCA                         ;METROPOLITANA;0;0;0;0;0;0;0;0;0;Horno Microondas Mecanico Easy Wave 20Lts;ELECTRODOMESTICOS
16530104;Soltero;M;34;CHILENO;;Millenial;PROVIDENCIA                   ;METROPOLITANA;0;0;0;0;0;0;0;0;0;Horno Microondas Digital TH-25DM 25Lts;ELECTRODOMESTICOS
15705504;Casado;F;38;CHILENO;;X;PROVIDENCIA                   ;METROPOLITANA;0;0;0;0;0;0;0;0;0;Horno Electrico TH-38N 38Lts;ELECTRODOMESTICOS
18627566;;F;28;CHILENO;;Silencioso;PROVIDENCIA                   ;METROPOLITANA;0;0;0;0;0;0;0;0;0;Maquina de Coser 1412;ELECTRODOMESTICOS
17367990;;M;33;CHILENO;;Millenial;ARICA                         ;ARICA Y PARINACOTA;0;0;0;0;0;0;0;0;0;Horno Microondas Digital UT-CLASSY720 20Lts;ELECTRODOMESTICOS
7002896;;F;69;CHILENO;;Silencioso;COIHAIQUE                     ;AYSEN;0;0;0;0;0;0;0;0;0;Exprimidor Fauna 500 cc;ELECTRODOMESTICOS
5901169;;M;71;CHILENO;;Silencioso;PROVIDENCIA                   ;METROPOLITANA;0;0;0;0;0;0;0;0;0;HERVIDOR TH-4340;ELECTRODOMESTICOS
10858173;;F;56;CHILENO;;Boomers;SAN CARLOS                    ;BIO BIO;0;0;0;0;0;0;0;0;0;Licuadora L2000VNG 1,5Lts Vaso Vidrio;ELECTRODOMESTICOS
10413998;;M;52;CHILENO;;X;LOS ANDES                     ;VALPARAISO;0;0;0;0;0;0;0;0;0;Hervidor Electrico TH-5407i 2Lts;ELECTRODOMESTICOS
6807230;;F;69;CHILENO;;Silencioso;COLTAUCO                      ;L.G.B.OÂ´HIGGINS;0;0;0;0;0;0;0;0;0;Horno Electrico UT-BACKOFEN38 38Lts;ELECTRODOMESTICOS
8973288;Casado;F;60;CHILENO;PROFESOR;Boomers;RENCA                         ;METROPOLITANA;0;0;0;0;0;0;0;0;0;Hervidor Electrico UT-MANLY17 1,7Lts Negro;ELECTRODOMESTICOS
7370853;;F;65;CHILENO;;Boomers;LA LIGUA                      ;VALPARAISO;0;0;0;0;0;0;0;0;0;Hervidor Electrico TH-6200 R 1,7Lts Rojo;ELECTRODOMESTICOS
9928068;;F;58;CHILENO;;Boomers;PENALOLEN                     ;METROPOLITANA;0;0;0;0;0;0;0;0;0;Plancha UT-KERAMIKTOP 2200Watts Base Ceramica;ELECTRODOMESTICOS
16192739;Soltero;M;36;CHILENO;CONTADOR AUDITOR;Millenial;PROVIDENCIA                   ;METROPOLITANA;0;0;0;0;0;0;0;0;0;Horno Electrico TH-48N 48Lts;ELECTRODOMESTICOS
19059892;;F;25;CHILENO;;Z;PROVIDENCIA                   ;METROPOLITANA;0;0;0;0;0;0;0;0;0;Horno Microondas Mecanico TH-18B05 18Lts;ELECTRODOMESTICOS
9340615;Soltero;M;61;CHILENO;;Boomers;PROVIDENCIA                   ;METROPOLITANA;0;0;0;0;0;0;0;0;0;Licuadora TH-320 Roja/Negro 1,5 Lts Vaso Vidrio;ELECTRODOMESTICOS
19881748;;F;24;CHILENO;;Z;PROVIDENCIA                   ;METROPOLITANA;0;0;0;0;0;0;0;0;0;Horno Microondas Digital 2600DM 26Lts;ELECTRODOMESTICOS
15677322;;F;38;CHILENO;;X;PROVIDENCIA                   ;METROPOLITANA;0;0;0;0;0;0;0;0;0;Batidora Vertical Multimixer TH-8720;ELECTRODOMESTICOS
13784308;;M;43;CHILENO;;X;PROVIDENCIA                   ;METROPOLITANA;0;0;0;0;0;0;0;0;0;Aspiradora AP1700 Arrastre 1700Watts;ELECTRODOMESTICOS
18408909;Soltero;M;28;CHILENO;;Millenial;PROVIDENCIA                   ;METROPOLITANA;0;0;0;0;0;0;0;0;0;Procesador TH-9010 Multimixer 1,5Lts Vaso Vidrio;ELECTRODOMESTICOS
9419237;Casado;F;60;CHILENO;;Boomers;PROVIDENCIA                   ;METROPOLITANA;0;0;0;0;0;0;0;0;0;Hervidor Electrico UT-KLAR20PW 2Lts Blanco;ELECTRODOMESTICOS
5878087;;M;67;CHILENO;;Boomers;SAN BERNARDO                  ;METROPOLITANA;0;0;0;0;0;0;0;0;0;Picadora UT-PETRUS320 1Lts Vaso Vidrio;ELECTRODOMESTICOS
9847760;Casado;F;56;CHILENO;;Boomers;RENCA                         ;METROPOLITANA;0;0;0;0;0;0;0;0;0;Hervidor Electrico HA-3300 2,5Lts Blanco;ELECTRODOMESTICOS
16425037;;F;35;CHILENO;;Millenial;N/D;N/D;0;0;0;0;0;0;0;0;0;BATIDORA INMERSION S MIX 2616;ELECTRODOMESTICOS
13354552;;F;44;CHILENO;;X;CONSTITUCION                  ;MAULE;0;0;0;0;0;0;0;0;0;Batidora Manual 2532;ELECTRODOMESTICOS
8277953;;M;62;CHILENO;;Boomers;TALAGANTE                     ;METROPOLITANA;0;0;0;0;0;0;0;0;0;Licuadora TH-501V 1,5Lts Vaso Vidrio;ELECTRODOMESTICOS
11234143;;M;53;CHILENO;;X;RENCA                         ;METROPOLITANA;0;0;0;0;0;0;0;0;0;Hervidor Electrico HA-3300 2,5Lts Blanco;ELECTRODOMESTICOS
16888928;;M;33;CHILENO;;Millenial;HIJUELAS                      ;VALPARAISO;0;0;0;0;0;0;0;0;0;Hervidor Electrico 3100 1,7Lts Negro;ELECTRODOMESTICOS
16306144;;F;36;CHILENO;;Millenial;SAN ESTEBAN                   ;VALPARAISO;0;0;0;0;0;0;0;0;0;PLANCHA A VAPOR 6003 BASE ANTIADHERENTE 1600W;ELECTRODOMESTICOS
12403631;Soltero;F;49;CHILENO;;X;RENCA                         ;METROPOLITANA;0;0;0;0;0;0;0;0;0;Horno Electrico TH-48N 48Lts;ELECTRODOMESTICOS
11133570;;F;55;CHILENO;;Boomers;RENCA                         ;METROPOLITANA;0;0;0;0;0;0;0;0;0;Exprimidor Fauna 500 cc;ELECTRODOMESTICOS
8766434;;M;62;CHILENO;;Boomers;PROVIDENCIA                   ;METROPOLITANA;0;0;0;0;0;0;0;0;0;Licuadora TH-320 Roja/Negro 1,5 Lts Vaso Vidrio;ELECTRODOMESTICOS
16636738;;F;35;CHILENO;;Millenial;N/D;N/D;0;0;0;0;0;0;0;0;0;Combo Hervidor + Tostador + Sandwichera;ELECTRODOMESTICOS
18431745;Soltero;F;28;CHILENO;CIRUJANO DENTISTA;Millenial;PROVIDENCIA                   ;METROPOLITANA;0;0;0;0;0;0;0;0;0;Aspiradora Polvo AP-700 GR;ELECTRODOMESTICOS
6609783;;M;66;CHILENO;;Silencioso;PROVIDENCIA                   ;METROPOLITANA;0;0;0;0;0;0;0;0;0;Plancha TH-7052 2000Watts Base Inox;ELECTRODOMESTICOS
20005980;;F;23;CHILENO;;Silencioso;PROVIDENCIA                   ;METROPOLITANA;0;0;0;0;0;0;0;0;0;Aspiradora VCC4190V3E/XZS Arrastre 2000Watts;ELECTRODOMESTICOS
9268889;;M;57;CHILENO;;Boomers;PENALOLEN                     ;METROPOLITANA;0;0;0;0;0;0;0;0;0;Licuadora TH-501V 1,5Lts Vaso Vidrio;ELECTRODOMESTICOS
17048819;;F;33;CHILENO;;Millenial;PROVIDENCIA                   ;METROPOLITANA;0;0;0;0;0;0;0;0;0;Licuadora L1000 Inox 1,7LtsVaso Vidrio;ELECTRODOMESTICOS
9448735;;M;60;CHILENO;;Boomers;ARICA                         ;ARICA Y PARINACOTA;0;0;0;0;0;0;0;0;0;Plancha UT-PLATTEISEN 2000Watts Base Ceramica;ELECTRODOMESTICOS
16158761;;M;36;CHILENO;;Millenial;CASTRO                        ;LOS LAGOS;0;0;0;0;0;0;0;0;0;Hervidor Electrico 3100 1,7Lts Negro;ELECTRODOMESTICOS
17757736;;F;31;CHILENO;;Millenial;CORONEL                       ;BIO BIO;0;0;0;0;0;0;0;0;0;Licuadora L-1630V Negra 1,5Lts Vaso Vidrio;ELECTRODOMESTICOS
3622876;;F;86;CHILENO;;Silencioso;PROVIDENCIA                   ;METROPOLITANA;0;0;0;0;0;0;0;0;0;Hervidor Electrico UT-MANLY17 1,7Lts Negro;ELECTRODOMESTICOS
9741331;;F;61;CHILENO;;Boomers;PROVIDENCIA                   ;METROPOLITANA;0;0;0;0;0;0;0;0;0;Licuadora Roja 550W 1,5Lts Vaso Vidrio;ELECTRODOMESTICOS
6875774;Casado;M;68;CHILENO;;Silencioso;PROVIDENCIA                   ;METROPOLITANA;0;0;0;0;0;0;0;0;0;Hervidor Electrico 3100 1,7Lts Negro;ELECTRODOMESTICOS
19473315;;M;25;CHILENO;;Z;TALCA                         ;MAULE;0;0;0;0;0;0;0;0;0;Horno Electrico TH62I 60Lts;ELECTRODOMESTICOS
10852323;;F;57;CHILENO;;Boomers;PROVIDENCIA                   ;METROPOLITANA;0;0;0;0;0;0;0;0;0;Licuadora Roja 550W 1,5Lts Vaso Vidrio;ELECTRODOMESTICOS
17899786;Soltero;F;30;CHILENO;TECNICO DE NIVEL SUPERIOR EN ENFERMERIA;Millenial;PROVIDENCIA                   ;METROPOLITANA;0;0;0;0;0;0;0;0;0;Horno Electrico UT-BACKOFEN26 26Lts;ELECTRODOMESTICOS
19590382;;F;25;CHILENO;;Z;PROVIDENCIA                   ;METROPOLITANA;0;0;0;0;0;0;0;0;0;Horno Electrico UT-BACKOFEN26 26Lts;ELECTRODOMESTICOS
8706045;;F;64;CHILENO;;Boomers;SAN ROSENDO                   ;BIO BIO;0;0;0;0;0;0;0;0;0;Horno Electrico UT-LEIF36 36Lts;ELECTRODOMESTICOS
16856241;;F;34;CHILENO;;Silencioso;PROVIDENCIA                   ;METROPOLITANA;0;0;0;0;0;0;0;0;0;Freidora electrica Ut-KeramikAir;ELECTRODOMESTICOS
8075025;;F;58;CHILENO;;Boomers;OVALLE                        ;COQUIMBO;0;0;0;0;0;0;0;0;0;HERVIDOR TH-4340;ELECTRODOMESTICOS
17990716;;M;30;CHILENO;;Millenial;PROVIDENCIA                   ;METROPOLITANA;0;0;0;0;0;0;0;0;0;Horno Microondas Mecanico TH-18B05 18Lts;ELECTRODOMESTICOS
15802119;Soltero;F;37;CHILENO;PSICOPEDAGOGO;Millenial;PROVIDENCIA                   ;METROPOLITANA;0;0;0;0;0;0;0;0;0;Hervidor Electrico Tetera UT-LECKER18R 1,8Lts;ELECTRODOMESTICOS
17435280;;M;31;CHILENO;;Silencioso;PROVIDENCIA                   ;METROPOLITANA;0;0;0;0;0;0;0;0;0;Robot aspirador Roomba E5;ELECTRODOMESTICOS
23720071;;F;41;PERUANO;;Extranjero;SANTIAGO                      ;METROPOLITANA;0;0;0;0;0;0;0;0;0;Tostador de Pan TH-116 2 Rebanadas Negro;ELECTRODOMESTICOS
19192889;Soltero;M;26;CHILENO;;Z;PROVIDENCIA                   ;METROPOLITANA;0;0;0;0;0;0;0;0;0;Licuadora TH-320 Roja/Negro 1,5 Lts Vaso Vidrio;ELECTRODOMESTICOS
4817444;;F;76;CHILENO;;Silencioso;RENCA                         ;METROPOLITANA;0;0;0;0;0;0;0;0;0;Procesador TH-9010 Multimixer 1,5Lts Vaso Vidrio;ELECTRODOMESTICOS
18881061;;F;27;CHILENO;;Millenial;MAIPU                         ;METROPOLITANA;0;0;0;0;0;0;0;0;0;Aspiradora UT-ZYKLON1402 Arrastre 1400Watts;ELECTRODOMESTICOS
11450330;;F;52;CHILENO;;X;RENCA                         ;METROPOLITANA;0;0;0;0;0;0;0;0;0;Aspiradora TH1407 Arrastre 1400Watts;ELECTRODOMESTICOS
10315016;;F;55;CHILENO;;Boomers;LA FLORIDA                    ;METROPOLITANA;0;0;0;0;0;0;0;0;0;Licuadora TH-501V 1,5Lts Vaso Vidrio;ELECTRODOMESTICOS
25139866;;F;55;PERUANO;;Extranjero;SANTIAGO                      ;METROPOLITANA;0;0;0;0;0;0;0;0;0;Combo Licuadora + Batidora;ELECTRODOMESTICOS
10465174;;M;56;CHILENO;;Boomers;PUENTE ALTO                   ;METROPOLITANA;0;0;0;0;0;0;0;0;0;Horno Electrico UT-LEIF36 36Lts;ELECTRODOMESTICOS
12827422;Casado;M;47;CHILENO;;X;RENCA                         ;METROPOLITANA;0;0;0;0;0;0;0;0;0;HORNO ELECTRICO 16 LITROS HE-16NG;ELECTRODOMESTICOS
5618970;;F;91;CHILENO;;Silencioso;PROVIDENCIA                   ;METROPOLITANA;0;0;0;0;0;0;0;0;0;Horno Electrico UT-LEIF36 36Lts;ELECTRODOMESTICOS
8154899;;M;67;CHILENO;;Boomers;PROVIDENCIA                   ;METROPOLITANA;0;0;0;0;0;0;0;0;0;Hervidor Termo TH-5440TK 1,5Lts Inox;ELECTRODOMESTICOS
18646442;Casado;F;28;CHILENO;PROFESOR;Millenial;PROVIDENCIA                   ;METROPOLITANA;0;0;0;0;0;0;0;0;0;Maquina de Coser JS-2135CL Calipso;ELECTRODOMESTICOS
10717292;;F;53;CHILENO;;X;RENCA                         ;METROPOLITANA;0;0;0;0;0;0;0;0;0;Licuadora Roja 550W 1,5Lts Vaso Vidrio;ELECTRODOMESTICOS
13327790;Soltero;M;44;CHILENO;;X;RENCA                         ;METROPOLITANA;0;0;0;0;0;0;0;0;0;Horno Microondas Digital UT-CLASSY720 20Lts;ELECTRODOMESTICOS
18756663;;F;28;CHILENO;;Millenial;PROVIDENCIA                   ;METROPOLITANA;0;0;0;0;0;0;0;0;0;Licuadora Roja 550W 1,5Lts Vaso Vidrio;ELECTRODOMESTICOS
12227195;;M;49;CHILENO;;X;N/D;N/D;0;0;0;0;0;0;0;0;0;Licuadora L2000VNG 1,5Lts Vaso Vidrio;ELECTRODOMESTICOS
9755413;;F;57;CHILENO;;Boomers;SAN FELIPE                    ;VALPARAISO;0;0;0;0;0;0;0;0;0;Hervidor Electrico TH-5407i 2Lts;ELECTRODOMESTICOS
13921447;;M;42;CHILENO;;Millenial;PROVIDENCIA                   ;METROPOLITANA;0;0;0;0;0;0;0;0;0;Batidora Manual TH-8830;ELECTRODOMESTICOS
12354351;;F;49;CHILENO;;X;PROVIDENCIA                   ;METROPOLITANA;0;0;0;0;0;0;0;0;0;Combo Licuadora + Batidora;ELECTRODOMESTICOS
20239680;;F;23;CHILENO;;Silencioso;PROVIDENCIA                   ;METROPOLITANA;0;0;0;0;0;0;0;0;0;Maquina de Coser XB-2500CL Rosado;ELECTRODOMESTICOS
6474791;;F;71;CHILENO;;Silencioso;NATALES                       ;MAGALLANES;0;0;0;0;0;0;0;0;0;Picadora TH-9020V Vaso Vidrio 2Lts;ELECTRODOMESTICOS
12964671;;F;45;CHILENO;;X;RENCA                         ;METROPOLITANA;0;0;0;0;0;0;0;0;0;Horno Microondas Mecanico UT-SYDNEY18 18Lts;ELECTRODOMESTICOS
5791169;;F;72;CHILENO;;Silencioso;ISLA DE MAIPO                 ;METROPOLITANA;0;0;0;0;0;0;0;0;0;Horno Electrico TH-48N 48Lts;ELECTRODOMESTICOS
5147100;;M;79;CHILENO;;Silencioso;PROVIDENCIA                   ;METROPOLITANA;0;0;0;0;0;0;0;0;0;Horno Electrico UT-BACKOFEN26 26Lts;ELECTRODOMESTICOS
10083481;;M;57;CHILENO;;Boomers;SAN FERNANDO                  ;L.G.B.OÂ´HIGGINS;0;0;0;0;0;0;0;0;0;Horno Electrico TH-100i 100Lts;ELECTRODOMESTICOS
7811518;;F;64;CHILENO;;Boomers;ZAPALLAR                      ;VALPARAISO;0;0;0;0;0;0;0;0;0;Maquina de Coser ME9100;ELECTRODOMESTICOS
15437749;Casado;F;40;CHILENO;ENFERMERA;X;PROVIDENCIA                   ;METROPOLITANA;0;0;0;0;0;0;0;0;0;Horno Electrico TH-48N 48Lts;ELECTRODOMESTICOS
15695757;;F;38;CHILENO;;Millenial;VILLA ALEMANA                 ;VALPARAISO;0;0;0;0;0;0;0;0;0;Aspiradora Polvo AP-700 GR;ELECTRODOMESTICOS
8467441;;M;65;CHILENO;;Boomers;N/D;N/D;0;0;0;0;0;0;0;0;0;Batidora Vertical Minipimer UT-KLOT400P;ELECTRODOMESTICOS
13032839;;F;45;CHILENO;;X;RENCA                         ;METROPOLITANA;0;0;0;0;0;0;0;0;0;Hervidor Electrico HA-3300 2,5Lts Blanco;ELECTRODOMESTICOS
14005995;Soltero;F;41;CHILENO;PROFESOR;X;PROVIDENCIA                   ;METROPOLITANA;0;0;0;0;0;0;0;0;0;Procesador TH-9010 Multimixer 1,5Lts Vaso Vidrio;ELECTRODOMESTICOS
8959658;;M;59;CHILENO;;Boomers;SAN JOAQUIN                   ;METROPOLITANA;0;0;0;0;0;0;0;0;0;Licuadora L1000 Inox 1,7LtsVaso Vidrio;ELECTRODOMESTICOS
10426749;Casado;F;54;CHILENO;;Boomers;PROVIDENCIA                   ;METROPOLITANA;0;0;0;0;0;0;0;0;0;Licuadora TH-401V Roja 1,75Lts Vaso Vidrio;ELECTRODOMESTICOS
18221280;;F;30;CHILENO;;Millenial;PROVIDENCIA                   ;METROPOLITANA;0;0;0;0;0;0;0;0;0;Procesador TH-9010 Multimixer 1,5Lts Vaso Vidrio;ELECTRODOMESTICOS
24198668;;F;38;ARGENTINO;;Extranjero;SAN FERNANDO                  ;L.G.B.OÂ´HIGGINS;0;0;0;0;0;0;0;0;0;ASPIRADORA THOMAS TH-2230;ELECTRODOMESTICOS
19744092;;F;24;CHILENO;;Z;PROVIDENCIA                   ;METROPOLITANA;0;0;0;0;0;0;0;0;0;Olla Multiuso 6801 5,7Lts;ELECTRODOMESTICOS
12646751;;F;47;CHILENO;;X;PROVIDENCIA                   ;METROPOLITANA;0;0;0;0;0;0;0;0;0;Licuadora TH-401V Roja 1,75Lts Vaso Vidrio;ELECTRODOMESTICOS
9647482;;F;62;CHILENO;;Boomers;SAN ANTONIO                   ;VALPARAISO;0;0;0;0;0;0;0;0;0;Horno Microondas Mecanico TH-18B05 18Lts;ELECTRODOMESTICOS
16537497;;F;35;CHILENO;;Millenial;PROVIDENCIA                   ;METROPOLITANA;0;0;0;0;0;0;0;0;0;Licuadora TH-501V 1,5Lts Vaso Vidrio;ELECTRODOMESTICOS
8066574;Casado;F;63;CHILENO;NUTRICIONISTA;Boomers;PROVIDENCIA                   ;METROPOLITANA;0;0;0;0;0;0;0;0;0;Hervidor Electrico UT-MANLY17 1,7Lts Negro;ELECTRODOMESTICOS
18360800;;F;29;CHILENO;;Millenial;PROVIDENCIA                   ;METROPOLITANA;0;0;0;0;0;0;0;0;0;Batidora Vertical Minipimer UT-KLOT400P;ELECTRODOMESTICOS
6318612;;F;67;CHILENO;;Boomers;RENCA                         ;METROPOLITANA;0;0;0;0;0;0;0;0;0;Horno Microondas Mecanico M-2030 NG 20Lts;ELECTRODOMESTICOS
11874487;;F;51;CHILENO;;X;RENGO                         ;L.G.B.OÂ´HIGGINS;0;0;0;0;0;0;0;0;0;Enceradora EA-5000;ELECTRODOMESTICOS
9070188;;M;52;CHILENO;;Boomers;PROVIDENCIA                   ;METROPOLITANA;0;0;0;0;0;0;0;0;0;Tostador de Pan TP-1400 4 Rebanadas Inox;ELECTRODOMESTICOS
19577020;Soltero;M;25;CHILENO;TECNICO DE NIVEL SUPERIOR EN ENFERMERIA;Silencioso;PROVIDENCIA                   ;METROPOLITANA;0;0;0;0;0;0;0;0;0;Licuadora TH-320 Roja/Negro 1,5 Lts Vaso Vidrio;ELECTRODOMESTICOS
15195457;;F;39;CHILENO;;X;YUMBEL                        ;BIO BIO;0;0;0;0;0;0;0;0;0;Horno Electrico UT-BACKOFEN38 38Lts;ELECTRODOMESTICOS
16759621;;F;34;CHILENO;;Millenial;N/D;N/D;0;0;0;0;0;0;0;0;0;Horno Electrico TH-25N01 25Lts;ELECTRODOMESTICOS
17598578;Casado;F;32;CHILENO;;Silencioso;PROVIDENCIA                   ;METROPOLITANA;0;0;0;0;0;0;0;0;0;Aspiradora TH1870 Arrastre 1800Watts Gris;ELECTRODOMESTICOS
17669759;;F;31;CHILENO;;Millenial;PROVIDENCIA                   ;METROPOLITANA;0;0;0;0;0;0;0;0;0;Horno Electrico TH62I 60Lts;ELECTRODOMESTICOS
18297217;;M;30;CHILENO;;Millenial;PROVIDENCIA                   ;METROPOLITANA;0;0;0;0;0;0;0;0;0;Horno Microondas Digital TH-20S01 20Lts;ELECTRODOMESTICOS
13787908;;F;43;CHILENO;;X;QUILLECO                      ;BIO BIO;0;0;0;0;0;0;0;0;0;Hervidor Electrico TH-5407i 2Lts;ELECTRODOMESTICOS
13559106;;F;43;CHILENO;;Silencioso;MELIPILLA                     ;METROPOLITANA;0;0;0;0;0;0;0;0;0;Exprimidor Fauna 500 cc;ELECTRODOMESTICOS
10838407;;F;56;CHILENO;;Boomers;PROVIDENCIA                   ;METROPOLITANA;0;0;0;0;0;0;0;0;0;Hervidor Electrico Tetera UT-LECKER18R 1,8Lts;ELECTRODOMESTICOS
16631854;Casado;F;35;CHILENO;;Millenial;PROVIDENCIA                   ;METROPOLITANA;0;0;0;0;0;0;0;0;0;Batidora Pedestal TH910PN 4,6Lts 1300Watts;ELECTRODOMESTICOS
7362850;;M;68;CHILENO;;Silencioso;RENCA                         ;METROPOLITANA;0;0;0;0;0;0;0;0;0;Aspiradora Polvo AP-700 GR;ELECTRODOMESTICOS
12826972;;F;46;CHILENO;;Silencioso;PROVIDENCIA                   ;METROPOLITANA;0;0;0;0;0;0;0;0;0;Aspiradora TH1870 Arrastre 1800Watts Gris;ELECTRODOMESTICOS
10861057;;F;56;CHILENO;;Boomers;TALCAHUANO                    ;BIO BIO;0;0;0;0;0;0;0;0;0;Hervidor Electrico Tetera HA-4100 4Lts Iox;ELECTRODOMESTICOS
16755686;;M;35;CHILENO;;Millenial;CALERA                        ;VALPARAISO;0;0;0;0;0;0;0;0;0;Combo Hervidor + Batidora;ELECTRODOMESTICOS
19339170;Soltero;M;25;CHILENO;;Z;PROVIDENCIA                   ;METROPOLITANA;0;0;0;0;0;0;0;0;0;Horno Electrico TH-38N 38Lts;ELECTRODOMESTICOS
18526795;;M;29;CHILENO;;Millenial;N/D;N/D;0;0;0;0;0;0;0;0;0;Batidora Vertical Minipimer UT-KLOT800SS;ELECTRODOMESTICOS
5756294;Casado;M;73;CHILENO;;Silencioso;RENCA                         ;METROPOLITANA;0;0;0;0;0;0;0;0;0;Licuadora L2000VNG 1,5Lts Vaso Vidrio;ELECTRODOMESTICOS
6728501;;F;85;CHILENO;;Silencioso;PROVIDENCIA                   ;METROPOLITANA;0;0;0;0;0;0;0;0;0;Hervidor Electrico UT-MANLY17 1,7Lts Negro;ELECTRODOMESTICOS
8418281;;F;55;CHILENO;;Boomers;SAN CLEMENTE                  ;MAULE;0;0;0;0;0;0;0;0;0;Aspiradora Tambor APA1000 1000Watts;ELECTRODOMESTICOS
12399308;;F;49;CHILENO;;X;LA LIGUA                      ;VALPARAISO;0;0;0;0;0;0;0;0;0;Plancha UT-PLATTEISEN 2000Watts Base Ceramica;ELECTRODOMESTICOS
18236787;Soltero;F;29;CHILENO;INGENIERIA EN PREVENCION DE RIESGOS CALIDAD Y AMBIENTE;Millenial;"";"";0;0;0;0;0;0;0;0;0;Licuadora UT-METALLEK505P 1,5Lts Vaso Vidrio;ELECTRODOMESTICOS
13529998;Casado;F;43;CHILENO;MATRONA;X;PROVIDENCIA                   ;METROPOLITANA;0;0;0;0;0;0;0;0;0;Olla Multiuso 6801 5,7Lts;ELECTRODOMESTICOS
7697166;;F;65;CHILENO;;Boomers;PROVIDENCIA                   ;METROPOLITANA;0;0;0;0;0;0;0;0;0;Hervidor Electrico UT-DUNKEL17P 2Lts Negro;ELECTRODOMESTICOS
12498710;;F;49;CHILENO;;X;SAN RAMON                     ;METROPOLITANA;0;0;0;0;0;0;0;0;0;Horno Microondas Mecanico C1700N 17Lts Blanco;ELECTRODOMESTICOS
5167474;Casado;F;74;CHILENO;;Silencioso;RENCA                         ;METROPOLITANA;0;0;0;0;0;0;0;0;0;Horno Electrico TH-16N 16Lts;ELECTRODOMESTICOS
13871108;;F;41;CHILENO;;X;ANTOFAGASTA                   ;ANTOFAGASTA;0;0;0;0;0;0;0;0;0;Batidora Vertical Multimixer TH-8720;ELECTRODOMESTICOS
17144714;;M;33;CHILENO;;Millenial;RENCA                         ;METROPOLITANA;0;0;0;0;0;0;0;0;0;Batidora Pedestal B5300 Inox;ELECTRODOMESTICOS
23966677;;M;37;CHILENO;;Millenial;TIERRA AMARILLA               ;ATACAMA;0;0;0;0;0;0;0;0;0;Hervidor Electrico UT-MANLY17 1,7Lts Negro;ELECTRODOMESTICOS
7811625;;M;61;CHILENO;;Boomers;PUDAHUEL                      ;METROPOLITANA;0;0;0;0;0;0;0;0;0;HERVIDOR TH-4340;ELECTRODOMESTICOS
17559457;;M;31;CHILENO;;Millenial;PROVIDENCIA                   ;METROPOLITANA;0;0;0;0;0;0;0;0;0;Licuadora/Exprimidora 58149-CL 1,5Lts Vaso Vidri;ELECTRODOMESTICOS
18332398;;M;27;CHILENO;;Millenial;RENCA                         ;METROPOLITANA;0;0;0;0;0;0;0;0;0;Maquina para Hacer Pan MPP-600 BL;ELECTRODOMESTICOS
16773352;;F;34;CHILENO;;Millenial;PROVIDENCIA                   ;METROPOLITANA;0;0;0;0;0;0;0;0;0;Horno Electrico TH-38N 38Lts;ELECTRODOMESTICOS
15134204;;F;40;CHILENO;;X;"";"";0;0;0;0;0;0;0;0;0;Exprimidor de Jugo CJ-2000 1Lts;ELECTRODOMESTICOS
10730173;;M;54;CHILENO;;X;ANCUD                         ;LOS LAGOS;0;0;0;0;0;0;0;0;0;Batidora Vertical Multimixer TH-8720;ELECTRODOMESTICOS
13116942;;F;47;CHILENO;;X;VALDIVIA                      ;LOS RIOS;0;0;0;0;0;0;0;0;0;Batidora Vertical Minipimer UT-KLOT800SS;ELECTRODOMESTICOS
18930605;;F;27;CHILENO;;Millenial;PROVIDENCIA                   ;METROPOLITANA;0;0;0;0;0;0;0;0;0;Picadora UT-PETRUS320 1Lts Vaso Vidrio;ELECTRODOMESTICOS
17164874;;M;32;CHILENO;;Millenial;PROVIDENCIA                   ;METROPOLITANA;0;0;0;0;0;0;0;0;0;Hervidor Electrico Tetera HA-4100 4Lts Iox;ELECTRODOMESTICOS
11410427;;M;53;CHILENO;;X;PROVIDENCIA                   ;METROPOLITANA;0;0;0;0;0;0;0;0;0;Aspiradora TH1870 Arrastre 1800Watts Gris;ELECTRODOMESTICOS
6020927;;M;74;CHILENO;;Silencioso;BUIN                          ;METROPOLITANA;0;0;0;0;0;0;0;0;0;Horno Microondas Digital TH-25DM 25Lts;ELECTRODOMESTICOS
12471554;;F;49;CHILENO;;X;MAIPU                         ;METROPOLITANA;0;0;0;0;0;0;0;0;0;Batidora Vertical Multimixer TH-8720;ELECTRODOMESTICOS
13134827;;F;45;CHILENO;;X;TALCAHUANO                    ;BIO BIO;0;0;0;0;0;0;0;0;0;BATIDORA MANUAL 260R;ELECTRODOMESTICOS
8810484;;M;60;CHILENO;;Boomers;VALDIVIA                      ;LOS RIOS;0;0;0;0;0;0;0;0;0;Aspiradora UT-SILENT1804 Arrastre 1800Watts;ELECTRODOMESTICOS
17484851;;F;32;CHILENO;;Millenial;MAIPU                         ;METROPOLITANA;0;0;0;0;0;0;0;0;0;Combo Hervidor + Batidora;ELECTRODOMESTICOS
20340793;;F;29;CHILENO;;Millenial;GRANEROS;O HIGGINS;0;0;0;0;0;0;0;0;0;Maquina de coser computarizada 60 puntadas SH660;ELECTRODOMESTICOS
9136446;;F;59;CHILENO;;Boomers;PROVIDENCIA                   ;METROPOLITANA;0;0;0;0;0;0;0;0;0;Licuadora TH-401V Roja 1,75Lts Vaso Vidrio;ELECTRODOMESTICOS
9338275;;F;68;NO INFORMA NACIONALIDAD;;Extranjero;LAS CONDES                    ;METROPOLITANA;0;0;0;0;0;0;0;0;0;Horno Microondas Digital TH-25DM 25Lts;ELECTRODOMESTICOS
10565482;;F;57;CHILENO;;Boomers;RENCA                         ;METROPOLITANA;0;0;0;0;0;0;0;0;0;PLANCHA A VAPOR 6003 BASE ANTIADHERENTE 1600W;ELECTRODOMESTICOS
16131805;;M;36;CHILENO;;Millenial;PROVIDENCIA                   ;METROPOLITANA;0;0;0;0;0;0;0;0;0;Licuadora TH-320 Roja/Negro 1,5 Lts Vaso Vidrio;ELECTRODOMESTICOS
14091145;;M;42;CHILENO;;X;N/D;N/D;0;0;0;0;0;0;0;0;0;Set Picador KP-123BL 1,2Lts;ELECTRODOMESTICOS
12847406;;F;46;CHILENO;;X;RENCA                         ;METROPOLITANA;0;0;0;0;0;0;0;0;0;Maquina de coser computarizada 60 puntadas SH660;ELECTRODOMESTICOS
9637253;;F;46;CHILENO;;X;ARICA                         ;ARICA Y PARINACOTA;0;0;0;0;0;0;0;0;0;Horno Microondas Digital ME0113MB1/XZS 32Lts;ELECTRODOMESTICOS
14444908;;F;51;CHILENO;;X;COLLIPULLI                    ;ARAUCANIA;0;0;0;0;0;0;0;0;0;Hervidor Electrico UT-DUNKEL17P 2Lts Negro;ELECTRODOMESTICOS
16369481;Soltero;M;35;CHILENO;;Silencioso;PROVIDENCIA                   ;METROPOLITANA;0;0;0;0;0;0;0;0;0;Horno Electrico TH-80i 80Lts;ELECTRODOMESTICOS
12110392;Casado;F;57;CHILENO;;Boomers;PROVIDENCIA                   ;METROPOLITANA;0;0;0;0;0;0;0;0;0;Batidora Manual UT-TEKLA300;ELECTRODOMESTICOS
6768185;Casado;M;71;CHILENO;;Silencioso;PROVIDENCIA                   ;METROPOLITANA;0;0;0;0;0;0;0;0;0;Horno Electrico UT-BACKOFEN60 60Lts;ELECTRODOMESTICOS
11413956;;F;53;CHILENO;;X;PROVIDENCIA                   ;METROPOLITANA;0;0;0;0;0;0;0;0;0;Set Picador KP-123BL 1,2Lts;ELECTRODOMESTICOS
15624207;;M;38;CHILENO;;Millenial;PROVIDENCIA                   ;METROPOLITANA;0;0;0;0;0;0;0;0;0;Licuadora TH-501V 1,5Lts Vaso Vidrio;ELECTRODOMESTICOS
7555445;;F;67;CHILENO;;Boomers;SAN CARLOS                    ;BIO BIO;0;0;0;0;0;0;0;0;0;Horno Electrico TH-25N01 25Lts;ELECTRODOMESTICOS
5418307;;M;77;CHILENO;;Silencioso;RENCA                         ;METROPOLITANA;0;0;0;0;0;0;0;0;0;Horno Microondas Digital L UT-25KROMM 25Lts;ELECTRODOMESTICOS
12771089;Casado;M;46;CHILENO;;X;RENCA                         ;METROPOLITANA;0;0;0;0;0;0;0;0;0;Exprimidor Fauna 500 cc;ELECTRODOMESTICOS
16904413;Soltero;M;34;CHILENO;;Millenial;PROVIDENCIA                   ;METROPOLITANA;0;0;0;0;0;0;0;0;0;Hervidor Electrico TH-4800 2Lts Negro Azul;ELECTRODOMESTICOS
9890603;;F;56;CHILENO;;Boomers;PROVIDENCIA                   ;METROPOLITANA;0;0;0;0;0;0;0;0;0;Licuadora TH-501V 1,5Lts Vaso Vidrio;ELECTRODOMESTICOS
12221172;;F;50;CHILENO;;X;PROVIDENCIA                   ;METROPOLITANA;0;0;0;0;0;0;0;0;0;Hervidor Electrico Tetera UT-LECKER18R 1,8Lts;ELECTRODOMESTICOS
20055763;;M;23;CHILENO;;Z;RENCA                         ;METROPOLITANA;0;0;0;0;0;0;0;0;0;Hervidor Electrico TH-4212N 1,7Lts Negro;ELECTRODOMESTICOS
10083711;;F;52;CHILENO;;X;RENCA                         ;METROPOLITANA;0;0;0;0;0;0;0;0;0;Batidora Vertical Minipimer UT-KLOT400P;ELECTRODOMESTICOS
12899543;;M;46;CHILENO;;X;N/D;N/D;0;0;0;0;0;0;0;0;0;Licuadora TH-501V 1,5Lts Vaso Vidrio;ELECTRODOMESTICOS
13101276;;F;45;CHILENO;;X;RENCA                         ;METROPOLITANA;0;0;0;0;0;0;0;0;0;Hervidor Electrico Tetera HA-4100 4Lts Iox;ELECTRODOMESTICOS
17248135;Soltero;M;33;CHILENO;;Millenial;"";"";0;0;0;0;0;0;0;0;0;Aspiradora AP3400 Arrastre 2000Watts;ELECTRODOMESTICOS
13141479;;F;45;CHILENO;;X;RENCA                         ;METROPOLITANA;0;0;0;0;0;0;0;0;0;Batidora Manual UT-TEKLA300;ELECTRODOMESTICOS
8376789;;M;57;CHILENO;;Boomers;RENCA                         ;METROPOLITANA;0;0;0;0;0;0;0;0;0;Licuadora L2000VNG 1,5Lts Vaso Vidrio;ELECTRODOMESTICOS
9450956;;F;56;CHILENO;;Boomers;QUILPUE                       ;VALPARAISO;0;0;0;0;0;0;0;0;0;Parrilla Electrica PE2650;ELECTRODOMESTICOS
5691520;;F;75;CHILENO;;Silencioso;RENCA                         ;METROPOLITANA;0;0;0;0;0;0;0;0;0;Hervidor Electrico TH-4212N 1,7Lts Negro;ELECTRODOMESTICOS
12805059;;F;47;CHILENO;;X;LA SERENA                     ;COQUIMBO;0;0;0;0;0;0;0;0;0;Horno Electrico UT-BACKOFEN38 38Lts;ELECTRODOMESTICOS
10202348;;F;51;CHILENO;;X;PROVIDENCIA                   ;METROPOLITANA;0;0;0;0;0;0;0;0;0;Tostador de Pan TP-1400 4 Rebanadas Inox;ELECTRODOMESTICOS
19127039;Soltero;F;26;CHILENO;TECNICO EN ADMINISTRACION DE EMPRESAS;Z;PROVIDENCIA                   ;METROPOLITANA;0;0;0;0;0;0;0;0;0;Plancha Vertical TH-7300 1200Watts;ELECTRODOMESTICOS
10681785;;M;52;CHILENO;;X;PROVIDENCIA                   ;METROPOLITANA;0;0;0;0;0;0;0;0;0;Hervidor Electrico TH-4212N 1,7Lts Negro;ELECTRODOMESTICOS
7748695;;M;65;CHILENO;;Boomers;RENCA                         ;METROPOLITANA;0;0;0;0;0;0;0;0;0;Hervidor Electrico UT-MANLY17 1,7Lts Negro;ELECTRODOMESTICOS
13228399;;F;45;CHILENO;;X;VINA DEL MAR                  ;VALPARAISO;0;0;0;0;0;0;0;0;0;Horno Electrico TH-38N 38Lts;ELECTRODOMESTICOS
9011999;;F;58;CHILENO;;Boomers;N/D;N/D;0;0;0;0;0;0;0;0;0;Horno Electrico UT-BACKOFEN48 48Lts;ELECTRODOMESTICOS
15697920;;M;38;CHILENO;;X;PROVIDENCIA                   ;METROPOLITANA;0;0;0;0;0;0;0;0;0;Batidora Pedestal TH910PN 4,6Lts 1300Watts;ELECTRODOMESTICOS
16641251;;F;35;CHILENO;;Millenial;PUENTE ALTO                   ;METROPOLITANA;0;0;0;0;0;0;0;0;0;Aspiradora VCC4190V3E/XZS Arrastre 2000Watts;ELECTRODOMESTICOS
6397418;Divorciado;F;70;CHILENO;;Silencioso;RENCA                         ;METROPOLITANA;0;0;0;0;0;0;0;0;0;Licuadora L-1630V Negra 1,5Lts Vaso Vidrio;ELECTRODOMESTICOS
19651579;;F;24;CHILENO;;Z;CONSTITUCION                  ;MAULE;0;0;0;0;0;0;0;0;0;Plancha TH-7052 2000Watts Base Inox;ELECTRODOMESTICOS
7422483;;F;55;CHILENO;;Boomers;PROVIDENCIA                   ;METROPOLITANA;0;0;0;0;0;0;0;0;0;Batidora Pedestal B5300 Inox;ELECTRODOMESTICOS
14468239;;F;50;CHILENO;;X;BUIN                          ;METROPOLITANA;0;0;0;0;0;0;0;0;0;Hervidor Electrico Tetera TH-6505RT 1,7Lts Rojo;ELECTRODOMESTICOS
12915501;Casado;M;46;CHILENO;TECNICO MECANICO;X;PROVIDENCIA                   ;METROPOLITANA;0;0;0;0;0;0;0;0;0;Plancha OSTER 4801T 1200Watts Base Ceramica;ELECTRODOMESTICOS
19633101;;F;25;CHILENO;;Z;PROVIDENCIA                   ;METROPOLITANA;0;0;0;0;0;0;0;0;0;Hervidor Electrico TH-4515N 2Lts Negro;ELECTRODOMESTICOS
17827327;Soltero;F;30;CHILENO;MATRONA;Millenial;PROVIDENCIA                   ;METROPOLITANA;0;0;0;0;0;0;0;0;0;Tostador de Pan TH-116 2 Rebanadas Negro;ELECTRODOMESTICOS
7486183;;F;68;CHILENO;;Boomers;QUILLOTA                      ;VALPARAISO;0;0;0;0;0;0;0;0;0;Horno Microondas Mecanico TH-18B05 18Lts;ELECTRODOMESTICOS
18132976;;M;30;CHILENO;;Millenial;VILLA ALEMANA                 ;VALPARAISO;0;0;0;0;0;0;0;0;0;Horno Electrico TH-25N01 25Lts;ELECTRODOMESTICOS
9235496;;F;60;CHILENO;;Boomers;RENCA                         ;METROPOLITANA;0;0;0;0;0;0;0;0;0;FREIDORA DE AIRE CKSTAF18D 1000W;ELECTRODOMESTICOS
17118369;;M;33;CHILENO;;Millenial;PROVIDENCIA                   ;METROPOLITANA;0;0;0;0;0;0;0;0;0;Parrilla Electrica y Panini 4881;ELECTRODOMESTICOS
10470995;;F;55;CHILENO;;Boomers;SAN PEDRO DE LA PAZ           ;BIO BIO;0;0;0;0;0;0;0;0;0;Cafetera P65 Silver;ELECTRODOMESTICOS
18133572;;M;30;CHILENO;;Millenial;PROVIDENCIA                   ;METROPOLITANA;0;0;0;0;0;0;0;0;0;Plancha UT-KERAMIK1 2200Watts Base Ceramica;ELECTRODOMESTICOS
7164029;Casado;M;68;CHILENO;;Boomers;PROVIDENCIA                   ;METROPOLITANA;0;0;0;0;0;0;0;0;0;Aspiradora TH1415 Arrastre 1500Watts;ELECTRODOMESTICOS
14147078;Casado;M;41;CHILENO;PERIODISTA;X;PROVIDENCIA                   ;METROPOLITANA;0;0;0;0;0;0;0;0;0;Aspiradora TH1870 Arrastre 1800Watts Gris;ELECTRODOMESTICOS
14262189;;M;48;CHILENO;;X;PALMILLA                      ;L.G.B.OÂ´HIGGINS;0;0;0;0;0;0;0;0;0;Horno Microondas Digital TH-20S01 20Lts;ELECTRODOMESTICOS
10695600;;F;55;CHILENO;;Boomers;RENCA                         ;METROPOLITANA;0;0;0;0;0;0;0;0;0;Aspiradora VCC4190V3E/XZS Arrastre 2000Watts;ELECTRODOMESTICOS
8214364;Casado;M;65;CHILENO;;Boomers;PROVIDENCIA                   ;METROPOLITANA;0;0;0;0;0;0;0;0;0;Plancha UT-DUNST 2200Watts Base Ceramica;ELECTRODOMESTICOS
15551662;;M;36;CHILENO;;Millenial;PROVIDENCIA                   ;METROPOLITANA;0;0;0;0;0;0;0;0;0;Cafetera TH-138i;ELECTRODOMESTICOS
5247207;;F;77;CHILENO;;Silencioso;VALDIVIA                      ;LOS RIOS;0;0;0;0;0;0;0;0;0;Extractor de Jugo EX800 1,4Lts;ELECTRODOMESTICOS
20231265;;F;22;CHILENO;;Extranjero;PROVIDENCIA                   ;METROPOLITANA;0;0;0;0;0;0;0;0;0;Batidora Vertical Stick Mixer 2609;ELECTRODOMESTICOS
14252512;;M;48;CHILENO;;X;QUILPUE                       ;VALPARAISO;0;0;0;0;0;0;0;0;0;Horno Microondas Digital TH-20S01 20Lts;ELECTRODOMESTICOS
7632544;;M;64;CHILENO;;Boomers;QUILPUE                       ;VALPARAISO;0;0;0;0;0;0;0;0;0;Horno Electrico UT-BACKOFEN26 26Lts;ELECTRODOMESTICOS
8039085;;F;61;CHILENO;;Boomers;PROVIDENCIA                   ;METROPOLITANA;0;0;0;0;0;0;0;0;0;FREIDORA DE AIRE CKSTAF15B 1850W;ELECTRODOMESTICOS
18027930;;M;30;CHILENO;;Millenial;PROVIDENCIA                   ;METROPOLITANA;0;0;0;0;0;0;0;0;0;Aspiradora TH1415 Arrastre 1500Watts;ELECTRODOMESTICOS
17341933;;F;32;CHILENO;;Millenial;N/D;N/D;0;0;0;0;0;0;0;0;0;Batidora Vertical Minipimer UT-KLOT400P;ELECTRODOMESTICOS
10190815;;F;57;CHILENO;;Boomers;PARRAL                        ;MAULE;0;0;0;0;0;0;0;0;0;Exprimidor de Jugo TH-1215 1,5Lts;ELECTRODOMESTICOS
5380812;;F;78;CHILENO;;Silencioso;RENCA                         ;METROPOLITANA;0;0;0;0;0;0;0;0;0;Licuadora Roja 550W 1,5Lts Vaso Vidrio;ELECTRODOMESTICOS
10832938;;M;48;CHILENO;;X;ILLAPEL                       ;COQUIMBO;0;0;0;0;0;0;0;0;0;Licuadora Personal TH-300PB;ELECTRODOMESTICOS
7507215;Viudo;F;73;CHILENO;;Silencioso;CURICO                        ;MAULE;0;0;0;0;0;0;0;0;0;Licuadora TH-320 Roja/Negro 1,5 Lts Vaso Vidrio;ELECTRODOMESTICOS
9240049;;M;61;CHILENO;;Boomers;PROVIDENCIA                   ;METROPOLITANA;0;0;0;0;0;0;0;0;0;Licuadora UT-METALLEK605P 1,55Lts;ELECTRODOMESTICOS
16987346;;F;34;CHILENO;;Millenial;CONSTITUCION                  ;MAULE;0;0;0;0;0;0;0;0;0;Horno Microondas Mecanico TH-18B05 18Lts;ELECTRODOMESTICOS
13486372;;F;44;CHILENO;;X;CALDERA                       ;ATACAMA;0;0;0;0;0;0;0;0;0;Horno Electrico TH-25N01 25Lts;ELECTRODOMESTICOS
18521270;Soltero;M;28;CHILENO;;Millenial;PROVIDENCIA                   ;METROPOLITANA;0;0;0;0;0;0;0;0;0;Procesador TH-9010 Multimixer 1,5Lts Vaso Vidrio;ELECTRODOMESTICOS
8412042;Casado;M;65;CHILENO;;Boomers;PROVIDENCIA                   ;METROPOLITANA;0;0;0;0;0;0;0;0;0;Hervidor Electrico Tetera HA-4100 4Lts Iox;ELECTRODOMESTICOS
14212102;;M;40;CHILENO;;X;CONCEPCION                    ;BIO BIO;0;0;0;0;0;0;0;0;0;Maquina de Coser ST-371HD Heavy Duty;ELECTRODOMESTICOS
12861893;;M;47;CHILENO;;X;CASTRO                        ;LOS LAGOS;0;0;0;0;0;0;0;0;0;Hervidor Electrico Tetera TH-6505RT 1,7Lts Rojo;ELECTRODOMESTICOS
16957773;;F;33;CHILENO;;Millenial;CASTRO                        ;LOS LAGOS;0;0;0;0;0;0;0;0;0;Licuadora TH-320 Roja/Negro 1,5 Lts Vaso Vidrio;ELECTRODOMESTICOS
18826743;;M;27;CHILENO;;Z;N/D;N/D;0;0;0;0;0;0;0;0;0;ASPIRADORA THOMAS TH-1640;ELECTRODOMESTICOS
8599031;Casado;M;64;CHILENO;AGROINDUSTRIA;Boomers;PROVIDENCIA                   ;METROPOLITANA;0;0;0;0;0;0;0;0;0;Horno Electrico UT-BACKOFEN38 38Lts;ELECTRODOMESTICOS
8749038;;F;60;CHILENO;;Boomers;N/D;N/D;0;0;0;0;0;0;0;0;0;Horno Electrico UT-BACKOFEN38 38Lts;ELECTRODOMESTICOS
10865759;;F;55;CHILENO;;Boomers;RENCA                         ;METROPOLITANA;0;0;0;0;0;0;0;0;0;Enceradora EA-5000;ELECTRODOMESTICOS
5230757;;M;77;CHILENO;;Silencioso;RENCA                         ;METROPOLITANA;0;0;0;0;0;0;0;0;0;Horno Electrico UT-BACKOFEN38 38Lts;ELECTRODOMESTICOS
10947165;;F;61;CHILENO;;Boomers;VILLA ALEGRE                  ;MAULE;0;0;0;0;0;0;0;0;0;Combo Licuadora + Batidora;ELECTRODOMESTICOS
10520536;;F;44;CHILENO;;X;ANCUD                         ;LOS LAGOS;0;0;0;0;0;0;0;0;0;Licuadora Berry Blender Roja 1400 Vaso Vidrio;ELECTRODOMESTICOS
19645357;;F;25;CHILENO;;Z;PROVIDENCIA                   ;METROPOLITANA;0;0;0;0;0;0;0;0;0;Batidora Pedestal B5300 Inox;ELECTRODOMESTICOS
8964188;;F;61;CHILENO;;Boomers;RENCA                         ;METROPOLITANA;0;0;0;0;0;0;0;0;0;Picadora UT-PETRUS320 1Lts Vaso Vidrio;ELECTRODOMESTICOS
17795435;;M;31;CHILENO;;Millenial;N/D;N/D;0;0;0;0;0;0;0;0;0;Horno Electrico TH-25N01 25Lts;ELECTRODOMESTICOS
17770961;Soltero;F;30;CHILENO;INGENIERO EN ADMINISTRACION DE EMPRESAS;Millenial;PROVIDENCIA                   ;METROPOLITANA;0;0;0;0;0;0;0;0;0;Aspiradora TH1415 Arrastre 1500Watts;ELECTRODOMESTICOS
5184444;;F;78;CHILENO;;Silencioso;PROVIDENCIA                   ;METROPOLITANA;0;0;0;0;0;0;0;0;0;Horno Electrico UT-LEIF36 36Lts;ELECTRODOMESTICOS
11813739;Soltero;F;51;CHILENO;;X;RENCA                         ;METROPOLITANA;0;0;0;0;0;0;0;0;0;Hervidor Electrico 3100 1,7Lts Negro;ELECTRODOMESTICOS
7507184;;M;65;CHILENO;;Boomers;PROVIDENCIA                   ;METROPOLITANA;0;0;0;0;0;0;0;0;0;Batidora Pedestal UT-KLEIN700;ELECTRODOMESTICOS
10357925;;F;58;CHILENO;;Boomers;QUILPUE                       ;VALPARAISO;0;0;0;0;0;0;0;0;0;PROCESADOR DE ALIMENTOS UT-PROCESSOR750;ELECTRODOMESTICOS
15466038;;M;40;CHILENO;;X;"";"";0;0;0;0;0;0;0;0;0;Batidora Manual TH-8830;ELECTRODOMESTICOS
11345302;Soltero;F;54;CHILENO;;Boomers;RENCA                         ;METROPOLITANA;0;0;0;0;0;0;0;0;0;Aspiradora Handy Clean Black 1400;ELECTRODOMESTICOS
17354520;Casado;M;32;CHILENO;;Millenial;PROVIDENCIA                   ;METROPOLITANA;0;0;0;0;0;0;0;0;0;Hervidor Electrico UT-MANLY17 1,7Lts Negro;ELECTRODOMESTICOS
5105283;;F;80;CHILENO;;Silencioso;N/D;N/D;0;0;0;0;0;0;0;0;0;Hervidor Electrico UT-MANLY17 1,7Lts Negro;ELECTRODOMESTICOS
8206462;;M;64;CHILENO;;Boomers;RENCA                         ;METROPOLITANA;0;0;0;0;0;0;0;0;0;Licuadora Roja 550W 1,5Lts Vaso Vidrio;ELECTRODOMESTICOS
25436247;;M;36;ECUATORIANO;;Extranjero;LINARES                       ;MAULE;0;0;0;0;0;0;0;0;0;Aspiradora AP1700 Arrastre 1700Watts;ELECTRODOMESTICOS
6711721;Casado;M;71;CHILENO;;Silencioso;RENCA                         ;METROPOLITANA;0;0;0;0;0;0;0;0;0;Hervidor Electrico TH-4515N 2Lts Negro;ELECTRODOMESTICOS
13042986;;F;46;CHILENO;;X;RECOLETA                      ;METROPOLITANA;0;0;0;0;0;0;0;0;0;Aspiradora UT-SILENT1603 Arrastre 1600Watts;ELECTRODOMESTICOS
18509806;;M;29;CHILENO;;Millenial;PROVIDENCIA                   ;METROPOLITANA;0;0;0;0;0;0;0;0;0;Licuadora UT-METALLEK505P 1,5Lts Vaso Vidrio;ELECTRODOMESTICOS
17214423;;F;33;CHILENO;;Millenial;TUCAPEL                       ;BIO BIO;0;0;0;0;0;0;0;0;0;Horno Microondas Digital TH-20S01 20Lts;ELECTRODOMESTICOS
4524059;;M;79;CHILENO;;Silencioso;"";"";0;0;0;0;0;0;0;0;0;Licuadora UT-METALLEK605P 1,55Lts;ELECTRODOMESTICOS
6938833;;F;69;CHILENO;;Silencioso;CALERA                        ;VALPARAISO;0;0;0;0;0;0;0;0;0;Licuadora Berry Blender Roja 1400 Vaso Vidrio;ELECTRODOMESTICOS
16353687;;M;35;CHILENO;;Millenial;PROVIDENCIA                   ;METROPOLITANA;0;0;0;0;0;0;0;0;0;CAFETERA CF-4600 NG;ELECTRODOMESTICOS
26417370;;M;29;CHILENO;;Extranjero;CURICO                        ;MAULE;0;0;0;0;0;0;0;0;0;Licuadora TH-320 Roja/Negro 1,5 Lts Vaso Vidrio;ELECTRODOMESTICOS
8990115;Soltero;F;62;CHILENO;CONTADOR AUDITOR;Boomers;RENCA                         ;METROPOLITANA;0;0;0;0;0;0;0;0;0;Combo Hervidor + Batidora;ELECTRODOMESTICOS
9408277;;F;61;CHILENO;;Boomers;OVALLE                        ;COQUIMBO;0;0;0;0;0;0;0;0;0;Hervidor Electrico UT-DUNKEL17P 2Lts Negro;ELECTRODOMESTICOS
11342552;;F;53;CHILENO;;X;ARICA                         ;ARICA Y PARINACOTA;0;0;0;0;0;0;0;0;0;Combo Plancha Batidora Secador de Pelo;ELECTRODOMESTICOS
26478499;;F;35;VENEZOLANO;;Extranjero;N/D;N/D;0;0;0;0;0;0;0;0;0;Aspiradora AP1700 Arrastre 1700Watts;ELECTRODOMESTICOS
14171369;;M;41;CHILENO;;X;SANTIAGO;METROPOLITANA;0;0;0;0;0;0;0;0;0;Licuadora L2000VNG 1,5Lts Vaso Vidrio;ELECTRODOMESTICOS
17076775;;F;33;CHILENO;;Millenial;N/D;N/D;0;0;0;0;0;0;0;0;0;Plancha GSTBS 5854 1600Watts Base Ceramica;ELECTRODOMESTICOS
8510975;Casado;M;48;CHILENO;AGRONOMO;X;PROVIDENCIA                   ;METROPOLITANA;0;0;0;0;0;0;0;0;0;Aspiradora UT-ZYKLON1402 Arrastre 1400Watts;ELECTRODOMESTICOS
17505741;;M;32;CHILENO;;Millenial;PROVIDENCIA                   ;METROPOLITANA;0;0;0;0;0;0;0;0;0;Combo Hervidor + Batidora;ELECTRODOMESTICOS
6135303;;F;76;CHILENO;;Silencioso;PROVIDENCIA                   ;METROPOLITANA;0;0;0;0;0;0;0;0;0;Horno Electrico TH-38N 38Lts;ELECTRODOMESTICOS
6466546;;F;73;CHILENO;;Silencioso;PUENTE ALTO                   ;METROPOLITANA;0;0;0;0;0;0;0;0;0;Hervidor Electrico 388R Rojo;ELECTRODOMESTICOS
13994596;;F;40;CHILENO;;X;CABILDO                       ;VALPARAISO;0;0;0;0;0;0;0;0;0;Horno Microondas Mecanico UT-SYDNEY18 18Lts;ELECTRODOMESTICOS
18417342;Soltero;F;29;CHILENO;;Millenial;RENCA                         ;METROPOLITANA;0;0;0;0;0;0;0;0;0;Licuadora Berry Blender Roja 1400 Vaso Vidrio;ELECTRODOMESTICOS
9310265;;M;60;CHILENO;;Boomers;LOS ANGELES                   ;BIO BIO;0;0;0;0;0;0;0;0;0;Licuadora BLSTPYG1210NBG052 1,5Lts Vaso Vidrio;ELECTRODOMESTICOS
14459048;;F;51;CHILENO;;X;NUNOA                         ;METROPOLITANA;0;0;0;0;0;0;0;0;0;Maquina de Coser 311;ELECTRODOMESTICOS
9967636;;F;62;CHILENO;;Boomers;QUINCHAO                      ;LOS LAGOS;0;0;0;0;0;0;0;0;0;Horno Microondas Digital TH-20S01 20Lts;ELECTRODOMESTICOS
25635501;Soltero;M;38;HAITIANO;;Extranjero;PROVIDENCIA                   ;METROPOLITANA;0;0;0;0;0;0;0;0;0;Licuadora TH-320 Roja/Negro 1,5 Lts Vaso Vidrio;ELECTRODOMESTICOS
7441983;Soltero;F;65;CHILENO;;Boomers;RENCA                         ;METROPOLITANA;0;0;0;0;0;0;0;0;0;Plancha UT-PLATTEISEN 2000Watts Base Ceramica;ELECTRODOMESTICOS
18840665;;F;27;CHILENO;;Millenial;PROVIDENCIA                   ;METROPOLITANA;0;0;0;0;0;0;0;0;0;Parrilla Electrica TH-180;ELECTRODOMESTICOS
13767345;Soltero;F;41;CHILENO;;X;PROVIDENCIA                   ;METROPOLITANA;0;0;0;0;0;0;0;0;0;Hervidor Electrico UT-KLAR20PW 2Lts Blanco;ELECTRODOMESTICOS
9763838;;F;57;CHILENO;;Boomers;SAN JAVIER                    ;MAULE;0;0;0;0;0;0;0;0;0;Plancha GSTBS 5854 1600Watts Base Ceramica;ELECTRODOMESTICOS
6162441;;M;72;CHILENO;;Silencioso;RENCA                         ;METROPOLITANA;0;0;0;0;0;0;0;0;0;Licuadora TH-501V 1,5Lts Vaso Vidrio;ELECTRODOMESTICOS
16833562;;M;34;CHILENO;;Millenial;VILLA ALEMANA                 ;VALPARAISO;0;0;0;0;0;0;0;0;0;Horno Electrico TH-48N 48Lts;ELECTRODOMESTICOS
13243562;;F;45;CHILENO;;X;RECOLETA                      ;METROPOLITANA;0;0;0;0;0;0;0;0;0;Freidora FE4000 4Lts;ELECTRODOMESTICOS
4470729;;M;80;CHILENO;;Silencioso;RENCA                         ;METROPOLITANA;0;0;0;0;0;0;0;0;0;Horno Electrico UT-LEIF36 36Lts;ELECTRODOMESTICOS
13918962;;F;55;CHILENO;;Boomers;RENCA                         ;METROPOLITANA;0;0;0;0;0;0;0;0;0;Licuadora UT-METALLEK505P 1,5Lts Vaso Vidrio;ELECTRODOMESTICOS
10127390;;F;56;CHILENO;;Boomers;PUENTE ALTO                   ;METROPOLITANA;0;0;0;0;0;0;0;0;0;Plancha UT-PLATTEISEN 2000Watts Base Ceramica;ELECTRODOMESTICOS
10031633;;M;52;CHILENO;;X;PROVIDENCIA                   ;METROPOLITANA;0;0;0;0;0;0;0;0;0;Horno Microondas Digital TH-25DM 25Lts;ELECTRODOMESTICOS
8895633;;F;56;CHILENO;;Boomers;PROVIDENCIA                   ;METROPOLITANA;0;0;0;0;0;0;0;0;0;Horno Microondas Mecanico TH-18B05 18Lts;ELECTRODOMESTICOS
15398428;;F;40;CHILENO;;X;PROVIDENCIA                   ;METROPOLITANA;0;0;0;0;0;0;0;0;0;Horno Microondas Digital TH-20S01 20Lts;ELECTRODOMESTICOS
8463191;;M;64;CHILENO;;Boomers;ANGOL                         ;ARAUCANIA;0;0;0;0;0;0;0;0;0;Hervidor Electrico TH-4350 3Lts Blanco;ELECTRODOMESTICOS
6955953;Divorciado;M;68;CHILENO;;Silencioso;RENCA                         ;METROPOLITANA;0;0;0;0;0;0;0;0;0;Horno Microondas Mecanico TH-18B05 18Lts;ELECTRODOMESTICOS
16464980;Soltero;F;35;CHILENO;;Millenial;PROVIDENCIA                   ;METROPOLITANA;0;0;0;0;0;0;0;0;0;Hervidor Electrico TH-4350 3Lts Blanco;ELECTRODOMESTICOS
6212612;;F;72;CHILENO;;Silencioso;QUILLOTA                      ;VALPARAISO;0;0;0;0;0;0;0;0;0;Horno Electrico UT-LEIF36 36Lts;ELECTRODOMESTICOS
13539237;;F;43;CHILENO;;X;LOS ANDES                     ;VALPARAISO;0;0;0;0;0;0;0;0;0;Batidora Vertical Minipimer UT-KLOT400P;ELECTRODOMESTICOS
16910495;;F;33;CHILENO;;Millenial;N/D;N/D;0;0;0;0;0;0;0;0;0;Licuadora L1000 Inox 1,7LtsVaso Vidrio;ELECTRODOMESTICOS
15253756;;F;37;CHILENO;;Millenial;"";"";0;0;0;0;0;0;0;0;0;Aspiradora UT-MAGICLEAN Inalambrica Vertical;ELECTRODOMESTICOS
11517316;;M;52;CHILENO;;X;LOS ANDES                     ;VALPARAISO;0;0;0;0;0;0;0;0;0;Horno Electrico TH-25N01 25Lts;ELECTRODOMESTICOS
10833157;;M;46;CHILENO;;X;PUERTO MONTT                  ;LOS LAGOS;0;0;0;0;0;0;0;0;0;Hervidor Termo BA-6928 Rojo 2,8Lts;ELECTRODOMESTICOS
7531463;;F;66;CHILENO;;Boomers;PUERTO MONTT                  ;LOS LAGOS;0;0;0;0;0;0;0;0;0;Hervidor Electrico HA-3300 2,5Lts Blanco;ELECTRODOMESTICOS
8911019;;F;60;CHILENO;;Boomers;CALBUCO                       ;LOS LAGOS;0;0;0;0;0;0;0;0;0;Procesador TH-9010 Multimixer 1,5Lts Vaso Vidrio;ELECTRODOMESTICOS
9289324;;F;60;CHILENO;;Boomers;QUILPUE                       ;VALPARAISO;0;0;0;0;0;0;0;0;0;Horno Microondas Digital TH-20S01 20Lts;ELECTRODOMESTICOS
12707181;;F;51;CHILENO;;X;RENCA                         ;METROPOLITANA;0;0;0;0;0;0;0;0;0;Hervidor Electrico UT-DUNKEL17P 2Lts Negro;ELECTRODOMESTICOS
17053691;;F;33;CHILENO;;Millenial;RENCA                         ;METROPOLITANA;0;0;0;0;0;0;0;0;0;Combo Hervidor + Batidora;ELECTRODOMESTICOS
19285468;;F;25;CHILENO;;Z;PROVIDENCIA                   ;METROPOLITANA;0;0;0;0;0;0;0;0;0;Licuadora TH-320 Roja/Negro 1,5 Lts Vaso Vidrio;ELECTRODOMESTICOS
19168585;;M;27;CHILENO;;Z;N/D;N/D;0;0;0;0;0;0;0;0;0;Hervidor Electrico HA-3300 2,5Lts Blanco;ELECTRODOMESTICOS
10782281;;M;56;CHILENO;;Boomers;PENAFLOR                      ;METROPOLITANA;0;0;0;0;0;0;0;0;0;Hervidor Electrico UT-DUNKEL17P 2Lts Negro;ELECTRODOMESTICOS
18614470;;F;28;CHILENO;;Millenial;SAN RAMON                     ;METROPOLITANA;0;0;0;0;0;0;0;0;0;Combo Licuadora + Batidora;ELECTRODOMESTICOS
23409916;;M;37;PERUANO;;Extranjero;QUILLOTA                      ;VALPARAISO;0;0;0;0;0;0;0;0;0;Combo Hervidor + Batidora;ELECTRODOMESTICOS
17711332;;M;31;CHILENO;;Millenial;PROVIDENCIA                   ;METROPOLITANA;0;0;0;0;0;0;0;0;0;Hervidor Electrico UT-MANLY17 1,7Lts Negro;ELECTRODOMESTICOS
19076329;Soltero;M;33;CHILENO;;Millenial;PROVIDENCIA                   ;METROPOLITANA;0;0;0;0;0;0;0;0;0;Licuadora TH-501V 1,5Lts Vaso Vidrio;ELECTRODOMESTICOS
7930243;;M;62;CHILENO;;Boomers;PROVIDENCIA                   ;METROPOLITANA;0;0;0;0;0;0;0;0;0;Licuadora Low Cost Roja 1,5Lts Vaso Vidrio;ELECTRODOMESTICOS
20434712;;F;22;CHILENO;;Z;PROVIDENCIA                   ;METROPOLITANA;0;0;0;0;0;0;0;0;0;Batidora Vertical Minipimer UT-KLOT400P;ELECTRODOMESTICOS
10703638;;F;57;CHILENO;;Boomers;RENCA                         ;METROPOLITANA;0;0;0;0;0;0;0;0;0;Batidora Vertical Minipimer UT-KLOT400P;ELECTRODOMESTICOS
16680527;;F;35;CHILENO;;Millenial;N/D;N/D;0;0;0;0;0;0;0;0;0;Plancha UT-KERAMIKTOP 2200Watts Base Ceramica;ELECTRODOMESTICOS
11784166;;M;50;CHILENO;;X;RENCA                         ;METROPOLITANA;0;0;0;0;0;0;0;0;0;Aspiradora TH2220 Arrastre 2200Watts;ELECTRODOMESTICOS
12594526;;F;47;CHILENO;;X;ANCUD                         ;LOS LAGOS;0;0;0;0;0;0;0;0;0;Horno Electrico TH62I 60Lts;ELECTRODOMESTICOS
6400361;;M;72;CHILENO;;Silencioso;RENCA                         ;METROPOLITANA;0;0;0;0;0;0;0;0;0;Licuadora Low Cost Pistacho 1,25Lts Vaso Vidrio;ELECTRODOMESTICOS
10354317;;F;54;CHILENO;;Boomers;OVALLE                        ;COQUIMBO;0;0;0;0;0;0;0;0;0;Aspiradora TH1415 Arrastre 1500Watts;ELECTRODOMESTICOS
10998740;;F;41;CHILENO;;X;LA FLORIDA                    ;METROPOLITANA;0;0;0;0;0;0;0;0;0;Horno Microondas Mecanico M-2030 NG 20Lts;ELECTRODOMESTICOS
19469651;;F;25;CHILENO;;Z;PROVIDENCIA                   ;METROPOLITANA;0;0;0;0;0;0;0;0;0;Licuadora TH-401V Roja 1,75Lts Vaso Vidrio;ELECTRODOMESTICOS
11222488;;F;54;CHILENO;;X;QUILLOTA                      ;VALPARAISO;0;0;0;0;0;0;0;0;0;Hervidor Electrico HE1723 1,7Lts Inox;ELECTRODOMESTICOS
12092722;Casado;F;49;CHILENO;;X;PUCON                         ;ARAUCANIA;0;0;0;0;0;0;0;0;0;Horno Electrico TH-25N01 25Lts;ELECTRODOMESTICOS
8809851;;F;64;CHILENO;;Boomers;QUELLON                       ;LOS LAGOS;0;0;0;0;0;0;0;0;0;Aspiradora TH1415 Arrastre 1500Watts;ELECTRODOMESTICOS
15118509;;F;39;CHILENO;;X;PROVIDENCIA                   ;METROPOLITANA;0;0;0;0;0;0;0;0;0;MOPA A VAPOR SINDELEN MV-1305 GR;ELECTRODOMESTICOS
16401316;;F;35;CHILENO;;Millenial;PROVIDENCIA                   ;METROPOLITANA;0;0;0;0;0;0;0;0;0;Horno Electrico TH62I 60Lts;ELECTRODOMESTICOS
19976459;;M;24;CHILENO;;Z;ALTO HOSPICIO;TARAPACA;0;0;0;0;0;0;0;0;0;Hervidor Electrico Tetera UT-LECKER18R 1,8Lts;ELECTRODOMESTICOS
15046485;Casado;F;38;CHILENO;;X;RENCA                         ;METROPOLITANA;0;0;0;0;0;0;0;0;0;Plancha TH-7052 2000Watts Base Inox;ELECTRODOMESTICOS
25923368;;M;28;VENEZOLANO;;Extranjero;QUINTA NORMAL                 ;METROPOLITANA;0;0;0;0;0;0;0;0;0;Licuadora TH-501V 1,5Lts Vaso Vidrio;ELECTRODOMESTICOS
17443610;Soltero;M;32;CHILENO;MEDICO CIRUJANO;Millenial;PROVIDENCIA                   ;METROPOLITANA;0;0;0;0;0;0;0;0;0;Horno Electrico TH-25N01 25Lts;ELECTRODOMESTICOS
13074783;;F;46;CHILENO;;X;"";"";0;0;0;0;0;0;0;0;0;Batidora Pedestal Desmontable 64650-CL;ELECTRODOMESTICOS
7537782;Casado;M;62;CHILENO;CONTADOR GENERAL;Boomers;PARRAL                        ;MAULE;0;0;0;0;0;0;0;0;0;Horno Electrico TH62I 60Lts;ELECTRODOMESTICOS
9770142;;M;56;CHILENO;;Boomers;TALCA                         ;MAULE;0;0;0;0;0;0;0;0;0;Parrilla Electrica 3006;ELECTRODOMESTICOS
11600592;Casado;F;52;CHILENO;;X;RENCA                         ;METROPOLITANA;0;0;0;0;0;0;0;0;0;Aspiradora TH1870 Arrastre 1800Watts Gris;ELECTRODOMESTICOS
6140655;;M;73;CHILENO;;Silencioso;PROVIDENCIA                   ;METROPOLITANA;0;0;0;0;0;0;0;0;0;Plancha THOMAS TH-7170 2200Watts Base Ceramica;ELECTRODOMESTICOS
8584006;;M;64;CHILENO;;Boomers;VICTORIA                      ;ARAUCANIA;0;0;0;0;0;0;0;0;0;Horno Electrico TH-100i 100Lts;ELECTRODOMESTICOS
6415313;;F;67;CHILENO;;Boomers;LAJA                          ;BIO BIO;0;0;0;0;0;0;0;0;0;Batidora Manual UT-TEKLA300;ELECTRODOMESTICOS
17888271;Soltero;F;31;CHILENO;PSICOPEDAGOGO;Millenial;PROVIDENCIA                   ;METROPOLITANA;0;0;0;0;0;0;0;0;0;Cafetera Dolce Gusto Piccolo Red Nescafe;ELECTRODOMESTICOS
16552586;;F;35;CHILENO;;Millenial;PROVIDENCIA                   ;METROPOLITANA;0;0;0;0;0;0;0;0;0;Cafetera TH-130;ELECTRODOMESTICOS
9776995;;M;59;CHILENO;;Boomers;PROVIDENCIA                   ;METROPOLITANA;0;0;0;0;0;0;0;0;0;Combo Juguera + Hervidor;ELECTRODOMESTICOS
6304979;Viudo;F;71;CHILENO;;Silencioso;RENCA                         ;METROPOLITANA;0;0;0;0;0;0;0;0;0;Horno Electrico TH-25N01 25Lts;ELECTRODOMESTICOS
14169347;;F;42;CHILENO;;X;PUENTE ALTO                   ;METROPOLITANA;0;0;0;0;0;0;0;0;0;Picadora UT-PETRUS320 1Lts Vaso Vidrio;ELECTRODOMESTICOS
11540022;Soltero;M;51;CHILENO;;X;LA FLORIDA                    ;METROPOLITANA;0;0;0;0;0;0;0;0;0;Hervidor Electrico UT-DUNKEL17P 2Lts Negro;ELECTRODOMESTICOS
6629856;;F;69;CHILENO;;Silencioso;CAUQUENES                     ;MAULE;0;0;0;0;0;0;0;0;0;Batidora Manual BA-5010 Inox;ELECTRODOMESTICOS
12447424;;F;48;CHILENO;;X;COQUIMBO                      ;COQUIMBO;0;0;0;0;0;0;0;0;0;Tostador de Pan TH-116 2 Rebanadas Negro;ELECTRODOMESTICOS
19923327;;M;24;CHILENO;;Z;SAGRADA FAMILIA               ;MAULE;0;0;0;0;0;0;0;0;0;Licuadora TH-320 Roja/Negro 1,5 Lts Vaso Vidrio;ELECTRODOMESTICOS
12197294;Casado;F;50;CHILENO;;X;RENCA                         ;METROPOLITANA;0;0;0;0;0;0;0;0;0;Aspiradora TH1630 Arrastre 1600Watts;ELECTRODOMESTICOS
17851062;;M;31;CHILENO;;Millenial;SAN RAMON                     ;METROPOLITANA;0;0;0;0;0;0;0;0;0;Cafetera Dolce Gusto Piccolo Red Nescafe;ELECTRODOMESTICOS
11069507;;F;55;CHILENO;;Boomers;CHIMBARONGO                   ;L.G.B.OÂ´HIGGINS;0;0;0;0;0;0;0;0;0;Horno Electrico UT-LEIF36 36Lts;ELECTRODOMESTICOS
11374741;Casado;F;52;CHILENO;;X;RENCA                         ;METROPOLITANA;0;0;0;0;0;0;0;0;0;Horno Microondas Digital TH-25DM 25Lts;ELECTRODOMESTICOS
19417055;;F;25;CHILENO;;Z;PROVIDENCIA                   ;METROPOLITANA;0;0;0;0;0;0;0;0;0;Horno Electrico TH-25N01 25Lts;ELECTRODOMESTICOS
5870543;;M;73;CHILENO;;Silencioso;CASTRO                        ;LOS LAGOS;0;0;0;0;0;0;0;0;0;Licuadora UT-METALLEK705 1,75Lts Vaso Vidrio;ELECTRODOMESTICOS
8125619;Soltero;F;65;CHILENO;ENFERMERA;Boomers;PROVIDENCIA                   ;METROPOLITANA;0;0;0;0;0;0;0;0;0;Horno Microondas Digital TH-25DM 25Lts;ELECTRODOMESTICOS
5529030;Soltero;M;73;CHILENO;INGENIERO;Silencioso;SANTIAGO                      ;METROPOLITANA;0;0;0;0;0;0;0;0;0;Hervidor Electrico UT-MANLY17 1,7Lts Negro;ELECTRODOMESTICOS
16798034;;F;34;CHILENO;;Millenial;LAMPA;METROPOLITANA;0;0;0;0;0;0;0;0;0;Licuadora 58159-CL 1,4Lts Vaso Tritan;ELECTRODOMESTICOS
5360305;;M;75;CHILENO;;Silencioso;PROVIDENCIA                   ;METROPOLITANA;0;0;0;0;0;0;0;0;0;Horno Electrico TH-48N 48Lts;ELECTRODOMESTICOS
12139709;;F;54;CHILENO;;X;EL BOSQUE                     ;METROPOLITANA;0;0;0;0;0;0;0;0;0;Horno Electrico UT-BACKOFEN48 48Lts;ELECTRODOMESTICOS
13663476;;M;43;CHILENO;;X;PROVIDENCIA                   ;METROPOLITANA;0;0;0;0;0;0;0;0;0;Batidora Vertical Stick Mixer 2609;ELECTRODOMESTICOS
19372557;;M;25;CHILENO;;Millenial;N/D;N/D;0;0;0;0;0;0;0;0;0;Licuadora TH-401V Roja 1,75Lts Vaso Vidrio;ELECTRODOMESTICOS
17682378;;F;32;CHILENO;;Millenial;MELIPILLA                     ;METROPOLITANA;0;0;0;0;0;0;0;0;0;Plancha TH7355 Inalambrica 2200Watts Base Cerami;ELECTRODOMESTICOS
12016632;Soltero;M;49;CHILENO;;X;PROVIDENCIA                   ;METROPOLITANA;0;0;0;0;0;0;0;0;0;Aspiradora AP1700 Arrastre 1700Watts;ELECTRODOMESTICOS
6504254;;F;73;CHILENO;;Silencioso;RENCA                         ;METROPOLITANA;0;0;0;0;0;0;0;0;0;Plancha 6201 2200Watts Base Ceramica;ELECTRODOMESTICOS
7003159;Casado;F;64;CHILENO;PROFESOR;Boomers;PROVIDENCIA                   ;METROPOLITANA;0;0;0;0;0;0;0;0;0;Horno Electrico TH62I 60Lts;ELECTRODOMESTICOS
19367617;;M;25;CHILENO;;Z;PUERTO MONTT;LOS LAGOS;415930;7;5;4;2;225960;3;3;189970;PARLANTE MEGALUX K2777;ELECTRONICA MAYOR
6489596;;F;68;CHILENO;;Boomers;LOS ALAMOS                    ;BIO BIO;880849;6;3;0;0;0;6;3;880849;LED 58 UN58AU7000GXZS UHD 4K SMART TV;ELECTRONICA MAYOR
10458530;;M;57;CHILENO;;Boomers;SAN VICENTE                   ;L.G.B.OÂ´HIGGINS;634020;6;4;0;0;0;6;4;634020;LED 32 UN32T4300AGXZS HD SMART TV;ELECTRONICA MAYOR
9191435;;M;57;CHILENO;;Boomers;NATALES                       ;MAGALLANES;1084410;9;8;-2;1;-1321980;11;7;2406390;LED 58 UN58AU7000GXZS UHD 4K SMART TV;ELECTRONICA MAYOR
14394690;;F;44;CHILENO;;Millenial;"";"";339980;2;2;0;0;0;2;2;339980;LED PHILIPS 50 50PUD7406 ANDROID TV UHD 4K;ELECTRONICA MAYOR
15154918;;F;54;CHILENO;;X;LINARES                       ;MAULE;431110;8;6;0;0;0;8;6;431110;LED 42 42S6500 ANDROID TV FHD;ELECTRONICA MAYOR
12891040;Soltero;M;46;CHILENO;;X;RENCA                         ;METROPOLITANA;189990;1;1;0;0;0;1;1;189990;LED 43 43S5305 SMART TV FULL HD;ELECTRONICA MAYOR
9124195;Casado;F;61;CHILENO;;Boomers;PROVIDENCIA                   ;METROPOLITANA;279980;2;1;2;1;279980;0;0;0;LED SAMSUNG 50 AU7090 CRYSTAL UHD 4K SMART TV 20;ELECTRONICA MAYOR
10071777;;F;53;CHILENO;;X;N/D;N/D;223220;2;1;0;0;0;2;1;223220;LED 42 KHFH4221 SMART TV;ELECTRONICA MAYOR
7254990;;M;65;CHILENO;;Boomers;PUDAHUEL                      ;METROPOLITANA;962910;10;2;0;0;0;10;2;962910;LED 58 UN58AU7000GXZS UHD 4K SMART TV;ELECTRONICA MAYOR
19721240;;F;24;CHILENO;;Millenial;PROVIDENCIA                   ;METROPOLITANA;657140;4;2;0;0;0;4;2;657140;LED 55 KEUH5521 SMART TV UHD;ELECTRONICA MAYOR
15166855;;M;45;CHILENO;;X;RENCA                         ;METROPOLITANA;189990;1;1;1;1;189990;0;0;0;LED 50 KEUH50 SMART TV UHD;ELECTRONICA MAYOR
18221658;;M;29;CHILENO;;Millenial;N/D;N/D;259990;1;1;0;0;0;1;1;259990;LED PHILIPS 43 43PUD7406 ANDROID TV UHD 4K;ELECTRONICA MAYOR
15684608;;F;39;CHILENO;;X;GRANEROS;O HIGGINS;386960;4;4;6;3;751500;-2;1;-364540;LED KIOTO 32 MI3228 SMART TV;ELECTRONICA MAYOR
8081762;;F;58;CHILENO;;Boomers;COIHAIQUE                     ;AYSEN;1792490;11;5;0;0;0;11;5;1792490;LED 65 KEUH6521 SMART TV UHD;ELECTRONICA MAYOR
10181930;;M;48;CHILENO;;X;LOS ANGELES                   ;BIO BIO;251790;2;1;0;0;0;2;1;251790;PARLANTE ULTRA BOOSTER Z2;ELECTRONICA MAYOR
18923157;;M;27;CHILENO;;Millenial;LA SERENA                     ;COQUIMBO;269990;1;1;1;1;269990;0;0;0;LED SAMSUNG 50 AU7090 CRYSTAL UHD 4K SMART TV 20;ELECTRONICA MAYOR
17055293;;F;46;CHILENO;;X;LA SERENA;COQUIMBO;127992;1;1;0;0;0;1;1;127992;LED 40 KEHD4020 SMART TV;ELECTRONICA MAYOR
18218881;;M;29;CHILENO;;Millenial;VALLENAR;ATACAMA;917590;7;4;5;3;587610;2;1;329980;LED 55 55P615 UHD ANDROID TV 4K;ELECTRONICA MAYOR
18074089;Soltero;M;30;CHILENO;;Millenial;RENCA                         ;METROPOLITANA;193980;2;3;0;0;0;2;3;193980;LED LG 32 SMART TV FHD 32LQ630BPSA.AWH;ELECTRONICA MAYOR
7240827;;F;75;CHILENO;;Silencioso;LA LIGUA                      ;VALPARAISO;1034230;6;4;0;0;0;6;4;1034230;LED 43 43S5195 ROKU TV FHD;ELECTRONICA MAYOR
6803974;;M;69;CHILENO;;Silencioso;MAIPU                         ;METROPOLITANA;513950;6;3;4;1;479970;2;2;33980;LED 58 UN58AU7000GXZS UHD 4K SMART TV;ELECTRONICA MAYOR
12270233;;F;50;CHILENO;;X;PENALOLEN                     ;METROPOLITANA;479960;4;5;0;0;0;4;5;479960;LED 40 40S65A-40P ANDROID TV SMART LINE FHD;ELECTRONICA MAYOR
10621728;;M;54;CHILENO;;Boomers;RENCA                         ;METROPOLITANA;310180;6;3;0;0;0;6;3;310180;LED 32 32PHD6825 HD SMART TV;ELECTRONICA MAYOR
25975879;Soltero;F;30;VENEZOLANO;;Millenial;PROVIDENCIA                   ;METROPOLITANA;113980;2;1;2;1;113980;0;0;0;LED 32 32PHD6825 HD SMART TV;ELECTRONICA MAYOR
6983051;;F;71;CHILENO;;Silencioso;SAN FERNANDO                  ;L.G.B.OÂ´HIGGINS;618950;5;6;0;0;0;5;6;618950;MINICOMPONENTE CJ45;ELECTRONICA MAYOR
15005822;;M;40;CHILENO;;X;ARICA                         ;ARICA Y PARINACOTA;359990;1;1;0;0;0;1;1;359990;LED 55UP7500 UHD SMART;ELECTRONICA MAYOR
8121860;;M;65;CHILENO;;Boomers;N/D;N/D;167500;2;1;0;0;0;2;1;167500;PARLANTE KARAOKE K3421;ELECTRONICA MAYOR
19796268;;M;24;CHILENO;;Z;N/D;N/D;555920;4;2;0;0;0;4;2;555920;LED 50 KEUH50 SMART TV UHD;ELECTRONICA MAYOR
16665881;;M;35;CHILENO;;Millenial;CERRO NAVIA                   ;METROPOLITANA;1497850;15;12;7;5;713930;8;7;783920;LED 40 KEHD4020 SMART TV;ELECTRONICA MAYOR
7581319;;F;68;CHILENO;;Silencioso;LA PINTANA                    ;METROPOLITANA;1116840;5;2;0;0;0;5;2;1116840;LED SAMSUNG 55 4K UHD SMART TV UN55AU7090GXZS;ELECTRONICA MAYOR
11760378;Casado;M;51;CHILENO;;X;RENCA                         ;METROPOLITANA;108980;2;1;2;1;108980;0;0;0;LED 32 32PHD6825 HD SMART TV;ELECTRONICA MAYOR
12185197;;F;50;CHILENO;;X;PEMUCO                        ;BIO BIO;479980;4;2;0;0;0;4;2;479980;LED 55 KEUH5521 SMART TV UHD;ELECTRONICA MAYOR
6903179;;F;71;CHILENO;;Silencioso;VINA DEL MAR                  ;VALPARAISO;703390;11;5;0;0;0;11;5;703390;LED 32 UN32T4300AGXZS HD SMART TV;ELECTRONICA MAYOR
11599658;;M;52;CHILENO;;X;TOCOPILLA                     ;ANTOFAGASTA;390970;3;2;0;0;0;3;2;390970;LED 55 55P615 UHD ANDROID TV 4K;ELECTRONICA MAYOR
15360627;;F;38;CHILENO;;Millenial;N/D;N/D;263742;5;3;0;0;0;5;3;263742;LED 42 KHFH4221 SMART TV;ELECTRONICA MAYOR
10131841;;F;58;CHILENO;;Boomers;FREIRINA                      ;ATACAMA;512900;3;1;0;0;0;3;1;512900;LED SAMSUNG 55 4K UHD SMART TV UN55AU7090GXZS;ELECTRONICA MAYOR
6962443;Casado;M;70;CHILENO;;Silencioso;BULNES                        ;BIO BIO;325540;5;3;0;0;0;5;3;325540;LED 32 32PHD6825 HD SMART TV;ELECTRONICA MAYOR
8023234;;M;64;CHILENO;;Boomers;N/D;N/D;299960;4;3;0;0;0;4;3;299960;LED 32 32PHD6825 HD SMART TV;ELECTRONICA MAYOR
10336347;;M;55;CHILENO;;Boomers;LOS ANDES                     ;VALPARAISO;531960;4;2;0;0;0;4;2;531960;LED 42 KHFH4221 SMART TV;ELECTRONICA MAYOR
7655074;;F;68;CHILENO;;Silencioso;CURICO                        ;MAULE;351840;5;4;0;0;0;5;4;351840;LED 40 40S65A-40P ANDROID TV SMART LINE FHD;ELECTRONICA MAYOR
17569761;;F;32;CHILENO;;Millenial;CONCEPCION                    ;BIO BIO;1014370;11;3;0;0;0;11;3;1014370;LED 43 43UP7500 UHD SMART TV;ELECTRONICA MAYOR
16491124;;F;35;CHILENO;;Millenial;LAS CABRAS                    ;L.G.B.OÂ´HIGGINS;355951;6;3;4;2;155960;2;1;199991;LED 32 32PHD6825 HD SMART TV;ELECTRONICA MAYOR
8572438;;F;61;CHILENO;;Boomers;RENCA                         ;METROPOLITANA;149990;1;1;0;0;0;1;1;149990;LED 32 32S60-32P ANDROID TV SMART LINE HD;ELECTRONICA MAYOR
8577037;;M;61;CHILENO;;Boomers;PROVIDENCIA                   ;METROPOLITANA;169990;1;1;0;0;0;1;1;169990;LED 43 CS43S1USM UHD SMART TV NEGRO;ELECTRONICA MAYOR
7651281;;F;67;CHILENO;;Boomers;FLORIDA                       ;BIO BIO;256452;4;2;0;0;0;4;2;256452;LED 32 32S5305 HD HDR10/HLG;ELECTRONICA MAYOR
12287404;;F;49;CHILENO;;X;FRESIA                        ;LOS LAGOS;1864280;7;3;0;0;0;7;3;1864280;LED 70 UN70AU7000GXZS UHD;ELECTRONICA MAYOR
10485025;;F;56;CHILENO;;Boomers;N/D;N/D;227970;3;2;0;0;0;3;2;227970;LED 42 KHFH4221 SMART TV;ELECTRONICA MAYOR
17491264;;M;31;CHILENO;;Millenial;PUDAHUEL;METROPOLITANA;133980;2;1;2;1;133980;0;0;0;LED 32 32PHD6825 HD SMART TV;ELECTRONICA MAYOR
4683447;;F;79;CHILENO;;Silencioso;TOCOPILLA                     ;ANTOFAGASTA;939829;7;3;0;0;0;7;3;939829;LED 58 KEUH5821 SMART TV UHD;ELECTRONICA MAYOR
26895074;;F;34;EXTRANJERO - NO INFORMA NACIONALIDAD;;Extranjero;TALCA;MAULE;179990;1;1;0;0;0;1;1;179990;LED 42 42S6500 ANDROID TV FHD;ELECTRONICA MAYOR
18147257;;M;30;CHILENO;;Millenial;TEMUCO                        ;ARAUCANIA;250470;3;2;0;0;0;3;2;250470;MINICOMPONENTE RN5;ELECTRONICA MAYOR
8051203;Soltero;F;62;CHILENO;;Boomers;PROVIDENCIA                   ;METROPOLITANA;340930;2;1;0;0;0;2;1;340930;LED 43 43UP7500 UHD SMART TV;ELECTRONICA MAYOR
4955523;;M;79;CHILENO;;Silencioso;MELIPILLA                     ;METROPOLITANA;1460390;11;4;0;0;0;11;4;1460390;LED 55UP7500 UHD SMART;ELECTRONICA MAYOR
12899452;;M;46;CHILENO;;X;N/D;N/D;398063;4;2;0;0;0;4;2;398063;LED SAMSUNG 50 AU7090 CRYSTAL UHD 4K SMART TV 20;ELECTRONICA MAYOR
15724694;;M;38;CHILENO;;X;CERRO NAVIA;METROPOLITANA;202970;4;2;4;2;202970;0;0;0;LED 42 42S6500 ANDROID TV FHD;ELECTRONICA MAYOR
10838977;;M;54;CHILENO;;Boomers;SAN FERNANDO                  ;L.G.B.OÂ´HIGGINS;212980;2;1;0;0;0;2;1;212980;LED 43 43S5195 ROKU TV FHD;ELECTRONICA MAYOR
11195212;Casado;F;54;CHILENO;;Boomers;RENCA                         ;METROPOLITANA;210980;2;2;2;2;210980;0;0;0;LED 32 UN32T4300AGXZS HD SMART TV;ELECTRONICA MAYOR
15955345;;F;37;CHILENO;;Millenial;CORONEL                       ;BIO BIO;695152;7;4;0;0;0;7;4;695152;PARLANTE ULTRA BOOSTER Z2;ELECTRONICA MAYOR
15854093;;M;38;CHILENO;;Millenial;PROVIDENCIA                   ;METROPOLITANA;261370;3;2;0;0;0;3;2;261370;PARLANTE ULTRAMAGIC;ELECTRONICA MAYOR
5844432;;F;75;CHILENO;;Silencioso;TOCOPILLA                     ;ANTOFAGASTA;1665790;13;8;2;1;399980;11;7;1265810;PARLANTE KARAOKE K3421;ELECTRONICA MAYOR
15287668;;F;40;CHILENO;;X;PROVIDENCIA                   ;METROPOLITANA;209970;3;1;0;0;0;3;1;209970;LED 32 AOC ROKU TV HD 32S5195;ELECTRONICA MAYOR
5739943;;M;76;CHILENO;;Silencioso;RENCA                         ;METROPOLITANA;340930;2;1;0;0;0;2;1;340930;LED 55 KEUH5521 SMART TV UHD;ELECTRONICA MAYOR
4521941;;M;79;CHILENO;;Silencioso;LO ESPEJO                     ;METROPOLITANA;34980;3;2;0;0;0;3;2;34980;PARLANTE SCREAMER 3;ELECTRONICA MAYOR
13169666;;F;45;CHILENO;;X;CASTRO                        ;LOS LAGOS;581340;6;3;0;0;0;6;3;581340;LED 40 KEHD4020 SMART TV;ELECTRONICA MAYOR
17333154;;F;32;CHILENO;;Millenial;"";"";57980;2;2;0;0;0;2;2;57980;PARLANTE KARAOKE 12 FM/BT/USB;ELECTRONICA MAYOR
22926047;;M;46;NO INFORMA NACIONALIDAD;;Extranjero;SANTIAGO                      ;METROPOLITANA;449990;1;1;0;0;0;1;1;449990;LED 60UP7750 UHD SMART + MAGIC;ELECTRONICA MAYOR
26014418;;M;49;VENEZOLANO;;Extranjero;"";"";319990;1;1;1;1;319990;0;0;0;LED SAMSUNG 50 AU7090 CRYSTAL UHD 4K SMART TV 20;ELECTRONICA MAYOR
8988414;;F;62;CHILENO;;Boomers;CURANILAHUE                   ;BIO BIO;369950;5;4;0;0;0;5;4;369950;LED 32 AOC ROKU TV HD 32S5195;ELECTRONICA MAYOR
16528829;;F;35;CHILENO;;Millenial;PROVIDENCIA                   ;METROPOLITANA;149980;2;2;0;0;0;2;2;149980;LED KIOTO 32 MI3228 SMART TV;ELECTRONICA MAYOR
8485474;;F;50;CHILENO;;X;N/D;N/D;333440;5;3;0;0;0;5;3;333440;LED 40 KEHD4020 SMART TV;ELECTRONICA MAYOR
14900410;;M;40;CHILENO;;X;VALLENAR;ATACAMA;518143;6;5;0;0;0;6;5;518143;LED 43 43S5195 ROKU TV FHD;ELECTRONICA MAYOR
17839107;Soltero;M;30;CHILENO;;Millenial;PROVIDENCIA                   ;METROPOLITANA;196980;2;1;0;0;0;2;1;196980;LED 43 43S5195 ROKU TV FHD;ELECTRONICA MAYOR
10674078;Soltero;M;56;CHILENO;INGENIERO AGRICOLA;Boomers;RENCA                         ;METROPOLITANA;372980;2;1;0;0;0;2;1;372980;LED SAMSUNG 50 AU7090 CRYSTAL UHD 4K SMART TV 20;ELECTRONICA MAYOR
8212706;;F;65;CHILENO;;Boomers;ANTOFAGASTA                   ;ANTOFAGASTA;179990;1;1;0;0;0;1;1;179990;LED 42 42S6500 ANDROID TV FHD;ELECTRONICA MAYOR
25013486;;M;48;HAITIANO;;Extranjero;SANTIAGO                      ;METROPOLITANA;292979;2;1;0;0;0;2;1;292979;LED 50 KEUH50 SMART TV UHD;ELECTRONICA MAYOR
5244562;;M;77;CHILENO;;Silencioso;LOS ANDES                     ;VALPARAISO;322970;3;3;0;0;0;3;3;322970;LED 43 43UP7500 UHD SMART TV;ELECTRONICA MAYOR
17976141;;F;30;CHILENO;;Millenial;SAN CARLOS                    ;BIO BIO;630380;11;3;0;0;0;11;3;630380;LED LG 32 SMART TV FHD 32LQ630BPSA.AWH;ELECTRONICA MAYOR
19211668;;F;26;CHILENO;;Z;ISLA DE MAIPO                 ;METROPOLITANA;438540;4;2;0;0;0;4;2;438540;PARLANTE SCREAMER 3;ELECTRONICA MAYOR
19522129;;F;25;CHILENO;;Z;N/D;N/D;199990;1;1;1;1;199990;0;0;0;LED 58 KEUH5821 SMART TV UHD;ELECTRONICA MAYOR
16955609;;M;33;CHILENO;;Millenial;LO PRADO;METROPOLITANA;259980;2;3;3;1;243970;-1;2;16010;LED 58 KEUH5821 SMART TV UHD;ELECTRONICA MAYOR
15188849;Casado;F;40;CHILENO;TECNICO EN ENFERMERIA DE NIVEL SUPERIOR;X;RENCA                         ;METROPOLITANA;229990;1;1;1;1;229990;0;0;0;LED 58 KEUH5821 SMART TV UHD;ELECTRONICA MAYOR
15853705;;M;38;CHILENO;;Millenial;PROVIDENCIA                   ;METROPOLITANA;159990;1;1;1;1;159990;0;0;0;LED 40 KEHD4020 SMART TV;ELECTRONICA MAYOR
13313578;;M;44;CHILENO;;X;CONCEPCION                    ;BIO BIO;129990;1;3;0;0;0;1;3;129990;LED 40 KEHD4020 SMART TV;ELECTRONICA MAYOR
18599915;;F;28;CHILENO;;Millenial;N/D;N/D;1438500;9;7;3;2;244970;6;5;1193530;LED 50 KEUH50 SMART TV UHD;ELECTRONICA MAYOR
9648984;;M;49;CHILENO;;X;RECOLETA                      ;METROPOLITANA;247160;2;1;0;0;0;2;1;247160;LED 55 KEUH5521 SMART TV UHD;ELECTRONICA MAYOR
17306141;;F;32;CHILENO;;Millenial;QUINTA NORMAL;METROPOLITANA;432960;4;3;0;0;0;4;3;432960;LED 58 KEUH5821 SMART TV UHD;ELECTRONICA MAYOR
26824144;;M;40;EXTRANJERO - NO INFORMA NACIONALIDAD ;;Extranjero;VALLENAR;ATACAMA;290000;2;1;0;0;0;2;1;290000;LED 50 50UP7500 UHD SMART TV;ELECTRONICA MAYOR
8058403;;F;60;CHILENO;;Boomers;RENCA                         ;METROPOLITANA;199990;1;1;1;1;199990;0;0;0;LED 43 UN43T5202AGXZS FHD SMART TV;ELECTRONICA MAYOR
9108949;;M;58;CHILENO;;Boomers;CASTRO                        ;LOS LAGOS;1700990;12;6;0;0;0;12;6;1700990;LED 40 KEHD4020 SMART TV;ELECTRONICA MAYOR
19050949;;F;27;CHILENO;;Z;PROVIDENCIA                   ;METROPOLITANA;201980;2;1;2;1;201980;0;0;0;LED 50 KEUH50 SMART TV UHD;ELECTRONICA MAYOR
15808431;;M;38;CHILENO;;Millenial;PUREN                         ;ARAUCANIA;482361;6;6;0;0;0;6;6;482361;LED 55 KEUH5521 SMART TV UHD;ELECTRONICA MAYOR
20036224;;F;23;CHILENO;;Millenial;PROVIDENCIA                   ;METROPOLITANA;28990;1;1;0;0;0;1;1;28990;SOUNDBAR BLIK SURREAL 2.0;ELECTRONICA MAYOR
7703601;;F;63;CHILENO;;Boomers;IQUIQUE                       ;TARAPACA;488110;3;2;0;0;0;3;2;488110;LED 43 43S5195 ROKU TV FHD;ELECTRONICA MAYOR
17927160;;M;30;CHILENO;;Millenial;PROVIDENCIA                   ;METROPOLITANA;199990;1;1;0;0;0;1;1;199990;LED 55 KEUH5521 SMART TV UHD;ELECTRONICA MAYOR
13719237;;F;43;CHILENO;;X;RANCAGUA                      ;L.G.B.OÂ´HIGGINS;1013860;14;6;3;1;247970;11;5;765890;LED 40 KEHD4020 SMART TV;ELECTRONICA MAYOR
19266791;;M;32;CHILENO;;Millenial;ANCUD                         ;LOS LAGOS;878900;12;6;0;0;0;12;6;878900;MINICOMPONENTE RN7;ELECTRONICA MAYOR
20767602;;F;21;CHILENO;;Z;TALCA;MAULE;199990;1;1;1;1;199990;0;0;0;LED 58 KEUH5821 SMART TV UHD;ELECTRONICA MAYOR
11517947;;M;52;CHILENO;;X;N/D;N/D;1498170;6;6;0;0;0;6;6;1498170;LED 60UP7750 UHD SMART + MAGIC;ELECTRONICA MAYOR
5053184;;F;78;CHILENO;;Silencioso;LAJA                          ;BIO BIO;166980;2;1;0;0;0;2;1;166980;LED 42 KHFH4221 SMART TV;ELECTRONICA MAYOR
10681692;;F;55;CHILENO;;Boomers;CALERA                        ;VALPARAISO;379960;4;3;0;0;0;4;3;379960;LED 40 KEHD4020 SMART TV;ELECTRONICA MAYOR
15864239;;F;37;CHILENO;;Millenial;"";"";110000;2;1;0;0;0;2;1;110000;SOUNDBAR SP2;ELECTRONICA MAYOR
6016256;;M;73;CHILENO;;Silencioso;RENCA                         ;METROPOLITANA;211970;3;3;0;0;0;3;3;211970;MINICOMPONENTE CJ45;ELECTRONICA MAYOR
10460353;;M;55;CHILENO;;Boomers;CONSTITUCION                  ;MAULE;806580;6;3;0;0;0;6;3;806580;LED 65 KEUH6521 SMART TV UHD;ELECTRONICA MAYOR
15059010;;M;37;CHILENO;;Millenial;CABILDO                       ;VALPARAISO;139990;1;1;1;1;139990;0;0;0;LED 40 KEHD4020 SMART TV;ELECTRONICA MAYOR
17234270;;F;37;CHILENO;;Millenial;COIHAIQUE                     ;AYSEN;791911;9;6;1;1;199990;8;5;591921;LED 58 KEUH5821 SMART TV UHD;ELECTRONICA MAYOR
14074091;;F;41;CHILENO;;X;VICTORIA                      ;ARAUCANIA;390790;2;1;0;0;0;2;1;390790;LED SAMSUNG 50 AU7090 CRYSTAL UHD 4K SMART TV 20;ELECTRONICA MAYOR
19974995;;M;23;CHILENO;;Z;SAN ANTONIO                   ;VALPARAISO;140000;2;1;0;0;0;2;1;140000;PARLANTE ULTRABUZZ;ELECTRONICA MAYOR
16562894;;F;30;CHILENO;;Millenial;LAMPA;METROPOLITANA;547920;8;6;6;3;167940;2;3;379980;PARLANTE SCREAMER 3;ELECTRONICA MAYOR
11549426;;F;52;CHILENO;;X;N/D;N/D;673429;4;2;0;0;0;4;2;673429;LED 60UP7750 UHD SMART + MAGIC;ELECTRONICA MAYOR
20034721;;M;23;CHILENO;;Z;CHEPICA;O HIGGINS;169990;1;1;1;1;169990;0;0;0;LED 50 KEUH50 SMART TV UHD;ELECTRONICA MAYOR
7030323;;M;66;CHILENO;;Boomers;QUILPUE                       ;VALPARAISO;505280;4;3;0;0;0;4;3;505280;LED 55 KEUH5521 SMART TV UHD;ELECTRONICA MAYOR
8977044;Casado;F;57;CHILENO;PROFESOR;Boomers;RENCA                         ;METROPOLITANA;166990;3;1;0;0;0;3;1;166990;LED 40 KEHD4020 SMART TV;ELECTRONICA MAYOR
13745913;;M;42;CHILENO;;X;OVALLE                        ;COQUIMBO;529980;2;2;0;0;0;2;2;529980;LED 58 KEUH5821 SMART TV UHD;ELECTRONICA MAYOR
17965615;Soltero;M;31;CHILENO;;Millenial;PROVIDENCIA                   ;METROPOLITANA;474970;3;2;1;1;179990;2;1;294980;LED 50 KEUH50 SMART TV UHD;ELECTRONICA MAYOR
13887545;;M;42;CHILENO;;X;RECOLETA                      ;METROPOLITANA;192990;3;2;0;0;0;3;2;192990;LED 55 KEUH5521 SMART TV UHD;ELECTRONICA MAYOR
14097380;;F;44;CHILENO;;X;DALCAHUE                      ;LOS LAGOS;207780;3;1;0;0;0;3;1;207780;LED 40 KEHD4020 SMART TV;ELECTRONICA MAYOR
17712660;;M;31;CHILENO;;Millenial;CALAMA;ANTOFAGASTA;1316750;7;5;1;1;189990;6;4;1126760;LED 65 KEUH6521 SMART TV UHD;ELECTRONICA MAYOR
15489708;;F;39;CHILENO;;X;PUENTE ALTO                   ;METROPOLITANA;296310;7;3;0;0;0;7;3;296310;MINICOMPONENTE RN5;ELECTRONICA MAYOR
15116024;Soltero;M;35;CHILENO;;Millenial;PROVIDENCIA                   ;METROPOLITANA;129990;1;1;0;0;0;1;1;129990;LED KIOTO 32 MI3228 SMART TV;ELECTRONICA MAYOR
7728909;;F;64;CHILENO;;Boomers;PUENTE ALTO                   ;METROPOLITANA;173990;2;1;0;0;0;2;1;173990;LED 40 KEHD4020 SMART TV;ELECTRONICA MAYOR
19479864;;M;26;CHILENO;;Z;CARAHUE                       ;ARAUCANIA;199990;1;1;0;0;0;1;1;199990;LED 50 KEUH50 SMART TV UHD;ELECTRONICA MAYOR
15913429;Soltero;F;37;CHILENO;INGENIERA FORESTAL;Millenial;PROVIDENCIA                   ;METROPOLITANA;198960;4;1;0;0;0;4;1;198960;LED 32 32S5305 HD HDR10/HLG;ELECTRONICA MAYOR
4732420;;F;78;CHILENO;;Silencioso;TALCA                         ;MAULE;430840;3;1;0;0;0;3;1;430840;QLED 50 50C725 ANDROID TV 4K UHD;ELECTRONICA MAYOR
11945332;;M;50;CHILENO;;X;SAN ANTONIO                   ;VALPARAISO;164000;3;1;0;0;0;3;1;164000;LED 40 KEHD4020 SMART TV;ELECTRONICA MAYOR
18616411;;F;28;CHILENO;;Millenial;N/D;N/D;572771;7;4;2;1;174540;5;3;398231;LED 43 43S5195 ROKU TV FHD;ELECTRONICA MAYOR
17399807;;M;32;CHILENO;;Millenial;PROVIDENCIA                   ;METROPOLITANA;439980;2;2;2;2;439980;0;0;0;LED 50 UN50TU7090GXZS UHD SMART TV;ELECTRONICA MAYOR
9244233;;F;57;CHILENO;;Boomers;N/D;N/D;449130;5;3;0;0;0;5;3;449130;LED 43 43UP7500 UHD SMART TV;ELECTRONICA MAYOR
8036914;;F;61;CHILENO;;Boomers;RENCA                         ;METROPOLITANA;163980;2;1;2;1;163980;0;0;0;LED 32 UN32T4300AGXZS HD SMART TV;ELECTRONICA MAYOR
16783315;;F;34;CHILENO;;Millenial;N/D;N/D;352960;4;2;2;1;107980;2;1;244980;LED 65 KEUH6521 SMART TV UHD;ELECTRONICA MAYOR
16299912;;M;35;CHILENO;;Millenial;N/D;N/D;195970;3;2;1;1;179990;2;1;15980;LED 32 UN32T4300AGXZS HD SMART TV;ELECTRONICA MAYOR
12358323;;F;49;CHILENO;;X;TALCA                         ;MAULE;519990;1;1;0;0;0;1;1;519990;LED 65 65P725 ANDROID TV 4K UHD;ELECTRONICA MAYOR
11592340;Soltero;M;51;CHILENO;;X;NATALES                       ;MAGALLANES;742950;5;8;0;0;0;5;8;742950;LED 32 32PHD6825 HD SMART TV;ELECTRONICA MAYOR
18231064;;M;30;CHILENO;;Millenial;TOCOPILLA                     ;ANTOFAGASTA;288960;4;3;2;1;221980;2;2;66980;LED 50 KEUH50 SMART TV UHD;ELECTRONICA MAYOR
10735285;;F;55;CHILENO;;Boomers;TALAGANTE                     ;METROPOLITANA;330000;2;1;0;0;0;2;1;330000;LED 55 55P615 UHD ANDROID TV 4K;ELECTRONICA MAYOR
16695211;;M;34;CHILENO;;Millenial;"";"";247960;4;2;4;2;247960;0;0;0;LED 40 KEHD4020 SMART TV;ELECTRONICA MAYOR
17639855;;M;31;CHILENO;;Millenial;CALBUCO                       ;LOS LAGOS;571960;4;4;0;0;0;4;4;571960;LED KIOTO 32 MI3228 SMART TV;ELECTRONICA MAYOR
15464339;;M;39;CHILENO;;X;EL BOSQUE                     ;METROPOLITANA;439740;5;1;0;0;0;5;1;439740;LED 55 55P615 UHD ANDROID TV 4K;ELECTRONICA MAYOR
17791008;Casado;F;31;CHILENO;;Millenial;PROVIDENCIA                   ;METROPOLITANA;106980;2;1;2;1;106980;0;0;0;LED 65 KEUH6521 SMART TV UHD;ELECTRONICA MAYOR
19978654;;M;23;CHILENO;;Z;IQUIQUE                       ;TARAPACA;369980;2;1;2;1;369980;0;0;0;LED 58 UN58AU7000GXZS UHD 4K SMART TV;ELECTRONICA MAYOR
17290167;;F;33;CHILENO;;Millenial;PROVIDENCIA                   ;METROPOLITANA;309990;1;1;0;0;0;1;1;309990;LED 50 UN50TU7090GXZS UHD SMART TV;ELECTRONICA MAYOR
7141939;;F;69;CHILENO;;Silencioso;TALCA                         ;MAULE;207980;2;1;2;1;207980;0;0;0;LED 43 UN43T5202AGXZS FHD SMART TV;ELECTRONICA MAYOR
15286549;;M;46;CHILENO;;X;PROVIDENCIA                   ;METROPOLITANA;588940;6;3;0;0;0;6;3;588940;LED 58 KEUH5821 SMART TV UHD;ELECTRONICA MAYOR
17504831;;F;32;CHILENO;;Millenial;"";"";181980;2;1;2;1;181980;0;0;0;LED 50 KEUH50 SMART TV UHD;ELECTRONICA MAYOR
14436098;;M;51;CHILENO;;X;"";"";199980;2;1;2;1;199980;0;0;0;LED 55 KEUH5521 SMART TV UHD;ELECTRONICA MAYOR
17588343;;F;31;CHILENO;;Millenial;PUNTA ARENAS                  ;MAGALLANES;531460;4;2;4;2;531460;0;0;0;LED 50 UN50TU7090GXZS UHD SMART TV;ELECTRONICA MAYOR
19145415;Soltero;F;26;CHILENO;;Z;FREIRINA                      ;ATACAMA;456350;4;3;1;1;169990;3;2;286360;LED 50 KEUH50 SMART TV UHD;ELECTRONICA MAYOR
11528379;;F;52;CHILENO;;X;PROVIDENCIA                   ;METROPOLITANA;213360;3;1;0;0;0;3;1;213360;LED 32 32S60-32P ANDROID TV SMART LINE HD;ELECTRONICA MAYOR
12037506;;F;53;CHILENO;;X;PUENTE ALTO                   ;METROPOLITANA;229990;1;1;0;0;0;1;1;229990;LED 43 UN43T5202AGXZS FHD SMART TV;ELECTRONICA MAYOR
13525831;Casado;M;43;CHILENO;;X;CORONEL                       ;BIO BIO;453940;5;2;0;0;0;5;2;453940;LED 50 UN50TU7090GXZS UHD SMART TV;ELECTRONICA MAYOR
11258936;;F;54;CHILENO;;X;N/D;N/D;895110;9;4;0;0;0;9;4;895110;LED 32 UN32T4300AGXZS HD SMART TV;ELECTRONICA MAYOR
13522792;;F;44;CHILENO;;X;OSORNO                        ;LOS LAGOS;181980;2;2;0;0;0;2;2;181980;LED 50 KEUH50 SMART TV UHD;ELECTRONICA MAYOR
12948583;;M;46;CHILENO;;X;PUTAENDO                      ;VALPARAISO;428410;5;7;0;0;0;5;7;428410;LED 43 Full HD Smart TV 43PFD6825;ELECTRONICA MAYOR
17744696;;F;31;CHILENO;;Millenial;N/D;N/D;689960;6;4;1;1;169990;5;3;519970;LED 43 43S5195 ROKU TV FHD;ELECTRONICA MAYOR
13077561;Soltero;M;46;CHILENO;;X;PROVIDENCIA                   ;METROPOLITANA;218980;2;1;2;1;218980;0;0;0;LED 55 KEUH5521 SMART TV UHD;ELECTRONICA MAYOR
20136239;;F;23;CHILENO;;Z;ISLA DE MAIPO                 ;METROPOLITANA;339990;1;1;0;0;0;1;1;339990;LED 55 55P615 UHD ANDROID TV 4K;ELECTRONICA MAYOR
25441846;;F;27;COLOMBIANO;;Extranjero;N/D;N/D;159990;1;1;1;1;159990;0;0;0;LED 50 KEUH50 SMART TV UHD;ELECTRONICA MAYOR
20135797;;M;22;CHILENO;;Millenial;PROVIDENCIA                   ;METROPOLITANA;159990;1;1;1;1;159990;0;0;0;LED 50 KEUH50 SMART TV UHD;ELECTRONICA MAYOR
7589206;Casado;M;68;CHILENO;;Boomers;LOTA                          ;BIO BIO;130000;2;1;0;0;0;2;1;130000;LED KIOTO 32 MI3228 SMART TV;ELECTRONICA MAYOR
19850738;;M;24;CHILENO;;Z;SAN VICENTE                   ;L.G.B.OÂ´HIGGINS;172980;2;1;0;0;0;2;1;172980;LED 42 KHFH4221 SMART TV;ELECTRONICA MAYOR
19413093;;M;25;CHILENO;;Z;EL MONTE                      ;METROPOLITANA;159990;1;1;0;0;0;1;1;159990;LED 32 32S60-32P ANDROID TV SMART LINE HD;ELECTRONICA MAYOR
20179205;;F;22;CHILENO;;Z;SAN FERNANDO;O HIGGINS;142980;2;1;2;1;142980;0;0;0;LED KIOTO 32 MI3228 SMART TV;ELECTRONICA MAYOR
14363201;;F;42;CHILENO;;Z;PROVIDENCIA                   ;METROPOLITANA;179990;1;1;1;1;179990;0;0;0;LED 50 KEUH50 SMART TV UHD;ELECTRONICA MAYOR
10207556;;M;55;CHILENO;;Boomers;CORONEL                       ;BIO BIO;149990;1;1;0;0;0;1;1;149990;MINICOMPONENTE RN5;ELECTRONICA MAYOR
17892984;Soltero;F;31;CHILENO;PSICOPEDAGOGO;Millenial;PROVIDENCIA                   ;METROPOLITANA;179990;1;1;1;1;179990;0;0;0;LED 50 KEUH50 SMART TV UHD;ELECTRONICA MAYOR
13512540;;M;43;CHILENO;;X;N/D;N/D;291950;6;8;3;2;227980;3;6;63970;LED 43 UN43T5202AGXZS FHD SMART TV;ELECTRONICA MAYOR
19519581;;M;25;CHILENO;;Z;TEMUCO                        ;ARAUCANIA;226980;2;1;0;0;0;2;1;226980;LED 50 KEUH50 SMART TV UHD;ELECTRONICA MAYOR
20270534;;M;22;CHILENO;;Z;PROVIDENCIA                   ;METROPOLITANA;128980;2;1;2;1;128980;0;0;0;LED 40 KEHD4020 SMART TV;ELECTRONICA MAYOR
7692043;;M;65;CHILENO;;Boomers;PROVIDENCIA                   ;METROPOLITANA;159990;1;1;0;0;0;1;1;159990;LED 32 32PHD6825 HD SMART TV;ELECTRONICA MAYOR
20077527;;M;23;CHILENO;;Z;PROVIDENCIA                   ;METROPOLITANA;149990;1;1;1;1;149990;0;0;0;LED 40 KEHD4020 SMART TV;ELECTRONICA MAYOR
18594293;;F;29;CHILENO;;Millenial;LO PRADO                      ;METROPOLITANA;203980;2;1;2;1;203980;0;0;0;LED 43 UN43T5202AGXZS FHD SMART TV;ELECTRONICA MAYOR
9398532;;F;60;CHILENO;;Boomers;CALAMA                        ;ANTOFAGASTA;191300;3;1;0;0;0;3;1;191300;LED KIOTO 32 MI3228 SMART TV;ELECTRONICA MAYOR
24029191;;M;40;COLOMBIANO;;Extranjero;PICHIDEGUA                    ;L.G.B.OÂ´HIGGINS;876880;3;1;0;0;0;3;1;876880;LED 65 UN65AU7000GXZS UHD 4K SMART TV;ELECTRONICA MAYOR
10550977;;M;56;CHILENO;;Boomers;PROVIDENCIA                   ;METROPOLITANA;69990;1;1;0;0;0;1;1;69990;PARLANTE SENSEIGTH K3175;ELECTRONICA MAYOR
7015177;;F;65;CHILENO;;Boomers;QUINTA NORMAL                 ;METROPOLITANA;199990;1;1;0;0;0;1;1;199990;LED 50 KEUH50 SMART TV UHD;ELECTRONICA MAYOR
20433947;;F;22;CHILENO;;Z;CERRO NAVIA;METROPOLITANA;196980;2;2;2;2;196980;0;0;0;LED 50 KEUH50 SMART TV UHD;ELECTRONICA MAYOR
5553847;;F;79;CHILENO;;Silencioso;RENCA                         ;METROPOLITANA;169990;1;1;0;0;0;1;1;169990;MINICOMPONENTE MHC-V02 ALL IN ONE;ELECTRONICA MAYOR
3234530;;M;80;CHILENO;;Silencioso;LA LIGUA                      ;VALPARAISO;174310;2;1;0;0;0;2;1;174310;LED KIOTO 32 MI3228 SMART TV;ELECTRONICA MAYOR
10322861;;M;56;CHILENO;;Boomers;TEMUCO                        ;ARAUCANIA;129990;1;1;0;0;0;1;1;129990;MINICOMPONENTE OL45;ELECTRONICA MAYOR
14548532;;F;48;CHILENO;;X;PUERTO MONTT                  ;LOS LAGOS;209471;3;3;0;0;0;3;3;209471;LED KIOTO 32 MI3228 SMART TV;ELECTRONICA MAYOR
10892253;;M;56;CHILENO;;Boomers;PELLUHUE                      ;MAULE;327460;3;1;0;0;0;3;1;327460;LED 43 43UP7500 UHD SMART TV;ELECTRONICA MAYOR
16085915;;F;36;CHILENO;;Millenial;PROVIDENCIA                   ;METROPOLITANA;259980;2;1;2;1;259980;0;0;0;LED 58 KEUH5821 SMART TV UHD;ELECTRONICA MAYOR
11307405;;F;54;CHILENO;;X;PUENTE ALTO                   ;METROPOLITANA;149990;1;1;0;0;0;1;1;149990;SOUNDBAR TS7010;ELECTRONICA MAYOR
16449107;;F;36;CHILENO;;Millenial;CHONCHI                       ;LOS LAGOS;612910;9;2;0;0;0;9;2;612910;LED 40 KEHD4020 SMART TV;ELECTRONICA MAYOR
7727580;Casado;F;67;CHILENO;;Boomers;SAN CARLOS                    ;BIO BIO;197980;2;1;0;0;0;2;1;197980;LED 42 KHFH4221 SMART TV;ELECTRONICA MAYOR
18346386;;M;29;CHILENO;;Millenial;TALAGANTE                     ;METROPOLITANA;370820;4;3;0;0;0;4;3;370820;LED 50 UN50TU7090GXZS UHD SMART TV;ELECTRONICA MAYOR
25428249;;F;35;VENEZOLANO;;Extranjero;MACUL;METROPOLITANA;769960;4;3;4;3;769960;0;0;0;QLED 55 QN55Q60AAGXZS 4K UHD SMART TV;ELECTRONICA MAYOR
13283695;;F;45;CHILENO;;X;LOLOL                         ;L.G.B.OÂ´HIGGINS;159980;2;3;0;0;0;2;3;159980;LED KIOTO 32 MI3228 SMART TV;ELECTRONICA MAYOR
16579508;;F;35;CHILENO;;Millenial;SAN JAVIER                    ;MAULE;229980;2;2;0;0;0;2;2;229980;MINICOMPONENTE RN5;ELECTRONICA MAYOR
25677051;Soltero;F;31;ECUATORIANO;CIRUJANO DENTISTA;Extranjero;PROVIDENCIA                   ;METROPOLITANA;188990;1;1;1;1;188990;0;0;0;LED 43 UN43T5202AGXZS FHD SMART TV;ELECTRONICA MAYOR
15976537;;F;37;CHILENO;;Millenial;CHEPICA                       ;L.G.B.OÂ´HIGGINS;175970;3;3;0;0;0;3;3;175970;LED 40 KEHD4020 SMART TV;ELECTRONICA MAYOR
14432107;;F;76;CHILENO;;Silencioso;CONSTITUCION                  ;MAULE;1410850;18;8;0;0;0;18;8;1410850;LED 58 58PUD7625 BORDES ULTRA DELGADOS 4K UHD;ELECTRONICA MAYOR
10277502;;F;54;CHILENO;;X;TEMUCO                        ;ARAUCANIA;196140;2;1;0;0;0;2;1;196140;PARLANTE ULTRAMAGIC;ELECTRONICA MAYOR
9829752;;M;59;CHILENO;;Boomers;CONCHALI                      ;METROPOLITANA;19990;1;1;0;0;0;1;1;19990;PARLANTE KARAOKE 8 MAXEIGHT;ELECTRONICA MAYOR
6516584;;M;69;CHILENO;;Silencioso;RENCA                         ;METROPOLITANA;412980;2;1;0;0;0;2;1;412980;LED 58 UN58AU7000GXZS UHD 4K SMART TV;ELECTRONICA MAYOR
16679169;;F;35;CHILENO;;Millenial;CONSTITUCION                  ;MAULE;164990;1;1;0;0;0;1;1;164990;LED 32LM637B HD SMART;ELECTRONICA MAYOR
5714759;Viudo;F;71;CHILENO;;Silencioso;RENCA                         ;METROPOLITANA;195600;2;1;0;0;0;2;1;195600;MINICOMPONENTE RN7;ELECTRONICA MAYOR
15401237;;M;40;CHILENO;;X;"";"";319990;1;1;0;0;0;1;1;319990;LED 55 55P615 UHD ANDROID TV 4K;ELECTRONICA MAYOR
9851432;;M;58;CHILENO;;Boomers;LOS ANGELES                   ;BIO BIO;192980;2;1;0;0;0;2;1;192980;LED 40 KEHD4020 SMART TV;ELECTRONICA MAYOR
15133150;;M;38;CHILENO;;Millenial;MAULE                         ;MAULE;259980;2;2;0;0;0;2;2;259980;LED KIOTO 32 MI3228 SMART TV;ELECTRONICA MAYOR
10659613;;M;51;CHILENO;;X;SAN CARLOS                    ;BIO BIO;838960;4;1;0;0;0;4;1;838960;LED 65 KEUH6521 SMART TV UHD;ELECTRONICA MAYOR
8410303;;F;61;CHILENO;;Boomers;ANTOFAGASTA                   ;ANTOFAGASTA;139990;1;1;0;0;0;1;1;139990;MLAB KARAOKE DISCO VIBRANIUM 9106;ELECTRONICA MAYOR
11903213;;M;50;CHILENO;;X;CORONEL                       ;BIO BIO;309950;5;3;0;0;0;5;3;309950;LED KIOTO 32 MI3228 SMART TV;ELECTRONICA MAYOR
11567155;;F;51;CHILENO;;X;RENCA                         ;METROPOLITANA;243950;3;1;0;0;0;3;1;243950;LED 40 KEHD4020 SMART TV;ELECTRONICA MAYOR
26235831;Soltero;M;28;VENEZOLANO;;Extranjero;PROVIDENCIA                   ;METROPOLITANA;163980;2;1;2;1;163980;0;0;0;LED 32 UN32T4300AGXZS HD SMART TV;ELECTRONICA MAYOR
13643574;;M;43;CHILENO;;X;ARICA                         ;ARICA Y PARINACOTA;328960;6;2;0;0;0;6;2;328960;MONITOR 24 24TL520S SMART TV HD;ELECTRONICA MAYOR
18957976;;M;34;CHILENO;;Millenial;SANTIAGO;METROPOLITANA;369020;3;1;0;0;0;3;1;369020;LED 55 55P615 UHD ANDROID TV 4K;ELECTRONICA MAYOR
10324863;;M;52;CHILENO;;X;PROVIDENCIA                   ;METROPOLITANA;447960;4;3;4;3;447960;0;0;0;LED KIOTO 32 MI3228 SMART TV;ELECTRONICA MAYOR
18628346;;M;28;CHILENO;;Millenial;N/D;N/D;295960;4;3;0;0;0;4;3;295960;LED 50 50PUD6654 SMART TV UHD BL BT SILVER;ELECTRONICA MAYOR
9040693;Casado;M;62;CHILENO;;Boomers;RENCA                         ;METROPOLITANA;329990;1;1;0;0;0;1;1;329990;LED 55UP7500 UHD SMART;ELECTRONICA MAYOR
7225282;;M;69;CHILENO;;Silencioso;NUEVA IMPERIAL                ;ARAUCANIA;643520;6;5;0;0;0;6;5;643520;LED 50 50PUD7625 SMART TV ULTRA HD 4K;ELECTRONICA MAYOR
14117943;;M;41;CHILENO;;X;PROVIDENCIA                   ;METROPOLITANA;359940;6;2;0;0;0;6;2;359940;PARLANTE ULTRAMEGA;ELECTRONICA MAYOR
7905812;;M;65;CHILENO;;Boomers;YERBAS BUENAS                 ;MAULE;199990;1;1;0;0;0;1;1;199990;LED 43 43S5305 SMART TV FULL HD;ELECTRONICA MAYOR
11770709;;F;51;CHILENO;;X;SAN CARLOS                    ;BIO BIO;658929;7;4;0;0;0;7;4;658929;LED 50 KEUH50 SMART TV UHD;ELECTRONICA MAYOR
19445676;;F;25;CHILENO;;Z;VALLENAR;ATACAMA;149990;1;1;0;0;0;1;1;149990;MINICOMPONENTE RN5;ELECTRONICA MAYOR
16627687;;F;34;CHILENO;;Millenial;"";"";329991;1;2;0;0;0;1;2;329991;LED 55UP7500 UHD SMART;ELECTRONICA MAYOR
14316939;;M;46;CHILENO;;X;RENGO                         ;L.G.B.OÂ´HIGGINS;169990;1;1;0;0;0;1;1;169990;LED 32 UN32T4300AGXZS HD SMART TV;ELECTRONICA MAYOR
14182623;;M;41;CHILENO;;X;LA PINTANA                    ;METROPOLITANA;257360;3;2;0;0;0;3;2;257360;PARLANTE KARAOKE 8 MAXEIGHT;ELECTRONICA MAYOR
9158407;;M;60;CHILENO;;Boomers;CASTRO                        ;LOS LAGOS;151979;2;1;0;0;0;2;1;151979;LED 32 UN32T4300AGXZS HD SMART TV;ELECTRONICA MAYOR
11976416;;F;51;CHILENO;;X;N/D;N/D;286980;2;1;0;0;0;2;1;286980;LED 50 50P615-50P ANDROID TV PASSION LINE UHD 4K;ELECTRONICA MAYOR
13807644;;M;42;CHILENO;;X;"";"";159990;1;1;0;0;0;1;1;159990;PARLANTE MGULTRAEXTREME;ELECTRONICA MAYOR
6126780;;F;75;CHILENO;;Silencioso;ANTOFAGASTA                   ;ANTOFAGASTA;24980;2;1;0;0;0;2;1;24980;PARLANTE KARAOKE 8 MAXEIGHT;ELECTRONICA MAYOR
15120123;;F;38;CHILENO;;Millenial;N/D;N/D;845162;12;7;0;0;0;12;7;845162;LED 55UP7500 UHD SMART;ELECTRONICA MAYOR
6993316;;F;68;CHILENO;;Boomers;COIHAIQUE                     ;AYSEN;1252590;9;7;0;0;0;9;7;1252590;PARLANTE KARAOKE PINGUINO PORTATIL NEGRO;ELECTRONICA MAYOR
17498115;;F;32;CHILENO;;Millenial;SAN JAVIER                    ;MAULE;141980;2;2;0;0;0;2;2;141980;LED 32 CS32S1 SMART TV HD NEGRO;ELECTRONICA MAYOR
5535159;;M;74;CHILENO;;Silencioso;"";"";1070980;2;1;0;0;0;2;1;1070980;OLED 55C1 UHD SMART + MAGIC;ELECTRONICA MAYOR
14067436;;M;41;CHILENO;;X;N/D;N/D;242960;4;2;0;0;0;4;2;242960;MINICOMPONENTE RN7;ELECTRONICA MAYOR
6314117;;F;72;CHILENO;;Silencioso;SAN ANTONIO                   ;VALPARAISO;417970;4;1;0;0;0;4;1;417970;LED 55 KEUH5521 SMART TV UHD;ELECTRONICA MAYOR
7667036;Soltero;F;70;CHILENO;;Silencioso;TEMUCO                        ;ARAUCANIA;159990;1;1;0;0;0;1;1;159990;MINICOMPONENTE RN5;ELECTRONICA MAYOR
17636318;;F;31;CHILENO;;Millenial;N/D;N/D;537830;6;4;0;0;0;6;4;537830;LED 43 43S5305 SMART TV FULL HD;ELECTRONICA MAYOR
9010408;;F;63;CHILENO;;Boomers;LOS ANGELES                   ;BIO BIO;24990;1;1;0;0;0;1;1;24990;KARAOKE STREET SONG 4 MICÂ CABLEÂ BLACK 8900;ELECTRONICA MAYOR
19032550;;F;27;CHILENO;;Z;VALLENAR;ATACAMA;179990;1;1;0;0;0;1;1;179990;LED 32 32S60-32P ANDROID TV SMART LINE HD;ELECTRONICA MAYOR
19464753;;F;25;CHILENO;;Z;VICTORIA;ARAUCANIA;109990;3;1;0;0;0;3;1;109990;KARAOKE SP-101BT ALL IN ONE PORTATIL 60W;ELECTRONICA MAYOR
19180702;;F;26;CHILENO;;Z;N/D;N/D;379990;1;1;0;0;0;1;1;379990;LED 58 UN58AU7000GXZS UHD 4K SMART TV;ELECTRONICA MAYOR
11965272;;M;50;CHILENO;;X;ANGOL                         ;ARAUCANIA;299980;2;2;0;0;0;2;2;299980;LED 43 43UP7500 UHD SMART TV;ELECTRONICA MAYOR
13066205;;F;47;CHILENO;;X;RENCA                         ;METROPOLITANA;169980;2;1;0;0;0;2;1;169980;MINICOMPONENTE OL45;ELECTRONICA MAYOR
15866171;;M;38;CHILENO;;Millenial;MELIPILLA                     ;METROPOLITANA;594930;6;2;6;2;594930;0;0;0;LED 50 KEUH50 SMART TV UHD;ELECTRONICA MAYOR
13625799;;M;43;CHILENO;;X;LA FLORIDA;METROPOLITANA;649980;2;1;2;1;649980;0;0;0;QLED 65 QN65Q70AAGXZS 4K UHD SMART TV;ELECTRONICA MAYOR
26409113;;F;36;VENEZOLANO;;Extranjero;"";"";2342779;16;4;9;3;2260839;7;1;81940;QLED 75 UN75AU8200GXZS ANDROID TV FHD;ELECTRONICA MAYOR
13786391;Casado;F;41;CHILENO;ABOGADO;X;RENCA                         ;METROPOLITANA;199990;1;1;0;0;0;1;1;199990;LED 32LM637B HD SMART;ELECTRONICA MAYOR
9886998;;M;58;CHILENO;;Boomers;N/D;N/D;293460;3;2;0;0;0;3;2;293460;KARAOKE SP-101BT ALL IN ONE PORTATIL 60W;ELECTRONICA MAYOR
19937683;;M;39;CHILENO;;X;BUIN                          ;METROPOLITANA;159990;1;1;0;0;0;1;1;159990;MINICOMPONENTE RN5;ELECTRONICA MAYOR
7820386;;F;68;CHILENO;;Silencioso;VILLARICA                     ;ARAUCANIA;209990;1;1;0;0;0;1;1;209990;SOUNDBAR HW-Q600A/ZS;ELECTRONICA MAYOR
27053262;;F;29;EXTRANJERO - NO INFORMA NACIONALIDAD ;;Extranjero;NATALES                       ;MAGALLANES;262960;4;6;0;0;0;4;6;262960;LED 40 KEHD4020 SMART TV;ELECTRONICA MAYOR
19399456;;F;26;CHILENO;;Z;QUEILEN                       ;LOS LAGOS;232980;2;1;2;1;232980;0;0;0;LED 43 UN43T5202AGXZS FHD SMART TV;ELECTRONICA MAYOR
16219166;Soltero;F;35;CHILENO;ASISTENTE SOCIAL;Millenial;N/D;N/D;479980;2;2;1;1;219990;1;1;259990;LED 43 UN43T5202AGXZS FHD SMART TV;ELECTRONICA MAYOR
26419570;;F;33;VENEZOLANO;;Extranjero;BUIN                          ;METROPOLITANA;1352920;8;4;2;1;223980;6;3;1128940;LED 58 UN58AU7000GXZS UHD 4K SMART TV;ELECTRONICA MAYOR
5165245;Casado;M;75;NO INFORMA NACIONALIDAD;;Extranjero;PROVIDENCIA                   ;METROPOLITANA;179990;1;1;0;0;0;1;1;179990;LED 40 KEHD4020 SMART TV;ELECTRONICA MAYOR
11368736;;M;53;CHILENO;;X;EL BOSQUE                     ;METROPOLITANA;92870;2;2;0;0;0;2;2;92870;KARAOKE RHYTHM CHARGER 12 MIC CABLE 8890;ELECTRONICA MAYOR
13285789;;M;45;CHILENO;;Millenial;"";"";259990;1;1;0;0;0;1;1;259990;LED 43 UN43TU7090GXZS UHD SMART TV;ELECTRONICA MAYOR
6237391;;F;77;CHILENO;;Silencioso;LICANTEN                      ;MAULE;187980;2;1;0;0;0;2;1;187980;LED KIOTO 32 MI3228 SMART TV;ELECTRONICA MAYOR
12420343;;F;48;CHILENO;;X;OVALLE                        ;COQUIMBO;37980;2;2;0;0;0;2;2;37980;PARLANTE KARAOKE 8 MAXEIGHT;ELECTRONICA MAYOR
9965461;;F;59;CHILENO;;Boomers;PUENTE ALTO                   ;METROPOLITANA;377970;3;1;0;0;0;3;1;377970;LED 50 50P615-50P ANDROID TV PASSION LINE UHD 4K;ELECTRONICA MAYOR
10333163;;F;53;CHILENO;;Boomers;OSORNO                        ;LOS LAGOS;399550;4;3;0;0;0;4;3;399550;LED 55 KEUH5521 SMART TV UHD;ELECTRONICA MAYOR
18872920;;M;27;CHILENO;;Millenial;VILCUN                        ;ARAUCANIA;248980;2;1;2;1;248980;0;0;0;LED 43 43LM33911 ANDROID SMART TV UHD 4K;ELECTRONICA MAYOR
9424002;;M;60;CHILENO;;Boomers;PUDAHUEL                      ;METROPOLITANA;224980;2;1;0;0;0;2;1;224980;LED 32LM637B HD SMART;ELECTRONICA MAYOR
15510684;;M;39;CHILENO;;X;LINARES                       ;MAULE;239990;1;1;0;0;0;1;1;239990;LED 43 UN43T5202AGXZS FHD SMART TV;ELECTRONICA MAYOR
10970754;;F;53;CHILENO;;X;SAN CARLOS                    ;BIO BIO;400850;4;3;0;0;0;4;3;400850;LED 40 UN40T5290AGXZS FHD SMART TV;ELECTRONICA MAYOR
10824436;;F;55;CHILENO;;Boomers;TOCOPILLA                     ;ANTOFAGASTA;367210;5;2;0;0;0;5;2;367210;LED 43 UN43TU7090GXZS UHD SMART TV;ELECTRONICA MAYOR
19250584;;F;25;CHILENO;;Z;VILLARICA                     ;ARAUCANIA;229980;2;2;0;0;0;2;2;229980;PARLANTE ULTRABUZZ;ELECTRONICA MAYOR
17558855;Soltero;F;32;CHILENO;;Millenial;PROVIDENCIA                   ;METROPOLITANA;159990;1;1;1;1;159990;0;0;0;LED 32 UN32T4300AGXZS HD SMART TV;ELECTRONICA MAYOR
15111429;;F;23;CHILENO;;Z;PUERTO MONTT                  ;LOS LAGOS;320470;5;3;1;1;209990;4;2;110480;LED 43 UN43T5202AGXZS FHD SMART TV;ELECTRONICA MAYOR
18833792;;F;27;CHILENO;;Millenial;MACUL                         ;METROPOLITANA;149990;1;1;0;0;0;1;1;149990;LED 32 32PHD6825 HD SMART TV;ELECTRONICA MAYOR
15958203;;F;37;CHILENO;;Millenial;N/D;N/D;541000;0;3;-1;2;151010;1;1;389990;LED 55 UN55TU7090GXZS SMART TV UHD;ELECTRONICA MAYOR
19480585;;F;25;CHILENO;;Z;N/D;N/D;379990;1;1;0;0;0;1;1;379990;LED 58 UN58AU7000GXZS UHD 4K SMART TV;ELECTRONICA MAYOR
10311289;;M;56;CHILENO;;Boomers;PARRAL                        ;MAULE;295980;2;2;0;0;0;2;2;295980;LED 55 KEUH5521 SMART TV UHD;ELECTRONICA MAYOR
19684248;;F;24;CHILENO;;Z;CALBUCO                       ;LOS LAGOS;572962;4;4;0;0;0;4;4;572962;LED 50 KEUH50 SMART TV UHD;ELECTRONICA MAYOR
13835254;;M;42;CHILENO;;X;MELIPILLA                     ;METROPOLITANA;29980;2;1;0;0;0;2;1;29980;PARLANTE KARAOKE 8 MAXEIGHT;ELECTRONICA MAYOR
20713036;;M;21;CHILENO;;Z;LA SERENA                     ;COQUIMBO;280000;2;1;0;0;0;2;1;280000;LED 55 KEUH5521 SMART TV UHD;ELECTRONICA MAYOR
19302026;;F;26;CHILENO;;Z;OVALLE                        ;COQUIMBO;727950;5;2;0;0;0;5;2;727950;LED 65 KEUH6521 SMART TV UHD;ELECTRONICA MAYOR
11185388;;F;54;CHILENO;;Boomers;ISLA DE MAIPO                 ;METROPOLITANA;289980;2;2;0;0;0;2;2;289980;LED 43 43LM6370 SMART TV FHD;ELECTRONICA MAYOR
9700862;;F;60;CHILENO;;Boomers;LONGAVI                       ;MAULE;119980;2;1;0;0;0;2;1;119980;PARLANTE ULTRAMEGA;ELECTRONICA MAYOR
25388427;Soltero;M;55;PERUANO;;Extranjero;"";"";499960;4;2;0;0;0;4;2;499960;LED 43 UN43TU7090GXZS UHD SMART TV;ELECTRONICA MAYOR
10732681;;M;55;CHILENO;;Boomers;RENCA                         ;METROPOLITANA;239990;1;1;0;0;0;1;1;239990;LED 43 UN43T5202AGXZS FHD SMART TV;ELECTRONICA MAYOR
15229124;;F;40;CHILENO;;X;N/D;N/D;389990;1;2;0;0;0;1;2;389990;LED 58 UN58AU7000GXZS UHD 4K SMART TV;ELECTRONICA MAYOR
17145567;Casado;M;33;CHILENO;PROFESOR;Millenial;PROVIDENCIA                   ;METROPOLITANA;183980;2;1;0;0;0;2;1;183980;LED 32 UN32T4300AGXZS HD SMART TV;ELECTRONICA MAYOR
25411917;Soltero;F;35;COLOMBIANO;;Extranjero;PROVIDENCIA                   ;METROPOLITANA;499980;2;2;1;1;189990;1;1;309990;LED 50 50UP7500 UHD SMART TV;ELECTRONICA MAYOR
11135775;Soltero;M;54;CHILENO;;Boomers;PROVIDENCIA                   ;METROPOLITANA;205980;2;1;0;0;0;2;1;205980;PARLANTE MGULTRAEXTREME;ELECTRONICA MAYOR
10819375;;F;53;CHILENO;;Millenial;PROVIDENCIA                   ;N/D;179990;1;1;0;0;0;1;1;179990;PARLANTE ULTRABUZZ;ELECTRONICA MAYOR
18426377;;M;28;CHILENO;;Silencioso;PROVIDENCIA                   ;METROPOLITANA;278960;4;2;4;2;278960;0;0;0;LED 32LM637B HD SMART;ELECTRONICA MAYOR
12111445;;M;71;ESTADOUNIDENSE;;Silencioso;PROVIDENCIA                   ;METROPOLITANA;0;0;2;0;0;0;0;2;0;PARLANTE KARAOKE 12 FM/BT/USB;ELECTRONICA MAYOR
16440675;;M;36;CHILENO;;Millenial;RENCA                         ;METROPOLITANA;189990;1;1;0;0;0;1;1;189990;LED 42 KHFH4221 SMART TV;ELECTRONICA MAYOR
3731803;;F;85;CHILENO;;Silencioso;ILLAPEL                       ;COQUIMBO;619340;5;3;0;0;0;5;3;619340;PARLANTE ULTRABUZZ;ELECTRONICA MAYOR
5117010;;M;76;CHILENO;;Silencioso;N/D;N/D;152970;3;1;0;0;0;3;1;152970;PARLANTE ULTRAMAGIC;ELECTRONICA MAYOR
17196556;;M;31;CHILENO;;Millenial;NIQUEN                        ;BIO BIO;129990;1;1;0;0;0;1;1;129990;PARLANTE ULTRABUZZ;ELECTRONICA MAYOR
11718382;Casado;F;52;CHILENO;;X;RENCA                         ;METROPOLITANA;273980;2;1;0;0;0;2;1;273980;LED 43 Full HD Smart TV 43PFD6825;ELECTRONICA MAYOR
25441344;Soltero;F;46;COLOMBIANO;;Extranjero;PROVIDENCIA                   ;METROPOLITANA;149980;2;1;0;0;0;2;1;149980;PARLANTE ULTRAMAGIC;ELECTRONICA MAYOR
12750380;;M;47;CHILENO;;X;RIO BUENO                     ;LOS RIOS;355980;2;1;2;1;355980;0;0;0;LED 55 55PUD6794 SMART TV UHD 4K;ELECTRONICA MAYOR
9805600;;M;57;CHILENO;;Boomers;RENCA                         ;METROPOLITANA;209990;1;1;0;0;0;1;1;209990;LED 40 UN40T5290AGXZS FHD SMART TV;ELECTRONICA MAYOR
10233859;;M;55;CHILENO;;Boomers;RENCA                         ;METROPOLITANA;139990;2;1;0;0;0;2;1;139990;LED KIOTO 32 MI3228 SMART TV;ELECTRONICA MAYOR
8608929;;F;61;CHILENO;;Boomers;TEMUCO                        ;ARAUCANIA;280000;2;1;0;0;0;2;1;280000;LED 55 KEUH5521 SMART TV UHD;ELECTRONICA MAYOR
14465452;;M;50;CHILENO;;X;LOS ANGELES                   ;BIO BIO;338060;3;2;0;0;0;3;2;338060;PARLANTE MGULTRAEXTREME;ELECTRONICA MAYOR
13789275;;M;42;CHILENO;;X;COLBUN                        ;MAULE;304970;3;2;0;0;0;3;2;304970;LED KIOTO 32 MI3228 SMART TV;ELECTRONICA MAYOR
14162717;;M;40;CHILENO;;X;"";"";262960;4;3;0;0;0;4;3;262960;SOUNDBAR HW-T400/ZS;ELECTRONICA MAYOR
14172313;;M;41;CHILENO;;X;QUILPUE                       ;VALPARAISO;179980;2;2;0;0;0;2;2;179980;LED 32 CS32S1 SMART TV HD NEGRO;ELECTRONICA MAYOR
7346590;;M;66;CHILENO;;Boomers;NATALES                       ;MAGALLANES;181980;2;1;0;0;0;2;1;181980;LED 32 CS32S1 SMART TV HD NEGRO;ELECTRONICA MAYOR
14310013;;F;46;CHILENO;;X;CASTRO                        ;LOS LAGOS;367980;2;2;0;0;0;2;2;367980;LED 55UP7500 UHD SMART;ELECTRONICA MAYOR
16581989;;M;34;CHILENO;;Millenial;N/D;N/D;229990;1;3;0;0;0;1;3;229990;LED 50 KEUH50 SMART TV UHD;ELECTRONICA MAYOR
18620175;;F;27;CHILENO;;Extranjero;CARAHUE                       ;ARAUCANIA;971960;4;2;0;0;0;4;2;971960;LED 50 50UP7500 UHD SMART TV;ELECTRONICA MAYOR
13331727;;M;44;CHILENO;;X;PROVIDENCIA                   ;METROPOLITANA;139990;1;1;1;1;139990;0;0;0;LED 32 32S5295 SMART TV HD;ELECTRONICA MAYOR
18267462;;M;30;CHILENO;;Millenial;"";"";349990;1;1;0;0;0;1;1;349990;LED 55UP7500 UHD SMART;ELECTRONICA MAYOR
17719802;;F;29;CHILENO;;Millenial;DALCAHUE                      ;LOS LAGOS;346960;4;2;0;0;0;4;2;346960;LED KIOTO 32 MI3228 SMART TV;ELECTRONICA MAYOR
7082884;;F;72;CHILENO;;Silencioso;N/D;N/D;373960;4;3;0;0;0;4;3;373960;KARAOKE STREET SONG 4 MICÂ CABLEÂ BLACK 8900;ELECTRONICA MAYOR
25982440;;M;39;HAITIANO;;Extranjero;LAMPA                         ;METROPOLITANA;249990;1;1;0;0;0;1;1;249990;LED 43 UN43TU7090GXZS UHD SMART TV;ELECTRONICA MAYOR
15578627;;F;39;CHILENO;;X;N/D;N/D;256970;4;3;0;0;0;4;3;256970;LED 42 KHFH4221 SMART TV;ELECTRONICA MAYOR
13824864;;F;47;CHILENO;;X;PUERTO MONTT                  ;LOS LAGOS;259980;2;2;0;0;0;2;2;259980;LED KIOTO 32 MI3228 SMART TV;ELECTRONICA MAYOR
12826055;;F;47;CHILENO;;X;SAN ANTONIO                   ;VALPARAISO;129990;1;1;0;0;0;1;1;129990;PARLANTE ULTRAMAGIC;ELECTRONICA MAYOR
26140742;;M;40;EXTRANJERO - NO INFORMA NACIONALIDAD;;Extranjero;RECOLETA                      ;METROPOLITANA;215980;2;1;0;0;0;2;1;215980;PARLANTE ULTRAFORCE-I;ELECTRONICA MAYOR
7555109;;M;67;CHILENO;;Boomers;VALDIVIA                      ;LOS RIOS;279990;1;1;1;1;279990;0;0;0;LED 50 50UP7500 UHD SMART TV;ELECTRONICA MAYOR
6897894;;M;70;CHILENO;;Silencioso;CONSTITUCION                  ;MAULE;259990;1;1;0;0;0;1;1;259990;LED 50 50PUD7625 SMART TV ULTRA HD 4K;ELECTRONICA MAYOR
19972217;;M;23;CHILENO;;Z;"";"";139990;1;1;0;0;0;1;1;139990;LED KIOTO 32 MI3228 SMART TV;ELECTRONICA MAYOR
5495162;;F;71;CHILENO;;Silencioso;TOCOPILLA                     ;ANTOFAGASTA;289990;1;1;0;0;0;1;1;289990;LED 50 50PUD7625 SMART TV ULTRA HD 4K;ELECTRONICA MAYOR
18076122;;M;39;CHILENO;;X;PUENTE ALTO                   ;METROPOLITANA;226980;2;1;0;0;0;2;1;226980;LED 40 UN40T5290AGXZS FHD SMART TV;ELECTRONICA MAYOR
9328118;;F;42;CHILENO;;X;PROVIDENCIA                   ;METROPOLITANA;189990;1;1;1;1;189990;0;0;0;LED 43 43S5305 SMART TV FULL HD;ELECTRONICA MAYOR
12745669;;F;51;CHILENO;;X;PANGUIPULLI                   ;LOS RIOS;283970;3;1;0;0;0;3;1;283970;LED 40 UN40T5290AGXZS FHD SMART TV;ELECTRONICA MAYOR
20338560;;M;22;CHILENO;;Millenial;"";"";379970;3;3;1;1;119990;2;2;259980;PARLANTE SENSEIGTH K3175;ELECTRONICA MAYOR
20275706;;M;22;CHILENO;;Z;BULNES                        ;BIO BIO;502970;3;1;0;0;0;3;1;502970;LED 55 UN55TU7090GXZS SMART TV UHD;ELECTRONICA MAYOR
8872422;Casado;M;61;CHILENO;INGENIERO AGRICOLA;Boomers;RENCA                         ;METROPOLITANA;219990;1;1;0;0;0;1;1;219990;LED 40 UN40T5290AGXZS FHD SMART TV;ELECTRONICA MAYOR
16508436;;F;34;CHILENO;;Millenial;RENCA                         ;METROPOLITANA;24990;1;1;0;0;0;1;1;24990;PARLANTE KARAOKE 8 MAXEIGHT;ELECTRONICA MAYOR
14241033;;M;48;CHILENO;;X;QUILPUE                       ;VALPARAISO;99990;1;1;0;0;0;1;1;99990;PARLANTE ULTRAMAGIC;ELECTRONICA MAYOR
7659978;;M;64;CHILENO;;Boomers;LOTA                          ;BIO BIO;239990;1;1;0;0;0;1;1;239990;LED 40 UN40T5290AGXZS FHD SMART TV;ELECTRONICA MAYOR
9104120;;M;61;CHILENO;;Boomers;PROVIDENCIA                   ;METROPOLITANA;139990;1;1;0;0;0;1;1;139990;LED KIOTO 32 MI3228 SMART TV;ELECTRONICA MAYOR
20348998;;F;22;CHILENO;;Millenial;CONSTITUCION                  ;MAULE;362940;6;5;0;0;0;6;5;362940;LED 32 32S60-32P ANDROID TV SMART LINE HD;ELECTRONICA MAYOR
14349374;;M;43;CHILENO;;X;TRAIGUEN                      ;ARAUCANIA;309980;2;2;0;0;0;2;2;309980;LED 55 KEUH5521 SMART TV UHD;ELECTRONICA MAYOR
17151018;;F;33;CHILENO;;Millenial;MAIPU                         ;METROPOLITANA;282200;6;5;0;0;0;6;5;282200;LED 32 32PHD6825 HD SMART TV;ELECTRONICA MAYOR
19451917;;M;25;CHILENO;;Z;N/D;N/D;164980;2;2;0;0;0;2;2;164980;PARLANTE SPBYF7 PORTATIL;ELECTRONICA MAYOR
11979627;;M;49;CHILENO;;X;BUIN                          ;METROPOLITANA;89990;1;1;0;0;0;1;1;89990;PARLANTE ULTRAMEGA;ELECTRONICA MAYOR
17897590;;M;31;CHILENO;;Millenial;N/D;N/D;753960;4;6;0;0;0;4;6;753960;LED 50 UN50TU7090GXZS UHD SMART TV;ELECTRONICA MAYOR
18041509;Soltero;M;30;CHILENO;;Millenial;PROVIDENCIA                   ;METROPOLITANA;139990;1;1;0;0;0;1;1;139990;LED KIOTO 32 MI3228 SMART TV;ELECTRONICA MAYOR
17487797;;F;31;CHILENO;;Millenial;N/D;N/D;555960;4;5;0;0;0;4;5;555960;LED 43 UN43TU7090GXZS UHD SMART TV;ELECTRONICA MAYOR
10629019;;M;53;CHILENO;;X;N/D;N/D;222980;2;1;0;0;0;2;1;222980;LED 32 UN32T4300AGXZS HD SMART TV;ELECTRONICA MAYOR
12691429;Casado;F;48;CHILENO;;X;RENCA                         ;METROPOLITANA;119990;1;1;0;0;0;1;1;119990;PARLANTE MEGALUX K2777;ELECTRONICA MAYOR
12460721;;M;48;CHILENO;;Silencioso;PROVIDENCIA                   ;METROPOLITANA;213980;2;1;2;1;213980;0;0;0;LED 40 UN40T5290AGXZS FHD SMART TV;ELECTRONICA MAYOR
9256719;;F;62;CHILENO;;Boomers;N/D;N/D;677390;8;4;0;0;0;8;4;677390;LED 50 KEUH50 SMART TV UHD;ELECTRONICA MAYOR
17000262;;F;33;CHILENO;;Millenial;CORONEL                       ;BIO BIO;35990;1;1;0;0;0;1;1;35990;PARLANTE KARAOKE SPB8B;ELECTRONICA MAYOR
25849355;;M;51;VENEZOLANO;;Extranjero;N/D;N/D;183980;2;1;2;1;183980;0;0;0;LED 32LM637B HD SMART;ELECTRONICA MAYOR
19970703;;F;23;CHILENO;;Z;ANCUD                         ;LOS LAGOS;269970;3;1;0;0;0;3;1;269970;LED 40 KEHD4020 SMART TV;ELECTRONICA MAYOR
12055242;;M;55;CHILENO;;Boomers;CHIMBARONGO                   ;L.G.B.OÂ´HIGGINS;304950;5;3;0;0;0;5;3;304950;PARLANTE ULTRAFORCE-I;ELECTRONICA MAYOR
7304794;;F;67;CHILENO;;Boomers;PROVIDENCIA                   ;METROPOLITANA;549970;3;1;0;0;0;3;1;549970;LED 55UP7500 UHD SMART;ELECTRONICA MAYOR
7572668;;F;61;CHILENO;;Boomers;PADRE LAS CASAS               ;ARAUCANIA;176980;2;1;0;0;0;2;1;176980;MONITOR 24 24TL520S SMART TV HD;ELECTRONICA MAYOR
10739042;;F;53;CHILENO;;X;TALCAHUANO                    ;BIO BIO;270830;3;2;2;1;95840;1;1;174990;LED 40 UN40T5290AGXZS FHD SMART TV;ELECTRONICA MAYOR
14448609;;F;48;CHILENO;;X;N/D;N/D;260550;4;2;0;0;0;4;2;260550;KARAOKE STREET SONG 4 MICÂ CABLEÂ BLACK 8900;ELECTRONICA MAYOR
3594944;;M;86;CHILENO;;Silencioso;RENCA                         ;METROPOLITANA;159990;1;1;0;0;0;1;1;159990;LED 32 32PHD6825 HD SMART TV;ELECTRONICA MAYOR
8670815;;M;64;CHILENO;;Boomers;SALAMANCA                     ;COQUIMBO;787970;3;1;0;0;0;3;1;787970;LED 65 UN65AU7000GXZS UHD 4K SMART TV;ELECTRONICA MAYOR
12776219;;M;47;CHILENO;;X;RECOLETA                      ;METROPOLITANA;179990;1;1;0;0;0;1;1;179990;KARAOKE TRUE WIRELESS DUAL 10 PULGADAS LIGHT SHO;ELECTRONICA MAYOR
13942916;;M;41;CHILENO;;X;PROVIDENCIA                   ;METROPOLITANA;124980;2;2;0;0;0;2;2;124980;PARLANTE KARAOKE 8 MAXEIGHT;ELECTRONICA MAYOR
11734111;;F;50;CHILENO;;X;QUILLOTA                      ;VALPARAISO;911020;7;3;0;0;0;7;3;911020;LED 65 KEUH6521 SMART TV UHD;ELECTRONICA MAYOR
8891411;;M;61;CHILENO;;Boomers;TALCAHUANO                    ;BIO BIO;346950;5;3;0;0;0;5;3;346950;LED 40 UN40T5290AGXZS FHD SMART TV;ELECTRONICA MAYOR
6265370;;M;71;CHILENO;;Silencioso;VALLENAR;ATACAMA;69990;1;1;0;0;0;1;1;69990;PARLANTE BOLA DISCO CON MICROFONO INAL;ELECTRONICA MAYOR
5709189;Casado;M;73;CHILENO;;Silencioso;VINA DEL MAR                  ;VALPARAISO;59980;2;1;0;0;0;2;1;59980;PARLANTE COBRA;ELECTRONICA MAYOR
13016426;;F;46;CHILENO;;X;COPIAPO                       ;ATACAMA;89970;3;3;0;0;0;3;3;89970;PARLANTE COBRA;ELECTRONICA MAYOR
9525178;;F;60;CHILENO;;Boomers;PENAFLOR                      ;METROPOLITANA;77980;2;2;0;0;0;2;2;77980;PARLANTE SENSEIGTH K3175;ELECTRONICA MAYOR
5140126;;M;78;CHILENO;;Silencioso;CASTRO                        ;LOS LAGOS;121850;4;2;0;0;0;4;2;121850;PARLANTE KARAOKE SPB8B;ELECTRONICA MAYOR
15948788;;M;37;CHILENO;;Millenial;CONSTITUCION                  ;MAULE;184950;5;2;0;0;0;5;2;184950;PARLANTE KARAOKE PINGUINO PORTATIL NEGRO;ELECTRONICA MAYOR
12185317;;F;50;CHILENO;;X;LINARES                       ;MAULE;74980;2;3;0;0;0;2;3;74980;KARAOKE FUNKY DISCO;ELECTRONICA MAYOR
11879702;;M;51;CHILENO;;X;"";"";314990;1;1;1;1;314990;0;0;0;LED 50 UN50TU7090GXZS UHD SMART TV;ELECTRONICA MAYOR
25102369;;M;45;CHILENO;;Extranjero;N/D;N/D;1156880;11;1;0;0;0;11;1;1156880;LED 50 50PUD7625 SMART TV ULTRA HD 4K;ELECTRONICA MAYOR
10207446;;M;56;CHILENO;;Boomers;PROVIDENCIA                   ;METROPOLITANA;139990;1;1;1;1;139990;0;0;0;LED 32 KHHD3221 SMART TV;ELECTRONICA MAYOR
18644650;;M;28;CHILENO;;Millenial;ANGOL                         ;ARAUCANIA;329980;2;2;0;0;0;2;2;329980;LED 50 50UP7500 UHD SMART TV;ELECTRONICA MAYOR
16633872;;F;34;CHILENO;;Millenial;COLLIPULLI                    ;ARAUCANIA;319980;2;1;0;0;0;2;1;319980;LED 40 KEHD4020 SMART TV;ELECTRONICA MAYOR
11350138;;F;42;CHILENO;;X;PARRAL                        ;MAULE;339980;2;2;0;0;0;2;2;339980;LED 50 50PUD7625 SMART TV ULTRA HD 4K;ELECTRONICA MAYOR
19194200;Soltero;M;30;CHILENO;;Millenial;PROVIDENCIA                   ;METROPOLITANA;277980;2;1;0;0;0;2;1;277980;LED 50 KEUH50 SMART TV UHD;ELECTRONICA MAYOR
16186176;;F;37;CHILENO;;Millenial;RENCA                         ;METROPOLITANA;24990;1;1;0;0;0;1;1;24990;PARLANTE KARAOKE 8 MAXEIGHT;ELECTRONICA MAYOR
9733653;;M;59;CHILENO;;Boomers;VALLENAR;ATACAMA;124970;3;2;0;0;0;3;2;124970;PARLANTE KARAOKE MGROKR NEGRO;ELECTRONICA MAYOR
14242678;;M;48;CHILENO;;X;PROVIDENCIA                   ;METROPOLITANA;26980;2;1;0;0;0;2;1;26980;PARLANTE MG TWISTER;ELECTRONICA MAYOR
11906397;;F;51;CHILENO;;X;LAUTARO                       ;ARAUCANIA;189990;1;1;0;0;0;1;1;189990;LED 32LM637B HD SMART;ELECTRONICA MAYOR
16531151;;F;35;CHILENO;;Millenial;CAUQUENES                     ;MAULE;929940;6;2;0;0;0;6;2;929940;LED 65 KEUH6521 SMART TV UHD;ELECTRONICA MAYOR
16405484;;F;35;CHILENO;;Millenial;CHILLAN                       ;BIO BIO;692950;5;5;0;0;0;5;5;692950;PARLANTE SENSEIGTH K3175;ELECTRONICA MAYOR
11523330;;F;53;CHILENO;;X;COLINA                        ;METROPOLITANA;146980;2;1;0;0;0;2;1;146980;LED KIOTO 32 MI3228 SMART TV;ELECTRONICA MAYOR
15009827;;M;39;CHILENO;;X;N/D;N/D;128540;2;1;2;1;128540;0;0;0;MONITOR 24 24TL520S SMART TV HD;ELECTRONICA MAYOR
10751830;;F;48;CHILENO;;X;RENCA                         ;METROPOLITANA;147980;2;1;0;0;0;2;1;147980;MONITOR 24 24TL520S SMART TV HD;ELECTRONICA MAYOR
12055842;;F;58;CHILENO;;Boomers;TALCA                         ;MAULE;357960;4;1;0;0;0;4;1;357960;PARLANTE ULTRAFUSION;ELECTRONICA MAYOR
20300358;;F;22;CHILENO;;Silencioso;PROVIDENCIA                   ;METROPOLITANA;209990;1;1;1;1;209990;0;0;0;LED 42 KHFH4221 SMART TV;ELECTRONICA MAYOR
6473559;Casado;M;66;CHILENO;PROFESOR;Boomers;RENCA                         ;METROPOLITANA;818970;4;2;4;2;818970;0;0;0;TOCADISCOS PS-LX310BT BT;ELECTRONICA MAYOR
16116779;;F;36;CHILENO;;Millenial;PUDAHUEL                      ;METROPOLITANA;340930;6;2;6;2;340930;0;0;0;LED 43 43S5305 SMART TV FULL HD;ELECTRONICA MAYOR
12155235;;F;51;CHILENO;;X;ERCILLA                       ;ARAUCANIA;399990;1;1;0;0;0;1;1;399990;LED 58 UN58AU7000GXZS UHD 4K SMART TV;ELECTRONICA MAYOR
10199373;Casado;F;57;CHILENO;;Boomers;RENCA                         ;METROPOLITANA;24990;1;1;0;0;0;1;1;24990;PARLANTE KARAOKE 8 MAXEIGHT;ELECTRONICA MAYOR
15040927;;M;39;CHILENO;;X;OVALLE                        ;COQUIMBO;45980;2;2;0;0;0;2;2;45980;PARLANTE COBRA;ELECTRONICA MAYOR
9928661;Casado;M;58;CHILENO;;Boomers;COIHUECO                      ;BIO BIO;59980;2;1;0;0;0;2;1;59980;PARLANTE COBRA;ELECTRONICA MAYOR
20304300;;F;22;CHILENO;;Z;RENGO;O HIGGINS;129990;1;1;1;1;129990;0;0;0;LED 32 KHHD3221 SMART TV;ELECTRONICA MAYOR
14301061;;M;47;CHILENO;;X;CONSTITUCION                  ;MAULE;580970;3;2;0;0;0;3;2;580970;LED 50 50UP7500 UHD SMART TV;ELECTRONICA MAYOR
8580518;Casado;M;63;CHILENO;;Boomers;PROVIDENCIA                   ;METROPOLITANA;62980;2;1;0;0;0;2;1;62980;PARLANTE COBRA;ELECTRONICA MAYOR
16903181;;F;33;CHILENO;;Millenial;N/D;N/D;479980;2;1;0;0;0;2;1;479980;LED 40 UN40T5290AGXZS FHD SMART TV;ELECTRONICA MAYOR
9101157;;F;61;CHILENO;;Boomers;PUENTE ALTO                   ;METROPOLITANA;269990;1;1;0;0;0;1;1;269990;LED 43 UN43TU7090GXZS UHD SMART TV;ELECTRONICA MAYOR
19211648;;F;26;CHILENO;;Z;PROVIDENCIA                   ;METROPOLITANA;272980;2;1;0;0;0;2;1;272980;PARLANTE ULTRAFORCE-I;ELECTRONICA MAYOR
17498283;;M;32;CHILENO;;Millenial;SAN JAVIER                    ;MAULE;129990;1;1;0;0;0;1;1;129990;LED 32 KHHD3221 SMART TV;ELECTRONICA MAYOR
13138468;;F;45;CHILENO;;X;PROVIDENCIA                   ;METROPOLITANA;24990;1;1;0;0;0;1;1;24990;PARLANTE KARAOKE 8 MAXEIGHT;ELECTRONICA MAYOR
13620401;;M;42;CHILENO;;X;N/D;N/D;173980;2;1;2;1;173980;0;0;0;LED 32 UN32T4300AGXZS HD SMART TV;ELECTRONICA MAYOR
19926784;;M;24;CHILENO;;Z;MOSTAZAL;O HIGGINS;154540;2;1;2;1;154540;0;0;0;PARLANTE ULTRAFUSION;ELECTRONICA MAYOR
13822256;;F;44;CHILENO;;X;PROVIDENCIA                   ;METROPOLITANA;214980;2;1;0;0;0;2;1;214980;LED 42 KHFH4221 SMART TV;ELECTRONICA MAYOR
14179137;;F;40;CHILENO;;X;N/D;N/D;129990;1;1;0;0;0;1;1;129990;PARLANTE ULTRAFUSION;ELECTRONICA MAYOR
6279116;;F;75;CHILENO;;Silencioso;N/D;N/D;179990;2;1;2;1;179990;0;0;0;LED 42 KHFH4221 SMART TV;ELECTRONICA MAYOR
10578666;;M;54;CHILENO;;Boomers;MELIPILLA                     ;METROPOLITANA;179990;1;1;0;0;0;1;1;179990;LED 42 KHFH4221 SMART TV;ELECTRONICA MAYOR
16279517;Soltero;F;36;CHILENO;;Silencioso;PROVIDENCIA                   ;METROPOLITANA;408540;2;1;2;1;408540;0;0;0;LED 58 UN58AU7000GXZS UHD 4K SMART TV;ELECTRONICA MAYOR
5467710;;F;76;CHILENO;;Silencioso;GRANEROS                      ;L.G.B.OÂ´HIGGINS;179990;1;1;0;0;0;1;1;179990;LED 32 32PHD6825 HD SMART TV;ELECTRONICA MAYOR
12311754;Soltero;F;50;CHILENO;TECNICO EN ENFERMERIA DE NIVEL SUPERIOR;X;RENCA                         ;METROPOLITANA;329990;1;1;1;1;329990;0;0;0;LED 55UP7500 UHD SMART;ELECTRONICA MAYOR
18500454;;M;29;CHILENO;;Millenial;PROVIDENCIA                   ;METROPOLITANA;289990;1;1;1;1;289990;0;0;0;LED 50 50UP7500 UHD SMART TV;ELECTRONICA MAYOR
12082403;;F;52;CHILENO;;X;PADRE LAS CASAS               ;ARAUCANIA;963580;7;1;0;0;0;7;1;963580;LED 58 UN58AU7000GXZS UHD 4K SMART TV;ELECTRONICA MAYOR
7874610;;F;66;CHILENO;;Boomers;RENCA                         ;METROPOLITANA;344570;2;1;0;0;0;2;1;344570;LED 50 50U6305 SMART TV ULTRA HD;ELECTRONICA MAYOR
9749977;;M;56;CHILENO;;Boomers;SAN FERNANDO                  ;L.G.B.OÂ´HIGGINS;873430;6;3;0;0;0;6;3;873430;LED 60UP7750 UHD SMART + MAGIC;ELECTRONICA MAYOR
15969930;;M;37;CHILENO;;Millenial;N/D;N/D;189990;1;1;0;0;0;1;1;189990;LED 42 KHFH4221 SMART TV;ELECTRONICA MAYOR
13596204;;F;42;CHILENO;;X;"";"";343980;2;1;2;1;343980;0;0;0;LED 50 50UP7500 UHD SMART TV;ELECTRONICA MAYOR
26000155;;M;41;HAITIANO;;Extranjero;N/D;N/D;152470;2;1;0;0;0;2;1;152470;MINICOMPONENTE OL45;ELECTRONICA MAYOR
19339409;;F;25;CHILENO;;Z;VINA DEL MAR;VALPARAISO;329990;1;1;0;0;0;1;1;329990;LED 50 UN50TU7090GXZS UHD SMART TV;ELECTRONICA MAYOR
12329671;;F;49;CHILENO;;X;LEBU                          ;BIO BIO;195840;2;1;2;1;195840;0;0;0;LED 43 CS43F2 SMART TV FHD NEGRO;ELECTRONICA MAYOR
13960749;;M;44;CHILENO;;X;TRAIGUEN                      ;ARAUCANIA;431950;5;2;0;0;0;5;2;431950;LED 32 CS32S1 SMART TV HD NEGRO;ELECTRONICA MAYOR
7603118;;F;70;CHILENO;;Silencioso;LOS ANDES                     ;VALPARAISO;440990;5;2;0;0;0;5;2;440990;LED 43 43S5305 SMART TV FULL HD;ELECTRONICA MAYOR
9506600;;F;58;CHILENO;;Boomers;RENCA                         ;METROPOLITANA;289990;1;1;1;1;289990;0;0;0;LED 50 50UP7500 UHD SMART TV;ELECTRONICA MAYOR
18111003;Soltero;M;29;CHILENO;;Millenial;PROVIDENCIA                   ;METROPOLITANA;369990;1;1;1;1;369990;0;0;0;LED 50 50NANO75 NanoCell UHD SMART + MAGIC;ELECTRONICA MAYOR
16555044;;F;35;CHILENO;;Millenial;PUENTE ALTO;METROPOLITANA;299990;2;1;2;1;299990;0;0;0;LED 50 50P615-50P ANDROID TV PASSION LINE UHD 4K;ELECTRONICA MAYOR
16402611;;F;36;CHILENO;;Millenial;PROVIDENCIA                   ;METROPOLITANA;304980;2;1;2;1;304980;0;0;0;LED 50 50PUD7625 SMART TV ULTRA HD 4K;ELECTRONICA MAYOR
9998574;;F;60;CHILENO;;Boomers;SAN ANTONIO                   ;VALPARAISO;1091620;9;3;0;0;0;9;3;1091620;LED 42 KHFH4221 SMART TV;ELECTRONICA MAYOR
8556734;;M;63;CHILENO;;Boomers;CALAMA                        ;ANTOFAGASTA;118360;3;1;0;0;0;3;1;118360;SISTEMA DE SONIDO CM1560;ELECTRONICA MAYOR
18489176;Soltero;F;29;CHILENO;;Millenial;PROVIDENCIA                   ;METROPOLITANA;289990;1;1;1;1;289990;0;0;0;LED 50 50UP7500 UHD SMART TV;ELECTRONICA MAYOR
5163277;;M;74;CHILENO;;Silencioso;ARICA                         ;ARICA Y PARINACOTA;306860;3;2;0;0;0;3;2;306860;LED 43 43S5305 SMART TV FULL HD;ELECTRONICA MAYOR
7490607;;M;66;CHILENO;;Boomers;SANTA MARIA                   ;VALPARAISO;102370;2;1;0;0;0;2;1;102370;PARLANTE FD-DJ530 DJ NEGRO;ELECTRONICA MAYOR
18318869;;M;29;CHILENO;;Millenial;QUELLON                       ;LOS LAGOS;457770;6;1;0;0;0;6;1;457770;LED 32 UN32T4300AGXZS HD SMART TV;ELECTRONICA MAYOR
15682250;;M;38;CHILENO;;Millenial;N/D;N/D;199980;2;2;0;0;0;2;2;199980;LED 42 KHFH4221 SMART TV;ELECTRONICA MAYOR
13373088;;M;44;CHILENO;;X;RENCA                         ;METROPOLITANA;279990;1;1;0;0;0;1;1;279990;LED 43 43UP7500 UHD SMART TV;ELECTRONICA MAYOR
16375034;;F;35;CHILENO;;Millenial;SAN ANTONIO                   ;VALPARAISO;169570;2;1;0;0;0;2;1;169570;LED 32 KHHD3221 SMART TV;ELECTRONICA MAYOR
26609820;;F;46;VENEZOLANO;;Extranjero;DALCAHUE                      ;LOS LAGOS;612480;4;2;0;0;0;4;2;612480;LED 50 UN50TU7090GXZS UHD SMART TV;ELECTRONICA MAYOR
7166203;;F;62;CHILENO;;Silencioso;PROVIDENCIA                   ;METROPOLITANA;199990;1;1;0;0;0;1;1;199990;LED 43 CS43F2 SMART TV FHD NEGRO;ELECTRONICA MAYOR
6967607;;F;68;CHILENO;;Silencioso;LOS ALAMOS                    ;BIO BIO;229990;1;1;0;0;0;1;1;229990;LED 43 43S5305 SMART TV FULL HD;ELECTRONICA MAYOR
14024076;;F;41;CHILENO;;X;N/D;N/D;359820;4;2;4;2;359820;0;0;0;LED 42 KHFH4221 SMART TV;ELECTRONICA MAYOR
9686087;;F;54;CHILENO;;X;ARICA                         ;ARICA Y PARINACOTA;299990;1;1;0;0;0;1;1;299990;LED 43 43UP7500 UHD SMART TV;ELECTRONICA MAYOR
12327016;;M;50;CHILENO;;X;LOS ANGELES                   ;BIO BIO;265830;3;2;2;1;125840;1;1;139990;PARLANTE ULTRAFUSION;ELECTRONICA MAYOR
13979881;;F;41;CHILENO;;X;PUTAENDO                      ;VALPARAISO;35670;2;1;0;0;0;2;1;35670;KARAOKE EXTRA SAVAGE MICÂ CABLEÂ BLACK 8902;ELECTRONICA MAYOR
26494311;;F;29;VENEZOLANO;;Extranjero;SAN PEDRO DE LA PAZ           ;BIO BIO;155840;2;1;2;1;155840;0;0;0;LED 42 KHFH4221 SMART TV;ELECTRONICA MAYOR
18009687;;F;29;CHILENO;;Millenial;PROVIDENCIA                   ;METROPOLITANA;296980;2;1;2;1;296980;0;0;0;LED 50 50UP7500 UHD SMART TV;ELECTRONICA MAYOR
9953496;;F;51;CHILENO;;X;ANCUD                         ;LOS LAGOS;349990;1;1;0;0;0;1;1;349990;LED 58 UN58AU7000GXZS UHD 4K SMART TV;ELECTRONICA MAYOR
13407233;;F;44;CHILENO;;X;CALBUCO                       ;LOS LAGOS;149990;1;1;0;0;0;1;1;149990;MINICOMPONENTE RN5;ELECTRONICA MAYOR
18906140;;F;28;CHILENO;;Millenial;N/D;N/D;129990;1;1;0;0;0;1;1;129990;PARLANTE ULTRAFUSION;ELECTRONICA MAYOR
5013760;;M;78;CHILENO;;Silencioso;RENCA                         ;METROPOLITANA;314570;2;1;0;0;0;2;1;314570;LED 40 UN40T5290AGXZS FHD SMART TV;ELECTRONICA MAYOR
6185179;;M;73;CHILENO;;Silencioso;VINA DEL MAR                  ;VALPARAISO;209460;3;1;0;0;0;3;1;209460;MINICOMPONENTE RN7;ELECTRONICA MAYOR
5994989;;F;74;CHILENO;;Silencioso;TALCAHUANO                    ;BIO BIO;244570;2;1;0;0;0;2;1;244570;LED 43 CS43F2 SMART TV FHD NEGRO;ELECTRONICA MAYOR
17554399;Soltero;M;30;CHILENO;PSICOPEDAGOGIA;Millenial;ARICA                         ;TARAPACA;389990;1;1;1;1;389990;0;0;0;LED 55UP7500 UHD SMART;ELECTRONICA MAYOR
6584653;;M;70;CHILENO;;Silencioso;PROVIDENCIA                   ;METROPOLITANA;297870;2;1;0;0;0;2;1;297870;LED 43 Full HD Smart TV 43PFD6825;ELECTRONICA MAYOR
22385381;;F;38;PERUANO;;Extranjero;N/D;N/D;109990;1;1;0;0;0;1;1;109990;PARLANTE ULTRAFUSION;ELECTRONICA MAYOR
15015701;;M;39;CHILENO;;X;N/D;N/D;34990;1;1;0;0;0;1;1;34990;KARAOKE 8 CITY SET MIC WIRELESS ATRIL SILVER;ELECTRONICA MAYOR
12418855;;F;49;CHILENO;;X;CONSTITUCION                  ;MAULE;399990;1;1;0;0;0;1;1;399990;LED 55 UN55TU7090GXZS SMART TV UHD;ELECTRONICA MAYOR
13558292;Soltero;M;43;CHILENO;;X;RENCA                         ;METROPOLITANA;357970;3;1;0;0;0;3;1;357970;LED 50 50PUD7625 SMART TV ULTRA HD 4K;ELECTRONICA MAYOR
20181994;;F;23;CHILENO;;Millenial;N/D;N/D;287870;2;1;0;0;0;2;1;287870;LED 43 43S5305 SMART TV FULL HD;ELECTRONICA MAYOR
15352647;;F;39;CHILENO;;X;RENCA                         ;METROPOLITANA;343980;2;1;2;1;343980;0;0;0;LED 50 UN50TU7090GXZS UHD SMART TV;ELECTRONICA MAYOR
12693052;;F;47;CHILENO;;X;PROVIDENCIA                   ;METROPOLITANA;39990;1;1;0;0;0;1;1;39990;PARLANTE SPBYF7 PORTATIL;ELECTRONICA MAYOR
5803402;;F;71;CHILENO;;Silencioso;SANTIAGO                      ;METROPOLITANA;259990;1;1;0;0;0;1;1;259990;LED 40 UN40T5290AGXZS FHD SMART TV;ELECTRONICA MAYOR
9722003;;F;60;CHILENO;;Boomers;EL BOSQUE                     ;METROPOLITANA;263160;3;1;0;0;0;3;1;263160;LED 32 KHHD3221 SMART TV;ELECTRONICA MAYOR
24384669;;M;34;BOLIVIANO;;Extranjero;N/D;N/D;401870;2;1;0;0;0;2;1;401870;LED 50 UN50TU7090GXZS UHD SMART TV;ELECTRONICA MAYOR
16019952;;F;36;CHILENO;;Millenial;LA REINA                      ;METROPOLITANA;673980;2;1;2;1;673980;0;0;0;QLED 50 QN50LS03AAGXZS FRAME SMART TV 4K;ELECTRONICA MAYOR
14138528;;F;41;CHILENO;;X;RENCA                         ;METROPOLITANA;389980;2;1;2;1;389980;0;0;0;LED 55UP7500 UHD SMART;ELECTRONICA MAYOR
19034517;;F;27;CHILENO;;Z;N/D;N/D;143980;2;1;2;1;143980;0;0;0;LED 32 CS32S1 SMART TV HD NEGRO;ELECTRONICA MAYOR
14056771;;M;41;CHILENO;;X;CAUQUENES                     ;MAULE;135480;2;1;2;1;135480;0;0;0;LED 32 KHHD3221 SMART TV;ELECTRONICA MAYOR
17097430;;M;32;CHILENO;;Millenial;TEMUCO                        ;ARAUCANIA;198540;2;1;2;1;198540;0;0;0;LED 32LM637B HD SMART;ELECTRONICA MAYOR
16433690;;F;35;CHILENO;;Millenial;N/D;N/D;336980;2;1;0;0;0;2;1;336980;LED 50 50UP7500 UHD SMART TV;ELECTRONICA MAYOR
15735682;;M;38;CHILENO;;X;N/D;N/D;73980;2;1;2;1;73980;0;0;0;PARLANTE KARAOKE MGROKR NEGRO;ELECTRONICA MAYOR
25908023;Soltero;M;43;VENEZOLANO;;Extranjero;PROVIDENCIA                   ;METROPOLITANA;1206980;2;1;2;1;1206980;0;0;0;OLED65A1 UHD SMART + MAGIC;ELECTRONICA MAYOR
20275909;;M;21;CHILENO;;Z;PROVIDENCIA                   ;METROPOLITANA;219990;1;1;1;1;219990;0;0;0;LED 43 43S5305 SMART TV FULL HD;ELECTRONICA MAYOR
13777629;;F;42;CHILENO;;X;REQUINOA                      ;L.G.B.OÂ´HIGGINS;24540;2;1;2;1;24540;0;0;0;KARAOKE EXTRA SAVAGE MICÂ CABLEÂ BLACK 8902;ELECTRONICA MAYOR
18543353;;F;28;CHILENO;;Millenial;LEBU                          ;BIO BIO;202960;3;1;3;1;202960;0;0;0;LED 42 KHFH4221 SMART TV;ELECTRONICA MAYOR
16155095;;F;36;CHILENO;;Silencioso;PROVIDENCIA                   ;METROPOLITANA;185840;2;1;2;1;185840;0;0;0;LED 32 UN32T4300AGXZS HD SMART TV;ELECTRONICA MAYOR
17225518;;M;33;CHILENO;;Millenial;TALAGANTE;METROPOLITANA;143980;2;1;2;1;143980;0;0;0;SOUNDBAR HW-A450/ZS;ELECTRONICA MAYOR
9459244;;M;57;CHILENO;;Boomers;VINA DEL MAR                  ;VALPARAISO;209990;1;1;1;1;209990;0;0;0;LED 43 43S5305 SMART TV FULL HD;ELECTRONICA MAYOR
6066317;Casado;M;64;CHILENO;;Boomers;RENCA                         ;METROPOLITANA;209990;1;1;0;0;0;1;1;209990;LED 32LM637B HD SMART;ELECTRONICA MAYOR
11668415;;F;51;CHILENO;;X;SAN BERNARDO                  ;METROPOLITANA;263980;2;1;2;1;263980;0;0;0;MINICOMPONENTE RN9;ELECTRONICA MAYOR
17188178;;M;32;CHILENO;;Silencioso;PROVIDENCIA                   ;METROPOLITANA;141980;2;1;2;1;141980;0;0;0;LED 32 CS32S1 SMART TV HD NEGRO;ELECTRONICA MAYOR
19339995;;F;25;CHILENO;;Z;N/D;N/D;129990;1;1;1;1;129990;0;0;0;LED 32 KHHD3221 SMART TV;ELECTRONICA MAYOR
8325682;Soltero;M;64;CHILENO;;Boomers;CARTAGENA                     ;VALPARAISO;493260;3;1;0;0;0;3;1;493260;LED 55UP7500 UHD SMART;ELECTRONICA MAYOR
10177546;;M;57;CHILENO;;Boomers;OVALLE                        ;COQUIMBO;199990;1;1;0;0;0;1;1;199990;LED 32LM637B HD SMART;ELECTRONICA MAYOR
10174452;;M;57;CHILENO;;Boomers;RENCA                         ;METROPOLITANA;258980;2;1;0;0;0;2;1;258980;MINICOMPONENTE RN7;ELECTRONICA MAYOR
17634730;;M;32;CHILENO;;Millenial;QUILLOTA                      ;VALPARAISO;424980;2;1;2;1;424980;0;0;0;LED 55 55UP7750 UHD SMART + MAGIC;ELECTRONICA MAYOR
26998706;;F;31;VENEZOLANO;;Extranjero;N/D;N/D;339990;1;1;0;0;0;1;1;339990;LED 50 UN50TU7090GXZS UHD SMART TV;ELECTRONICA MAYOR
8392441;;F;65;CHILENO;;Boomers;LA PINTANA                    ;METROPOLITANA;489980;2;1;0;0;0;2;1;489980;LED 60UP7750 UHD SMART + MAGIC;ELECTRONICA MAYOR
15892487;;M;37;CHILENO;;Millenial;EL BOSQUE                     ;METROPOLITANA;512270;2;1;0;0;0;2;1;512270;LED 70 UN70AU7000GXZS UHD;ELECTRONICA MAYOR
11755404;;F;50;CHILENO;;Silencioso;PROVIDENCIA                   ;METROPOLITANA;647870;2;1;0;0;0;2;1;647870;LED 65UP7500 UHD SMART;ELECTRONICA MAYOR
9508045;Casado;M;59;CHILENO;;Boomers;RENCA                         ;METROPOLITANA;349990;1;1;0;0;0;1;1;349990;LED 55 CS55F2 UHD SMART TV LINUX;ELECTRONICA MAYOR
19502822;;F;25;CHILENO;;Z;TALAGANTE                     ;METROPOLITANA;26990;1;1;0;0;0;1;1;26990;KARAOKE STREET SONG 4 MICÂ CABLEÂ BLACK 8900;ELECTRONICA MAYOR
11505262;;F;52;CHILENO;;X;ARICA                         ;TARAPACA;469860;3;1;0;0;0;3;1;469860;LED 55UP7500 UHD SMART;ELECTRONICA MAYOR
19512317;;F;24;CHILENO;;Z;PROVIDENCIA                   ;METROPOLITANA;79990;1;1;1;1;79990;0;0;0;PARLANTE KARAOKE MGROKR NEGRO;ELECTRONICA MAYOR
10870239;;F;55;CHILENO;;Boomers;TOME                          ;BIO BIO;50000;1;2;0;0;0;1;2;50000;PARLANTE KARAOKE MGROKR NEGRO;ELECTRONICA MAYOR
15819899;;M;38;CHILENO;;Millenial;PROVIDENCIA                   ;METROPOLITANA;664980;2;1;2;1;664980;0;0;0;LED 70 UN70AU7000GXZS UHD;ELECTRONICA MAYOR
13316823;;F;45;CHILENO;;Silencioso;PROVIDENCIA                   ;METROPOLITANA;373770;2;1;0;0;0;2;1;373770;LED 43 43UP7500 UHD SMART TV;ELECTRONICA MAYOR
13719185;;M;43;CHILENO;;X;N/D;N/D;91270;2;1;0;0;0;2;1;91270;PARLANTE KARAOKE MGROKR NEGRO;ELECTRONICA MAYOR
10653065;;F;45;CHILENO;;X;QUELLON                       ;LOS LAGOS;348540;2;1;2;1;348540;0;0;0;LED 50 UN50TU7090GXZS UHD SMART TV;ELECTRONICA MAYOR
18979762;;F;26;CHILENO;;Z;N/D;N/D;24990;1;1;0;0;0;1;1;24990;KARAOKE STREET SONG 4 MICÂ CABLEÂ BLACK 8900;ELECTRONICA MAYOR
14591779;;F;42;CHILENO;;X;PROVIDENCIA                   ;METROPOLITANA;229980;2;1;0;0;0;2;1;229980;LED 32 UN32T4300AGXZS HD SMART TV;ELECTRONICA MAYOR
14176759;;F;40;CHILENO;;X;ANTOFAGASTA                   ;ANTOFAGASTA;249640;2;1;2;1;249640;0;0;0;LED 40 UN40T5290AGXZS FHD SMART TV;ELECTRONICA MAYOR
4630470;;M;77;CHILENO;;Silencioso;CONCEPCION                    ;BIO BIO;231570;2;1;0;0;0;2;1;231570;LED 32 UN32T4300AGXZS HD SMART TV;ELECTRONICA MAYOR
11079148;;F;55;CHILENO;;Boomers;SAN CARLOS                    ;BIO BIO;149990;1;1;0;0;0;1;1;149990;LED 32 KHHD3221 SMART TV;ELECTRONICA MAYOR
10866761;;F;54;CHILENO;;X;PETORCA                       ;VALPARAISO;169990;1;1;0;0;0;1;1;169990;LED 32 KHHD3221 SMART TV;ELECTRONICA MAYOR
8373154;;M;62;CHILENO;;Boomers;PROVIDENCIA                   ;METROPOLITANA;314540;2;1;2;1;314540;0;0;0;LED 43 UN43TU7090GXZS UHD SMART TV;ELECTRONICA MAYOR
26181405;;M;30;EXTRANJERO - NO INFORMA NACIONALIDAD;;Extranjero;CALAMA                        ;ANTOFAGASTA;279990;1;1;0;0;0;1;1;279990;LED 50 KHUH5021 SMART TV;ELECTRONICA MAYOR
16057703;;M;37;CHILENO;;Millenial;TUCAPEL                       ;BIO BIO;150670;4;1;0;0;0;4;1;150670;LED 32 KHHD3221 SMART TV;ELECTRONICA MAYOR
9650591;;M;60;CHILENO;;Boomers;DIEGO DE ALMAGRO              ;ATACAMA;411870;2;1;0;0;0;2;1;411870;LED 50 50UP7500 UHD SMART TV;ELECTRONICA MAYOR
27061029;;F;51;VENEZOLANO;;Extranjero;CORONEL                       ;BIO BIO;100000;0;2;0;0;0;0;2;100000;LED 50 UN50TU7090GXZS UHD SMART TV;ELECTRONICA MAYOR
18774340;;F;28;CHILENO;;Millenial;PETORCA                       ;VALPARAISO;209990;1;1;0;0;0;1;1;209990;LED 32LM637B HD SMART;ELECTRONICA MAYOR
14748822;;M;59;ECUATORIANO;;Extranjero;"";"";450000;2;1;0;0;0;2;1;450000;LED 55 UN55TU7090GXZS SMART TV UHD;ELECTRONICA MAYOR
17003027;;M;33;CHILENO;;Millenial;ARICA                         ;TARAPACA;349990;1;1;0;0;0;1;1;349990;LED 50 UN50TU7090GXZS UHD SMART TV;ELECTRONICA MAYOR
7861475;;M;63;CHILENO;;Boomers;NANCAGUA                      ;L.G.B.OÂ´HIGGINS;289570;2;1;0;0;0;2;1;289570;LED 40 UN40T5290AGXZS FHD SMART TV;ELECTRONICA MAYOR
14337819;;M;45;CHILENO;;X;REQUINOA                      ;L.G.B.OÂ´HIGGINS;259670;2;1;0;0;0;2;1;259670;MINICOMPONENTE MX-T50/ZS ALL IN ONE;ELECTRONICA MAYOR
17469749;Soltero;F;32;CHILENO;INGENIERO EN PREVENCION DE RIESGOS;Millenial;PROVIDENCIA                   ;METROPOLITANA;199990;1;1;0;0;0;1;1;199990;LED 32 UN32T4300AGXZS HD SMART TV;ELECTRONICA MAYOR
72265000;;M;118;CHILENO;;Extranjero;PROVIDENCIA                   ;METROPOLITANA;139990;1;1;0;0;0;1;1;139990;MINICOMPONENTE CJ45;ELECTRONICA MAYOR
18587010;;F;28;CHILENO;;Millenial;VICTORIA                      ;ARAUCANIA;249980;2;2;0;0;0;2;2;249980;LED 43 CS43S1USM UHD SMART TV NEGRO;ELECTRONICA MAYOR
11520576;;M;51;CHILENO;;X;N/D;N/D;212710;2;1;0;0;0;2;1;212710;PARLANTE ULTRAFORCE-I;ELECTRONICA MAYOR
5239568;;F;78;CHILENO;;Silencioso;VINA DEL MAR                  ;VALPARAISO;215070;5;1;0;0;0;5;1;215070;LED 32 KHHD3221 SMART TV;ELECTRONICA MAYOR
12184492;Casado;M;49;CHILENO;;X;N/D;N/D;181570;4;1;0;0;0;4;1;181570;LED 32 KHHD3221 SMART TV;ELECTRONICA MAYOR
8422650;;F;62;CHILENO;;Boomers;RENCA                         ;METROPOLITANA;49990;1;1;0;0;0;1;1;49990;KARAOKE RHYTHM CHARGER 12 MIC CABLE 8890;ELECTRONICA MAYOR
11320515;;M;53;CHILENO;;X;SAN RAFAEL                    ;MAULE;413740;4;2;0;0;0;4;2;413740;KARAOKE TOWER OUTDOOR POWER MIC BT BK 8571;ELECTRONICA MAYOR
12191940;;M;49;CHILENO;;X;N/D;N/D;129990;1;1;0;0;0;1;1;129990;MINICOMPONENTE CJ45;ELECTRONICA MAYOR
14583387;;M;44;CHILENO;;X;IQUIQUE                       ;TARAPACA;259990;1;1;0;0;0;1;1;259990;LED 40 UN40T5290AGXZS FHD SMART TV;ELECTRONICA MAYOR
10111889;;M;57;CHILENO;;Boomers;LA SERENA                     ;COQUIMBO;198760;3;1;0;0;0;3;1;198760;LED 32 UN32T4300AGXZS HD SMART TV;ELECTRONICA MAYOR
13174858;;M;45;CHILENO;;X;MELIPILLA                     ;METROPOLITANA;0;0;0;0;0;0;0;0;0;LED 50 UN50TU7090GXZS UHD SMART TV;ELECTRONICA MAYOR
14528597;;M;47;CHILENO;;X;CURICO                        ;MAULE;0;0;0;0;0;0;0;0;0;MINICOMPONENTE MHC-V02 ALL IN ONE;ELECTRONICA MAYOR
9385714;;F;62;CHILENO;;Boomers;VALLENAR;ATACAMA;0;0;0;0;0;0;0;0;0;LED 43 43LM6370 SMART TV FHD;ELECTRONICA MAYOR
9497220;;M;59;CHILENO;;Boomers;LAMPA                         ;METROPOLITANA;0;0;0;0;0;0;0;0;0;LED 50 50NANO75 NanoCell UHD SMART + MAGIC;ELECTRONICA MAYOR
9313751;Soltero;F;60;CHILENO;;Boomers;RENCA                         ;METROPOLITANA;0;0;0;0;0;0;0;0;0;LED 32 KHHD3221 SMART TV;ELECTRONICA MAYOR
14216430;;M;40;CHILENO;;X;N/D;N/D;0;0;0;0;0;0;0;0;0;LED 65UP7500 UHD SMART;ELECTRONICA MAYOR
20464958;;M;22;CHILENO;;Z;PROVIDENCIA                   ;METROPOLITANA;0;0;0;0;0;0;0;0;0;MINICOMPONENTE OL45;ELECTRONICA MAYOR
11929211;;F;55;CHILENO;;Boomers;DALCAHUE                      ;LOS LAGOS;0;0;0;0;0;0;0;0;0;MINICOMPONENTE OL45;ELECTRONICA MAYOR
10109668;;F;55;CHILENO;;Boomers;RENCA                         ;METROPOLITANA;0;0;0;0;0;0;0;0;0;PARLANTE ULTRAFORCE-I;ELECTRONICA MAYOR
17074866;;M;33;CHILENO;;Silencioso;PROVIDENCIA                   ;METROPOLITANA;0;0;0;0;0;0;0;0;0;LED 50 UN50TU7090GXZS UHD SMART TV;ELECTRONICA MAYOR
23885487;;F;31;CHILENO;;Extranjero;N/D;N/D;0;0;0;0;0;0;0;0;0;LED 50 UN50TU7090GXZS UHD SMART TV;ELECTRONICA MAYOR
17399876;;F;32;CHILENO;;Millenial;NIQUEN                        ;BIO BIO;0;0;0;0;0;0;0;0;0;LED KIOTO 32 MI3228 SMART TV;ELECTRONICA MAYOR
16460976;;M;35;CHILENO;;Millenial;N/D;N/D;0;0;0;0;0;0;0;0;0;LED 43 43UP7500 UHD SMART TV;ELECTRONICA MAYOR
11354465;;M;53;CHILENO;;X;TEMUCO                        ;ARAUCANIA;0;0;0;0;0;0;0;0;0;LED 32LM637B HD SMART;ELECTRONICA MAYOR
13918411;;M;41;CHILENO;;X;N/D;N/D;0;0;0;0;0;0;0;0;0;MINICOMPONENTE OL45;ELECTRONICA MAYOR
6779275;;M;66;CHILENO;;Silencioso;PROVIDENCIA                   ;METROPOLITANA;0;0;0;0;0;0;0;0;0;LED 40 UN40T5290AGXZS FHD SMART TV;ELECTRONICA MAYOR
10040174;;M;58;CHILENO;;Boomers;PERALILLO                     ;L.G.B.OÂ´HIGGINS;0;0;0;0;0;0;0;0;0;LED 50 50U6305 SMART TV ULTRA HD;ELECTRONICA MAYOR
13124516;;M;47;CHILENO;;Extranjero;NATALES                       ;MAGALLANES;0;0;0;0;0;0;0;0;0;LED KIOTO 32 MI3228 SMART TV;ELECTRONICA MAYOR
6264612;Casado;M;69;CHILENO;PROFESOR;Silencioso;RENCA                         ;METROPOLITANA;0;0;0;0;0;0;0;0;0;SOUNDBAR SK1;ELECTRONICA MAYOR
6983799;;M;76;CHILENO;;Silencioso;CALBUCO                       ;LOS LAGOS;0;0;0;0;0;0;0;0;0;MINICOMPONENTE OL45;ELECTRONICA MAYOR
16505148;Soltero;F;35;CHILENO;;Silencioso;PROVIDENCIA                   ;METROPOLITANA;0;0;0;0;0;0;0;0;0;LED 50 50U6305 SMART TV ULTRA HD;ELECTRONICA MAYOR
6708286;Casado;M;66;CHILENO;;Boomers;MELIPILLA                     ;METROPOLITANA;0;0;0;0;0;0;0;0;0;LED 40 UN40T5290AGXZS FHD SMART TV;ELECTRONICA MAYOR
11450374;;F;53;CHILENO;;X;CANETE                        ;BIO BIO;0;0;0;0;0;0;0;0;0;LED 49 49UN7100 UHD SMART TV;ELECTRONICA MAYOR
5946474;Casado;M;73;CHILENO;;Silencioso;PROVIDENCIA                   ;METROPOLITANA;0;0;0;0;0;0;0;0;0;MINICOMPONENTE RN7;ELECTRONICA MAYOR
20111816;;F;23;CHILENO;;Millenial;"";"";0;0;0;0;0;0;0;0;0;PARLANTE SPBYF7 PORTATIL;ELECTRONICA MAYOR
19769344;;F;24;CHILENO;;Z;N/D;N/D;0;0;0;0;0;0;0;0;0;PARLANTE COBRA;ELECTRONICA MAYOR
10316923;;M;54;CHILENO;;X;ARAUCO                        ;BIO BIO;0;0;0;0;0;0;0;0;0;LED KIOTO 32 MI3228 SMART TV;ELECTRONICA MAYOR
6730586;;M;70;CHILENO;;Silencioso;PARRAL                        ;MAULE;0;0;0;0;0;0;0;0;0;LED 43 Full HD Smart TV 43PFD6825;ELECTRONICA MAYOR
6431212;;F;68;CHILENO;;Silencioso;MAIPU                         ;METROPOLITANA;0;0;0;0;0;0;0;0;0;LED 43 Full HD Smart TV 43PFD6825;ELECTRONICA MAYOR
20161308;;F;22;CHILENO;;Z;N/D;N/D;0;0;0;0;0;0;0;0;0;KARAOKE STREET SONG 4 MICÂ CABLEÂ BLACK 8900;ELECTRONICA MAYOR
10368417;;F;58;CHILENO;;Boomers;LA FLORIDA                    ;METROPOLITANA;0;0;0;0;0;0;0;0;0;MINICOMPONENTE MHC-V02 ALL IN ONE;ELECTRONICA MAYOR
8625660;;M;61;CHILENO;;Boomers;RENCA                         ;METROPOLITANA;0;0;0;0;0;0;0;0;0;PARLANTE ULTRAMEGA;ELECTRONICA MAYOR
12457571;;M;49;CHILENO;;X;RENCA                         ;METROPOLITANA;0;0;0;0;0;0;0;0;0;MINICOMPONENTE MHC-V02 ALL IN ONE;ELECTRONICA MAYOR
16151485;;F;36;CHILENO;;Silencioso;PROVIDENCIA                   ;METROPOLITANA;0;0;0;0;0;0;0;0;0;LED KIOTO 32 MI3228 SMART TV;ELECTRONICA MAYOR
12324045;;F;50;CHILENO;;X;N/D;N/D;0;0;0;0;0;0;0;0;0;LED 50 CS50S1USM UHD SMART TV NEGRO;ELECTRONICA MAYOR
8153140;;M;62;CHILENO;;Boomers;SAN VICENTE                   ;L.G.B.OÂ´HIGGINS;0;0;0;0;0;0;0;0;0;PARLANTE ULTRAFORCE-I;ELECTRONICA MAYOR
15779814;;M;38;CHILENO;;X;PROVIDENCIA                   ;METROPOLITANA;0;0;0;0;0;0;0;0;0;PARLANTE ULTRASENSATION;ELECTRONICA MAYOR
17694367;;M;31;CHILENO;;Millenial;VALDIVIA                      ;LOS RIOS;0;0;0;0;0;0;0;0;0;PARLANTE ULTRAFORCE-I;ELECTRONICA MAYOR
9063289;;M;59;CHILENO;;Boomers;CHIGUAYANTE                   ;BIO BIO;0;0;0;0;0;0;0;0;0;LED KIOTO 32 MI3228 SMART TV;ELECTRONICA MAYOR
10616109;;F;58;CHILENO;;Boomers;CALAMA                        ;ANTOFAGASTA;0;0;0;0;0;0;0;0;0;LED 55 UN55TU7090GXZS SMART TV UHD;ELECTRONICA MAYOR
16086177;;M;36;CHILENO;;Millenial;CERRO NAVIA                   ;METROPOLITANA;0;0;0;0;0;0;0;0;0;MINICOMPONENTE RN7;ELECTRONICA MAYOR
14570157;;M;45;CHILENO;;X;PROVIDENCIA                   ;METROPOLITANA;0;0;0;0;0;0;0;0;0;PARLANTE ULTRASENSATION;ELECTRONICA MAYOR
9329860;Casado;M;60;CHILENO;;Boomers;RANCAGUA                      ;L.G.B.OÂ´HIGGINS;0;0;0;0;0;0;0;0;0;KARAOKE FUNKY DISCO;ELECTRONICA MAYOR
12110158;;F;53;CHILENO;;X;TEMUCO                        ;ARAUCANIA;0;0;0;0;0;0;0;0;0;LED 32 CS32S1 SMART TV HD NEGRO;ELECTRONICA MAYOR
13586149;;M;43;CHILENO;;X;PANGUIPULLI                   ;LOS LAGOS;0;0;0;0;0;0;0;0;0;PARLANTE BT T15 NEGRO + ATRIL;ELECTRONICA MAYOR
15791970;Casado;F;37;CHILENO;;Millenial;PROVIDENCIA                   ;METROPOLITANA;0;0;0;0;0;0;0;0;0;LED 43 UN43TU7090GXZS UHD SMART TV;ELECTRONICA MAYOR
16514883;;F;35;CHILENO;;Silencioso;PROVIDENCIA                   ;METROPOLITANA;0;0;0;0;0;0;0;0;0;LED 50 UN50TU7090GXZS UHD SMART TV;ELECTRONICA MAYOR
15881877;;M;37;CHILENO;;Millenial;MAIPU                         ;METROPOLITANA;0;0;0;0;0;0;0;0;0;LED 32LM637B HD SMART;ELECTRONICA MAYOR
20344304;;F;22;CHILENO;;Z;N/D;N/D;0;0;0;0;0;0;0;0;0;LED KIOTO 32 MI3228 SMART TV;ELECTRONICA MAYOR
14334484;;M;44;CHILENO;;Silencioso;PROVIDENCIA                   ;METROPOLITANA;0;0;0;0;0;0;0;0;0;PARLANTE ULTRAMEGA;ELECTRONICA MAYOR
12827952;;F;48;CHILENO;;X;LAS CABRAS                    ;L.G.B.OÂ´HIGGINS;0;0;0;0;0;0;0;0;0;LED KIOTO 32 MI3228 SMART TV;ELECTRONICA MAYOR
11717633;;M;51;CHILENO;;X;N/D;N/D;0;0;0;0;0;0;0;0;0;LED 50 KEUH50 SMART TV UHD;ELECTRONICA MAYOR
18740733;;F;28;CHILENO;;Silencioso;PROVIDENCIA                   ;METROPOLITANA;0;0;0;0;0;0;0;0;0;LED 50 UN50TU7090GXZS UHD SMART TV;ELECTRONICA MAYOR
20221163;;F;23;CHILENO;;Z;LA CISTERNA;METROPOLITANA;0;0;0;0;0;0;0;0;0;LED KIOTO 32 MI3228 SMART TV;ELECTRONICA MAYOR
20225574;;F;22;CHILENO;;Millenial;N/D;N/D;0;0;0;0;0;0;0;0;0;LED 42 42S6500 ANDROID TV FHD;ELECTRONICA MAYOR
19238492;;F;26;CHILENO;;Z;CERRILLOS                     ;METROPOLITANA;0;0;0;0;0;0;0;0;0;LED 55 UN55TU7090GXZS SMART TV UHD;ELECTRONICA MAYOR
13901682;Casado;M;42;CHILENO;;Silencioso;PROVIDENCIA                   ;METROPOLITANA;0;0;0;0;0;0;0;0;0;LED 43 UN43T5202AGXZS FHD SMART TV;ELECTRONICA MAYOR
18781211;Soltero;M;27;CHILENO;;Silencioso;PROVIDENCIA                   ;METROPOLITANA;0;0;0;0;0;0;0;0;0;LED 43 Full HD Smart TV 43PFD6825;ELECTRONICA MAYOR
5333736;;M;73;CHILENO;;Silencioso;PENALOLEN                     ;METROPOLITANA;0;0;0;0;0;0;0;0;0;LED 32 UN32T4300AGXZS HD SMART TV;ELECTRONICA MAYOR
12802885;;M;47;CHILENO;;X;CHANARAL                      ;ATACAMA;0;0;0;0;0;0;0;0;0;LED 43 43UP7500 UHD SMART TV;ELECTRONICA MAYOR
18554580;Soltero;M;29;CHILENO;TECNOLOGO MEDICO;Millenial;PROVIDENCIA                   ;METROPOLITANA;0;0;0;0;0;0;0;0;0;LED 43UP7750 UHD SMART + MAGIC;ELECTRONICA MAYOR
7284181;;M;66;CHILENO;;Silencioso;PROVIDENCIA                   ;METROPOLITANA;0;0;0;0;0;0;0;0;0;SISTEMA DE SONIDO CM1560;ELECTRONICA MAYOR
15197848;;F;40;CHILENO;;Z;CURANILAHUE                   ;BIO BIO;0;0;0;0;0;0;0;0;0;PARLANTE ULTRAMAGIC;ELECTRONICA MAYOR
15038018;;F;34;CHILENO;;Millenial;RENCA                         ;METROPOLITANA;0;0;0;0;0;0;0;0;0;LED 50 50PUD6513/44 SMART TV UHD 4K;ELECTRONICA MAYOR
16655159;;M;38;CHILENO;;Millenial;PROVIDENCIA                   ;METROPOLITANA;0;0;0;0;0;0;0;0;0;LED 50 UN50TU7090GXZS UHD SMART TV;ELECTRONICA MAYOR
12690202;;F;47;CHILENO;;X;PROVIDENCIA                   ;METROPOLITANA;0;0;0;0;0;0;0;0;0;LED 60 UN60AU8000GXZS UHD SMART TV;ELECTRONICA MAYOR
11860060;;M;50;CHILENO;;X;RENCA                         ;METROPOLITANA;0;0;0;0;0;0;0;0;0;MAGIC REMOTE MR20GA;ELECTRONICA MAYOR
23039104;;M;37;CHILENO;;Millenial;QUILPUE                       ;VALPARAISO;0;0;0;0;0;0;0;0;0;BARRA DE SONIDO HT-S350;ELECTRONICA MAYOR
16701071;;M;34;CHILENO;;Millenial;CABILDO                       ;VALPARAISO;0;0;0;0;0;0;0;0;0;LED KIOTO 32 MI3228 SMART TV;ELECTRONICA MAYOR
19288430;;M;26;CHILENO;;Z;N/D;N/D;0;0;0;0;0;0;0;0;0;LED 43 43S5295 SMART TV FHD;ELECTRONICA MAYOR
13304862;;F;45;CHILENO;;X;N/D;N/D;0;0;0;0;0;0;0;0;0;PARLANTE ULTRAFORCE-I;ELECTRONICA MAYOR
15137105;;M;39;CHILENO;;Silencioso;PROVIDENCIA                   ;METROPOLITANA;0;0;0;0;0;0;0;0;0;LED 50 UN50TU7090GXZS UHD SMART TV;ELECTRONICA MAYOR
11875079;;F;51;CHILENO;;X;PUDAHUEL                      ;METROPOLITANA;0;0;0;0;0;0;0;0;0;MONITOR 24 24TL520S SMART TV HD;ELECTRONICA MAYOR
17993648;;F;30;CHILENO;;Millenial;PROVIDENCIA                   ;METROPOLITANA;0;0;0;0;0;0;0;0;0;LED 50 UN50TU7090GXZS UHD SMART TV;ELECTRONICA MAYOR
8678824;;F;63;CHILENO;;Boomers;VICTORIA                      ;ARAUCANIA;0;0;0;0;0;0;0;0;0;MINICOMPONENTE RN7;ELECTRONICA MAYOR
17318952;Soltero;F;32;CHILENO;CONTADOR AUDITOR;Millenial;PROVIDENCIA                   ;METROPOLITANA;0;0;0;0;0;0;0;0;0;MONITOR 24 24TL520S SMART TV HD;ELECTRONICA MAYOR
20196190;;M;22;CHILENO;;Z;N/D;N/D;0;0;0;0;0;0;0;0;0;LED 50 50U6305 SMART TV ULTRA HD;ELECTRONICA MAYOR
17438411;Soltero;M;32;CHILENO;TECNICO EN MANTENCION INDUSTRIAL;Millenial;PROVIDENCIA                   ;METROPOLITANA;0;0;0;0;0;0;0;0;0;LED 60 UN60AU8000GXZS UHD SMART TV;ELECTRONICA MAYOR
9020107;;M;62;CHILENO;;Boomers;CUNCO                         ;ARAUCANIA;0;0;0;0;0;0;0;0;0;PARLANTE COBRA;ELECTRONICA MAYOR
12120278;;F;51;CHILENO;;X;PADRE HURTADO                 ;METROPOLITANA;0;0;0;0;0;0;0;0;0;LED 32 32PHD5813 SMART TV HD;ELECTRONICA MAYOR
7626823;Casado;M;66;CHILENO;;Silencioso;PROVIDENCIA                   ;METROPOLITANA;0;0;0;0;0;0;0;0;0;PARLANTE BT T15 NEGRO + ATRIL;ELECTRONICA MAYOR
11205969;;F;55;CHILENO;;Boomers;PROVIDENCIA                   ;METROPOLITANA;0;0;0;0;0;0;0;0;0;LED 50 UN50TU7090GXZS UHD SMART TV;ELECTRONICA MAYOR
15368441;;F;40;CHILENO;;X;VALDIVIA                      ;LOS RIOS;0;0;0;0;0;0;0;0;0;LED KIOTO 32 MI3228 SMART TV;ELECTRONICA MAYOR
23876168;;F;41;COLOMBIANO;;Extranjero;CALAMA                        ;ANTOFAGASTA;0;0;0;0;0;0;0;0;0;LED 50 50U6295 SMART TV UHD;ELECTRONICA MAYOR
18908420;;F;27;CHILENO;;Millenial;"";"";0;0;0;0;0;0;0;0;0;LED 40 40PFD6825 UHD Smart TV;ELECTRONICA MAYOR
18448149;;F;28;CHILENO;;Millenial;SAN ANTONIO                   ;VALPARAISO;0;0;0;0;0;0;0;0;0;PARLANTE KARAOKE 12 FM/BT/USB;ELECTRONICA MAYOR
8764553;;F;60;CHILENO;;Boomers;LA LIGUA                      ;VALPARAISO;0;0;0;0;0;0;0;0;0;LED 55 UN55TU7090GXZS SMART TV UHD;ELECTRONICA MAYOR
14119210;;M;41;CHILENO;;Silencioso;PROVIDENCIA                   ;METROPOLITANA;0;0;0;0;0;0;0;0;0;LED 49 49UN7100 UHD SMART TV;ELECTRONICA MAYOR
13923226;Casado;M;42;CHILENO;;Silencioso;PROVIDENCIA                   ;METROPOLITANA;0;0;0;0;0;0;0;0;0;LED 43 UN43T5202AGXZS FHD SMART TV;ELECTRONICA MAYOR
26844811;;F;45;VENEZOLANO;;Extranjero;CONCEPCION                    ;BIO BIO;0;0;0;0;0;0;0;0;0;LED 55 55UN7100 UHD SMART TV;ELECTRONICA MAYOR
8928976;;F;58;CHILENO;;Boomers;RENCA                         ;METROPOLITANA;0;0;0;0;0;0;0;0;0;LED KIOTO 32 MI3228 SMART TV;ELECTRONICA MAYOR
10762847;Soltero;F;56;CHILENO;;Boomers;PROVIDENCIA                   ;METROPOLITANA;0;0;0;0;0;0;0;0;0;MINICOMPONENTE CJ45;ELECTRONICA MAYOR
17917556;;M;31;CHILENO;;Millenial;N/D;N/D;0;0;0;0;0;0;0;0;0;MINICOMPONENTE RN5;ELECTRONICA MAYOR
16978875;Soltero;M;33;CHILENO;;Millenial;PROVIDENCIA                   ;METROPOLITANA;0;0;0;0;0;0;0;0;0;LED 49 49UN7100 UHD SMART TV;ELECTRONICA MAYOR
16035973;;M;37;CHILENO;;Millenial;HUALPEN;BIO BIO;0;0;0;0;0;0;0;0;0;KARAOKE BLACK PHANTER II;ELECTRONICA MAYOR
18055130;;F;29;CHILENO;;Millenial;SAN JOAQUIN                   ;METROPOLITANA;0;0;0;0;0;0;0;0;0;LED 50 UN50TU7090GXZS UHD SMART TV;ELECTRONICA MAYOR
16765655;;F;34;CHILENO;;Millenial;N/D;N/D;0;0;0;0;0;0;0;0;0;SOUNDBAR SK1;ELECTRONICA MAYOR
11780742;;M;53;CHILENO;;Silencioso;PROVIDENCIA                   ;METROPOLITANA;0;0;0;0;0;0;0;0;0;LED 40 KEHD4020 SMART TV;ELECTRONICA MAYOR
17157206;;F;32;CHILENO;;Millenial;PROVIDENCIA                   ;METROPOLITANA;0;0;0;0;0;0;0;0;0;LED 32 UN32T4300AGXZS HD SMART TV;ELECTRONICA MAYOR
16828762;Casado;M;34;CHILENO;INGENIERO INFORMATICO;Silencioso;PROVIDENCIA                   ;METROPOLITANA;0;0;0;0;0;0;0;0;0;LED 43 UN43T5202AGXZS FHD SMART TV;ELECTRONICA MAYOR
19940348;;F;24;CHILENO;;Silencioso;PROVIDENCIA                   ;METROPOLITANA;0;0;0;0;0;0;0;0;0;LED 50 KEUH50 SMART TV UHD;ELECTRONICA MAYOR
12550891;;F;48;CHILENO;;X;CHILLAN                       ;NUBLE;0;0;0;0;0;0;0;0;0;LED 32 32LM630BPSB SMART TV;ELECTRONICA MAYOR
14367512;;M;48;CHILENO;;X;PROVIDENCIA                   ;METROPOLITANA;0;0;0;0;0;0;0;0;0;LED 55 55UN7100 UHD SMART TV;ELECTRONICA MAYOR
8344872;;F;50;CHILENO;;X;PROVIDENCIA                   ;METROPOLITANA;0;0;0;0;0;0;0;0;0;LED 50 UN50TU7090GXZS UHD SMART TV;ELECTRONICA MAYOR
14185042;;M;41;CHILENO;;X;TIRUA                         ;BIO BIO;0;0;0;0;0;0;0;0;0;LED 42 42S6500 ANDROID TV FHD;ELECTRONICA MAYOR
16620780;Soltero;M;34;CHILENO;;Silencioso;PROVIDENCIA                   ;METROPOLITANA;0;0;0;0;0;0;0;0;0;LED 43 UN43T5202AGXZS FHD SMART TV;ELECTRONICA MAYOR
15254933;;M;39;CHILENO;;X;PROVIDENCIA                   ;METROPOLITANA;0;0;0;0;0;0;0;0;0;LED 55 55P615 UHD ANDROID TV 4K;ELECTRONICA MAYOR
9778046;;F;60;CHILENO;;Boomers;VALDIVIA                      ;LOS RIOS;0;0;0;0;0;0;0;0;0;LED KIOTO 32 MI3228 SMART TV;ELECTRONICA MAYOR
9073240;;M;60;CHILENO;;Boomers;PELLUHUE                      ;MAULE;0;0;0;0;0;0;0;0;0;LED 40 KEHD4020 SMART TV;ELECTRONICA MAYOR
12075133;;F;63;CHILENO;;Boomers;PROVIDENCIA                   ;METROPOLITANA;0;0;0;0;0;0;0;0;0;LED 43 Full HD Smart TV 43PFD6825;ELECTRONICA MAYOR
18037220;;M;30;CHILENO;;Millenial;CONCON                        ;VALPARAISO;0;0;0;0;0;0;0;0;0;SISTEMA DE SONIDO CM1560;ELECTRONICA MAYOR
6124386;Viudo;M;70;CHILENO;AGROINDUSTRIA;Silencioso;RENCA                         ;METROPOLITANA;0;0;0;0;0;0;0;0;0;LED 32 UN32T4300AGXZS HD SMART TV;ELECTRONICA MAYOR
17800464;;M;31;CHILENO;;Millenial;PROVIDENCIA                   ;METROPOLITANA;0;0;0;0;0;0;0;0;0;LED 55 55PUD6794 SMART TV UHD 4K;ELECTRONICA MAYOR
17811645;Soltero;M;30;CHILENO;;Silencioso;PROVIDENCIA                   ;METROPOLITANA;0;0;0;0;0;0;0;0;0;MINICOMPONENTE RN9;ELECTRONICA MAYOR
7096386;;F;65;CHILENO;;Boomers;ISLA DE MAIPO                 ;METROPOLITANA;0;0;0;0;0;0;0;0;0;KARAOKE URBAN AZUL;ELECTRONICA MAYOR
27225377;;M;43;EXTRANJERO - NO INFORMA NACIONALIDAD;;Extranjero;N/D;N/D;0;0;0;0;0;0;0;0;0;LED 40 KEHD4020 SMART TV;ELECTRONICA MAYOR
10458512;Casado;M;57;CHILENO;;Boomers;RENCA                         ;METROPOLITANA;0;0;0;0;0;0;0;0;0;LED 32 32PHD6825 HD SMART TV;ELECTRONICA MAYOR
11417905;;F;53;CHILENO;;X;PROVIDENCIA                   ;METROPOLITANA;0;0;0;0;0;0;0;0;0;LED 49 49UN7100 UHD SMART TV;ELECTRONICA MAYOR
10757176;;F;53;CHILENO;;X;PUNTA ARENAS                  ;MAGALLANES;0;0;0;0;0;0;0;0;0;KARAOKE BLACK PHANTER II;ELECTRONICA MAYOR
13903651;;F;42;CHILENO;;Millenial;PUENTE ALTO                   ;METROPOLITANA;0;0;0;0;0;0;0;0;0;LED 50 KEUH50 SMART TV UHD;ELECTRONICA MAYOR
16908936;;M;34;CHILENO;;Silencioso;PROVIDENCIA                   ;METROPOLITANA;0;0;0;0;0;0;0;0;0;LED 49 49UN7100 UHD SMART TV;ELECTRONICA MAYOR
13952125;;M;42;CHILENO;;X;CHILLAN                       ;BIO BIO;0;0;0;0;0;0;0;0;0;SOUNDBAR HW-T400/ZS;ELECTRONICA MAYOR
14187518;;F;40;CHILENO;;X;N/D;N/D;0;0;0;0;0;0;0;0;0;MINICOMPONENTE MX-T50/ZS ALL IN ONE;ELECTRONICA MAYOR
21104107;;F;26;CHILENO;;Z;TEMUCO                        ;ARAUCANIA;0;0;0;0;0;0;0;0;0;LED 50 50PUD6513/44 SMART TV UHD 4K;ELECTRONICA MAYOR
13990235;Divorciado;F;41;CHILENO;;X;PROVIDENCIA                   ;METROPOLITANA;0;0;0;0;0;0;0;0;0;LED 43 UN43T5202AGXZS FHD SMART TV;ELECTRONICA MAYOR
14905022;;F;42;CHILENO;;X;PROVIDENCIA                   ;METROPOLITANA;0;0;0;0;0;0;0;0;0;LED 40 KEHD4020 SMART TV;ELECTRONICA MAYOR
18102246;;F;29;CHILENO;;Millenial;LOS ANGELES;BIO-BIO;0;0;0;0;0;0;0;0;0;LED 50 50PUD6513/44 SMART TV UHD 4K;ELECTRONICA MAYOR
18644947;;M;27;CHILENO;;Millenial;ANGOL                         ;ARAUCANIA;0;0;0;0;0;0;0;0;0;LED 50 50PUD6513/44 SMART TV UHD 4K;ELECTRONICA MAYOR
25923970;;M;31;VENEZOLANO;;Extranjero;SANTIAGO                      ;METROPOLITANA;0;0;0;0;0;0;0;0;0;LED 40 KEHD4020 SMART TV;ELECTRONICA MAYOR
16435934;;F;36;CHILENO;;Millenial;TOCOPILLA                     ;ANTOFAGASTA;0;0;0;0;0;0;0;0;0;LED 40 KEHD4020 SMART TV;ELECTRONICA MAYOR
10275061;;M;57;CHILENO;;Boomers;LA PINTANA                    ;METROPOLITANA;0;0;0;0;0;0;0;0;0;LED 55UP7500 UHD SMART;ELECTRONICA MAYOR
15457012;;F;40;CHILENO;;X;PROVIDENCIA                   ;METROPOLITANA;0;0;0;0;0;0;0;0;0;LED 43 UN43T5202AGXZS FHD SMART TV;ELECTRONICA MAYOR
12510769;;F;49;CHILENO;;X;CARAHUE                       ;ARAUCANIA;0;0;0;0;0;0;0;0;0;LED 43 UN43T5202AGXZS FHD SMART TV;ELECTRONICA MAYOR
19858458;;F;24;CHILENO;;Z;N/D;N/D;0;0;0;0;0;0;0;0;0;PARLANTE ULTRAMAGIC;ELECTRONICA MAYOR
16415994;;M;36;CHILENO;;Millenial;PADRE HURTADO;METROPOLITANA;0;0;0;0;0;0;0;0;0;LED 32 32LM630BPSB SMART TV;ELECTRONICA MAYOR
15611154;;M;38;CHILENO;;X;SAN BERNARDO                  ;METROPOLITANA;0;0;0;0;0;0;0;0;0;QLED 55 QN55LS03AAGXZS FRAME 4K SMART TV;ELECTRONICA MAYOR
10198164;;M;46;CHILENO;;X;RENCA                         ;METROPOLITANA;0;0;0;0;0;0;0;0;0;LED 49 49UN7100 UHD SMART TV;ELECTRONICA MAYOR
13289109;;F;44;CHILENO;;X;N/D;N/D;0;0;0;0;0;0;0;0;0;LED 65 KUHK6520 UHD SMART TV;ELECTRONICA MAYOR
11848209;Soltero;F;51;CHILENO;;X;PROVIDENCIA                   ;METROPOLITANA;0;0;0;0;0;0;0;0;0;LED 55 UN55TU7090GXZS SMART TV UHD;ELECTRONICA MAYOR
5387205;;M;77;CHILENO;;Silencioso;PROVIDENCIA                   ;METROPOLITANA;0;0;0;0;0;0;0;0;0;LED 50 KEUH50 SMART TV UHD;ELECTRONICA MAYOR
13512983;;F;44;CHILENO;;X;CORONEL                       ;BIO BIO;0;0;0;0;0;0;0;0;0;LED 40 KEHD4020 SMART TV;ELECTRONICA MAYOR
11451530;;F;53;CHILENO;;X;LO PRADO                      ;METROPOLITANA;0;0;0;0;0;0;0;0;0;LED 42 42S6500 ANDROID TV FHD;ELECTRONICA MAYOR
8863347;;F;63;CHILENO;;Boomers;RECOLETA                      ;METROPOLITANA;0;0;0;0;0;0;0;0;0;LED 43 43S5295 SMART TV FHD;ELECTRONICA MAYOR
19272284;;F;26;CHILENO;;Z;PROVIDENCIA                   ;METROPOLITANA;0;0;0;0;0;0;0;0;0;SISTEMA DE SONIDO CM1560;ELECTRONICA MAYOR
15343749;;M;40;CHILENO;;Silencioso;PROVIDENCIA                   ;METROPOLITANA;0;0;0;0;0;0;0;0;0;KARAOKE EXTRA SAVAGE MICÂ CABLEÂ BLACK 8902;ELECTRONICA MAYOR
7705967;;F;68;CHILENO;;Boomers;VALDIVIA                      ;LOS RIOS;0;0;0;0;0;0;0;0;0;LED 50 UN50TU7090GXZS UHD SMART TV;ELECTRONICA MAYOR
17421986;;M;31;CHILENO;;Silencioso;PROVIDENCIA                   ;METROPOLITANA;0;0;0;0;0;0;0;0;0;LED 32 32LM630BPSB SMART TV;ELECTRONICA MAYOR
26907103;;M;27;VENEZOLANO;;Extranjero;TEMUCO                        ;ARAUCANIA;0;0;0;0;0;0;0;0;0;LED 40 KEHD4020 SMART TV;ELECTRONICA MAYOR
18443274;;M;29;CHILENO;;Millenial;PROVIDENCIA                   ;METROPOLITANA;0;0;0;0;0;0;0;0;0;LED 50 KEUH50 SMART TV UHD;ELECTRONICA MAYOR
15053581;;M;39;CHILENO;;X;LA SERENA;COQUIMBO;0;0;0;0;0;0;0;0;0;LED 32 UN32T4300AGXZS HD SMART TV;ELECTRONICA MAYOR
19802627;;F;24;CHILENO;;Silencioso;PROVIDENCIA                   ;METROPOLITANA;0;0;0;0;0;0;0;0;0;MINICOMPONENTE CJ45;ELECTRONICA MAYOR
15362787;;M;37;CHILENO;;Silencioso;VILLARICA                     ;ARAUCANIA;0;0;0;0;0;0;0;0;0;LED 32 UN32T4300AGXZS HD SMART TV;ELECTRONICA MAYOR
16935031;;M;34;CHILENO;;Millenial;N/D;N/D;0;0;0;0;0;0;0;0;0;LED 43 UN43TU7090GXZS UHD SMART TV;ELECTRONICA MAYOR
15405856;Casado;F;39;CHILENO;;X;RENCA                         ;METROPOLITANA;0;0;0;0;0;0;0;0;0;LED 40 KEHD4020 SMART TV;ELECTRONICA MAYOR
14527186;Soltero;M;47;CHILENO;TECNICO EN MANTENCION INDUSTRIAL;X;RENCA                         ;METROPOLITANA;0;0;0;0;0;0;0;0;0;LED 43 UN43TU7090GXZS UHD SMART TV;ELECTRONICA MAYOR
5353353;;F;74;CHILENO;;Silencioso;PROVIDENCIA                   ;METROPOLITANA;0;0;0;0;0;0;0;0;0;LED 32 UN32T4300AGXZS HD SMART TV;ELECTRONICA MAYOR
14118739;Casado;F;41;CHILENO;PERIODISTA;Silencioso;PROVIDENCIA                   ;METROPOLITANA;0;0;0;0;0;0;0;0;0;LED 32 32LM630BPSB SMART TV;ELECTRONICA MAYOR
15780843;;F;38;CHILENO;;Millenial;PROVIDENCIA                   ;METROPOLITANA;0;0;0;0;0;0;0;0;0;SOUNDBAR SJ2;ELECTRONICA MAYOR
18969840;;F;27;CHILENO;;Z;COPIAPO                       ;ATACAMA;0;0;0;0;0;0;0;0;0;LED 65 KUHK6520 UHD SMART TV;ELECTRONICA MAYOR
7595817;;M;67;CHILENO;;Boomers;TALCA                         ;MAULE;0;0;0;0;0;0;0;0;0;PARLANTE MGVIPER;ELECTRONICA MAYOR
12439905;;M;49;CHILENO;;X;MARIA ELENA                   ;ANTOFAGASTA;0;0;0;0;0;0;0;0;0;LED 43 UN43TU7090GXZS UHD SMART TV;ELECTRONICA MAYOR
13474501;;F;46;CHILENO;;X;PENALOLEN                     ;METROPOLITANA;0;0;0;0;0;0;0;0;0;LED 40 KEHD4020 SMART TV;ELECTRONICA MAYOR
13388181;;M;43;CHILENO;;X;RENCA                         ;METROPOLITANA;0;0;0;0;0;0;0;0;0;LED 50 UN50TU7090GXZS UHD SMART TV;ELECTRONICA MAYOR
8052206;Soltero;F;61;CHILENO;;Silencioso;PROVIDENCIA                   ;METROPOLITANA;0;0;0;0;0;0;0;0;0;LED 32 32LM630BPSB SMART TV;ELECTRONICA MAYOR
19335747;Casado;F;25;CHILENO;;Z;CONCEPCION;BIO-BIO;0;0;0;0;0;0;0;0;0;LED 32 UN32T4300AGXZS HD SMART TV;ELECTRONICA MAYOR
18906749;;M;27;CHILENO;;Silencioso;PROVIDENCIA                   ;METROPOLITANA;0;0;0;0;0;0;0;0;0;MONITOR 24 24TL520S SMART TV HD;ELECTRONICA MAYOR
7202939;Casado;M;63;CHILENO;INGENIERO CIVIL;Silencioso;PROVIDENCIA                   ;METROPOLITANA;0;0;0;0;0;0;0;0;0;LED 55 UN55TU7090GXZS SMART TV UHD;ELECTRONICA MAYOR
19194476;;M;25;CHILENO;;Z;MULCHEN;BIO-BIO;0;0;0;0;0;0;0;0;0;LED 32 UN32T4300AGXZS HD SMART TV;ELECTRONICA MAYOR
7513714;;M;63;CHILENO;;Boomers;PEDRO AGUIRRE CERDA;METROPOLITANA;0;0;0;0;0;0;0;0;0;LED 40 KEHD4020 SMART TV;ELECTRONICA MAYOR
18716922;;F;28;CHILENO;;Millenial;PROVIDENCIA                   ;METROPOLITANA;0;0;0;0;0;0;0;0;0;LED KIOTO 32 MI3228 SMART TV;ELECTRONICA MAYOR
16682079;;F;34;CHILENO;;Millenial;PROVIDENCIA                   ;METROPOLITANA;0;0;0;0;0;0;0;0;0;LED 40 KEHD4020 SMART TV;ELECTRONICA MAYOR
11218998;;F;56;CHILENO;;Boomers;COIHAIQUE                     ;AYSEN;0;0;0;0;0;0;0;0;0;LED 40 KEHD4020 SMART TV;ELECTRONICA MAYOR
11746021;;M;51;CHILENO;;X;YERBAS BUENAS                 ;MAULE;0;0;0;0;0;0;0;0;0;LED 32 32PHD5813 SMART TV HD;ELECTRONICA MAYOR
25107501;;M;32;HAITIANO;;Extranjero;N/D;N/D;0;0;0;0;0;0;0;0;0;LED 55 55UN7100 UHD SMART TV;ELECTRONICA MAYOR
6805565;;M;65;CHILENO;;Boomers;RENCA                         ;METROPOLITANA;0;0;0;0;0;0;0;0;0;LED 43 43S5295 SMART TV FHD;ELECTRONICA MAYOR
10616271;;F;47;CHILENO;;X;TALCA                         ;MAULE;0;0;0;0;0;0;0;0;0;LED 40 KEHD4020 SMART TV;ELECTRONICA MAYOR
16417401;;F;38;CHILENO;;Millenial;SAN PEDRO                     ;METROPOLITANA;0;0;0;0;0;0;0;0;0;LED 50 KEUH50 SMART TV UHD;ELECTRONICA MAYOR
20397508;;F;22;CHILENO;;Silencioso;PROVIDENCIA                   ;METROPOLITANA;0;0;0;0;0;0;0;0;0;LED 50 KEUH50 SMART TV UHD;ELECTRONICA MAYOR
15025430;;M;35;CHILENO;;Millenial;PROVIDENCIA                   ;METROPOLITANA;0;0;0;0;0;0;0;0;0;LED 50 UN50NU7095GXZS SMART TV 4K;ELECTRONICA MAYOR
11353839;;F;54;CHILENO;;X;LOS SAUCES                    ;ARAUCANIA;0;0;0;0;0;0;0;0;0;LED 50 KEUH50 SMART TV UHD;ELECTRONICA MAYOR
13803776;;F;46;CHILENO;;X;SANTA BARBARA                 ;BIO BIO;0;0;0;0;0;0;0;0;0;LED 43 UN43T5202AGXZS FHD SMART TV;ELECTRONICA MAYOR
16186510;;F;36;CHILENO;;Millenial;RENCA                         ;METROPOLITANA;0;0;0;0;0;0;0;0;0;LED 50 UN50TU7090GXZS UHD SMART TV;ELECTRONICA MAYOR
16314000;;M;36;CHILENO;;Millenial;"";"";0;0;0;0;0;0;0;0;0;LED 65 65UN7100 UHD SMART TV;ELECTRONICA MAYOR
11553011;;F;51;CHILENO;;X;PROVIDENCIA                   ;METROPOLITANA;0;0;0;0;0;0;0;0;0;LED 43 43UN7300 UHD SMART TV 4K;ELECTRONICA MAYOR
18312032;;F;29;CHILENO;;Millenial;N/D;N/D;0;0;0;0;0;0;0;0;0;LED 40 KEHD4020 SMART TV;ELECTRONICA MAYOR
17816458;;M;30;CHILENO;;Millenial;SAN ANTONIO                   ;VALPARAISO;0;0;0;0;0;0;0;0;0;LED 43 43UN7300 UHD SMART TV 4K;ELECTRONICA MAYOR
20629022;;M;21;CHILENO;;Z;N/D;N/D;0;0;0;0;0;0;0;0;0;LED 50 KEUH50 SMART TV UHD;ELECTRONICA MAYOR
17453759;;F;32;CHILENO;;Millenial;LINARES                       ;MAULE;0;0;0;0;0;0;0;0;0;LED KIOTO 32 MI3228 SMART TV;ELECTRONICA MAYOR
14517697;Divorciado;M;47;CHILENO;;X;RENCA                         ;METROPOLITANA;0;0;0;0;0;0;0;0;0;MINICOMPONENTE CJ45;ELECTRONICA MAYOR
25972233;;F;37;VENEZOLANO;;Extranjero;ESTACION CENTRAL              ;METROPOLITANA;0;0;0;0;0;0;0;0;0;LED 49 49UN7100 UHD SMART TV;ELECTRONICA MAYOR
9573572;;M;59;CHILENO;;Boomers;TEMUCO                        ;ARAUCANIA;0;0;0;0;0;0;0;0;0;LED 40 KEHD4020 SMART TV;ELECTRONICA MAYOR
9295861;;F;63;CHILENO;;Boomers;CHIGUAYANTE                   ;BIO BIO;0;0;0;0;0;0;0;0;0;LED 55 55UN7100 UHD SMART TV;ELECTRONICA MAYOR
17090275;Soltero;F;32;CHILENO;CIRUJANO DENTISTA;Silencioso;PROVIDENCIA                   ;METROPOLITANA;0;0;0;0;0;0;0;0;0;LED 50 UN50TU7090GXZS UHD SMART TV;ELECTRONICA MAYOR
27036506;;F;28;VENEZOLANO;;Extranjero;"";"";0;0;0;0;0;0;0;0;0;LED 50 50NANO79 NanoCell UHD SMART TV;ELECTRONICA MAYOR
10708269;;F;67;CHILENO;;Boomers;RENCA                         ;METROPOLITANA;0;0;0;0;0;0;0;0;0;LED 55 55UN7100 UHD SMART TV;ELECTRONICA MAYOR
7943226;;F;61;CHILENO;;Boomers;PROVIDENCIA                   ;METROPOLITANA;0;0;0;0;0;0;0;0;0;LED 32 32LM630BPSB SMART TV;ELECTRONICA MAYOR
8383462;;F;61;CHILENO;;Boomers;GRANEROS                      ;L.G.B.OÂ´HIGGINS;0;0;0;0;0;0;0;0;0;LED 40 KEHD4020 SMART TV;ELECTRONICA MAYOR
9447167;;M;59;CHILENO;;Boomers;COIHUECO                      ;BIO BIO;0;0;0;0;0;0;0;0;0;LED KIOTO 32 MI3228 SMART TV;ELECTRONICA MAYOR
13134302;;F;45;CHILENO;;Silencioso;PROVIDENCIA                   ;METROPOLITANA;0;0;0;0;0;0;0;0;0;LED 50 KEUH50 SMART TV UHD;ELECTRONICA MAYOR
18165942;Soltero;M;30;CHILENO;;Silencioso;PROVIDENCIA                   ;METROPOLITANA;0;0;0;0;0;0;0;0;0;LED 60UP7750 UHD SMART + MAGIC;ELECTRONICA MAYOR
12285242;;F;50;CHILENO;;Silencioso;PROVIDENCIA                   ;METROPOLITANA;0;0;0;0;0;0;0;0;0;LED 43 UN43TU7090GXZS UHD SMART TV;ELECTRONICA MAYOR
13568744;Soltero;M;42;CHILENO;GASTRONOMIA INTERNACIONAL;Silencioso;PROVIDENCIA                   ;METROPOLITANA;0;0;0;0;0;0;0;0;0;LED 43 UN43T5202AGXZS FHD SMART TV;ELECTRONICA MAYOR
18433887;Soltero;F;28;CHILENO;;Millenial;PROVIDENCIA                   ;METROPOLITANA;0;0;0;0;0;0;0;0;0;PARLANTE ULTRAMAGIC;ELECTRONICA MAYOR
8995236;Casado;M;58;CHILENO;;Boomers;CHEPICA                       ;L.G.B.OÂ´HIGGINS;0;0;0;0;0;0;0;0;0;LED 32 UN32T4300AGXZS HD SMART TV;ELECTRONICA MAYOR
19192507;;F;26;CHILENO;;Z;RENCA                         ;METROPOLITANA;0;0;0;0;0;0;0;0;0;LED KIOTO 32 MI3228 SMART TV;ELECTRONICA MAYOR
17711347;;M;32;CHILENO;;Millenial;COPIAPO                       ;ATACAMA;0;0;0;0;0;0;0;0;0;KARAOKE PORTATIL TWO-EIGHT 8860;ELECTRONICA MAYOR
5183104;Casado;F;74;CHILENO;;Silencioso;RENCA                         ;METROPOLITANA;0;0;0;0;0;0;0;0;0;LED 49 49UN7100 UHD SMART TV;ELECTRONICA MAYOR
15008981;;M;39;CHILENO;;X;IQUIQUE                       ;TARAPACA;0;0;0;0;0;0;0;0;0;LED 50 KEUH50 SMART TV UHD;ELECTRONICA MAYOR
8687466;;F;62;CHILENO;;Boomers;PROVIDENCIA                   ;METROPOLITANA;0;0;0;0;0;0;0;0;0;LED 55 UN55TU7090GXZS SMART TV UHD;ELECTRONICA MAYOR
13827945;;F;41;CHILENO;;X;PROVIDENCIA                   ;METROPOLITANA;0;0;0;0;0;0;0;0;0;LED 50 UN50TU7090GXZS UHD SMART TV;ELECTRONICA MAYOR
20179309;;M;22;CHILENO;;Z;PROVIDENCIA                   ;METROPOLITANA;0;0;0;0;0;0;0;0;0;PARLANTE BOLA DISCO CON MICROFONO INAL;ELECTRONICA MAYOR
15171107;;F;39;CHILENO;;X;TOME                          ;BIO BIO;0;0;0;0;0;0;0;0;0;LED 55 55UN7100 UHD SMART TV;ELECTRONICA MAYOR
12613724;;F;48;CHILENO;;Silencioso;N/D;N/D;0;0;0;0;0;0;0;0;0;LED 55 55UN7100 UHD SMART TV;ELECTRONICA MAYOR
11428805;;M;53;CHILENO;;X;RENCA                         ;METROPOLITANA;0;0;0;0;0;0;0;0;0;PARLANTE MGVIPER;ELECTRONICA MAYOR
19255671;;M;25;CHILENO;;Z;CONSTITUCION                  ;MAULE;0;0;0;0;0;0;0;0;0;LED KIOTO 32 MI3228 SMART TV;ELECTRONICA MAYOR
16034538;;F;36;CHILENO;;Silencioso;PROVIDENCIA                   ;METROPOLITANA;0;0;0;0;0;0;0;0;0;LED 43 43UN7300 UHD SMART TV 4K;ELECTRONICA MAYOR
17972154;;M;30;CHILENO;;Millenial;N/D;N/D;0;0;0;0;0;0;0;0;0;KARAOKE FUNKY DISCO;ELECTRONICA MAYOR
7067558;;F;67;CHILENO;;Boomers;QUILLOTA                      ;VALPARAISO;0;0;0;0;0;0;0;0;0;LED 50 UN50TU7090GXZS UHD SMART TV;ELECTRONICA MAYOR
11545195;;M;52;CHILENO;;X;PUQUELDON                     ;LOS LAGOS;0;0;0;0;0;0;0;0;0;PARLANTE ULTRABUZZ;ELECTRONICA MAYOR
15791690;;M;37;CHILENO;;Millenial;RENCA                         ;METROPOLITANA;0;0;0;0;0;0;0;0;0;LED 40 KEHD4020 SMART TV;ELECTRONICA MAYOR
7180026;;M;66;CHILENO;;Boomers;N/D;N/D;0;0;0;0;0;0;0;0;0;LED KIOTO 32 MI3228 SMART TV;ELECTRONICA MAYOR
9594496;;M;59;CHILENO;;Boomers;DIEGO DE ALMAGRO              ;ATACAMA;0;0;0;0;0;0;0;0;0;LED 43 UN43T5202AGXZS FHD SMART TV;ELECTRONICA MAYOR
17199579;Soltero;M;32;CHILENO;PUBLICISTA;Silencioso;PROVIDENCIA                   ;METROPOLITANA;0;0;0;0;0;0;0;0;0;LED 50 50PUD6513/44 SMART TV UHD 4K;ELECTRONICA MAYOR
15076871;;F;24;CHILENO;;Z;PROVIDENCIA                   ;METROPOLITANA;0;0;0;0;0;0;0;0;0;MONITOR 24 24TL520S SMART TV HD;ELECTRONICA MAYOR
15224249;;M;39;CHILENO;;X;PROVIDENCIA                   ;METROPOLITANA;0;0;0;0;0;0;0;0;0;LED 50 UN50TU7090GXZS UHD SMART TV;ELECTRONICA MAYOR
18643828;;M;28;CHILENO;;Millenial;N/D;N/D;0;0;0;0;0;0;0;0;0;LED 55 UN55TU7090GXZS SMART TV UHD;ELECTRONICA MAYOR
7646368;;F;67;CHILENO;;Boomers;PARRAL                        ;MAULE;0;0;0;0;0;0;0;0;0;LED 32 32LM630BPSB SMART TV;ELECTRONICA MAYOR
8182383;Casado;F;63;CHILENO;;Boomers;RENCA                         ;METROPOLITANA;0;0;0;0;0;0;0;0;0;LED 40 KEHD4020 SMART TV;ELECTRONICA MAYOR
5954426;;F;71;CHILENO;;Silencioso;PROVIDENCIA                   ;METROPOLITANA;0;0;0;0;0;0;0;0;0;LED 43 CS43S1USM UHD SMART TV NEGRO;ELECTRONICA MAYOR
8812136;;F;63;CHILENO;;Boomers;HUALQUI                       ;BIO BIO;0;0;0;0;0;0;0;0;0;LED 50 UN50TU7090GXZS UHD SMART TV;ELECTRONICA MAYOR
16792648;Soltero;F;34;CHILENO;;Silencioso;PROVIDENCIA                   ;METROPOLITANA;0;0;0;0;0;0;0;0;0;LED 43 43UN7300 UHD SMART TV 4K;ELECTRONICA MAYOR
5390947;;F;76;CHILENO;;Silencioso;RENCA                         ;METROPOLITANA;0;0;0;0;0;0;0;0;0;LED 40 KEHD4020 SMART TV;ELECTRONICA MAYOR
7763233;Casado;M;62;CHILENO;;Boomers;PROVIDENCIA                   ;METROPOLITANA;0;0;0;0;0;0;0;0;0;LED KIOTO 32 MI3228 SMART TV;ELECTRONICA MAYOR
11431399;;F;53;CHILENO;;X;PUERTO MONTT                  ;LOS LAGOS;0;0;0;0;0;0;0;0;0;LED 43 CS43S1USM UHD SMART TV NEGRO;ELECTRONICA MAYOR
16859845;;F;33;CHILENO;;Millenial;CURICO                        ;MAULE;0;0;0;0;0;0;0;0;0;LED 55 UN55TU7090GXZS SMART TV UHD;ELECTRONICA MAYOR
16788757;;M;34;CHILENO;;Millenial;CERRO NAVIA                   ;METROPOLITANA;0;0;0;0;0;0;0;0;0;LED 50 50NANO75 NanoCell UHD SMART + MAGIC;ELECTRONICA MAYOR
17647848;Casado;M;31;CHILENO;TECNICO UNIVERSITARIO EN ENFERMERIA;Millenial;RENCA                         ;METROPOLITANA;0;0;0;0;0;0;0;0;0;LED 32 32LM630BPSB SMART TV;ELECTRONICA MAYOR
18349468;Soltero;F;29;CHILENO;ASISTENTE DE PARVULOS;Silencioso;PROVIDENCIA                   ;METROPOLITANA;0;0;0;0;0;0;0;0;0;LED 50 KEUH50 SMART TV UHD;ELECTRONICA MAYOR
12674782;;F;49;CHILENO;;X;RENCA                         ;METROPOLITANA;0;0;0;0;0;0;0;0;0;LED 55 UN55TU7090GXZS SMART TV UHD;ELECTRONICA MAYOR
19130971;;M;26;CHILENO;;Z;N/D;N/D;0;0;0;0;0;0;0;0;0;LED 50 KEUH50 SMART TV UHD;ELECTRONICA MAYOR
20113200;;F;23;CHILENO;;Z;PROVIDENCIA                   ;METROPOLITANA;0;0;0;0;0;0;0;0;0;LED 43 UN43T5202AGXZS FHD SMART TV;ELECTRONICA MAYOR
18431762;;F;28;CHILENO;;Silencioso;PROVIDENCIA                   ;METROPOLITANA;0;0;0;0;0;0;0;0;0;LED 43 43UN7300 UHD SMART TV 4K;ELECTRONICA MAYOR
13186964;;M;45;CHILENO;;X;ANTOFAGASTA                   ;ANTOFAGASTA;0;0;0;0;0;0;0;0;0;LED 49 49UN7100 UHD SMART TV;ELECTRONICA MAYOR
13678467;;F;43;CHILENO;;X;LO PRADO                      ;METROPOLITANA;0;0;0;0;0;0;0;0;0;LED 40 40S65A-40P ANDROID TV SMART LINE FHD;ELECTRONICA MAYOR
16964466;Soltero;M;33;CHILENO;INGENIERO EN PREVENCION DE RIESGOS;Silencioso;PROVIDENCIA                   ;METROPOLITANA;0;0;0;0;0;0;0;0;0;LED 49 49UN7100 UHD SMART TV;ELECTRONICA MAYOR
15279917;Soltero;M;39;CHILENO;;Silencioso;PROVIDENCIA                   ;METROPOLITANA;0;0;0;0;0;0;0;0;0;LED 32 UN32T4300AGXZS HD SMART TV;ELECTRONICA MAYOR
17241248;Soltero;F;32;CHILENO;TECNICO EN ENFERMERIA DE NIVEL SUPERIOR;Millenial;PROVIDENCIA                   ;METROPOLITANA;0;0;0;0;0;0;0;0;0;LED KIOTO 32 MI3228 SMART TV;ELECTRONICA MAYOR
17811940;Soltero;M;30;CHILENO;TECNICO DE NIVEL SUPERIOR EN PODOLOGIA CLINICA;Millenial;PROVIDENCIA                   ;METROPOLITANA;0;0;0;0;0;0;0;0;0;LED 65 KUHK6520 UHD SMART TV;ELECTRONICA MAYOR
26008322;;F;45;CHILENO;;Extranjero;N/D;N/D;0;0;0;0;0;0;0;0;0;LED 50 KEUH50 SMART TV UHD;ELECTRONICA MAYOR
10786251;;F;55;CHILENO;;Boomers;PUENTE ALTO                   ;METROPOLITANA;0;0;0;0;0;0;0;0;0;PARLANTE ULTRAFUSION;ELECTRONICA MAYOR
18567534;;M;28;CHILENO;;Millenial;VINA DEL MAR                  ;VALPARAISO;0;0;0;0;0;0;0;0;0;LED KIOTO 32 MI3228 SMART TV;ELECTRONICA MAYOR
13506696;;M;47;CHILENO;;X;PROVIDENCIA                   ;METROPOLITANA;0;0;0;0;0;0;0;0;0;LED 50 KEUH50 SMART TV UHD;ELECTRONICA MAYOR
16144526;;F;37;CHILENO;;Millenial;PROVIDENCIA                   ;METROPOLITANA;0;0;0;0;0;0;0;0;0;LED 40 KEHD4020 SMART TV;ELECTRONICA MAYOR
9318039;;M;57;CHILENO;;Boomers;ARICA                         ;TARAPACA;0;0;0;0;0;0;0;0;0;LED 43 UN43T5202AGXZS FHD SMART TV;ELECTRONICA MAYOR
19333481;Soltero;M;26;CHILENO;;Silencioso;PROVIDENCIA                   ;METROPOLITANA;0;0;0;0;0;0;0;0;0;LED 49 49UN7100 UHD SMART TV;ELECTRONICA MAYOR
13365958;;F;44;CHILENO;;X;RENCA                         ;METROPOLITANA;0;0;0;0;0;0;0;0;0;LED 32 UN32T4300AGXZS HD SMART TV;ELECTRONICA MAYOR
13663056;;F;42;CHILENO;;X;QUINTA NORMAL                 ;METROPOLITANA;0;0;0;0;0;0;0;0;0;LED 55 UN55TU8300GXZS UHD SMART TV CURVO;ELECTRONICA MAYOR
19607394;;F;24;CHILENO;;Z;PROVIDENCIA                   ;METROPOLITANA;0;0;0;0;0;0;0;0;0;LED 40 KEHD4020 SMART TV;ELECTRONICA MAYOR
18519453;;M;28;CHILENO;;Millenial;PROVIDENCIA                   ;METROPOLITANA;0;0;0;0;0;0;0;0;0;LED 55 UN55TU7090GXZS SMART TV UHD;ELECTRONICA MAYOR
11627695;;M;52;CHILENO;;X;CERRO NAVIA                   ;METROPOLITANA;0;0;0;0;0;0;0;0;0;SOUNDBAR HW-T450/ZS;ELECTRONICA MAYOR
10730442;;F;55;CHILENO;;Boomers;PROVIDENCIA                   ;METROPOLITANA;0;0;0;0;0;0;0;0;0;LED 65 UN65TU6900GXZS UHD SMART TV;ELECTRONICA MAYOR
18192277;Soltero;M;29;CHILENO;CONTADOR AUDITOR;Millenial;PROVIDENCIA                   ;METROPOLITANA;0;0;0;0;0;0;0;0;0;LED KIOTO 32 MI3228 SMART TV;ELECTRONICA MAYOR
19550032;;M;24;CHILENO;;Silencioso;PROVIDENCIA                   ;METROPOLITANA;0;0;0;0;0;0;0;0;0;LED 50 KEUH50 SMART TV UHD;ELECTRONICA MAYOR
11301525;;M;54;CHILENO;;X;VICTORIA                      ;ARAUCANIA;0;0;0;0;0;0;0;0;0;PARLANTE ULTRAFUSION;ELECTRONICA MAYOR
12902639;;M;48;CHILENO;;X;HUALPEN;BIO BIO;0;0;0;0;0;0;0;0;0;LED 55 UN55TU7090GXZS SMART TV UHD;ELECTRONICA MAYOR
5047872;;M;77;CHILENO;;Silencioso;RENCA                         ;METROPOLITANA;0;0;0;0;0;0;0;0;0;KARAOKE 8 CITY SET MIC WIRELESS ATRIL SILVER;ELECTRONICA MAYOR
18653871;;F;28;CHILENO;;Millenial;TALCA                         ;MAULE;0;0;0;0;0;0;0;0;0;LED 32 UN32T4300AGXZS HD SMART TV;ELECTRONICA MAYOR
12678539;;M;47;CHILENO;;X;PROVIDENCIA                   ;METROPOLITANA;0;0;0;0;0;0;0;0;0;LED 43 43UN7300 UHD SMART TV 4K;ELECTRONICA MAYOR
12862083;;M;47;CHILENO;;X;RENCA                         ;METROPOLITANA;0;0;0;0;0;0;0;0;0;LED KIOTO 32 MI3228 SMART TV;ELECTRONICA MAYOR
11170885;;M;54;CHILENO;;Boomers;SAN PEDRO                     ;METROPOLITANA;0;0;0;0;0;0;0;0;0;LED KIOTO 32 MI3228 SMART TV;ELECTRONICA MAYOR
17467765;;M;34;CHILENO;;Millenial;PROVIDENCIA                   ;METROPOLITANA;0;0;0;0;0;0;0;0;0;LED 55 UN55TU7090GXZS SMART TV UHD;ELECTRONICA MAYOR
19351231;Soltero;M;26;CHILENO;INGENIERIA EN MAQUINARIA VEHICULOS AUTOMOTRICES Y SISTEMAS ELECTRONICOS;Z;PROVIDENCIA                   ;METROPOLITANA;0;0;0;0;0;0;0;0;0;LED 50 UN50TU7090GXZS UHD SMART TV;ELECTRONICA MAYOR
9665681;;M;63;CHILENO;;Boomers;PROVIDENCIA                   ;METROPOLITANA;0;0;0;0;0;0;0;0;0;PARLANTE MGVIPER;ELECTRONICA MAYOR
8025743;;F;67;CHILENO;;Boomers;RENCA                         ;METROPOLITANA;0;0;0;0;0;0;0;0;0;LED 65 UN65TU6900GXZS UHD SMART TV;ELECTRONICA MAYOR
11285007;;M;53;CHILENO;;X;RENCA                         ;METROPOLITANA;0;0;0;0;0;0;0;0;0;LED 55 55UN7100 UHD SMART TV;ELECTRONICA MAYOR
11339542;;M;54;CHILENO;;X;ESTACION CENTRAL              ;METROPOLITANA;0;0;0;0;0;0;0;0;0;LED 32 32PHD5813 SMART TV HD;ELECTRONICA MAYOR
15303915;;F;38;CHILENO;;Millenial;COIHAIQUE                     ;AYSEN;0;0;0;0;0;0;0;0;0;MONITOR 24 24TL520S SMART TV HD;ELECTRONICA MAYOR
7723079;;F;68;CHILENO;;Boomers;TOME                          ;BIO BIO;0;0;0;0;0;0;0;0;0;MINICOMPONENTE OL45;ELECTRONICA MAYOR
11484058;;M;52;CHILENO;;X;PROVIDENCIA                   ;METROPOLITANA;0;0;0;0;0;0;0;0;0;LED 43 43LM6300PSB SMART TV HD;ELECTRONICA MAYOR
8560363;;M;57;CHILENO;;Boomers;RENCA                         ;METROPOLITANA;0;0;0;0;0;0;0;0;0;MINICOMPONENTE CJ45;ELECTRONICA MAYOR
10746285;;F;56;CHILENO;;Boomers;SAN VICENTE                   ;L.G.B.OÂ´HIGGINS;0;0;0;0;0;0;0;0;0;LED 32 UN32T4300AGXZS HD SMART TV;ELECTRONICA MAYOR
13257475;;M;44;CHILENO;;X;PROVIDENCIA                   ;METROPOLITANA;0;0;0;0;0;0;0;0;0;LED 40 KEHD4020 SMART TV;ELECTRONICA MAYOR
19059477;;F;26;CHILENO;;Millenial;PROVIDENCIA                   ;METROPOLITANA;0;0;0;0;0;0;0;0;0;PARLANTE MGVIPER;ELECTRONICA MAYOR
8883777;;F;59;CHILENO;;Boomers;CASTRO                        ;LOS LAGOS;0;0;0;0;0;0;0;0;0;LED 40 KEHD4020 SMART TV;ELECTRONICA MAYOR
17029818;Casado;M;33;CHILENO;;Millenial;PROVIDENCIA                   ;METROPOLITANA;0;0;0;0;0;0;0;0;0;MINICOMPONENTE RN5;ELECTRONICA MAYOR
19068483;Soltero;F;26;CHILENO;QUIMICO FARMACEUTICO;Z;PROVIDENCIA                   ;METROPOLITANA;0;0;0;0;0;0;0;0;0;LED 32 UN32T4300AGXZS HD SMART TV;ELECTRONICA MAYOR
19829752;;F;24;CHILENO;;Silencioso;PROVIDENCIA                   ;METROPOLITANA;0;0;0;0;0;0;0;0;0;LED 32 UN32T4300AGXZS HD SMART TV;ELECTRONICA MAYOR
16924619;;F;34;CHILENO;;Millenial;PROVIDENCIA                   ;METROPOLITANA;0;0;0;0;0;0;0;0;0;SISTEMA DE SONIDO OK75;ELECTRONICA MAYOR
6883164;;M;69;CHILENO;;Silencioso;CURANILAHUE                   ;BIO BIO;0;0;0;0;0;0;0;0;0;LED KIOTO 32 MI3228 SMART TV;ELECTRONICA MAYOR
17459032;;F;32;CHILENO;;Millenial;PROVIDENCIA                   ;METROPOLITANA;0;0;0;0;0;0;0;0;0;LED 32 UN32T4300AGXZS HD SMART TV;ELECTRONICA MAYOR
16514060;;F;35;CHILENO;;Millenial;PROVIDENCIA                   ;METROPOLITANA;0;0;0;0;0;0;0;0;0;LED 50 KEUH50 SMART TV UHD;ELECTRONICA MAYOR
14341802;;M;45;CHILENO;;X;SAN JAVIER                    ;MAULE;0;0;0;0;0;0;0;0;0;LED 32 UN32T4300AGXZS HD SMART TV;ELECTRONICA MAYOR
15791661;;F;37;CHILENO;;Millenial;LA PINTANA                    ;METROPOLITANA;0;0;0;0;0;0;0;0;0;LED KIOTO 32 MI3228 SMART TV;ELECTRONICA MAYOR
9468831;;M;58;CHILENO;;Boomers;RENCA                         ;METROPOLITANA;0;0;0;0;0;0;0;0;0;LED 43 UN43T5202AGXZS FHD SMART TV;ELECTRONICA MAYOR
14308680;;M;46;CHILENO;;X;SAN ANTONIO                   ;VALPARAISO;0;0;0;0;0;0;0;0;0;LED 32 32PHD5813 SMART TV HD;ELECTRONICA MAYOR
12768104;;F;46;CHILENO;;X;RENCA                         ;METROPOLITANA;0;0;0;0;0;0;0;0;0;LED 32 32S5295 SMART TV HD;ELECTRONICA MAYOR
6365959;Casado;M;68;CHILENO;;Silencioso;PROVIDENCIA                   ;METROPOLITANA;0;0;0;0;0;0;0;0;0;LED 49 49UN7100 UHD SMART TV;ELECTRONICA MAYOR
13889011;Casado;M;41;CHILENO;INGENIERO CIVIL EN OBRAS CIVILES;X;RENCA                         ;METROPOLITANA;0;0;0;0;0;0;0;0;0;MONITOR 24 24TL520S SMART TV HD;ELECTRONICA MAYOR
17410550;;M;32;CHILENO;;Millenial;"";"";0;0;0;0;0;0;0;0;0;MINICOMPONENTE RN7;ELECTRONICA MAYOR
11124630;;F;54;CHILENO;;Boomers;MAIPU                         ;METROPOLITANA;0;0;0;0;0;0;0;0;0;LED KIOTO 32 MI3228 SMART TV;ELECTRONICA MAYOR
11794867;Casado;M;50;CHILENO;;X;LOS ANGELES                   ;BIO BIO;0;0;0;0;0;0;0;0;0;LED 32 32S5295 SMART TV HD;ELECTRONICA MAYOR
16576617;Soltero;M;35;CHILENO;;Millenial;PROVIDENCIA                   ;METROPOLITANA;0;0;0;0;0;0;0;0;0;LED 43 UN43T5202AGXZS FHD SMART TV;ELECTRONICA MAYOR
15334083;;F;38;CHILENO;;Millenial;MAIPU                         ;METROPOLITANA;0;0;0;0;0;0;0;0;0;MONITOR 24 24TL520S SMART TV HD;ELECTRONICA MAYOR
24378893;;F;33;BOLIVIANO;;Extranjero;CONCHALI                      ;METROPOLITANA;0;0;0;0;0;0;0;0;0;MINICOMPONENTE RN7;ELECTRONICA MAYOR
10487450;;M;57;CHILENO;;Boomers;ISLA DE MAIPO                 ;METROPOLITANA;0;0;0;0;0;0;0;0;0;LED 43 43S5295 SMART TV FHD;ELECTRONICA MAYOR
11549249;;M;52;CHILENO;;X;PROVIDENCIA                   ;METROPOLITANA;0;0;0;0;0;0;0;0;0;PARLANTE BT T15 NEGRO + ATRIL;ELECTRONICA MAYOR
6839267;;F;65;CHILENO;;Boomers;ANGOL                         ;ARAUCANIA;0;0;0;0;0;0;0;0;0;LED 32 UN32T4300AGXZS HD SMART TV;ELECTRONICA MAYOR
18684399;Soltero;M;28;CHILENO;;Silencioso;PROVIDENCIA                   ;METROPOLITANA;0;0;0;0;0;0;0;0;0;LED 32 UN32T4300AGXZS HD SMART TV;ELECTRONICA MAYOR
15309653;;M;40;CHILENO;;X;PROVIDENCIA                   ;METROPOLITANA;0;0;0;0;0;0;0;0;0;LED 43 UN43J5202AGXZS SMART TV FHD;ELECTRONICA MAYOR
10992960;;F;48;CHILENO;;X;PROVIDENCIA                   ;METROPOLITANA;0;0;0;0;0;0;0;0;0;LED 32 UN32T4300AGXZS HD SMART TV;ELECTRONICA MAYOR
19061096;;M;27;CHILENO;;Z;VALDIVIA                      ;LOS RIOS;0;0;0;0;0;0;0;0;0;LED 32 32LK540 HD SMART;ELECTRONICA MAYOR
18536472;;F;28;CHILENO;;Millenial;N/D;N/D;0;0;0;0;0;0;0;0;0;LED 49 49UN7100 UHD SMART TV;ELECTRONICA MAYOR
14697836;Casado;M;47;CHILENO;;Extranjero;PROVIDENCIA                   ;METROPOLITANA;0;0;0;0;0;0;0;0;0;LED 32 32S60-32P ANDROID TV SMART LINE HD;ELECTRONICA MAYOR
18786742;;F;28;CHILENO;;Millenial;N/D;N/D;0;0;0;0;0;0;0;0;0;LED 43 UN43T5202AGXZS FHD SMART TV;ELECTRONICA MAYOR
13979029;;M;40;CHILENO;;X;VILLA ALEMANA                 ;VALPARAISO;0;0;0;0;0;0;0;0;0;LED 49 49UN7100 UHD SMART TV;ELECTRONICA MAYOR
12919523;;M;47;CHILENO;;X;RENCA                         ;METROPOLITANA;0;0;0;0;0;0;0;0;0;LED 32 32PHD5813 SMART TV HD;ELECTRONICA MAYOR
8656343;;F;62;CHILENO;;Boomers;COPIAPO                       ;ATACAMA;0;0;0;0;0;0;0;0;0;LED 58 KTUHD5820 4K SMART TV;ELECTRONICA MAYOR
12318489;;M;48;CHILENO;;X;COBQUECURA                    ;BIO BIO;0;0;0;0;0;0;0;0;0;LED 40 KEHD4020 SMART TV;ELECTRONICA MAYOR
7064168;Casado;F;71;CHILENO;;Silencioso;TALCAHUANO                    ;BIO BIO;0;0;0;0;0;0;0;0;0;LED 32 32PHD5813 SMART TV HD;ELECTRONICA MAYOR
11667852;;M;51;CHILENO;;X;LO ESPEJO                     ;METROPOLITANA;0;0;0;0;0;0;0;0;0;LED 32 32S5295 SMART TV HD;ELECTRONICA MAYOR
6360013;;F;69;CHILENO;;Silencioso;LA PINTANA                    ;METROPOLITANA;0;0;0;0;0;0;0;0;0;LED 58 58PUD6513/44 SMART TV UHD;ELECTRONICA MAYOR
9289798;;M;60;CHILENO;;Boomers;PUENTE ALTO                   ;METROPOLITANA;0;0;0;0;0;0;0;0;0;LED 32 UN32T4300AGXZS HD SMART TV;ELECTRONICA MAYOR
9384908;;F;58;CHILENO;;Boomers;QUILICURA                     ;METROPOLITANA;0;0;0;0;0;0;0;0;0;LED 32 UN32T4300AGXZS HD SMART TV;ELECTRONICA MAYOR
20335862;;F;22;CHILENO;;Z;PROVIDENCIA                   ;METROPOLITANA;0;0;0;0;0;0;0;0;0;KARAOKE RHYTHM CHARGER 12 MIC CABLE 8890;ELECTRONICA MAYOR
16602516;;M;34;CHILENO;;Millenial;"";"";0;0;0;0;0;0;0;0;0;LED 55 55P615 UHD ANDROID TV 4K;ELECTRONICA MAYOR
13222053;;F;45;CHILENO;;Silencioso;PROVIDENCIA                   ;METROPOLITANA;0;0;0;0;0;0;0;0;0;MONITOR 24 24TL520S SMART TV HD;ELECTRONICA MAYOR
22972359;;M;34;PERUANO;;Extranjero;SANTIAGO                      ;METROPOLITANA;0;0;0;0;0;0;0;0;0;LED 55 55NANO79 NanoCell UHD SMART TV;ELECTRONICA MAYOR
19667225;;M;24;CHILENO;;Silencioso;PROVIDENCIA                   ;METROPOLITANA;0;0;0;0;0;0;0;0;0;LED 32 UN32T4300AGXZS HD SMART TV;ELECTRONICA MAYOR
11658972;Casado;M;52;CHILENO;INGENIERO EN ADMINISTRACION DE EMPRESAS;X;PROVIDENCIA                   ;METROPOLITANA;0;0;0;0;0;0;0;0;0;LED 32 UN32T4300AGXZS HD SMART TV;ELECTRONICA MAYOR
13560136;;M;42;CHILENO;;X;MELIPILLA                     ;METROPOLITANA;0;0;0;0;0;0;0;0;0;LED 32 32PHD5813 SMART TV HD;ELECTRONICA MAYOR
13642887;;M;43;CHILENO;;X;RENCA                         ;METROPOLITANA;0;0;0;0;0;0;0;0;0;LED 32 UN32T4300AGXZS HD SMART TV;ELECTRONICA MAYOR
8173384;;M;62;CHILENO;;Boomers;RENCA                         ;METROPOLITANA;0;0;0;0;0;0;0;0;0;LED 40 KEHD4020 SMART TV;ELECTRONICA MAYOR
8974847;;F;52;CHILENO;;X;PUENTE ALTO                   ;METROPOLITANA;0;0;0;0;0;0;0;0;0;LED 49 49UJ6300 UHD SMART;ELECTRONICA MAYOR
18684791;Soltero;M;28;CHILENO;;Millenial;PROVIDENCIA                   ;METROPOLITANA;0;0;0;0;0;0;0;0;0;LED 55 55P615 UHD ANDROID TV 4K;ELECTRONICA MAYOR
19282725;;F;26;CHILENO;;Z;N/D;N/D;0;0;0;0;0;0;0;0;0;LED 43 UN43T5202AGXZS FHD SMART TV;ELECTRONICA MAYOR
9217032;;M;60;CHILENO;;Boomers;EL BOSQUE                     ;METROPOLITANA;0;0;0;0;0;0;0;0;0;MINICOMPONENTE RN5;ELECTRONICA MAYOR
9144903;;F;62;CHILENO;;Boomers;VINA DEL MAR                  ;VALPARAISO;0;0;0;0;0;0;0;0;0;LED 40 KEHD4020 SMART TV;ELECTRONICA MAYOR
13850420;Divorciado;F;41;CHILENO;TECNICO DE NIVEL SUPERIOR EN ENFERMERIA;X;PROVIDENCIA                   ;METROPOLITANA;0;0;0;0;0;0;0;0;0;LED 50 UN50TU7090GXZS UHD SMART TV;ELECTRONICA MAYOR
15853237;;F;38;CHILENO;;Millenial;CURANILAHUE                   ;BIO BIO;0;0;0;0;0;0;0;0;0;LED 49 49UJ6300 UHD SMART;ELECTRONICA MAYOR
9575302;;F;60;CHILENO;;Boomers;RENCA                         ;METROPOLITANA;0;0;0;0;0;0;0;0;0;LED 55 UN55TU8300GXZS UHD SMART TV CURVO;ELECTRONICA MAYOR
17007488;;M;33;CHILENO;;Millenial;PROVIDENCIA                   ;METROPOLITANA;0;0;0;0;0;0;0;0;0;LED 32 UN32T4300AGXZS HD SMART TV;ELECTRONICA MAYOR
17185614;;F;33;CHILENO;;Millenial;N/D;N/D;0;0;0;0;0;0;0;0;0;MINICOMPONENTE MHC-V73D;ELECTRONICA MAYOR
17653545;Soltero;F;31;CHILENO;ENFERMERA;Millenial;PROVIDENCIA                   ;METROPOLITANA;0;0;0;0;0;0;0;0;0;LED 65 65UN7100 UHD SMART TV;ELECTRONICA MAYOR
15648527;;F;38;CHILENO;;Millenial;N/D;N/D;0;0;0;0;0;0;0;0;0;LED 32 32LK540 HD SMART;ELECTRONICA MAYOR
11676904;;F;53;CHILENO;;X;PROVIDENCIA                   ;METROPOLITANA;0;0;0;0;0;0;0;0;0;MONITOR 24 24TL520S SMART TV HD;ELECTRONICA MAYOR
12740687;;M;47;CHILENO;;X;PROVIDENCIA                   ;METROPOLITANA;0;0;0;0;0;0;0;0;0;LED 50 UN50TU7090GXZS UHD SMART TV;ELECTRONICA MAYOR
16788573;;F;34;CHILENO;;Millenial;PROVIDENCIA                   ;METROPOLITANA;0;0;0;0;0;0;0;0;0;MINICOMPONENTE MX-T40/ZS ALL IN ONE;ELECTRONICA MAYOR
13606926;;M;45;CHILENO;;X;PROVIDENCIA                   ;METROPOLITANA;0;0;0;0;0;0;0;0;0;PARLANTE KARAOKE BT 12 WIRED MIC/FM/BTUSB;ELECTRONICA MAYOR
12653305;Casado;F;48;CHILENO;;X;RENCA                         ;METROPOLITANA;0;0;0;0;0;0;0;0;0;LED 32 UN32T4300AGXZS HD SMART TV;ELECTRONICA MAYOR
15917358;;F;39;CHILENO;;X;EL BOSQUE                     ;METROPOLITANA;0;0;0;0;0;0;0;0;0;LED 50 UN50TU7090GXZS UHD SMART TV;ELECTRONICA MAYOR
10666711;;M;51;CHILENO;;X;"";"";0;0;0;0;0;0;0;0;0;MINICOMPONENTE RN7;ELECTRONICA MAYOR
5171219;;F;79;CHILENO;;Silencioso;VINA DEL MAR                  ;VALPARAISO;0;0;0;0;0;0;0;0;0;LED 50 50PUD6513/44 SMART TV UHD 4K;ELECTRONICA MAYOR
14342905;;M;45;CHILENO;;X;EL MONTE                      ;METROPOLITANA;0;0;0;0;0;0;0;0;0;PARLANTE ULTRAMEGA;ELECTRONICA MAYOR
21327733;;F;40;PERUANO;;Extranjero;ARICA                         ;ARICA Y PARINACOTA;0;0;0;0;0;0;0;0;0;LED 55 UN55TU7090GXZS SMART TV UHD;ELECTRONICA MAYOR
18563050;;F;28;CHILENO;;Millenial;PROVIDENCIA                   ;METROPOLITANA;0;0;0;0;0;0;0;0;0;LED 50 50PUD6513/44 SMART TV UHD 4K;ELECTRONICA MAYOR
12658882;;F;48;CHILENO;;X;RENCA                         ;METROPOLITANA;0;0;0;0;0;0;0;0;0;LED 50 UN50TU7090GXZS UHD SMART TV;ELECTRONICA MAYOR
14213375;;F;40;CHILENO;;X;RENCA                         ;METROPOLITANA;0;0;0;0;0;0;0;0;0;LED 55 UN55TU8300GXZS UHD SMART TV CURVO;ELECTRONICA MAYOR
13305362;;F;45;CHILENO;;X;RENCA                         ;METROPOLITANA;0;0;0;0;0;0;0;0;0;LED 55 UN55TU8300GXZS UHD SMART TV CURVO;ELECTRONICA MAYOR
25281373;;M;44;VENEZOLANO;;Extranjero;TALCA                         ;MAULE;0;0;0;0;0;0;0;0;0;LED 55 55NANO79 NanoCell UHD SMART TV;ELECTRONICA MAYOR
15289701;;F;40;CHILENO;;X;AISEN                         ;AYSEN;0;0;0;0;0;0;0;0;0;LED 32 32PHD5813 SMART TV HD;ELECTRONICA MAYOR
9092927;Viudo;M;63;CHILENO;;Boomers;RENCA                         ;METROPOLITANA;0;0;0;0;0;0;0;0;0;LED 50 UN50TU7090GXZS UHD SMART TV;ELECTRONICA MAYOR
25000173;;M;41;PERUANO;;Extranjero;SANTIAGO                      ;METROPOLITANA;0;0;0;0;0;0;0;0;0;PARLANTE ULTRAMAGIC;ELECTRONICA MAYOR
16204272;;M;36;CHILENO;;Millenial;PROVIDENCIA                   ;METROPOLITANA;0;0;0;0;0;0;0;0;0;PARLANTE ULTRAMAGIC;ELECTRONICA MAYOR
12140078;;M;46;CHILENO;;X;RENCA                         ;METROPOLITANA;0;0;0;0;0;0;0;0;0;LED 43 43LM6300PSB SMART TV HD;ELECTRONICA MAYOR
6962797;;F;69;CHILENO;;Silencioso;PINTO                         ;BIO BIO;0;0;0;0;0;0;0;0;0;PARLANTE ULTRAMEGA;ELECTRONICA MAYOR
10293056;;M;53;CHILENO;;X;HIJUELAS                      ;VALPARAISO;0;0;0;0;0;0;0;0;0;PARLANTE ULTRAMEGA;ELECTRONICA MAYOR
17269792;;M;32;CHILENO;;Millenial;PROVIDENCIA                   ;METROPOLITANA;0;0;0;0;0;0;0;0;0;LED 32 32S5295 SMART TV HD;ELECTRONICA MAYOR
15800740;;M;37;CHILENO;;Millenial;PROVIDENCIA                   ;METROPOLITANA;0;0;0;0;0;0;0;0;0;LED 43 43PFD5813 SMART TV FULL HD;ELECTRONICA MAYOR
17390200;;F;32;CHILENO;;Millenial;PAINE                         ;METROPOLITANA;0;0;0;0;0;0;0;0;0;LED 55 55NANO79 NanoCell UHD SMART TV;ELECTRONICA MAYOR
17841493;;F;30;CHILENO;;Millenial;RENCA                         ;METROPOLITANA;0;0;0;0;0;0;0;0;0;LED 32 UN32T4300AGXZS HD SMART TV;ELECTRONICA MAYOR
8013544;;M;61;CHILENO;;Boomers;CONSTITUCION                  ;MAULE;0;0;0;0;0;0;0;0;0;MINICOMPONENTE MX-T40/ZS ALL IN ONE;ELECTRONICA MAYOR
10426306;;F;55;CHILENO;;Boomers;CAUQUENES                     ;MAULE;0;0;0;0;0;0;0;0;0;KARAOKE RHYTHM CHARGER 12 MIC CABLE 8890;ELECTRONICA MAYOR
25602476;;F;48;PERUANO;;Extranjero;QUINTA NORMAL                 ;METROPOLITANA;0;0;0;0;0;0;0;0;0;LED 55 55UN7100 UHD SMART TV;ELECTRONICA MAYOR
19428427;;M;26;CHILENO;;Z;"";"";0;0;0;0;0;0;0;0;0;LED 55 UN55TU7090GXZS SMART TV UHD;ELECTRONICA MAYOR
5297452;;F;77;CHILENO;;Silencioso;PROVIDENCIA                   ;METROPOLITANA;0;0;0;0;0;0;0;0;0;MONITOR 24 24TL520S SMART TV HD;ELECTRONICA MAYOR
18269897;;M;29;CHILENO;;Millenial;VINA DEL MAR                  ;VALPARAISO;0;0;0;0;0;0;0;0;0;SOUNDBAR SK1;ELECTRONICA MAYOR
9987466;;M;49;CHILENO;;X;PROVIDENCIA                   ;METROPOLITANA;0;0;0;0;0;0;0;0;0;MINICOMPONENTE OL45;ELECTRONICA MAYOR
12642484;;M;47;CHILENO;;X;RENCA                         ;METROPOLITANA;0;0;0;0;0;0;0;0;0;SOUNDBAR SK1;ELECTRONICA MAYOR
8481708;;F;64;CHILENO;;Boomers;RENCA                         ;METROPOLITANA;0;0;0;0;0;0;0;0;0;LED 32 32S60-32P ANDROID TV SMART LINE HD;ELECTRONICA MAYOR
13835668;;M;42;CHILENO;;X;RENCA                         ;METROPOLITANA;0;0;0;0;0;0;0;0;0;MINICOMPONENTE RN7;ELECTRONICA MAYOR
11875400;;F;51;CHILENO;;X;PROVIDENCIA                   ;METROPOLITANA;0;0;0;0;0;0;0;0;0;LED 32 32LM630BPSB SMART TV;ELECTRONICA MAYOR
6134733;;M;68;CHILENO;;Boomers;CALBUCO                       ;LOS LAGOS;0;0;0;0;0;0;0;0;0;PARLANTE ULTRASENSATION;ELECTRONICA MAYOR
6395452;;M;71;CHILENO;;Silencioso;PUENTE ALTO                   ;METROPOLITANA;0;0;0;0;0;0;0;0;0;LED 50 50P615-50P ANDROID TV PASSION LINE UHD 4K;ELECTRONICA MAYOR
7699359;Casado;M;65;CHILENO;;Boomers;RENCA                         ;METROPOLITANA;0;0;0;0;0;0;0;0;0;PARLANTE ULTRAMEGA;ELECTRONICA MAYOR
15655220;;M;38;CHILENO;;Millenial;TEMUCO                        ;ARAUCANIA;0;0;0;0;0;0;0;0;0;LED 32 32LK540 HD SMART;ELECTRONICA MAYOR
16892097;;F;34;CHILENO;;Millenial;COQUIMBO                      ;COQUIMBO;0;0;0;0;0;0;0;0;0;SOUNDBAR SK1D;ELECTRONICA MAYOR
13447298;;M;43;CHILENO;;X;LINARES                       ;MAULE;0;0;0;0;0;0;0;0;0;PARLANTE ULTRAMEGA;ELECTRONICA MAYOR
11455834;;F;53;CHILENO;;X;PUENTE ALTO                   ;METROPOLITANA;0;0;0;0;0;0;0;0;0;LED 43 UN43TU7090GXZS UHD SMART TV;ELECTRONICA MAYOR
10035651;Casado;F;56;CHILENO;;Boomers;PROVIDENCIA                   ;METROPOLITANA;0;0;0;0;0;0;0;0;0;LED 50 50U6295 SMART TV UHD;ELECTRONICA MAYOR
5886049;;F;79;CHILENO;;Silencioso;RENCA                         ;METROPOLITANA;0;0;0;0;0;0;0;0;0;LED 43 43LM6300PSB SMART TV HD;ELECTRONICA MAYOR
12652468;;M;48;CHILENO;;X;PROVIDENCIA                   ;METROPOLITANA;0;0;0;0;0;0;0;0;0;LED 43 UN43TU7090GXZS UHD SMART TV;ELECTRONICA MAYOR
14087463;;M;40;CHILENO;;X;PROVIDENCIA                   ;METROPOLITANA;0;0;0;0;0;0;0;0;0;LED 32 UN32T4300AGXZS HD SMART TV;ELECTRONICA MAYOR
17619745;Soltero;F;29;CHILENO;;Millenial;PROVIDENCIA                   ;METROPOLITANA;0;0;0;0;0;0;0;0;0;LED 50 UN50TU7090GXZS UHD SMART TV;ELECTRONICA MAYOR
13884814;;F;42;CHILENO;;X;RENCA                         ;METROPOLITANA;0;0;0;0;0;0;0;0;0;LED 43 UN43TU7090GXZS UHD SMART TV;ELECTRONICA MAYOR
18285733;;M;29;CHILENO;;Millenial;PROVIDENCIA                   ;METROPOLITANA;0;0;0;0;0;0;0;0;0;LED 49 49UN7100 UHD SMART TV;ELECTRONICA MAYOR
18016693;Casado;F;30;CHILENO;TECNICO DE NIVEL SUPERIOR EN ENFERMERIA;Millenial;ANCUD                         ;LOS LAGOS;0;0;0;0;0;0;0;0;0;LED 50 50PUD6513/44 SMART TV UHD 4K;ELECTRONICA MAYOR
8862314;;M;51;CHILENO;;X;PROVIDENCIA                   ;METROPOLITANA;0;0;0;0;0;0;0;0;0;LED 70 70PUD6774 UHD SMART TV 4K;ELECTRONICA MAYOR
16583747;;M;35;CHILENO;;Millenial;ANGOL                         ;ARAUCANIA;0;0;0;0;0;0;0;0;0;LED 55 UN55NU7095GXZS SMART TV TV 4K;ELECTRONICA MAYOR
13098026;Casado;M;45;CHILENO;;X;PROVIDENCIA                   ;METROPOLITANA;0;0;0;0;0;0;0;0;0;LED 32 UN32T4300AGXZS HD SMART TV;ELECTRONICA MAYOR
17469920;;F;32;CHILENO;;Millenial;CONSTITUCION                  ;MAULE;0;0;0;0;0;0;0;0;0;LED KIOTO 32 MI3228 SMART TV;ELECTRONICA MAYOR
5311230;Casado;M;72;CHILENO;;Silencioso;PROVIDENCIA                   ;METROPOLITANA;0;0;0;0;0;0;0;0;0;LED 43 UN43J5202AGXZS SMART TV FHD;ELECTRONICA MAYOR
16798509;Soltero;F;34;CHILENO;TECNICO DEPORTIVO;Millenial;PROVIDENCIA                   ;METROPOLITANA;0;0;0;0;0;0;0;0;0;LED 32 32LM630BPSB SMART TV;ELECTRONICA MAYOR
7270624;;F;64;CHILENO;;Boomers;SAN VICENTE                   ;L.G.B.OÂ´HIGGINS;0;0;0;0;0;0;0;0;0;LED 65 65UN7300 UHD SMART TV;ELECTRONICA MAYOR
15145057;Casado;M;40;CHILENO;INGENIERO EN AUTOMATIZACION Y CONTROL INDUSTRIAL;X;RENCA                         ;METROPOLITANA;0;0;0;0;0;0;0;0;0;LED 32 UN32T4300AGXZS HD SMART TV;ELECTRONICA MAYOR
12057927;;F;56;CHILENO;;Boomers;TALCA                         ;MAULE;0;0;0;0;0;0;0;0;0;PARLANTE ULTRAFORCE-I;ELECTRONICA MAYOR
11983525;;M;50;CHILENO;;X;CAUQUENES                     ;MAULE;0;0;0;0;0;0;0;0;0;LED 43 UN43J5202AGXZS SMART TV FHD;ELECTRONICA MAYOR
9617642;;M;59;CHILENO;;Boomers;SANTIAGO                      ;METROPOLITANA;0;0;0;0;0;0;0;0;0;LED 50 50U6295 SMART TV UHD;ELECTRONICA MAYOR
7001882;;M;66;CHILENO;;Boomers;PROVIDENCIA                   ;METROPOLITANA;0;0;0;0;0;0;0;0;0;PARLANTE ULTRAMEGA;ELECTRONICA MAYOR
17527694;;M;31;CHILENO;;Millenial;SAN VICENTE                   ;L.G.B.OÂ´HIGGINS;0;0;0;0;0;0;0;0;0;LED 32 32S5295 SMART TV HD;ELECTRONICA MAYOR
25940749;;F;53;CHILENO;;Extranjero;PAPUDO                        ;VALPARAISO;0;0;0;0;0;0;0;0;0;LED 43 UN43J5202AGXZS SMART TV FHD;ELECTRONICA MAYOR
6379878;;F;58;CHILENO;;Boomers;PROVIDENCIA                   ;METROPOLITANA;0;0;0;0;0;0;0;0;0;LED 43 43LM6300PSB SMART TV HD;ELECTRONICA MAYOR
17016607;;M;33;CHILENO;;Millenial;PROVIDENCIA                   ;METROPOLITANA;0;0;0;0;0;0;0;0;0;LED 32 UN32T4300AGXZS HD SMART TV;ELECTRONICA MAYOR
18510457;;F;29;CHILENO;;Millenial;"";"";0;0;0;0;0;0;0;0;0;SOUNDBAR HW-T450/ZS;ELECTRONICA MAYOR
6883590;Casado;M;67;CHILENO;;Boomers;RENCA                         ;METROPOLITANA;0;0;0;0;0;0;0;0;0;LED 50 50P615-50P ANDROID TV PASSION LINE UHD 4K;ELECTRONICA MAYOR
8352513;;M;64;CHILENO;;Boomers;SAN ANTONIO                   ;VALPARAISO;0;0;0;0;0;0;0;0;0;LED KIOTO 32 MI3228 SMART TV;ELECTRONICA MAYOR
20768469;;F;21;CHILENO;;Z;PROVIDENCIA                   ;METROPOLITANA;0;0;0;0;0;0;0;0;0;LED 50 50PUD6513/44 SMART TV UHD 4K;ELECTRONICA MAYOR
13369474;;F;45;CHILENO;;X;COLINA                        ;METROPOLITANA;0;0;0;0;0;0;0;0;0;LED 32 UN32T4300AGXZS HD SMART TV;ELECTRONICA MAYOR
10113848;;M;56;CHILENO;;Boomers;RENCA                         ;METROPOLITANA;0;0;0;0;0;0;0;0;0;LED 49 49UN7100 UHD SMART TV;ELECTRONICA MAYOR
17372904;;M;32;CHILENO;;Millenial;"";"";0;0;0;0;0;0;0;0;0;LED KIOTO 32 MI3228 SMART TV;ELECTRONICA MAYOR
18213794;;M;29;CHILENO;;Millenial;MELIPILLA                     ;METROPOLITANA;0;0;0;0;0;0;0;0;0;LED 32 UN32T4300AGXZS HD SMART TV;ELECTRONICA MAYOR
19398261;;F;25;CHILENO;;Z;N/D;N/D;0;0;0;0;0;0;0;0;0;LED 55 UN55NU7095GXZS SMART TV TV 4K;ELECTRONICA MAYOR
17734126;;F;30;CHILENO;;Millenial;PROVIDENCIA                   ;METROPOLITANA;0;0;0;0;0;0;0;0;0;LED 43 43LM6300PSB SMART TV HD;ELECTRONICA MAYOR
7286299;Casado;F;65;CHILENO;;Boomers;LA SERENA                     ;COQUIMBO;0;0;0;0;0;0;0;0;0;LED 32 UN32T4300AGXZS HD SMART TV;ELECTRONICA MAYOR
10241100;;F;56;CHILENO;;Boomers;RENCA                         ;METROPOLITANA;0;0;0;0;0;0;0;0;0;LED 60 60UN7310 SMART TV UHD;ELECTRONICA MAYOR
9557766;;F;61;CHILENO;;Boomers;VILLA ALEGRE                  ;MAULE;0;0;0;0;0;0;0;0;0;LED 43 43S5295 SMART TV FHD;ELECTRONICA MAYOR
18519578;;M;29;CHILENO;;Millenial;CAUQUENES                     ;MAULE;0;0;0;0;0;0;0;0;0;LED 43 MI4328 SMART TV;ELECTRONICA MAYOR
17669491;;M;31;CHILENO;;Millenial;N/D;N/D;0;0;0;0;0;0;0;0;0;LED KIOTO 32 MI3228 SMART TV;ELECTRONICA MAYOR
16157881;Casado;M;40;CHILENO;;X;PROVIDENCIA                   ;METROPOLITANA;0;0;0;0;0;0;0;0;0;LED 32 32S5295 SMART TV HD;ELECTRONICA MAYOR
9214068;;M;61;CHILENO;;Boomers;RENCA                         ;METROPOLITANA;0;0;0;0;0;0;0;0;0;LED 32 CS32S1 SMART TV HD NEGRO;ELECTRONICA MAYOR
17345662;;M;33;CHILENO;;Millenial;TIRUA                         ;BIO BIO;0;0;0;0;0;0;0;0;0;LED 50 50PUD6654 SMART TV UHD BL BT SILVER;ELECTRONICA MAYOR
15398744;Casado;M;39;CHILENO;;X;PROVIDENCIA                   ;METROPOLITANA;0;0;0;0;0;0;0;0;0;LED 49 49UN7100 UHD SMART TV;ELECTRONICA MAYOR
13521730;;F;44;CHILENO;;X;PROVIDENCIA                   ;METROPOLITANA;0;0;0;0;0;0;0;0;0;LED 32 32PHD5813 SMART TV HD;ELECTRONICA MAYOR
12793851;;M;46;CHILENO;;X;RENCA                         ;METROPOLITANA;0;0;0;0;0;0;0;0;0;LED 32 32PHD5813 SMART TV HD;ELECTRONICA MAYOR
17091030;;M;33;CHILENO;;Millenial;PROVIDENCIA                   ;METROPOLITANA;0;0;0;0;0;0;0;0;0;KARAOKE BLACK PHANTER II;ELECTRONICA MAYOR
17051011;;F;33;CHILENO;;Millenial;N/D;N/D;0;0;0;0;0;0;0;0;0;LED KIOTO 32 MI3228 SMART TV;ELECTRONICA MAYOR
17283941;;M;32;CHILENO;;Millenial;PROVIDENCIA                   ;METROPOLITANA;0;0;0;0;0;0;0;0;0;LED 32 32S5295 SMART TV HD;ELECTRONICA MAYOR
7936085;;M;61;CHILENO;;Boomers;SAN RAMON                     ;METROPOLITANA;0;0;0;0;0;0;0;0;0;LED KIOTO 32 MI3228 SMART TV;ELECTRONICA MAYOR
11149058;;M;55;CHILENO;;Boomers;BULNES                        ;BIO BIO;0;0;0;0;0;0;0;0;0;LED 43 MI4328 SMART TV;ELECTRONICA MAYOR
9454426;;M;57;CHILENO;;Boomers;PROVIDENCIA                   ;METROPOLITANA;0;0;0;0;0;0;0;0;0;LED 32 CS32S1 SMART TV HD NEGRO;ELECTRONICA MAYOR
22238389;;M;38;COLOMBIANO;;Extranjero;INDEPENDENCIA;METROPOLITANA;0;0;0;0;0;0;0;0;0;LED 43 43LM6300PSB SMART TV HD;ELECTRONICA MAYOR
11705506;;F;52;CHILENO;;X;LOS ANDES                     ;VALPARAISO;0;0;0;0;0;0;0;0;0;LED 50 50U6295 SMART TV UHD;ELECTRONICA MAYOR
18352873;;F;29;CHILENO;;Silencioso;PROVIDENCIA                   ;METROPOLITANA;0;0;0;0;0;0;0;0;0;LED 50 50UN7300 SMART TV UHD;ELECTRONICA MAYOR
4171100;;M;84;CHILENO;;Silencioso;COQUIMBO                      ;COQUIMBO;0;0;0;0;0;0;0;0;0;LED 65 65UN7300 UHD SMART TV;ELECTRONICA MAYOR
9322386;;M;60;CHILENO;;Boomers;PROVIDENCIA                   ;METROPOLITANA;0;0;0;0;0;0;0;0;0;KARAOKE STREET3 8 CON MICROFONO RED;ELECTRONICA MAYOR
9554783;;F;61;CHILENO;;Boomers;QUILPUE                       ;VALPARAISO;0;0;0;0;0;0;0;0;0;MINICOMPONENTE RN5;ELECTRONICA MAYOR
10953222;Soltero;F;53;CHILENO;;X;RENCA                         ;METROPOLITANA;0;0;0;0;0;0;0;0;0;LED KIOTO 32 MI3228 SMART TV;ELECTRONICA MAYOR
12897840;;F;47;CHILENO;;X;PROVIDENCIA                   ;METROPOLITANA;0;0;0;0;0;0;0;0;0;LED KIOTO 32 MI3228 SMART TV;ELECTRONICA MAYOR
16434571;;M;36;CHILENO;;Millenial;PROVIDENCIA                   ;METROPOLITANA;0;0;0;0;0;0;0;0;0;KARAOKE FUNKY DISCO;ELECTRONICA MAYOR
16492067;;M;35;CHILENO;;Millenial;MACHALI;O HIGGINS;0;0;0;0;0;0;0;0;0;LED 50 50PUD6513/44 SMART TV UHD 4K;ELECTRONICA MAYOR
7237101;;M;69;CHILENO;;Silencioso;FREIRE                        ;ARAUCANIA;0;0;0;0;0;0;0;0;0;LED 50 UN50TU7090GXZS UHD SMART TV;ELECTRONICA MAYOR
15542328;;M;38;CHILENO;;X;PROVIDENCIA                   ;METROPOLITANA;0;0;0;0;0;0;0;0;0;LED SHARP 55 UHD SMART TV;ELECTRONICA MAYOR
14215878;;M;41;CHILENO;;X;RENCA                         ;METROPOLITANA;0;0;0;0;0;0;0;0;0;SISTEMA DE SONIDO PORTATIL PG10 NEGRO;ELECTRONICA MAYOR
15122739;;F;40;CHILENO;;X;PROVIDENCIA                   ;METROPOLITANA;0;0;0;0;0;0;0;0;0;LED 43 43PFD5813 SMART TV FULL HD;ELECTRONICA MAYOR
7522787;;M;68;CHILENO;;Boomers;CONSTITUCION                  ;MAULE;0;0;0;0;0;0;0;0;0;LED 43 MI4328 SMART TV;ELECTRONICA MAYOR
15760652;;M;38;CHILENO;;Millenial;PROVIDENCIA                   ;METROPOLITANA;0;0;0;0;0;0;0;0;0;LED 43 43UN7300 UHD SMART TV 4K;ELECTRONICA MAYOR
12908917;;M;46;CHILENO;;X;LINARES                       ;MAULE;0;0;0;0;0;0;0;0;0;LED KIOTO 32 MI3228 SMART TV;ELECTRONICA MAYOR
7394430;;M;67;CHILENO;;Boomers;PROVIDENCIA                   ;METROPOLITANA;0;0;0;0;0;0;0;0;0;LED KIOTO 32 MI3228 SMART TV;ELECTRONICA MAYOR
13392778;;F;44;CHILENO;;X;ANGOL                         ;ARAUCANIA;0;0;0;0;0;0;0;0;0;LED 50 50PUD6654 SMART TV UHD BL BT SILVER;ELECTRONICA MAYOR
13533339;;F;43;CHILENO;;X;LA SERENA                     ;COQUIMBO;0;0;0;0;0;0;0;0;0;LED KIOTO 32 MI3228 SMART TV;ELECTRONICA MAYOR
16375548;;F;35;CHILENO;;Millenial;PROVIDENCIA                   ;METROPOLITANA;0;0;0;0;0;0;0;0;0;LED 43 43LM6300PSB SMART TV HD;ELECTRONICA MAYOR
8558081;;M;63;CHILENO;;Boomers;SANTIAGO                      ;METROPOLITANA;0;0;0;0;0;0;0;0;0;LED KIOTO 32 MI3228 SMART TV;ELECTRONICA MAYOR
8061727;;M;64;CHILENO;;Boomers;GRANEROS                      ;L.G.B.OÂ´HIGGINS;0;0;0;0;0;0;0;0;0;MINICOMPONENTE RN5;ELECTRONICA MAYOR
15773554;;F;37;CHILENO;;Millenial;CONSTITUCION                  ;MAULE;0;0;0;0;0;0;0;0;0;LED 58 58PUD6513/44 SMART TV UHD;ELECTRONICA MAYOR
13007531;Casado;M;45;CHILENO;INGENIERO MECANICO;X;RENCA                         ;METROPOLITANA;0;0;0;0;0;0;0;0;0;KARAOKE BLACK PHANTER II;ELECTRONICA MAYOR
14195665;;F;41;CHILENO;;X;N/D;N/D;0;0;0;0;0;0;0;0;0;LED 50 UN50TU7090GXZS UHD SMART TV;ELECTRONICA MAYOR
19278004;Soltero;M;26;CHILENO;;Z;PROVIDENCIA                   ;METROPOLITANA;0;0;0;0;0;0;0;0;0;LED 50 MI50291 SMART TV 4K;ELECTRONICA MAYOR
17167407;;M;33;CHILENO;;Millenial;PROVIDENCIA                   ;METROPOLITANA;0;0;0;0;0;0;0;0;0;MLAB KARAOKE 8 CITY SET MICROFONO INALAMBRICO AT;ELECTRONICA MAYOR
26575999;;M;33;VENEZOLANO;;Extranjero;TEMUCO                        ;ARAUCANIA;0;0;0;0;0;0;0;0;0;LED 50 50UN7300 SMART TV UHD;ELECTRONICA MAYOR
6117761;;M;72;CHILENO;;Silencioso;PROVIDENCIA                   ;METROPOLITANA;0;0;0;0;0;0;0;0;0;KARAOKE RHYTHM CHARGER 12 MIC CABLE 8890;ELECTRONICA MAYOR
9503192;Casado;F;61;CHILENO;;Boomers;RANCAGUA                      ;L.G.B.OÂ´HIGGINS;0;0;0;0;0;0;0;0;0;LED KIOTO 32 MI3228 SMART TV;ELECTRONICA MAYOR
