CUSTOMER_ID;ESTADO_CIVIL;SEXO;EDAD;NACIONALIDAD;PROFESION;GENERACION_CLIENTE;COMUNA_CLIENTE;CIUDAD_CLIENTE;SUMA_INGRESOS_12;CANTIDAD_PRODUCTOS_12;SUMA_BOLETAS_12;CANTIDAD_UNIDADES_ECOMMERCE_12;SUMA_BOLETAS_ECOMMERCE_12;SUMA_INGRESOS_ECOMMERCE_12;CANTIDAD_UNIDADES_TIENDA_12;SUMA_BOLETAS_TIENDA_12;SUMA_INGRESOS_TIENDA_12;ULTIMO_PRODUCTO_COMPRADO;LINEA_ULTIMO_PRODUCTO_COMPRDO
13796819;;F;42;CHILENO;;X;PROVIDENCIA                   ;METROPOLITANA;81869;6;4;0;0;0;6;4;81869;Bolsa Papel Abcdin;PROMOCIONES
7922699;;F;66;CHILENO;;Boomers;CHIGUAYANTE                   ;BIO BIO;257950;6;6;0;0;0;6;6;257950;Bolsa Papel Abcdin;PROMOCIONES
11883669;;M;51;CHILENO;;X;LA FLORIDA                    ;METROPOLITANA;4950;5;1;0;0;0;5;1;4950;KEY FINDER ASD-ATL1003-1;PROMOCIONES
17962403;;F;30;CHILENO;;Millenial;N/D;N/D;1470;3;1;0;0;0;3;1;1470;FIDGET SPINNER COL. SURTIDOS;PROMOCIONES
18895527;;F;28;CHILENO;;Millenial;N/D;N/D;0;0;0;0;0;0;0;0;0;GAFAS DE SOL YAC DARTH VADER 26603;PROMOCIONES
13087336;Casado;M;46;CHILENO;;X;LA GRANJA                     ;METROPOLITANA;53980;2;1;2;1;53980;0;0;0;MI PRIMER TRAMPOLIN 140CM GAMEPOWER AZUL/AMARILL;OUTDOOR
19266137;Soltero;F;26;CHILENO;;Z;PROVIDENCIA                   ;METROPOLITANA;79991;1;2;0;0;0;1;2;79991;GO-KART PEDALES NEGRO;OUTDOOR
19068296;;F;27;CHILENO;;Z;MELIPILLA                     ;METROPOLITANA;0;0;2;0;0;0;0;2;0;GO-KART PEDALES ROJO;OUTDOOR
17954881;;M;30;CHILENO;;Millenial;OLMUE                         ;VALPARAISO;1103870;13;7;10;5;893900;3;2;209970;V-PISCINA ESTRUCTURAL BESTWAY STEEL PRO 3.05M X;OUTDOOR
14147952;;F;40;CHILENO;;X;N/D;N/D;21970;3;2;2;1;13980;1;1;7990;TERMO BALA METALICO NATIONAL GEOGRAPHIC 1000ML T;OUTDOOR
10188977;Casado;M;42;CHILENO;INGENIERO COMERCIAL;X;PROVIDENCIA                   ;METROPOLITANA;235960;4;2;4;2;235960;0;0;0;COHETE C/LANZADOR;OUTDOOR
20266981;;M;23;CHILENO;;Z;"";"";70960;4;2;2;1;43980;2;1;26980;V-SACO DORMIR TUCSON AZUL NAT GEO S17;OUTDOOR
13643936;;M;43;CHILENO;;Silencioso;LAS CONDES                    ;METROPOLITANA;108980;2;1;2;1;108980;0;0;0;MESA DE PING PONG GAMEPOWER AZUL;OUTDOOR
17979503;;F;30;CHILENO;;Millenial;N/D;N/D;26980;2;1;2;1;26980;0;0;0;Scooter Peluche Dotty Dalmata y Luces Led Keyrid;OUTDOOR
9951984;;F;52;CHILENO;;X;LOS ALAMOS                    ;BIO BIO;16990;1;1;1;1;16990;0;0;0;Juego de Mesa Camcorro 10 en 1;OUTDOOR
14388432;;F;44;CHILENO;;X;COPIAPO                       ;ATACAMA;129990;1;1;0;0;0;1;1;129990;Auto Electrico 4x4 Descapotable Verde Militar;OUTDOOR
16052508;;M;36;CHILENO;;Millenial;TEMUCO                        ;ARAUCANIA;249980;2;4;0;0;0;2;4;249980;Auto Electrico Descapotable Coupe Rojo;OUTDOOR
18605837;Soltero;M;28;CHILENO;KINESIOLOGO;Millenial;PROVIDENCIA                   ;METROPOLITANA;16990;1;1;1;1;16990;0;0;0;Juego de Mesa Camcorro 10 en 1;OUTDOOR
19926066;;F;24;CHILENO;;Z;NUEVA IMPERIAL                ;ARAUCANIA;109990;1;1;0;0;0;1;1;109990;GO-KART PEDALES NEGRO;OUTDOOR
16455420;Soltero;F;35;CHILENO;INGENIERO EN ADMINISTRACION DE EMPRESAS;Millenial;PROVIDENCIA                   ;METROPOLITANA;15990;1;1;1;1;15990;0;0;0;COLCHON 2 PZA 203X152X22 CM;OUTDOOR
17322755;;F;32;CHILENO;;Millenial;MAULE                         ;MAULE;34480;2;1;2;1;34480;0;0;0;V-BOLSO PORTA EQUIPAJE MEDIANO NAT GEO S17;OUTDOOR
18800544;Soltero;M;28;CHILENO;;Millenial;PROVIDENCIA                   ;METROPOLITANA;712980;2;1;0;0;0;2;1;712980;Piscinas Swim Vista Set 4.88M X 1.22M;OUTDOOR
18135362;;F;30;CHILENO;;Millenial;N/D;N/D;40920;4;1;4;1;40920;0;0;0;V-QUITASOL BLANCO NAT GEO S17;OUTDOOR
13988199;Soltero;F;41;CHILENO;ANALISTA DE SISTEMAS;X;RENCA                         ;METROPOLITANA;33980;2;1;2;1;33980;0;0;0;V-BOLSO PORTA EQUIPAJE MEDIANO NAT GEO S17;OUTDOOR
11466053;;M;53;CHILENO;;X;ARICA                         ;ARICA Y PARINACOTA;501830;6;3;0;0;0;6;3;501830;PISCINA CIRCULAR STEEL PRO;OUTDOOR
11260232;;F;54;CHILENO;;X;ALTO DEL CARMEN               ;ATACAMA;89990;1;1;0;0;0;1;1;89990;PISCINA STEEL PRO 300X201X66CM;OUTDOOR
13820397;;F;42;CHILENO;;X;VALDIVIA                      ;LOS LAGOS;17990;1;1;0;0;0;1;1;17990;Juego de Mesa Camcorro 10 en 1;OUTDOOR
17136958;;M;33;CHILENO;;Millenial;"";"";26540;2;1;2;1;26540;0;0;0;Juego de Mesa Camcorro 10 en 1;OUTDOOR
19108965;;M;26;CHILENO;;Z;PROVIDENCIA                   ;METROPOLITANA;204840;2;1;2;1;204840;0;0;0;CARPA TRAKKER VI PERSONAS NATIONAL GEOGRAPHIC 5;OUTDOOR
8338757;;M;63;CHILENO;;Boomers;PUENTE ALTO                   ;METROPOLITANA;89990;1;1;0;0;0;1;1;89990;PISCINA STEEL PRO 300X201X66CM;OUTDOOR
18381036;;F;29;CHILENO;;Millenial;VILLA ALEMANA                 ;VALPARAISO;89990;1;1;0;0;0;1;1;89990;CAMA ELASTICA (1,83M) CON MALLA GAMEPOWER AZUL;OUTDOOR
8502566;;F;49;CHILENO;;X;PROVIDENCIA                   ;METROPOLITANA;48970;4;2;4;2;48970;0;0;0;SPIN BALL;OUTDOOR
9611250;;F;60;CHILENO;;Boomers;N/D;N/D;12990;1;1;0;0;0;1;1;12990;Correpasillos Rojo;OUTDOOR
14052600;;F;40;CHILENO;;X;CURICO                        ;MAULE;135480;2;1;2;1;135480;0;0;0;MESA DE PING PONG GAMEPOWER AZUL;OUTDOOR
17345141;;M;32;CHILENO;;Millenial;PROVIDENCIA                   ;METROPOLITANA;128540;2;1;2;1;128540;0;0;0;PISCINA CIRCULAR STEEL PRO;OUTDOOR
16891206;;M;27;CHILENO;;Z;LIMACHE                       ;VALPARAISO;19990;1;1;0;0;0;1;1;19990;Scooter Peluche Flamenco y Luces Led KeyRiders;OUTDOOR
13018639;;M;45;CHILENO;;X;RENCA                         ;METROPOLITANA;79990;1;1;0;0;0;1;1;79990;GO-KART PEDALES ROJO;OUTDOOR
12759730;;F;47;CHILENO;;X;PUERTO MONTT                  ;LOS LAGOS;109990;1;1;1;1;109990;0;0;0;PISCINA STEEL PRO 300X201X66CM;OUTDOOR
8776613;;F;64;CHILENO;;Boomers;N/D;N/D;343970;3;1;3;1;343970;0;0;0;Cama Elastica + Malla y Escalera 8ft;OUTDOOR
15651813;;M;39;CHILENO;;X;PROVIDENCIA                   ;METROPOLITANA;156980;2;1;2;1;156980;0;0;0;PISCINA CIRCULAR STEEL PRO 6473 L;OUTDOOR
15723361;Soltero;M;38;CHILENO;INGENIERIA EN TELECOMUNICACIONES CONECTIVIDAD Y REDES;X;RANCAGUA;O HIGGINS;89990;1;1;1;1;89990;0;0;0;PISCINA STEEL PRO 300X201X66CM;OUTDOOR
12153294;;F;52;CHILENO;;X;SAN JOAQUIN;METROPOLITANA;142960;4;3;0;0;0;4;3;142960;TACA TACA MADERA EVER GROUP;OUTDOOR
14394693;;F;47;CHILENO;;X;BUIN                          ;METROPOLITANA;389980;2;2;0;0;0;2;2;389980;PISCINA STEEL PRO C/ESCALERA Y COBERTOR;OUTDOOR
17758652;;F;31;CHILENO;;Millenial;N/D;N/D;93980;2;1;2;1;93980;0;0;0;V-PISCINA ESTRUCTURAL BESTWAY STEEL PRO 3.05M X;OUTDOOR
16983865;;F;34;CHILENO;;Millenial;PROVIDENCIA                   ;METROPOLITANA;105840;2;1;2;1;105840;0;0;0;V-PISCINA ESTRUCTURAL BESTWAY STEEL PRO 3.05M X;OUTDOOR
5310699;;M;71;CHILENO;;Silencioso;PROVIDENCIA                   ;METROPOLITANA;133980;2;1;2;1;133980;0;0;0;MESA DE PING PONG GAMEPOWER AZUL;OUTDOOR
18940157;;M;27;CHILENO;;Z;N/D;N/D;879960;4;2;4;2;879960;0;0;0;PISCINA POWER STEEL OVALADA;OUTDOOR
19272609;;F;25;CHILENO;;Z;PANGUIPULLI                   ;LOS RIOS;169990;1;1;0;0;0;1;1;169990;PISCINA RECTANGULAR 211CM BESTWAY AZUL;OUTDOOR
17931897;;F;31;CHILENO;;Millenial;CONSTITUCION                  ;MAULE;119990;1;1;1;1;119990;0;0;0;PISCINA CIRCULAR STEEL PRO;OUTDOOR
17244754;;M;32;CHILENO;;Millenial;PROVIDENCIA                   ;METROPOLITANA;123980;2;1;2;1;123980;0;0;0;PISCINA CIRCULAR STEEL PRO;OUTDOOR
14284234;;F;47;CHILENO;;Silencioso;PROVIDENCIA                   ;METROPOLITANA;145480;2;1;2;1;145480;0;0;0;PISCINA CIRCULAR STEEL PRO 6473 L;OUTDOOR
9718901;;F;57;CHILENO;;Boomers;N/D;N/D;1021970;3;3;0;0;0;3;3;1021970;Juego de Mesa Camcorro 10 en 1;OUTDOOR
17946759;;M;34;CHILENO;;Millenial;PROVIDENCIA                   ;METROPOLITANA;59836;3;1;3;1;59836;0;0;0;COLCHONETA ULTRALIGHT VERDE MILITAR NATIONAL GEO;OUTDOOR
17848632;Soltero;M;31;CHILENO;;Millenial;RENCA                         ;METROPOLITANA;133980;2;1;2;1;133980;0;0;0;MESA DE PING PONG GAMEPOWER AZUL;OUTDOOR
16980255;;F;33;CHILENO;;Millenial;RENCA;METROPOLITANA;259970;3;2;2;1;239980;1;1;19990;COLCHON 2 PZA 203X152X22 CM;OUTDOOR
16765437;;F;34;CHILENO;;Millenial;CONCEPCION                    ;BIO BIO;65840;2;1;2;1;65840;0;0;0;Centro Juegos 2en1 Juego De Bloques Y Escritorio;OUTDOOR
9371341;;M;59;CHILENO;;Boomers;PEDRO AGUIRRE CERDA           ;METROPOLITANA;21990;1;1;0;0;0;1;1;21990;Juego de Mesa Camcorro 10 en 1;OUTDOOR
15121096;;M;35;CHILENO;;Millenial;SAN FERNANDO                  ;L.G.B.OÂ´HIGGINS;309080;4;2;4;2;309080;0;0;0;MESA DE PING PONG GAMEPOWER AZUL;OUTDOOR
8520708;;F;61;CHILENO;;Boomers;VINA DEL MAR                  ;VALPARAISO;69990;1;1;0;0;0;1;1;69990;Cuatrimoto Electrica Force Rosada;OUTDOOR
16375270;;F;35;CHILENO;;Millenial;N/D;N/D;19990;1;1;0;0;0;1;1;19990;COLCHON 2 PZA 203X152X22 CM;OUTDOOR
8681688;;F;59;CHILENO;;Boomers;RENCA                         ;METROPOLITANA;69990;1;1;0;0;0;1;1;69990;TACA TACA MADERA EVER GROUP;OUTDOOR
3638999;;M;82;CHILENO;;Silencioso;LA PINTANA                    ;METROPOLITANA;257870;2;3;0;0;0;2;3;257870;Scooter Burbujas Barbie;OUTDOOR
16214942;;F;36;CHILENO;;Millenial;PROVIDENCIA                   ;METROPOLITANA;125840;2;1;2;1;125840;0;0;0;PISCINA CIRCULAR STEEL PRO;OUTDOOR
10974910;;F;45;CHILENO;;X;PROVIDENCIA                   ;METROPOLITANA;164980;2;1;2;1;164980;0;0;0;Cama Elastica + Malla y Escalera 6ft;OUTDOOR
14293171;;F;47;CHILENO;;X;CHILLAN                       ;BIO BIO;69830;3;2;2;1;34840;1;1;34990;V-MESA REDONDA PLEG. 81CM NORTHWEST;OUTDOOR
16202697;Casado;F;35;CHILENO;AUXILIAR PARAMEDICO DE FARMACIA;Millenial;RENCA                         ;METROPOLITANA;179980;2;2;0;0;0;2;2;179980;PISCINA CIRCULAR STEEL PRO 6473 L;OUTDOOR
13802593;;M;42;CHILENO;;X;SAN PEDRO DE LA PAZ;BIO-BIO;109990;1;1;1;1;109990;0;0;0;PISCINA STEEL PRO 300X201X66CM;OUTDOOR
16631160;;M;34;CHILENO;;Millenial;PROVIDENCIA                   ;METROPOLITANA;99992;1;2;0;0;0;1;2;99992;GO-KART PEDALES NEGRO;OUTDOOR
18981623;;M;27;CHILENO;;Millenial;COLBUN                        ;MAULE;204980;2;2;0;0;0;2;2;204980;PISCINA RECTANGULAR 211CM BESTWAY AZUL;OUTDOOR
7850610;;M;62;CHILENO;;Boomers;LAS CONDES;METROPOLITANA;489980;2;1;2;1;489980;0;0;0;PISCINA POWER STEEL OVALADA;OUTDOOR
16228078;;M;37;CHILENO;;Millenial;SAN CARLOS                    ;BIO BIO;219970;3;2;0;0;0;3;2;219970;V-PISCINA ESTRUCTURAL BESTWAY STEEL PRO 3.05M X;OUTDOOR
18255710;Soltero;F;30;CHILENO;;Millenial;PUCHUNCAVI                    ;VALPARAISO;89990;1;1;0;0;0;1;1;89990;AUTO ELECTRICO DESCAPOTABLE BLANCO COUP;OUTDOOR
19049701;Soltero;M;26;CHILENO;;Z;PROVIDENCIA                   ;METROPOLITANA;33980;2;1;2;1;33980;0;0;0;V-MOCHILA TUNDRA 28LTS AZUL NAT GEO S17;OUTDOOR
17542785;;F;29;CHILENO;;Millenial;N/D;N/D;161970;3;2;0;0;0;3;2;161970;PISCINA CIRCULAR STEEL PRO 6473 L;OUTDOOR
15230113;;F;38;CHILENO;;X;PROVIDENCIA                   ;METROPOLITANA;146980;2;1;2;1;146980;0;0;0;PISCINA CIRCULAR STEEL PRO 6473 L;OUTDOOR
15527102;;F;38;CHILENO;;Millenial;RENGO;O HIGGINS;231070;4;2;4;2;231070;0;0;0;PISCINA RECTANGULAR 150CM BESTWAY AZUL;OUTDOOR
18342197;Soltero;M;29;CHILENO;TECNICO EN ELECTRICIDAD;Millenial;PROVIDENCIA                   ;METROPOLITANA;95480;2;1;2;1;95480;0;0;0;V-CARPA 6 PERSONAS TORONTO NAT GEO S17;OUTDOOR
15269185;;M;40;CHILENO;;X;PAILLACO                      ;LOS LAGOS;89990;1;1;0;0;0;1;1;89990;SCOOTER ELECTRICO CERO EKIDS NEGRO;OUTDOOR
18044131;;M;29;CHILENO;;Millenial;RANCAGUA                      ;L.G.B.OÂ´HIGGINS;124540;2;1;2;1;124540;0;0;0;PISCINA CIRCULAR STEEL PRO;OUTDOOR
17212842;;F;33;CHILENO;;Millenial;ISLA DE MAIPO                 ;METROPOLITANA;683940;6;3;6;3;683940;0;0;0;TACA TACA MADERA EVER GROUP;OUTDOOR
16864297;;M;34;CHILENO;;Millenial;NOGALES                       ;VALPARAISO;19990;1;1;0;0;0;1;1;19990;Scooter Peluche Unicornio y Luces Led KeyRiders;OUTDOOR
17537267;;F;34;CHILENO;;Millenial;TEMUCO                        ;ARAUCANIA;356980;2;1;2;1;356980;0;0;0;PISCINA STEEL PRO C/ESCALERA Y COBERTOR;OUTDOOR
18829793;;F;28;CHILENO;;Millenial;PROVIDENCIA                   ;METROPOLITANA;649980;2;1;2;1;649980;0;0;0;PISCINA POWER STEEL RECTANGULAR;OUTDOOR
18181829;;M;30;CHILENO;;Millenial;LAUTARO                       ;ARAUCANIA;109990;1;1;0;0;0;1;1;109990;PISCINA STEEL PRO 300X201X66CM;OUTDOOR
17548798;;F;30;CHILENO;;Extranjero;CURANILAHUE                   ;BIO BIO;24990;1;1;0;0;0;1;1;24990;Scooter Peluche Dinosaurio y Luces Led KeyRiders;OUTDOOR
23974590;;M;30;PERUANO;;Extranjero;N/D;N/D;152980;2;1;0;0;0;2;1;152980;PISCINA STEEL PRO 300X201X66CM;OUTDOOR
16117418;;F;36;CHILENO;;Millenial;N/D;N/D;207220;4;2;0;0;0;4;2;207220;PISCINA RECTANGULAR 211CM BESTWAY AZUL;OUTDOOR
8341591;;F;63;CHILENO;;Boomers;PUCON                         ;ARAUCANIA;164990;1;1;0;0;0;1;1;164990;PISCINA RECTANGULAR 211CM BESTWAY AZUL;OUTDOOR
8659277;;M;60;CHILENO;;Boomers;CORONEL                       ;BIO BIO;69990;1;1;0;0;0;1;1;69990;PISCINA RECTANGULAR 150CM BESTWAY AZUL;OUTDOOR
6018697;;M;62;CHILENO;;Boomers;CHILLAN                       ;BIO BIO;359980;2;1;0;0;0;2;1;359980;PISCINA STEEL PRO C/ESCALERA Y COBERTOR;OUTDOOR
16591251;;F;34;CHILENO;;Millenial;COLINA                        ;METROPOLITANA;249970;3;2;0;0;0;3;2;249970;TACA TACA MADERA EVER GROUP;OUTDOOR
17610544;;F;31;CHILENO;;Millenial;N/D;N/D;24990;1;1;0;0;0;1;1;24990;Scooter Peluche Unicornio y Luces Led KeyRiders;OUTDOOR
4422107;;F;79;CHILENO;;Silencioso;QUILPUE                       ;VALPARAISO;69990;1;1;0;0;0;1;1;69990;PISCINA RECTANGULAR 150CM BESTWAY AZUL;OUTDOOR
13733759;Casado;F;45;CHILENO;;X;TEMUCO                        ;ARAUCANIA;356980;2;1;2;1;356980;0;0;0;PISCINA STEEL PRO C/ESCALERA Y COBERTOR;OUTDOOR
10151220;;M;57;CHILENO;;Boomers;YERBAS BUENAS                 ;MAULE;14990;1;1;0;0;0;1;1;14990;Correpasillos Unicornio Rosado;OUTDOOR
19495911;;F;24;CHILENO;;Z;N/D;N/D;9990;1;1;0;0;0;1;1;9990;Correpasillos Rojo;OUTDOOR
10193950;;M;54;CHILENO;;X;PROVIDENCIA                   ;METROPOLITANA;134980;2;1;2;1;134980;0;0;0;PISCINA RECTANGULAR 211CM BESTWAY AZUL;OUTDOOR
16480097;;F;35;CHILENO;;Millenial;PROVIDENCIA                   ;METROPOLITANA;99970;3;1;3;1;99970;0;0;0;TACA TACA MADERA EVER GROUP;OUTDOOR
18401084;Casado;F;29;CHILENO;;Millenial;PROVIDENCIA                   ;METROPOLITANA;19990;1;1;0;0;0;1;1;19990;Scooter Peluche Flamenco y Luces Led KeyRiders;OUTDOOR
17966453;;F;30;CHILENO;;Millenial;PROVIDENCIA                   ;METROPOLITANA;39980;2;1;2;1;39980;0;0;0;V-MOCHILA NATIONAL GEOGRAPHIC BLUELAKE 25L AZUL;OUTDOOR
19876438;;F;23;CHILENO;;Silencioso;PROVIDENCIA                   ;METROPOLITANA;130520;4;2;4;2;130520;0;0;0;TACA TACA MADERA EVER GROUP;OUTDOOR
15708723;Soltero;F;38;CHILENO;CONTADOR GENERAL;X;PUDAHUEL                      ;METROPOLITANA;74980;2;1;2;1;74980;0;0;0;TACA TACA MADERA EVER GROUP;OUTDOOR
19057291;;F;27;CHILENO;;Z;N/D;N/D;59990;1;1;1;1;59990;0;0;0;TACA TACA MADERA EVER GROUP;OUTDOOR
17585158;;F;31;CHILENO;;Silencioso;PROVIDENCIA                   ;METROPOLITANA;74980;2;1;2;1;74980;0;0;0;Triciclo 360 Desmontable Bebesit;OUTDOOR
16292290;;M;35;CHILENO;;Millenial;SALAMANCA                     ;COQUIMBO;99980;2;1;0;0;0;2;1;99980;MOTO ELECTRICA LUCES BLANCA;OUTDOOR
12410828;Soltero;F;49;CHILENO;;X;RENCA                         ;METROPOLITANA;69980;2;1;2;1;69980;0;0;0;TACA TACA MADERA EVER GROUP;OUTDOOR
17965357;;F;31;CHILENO;;Millenial;PROVIDENCIA                   ;METROPOLITANA;84980;2;1;2;1;84980;0;0;0;Triciclo 360 Desmontable Bebesit;OUTDOOR
18441919;;M;29;CHILENO;;Millenial;PROVIDENCIA                   ;METROPOLITANA;0;0;0;0;0;0;0;0;0;V-AUTITO PARA NINOS 80x48x91CM S17;OUTDOOR
15971652;;F;37;CHILENO;;Millenial;PROVIDENCIA                   ;METROPOLITANA;0;0;0;0;0;0;0;0;0;V-AUTITO PARA NINOS 80x48x91CM S17;OUTDOOR
15368301;;M;39;CHILENO;;Silencioso;PROVIDENCIA                   ;METROPOLITANA;0;0;0;0;0;0;0;0;0;V-CARPA PLAYA POP UP COLOR AZUL;OUTDOOR
15170443;;F;39;CHILENO;;X;PROVIDENCIA                   ;METROPOLITANA;0;0;0;0;0;0;0;0;0;Correpasillos Rojo;OUTDOOR
16576814;;M;33;CHILENO;;Millenial;MELIPILLA                     ;METROPOLITANA;0;0;0;0;0;0;0;0;0;Triciclo 360 Desmontable Bebesit;OUTDOOR
15615824;;F;38;CHILENO;;Millenial;HUALPEN;BIO BIO;0;0;0;0;0;0;0;0;0;Piscina Redonda Steel Pro Max Pool Set 3.66x1.00;OUTDOOR
26256234;;F;33;VENEZOLANO;;Extranjero;PROVIDENCIA                   ;METROPOLITANA;0;0;0;0;0;0;0;0;0;V-COLCHON NATGEO DOBLE C/INF 191X137X22CM S17;OUTDOOR
17475499;;F;32;CHILENO;;Silencioso;PROVIDENCIA                   ;METROPOLITANA;0;0;0;0;0;0;0;0;0;CENTRO JUEGOS 3EN1 RESBALIN+COLUMPIO+AROBASQ;OUTDOOR
17514687;;F;32;CHILENO;;Silencioso;PROVIDENCIA                   ;METROPOLITANA;0;0;0;0;0;0;0;0;0;Correpasillos Unicornio Rosado;OUTDOOR
20070560;;M;23;CHILENO;;Silencioso;PROVIDENCIA                   ;METROPOLITANA;0;0;0;0;0;0;0;0;0;V-MI PRIMER TRAMPOLIN Y COLUMPIO 312x234x186CM S;OUTDOOR
17394980;;F;32;CHILENO;;Millenial;PROVIDENCIA                   ;METROPOLITANA;0;0;0;0;0;0;0;0;0;Columpio 2 Estaciones Kids;OUTDOOR
18503241;;M;29;CHILENO;;Millenial;N/D;N/D;0;0;0;0;0;0;0;0;0;V-CARPA MONTANA 4 PERSONAS OUTBACK;OUTDOOR
16510397;;F;35;CHILENO;;Millenial;SAN ANTONIO;VALPARAISO;0;0;0;0;0;0;0;0;0;MALETA CORREPASILLO MOTO AZUL;OUTDOOR
15631847;;M;38;CHILENO;;Millenial;CURICO                        ;MAULE;0;0;0;0;0;0;0;0;0;PISCINA CIRCULAR STEEL PRO 6473 L;OUTDOOR
15139983;;F;39;CHILENO;;X;PROVIDENCIA                   ;METROPOLITANA;0;0;0;0;0;0;0;0;0;V-PISCINA MY FIRST FAST SET SPRAY POOL 1.52M X 3;OUTDOOR
18128039;;F;29;CHILENO;;Millenial;COLINA                        ;METROPOLITANA;0;0;0;0;0;0;0;0;0;SCOOTER ELECTRICO CERO EKIDS NEGRO;OUTDOOR
14320691;;F;46;CHILENO;;X;SAN CARLOS                    ;BIO BIO;0;0;0;0;0;0;0;0;0;COLCHON 2 PZA 203X152X22 CM;OUTDOOR
19142184;;M;26;CHILENO;;Z;PROVIDENCIA                   ;METROPOLITANA;0;0;0;0;0;0;0;0;0;V-CARPA 4 PERS. VANCOUVER NAT GEO S17;OUTDOOR
16609629;Soltero;M;34;CHILENO;CIRUJANO DENTISTA;Millenial;PROVIDENCIA                   ;METROPOLITANA;0;0;0;0;0;0;0;0;0;COLCHON 2 PZA 203X152X22 CM;OUTDOOR
11773935;;F;50;CHILENO;;X;VILLA ALEMANA                 ;VALPARAISO;0;0;0;0;0;0;0;0;0;COLCHON 2 PZA 203X152X22 CM;OUTDOOR
25085137;;M;27;BOLIVIANO;;Extranjero;TOCOPILLA                     ;ANTOFAGASTA;0;0;0;0;0;0;0;0;0;PATINES EN LINEA T 28-31 ALPACA;OUTDOOR
16829100;Soltero;M;33;CHILENO;;Millenial;PROVIDENCIA                   ;METROPOLITANA;0;0;0;0;0;0;0;0;0;PISCINA RECTANGULAR 150CM BESTWAY AZUL;OUTDOOR
11335474;;F;54;CHILENO;;Boomers;PROVIDENCIA                   ;METROPOLITANA;0;0;0;0;0;0;0;0;0;PISCINA RECTANGULAR 211CM BESTWAY AZUL;OUTDOOR
12586934;;F;48;CHILENO;;X;RENCA                         ;METROPOLITANA;0;0;0;0;0;0;0;0;0;CAMIONETA ELECTRICA TODO TERRENO BLANCO;OUTDOOR
8475036;;F;65;CHILENO;;Boomers;GALVARINO                     ;ARAUCANIA;0;0;0;0;0;0;0;0;0;PISCINA CIRCULAR STEEL PRO;OUTDOOR
12081893;;M;53;CHILENO;;X;RENCA                         ;METROPOLITANA;0;0;0;0;0;0;0;0;0;PISCINA CIRCULAR STEEL PRO 6473 L;OUTDOOR
11415892;Casado;M;52;CHILENO;;X;PROVIDENCIA                   ;METROPOLITANA;0;0;0;0;0;0;0;0;0;PISCINA ESTRUCTURAL STEEL PRO 5700LT;OUTDOOR
16647901;Soltero;M;34;CHILENO;ANALISTA DE SISTEMAS;Millenial;PROVIDENCIA                   ;METROPOLITANA;0;0;0;0;0;0;0;0;0;COLCHON 2 PZA 203X152X22 CM;OUTDOOR
5526717;;F;79;CHILENO;;Silencioso;LAMPA                         ;METROPOLITANA;0;0;0;0;0;0;0;0;0;PISCINA CIRCULAR STEEL PRO 6473 L;OUTDOOR
17906802;;M;30;CHILENO;;Millenial;PROVIDENCIA                   ;METROPOLITANA;0;0;0;0;0;0;0;0;0;TACA TACA MADERA EVER GROUP;OUTDOOR
14592202;;F;46;CHILENO;;X;COPIAPO                       ;ATACAMA;0;0;0;0;0;0;0;0;0;Piscina Campo De Basketball Inf. 254X168X102;OUTDOOR
16334591;;F;35;CHILENO;;Millenial;RENCA                         ;METROPOLITANA;0;0;0;0;0;0;0;0;0;CAMA ELASTICA (2,44M) CON MALLA GAMEPOWER AZUL;OUTDOOR
10001249;;F;56;CHILENO;;Boomers;SAN PEDRO DE ATACAMA          ;ANTOFAGASTA;0;0;0;0;0;0;0;0;0;PISCINA RECTANGULAR 211CM BESTWAY AZUL;OUTDOOR
15470749;;M;40;CHILENO;;X;PENALOLEN                     ;METROPOLITANA;0;0;0;0;0;0;0;0;0;MINI TRAMPOLIN 38 GAMEPOWER AZUL;OUTDOOR
18999593;Soltero;M;26;CHILENO;;Z;PROVIDENCIA                   ;METROPOLITANA;0;0;0;0;0;0;0;0;0;PISCINA ESTRUCTURAL STEEL PRO 5700LT;OUTDOOR
19018198;;F;27;CHILENO;;Z;PROVIDENCIA                   ;METROPOLITANA;0;0;0;0;0;0;0;0;0;AUTO ELECTRICO DESCAPOTABLE BLANCO COUP;OUTDOOR
8992512;;F;59;CHILENO;;Boomers;COLINA                        ;METROPOLITANA;0;0;0;0;0;0;0;0;0;PISCINA CIRCULAR STEEL PRO;OUTDOOR
14060162;;F;41;CHILENO;;X;CURACAUTIN                    ;ARAUCANIA;0;0;0;0;0;0;0;0;0;PISCINA STEEL PRO C/ESCALERA Y COBERTOR;OUTDOOR
12399694;;M;49;CHILENO;;X;CABILDO                       ;VALPARAISO;0;0;0;0;0;0;0;0;0;PISCINA CIRCULAR STEEL PRO;OUTDOOR
13461932;;M;43;CHILENO;;X;PROVIDENCIA                   ;METROPOLITANA;0;0;0;0;0;0;0;0;0;Piscina Power Steel Swim Vista Series Oval 4.8x3;OUTDOOR
5382815;;F;72;CHILENO;;Silencioso;RENCA                         ;METROPOLITANA;0;0;0;0;0;0;0;0;0;MI PRIMER TRAMPOLIN 140CM GAMEPOWER AZUL/AMARILL;OUTDOOR
12052387;;M;45;CHILENO;;X;CURICO                        ;MAULE;0;0;0;0;0;0;0;0;0;PISCINA CIRCULAR STEEL PRO;OUTDOOR
16970995;;F;33;CHILENO;;Millenial;MELIPILLA                     ;METROPOLITANA;0;0;0;0;0;0;0;0;0;PISCINA CIRCULAR STEEL PRO;OUTDOOR
19350136;;F;25;CHILENO;;Z;PENALOLEN                     ;METROPOLITANA;0;0;0;0;0;0;0;0;0;PISCINA CIRCULAR STEEL PRO;OUTDOOR
12408697;;F;49;CHILENO;;X;N/D;N/D;0;0;0;0;0;0;0;0;0;PISCINA STEEL PRO 300X201X66CM;OUTDOOR
15709698;;M;38;CHILENO;;Millenial;RENCA                         ;METROPOLITANA;0;0;0;0;0;0;0;0;0;PISCINA STEEL PRO 300X201X66CM;OUTDOOR
12823669;;M;47;CHILENO;;X;PUCHUNCAVI                    ;VALPARAISO;0;0;0;0;0;0;0;0;0;CAMA ELASTICA (3,05M) CON MALLA GAMEPOWER AZUL;OUTDOOR
9013456;;M;61;CHILENO;;Boomers;YERBAS BUENAS                 ;MAULE;0;0;0;0;0;0;0;0;0;TACA TACA MADERA EVER GROUP;OUTDOOR
14535644;;M;42;CHILENO;;X;VINA DEL MAR                  ;VALPARAISO;0;0;0;0;0;0;0;0;0;PATINES SOY LUNA GIRL POWER T34;OUTDOOR
13864085;;F;41;CHILENO;;X;ARICA                         ;ARICA Y PARINACOTA;0;0;0;0;0;0;0;0;0;PISCINA STEEL PRO C/ESCALERA Y COBERTOR;OUTDOOR
16709115;;M;34;CHILENO;;Millenial;PROVIDENCIA                   ;METROPOLITANA;0;0;0;0;0;0;0;0;0;AUTO ELECTRICO CHEVROLET CAMARO RS AMARILLO 6V;OUTDOOR
7569053;Casado;F;61;CHILENO;PSICOLOGO;Boomers;SAN ANTONIO                   ;VALPARAISO;0;0;0;0;0;0;0;0;0;MOTO ELECTRICA BMW BLANCA;OUTDOOR
20222294;;F;22;CHILENO;;Z;MAIPU;METROPOLITANA;0;0;0;0;0;0;0;0;0;2EN1 CABALLO MECEDOR+SILLA;OUTDOOR
15100997;;F;39;CHILENO;;X;PROVIDENCIA                   ;METROPOLITANA;0;0;0;0;0;0;0;0;0;MALETA CORREPASILLO ELEFANTE ROSADA;OUTDOOR
17632904;;M;31;CHILENO;;Millenial;PROVIDENCIA                   ;METROPOLITANA;0;0;0;0;0;0;0;0;0;CUATRIMOTO ELECTRICA SUPER ROJA 6V;OUTDOOR
8804722;;M;62;CHILENO;;Boomers;VICTORIA                      ;ARAUCANIA;0;0;0;0;0;0;0;0;0;SET SNORKEL HYDRO-SWIM COZUMEL;OUTDOOR
15703648;;F;38;CHILENO;;Millenial;N/D;N/D;52990;1;1;0;0;0;1;1;52990;Asistencia Programa Domiciliario;GARANTIAS
7731708;;M;62;CHILENO;;Boomers;TALCA                         ;MAULE;805960;4;3;0;0;0;4;3;805960;Asistencia Salud Integral Familia;GARANTIAS
8881256;;M;60;CHILENO;;Boomers;QUILLON                       ;BIO BIO;52990;1;1;0;0;0;1;1;52990;Asistencia Salud Integral Familia;GARANTIAS
6209104;;F;70;CHILENO;;Silencioso;TALCAHUANO                    ;BIO BIO;52990;1;1;0;0;0;1;1;52990;Asistencia Salud Integral Familia;GARANTIAS
17164968;;F;32;CHILENO;;Millenial;LOS ANDES                     ;VALPARAISO;0;0;2;0;0;0;0;2;0;Asistencia Salud Integral Familia;GARANTIAS
8780563;;F;64;CHILENO;;Boomers;TALCAHUANO                    ;BIO BIO;52990;1;1;0;0;0;1;1;52990;Asistencia Salud Integral Familia;GARANTIAS
7609192;;M;65;CHILENO;;Boomers;MONTE PATRIA                  ;COQUIMBO;105980;2;2;0;0;0;2;2;105980;Asistencia Salud Integral Familia;GARANTIAS
8685584;;M;59;CHILENO;;Boomers;N/D;N/D;143970;3;1;0;0;0;3;1;143970;Asistencia Salud Integral Familia;GARANTIAS
7157479;;F;69;CHILENO;;Silencioso;VILLARICA                     ;ARAUCANIA;193510;3;2;0;0;0;3;2;193510;Asistencia Salud Integral Familia;GARANTIAS
9545825;;M;59;CHILENO;;Boomers;MELIPILLA                     ;METROPOLITANA;730870;12;7;0;0;0;12;7;730870;Asistencia Salud Integral Familia;GARANTIAS
6655030;;M;70;CHILENO;;Silencioso;N/D;N/D;52990;1;1;0;0;0;1;1;52990;Asistencia Salud Integral Familia;GARANTIAS
12626340;;F;47;CHILENO;;X;VALPARAISO                    ;VALPARAISO;553940;6;3;0;0;0;6;3;553940;Asistencia Salud Integral Familia;GARANTIAS
17540153;;F;32;CHILENO;;Millenial;HUALPEN;BIO-BIO;52990;1;1;0;0;0;1;1;52990;Asistencia Salud Integral Familia;GARANTIAS
10055179;;F;58;CHILENO;;Boomers;LOS ANDES                     ;VALPARAISO;153860;3;3;0;0;0;3;3;153860;Asistencia Programa Domiciliario;GARANTIAS
18516818;;M;29;CHILENO;;Millenial;ZAPALLAR                      ;VALPARAISO;225970;3;3;0;0;0;3;3;225970;Asistencia Salud Integral Familia;GARANTIAS
5993832;;F;70;CHILENO;;Silencioso;CALAMA                        ;ANTOFAGASTA;105980;2;2;0;0;0;2;2;105980;Asistencia Salud Integral Familia;GARANTIAS
6254915;;F;71;CHILENO;;Silencioso;MOLINA                        ;MAULE;34990;1;3;0;0;0;1;3;34990;Asistencia Salud Integral Familia;GARANTIAS
18723828;;F;28;CHILENO;;Millenial;"";"";156970;3;2;2;1;103980;1;1;52990;Asistencia Salud Integral Familia;GARANTIAS
5847911;;F;77;CHILENO;;Silencioso;MACHALI                       ;L.G.B.OÂ´HIGGINS;172980;2;2;0;0;0;2;2;172980;Asistencia Salud Integral Familia;GARANTIAS
9116119;;F;60;CHILENO;;Boomers;QUILLOTA                      ;VALPARAISO;470930;7;5;0;0;0;7;5;470930;ASIST. FULL HOGAR Y AUTO INGRAL;GARANTIAS
7839161;;M;63;CHILENO;;Boomers;VICUNA                        ;COQUIMBO;1332241;12;6;0;0;0;12;6;1332241;Asistencia Salud Integral Familia;GARANTIAS
22903221;;F;47;PERUANO;;Extranjero;"";"";105980;2;2;0;0;0;2;2;105980;Asistencia Programa Domiciliario;GARANTIAS
7710572;;M;66;CHILENO;;Boomers;CALAMA                        ;ANTOFAGASTA;45041;1;1;0;0;0;1;1;45041;Asistencia Salud Integral Familia;GARANTIAS
12329888;;F;49;CHILENO;;X;LEBU                          ;BIO BIO;538040;8;6;0;0;0;8;6;538040;ASIST. FULL HOGAR Y AUTO INGRAL;GARANTIAS
12492837;;M;49;CHILENO;;X;MACUL                         ;METROPOLITANA;52990;1;1;0;0;0;1;1;52990;Asistencia Salud Integral Familia;GARANTIAS
11231302;;M;53;CHILENO;;X;MELIPILLA                     ;METROPOLITANA;52990;1;1;0;0;0;1;1;52990;ASIST. FULL HOGAR Y AUTO INGRAL;GARANTIAS
9792344;;M;58;CHILENO;;Boomers;TALCA                         ;MAULE;658940;6;6;0;0;0;6;6;658940;Asistencia Salud Integral Familia;GARANTIAS
11696380;;F;50;CHILENO;;X;SAN BERNARDO                  ;METROPOLITANA;742160;10;7;0;0;0;10;7;742160;Asistencia Salud Integral Familia;GARANTIAS
8923071;;M;64;CHILENO;;Boomers;LOLOL                         ;L.G.B.OÂ´HIGGINS;105980;2;2;0;0;0;2;2;105980;Asistencia Programa Domiciliario;GARANTIAS
26895418;;F;51;CHILENO;;X;"";"";52990;1;1;0;0;0;1;1;52990;Asistencia Salud Integral Familia;GARANTIAS
12498100;;F;49;CHILENO;;X;EL MONTE                      ;METROPOLITANA;19990;1;3;0;0;0;1;3;19990;Asistencia Salud Integral Familia;GARANTIAS
7276137;;M;67;CHILENO;;Boomers;VINA DEL MAR                  ;VALPARAISO;168020;6;2;0;0;0;6;2;168020;Asistencia Salud Integral Familia;GARANTIAS
10556151;;F;56;CHILENO;;Boomers;N/D;N/D;173130;3;3;0;0;0;3;3;173130;Asistencia Salud Integral Familia;GARANTIAS
14017371;;M;41;CHILENO;;X;N/D;N/D;510150;5;3;0;0;0;5;3;510150;Asistencia Salud Integral Familia;GARANTIAS
25534912;;F;34;PERUANO;;Extranjero;LA FLORIDA                    ;METROPOLITANA;354950;5;3;2;1;259980;3;2;94970;Asistencia Salud Integral Familia;GARANTIAS
10429762;;M;56;CHILENO;;Boomers;"";"";52990;1;1;0;0;0;1;1;52990;Asistencia Salud Integral Familia;GARANTIAS
4937395;;F;75;CHILENO;;Silencioso;VALDIVIA                      ;LOS LAGOS;514930;7;4;0;0;0;7;4;514930;Asistencia Salud Integral Familia;GARANTIAS
6769781;;F;77;CHILENO;;Silencioso;CONCEPCION                    ;BIO BIO;153860;3;3;0;0;0;3;3;153860;Asistencia Programa Domiciliario;GARANTIAS
11440087;;F;54;CHILENO;;Boomers;LEBU                          ;BIO BIO;298960;4;4;0;0;0;4;4;298960;Asistencia Salud Integral Familia;GARANTIAS
8368499;;F;66;CHILENO;;Boomers;PUERTO MONTT                  ;LOS LAGOS;105980;2;2;0;0;0;2;2;105980;Asistencia Salud Integral Familia;GARANTIAS
26745850;;M;63;VENEZOLANO;;Extranjero;LOS ANGELES                   ;BIO BIO;254750;4;3;0;0;0;4;3;254750;Asistencia Programa Domiciliario;GARANTIAS
7131987;;M;65;CHILENO;;Boomers;MELIPILLA                     ;METROPOLITANA;1708939;6;3;0;0;0;6;3;1708939;ASIST. FULL HOGAR Y AUTO INGRAL;GARANTIAS
24039800;;F;59;PERUANO;;Extranjero;RECOLETA                      ;METROPOLITANA;52990;1;1;0;0;0;1;1;52990;Asistencia Salud Integral Familia;GARANTIAS
25802051;;M;45;EXTRANJERO - NO INFORMA NACIONALIDAD;;Extranjero;TILTIL                        ;METROPOLITANA;642960;4;4;0;0;0;4;4;642960;Asistencia Salud Integral Familia;GARANTIAS
8518256;;F;62;CHILENO;;Boomers;SANTA CRUZ                    ;L.G.B.OÂ´HIGGINS;768940;6;4;0;0;0;6;4;768940;Asistencia Salud Integral Familia;GARANTIAS
15056924;;F;39;CHILENO;;X;LA LIGUA                      ;VALPARAISO;654961;5;5;2;3;241980;3;2;412981;Asistencia Salud Integral Familia;GARANTIAS
11232430;;F;54;CHILENO;;X;CURICO                        ;MAULE;45041;1;1;0;0;0;1;1;45041;Asistencia Salud Integral Familia;GARANTIAS
8922967;;M;61;CHILENO;;Boomers;SAN BERNARDO                  ;METROPOLITANA;52990;1;1;0;0;0;1;1;52990;Asistencia Salud Integral Familia;GARANTIAS
15418975;;F;40;CHILENO;;X;SAN JAVIER                    ;MAULE;188960;4;3;0;0;0;4;3;188960;Asistencia Salud Integral Familia;GARANTIAS
7958074;;M;63;CHILENO;;Boomers;RIO NEGRO                     ;LOS LAGOS;474950;5;2;0;0;0;5;2;474950;Asistencia Salud Integral Familia;GARANTIAS
11239320;;F;54;CHILENO;;X;TALCAHUANO                    ;BIO BIO;238440;5;3;0;0;0;5;3;238440;GM 1A X CTA SBI;GARANTIAS
15192598;;F;41;CHILENO;;X;CORONEL;BIO-BIO;67970;3;2;0;0;0;3;2;67970;Asistencia Programa Domiciliario;GARANTIAS
20773305;;F;21;CHILENO;;Z;QUELLON;LOS LAGOS;126540;2;3;2;1;126540;0;2;0;GPL 3A X CTA SBI;GARANTIAS
26521154;Soltero;M;33;NO INFORMA NACIONALIDAD;;Extranjero;SANTIAGO                      ;METROPOLITANA;52990;1;1;0;0;0;1;1;52990;Asistencia Programa Domiciliario;GARANTIAS
7250837;;F;69;CHILENO;;Silencioso;"";"";52990;1;1;0;0;0;1;1;52990;Asistencia Programa Domiciliario;GARANTIAS
12083564;;M;54;CHILENO;;Boomers;SAN FERNANDO                  ;L.G.B.OÂ´HIGGINS;79980;2;2;0;0;0;2;2;79980;Asistencia Salud Integral Familia;GARANTIAS
9993069;;F;54;CHILENO;;Boomers;N/D;N/D;92970;3;3;0;0;0;3;3;92970;Asistencia Programa Domiciliario;GARANTIAS
10046961;;F;58;CHILENO;;Boomers;FREIRE                        ;ARAUCANIA;389510;6;4;0;0;0;6;4;389510;Asistencia Salud Integral Familia;GARANTIAS
10930555;;F;56;CHILENO;;Boomers;SANTA CRUZ                    ;L.G.B.OÂ´HIGGINS;211960;4;2;0;0;0;4;2;211960;Asistencia Salud Integral Familia;GARANTIAS
24019429;;M;56;COLOMBIANO;;Extranjero;ANTOFAGASTA                   ;ANTOFAGASTA;69980;2;2;0;0;0;2;2;69980;Asistencia Programa Domiciliario;GARANTIAS
25836511;;M;45;COLOMBIANO;;Extranjero;ANTOFAGASTA                   ;ANTOFAGASTA;158970;3;3;0;0;0;3;3;158970;Asistencia Programa Domiciliario;GARANTIAS
14247131;;F;48;CHILENO;;X;PERALILLO                     ;L.G.B.OÂ´HIGGINS;72980;2;2;0;0;0;2;2;72980;Asistencia Salud Integral Familia;GARANTIAS
11526862;;M;52;CHILENO;;X;ANTOFAGASTA                   ;ANTOFAGASTA;302980;2;2;1;1;249990;1;1;52990;Asistencia Programa Domiciliario;GARANTIAS
7083276;;F;64;CHILENO;;Boomers;MACUL                         ;METROPOLITANA;105980;2;1;0;0;0;2;1;105980;Asistencia Salud Integral Familia;GARANTIAS
9621238;;F;60;CHILENO;;Boomers;SANTA CRUZ                    ;L.G.B.OÂ´HIGGINS;688920;9;8;0;0;0;9;8;688920;Asistencia Salud Integral Familia;GARANTIAS
6275678;;M;68;CHILENO;;Boomers;RANCAGUA                      ;L.G.B.OÂ´HIGGINS;371950;5;3;0;0;0;5;3;371950;Asistencia Salud Integral Familia;GARANTIAS
12316560;;F;54;CHILENO;;X;SAN JAVIER                    ;MAULE;319821;6;5;0;0;0;6;5;319821;Asistencia Salud Integral Familia;GARANTIAS
11230882;;F;54;CHILENO;;X;MELIPILLA                     ;METROPOLITANA;600940;6;3;0;0;0;6;3;600940;Asistencia Salud Integral Familia;GARANTIAS
7853252;;M;65;CHILENO;;Boomers;PLACILLA                      ;L.G.B.OÂ´HIGGINS;688930;7;6;0;0;0;7;6;688930;Asistencia Salud Integral Familia;GARANTIAS
7462469;;F;69;CHILENO;;Silencioso;VICTORIA                      ;ARAUCANIA;112980;2;2;0;0;0;2;2;112980;ASIST. FULL HOGAR Y AUTO INGRAL;GARANTIAS
26887938;;F;33;EXTRANJERO - NO INFORMA NACIONALIDAD;;Extranjero;"";"";52990;1;1;0;0;0;1;1;52990;Asistencia Programa Domiciliario;GARANTIAS
5589672;;M;75;CHILENO;;Silencioso;ARICA                         ;ARICA Y PARINACOTA;539990;1;3;0;0;0;1;3;539990;Asistencia Salud Integral Familia;GARANTIAS
26433585;;F;37;CHILENO;;Extranjero;"";"";174970;3;4;1;1;149990;2;3;24980;Asistencia de Mascotas;GARANTIAS
5859668;;M;81;CHILENO;;Silencioso;ISLA DE MAIPO                 ;METROPOLITANA;52990;1;1;0;0;0;1;1;52990;Asistencia Programa Domiciliario;GARANTIAS
14245445;;F;48;CHILENO;;X;MARIA PINTO                   ;METROPOLITANA;157970;3;3;0;0;0;3;3;157970;ASIST. FULL HOGAR Y AUTO INGRAL;GARANTIAS
4985766;;F;78;CHILENO;;Silencioso;LAUTARO                       ;ARAUCANIA;114980;4;2;0;0;0;4;2;114980;Asistencia Salud Integral Familia;GARANTIAS
8291287;;M;65;CHILENO;;Boomers;LOS ANGELES                   ;BIO BIO;238960;5;2;0;0;0;5;2;238960;Asistencia Salud Integral Familia;GARANTIAS
11279974;;F;53;CHILENO;;X;NANCAGUA                      ;L.G.B.OÂ´HIGGINS;1018370;12;5;0;0;0;12;5;1018370;Asistencia de Mascotas;GARANTIAS
5940771;;F;74;CHILENO;;Silencioso;N/D;N/D;1220240;10;5;0;0;0;10;5;1220240;Asistencia Salud Integral Familia;GARANTIAS
9468648;;M;60;CHILENO;;Boomers;CHILLAN                       ;BIO BIO;262970;3;3;0;0;0;3;3;262970;Asistencia Salud Integral Familia;GARANTIAS
11412610;;F;54;CHILENO;;Millenial;FRUTILLAR                     ;LOS LAGOS;52990;1;1;0;0;0;1;1;52990;Asistencia Salud Integral Familia;GARANTIAS
14300923;;F;49;CHILENO;;X;RANCAGUA                      ;L.G.B.OÂ´HIGGINS;52990;1;1;0;0;0;1;1;52990;Asistencia Salud Integral Familia;GARANTIAS
18943955;;M;28;CHILENO;;Millenial;N/D;N/D;433960;4;4;0;0;0;4;4;433960;Asistencia Programa Domiciliario;GARANTIAS
9116905;;M;59;CHILENO;;Boomers;LLAILLAY                      ;VALPARAISO;232140;4;3;0;0;0;4;3;232140;Asistencia Salud Integral Familia;GARANTIAS
6425011;;F;69;CHILENO;;Silencioso;CONCEPCION                    ;BIO BIO;0;0;2;0;0;0;0;2;0;Asistencia Salud Integral Familia;GARANTIAS
9743726;;M;59;CHILENO;;Boomers;LAS CABRAS                    ;L.G.B.OÂ´HIGGINS;105980;2;2;0;0;0;2;2;105980;Asistencia Salud Integral Familia;GARANTIAS
17728745;;F;31;CHILENO;;Millenial;"";"";0;0;2;0;0;0;0;2;0;ASIST. FULL HOGAR Y AUTO INGRAL;GARANTIAS
10577784;;M;56;CHILENO;;Boomers;OVALLE                        ;COQUIMBO;359362;6;4;0;0;0;6;4;359362;Asistencia Salud Integral Familia;GARANTIAS
10200147;;M;57;CHILENO;;Boomers;PALMILLA                      ;L.G.B.OÂ´HIGGINS;52990;1;1;0;0;0;1;1;52990;Asistencia Salud Integral Familia;GARANTIAS
10701319;;M;53;CHILENO;;X;CONCEPCION                    ;BIO BIO;78580;6;6;0;0;0;6;6;78580;Asistencia Salud Integral Familia;GARANTIAS
26082659;;F;41;VENEZOLANO;;Extranjero;"";"";52990;1;1;0;0;0;1;1;52990;Asistencia Programa Domiciliario;GARANTIAS
9445804;;F;57;CHILENO;;Boomers;TOME                          ;BIO BIO;143970;3;1;0;0;0;3;1;143970;Asistencia Salud Integral Familia;GARANTIAS
5059626;;F;75;CHILENO;;Silencioso;SAN ANTONIO                   ;VALPARAISO;1144380;11;8;0;0;0;11;8;1144380;Asistencia Programa Domiciliario;GARANTIAS
10874180;;M;56;CHILENO;;Boomers;LOS ALAMOS                    ;BIO BIO;359940;6;3;0;0;0;6;3;359940;Asistencia Salud Integral Familia;GARANTIAS
23860139;;F;37;COLOMBIANO;;Extranjero;CALAMA                        ;ANTOFAGASTA;322970;5;3;0;0;0;5;3;322970;Asistencia Salud Integral Familia;GARANTIAS
8579644;;M;64;CHILENO;;Boomers;PINTO                         ;BIO BIO;109260;5;3;0;0;0;5;3;109260;Asistencia Salud Integral Familia;GARANTIAS
11942685;;F;49;CHILENO;;X;LA LIGUA                      ;VALPARAISO;84970;3;5;0;0;0;3;5;84970;GM 1A X CTA SBI;GARANTIAS
10972125;;M;53;CHILENO;;X;"";"";53000;2;1;0;0;0;2;1;53000;Asistencia Programa Domiciliario;GARANTIAS
8813360;;M;62;CHILENO;;Boomers;LOS ANGELES                   ;BIO BIO;105980;2;1;0;0;0;2;1;105980;Asistencia Salud Integral Familia;GARANTIAS
14028400;;F;40;CHILENO;;X;LA FLORIDA                    ;METROPOLITANA;0;0;2;0;0;0;0;2;0;Asistencia Programa Domiciliario;GARANTIAS
10367409;;F;56;CHILENO;;Boomers;CONSTITUCION                  ;MAULE;282980;2;2;0;0;0;2;2;282980;Asistencia Programa Domiciliario;GARANTIAS
14028540;;F;40;CHILENO;;X;CHILLAN VIEJO                 ;BIO BIO;278130;7;6;0;0;0;7;6;278130;Asistencia Salud Integral Familia;GARANTIAS
11856015;;M;51;CHILENO;;X;MACUL                         ;METROPOLITANA;75980;2;2;0;0;0;2;2;75980;Asistencia Programa Domiciliario;GARANTIAS
12129755;;F;53;CHILENO;;X;TALCAHUANO                    ;BIO BIO;16990;1;7;0;0;0;1;7;16990;GPL 2A X CTA SBI;GARANTIAS
6036990;;M;72;CHILENO;;Silencioso;TALCAHUANO                    ;BIO BIO;52990;1;1;0;0;0;1;1;52990;ASIST. FULL HOGAR Y AUTO INGRAL;GARANTIAS
7119490;;F;65;CHILENO;;Boomers;VINA DEL MAR                  ;VALPARAISO;60980;2;2;0;0;0;2;2;60980;Asistencia Programa Domiciliario;GARANTIAS
8399360;;M;63;CHILENO;;Boomers;TEMUCO                        ;ARAUCANIA;71980;2;2;0;0;0;2;2;71980;ASIST. FULL HOGAR Y AUTO INGRAL;GARANTIAS
18520850;;F;28;CHILENO;;Millenial;VALLENAR;ATACAMA;574970;3;2;2;1;521980;1;1;52990;Asistencia Salud Integral Familia;GARANTIAS
19427040;;F;26;CHILENO;;Z;N/D;N/D;1435950;5;3;2;1;1309980;3;2;125970;Asistencia Salud Integral Familia;GARANTIAS
4117808;;M;82;CHILENO;;Silencioso;CHILLAN                       ;BIO BIO;52990;1;1;0;0;0;1;1;52990;Asistencia Salud Integral Familia;GARANTIAS
20177458;;F;23;CHILENO;;Z;N/D;N/D;257970;3;2;2;1;204980;1;1;52990;Asistencia Salud Integral Familia;GARANTIAS
5036936;;M;76;CHILENO;;Silencioso;COLINA                        ;METROPOLITANA;145640;5;4;0;0;0;5;4;145640;Asistencia Salud Integral Familia;GARANTIAS
11767529;;F;50;CHILENO;;X;PELLUHUE                      ;MAULE;52990;1;1;0;0;0;1;1;52990;Asistencia Salud Integral Familia;GARANTIAS
6800481;;M;71;CHILENO;;Silencioso;N/D;N/D;52990;1;1;0;0;0;1;1;52990;Asistencia Programa Domiciliario;GARANTIAS
10934032;;M;45;CHILENO;;X;LEBU                          ;BIO BIO;107980;2;2;0;0;0;2;2;107980;Asistencia Salud Integral Familia;GARANTIAS
15072844;;M;40;CHILENO;;X;N/D;N/D;52990;1;1;0;0;0;1;1;52990;Asistencia Salud Integral Familia;GARANTIAS
15750023;;F;39;CHILENO;;X;CALBUCO                       ;LOS LAGOS;52990;1;1;0;0;0;1;1;52990;Asistencia Programa Domiciliario;GARANTIAS
16742772;;F;34;CHILENO;;Millenial;SAN RAMON;METROPOLITANA;196970;3;2;2;1;143980;1;1;52990;Asistencia Programa Domiciliario;GARANTIAS
10120064;;M;56;CHILENO;;Boomers;MELIPILLA                     ;METROPOLITANA;1020910;9;5;0;0;0;9;5;1020910;Asistencia Salud Integral Familia;GARANTIAS
5989446;;F;70;CHILENO;;Silencioso;MAULE                         ;MAULE;236490;5;3;0;0;0;5;3;236490;Asistencia de Mascotas;GARANTIAS
7422377;;F;67;CHILENO;;Boomers;OSORNO                        ;LOS LAGOS;52990;1;1;0;0;0;1;1;52990;Asistencia Salud Integral Familia;GARANTIAS
12025195;;F;54;CHILENO;;X;CANETE                        ;BIO BIO;132970;4;2;0;0;0;4;2;132970;Asistencia Salud Integral Familia;GARANTIAS
26036203;;M;41;PERUANO;;Extranjero;LOS VILOS                     ;COQUIMBO;0;0;2;0;0;0;0;2;0;ASIS. SALUD X CTA ASSISTIME;GARANTIAS
9552431;;F;62;CHILENO;;Boomers;TALCAHUANO                    ;BIO BIO;1014930;6;3;0;0;0;6;3;1014930;ASIST. FULL HOGAR Y AUTO INGRAL;GARANTIAS
10612698;;F;56;CHILENO;;Boomers;OVALLE                        ;COQUIMBO;100870;2;2;0;0;0;2;2;100870;Asistencia Salud Integral Familia;GARANTIAS
25650460;Soltero;M;38;VENEZOLANO;;Extranjero;"";"";52990;1;1;0;0;0;1;1;52990;Asistencia Programa Domiciliario;GARANTIAS
26213148;;M;56;EXTRANJERO - NO INFORMA NACIONALIDAD;;Extranjero;PADRE HURTADO                 ;METROPOLITANA;860940;6;3;0;0;0;6;3;860940;Asistencia Salud Integral Familia;GARANTIAS
9631301;;F;63;CHILENO;;Boomers;YUMBEL                        ;BIO BIO;52990;1;1;0;0;0;1;1;52990;ASIST. FULL HOGAR Y AUTO INGRAL;GARANTIAS
9534805;;F;61;CHILENO;;Boomers;LOS ANGELES                   ;BIO BIO;432980;2;2;0;0;0;2;2;432980;Asistencia Salud Integral Familia;GARANTIAS
13077470;;M;46;CHILENO;;Millenial;N/D;N/D;52990;1;1;0;0;0;1;1;52990;Asistencia Programa Domiciliario;GARANTIAS
14908760;;F;42;CHILENO;;X;"";"";926240;5;4;0;0;0;5;4;926240;Asistencia Salud Integral Familia;GARANTIAS
13924163;;F;42;CHILENO;;X;PROVIDENCIA;METROPOLITANA;52990;1;1;0;0;0;1;1;52990;Asistencia Programa Domiciliario;GARANTIAS
15304318;;F;41;CHILENO;;X;N/D;N/D;94180;3;1;0;0;0;3;1;94180;Asistencia Salud Integral Familia;GARANTIAS
10268105;;M;54;CHILENO;;Boomers;OVALLE                        ;COQUIMBO;369840;5;3;0;0;0;5;3;369840;Asistencia Programa Domiciliario;GARANTIAS
26175605;;M;23;VENEZOLANO;;Extranjero;VINA DEL MAR                  ;VALPARAISO;52990;1;1;0;0;0;1;1;52990;Asistencia Salud Integral Familia;GARANTIAS
16109169;;F;37;CHILENO;;Millenial;COPIAPO                       ;ATACAMA;157960;4;3;0;0;0;4;3;157960;ASIST. FULL HOGAR Y AUTO INGRAL;GARANTIAS
16666189;;F;35;CHILENO;;Millenial;PUDAHUEL                      ;METROPOLITANA;52990;1;1;0;0;0;1;1;52990;Asistencia Programa Domiciliario;GARANTIAS
15797168;;F;38;CHILENO;;Millenial;N/D;N/D;52990;1;1;0;0;0;1;1;52990;ASIST. FULL HOGAR Y AUTO INGRAL;GARANTIAS
24833474;;F;48;COLOMBIANO;;Extranjero;N/D;N/D;159960;4;3;0;0;0;4;3;159960;Asistencia Programa Domiciliario;GARANTIAS
8569629;;M;64;CHILENO;;Boomers;MELIPILLA                     ;METROPOLITANA;52990;1;1;0;0;0;1;1;52990;Asistencia Salud Integral Familia;GARANTIAS
15149032;;M;40;CHILENO;;X;SAN JAVIER                    ;MAULE;52990;1;1;0;0;0;1;1;52990;Asistencia Salud Integral Familia;GARANTIAS
9519391;;M;59;CHILENO;;Boomers;VICTORIA                      ;ARAUCANIA;52990;1;1;0;0;0;1;1;52990;ASIST. FULL HOGAR Y AUTO INGRAL;GARANTIAS
7858941;;F;64;CHILENO;;Boomers;BUIN                          ;METROPOLITANA;152980;2;2;0;0;0;2;2;152980;Asistencia Salud Integral Familia;GARANTIAS
16290376;Soltero;M;35;CHILENO;;Millenial;RENCA                         ;METROPOLITANA;0;0;2;0;0;0;0;2;0;GM 1A X CTA SBI;GARANTIAS
24560327;;F;50;COLOMBIANO;;Extranjero;EL MONTE                      ;METROPOLITANA;105980;2;2;0;0;0;2;2;105980;ASIST. FULL HOGAR Y AUTO INGRAL;GARANTIAS
26394404;;M;39;HAITIANO;;Extranjero;LAMPA                         ;METROPOLITANA;52990;1;1;0;0;0;1;1;52990;ASIST. FULL HOGAR Y AUTO INGRAL;GARANTIAS
7561512;;F;76;CHILENO;;Silencioso;LEBU                          ;BIO BIO;932970;3;2;0;0;0;3;2;932970;Asistencia Salud Integral Familia;GARANTIAS
7612213;;F;69;CHILENO;;Silencioso;COQUIMBO                      ;COQUIMBO;52990;1;1;0;0;0;1;1;52990;Asistencia Salud Integral Familia;GARANTIAS
10173457;;F;59;CHILENO;;Boomers;SAN FERNANDO                  ;L.G.B.OÂ´HIGGINS;52990;1;1;0;0;0;1;1;52990;Asistencia Programa Domiciliario;GARANTIAS
21643258;;F;53;PERUANO;;Extranjero;N/D;N/D;52990;1;1;0;0;0;1;1;52990;Asistencia Programa Domiciliario;GARANTIAS
25303543;;M;26;PERUANO;;Extranjero;SANTIAGO                      ;METROPOLITANA;1227730;6;3;0;0;0;6;3;1227730;Asistencia Salud Integral Familia;GARANTIAS
8790158;;M;63;CHILENO;;Boomers;CHILLAN                       ;BIO BIO;52990;1;1;0;0;0;1;1;52990;Asistencia Salud Integral Familia;GARANTIAS
12512460;;F;48;CHILENO;;X;N/D;N/D;254950;5;4;0;0;0;5;4;254950;Asistencia Programa Domiciliario;GARANTIAS
6822124;;M;70;CHILENO;;Silencioso;CALERA                        ;VALPARAISO;52990;1;1;0;0;0;1;1;52990;Asistencia Salud Integral Familia;GARANTIAS
6756326;;F;69;CHILENO;;Silencioso;PEUMO                         ;L.G.B.OÂ´HIGGINS;163910;9;4;0;0;0;9;4;163910;Asistencia Salud Integral Familia;GARANTIAS
14312001;;M;46;CHILENO;;X;ARICA                         ;ARICA Y PARINACOTA;132980;2;2;0;0;0;2;2;132980;Asistencia Salud Integral Familia;GARANTIAS
25832504;;F;31;ECUATORIANO;;Extranjero;N/D;N/D;52990;1;1;0;0;0;1;1;52990;Asistencia Salud Integral Familia;GARANTIAS
11824053;;M;50;CHILENO;;X;COQUIMBO                      ;COQUIMBO;52990;1;1;0;0;0;1;1;52990;Asistencia Salud Integral Familia;GARANTIAS
12759867;;F;46;CHILENO;;X;PUERTO MONTT                  ;LOS LAGOS;391960;4;3;0;0;0;4;3;391960;Asistencia Programa Domiciliario;GARANTIAS
9445953;;F;59;CHILENO;;Boomers;CONSTITUCION                  ;MAULE;684410;9;4;6;3;525440;3;1;158970;Asistencia Salud Integral Familia;GARANTIAS
7056413;;F;71;CHILENO;;Silencioso;LOS ANGELES                   ;BIO BIO;158970;3;1;0;0;0;3;1;158970;Asistencia Salud Integral Familia;GARANTIAS
12334656;;F;48;CHILENO;;X;PUENTE ALTO                   ;METROPOLITANA;142980;2;2;0;0;0;2;2;142980;Asistencia Programa Domiciliario;GARANTIAS
8813005;;F;65;CHILENO;;Boomers;VINA DEL MAR                  ;VALPARAISO;431920;9;4;0;0;0;9;4;431920;Asistencia Programa Domiciliario;GARANTIAS
8397861;;M;61;CHILENO;;Boomers;RENCA                         ;METROPOLITANA;0;0;2;0;0;0;0;2;0;GPL 1A X CTA SBI;GARANTIAS
17636131;;M;32;CHILENO;;Millenial;CABILDO                       ;VALPARAISO;52990;1;1;0;0;0;1;1;52990;Asistencia Salud Integral Familia;GARANTIAS
26401819;;M;45;EXTRANJERO - NO INFORMA NACIONALIDAD;;Extranjero;SANTIAGO;METROPOLITANA;52990;1;1;0;0;0;1;1;52990;Asistencia Programa Domiciliario;GARANTIAS
18155132;;F;30;CHILENO;;Millenial;PROVIDENCIA                   ;METROPOLITANA;0;0;2;0;0;0;0;2;0;GPL 1A X CTA SBI;GARANTIAS
11697432;;M;50;CHILENO;;X;MARIA PINTO                   ;METROPOLITANA;52990;1;1;0;0;0;1;1;52990;Asistencia Salud Integral Familia;GARANTIAS
8229921;;M;62;CHILENO;;Boomers;QUINCHAO                      ;LOS LAGOS;42392;1;1;0;0;0;1;1;42392;Asistencia Programa Domiciliario;GARANTIAS
9106094;;F;63;CHILENO;;Boomers;SAN FERNANDO                  ;L.G.B.OÂ´HIGGINS;52990;1;1;0;0;0;1;1;52990;Asistencia Salud Integral Familia;GARANTIAS
14195245;;F;41;CHILENO;;X;LA CISTERNA                   ;METROPOLITANA;192970;3;3;0;0;0;3;3;192970;Asistencia Salud Integral Familia;GARANTIAS
5943562;;F;71;CHILENO;;Silencioso;VILLARICA                     ;ARAUCANIA;550920;8;5;0;0;0;8;5;550920;Asistencia Programa Domiciliario;GARANTIAS
14007667;;F;41;CHILENO;;X;MELIPILLA                     ;METROPOLITANA;232960;5;2;0;0;0;5;2;232960;Asistencia Programa Domiciliario;GARANTIAS
6393447;;M;73;CHILENO;;Silencioso;INDEPENDENCIA                 ;METROPOLITANA;105980;2;1;0;0;0;2;1;105980;Asistencia Programa Domiciliario;GARANTIAS
8642096;;M;60;CHILENO;;Boomers;LOS ANDES                     ;VALPARAISO;52990;1;1;0;0;0;1;1;52990;Asistencia Salud Integral Familia;GARANTIAS
7143479;;F;71;CHILENO;;Silencioso;SAN BERNARDO                  ;METROPOLITANA;200970;3;3;0;0;0;3;3;200970;Asistencia Programa Domiciliario;GARANTIAS
7930204;;F;62;CHILENO;;Boomers;EL QUISCO                     ;VALPARAISO;52990;1;1;0;0;0;1;1;52990;Asistencia Salud Integral Familia;GARANTIAS
18154359;;M;31;CHILENO;;Millenial;CHILLAN                       ;BIO BIO;52990;1;1;0;0;0;1;1;52990;Asistencia Salud Integral Familia;GARANTIAS
20368632;;M;22;CHILENO;;Z;RANCAGUA                      ;L.G.B.OÂ´HIGGINS;526510;5;3;4;2;473520;1;1;52990;Asistencia Salud Integral Familia;GARANTIAS
9248774;;M;60;CHILENO;;Boomers;ALTO HOSPICIO;TARAPACA;52990;1;1;0;0;0;1;1;52990;Asistencia Salud Integral Familia;GARANTIAS
8249038;;F;63;CHILENO;;Boomers;VILLARICA                     ;ARAUCANIA;52990;1;1;0;0;0;1;1;52990;Asistencia Salud Integral Familia;GARANTIAS
14465067;;F;49;CHILENO;;X;OVALLE                        ;COQUIMBO;196950;7;3;0;0;0;7;3;196950;GPL 1A X CTA SBI;GARANTIAS
19214078;;M;26;CHILENO;;Z;N/D;N/D;71970;3;2;0;0;0;3;2;71970;Asistencia Programa Domiciliario;GARANTIAS
7743911;;M;63;CHILENO;;Boomers;EL BOSQUE                     ;METROPOLITANA;52990;1;1;0;0;0;1;1;52990;Asistencia Programa Domiciliario;GARANTIAS
5313466;;F;77;CHILENO;;Silencioso;LONCOCHE                      ;ARAUCANIA;52990;1;1;0;0;0;1;1;52990;Asistencia Salud Integral Familia;GARANTIAS
10927216;Soltero;F;58;CHILENO;;Boomers;MAFIL                         ;LOS LAGOS;76980;3;1;0;0;0;3;1;76980;GPL 1A X CTA SBI;GARANTIAS
25368534;;F;58;BOLIVIANO;;Extranjero;COLINA                        ;METROPOLITANA;52990;1;1;0;0;0;1;1;52990;Asistencia Salud Integral Familia;GARANTIAS
5523459;;F;74;CHILENO;;Silencioso;VILLARICA                     ;ARAUCANIA;59990;1;1;0;0;0;1;1;59990;Asistencia Salud Integral Familia;GARANTIAS
14311896;;M;46;CHILENO;;X;MELIPILLA                     ;METROPOLITANA;386970;3;2;0;0;0;3;2;386970;Asistencia Salud Integral Familia;GARANTIAS
11209890;;F;54;CHILENO;;Boomers;N/D;N/D;100870;2;2;0;0;0;2;2;100870;Asistencia Programa Domiciliario;GARANTIAS
23793930;;F;39;PERUANO;;Extranjero;QUINTA NORMAL                 ;METROPOLITANA;52990;1;1;0;0;0;1;1;52990;Asistencia Programa Domiciliario;GARANTIAS
13436135;;M;43;CHILENO;;X;N/D;N/D;52990;1;1;0;0;0;1;1;52990;Asistencia Programa Domiciliario;GARANTIAS
11877487;;F;50;CHILENO;;X;SAN MIGUEL                    ;METROPOLITANA;52990;1;1;0;0;0;1;1;52990;Asistencia Programa Domiciliario;GARANTIAS
5928962;;F;73;CHILENO;;Silencioso;LA PINTANA                    ;METROPOLITANA;47880;1;1;0;0;0;1;1;47880;ASIS. SALUD X CTA ASSISTIME;GARANTIAS
10219931;;F;58;CHILENO;;Boomers;QUILPUE                       ;VALPARAISO;52990;1;1;0;0;0;1;1;52990;Asistencia Salud Integral Familia;GARANTIAS
12073109;;M;43;CHILENO;;X;TALCA                         ;MAULE;52990;1;1;0;0;0;1;1;52990;Asistencia Salud Integral Familia;GARANTIAS
18331385;;F;46;CHILENO;;X;N/D;N/D;292980;2;2;0;0;0;2;2;292980;Asistencia Salud Integral Familia;GARANTIAS
11597627;;M;52;CHILENO;;X;N/D;N/D;52990;1;1;0;0;0;1;1;52990;Asistencia Programa Domiciliario;GARANTIAS
11132810;;F;55;CHILENO;;Boomers;PEUMO                         ;L.G.B.OÂ´HIGGINS;107980;2;2;0;0;0;2;2;107980;Asistencia Salud Integral Familia;GARANTIAS
24755776;;F;46;COLOMBIANO;;Extranjero;ALTO HOSPICIO;TARAPACA;52990;1;1;0;0;0;1;1;52990;Asistencia Salud Integral Familia;GARANTIAS
6033027;;M;71;CHILENO;;Silencioso;N/D;N/D;155020;6;2;0;0;0;6;2;155020;ASIS. SALUD X CTA ASSISTIME;GARANTIAS
17713487;;F;32;CHILENO;;Millenial;PUNITAQUI                     ;COQUIMBO;47880;1;1;0;0;0;1;1;47880;ASIS. SALUD X CTA ASSISTIME;GARANTIAS
8178006;;F;62;CHILENO;;Boomers;LA LIGUA                      ;VALPARAISO;47880;1;1;0;0;0;1;1;47880;ASIS. SALUD X CTA ASSISTIME;GARANTIAS
11935099;;F;50;CHILENO;;X;N/D;N/D;55080;1;1;0;0;0;1;1;55080;Asistencia Programa Domiciliario;GARANTIAS
9869678;;M;58;CHILENO;;Boomers;ISLA DE MAIPO                 ;METROPOLITANA;47880;1;1;0;0;0;1;1;47880;ASIS. SALUD X CTA ASSISTIME;GARANTIAS
17538875;;M;32;CHILENO;;Millenial;PINTO                         ;BIO BIO;47880;1;1;0;0;0;1;1;47880;ASIS. SALUD X CTA ASSISTIME;GARANTIAS
19268980;;F;26;CHILENO;;Z;N/D;N/D;102960;2;2;0;0;0;2;2;102960;Asistencia Programa Domiciliario;GARANTIAS
23109683;;F;54;COLOMBIANO;;Extranjero;COPIAPO                       ;ATACAMA;47880;1;1;0;0;0;1;1;47880;ASIS. SALUD X CTA ASSISTIME;GARANTIAS
5992549;;F;76;CHILENO;;Silencioso;LOS ANGELES                   ;BIO BIO;103750;3;1;0;0;0;3;1;103750;ASIS. SALUD X CTA ASSISTIME;GARANTIAS
11454482;;F;52;CHILENO;;X;SAN VICENTE                   ;L.G.B.OÂ´HIGGINS;47880;1;1;0;0;0;1;1;47880;ASIS. SALUD X CTA ASSISTIME;GARANTIAS
23189029;;F;56;PERUANO;;Extranjero;N/D;N/D;47880;1;1;0;0;0;1;1;47880;ASIS. SALUD X CTA ASSISTIME;GARANTIAS
11916048;;F;50;CHILENO;;X;RECOLETA                      ;METROPOLITANA;47880;1;1;0;0;0;1;1;47880;ASIS. SALUD X CTA ASSISTIME;GARANTIAS
18571721;;F;29;CHILENO;;Millenial;TALCA                         ;MAULE;102960;2;1;0;0;0;2;1;102960;Asistencia Programa Domiciliario;GARANTIAS
8883694;;M;63;CHILENO;;Boomers;CURICO                        ;MAULE;102960;2;2;0;0;0;2;2;102960;Asistencia Programa Domiciliario;GARANTIAS
6675758;;F;66;CHILENO;;Boomers;MAIPU                         ;METROPOLITANA;47880;1;1;0;0;0;1;1;47880;ASIS. SALUD X CTA ASSISTIME;GARANTIAS
8272670;;F;64;CHILENO;;Boomers;LINARES                       ;MAULE;92060;3;3;0;0;0;3;3;92060;Asistencia Programa Domiciliario;GARANTIAS
17760858;;M;31;CHILENO;;Millenial;PETORCA                       ;VALPARAISO;47880;1;1;0;0;0;1;1;47880;ASIS. SALUD X CTA ASSISTIME;GARANTIAS
8427718;;F;64;CHILENO;;Boomers;N/D;N/D;47880;1;1;0;0;0;1;1;47880;ASIS. SALUD X CTA ASSISTIME;GARANTIAS
15997383;;F;36;CHILENO;;Millenial;PUERTO MONTT                  ;LOS LAGOS;47880;1;1;0;0;0;1;1;47880;ASIS. SALUD X CTA ASSISTIME;GARANTIAS
11019085;;F;56;CHILENO;;Boomers;N/D;N/D;47880;1;1;0;0;0;1;1;47880;ASIS. SALUD X CTA ASSISTIME;GARANTIAS
5138351;;F;75;CHILENO;;Silencioso;SAN BERNARDO                  ;METROPOLITANA;47880;1;1;0;0;0;1;1;47880;ASIS. SALUD X CTA ASSISTIME;GARANTIAS
11515146;;F;52;CHILENO;;X;LOS VILOS                     ;COQUIMBO;47880;1;1;0;0;0;1;1;47880;ASIS. SALUD X CTA ASSISTIME;GARANTIAS
7244406;;M;68;CHILENO;;Silencioso;COQUIMBO                      ;COQUIMBO;47880;1;1;0;0;0;1;1;47880;ASIS. SALUD X CTA ASSISTIME;GARANTIAS
25774324;;M;29;CHILENO;;Extranjero;N/D;N/D;47880;1;1;0;0;0;1;1;47880;ASIS. SALUD X CTA ASSISTIME;GARANTIAS
26374558;;M;50;CHILENO;;Extranjero;N/D;N/D;47880;1;1;0;0;0;1;1;47880;ASIS. SALUD X CTA ASSISTIME;GARANTIAS
8945653;;M;61;CHILENO;;Boomers;TALCA                         ;MAULE;55080;1;1;0;0;0;1;1;55080;Asistencia Programa Domiciliario;GARANTIAS
15579736;;F;39;CHILENO;;X;N/D;N/D;47880;1;1;0;0;0;1;1;47880;ASIS. SALUD X CTA ASSISTIME;GARANTIAS
9114401;;F;66;CHILENO;;Boomers;CONCEPCION                    ;BIO BIO;47880;1;1;0;0;0;1;1;47880;ASIS. SALUD X CTA ASSISTIME;GARANTIAS
18417937;;F;29;CHILENO;;Millenial;LEBU                          ;BIO BIO;0;0;0;0;0;0;0;0;0;ASIS. SALUD X CTA ASSISTIME;GARANTIAS
18696118;;F;28;CHILENO;;Millenial;N/D;N/D;0;0;0;0;0;0;0;0;0;ASIS. SALUD X CTA ASSISTIME;GARANTIAS
27187847;;M;34;CHILENO;;Extranjero;N/D;N/D;0;0;0;0;0;0;0;0;0;ASIS. SALUD X CTA ASSISTIME;GARANTIAS
12316706;;F;49;CHILENO;;X;LA SERENA                     ;COQUIMBO;0;0;0;0;0;0;0;0;0;ASIS. SALUD X CTA ASSISTIME;GARANTIAS
10975691;;M;51;CHILENO;;X;N/D;N/D;0;0;0;0;0;0;0;0;0;GM 1A X CTA SBI;GARANTIAS
15389610;;F;38;CHILENO;;X;N/D;N/D;0;0;0;0;0;0;0;0;0;ASIS. SALUD X CTA ASSISTIME;GARANTIAS
6178999;;M;72;CHILENO;;Silencioso;AISEN                         ;AYSEN;0;0;0;0;0;0;0;0;0;ASIS. SALUD X CTA ASSISTIME;GARANTIAS
10583865;;M;53;CHILENO;;X;N/D;N/D;0;0;0;0;0;0;0;0;0;ASIS. SALUD X CTA ASSISTIME;GARANTIAS
15092345;;M;39;CHILENO;;X;LOS ANDES                     ;VALPARAISO;0;0;0;0;0;0;0;0;0;ASIS. SALUD X CTA ASSISTIME;GARANTIAS
11825782;;F;54;CHILENO;;Boomers;N/D;N/D;0;0;0;0;0;0;0;0;0;ASIS. SALUD X CTA ASSISTIME;GARANTIAS
26328495;;F;29;VENEZOLANO;;Extranjero;CONCEPCION                    ;BIO BIO;0;0;0;0;0;0;0;0;0;ASIS. SALUD X CTA ASSISTIME;GARANTIAS
7174548;;M;66;CHILENO;;Boomers;VALDIVIA                      ;LOS RIOS;0;0;0;0;0;0;0;0;0;ASIS. SALUD X CTA ASSISTIME;GARANTIAS
16820157;;M;34;CHILENO;;Millenial;N/D;N/D;0;0;0;0;0;0;0;0;0;ASIS. SALUD X CTA ASSISTIME;GARANTIAS
9808571;;M;59;CHILENO;;Boomers;N/D;N/D;0;0;0;0;0;0;0;0;0;ASIS. SALUD X CTA ASSISTIME;GARANTIAS
10211174;;F;58;CHILENO;;Boomers;PELLUHUE                      ;MAULE;0;0;0;0;0;0;0;0;0;ASIS. SALUD X CTA ASSISTIME;GARANTIAS
8077705;;F;64;CHILENO;;Boomers;AISEN                         ;AYSEN;0;0;0;0;0;0;0;0;0;ASIS. SALUD X CTA ASSISTIME;GARANTIAS
14201165;;F;42;CHILENO;;X;N/D;N/D;0;0;0;0;0;0;0;0;0;ASIS. SALUD X CTA ASSISTIME;GARANTIAS
19111256;;M;26;CHILENO;;Z;PENCO                         ;BIO BIO;0;0;0;0;0;0;0;0;0;ASIS. SALUD X CTA ASSISTIME;GARANTIAS
7468085;;M;68;CHILENO;;Boomers;TEMUCO                        ;ARAUCANIA;0;0;0;0;0;0;0;0;0;GM 1A X CTA SBI;GARANTIAS
26694633;;M;43;EXTRANJERO - NO INFORMA NACIONALIDAD;;Extranjero;N/D;N/D;0;0;0;0;0;0;0;0;0;ASIS. SALUD X CTA ASSISTIME;GARANTIAS
6435982;;F;72;CHILENO;;Silencioso;CERRO NAVIA                   ;METROPOLITANA;0;0;0;0;0;0;0;0;0;ASIS. SALUD X CTA ASSISTIME;GARANTIAS
26906581;;M;28;EXTRANJERO - NO INFORMA NACIONALIDAD;;Extranjero;N/D;N/D;0;0;0;0;0;0;0;0;0;ASIS. SALUD X CTA ASSISTIME;GARANTIAS
9161981;;M;59;CHILENO;;Boomers;MAULE                         ;MAULE;0;0;0;0;0;0;0;0;0;ASIS. SALUD X CTA ASSISTIME;GARANTIAS
14082552;;M;41;CHILENO;;X;N/D;N/D;0;0;0;0;0;0;0;0;0;ASIS. SALUD X CTA ASSISTIME;GARANTIAS
12952366;;F;46;CHILENO;;X;LLAILLAY                      ;VALPARAISO;0;0;0;0;0;0;0;0;0;ASIS. SALUD X CTA ASSISTIME;GARANTIAS
16035433;;F;36;CHILENO;;Millenial;COIHUECO                      ;BIO BIO;0;0;0;0;0;0;0;0;0;ASIS. SALUD X CTA ASSISTIME;GARANTIAS
12999874;;F;46;CHILENO;;X;PUERTO MONTT                  ;LOS LAGOS;0;0;0;0;0;0;0;0;0;ASIS. SALUD X CTA ASSISTIME;GARANTIAS
8095703;;M;58;CHILENO;;Boomers;ANCUD                         ;LOS LAGOS;0;0;0;0;0;0;0;0;0;ASIS. SALUD X CTA ASSISTIME;GARANTIAS
13212919;;M;44;CHILENO;;X;N/D;N/D;0;0;0;0;0;0;0;0;0;ASIS. SALUD X CTA ASSISTIME;GARANTIAS
14021780;;M;41;CHILENO;;X;CONSTITUCION                  ;MAULE;0;0;0;0;0;0;0;0;0;ASIST. FULL HOGAR X CTA MOK;GARANTIAS
6674989;;M;72;CHILENO;;Silencioso;SAN ANTONIO                   ;VALPARAISO;0;0;0;0;0;0;0;0;0;ASIS. SALUD X CTA ASSISTIME;GARANTIAS
12305320;;M;50;CHILENO;;X;N/D;N/D;0;0;0;0;0;0;0;0;0;ASIS. SALUD X CTA ASSISTIME;GARANTIAS
16138993;;M;36;CHILENO;;Millenial;SAN PEDRO DE LA PAZ           ;BIO BIO;0;0;0;0;0;0;0;0;0;ASIS. SALUD X CTA ASSISTIME;GARANTIAS
11770128;;M;51;CHILENO;;X;PUENTE ALTO                   ;METROPOLITANA;0;0;0;0;0;0;0;0;0;ASIS. SALUD X CTA ASSISTIME;GARANTIAS
18672185;;M;28;CHILENO;;Millenial;N/D;N/D;0;0;0;0;0;0;0;0;0;ASIS. SALUD X CTA ASSISTIME;GARANTIAS
7210512;;F;68;CHILENO;;Boomers;VICUNA                        ;COQUIMBO;0;0;0;0;0;0;0;0;0;ASIS. SALUD X CTA ASSISTIME;GARANTIAS
8210903;;M;62;CHILENO;;Boomers;RENCA                         ;METROPOLITANA;0;0;0;0;0;0;0;0;0;ASIS. SALUD X CTA ASSISTIME;GARANTIAS
10139730;;M;58;CHILENO;;Boomers;LO PRADO                      ;METROPOLITANA;0;0;0;0;0;0;0;0;0;GM 1A X CTA SBI;GARANTIAS
7009589;;F;70;CHILENO;;Silencioso;SAN ANTONIO                   ;VALPARAISO;0;0;0;0;0;0;0;0;0;ASIS. SALUD X CTA ASSISTIME;GARANTIAS
7486604;;F;65;CHILENO;;Boomers;PUNTA ARENAS                  ;MAGALLANES;0;0;0;0;0;0;0;0;0;ASIS. SALUD X CTA ASSISTIME;GARANTIAS
5990007;;F;76;CHILENO;;Silencioso;HIJUELAS                      ;VALPARAISO;0;0;0;0;0;0;0;0;0;ASIS. SALUD X CTA ASSISTIME;GARANTIAS
19742738;;F;24;CHILENO;;Z;N/D;N/D;0;0;0;0;0;0;0;0;0;ASIS. SALUD X CTA ASSISTIME;GARANTIAS
15076681;;M;24;CHILENO;;Z;N/D;N/D;0;0;0;0;0;0;0;0;0;ASIS. SALUD X CTA ASSISTIME;GARANTIAS
7930802;;M;63;CHILENO;;Boomers;N/D;N/D;0;0;0;0;0;0;0;0;0;ASIS. SALUD X CTA ASSISTIME;GARANTIAS
7451662;;M;66;CHILENO;;Boomers;CALAMA                        ;ANTOFAGASTA;0;0;0;0;0;0;0;0;0;ASIS. SALUD X CTA ASSISTIME;GARANTIAS
13371325;;M;51;CHILENO;;X;N/D;N/D;0;0;0;0;0;0;0;0;0;ASIS. SALUD X CTA ASSISTIME;GARANTIAS
22117228;;F;46;ARGENTINO;;Extranjero;CALAMA                        ;ANTOFAGASTA;0;0;0;0;0;0;0;0;0;GM 1A X CTA SBI;GARANTIAS
10584963;;F;57;CHILENO;;Boomers;NUEVA IMPERIAL                ;ARAUCANIA;0;0;0;0;0;0;0;0;0;ASIS. SALUD X CTA ASSISTIME;GARANTIAS
7737085;Casado;F;66;CHILENO;;Boomers;RENCA                         ;METROPOLITANA;0;0;0;0;0;0;0;0;0;TARIFA NORMAL;GARANTIAS
19553805;;M;25;CHILENO;;Z;N/D;N/D;0;0;0;0;0;0;0;0;0;ASIS. SALUD X CTA ASSISTIME;GARANTIAS
8187431;;F;60;CHILENO;;Boomers;ARICA                         ;ARICA Y PARINACOTA;963140;6;3;0;0;0;6;3;963140;CELULAR GALAXY A33 5G 6+128GB ORANGE OPEN;TELEFONIA
9791871;;F;57;CHILENO;;Boomers;NUEVA IMPERIAL                ;ARAUCANIA;1178199;7;5;0;0;0;7;5;1178199;CELULAR GALAXY A22 5G 4+128GB WHITE;TELEFONIA
13490175;;M;43;CHILENO;;X;PROVIDENCIA                   ;METROPOLITANA;329980;2;2;2;2;329980;0;0;0;CELULAR GALAXY A33 5G 6+128GB LIGHT BLUE OPEN;TELEFONIA
7186338;;M;74;CHILENO;;Z;ANGOL                         ;ARAUCANIA;480870;4;2;0;0;0;4;2;480870;CELULAR REDMI 10A US 32GB CHROME SILVER OPEN;TELEFONIA
16514754;;F;35;CHILENO;;Millenial;CORONEL                       ;BIO BIO;244980;4;2;0;0;0;4;2;244980;CELULAR GALAXY A13 4+128GB WHITE OPEN;TELEFONIA
6531391;Soltero;M;70;CHILENO;;Silencioso;CHONCHI                       ;LOS LAGOS;225010;2;3;0;0;0;2;3;225010;CELULAR VIVO Y21S MIDNIGHT BLUE 128 GB OPEN;TELEFONIA
13389774;;M;44;CHILENO;;X;LOS ALAMOS                    ;BIO BIO;496609;6;2;0;0;0;6;2;496609;CELULAR GALAXY A03 4+64GB BLACK OPEN;TELEFONIA
10578913;;M;57;CHILENO;;Boomers;RENCA                         ;METROPOLITANA;119990;1;1;0;0;0;1;1;119990;CELULAR GALAXY A03 4+64GB BLACK OPEN;TELEFONIA
7490205;Casado;M;68;CHILENO;;Boomers;NACIMIENTO                    ;BIO BIO;109990;1;1;0;0;0;1;1;109990;CELULAR MOTOROLA E30 GRIS CLARO;TELEFONIA
11983491;;F;50;CHILENO;;X;CONSTITUCION                  ;MAULE;113970;3;3;0;0;0;3;3;113970;CELULAR GALAXY A03 4+64GB BLACK OPEN;TELEFONIA
14026309;;M;41;CHILENO;;X;CHILLAN;BIO-BIO;390900;3;2;0;0;0;3;2;390900;CELULAR GALAXY A23 6+128GB BLACK OPEN;TELEFONIA
26125206;;M;28;COLOMBIANO;;Millenial;N/D;N/D;279990;1;1;0;0;0;1;1;279990;CELULAR XIAOMI 11 LITE 5G NE 6/128GB TRUFFLE BLA;TELEFONIA
16382085;;F;36;CHILENO;;Millenial;PROVIDENCIA                   ;METROPOLITANA;203980;2;1;2;1;203980;0;0;0;CELULAR MOTO G60 4/128 GB NEGRO OPEN;TELEFONIA
11853907;;M;50;CHILENO;;Extranjero;N/D;N/D;174980;2;1;2;1;174980;0;0;0;CELULAR REDMI NOTE 10 5G 128GB CHROME SILVER OPE;TELEFONIA
9298712;;M;60;CHILENO;;Boomers;CONCHALI                      ;METROPOLITANA;359970;5;3;0;0;0;5;3;359970;CELULAR GALAXY A13 4+128GB LIGHT BLUE OPEN;TELEFONIA
17882651;Soltero;F;30;CHILENO;;Millenial;PROVIDENCIA                   ;METROPOLITANA;149990;1;1;1;1;149990;0;0;0;CELULAR REDMI 10C 128GB GRAPHITE GRAY CLARO;TELEFONIA
17131667;;F;33;CHILENO;;Millenial;NIQUEN                        ;BIO BIO;373261;7;4;0;0;0;7;4;373261;CELULAR GALAXY A03 CORE 2GB 32GB BLUE OPEN;TELEFONIA
15675758;Soltero;F;38;CHILENO;;X;RENCA                         ;METROPOLITANA;39990;1;1;0;0;0;1;1;39990;CELULAR ALCATEL P1 3080 BLACK MOVISTAR DIRECTO;TELEFONIA
7969584;;M;62;CHILENO;;Boomers;CANETE                        ;BIO BIO;678950;5;4;0;0;0;5;4;678950;CELULAR GALAXY A33 5G 6+128GB ORANGE OPEN;TELEFONIA
19719479;;F;25;CHILENO;;Z;ANGOL                         ;ARAUCANIA;449990;1;1;0;0;0;1;1;449990;CELULAR GALAXY A73 5G 128GB LIGHT GREEN OPEN;TELEFONIA
11967609;;F;49;CHILENO;;X;LONQUIMAY                     ;ARAUCANIA;456970;3;2;3;2;456970;0;0;0;CELULAR GALAXY A53 5G 6+128GB WHITE;TELEFONIA
13268225;;F;44;CHILENO;;X;SAN BERNARDO                  ;METROPOLITANA;314990;1;1;0;0;0;1;1;314990;CELULAR GALAXY A53 5G 6+128GB BLACK;TELEFONIA
10689673;;F;54;CHILENO;;Boomers;N/D;N/D;149990;1;1;0;0;0;1;1;149990;CELULAR GALAXY A13 4+128GB WHITE OPEN;TELEFONIA
10106855;;M;59;CHILENO;;Boomers;PENCAHUE                      ;MAULE;676950;5;2;0;0;0;5;2;676950;CELULAR BMOBILE BS30 BLACK OPEN;TELEFONIA
8126059;;M;66;CHILENO;;Boomers;TENO                          ;MAULE;803342;11;5;0;0;0;11;5;803342;CELULAR GALAXY A22 5G 4+128GB GRAY;TELEFONIA
11647450;;M;52;CHILENO;;X;RENCA                         ;METROPOLITANA;173980;2;1;2;1;173980;0;0;0;CELULAR POCO M4 PRO 128GB POWER BLACK OPEN;TELEFONIA
17866808;;F;31;CHILENO;;Millenial;CAUQUENES                     ;MAULE;241960;4;3;3;2;216970;1;1;24990;CELULAR POCO M4 PRO 128GB COOL BLUE OPEN;TELEFONIA
10930047;;F;52;CHILENO;;X;CARTAGENA                     ;VALPARAISO;159990;1;1;0;0;0;1;1;159990;CELULAR VIVO Y21S MIDNIGHT BLUE 128 GB OPEN;TELEFONIA
12758890;;F;48;CHILENO;;X;ANCUD                         ;LOS LAGOS;58980;2;2;0;0;0;2;2;58980;CELULAR BMOBILE W41 AZUL 32GB OPEN;TELEFONIA
18693560;;F;28;CHILENO;;Millenial;LA CISTERNA                   ;METROPOLITANA;79990;1;1;0;0;0;1;1;79990;CELULAR XIAOMI REDMI 9A 2/32GB GRANITE GRAY;TELEFONIA
18136041;;F;28;CHILENO;;Millenial;N/D;N/D;429980;2;2;0;0;0;2;2;429980;CELULAR VIVO Y15S WAVE GREEN OPEN;TELEFONIA
12826659;;M;46;CHILENO;;X;SAN ANTONIO                   ;VALPARAISO;119990;1;1;0;0;0;1;1;119990;CELULAR GALAXY A03 4+64GB BLACK OPEN;TELEFONIA
11600233;;M;51;CHILENO;;X;PROVIDENCIA                   ;METROPOLITANA;1623720;11;7;0;0;0;11;7;1623720;CELULAR BMOBILE W41 AZUL 32GB OPEN;TELEFONIA
16987938;;M;33;CHILENO;;Millenial;PROVIDENCIA                   ;METROPOLITANA;980;2;1;0;0;0;2;1;980;CHIP OPEN ENTEL;TELEFONIA
6840169;;F;72;CHILENO;;Silencioso;MACHALI                       ;L.G.B.OÂ´HIGGINS;1955260;22;9;0;0;0;22;9;1955260;CELULAR MOTO G22 128GB NEGRO MOVISTAR;TELEFONIA
12328936;Casado;F;49;CHILENO;;X;RENCA                         ;METROPOLITANA;189990;1;1;0;0;0;1;1;189990;CELULAR GALAXY A22 5G 4+128GB MINT;TELEFONIA
16026589;;F;37;CHILENO;;Millenial;N/D;N/D;35990;1;1;1;1;35990;0;0;0;CELULAR BMOBILE SENIORPHONE C40 GRIS WOM;TELEFONIA
10309221;;M;57;CHILENO;;Boomers;N/D;N/D;109990;2;1;0;0;0;2;1;109990;CELULAR VIVO Y01 AZUL ZAFIRO OPEN;TELEFONIA
17889809;;F;30;CHILENO;;Millenial;"";"";980;2;1;0;0;0;2;1;980;CHIP OPEN ENTEL;TELEFONIA
9473833;;F;57;CHILENO;;Boomers;PUERTO VARAS;LOS LAGOS;453510;5;2;5;2;453510;0;0;0;CELULAR GALAXY A23 6+128GB LIGHT BLUE OPEN;TELEFONIA
19220477;;F;26;CHILENO;;Z;"";"";410130;6;2;0;0;0;6;2;410130;CELULAR POCO M4 PRO 128GB COOL BLUE OPEN;TELEFONIA
17579892;;F;31;CHILENO;;Millenial;"";"";674920;8;4;6;3;301940;2;1;372980;CELULAR GALAXY A53 5G 6+128GB ORANGE;TELEFONIA
10166346;;F;56;CHILENO;;Boomers;TOME;BIO-BIO;39990;1;1;0;0;0;1;1;39990;CELULAR BMOBILE W41 AZUL 32GB OPEN;TELEFONIA
10445032;;F;55;CHILENO;;Boomers;RENCA                         ;METROPOLITANA;109990;2;1;0;0;0;2;1;109990;CELULAR VIVO Y21S MIDNIGHT BLUE 128 GB OPEN;TELEFONIA
16001857;;M;37;CHILENO;;Millenial;PROVIDENCIA                   ;METROPOLITANA;76950;8;4;0;0;0;8;4;76950;CELULAR Moto E7 Rosado WOM;TELEFONIA
13582168;;F;43;CHILENO;;X;TEMUCO                        ;ARAUCANIA;361690;4;3;0;0;0;4;3;361690;CELULAR VIVO Y01 AZUL ZAFIRO OPEN;TELEFONIA
11374893;;M;53;CHILENO;;X;BUIN                          ;METROPOLITANA;529620;4;2;0;0;0;4;2;529620;CELULAR VIVO Y01 AZUL ZAFIRO OPEN;TELEFONIA
13846800;;M;42;CHILENO;;X;PROVIDENCIA                   ;METROPOLITANA;89980;2;1;2;1;89980;0;0;0;CELULAR SAMSUNG A03 64GB NEGRO WOM;TELEFONIA
17728747;;M;31;CHILENO;;Millenial;"";"";379970;3;2;0;0;0;3;2;379970;CELULAR VIVO Y20S NEBULA 128 GB BLUE OPEN;TELEFONIA
15151896;;M;40;CHILENO;;X;YERBAS BUENAS                 ;MAULE;210050;3;1;0;0;0;3;1;210050;CELULAR GALAXY A13 4+128GB LIGHT BLUE OPEN;TELEFONIA
15749979;;F;38;CHILENO;;X;PROVIDENCIA                   ;METROPOLITANA;189990;1;1;0;0;0;1;1;189990;CELULAR VIVO Y21s 128GB AZUL CLARO;TELEFONIA
22221469;;M;47;PERUANO;;Extranjero;N/D;N/D;1380740;9;6;0;0;0;9;6;1380740;CELULAR VIVO Y53S FANTASTIC RAINBOW 128GB OPEN;TELEFONIA
18679997;;M;28;CHILENO;;Millenial;LOS ANDES;VALPARAISO;229990;2;1;0;0;0;2;1;229990;CELULAR VIVO Y53S FANTASTIC RAINBOW 128GB OPEN;TELEFONIA
10985455;;F;53;CHILENO;;X;CORONEL                       ;BIO BIO;289990;1;1;1;1;289990;0;0;0;CELULAR GALAXY A53 5G BLACK CLARO;TELEFONIA
9557349;;F;62;CHILENO;;Boomers;RANCAGUA                      ;L.G.B.OÂ´HIGGINS;177960;4;3;0;0;0;4;3;177960;CELULAR MOTO G22 128GB NEGRO WOM;TELEFONIA
12435970;;F;49;CHILENO;;X;RENCA                         ;METROPOLITANA;99990;1;1;0;0;0;1;1;99990;CELULAR REDMI 9A 32GB AURORA GREEN OPEN;TELEFONIA
10317436;;F;57;CHILENO;;Boomers;"";"";683940;6;5;2;1;239980;4;4;443960;CELULAR GALAXY A23 6+128GB LIGHT BLUE OPEN;TELEFONIA
10894963;;M;54;CHILENO;;X;ZAPALLAR                      ;VALPARAISO;600940;10;3;0;0;0;10;3;600940;CELULAR VIVO Y21S 128GB BLANCO WOM;TELEFONIA
13608310;;M;43;CHILENO;;X;MELIPEUCO                     ;ARAUCANIA;166800;2;1;0;0;0;2;1;166800;CELULAR GALAXY A03 64GB RED OPEN;TELEFONIA
12207391;Casado;M;49;CHILENO;;X;RENCA                         ;METROPOLITANA;126980;2;1;2;1;126980;0;0;0;CELULAR MOTO ONE FUSION 128GB AZUL OPEN;TELEFONIA
4807318;;M;77;CHILENO;;Silencioso;RENCA                         ;METROPOLITANA;84980;2;2;0;0;0;2;2;84980;Celular SA3 CLARO DIRECTO BLACK;TELEFONIA
10814026;;M;55;CHILENO;;Boomers;COQUIMBO                      ;COQUIMBO;9990;1;1;0;0;0;1;1;9990;Mi Router 4A Giga Version Xiaomi;TELEFONIA
11180854;;M;54;CHILENO;;Boomers;CALERA                        ;VALPARAISO;179990;1;1;0;0;0;1;1;179990;CELULAR SAMSUNG A23 128GB BLACK CLARO;TELEFONIA
25955212;;M;60;ECUATORIANO;;Extranjero;RENGO                         ;L.G.B.OÂ´HIGGINS;1625910;11;6;0;0;0;11;6;1625910;IPHONE 11 64GB BLACK CLARO;TELEFONIA
20613961;;M;21;CHILENO;;Z;PROVIDENCIA                   ;METROPOLITANA;317960;4;2;4;2;317960;0;0;0;CELULAR MOTOROLA G9 PLAY 64GB ELECTRIC BLUE OPEN;TELEFONIA
13771418;;M;41;CHILENO;;X;TALAGANTE                     ;METROPOLITANA;2298240;13;7;0;0;0;13;7;2298240;CELULAR REDMI 9A 32GB AURORA GREEN OPEN;TELEFONIA
12842309;;M;46;CHILENO;;Millenial;"";"";139990;2;1;0;0;0;2;1;139990;CELULAR VIVO Y53S FANTASTIC AZUL WOM;TELEFONIA
9365970;;F;60;CHILENO;;Boomers;CHANCO                        ;MAULE;646440;6;4;0;0;0;6;4;646440;CELULAR GALAXY A03 4+64GB BLUE OPEN;TELEFONIA
7602325;;F;65;CHILENO;;Boomers;VILLA ALEMANA                 ;VALPARAISO;399170;5;5;0;0;0;5;5;399170;CELULAR REDMI NOTE 10 5G 128GB CHROME SILVER OPE;TELEFONIA
18595516;;F;29;CHILENO;;Millenial;N/D;N/D;505390;13;6;9;5;461910;4;1;43480;CELULAR GALAXY A13 4+128GB WHITE OPEN;TELEFONIA
19333595;;F;26;CHILENO;;Z;N/D;N/D;322980;4;3;0;0;0;4;3;322980;CELULAR REDMI NOTE 11 PRO 128GB WHITE;TELEFONIA
10466084;Soltero;M;50;CHILENO;AGROINDUSTRIA;X;RENCA                         ;METROPOLITANA;59990;2;1;0;0;0;2;1;59990;CELULAR REDMI 9A 32GB AURORA GREEN OPEN;TELEFONIA
10160352;;F;58;CHILENO;;Boomers;PUENTE ALTO                   ;METROPOLITANA;164980;3;3;0;0;0;3;3;164980;CELULAR MOTO G22 128GB NEGRO MOVISTAR;TELEFONIA
6685248;;F;70;CHILENO;;Silencioso;SALAMANCA                     ;COQUIMBO;546540;5;3;0;0;0;5;3;546540;CELULAR GALAXY A23 6+128GB LIGHT BLUE OPEN;TELEFONIA
6507351;;F;74;CHILENO;;Silencioso;VINA DEL MAR                  ;VALPARAISO;878630;13;9;0;0;0;13;9;878630;CELULAR GALAXY A03 128GB BLACK CLARO;TELEFONIA
8562700;;M;60;CHILENO;;Boomers;RENCA                         ;METROPOLITANA;89990;1;1;0;0;0;1;1;89990;CELULAR REDMI 9A 32GB AURORA GREEN OPEN;TELEFONIA
17856480;;M;30;CHILENO;;Millenial;N/D;N/D;200083;2;2;0;0;0;2;2;200083;CELULAR REDMI 10C 128GB GRAPHITE GRAY CLARO;TELEFONIA
9710568;;F;59;CHILENO;;Boomers;"";"";1095980;10;5;0;0;0;10;5;1095980;CELULAR REDMI 9A 32GB AURORA GREEN OPEN;TELEFONIA
15203541;;F;40;CHILENO;;X;PROVIDENCIA                   ;METROPOLITANA;109990;1;1;0;0;0;1;1;109990;CELULAR GALAXY A03 4+64GB BLACK OPEN;TELEFONIA
20753655;;F;21;CHILENO;;Z;PROVIDENCIA                   ;METROPOLITANA;149990;1;1;0;0;0;1;1;149990;CELULAR VIVO Y20S NEBULA 128 GB BLUE OPEN;TELEFONIA
16035073;;M;36;CHILENO;;Millenial;QUILPUE                       ;VALPARAISO;299980;2;2;0;0;0;2;2;299980;CELULAR VIVO Y11S 32GB NEBULA BLUE OPEN;TELEFONIA
12734583;;F;47;CHILENO;;X;CANETE                        ;BIO BIO;1410800;10;7;0;0;0;10;7;1410800;CELULAR GALAXY A13 4+128GB WHITE OPEN;TELEFONIA
25815546;;F;37;COLOMBIANO;;Extranjero;TOCOPILLA                     ;ANTOFAGASTA;447744;5;3;0;0;0;5;3;447744;CELULAR REDMI NOTE 11 4/128GB TWILIGHT BLUE OPEN;TELEFONIA
15298734;;F;40;CHILENO;;X;CASTRO                        ;LOS LAGOS;909950;6;4;0;0;0;6;4;909950;CELULAR VIVO Y21S PEARL WHITE 128 GB OPEN;TELEFONIA
6578066;;M;71;CHILENO;;Silencioso;N/D;N/D;608600;3;3;0;0;0;3;3;608600;IPHONE XR 128GB ROJO REAC;TELEFONIA
26842250;;M;29;HAITIANO;;Extranjero;N/D;N/D;459250;10;6;0;0;0;10;6;459250;CELULAR SAMSUNG A23 128GB BLACK CLARO;TELEFONIA
5290922;;M;78;CHILENO;;Silencioso;RENCA                         ;METROPOLITANA;79990;1;1;0;0;0;1;1;79990;CELULAR SAMSUNG A03 CORE 32GB BLACK CLARO;TELEFONIA
10434226;Casado;M;56;CHILENO;CONTADOR GENERAL;Boomers;RENCA                         ;METROPOLITANA;0;0;2;0;0;0;0;2;0;CELULAR MOTOROLA G20 EDICION ESPECIAL VERDE CLAR;TELEFONIA
12962609;;F;46;CHILENO;;X;LINARES                       ;MAULE;2468011;16;9;0;0;0;16;9;2468011;CELULAR IPHONE 12 64GB BLACK CLARO;TELEFONIA
18214303;Casado;M;30;CHILENO;PROFESOR;Millenial;PROVIDENCIA                   ;METROPOLITANA;69990;2;1;0;0;0;2;1;69990;CELULAR VIVO Y21S MIDNIGHT BLUE 128 GB OPEN;TELEFONIA
10760609;;F;57;CHILENO;;Boomers;OVALLE                        ;COQUIMBO;396330;5;2;0;0;0;5;2;396330;CELULAR GALAXY A23 6+128GB LIGHT BLUE OPEN;TELEFONIA
9077271;;M;62;CHILENO;;Boomers;SANTIAGO                      ;METROPOLITANA;259980;3;2;0;0;0;3;2;259980;CELULAR REDMI NOTE 10 5G 4/128GB GRAPHITE GRAY O;TELEFONIA
17330255;;M;33;CHILENO;;Millenial;ALTO DEL CARMEN               ;ATACAMA;189990;1;1;0;0;0;1;1;189990;CELULAR REDMI NOTE 11 4/128GB GRAPHITE GRAY OPEN;TELEFONIA
17462861;;M;32;CHILENO;;Millenial;PROVIDENCIA                   ;METROPOLITANA;439990;2;1;0;0;0;2;1;439990;CELULAR GALAXY A73 5G 256GB LIGHT GREEN OPEN;TELEFONIA
24756875;;F;46;BOLIVIANO;;Extranjero;CALAMA                        ;ANTOFAGASTA;602950;6;7;0;0;0;6;7;602950;CELULAR GALAXY A22 5G 4+128GB MINT;TELEFONIA
14333032;Casado;M;45;CHILENO;;X;RENCA                         ;METROPOLITANA;520990;4;2;0;0;0;4;2;520990;CELULAR SAMSUNG A23 128GB BLACK CLARO;TELEFONIA
18587752;;F;28;CHILENO;;Millenial;PUREN                         ;ARAUCANIA;178980;2;1;2;1;178980;0;0;0;Celular P40 LITE LIB OPEN GREEN;TELEFONIA
17801510;;F;32;CHILENO;;Millenial;TEMUCO;ARAUCANIA;631940;6;5;6;5;631940;0;0;0;CELULAR GALAXY A03 4+128GB BLACK OPEN;TELEFONIA
22706826;;M;34;ECUATORIANO;;Extranjero;VICTORIA                      ;ARAUCANIA;205010;2;3;0;0;0;2;3;205010;SMARTPHONE A22 VERDE 128GB;TELEFONIA
15923688;;M;37;CHILENO;;Millenial;ILLAPEL                       ;COQUIMBO;434980;2;2;0;0;0;2;2;434980;CELULAR GALAXY A13 4+128GB WHITE OPEN;TELEFONIA
15284196;;F;40;CHILENO;;X;N/D;N/D;980;2;1;0;0;0;2;1;980;CHIP OPEN ENTEL;TELEFONIA
9223458;;F;61;CHILENO;;Boomers;LINARES                       ;MAULE;384090;3;2;0;0;0;3;2;384090;CELULAR SAMSUNG A52s 128GB BLACK CLARO;TELEFONIA
13189908;;F;45;CHILENO;;X;QUILPUE                       ;VALPARAISO;1920350;21;6;6;3;720940;15;3;1199410;CELULAR GALAXY A53 5G 6+128GB WHITE;TELEFONIA
8803844;;M;63;CHILENO;;Boomers;MAULE                         ;MAULE;815230;7;3;0;0;0;7;3;815230;CELULAR GALAXY A13 4+128GB WHITE OPEN;TELEFONIA
8108476;;F;64;CHILENO;;Boomers;PROVIDENCIA                   ;METROPOLITANA;16990;3;1;0;0;0;3;1;16990;CELULAR BMOBILE C40 CRIS OPEN;TELEFONIA
18292942;Soltero;F;30;CHILENO;PROFESOR;Millenial;PROVIDENCIA                   ;METROPOLITANA;138810;2;1;0;0;0;2;1;138810;CELULAR SAMSUNG A03 64GB NEGRO WOM;TELEFONIA
12815538;;F;47;CHILENO;;X;SAN FELIPE                    ;VALPARAISO;259990;1;1;0;0;0;1;1;259990;CELULAR SAMSUNG A52s 128GB BLACK CLARO;TELEFONIA
15669300;Soltero;M;38;CHILENO;;Millenial;PROVIDENCIA                   ;METROPOLITANA;186240;2;1;0;0;0;2;1;186240;CELULAR GALAXY A13 4+128GB BLACK;TELEFONIA
14489407;;M;45;CHILENO;;X;PEUMO                         ;L.G.B.OÂ´HIGGINS;130470;4;2;0;0;0;4;2;130470;CELULAR GALAXY A03 4+64GB BLACK OPEN;TELEFONIA
10082655;;M;56;CHILENO;;Boomers;COLBUN                        ;MAULE;148810;2;1;0;0;0;2;1;148810;CELULAR REDMI 9C 64GB MIDNIGHT GRAY MOVISTAR;TELEFONIA
5154413;;M;79;CHILENO;;Silencioso;VILLARRICA;ARAUCANIA;93980;2;1;2;1;93980;0;0;0;CELULAR SAMSUNG GALAXY A03 CORE AZUL WOM;TELEFONIA
15850868;;M;38;CHILENO;;Millenial;COIHAIQUE                     ;AYSEN;109990;2;1;0;0;0;2;1;109990;CELULAR GALAXY A22 5G 4+128GB GRAY;TELEFONIA
18368427;;F;29;CHILENO;;Millenial;N/D;N/D;277970;3;3;2;2;249980;1;1;27990;CELULAR GALAXY A03 4+64GB BLACK OPEN;TELEFONIA
18629218;;F;28;CHILENO;;Millenial;N/D;N/D;254980;2;1;0;0;0;2;1;254980;CELULAR A52 128 GB BLUE OPEN;TELEFONIA
9801433;;F;59;CHILENO;;Boomers;"";"";109990;1;1;0;0;0;1;1;109990;CELULAR VIVO Y01 AZUL ZAFIRO OPEN;TELEFONIA
26436349;;M;25;EXTRANJERO - NO INFORMA NACIONALIDAD;;Extranjero;"";"";448590;8;5;1;1;209990;7;4;238600;CELULAR SAMSUNG GALAXY A03 CORE 32GB NEGRO WOM;TELEFONIA
16143106;;M;36;CHILENO;;Millenial;PROVIDENCIA                   ;METROPOLITANA;16980;2;1;2;1;16980;0;0;0;Mi Router 4A Giga Version Xiaomi;TELEFONIA
15748077;;M;38;CHILENO;;Millenial;MELIPILLA;METROPOLITANA;109990;1;1;0;0;0;1;1;109990;CELULAR Moto G20 Blue WOM;TELEFONIA
11778271;;F;51;CHILENO;;X;CURANILAHUE                   ;BIO BIO;189990;1;1;0;0;0;1;1;189990;CELULAR VIVO Y21s 128GB AZUL CLARO;TELEFONIA
19458309;;F;25;CHILENO;;Z;OVALLE                        ;COQUIMBO;252980;2;2;0;0;0;2;2;252980;CELULAR VIVO Y53S FANTASTIC RAINBOW 128GB OPEN;TELEFONIA
14458153;;M;50;CHILENO;;X;SALAMANCA                     ;COQUIMBO;286230;3;2;0;0;0;3;2;286230;CELULAR GALAXY A13 4+128GB BLACK;TELEFONIA
18965993;;F;26;CHILENO;;Z;CHANCO                        ;MAULE;119875;3;5;0;0;0;3;5;119875;CELULAR GALAXY A03 CORE 2GB 32GB BLUE OPEN;TELEFONIA
13940213;;M;42;CHILENO;;X;EL TABO                       ;VALPARAISO;150480;2;1;0;0;0;2;1;150480;CELULAR VIVO Y21S 128GB BLANCO WOM;TELEFONIA
16631057;;F;34;CHILENO;;Millenial;PUNTA ARENAS                  ;MAGALLANES;339980;2;2;2;2;339980;0;0;0;CELULAR MOTOROLA G50 128GB AZUL CLARO;TELEFONIA
8403566;;F;51;CHILENO;;X;REQUINOA                      ;L.G.B.OÂ´HIGGINS;295970;3;2;2;1;165980;1;1;129990;CELULAR MOTO G60 4/128 GB SILVER OPEN;TELEFONIA
7027180;;M;70;CHILENO;;Silencioso;LOTA                          ;BIO BIO;89990;1;1;0;0;0;1;1;89990;CELULAR REDMI 9C 64GB SUNRISE ORANGE;TELEFONIA
6680571;;F;69;CHILENO;;Silencioso;N/D;N/D;1015930;7;4;6;3;996940;1;1;18990;CELULAR GALAXY A23 6+128GB LIGHT BLUE OPEN;TELEFONIA
14531703;;F;48;CHILENO;;X;CHIMBARONGO                   ;L.G.B.OÂ´HIGGINS;176240;2;1;0;0;0;2;1;176240;CELULAR GALAXY A03 4+128GB BLUE OPEN;TELEFONIA
19026787;Soltero;F;27;CHILENO;;Z;PROVIDENCIA                   ;METROPOLITANA;163980;2;1;2;1;163980;0;0;0;CELULAR A32 128 GB BLACK OPEN;TELEFONIA
26844407;;F;29;EXTRANJERO - NO INFORMA NACIONALIDAD;;Extranjero;PROVIDENCIA                   ;METROPOLITANA;394960;4;2;4;2;394960;0;0;0;CELULAR SAMSUNG A52s 128GB BLACK CLARO;TELEFONIA
6757312;;F;68;CHILENO;;Silencioso;RENCA                         ;METROPOLITANA;194980;3;2;0;0;0;3;2;194980;CELULAR SAMSUNG A03 128GB BLACK CLARO;TELEFONIA
19232014;;F;26;CHILENO;;Z;N/D;N/D;429970;4;3;2;2;349980;2;1;79990;CELULAR GALAXY A03 CORE 2GB 32GB BLUE OPEN;TELEFONIA
19700292;;F;24;CHILENO;;Z;"";"";980;2;1;0;0;0;2;1;980;CHIP PREPAGO OPEN WOM;TELEFONIA
15871758;;M;38;CHILENO;;Millenial;CARTAGENA                     ;VALPARAISO;174960;4;2;4;2;174960;0;0;0;CELULAR REDMI 10A US 32GB CHROME SILVER OPEN;TELEFONIA
14282417;;M;47;CHILENO;;X;VALDIVIA                      ;LOS LAGOS;189990;1;1;0;0;0;1;1;189990;CELULAR VIVO Y21s 128GB AZUL CLARO;TELEFONIA
15303103;;F;39;CHILENO;;X;PROVIDENCIA                   ;METROPOLITANA;75980;3;1;0;0;0;3;1;75980;CELULAR GALAXY A13 4+128GB LIGHT BLUE OPEN;TELEFONIA
9498763;;M;46;CHILENO;;X;MAIPU                         ;METROPOLITANA;149990;1;1;0;0;0;1;1;149990;CELULAR GALAXY A22 5G 4+128GB GRAY;TELEFONIA
20011184;;F;24;CHILENO;;Z;N/D;N/D;129990;1;1;0;0;0;1;1;129990;CELULAR GALAXY A13 4+128GB LIGHT BLUE OPEN;TELEFONIA
25875496;Soltero;M;37;HAITIANO;;Extranjero;PROVIDENCIA                   ;METROPOLITANA;170140;2;1;0;0;0;2;1;170140;CELULAR GALAXY A22 5G 4+128GB GRAY;TELEFONIA
7840627;;M;49;CHILENO;;X;LO BARNECHEA;METROPOLITANA;347960;3;1;3;1;347960;0;0;0;CELULAR GALAXY A53 5G 6+128GB WHITE;TELEFONIA
24741717;Soltero;M;43;CUBANO;;Extranjero;PROVIDENCIA                   ;METROPOLITANA;163970;3;1;3;1;163970;0;0;0;CELULAR GALAXY A03 CORE 2GB 32GB BLUE OPEN;TELEFONIA
11825692;;M;51;CHILENO;;X;LIMACHE                       ;VALPARAISO;1406860;14;10;0;0;0;14;10;1406860;CELULAR GALAXY A53 5G 6+128GB WHITE;TELEFONIA
7095071;;F;73;CHILENO;;Extranjero;COLINA                        ;METROPOLITANA;69990;1;1;0;0;0;1;1;69990;CELULAR BMOBILE AX1076 PRO BUNDLE;TELEFONIA
15133966;;M;40;CHILENO;;X;PELARCO                       ;MAULE;159990;1;1;0;0;0;1;1;159990;CELULAR GALAXY A13 4+128GB LIGHT BLUE OPEN;TELEFONIA
9271282;;M;60;CHILENO;;Boomers;PAINE                         ;METROPOLITANA;908940;7;4;0;0;0;7;4;908940;CELULAR GALAXY A13 4+128GB WHITE OPEN;TELEFONIA
18368316;;F;29;CHILENO;;Millenial;VILLARICA                     ;ARAUCANIA;426220;4;3;0;0;0;4;3;426220;CELULAR VIVO Y01 AZUL ZAFIRO OPEN;TELEFONIA
17310760;;F;32;CHILENO;;Millenial;PROVIDENCIA                   ;METROPOLITANA;159990;1;1;1;1;159990;0;0;0;CELULAR A32 128 GB BLUE OPEN;TELEFONIA
9060065;;M;61;CHILENO;;Boomers;PANGUIPULLI                   ;LOS RIOS;159990;1;1;0;0;0;1;1;159990;CELULAR GALAXY A23 6+128GB BLACK OPEN;TELEFONIA
17297464;;F;33;CHILENO;;Extranjero;PUERTO MONTT                  ;LOS LAGOS;69990;3;1;0;0;0;3;1;69990;CELULAR AZUMI V60 DUAL OPEN;TELEFONIA
8673208;;M;61;CHILENO;;Boomers;COPIAPO                       ;ATACAMA;233220;6;3;0;0;0;6;3;233220;CELULAR VIVO Y01 AZUL ZAFIRO OPEN;TELEFONIA
19503802;;M;25;CHILENO;;Z;N/D;N/D;143536;3;1;0;0;0;3;1;143536;CELULAR VIVO Y15S WAVE GREEN OPEN;TELEFONIA
10390243;;F;54;CHILENO;;Boomers;VALLENAR;ATACAMA;114980;2;2;0;0;0;2;2;114980;CELULAR A02 NEGRO 32GB OPEN;TELEFONIA
10404156;;M;45;CHILENO;;Silencioso;PROVIDENCIA                   ;METROPOLITANA;139980;4;2;0;0;0;4;2;139980;CELULAR GALAXY A13 4+128GB LIGHT BLUE OPEN;TELEFONIA
12599375;;M;47;CHILENO;;X;COLINA                        ;METROPOLITANA;336970;3;2;0;0;0;3;2;336970;CELULAR GALAXY A13 4+128GB LIGHT BLUE OPEN;TELEFONIA
8620212;;F;61;CHILENO;;Boomers;ANCUD                         ;LOS LAGOS;128810;2;1;0;0;0;2;1;128810;CELULAR XIAOMI REDMI 9A 2/32GB GRANITE GRAY;TELEFONIA
5972698;;M;77;CHILENO;;Silencioso;RENCA                         ;METROPOLITANA;36990;1;1;0;0;0;1;1;36990;CELULAR BMOBILE BS30 BLACK OPEN;TELEFONIA
19874185;;F;24;CHILENO;;Z;PROVIDENCIA                   ;METROPOLITANA;159990;1;1;1;1;159990;0;0;0;CELULAR A32 128 GB BLUE OPEN;TELEFONIA
15869206;;M;37;CHILENO;;Millenial;PENALOLEN                     ;METROPOLITANA;133980;2;1;2;1;133980;0;0;0;CELULAR MOTO G20 EDICION ESPECIAL 4/128 GB AZUL;TELEFONIA
11979638;;F;50;CHILENO;;X;PAINE                         ;METROPOLITANA;773950;6;4;2;1;153980;4;3;619970;CELULAR GALAXY A33 5G 6+128GB LIGHT BLUE OPEN;TELEFONIA
18889087;;M;26;CHILENO;;Z;N/D;N/D;347720;5;2;0;0;0;5;2;347720;CELULAR REDMI NOTE 11 4/128GB TWILIGHT BLUE OPEN;TELEFONIA
19284108;Soltero;M;26;CHILENO;;Extranjero;PROVIDENCIA                   ;METROPOLITANA;173980;2;1;2;1;173980;0;0;0;CELULAR HUAWEI Y9A BLACK OPEN;TELEFONIA
7800808;;F;71;CHILENO;;Silencioso;PAIGUANO                      ;COQUIMBO;89990;1;1;0;0;0;1;1;89990;CELULAR Moto E7 Rosado WOM;TELEFONIA
6435246;Casado;M;72;CHILENO;;Silencioso;PROVIDENCIA                   ;METROPOLITANA;34990;1;1;0;0;0;1;1;34990;Celular SA3 CLARO DIRECTO BLACK;TELEFONIA
6753119;;M;69;CHILENO;;Silencioso;TOCOPILLA                     ;ANTOFAGASTA;224980;2;2;0;0;0;2;2;224980;CELULAR SAMSUNG A03 64GB NEGRO WOM;TELEFONIA
25795767;;M;63;EXTRANJERO - NO INFORMA NACIONALIDAD;;Extranjero;"";"";573501;6;5;1;1;179990;5;4;393511;CELULAR GALAXY A13 4+128GB WHITE OPEN;TELEFONIA
13277382;;M;45;CHILENO;;X;PROVIDENCIA                   ;METROPOLITANA;89990;1;1;0;0;0;1;1;89990;CELULAR GALAXY A03 CORE 2GB 32GB BLACK OPEN;TELEFONIA
10264991;;F;55;CHILENO;;Boomers;SAN CARLOS                    ;BIO BIO;612900;9;4;0;0;0;9;4;612900;CELULAR GALAXY A22 5G 4+128GB GRAY;TELEFONIA
14418366;;F;51;CHILENO;;Extranjero;PAINE                         ;METROPOLITANA;139990;3;1;0;0;0;3;1;139990;CELULAR GALAXY A13 4+128GB BLACK;TELEFONIA
15775866;;F;38;CHILENO;;Millenial;PROVIDENCIA                   ;METROPOLITANA;274970;3;1;0;0;0;3;1;274970;CELULAR GALAXY A13 4+128GB BLACK;TELEFONIA
16301074;;M;55;CHILENO;;Boomers;CONCON;VALPARAISO;225980;2;1;2;1;225980;0;0;0;CELULAR SAMSUNG A52s 128GB BLACK CLARO;TELEFONIA
20662172;;M;21;CHILENO;;Z;N/D;N/D;119990;1;1;1;1;119990;0;0;0;CELULAR REDMI 10A US 32GB CHROME SILVER OPEN;TELEFONIA
19653819;;F;24;CHILENO;;Z;N/D;N/D;354970;3;4;0;0;0;3;4;354970;CELULAR MOTO G50 AZUL 128 GB OPEN;TELEFONIA
16965979;;F;33;CHILENO;;Millenial;PROVIDENCIA                   ;METROPOLITANA;109990;1;1;0;0;0;1;1;109990;CELULAR REDMI 9C 64GB SUNRISE ORANGE;TELEFONIA
10094183;;F;67;CHILENO;;Boomers;ARAUCO                        ;BIO BIO;554659;8;3;0;0;0;8;3;554659;CELULAR GALAXY A23 6+128GB BLACK OPEN;TELEFONIA
18468448;;M;29;CHILENO;;Millenial;N/D;N/D;1044220;8;3;4;1;715970;4;2;328250;CELULAR SAMSUNG S21 FE 128GB LIGHT GREEN OPEN;TELEFONIA
6999290;;F;71;CHILENO;;Silencioso;ANGOL                         ;ARAUCANIA;1465160;15;8;0;0;0;15;8;1465160;CELULAR GALAXY A03 4+64GB BLACK OPEN;TELEFONIA
18667659;Soltero;F;28;CHILENO;INGENIERO COMERCIAL;Millenial;PROVIDENCIA                   ;METROPOLITANA;14990;1;1;1;1;14990;0;0;0;CELULAR AZUMI L4G BLACK CLARO;TELEFONIA
13371523;;F;48;CHILENO;;X;TALCA                         ;MAULE;179990;1;1;0;0;0;1;1;179990;CELULAR VIVO Y21S PEARL WHITE 128 GB OPEN;TELEFONIA
17426793;Soltero;F;32;CHILENO;;Millenial;PROVIDENCIA                   ;METROPOLITANA;183960;4;2;4;2;183960;0;0;0;CELULAR A32 128 GB BLUE OPEN;TELEFONIA
18944496;;F;26;CHILENO;;Z;N/D;N/D;579970;3;3;0;0;0;3;3;579970;CELULAR GALAXY A13 4+128GB LIGHT BLUE OPEN;TELEFONIA
13921401;;F;42;CHILENO;;X;RENCA                         ;METROPOLITANA;364980;2;1;2;1;364980;0;0;0;CELULAR GALAXY S20FE 128GB CLOUD LAVENDER OPEN;TELEFONIA
15252441;;F;40;CHILENO;;X;PROVIDENCIA                   ;METROPOLITANA;169990;1;1;0;0;0;1;1;169990;CELULAR GALAXY A22 5G 4+128GB GRAY;TELEFONIA
20466863;;F;22;CHILENO;;Silencioso;PROVIDENCIA                   ;METROPOLITANA;129990;1;1;1;1;129990;0;0;0;CELULAR GALAXY A13 4+128GB LIGHT BLUE OPEN;TELEFONIA
26344757;;F;23;NO INFORMA NACIONALIDAD;;Extranjero;PROVIDENCIA                   ;METROPOLITANA;193980;2;1;2;1;193980;0;0;0;CELULAR A52 128 GB WHITE OPEN;TELEFONIA
19258417;;M;26;CHILENO;;Z;LA SERENA;COQUIMBO;104660;8;5;0;0;0;8;5;104660;CHIP OPEN ENTEL;TELEFONIA
13537517;;F;43;CHILENO;;X;SALAMANCA                     ;COQUIMBO;219811;3;2;0;0;0;3;2;219811;CELULAR XIAOMI REDMI 9A 32 GB BLUE DIRECTO CLARO;TELEFONIA
17115170;Soltero;M;33;CHILENO;INGENIERO EN AUTOMATIZACION Y CONTROL INDUSTRIAL;Millenial;PROVIDENCIA                   ;METROPOLITANA;400480;2;1;2;1;400480;0;0;0;CELULAR XIAOMI 11T PRO 8/256GB CELESTIAL BLUE OP;TELEFONIA
23896861;Soltero;M;34;COLOMBIANO;;Extranjero;PROVIDENCIA                   ;METROPOLITANA;654980;2;1;2;1;654980;0;0;0;CELULAR GALAXY S22 PINK GOLD 128GB;TELEFONIA
16613831;;F;34;CHILENO;;Millenial;ILLAPEL                       ;COQUIMBO;334174;6;3;0;0;0;6;3;334174;CELULAR REDMI 10C 128GB GRAPHITE GRAY CLARO;TELEFONIA
13389154;;F;44;CHILENO;;X;CURANILAHUE                   ;BIO BIO;362960;4;3;0;0;0;4;3;362960;CELULAR MOTO G60S 6/128 GB AZUL;TELEFONIA
15044012;;F;41;CHILENO;;X;COPIAPO                       ;ATACAMA;1249650;11;8;0;0;0;11;8;1249650;CELULAR GALAXY A53 5G BLACK CLARO;TELEFONIA
5926818;;M;77;CHILENO;;Silencioso;PARRAL                        ;MAULE;110760;2;1;0;0;0;2;1;110760;CELULAR SAMSUNG A03 CORE 32GB BLACK CLARO;TELEFONIA
10775315;;M;52;CHILENO;;X;AISEN                         ;AYSEN;259990;1;1;0;0;0;1;1;259990;CELULAR SMARTPHONE A52S 5G BLACK 128GB;TELEFONIA
18181701;;F;29;CHILENO;;Millenial;SAN VICENTE                   ;L.G.B.OÂ´HIGGINS;99980;2;2;0;0;0;2;2;99980;CELULAR Moto E7 Rosado WOM;TELEFONIA
15697493;;M;39;CHILENO;;X;N/D;N/D;799920;9;5;1;1;149990;8;4;649930;CELULAR REDMI NOTE 10 5G 4/128GB GRAPHITE GRAY O;TELEFONIA
10888261;;F;55;CHILENO;;Boomers;CURANILAHUE                   ;BIO BIO;778940;6;5;0;0;0;6;5;778940;CELULAR REDMI NOTE 10 PRO 6+128GB GRADIENT BRONZ;TELEFONIA
19391929;;F;25;CHILENO;;Z;N/D;N/D;101970;3;2;2;1;11980;1;1;89990;REPETIDOR MI WIFI RANGE EXTENDER PRO XIAOMI;TELEFONIA
13497921;;F;43;CHILENO;;X;SIERRA GORDA;ANTOFAGASTA;499990;1;1;1;1;499990;0;0;0;IPHONE 11 128GB BLACK CLARO;TELEFONIA
12296581;;F;50;CHILENO;;X;MAULE                         ;MAULE;859690;10;4;0;0;0;10;4;859690;CELULAR VIVO Y15S WAVE GREEN OPEN;TELEFONIA
18296680;;F;29;CHILENO;;Millenial;SAN FERNANDO;O HIGGINS;448960;4;3;4;3;448960;0;0;0;CELULAR GALAXY A53 5G 6+128GB WHITE;TELEFONIA
16978125;;M;33;CHILENO;;Millenial;N/D;N/D;719970;4;3;2;1;279990;2;2;439980;CELULAR VIVO Y53S FANTASTIC RAINBOW 128GB OPEN;TELEFONIA
21875506;Soltero;M;47;PERUANO;;Extranjero;PROVIDENCIA                   ;METROPOLITANA;179990;1;1;0;0;0;1;1;179990;CELULAR A52 128 GB LIGHT VIOLET OPEN;TELEFONIA
10297132;;M;57;CHILENO;;Silencioso;PROVIDENCIA                   ;METROPOLITANA;146980;2;1;2;1;146980;0;0;0;CELULAR A32 128 GB BLACK OPEN;TELEFONIA
13733753;;M;43;CHILENO;;X;ARICA                         ;TARAPACA;398110;3;2;0;0;0;3;2;398110;CELULAR A52 128 GB BLACK OPEN;TELEFONIA
11567364;;M;52;CHILENO;;X;NINHUE                        ;BIO BIO;79990;1;1;0;0;0;1;1;79990;CELULAR XIAOMI REDMI 9A 32GB VERDE CLARO;TELEFONIA
19385131;;F;25;CHILENO;;Z;N/D;N/D;423960;4;2;4;2;423960;0;0;0;CELULAR GALAXY A53 5G 6+128GB BLUE;TELEFONIA
11281515;;F;53;CHILENO;;X;CHEPICA                       ;L.G.B.OÂ´HIGGINS;79990;1;1;0;0;0;1;1;79990;CELULAR GALAXY A03 CORE 2GB 32GB BLACK OPEN;TELEFONIA
16206072;;F;37;CHILENO;;Millenial;"";"";512340;8;4;4;2;402960;4;2;109380;CELULAR A52 128 GB BLACK OPEN;TELEFONIA
12562904;Soltero;M;48;CHILENO;;X;PROVIDENCIA                   ;METROPOLITANA;149990;1;1;0;0;0;1;1;149990;CELULAR VIVO Y20S NEBULA 128 GB BLUE OPEN;TELEFONIA
18017936;;F;30;CHILENO;;Millenial;PROVIDENCIA                   ;METROPOLITANA;1773950;5;4;5;4;1773950;0;0;0;CELULAR VIVO V21 5G DUSK BLUE 128GB OPEN;TELEFONIA
16741499;;M;34;CHILENO;;Millenial;SAN VICENTE;O HIGGINS;175470;5;3;0;0;0;5;3;175470;CELULAR XIAOMI REDMI 9A 32GB VERDE CLARO;TELEFONIA
8150866;;M;64;CHILENO;;Boomers;MELIPILLA                     ;METROPOLITANA;904650;7;2;0;0;0;7;2;904650;CELULAR MOTO G100 128GB VERDE BOREAL + HMDI OPEN;TELEFONIA
18901232;Soltero;F;30;CHILENO;;Millenial;NUEVA IMPERIAL                ;ARAUCANIA;319990;3;2;0;0;0;3;2;319990;CELULAR A32 128 GB BLACK OPEN;TELEFONIA
10828177;;M;55;CHILENO;;Boomers;CALAMA                        ;ANTOFAGASTA;412970;3;2;0;0;0;3;2;412970;SMARTPHONE A22 BLANCO 128GB;TELEFONIA
19144073;Soltero;F;26;CHILENO;;Z;PROVIDENCIA                   ;METROPOLITANA;785970;3;2;3;2;785970;0;0;0;CELULAR A52 128 GB BLUE OPEN;TELEFONIA
15914675;Casado;M;37;CHILENO;INGENIERO CIVIL INDUSTRIAL;Millenial;TALCA                         ;MAULE;169990;1;1;1;1;169990;0;0;0;CELULAR A52 128 GB BLACK OPEN;TELEFONIA
14183035;;M;41;CHILENO;;X;COLLIPULLI                    ;ARAUCANIA;522950;6;3;0;0;0;6;3;522950;CELULAR A52 128 GB LIGHT VIOLET OPEN;TELEFONIA
10390145;;M;56;CHILENO;;Boomers;CHIGUAYANTE                   ;BIO BIO;99990;2;1;0;0;0;2;1;99990;CELULAR VIVO Y21S 128GB BLANCO WOM;TELEFONIA
18178718;;F;30;CHILENO;;Millenial;LA SERENA                     ;COQUIMBO;130970;5;3;0;0;0;5;3;130970;CELULAR SAMSUNG A03 128GB BLACK CLARO;TELEFONIA
26447589;;F;39;EXTRANJERO - NO INFORMA NACIONALIDAD;;Extranjero;"";"";369990;1;1;0;0;0;1;1;369990;CELULAR SAMSUNG S21 FE 128GB WHITE OPEN;TELEFONIA
7735154;;M;64;CHILENO;;Boomers;PROVIDENCIA                   ;METROPOLITANA;323290;5;2;0;0;0;5;2;323290;CELULAR BMOBILE C40 CRIS OPEN;TELEFONIA
26304492;;M;42;VENEZOLANO;;Extranjero;N/D;N/D;403970;3;2;3;2;403970;0;0;0;CELULAR REDMI NOTE 11 4/128GB TWILIGHT BLUE OPEN;TELEFONIA
5895867;Casado;M;69;CHILENO;;Silencioso;PROVIDENCIA                   ;METROPOLITANA;209990;1;1;0;0;0;1;1;209990;CELULAR VIVO Y53S FANTASTIC RAINBOW 128GB OPEN;TELEFONIA
12349743;;M;49;CHILENO;;X;OVALLE                        ;COQUIMBO;132980;2;1;0;0;0;2;1;132980;CELULAR SAMSUNG A03 CORE 32GB BLACK CLARO;TELEFONIA
8188293;;F;69;CHILENO;;Silencioso;PROVIDENCIA                   ;METROPOLITANA;109990;2;1;0;0;0;2;1;109990;CELULAR A54 OPPO NEGRO 128GB;TELEFONIA
7525293;;M;67;CHILENO;;Boomers;VICTORIA                      ;ARAUCANIA;285980;2;2;1;1;259990;1;1;25990;CELULAR SMARTPHONE A52S 5G BLACK 128GB;TELEFONIA
11967334;Casado;M;49;CHILENO;;X;TALAGANTE                     ;METROPOLITANA;189990;1;1;0;0;0;1;1;189990;CELULAR RENO5 LITE NEGRO 128GB;TELEFONIA
18349946;Soltero;F;29;CHILENO;;Millenial;PROVIDENCIA                   ;METROPOLITANA;249990;1;1;1;1;249990;0;0;0;CELULAR VIVO V21 5G 128GB SUNSET DAZZLE OPEN;TELEFONIA
12814912;;M;46;CHILENO;;X;PROVIDENCIA                   ;METROPOLITANA;712960;11;5;0;0;0;11;5;712960;CELULAR A12 128GB Negro OPEN;TELEFONIA
23070505;;M;43;COLOMBIANO;;Extranjero;N/D;N/D;681940;6;3;6;3;681940;0;0;0;CELULAR A32 128 GB LIGHT VIOLET OPEN;TELEFONIA
10691784;;M;48;CHILENO;;Millenial;PROVIDENCIA                   ;METROPOLITANA;64990;1;1;1;1;64990;0;0;0;CELULAR XIAOMI REDMI 9A 32GB VERDE CLARO;TELEFONIA
11517042;;M;51;CHILENO;;X;SAN FELIPE                    ;VALPARAISO;529970;4;2;0;0;0;4;2;529970;CELULAR GALAXY A03 CORE 2GB 32GB BLACK OPEN;TELEFONIA
15045433;;M;40;CHILENO;;X;RENCA                         ;METROPOLITANA;214010;2;1;0;0;0;2;1;214010;CELULAR REDMI 10C EU 4GB+128GB GRAPHITE GRAY OPE;TELEFONIA
15415199;;M;39;CHILENO;;X;RENCA                         ;METROPOLITANA;0;0;2;0;0;0;0;2;0;CELULAR A52 128 GB BLACK OPEN;TELEFONIA
12111019;;M;52;CHILENO;;X;PAINE                         ;METROPOLITANA;139990;1;1;1;1;139990;0;0;0;CELULAR REDMI 10C EU 4GB+128GB GRAPHITE GRAY OPE;TELEFONIA
16047172;;M;37;CHILENO;;Millenial;N/D;N/D;239990;1;1;1;1;239990;0;0;0;CELULAR REDMI NOTE 11 PRO 128GB GRAPHITE;TELEFONIA
10381955;;F;54;CHILENO;;Boomers;N/D;N/D;302980;3;2;0;0;0;3;2;302980;CELULAR VIVO V21 5G DUSK BLUE 128GB OPEN;TELEFONIA
17872322;;M;30;CHILENO;;Millenial;BUIN                          ;METROPOLITANA;119990;1;1;0;0;0;1;1;119990;CELULAR REDMI 9C 64GB SUNRISE ORANGE;TELEFONIA
15832154;;M;46;CHILENO;;X;VITACURA;METROPOLITANA;245940;6;3;6;3;245940;0;0;0;CELULAR GALAXY A22 5G 4+128GB WHITE;TELEFONIA
26177959;;M;30;EXTRANJERO - NO INFORMA NACIONALIDAD;;Extranjero;N/D;N/D;519960;4;2;4;2;519960;0;0;0;CELULAR A32 128 GB BLUE OPEN;TELEFONIA
8655987;;F;54;CHILENO;;X;NATALES                       ;MAGALLANES;159990;1;1;0;0;0;1;1;159990;CELULAR GALAXY A22 5G 4+128GB GRAY;TELEFONIA
20317640;;M;22;CHILENO;;Z;COIHAIQUE                     ;AYSEN;160000;2;1;0;0;0;2;1;160000;CELULAR REDMI NOTE 11 4/128GB GRAPHITE GRAY OPEN;TELEFONIA
12555563;;F;48;CHILENO;;X;LONGAVI                       ;MAULE;458730;6;3;0;0;0;6;3;458730;SMARTPHONE A03S NEGRO 32GB;TELEFONIA
9390293;;M;58;CHILENO;;Boomers;N/D;N/D;169990;1;1;1;1;169990;0;0;0;CELULAR A52 128 GB BLUE OPEN;TELEFONIA
9731810;Soltero;M;59;CHILENO;AGRONOMO;Boomers;RENCA                         ;METROPOLITANA;148770;3;1;0;0;0;3;1;148770;CELULAR REDMI 9C 64GB SUNRISE ORANGE;TELEFONIA
7759396;;F;66;CHILENO;;Boomers;ALHUE                         ;METROPOLITANA;51970;4;4;0;0;0;4;4;51970;CELULAR VIVO Y01 AZUL ZAFIRO OPEN;TELEFONIA
12465996;;M;50;CHILENO;;X;COQUIMBO;COQUIMBO;89990;1;1;0;0;0;1;1;89990;CELULAR REDMI 9C 64GB SUNRISE ORANGE;TELEFONIA
12449008;;M;49;CHILENO;;X;N/D;N/D;700960;4;2;2;1;405980;2;1;294980;IPHONE 11 64GB BLACK CLARO;TELEFONIA
12666013;;F;48;CHILENO;;X;PROVIDENCIA                   ;METROPOLITANA;229990;1;1;0;0;0;1;1;229990;CELULAR SAMSUNG A52s 128GB BLACK CLARO;TELEFONIA
18875424;;F;27;CHILENO;;Z;"";"";139990;1;1;1;1;139990;0;0;0;CELULAR REDMI NOTE 10 5G 4/128GB GRAPHITE GRAY O;TELEFONIA
14118206;Soltero;M;41;CHILENO;PSICOLOGO;X;RENCA                         ;METROPOLITANA;639980;2;3;2;3;639980;0;0;0;CELULAR GALAXY S20 FE 5G 128GB BLUE OPEN;TELEFONIA
10551422;;M;56;CHILENO;;Boomers;PROVIDENCIA                   ;METROPOLITANA;603980;2;1;2;1;603980;0;0;0;CELULAR GALAXY S22 BLACK 128GB;TELEFONIA
26954549;Soltero;F;35;NO INFORMA NACIONALIDAD;;Extranjero;PROVIDENCIA                   ;METROPOLITANA;429990;1;1;1;1;429990;0;0;0;CELULAR GALAXY A73 5G 256GB GRAY OPEN;TELEFONIA
9432449;;M;57;CHILENO;;Boomers;RENCA                         ;METROPOLITANA;139990;2;1;0;0;0;2;1;139990;CELULAR GALAXY A13 4+128GB BLACK;TELEFONIA
15826065;;M;38;CHILENO;;Millenial;RENCA                         ;METROPOLITANA;146980;2;2;0;0;0;2;2;146980;CELULAR GALAXY A03 64GB BLACK DIRECTO MOVISTAR;TELEFONIA
8515819;;F;63;CHILENO;;Boomers;PROVIDENCIA                   ;METROPOLITANA;189990;1;1;1;1;189990;0;0;0;CELULAR A52 128 GB BLACK OPEN;TELEFONIA
25803952;;M;39;VENEZOLANO;;Extranjero;TALCA                         ;MAULE;44980;4;2;0;0;0;4;2;44980;CELULAR REDMI 9C 64GB SUNRISE ORANGE;TELEFONIA
12365494;;F;49;CHILENO;;X;RANCAGUA                      ;L.G.B.OÂ´HIGGINS;199990;1;1;1;1;199990;0;0;0;CELUALAR REDMI NOTE 11 PRO US 6GB+128GB STAR BLU;TELEFONIA
19600520;;M;25;CHILENO;;Millenial;"";"";990;3;1;0;0;0;3;1;990;CHIP OPEN ENTEL;TELEFONIA
5662857;Casado;F;73;CHILENO;;Millenial;"";"";777960;4;2;4;2;777960;0;0;0;CELULAR A52 128 GB BLACK OPEN;TELEFONIA
9700289;;F;59;CHILENO;;Boomers;CASTRO                        ;LOS LAGOS;130960;4;2;0;0;0;4;2;130960;CELULAR GALAXY A03 4+64GB BLACK OPEN;TELEFONIA
12371714;Viudo;F;48;CHILENO;;X;RENCA                         ;METROPOLITANA;148200;2;1;0;0;0;2;1;148200;CELULAR SAMSUNG A03 64GB NEGRO WOM;TELEFONIA
25955587;;F;31;PERUANO;;Extranjero;CERRILLOS                     ;METROPOLITANA;317720;8;3;0;0;0;8;3;317720;CELULAR GALAXY A53 5G 6+128GB WHITE;TELEFONIA
9313582;;F;59;CHILENO;;Boomers;MAULE                         ;MAULE;1009727;10;5;0;0;0;10;5;1009727;CELULAR VIVO V21 5G 128GB SUNSET DAZZLE OPEN;TELEFONIA
11385413;;F;53;CHILENO;;X;PAPUDO                        ;VALPARAISO;216650;4;4;0;2;0;4;2;216650;CELULAR A32 128 GB BLUE OPEN;TELEFONIA
13212406;;F;45;CHILENO;;X;ARICA                         ;ARICA Y PARINACOTA;575060;5;4;0;0;0;5;4;575060;CELULAR MOTOROLA MOTO G20 64GB ROSA FLAMINGO;TELEFONIA
14422381;;F;54;CHILENO;;X;PUENTE ALTO                   ;METROPOLITANA;94276;2;1;0;0;0;2;1;94276;CELULAR VIVO Y21S 128GB BLANCO WOM;TELEFONIA
12765636;;M;47;CHILENO;;X;CHILLAN                       ;BIO BIO;593980;2;1;2;1;593980;0;0;0;SMARTPHONE Z FLIP3 GREEN 128GB;TELEFONIA
5447228;;F;78;CHILENO;;Silencioso;N/D;N/D;450950;5;5;0;0;0;5;5;450950;CELULAR BMOBILE C40 CRIS OPEN;TELEFONIA
9514932;;M;58;CHILENO;;Boomers;RENCA                         ;METROPOLITANA;33990;1;1;0;0;0;1;1;33990;Celular SA3 CLARO DIRECTO BLACK;TELEFONIA
12691483;Divorciado;M;48;CHILENO;;X;NIQUEN                        ;BIO BIO;189990;1;1;0;0;0;1;1;189990;CELULAR A32 128 GB LIGHT VIOLET OPEN;TELEFONIA
19109988;;F;26;CHILENO;;Z;TOME                          ;BIO BIO;507800;6;3;6;3;507800;0;0;0;CELULAR GALAXY A22 5G 4+128GB GRAY;TELEFONIA
7583536;;F;68;CHILENO;;Boomers;PROVIDENCIA                   ;METROPOLITANA;99990;1;1;0;0;0;1;1;99990;CELULAR VIVO Y01 AZUL ZAFIRO OPEN;TELEFONIA
10401944;Casado;M;56;CHILENO;CONTADOR GENERAL;Boomers;RENCA                         ;METROPOLITANA;119990;3;1;0;0;0;3;1;119990;CELULAR REDMI 10A US 64GB GRAPHITE GRAY OPEN;TELEFONIA
15809662;;F;38;CHILENO;;Millenial;CHILLAN VIEJO                 ;BIO BIO;249990;2;1;0;0;0;2;1;249990;CELUALAR REDMI NOTE 11 PRO US 6GB+128GB STAR BLU;TELEFONIA
12804172;;M;47;CHILENO;;X;N/D;N/D;1580853;20;15;0;0;0;20;15;1580853;CELULAR VIVO Y21S PEARL WHITE 128 GB OPEN;TELEFONIA
11362767;;M;52;CHILENO;;X;CARTAGENA                     ;VALPARAISO;204960;4;4;0;0;0;4;4;204960;CELULAR BMOBILE C40 CRIS OPEN;TELEFONIA
9478779;;F;59;CHILENO;;Boomers;N/D;N/D;80000;2;1;0;0;0;2;1;80000;CELULAR Moto E7 Rosado WOM;TELEFONIA
19206586;Soltero;M;25;CHILENO;;Silencioso;PROVIDENCIA                   ;METROPOLITANA;740980;2;1;2;1;740980;0;0;0;CELULAR GALAXY S22+ BLACK 128GB;TELEFONIA
8266370;;M;63;CHILENO;;Boomers;TEMUCO                        ;ARAUCANIA;139990;1;1;1;1;139990;0;0;0;CELULAR REDMI NOTE 10 5G 4/128GB GRAPHITE GRAY O;TELEFONIA
8951891;;M;56;CHILENO;;Boomers;PROVIDENCIA                   ;METROPOLITANA;189990;1;1;0;0;0;1;1;189990;CELULAR GALAXY A23 6+128GB BLACK OPEN;TELEFONIA
10093910;;M;57;CHILENO;;Boomers;ILLAPEL                       ;COQUIMBO;613590;4;2;0;0;0;4;2;613590;CELULAR GALAXY A22 5G 4+128GB GRAY;TELEFONIA
17690472;;M;31;CHILENO;;Millenial;PROVIDENCIA                   ;METROPOLITANA;138200;2;1;0;0;0;2;1;138200;CELULAR XIAOMI REDMI 9C 64GB GRAY WOM;TELEFONIA
20339534;;F;31;ARGENTINO;;Millenial;PROVIDENCIA                   ;METROPOLITANA;190980;2;1;2;1;190980;0;0;0;CELULAR VIVO Y21S MIDNIGHT BLUE 128 GB OPEN;TELEFONIA
16813382;;F;34;CHILENO;;Millenial;VILLA ALEMANA                 ;VALPARAISO;603980;2;1;2;1;603980;0;0;0;CELULAR XIAOMI 12 5G US 8GB+256GB GRAY BUNDLE;TELEFONIA
8765184;;M;63;CHILENO;;Boomers;BUIN                          ;METROPOLITANA;99990;1;1;0;0;0;1;1;99990;CELULAR GALAXY A03 4+64GB BLACK OPEN;TELEFONIA
10601006;;M;56;CHILENO;;Boomers;YERBAS BUENAS                 ;MAULE;39990;2;1;0;0;0;2;1;39990;CELULAR REDMI 9C 64GB SUNRISE ORANGE;TELEFONIA
25507284;;F;55;BOLIVIANO;;Extranjero;CALAMA                        ;ANTOFAGASTA;189970;5;2;0;0;0;5;2;189970;CELULAR REDMI NOTE 10S 128GB ONIX BLACK;TELEFONIA
10818555;;M;56;CHILENO;;Boomers;TOCOPILLA                     ;ANTOFAGASTA;826950;5;3;2;1;399980;3;2;426970;CELULAR XIAOMI REDMI 9A SE 2/32GB GB PEACOCK GRE;TELEFONIA
17183495;;F;33;CHILENO;;Millenial;N/D;N/D;311960;4;4;2;2;111980;2;2;199980;CELULAR SAMSUNG A03 64GB NEGRO WOM;TELEFONIA
18673818;;F;28;CHILENO;;Millenial;PAINE                         ;METROPOLITANA;224256;5;2;0;0;0;5;2;224256;CELULAR VIVO Y15S WAVE GREEN OPEN;TELEFONIA
7054968;;M;65;CHILENO;;Boomers;LA CISTERNA                   ;METROPOLITANA;34140;2;1;0;0;0;2;1;34140;Celular SA3 CLARO DIRECTO BLACK;TELEFONIA
9649380;;F;57;CHILENO;;Boomers;RENCA                         ;METROPOLITANA;99990;1;1;0;0;0;1;1;99990;CELULAR VIVO Y01 AZUL ZAFIRO OPEN;TELEFONIA
11062295;;F;56;CHILENO;;Boomers;CORONEL                       ;BIO BIO;478700;14;5;0;0;0;14;5;478700;CELULAR SAMSUNG A03 CORE 32GB BLACK CLARO;TELEFONIA
12774900;Casado;M;50;CHILENO;TECNICO EN ADMINISTRACION DE EMPRESAS;X;RENCA                         ;METROPOLITANA;266980;2;1;2;1;266980;0;0;0;CELULAR SMARTPHONE A52S 5G BLACK 128GB;TELEFONIA
22460902;;M;22;COLOMBIANO;;Extranjero;PROVIDENCIA                   ;METROPOLITANA;424970;4;2;0;0;0;4;2;424970;CELULAR GALAXY A53 5G 6+128GB BLUE;TELEFONIA
14748562;;F;47;PERUANO;;Extranjero;ARICA                         ;ARICA Y PARINACOTA;1267941;7;4;0;0;0;7;4;1267941;SMARTPHONE A03S NEGRO 32GB;TELEFONIA
26187557;;M;32;NO INFORMA NACIONALIDAD;;Extranjero;SANTIAGO                      ;METROPOLITANA;179990;1;1;0;0;0;1;1;179990;CELULAR GALAXY A13 4+128GB WHITE OPEN;TELEFONIA
12042584;;M;54;CHILENO;;X;MONTE PATRIA                  ;COQUIMBO;359980;4;1;0;0;0;4;1;359980;CELULAR A52 128 GB BLUE OPEN;TELEFONIA
13285937;;F;45;CHILENO;;X;SAN BERNARDO                  ;METROPOLITANA;139990;1;1;1;1;139990;0;0;0;CELULAR A32 128 GB BLUE OPEN;TELEFONIA
11517123;;M;51;CHILENO;;X;SAN FELIPE                    ;VALPARAISO;79990;1;1;0;0;0;1;1;79990;CELULAR XIAOMI REDMI 9A 2/32GB GRANITE GRAY;TELEFONIA
11366599;;F;53;CHILENO;;X;PEUMO                         ;L.G.B.OÂ´HIGGINS;69990;1;1;0;0;0;1;1;69990;CELULAR GALAXY A03 CORE 2GB 32GB BLACK OPEN;TELEFONIA
10851075;;M;52;CHILENO;;X;ILLAPEL                       ;COQUIMBO;139990;1;1;1;1;139990;0;0;0;CELULAR A32 128 GB WHITE OPEN;TELEFONIA
10713303;;M;56;CHILENO;;Boomers;SAN FERNANDO                  ;L.G.B.OÂ´HIGGINS;174990;3;1;0;0;0;3;1;174990;CELULAR A52 128 GB LIGHT VIOLET OPEN;TELEFONIA
17065459;;F;33;CHILENO;;Millenial;PROVIDENCIA                   ;METROPOLITANA;219990;1;1;1;1;219990;0;0;0;CELULAR SMARTPHONE A52S 5G LIGHT GREEN 128GB;TELEFONIA
19283608;Soltero;M;26;CHILENO;;Z;PROVIDENCIA                   ;METROPOLITANA;169990;1;1;1;1;169990;0;0;0;CELULAR REDMI NOTE 10S 128GB ONIX BLACK;TELEFONIA
12775063;Soltero;M;47;CHILENO;;X;PROVIDENCIA                   ;METROPOLITANA;460340;5;3;0;0;0;5;3;460340;SMARTPHONE A03S NEGRO 32GB;TELEFONIA
18554455;;F;28;CHILENO;;Millenial;QUINTERO                      ;VALPARAISO;556980;2;1;2;1;556980;0;0;0;CELULAR IPHONE 12 64GB BLACK CLARO;TELEFONIA
10313019;;M;57;CHILENO;;Boomers;BUIN                          ;METROPOLITANA;149990;2;1;0;0;0;2;1;149990;CELULAR REDMI NOTE 10 5G 4/128GB GRAPHITE GRAY O;TELEFONIA
27170495;;M;34;VENEZOLANO;;Extranjero;TALCA                         ;MAULE;279980;3;4;0;0;0;3;4;279980;CELULAR MOTOROLA G20 EDICION ESPECIAL VERDE CLAR;TELEFONIA
18178047;;F;30;CHILENO;;Millenial;PROVIDENCIA                   ;METROPOLITANA;169990;1;1;1;1;169990;0;0;0;CELULAR A52 128 GB WHITE OPEN;TELEFONIA
12545507;;F;48;CHILENO;;X;PROVIDENCIA                   ;METROPOLITANA;525470;3;2;2;1;135480;1;1;389990;CELULAR XIAOMI 11T 8/256GB CELESTIAL BLUE OPEN;TELEFONIA
9448270;;F;60;CHILENO;;Boomers;SALAMANCA                     ;COQUIMBO;284980;2;2;0;0;0;2;2;284980;CELULAR MOTO G51 5G 4/128 GB AZUL OPEN;TELEFONIA
19324510;;F;25;CHILENO;;Z;GORBEA                        ;ARAUCANIA;539990;2;1;0;0;0;2;1;539990;CELULAR GALAXY S21 FE 8GB 256GB GRAY;TELEFONIA
9743948;;F;56;CHILENO;;Boomers;PROVIDENCIA                   ;METROPOLITANA;169990;2;1;2;1;169990;0;0;0;CELULAR A52 128 GB BLACK OPEN;TELEFONIA
19277452;Soltero;F;26;CHILENO;;Z;PROVIDENCIA                   ;METROPOLITANA;73980;2;1;2;1;73980;0;0;0;CELULAR REDMI 9A 32GB SKY BLUE;TELEFONIA
16268542;Soltero;M;36;CHILENO;INGENIERO EN LOGISTICA;Silencioso;PROVIDENCIA                   ;METROPOLITANA;269980;2;1;2;1;269980;0;0;0;CELULAR GALAXY A53 5G 6+128GB BLACK;TELEFONIA
10520874;;F;54;CHILENO;;X;ISLA DE MAIPO                 ;METROPOLITANA;69990;1;1;0;0;0;1;1;69990;CELULAR REDMI 9A 32GB SKY BLUE;TELEFONIA
16433507;;M;35;CHILENO;;Millenial;CHEPICA                       ;L.G.B.OÂ´HIGGINS;469980;3;2;0;0;0;3;2;469980;CELULAR VIVO V21 5G 128GB SUNSET DAZZLE OPEN;TELEFONIA
8063136;;F;61;CHILENO;;Boomers;PROVIDENCIA                   ;METROPOLITANA;189990;1;1;0;0;0;1;1;189990;CELULAR A32 128 GB BLUE OPEN;TELEFONIA
10944400;;F;51;CHILENO;;X;MONTE PATRIA                  ;COQUIMBO;119990;2;1;0;0;0;2;1;119990;CELULAR GALAXY A03 4+64GB BLACK OPEN;TELEFONIA
6931089;;M;67;CHILENO;;Boomers;N/D;N/D;331050;3;1;0;0;0;3;1;331050;VIVO Y53S DEEP SEA BLUE 128GB OPEN;TELEFONIA
14007077;;F;41;CHILENO;;X;"";"";99990;1;1;0;0;0;1;1;99990;CELULAR GALAXY A03 4+64GB BLACK OPEN;TELEFONIA
19771661;;F;24;CHILENO;;Z;PROVIDENCIA                   ;METROPOLITANA;269990;1;1;1;1;269990;0;0;0;CELULAR IPHONE SE 64GB DIRECTO CLARO;TELEFONIA
17797199;;M;30;CHILENO;;Millenial;SAN BERNARDO;METROPOLITANA;0;0;2;0;2;0;0;0;0;CELULAR IPHONE 12 64GB BLACK CLARO;TELEFONIA
6823978;;F;68;CHILENO;;Silencioso;TALCAHUANO                    ;BIO BIO;63980;2;2;0;0;0;2;2;63980;CELULAR BMOBILE C40 CRIS OPEN;TELEFONIA
13080069;;M;46;CHILENO;;X;LA PINTANA                    ;METROPOLITANA;79990;1;1;0;0;0;1;1;79990;CELULAR XIAOMI REDMI 9A 32GB GRANITE GRAY TRI WO;TELEFONIA
10847741;;F;44;CHILENO;;X;N/D;N/D;18280;2;1;0;0;0;2;1;18280;CELULAR AZUMI L4G BLACK CLARO;TELEFONIA
12839290;;F;47;CHILENO;;X;ANTOFAGASTA                   ;ANTOFAGASTA;284021;5;3;0;0;0;5;3;284021;CELULAR XIAOMI REDMI 9A 2/32GB GRANITE GRAY;TELEFONIA
7254006;;F;79;CHILENO;;Silencioso;COLINA                        ;METROPOLITANA;164991;3;2;0;0;0;3;2;164991;CELULAR SAMSUNG A03 CORE 32GB BLACK CLARO;TELEFONIA
13751621;;F;42;CHILENO;;X;SAN FELIPE                    ;VALPARAISO;184970;3;2;0;0;0;3;2;184970;CELULAR GALAXY A03 64GB BLACK DIRECTO MOVISTAR;TELEFONIA
13616848;Casado;F;42;CHILENO;;X;PROVIDENCIA                   ;METROPOLITANA;129880;2;1;0;0;0;2;1;129880;CELULAR GALAXY A03 64GB BLACK DIRECTO MOVISTAR;TELEFONIA
17920817;Soltero;F;30;CHILENO;;Silencioso;PROVIDENCIA                   ;METROPOLITANA;299990;1;1;0;0;0;1;1;299990;CELULAR XIAOMI 11 LITE 5G NE 6/128GB TRUFFLE BLA;TELEFONIA
19312837;;M;26;CHILENO;;Z;N/D;N/D;174970;3;2;0;0;0;3;2;174970;CELULAR REDMI NOTE 10 5G 4/128GB GRAPHITE GRAY O;TELEFONIA
19920973;;F;23;CHILENO;;Z;PROVIDENCIA                   ;METROPOLITANA;149990;1;1;1;1;149990;0;0;0;CELULAR GALAXY A22 5G 4+128GB GRAY;TELEFONIA
6390338;;M;69;CHILENO;;Silencioso;CALAMA                        ;ANTOFAGASTA;692950;5;2;0;0;0;5;2;692950;CELULAR SMARTPHONE A52S 5G LIGHT VIOLET 128GB;TELEFONIA
19293808;;M;26;CHILENO;;Z;N/D;N/D;382655;7;4;2;1;199980;5;3;182675;CELULAR REDMI NOTE 11 4/128GB TWILIGHT BLUE OPEN;TELEFONIA
8068531;;M;65;CHILENO;;Boomers;SAN FERNANDO                  ;L.G.B.OÂ´HIGGINS;444830;2;1;0;0;0;2;1;444830;CELULAR VIVO V21 5G 128GB SUNSET DAZZLE OPEN;TELEFONIA
6577056;Soltero;M;67;CHILENO;PROFESOR;Boomers;PROVIDENCIA                   ;METROPOLITANA;149990;1;1;1;1;149990;0;0;0;CELULAR GALAXY A22 5G 4+128GB MINT;TELEFONIA
19175622;;M;25;CHILENO;;Z;SAAVEDRA                      ;ARAUCANIA;130030;3;1;0;0;0;3;1;130030;CELULAR XIAOMI REDMI 9C 64GB GRAY WOM;TELEFONIA
19964957;;M;23;CHILENO;;Z;CHILLAN                       ;BIO BIO;149990;3;1;0;0;0;3;1;149990;CELULAR VIVO Y53S FANTASTIC RAINBOW 128GB OPEN;TELEFONIA
10351013;;F;55;CHILENO;;Boomers;SAN JAVIER                    ;MAULE;924830;7;6;0;0;0;7;6;924830;CELULAR MOTO E7 32GB GRIS OPEN;TELEFONIA
22787893;;M;43;PERUANO;;Extranjero;LA FLORIDA                    ;METROPOLITANA;169980;2;2;0;0;0;2;2;169980;CELULAR GALAXY A22 5G 4+128GB GRAY;TELEFONIA
12966454;Casado;M;46;CHILENO;;X;PARRAL                        ;MAULE;299990;1;1;0;0;0;1;1;299990;CELUALAR REDMI NOTE 11 PRO US 6GB+128GB STAR BLU;TELEFONIA
17813960;Soltero;F;31;CHILENO;PROFESOR;Millenial;PROVIDENCIA                   ;METROPOLITANA;199990;1;1;1;1;199990;0;0;0;CELULAR REDMI NOTE 11 GRAPHITE GRAY + REDMI BUDS;TELEFONIA
11891421;;M;53;CHILENO;;X;RENCA                         ;METROPOLITANA;79990;1;1;0;0;0;1;1;79990;CELULAR XIAOMI REDMI 9A 32GB VERDE CLARO;TELEFONIA
13489959;;F;43;CHILENO;;X;CORONEL                       ;BIO BIO;1100990;8;4;0;0;0;8;4;1100990;CELULAR VIVO Y01 AZUL ZAFIRO OPEN;TELEFONIA
10163218;;M;56;CHILENO;;Boomers;PROVIDENCIA                   ;METROPOLITANA;79990;1;1;1;1;79990;0;0;0;CELULAR XIAOMI REDMI 9A 32 GB BLUE DIRECTO CLARO;TELEFONIA
13066156;;F;46;CHILENO;;X;RENCA                         ;METROPOLITANA;249980;2;2;0;0;0;2;2;249980;CELULAR A52 128 GB BLUE OPEN;TELEFONIA
16975943;;F;33;CHILENO;;Millenial;COIHAIQUE                     ;AYSEN;189990;2;1;0;0;0;2;1;189990;CELULAR REDMI NOTE 11 4/128GB GRAPHITE GRAY OPEN;TELEFONIA
15271752;;F;39;CHILENO;;X;N/D;N/D;369990;2;1;0;0;0;2;1;369990;CELULAR XIAOMI 11T PRO 8/256GB METEORITE GRAY;TELEFONIA
10246790;;M;58;CHILENO;;Boomers;"";"";747600;4;1;0;0;0;4;1;747600;CELULAR XIAOMI 11T PRO 8/256GB METEORITE GRAY;TELEFONIA
18994700;Soltero;M;27;CHILENO;INGENIERIA EN MAQUINARIA VEHICULOS AUTOMOTRICES Y SISTEMAS ELECTRONICOS;Z;SAN JAVIER                    ;MAULE;304160;3;2;0;0;0;3;2;304160;CELULAR SAMSUNG A52s 128GB BLACK CLARO;TELEFONIA
16289567;;M;35;CHILENO;;Millenial;LA PINTANA                    ;METROPOLITANA;173980;2;1;2;1;173980;0;0;0;CELULAR REDMI NOTE 10S 128GB OCEAN BLUE;TELEFONIA
12214231;;M;50;CHILENO;;X;N/D;N/D;232980;2;1;0;0;0;2;1;232980;CELULAR REDMI NOTE 10S 128GB ONIX BLACK;TELEFONIA
20301808;;F;22;CHILENO;;Millenial;SAN FELIPE;VALPARAISO;149980;3;2;0;0;0;3;2;149980;CELULAR XIAOMI REDMI 9A 2/32GB GRANITE GRAY;TELEFONIA
21367265;;F;28;CHILENO;;Extranjero;PROVIDENCIA                   ;METROPOLITANA;169990;2;1;2;1;169990;0;0;0;CELULAR A52 128 GB WHITE OPEN;TELEFONIA
17290882;;F;33;CHILENO;;Millenial;CASTRO                        ;LOS LAGOS;149990;1;1;0;0;0;1;1;149990;CELULAR VIVO Y20S NEBULA 128 GB BLUE OPEN;TELEFONIA
16214065;Soltero;F;36;CHILENO;;Millenial;PROVIDENCIA                   ;METROPOLITANA;169990;1;1;1;1;169990;0;0;0;CELULAR A32 128 GB BLACK OPEN;TELEFONIA
6858606;;F;71;CHILENO;;Silencioso;"";"";980;2;1;0;0;0;2;1;980;CHIP OPEN ENTEL;TELEFONIA
25284543;;F;25;EXTRANJERO - NO INFORMA NACIONALIDAD;;Extranjero;ANTOFAGASTA                   ;ANTOFAGASTA;627770;3;1;0;0;0;3;1;627770;CELULAR GALAXY S20 FE 5G 128GB RED OPEN;TELEFONIA
6283309;;F;69;CHILENO;;Silencioso;LA PINTANA                    ;METROPOLITANA;289980;2;2;0;0;0;2;2;289980;SMARTPHONE A22 BLANCO 128GB;TELEFONIA
13869483;;M;42;CHILENO;;X;ANTOFAGASTA                   ;ANTOFAGASTA;1456970;5;2;0;0;0;5;2;1456970;CELULAR MOTO G60S 6/128 GB AZUL;TELEFONIA
19972061;;M;23;CHILENO;;Z;RENAICO                       ;ARAUCANIA;379970;3;3;0;0;0;3;3;379970;CELULAR REDMI NOTE 10 5G 4/128GB GRAPHITE GRAY O;TELEFONIA
24673142;;M;43;BOLIVIANO;;Extranjero;ARICA                         ;ARICA Y PARINACOTA;526050;4;2;0;0;0;4;2;526050;CELULAR A54 OPPO AZUL 128GB;TELEFONIA
9735028;;M;59;CHILENO;;Boomers;TEMUCO                        ;ARAUCANIA;389240;4;1;0;0;0;4;1;389240;CELULAR A16 CRYSTAL BLACK 64GB;TELEFONIA
13319174;;M;46;CHILENO;;Millenial;"";"";257150;4;1;0;0;0;4;1;257150;CELULAR HUAWEI Y9A BLACK OPEN;TELEFONIA
16750557;;M;34;CHILENO;;Millenial;MAIPU                         ;METROPOLITANA;70140;2;2;0;0;0;2;2;70140;CELULAR XIAOMI REDMI 9A 2/32GB GRANITE GRAY;TELEFONIA
19876542;;M;24;CHILENO;;Z;PUTAENDO                      ;VALPARAISO;169990;1;1;1;1;169990;0;0;0;CELULAR REDMI NOTE 10 5G 4/128GB GRAPHITE GRAY O;TELEFONIA
27030451;Soltero;M;37;EXTRANJERO - NO INFORMA NACIONALIDAD;;Extranjero;PROVIDENCIA                   ;METROPOLITANA;155980;3;2;2;1;139990;1;1;15990;CELULAR A32 128 GB BLACK OPEN;TELEFONIA
14181492;Soltero;F;41;CHILENO;;X;RENCA                         ;METROPOLITANA;273980;2;1;2;1;273980;0;0;0;CELULAR IPHONE SE 64GB DIRECTO CLARO;TELEFONIA
19801196;;F;24;CHILENO;;Z;N/D;N/D;218970;3;2;3;2;218970;0;0;0;CELULAR A52 128 GB LIGHT VIOLET OPEN;TELEFONIA
6158174;Divorciado;M;69;CHILENO;;Silencioso;RENGO                         ;L.G.B.OÂ´HIGGINS;136980;2;2;0;0;0;2;2;136980;CELULAR VIVO Y11S PHANTON BLACK 32GB MOVISTAR;TELEFONIA
8001889;Casado;M;62;CHILENO;;Boomers;RENCA                         ;METROPOLITANA;449970;3;1;3;1;449970;0;0;0;CELULAR GALAXY A22 5G 4+128GB GRAY;TELEFONIA
16975474;Soltero;F;33;CHILENO;MEDICO CIRUJANO;Millenial;PROVIDENCIA                   ;METROPOLITANA;759990;1;1;0;0;0;1;1;759990;Galaxy Z Flip3 128GB LAVENDER;TELEFONIA
7367990;Soltero;M;65;CHILENO;;Boomers;TEMUCO                        ;ARAUCANIA;119990;1;1;0;0;0;1;1;119990;CELULAR VIVO Y01 AZUL ZAFIRO OPEN;TELEFONIA
5099394;;M;79;CHILENO;;Silencioso;RENCA                         ;METROPOLITANA;54410;2;1;0;0;0;2;1;54410;CELULAR BMOBILE C40 CRIS OPEN;TELEFONIA
16088639;;M;36;CHILENO;;Millenial;N/D;N/D;637070;9;4;1;1;399990;8;3;237080;CELULAR XIAOMI 11T PRO 8/256GB CELESTIAL BLUE OP;TELEFONIA
14210143;;M;41;CHILENO;;X;RENCA                         ;METROPOLITANA;673970;3;2;3;2;673970;0;0;0;CELULAR GALAXY A22 5G 4+128GB GRAY;TELEFONIA
19293529;;M;25;CHILENO;;Z;LOS ANGELES;BIO-BIO;219990;1;1;1;1;219990;0;0;0;CELULAR SAMSUNG A52s 128GB BLACK CLARO;TELEFONIA
10814255;;F;55;CHILENO;;Boomers;ANTOFAGASTA                   ;ANTOFAGASTA;692960;4;3;4;3;692960;0;0;0;CELULAR GALAXY A22 5G 4+128GB GRAY;TELEFONIA
10913972;Soltero;M;55;CHILENO;;Boomers;RENCA                         ;METROPOLITANA;198120;3;1;0;0;0;3;1;198120;CELULAR REDMI NOTE 10 5G 4/128GB GRAPHITE GRAY O;TELEFONIA
13632116;Casado;M;45;CHILENO;;X;RENCA                         ;METROPOLITANA;99990;1;1;0;0;0;1;1;99990;CELULAR XIAOMI REDMI 9C 64GB GRAY WOM;TELEFONIA
15983961;;F;37;CHILENO;;Millenial;SAN CARLOS                    ;BIO BIO;214980;2;2;1;1;169990;1;1;44990;CELULAR A52 128 GB BLUE OPEN;TELEFONIA
14382619;;M;42;CHILENO;;X;SAN BERNARDO                  ;METROPOLITANA;269980;3;2;2;1;169990;1;1;99990;CELULAR A52 128 GB BLACK OPEN;TELEFONIA
16846952;;M;33;CHILENO;;Millenial;PROVIDENCIA                   ;METROPOLITANA;955980;2;1;2;1;955980;0;0;0;CELULAR IPHONE 13 PRO 256GB GRAFITO CLARO;TELEFONIA
16504799;;M;35;CHILENO;;Millenial;LOS VILOS                     ;COQUIMBO;923520;3;3;3;1;357970;0;2;565550;Celular Galaxy S21 Plus Phantom Silver 128GB;TELEFONIA
16317670;Soltero;M;36;CHILENO;;Millenial;PUENTE ALTO                   ;METROPOLITANA;259990;1;1;1;1;259990;0;0;0;CELULAR GALAXY A53 5G 6+128GB BLUE;TELEFONIA
6661029;Divorciado;F;62;CHILENO;INGENIERO CIVIL QUIMICO;Boomers;PROVIDENCIA                   ;METROPOLITANA;259990;1;1;1;1;259990;0;0;0;CELULAR GALAXY A53 5G 6+128GB BLACK;TELEFONIA
17007678;;M;33;CHILENO;;Millenial;PROVIDENCIA                   ;METROPOLITANA;54410;2;1;0;0;0;2;1;54410;CELULAR BMOBILE C40 CRIS OPEN;TELEFONIA
18377908;Soltero;F;28;CHILENO;;Silencioso;PROVIDENCIA                   ;METROPOLITANA;1003980;2;1;2;1;1003980;0;0;0;CELULAR IPHONE 13 PRO 256GB GRAFITO CLARO;TELEFONIA
20354873;;F;22;CHILENO;;Z;TEMUCO;ARAUCANIA;99990;2;1;0;0;0;2;1;99990;CELULAR A16 PEARL BLUE 64GB;TELEFONIA
18361781;;M;28;CHILENO;;Millenial;N/D;N/D;1061510;7;2;7;2;1061510;0;0;0;CELULAR XIAOMI 12 PRO 5G 8GB+256GB PURPLE BUNDLE;TELEFONIA
24043392;;F;41;PERUANO;;Extranjero;SANTIAGO                      ;METROPOLITANA;149990;2;1;2;1;149990;0;0;0;CELULAR GALAXY A22 5G 4+128GB GRAY;TELEFONIA
26429418;Soltero;M;33;EXTRANJERO - NO INFORMA NACIONALIDAD;;Extranjero;"";"";206970;4;3;1;1;59990;3;2;146980;SMARTPHONE A03S 64 GB NEGRO;TELEFONIA
11926030;;M;49;CHILENO;;X;PUERTO MONTT                  ;LOS LAGOS;159990;10;2;0;0;0;10;2;159990;CELULAR SMARTPHONE BMOBIL AX1076 PRO BLACK TRI W;TELEFONIA
9752443;;F;58;CHILENO;;Boomers;RENCA                         ;METROPOLITANA;35990;2;1;0;0;0;2;1;35990;CELULAR BMOBILE BS30 BLACK OPEN;TELEFONIA
19696262;;M;25;CHILENO;;Z;TALCA                         ;MAULE;259700;4;1;0;0;0;4;1;259700;CELULAR REDMI NOTE 11 4/128GB GRAPHITE GRAY OPEN;TELEFONIA
15448710;;M;39;CHILENO;;X;LA CISTERNA;METROPOLITANA;310130;3;2;0;0;0;3;2;310130;SMARTPHONE A52S 5G WHITE 128GB;TELEFONIA
6335329;;M;70;CHILENO;;Silencioso;SAN FELIPE                    ;VALPARAISO;234960;6;4;0;0;0;6;4;234960;CELULAR XIAOMI REDMI 9A 32GB GRANITE GRAY TRI WO;TELEFONIA
25467450;;F;39;VENEZOLANO;;Extranjero;SANTIAGO                      ;METROPOLITANA;139990;1;1;1;1;139990;0;0;0;CELULAR REDMI NOTE 11 4/128GB GRAPHITE GRAY OPEN;TELEFONIA
19005566;;F;27;CHILENO;;Z;"";"";69990;1;1;1;1;69990;0;0;0;CELULAR XIAOMI REDMI 9A 2/32GB GRANITE GRAY;TELEFONIA
16298904;;M;36;CHILENO;;Millenial;TALCA                         ;MAULE;149990;1;1;1;1;149990;0;0;0;CELULAR GALAXY A22 5G 4+128GB GRAY;TELEFONIA
14418738;;F;53;CHILENO;;X;SAN JOAQUIN                   ;METROPOLITANA;611490;4;2;0;0;0;4;2;611490;CELULAR VIVO Y15S WAVE GREEN OPEN;TELEFONIA
7997857;;M;62;CHILENO;;Boomers;CORONEL                       ;BIO BIO;134990;1;1;1;1;134990;0;0;0;CELULAR GALAXY A22 5G 4+128GB GRAY;TELEFONIA
25710398;Soltero;F;32;VENEZOLANO;;Extranjero;PROVIDENCIA                   ;METROPOLITANA;89990;1;1;1;1;89990;0;0;0;CELULAR CLARO MOTOROLA E7 32GB GRIS;TELEFONIA
18401266;;F;29;CHILENO;;Millenial;PAINE                         ;METROPOLITANA;59980;3;2;1;1;49990;2;1;9990;CELULAR REDMI 9A 32GB SKY BLUE;TELEFONIA
14465908;;M;45;CHILENO;;X;MARIA PINTO                   ;METROPOLITANA;359980;2;2;0;0;0;2;2;359980;CELULAR A52 128 GB WHITE OPEN;TELEFONIA
16837790;;F;34;CHILENO;;Millenial;N/D;N/D;1070930;8;5;6;3;670950;2;2;399980;CELULAR SAMSUNG S21 FE 128GB GRAY OPEN;TELEFONIA
7552022;Casado;M;66;CHILENO;CONTADOR GENERAL;Boomers;PROVIDENCIA                   ;METROPOLITANA;169990;3;1;3;1;169990;0;0;0;CELULAR GALAXY A22 5G 4+128GB GRAY;TELEFONIA
19678541;;M;24;CHILENO;;Z;PROVIDENCIA                   ;METROPOLITANA;347970;3;3;1;1;219990;2;2;127980;CELULAR SAMSUNG A52s 128GB BLACK CLARO;TELEFONIA
7602056;Casado;M;66;CHILENO;;Boomers;LAS CABRAS                    ;L.G.B.OÂ´HIGGINS;124880;2;1;0;0;0;2;1;124880;CELULAR REDMI 9C 64GB MIDNIGHT GRAY MOVISTAR;TELEFONIA
15319918;;M;44;CHILENO;;X;CHILLAN                       ;BIO BIO;955980;2;1;2;1;955980;0;0;0;CELULAR IPHONE 13 PRO 256GB GRAFITO CLARO;TELEFONIA
10760915;;F;52;CHILENO;;X;LOS ALAMOS                    ;BIO BIO;94541;2;1;0;0;0;2;1;94541;CELULAR GALAXY A03 CORE 2GB 32GB BLACK OPEN;TELEFONIA
9755098;;M;57;CHILENO;;Boomers;PROVIDENCIA                   ;METROPOLITANA;27990;1;1;0;0;0;1;1;27990;CELULAR BMOBILE BS30 BLACK OPEN;TELEFONIA
15335294;;F;40;CHILENO;;X;VICTORIA                      ;ARAUCANIA;471960;4;3;1;1;199990;3;2;271970;CELULAR A52 128 GB WHITE OPEN;TELEFONIA
14190806;;M;41;CHILENO;;X;CUNCO                         ;ARAUCANIA;119990;1;1;0;0;0;1;1;119990;CELULAR XIAOMI REDMI 9C 64GB GRAY WOM;TELEFONIA
8984431;;F;62;CHILENO;;Boomers;ARICA                         ;ARICA Y PARINACOTA;381760;2;1;0;0;0;2;1;381760;CELULAR SMARTPHONE A52S 5G LIGHT VIOLET 128GB;TELEFONIA
9260060;Soltero;M;60;CHILENO;AGROINDUSTRIA;Boomers;PROVIDENCIA                   ;METROPOLITANA;109990;1;1;0;0;0;1;1;109990;CELULAR VIVO Y11S PHANTON BLACK 32GB MOVISTAR;TELEFONIA
18430236;;M;29;CHILENO;;Millenial;"";"";189990;2;1;0;0;0;2;1;189990;POCO X3 PRO 256 GB PHANTOM BLACK;TELEFONIA
18763282;;F;27;CHILENO;;Millenial;SAN CARLOS                    ;BIO BIO;29990;1;1;0;0;0;1;1;29990;CELULAR ALCATEL P1 DIRECTO CLARO BLACK;TELEFONIA
23918354;;F;46;DOMINICANO;;Extranjero;DIEGO DE ALMAGRO              ;ATACAMA;341970;4;2;4;2;341970;0;0;0;CELULAR A52 128 GB LIGHT VIOLET OPEN;TELEFONIA
20116020;;F;23;CHILENO;;Z;ANTUCO;BIO-BIO;254321;10;5;0;0;0;10;5;254321;CELULAR BMOBILE BS30 BLACK OPEN;TELEFONIA
13450544;Casado;M;44;CHILENO;DIBUJANTE TECNICO;X;RENCA                         ;METROPOLITANA;303980;2;1;2;1;303980;0;0;0;CELULAR IPHONE SE 64GB DIRECTO CLARO;TELEFONIA
16852635;;F;33;CHILENO;;Millenial;PROVIDENCIA                   ;METROPOLITANA;91990;2;1;0;0;0;2;1;91990;CELULAR VIVO Y20 BLACK 64GB MOVISTAR;TELEFONIA
6973869;Casado;M;69;CHILENO;;Silencioso;PROVIDENCIA                   ;METROPOLITANA;17990;1;1;1;1;17990;0;0;0;CELULAR NOKIA 110 BLACK OPEN;TELEFONIA
12965807;;M;45;CHILENO;;X;PARRAL                        ;MAULE;157640;2;1;0;0;0;2;1;157640;CELULAR GALAXY A03 4+64GB BLACK OPEN;TELEFONIA
4987037;;M;79;CHILENO;;Silencioso;CAUQUENES                     ;MAULE;786940;6;3;0;0;0;6;3;786940;CELULAR REDMI 9C 64GB MIDNIGHT GRAY MOVISTAR;TELEFONIA
15830239;;M;37;CHILENO;;Millenial;PROVIDENCIA                   ;METROPOLITANA;614960;4;3;4;3;614960;0;0;0;CELULAR REDMI NOTE 11 4/128GB TWILIGHT BLUE OPEN;TELEFONIA
18181229;;M;30;CHILENO;;Millenial;NATALES                       ;MAGALLANES;301960;4;4;0;0;0;4;4;301960;CELULAR REDMI NOTE 11 4/128GB GRAPHITE GRAY OPEN;TELEFONIA
9853853;;F;61;CHILENO;;Boomers;VICUNA                        ;COQUIMBO;254970;3;4;0;0;0;3;4;254970;CELULAR A52 128 GB WHITE OPEN;TELEFONIA
17209088;Soltero;F;33;CHILENO;TECNICO DE NIVEL SUPERIOR EN ENFERMERIA;Silencioso;PROVIDENCIA                   ;METROPOLITANA;184990;2;1;0;0;0;2;1;184990;CELULAR MOTO G60S 6/128 GB AZUL;TELEFONIA
26183262;;M;34;VENEZOLANO;;Extranjero;ESTACION CENTRAL              ;METROPOLITANA;113980;2;1;2;1;113980;0;0;0;CELULAR VIVO Y11S 32GB NEBULA BLUE OPEN;TELEFONIA
10616901;;F;56;CHILENO;;Boomers;RANCAGUA                      ;L.G.B.OÂ´HIGGINS;303970;3;2;0;0;0;3;2;303970;Celular SA3 CLARO DIRECTO BLACK;TELEFONIA
7653175;Casado;F;67;CHILENO;;Boomers;PROVIDENCIA                   ;METROPOLITANA;29991;2;1;0;0;0;2;1;29991;CELULAR BMOBILE BS30 BLACK OPEN;TELEFONIA
17999055;;M;29;CHILENO;;Millenial;LA SERENA;COQUIMBO;170000;2;1;0;0;0;2;1;170000;CELULAR XIAOMI REDMI NOTE 10S BLANCO WOM;TELEFONIA
7274124;;F;68;CHILENO;;Silencioso;CARAHUE                       ;ARAUCANIA;283460;4;2;0;0;0;4;2;283460;CELULAR XIAOMI REDMI 9C 64GB GRAY WOM;TELEFONIA
10503662;Casado;F;56;CHILENO;CONTADOR AUDITOR;Boomers;PROVIDENCIA                   ;METROPOLITANA;554980;2;1;2;1;554980;0;0;0;Galaxy Z Flip3 128GB LAVENDER;TELEFONIA
12712895;;F;48;CHILENO;;X;EL BOSQUE                     ;METROPOLITANA;563060;3;2;0;0;0;3;2;563060;CELULAR VIVO Y53S FANTASTIC RAINBOW 128GB OPEN;TELEFONIA
13829858;;F;42;CHILENO;;X;PROVIDENCIA                   ;METROPOLITANA;419990;1;1;0;0;0;1;1;419990;CELULAR GALAXY A53 5G 6+128GB ORANGE;TELEFONIA
17521565;;F;31;CHILENO;;Millenial;N/D;N/D;850091;9;4;0;0;0;9;4;850091;CELULAR SMARTPHONE A52S 5G BLACK 128GB;TELEFONIA
10517322;;M;54;CHILENO;;Boomers;N/D;N/D;273980;2;1;2;1;273980;0;0;0;CELULAR SMARTPHONE A52S 5G BLACK 128GB;TELEFONIA
6934012;;M;67;CHILENO;;Boomers;RENGO                         ;L.G.B.OÂ´HIGGINS;39990;1;1;0;0;0;1;1;39990;CELULAR BMOBILE C40 CRIS OPEN;TELEFONIA
17990088;;M;30;CHILENO;;Millenial;"";"";159990;1;1;1;1;159990;0;0;0;CELULAR GALAXY A22 5G 4+128GB GRAY;TELEFONIA
16003890;;M;36;CHILENO;;Millenial;TALCA                         ;MAULE;209990;1;3;3;2;455470;-2;1;-245480;CELULAR A52 128 GB BLACK OPEN;TELEFONIA
19558175;;F;25;CHILENO;;Z;"";"";79990;1;1;0;0;0;1;1;79990;CELULAR XIAOMI REDMI 9A 32GB VERDE CLARO;TELEFONIA
17828503;Soltero;M;31;CHILENO;;Millenial;PROVIDENCIA                   ;METROPOLITANA;85980;2;1;2;1;85980;0;0;0;CELULAR XIAOMI REDMI 9A SE 2/32GB GB PEACOCK GRE;TELEFONIA
9302355;;F;60;CHILENO;;Boomers;RENCA                         ;METROPOLITANA;187640;2;1;0;0;0;2;1;187640;CELULAR MOTO G30 GRIS TORNASOL 128GB MOVISTAR;TELEFONIA
12952191;;M;46;CHILENO;;X;HIJUELAS                      ;VALPARAISO;119990;1;1;0;0;0;1;1;119990;CELULAR XIAOMI REDMI 9 64GB DIRECTO CLARO MORADO;TELEFONIA
11466195;;F;53;CHILENO;;X;PUENTE ALTO                   ;METROPOLITANA;629960;4;2;4;2;629960;0;0;0;CELULAR A52 128 GB BLUE OPEN;TELEFONIA
25749779;;M;44;VENEZOLANO;;Extranjero;SANTIAGO                      ;METROPOLITANA;651980;3;1;3;1;651980;0;0;0;Galaxy Z Flip3 128GB LAVENDER;TELEFONIA
9333904;;F;59;CHILENO;;Boomers;TALCA                         ;MAULE;199990;1;1;0;0;0;1;1;199990;CELULAR A52 128 GB BLACK OPEN;TELEFONIA
10541403;;F;56;CHILENO;;Boomers;RENCA                         ;METROPOLITANA;199990;1;1;1;1;199990;0;0;0;CELULAR HUAWEI NOVA 8i BLUE;TELEFONIA
25172102;;F;32;COLOMBIANO;;Extranjero;N/D;N/D;220470;3;2;2;1;190480;1;1;29990;CELULAR REDMI NOTE 11 GRAPHITE GRAY + REDMI BUDS;TELEFONIA
9652954;;M;60;CHILENO;;Boomers;SAN CARLOS                    ;BIO BIO;137489;2;1;0;0;0;2;1;137489;CELULAR VIVO Y21S MIDNIGHT BLUE 128 GB OPEN;TELEFONIA
14202232;;F;41;CHILENO;;X;DONIHUE                       ;L.G.B.OÂ´HIGGINS;887980;13;6;13;6;887980;0;0;0;CELULAR GALAXY A22 5G 4+128GB GRAY;TELEFONIA
12544539;;M;48;CHILENO;;X;LONGAVI                       ;MAULE;42190;2;1;0;0;0;2;1;42190;CELULAR BMOBILE BS30 BLACK OPEN;TELEFONIA
15071046;;F;38;CHILENO;;X;PROVIDENCIA                   ;METROPOLITANA;589950;5;4;2;1;324980;3;3;264970;CELULAR GALAXY A03 CORE 2GB 32GB BLACK OPEN;TELEFONIA
16389738;;F;36;CHILENO;;Millenial;N/D;N/D;146950;3;1;0;0;0;3;1;146950;CELULAR VIVO Y11S NEGRO WOM;TELEFONIA
5809946;Casado;F;70;CHILENO;;Silencioso;LAMPA                         ;METROPOLITANA;89990;1;1;0;0;0;1;1;89990;CELULAR GALAXY A03 CORE 2GB 32GB BLUE OPEN;TELEFONIA
25503595;;F;46;BOLIVIANO;;Extranjero;RECOLETA                      ;METROPOLITANA;205970;4;3;0;0;0;4;3;205970;CELULAR REDMI NOTE 10S 128GB OCEAN BLUE;TELEFONIA
8588773;;F;61;CHILENO;;Boomers;SAN CLEMENTE                  ;MAULE;404161;6;3;0;0;0;6;3;404161;CELULAR BMOBILE BS30 BLACK OPEN;TELEFONIA
12541359;;F;49;CHILENO;;X;COIHAIQUE                     ;AYSEN;169990;1;1;0;0;0;1;1;169990;CELULAR XIAOMI REDMI NOTE 10S BLANCO WOM;TELEFONIA
11095083;;F;55;CHILENO;;Boomers;MULCHEN                       ;BIO BIO;129990;2;1;0;0;0;2;1;129990;CELULAR GALAXY A22 5G 4+128GB GRAY;TELEFONIA
16076294;;F;36;CHILENO;;Millenial;N/D;N/D;187730;2;1;0;0;0;2;1;187730;CELULAR A54 OPPO NEGRO 128GB;TELEFONIA
24626462;;F;49;BOLIVIANO;;Extranjero;PAINE                         ;METROPOLITANA;209981;4;2;0;0;0;4;2;209981;CELULAR VIVO Y20S NEBULA 128 GB BLUE OPEN;TELEFONIA
11783990;;M;51;CHILENO;;X;SALAMANCA                     ;COQUIMBO;189990;1;1;0;0;0;1;1;189990;CELULAR MOTO G60 4/128 GB SILVER OPEN;TELEFONIA
19058665;Soltero;M;27;CHILENO;;Z;LLANQUIHUE;LOS LAGOS;179990;1;1;1;1;179990;0;0;0;CELULAR REDMI NOTE 11 GRAPHITE GRAY + REDMI BUDS;TELEFONIA
8177283;Casado;F;63;CHILENO;PROFESOR;Boomers;RENCA                         ;METROPOLITANA;279990;1;1;0;0;0;1;1;279990;CELULAR SMARTPHONE A52S 5G BLACK 128GB;TELEFONIA
18671066;;M;28;CHILENO;;Millenial;CANETE                        ;BIO BIO;219990;1;1;0;0;0;1;1;219990;CELULAR A52 128 GB BLACK OPEN;TELEFONIA
13512188;;M;46;CHILENO;;X;CORONEL                       ;BIO BIO;33990;1;1;0;0;0;1;1;33990;Celular SA3 CLARO DIRECTO BLACK;TELEFONIA
16992442;;M;33;CHILENO;;Silencioso;PROVIDENCIA                   ;METROPOLITANA;407980;2;1;2;1;407980;0;0;0;SMARTPHONE RENO 6 STELLAR BLACK 128GB;TELEFONIA
13575296;;M;43;CHILENO;;X;SAN JAVIER                    ;MAULE;262980;2;1;0;0;0;2;1;262980;CELULAR A32 128 GB BLACK OPEN;TELEFONIA
8367398;;M;62;CHILENO;;Boomers;N/D;N/D;334990;2;1;0;0;0;2;1;334990;CELULAR XIAOMI 11T 8/256GB METEORITE GRAY OPEN;TELEFONIA
9793246;;M;59;CHILENO;;Boomers;RENCA                         ;METROPOLITANA;219990;1;1;0;0;0;1;1;219990;CELULAR A52 128 GB BLACK OPEN;TELEFONIA
18526477;;F;27;CHILENO;;Millenial;N/D;N/D;421960;4;3;4;3;421960;0;0;0;CELULAR REDMI 9A 32GB SKY BLUE;TELEFONIA
15007114;Soltero;M;39;CHILENO;;X;"";"";74991;2;1;0;0;0;2;1;74991;CELULAR AZUMI V60 DUAL OPEN;TELEFONIA
6436736;;F;72;CHILENO;;Silencioso;PROVIDENCIA                   ;METROPOLITANA;164220;3;2;0;0;0;3;2;164220;CELULAR BMOBILE C40 CRIS OPEN;TELEFONIA
13142992;;F;45;CHILENO;;X;TUCAPEL                       ;BIO BIO;259980;2;2;0;0;0;2;2;259980;CELULAR GALAXY A22 5G 4+128GB GRAY;TELEFONIA
24474069;Soltero;M;32;VENEZOLANO;;Extranjero;PROVIDENCIA                   ;METROPOLITANA;113980;2;1;2;1;113980;0;0;0;CELULAR A16 PEARL BLUE 64GB;TELEFONIA
9081425;;M;61;CHILENO;;Boomers;TALCA                         ;MAULE;74990;2;1;0;0;0;2;1;74990;SMARTPHONE A03S 64 GB NEGRO;TELEFONIA
5933958;;M;75;CHILENO;;Silencioso;RENCA                         ;METROPOLITANA;104501;3;1;0;0;0;3;1;104501;CELULAR XIAOMI REDMI 9A 2/32GB GRANITE GRAY;TELEFONIA
10349510;;F;57;CHILENO;;Boomers;N/D;N/D;483980;2;1;2;1;483980;0;0;0;CELULAR XIAOMI 11T PRO 8/256GB CELESTIAL BLUE KI;TELEFONIA
8066480;;F;66;CHILENO;;Boomers;RANCAGUA                      ;L.G.B.OÂ´HIGGINS;95450;3;2;0;0;0;3;2;95450;Celular SA3 CLARO DIRECTO BLACK;TELEFONIA
11771816;;F;50;CHILENO;;X;SAN CARLOS                    ;BIO BIO;480940;6;6;0;0;0;6;6;480940;CELULAR GALAXY A03 CORE 2GB 32GB BLACK OPEN;TELEFONIA
17886085;;M;31;CHILENO;;Millenial;N/D;N/D;129990;2;1;0;0;0;2;1;129990;CELULAR GALAXY A22 5G 4+128GB GRAY;TELEFONIA
11612138;;F;52;CHILENO;;X;ARICA                         ;TARAPACA;249990;1;1;0;0;0;1;1;249990;CELULAR SMARTPHONE A52S 5G BLACK 128GB;TELEFONIA
12177499;;F;50;CHILENO;;X;EL MONTE                      ;METROPOLITANA;688190;5;2;0;0;0;5;2;688190;CELULAR GALAXY A22 5G 4+128GB GRAY;TELEFONIA
18477950;Soltero;F;28;CHILENO;;Millenial;PROVIDENCIA                   ;METROPOLITANA;69990;1;1;1;1;69990;0;0;0;CELULAR GALAXY A03 CORE 2GB 32GB BLACK OPEN;TELEFONIA
7906388;;F;66;CHILENO;;Boomers;TEMUCO                        ;ARAUCANIA;134981;5;2;0;0;0;5;2;134981;CELULAR XIAOMI REDMI 9A SE 2/32GB GB PEACOCK GRE;TELEFONIA
8029885;;M;63;CHILENO;;Boomers;MAIPU                         ;METROPOLITANA;129990;2;1;0;0;0;2;1;129990;CELULAR VIVO Y21S PEARL WHITE 128 GB OPEN;TELEFONIA
15847603;;M;38;CHILENO;;Millenial;PUERTO MONTT                  ;LOS LAGOS;813690;7;4;2;1;615980;5;3;197710;CELULAR REDMI NOTE 11 4/128GB TWILIGHT BLUE OPEN;TELEFONIA
9556574;Viudo;M;58;CHILENO;;Boomers;RENCA                         ;METROPOLITANA;164990;2;1;0;0;0;2;1;164990;CELULAR A52 128 GB BLACK OPEN;TELEFONIA
26709934;;M;39;VENEZOLANO;;Extranjero;RANCAGUA                      ;L.G.B.OÂ´HIGGINS;219980;2;2;0;0;0;2;2;219980;CELULAR GALAXY A03 4+64GB BLUE OPEN;TELEFONIA
6839604;;M;66;CHILENO;;Boomers;PROVIDENCIA                   ;METROPOLITANA;229990;1;1;1;1;229990;0;0;0;CELULAR HUAWEI NOVA 8i BUNDLE;TELEFONIA
9050577;;M;61;CHILENO;;Boomers;CATEMU                        ;VALPARAISO;821570;5;3;0;0;0;5;3;821570;CELULAR GALAXY A03 CORE 2GB 32GB BLACK OPEN;TELEFONIA
16779667;;F;34;CHILENO;;Millenial;ANCUD;LOS LAGOS;420290;5;3;2;1;68540;3;2;351750;CELULAR A52 128 GB LIGHT VIOLET OPEN;TELEFONIA
15299944;;M;40;CHILENO;;X;PROVIDENCIA                   ;METROPOLITANA;34630;3;1;0;0;0;3;1;34630;Celular SA3 CLARO DIRECTO BLACK;TELEFONIA
6079122;;F;70;CHILENO;;Silencioso;PUERTO MONTT                  ;LOS LAGOS;442950;5;4;2;1;179980;3;3;262970;CELULAR GALAXY A22 5G 4+128GB GRAY;TELEFONIA
5811279;;F;76;CHILENO;;Silencioso;CONCHALI                      ;METROPOLITANA;54230;2;1;0;0;0;2;1;54230;CELULAR BMOBILE C40 CRIS OPEN;TELEFONIA
7324484;Casado;M;68;CHILENO;;Silencioso;CERRO NAVIA                   ;METROPOLITANA;203930;2;1;0;0;0;2;1;203930;CELULAR VIVO Y20S NEBULA 128 GB BLUE OPEN;TELEFONIA
16091128;;M;37;CHILENO;;Millenial;"";"";99990;1;3;0;0;0;1;3;99990;CELULAR VIVO Y11S NEGRO WOM;TELEFONIA
19097222;;F;27;CHILENO;;Extranjero;CHILLAN                       ;BIO BIO;279990;1;1;1;1;279990;0;0;0;SMARTPHONE A52S 5G WHITE 128GB;TELEFONIA
12036595;;M;48;CHILENO;;X;VILLARICA                     ;ARAUCANIA;149990;2;1;0;0;0;2;1;149990;CELULAR REDMI NOTE 11 4/128GB GRAPHITE GRAY OPEN;TELEFONIA
20611026;;M;21;CHILENO;;Z;PROVIDENCIA                   ;METROPOLITANA;557980;2;1;2;1;557980;0;0;0;IPHONE 11 128GB BLACK CLARO;TELEFONIA
11415962;;M;52;CHILENO;;X;RENCA                         ;METROPOLITANA;139990;1;1;0;0;0;1;1;139990;CELULAR MOTO ONE FUSION 128GB AZUL OPEN;TELEFONIA
13656570;;F;43;CHILENO;;X;QUINTA NORMAL                 ;METROPOLITANA;1007940;7;3;7;3;1007940;0;0;0;CELULAR GALAXY S22 PINK GOLD 128GB;TELEFONIA
16178325;;M;36;CHILENO;;Millenial;PROVIDENCIA                   ;METROPOLITANA;444960;4;2;4;2;444960;0;0;0;CELULAR REDMI NOTE 11 4/128GB GRAPHITE GRAY OPEN;TELEFONIA
12324490;;M;49;CHILENO;;X;LAJA                          ;BIO BIO;235980;2;1;2;1;235980;0;0;0;CELULAR A52 128 GB BLACK OPEN;TELEFONIA
5530897;Viudo;F;73;CHILENO;;Silencioso;RENCA                         ;METROPOLITANA;119990;1;1;0;0;0;1;1;119990;CELULAR GALAXY A03 4+64GB BLUE OPEN;TELEFONIA
7343137;;F;69;CHILENO;;Silencioso;TEMUCO                        ;ARAUCANIA;426950;6;6;0;0;0;6;6;426950;CELULAR A12 128GB Rojo OPEN;TELEFONIA
13345743;;F;44;CHILENO;;X;RENCA                         ;METROPOLITANA;0;0;2;0;0;0;0;2;0;CELULAR MOTO E7 32GB GRIS OPEN;TELEFONIA
8140633;;M;61;CHILENO;;Boomers;CALBUCO                       ;LOS LAGOS;758970;4;1;0;0;0;4;1;758970;CELULAR GALAXY S22 GREEN 128GB;TELEFONIA
5776287;;F;74;CHILENO;;Silencioso;"";"";562970;3;2;0;0;0;3;2;562970;CELULAR IPHONE SE 64GB DIRECTO CLARO;TELEFONIA
19565596;;F;25;CHILENO;;Z;PROVIDENCIA                   ;METROPOLITANA;199990;1;1;0;0;0;1;1;199990;CELULAR MOTO G60S 6/128 GB AZUL;TELEFONIA
20115658;;F;23;CHILENO;;Z;PROVIDENCIA                   ;METROPOLITANA;205480;2;1;2;1;205480;0;0;0;CELULAR A32 128 GB WHITE OPEN;TELEFONIA
9613488;;F;60;CHILENO;;Boomers;MAIPU                         ;METROPOLITANA;232970;3;3;0;0;0;3;3;232970;CELULAR XIAOMI REDMI 9A 2/32GB GRANITE GRAY;TELEFONIA
12204213;;F;50;CHILENO;;X;LA SERENA                     ;COQUIMBO;184970;3;1;0;0;0;3;1;184970;CELULAR VIVO Y20 NEBULA BLUE OPEN;TELEFONIA
20077806;;F;23;CHILENO;;Z;PROVIDENCIA                   ;METROPOLITANA;41980;2;1;2;1;41980;0;0;0;CELULAR ALCATEL P1 3080 BLACK MOVISTAR DIRECTO;TELEFONIA
17146190;;F;32;CHILENO;;Millenial;CHANCO                        ;MAULE;354980;3;2;0;0;0;3;2;354980;CELULAR A12 128GB Azul OPEN;TELEFONIA
11057148;;F;55;CHILENO;;Boomers;RENCA                         ;METROPOLITANA;521520;4;2;4;2;521520;0;0;0;CELULAR SMARTPHONE A52S 5G LIGHT VIOLET 128GB;TELEFONIA
11257201;;M;53;CHILENO;;X;CHILLAN;BIO-BIO;299980;2;2;0;0;0;2;2;299980;CELULAR GALAXY A03 4+128GB BLUE OPEN;TELEFONIA
18165049;Soltero;M;29;CHILENO;;Millenial;ALTO HOSPICIO;TARAPACA;279980;2;2;2;2;279980;0;0;0;CELULAR A12 128GB Negro OPEN;TELEFONIA
12750085;;F;47;CHILENO;;X;ALGARROBO                     ;VALPARAISO;119990;1;1;0;0;0;1;1;119990;CELULAR MOTOROLA MOTO G20 64GB ROSA FLAMINGO;TELEFONIA
10773764;;F;55;CHILENO;;Boomers;N/D;N/D;399980;2;1;0;0;0;2;1;399980;CELULAR VIVO Y21S MIDNIGHT BLUE 128 GB OPEN;TELEFONIA
11788518;;M;51;CHILENO;;X;PARRAL                        ;MAULE;1009960;5;4;0;0;0;5;4;1009960;SMARTPHONE A03s 64 GB Red DS;TELEFONIA
15826591;;M;37;CHILENO;;Millenial;TALCA                         ;MAULE;119990;1;1;1;1;119990;0;0;0;CELULAR A12 128GB Negro OPEN;TELEFONIA
18718189;;M;27;CHILENO;;Extranjero;BUIN                          ;METROPOLITANA;203980;2;1;2;1;203980;0;0;0;CELULAR POCO X3 PRO 128G PHANTOM BLACK OPEN;TELEFONIA
10238618;;M;56;CHILENO;;Boomers;MELIPILLA                     ;METROPOLITANA;456960;4;3;0;0;0;4;3;456960;CELULAR MOTO G60S 6/128 GB AZUL;TELEFONIA
18487587;Soltero;M;30;CHILENO;;Millenial;MELIPILLA                     ;METROPOLITANA;252980;2;1;0;0;0;2;1;252980;CELULAR RENO5 LITE VIOLETA 128GB;TELEFONIA
11737738;;M;51;CHILENO;;X;RENCA                         ;METROPOLITANA;99990;1;1;0;0;0;1;1;99990;CELULAR REDMI 9C 64GB MIDNIGHT GRAY MOVISTAR;TELEFONIA
9221911;;F;60;CHILENO;;Boomers;LA PINTANA                    ;METROPOLITANA;406970;4;2;0;0;0;4;2;406970;CELULAR MOTO E7 32GB GRIS OPEN;TELEFONIA
10300004;;F;49;CHILENO;;X;PUCON                         ;ARAUCANIA;179990;1;1;0;0;0;1;1;179990;SMARTPHONE A22 BLANCO 128GB;TELEFONIA
8284650;;F;65;CHILENO;;Boomers;LA SERENA                     ;COQUIMBO;119991;2;1;0;0;0;2;1;119991;CELULAR VIVO Y20S NEBULA 128 GB BLUE OPEN;TELEFONIA
27042771;;M;33;VENEZOLANO;;Extranjero;N/D;N/D;769970;3;3;0;0;0;3;3;769970;CELULAR GALAXY S20FE 128GB CLOUD LAVENDER OPEN;TELEFONIA
19632011;;F;26;CHILENO;;Z;PROVIDENCIA                   ;METROPOLITANA;203980;2;1;2;1;203980;0;0;0;CELULAR MOTO G60S 6/128 GB AZUL;TELEFONIA
18807621;Soltero;M;28;CHILENO;;Millenial;PROVIDENCIA                   ;METROPOLITANA;465980;2;1;2;1;465980;0;0;0;CELULAR SAMSUNG S21 FE 128GB LIGHT GREEN OPEN;TELEFONIA
10345706;;F;58;CHILENO;;Boomers;PUENTE ALTO                   ;METROPOLITANA;199991;2;1;0;0;0;2;1;199991;CELULAR A32 128 GB BLACK OPEN;TELEFONIA
19805634;;F;24;CHILENO;;Z;TALCA                         ;MAULE;179980;2;2;0;0;0;2;2;179980;CELULAR XIAOMI REDMI 9 MORADO ENTEL;TELEFONIA
7168054;;F;67;CHILENO;;Boomers;CURICO                        ;MAULE;99990;1;1;0;0;0;1;1;99990;CELULAR GALAXY A03 CORE 2GB 32GB BLUE OPEN;TELEFONIA
13663521;;M;44;CHILENO;;X;MAIPU                         ;METROPOLITANA;529990;1;1;1;1;529990;0;0;0;IPHONE 11 128GB BLACK CLARO;TELEFONIA
23512410;;M;40;BOLIVIANO;;Extranjero;CALAMA                        ;ANTOFAGASTA;554950;6;3;0;0;0;6;3;554950;SMARTPHONE A03S 64 GB NEGRO;TELEFONIA
13358580;;F;45;CHILENO;;X;MAIPU                         ;METROPOLITANA;1356710;8;3;0;0;0;8;3;1356710;CELULAR SAMSUNG S21 FE 128GB WHITE OPEN;TELEFONIA
13038551;;F;45;CHILENO;;X;SALAMANCA                     ;COQUIMBO;170921;9;3;0;0;0;9;3;170921;CELULAR BMOBILE C40 CRIS OPEN;TELEFONIA
19539373;;M;24;CHILENO;;Millenial;PROVIDENCIA                   ;METROPOLITANA;660980;2;1;2;1;660980;0;0;0;CELULAR IPHONE 12 64GB BLACK CLARO;TELEFONIA
11356409;Soltero;F;53;CHILENO;;X;TEMUCO                        ;ARAUCANIA;186980;3;1;0;0;0;3;1;186980;CELULAR A12 128GB Azul OPEN;TELEFONIA
19578972;;F;30;CHILENO;;Millenial;PROVIDENCIA                   ;METROPOLITANA;721350;7;5;0;0;0;7;5;721350;CELULAR AZUMI L4G BLACK CLARO;TELEFONIA
9915275;;F;57;CHILENO;;Boomers;TALCA                         ;MAULE;79990;1;1;0;0;0;1;1;79990;CELULAR XIAOMI REDMI 9A 32GB GRANITE GRAY TRI WO;TELEFONIA
8903634;;F;66;CHILENO;;Boomers;CURACAUTIN                    ;ARAUCANIA;253960;5;2;5;2;253960;0;0;0;CELULAR A12 128GB Rojo OPEN;TELEFONIA
8906538;;M;62;CHILENO;;Boomers;CURANILAHUE                   ;BIO BIO;129990;1;1;0;0;0;1;1;129990;CELULAR MOTO G20 64GB ROSA FLAMINGO OPEN;TELEFONIA
13211131;;F;45;CHILENO;;X;PROVIDENCIA                   ;METROPOLITANA;269990;2;1;0;0;0;2;1;269990;CELULAR XIAOMI 11 LITE 5G NE 8/128GB TRUFFLE BLA;TELEFONIA
7603540;;F;66;CHILENO;;Boomers;LOTA                          ;BIO BIO;642911;11;4;0;0;0;11;4;642911;CELULAR BMOBILE C40 CRIS OPEN;TELEFONIA
8742009;;F;63;CHILENO;;Boomers;LA CRUZ                       ;VALPARAISO;231970;3;2;2;1;216980;1;1;14990;CELULAR POCO X3 PRO 256 GB FROST BLUE;TELEFONIA
18518660;;M;28;CHILENO;;Millenial;TOCOPILLA                     ;ANTOFAGASTA;156970;3;2;0;0;0;3;2;156970;SMARTPHONE A03S NEGRO 32GB;TELEFONIA
15304320;;M;40;CHILENO;;X;COIHAIQUE                     ;AYSEN;79990;1;1;0;0;0;1;1;79990;CELULAR REDMI 9A 32GB PEACOCK GREEN;TELEFONIA
13581713;;F;47;CHILENO;;X;PUCHUNCAVI                    ;VALPARAISO;189970;3;2;0;0;0;3;2;189970;CELULAR VIVO Y11S 32 GB NEBULA BLUE WOM;TELEFONIA
8635642;;F;63;CHILENO;;Boomers;RENGO                         ;L.G.B.OÂ´HIGGINS;14990;1;1;0;0;0;1;1;14990;CELULAR AZUMI L4G BLACK CLARO;TELEFONIA
13606366;;F;43;CHILENO;;X;N/D;N/D;289980;2;2;0;0;0;2;2;289980;CELULAR A12 128GB Negro OPEN;TELEFONIA
15255496;;F;50;CHILENO;;X;RENCA                         ;METROPOLITANA;89991;2;1;0;0;0;2;1;89991;CELULAR XIAOMI REDMI 9A 2/32GB GRANITE GRAY;TELEFONIA
9102480;;F;58;CHILENO;;Boomers;VINA DEL MAR                  ;VALPARAISO;381980;2;3;0;0;0;2;3;381980;CELULAR IPHONE SE 64GB DIRECTO CLARO;TELEFONIA
16070370;;M;37;CHILENO;;Millenial;N/D;N/D;999530;6;4;2;1;550980;4;3;448550;IPHONE 11 64GB BLACK CLARO;TELEFONIA
8910299;;F;60;CHILENO;;Boomers;PROVIDENCIA                   ;METROPOLITANA;43980;2;1;2;1;43980;0;0;0;CELULAR BMOBILE BS30 BLACK OPEN;TELEFONIA
13541605;;F;43;CHILENO;;X;LLAILLAY                      ;VALPARAISO;309990;1;1;0;0;0;1;1;309990;POCO F3 US 256G Deep Ocean Blue ];TELEFONIA
18755109;;F;27;CHILENO;;Z;LA SERENA                     ;COQUIMBO;196960;6;2;0;0;0;6;2;196960;CELULAR VIVO Y11S PHANTON BLACK 32GB MOVISTAR;TELEFONIA
16159021;;F;36;CHILENO;;Millenial;CASTRO                        ;LOS LAGOS;504970;3;2;0;0;0;3;2;504970;CELULAR REDMI NOTE 10S 128GB ONIX BLACK;TELEFONIA
8254587;Casado;M;61;CHILENO;INGENIERO AGRICOLA;Boomers;PROVIDENCIA                   ;METROPOLITANA;39990;1;1;0;0;0;1;1;39990;CELULAR BMOBILE C40 CRIS OPEN;TELEFONIA
18966131;;F;27;CHILENO;;Z;PUREN                         ;ARAUCANIA;617950;5;3;3;1;487970;2;2;129980;CELULAR MOTO G60 4/128 GB SILVER OPEN;TELEFONIA
6253695;;F;69;CHILENO;;Silencioso;PARRAL                        ;MAULE;604951;6;3;0;0;0;6;3;604951;CELULAR A12 128GB Negro OPEN;TELEFONIA
10899957;;M;56;CHILENO;;Boomers;RENCA                         ;METROPOLITANA;164990;2;1;0;0;0;2;1;164990;CELULAR POCO X3 PRO 128 GB FROST BLUE;TELEFONIA
15362702;;F;37;CHILENO;;Millenial;N/D;N/D;899990;4;1;4;1;899990;0;0;0;CELULAR GALAXY S22 WHITE 128GB;TELEFONIA
16531269;;F;35;CHILENO;;Millenial;CAUQUENES                     ;MAULE;1271400;11;5;2;1;261980;9;4;1009420;CELULAR SMARTPHONE A52S 5G LIGHT VIOLET 128GB;TELEFONIA
17766249;Soltero;M;31;CHILENO;;Millenial;PROVIDENCIA                   ;METROPOLITANA;189990;1;1;1;1;189990;0;0;0;CELULAR A32 128 GB BLACK OPEN;TELEFONIA
16505175;;M;35;CHILENO;;Millenial;PROVIDENCIA                   ;METROPOLITANA;325970;3;2;3;2;325970;0;0;0;CELULAR REDMI NOTE 10S 128GB OCEAN BLUE;TELEFONIA
19732506;;F;24;CHILENO;;Z;PROVIDENCIA                   ;METROPOLITANA;107980;2;1;0;0;0;2;1;107980;CELULAR XIAOMI REDMI 9A 32GB BLACK DIRECTO CLARO;TELEFONIA
9727687;;M;58;CHILENO;;Boomers;PROVIDENCIA                   ;METROPOLITANA;19991;2;1;0;0;0;2;1;19991;CELULAR AZUMI L4G BLACK CLARO;TELEFONIA
13853947;;F;41;CHILENO;;X;LEBU                          ;BIO BIO;199990;1;1;0;0;0;1;1;199990;POCO X3 PRO US 128G METAL BRONZE;TELEFONIA
12359476;;M;48;CHILENO;;X;SAN JAVIER                    ;MAULE;299990;1;1;0;0;0;1;1;299990;CELULAR IPHONE SE 64GB DIRECTO CLARO;TELEFONIA
10522385;;M;56;CHILENO;;Boomers;VINA DEL MAR                  ;VALPARAISO;729180;8;3;0;0;0;8;3;729180;CELULAR VIVO Y11S 32GB NEBULA BLUE OPEN;TELEFONIA
8029869;;F;64;CHILENO;;Boomers;ISLA DE MAIPO                 ;METROPOLITANA;93980;2;1;2;1;93980;0;0;0;CELULAR REDMI 9A 32GB PEACOCK GREEN;TELEFONIA
19233894;Soltero;M;26;CHILENO;TECNICO DE NIVEL MEDIO EN ALIMENTACION;Z;VILLARICA                     ;ARAUCANIA;719990;2;1;0;0;0;2;1;719990;CELULAR SAMSUNG S21 FE 128GB LIGHT GREEN OPEN;TELEFONIA
19943227;;M;24;CHILENO;;Z;PROVIDENCIA                   ;METROPOLITANA;30000;0;1;0;0;0;0;1;30000;POCO F3 US 256G Deep Ocean Blue ];TELEFONIA
19509543;;F;25;CHILENO;;Z;PROVIDENCIA                   ;METROPOLITANA;205970;4;3;0;0;0;4;3;205970;CELULAR Moto G20 Rosado WOM;TELEFONIA
15652467;;F;39;CHILENO;;X;TEMUCO                        ;ARAUCANIA;99990;2;1;0;0;0;2;1;99990;SMARTPHONE A03S 32 GB ROJO;TELEFONIA
12981682;;F;46;CHILENO;;X;LOS ANGELES                   ;BIO BIO;108970;4;3;0;0;0;4;3;108970;CELULAR A12 128GB Azul OPEN;TELEFONIA
18126818;;F;30;CHILENO;;Millenial;PROVIDENCIA                   ;METROPOLITANA;719980;2;2;0;0;0;2;2;719980;CELULAR 11 LITE 5G NE 8/128GB PEACH PINK OPEN;TELEFONIA
18434295;Soltero;F;29;CHILENO;ENFERMERA;Millenial;PROVIDENCIA                   ;METROPOLITANA;189990;1;1;0;0;0;1;1;189990;CELULAR REDMI NOTE 10S 128GB ONIX BLACK;TELEFONIA
19128663;;F;26;CHILENO;;Z;LA LIGUA                      ;VALPARAISO;411970;3;2;0;0;0;3;2;411970;CELULAR A12 128GB Azul OPEN;TELEFONIA
7540915;;M;64;CHILENO;;Boomers;CERRO NAVIA                   ;METROPOLITANA;424980;2;2;0;0;0;2;2;424980;CELULAR A72 128 GB BLACK OPEN;TELEFONIA
12766964;Soltero;F;46;CHILENO;;X;RENCA                         ;METROPOLITANA;129990;1;1;0;0;0;1;1;129990;CELULAR A12 128GB Azul OPEN;TELEFONIA
11608305;;M;52;CHILENO;;X;MELIPILLA                     ;METROPOLITANA;677981;3;1;0;0;0;3;1;677981;CELULAR XIAOMI 11T PRO 8/256GB METEORITE GRAY;TELEFONIA
8901764;;F;59;CHILENO;;Boomers;RENCA                         ;METROPOLITANA;25980;2;1;0;0;0;2;1;25980;CELULAR NOKIA 110 BLACK OPEN;TELEFONIA
18214486;Soltero;F;30;CHILENO;TECNICO EN ENFERMERIA DE NIVEL SUPERIOR;Extranjero;PROVIDENCIA                   ;METROPOLITANA;79990;1;1;0;0;0;1;1;79990;CELULAR XIAOMI REDMI 9A 32GB BLACK DIRECTO CLARO;TELEFONIA
12734515;;F;49;CHILENO;;X;CANETE                        ;BIO BIO;119990;1;1;0;0;0;1;1;119990;CELULAR A12 128GB Azul OPEN;TELEFONIA
15383801;;F;39;CHILENO;;X;SANTIAGO;METROPOLITANA;189990;1;1;1;1;189990;0;0;0;POCO X3 PRO US 128G METAL BRONZE;TELEFONIA
18519330;;M;28;CHILENO;;Millenial;TEMUCO                        ;ARAUCANIA;119990;1;1;1;1;119990;0;0;0;CELULAR A12 128GB Rojo OPEN;TELEFONIA
11479509;;M;52;CHILENO;;X;RENCA                         ;METROPOLITANA;389990;1;1;0;0;0;1;1;389990;CELULAR A72 128 GB BLACK OPEN;TELEFONIA
16576727;;M;35;CHILENO;;Millenial;"";"";25990;3;2;0;0;0;3;2;25990;CHIP OPEN ENTEL;TELEFONIA
7382337;;F;68;CHILENO;;Silencioso;PAINE                         ;METROPOLITANA;19990;1;3;0;0;0;1;3;19990;CELULAR ALCATEL P1 DIRECTO CLARO BLACK;TELEFONIA
17898841;;F;31;CHILENO;;Millenial;"";"";319990;1;1;0;0;0;1;1;319990;CELULAR VIVO V21 5G 128GB SUNSET DAZZLE OPEN;TELEFONIA
8923988;;M;62;CHILENO;;Boomers;LA SERENA                     ;COQUIMBO;74990;2;1;0;0;0;2;1;74990;CELULAR REDMI 9A 32GB SKY BLUE;TELEFONIA
7991360;;M;63;CHILENO;;Boomers;ANTOFAGASTA                   ;ANTOFAGASTA;219980;2;4;0;0;0;2;4;219980;SMARTPHONE A03S 32 GB ROJO;TELEFONIA
11781558;;F;50;CHILENO;;X;VICTORIA                      ;ARAUCANIA;379980;2;2;2;2;379980;0;0;0;CELULAR XIAOMI POCO X3 PRO 128GB PANTHOM BLACK;TELEFONIA
18971010;;F;27;CHILENO;;Millenial;SALAMANCA                     ;COQUIMBO;549980;2;3;0;0;0;2;3;549980;POCO X3 PRO US 128G METAL BRONZE;TELEFONIA
19990437;;M;23;CHILENO;;Z;RETIRO                        ;MAULE;497970;5;2;0;0;0;5;2;497970;CELULAR POCO X3 PRO 128 GB FROST BLUE;TELEFONIA
7870834;;M;65;CHILENO;;Boomers;RENCA                         ;METROPOLITANA;146980;2;1;0;0;0;2;1;146980;CELULAR VIVO Y11S PHANTON BLACK 32GB MOVISTAR;TELEFONIA
15581200;;F;38;CHILENO;;X;"";"";119990;1;1;0;0;0;1;1;119990;CELULAR VIVO Y11S 32 GB NEBULA BLUE WOM;TELEFONIA
18963799;;F;27;CHILENO;;Z;OSORNO                        ;LOS LAGOS;408980;3;1;0;0;0;3;1;408980;SMARTPHONE A52S 5G WHITE 128GB;TELEFONIA
13369031;;M;43;CHILENO;;X;SAN ANTONIO                   ;VALPARAISO;539980;2;2;0;0;0;2;2;539980;CELULAR VIVO Y11S 32GB NEBULA BLUE OPEN;TELEFONIA
15437462;;M;40;CHILENO;;X;PROVIDENCIA                   ;METROPOLITANA;109991;2;1;0;0;0;2;1;109991;SMARTPHONE A03S AZUL 32GB;TELEFONIA
10229651;;F;57;CHILENO;;Boomers;VILLA ALEGRE                  ;MAULE;39990;1;1;0;0;0;1;1;39990;CELULAR ALCATEL P1 DIRECTO CLARO BLACK;TELEFONIA
18995140;;F;27;CHILENO;;Millenial;PROVIDENCIA                   ;METROPOLITANA;129990;1;1;0;0;0;1;1;129990;CELULAR A12 128GB Negro OPEN;TELEFONIA
11236051;;F;54;CHILENO;;X;CHILLAN                       ;BIO BIO;449980;3;2;0;0;0;3;2;449980;CELULAR A52 128 GB BLACK OPEN;TELEFONIA
15199214;;F;39;CHILENO;;X;N/D;N/D;139970;3;2;0;0;0;3;2;139970;CELULAR A12 128GB Negro OPEN;TELEFONIA
7221283;;F;79;CHILENO;;Silencioso;RENCA                         ;METROPOLITANA;32990;1;1;0;0;0;1;1;32990;CELULAR BMOBILE BS30 BLACK OPEN;TELEFONIA
11987700;Casado;M;49;CHILENO;TECNICO MECANICO;X;RENCA                         ;METROPOLITANA;439980;2;2;0;0;0;2;2;439980;CELULAR MOTO G60S 6/128 GB AZUL;TELEFONIA
12398593;;F;49;CHILENO;;X;ILLAPEL                       ;COQUIMBO;869960;4;4;0;0;0;4;4;869960;CELULAR MOTO G60 4/128 GB SILVER OPEN;TELEFONIA
10592975;;F;56;CHILENO;;Boomers;PITRUFQUEN                    ;ARAUCANIA;169990;1;1;0;0;0;1;1;169990;CELULAR A16 PEARL BLUE 64GB;TELEFONIA
5247118;Casado;M;74;CHILENO;;Silencioso;RENCA                         ;METROPOLITANA;179980;2;1;0;0;0;2;1;179980;CELULAR MOTOROLA E7 IPOWER 32GB BLUE CLARO;TELEFONIA
14155969;;M;42;CHILENO;;X;EL BOSQUE                     ;METROPOLITANA;249990;1;1;0;0;0;1;1;249990;CELULAR REDMI NOTE 10 PRO 128GB AZUL WOM;TELEFONIA
11227904;;M;55;CHILENO;;Boomers;PUDAHUEL                      ;METROPOLITANA;395970;3;1;0;0;0;3;1;395970;CELULAR A32 128 GB BLACK OPEN;TELEFONIA
5454320;;M;73;CHILENO;;Silencioso;PAINE                         ;METROPOLITANA;89990;1;1;0;0;0;1;1;89990;CELULAR MOTO E7 32GB GRIS OPEN;TELEFONIA
15987465;Soltero;M;37;CHILENO;PROFESOR;Millenial;PROVIDENCIA                   ;METROPOLITANA;189990;1;1;0;0;0;1;1;189990;CELULAR REDMI NOTE 10S 128GB ONIX BLACK;TELEFONIA
16807085;;M;35;CHILENO;;Millenial;CONTULMO                      ;BIO BIO;338960;4;4;0;0;0;4;4;338960;MOTO EDGE 20 LITE 6/128GB GRIS;TELEFONIA
12206747;;F;50;CHILENO;;X;PROVIDENCIA                   ;METROPOLITANA;199990;1;1;1;1;199990;0;0;0;Celular P40 LITE LIB OPEN GREEN;TELEFONIA
6493553;;F;71;CHILENO;;Silencioso;RENCA                         ;METROPOLITANA;144990;2;1;0;0;0;2;1;144990;POCO X3 PRO US 128G METAL BRONZE;TELEFONIA
17822581;Casado;M;31;CHILENO;;Millenial;PROVIDENCIA                   ;METROPOLITANA;39990;1;1;0;0;0;1;1;39990;CELULAR ALCATEL P1 DIRECTO CLARO BLACK;TELEFONIA
19805123;;M;24;CHILENO;;Silencioso;PROVIDENCIA                   ;METROPOLITANA;189990;1;1;1;1;189990;0;0;0;POCO X3 PRO US 128G METAL BRONZE;TELEFONIA
14053479;;M;49;CHILENO;;X;CUREPTO                       ;MAULE;299990;1;1;0;0;0;1;1;299990;CELULAR SMARTPHONE A52S 5G LIGHT GREEN 128GB;TELEFONIA
7533199;;M;67;CHILENO;;Boomers;ESTACION CENTRAL              ;METROPOLITANA;109990;1;1;0;0;0;1;1;109990;SMARTPHONE A03S 32 GB ROJO;TELEFONIA
6945891;Soltero;M;68;CHILENO;;Silencioso;CALAMA                        ;ANTOFAGASTA;161981;3;1;0;0;0;3;1;161981;SMARTPHONE A03S 32 GB ROJO;TELEFONIA
7236155;Casado;F;70;CHILENO;;Silencioso;PROVIDENCIA                   ;METROPOLITANA;129990;1;1;0;0;0;1;1;129990;Celular XIAOMI REDMI 9 64 GB DIRECTO CLARO NEGRO;TELEFONIA
7354669;;M;69;CHILENO;;Silencioso;PROVIDENCIA                   ;METROPOLITANA;18990;1;1;0;0;0;1;1;18990;Celular SA3 CLARO DIRECTO BLACK;TELEFONIA
7355060;;F;82;CHILENO;;Silencioso;SAN CARLOS                    ;BIO BIO;99990;1;1;0;0;0;1;1;99990;CELULAR VIVO Y11S 32GB NEBULA BLUE OPEN;TELEFONIA
15852733;;F;38;CHILENO;;Millenial;MONTE PATRIA                  ;COQUIMBO;139990;1;1;0;0;0;1;1;139990;CELULAR A12 128GB Negro OPEN;TELEFONIA
17170078;;M;33;CHILENO;;Millenial;PENCO                         ;BIO BIO;181970;3;1;0;0;0;3;1;181970;CELULAR MOTO G20 EDICION ESPECIAL 4/128 GB VERDE;TELEFONIA
5661734;;F;74;CHILENO;;Silencioso;LA GRANJA                     ;METROPOLITANA;89990;1;1;0;0;0;1;1;89990;CELULAR XIAOMI REDMI 9A 2/32GB GRANITE GRAY;TELEFONIA
10385456;;F;55;CHILENO;;Boomers;RENCA                         ;METROPOLITANA;269990;1;1;0;0;0;1;1;269990;CELULAR REDMI NOTE 10 PRO 128GB AZUL WOM;TELEFONIA
17161977;Soltero;M;33;CHILENO;;Millenial;IQUIQUE                       ;TARAPACA;135980;2;1;0;0;0;2;1;135980;CELULAR MOTO E7 32GB GRIS OPEN;TELEFONIA
10022690;;M;57;CHILENO;;Boomers;CALAMA                        ;ANTOFAGASTA;172980;2;1;0;0;0;2;1;172980;CELULAR A12 128GB Azul OPEN;TELEFONIA
25049635;;M;35;PERUANO;;Extranjero;SANTIAGO                      ;METROPOLITANA;695940;9;4;0;0;0;9;4;695940;CELULAR POCO X3 PRO 128G PHANTOM BLACK OPEN;TELEFONIA
18691400;;M;34;CHILENO;;Millenial;N/D;N/D;171980;2;1;0;0;0;2;1;171980;CELULAR A12 128GB Azul OPEN;TELEFONIA
16700888;Soltero;M;34;CHILENO;;Millenial;RENCA                         ;METROPOLITANA;277971;4;2;0;0;0;4;2;277971;SMARTPHONE A03S 32 GB ROJO;TELEFONIA
13914811;;M;42;CHILENO;;X;EL BOSQUE                     ;METROPOLITANA;309990;1;1;0;0;0;1;1;309990;CELULAR SMARTPHONE A52S 5G LIGHT GREEN 128GB;TELEFONIA
7105528;;F;67;CHILENO;;Boomers;EL BOSQUE                     ;METROPOLITANA;1628880;13;6;10;4;1248900;3;2;379980;IPHONE 11 64GB BLACK CLARO;TELEFONIA
10026669;Divorciado;M;56;CHILENO;MEDICO CIRUJANO;Boomers;PROVIDENCIA                   ;METROPOLITANA;263980;2;1;0;0;0;2;1;263980;CELULAR XIAOMI POCO X3 PRO 128GB PANTHOM BLACK;TELEFONIA
13978368;;M;41;CHILENO;;X;N/D;N/D;198970;3;2;0;0;0;3;2;198970;CELULAR A12 128GB Negro OPEN;TELEFONIA
18750319;;M;28;CHILENO;;Millenial;EL BOSQUE;METROPOLITANA;119990;2;1;0;0;0;2;1;119990;CELULAR VIVO Y21S PEARL WHITE 128 GB OPEN;TELEFONIA
19385373;Soltero;M;25;CHILENO;;Millenial;"";"";219990;3;1;0;0;0;3;1;219990;CELULAR MOTO G60S 6/128 GB AZUL;TELEFONIA
10564798;Divorciado;M;56;CHILENO;;Boomers;SAN MIGUEL                    ;METROPOLITANA;80140;2;1;0;0;0;2;1;80140;CELULAR XIAOMI REDMI 9A 32GB BLACK DIRECTO CLARO;TELEFONIA
16835265;;F;34;CHILENO;;Millenial;SAN VICENTE;O HIGGINS;769940;6;5;1;1;189990;5;4;579950;CELULAR GALAXY S20FE 128GB CLOUD LAVENDER OPEN;TELEFONIA
14459937;Soltero;M;46;CHILENO;;X;SAN CLEMENTE                  ;MAULE;127980;2;1;0;0;0;2;1;127980;SMARTPHONE A03S AZUL 32GB;TELEFONIA
18303519;;M;30;CHILENO;;Millenial;QUILPUE                       ;VALPARAISO;149990;1;1;0;0;0;1;1;149990;CELULAR REDMI 9 64GB CARBON GREY;TELEFONIA
14508072;;F;48;CHILENO;;X;RENCA                         ;METROPOLITANA;259980;2;2;0;0;0;2;2;259980;CELULAR A22 128GB NEGRO;TELEFONIA
16535980;;F;34;CHILENO;;Millenial;SAN CARLOS                    ;BIO BIO;74990;2;1;0;0;0;2;1;74990;CELULAR A12 128GB Azul OPEN;TELEFONIA
10136739;;M;57;CHILENO;;Boomers;EL MONTE                      ;METROPOLITANA;189990;1;1;0;0;0;1;1;189990;SMARTPHONE A22 BLANCO 128GB;TELEFONIA
14591570;;F;46;CHILENO;;X;PUREN                         ;ARAUCANIA;444980;2;2;0;0;0;2;2;444980;CELULAR A12 128GB Azul OPEN;TELEFONIA
12345438;;M;49;CHILENO;;X;RENCA                         ;METROPOLITANA;103970;3;2;0;0;0;3;2;103970;CELULAR BMOBILE C40 CRIS OPEN;TELEFONIA
18161604;;F;30;CHILENO;;Millenial;PROVIDENCIA                   ;METROPOLITANA;299990;1;1;0;0;0;1;1;299990;CELULAR SMARTPHONE A52S 5G BLACK 128GB;TELEFONIA
17833558;;M;31;CHILENO;;Millenial;LA PINTANA                    ;METROPOLITANA;419980;2;1;0;0;0;2;1;419980;POCO X3 PRO 256 GB PHANTOM BLACK;TELEFONIA
16979970;Soltero;F;33;CHILENO;;Millenial;RENCA                         ;METROPOLITANA;159990;1;1;1;1;159990;0;0;0;CELULAR MOTOROLA G30 GRIS WOM 128 GB;TELEFONIA
14123640;;M;40;CHILENO;;Millenial;N/D;N/D;239230;3;2;0;0;0;3;2;239230;CELULAR MOTO G50 AZUL 128 GB OPEN;TELEFONIA
8696151;;M;60;CHILENO;;Boomers;PROVIDENCIA                   ;METROPOLITANA;199990;1;1;0;0;0;1;1;199990;CELULAR A32 128 GB BLACK OPEN;TELEFONIA
15940677;;F;37;CHILENO;;Millenial;PUENTE ALTO;METROPOLITANA;200000;1;1;0;0;0;1;1;200000;CELULAR A32 128 GB LIGHT VIOLET OPEN;TELEFONIA
11209702;;F;54;CHILENO;;Boomers;CONCHALI                      ;METROPOLITANA;219971;5;3;2;1;39990;3;2;179981;CELULAR A12 128GB Rojo OPEN;TELEFONIA
9140784;;F;60;CHILENO;;Boomers;TEMUCO                        ;ARAUCANIA;282460;4;2;0;0;0;4;2;282460;CELULAR XIAOMI REDMI 9 64GB DIRECTO CLARO MORADO;TELEFONIA
23486589;;F;39;PERUANO;;Extranjero;RECOLETA;METROPOLITANA;129991;2;1;0;0;0;2;1;129991;CELULAR A12 128GB Rojo OPEN;TELEFONIA
26261231;;M;34;ECUATORIANO;;Extranjero;SAN ANTONIO                   ;VALPARAISO;694970;3;3;0;0;0;3;3;694970;CELULAR XIAOMI 11T 8/256GB MOONLIGHT WHITE KIT;TELEFONIA
17976269;;F;30;CHILENO;;Millenial;PROVIDENCIA                   ;METROPOLITANA;200980;2;1;0;0;0;2;1;200980;CELULAR SAMSUNG A12 128GB BLACK CLARO;TELEFONIA
17518997;;F;32;CHILENO;;Millenial;TALAGANTE                     ;METROPOLITANA;623980;2;1;2;1;623980;0;0;0;Celular Galaxy S21 Plus Phantom Silver 128GB;TELEFONIA
18505683;Soltero;M;30;CHILENO;;Millenial;PROVIDENCIA                   ;METROPOLITANA;129990;1;1;0;0;0;1;1;129990;SMARTPHONE A03S AZUL 32GB;TELEFONIA
19144934;;F;27;CHILENO;;Z;VALLENAR;ATACAMA;109991;2;1;0;0;0;2;1;109991;CELULAR VIVO Y11S 32GB NEBULA BLUE OPEN;TELEFONIA
11900571;;M;50;CHILENO;;X;CONCEPCION                    ;BIO BIO;149990;1;1;0;0;0;1;1;149990;XIAOMI REDMI 9T CARBON GRAY 128GB MOVISTAR;TELEFONIA
9166331;;F;62;CHILENO;;Boomers;PROVIDENCIA                   ;METROPOLITANA;79990;1;1;0;0;0;1;1;79990;CELULAR REDMI 9A 32GB SKY BLUE;TELEFONIA
16055109;;M;37;CHILENO;;Millenial;IQUIQUE;TARAPACA;169990;1;1;1;1;169990;0;0;0;CELULAR MOTOROLA G9 PLUS 128GB AZUL CLARO;TELEFONIA
10984648;;F;48;CHILENO;;X;"";"";990;1;1;0;0;0;1;1;990;KIT PACK OPEN RETAIL 4G TELEFONICA;TELEFONIA
10931862;;F;56;CHILENO;;Boomers;N/D;N/D;-60010;1;3;0;0;0;1;3;-60010;CELULAR SMARTPHONE BMOBIL AX1076 PRO BLACK TRI W;TELEFONIA
18224884;;M;29;CHILENO;;Millenial;PETORCA                       ;VALPARAISO;269991;2;1;0;0;0;2;1;269991;CELULAR SMARTPHONE A52S 5G BLACK 128GB;TELEFONIA
16479731;;F;35;CHILENO;;Millenial;N/D;N/D;334970;4;3;3;2;309980;1;1;24990;CELULAR MOTO G30 GRIS TORNASOL 128GB MOVISTAR;TELEFONIA
14126263;;M;41;CHILENO;;X;N/D;N/D;119990;1;1;0;0;0;1;1;119990;SMARTPHONE A03S NEGRO 32GB;TELEFONIA
19106697;;M;26;CHILENO;;Z;SAN RAFAEL                    ;MAULE;285480;2;1;2;1;285480;0;0;0;CELULAR SMARTPHONE A52S 5G BLACK 128GB;TELEFONIA
17392182;;M;32;CHILENO;;Millenial;"";"";199980;3;2;0;0;0;3;2;199980;CELULAR XIAOMI REDMI 9A 32GB GRANITE GRAY TRI WO;TELEFONIA
12317860;;F;49;CHILENO;;X;CAUQUENES                     ;MAULE;199990;1;1;0;0;0;1;1;199990;CELULAR A22 128GB NEGRO;TELEFONIA
12950691;;M;46;CHILENO;;X;PROVIDENCIA                   ;METROPOLITANA;329981;3;1;0;0;0;3;1;329981;CELULAR MOTO G30 128GB LILA PASTEL OPEN;TELEFONIA
10465871;Soltero;F;55;CHILENO;;Boomers;RENCA                         ;METROPOLITANA;93970;3;1;0;0;0;3;1;93970;CELULAR XIAOMI REDMI 9A 32GB GRANITE GRAY TRI WO;TELEFONIA
18691771;;M;28;CHILENO;;Millenial;AISEN                         ;AYSEN;864980;2;1;0;0;0;2;1;864980;Celular Galaxy S21 Ultra Phantom Black 128GB;TELEFONIA
16122433;Casado;M;37;CHILENO;BIOQUIMICO;Millenial;PROVIDENCIA                   ;METROPOLITANA;189990;1;1;1;1;189990;0;0;0;CELULAR A32 128 GB BLUE OPEN;TELEFONIA
16703088;;M;34;CHILENO;;Millenial;SAN FELIPE                    ;VALPARAISO;564960;4;2;4;2;564960;0;0;0;CELULAR SMARTPHONE A52S 5G LIGHT GREEN 128GB;TELEFONIA
4366266;;M;79;CHILENO;;Extranjero;ZAPALLAR                      ;VALPARAISO;420972;5;1;0;0;0;5;1;420972;CELULAR REDMI NOTE 10S 128GB ONIX BLACK;TELEFONIA
18485088;Soltero;M;28;CHILENO;;Millenial;PROVIDENCIA                   ;METROPOLITANA;269990;1;1;1;1;269990;0;0;0;CELULAR REDMI NOTE 10 PRO 128GB AZUL WOM;TELEFONIA
17286904;Soltero;F;32;CHILENO;;Millenial;PROVIDENCIA                   ;METROPOLITANA;79990;1;1;0;0;0;1;1;79990;CELULAR MOTO E7i 32GB AZUL OPEN;TELEFONIA
13945481;;M;41;CHILENO;;X;RENGO                         ;L.G.B.OÂ´HIGGINS;642940;6;1;0;0;0;6;1;642940;CELULAR SMARTPHONE A52S 5G LIGHT VIOLET 128GB;TELEFONIA
12715406;;F;47;CHILENO;;X;RENCA                         ;METROPOLITANA;379980;2;2;0;0;0;2;2;379980;POCO F3 US 256G Deep Ocean Blue ];TELEFONIA
6779244;;F;69;CHILENO;;Silencioso;N/D;N/D;201960;5;3;0;0;0;5;3;201960;SMARTPHONE A03S 32 GB ROJO;TELEFONIA
15723503;;F;39;CHILENO;;X;PAINE                         ;METROPOLITANA;472750;4;2;0;0;0;4;2;472750;CELULAR VIVO Y11S PHANTOM BLACK OPEN;TELEFONIA
12801970;;F;46;CHILENO;;X;CALAMA                        ;ANTOFAGASTA;167960;4;1;0;0;0;4;1;167960;CELULAR A12 128GB Rojo OPEN;TELEFONIA
17382326;;M;32;CHILENO;;Millenial;PROVIDENCIA                   ;METROPOLITANA;149992;1;2;0;0;0;1;2;149992;CELULAR REDMI 9 64GB CARBON GREY;TELEFONIA
16275053;Viudo;F;36;CHILENO;;Millenial;RENCA                         ;METROPOLITANA;107980;2;1;0;0;0;2;1;107980;CELULAR Moto E7 Rosado WOM;TELEFONIA
18779199;;M;28;CHILENO;;Millenial;TALCA                         ;MAULE;191990;2;1;0;0;0;2;1;191990;CELULAR XIAOMI POCO X3 PRO 128GB PANTHOM BLACK;TELEFONIA
19335670;Soltero;F;25;CHILENO;KINESIOLOGA;Z;PROVIDENCIA                   ;METROPOLITANA;259992;1;2;0;0;0;1;2;259992;CELULAR POCO X3 PRO 256 GB FROST BLUE;TELEFONIA
22513308;Soltero;F;35;BOLIVIANO;;Extranjero;ALTO HOSPICIO;TARAPACA;189991;2;1;0;0;0;2;1;189991;CELULAR A22 128GB NEGRO;TELEFONIA
13283852;;M;44;CHILENO;;X;TOCOPILLA                     ;ANTOFAGASTA;868950;5;3;0;0;0;5;3;868950;CELULAR VIVO V21 5G 128GB SUNSET DAZZLE OPEN;TELEFONIA
11960336;;F;49;CHILENO;;X;SAN RAMON                     ;METROPOLITANA;378250;4;3;0;0;0;4;3;378250;CELULAR REDMI NOTE 10S 128GB PEBBLE WHITE;TELEFONIA
10649060;;M;55;CHILENO;;Boomers;SAN PEDRO DE LA PAZ           ;BIO BIO;179991;2;1;0;0;0;2;1;179991;CELULAR POCO X3 PRO 128G PHANTOM BLACK OPEN;TELEFONIA
14601950;;F;45;CHILENO;;X;LA CISTERNA                   ;METROPOLITANA;1247900;10;7;10;7;1247900;0;0;0;REDMI 10 US 128GB Carbon Gray;TELEFONIA
15983381;;M;34;CHILENO;;Millenial;PROVIDENCIA                   ;METROPOLITANA;209990;2;1;0;0;0;2;1;209990;CELULAR POCO X3 PRO 256 GB FROST BLUE;TELEFONIA
11568212;;F;51;CHILENO;;X;SAN CARLOS                    ;BIO BIO;161980;2;1;0;0;0;2;1;161980;CELULAR VIVO Y11S 32GB NEBULA BLUE OPEN;TELEFONIA
6720308;;F;68;CHILENO;;Boomers;ARICA                         ;TARAPACA;393960;4;2;0;0;0;4;2;393960;CELULAR A32 128 GB LIGHT VIOLET OPEN;TELEFONIA
20049575;;F;23;CHILENO;;Z;LO BARNECHEA;METROPOLITANA;329980;2;2;0;0;0;2;2;329980;CELULAR POCO X3 PRO 256 GB FROST BLUE;TELEFONIA
20193591;;F;22;CHILENO;;Z;PROVIDENCIA                   ;METROPOLITANA;219990;1;1;0;0;0;1;1;219990;CELULAR A32 128 GB LIGHT VIOLET OPEN;TELEFONIA
22807806;;M;38;PERUANO;;Extranjero;N/D;N/D;733980;2;1;2;1;733980;0;0;0;CELULAR NOTE 20 ULTRA MYSTIC BRONZE 256 GB OPE;TELEFONIA
18233377;;F;29;CHILENO;;Millenial;ANTOFAGASTA                   ;ANTOFAGASTA;335980;2;1;0;0;0;2;1;335980;CELULAR SMARTPHONE A52S 5G BLACK 128GB;TELEFONIA
14369661;Soltero;F;46;CHILENO;;X;PROVIDENCIA                   ;METROPOLITANA;139990;1;1;1;1;139990;0;0;0;CELULAR XIAOMI REDMI 9T 128GB BLACK CLARO;TELEFONIA
17988378;;F;31;CHILENO;;Millenial;CHILLAN VIEJO                 ;BIO BIO;191980;2;1;0;0;0;2;1;191980;CELULAR A12 128GB Azul OPEN;TELEFONIA
12472697;;M;49;CHILENO;;X;NUNOA                         ;METROPOLITANA;243980;2;1;2;1;243980;0;0;0;POCO X3 PRO 256 GB PHANTOM BLACK;TELEFONIA
13327003;;F;43;CHILENO;;X;PROVIDENCIA                   ;METROPOLITANA;0;0;2;0;0;0;0;2;0;CELULAR NOKIA QUEEN VALUE BLACK CLARO;TELEFONIA
14450795;;M;50;CHILENO;;X;SAN JAVIER                    ;MAULE;399960;4;4;0;0;0;4;4;399960;CELULAR REDMI NOTE 10S 128GB PEBBLE WHITE;TELEFONIA
8708450;;F;61;CHILENO;;Boomers;PUERTO MONTT                  ;LOS LAGOS;498540;2;1;2;1;498540;0;0;0;SMARTHPHONE RENO 6 AURORA 128GB;TELEFONIA
16129689;;M;33;CHILENO;;Millenial;N/D;N/D;189980;4;1;0;0;0;4;1;189980;CELULAR A12 128GB Azul OPEN;TELEFONIA
16981334;;M;27;CHILENO;;Z;COIHAIQUE                     ;AYSEN;299990;1;2;0;0;0;1;2;299990;CELULAR SMARTPHONE A52S 5G BLACK 128GB;TELEFONIA
17670111;;M;31;CHILENO;;Millenial;CAUQUENES                     ;MAULE;299990;1;1;0;0;0;1;1;299990;CELULAR IPHONE SE 64GB DIRECTO CLARO;TELEFONIA
5886359;;F;77;CHILENO;;Silencioso;PROVIDENCIA                   ;METROPOLITANA;62980;2;1;0;0;0;2;1;62980;CELULAR ALCATEL P1 DIRECTO CLARO BLACK;TELEFONIA
9915160;;F;55;CHILENO;;Boomers;VALLENAR;ATACAMA;314980;3;2;0;0;0;3;2;314980;CELULAR VIVO Y21S PEARL WHITE 128 GB OPEN;TELEFONIA
18895258;;F;27;CHILENO;;Z;CONSTITUCION                  ;MAULE;389990;1;1;0;0;0;1;1;389990;CELULAR GALAXY S20FE 128GB CLOUD LAVENDER OPEN;TELEFONIA
17403213;Soltero;M;32;CHILENO;;Silencioso;PROVIDENCIA                   ;METROPOLITANA;1468960;4;2;4;2;1468960;0;0;0;Celular Galaxy S21 Ultra Phantom Silver 128GB;TELEFONIA
17592961;;F;31;CHILENO;;Millenial;TUCAPEL                       ;BIO BIO;139990;4;2;0;0;0;4;2;139990;CELULAR A12 128GB Negro OPEN;TELEFONIA
9101707;;F;62;CHILENO;;Boomers;HUALQUI                       ;BIO BIO;1220340;7;4;0;0;0;7;4;1220340;CELULAR VIVO Y11S PHANTOM BLACK OPEN;TELEFONIA
20091790;;M;23;CHILENO;;X;PROVIDENCIA                   ;METROPOLITANA;209990;1;1;1;1;209990;0;0;0;CELULAR XIAOMI POCO X3 PRO 128GB PANTHOM BLACK;TELEFONIA
7559228;;M;68;CHILENO;;Boomers;SAN VICENTE                   ;L.G.B.OÂ´HIGGINS;119990;1;1;0;0;0;1;1;119990;CELULAR MOTOROLA E30 GRIS CLARO;TELEFONIA
18296149;;F;29;CHILENO;;Millenial;N/D;N/D;468930;7;6;0;0;0;7;6;468930;Celular Y9S LIB OPEN BLACK;TELEFONIA
12368575;Soltero;M;48;CHILENO;;X;RENCA                         ;METROPOLITANA;90140;2;1;0;0;0;2;1;90140;CELULAR VIVO Y11S PHANTON BLACK 32GB MOVISTAR;TELEFONIA
13960191;;M;42;CHILENO;;X;RANCAGUA                      ;L.G.B.OÂ´HIGGINS;39990;1;1;1;1;39990;0;0;0;CELULAR SMARTPHONE 1B ALCATEL PRIME BLACK;TELEFONIA
12842188;Soltero;M;47;CHILENO;;X;RENCA                         ;METROPOLITANA;348980;2;1;0;0;0;2;1;348980;CELULAR SMARTPHONE A52S 5G BLACK 128GB;TELEFONIA
16072347;;F;36;CHILENO;;Millenial;CERRO NAVIA                   ;METROPOLITANA;39990;2;1;0;0;0;2;1;39990;CELULAR CLARO MOTOROLA E7 32GB GRIS;TELEFONIA
12165368;Soltero;M;59;CHILENO;;Boomers;RENCA                         ;METROPOLITANA;64990;1;1;0;0;0;1;1;64990;CELULAR MOTOROLA E6 PLAY AZUL TRI WOM;TELEFONIA
18487708;;F;28;CHILENO;;Millenial;PROVIDENCIA                   ;METROPOLITANA;263970;3;1;3;1;263970;0;0;0;SMARTPHONE A03S 64 GB NEGRO;TELEFONIA
12734294;;M;46;CHILENO;;X;MAIPU                         ;METROPOLITANA;85990;1;1;1;1;85990;0;0;0;CELULAR MOTO E7 32GB ROSA CORAL OPEN;TELEFONIA
4745923;;M;80;CHILENO;;Silencioso;PROVIDENCIA                   ;METROPOLITANA;36990;2;1;0;0;0;2;1;36990;CELULAR NOKIA 225 4G BLACK MOVISTAR DIRECTO;TELEFONIA
16631390;;F;35;CHILENO;;Millenial;PROVIDENCIA                   ;METROPOLITANA;129990;1;1;0;0;0;1;1;129990;CELULAR MOTOROLA MOTO G20 64GB ROSA FLAMINGO;TELEFONIA
16987447;Soltero;M;33;CHILENO;TECNICO MECANICO;Millenial;PROVIDENCIA                   ;METROPOLITANA;239470;3;2;0;0;0;3;2;239470;CELULAR REDMI 9 64GB CARBON GREY;TELEFONIA
7725221;;M;67;CHILENO;;Boomers;SAN JAVIER                    ;MAULE;117980;2;1;0;0;0;2;1;117980;CELULAR VIVO Y11S PHANTON BLACK 32GB MOVISTAR;TELEFONIA
6896795;;F;72;CHILENO;;Silencioso;QUILPUE                       ;VALPARAISO;246971;4;1;0;0;0;4;1;246971;CELULAR MOTOROLA G9 PLUS 128GB AZUL CLARO;TELEFONIA
16797735;;F;34;CHILENO;;Millenial;LA SERENA                     ;COQUIMBO;199990;1;1;0;0;0;1;1;199990;CELULAR POCO X3 PRO 128G PHANTOM BLACK OPEN;TELEFONIA
18631027;;F;28;CHILENO;;Millenial;PROVIDENCIA                   ;METROPOLITANA;119990;1;1;0;0;0;1;1;119990;CELULAR OPPO A15 BLACK 32GB CLARO;TELEFONIA
16158955;;F;36;CHILENO;;Millenial;CHONCHI                       ;LOS LAGOS;60980;2;1;0;0;0;2;1;60980;CELULAR NOKIA QUEEN VALUE BLACK CLARO;TELEFONIA
19465541;;F;25;CHILENO;;Z;"";"";209990;1;1;1;1;209990;0;0;0;CELULAR POCO X3 PRO 128 GB FROST BLUE;TELEFONIA
16930373;;F;33;CHILENO;;Millenial;PROVIDENCIA                   ;METROPOLITANA;193980;2;1;2;1;193980;0;0;0;CELULAR MOTO G9 POWER 128GB VERDE GRANITO OPEN;TELEFONIA
16254546;;F;36;CHILENO;;Millenial;DONIHUE                       ;L.G.B.OÂ´HIGGINS;189990;1;1;1;1;189990;0;0;0;CELULAR A32 128 GB LIGHT VIOLET OPEN;TELEFONIA
15879058;;M;40;CHILENO;;X;PROVIDENCIA                   ;METROPOLITANA;176980;2;1;0;0;0;2;1;176980;CELULAR MOTOROLA MOTO G20 64GB ROSA FLAMINGO;TELEFONIA
10400664;;F;55;CHILENO;;Boomers;ARICA                         ;ARICA Y PARINACOTA;599990;1;1;0;0;0;1;1;599990;Celular Galaxy S21 Phantom Grey 128GB;TELEFONIA
6111426;;M;72;CHILENO;;Silencioso;MULCHEN                       ;BIO BIO;139990;1;1;1;1;139990;0;0;0;CELULAR MOTO G30 128GB GRIS TORNASOL OPEN;TELEFONIA
15799544;;F;38;CHILENO;;Millenial;PUDAHUEL                      ;METROPOLITANA;259990;2;1;0;0;0;2;1;259990;CELULAR XIAOMI 11 LITE 5G NE 8/128GB BUBBLEGUM K;TELEFONIA
15097922;Casado;M;39;CHILENO;INGENIERO EN CONSTRUCCION;X;RENCA                         ;METROPOLITANA;309990;1;3;0;0;0;1;3;309990;CELULAR SMARTPHONE A52S 5G BLACK 128GB;TELEFONIA
9474922;;M;59;CHILENO;;Boomers;RENCA                         ;METROPOLITANA;156980;2;1;0;0;0;2;1;156980;SMARTPHONE A03S 32 GB ROJO;TELEFONIA
15353786;;F;39;CHILENO;;X;CALBUCO                       ;LOS LAGOS;289980;2;2;0;0;0;2;2;289980;CELULAR VIVO Y11S 32 GB NEBULA BLUE WOM;TELEFONIA
20254043;;M;22;CHILENO;;Silencioso;PROVIDENCIA                   ;METROPOLITANA;923120;7;3;0;0;0;7;3;923120;CELULAR Moto G20 Blue WOM;TELEFONIA
17521125;;F;31;CHILENO;;Millenial;"";"";159990;1;1;0;0;0;1;1;159990;CELULAR MOTO G30 128GB LILA PASTEL OPEN;TELEFONIA
11769770;Casado;F;51;CHILENO;;X;PARRAL                        ;MAULE;149990;1;1;0;0;0;1;1;149990;CELULAR XIAOMI REDMI 9T 128GB BLACK CLARO;TELEFONIA
12324245;;F;48;CHILENO;;X;ARAUCO                        ;BIO BIO;107980;2;1;0;0;0;2;1;107980;CELULAR MOTO E7I POWER 32GB BLUE MOVISTAR;TELEFONIA
19153202;Soltero;M;26;CHILENO;;Silencioso;PROVIDENCIA                   ;METROPOLITANA;279990;1;1;1;1;279990;0;0;0;CELULAR SMARTPHONE A52S 5G BLACK 128GB;TELEFONIA
5242998;;M;69;CHILENO;;Silencioso;TALCAHUANO                    ;BIO BIO;53980;2;2;0;0;0;2;2;53980;CHIP OPEN ENTEL;TELEFONIA
13574932;Soltero;M;43;CHILENO;;X;PROVIDENCIA                   ;METROPOLITANA;27992;1;1;0;0;0;1;1;27992;CELULAR NOKIA 225 4G BLACK MOVISTAR DIRECTO;TELEFONIA
11327688;;M;54;CHILENO;;X;CUNCO                         ;ARAUCANIA;428970;4;1;0;0;0;4;1;428970;CELULAR REDMI NOTE 10S 128GB PEBBLE WHITE;TELEFONIA
27350891;;M;30;"";;Extranjero;"";"";329980;2;2;0;0;0;2;2;329980;SMARTHPHONE REDMI 10 US 64GB SEA BLUE;TELEFONIA
15037144;;M;39;CHILENO;;X;PROVIDENCIA                   ;METROPOLITANA;705090;3;1;3;1;705090;0;0;0;Celular Galaxy S21 Plus Phantom Silver 128GB;TELEFONIA
12552133;;M;47;CHILENO;;X;RENCA                         ;METROPOLITANA;399992;1;2;0;0;0;1;2;399992;CELULAR GALAXY S20FE 128GB CLOUD LAVENDER OPEN;TELEFONIA
18336752;;F;29;CHILENO;;Millenial;SAN JOAQUIN                   ;METROPOLITANA;203980;2;1;2;1;203980;0;0;0;CELULAR REDMI NOTE 10S 128GB OCEAN BLUE;TELEFONIA
26745519;;M;33;VENEZOLANO;;Extranjero;N/D;N/D;1181950;5;1;0;0;0;5;1;1181950;Celular Galaxy S21 Phantom Grey 128GB;TELEFONIA
19017030;;F;28;CHILENO;;Millenial;COLTAUCO                      ;L.G.B.OÂ´HIGGINS;169980;2;2;0;0;0;2;2;169980;CELULAR VIVO Y11S PHANTOM BLACK OPEN;TELEFONIA
9918853;;F;58;CHILENO;;Boomers;"";"";156980;2;1;0;0;0;2;1;156980;CELULAR REDMI 9 64GB CARBON GREY;TELEFONIA
19555712;;F;24;CHILENO;;Z;N/D;N/D;350980;3;1;0;0;0;3;1;350980;CELULAR SMARTPHONE A52S 5G BLACK 128GB;TELEFONIA
4788115;;M;78;CHILENO;;Silencioso;CATEMU                        ;VALPARAISO;139990;1;1;0;0;0;1;1;139990;CELULAR VIVO Y20S NEBULA 128 GB BLUE OPEN;TELEFONIA
10355339;;M;56;CHILENO;;Boomers;CURANILAHUE                   ;BIO BIO;399980;2;2;0;0;0;2;2;399980;CELULAR REDMI NOTE 10S 128GB PEBBLE WHITE;TELEFONIA
27435242;;F;30;EXTRANJERO - NO INFORMA NACIONALIDAD ;;Millenial;N/D;N/D;239990;1;1;0;0;0;1;1;239990;POCO X3 PRO 256 GB PHANTOM BLACK;TELEFONIA
19215747;Soltero;F;26;CHILENO;TECNICO DE NIVEL SUPERIOR EN ENFERMERIA;Z;PROVIDENCIA                   ;METROPOLITANA;171530;3;2;3;2;171530;0;0;0;CELULAR A12 128GB Azul OPEN;TELEFONIA
7808137;;F;65;CHILENO;;Boomers;EL BOSQUE                     ;METROPOLITANA;309990;1;1;0;0;0;1;1;309990;CELULAR SMARTPHONE A52S 5G BLACK 128GB;TELEFONIA
10319321;;F;56;CHILENO;;Boomers;PUTAENDO                      ;VALPARAISO;159990;1;1;0;0;0;1;1;159990;XIAOMI REDMI 9T GRIS WOM 128 GB;TELEFONIA
16910970;;M;33;CHILENO;;Millenial;N/D;N/D;279990;1;1;0;0;0;1;1;279990;CELULAR REDMI NOTE 10 PRO 6+128GB GRADIENT BRONZ;TELEFONIA
12530511;;F;48;CHILENO;;X;N/D;N/D;180980;2;1;0;0;0;2;1;180980;SMARTPHONE A22 VERDE 128GB;TELEFONIA
13150508;;F;44;CHILENO;;X;PENALOLEN                     ;METROPOLITANA;0;0;2;0;0;0;0;2;0;CELULAR ALCATEL P1 DIRECTO CLARO BLACK;TELEFONIA
17091059;;F;33;CHILENO;;Millenial;RETIRO                        ;MAULE;289970;3;2;0;0;0;3;2;289970;VIVO Y53S DEEP SEA BLUE 128GB OPEN;TELEFONIA
10019308;;F;57;CHILENO;;Boomers;ANTOFAGASTA                   ;ANTOFAGASTA;469980;2;2;0;0;0;2;2;469980;POCO X3 PRO 256 GB PHANTOM BLACK;TELEFONIA
17206723;;F;33;CHILENO;;Millenial;CONCEPCION                    ;BIO BIO;309990;1;1;0;0;0;1;1;309990;CELULAR HUAWEI NOVA 8i BUNDLE;TELEFONIA
18692428;Soltero;F;28;CHILENO;;Millenial;COLBUN                        ;MAULE;72980;3;1;0;0;0;3;1;72980;CELULAR VIVO Y11S 32GB NEBULA BLUE OPEN;TELEFONIA
11454424;;F;53;CHILENO;;X;PEUMO                         ;L.G.B.OÂ´HIGGINS;129990;1;1;0;0;0;1;1;129990;SMARTPHONE A03S 32 GB ROJO;TELEFONIA
12072509;;F;56;CHILENO;;Boomers;LOS ALAMOS                    ;BIO BIO;557940;6;2;0;0;0;6;2;557940;VIVO Y53S DEEP SEA BLUE 128GB OPEN;TELEFONIA
18770909;;M;28;CHILENO;;Millenial;PROVIDENCIA                   ;METROPOLITANA;149991;2;1;0;0;0;2;1;149991;CELULAR A12 128GB Negro OPEN;TELEFONIA
18542436;;F;28;CHILENO;;Millenial;CAUQUENES                     ;MAULE;75990;1;1;0;0;0;1;1;75990;CELULAR Moto E7 Rosado WOM;TELEFONIA
8222723;;F;64;CHILENO;;Boomers;ISLA DE MAIPO                 ;METROPOLITANA;331970;3;1;0;0;0;3;1;331970;Celular XIAOMI REDMI 9 64 GB DIRECTO CLARO NEGRO;TELEFONIA
13616432;;F;42;CHILENO;;X;N/D;N/D;19990;1;1;0;0;0;1;1;19990;CELULAR AZUMI L4G BLACK CLARO;TELEFONIA
6517781;;F;69;CHILENO;;Silencioso;SAN JAVIER                    ;MAULE;298980;2;1;0;0;0;2;1;298980;POCO X3 PRO US 128G METAL BRONZE;TELEFONIA
9512586;;M;56;CHILENO;;Boomers;RENCA                         ;METROPOLITANA;18990;1;1;0;0;0;1;1;18990;TELEFONO PP BINDU ENTEL;TELEFONIA
17570793;;M;32;CHILENO;;Millenial;PROVIDENCIA                   ;METROPOLITANA;279970;3;2;0;0;0;3;2;279970;CELULAR REDMI NOTE 10S 128GB PEBBLE WHITE;TELEFONIA
8795908;;M;62;CHILENO;;Boomers;OSORNO                        ;LOS LAGOS;119990;1;1;0;0;0;1;1;119990;SMARTPHONE A03S NEGRO 32GB;TELEFONIA
6659069;;M;70;CHILENO;;Silencioso;PROVIDENCIA                   ;METROPOLITANA;166980;2;1;0;0;0;2;1;166980;SMARTPHONE A03S NEGRO 32GB;TELEFONIA
17078544;;F;33;CHILENO;;Millenial;PROVIDENCIA                   ;METROPOLITANA;603980;2;1;2;1;603980;0;0;0;Celular Galaxy S21 Phantom Pink 128GB;TELEFONIA
7395778;;F;68;CHILENO;;Silencioso;COIHUECO                      ;BIO BIO;1654910;9;1;0;0;0;9;1;1654910;CELULAR VIVO V21 5G 128GB SUNSET DAZZLE OPEN;TELEFONIA
25642318;;F;39;CHILENO;;Extranjero;QUILLOTA                      ;VALPARAISO;199990;1;1;0;0;0;1;1;199990;CELULAR REDMI NOTE 10S 128GB PEBBLE WHITE;TELEFONIA
18979777;;M;26;CHILENO;;Z;PEUMO                         ;L.G.B.OÂ´HIGGINS;269990;1;1;1;1;269990;0;0;0;CELULAR REDMI NOTE 10 PRO 6+128GB ONYX GRAY;TELEFONIA
16811554;;F;34;CHILENO;;Millenial;CASTRO                        ;LOS LAGOS;184990;1;1;0;0;0;1;1;184990;CELULAR A32 128 GB LIGHT VIOLET OPEN;TELEFONIA
12993874;;F;46;CHILENO;;X;VALDIVIA                      ;LOS RIOS;437960;4;1;0;0;0;4;1;437960;CELULAR REDMI NOTE 10 PRO 128GB GLACIER BLUE;TELEFONIA
18814262;Soltero;M;28;CHILENO;;Millenial;PROVIDENCIA                   ;METROPOLITANA;209990;1;1;0;0;0;1;1;209990;CELULAR A32 128 GB LIGHT VIOLET OPEN;TELEFONIA
20273787;;F;22;CHILENO;;Z;N/D;N/D;329980;2;2;0;0;0;2;2;329980;POCO X3 PRO US 128G METAL BRONZE;TELEFONIA
12814846;;M;47;CHILENO;;X;PROVIDENCIA                   ;METROPOLITANA;159990;1;1;0;0;0;1;1;159990;SMARTHPHONE REDMI 10 US 64GB SEA BLUE;TELEFONIA
19127947;Soltero;M;25;CHILENO;;Z;CONCEPCION;BIO-BIO;239991;2;1;0;0;0;2;1;239991;CELULAR POCO X3 PRO 256 GB FROST BLUE;TELEFONIA
9942261;;F;53;CHILENO;;X;RENCA                         ;METROPOLITANA;279990;1;1;1;1;279990;0;0;0;CELULAR SMARTPHONE A52S 5G BLACK 128GB;TELEFONIA
16362511;;F;36;CHILENO;;Millenial;PUNTA ARENAS                  ;MAGALLANES;302960;4;2;0;0;0;4;2;302960;CELULAR CLARO MOTOROLA E7 32GB GRIS;TELEFONIA
11747869;;F;50;CHILENO;;X;SAN JAVIER                    ;MAULE;1827940;16;9;0;0;0;16;9;1827940;CELULAR A32 128 GB WHITE OPEN;TELEFONIA
8174941;Casado;F;60;CHILENO;PROFESOR;Boomers;PROVIDENCIA                   ;METROPOLITANA;139990;1;1;1;1;139990;0;0;0;CELULAR MOTO ONE FUSION 128GB AZUL OPEN;TELEFONIA
20380366;;F;22;CHILENO;;Z;LA PINTANA                    ;METROPOLITANA;203980;2;1;2;1;203980;0;0;0;CELULAR RENO5 LITE VIOLETA 128GB;TELEFONIA
10805124;;F;43;CHILENO;;X;N/D;N/D;345940;6;4;0;0;0;6;4;345940;CELULAR VIVO Y20S NEBULA 128 GB BLUE OPEN;TELEFONIA
16031913;;M;37;CHILENO;;Millenial;N/D;N/D;224990;1;1;0;0;0;1;1;224990;CELULAR POCO X3 PRO 256 GB FROST BLUE;TELEFONIA
10474166;;M;55;CHILENO;;Boomers;LA CISTERNA                   ;METROPOLITANA;139990;1;1;1;1;139990;0;0;0;CELULAR XIAOMI REDMI 9 64GB DIRECTO CLARO MORADO;TELEFONIA
5029639;;M;80;CHILENO;;Silencioso;"";"";39990;1;1;0;0;0;1;1;39990;CELULAR ALCATEL P1 DIRECTO CLARO BLACK;TELEFONIA
20033709;;M;23;CHILENO;;Z;N/D;N/D;384530;3;2;2;1;244540;1;1;139990;CELULAR MOTO ONE FUSION 128GB AZUL OPEN;TELEFONIA
16868017;;M;34;CHILENO;;Millenial;VALLENAR;ATACAMA;99990;1;1;1;1;99990;0;0;0;CELULAR MOTOROLA G20 64GB BLUE CLARO;TELEFONIA
19733656;;M;24;CHILENO;;Z;PROVIDENCIA                   ;METROPOLITANA;1060460;4;2;0;0;0;4;2;1060460;Celular Galaxy S21 Ultra Phantom Black 128GB;TELEFONIA
6553390;;F;77;CHILENO;;Silencioso;EL BOSQUE                     ;METROPOLITANA;452440;5;5;0;0;0;5;5;452440;CELULAR MOTO G20 EDICION ESPECIAL 4/128 GB VERDE;TELEFONIA
7557347;;M;67;CHILENO;;Boomers;VICTORIA                      ;ARAUCANIA;528951;6;3;0;0;0;6;3;528951;MOTO G30 LILA PASTEL 128GB MOVISTAR;TELEFONIA
13115712;;M;45;CHILENO;;X;RENCA                         ;METROPOLITANA;448970;3;3;0;0;0;3;3;448970;SMARTPHONE A03S 64 GB NEGRO;TELEFONIA
24160758;;F;37;DOMINICANO;;Extranjero;SANTIAGO                      ;METROPOLITANA;329980;2;1;0;0;0;2;1;329980;CELULAR VIVO Y21S MIDNIGHT BLUE 128 GB OPEN;TELEFONIA
9929666;;M;57;CHILENO;;Boomers;PROVIDENCIA                   ;METROPOLITANA;309991;2;1;0;0;0;2;1;309991;CELULAR SMARTPHONE A52S 5G BLACK 128GB;TELEFONIA
18180354;;M;31;CHILENO;;Millenial;AISEN                         ;AYSEN;99990;1;1;0;0;0;1;1;99990;CELULAR OPPO A15 BLACK 32GB CLARO;TELEFONIA
18202525;;M;30;CHILENO;;Millenial;PROVIDENCIA                   ;METROPOLITANA;326980;2;1;2;1;326980;0;0;0;CELULAR SMARTPHONE A52S 5G LIGHT VIOLET 128GB;TELEFONIA
10059925;;M;55;CHILENO;;Boomers;N/D;N/D;176980;2;1;0;0;0;2;1;176980;CELULAR MOTO G30 128GB GRIS TORNASOL OPEN;TELEFONIA
19267850;Soltero;M;26;CHILENO;;Z;"";"";308980;2;4;0;0;0;2;4;308980;CELULAR VIVO V21 5G 128GB SUNSET DAZZLE OPEN;TELEFONIA
26213857;;M;33;HAITIANO;;Extranjero;N/D;N/D;316970;3;2;0;0;0;3;2;316970;CELULAR VIVO Y20S NEBULA 128 GB BLUE OPEN;TELEFONIA
16250361;;M;36;CHILENO;;Millenial;SAN FERNANDO                  ;L.G.B.OÂ´HIGGINS;239990;1;1;0;0;0;1;1;239990;POCO X3 PRO 256 GB METAL BRONCE;TELEFONIA
15772468;;F;36;CHILENO;;Millenial;NIQUEN                        ;BIO BIO;140980;2;1;0;0;0;2;1;140980;SMARTPHONE A03S 64 GB S/SIM NEGRO;TELEFONIA
26108566;;F;34;VENEZOLANO;;Extranjero;NATALES                       ;MAGALLANES;469970;3;3;0;0;0;3;3;469970;REDMI 10 US 128GB Carbon Gray;TELEFONIA
8642390;;F;65;CHILENO;;Boomers;RENCA                         ;METROPOLITANA;105480;2;1;0;0;0;2;1;105480;CELULAR Moto E7 Rosado WOM;TELEFONIA
15511703;;F;39;CHILENO;;X;N/D;N/D;359980;2;2;0;0;0;2;2;359980;CELULAR SMARTPHONE A52S 5G BLACK 128GB;TELEFONIA
12222001;;F;50;CHILENO;;X;QUILPUE                       ;VALPARAISO;94990;1;1;0;0;0;1;1;94990;CELULAR CLARO MOTOROLA E7 32GB GRIS;TELEFONIA
20401188;;F;22;CHILENO;;Z;PROVIDENCIA                   ;METROPOLITANA;139990;1;1;0;0;0;1;1;139990;CELULAR MOTOROLA MOTO G20 64GB ROSA FLAMINGO;TELEFONIA
18789688;;M;27;CHILENO;;Z;SAN CARLOS                    ;BIO BIO;99990;1;1;0;0;0;1;1;99990;CELULAR VIVO Y11S 32GB NEBULA BLUE OPEN;TELEFONIA
20218189;;F;22;CHILENO;;Z;ARICA;TARAPACA;139990;1;1;1;1;139990;0;0;0;CELULAR MOTO G30 128GB GRIS TORNASOL OPEN;TELEFONIA
13345163;;M;44;CHILENO;;X;RENGO                         ;L.G.B.OÂ´HIGGINS;114990;2;1;0;0;0;2;1;114990;CELULAR MOTO G30 128GB LILA PASTEL OPEN;TELEFONIA
18258381;;F;30;CHILENO;;Millenial;N/D;N/D;447960;4;1;0;0;0;4;1;447960;CELULAR A32 128 GB BLACK OPEN;TELEFONIA
13751805;;M;42;CHILENO;;X;N/D;N/D;41980;2;1;2;1;41980;0;0;0;CELULAR NOKIA 225 4G BLACK MOVISTAR DIRECTO;TELEFONIA
21897538;;F;43;PERUANO;;Extranjero;N/D;N/D;209980;4;1;0;0;0;4;1;209980;CELULAR VIVO Y20S OBSIDIAN BLACK 128GB OPEN;TELEFONIA
19279870;;M;26;CHILENO;;Z;PROVIDENCIA                   ;METROPOLITANA;192970;3;2;0;0;0;3;2;192970;CELULAR Moto One Fusion 128GB Blue WOM;TELEFONIA
9751696;;M;56;CHILENO;;Boomers;COIHAIQUE                     ;AYSEN;119990;1;1;0;0;0;1;1;119990;SMARTPHONE A03S AZUL 32GB;TELEFONIA
26169555;;M;26;HAITIANO;;Extranjero;RANCAGUA                      ;L.G.B.OÂ´HIGGINS;264990;2;3;0;0;0;2;3;264990;CELULAR SMARTPHONE A52S 5G LIGHT VIOLET 128GB;TELEFONIA
12948945;;F;46;CHILENO;;X;SAN FELIPE                    ;VALPARAISO;129990;1;1;0;0;0;1;1;129990;CELULAR Moto G20 Blue WOM;TELEFONIA
12192091;Soltero;M;50;CHILENO;;X;RENCA                         ;METROPOLITANA;64990;1;1;0;0;0;1;1;64990;Celular LG K22 ENTEL DIRECTO TITAN;TELEFONIA
18901583;Soltero;F;27;CHILENO;;Millenial;PROVIDENCIA                   ;METROPOLITANA;129990;1;1;0;0;0;1;1;129990;SMARTPHONE A03S NEGRO 32GB;TELEFONIA
16639937;;F;35;CHILENO;;Millenial;PROVIDENCIA                   ;METROPOLITANA;159990;1;1;0;0;0;1;1;159990;SMARTHPHONE REDMI 10 US 64GB SEA BLUE;TELEFONIA
17595318;;M;32;CHILENO;;Millenial;AISEN                         ;AYSEN;2146920;8;5;0;0;0;8;5;2146920;CELULAR XIAOMI 11T PRO 8/256GB MOON WHITE;TELEFONIA
5302913;;M;75;CHILENO;;Silencioso;RENCA                         ;METROPOLITANA;183980;3;1;0;0;0;3;1;183980;CELULAR A32 128 GB LIGHT VIOLET OPEN;TELEFONIA
7589659;;M;66;CHILENO;;Boomers;PARRAL                        ;MAULE;145980;2;1;0;0;0;2;1;145980;CELULAR VIVO Y11S 32GB NEBULA BLUE OPEN;TELEFONIA
16964479;;M;33;CHILENO;;Millenial;PROVIDENCIA                   ;METROPOLITANA;104990;2;1;0;0;0;2;1;104990;XIAOMI REDMI 9T GRIS WOM 128 GB;TELEFONIA
12250696;Casado;M;50;CHILENO;ANALISTA DE SISTEMAS;X;RENCA                         ;METROPOLITANA;169990;1;1;1;1;169990;0;0;0;CELULAR MOTOROLA G9 PLUS 128GB AZUL CLARO;TELEFONIA
15183368;;M;39;CHILENO;;X;PROVIDENCIA                   ;METROPOLITANA;153980;2;1;2;1;153980;0;0;0;CELULAR MOTO G30 128GB LILA PASTEL OPEN;TELEFONIA
11599279;;F;51;CHILENO;;X;NATALES                       ;MAGALLANES;159990;1;1;0;0;0;1;1;159990;CELULAR SAMSUNG A12 128GB BLACK CLARO;TELEFONIA
13474443;;M;43;CHILENO;;X;EL BOSQUE                     ;METROPOLITANA;1163970;3;1;3;1;1163970;0;0;0;IPHONE 11 128GB BLACK CLARO;TELEFONIA
18499851;;F;28;CHILENO;;Millenial;EL BOSQUE                     ;METROPOLITANA;129990;1;1;0;0;0;1;1;129990;CELULAR MOTO G20 64GB ROSA FLAMINGO OPEN;TELEFONIA
19516330;Soltero;F;25;CHILENO;;Z;N/D;N/D;573980;2;1;2;1;573980;0;0;0;IPHONE 11 128GB BLACK CLARO;TELEFONIA
26097604;;F;38;VENEZOLANO;;Extranjero;N/D;N/D;99990;1;1;1;1;99990;0;0;0;CELULAR MOTOROLA G20 64GB BLUE CLARO;TELEFONIA
7673510;Casado;M;64;CHILENO;;Boomers;PENAFLOR                      ;METROPOLITANA;279990;1;2;0;0;0;1;2;279990;VIVO Y53S DEEP SEA BLUE 128GB OPEN;TELEFONIA
20301002;;F;22;CHILENO;;Z;SANTA MARIA                   ;VALPARAISO;149990;1;1;0;0;0;1;1;149990;CELULAR A12 128GB Rojo OPEN;TELEFONIA
20093931;;F;23;CHILENO;;Z;PROVIDENCIA                   ;METROPOLITANA;127971;4;3;0;0;0;4;3;127971;CELULAR REDMI NOTE 8 2021 64GB MOONLIGHT WHITE;TELEFONIA
14051721;;M;41;CHILENO;;X;PROVIDENCIA                   ;METROPOLITANA;6990;1;1;0;0;0;1;1;6990;TELEFONO PP BINDU ENTEL;TELEFONIA
18767227;;F;28;CHILENO;;Millenial;SAN NICOLAS                   ;BIO BIO;99990;1;1;0;0;0;1;1;99990;CELULAR MOTOROLA G20 64GB BLUE CLARO;TELEFONIA
13078743;;F;45;CHILENO;;X;LOS ANGELES                   ;BIO BIO;32980;2;1;0;0;0;2;1;32980;CELULAR AZUMI L4G BLACK CLARO;TELEFONIA
16865857;;M;34;CHILENO;;Millenial;N/D;N/D;139980;2;1;0;0;0;2;1;139980;CELULAR MOTOROLA E7 IPOWER 32GB BLUE CLARO;TELEFONIA
15222168;;F;39;CHILENO;;X;ARAUCO                        ;BIO BIO;391680;3;1;3;1;391680;0;0;0;CELULAR HUAWEI NOVA 8i BUNDLE;TELEFONIA
15802037;;M;38;CHILENO;;Millenial;N/D;N/D;569990;1;1;0;0;0;1;1;569990;CELULAR XIAOMI 11T PRO 8/256GB CELESTIAL BLUE KI;TELEFONIA
13513139;;M;44;CHILENO;;X;LOTA                          ;BIO BIO;169992;1;2;0;0;0;1;2;169992;MOTO G30 LILA PASTEL 128GB MOVISTAR;TELEFONIA
12248449;;M;50;CHILENO;;X;N/D;N/D;119990;1;1;0;0;0;1;1;119990;SMARTPHONE A03S 32 GB ROJO;TELEFONIA
8873090;;M;62;CHILENO;;Boomers;LO ESPEJO                     ;METROPOLITANA;96980;3;1;0;0;0;3;1;96980;CELULAR A12 128GB Azul OPEN;TELEFONIA
6715416;;F;69;CHILENO;;Silencioso;MELIPILLA                     ;METROPOLITANA;79990;1;1;0;0;0;1;1;79990;CELULAR CLARO MOTOROLA E7 32GB GRIS;TELEFONIA
9912111;Casado;M;59;CHILENO;;Boomers;PROVIDENCIA                   ;METROPOLITANA;129990;1;1;0;0;0;1;1;129990;SMARTPHONE A03S 64 GB S/SIM NEGRO;TELEFONIA
15495053;;F;39;CHILENO;;X;COINCO                        ;L.G.B.OÂ´HIGGINS;440970;3;1;0;0;0;3;1;440970;CELULAR SMARTPHONE A52S 5G LIGHT VIOLET 128GB;TELEFONIA
20090263;;M;23;CHILENO;;Z;PROVIDENCIA                   ;METROPOLITANA;189990;1;1;1;1;189990;0;0;0;CELULAR A32 128 GB WHITE OPEN;TELEFONIA
14162057;;M;40;CHILENO;;X;PROVIDENCIA                   ;METROPOLITANA;209990;1;1;1;1;209990;0;0;0;POCO X3 PRO 256 GB METAL BRONCE;TELEFONIA
11686250;;F;51;CHILENO;;X;BUIN                          ;METROPOLITANA;139990;1;1;0;0;0;1;1;139990;CELULAR A12 128GB Azul OPEN;TELEFONIA
11541918;;M;52;CHILENO;;X;PAILLACO                      ;LOS RIOS;179990;1;1;0;0;0;1;1;179990;CELULAR MOTO G30 128GB GRIS TORNASOL OPEN;TELEFONIA
24331422;;F;43;COLOMBIANO;;Extranjero;N/D;N/D;215980;3;1;0;0;0;3;1;215980;CELULAR A32 128 GB WHITE OPEN;TELEFONIA
13241044;;F;46;CHILENO;;X;LOS ANGELES                   ;BIO BIO;155840;2;3;2;1;175840;0;2;-20000;CELULAR POCO X3 PRO 128G PHANTOM BLACK OPEN;TELEFONIA
15528241;;F;38;CHILENO;;X;YERBAS BUENAS                 ;MAULE;189980;2;1;0;0;0;2;1;189980;CELULAR A12 128GB Azul OPEN;TELEFONIA
11264221;;M;54;CHILENO;;X;IQUIQUE                       ;TARAPACA;241540;2;1;2;1;241540;0;0;0;CELULAR POCO X3 PRO 256 GB FROST BLUE;TELEFONIA
14126364;;M;41;CHILENO;;X;N/D;N/D;333980;2;1;2;1;333980;0;0;0;CELULAR SMARTPHONE A52S 5G LIGHT VIOLET 128GB;TELEFONIA
12799509;Casado;F;47;CHILENO;;X;RENCA                         ;METROPOLITANA;119990;1;1;1;1;119990;0;0;0;CELULAR A12 128GB Azul OPEN;TELEFONIA
19495603;;M;24;CHILENO;;Z;ARICA                         ;ARICA Y PARINACOTA;459970;3;3;0;0;0;3;3;459970;CELULAR A12 128GB Negro OPEN;TELEFONIA
17530553;Soltero;F;31;CHILENO;INGENIERO COMERCIAL;Millenial;CALAMA                        ;ANTOFAGASTA;110060;3;1;0;0;0;3;1;110060;Celular VIVO Y11S ENTEL DIRECTO AZUL;TELEFONIA
18683526;;M;28;CHILENO;;Millenial;"";"";519980;2;1;0;0;0;2;1;519980;CELULAR MI 11 LITE 128GB BOBA BLACK OPEN;TELEFONIA
13724395;;F;43;CHILENO;;X;RENCA                         ;METROPOLITANA;22980;2;1;2;1;22980;0;0;0;CELULAR NOKIA 110 BLACK OPEN;TELEFONIA
5778918;Casado;M;75;CHILENO;;Silencioso;RENCA                         ;METROPOLITANA;92470;3;2;0;0;0;3;2;92470;CELULAR MOTO E6I 32GB GRIS OPEN;TELEFONIA
11406422;;F;53;CHILENO;;X;CONCEPCION                    ;BIO BIO;199991;2;1;0;0;0;2;1;199991;CELULAR A32 128 GB BLACK OPEN;TELEFONIA
19676258;;F;24;CHILENO;;Z;PROVIDENCIA                   ;METROPOLITANA;549990;1;1;0;0;0;1;1;549990;IPHONE 11 64GB BLACK CLARO;TELEFONIA
9511751;;F;59;CHILENO;;Boomers;RENCA                         ;METROPOLITANA;6990;1;1;0;0;0;1;1;6990;TELEFONO PP BINDU ENTEL;TELEFONIA
15356223;;M;39;CHILENO;;X;PROVIDENCIA                   ;METROPOLITANA;139990;1;1;0;0;0;1;1;139990;SMARTPHONE A03S 64 GB S/SIM NEGRO;TELEFONIA
19869860;;F;23;CHILENO;;Z;ARICA                         ;TARAPACA;259990;1;1;0;0;0;1;1;259990;CELULAR MI 11 LITE 128GB BOBA BLACK OPEN;TELEFONIA
19307821;;F;26;CHILENO;;Z;PROVIDENCIA                   ;METROPOLITANA;223980;2;1;2;1;223980;0;0;0;CELULAR A32 128 GB LIGHT VIOLET OPEN;TELEFONIA
18652247;;M;28;CHILENO;;Millenial;NACIMIENTO                    ;BIO BIO;79990;1;1;0;0;0;1;1;79990;CELULAR ZTE A5 2020 DIRECTO CLARO VERDE;TELEFONIA
19199252;Soltero;F;26;CHILENO;TERAPEUTA OCUPACIONAL;Z;PROVIDENCIA                   ;METROPOLITANA;79990;2;1;0;0;0;2;1;79990;CELULAR Xiaomi Redmi 9 64 GB Morado WOM;TELEFONIA
8042134;;M;63;CHILENO;;Boomers;RENCA                         ;METROPOLITANA;573980;2;1;2;1;573980;0;0;0;IPHONE 11 128GB BLACK CLARO;TELEFONIA
15915452;;M;37;CHILENO;;Millenial;PROVIDENCIA                   ;METROPOLITANA;189990;1;1;1;1;189990;0;0;0;CELULAR A32 128 GB BLACK OPEN;TELEFONIA
17763967;;M;31;CHILENO;;Millenial;PROVIDENCIA                   ;METROPOLITANA;229990;1;1;0;0;0;1;1;229990;CELULAR VIVO Y53S FANTASTIC RAINBOW 128GB OPEN;TELEFONIA
18484960;Soltero;M;29;CHILENO;;Millenial;N/D;N/D;119990;1;1;1;1;119990;0;0;0;CELULAR A12 128GB Rojo OPEN;TELEFONIA
19854228;;F;23;CHILENO;;Z;PEUMO                         ;L.G.B.OÂ´HIGGINS;180970;3;2;0;0;0;3;2;180970;CELULAR A12 128GB Rojo OPEN;TELEFONIA
20085937;;F;34;CHILENO;;Millenial;VILLARICA                     ;ARAUCANIA;304990;1;1;0;0;0;1;1;304990;CELULAR SMARTPHONE A52S 5G BLACK 128GB;TELEFONIA
17437262;;F;32;CHILENO;;Millenial;PROVIDENCIA                   ;METROPOLITANA;219640;2;1;2;1;219640;0;0;0;POCO X3 PRO US 128G METAL BRONZE;TELEFONIA
19508214;;F;26;CHILENO;;Z;PROVIDENCIA                   ;METROPOLITANA;89990;2;1;0;0;0;2;1;89990;CELULAR VIVO Y20S OBSIDIAN BLACK 128GB OPEN;TELEFONIA
19558073;;F;25;CHILENO;;Z;PUDAHUEL                      ;METROPOLITANA;623980;2;1;2;1;623980;0;0;0;CELULAR NOTE 20 ULTRA MYSTIC BRONZE 256 GB OPE;TELEFONIA
17233480;;F;33;CHILENO;;Millenial;RENCA                         ;METROPOLITANA;219990;1;1;0;0;0;1;1;219990;CELULAR A32 128 GB BLUE OPEN;TELEFONIA
16727855;;M;35;CHILENO;;Millenial;PROVIDENCIA                   ;METROPOLITANA;193970;4;2;2;1;133980;2;1;59990;CELULAR Redmi 9C 32GB Gray WOM;TELEFONIA
7567985;Soltero;F;69;CHILENO;;Silencioso;LITUECHE                      ;L.G.B.OÂ´HIGGINS;139990;1;1;0;0;0;1;1;139990;CELULAR A12 128GB Azul OPEN;TELEFONIA
18391398;Soltero;F;29;CHILENO;;Silencioso;PROVIDENCIA                   ;METROPOLITANA;573980;2;1;2;1;573980;0;0;0;IPHONE 11 128GB BLACK CLARO;TELEFONIA
12291027;;M;52;CHILENO;;X;RENCA                         ;METROPOLITANA;229990;1;1;1;1;229990;0;0;0;POCO X3 PRO 256 GB PHANTOM BLACK;TELEFONIA
14301646;;F;45;CHILENO;;X;TALCAHUANO                    ;BIO BIO;249980;2;1;0;0;0;2;1;249980;CELULAR REDMI NOTE 10S 128GB PEBBLE WHITE;TELEFONIA
14241875;;M;48;CHILENO;;X;RENGO                         ;L.G.B.OÂ´HIGGINS;119990;1;1;0;0;0;1;1;119990;CELULAR MOTO G20 64GB ROSA FLAMINGO OPEN;TELEFONIA
12009004;;M;55;CHILENO;;X;RETIRO                        ;MAULE;304980;4;1;0;0;0;4;1;304980;CELULAR POCO X3 PRO 128 GB FROST BLUE;TELEFONIA
20317922;;F;22;CHILENO;;Z;PROVIDENCIA                   ;METROPOLITANA;179990;2;1;0;0;0;2;1;179990;CELULAR REDMI NOTE 10S 128GB PEBBLE WHITE;TELEFONIA
10638429;;F;58;CHILENO;;Boomers;REQUINOA                      ;L.G.B.OÂ´HIGGINS;169980;2;2;0;0;0;2;2;169980;CELULAR CLARO MOTOROLA E7 32GB GRIS;TELEFONIA
16393319;;F;35;CHILENO;;Silencioso;MELIPILLA                     ;METROPOLITANA;149990;1;1;0;0;0;1;1;149990;CELULAR A12 128GB Azul OPEN;TELEFONIA
26923362;;F;49;EXTRANJERO - NO INFORMA NACIONALIDAD;;Extranjero;"";"";305480;2;1;2;1;305480;0;0;0;CELULAR HUAWEI NOVA 8i BUNDLE;TELEFONIA
19345241;Soltero;M;25;CHILENO;;Z;QUILICURA                     ;METROPOLITANA;1249950;6;3;6;3;1249950;0;0;0;CELULAR XIAOMI 11T PRO 8/256GB MOON WHITE;TELEFONIA
9103726;;F;60;CHILENO;;Boomers;PROVIDENCIA                   ;METROPOLITANA;129990;1;1;0;0;0;1;1;129990;VIVO Y20 OBSIDIAN BLACK OPEN;TELEFONIA
7714150;;F;64;CHILENO;;Boomers;YUMBEL                        ;BIO BIO;149990;1;1;0;0;0;1;1;149990;CELULAR MOTO ONE FUSION 128GB AZUL OPEN;TELEFONIA
17712723;;F;31;CHILENO;;Millenial;PROVIDENCIA                   ;METROPOLITANA;143980;2;2;1;1;129990;1;1;13990;CELULAR A12 128GB Rojo OPEN;TELEFONIA
18759656;Soltero;F;28;CHILENO;;Millenial;PROVIDENCIA                   ;METROPOLITANA;189990;1;1;1;1;189990;0;0;0;CELULAR A32 128 GB BLUE OPEN;TELEFONIA
6199374;;M;71;CHILENO;;Silencioso;RENCA                         ;METROPOLITANA;69990;1;1;0;0;0;1;1;69990;CELULAR MOTO E7I POWER 32GB BLUE MOVISTAR;TELEFONIA
9996075;;M;58;CHILENO;;Boomers;PENCO                         ;BIO BIO;74990;1;1;0;0;0;1;1;74990;CELULAR MOTOROLA E7 IPOWER 32GB BLUE CLARO;TELEFONIA
9380440;;M;57;CHILENO;;Boomers;PROVIDENCIA                   ;METROPOLITANA;149990;1;1;1;1;149990;0;0;0;Celular Y8P ENTEL TRIANGULADO NEGRO;TELEFONIA
25412722;;M;64;PERUANO;;Extranjero;ESTACION CENTRAL              ;METROPOLITANA;119990;2;1;0;0;0;2;1;119990;CELULAR A54 OPPO NEGRO 128GB;TELEFONIA
27214096;;M;27;EXTRANJERO - NO INFORMA NACIONALIDAD;;Extranjero;N/D;N/D;159990;2;1;0;0;0;2;1;159990;CELULAR POCO X3 PRO 128G PHANTOM BLACK OPEN;TELEFONIA
13936054;;F;48;CHILENO;;X;N/D;N/D;344980;3;2;0;0;0;3;2;344980;CELULAR VIVO Y51 CRYSTAL SYMPHONY OPEN;TELEFONIA
15943206;;F;37;CHILENO;;Millenial;COLBUN                        ;MAULE;129480;2;1;0;0;0;2;1;129480;CELULAR REDMI 9C 64GB SUNRISE ORANGE;TELEFONIA
23516546;;M;32;EXTRANJERO - NO INFORMA NACIONALIDAD;;Extranjero;INDEPENDENCIA                 ;METROPOLITANA;259990;1;1;0;0;0;1;1;259990;POCO X3 PRO 256 GB METAL BRONCE;TELEFONIA
4861454;;F;77;CHILENO;;Silencioso;SAN FELIPE                    ;VALPARAISO;86480;2;1;0;0;0;2;1;86480;Celular SAMSUNG A01 CORE BLACK CLARO;TELEFONIA
8128550;;M;60;CHILENO;;Boomers;N/D;N/D;103980;2;1;2;1;103980;0;0;0;Celular Y7P LIB OPEN NEGRO;TELEFONIA
5582469;;M;77;CHILENO;;Silencioso;"";"";705830;3;1;3;1;705830;0;0;0;CELULAR SMARTPHONE A52S 5G BLACK 128GB;TELEFONIA
17946552;;F;38;CHILENO;;Millenial;N/D;N/D;505840;2;1;2;1;505840;0;0;0;IPHONE 11 64GB BLACK CLARO;TELEFONIA
16164189;;F;37;CHILENO;;Millenial;QUILICURA                     ;METROPOLITANA;144980;2;1;0;0;0;2;1;144980;CELULAR MOTOROLA G9 PLAY 64GB ELECTRIC BLUE OPEN;TELEFONIA
15255598;;M;43;CHILENO;;X;N/D;N/D;248970;3;2;0;0;0;3;2;248970;CELULAR A22 128GB NEGRO;TELEFONIA
21118775;;M;32;CHILENO;;Extranjero;LOS VILOS                     ;COQUIMBO;373970;3;2;0;0;0;3;2;373970;CELULAR MOTO G9 POWER 128GB MORADO SONICO OPEN;TELEFONIA
17062830;Soltero;F;33;CHILENO;;Millenial;PROVIDENCIA                   ;METROPOLITANA;264980;3;1;0;0;0;3;1;264980;CELULAR MI 11 LITE 128GB BUBBLEGUM BLUE;TELEFONIA
18074789;;M;30;CHILENO;;Millenial;PROVIDENCIA                   ;METROPOLITANA;17990;1;1;1;1;17990;0;0;0;CELULAR NOKIA 110 BLACK OPEN;TELEFONIA
7268647;;M;65;CHILENO;;Boomers;RENCA                         ;METROPOLITANA;65980;2;1;0;0;0;2;1;65980;CELULAR MOTOROLA E6 PLAY AZUL TRI WOM;TELEFONIA
13350640;;M;44;CHILENO;;X;RENCA                         ;METROPOLITANA;195480;2;1;2;1;195480;0;0;0;Celular P40 LITE LIB OPEN GREEN;TELEFONIA
17092165;;M;33;CHILENO;;Millenial;PROVIDENCIA                   ;METROPOLITANA;709640;2;1;2;1;709640;0;0;0;Celular Galaxy S21 Plus Phantom Black 128GB;TELEFONIA
7820203;;M;66;CHILENO;;Boomers;TALCAHUANO                    ;BIO BIO;109480;2;1;0;0;0;2;1;109480;CELULAR VIVO Y11s PHANTOM BLACK ENTEL DIRECTO;TELEFONIA
15766348;;M;37;CHILENO;;Millenial;QUILPUE                       ;VALPARAISO;129970;3;2;3;2;129970;0;0;0;CELULAR Samsung Galaxy A02s 32GB Azul WOM;TELEFONIA
19701290;;F;24;CHILENO;;Millenial;PROVIDENCIA                   ;METROPOLITANA;74540;2;1;2;1;74540;0;0;0;CELULAR REDMI 9C 32GB MIDNIGHT GRAY;TELEFONIA
13676090;;F;42;CHILENO;;X;PROVIDENCIA                   ;METROPOLITANA;219980;2;2;2;2;219980;0;0;0;CELULAR POCO X3 PRO 128G PHANTOM BLACK OPEN;TELEFONIA
13169856;;M;44;CHILENO;;X;PUDAHUEL                      ;METROPOLITANA;20000;0;2;0;0;0;0;2;20000;CELULAR MOTO E7 32GB ROSA CORAL OPEN;TELEFONIA
7987281;;F;66;CHILENO;;Boomers;N/D;N/D;103980;2;1;2;1;103980;0;0;0;CELULAR XIAOMI REDMI 9 64GB DIRECTO CLARO MORADO;TELEFONIA
12587861;Casado;M;48;CHILENO;;X;PROVIDENCIA                   ;METROPOLITANA;990;1;1;0;0;0;1;1;990;CHIP OPEN ENTEL;TELEFONIA
16261269;;F;36;CHILENO;;Millenial;PROVIDENCIA                   ;METROPOLITANA;373980;2;1;2;1;373980;0;0;0;CELULAR SMARTPHONE A52S 5G BLACK 128GB;TELEFONIA
3783280;;M;87;CHILENO;;Silencioso;ESTACION CENTRAL              ;METROPOLITANA;89990;1;1;0;0;0;1;1;89990;CELULAR Redmi 9C 32GB Gray WOM;TELEFONIA
18708015;;M;27;CHILENO;;Millenial;PROVIDENCIA                   ;METROPOLITANA;183980;2;1;2;1;183980;0;0;0;CELULAR A22 128GB NEGRO;TELEFONIA
14245856;;F;48;CHILENO;;X;RENCA                         ;METROPOLITANA;129990;1;1;0;0;0;1;1;129990;CELULAR POCO M3 128GB POWER BLACK;TELEFONIA
19427047;;M;26;CHILENO;;Silencioso;PROVIDENCIA                   ;METROPOLITANA;357960;4;2;4;2;357960;0;0;0;CELULAR POCO X3 PRO 128 GB FROST BLUE;TELEFONIA
5372783;Casado;F;72;CHILENO;;Silencioso;SAN FERNANDO                  ;L.G.B.OÂ´HIGGINS;79990;1;1;0;0;0;1;1;79990;CELULAR MOTOROLA G9 PLAY 64GB ELECTRIC BLUE OPEN;TELEFONIA
18192079;;F;29;CHILENO;;Millenial;N/D;N/D;293970;3;2;3;2;293970;0;0;0;POCO X3 PRO 256 GB METAL BRONCE;TELEFONIA
9427217;;F;61;CHILENO;;Boomers;RENCA                         ;METROPOLITANA;91770;2;1;0;0;0;2;1;91770;CELULAR MOTOROLA E6 PLAY AZUL TRI WOM;TELEFONIA
18905540;Soltero;M;27;CHILENO;;Silencioso;PROVIDENCIA                   ;METROPOLITANA;769990;2;1;2;1;769990;0;0;0;IPHONE 12 128GB BLACK CLARO;TELEFONIA
10456141;;F;45;CHILENO;;Silencioso;PROVIDENCIA                   ;METROPOLITANA;123060;3;1;0;0;0;3;1;123060;CELULAR POCO M3 64GB COOL BLUE;TELEFONIA
18538893;;M;29;CHILENO;;Millenial;PROVIDENCIA                   ;METROPOLITANA;209990;1;1;0;0;0;1;1;209990;CELULAR POCO X3 PRO 128 GB FROST BLUE;TELEFONIA
10160542;Soltero;F;57;CHILENO;;Boomers;RENCA                         ;METROPOLITANA;769990;2;1;2;1;769990;0;0;0;CELULAR IPHONE 12 128GB WHITE CLARO;TELEFONIA
9806808;Casado;M;59;CHILENO;;Boomers;RENCA                         ;METROPOLITANA;129480;2;1;0;0;0;2;1;129480;CELULAR SAMSUNG A02S DIRECTO CLARO BLACK;TELEFONIA
11718855;;F;50;CHILENO;;X;CASTRO                        ;LOS LAGOS;64480;3;1;0;0;0;3;1;64480;CELULAR XIAOMI REDMI 9A 32GB BLACK DIRECTO CLARO;TELEFONIA
10070293;;M;58;CHILENO;;Boomers;N/D;N/D;89990;1;1;0;0;0;1;1;89990;CELULAR VIVO Y11S PHANTON BLACK 32GB MOVISTAR;TELEFONIA
13403944;Soltero;M;44;CHILENO;;Silencioso;PROVIDENCIA                   ;METROPOLITANA;29990;1;1;1;1;29990;0;0;0;CELULAR OWN 1026 AZUL ENTEL;TELEFONIA
18605832;;M;28;CHILENO;;Silencioso;PROVIDENCIA                   ;METROPOLITANA;173980;2;1;2;1;173980;0;0;0;CELULAR POCO X3 PRO 128 GB FROST BLUE;TELEFONIA
12545794;;F;48;CHILENO;;X;CURANILAHUE                   ;BIO BIO;124990;1;1;0;0;0;1;1;124990;XIAOMI REDMI 9T CARBON GRAY 128GB MOVISTAR;TELEFONIA
7828623;;M;66;CHILENO;;Boomers;FREIRINA                      ;ATACAMA;119991;2;1;0;0;0;2;1;119991;SMARTPHONE A03S AZUL 32GB;TELEFONIA
16771204;;M;34;CHILENO;;Millenial;N/D;N/D;261520;4;1;4;1;261520;0;0;0;CELULAR POCO X3 PRO 256 GB FROST BLUE;TELEFONIA
17512469;;F;32;CHILENO;;Millenial;RENGO                         ;L.G.B.OÂ´HIGGINS;79990;1;1;0;0;0;1;1;79990;CELULAR MOTO E7I POWER ORANGE 32GB MOVISTAR;TELEFONIA
19848814;;F;27;CHILENO;;Z;N/D;N/D;64990;1;1;0;0;0;1;1;64990;CELULAR MOTO E7I POWER 32GB BLUE MOVISTAR;TELEFONIA
12726504;Divorciado;M;46;CHILENO;ENFERMERO MATRON;X;PROVIDENCIA                   ;METROPOLITANA;169990;1;1;1;1;169990;0;0;0;CELULAR POCO X3 PRO 128G PHANTOM BLACK OPEN;TELEFONIA
12976944;;M;46;CHILENO;;X;CHILLAN                       ;BIO BIO;469990;2;1;0;0;0;2;1;469990;CELULAR GALAXY S20FE 128GB CLOUD LAVENDER OPEN;TELEFONIA
6230880;;M;67;CHILENO;;Boomers;LA SERENA                     ;COQUIMBO;91770;2;1;0;0;0;2;1;91770;CELULAR MOTOROLA E6 PLAY AZUL TRI WOM;TELEFONIA
6361068;;F;73;CHILENO;;Silencioso;PROVIDENCIA                   ;METROPOLITANA;73980;2;1;2;1;73980;0;0;0;CELULAR XIAOMI REDMI 9C 32GB AZUL WOM;TELEFONIA
9533926;;M;60;CHILENO;;Boomers;CURICO                        ;MAULE;255980;2;1;0;0;0;2;1;255980;CELULAR REDMI NOTE 10 PRO 128GB GLACIER BLUE;TELEFONIA
13606648;;F;42;CHILENO;;X;CURANILAHUE                   ;BIO BIO;174470;3;2;0;0;0;3;2;174470;CELULAR MOTO E6I 32GB GRIS OPEN;TELEFONIA
9366670;;F;56;CHILENO;;Boomers;NUEVA IMPERIAL                ;ARAUCANIA;24990;2;1;0;0;0;2;1;24990;CELULAR MOTOROLA E6 PLAY AZUL TRI WOM;TELEFONIA
17986402;;F;30;CHILENO;;Millenial;N/D;N/D;-35990;-1;1;0;0;0;-1;1;-35990;CELULAR NOKIA 225 4G BLACK MOVISTAR DIRECTO;TELEFONIA
17520724;;F;31;CHILENO;;Millenial;PROVIDENCIA                   ;METROPOLITANA;239990;1;1;0;0;0;1;1;239990;CELULAR MI 11 LITE 128GB BOBA BLACK OPEN;TELEFONIA
17505704;;F;32;CHILENO;;Millenial;RANCAGUA;O HIGGINS;109990;1;1;1;1;109990;0;0;0;CELULAR MOTO G20 64GB AZUL OPEN;TELEFONIA
9633068;;F;68;CHILENO;;Boomers;NUNOA                         ;METROPOLITANA;145860;3;1;0;0;0;3;1;145860;CELULAR REDMI 9C 32GB MIDNIGHT GRAY;TELEFONIA
9761916;Casado;M;58;CHILENO;AGRONOMO;Silencioso;PROVIDENCIA                   ;METROPOLITANA;195840;2;1;2;1;195840;0;0;0;Celular P40 LITE LIB OPEN GREEN;TELEFONIA
17223920;;M;32;CHILENO;;Millenial;"";"";199990;1;1;0;0;0;1;1;199990;CELULAR POCO X3 PRO 256 GB FROST BLUE;TELEFONIA
15735503;;F;38;CHILENO;;X;PUENTE ALTO                   ;METROPOLITANA;29990;2;1;0;0;0;2;1;29990;CELULAR MOTO E7 32GB ROSA CORAL OPEN;TELEFONIA
14377332;;F;45;CHILENO;;X;PROVIDENCIA                   ;METROPOLITANA;119990;1;1;0;0;0;1;1;119990;SMARTPHONE A03S NEGRO 32GB;TELEFONIA
18459587;;F;29;CHILENO;;Silencioso;PROVIDENCIA                   ;METROPOLITANA;169990;1;1;1;1;169990;0;0;0;CELULAR POCO X3 PRO 128G PHANTOM BLACK OPEN;TELEFONIA
19844118;;M;24;CHILENO;;Z;PROVIDENCIA                   ;METROPOLITANA;213980;2;1;2;1;213980;0;0;0;POCO X3 PRO 256 GB PHANTOM BLACK;TELEFONIA
15666010;;M;38;CHILENO;;Millenial;PROVIDENCIA                   ;METROPOLITANA;903980;2;1;2;1;903980;0;0;0;CELULAR IPHONE 12 PRO 128GB GRAFITO CLARO;TELEFONIA
13179159;;M;44;CHILENO;;X;PROVIDENCIA                   ;METROPOLITANA;249990;1;1;0;0;0;1;1;249990;CELULAR HUAWEI Y9A BLACK OPEN;TELEFONIA
19899807;;F;22;CHILENO;;Z;PROVIDENCIA                   ;METROPOLITANA;99990;1;1;0;0;0;1;1;99990;CELULAR REDMI NOTE 8 2021 64GB MOONLIGHT WHITE;TELEFONIA
19847432;;F;24;CHILENO;;Z;N/D;N/D;209990;1;1;0;0;0;1;1;209990;CELULAR POCO X3 PRO 128 GB FROST BLUE;TELEFONIA
17586474;;F;31;CHILENO;;Millenial;PROVIDENCIA                   ;METROPOLITANA;19990;1;1;0;0;0;1;1;19990;Celular AL3 CLARO DIRECTO NEGRO;TELEFONIA
11866946;;M;51;CHILENO;;X;PROVIDENCIA                   ;METROPOLITANA;36990;1;1;0;0;0;1;1;36990;CELULAR NOKIA 225 4G BLACK MOVISTAR DIRECTO;TELEFONIA
14074841;;M;41;CHILENO;;X;CASTRO                        ;LOS LAGOS;99990;1;1;0;0;0;1;1;99990;CELULAR VIVO Y11S PHANTON BLACK 32GB MOVISTAR;TELEFONIA
20339850;;F;45;CHILENO;;X;PUCON                         ;ARAUCANIA;149990;1;1;0;0;0;1;1;149990;CELULAR Moto One Fusion 128GB Blue WOM;TELEFONIA
17830813;;M;31;CHILENO;;Silencioso;PROVIDENCIA                   ;METROPOLITANA;499290;3;1;3;1;499290;0;0;0;CELULAR GALAXY S20FE 128GB CLOUD LAVENDER OPEN;TELEFONIA
16493641;;F;35;CHILENO;;Silencioso;PROVIDENCIA                   ;METROPOLITANA;229990;1;1;0;0;0;1;1;229990;CELULAR A32 128 GB WHITE OPEN;TELEFONIA
18153649;;F;29;CHILENO;;Millenial;RENCA                         ;METROPOLITANA;479990;3;1;3;1;479990;0;0;0;CELULAR GALAXY S20FE 128GB ClOUD NAVY OPEN;TELEFONIA
6517803;;F;68;CHILENO;;Boomers;PENAFLOR                      ;METROPOLITANA;159990;1;1;0;0;0;1;1;159990;CELULAR REDMI NOTE 10 128GB PEBBLE WHITE;TELEFONIA
14359011;;M;44;CHILENO;;X;N/D;N/D;99990;1;1;0;0;0;1;1;99990;CELULAR REDMI 9 64GB SUNSET PURPLE TRI WOM;TELEFONIA
13345692;;F;43;CHILENO;;X;RENCA                         ;METROPOLITANA;149990;1;1;1;1;149990;0;0;0;CELULAR A12 128GB Negro OPEN;TELEFONIA
18771707;;F;27;CHILENO;;Millenial;PROVIDENCIA                   ;METROPOLITANA;229990;1;1;1;1;229990;0;0;0;CELULAR MI 11 LITE 128GB BUBBLEGUM BLUE;TELEFONIA
19938687;;M;24;CHILENO;;Z;PROVIDENCIA                   ;METROPOLITANA;198540;2;1;2;1;198540;0;0;0;Celular P40 LITE LIB OPEN GREEN;TELEFONIA
12098730;;F;53;CHILENO;;X;LOS ANGELES                   ;BIO BIO;259990;1;1;0;0;0;1;1;259990;CELULAR HUAWEI Y9A BLACK OPEN;TELEFONIA
26823233;;F;38;CHILENO;;Extranjero;TEMUCO                        ;ARAUCANIA;359980;4;2;0;0;0;4;2;359980;CELULAR REDMI NOTE 10S 128GB ONIX BLACK;TELEFONIA
9479325;;M;59;CHILENO;;Boomers;RENCA                         ;METROPOLITANA;193980;2;1;2;1;193980;0;0;0;CELULAR REDMI NOTE 10S 128GB OCEAN BLUE;TELEFONIA
9299835;;M;61;CHILENO;;Boomers;CHILLAN                       ;BIO BIO;119991;2;1;0;0;0;2;1;119991;CELULAR MOTOROLA G9 PLAY 64GB SPRING PINK OPEN;TELEFONIA
26645426;;M;36;EXTRANJERO - NO INFORMA NACIONALIDAD;;Extranjero;N/D;N/D;103980;2;1;2;1;103980;0;0;0;CELULAR Moto One Fusion 128GB Blue WOM;TELEFONIA
5110236;;M;77;CHILENO;;Silencioso;LINARES                       ;MAULE;34990;1;1;0;0;0;1;1;34990;CELULAR ALCATEL P1 DIRECTO CLARO BLACK;TELEFONIA
11165774;;F;55;CHILENO;;Boomers;PUCHUNCAVI                    ;VALPARAISO;199990;1;1;1;1;199990;0;0;0;CELULAR POCO X3 PRO 256 GB FROST BLUE;TELEFONIA
9107326;;M;61;CHILENO;;Boomers;N/D;N/D;407950;5;3;0;0;0;5;3;407950;CELULAR REDMI NOTE 10 PRO 6+128GB ONYX GRAY;TELEFONIA
7961712;;M;60;CHILENO;;Boomers;RENCA                         ;METROPOLITANA;119990;1;1;0;0;0;1;1;119990;SMARTPHONE A03S AZUL 32GB;TELEFONIA
12937549;Soltero;F;46;CHILENO;CONTADOR AUDITOR;X;ALTO HOSPICIO;TARAPACA;79990;1;1;0;0;0;1;1;79990;Celular NOKIA 4.2 ENTEL DIRECTO NEGRO;TELEFONIA
5372224;;F;80;CHILENO;;Silencioso;MELIPILLA                     ;METROPOLITANA;244980;2;1;0;0;0;2;1;244980;CELULAR POCO X3 PRO 256 GB FROST BLUE;TELEFONIA
16636918;;F;35;CHILENO;;Silencioso;PROVIDENCIA                   ;METROPOLITANA;109990;1;1;0;0;0;1;1;109990;CELULAR Xiaomi Redmi 9 64 GB Morado WOM;TELEFONIA
14049808;;M;41;CHILENO;;X;PERALILLO                     ;L.G.B.OÂ´HIGGINS;194540;2;1;2;1;194540;0;0;0;POCO X3 PRO 256 GB PHANTOM BLACK;TELEFONIA
18452749;;F;28;CHILENO;;Millenial;PROVIDENCIA                   ;METROPOLITANA;299990;1;1;1;1;299990;0;0;0;CELULAR IPHONE SE 64GB DIRECTO CLARO;TELEFONIA
12734282;;M;46;CHILENO;;X;PROVIDENCIA                   ;METROPOLITANA;149991;2;1;0;0;0;2;1;149991;CELULAR MOTO G20 64GB AZUL OPEN;TELEFONIA
18511019;;F;29;CHILENO;;Millenial;RENCA                         ;METROPOLITANA;41990;2;1;0;0;0;2;1;41990;CELULAR MOTO E7 GRIS MINERAL MOVISTAR;TELEFONIA
14475007;;M;48;CHILENO;;X;RENCA                         ;METROPOLITANA;74990;1;1;0;0;0;1;1;74990;CELULAR MOTO E7i 32GB AZUL OPEN;TELEFONIA
16474023;;M;35;CHILENO;;Silencioso;PROVIDENCIA                   ;METROPOLITANA;133980;2;1;2;1;133980;0;0;0;CELULAR Galaxy A21s (128GB) Black WOM;TELEFONIA
16897734;;M;33;CHILENO;;Millenial;PROVIDENCIA                   ;METROPOLITANA;30990;5;2;0;0;0;5;2;30990;CELULAR VIVO Y11S PHANTON BLACK 32GB MOVISTAR;TELEFONIA
19502167;;M;26;CHILENO;;Z;PUERTO MONTT                  ;LOS LAGOS;198540;2;1;2;1;198540;0;0;0;POCO X3 PRO 256 GB METAL BRONCE;TELEFONIA
6338784;;F;73;CHILENO;;Silencioso;MAIPU                         ;METROPOLITANA;119980;3;2;0;0;0;3;2;119980;SMARTPHONE A03S NEGRO 32GB;TELEFONIA
13356690;;M;44;CHILENO;;X;N/D;N/D;154982;2;2;0;0;0;2;2;154982;CELULAR CLARO MOTOROLA E7 32GB GRIS;TELEFONIA
14000346;;M;40;CHILENO;;X;N/D;N/D;174980;2;1;2;1;174980;0;0;0;CELULAR POCO X3 PRO 128G PHANTOM BLACK OPEN;TELEFONIA
18704309;;M;28;CHILENO;;Millenial;VINA DEL MAR;VALPARAISO;489970;3;1;3;1;489970;0;0;0;CELULAR GALAXY S20FE 128GB CLOUD GREEN OPEN;TELEFONIA
25745746;;M;43;VENEZOLANO;;Extranjero;CONCON                        ;VALPARAISO;99990;1;1;1;1;99990;0;0;0;CELULAR REDMI NOTE 8 2021 64GB NEPTUNE BLUE;TELEFONIA
12952715;;F;46;CHILENO;;Silencioso;PROVIDENCIA                   ;METROPOLITANA;173980;2;1;2;1;173980;0;0;0;CELULAR POCO X3 PRO 128 GB FROST BLUE;TELEFONIA
12293922;;F;49;CHILENO;;X;RENCA                         ;METROPOLITANA;189990;1;1;1;1;189990;0;0;0;Celular P40 LITE LIB OPEN GREEN;TELEFONIA
19482552;;M;25;CHILENO;;Z;PROVIDENCIA                   ;METROPOLITANA;803980;2;1;2;1;803980;0;0;0;IPHONE 12 128GB BLACK CLARO;TELEFONIA
16256035;;F;35;CHILENO;;Millenial;"";"";539980;2;2;1;1;139990;1;1;399990;CELULAR GALAXY S20FE 128GB ClOUD NAVY OPEN;TELEFONIA
22401599;;F;43;BOLIVIANO;;Extranjero;ALTO HOSPICIO;TARAPACA;201540;2;1;2;1;201540;0;0;0;POCO X3 PRO 256 GB METAL BRONCE;TELEFONIA
8552943;;M;64;CHILENO;;Boomers;CAUQUENES                     ;MAULE;159980;2;1;0;0;0;2;1;159980;CELULAR Galaxy A21s (128GB) Black WOM;TELEFONIA
10623237;Soltero;F;52;CHILENO;AUXILIAR PARAMEDICO DE ENFERMERIA;X;PROVIDENCIA                   ;METROPOLITANA;119990;1;1;0;0;0;1;1;119990;SMARTPHONE A03S NEGRO 32GB;TELEFONIA
9997273;;F;58;CHILENO;;Boomers;MELIPILLA                     ;METROPOLITANA;471960;4;1;0;0;0;4;1;471960;CELULAR MOTOROLA G9 PLUS 128GB AZUL CLARO;TELEFONIA
10059417;;F;59;CHILENO;;Boomers;RENCA                         ;METROPOLITANA;79990;1;1;0;0;0;1;1;79990;CELULAR Redmi 9C 32GB Gray WOM;TELEFONIA
14221407;;F;41;CHILENO;;X;PROVIDENCIA                   ;METROPOLITANA;62980;2;2;0;0;0;2;2;62980;CELULAR NOKIA QUEEN VALUE BLACK CLARO;TELEFONIA
12205688;;F;49;CHILENO;;X;RENCA                         ;METROPOLITANA;133980;2;1;2;1;133980;0;0;0;CELULAR A12 128GB Negro OPEN;TELEFONIA
18094625;;M;30;CHILENO;;Millenial;"";"";44990;2;1;0;0;0;2;1;44990;CELULAR CLARO MOTOROLA E7 32GB GRIS;TELEFONIA
17478945;;F;32;CHILENO;;Millenial;ILLAPEL                       ;COQUIMBO;139990;1;1;0;0;0;1;1;139990;CELULAR A21s 128 GB Negro;TELEFONIA
15204649;;M;40;CHILENO;;X;LOS ANGELES                   ;BIO BIO;304980;2;1;0;0;0;2;1;304980;CELULAR MOTOROLA G9 PLUS 128GB AZUL CLARO;TELEFONIA
9183946;;M;61;CHILENO;;Boomers;CAUQUENES                     ;MAULE;250980;2;1;0;0;0;2;1;250980;MOTO G30 LILA PASTEL 128GB MOVISTAR;TELEFONIA
6316576;;M;70;CHILENO;;Silencioso;PROVIDENCIA                   ;METROPOLITANA;189980;2;1;0;0;0;2;1;189980;CELULAR A12 128GB Negro OPEN;TELEFONIA
19144075;Soltero;F;26;CHILENO;;Z;PROVIDENCIA                   ;METROPOLITANA;49990;1;1;1;1;49990;0;0;0;CELULAR ZTE A3 2020 GRIS DIRECTO CLARO;TELEFONIA
13979498;;M;40;CHILENO;;X;PROVIDENCIA                   ;METROPOLITANA;149990;1;1;0;0;0;1;1;149990;CELULAR REDMI 9T 128 GB OCEAN GREEN;TELEFONIA
16911867;;M;33;CHILENO;;Millenial;SANTIAGO                      ;METROPOLITANA;153980;2;1;2;1;153980;0;0;0;CELULAR REDMI NOTE 10 EU 64GB ONIX GRAY OPEN;TELEFONIA
15077047;;F;24;CHILENO;;Z;N/D;N/D;134990;1;1;0;0;0;1;1;134990;CELULAR A21s 128 GB Negro;TELEFONIA
19160755;Soltero;F;26;CHILENO;;Z;PROVIDENCIA                   ;METROPOLITANA;109990;2;1;0;0;0;2;1;109990;CELULAR A21s 128 GB Rojo;TELEFONIA
16425255;;F;35;CHILENO;;Millenial;"";"";267960;3;1;3;1;267960;0;0;0;CELULAR A12 128GB Azul OPEN;TELEFONIA
15205564;;M;40;CHILENO;;X;LOS ANGELES                   ;BIO BIO;169990;1;1;1;1;169990;0;0;0;CELULAR XIAOMI POCO X3 64G SHADOW GRAY;TELEFONIA
10303714;Casado;F;59;CHILENO;;Boomers;VALLENAR;ATACAMA;19990;1;1;0;0;0;1;1;19990;Celular AL3 CLARO DIRECTO NEGRO;TELEFONIA
19407668;Soltero;M;26;CHILENO;;Z;PROVIDENCIA                   ;METROPOLITANA;229990;1;1;0;0;0;1;1;229990;POCO X3 PRO 256 GB PHANTOM BLACK;TELEFONIA
15383530;;F;39;CHILENO;;Silencioso;PROVIDENCIA                   ;METROPOLITANA;209970;3;1;0;0;0;3;1;209970;CELULAR A21s 128 GB AZUL;TELEFONIA
13312100;;M;44;CHILENO;;X;CORONEL                       ;BIO BIO;199990;2;1;0;0;0;2;1;199990;MOTO G30 LILA PASTEL 128GB MOVISTAR;TELEFONIA
26578443;;M;28;VENEZOLANO;;Extranjero;CURICO                        ;MAULE;139990;1;1;0;0;0;1;1;139990;CELULAR A21s 128 GB Negro;TELEFONIA
19509848;;M;25;CHILENO;;Z;PROVIDENCIA                   ;METROPOLITANA;99990;1;1;0;0;0;1;1;99990;CELULAR REDMI 9 32GB CARBON GREY OPEN;TELEFONIA
12766169;Viudo;F;48;CHILENO;;X;PROVIDENCIA                   ;METROPOLITANA;129990;1;1;0;0;0;1;1;129990;CELULAR POCO M3 128GB COOL BLUE;TELEFONIA
10828990;;F;57;CHILENO;;Boomers;MELIPILLA                     ;METROPOLITANA;139990;1;1;0;0;0;1;1;139990;CELULAR NOKIA 5.3 CHARCOAL TRI ENTEL;TELEFONIA
13775260;;M;42;CHILENO;;X;NAVIDAD                       ;L.G.B.OÂ´HIGGINS;399990;1;1;0;0;0;1;1;399990;CELULAR GALAXY S20FE 128GB CLOUD LAVENDER OPEN;TELEFONIA
8083026;;M;64;CHILENO;;Boomers;PUENTE ALTO                   ;METROPOLITANA;129480;2;1;0;0;0;2;1;129480;CELULAR VIVO Y11S PHANTON BLACK 32GB MOVISTAR;TELEFONIA
20353477;;F;22;CHILENO;;Z;MELIPEUCO;ARAUCANIA;959980;2;1;0;0;0;2;1;959980;CELULAR IPHONE 12 64GB BLACK CLARO;TELEFONIA
13784895;;F;42;CHILENO;;X;MAIPU                         ;METROPOLITANA;89990;1;1;0;0;0;1;1;89990;CELULAR MOTO E7 32GB ROSA CORAL OPEN;TELEFONIA
10819585;;F;54;CHILENO;;Millenial;"";"";189990;1;1;0;0;0;1;1;189990;CELULAR A32 128 GB LIGHT VIOLET OPEN;TELEFONIA
17882669;;F;30;CHILENO;;Millenial;CHIMBARONGO                   ;L.G.B.OÂ´HIGGINS;119990;1;1;0;0;0;1;1;119990;CELULAR OPPO A15 BLACK 32GB CLARO;TELEFONIA
17775841;;F;32;CHILENO;;Millenial;NUEVA IMPERIAL                ;ARAUCANIA;74990;1;1;0;0;0;1;1;74990;CELULAR MOTO E6I ROSA OPEN;TELEFONIA
5911038;Casado;F;72;CHILENO;;Silencioso;RENCA                         ;METROPOLITANA;83770;2;1;0;0;0;2;1;83770;CELULAR SMARTPHONE 1B ALCATEL PRIME BLACK;TELEFONIA
11332914;;F;53;CHILENO;;X;PROVIDENCIA                   ;METROPOLITANA;369990;2;1;0;0;0;2;1;369990;CELULAR A72 128 GB BLACK OPEN;TELEFONIA
7465726;Soltero;M;66;CHILENO;;Boomers;SANTA MARIA                   ;VALPARAISO;54990;1;1;0;0;0;1;1;54990;Celular SAMSUNG A01 CORE BLACK CLARO;TELEFONIA
7310726;;M;64;CHILENO;;Boomers;ANTOFAGASTA                   ;ANTOFAGASTA;239990;1;1;0;0;0;1;1;239990;POCO X3 PRO 256 GB PHANTOM BLACK;TELEFONIA
9645147;;F;57;CHILENO;;Boomers;RENCA                         ;METROPOLITANA;81480;2;1;0;0;0;2;1;81480;Celular SAMSUNG A01 CORE BLACK CLARO;TELEFONIA
16269760;;F;36;CHILENO;;Millenial;RENCA                         ;METROPOLITANA;174990;2;1;0;0;0;2;1;174990;CELULAR MOTO G30 128GB GRIS TORNASOL OPEN;TELEFONIA
14142363;;F;40;CHILENO;;Silencioso;PROVIDENCIA                   ;METROPOLITANA;1007970;3;1;3;1;1007970;0;0;0;SMARTPHONE GALAXY Z FLIP3 128GB CREAM;TELEFONIA
11440065;;F;53;CHILENO;;X;LOS ALAMOS                    ;BIO BIO;184990;1;1;0;0;0;1;1;184990;CELULAR REDMI NOTE 10S 128GB ONIX BLACK;TELEFONIA
10979704;Casado;M;54;CHILENO;;X;PROVIDENCIA                   ;METROPOLITANA;119990;2;1;0;0;0;2;1;119990;CELULAR MOTOROLA G9 PLAY 64GB ELECTRIC BLUE OPEN;TELEFONIA
27148274;;M;36;VENEZOLANO;;Extranjero;N/D;N/D;190362;6;2;0;0;0;6;2;190362;CELULAR MOTO E7 32GB ROSA CORAL OPEN;TELEFONIA
16772793;;F;34;CHILENO;;Millenial;ARICA                         ;ARICA Y PARINACOTA;229990;1;1;0;0;0;1;1;229990;CELULAR A32 128 GB WHITE OPEN;TELEFONIA
9734441;;F;57;CHILENO;;Boomers;ALTO HOSPICIO;TARAPACA;228980;2;1;0;0;0;2;1;228980;CELULAR MOTO G30 128GB GRIS TORNASOL OPEN;TELEFONIA
8498963;;M;67;CHILENO;;Boomers;QUILPUE                       ;VALPARAISO;84990;1;1;0;0;0;1;1;84990;CELULAR XIAOMI REDMI 9 64GB DIRECTO CLARO MORADO;TELEFONIA
8288256;;F;66;CHILENO;;Boomers;MELIPILLA                     ;METROPOLITANA;149980;2;1;0;0;0;2;1;149980;CELULAR MOTOROLA G9 PLAY 64GB SPRING PINK OPEN;TELEFONIA
18528247;Soltero;F;29;CHILENO;TECNICO DE NIVEL SUPERIOR EN ENFERMERIA;Millenial;PROVIDENCIA                   ;METROPOLITANA;133980;2;1;2;1;133980;0;0;0;CELULAR A12 128GB Azul OPEN;TELEFONIA
15088911;Casado;F;39;CHILENO;;X;RENCA                         ;METROPOLITANA;65990;1;1;0;0;0;1;1;65990;CELULAR MOTOROLA E6 PLAY AZUL TRI WOM;TELEFONIA
11385161;Casado;M;52;CHILENO;;X;RENCA                         ;METROPOLITANA;129990;1;1;0;0;0;1;1;129990;CELULAR XIAOMI REDMI 9T TWILIGHT BLUE MOVISTAR;TELEFONIA
15651368;;M;40;CHILENO;;X;MACUL                         ;METROPOLITANA;96980;2;1;2;1;96980;0;0;0;CELULAR REDMI 9C 64GB SUNRISE ORANGE;TELEFONIA
24515635;;F;62;COLOMBIANO;;Extranjero;N/D;N/D;239990;1;1;1;1;239990;0;0;0;POCO X3 PRO 256 GB PHANTOM BLACK;TELEFONIA
13144001;;M;45;CHILENO;;X;N/D;N/D;239991;2;1;0;0;0;2;1;239991;POCO X3 PRO 256 GB PHANTOM BLACK;TELEFONIA
9558015;;M;59;CHILENO;;Boomers;SAN VICENTE                   ;L.G.B.OÂ´HIGGINS;37990;1;1;0;0;0;1;1;37990;CELULAR NOKIA QUEEN VALUE BLACK CLARO;TELEFONIA
13437232;;F;44;CHILENO;;X;"";"";109990;1;1;1;1;109990;0;0;0;CELULAR REDMI NOTE 8 2021 64 GB SPACE BLACK;TELEFONIA
19039862;;F;27;CHILENO;;Z;LA SERENA                     ;COQUIMBO;189980;2;1;0;0;0;2;1;189980;CELULAR A21s 128 GB Rojo;TELEFONIA
16273132;;F;36;CHILENO;;Millenial;LONGAVI                       ;MAULE;198980;3;1;0;0;0;3;1;198980;CELULAR A32 128 GB BLUE OPEN;TELEFONIA
9935104;;M;59;CHILENO;;Boomers;HUALQUI                       ;BIO BIO;0;0;2;0;0;0;0;2;0;CELULAR VIVO Y11S PHANTON BLACK 32GB MOVISTAR;TELEFONIA
16418259;;F;35;CHILENO;;Millenial;PROVIDENCIA                   ;METROPOLITANA;149990;1;1;0;0;0;1;1;149990;CELULAR A21s 128 GB Rojo;TELEFONIA
11279030;;F;54;CHILENO;;X;SAN FERNANDO                  ;L.G.B.OÂ´HIGGINS;37990;1;1;0;0;0;1;1;37990;CELULAR NOKIA 225 4G BLACK MOVISTAR DIRECTO;TELEFONIA
16769523;;F;35;CHILENO;;Millenial;"";"";49990;1;1;1;1;49990;0;0;0;Celular ZTE A3 2020 WOM DIRECTO NEGRO;TELEFONIA
19144236;;F;26;CHILENO;;Z;N/D;N/D;94990;1;1;0;0;0;1;1;94990;CELULAR MOTO E7I POWER 32GB BLUE MOVISTAR;TELEFONIA
17549678;Soltero;F;30;CHILENO;MATRONA;Millenial;PETORCA                       ;VALPARAISO;121870;2;1;0;0;0;2;1;121870;CELULAR MOTO E7I POWER 32GB BLUE MOVISTAR;TELEFONIA
18959555;;F;27;CHILENO;;Z;N/D;N/D;69990;1;1;0;0;0;1;1;69990;CELULAR MOTOROLA E6 PLAY AZUL TRI WOM;TELEFONIA
13194266;;F;44;CHILENO;;X;VILLA ALEMANA                 ;VALPARAISO;597070;3;2;0;0;0;3;2;597070;CELULAR A72 128 GB BLACK OPEN;TELEFONIA
3732962;;M;84;CHILENO;;Silencioso;IQUIQUE                       ;TARAPACA;32990;1;1;0;0;0;1;1;32990;CELULAR OWN 1026 AZUL ENTEL;TELEFONIA
9888363;;F;59;CHILENO;;Boomers;OVALLE                        ;COQUIMBO;129990;1;1;0;0;0;1;1;129990;CELULAR A12 128GB Rojo OPEN;TELEFONIA
19923417;;F;24;CHILENO;;Z;PROVIDENCIA                   ;METROPOLITANA;109990;1;1;1;1;109990;0;0;0;CELULAR REDMI NOTE 8 2021 64GB MOONLIGHT WHITE;TELEFONIA
12319302;;F;48;CHILENO;;X;RENCA                         ;METROPOLITANA;149980;2;1;2;1;149980;0;0;0;CELULAR A21s 128 GB Rojo;TELEFONIA
13376013;;M;43;CHILENO;;X;SAN CARLOS                    ;BIO BIO;229990;1;1;0;0;0;1;1;229990;POCO X3 PRO 256 GB PHANTOM BLACK;TELEFONIA
16860599;;M;34;CHILENO;;Millenial;SAN FERNANDO                  ;L.G.B.OÂ´HIGGINS;82482;2;1;0;0;0;2;1;82482;CELULAR ZTE A5 2020 DIRECTO CLARO VERDE;TELEFONIA
7964493;Casado;F;68;CHILENO;;Boomers;RENCA                         ;METROPOLITANA;144980;2;1;0;0;0;2;1;144980;CELULAR Samsung Galaxy A02s 32GB Azul WOM;TELEFONIA
14284273;Soltero;F;47;CHILENO;;X;RENCA                         ;METROPOLITANA;149990;1;1;0;0;0;1;1;149990;CELULAR A21s 128 GB Rojo;TELEFONIA
17897547;;M;31;CHILENO;;Silencioso;PROVIDENCIA                   ;METROPOLITANA;441160;3;1;0;0;0;3;1;441160;CELULAR GALAXY S20FE 128GB CLOUD LAVENDER OPEN;TELEFONIA
20317779;;F;22;CHILENO;;Millenial;PROVIDENCIA                   ;METROPOLITANA;490;1;1;0;0;0;1;1;490;KIT PACK OPEN RETAIL 4G TELEFONICA;TELEFONIA
12622246;;M;48;CHILENO;;X;PROVIDENCIA                   ;METROPOLITANA;150980;2;1;0;0;0;2;1;150980;CELULAR MOTOROLA G20 64GB BLUE CLARO;TELEFONIA
12204364;;F;50;CHILENO;;X;PROVIDENCIA                   ;METROPOLITANA;139990;1;1;0;0;0;1;1;139990;CELULAR VIVO Y20S NEBULA 128 GB BLUE OPEN;TELEFONIA
14095679;;F;41;CHILENO;;X;VALDIVIA                      ;LOS LAGOS;164980;2;1;0;0;0;2;1;164980;CELULAR A12 128GB ROJO OPEN;TELEFONIA
9810432;;F;59;CHILENO;;Boomers;COINCO                        ;L.G.B.OÂ´HIGGINS;79990;1;1;0;0;0;1;1;79990;CELULAR CLARO MOTOROLA E7 32GB GRIS;TELEFONIA
16576622;;M;35;CHILENO;;Millenial;COIHAIQUE                     ;AYSEN;99990;1;1;0;0;0;1;1;99990;CELULAR REDMI 9C 64GB SUNRISE ORANGE;TELEFONIA
14026231;Soltero;F;41;CHILENO;INGENIERO INFORMATICO;X;CHILLAN                       ;BIO BIO;89990;2;1;0;0;0;2;1;89990;CELULAR A12 128GB Rojo OPEN;TELEFONIA
25922995;;M;39;HAITIANO;;Extranjero;CHILLAN                       ;BIO BIO;329970;6;3;0;0;0;6;3;329970;CELULAR Galaxy A21s (128GB) Black WOM;TELEFONIA
16063182;;F;36;CHILENO;;Millenial;SANTA BARBARA                 ;BIO BIO;509980;2;2;0;0;0;2;2;509980;CELULAR REDMI NOTE 10 PRO 6+128GB GRADIENT BRONZ;TELEFONIA
7113208;Casado;M;66;CHILENO;;Boomers;IQUIQUE                       ;TARAPACA;1023090;3;1;3;1;1023090;0;0;0;CELULAR Galaxy Z Flip3 128GB BLACK OPEN;TELEFONIA
9112981;;M;61;CHILENO;;Boomers;NUEVA IMPERIAL                ;ARAUCANIA;149990;1;1;0;0;0;1;1;149990;MOTO G20 AZUL CIELO 64GB MOVISTAR;TELEFONIA
10037032;;M;58;CHILENO;;Boomers;RENCA                         ;METROPOLITANA;62870;2;1;0;0;0;2;1;62870;CELULAR NOKIA QUEEN VALUE BLACK CLARO;TELEFONIA
19277913;;M;26;CHILENO;;Z;"";"";259980;2;1;2;1;259980;0;0;0;CELULAR A21s 128 GB AZUL;TELEFONIA
11917366;;M;50;CHILENO;;X;RENCA                         ;METROPOLITANA;79990;1;1;0;0;0;1;1;79990;CELULAR CLARO MOTOROLA E7 32GB GRIS;TELEFONIA
9258394;Casado;M;60;CHILENO;;Boomers;RENCA                         ;METROPOLITANA;103980;2;1;2;1;103980;0;0;0;CELULAR REDMI 9C 64GB SUNRISE ORANGE;TELEFONIA
16129442;;F;36;CHILENO;;Millenial;LOLOL                         ;L.G.B.OÂ´HIGGINS;125980;3;1;0;0;0;3;1;125980;CELULAR REDMI NOTE 8 2021 64 GB SPACE BLACK;TELEFONIA
11615017;;M;52;CHILENO;;X;PROVIDENCIA                   ;METROPOLITANA;147970;3;1;0;0;0;3;1;147970;Celular A20S WOM DIRECTO BLACK;TELEFONIA
15067268;Soltero;M;37;CHILENO;TECNICO AGRICOLA;Millenial;PROVIDENCIA                   ;METROPOLITANA;229990;1;1;0;0;0;1;1;229990;CELULAR A32 128 GB BLACK OPEN;TELEFONIA
8216551;;F;65;CHILENO;;Boomers;PROVIDENCIA                   ;METROPOLITANA;119480;4;1;0;0;0;4;1;119480;CELULAR MOTO E7 32GB ROSA CORAL OPEN;TELEFONIA
17548310;;F;30;CHILENO;;Millenial;PROVIDENCIA                   ;METROPOLITANA;324980;2;3;0;0;0;2;3;324980;CELULAR A32 128 GB BLACK OPEN;TELEFONIA
19789648;;F;24;CHILENO;;Z;SAN VICENTE                   ;L.G.B.OÂ´HIGGINS;0;0;0;0;0;0;0;0;0;CELULAR A21s 128 GB Rojo;TELEFONIA
18877626;;F;27;CHILENO;;Silencioso;PROVIDENCIA                   ;METROPOLITANA;0;0;0;0;0;0;0;0;0;CELULAR REDMI 9T 128 GB OCEAN GREEN;TELEFONIA
19856973;;M;24;CHILENO;;Silencioso;PROVIDENCIA                   ;METROPOLITANA;0;0;0;0;0;0;0;0;0;POCO X3 PRO 256 GB PHANTOM BLACK;TELEFONIA
15339907;;M;39;CHILENO;;X;SANTIAGO                      ;METROPOLITANA;0;0;0;0;0;0;0;0;0;CELULAR A12 128GB AZUL OPEN;TELEFONIA
10816059;;F;54;CHILENO;;X;N/D;N/D;0;0;0;0;0;0;0;0;0;CELULAR REDMI NOTE 10 PRO 6+128GB GRADIENT BRONZ;TELEFONIA
12548663;;M;47;CHILENO;;X;TOME                          ;BIO BIO;0;0;0;0;0;0;0;0;0;CELULAR A32 128 GB BLACK OPEN;TELEFONIA
6700495;;M;72;CHILENO;;Silencioso;EL QUISCO                     ;VALPARAISO;0;0;0;0;0;0;0;0;0;CELULAR MOTOROLA E7 IPOWER 32GB BLUE CLARO;TELEFONIA
13792670;Casado;M;42;CHILENO;;X;PROVIDENCIA                   ;METROPOLITANA;0;0;0;0;0;0;0;0;0;CELULAR MOTOROLA E6 PLAY AZUL TRI WOM;TELEFONIA
9932921;;M;58;CHILENO;;Boomers;ALTO BIO BIO;BIO BIO;0;0;0;0;0;0;0;0;0;CELULAR REDMI 9A GRANITE GREY DIRECTO MOVISTAR;TELEFONIA
9369052;;F;50;CHILENO;;Silencioso;PROVIDENCIA                   ;METROPOLITANA;0;0;0;0;0;0;0;0;0;CELULAR REDMI 9A 32GB PEACOCK GREEN;TELEFONIA
16324309;;M;36;CHILENO;;Millenial;N/D;N/D;0;0;0;0;0;0;0;0;0;CELULAR A32 128 GB BLACK OPEN;TELEFONIA
18123278;Soltero;M;29;CHILENO;PROFESOR;Millenial;PROVIDENCIA                   ;METROPOLITANA;0;0;0;0;0;0;0;0;0;CELULAR REDMI NOTE 10 128GB ONIX GRAY OPEN;TELEFONIA
11557408;Casado;F;51;CHILENO;;X;RENCA                         ;METROPOLITANA;0;0;0;0;0;0;0;0;0;CELULAR A21s 128 GB AZUL;TELEFONIA
15019891;;M;40;CHILENO;;X;N/D;N/D;0;0;0;0;0;0;0;0;0;CELULAR REDMI NOTE 10 PRO 6+128GB GRADIENT BRONZ;TELEFONIA
14903280;;F;40;CHILENO;;X;CALAMA                        ;ANTOFAGASTA;0;0;0;0;0;0;0;0;0;Celular LG K22 ENTEL DIRECTO TITAN;TELEFONIA
5500952;;F;72;CHILENO;;Silencioso;PROVIDENCIA                   ;METROPOLITANA;0;0;0;0;0;0;0;0;0;CELULAR A32 128 GB WHITE OPEN;TELEFONIA
8781537;;F;62;CHILENO;;Boomers;CALERA                        ;VALPARAISO;0;0;0;0;0;0;0;0;0;CELULAR A02 AZUL 32GB OPEN;TELEFONIA
14489858;Divorciado;F;46;CHILENO;;X;SAN CLEMENTE                  ;MAULE;0;0;0;0;0;0;0;0;0;CELULAR A32 128 GB BLACK OPEN;TELEFONIA
13396869;;M;43;CHILENO;;X;PADRE LAS CASAS               ;ARAUCANIA;0;0;0;0;0;0;0;0;0;CELULAR MOTO G30 128GB GRIS TORNASOL OPEN;TELEFONIA
10139917;;M;57;CHILENO;;Boomers;RENCA                         ;METROPOLITANA;0;0;0;0;0;0;0;0;0;CELULAR A21s 128 GB Negro;TELEFONIA
8188621;;M;65;CHILENO;;Silencioso;PROVIDENCIA                   ;METROPOLITANA;0;0;0;0;0;0;0;0;0;CELULAR OWN 1026 AZUL ENTEL;TELEFONIA
15873968;;M;37;CHILENO;;Millenial;CALBUCO                       ;LOS LAGOS;0;0;0;0;0;0;0;0;0;CELULAR A02 ROJO 32GB OPEN;TELEFONIA
20363471;;M;22;CHILENO;;Silencioso;PROVIDENCIA                   ;METROPOLITANA;0;0;0;0;0;0;0;0;0;CELULAR MOTO ONE FUSION 128GB AZUL OPEN;TELEFONIA
7963004;;M;65;CHILENO;;Boomers;RENCA                         ;METROPOLITANA;0;0;0;0;0;0;0;0;0;CELULAR REDMI 9C 32GB MIDNIGHT GRAY MOVISTAR;TELEFONIA
11781779;;F;51;CHILENO;;X;QUINTA NORMAL                 ;METROPOLITANA;0;0;0;0;0;0;0;0;0;Celular XIAOMI REDMI 9 64 GB DIRECTO CLARO NEGRO;TELEFONIA
18409258;;M;28;CHILENO;;Millenial;N/D;N/D;0;0;0;0;0;0;0;0;0;CELULAR REDMI NOTE 8 2021 64GB NEPTUNE BLUE;TELEFONIA
12461211;;F;48;CHILENO;;X;QUINTA NORMAL                 ;METROPOLITANA;0;0;0;0;0;0;0;0;0;CELULAR REDMI NOTE 9 128 GB MIDNIGHT GREY OPEN;TELEFONIA
7626568;;M;64;CHILENO;;Boomers;QUINTA NORMAL                 ;METROPOLITANA;0;0;0;0;0;0;0;0;0;CELULAR A02 AZUL 32GB OPEN;TELEFONIA
19023985;;F;27;CHILENO;;Z;COPIAPO                       ;ATACAMA;0;0;0;0;0;0;0;0;0;CELULAR XIAOMI REDMI 9A 32GB BLACK DIRECTO CLARO;TELEFONIA
16533211;Soltero;M;35;CHILENO;;Millenial;LAS CONDES                    ;METROPOLITANA;0;0;0;0;0;0;0;0;0;CELULAR A21s 128 GB Rojo;TELEFONIA
9999520;;M;56;CHILENO;;Boomers;TALCAHUANO                    ;BIO BIO;0;0;0;0;0;0;0;0;0;CELULAR MOTO E7i 32GB AZUL OPEN;TELEFONIA
20178878;;F;23;CHILENO;;Millenial;PROVIDENCIA                   ;METROPOLITANA;0;0;0;0;0;0;0;0;0;CELULAR A21s 128 GB AZUL;TELEFONIA
18882098;;F;27;CHILENO;;Millenial;COLINA                        ;METROPOLITANA;0;0;0;0;0;0;0;0;0;CELULAR REDMI 9T 128GB SUNRISE ORANGE MOVISTAR;TELEFONIA
18894517;;F;27;CHILENO;;Millenial;N/D;N/D;0;0;0;0;0;0;0;0;0;CELULAR REDMI NOTE 10 PRO 6+128GB GRADIENT BRONZ;TELEFONIA
16161624;;M;36;CHILENO;;Millenial;SAN ANTONIO                   ;VALPARAISO;0;0;0;0;0;0;0;0;0;CELULAR REDMI NOTE 10S 128GB PEBBLE WHITE;TELEFONIA
7574125;;F;64;CHILENO;;Boomers;LA PINTANA                    ;METROPOLITANA;0;0;0;0;0;0;0;0;0;CELULAR A21s 128 GB Negro;TELEFONIA
12038122;;F;58;CHILENO;;Boomers;LEBU                          ;BIO BIO;0;0;0;0;0;0;0;0;0;CELULAR A21s 128 GB Rojo;TELEFONIA
17572377;;M;32;CHILENO;;Millenial;PROVIDENCIA                   ;METROPOLITANA;0;0;0;0;0;0;0;0;0;CELULAR A21s 128 GB AZUL;TELEFONIA
18510901;Soltero;F;29;CHILENO;;Millenial;PROVIDENCIA                   ;METROPOLITANA;0;0;0;0;0;0;0;0;0;CELULAR A21s 128 GB AZUL;TELEFONIA
18212757;;F;30;CHILENO;;Millenial;PROVIDENCIA                   ;METROPOLITANA;0;0;0;0;0;0;0;0;0;CELULAR MOTO E6I ROSA OPEN;TELEFONIA
8969934;;F;62;CHILENO;;Boomers;PROVIDENCIA                   ;METROPOLITANA;0;0;0;0;0;0;0;0;0;CELULAR REDMI NOTE 9 128 GB MIDNIGHT GREY OPEN;TELEFONIA
5554145;;M;76;CHILENO;;Silencioso;NUEVA IMPERIAL                ;ARAUCANIA;0;0;0;0;0;0;0;0;0;CELULAR NOKIA 225 4G BLACK MOVISTAR DIRECTO;TELEFONIA
16614547;;M;36;CHILENO;;Millenial;N/D;N/D;0;0;0;0;0;0;0;0;0;CELULAR A21s 128 GB Rojo;TELEFONIA
18248863;;M;29;CHILENO;;Millenial;LA FLORIDA                    ;METROPOLITANA;0;0;0;0;0;0;0;0;0;CELULAR MOTOROLA G9 PLAY 64GB ELECTRIC BLUE OPEN;TELEFONIA
9714617;Soltero;M;58;CHILENO;;Boomers;PUQUELDON                     ;LOS LAGOS;0;0;0;0;0;0;0;0;0;CELULAR VIVO Y11S PHANTON BLACK 32GB MOVISTAR;TELEFONIA
13420694;;F;47;CHILENO;;X;ANTOFAGASTA                   ;ANTOFAGASTA;0;0;0;0;0;0;0;0;0;CELULAR IPHONE SE 64GB DIRECTO CLARO;TELEFONIA
9983862;;F;57;CHILENO;;Boomers;CALERA                        ;VALPARAISO;0;0;0;0;0;0;0;0;0;CELULAR MOTO E7I POWER ORANGE 32GB MOVISTAR;TELEFONIA
25061961;;F;28;PERUANO;;Extranjero;"";"";0;0;0;0;0;0;0;0;0;CELULAR REDMI NOTE 10S 128GB ONIX BLACK;TELEFONIA
19756956;;M;24;CHILENO;;Z;SAN ANTONIO                   ;VALPARAISO;0;0;0;0;0;0;0;0;0;CELULAR GALAXY S20FE 128GB ClOUD NAVY OPEN;TELEFONIA
12554531;;F;50;CHILENO;;X;CONCEPCION                    ;BIO BIO;0;0;0;0;0;0;0;0;0;CELULAR VIVO Y20S OBSIDIAN BLACK 128GB OPEN;TELEFONIA
18360111;;F;29;CHILENO;;Millenial;PROVIDENCIA                   ;METROPOLITANA;0;0;0;0;0;0;0;0;0;CELULAR A21s 128 GB AZUL;TELEFONIA
6328033;;M;69;CHILENO;;Silencioso;PROVIDENCIA                   ;METROPOLITANA;0;0;0;0;0;0;0;0;0;CELULAR MOTO E6I 32GB GRIS OPEN;TELEFONIA
19493239;;F;25;CHILENO;;Z;N/D;N/D;0;0;0;0;0;0;0;0;0;CELULAR REDMI 9T 128 GB OCEAN GREEN;TELEFONIA
13351049;;F;44;CHILENO;;X;CURICO                        ;MAULE;0;0;0;0;0;0;0;0;0;CELULAR REDMI NOTE 10S 128GB ONIX BLACK;TELEFONIA
25897151;;M;44;COLOMBIANO;;Extranjero;N/D;N/D;0;0;0;0;0;0;0;0;0;CELULAR A32 128 GB BLACK OPEN;TELEFONIA
8022504;Divorciado;M;64;CHILENO;AGROINDUSTRIA;Boomers;PROVIDENCIA                   ;METROPOLITANA;0;0;0;0;0;0;0;0;0;CELULAR A02s AZUL 32GB OPEN;TELEFONIA
24489918;;F;65;PERUANO;;Extranjero;CURANILAHUE                   ;BIO BIO;0;0;0;0;0;0;0;0;0;CELULAR A02s ROJO 32GB OPEN;TELEFONIA
19977172;;F;24;CHILENO;;Z;N/D;N/D;0;0;0;0;0;0;0;0;0;CELULAR A32 128 GB BLACK OPEN;TELEFONIA
19049861;;F;27;CHILENO;;Z;PROVIDENCIA                   ;METROPOLITANA;0;0;0;0;0;0;0;0;0;CELULAR A21s 128 GB AZUL;TELEFONIA
3567093;;F;87;CHILENO;;Silencioso;LOS ANDES                     ;VALPARAISO;0;0;0;0;0;0;0;0;0;CELULAR OWN 1026 AZUL ENTEL;TELEFONIA
15092613;;F;39;CHILENO;;X;PUTAENDO                      ;VALPARAISO;0;0;0;0;0;0;0;0;0;CELULAR REDMI 9C 64GB SUNRISE ORANGE;TELEFONIA
15670622;;F;39;CHILENO;;X;TOME                          ;BIO BIO;0;0;0;0;0;0;0;0;0;CELULAR A21s 128 GB Rojo;TELEFONIA
17592394;;F;32;CHILENO;;Millenial;NACIMIENTO                    ;BIO BIO;0;0;0;0;0;0;0;0;0;CELULAR A32 128 GB LIGHT VIOLET OPEN;TELEFONIA
9194355;;F;60;CHILENO;;Boomers;SAN PEDRO DE LA PAZ           ;BIO BIO;0;0;0;0;0;0;0;0;0;Celular P30 LITE LIB OPEN NEGRO;TELEFONIA
19596135;;F;25;CHILENO;;Z;PROVIDENCIA                   ;METROPOLITANA;0;0;0;0;0;0;0;0;0;CELULAR IPHONE SE 64GB DIRECTO CLARO;TELEFONIA
24706152;;M;28;BOLIVIANO;;Extranjero;ARICA                         ;ARICA Y PARINACOTA;0;0;0;0;0;0;0;0;0;CELULAR A32 128 GB LIGHT VIOLET OPEN;TELEFONIA
8203917;;F;66;CHILENO;;Silencioso;PROVIDENCIA                   ;METROPOLITANA;0;0;0;0;0;0;0;0;0;CELULAR A21s 128 GB Rojo;TELEFONIA
16953192;;F;33;CHILENO;;Millenial;RENCA                         ;METROPOLITANA;0;0;0;0;0;0;0;0;0;CELULAR A21s 128 GB AZUL;TELEFONIA
9012167;;F;60;CHILENO;;Boomers;RENCA                         ;METROPOLITANA;0;0;0;0;0;0;0;0;0;Celular A01 CLARO DIRECTO BLACK;TELEFONIA
8729794;;M;62;CHILENO;;Boomers;RENCA                         ;METROPOLITANA;0;0;0;0;0;0;0;0;0;CELULAR XIAOMI REDMI 9C 64GB TIWLIGHT BLUE TRI W;TELEFONIA
8071700;;M;63;CHILENO;;Boomers;ARICA                         ;TARAPACA;0;0;0;0;0;0;0;0;0;CELULAR OPPO A15 BLACK 32GB CLARO;TELEFONIA
13018312;;F;45;CHILENO;;X;RENCA                         ;METROPOLITANA;0;0;0;0;0;0;0;0;0;Celular AL3 CLARO DIRECTO NEGRO;TELEFONIA
16771694;;M;34;CHILENO;;Millenial;N/D;N/D;0;0;0;0;0;0;0;0;0;CELULAR POCO X3 PRO 256 GB FROST BLUE;TELEFONIA
19675171;;F;24;CHILENO;;Z;N/D;N/D;0;0;0;0;0;0;0;0;0;CELULAR ALCATEL P1 3080 BLACK MOVISTAR DIRECTO;TELEFONIA
17585012;;F;31;CHILENO;;Millenial;PROVIDENCIA                   ;METROPOLITANA;0;0;0;0;0;0;0;0;0;CELULAR NOKIA QUEEN VALUE BLACK CLARO;TELEFONIA
8908589;Casado;F;63;CHILENO;;Boomers;RENCA                         ;METROPOLITANA;0;0;0;0;0;0;0;0;0;CELULAR OWN 1026 AZUL ENTEL;TELEFONIA
9708959;;F;59;CHILENO;;Boomers;EL BOSQUE                     ;METROPOLITANA;0;0;0;0;0;0;0;0;0;CELULAR A21s 128 GB AZUL;TELEFONIA
18772676;;F;27;CHILENO;;Millenial;PROVIDENCIA                   ;METROPOLITANA;0;0;0;0;0;0;0;0;0;CELULAR MOTO G30 128GB GRIS TORNASOL OPEN;TELEFONIA
19074468;;F;26;CHILENO;;Z;ANTOFAGASTA                   ;ANTOFAGASTA;0;0;0;0;0;0;0;0;0;CELULAR REDMI NOTE 10 PRO 6+128GB GRADIENT BRONZ;TELEFONIA
18689866;;M;28;CHILENO;;Millenial;PROVIDENCIA                   ;METROPOLITANA;0;0;0;0;0;0;0;0;0;CELULAR A02s ROJO 32GB OPEN;TELEFONIA
18320206;;M;32;CHILENO;;Millenial;N/D;N/D;0;0;0;0;0;0;0;0;0;CELULAR Xiaomi Redmi 9 64 GB Morado WOM;TELEFONIA
8687857;;F;60;CHILENO;;Boomers;N/D;N/D;0;0;0;0;0;0;0;0;0;CELULAR A21s 128 GB Rojo;TELEFONIA
17250801;;M;33;CHILENO;;Millenial;N/D;N/D;0;0;0;0;0;0;0;0;0;CELULAR REDMI NOTE 10 PRO 6+128GB ONYX GRAY;TELEFONIA
15453648;;F;40;CHILENO;;X;PROVIDENCIA                   ;METROPOLITANA;0;0;0;0;0;0;0;0;0;Celular Y7P LIB OPEN NEGRO;TELEFONIA
10297962;;F;54;CHILENO;;Boomers;N/D;N/D;0;0;0;0;0;0;0;0;0;CELULAR MOTO G20 64GB ROSA FLAMINGO OPEN;TELEFONIA
26076704;;M;35;HAITIANO;;Extranjero;N/D;N/D;0;0;0;0;0;0;0;0;0;CELULAR A72 128 GB BLACK OPEN;TELEFONIA
8629325;;M;63;CHILENO;;Boomers;SAN JAVIER                    ;MAULE;0;0;0;0;0;0;0;0;0;CELULAR A32 128 GB BLUE OPEN;TELEFONIA
15678472;;F;39;CHILENO;;X;PROVIDENCIA                   ;METROPOLITANA;0;0;0;0;0;0;0;0;0;CELULAR REDMI NOTE 9 128G FOREST GREEN OPEN;TELEFONIA
13792322;Casado;M;41;CHILENO;;X;CAUQUENES                     ;MAULE;0;0;0;0;0;0;0;0;0;CELULAR A12 128GB AZUL OPEN;TELEFONIA
18975377;;M;27;CHILENO;;Millenial;N/D;N/D;0;0;0;0;0;0;0;0;0;CELULAR POCO F3 128 GB DEEP OCEAN BLUE;TELEFONIA
13110584;;M;46;CHILENO;;X;PROVIDENCIA                   ;METROPOLITANA;0;0;0;0;0;0;0;0;0;CELULAR A32 128 GB BLACK OPEN;TELEFONIA
20310445;;M;22;CHILENO;;Z;PROVIDENCIA                   ;METROPOLITANA;0;0;0;0;0;0;0;0;0;CELULAR MOTO E6S 32GB GRIS DIRECTO ENTEL;TELEFONIA
19043067;;M;26;CHILENO;;Z;TALCA                         ;MAULE;0;0;0;0;0;0;0;0;0;CELULAR XIAOMI MI 10T 128GB LUNAR SILVER OPEN;TELEFONIA
13312378;;M;46;CHILENO;;X;NACIMIENTO                    ;BIO BIO;0;0;0;0;0;0;0;0;0;Celular A20S LIB OPEN NEGRO;TELEFONIA
11598064;;F;52;CHILENO;;X;ANCUD                         ;LOS LAGOS;0;0;0;0;0;0;0;0;0;CELULAR A02 NEGRO 32GB OPEN;TELEFONIA
12470590;;M;48;CHILENO;;X;PROVIDENCIA                   ;METROPOLITANA;0;0;0;0;0;0;0;0;0;CELULAR REDMI NOTE 10S 128GB PEBBLE WHITE;TELEFONIA
11258369;;M;53;CHILENO;;Millenial;N/D;N/D;0;0;0;0;0;0;0;0;0;CELULAR MOTOROLA E6S GRIS 32GB DIRECTO WOM;TELEFONIA
17323291;Soltero;F;32;CHILENO;;Millenial;VILLARICA                     ;ARAUCANIA;0;0;0;0;0;0;0;0;0;CELULAR A12 128GB NEGRO OPEN;TELEFONIA
10262658;;F;55;CHILENO;;Boomers;VILLA ALEMANA                 ;VALPARAISO;0;0;0;0;0;0;0;0;0;CELULAR A72 128 GB LIGHT VIOLET OPEN;TELEFONIA
8641477;;F;61;CHILENO;;Boomers;PROVIDENCIA                   ;METROPOLITANA;0;0;0;0;0;0;0;0;0;CELULAR A32 128 GB WHITE OPEN;TELEFONIA
19860629;;M;24;CHILENO;;Z;PROVIDENCIA                   ;METROPOLITANA;0;0;0;0;0;0;0;0;0;CELULAR REDMI NOTE 10 PRO 6+128GB GRADIENT BRONZ;TELEFONIA
20019976;;M;23;CHILENO;;Z;N/D;N/D;0;0;0;0;0;0;0;0;0;CELULAR REDMI NOTE 9 128G ONYX BLACK OPEN;TELEFONIA
18863443;Soltero;F;27;CHILENO;;Z;PROVIDENCIA                   ;METROPOLITANA;0;0;0;0;0;0;0;0;0;CELULAR POCO X3 PRO 128G PHANTOM BLACK OPEN;TELEFONIA
12114040;Soltero;M;41;CHILENO;CONSTRUCTOR CIVIL;X;PROVIDENCIA                   ;METROPOLITANA;0;0;0;0;0;0;0;0;0;CELULAR A32 128 GB LIGHT VIOLET OPEN;TELEFONIA
19937895;;M;25;CHILENO;;Z;PROVIDENCIA                   ;METROPOLITANA;0;0;0;0;0;0;0;0;0;CELULAR REDMI 9C 32GB TWILIGHT BLUE MOVISTAR;TELEFONIA
19524124;Soltero;F;25;CHILENO;TERAPEUTA OCUPACIONAL;Z;PROVIDENCIA                   ;METROPOLITANA;0;0;0;0;0;0;0;0;0;CELULAR GALAXY S20FE 128GB ClOUD NAVY OPEN;TELEFONIA
10246603;;F;57;CHILENO;;Boomers;LA SERENA                     ;COQUIMBO;0;0;0;0;0;0;0;0;0;CELULAR MOTO G9 POWER PURPLE 128GB MOVISTAR;TELEFONIA
16700771;;M;34;CHILENO;;Millenial;CABILDO                       ;VALPARAISO;0;0;0;0;0;0;0;0;0;Celular A01 Core Azul Tri Entel;TELEFONIA
20653417;;F;21;CHILENO;;Z;PROVIDENCIA                   ;METROPOLITANA;0;0;0;0;0;0;0;0;0;Celular A10S MOVISTAR DIRECTO BLACK;TELEFONIA
17276681;;M;33;CHILENO;;Millenial;SAN CARLOS                    ;BIO BIO;0;0;0;0;0;0;0;0;0;CELULAR REDMI 9C 32GB TWILIGHT BLUE MOVISTAR;TELEFONIA
7997549;;F;62;CHILENO;;Boomers;RENCA                         ;METROPOLITANA;0;0;0;0;0;0;0;0;0;CELULAR VIVO Y11S PHANTOM BLACK OPEN;TELEFONIA
6236904;;F;77;CHILENO;;Silencioso;PROVIDENCIA                   ;METROPOLITANA;0;0;0;0;0;0;0;0;0;CELULAR NOKIA 225 4G BLACK TRI ENTEL;TELEFONIA
17960946;;M;30;CHILENO;;Silencioso;PROVIDENCIA                   ;METROPOLITANA;0;0;0;0;0;0;0;0;0;CELULAR POCO X3 PRO 256 GB FROST BLUE;TELEFONIA
7245218;;M;68;CHILENO;;Silencioso;SAN BERNARDO                  ;METROPOLITANA;0;0;0;0;0;0;0;0;0;CELULAR REDMI 9A 32GB PEACOCK GREEN;TELEFONIA
6764397;Soltero;F;75;CHILENO;;Silencioso;PROVIDENCIA                   ;METROPOLITANA;0;0;0;0;0;0;0;0;0;CELULAR MI 11 LITE 128GB BOBA BLACK OPEN;TELEFONIA
9483708;;M;57;CHILENO;;Boomers;LO ESPEJO                     ;METROPOLITANA;0;0;0;0;0;0;0;0;0;CELULAR OPPO A15 BLACK 32GB CLARO;TELEFONIA
19981201;;F;23;CHILENO;;Z;OLMUE                         ;VALPARAISO;0;0;0;0;0;0;0;0;0;CELULAR A32 128 GB BLACK OPEN;TELEFONIA
20256486;;F;22;CHILENO;;Silencioso;PROVIDENCIA                   ;METROPOLITANA;0;0;0;0;0;0;0;0;0;CELULAR REDMI NOTE 10 128GB PEBBLE WHITE;TELEFONIA
9687533;;M;59;CHILENO;;Boomers;NACIMIENTO                    ;BIO BIO;0;0;0;0;0;0;0;0;0;CELULAR MOTO ONE FUSION 64GB VERDE 64GB OPEN;TELEFONIA
17757111;Soltero;F;30;CHILENO;;Millenial;PROVIDENCIA                   ;METROPOLITANA;0;0;0;0;0;0;0;0;0;CELULAR A21s 128 GB Rojo;TELEFONIA
20318639;;M;22;CHILENO;;Millenial;PROVIDENCIA                   ;METROPOLITANA;0;0;0;0;0;0;0;0;0;CELULAR A12 128GB AZUL OPEN;TELEFONIA
19024502;;M;27;CHILENO;;Z;PROVIDENCIA                   ;METROPOLITANA;0;0;0;0;0;0;0;0;0;POCO X3 PRO 256 GB PHANTOM BLACK;TELEFONIA
26292996;;F;38;EXTRANJERO - NO INFORMA NACIONALIDAD;;Extranjero;N/D;N/D;0;0;0;0;0;0;0;0;0;CELULAR POCO X3 PRO 128G PHANTOM BLACK OPEN;TELEFONIA
19120737;Soltero;F;26;CHILENO;;Z;PROVIDENCIA                   ;METROPOLITANA;0;0;0;0;0;0;0;0;0;CELULAR A32 128 GB BLACK OPEN;TELEFONIA
10953659;;F;58;CHILENO;;Boomers;RECOLETA                      ;METROPOLITANA;0;0;0;0;0;0;0;0;0;CELULAR GALAXY A01 32GB AZUL ENTEL;TELEFONIA
27068178;;M;32;VENEZOLANO;;Extranjero;"";"";0;0;0;0;0;0;0;0;0;CELULAR A12 128GB NEGRO OPEN;TELEFONIA
12658620;;M;47;CHILENO;;X;N/D;N/D;0;0;0;0;0;0;0;0;0;CELULAR A32 128 GB WHITE OPEN;TELEFONIA
8581735;Soltero;F;64;CHILENO;;Boomers;RENCA                         ;METROPOLITANA;0;0;0;0;0;0;0;0;0;CELULAR OWN 1026 AZUL ENTEL;TELEFONIA
18581851;;F;29;CHILENO;;Millenial;NUEVA IMPERIAL                ;ARAUCANIA;0;0;0;0;0;0;0;0;0;CELULAR GALAXY A01 32GB AZUL ENTEL;TELEFONIA
11942343;;M;50;CHILENO;;X;PAPUDO                        ;VALPARAISO;0;0;0;0;0;0;0;0;0;CELULAR A12 128GB AZUL OPEN;TELEFONIA
15255589;Casado;M;39;CHILENO;;X;RENCA                         ;METROPOLITANA;0;0;0;0;0;0;0;0;0;CELULAR MOTOROLA E6 PLAY AZUL TRI WOM;TELEFONIA
20300999;;F;24;CHILENO;;Z;N/D;N/D;0;0;0;0;0;0;0;0;0;CELULAR A21s 128 GB Negro;TELEFONIA
16747721;;F;34;CHILENO;;Silencioso;PROVIDENCIA                   ;METROPOLITANA;0;0;0;0;0;0;0;0;0;CELULAR MOTOROLA E6 PLAY AZUL TRI WOM;TELEFONIA
19664513;;M;24;CHILENO;;Z;PROVIDENCIA                   ;METROPOLITANA;0;0;0;0;0;0;0;0;0;CELULAR MOTO ONE FUSION 64GB VERDE 64GB OPEN;TELEFONIA
17438160;;F;32;CHILENO;;Millenial;PROVIDENCIA                   ;METROPOLITANA;0;0;0;0;0;0;0;0;0;CELULAR A32 128 GB LIGHT VIOLET OPEN;TELEFONIA
17829325;;M;31;CHILENO;;Millenial;ARICA                         ;TARAPACA;0;0;0;0;0;0;0;0;0;CELULAR A32 128 GB WHITE OPEN;TELEFONIA
16262574;;M;36;CHILENO;;Millenial;PUERTO MONTT                  ;LOS LAGOS;0;0;0;0;0;0;0;0;0;CELULAR REDMI NOTE 10 128GB ONIX GRAY OPEN;TELEFONIA
12136661;;F;48;CHILENO;;X;PROVIDENCIA                   ;METROPOLITANA;0;0;0;0;0;0;0;0;0;CELULAR A02 ROJO 32GB OPEN;TELEFONIA
16440136;;F;35;CHILENO;;Millenial;NATALES                       ;MAGALLANES;0;0;0;0;0;0;0;0;0;Celular A01 CLARO DIRECTO BLACK;TELEFONIA
18822349;;M;27;CHILENO;;Millenial;N/D;N/D;0;0;0;0;0;0;0;0;0;CELULAR GALAXY S20FE ClOUD ORANGE OPEN SAMSUNG;TELEFONIA
12022043;;F;48;CHILENO;;X;RENCA                         ;METROPOLITANA;0;0;0;0;0;0;0;0;0;CELULAR A32 128 GB BLUE OPEN;TELEFONIA
18997775;;F;27;CHILENO;;Z;VILLA ALEMANA                 ;VALPARAISO;0;0;0;0;0;0;0;0;0;CELULAR GALAXY S20FE 128GB ClOUD NAVY OPEN;TELEFONIA
7595818;;M;66;CHILENO;;Boomers;TALCA                         ;MAULE;0;0;0;0;0;0;0;0;0;CELULAR A21s 128 GB Negro;TELEFONIA
19947848;;M;24;CHILENO;;Millenial;N/D;N/D;0;0;0;0;0;0;0;0;0;CELULAR MOTO G8 POWER LITE AZUL TRI ENTEL;TELEFONIA
9421175;Casado;M;60;CHILENO;;Boomers;RENCA                         ;METROPOLITANA;0;0;0;0;0;0;0;0;0;CELULAR MOTOROLA E6 PLAY AZUL TRI WOM;TELEFONIA
7650690;;M;66;CHILENO;;Silencioso;PROVIDENCIA                   ;METROPOLITANA;0;0;0;0;0;0;0;0;0;CELULAR OWN 1026 AZUL ENTEL;TELEFONIA
11452856;;M;52;CHILENO;;X;PROVIDENCIA                   ;METROPOLITANA;0;0;0;0;0;0;0;0;0;CELULAR MOTO E6I 32GB GRIS OPEN;TELEFONIA
26477484;;M;38;VENEZOLANO;;Extranjero;LOS ANGELES                   ;BIO BIO;0;0;0;0;0;0;0;0;0;CELULAR MOTO G30 128GB LILA PASTEL OPEN;TELEFONIA
21957218;;F;56;PERUANO;;Extranjero;SANTIAGO                      ;METROPOLITANA;0;0;0;0;0;0;0;0;0;CELULAR A12 128GB ROJO OPEN;TELEFONIA
14522494;Casado;F;49;CHILENO;;X;RENCA                         ;METROPOLITANA;0;0;0;0;0;0;0;0;0;CELULAR A32 128 GB BLUE OPEN;TELEFONIA
11515528;;F;52;CHILENO;;X;CABILDO                       ;VALPARAISO;0;0;0;0;0;0;0;0;0;POCO X3 PRO 256 GB PHANTOM BLACK;TELEFONIA
20112000;;F;23;CHILENO;;Z;SAN CARLOS                    ;BIO BIO;0;0;0;0;0;0;0;0;0;CELULAR MOTO E6I ROSA OPEN;TELEFONIA
12872571;Casado;M;46;CHILENO;TECNICO EN ADMINISTRACION DE EMPRESAS;Silencioso;PROVIDENCIA                   ;METROPOLITANA;0;0;0;0;0;0;0;0;0;Celular Galaxy S21 Plus Phantom Silver 128GB;TELEFONIA
7958262;;F;65;CHILENO;;Boomers;LOS ANDES                     ;VALPARAISO;0;0;0;0;0;0;0;0;0;CELULAR A21s 128 GB Negro;TELEFONIA
19823487;;F;24;CHILENO;;Z;CHILLAN                       ;BIO BIO;0;0;0;0;0;0;0;0;0;CHIP OPEN ENTEL;TELEFONIA
8985311;;F;61;CHILENO;;Boomers;ARICA                         ;TARAPACA;0;0;0;0;0;0;0;0;0;CELULAR A02 AZUL 32GB OPEN;TELEFONIA
15404669;;M;40;CHILENO;;X;N/D;N/D;0;0;0;0;0;0;0;0;0;CELULAR NOKIA 5.3 CHARCOAL TRI ENTEL;TELEFONIA
10175913;;M;57;CHILENO;;Boomers;PROVIDENCIA                   ;METROPOLITANA;0;0;0;0;0;0;0;0;0;Celular A11 LIB OPEN WHITE;TELEFONIA
17289064;;F;32;CHILENO;;Millenial;PROVIDENCIA                   ;METROPOLITANA;0;0;0;0;0;0;0;0;0;CELULAR OWN 1026 AZUL ENTEL;TELEFONIA
8742050;;M;62;CHILENO;;Boomers;PUENTE ALTO                   ;METROPOLITANA;0;0;0;0;0;0;0;0;0;Celular A11 LIB OPEN WHITE;TELEFONIA
17856006;;F;31;CHILENO;;Millenial;PROVIDENCIA                   ;METROPOLITANA;0;0;0;0;0;0;0;0;0;CELULAR MOTO ONE FUSION 64GB VERDE 64GB OPEN;TELEFONIA
25834129;;F;29;BRASILEÃO;;Extranjero;N/D;N/D;0;0;0;0;0;0;0;0;0;CELULAR MOTO E6I ROSA OPEN;TELEFONIA
17641269;;M;31;CHILENO;;Millenial;PROVIDENCIA                   ;METROPOLITANA;0;0;0;0;0;0;0;0;0;CELULAR POCO X3 PRO 256 GB FROST BLUE;TELEFONIA
10619129;;M;61;CHILENO;;Boomers;PROVIDENCIA                   ;METROPOLITANA;0;0;0;0;0;0;0;0;0;Celular LG K22 ENTEL DIRECTO TITAN;TELEFONIA
8929657;;M;60;CHILENO;;Boomers;ARICA                         ;ARICA Y PARINACOTA;0;0;0;0;0;0;0;0;0;CELULAR MOTOROLA G9 PLAY 64GB BLUE DIRECTO CLAR;TELEFONIA
16897233;;M;33;CHILENO;;Millenial;N/D;N/D;0;0;0;0;0;0;0;0;0;CELULAR MOTOROLA E6 PLAY AZUL TRI WOM;TELEFONIA
18459216;;F;29;CHILENO;;Silencioso;PROVIDENCIA                   ;METROPOLITANA;0;0;0;0;0;0;0;0;0;CELULAR MI 11 LITE 128GB BUBBLEGUM BLUE;TELEFONIA
10171462;Soltero;M;58;CHILENO;INGENIERO AGRICOLA;Boomers;PROVIDENCIA                   ;METROPOLITANA;0;0;0;0;0;0;0;0;0;CELULAR ALCATEL P1 DIRECTO CLARO BLACK;TELEFONIA
13937421;;F;42;CHILENO;;X;N/D;N/D;0;0;0;0;0;0;0;0;0;CELULAR A32 128 GB BLUE OPEN;TELEFONIA
16996927;;M;33;CHILENO;;Millenial;PROVIDENCIA                   ;METROPOLITANA;0;0;0;0;0;0;0;0;0;POCO X3 PRO 256 GB PHANTOM BLACK;TELEFONIA
15864773;;F;37;CHILENO;;Millenial;PROVIDENCIA                   ;METROPOLITANA;0;0;0;0;0;0;0;0;0;CELULAR POCO X3 PRO 128G PHANTOM BLACK OPEN;TELEFONIA
13341726;;F;44;CHILENO;;X;PROVIDENCIA                   ;METROPOLITANA;0;0;0;0;0;0;0;0;0;CELULAR MOTO ONE FUSION 128GB AZUL OPEN;TELEFONIA
8850988;;M;61;CHILENO;;Boomers;RETIRO                        ;MAULE;0;0;0;0;0;0;0;0;0;CELULAR NOKIA 110 BLACK OPEN;TELEFONIA
9490205;;M;60;CHILENO;;Boomers;PROVIDENCIA                   ;METROPOLITANA;0;0;0;0;0;0;0;0;0;CELULAR ZTE A3 2020 GRIS DIRECTO CLARO;TELEFONIA
18369279;Soltero;M;29;CHILENO;;Silencioso;PROVIDENCIA                   ;METROPOLITANA;0;0;0;0;0;0;0;0;0;CELULAR MOTOROLA G9 PLAY 64GB BLUE DIRECTO CLAR;TELEFONIA
17173684;;M;33;CHILENO;;Silencioso;PROVIDENCIA                   ;METROPOLITANA;0;0;0;0;0;0;0;0;0;Celular Galaxy S21 Plus Phantom Silver 128GB;TELEFONIA
6796306;;M;70;CHILENO;;Silencioso;RENCA                         ;METROPOLITANA;0;0;0;0;0;0;0;0;0;CELULAR VIVO Y11S PHANTOM BLACK OPEN;TELEFONIA
10824923;;M;48;CHILENO;;X;RINCONADA                     ;VALPARAISO;0;0;0;0;0;0;0;0;0;CELULAR VIVO Y11S PHANTON BLACK 32GB MOVISTAR;TELEFONIA
9485797;;M;60;CHILENO;;Boomers;COLINA                        ;METROPOLITANA;0;0;0;0;0;0;0;0;0;CELULAR ZTE A3 2020 GRIS DIRECTO CLARO;TELEFONIA
11466834;;M;52;CHILENO;;Silencioso;PROVIDENCIA                   ;METROPOLITANA;0;0;0;0;0;0;0;0;0;CELULAR SAMSUNG NOTE 20 MYSTIC GRAY OPEN;TELEFONIA
18662240;Soltero;M;28;CHILENO;;Silencioso;PROVIDENCIA                   ;METROPOLITANA;0;0;0;0;0;0;0;0;0;CELULAR A12 128GB NEGRO OPEN;TELEFONIA
16238893;;M;36;CHILENO;;Millenial;TENO                          ;MAULE;0;0;0;0;0;0;0;0;0;Celular LG K22 ENTEL DIRECTO TITAN;TELEFONIA
8064121;;M;62;CHILENO;;Boomers;CONSTITUCION                  ;MAULE;0;0;0;0;0;0;0;0;0;CELULAR A21s 128 GB Negro;TELEFONIA
19824178;;F;23;CHILENO;;Silencioso;PROVIDENCIA                   ;METROPOLITANA;0;0;0;0;0;0;0;0;0;CELULAR MOTO ONE FUSION 64GB VERDE 64GB OPEN;TELEFONIA
20353560;;F;22;CHILENO;;Silencioso;PROVIDENCIA                   ;METROPOLITANA;0;0;0;0;0;0;0;0;0;CELULAR SAMSUNG A02S DIRECTO CLARO BLACK;TELEFONIA
18542968;Soltero;M;29;CHILENO;;Millenial;PROVIDENCIA                   ;METROPOLITANA;0;0;0;0;0;0;0;0;0;Celular A11 LIB OPEN WHITE;TELEFONIA
26079530;;F;30;VENEZOLANO;;Extranjero;N/D;N/D;0;0;0;0;0;0;0;0;0;CELULAR A72 128 GB BLACK OPEN;TELEFONIA
16220544;;M;36;CHILENO;;Millenial;RENCA                         ;METROPOLITANA;0;0;0;0;0;0;0;0;0;CELULAR OWN 1026 AZUL ENTEL;TELEFONIA
27119906;;F;32;EXTRANJERO - NO INFORMA NACIONALIDAD;;Extranjero;N/D;N/D;0;0;0;0;0;0;0;0;0;CELULAR VIVO Y20 BLACK 64GB MOVISTAR;TELEFONIA
20093736;;F;23;CHILENO;;X;N/D;N/D;0;0;0;0;0;0;0;0;0;CELULAR A02 ROJO 32GB OPEN;TELEFONIA
12405133;;M;49;CHILENO;;X;LO PRADO                      ;METROPOLITANA;0;0;0;0;0;0;0;0;0;CELULAR MI 11 LITE 128GB BUBBLEGUM BLUE;TELEFONIA
9690362;Soltero;F;61;CHILENO;MANIPULADOR DE ALIMOS;Silencioso;PROVIDENCIA                   ;METROPOLITANA;0;0;0;0;0;0;0;0;0;CELULAR A21s 128 GB Rojo;TELEFONIA
11729647;Soltero;F;51;CHILENO;;X;PROVIDENCIA                   ;METROPOLITANA;0;0;0;0;0;0;0;0;0;CELULAR MOTO G9 POWER 128GB MORADO SONICO OPEN;TELEFONIA
10964079;;F;57;CHILENO;;Boomers;N/D;N/D;0;0;0;0;0;0;0;0;0;CELULAR GALAXY S20FE 128GB ClOUD NAVY OPEN;TELEFONIA
20177532;;F;23;CHILENO;;Z;PROVIDENCIA                   ;METROPOLITANA;0;0;0;0;0;0;0;0;0;CELULAR A32 128 GB BLUE OPEN;TELEFONIA
9395262;;M;59;CHILENO;;Boomers;COLLIPULLI                    ;ARAUCANIA;0;0;0;0;0;0;0;0;0;CELULAR REDMI NOTE 9 128G FOREST GREEN OPEN;TELEFONIA
8926460;Casado;M;61;CHILENO;PROFESOR;Boomers;RENCA                         ;METROPOLITANA;0;0;0;0;0;0;0;0;0;CELULAR REDMI NOTE 10 EU 128G Onyx Gray BUNDLE;TELEFONIA
17399090;;F;32;CHILENO;;Millenial;PERALILLO                     ;L.G.B.OÂ´HIGGINS;0;0;0;0;0;0;0;0;0;CELULAR XIAOMI REDMI 9C 32GB AZUL WOM;TELEFONIA
11920585;;M;50;CHILENO;;X;LA UNION                      ;LOS RIOS;0;0;0;0;0;0;0;0;0;CELULAR ZTE A3 2020 GRIS DIRECTO CLARO;TELEFONIA
16669075;;M;34;CHILENO;;Millenial;PROVIDENCIA                   ;METROPOLITANA;0;0;0;0;0;0;0;0;0;CELULAR MOTOROLA E6 PLAY AZUL TRI WOM;TELEFONIA
19681925;;M;25;CHILENO;;Z;PROVIDENCIA                   ;METROPOLITANA;0;0;0;0;0;0;0;0;0;CELULAR GALAXY S20FE 128GB ClOUD NAVY OPEN;TELEFONIA
8952996;;F;61;CHILENO;;Boomers;PROVIDENCIA                   ;METROPOLITANA;0;0;0;0;0;0;0;0;0;Celular A11 LIB OPEN BLACK;TELEFONIA
19699289;;F;25;CHILENO;;Silencioso;PROVIDENCIA                   ;METROPOLITANA;0;0;0;0;0;0;0;0;0;CELULAR POCO X3 PRO 128G PHANTOM BLACK OPEN;TELEFONIA
13801500;;M;42;CHILENO;;X;LOS ANGELES                   ;BIO BIO;0;0;0;0;0;0;0;0;0;CELULAR A21s 128 GB AZUL;TELEFONIA
15050581;;F;40;CHILENO;;X;LA SERENA                     ;COQUIMBO;0;0;0;0;0;0;0;0;0;IPHONE X 64GB LIB OPEN GRIS;TELEFONIA
18365650;;F;29;CHILENO;;Extranjero;"";"";0;0;0;0;0;0;0;0;0;CELULAR A02s AZUL 32GB OPEN;TELEFONIA
10265695;;F;57;CHILENO;;Boomers;PUENTE ALTO                   ;METROPOLITANA;0;0;0;0;0;0;0;0;0;CELULAR VIVO Y11S PHANTON BLACK 32GB MOVISTAR;TELEFONIA
10166476;;F;57;CHILENO;;Boomers;LANCO                         ;LOS RIOS;0;0;0;0;0;0;0;0;0;CELULAR MOTOROLA E6 PLAY AZUL TRI WOM;TELEFONIA
20111542;;F;22;CHILENO;;Z;EL CARMEN                     ;BIO BIO;0;0;0;0;0;0;0;0;0;CELULAR REDMI NOTE 9 128G FOREST GREEN OPEN;TELEFONIA
20143489;;F;23;CHILENO;;Z;PROVIDENCIA                   ;METROPOLITANA;0;0;0;0;0;0;0;0;0;IPHONE 8 64 GB LIB OPEN DORADO;TELEFONIA
16227154;;F;36;CHILENO;;Millenial;N/D;N/D;0;0;0;0;0;0;0;0;0;CELULAR LG K22 TRIANGULADO WOM;TELEFONIA
18352672;;F;30;CHILENO;;Millenial;PROVIDENCIA                   ;METROPOLITANA;0;0;0;0;0;0;0;0;0;Celular A11 LIB OPEN WHITE;TELEFONIA
20292468;;M;22;CHILENO;;Z;QUINCHAO                      ;LOS LAGOS;0;0;0;0;0;0;0;0;0;Celular A31 LIB OPEN BLACK;TELEFONIA
18569434;;F;29;CHILENO;;Millenial;"";"";0;0;0;0;0;0;0;0;0;CELULAR REDMI 9A 32GB SKY BLUE DIRECTO MOVISTAR;TELEFONIA
13830674;Casado;M;42;CHILENO;;Silencioso;PROVIDENCIA                   ;METROPOLITANA;0;0;0;0;0;0;0;0;0;Celular A11 LIB OPEN BLACK;TELEFONIA
9248337;;M;57;CHILENO;;Boomers;RENCA                         ;METROPOLITANA;0;0;0;0;0;0;0;0;0;Celular SA3 CLARO DIRECTO BLACK;TELEFONIA
20234728;;F;22;CHILENO;;Z;PROVIDENCIA                   ;METROPOLITANA;0;0;0;0;0;0;0;0;0;CELULAR A52 128 GB BLACK OPEN;TELEFONIA
18681839;Soltero;F;28;CHILENO;;Millenial;PROVIDENCIA                   ;METROPOLITANA;0;0;0;0;0;0;0;0;0;Celular SAMSUNG A11 32GB ENTEL DIRECTO NEGRO;TELEFONIA
12169504;;M;51;CHILENO;;X;N/D;N/D;0;0;0;0;0;0;0;0;0;Celular A11 LIB OPEN BLACK;TELEFONIA
19633791;;M;25;CHILENO;;Z;LA GRANJA;METROPOLITANA;0;0;0;0;0;0;0;0;0;CELULAR MOTOROLA G9 PLAY 64GB ELECTRIC BLUE OPEN;TELEFONIA
11599472;;F;52;CHILENO;;X;ARICA                         ;ARICA Y PARINACOTA;0;0;0;0;0;0;0;0;0;CELULAR A12 128GB ROJO OPEN;TELEFONIA
15501754;;F;39;CHILENO;;Silencioso;PROVIDENCIA                   ;METROPOLITANA;0;0;0;0;0;0;0;0;0;CELULAR MOTOROLA G9 PLAY 64GB ELECTRIC BLUE OPEN;TELEFONIA
9003137;;F;62;CHILENO;;Boomers;SAN PEDRO DE LA PAZ           ;BIO BIO;0;0;0;0;0;0;0;0;0;Celular A31 LIB OPEN ROJO;TELEFONIA
13772413;;F;42;CHILENO;;X;PARRAL                        ;MAULE;0;0;0;0;0;0;0;0;0;CELULAR A12 128GB AZUL OPEN;TELEFONIA
15223059;;M;39;CHILENO;;X;SAN PEDRO DE LA PAZ           ;BIO BIO;0;0;0;0;0;0;0;0;0;Celular XIAOMI REDMI 9 64 GB DIRECTO CLARO NEGRO;TELEFONIA
13529697;;F;42;CHILENO;;X;PROVIDENCIA                   ;METROPOLITANA;0;0;0;0;0;0;0;0;0;CELULAR A02 AZUL 32GB OPEN;TELEFONIA
20370390;;F;22;CHILENO;;Silencioso;PROVIDENCIA                   ;METROPOLITANA;0;0;0;0;0;0;0;0;0;CELULAR REDMI 9 64GB SUNSET PURPLE TRI WOM;TELEFONIA
16244850;;M;36;CHILENO;;Millenial;N/D;N/D;0;0;0;0;0;0;0;0;0;CELULAR REDMI NOTE 10 128GB ONIX GRAY OPEN;TELEFONIA
16169571;;M;37;CHILENO;;Silencioso;PROVIDENCIA                   ;METROPOLITANA;0;0;0;0;0;0;0;0;0;IPHONE 12 128GB BLACK CLARO;TELEFONIA
18118280;;F;30;CHILENO;;Silencioso;PROVIDENCIA                   ;METROPOLITANA;0;0;0;0;0;0;0;0;0;CELULAR SAMSUNG NOTE 20 MYSTIC GRAY OPEN;TELEFONIA
25342594;;M;32;PERUANO;;Extranjero;N/D;N/D;0;0;0;0;0;0;0;0;0;CELULAR A72 128 GB BLACK OPEN;TELEFONIA
17195584;;F;34;CHILENO;;Millenial;NUEVA IMPERIAL                ;ARAUCANIA;0;0;0;0;0;0;0;0;0;Celular A11 LIB OPEN BLUE;TELEFONIA
18527432;Soltero;F;27;CHILENO;INFORMACION TURISTICO;Z;PROVIDENCIA                   ;METROPOLITANA;0;0;0;0;0;0;0;0;0;CELULAR ALCATEL P1 3080 BLACK MOVISTAR DIRECTO;TELEFONIA
13519675;;F;44;CHILENO;;X;VALDIVIA                      ;LOS LAGOS;0;0;0;0;0;0;0;0;0;CELULAR A02s ROJO 32GB OPEN;TELEFONIA
15267053;Soltero;F;39;CHILENO;;X;PROVIDENCIA                   ;METROPOLITANA;0;0;0;0;0;0;0;0;0;CELULAR ALCATEL P1 3080 BLACK MOVISTAR DIRECTO;TELEFONIA
18411513;Soltero;F;28;CHILENO;PROFESOR;Silencioso;PROVIDENCIA                   ;METROPOLITANA;0;0;0;0;0;0;0;0;0;CELULAR GALAXY S20FE 128GB ClOUD NAVY OPEN;TELEFONIA
15767944;;F;42;CHILENO;;X;CERRO NAVIA                   ;METROPOLITANA;0;0;0;0;0;0;0;0;0;CELULAR XIAOMI POCO X3 64G SHADOW GRAY;TELEFONIA
8057149;;M;62;CHILENO;;Boomers;ARICA                         ;ARICA Y PARINACOTA;0;0;0;0;0;0;0;0;0;CELULAR A02s AZUL 32GB OPEN;TELEFONIA
12092858;;M;44;CHILENO;;X;"";"";0;0;0;0;0;0;0;0;0;CELULAR A12 128GB AZUL OPEN;TELEFONIA
11851052;Viudo;M;50;CHILENO;;Silencioso;PROVIDENCIA                   ;METROPOLITANA;0;0;0;0;0;0;0;0;0;Celular A11 LIB OPEN WHITE;TELEFONIA
19918234;;M;23;CHILENO;;Z;PUENTE ALTO                   ;METROPOLITANA;0;0;0;0;0;0;0;0;0;CELULAR REDMI NOTE 10 EU 64GB ONIX GRAY OPEN;TELEFONIA
9444643;;M;60;CHILENO;;Boomers;PENAFLOR                      ;METROPOLITANA;0;0;0;0;0;0;0;0;0;CELULAR A21s 128 GB AZUL;TELEFONIA
15219377;Soltero;F;38;CHILENO;;X;PROVIDENCIA                   ;METROPOLITANA;0;0;0;0;0;0;0;0;0;CELULAR ZTE A3 2020 GRIS DIRECTO CLARO;TELEFONIA
18616679;;M;29;CHILENO;;Millenial;PERALILLO                     ;L.G.B.OÂ´HIGGINS;0;0;0;0;0;0;0;0;0;CELULAR POCO M3 64GB COOL BLUE;TELEFONIA
14153401;;M;40;CHILENO;;X;PROVIDENCIA                   ;METROPOLITANA;0;0;0;0;0;0;0;0;0;IPHONE 6S 64GB ROSA OPEN;TELEFONIA
18052575;Soltero;M;30;CHILENO;;Silencioso;PROVIDENCIA                   ;METROPOLITANA;0;0;0;0;0;0;0;0;0;Celular G8 POWER LITE WOM DIRECTO TURQUESA;TELEFONIA
19336464;;F;26;CHILENO;;Z;N/D;N/D;0;0;0;0;0;0;0;0;0;CELULAR MOTO G9 POWER 128GB MORADO SONICO OPEN;TELEFONIA
17325314;Casado;M;32;CHILENO;INGENIERO CIVIL INDUSTRIAL;Silencioso;PROVIDENCIA                   ;METROPOLITANA;0;0;0;0;0;0;0;0;0;CELULAR POCO M3 64GB COOL BLUE;TELEFONIA
19138667;Soltero;M;26;CHILENO;INGENIERIA EN MAQUINARIA VEHICULOS AUTOMOTRICES Y SISTEMAS ELECTRONICOS;Z;PROVIDENCIA                   ;METROPOLITANA;0;0;0;0;0;0;0;0;0;CELULAR A21s 128 GB Negro;TELEFONIA
19604084;;F;25;CHILENO;;Z;SAN FERNANDO                  ;L.G.B.OÂ´HIGGINS;0;0;0;0;0;0;0;0;0;CELULAR MOTO ONE FUSION 64GB VERDE 64GB OPEN;TELEFONIA
16997817;;M;34;CHILENO;;Silencioso;PROVIDENCIA                   ;METROPOLITANA;0;0;0;0;0;0;0;0;0;CELULAR REDMI NOTE 10 128GB ONIX GRAY OPEN;TELEFONIA
20169806;;F;22;CHILENO;;Z;N/D;N/D;0;0;0;0;0;0;0;0;0;CELULAR REDMI NOTE 10 EU 128G Lake Green BUNDLE;TELEFONIA
12187711;Casado;F;49;CHILENO;;Silencioso;PROVIDENCIA                   ;METROPOLITANA;0;0;0;0;0;0;0;0;0;CELULAR GALAXY A01 32GB AZUL ENTEL;TELEFONIA
14181586;Soltero;F;41;CHILENO;;Silencioso;PROVIDENCIA                   ;METROPOLITANA;0;0;0;0;0;0;0;0;0;CELULAR A32 128 GB LIGHT VIOLET OPEN;TELEFONIA
9944316;;F;41;CHILENO;;X;RENCA                         ;METROPOLITANA;0;0;0;0;0;0;0;0;0;Celular A01 Core Azul Tri Entel;TELEFONIA
12696744;;F;48;CHILENO;;X;"";"";0;0;0;0;0;0;0;0;0;CELULAR REDMI NOTE 10 128GB PEBBLE WHITE;TELEFONIA
10374924;Soltero;M;57;CHILENO;AGRONOMO;Boomers;RENCA                         ;METROPOLITANA;0;0;0;0;0;0;0;0;0;CELULAR A02 NEGRO 32GB OPEN;TELEFONIA
15546377;;F;38;CHILENO;;Silencioso;PROVIDENCIA                   ;METROPOLITANA;0;0;0;0;0;0;0;0;0;CELULAR A21s 128 GB AZUL;TELEFONIA
13573612;Casado;M;43;CHILENO;TECNICO MECANICO;X;RENCA                         ;METROPOLITANA;0;0;0;0;0;0;0;0;0;Celular Galaxy S21 Phantom Grey 128GB;TELEFONIA
7675911;;F;67;CHILENO;;Boomers;NATALES                       ;MAGALLANES;0;0;0;0;0;0;0;0;0;CELULAR REDMI 9 32GB CARBON GREY OPEN;TELEFONIA
19214071;Soltero;F;26;CHILENO;;Z;HIJUELAS                      ;VALPARAISO;0;0;0;0;0;0;0;0;0;CELULAR MOTO ONE FUSION 64GB VERDE 64GB OPEN;TELEFONIA
19829581;;F;24;CHILENO;;Z;PROVIDENCIA                   ;METROPOLITANA;0;0;0;0;0;0;0;0;0;CELULAR A21s 128 GB Rojo;TELEFONIA
18429286;;M;29;CHILENO;;Millenial;CHILLAN VIEJO                 ;BIO BIO;0;0;0;0;0;0;0;0;0;CELULAR A21s 128 GB AZUL;TELEFONIA
18690148;Soltero;M;28;CHILENO;TECNICO DEPORTIVO;Millenial;PROVIDENCIA                   ;METROPOLITANA;0;0;0;0;0;0;0;0;0;CELULAR MOTOROLA E6S GRIS 32GB DIRECTO WOM;TELEFONIA
12484263;;M;48;CHILENO;;X;N/D;N/D;0;0;0;0;0;0;0;0;0;Celular A11 LIB OPEN WHITE;TELEFONIA
17229238;;M;32;CHILENO;;Millenial;PROVIDENCIA                   ;METROPOLITANA;0;0;0;0;0;0;0;0;0;Celular A11 LIB OPEN BLUE;TELEFONIA
11794994;Casado;M;50;CHILENO;;X;RENCA                         ;METROPOLITANA;0;0;0;0;0;0;0;0;0;CELULAR A21s 128 GB AZUL;TELEFONIA
9184339;;F;75;CHILENO;;Silencioso;PROVIDENCIA                   ;METROPOLITANA;0;0;0;0;0;0;0;0;0;CELULAR OWN 1026 AZUL ENTEL;TELEFONIA
18329758;;F;29;CHILENO;;Silencioso;PROVIDENCIA                   ;METROPOLITANA;0;0;0;0;0;0;0;0;0;CELULAR A21s 128 GB Rojo;TELEFONIA
17732833;;F;31;CHILENO;;Millenial;"";"";0;0;0;0;0;0;0;0;0;CELULAR MOTO E6I ROSA OPEN;TELEFONIA
12544206;Casado;M;47;CHILENO;AGROINDUSTRIA;X;PROVIDENCIA                   ;METROPOLITANA;0;0;0;0;0;0;0;0;0;CELULAR A02s AZUL 32GB OPEN;TELEFONIA
7415826;;F;68;CHILENO;;Silencioso;CORONEL                       ;BIO BIO;0;0;0;0;0;0;0;0;0;Celular A10S LIB OPEN NEGRO;TELEFONIA
15969725;;M;37;CHILENO;;Millenial;"";"";0;0;0;0;0;0;0;0;0;CHIP OPEN ENTEL;TELEFONIA
16987624;;M;34;CHILENO;;Millenial;"";"";0;0;0;0;0;0;0;0;0;CELULAR A21s 128 GB AZUL;TELEFONIA
19425600;Soltero;F;26;CHILENO;TECNICO DE NIVEL SUPERIOR EN ENFERMERIA;Silencioso;PROVIDENCIA                   ;METROPOLITANA;0;0;0;0;0;0;0;0;0;Celular A20S LIB OPEN NEGRO;TELEFONIA
13879410;;F;42;CHILENO;;X;N/D;N/D;0;0;0;0;0;0;0;0;0;CELULAR MOTOROLA E6 PLAY AZUL TRI WOM;TELEFONIA
17980382;Soltero;M;30;CHILENO;;Millenial;PROVIDENCIA                   ;METROPOLITANA;0;0;0;0;0;0;0;0;0;CELULAR REDMI NOTE 9 128G FOREST GREEN OPEN;TELEFONIA
18515492;;M;30;CHILENO;;Millenial;SAN FERNANDO                  ;L.G.B.OÂ´HIGGINS;0;0;0;0;0;0;0;0;0;CELULAR A12 128GB NEGRO OPEN;TELEFONIA
13364987;;M;44;CHILENO;;X;NOGALES                       ;VALPARAISO;0;0;0;0;0;0;0;0;0;CELULAR A21s 128 GB AZUL;TELEFONIA
16785302;Soltero;M;35;CHILENO;;Silencioso;PROVIDENCIA                   ;METROPOLITANA;0;0;0;0;0;0;0;0;0;CELULAR REDMI NOTE 9 PRO 128GB GLACIER WHITE;TELEFONIA
19886327;;M;24;CHILENO;;Silencioso;PROVIDENCIA                   ;METROPOLITANA;0;0;0;0;0;0;0;0;0;CELULAR REDMI NOTE 10 EU 64GB ONIX GRAY OPEN;TELEFONIA
9345252;;F;59;CHILENO;;Boomers;LOS ANGELES                   ;BIO BIO;0;0;0;0;0;0;0;0;0;CELULAR A12 128GB NEGRO OPEN;TELEFONIA
19955531;;F;24;CHILENO;;Z;PROVIDENCIA                   ;METROPOLITANA;0;0;0;0;0;0;0;0;0;CELULAR A21s 128 GB Negro;TELEFONIA
6137419;Viudo;F;70;CHILENO;;Silencioso;PROVIDENCIA                   ;METROPOLITANA;0;0;0;0;0;0;0;0;0;CELULAR SAMSUNG A01 NEGRO DIRECTO WOM;TELEFONIA
7820173;;M;66;CHILENO;;Boomers;VILLARICA                     ;ARAUCANIA;0;0;0;0;0;0;0;0;0;CELULAR OWN 1026 AZUL ENTEL;TELEFONIA
12369592;;M;48;CHILENO;;X;RENCA                         ;METROPOLITANA;0;0;0;0;0;0;0;0;0;CELULAR MOTOROLA E6S GRIS 32GB DIRECTO WOM;TELEFONIA
20303479;;M;21;CHILENO;;Z;"";"";0;0;0;0;0;0;0;0;0;CELULAR A21s 128 GB AZUL;TELEFONIA
14379274;;F;43;CHILENO;;X;RENCA                         ;METROPOLITANA;0;0;0;0;0;0;0;0;0;Celular AL3 CLARO DIRECTO NEGRO;TELEFONIA
20278507;;F;22;CHILENO;;Z;PROVIDENCIA                   ;METROPOLITANA;0;0;0;0;0;0;0;0;0;CELULAR REDMI NOTE 10 128GB PEBBLE WHITE;TELEFONIA
14088041;;M;41;CHILENO;;X;ANCUD                         ;LOS LAGOS;0;0;0;0;0;0;0;0;0;CELULAR A21s 128 GB AZUL;TELEFONIA
11905647;;F;50;CHILENO;;X;RENCA                         ;METROPOLITANA;0;0;0;0;0;0;0;0;0;CELULAR SAMSUNG A01 NEGRO DIRECTO WOM;TELEFONIA
12193046;;F;50;CHILENO;;Silencioso;PROVIDENCIA                   ;METROPOLITANA;0;0;0;0;0;0;0;0;0;IPHONE 8 64 GB LIB OPEN DORADO;TELEFONIA
9429328;Casado;M;59;CHILENO;;Millenial;N/D;N/D;0;0;0;0;0;0;0;0;0;CELULAR A12 128GB NEGRO OPEN;TELEFONIA
16036230;;F;37;CHILENO;;Millenial;CONCEPCION                    ;BIO BIO;0;0;0;0;0;0;0;0;0;CELULAR REDMI NOTE 9 128 GB POLAR WHITE OPEN;TELEFONIA
16509837;;F;35;CHILENO;;Millenial;SAN ANTONIO                   ;VALPARAISO;0;0;0;0;0;0;0;0;0;CELULAR GALAXY S20FE 128GB ClOUD NAVY OPEN;TELEFONIA
13525685;;M;44;CHILENO;;X;N/D;N/D;0;0;0;0;0;0;0;0;0;CELULAR NOKIA 225 4G BLACK MOVISTAR DIRECTO;TELEFONIA
16549591;;F;34;CHILENO;;Silencioso;PROVIDENCIA                   ;METROPOLITANA;0;0;0;0;0;0;0;0;0;Celular R340 CLARO DIRECTO NEGRO;TELEFONIA
9903788;;F;58;CHILENO;;Boomers;RENCA                         ;METROPOLITANA;0;0;0;0;0;0;0;0;0;CELULAR A21s 128 GB AZUL;TELEFONIA
27143722;;M;30;CHILENO;;Extranjero;N/D;N/D;0;0;0;0;0;0;0;0;0;CELULAR Xiaomi Redmi 9 64 GB Morado WOM;TELEFONIA
9717877;;M;56;CHILENO;;Silencioso;PROVIDENCIA                   ;METROPOLITANA;0;0;0;0;0;0;0;0;0;CELULAR A21s 128 GB AZUL;TELEFONIA
15125978;;F;39;CHILENO;;X;PROVIDENCIA                   ;METROPOLITANA;0;0;0;0;0;0;0;0;0;CELULAR A32 128 GB LIGHT VIOLET OPEN;TELEFONIA
18234549;;M;29;CHILENO;;Millenial;PROVIDENCIA                   ;METROPOLITANA;0;0;0;0;0;0;0;0;0;Celular Galaxy S21 Phantom White 128GB;TELEFONIA
17777349;Soltero;F;31;CHILENO;;Millenial;RENCA                         ;METROPOLITANA;0;0;0;0;0;0;0;0;0;Celular A51 128GB LIB OPEN BLACK;TELEFONIA
15528426;;M;39;CHILENO;;Silencioso;PROVIDENCIA                   ;METROPOLITANA;0;0;0;0;0;0;0;0;0;CELULAR A21s 128 GB AZUL;TELEFONIA
12191169;;M;51;CHILENO;;X;N/D;N/D;0;0;0;0;0;0;0;0;0;CELULAR MOTO G9 POWER 128GB MORADO SONICO OPEN;TELEFONIA
16334446;Casado;M;35;CHILENO;;Millenial;RENCA                         ;METROPOLITANA;0;0;0;0;0;0;0;0;0;CELULAR A21s 128 GB Negro;TELEFONIA
10086568;;M;57;CHILENO;;Boomers;RENCA                         ;METROPOLITANA;0;0;0;0;0;0;0;0;0;CELULAR MOTO E6S 32GB ROSA OPEN;TELEFONIA
18708084;Soltero;F;31;CHILENO;;Millenial;LONGAVI                       ;MAULE;0;0;0;0;0;0;0;0;0;Celular A11 LIB OPEN BLACK;TELEFONIA
13569048;;F;43;CHILENO;;X;LAS CABRAS                    ;L.G.B.OÂ´HIGGINS;0;0;0;0;0;0;0;0;0;Celular A51 128GB LIB OPEN AZUL;TELEFONIA
18026858;;M;30;CHILENO;;Silencioso;PROVIDENCIA                   ;METROPOLITANA;0;0;0;0;0;0;0;0;0;Celular NOKIA 1.3 NEGRO WOM;TELEFONIA
13341241;;F;45;CHILENO;;X;MELIPILLA                     ;METROPOLITANA;0;0;0;0;0;0;0;0;0;CELULAR A21s 128 GB Rojo;TELEFONIA
17719086;Soltero;F;30;CHILENO;;Millenial;PROVIDENCIA                   ;METROPOLITANA;0;0;0;0;0;0;0;0;0;CELULAR MOTOROLA G9 PLAY 64GB ELECTRIC BLUE OPEN;TELEFONIA
8685900;Casado;M;51;CHILENO;INGENIERO CIVIL INFORMATICO;X;PROVIDENCIA                   ;METROPOLITANA;0;0;0;0;0;0;0;0;0;IPHONE 11 64GB BLACK CLARO;TELEFONIA
17965900;;M;30;CHILENO;;Millenial;PROVIDENCIA                   ;METROPOLITANA;0;0;0;0;0;0;0;0;0;CELULAR A02s NEGRO 32GB OPEN;TELEFONIA
10853632;Casado;M;53;CHILENO;AUXILIAR DE ENFERMERIA;X;RENCA                         ;METROPOLITANA;0;0;0;0;0;0;0;0;0;CELULAR MOTO G9 POWER 128GB MORADO SONICO OPEN;TELEFONIA
7404929;;F;63;CHILENO;;Boomers;CHILLAN                       ;BIO BIO;0;0;0;0;0;0;0;0;0;CELULAR XIAOMI POCO X3 64G SHADOW GRAY;TELEFONIA
13074000;Casado;F;46;CHILENO;TECNICO EN ADMINISTRACION DE EMPRESAS;X;PROVIDENCIA                   ;METROPOLITANA;0;0;0;0;0;0;0;0;0;CELULAR MOTOROLA G9 PLAY 64GB ELECTRIC BLUE OPEN;TELEFONIA
8427067;Casado;F;64;CHILENO;;Boomers;TALCA                         ;MAULE;0;0;0;0;0;0;0;0;0;CELULAR A02s AZUL 32GB OPEN;TELEFONIA
17711965;;M;31;CHILENO;;Millenial;OVALLE                        ;COQUIMBO;0;0;0;0;0;0;0;0;0;Celular A51 128GB LIB OPEN BLACK;TELEFONIA
18516934;;M;28;CHILENO;;Extranjero;"";"";0;0;0;0;0;0;0;0;0;Celular A51 128GB LIB OPEN AZUL;TELEFONIA
7839975;;M;62;CHILENO;;Boomers;LA HIGUERA                    ;COQUIMBO;0;0;0;0;0;0;0;0;0;CELULAR A12 128GB NEGRO TRIANGULADO CLARO;TELEFONIA
13994175;;M;40;CHILENO;;X;PROVIDENCIA                   ;METROPOLITANA;0;0;0;0;0;0;0;0;0;Celular A11 LIB OPEN BLACK;TELEFONIA
17642628;;M;32;CHILENO;;Millenial;LOS VILOS                     ;COQUIMBO;0;0;0;0;0;0;0;0;0;Celular A71 LIB OPEN PLATEADO;TELEFONIA
17171747;Soltero;F;33;CHILENO;;Millenial;PROVIDENCIA                   ;METROPOLITANA;0;0;0;0;0;0;0;0;0;Celular P40 LITE LIB OPEN GREEN;TELEFONIA
19842549;;F;24;CHILENO;;Silencioso;PROVIDENCIA                   ;METROPOLITANA;0;0;0;0;0;0;0;0;0;Celular A11 LIB OPEN BLUE;TELEFONIA
17723772;;F;31;CHILENO;;Millenial;CALAMA                        ;ANTOFAGASTA;0;0;0;0;0;0;0;0;0;Celular VIVO Y11S ENTEL DIRECTO AZUL;TELEFONIA
9303910;;M;60;CHILENO;;Silencioso;PROVIDENCIA                   ;METROPOLITANA;0;0;0;0;0;0;0;0;0;CELULAR A12 128GB AZUL OPEN;TELEFONIA
17645576;Soltero;M;32;CHILENO;;Millenial;PROVIDENCIA                   ;METROPOLITANA;0;0;0;0;0;0;0;0;0;Celular XIAOMI REDMI 9 64 GB DIRECTO CLARO NEGRO;TELEFONIA
19297840;Soltero;F;25;CHILENO;;Z;PROVIDENCIA                   ;METROPOLITANA;0;0;0;0;0;0;0;0;0;CELULAR A21s 128 GB Negro;TELEFONIA
26569009;;M;43;VENEZOLANO;;Extranjero;N/D;N/D;0;0;0;0;0;0;0;0;0;CELULAR A02s AZUL 32GB OPEN;TELEFONIA
17312160;Soltero;M;32;CHILENO;LICENCIADO EN CIENCIAS;Silencioso;PROVIDENCIA                   ;METROPOLITANA;0;0;0;0;0;0;0;0;0;CELULAR REDMI NOTE 9 PRO 128GB GLACIER WHITE;TELEFONIA
9085748;;M;58;CHILENO;;Boomers;RENCA                         ;METROPOLITANA;0;0;0;0;0;0;0;0;0;Celular LG K22 MOVISTAR DIRECTO TITAN;TELEFONIA
8747736;;M;60;CHILENO;;Boomers;PROVIDENCIA                   ;METROPOLITANA;0;0;0;0;0;0;0;0;0;CELULAR A21s 128 GB AZUL;TELEFONIA
15178195;;M;39;CHILENO;;X;"";"";0;0;0;0;0;0;0;0;0;Celular R340 CLARO DIRECTO NEGRO;TELEFONIA
5650760;Casado;M;70;CHILENO;;Silencioso;RENCA                         ;METROPOLITANA;0;0;0;0;0;0;0;0;0;CELULAR A72 128 GB BLACK OPEN;TELEFONIA
13716841;;F;42;CHILENO;;X;SAN JOAQUIN                   ;METROPOLITANA;0;0;0;0;0;0;0;0;0;Celular A11 LIB OPEN WHITE;TELEFONIA
16157549;;M;36;CHILENO;;Millenial;PROVIDENCIA                   ;METROPOLITANA;0;0;0;0;0;0;0;0;0;CELULAR A32 128 GB BLACK OPEN;TELEFONIA
17332511;;M;32;CHILENO;;Millenial;TALCA                         ;MAULE;0;0;0;0;0;0;0;0;0;CELULAR REDMI NOTE 10 128GB ONIX GRAY OPEN;TELEFONIA
12814017;Soltero;M;47;CHILENO;;Silencioso;PROVIDENCIA                   ;METROPOLITANA;0;0;0;0;0;0;0;0;0;CELULAR REDMI 9 32GB CARBON GREY OPEN;TELEFONIA
9099502;;F;60;CHILENO;;Boomers;PROVIDENCIA                   ;METROPOLITANA;0;0;0;0;0;0;0;0;0;CELULAR A02 NEGRO 32GB OPEN;TELEFONIA
12815452;;M;47;CHILENO;;X;PROVIDENCIA                   ;METROPOLITANA;0;0;0;0;0;0;0;0;0;Celular A11 LIB OPEN BLACK;TELEFONIA
18028591;;F;29;CHILENO;;Millenial;"";"";0;0;0;0;0;0;0;0;0;CELULAR MOTO G9 POWER 128GB MORADO SONICO OPEN;TELEFONIA
19417157;;F;25;CHILENO;;Z;PROVIDENCIA                   ;METROPOLITANA;0;0;0;0;0;0;0;0;0;Celular A11 LIB OPEN WHITE;TELEFONIA
19600951;;M;25;CHILENO;;Millenial;"";"";0;0;0;0;0;0;0;0;0;CELULAR A02s ROJO 32GB OPEN;TELEFONIA
14298503;Casado;M;47;CHILENO;INGENIERIA EN ADMINISTRACION DE EMPRESAS MENCION FINANZAS;X;PROVIDENCIA                   ;METROPOLITANA;0;0;0;0;0;0;0;0;0;CELULAR A21s 128 GB Negro;TELEFONIA
20590992;;M;21;CHILENO;;Z;PROVIDENCIA                   ;METROPOLITANA;0;0;0;0;0;0;0;0;0;CELULAR A21s 128 GB Negro;TELEFONIA
20142833;;M;22;CHILENO;;Z;PROVIDENCIA                   ;METROPOLITANA;0;0;0;0;0;0;0;0;0;CELULAR A21s 128 GB Negro;TELEFONIA
20118488;;M;23;CHILENO;;Z;PROVIDENCIA                   ;METROPOLITANA;0;0;0;0;0;0;0;0;0;CELULAR MOTOROLA G9 PLAY 64GB BLUE DIRECTO CLAR;TELEFONIA
11989121;;F;50;CHILENO;;X;VICTORIA                      ;ARAUCANIA;0;0;0;0;0;0;0;0;0;CELULAR A02s ROJO 32GB OPEN;TELEFONIA
9877972;;M;53;CHILENO;;X;PROVIDENCIA                   ;METROPOLITANA;0;0;0;0;0;0;0;0;0;CELULAR MOTO G9 POWER 128GB VERDE GRANITO OPEN;TELEFONIA
15805627;;F;38;CHILENO;;Millenial;RANCAGUA                      ;L.G.B.OÂ´HIGGINS;0;0;0;0;0;0;0;0;0;CELULAR A02s AZUL 32GB OPEN;TELEFONIA
13853891;;F;42;CHILENO;;X;CURANILAHUE                   ;BIO BIO;0;0;0;0;0;0;0;0;0;CELULAR A02s ROJO 32GB OPEN;TELEFONIA
17906336;Soltero;M;31;CHILENO;TECNICO MECANICO;Millenial;PROVIDENCIA                   ;METROPOLITANA;0;0;0;0;0;0;0;0;0;Celular A11 LIB OPEN BLUE;TELEFONIA
8728923;;M;65;CHILENO;;Boomers;TRAIGUEN                      ;ARAUCANIA;0;0;0;0;0;0;0;0;0;CELULAR A12 128GB NEGRO OPEN;TELEFONIA
19641554;;F;24;CHILENO;;Z;PROVIDENCIA                   ;METROPOLITANA;0;0;0;0;0;0;0;0;0;CELULAR A32 128 GB LIGHT VIOLET OPEN;TELEFONIA
17609950;Soltero;F;31;CHILENO;;Millenial;PROVIDENCIA                   ;METROPOLITANA;0;0;0;0;0;0;0;0;0;Celular A51 128GB LIB OPEN BLANCO;TELEFONIA
17886939;Soltero;F;31;CHILENO;PROFESORA DE EDUCACION MEDIA EN MATEMATICAS Y FISICA;Millenial;PROVIDENCIA                   ;METROPOLITANA;0;0;0;0;0;0;0;0;0;CELULAR A32 128 GB BLACK OPEN;TELEFONIA
22428527;;F;57;PERUANO;;Extranjero;LA CISTERNA                   ;METROPOLITANA;0;0;0;0;0;0;0;0;0;CELULAR MOTOROLA G9 PLAY ROSADO DIRECTO WOM;TELEFONIA
15287666;;F;40;CHILENO;;X;PROVIDENCIA                   ;METROPOLITANA;0;0;0;0;0;0;0;0;0;TELEFONO PP BINDU ENTEL;TELEFONIA
8674427;;M;62;CHILENO;;Boomers;PROVIDENCIA                   ;METROPOLITANA;0;0;0;0;0;0;0;0;0;CELULAR OWN 1026 AZUL ENTEL;TELEFONIA
16342458;;M;35;CHILENO;;Millenial;PROVIDENCIA                   ;METROPOLITANA;0;0;0;0;0;0;0;0;0;CELULAR A02 ROJO 32GB OPEN;TELEFONIA
15533874;;F;39;CHILENO;;Millenial;N/D;N/D;0;0;0;0;0;0;0;0;0;Celular VIVO Y11S ENTEL DIRECTO AZUL;TELEFONIA
19332675;;F;26;CHILENO;;Z;N/D;N/D;0;0;0;0;0;0;0;0;0;IPHONE 11 64GB BLACK CLARO;TELEFONIA
19474190;;F;25;CHILENO;;Z;PROVIDENCIA                   ;METROPOLITANA;0;0;0;0;0;0;0;0;0;CELULAR POCO M3 64GB COOL BLUE;TELEFONIA
15934743;Casado;F;38;CHILENO;FONOAUDIOLOGO;Silencioso;PROVIDENCIA                   ;METROPOLITANA;0;0;0;0;0;0;0;0;0;Celular A51 128GB LIB OPEN AZUL;TELEFONIA
13182229;;M;45;CHILENO;;X;LOS VILOS                     ;COQUIMBO;0;0;0;0;0;0;0;0;0;Celular G8 POWER LITE MOVISTAR DIRECTO AZUL;TELEFONIA
16135347;;F;36;CHILENO;;Millenial;ANTOFAGASTA;ANTOFAGASTA;0;0;0;0;0;0;0;0;0;CELULAR LG K22 TRIANGULADO WOM;TELEFONIA
15618918;;M;38;CHILENO;;X;PROVIDENCIA                   ;METROPOLITANA;0;0;0;0;0;0;0;0;0;Celular XIAOMI REDMI 9C 64 GB DIRECTO CLARO;TELEFONIA
16494459;;M;35;CHILENO;;Millenial;RENGO                         ;L.G.B.OÂ´HIGGINS;0;0;0;0;0;0;0;0;0;CELULAR MOTO E6I ROSA OPEN;TELEFONIA
17257233;;F;32;CHILENO;;Millenial;PROVIDENCIA                   ;METROPOLITANA;0;0;0;0;0;0;0;0;0;CELULAR REDMI NOTE 10 128GB ONIX GRAY OPEN;TELEFONIA
9239932;;M;60;CHILENO;;Boomers;RENCA                         ;METROPOLITANA;0;0;0;0;0;0;0;0;0;CELULAR A02 AZUL 32GB OPEN;TELEFONIA
8105588;;F;67;CHILENO;;Boomers;PADRE LAS CASAS               ;ARAUCANIA;0;0;0;0;0;0;0;0;0;Celular Y8P ENTEL TRIANGULADO NEGRO;TELEFONIA
15294563;;F;39;CHILENO;;X;PICHIDEGUA                    ;L.G.B.OÂ´HIGGINS;0;0;0;0;0;0;0;0;0;CELULAR A32 128 GB WHITE OPEN;TELEFONIA
18679553;Soltero;M;28;CHILENO;;Millenial;PROVIDENCIA                   ;METROPOLITANA;0;0;0;0;0;0;0;0;0;Celular Galaxy S21 Phantom Grey 128GB;TELEFONIA
12658129;;F;48;CHILENO;;X;CONCEPCION                    ;BIO BIO;0;0;0;0;0;0;0;0;0;CELULAR VIVO Y51 TITANIUM SAPPHIRE OPEN;TELEFONIA
8273190;;M;63;CHILENO;;Boomers;TALAGANTE                     ;METROPOLITANA;0;0;0;0;0;0;0;0;0;CELULAR A02s NEGRO 32GB OPEN;TELEFONIA
18660637;Soltero;M;27;CHILENO;;Millenial;PROVIDENCIA                   ;METROPOLITANA;0;0;0;0;0;0;0;0;0;Celular A51 128GB LIB OPEN BLACK;TELEFONIA
18398904;;F;29;CHILENO;;Millenial;COPIAPO                       ;ATACAMA;0;0;0;0;0;0;0;0;0;CELULAR A21s 128 GB Rojo;TELEFONIA
20183276;;F;23;CHILENO;;Z;VINA DEL MAR                  ;VALPARAISO;0;0;0;0;0;0;0;0;0;CELULAR A02 NEGRO 32GB OPEN;TELEFONIA
18702937;;F;28;CHILENO;;Millenial;PROVIDENCIA                   ;METROPOLITANA;0;0;0;0;0;0;0;0;0;Celular A11 LIB OPEN WHITE;TELEFONIA
18381837;Soltero;M;29;CHILENO;;Silencioso;PROVIDENCIA                   ;METROPOLITANA;0;0;0;0;0;0;0;0;0;CELULAR A02 NEGRO 32GB OPEN;TELEFONIA
6377552;;M;66;CHILENO;;Boomers;PROVIDENCIA                   ;METROPOLITANA;0;0;0;0;0;0;0;0;0;CELULAR A21s 128 GB Negro;TELEFONIA
17777957;;M;31;CHILENO;;Millenial;PROVIDENCIA                   ;METROPOLITANA;0;0;0;0;0;0;0;0;0;CELULAR REDMI NOTE 10 128GB PEBBLE WHITE;TELEFONIA
20093830;;F;23;CHILENO;;Silencioso;PROVIDENCIA                   ;METROPOLITANA;0;0;0;0;0;0;0;0;0;CELULAR A02s NEGRO 32GB OPEN;TELEFONIA
17883074;;F;30;CHILENO;;Millenial;CURICO;MAULE;0;0;0;0;0;0;0;0;0;CELULAR MOTOROLA E6S GRIS 32GB DIRECTO WOM;TELEFONIA
12440057;;M;48;CHILENO;;X;PROVIDENCIA                   ;METROPOLITANA;0;0;0;0;0;0;0;0;0;CELULAR A02 AZUL 32GB OPEN;TELEFONIA
13136577;;F;44;CHILENO;;X;RENCA                         ;METROPOLITANA;0;0;0;0;0;0;0;0;0;Celular A11 LIB OPEN BLUE;TELEFONIA
15987530;;F;37;CHILENO;;Millenial;PROVIDENCIA                   ;METROPOLITANA;0;0;0;0;0;0;0;0;0;CELULAR LG K22 TRIANGULADO WOM;TELEFONIA
14523854;Casado;F;45;CHILENO;;X;PROVIDENCIA                   ;METROPOLITANA;0;0;0;0;0;0;0;0;0;CELULAR REDMI 9 32GB CARBON GREY OPEN;TELEFONIA
18660756;;F;27;CHILENO;;Millenial;PROVIDENCIA                   ;METROPOLITANA;0;0;0;0;0;0;0;0;0;Celular A31 LIB OPEN ROJO;TELEFONIA
18350350;;F;28;CHILENO;;Millenial;CURICO                        ;MAULE;0;0;0;0;0;0;0;0;0;Celular A01 CORE MOVISTAR DIRECTO BLACK;TELEFONIA
17170824;;F;33;CHILENO;;Millenial;RENCA                         ;METROPOLITANA;0;0;0;0;0;0;0;0;0;CELULAR SAMSUNG A01 NEGRO DIRECTO WOM;TELEFONIA
12537172;;M;49;CHILENO;;X;PROVIDENCIA                   ;METROPOLITANA;0;0;0;0;0;0;0;0;0;CELULAR Samsung Galaxy A02s 32GB Azul WOM;TELEFONIA
15942538;;F;37;CHILENO;;Millenial;LINARES                       ;MAULE;0;0;0;0;0;0;0;0;0;CELULAR XIAOMI REDMI 9 64GB DIRECTO CLARO MORADO;TELEFONIA
23479475;;M;67;BOLIVIANO;;Extranjero;CALAMA                        ;ANTOFAGASTA;0;0;0;0;0;0;0;0;0;CELULAR SAMSUNG A02S 32GB NEGRO DIRECTO ENTEL;TELEFONIA
18612975;;F;28;CHILENO;;Millenial;"";"";0;0;0;0;0;0;0;0;0;CELULAR REDMI 9 32GB CARBON GREY OPEN;TELEFONIA
17909513;;M;30;CHILENO;;Millenial;LLAILLAY                      ;VALPARAISO;0;0;0;0;0;0;0;0;0;CELULAR MI 10T PRO 256GB AURORA BLUE OPEN;TELEFONIA
13151538;;F;45;CHILENO;;X;RENCA                         ;METROPOLITANA;0;0;0;0;0;0;0;0;0;Celular SAMSUNG A01 CORE BLACK CLARO;TELEFONIA
5581971;;F;77;CHILENO;;Silencioso;CURANILAHUE                   ;BIO BIO;0;0;0;0;0;0;0;0;0;CELULAR A21s 128 GB Rojo;TELEFONIA
18602777;Soltero;F;29;CHILENO;ABOGADO;Millenial;PROVIDENCIA                   ;METROPOLITANA;0;0;0;0;0;0;0;0;0;Celular A51 128GB LIB OPEN BLANCO;TELEFONIA
11521579;Soltero;M;52;CHILENO;;X;RENCA                         ;METROPOLITANA;0;0;0;0;0;0;0;0;0;CELULAR NOKIA 110 BLACK OPEN;TELEFONIA
13571443;;M;43;CHILENO;;X;NUNOA                         ;METROPOLITANA;0;0;0;0;0;0;0;0;0;CELULAR XIAOMI POCO M3 128GB YELLOW OPEN;TELEFONIA
20167600;;M;23;CHILENO;;Silencioso;PROVIDENCIA                   ;METROPOLITANA;0;0;0;0;0;0;0;0;0;IPHONE 5S 16GB NEGRO OPEN;TELEFONIA
15044485;Soltero;F;41;CHILENO;;X;PROVIDENCIA                   ;METROPOLITANA;0;0;0;0;0;0;0;0;0;Celular A11 LIB OPEN BLUE;TELEFONIA
12894942;;M;46;CHILENO;;X;RENCA                         ;METROPOLITANA;0;0;0;0;0;0;0;0;0;Celular A01 LIB OPEN NEGRO;TELEFONIA
14363803;;F;43;CHILENO;;X;CERRO NAVIA                   ;METROPOLITANA;0;0;0;0;0;0;0;0;0;CELULAR REDMI NOTE 9 PRO 128GB INTERSTELLAR GREY;TELEFONIA
17715956;Soltero;F;31;CHILENO;;Millenial;PROVIDENCIA                   ;METROPOLITANA;0;0;0;0;0;0;0;0;0;CELULAR MOTO G9 POWER 128GB VERDE GRANITO OPEN;TELEFONIA
16474070;Soltero;M;35;CHILENO;PROFESOR;Silencioso;PROVIDENCIA                   ;METROPOLITANA;0;0;0;0;0;0;0;0;0;CELULAR REDMI 9 32GB CARBON GREY OPEN;TELEFONIA
14270494;;F;53;CHILENO;;X;RENCA                         ;METROPOLITANA;0;0;0;0;0;0;0;0;0;CELULAR A12 128GB NEGRO OPEN;TELEFONIA
18055709;;F;29;CHILENO;;Millenial;N/D;N/D;0;0;0;0;0;0;0;0;0;CELULAR REDMI NOTE 10 PRO 8+128GB GRADIENT BRONZ;TELEFONIA
6548037;;F;73;CHILENO;;Silencioso;OVALLE                        ;COQUIMBO;0;0;0;0;0;0;0;0;0;Celular Galaxy S21 Phantom Violet 128GB;TELEFONIA
26116296;;M;43;VENEZOLANO;;Extranjero;CASTRO                        ;LOS LAGOS;0;0;0;0;0;0;0;0;0;CELULAR A21s 128 GB Rojo;TELEFONIA
14080625;;M;42;CHILENO;;X;PROVIDENCIA                   ;METROPOLITANA;0;0;0;0;0;0;0;0;0;CELULAR MOTO E6S 32GB GRIS DIRECTO ENTEL;TELEFONIA
18390599;Soltero;M;32;CHILENO;CONTADOR GENERAL;Millenial;PROVIDENCIA                   ;METROPOLITANA;0;0;0;0;0;0;0;0;0;CELULAR MOTOROLA G8 POWER LITE AZUL WOM;TELEFONIA
13033466;;M;45;CHILENO;;X;PROVIDENCIA                   ;METROPOLITANA;0;0;0;0;0;0;0;0;0;IPHONE 8 64 GB LIB OPEN GRAY;TELEFONIA
15158480;;M;39;CHILENO;;X;RENCA                         ;METROPOLITANA;0;0;0;0;0;0;0;0;0;CELULAR REDMI NOTE 9 PRO 128GB GLACIER WHITE;TELEFONIA
9530055;;F;60;CHILENO;;Boomers;RENCA                         ;METROPOLITANA;0;0;0;0;0;0;0;0;0;Celular A10S MOVISTAR DIRECTO BLACK;TELEFONIA
15749396;Soltero;M;38;CHILENO;;Millenial;PROVIDENCIA                   ;METROPOLITANA;0;0;0;0;0;0;0;0;0;CELULAR LG K61 Gris OPEN;TELEFONIA
15035253;Soltero;M;38;CHILENO;;Silencioso;PROVIDENCIA                   ;METROPOLITANA;0;0;0;0;0;0;0;0;0;IPHONE 8 64 GB LIB OPEN GRAY;TELEFONIA
8893023;;M;62;CHILENO;;Boomers;RENCA                         ;METROPOLITANA;0;0;0;0;0;0;0;0;0;CELULAR REDMI 9 32GB CARBON GREY OPEN;TELEFONIA
18779012;Soltero;F;28;CHILENO;TECNICO EN ENFERMERIA DE NIVEL SUPERIOR;Millenial;PROVIDENCIA                   ;METROPOLITANA;0;0;0;0;0;0;0;0;0;Celular A51 128GB LIB OPEN BLANCO;TELEFONIA
19333330;;F;26;CHILENO;;Z;N/D;N/D;0;0;0;0;0;0;0;0;0;Celular a11 azul samsung WOM;TELEFONIA
25435209;;M;42;PERUANO;;Extranjero;PIRQUE                        ;METROPOLITANA;0;0;0;0;0;0;0;0;0;CELULAR MOTO G9 POWER 128GB MORADO SONICO OPEN;TELEFONIA
19727318;;F;25;CHILENO;;Millenial;PROVIDENCIA                   ;METROPOLITANA;0;0;0;0;0;0;0;0;0;Celular A31 LIB OPEN AZUL;TELEFONIA
20122162;;M;23;CHILENO;;Z;PROVIDENCIA                   ;METROPOLITANA;0;0;0;0;0;0;0;0;0;CELULAR REDMI NOTE 9 PRO 128GB GLACIER WHITE;TELEFONIA
19150150;Soltero;F;26;CHILENO;;Z;PROVIDENCIA                   ;METROPOLITANA;0;0;0;0;0;0;0;0;0;Celular A31 LIB OPEN ROJO;TELEFONIA
13826332;;M;42;CHILENO;;X;MAFIL                         ;LOS LAGOS;0;0;0;0;0;0;0;0;0;CELULAR Y8S MOVISTAR DIRECTO BLACK;TELEFONIA
10848438;Soltero;M;47;CHILENO;;Silencioso;PROVIDENCIA                   ;METROPOLITANA;0;0;0;0;0;0;0;0;0;CELULAR A02s AZUL 32GB OPEN;TELEFONIA
25576499;;M;31;PERUANO;;Extranjero;"";"";0;0;0;0;0;0;0;0;0;CELULAR A21s 128 GB AZUL;TELEFONIA
7778749;;F;68;CHILENO;;Boomers;RENCA                         ;METROPOLITANA;0;0;0;0;0;0;0;0;0;Celular A31 LIB OPEN AZUL;TELEFONIA
19115944;;F;27;CHILENO;;Millenial;"";"";0;0;0;0;0;0;0;0;0;CELULAR MOTOROLA E6S ROSADO DIRECTO WOM;TELEFONIA
17954613;Soltero;M;31;CHILENO;;Millenial;PROVIDENCIA                   ;METROPOLITANA;0;0;0;0;0;0;0;0;0;Celular A51 128GB LIB OPEN BLANCO;TELEFONIA
10280704;Casado;M;53;CHILENO;;X;RENCA                         ;METROPOLITANA;0;0;0;0;0;0;0;0;0;CELULAR XIAOMI POCO M3 128GB YELLOW OPEN;TELEFONIA
18591157;;F;28;CHILENO;;Millenial;LOS LAGOS                     ;LOS LAGOS;0;0;0;0;0;0;0;0;0;Celular SAMSUNG A01 CORE BLACK CLARO;TELEFONIA
27000211;;M;37;EXTRANJERO - NO INFORMA NACIONALIDAD;;Extranjero;ESTACION CENTRAL              ;METROPOLITANA;0;0;0;0;0;0;0;0;0;CELULAR XIAOMI POCO X3 64G COBALT BLUE;TELEFONIA
13861903;Soltero;F;44;CHILENO;INGENIERO COMERCIAL;X;PROVIDENCIA                   ;METROPOLITANA;0;0;0;0;0;0;0;0;0;CELULAR A12 128GB ROJO OPEN;TELEFONIA
18542355;;M;28;CHILENO;;Millenial;PROVIDENCIA                   ;METROPOLITANA;0;0;0;0;0;0;0;0;0;CELULAR MOTO G9 POWER 128GB MORADO SONICO OPEN;TELEFONIA
16779284;Soltero;F;34;CHILENO;;Millenial;PROVIDENCIA                   ;METROPOLITANA;0;0;0;0;0;0;0;0;0;CELULAR MOTO E6S 32GB GRIS DIRECTO ENTEL;TELEFONIA
15443010;Soltero;F;39;CHILENO;TECNICO SUPERIOR DE LABORATORIO CLINICO Y BANCO DE SANGRE;X;PROVIDENCIA                   ;METROPOLITANA;0;0;0;0;0;0;0;0;0;CELULAR MOTOROLA G9 PLAY 64GB SPRING PINK OPEN;TELEFONIA
9921226;;M;55;CHILENO;;Boomers;RENCA                         ;METROPOLITANA;0;0;0;0;0;0;0;0;0;CELULAR XIAOMI REDMI 9A 32GB SKY BLUE TRI WOM;TELEFONIA
10000949;Casado;F;66;CHILENO;;Boomers;PROVIDENCIA                   ;METROPOLITANA;0;0;0;0;0;0;0;0;0;CELULAR OWN 1026 AZUL ENTEL;TELEFONIA
18519192;Soltero;F;29;CHILENO;;Millenial;RENCA                         ;METROPOLITANA;0;0;0;0;0;0;0;0;0;CELULAR A21s 128 GB AZUL;TELEFONIA
12740162;;M;46;CHILENO;;X;RENCA                         ;METROPOLITANA;0;0;0;0;0;0;0;0;0;CELULAR A21s 128 GB Negro;TELEFONIA
16127492;;M;36;CHILENO;;Millenial;PROVIDENCIA                   ;METROPOLITANA;0;0;0;0;0;0;0;0;0;Celular Galaxy S21 Ultra Phantom Silver 128GB;TELEFONIA
15512815;Soltero;F;38;CHILENO;;X;PROVIDENCIA                   ;METROPOLITANA;0;0;0;0;0;0;0;0;0;Celular A10S LIB OPEN RED;TELEFONIA
7836702;;M;64;CHILENO;;Boomers;VALPARAISO                    ;VALPARAISO;0;0;0;0;0;0;0;0;0;Celular A51 128GB LIB OPEN AZUL;TELEFONIA
12191879;;F;49;CHILENO;;X;RENCA                         ;METROPOLITANA;0;0;0;0;0;0;0;0;0;CELULAR A21s 128 GB Rojo;TELEFONIA
19331013;Soltero;M;25;CHILENO;;Z;TRAIGUEN                      ;ARAUCANIA;0;0;0;0;0;0;0;0;0;CELULAR A02s ROJO 32GB OPEN;TELEFONIA
8696147;;M;62;CHILENO;;Boomers;SAN VICENTE                   ;L.G.B.OÂ´HIGGINS;0;0;0;0;0;0;0;0;0;CELULAR MOTOROLA MOTO E6S PINK MOVISTAR DIRECTO;TELEFONIA
18819450;;F;27;CHILENO;;Z;VALDIVIA                      ;LOS RIOS;0;0;0;0;0;0;0;0;0;CELULAR HUAWEI P30 LITE BLACK CLARO;TELEFONIA
10750647;;M;52;CHILENO;;X;SAN FELIPE                    ;VALPARAISO;0;0;0;0;0;0;0;0;0;CELULAR A12 128GB NEGRO OPEN;TELEFONIA
14008183;Soltero;F;40;CHILENO;;X;PROVIDENCIA                   ;METROPOLITANA;0;0;0;0;0;0;0;0;0;Celular VIVO Y11S ENTEL DIRECTO AZUL;TELEFONIA
9987663;;M;57;CHILENO;;Boomers;PROVIDENCIA                   ;METROPOLITANA;0;0;0;0;0;0;0;0;0;CELULAR Xiaomi Redmi 9 64 GB Morado WOM;TELEFONIA
8667413;;M;47;CHILENO;;X;VILLARICA                     ;ARAUCANIA;0;0;0;0;0;0;0;0;0;CELULAR A21s 128 GB Negro;TELEFONIA
25919499;;F;53;CHILENO;;Extranjero;N/D;N/D;0;0;0;0;0;0;0;0;0;CELULAR POCO M3 64GB POWER BLACK;TELEFONIA
17217291;Soltero;F;32;CHILENO;PROFESOR;Millenial;RENCA                         ;METROPOLITANA;0;0;0;0;0;0;0;0;0;Celular NOKIA 1.3 NEGRO WOM;TELEFONIA
16448360;Soltero;F;34;CHILENO;PROFESOR;Millenial;RENCA                         ;METROPOLITANA;0;0;0;0;0;0;0;0;0;CHIP POST-PAGO WOM;TELEFONIA
16056281;;F;37;CHILENO;;Millenial;PROVIDENCIA                   ;METROPOLITANA;0;0;0;0;0;0;0;0;0;CELULAR MOTOROLA E6S GRIS 32GB DIRECTO WOM;TELEFONIA
9511083;;F;57;CHILENO;;Boomers;VINA DEL MAR                  ;VALPARAISO;0;0;0;0;0;0;0;0;0;CELULAR MOTO ONE FUSION 64GB VERDE 64GB OPEN;TELEFONIA
12312069;;F;49;CHILENO;;X;PROVIDENCIA                   ;METROPOLITANA;0;0;0;0;0;0;0;0;0;CELULAR NOKIA 110 BLACK OPEN;TELEFONIA
9478454;;F;59;CHILENO;;Boomers;EL BOSQUE                     ;METROPOLITANA;0;0;0;0;0;0;0;0;0;CELULAR A12 128GB AZUL OPEN;TELEFONIA
15854684;Soltero;M;37;CHILENO;TECNICO EN ADMINISTRACION DE EMPRESAS;X;PROVIDENCIA                   ;METROPOLITANA;0;0;0;0;0;0;0;0;0;CELULAR XIAOMI REDMI 9C 64GB TIWLIGHT BLUE TRI W;TELEFONIA
16665947;;M;35;CHILENO;;Millenial;PROVIDENCIA                   ;METROPOLITANA;0;0;0;0;0;0;0;0;0;CELULAR SAMSUNG A01 NEGRO DIRECTO WOM;TELEFONIA
12108473;;M;41;CHILENO;;Silencioso;PROVIDENCIA                   ;METROPOLITANA;0;0;0;0;0;0;0;0;0;CELULAR SAMSUNG NOTE 20 MYSTIC GRAY OPEN;TELEFONIA
4553739;;F;82;CHILENO;;Silencioso;OVALLE                        ;COQUIMBO;0;0;0;0;0;0;0;0;0;Celular S20 FE LIB OPEN Cloud Navy;TELEFONIA
18966278;;M;26;CHILENO;;Z;LOS SAUCES                    ;ARAUCANIA;0;0;0;0;0;0;0;0;0;Celular A51 128GB LIB OPEN AZUL;TELEFONIA
8974802;;M;62;CHILENO;;Boomers;CALLE LARGA                   ;VALPARAISO;0;0;0;0;0;0;0;0;0;CELULAR OWN 1026 AZUL ENTEL;TELEFONIA
15036149;Casado;M;36;CHILENO;PROFESOR;Millenial;PROVIDENCIA                   ;METROPOLITANA;0;0;0;0;0;0;0;0;0;Celular LG K22 MOVISTAR DIRECTO TITAN;TELEFONIA
17502967;;M;32;CHILENO;;Millenial;MACHALI                       ;L.G.B.OÂ´HIGGINS;0;0;0;0;0;0;0;0;0;Celular Galaxy S21 Phantom Grey 128GB;TELEFONIA
19503291;;M;25;CHILENO;;Z;PROVIDENCIA                   ;METROPOLITANA;0;0;0;0;0;0;0;0;0;CELULAR A02s ROJO 32GB OPEN;TELEFONIA
18407612;;F;28;CHILENO;;Extranjero;"";"";0;0;0;0;0;0;0;0;0;CELULAR XIAOMI POCO X3 64G SHADOW GRAY;TELEFONIA
12295622;;F;50;CHILENO;;X;TALCA                         ;MAULE;0;0;0;0;0;0;0;0;0;CELULAR XIAOMI POCO X3 64G COBALT BLUE;TELEFONIA
19976484;;M;24;CHILENO;;Silencioso;PROVIDENCIA                   ;METROPOLITANA;0;0;0;0;0;0;0;0;0;CELULAR MI 10T LITE 128G ATLANTIC BLUE OPEN;TELEFONIA
15675890;;F;37;CHILENO;;Millenial;CAUQUENES                     ;MAULE;0;0;0;0;0;0;0;0;0;CELULAR MOTO G8 POWER LITE AZUL TRI ENTEL;TELEFONIA
7194390;;M;70;CHILENO;;Silencioso;SAN RAMON                     ;METROPOLITANA;0;0;0;0;0;0;0;0;0;CELULAR REDMI NOTE 8 64GB NEPTUNE BLUE OPEN;TELEFONIA
18252203;;M;30;CHILENO;;Millenial;CURICO                        ;MAULE;0;0;0;0;0;0;0;0;0;CELULAR SAMSUNG A21S AZUL OPEN;TELEFONIA
11728405;;F;51;CHILENO;;X;N/D;N/D;0;0;0;0;0;0;0;0;0;CELULAR A02s ROJO 32GB OPEN;TELEFONIA
12914211;;M;46;CHILENO;;X;PROVIDENCIA                   ;METROPOLITANA;0;0;0;0;0;0;0;0;0;CELULAR A02s AZUL 32GB OPEN;TELEFONIA
18657656;;F;28;CHILENO;;Millenial;PROVIDENCIA                   ;METROPOLITANA;0;0;0;0;0;0;0;0;0;CELULAR A12 128GB NEGRO OPEN;TELEFONIA
8054411;Soltero;F;61;CHILENO;;Boomers;RENCA                         ;METROPOLITANA;0;0;0;0;0;0;0;0;0;CELULAR HUAWEI Y9 PRIME BLUE OPEN;TELEFONIA
17659644;;F;30;CHILENO;;Millenial;PROVIDENCIA                   ;METROPOLITANA;0;0;0;0;0;0;0;0;0;IPHONE 11 64GB BLACK CLARO;TELEFONIA
14225162;Soltero;M;41;CHILENO;;X;PROVIDENCIA                   ;METROPOLITANA;0;0;0;0;0;0;0;0;0;CELULAR REDMI 9 32GB CARBON GREY OPEN;TELEFONIA
7006980;;F;68;CHILENO;;Boomers;ISLA DE MAIPO                 ;METROPOLITANA;0;0;0;0;0;0;0;0;0;CELULAR SAMSUNG A01 NEGRO DIRECTO WOM;TELEFONIA
10896143;;M;56;CHILENO;;Boomers;PROVIDENCIA                   ;METROPOLITANA;0;0;0;0;0;0;0;0;0;Celular NOKIA 2.2 WOM TRIANGULADO NEGRO;TELEFONIA
8201994;Soltero;F;59;CHILENO;;Boomers;RENCA                         ;METROPOLITANA;0;0;0;0;0;0;0;0;0;CELULAR OWN 1026 AZUL ENTEL;TELEFONIA
12155038;;F;55;CHILENO;;Boomers;PROVIDENCIA                   ;METROPOLITANA;0;0;0;0;0;0;0;0;0;IPHONE 8 64 GB LIB OPEN GRAY;TELEFONIA
15812449;;M;38;CHILENO;;Millenial;RENCA                         ;METROPOLITANA;0;0;0;0;0;0;0;0;0;Celular A31 LIB OPEN AZUL;TELEFONIA
15796099;;M;39;CHILENO;;X;OSORNO                        ;LOS LAGOS;0;0;0;0;0;0;0;0;0;CELULAR A21s 128 GB AZUL;TELEFONIA
17491094;Soltero;M;31;CHILENO;;Millenial;PROVIDENCIA                   ;METROPOLITANA;0;0;0;0;0;0;0;0;0;Celular Galaxy S21 Phantom Grey 128GB;TELEFONIA
15882974;Soltero;F;36;CHILENO;;Silencioso;PROVIDENCIA                   ;METROPOLITANA;0;0;0;0;0;0;0;0;0;Celular P40 LITE LIB OPEN GREEN;TELEFONIA
14336261;;F;44;CHILENO;;X;COLTAUCO                      ;L.G.B.OÂ´HIGGINS;0;0;0;0;0;0;0;0;0;Celular A01 LIB OPEN NEGRO;TELEFONIA
14055101;;M;40;CHILENO;;X;PROVIDENCIA                   ;METROPOLITANA;0;0;0;0;0;0;0;0;0;Celular A31 LIB OPEN ROJO;TELEFONIA
18515745;;F;29;CHILENO;;Millenial;SAN FERNANDO                  ;L.G.B.OÂ´HIGGINS;0;0;0;0;0;0;0;0;0;Celular Y6P WOM TRIANGULADO NEGRO;TELEFONIA
25478285;;M;40;DOMINICANO;;Extranjero;RENCA                         ;METROPOLITANA;0;0;0;0;0;0;0;0;0;Celular SAMSUNG A01 CORE BLACK CLARO;TELEFONIA
5763895;Casado;M;74;CHILENO;AGRONOMO;Silencioso;PROVIDENCIA                   ;METROPOLITANA;0;0;0;0;0;0;0;0;0;CELULAR OWN 1026 AZUL ENTEL;TELEFONIA
17630234;Soltero;F;32;CHILENO;INGENIERIA EN ADMINISTRACION DE EMPRESAS MENCION FINANZAS;Millenial;PROVIDENCIA                   ;METROPOLITANA;0;0;0;0;0;0;0;0;0;Celular A51 128GB LIB OPEN BLANCO;TELEFONIA
12108012;Casado;F;44;CHILENO;;Silencioso;PROVIDENCIA                   ;METROPOLITANA;0;0;0;0;0;0;0;0;0;Celular A01 Core Azul Tri Entel;TELEFONIA
19348897;;M;25;CHILENO;;Z;PROVIDENCIA                   ;METROPOLITANA;0;0;0;0;0;0;0;0;0;Celular Galaxy S21 Ultra Phantom Black 128GB;TELEFONIA
15703834;;F;38;CHILENO;;X;PROVIDENCIA                   ;METROPOLITANA;0;0;0;0;0;0;0;0;0;CELULAR POCO M3 64GB COOL BLUE;TELEFONIA
18906565;;M;27;CHILENO;;Millenial;PROVIDENCIA                   ;METROPOLITANA;0;0;0;0;0;0;0;0;0;CELULAR REDMI 9 32GB CARBON GREY OPEN;TELEFONIA
17990755;Soltero;M;30;CHILENO;;Millenial;PROVIDENCIA                   ;METROPOLITANA;0;0;0;0;0;0;0;0;0;Celular A11 LIB OPEN BLACK;TELEFONIA
9211209;;F;61;CHILENO;;Boomers;PUENTE ALTO                   ;METROPOLITANA;0;0;0;0;0;0;0;0;0;CELULAR A21s 128 GB AZUL;TELEFONIA
6687260;;F;67;CHILENO;;Boomers;LAGO RANCO                    ;LOS LAGOS;0;0;0;0;0;0;0;0;0;CELULAR NOKIA 110 BLACK OPEN;TELEFONIA
9638471;Casado;F;59;CHILENO;;Boomers;RENCA                         ;METROPOLITANA;0;0;0;0;0;0;0;0;0;CELULAR LG K22 TRIANGULADO WOM;TELEFONIA
16802918;;F;34;CHILENO;;Millenial;HUECHURABA                    ;METROPOLITANA;0;0;0;0;0;0;0;0;0;Celular A01 Core Azul Tri Entel;TELEFONIA
7771373;;M;50;CHILENO;;Silencioso;PROVIDENCIA                   ;METROPOLITANA;0;0;0;0;0;0;0;0;0;Celular A71 LIB OPEN NEGRO;TELEFONIA
16672523;;M;34;CHILENO;;Millenial;RENCA                         ;METROPOLITANA;0;0;0;0;0;0;0;0;0;Celular XIAOMI REDMI 9C 64 GB DIRECTO CLARO;TELEFONIA
4539821;;M;82;CHILENO;;Silencioso;COPIAPO                       ;ATACAMA;0;0;0;0;0;0;0;0;0;CELULAR REDMI NOTE 9 PRO 128GB GLACIER WHITE;TELEFONIA
11536695;;M;51;CHILENO;;Silencioso;PROVIDENCIA                   ;METROPOLITANA;0;0;0;0;0;0;0;0;0;CELULAR REDMI 9 64GB SUNSET PURPLE TRI WOM;TELEFONIA
12138345;;F;57;CHILENO;;Boomers;NUEVA IMPERIAL                ;ARAUCANIA;0;0;0;0;0;0;0;0;0;Celular A10S LIB OPEN RED;TELEFONIA
8907996;;F;62;CHILENO;;Boomers;LOS ANDES                     ;VALPARAISO;0;0;0;0;0;0;0;0;0;Celular a11 azul samsung WOM;TELEFONIA
12774164;;F;47;CHILENO;;X;RENCA                         ;METROPOLITANA;0;0;0;0;0;0;0;0;0;CELULAR SAMSUNG A02S 32GB NEGRO DIRECTO ENTEL;TELEFONIA
15998485;;F;32;CHILENO;;Millenial;PROVIDENCIA                   ;METROPOLITANA;0;0;0;0;0;0;0;0;0;CELULAR MOTOROLA G8 POWER LITE AZUL WOM;TELEFONIA
19971290;;F;24;CHILENO;;Z;ANGOL                         ;ARAUCANIA;0;0;0;0;0;0;0;0;0;Celular A31 LIB OPEN AZUL;TELEFONIA
5554280;;M;75;CHILENO;;Silencioso;BUIN                          ;METROPOLITANA;0;0;0;0;0;0;0;0;0;CELULAR OWN 1026 AZUL ENTEL;TELEFONIA
17998275;;F;30;CHILENO;;Millenial;N/D;N/D;0;0;0;0;0;0;0;0;0;CELULAR XIAOMI REDMI 9A 32GB BLACK DIRECTO CLARO;TELEFONIA
19037570;Soltero;F;27;CHILENO;;Silencioso;PROVIDENCIA                   ;METROPOLITANA;0;0;0;0;0;0;0;0;0;Celular A3 LITE ENTEL TRIANGULADO NEGRO;TELEFONIA
5510049;;M;77;CHILENO;;Silencioso;BUIN                          ;METROPOLITANA;0;0;0;0;0;0;0;0;0;Celular A01 CLARO DIRECTO BLACK;TELEFONIA
16460697;;M;35;CHILENO;;Millenial;PUENTE ALTO                   ;METROPOLITANA;0;0;0;0;0;0;0;0;0;Celular Galaxy S21 Phantom Grey 128GB;TELEFONIA
17804378;;F;31;CHILENO;;Millenial;QUILPUE                       ;VALPARAISO;0;0;0;0;0;0;0;0;0;CELULAR MOTO ONE FUSION 64GB VERDE 64GB OPEN;TELEFONIA
16073625;;F;36;CHILENO;;Millenial;PROVIDENCIA                   ;METROPOLITANA;0;0;0;0;0;0;0;0;0;Celular A31 LIB OPEN BLACK;TELEFONIA
6310940;;F;71;CHILENO;;Silencioso;PAINE                         ;METROPOLITANA;0;0;0;0;0;0;0;0;0;Celular A51 128GB LIB OPEN BLANCO;TELEFONIA
17707836;;F;31;CHILENO;;Millenial;PROVIDENCIA                   ;METROPOLITANA;0;0;0;0;0;0;0;0;0;CELULAR NOKIA 110 BLACK OPEN;TELEFONIA
10283923;;M;56;CHILENO;;Boomers;PROVIDENCIA                   ;METROPOLITANA;0;0;0;0;0;0;0;0;0;CELULAR MOTO G8 POWER LITE AZUL TRI ENTEL;TELEFONIA
22857931;;F;26;CHILENO;;Z;PROVIDENCIA                   ;METROPOLITANA;0;0;0;0;0;0;0;0;0;CELULAR IPHONE SE 64GB DIRECTO CLARO;TELEFONIA
5482938;Casado;F;75;CHILENO;;Silencioso;PROVIDENCIA                   ;METROPOLITANA;0;0;0;0;0;0;0;0;0;Celular ZTE A3 2020 ENTEL DIRECTO GRIS;TELEFONIA
16059873;Soltero;M;36;CHILENO;;Millenial;PROVIDENCIA                   ;METROPOLITANA;0;0;0;0;0;0;0;0;0;Celular A01 LIB OPEN ROJO;TELEFONIA
15632761;;F;39;CHILENO;;X;PROVIDENCIA                   ;METROPOLITANA;0;0;0;0;0;0;0;0;0;CELULAR NOKIA 110 BLACK OPEN;TELEFONIA
17952958;Soltero;M;30;CHILENO;;Millenial;PROVIDENCIA                   ;METROPOLITANA;0;0;0;0;0;0;0;0;0;Celular Y7P LIB OPEN AZUL;TELEFONIA
13808014;;F;42;CHILENO;;X;COLLIPULLI                    ;ARAUCANIA;0;0;0;0;0;0;0;0;0;Celular A01 LIB OPEN AZUL;TELEFONIA
15968535;;M;37;CHILENO;;Millenial;PROVIDENCIA                   ;METROPOLITANA;0;0;0;0;0;0;0;0;0;Celular Galaxy S21 Ultra Phantom Black 128GB;TELEFONIA
18774202;;M;27;CHILENO;;Silencioso;PROVIDENCIA                   ;METROPOLITANA;0;0;0;0;0;0;0;0;0;CELULAR A21s 128 GB Negro;TELEFONIA
19320875;;F;26;CHILENO;;Z;PENALOLEN                     ;METROPOLITANA;0;0;0;0;0;0;0;0;0;CELULAR A21s 128 GB Negro;TELEFONIA
10027269;;M;57;CHILENO;;Boomers;QUILLOTA                      ;VALPARAISO;0;0;0;0;0;0;0;0;0;Celular SA3 CLARO DIRECTO BLACK;TELEFONIA
9646899;;M;58;CHILENO;;Boomers;PROVIDENCIA                   ;METROPOLITANA;0;0;0;0;0;0;0;0;0;Celular A71 LIB OPEN NEGRO;TELEFONIA
11574702;;M;51;CHILENO;;X;EL CARMEN                     ;BIO BIO;0;0;0;0;0;0;0;0;0;Celular A31 LIB OPEN AZUL;TELEFONIA
7170825;Soltero;F;67;CHILENO;;Boomers;RANCAGUA                      ;L.G.B.OÂ´HIGGINS;0;0;0;0;0;0;0;0;0;Celular G8 POWER LITE MOVISTAR DIRECTO AZUL;TELEFONIA
19886949;;F;23;CHILENO;;Z;PROVIDENCIA                   ;METROPOLITANA;0;0;0;0;0;0;0;0;0;Celular A10S LIB OPEN BLUE;TELEFONIA
14494853;;M;47;CHILENO;;X;RENCA                         ;METROPOLITANA;0;0;0;0;0;0;0;0;0;CELULAR HUAWEI Y5 NEO NEGRO WOM;TELEFONIA
17877397;;M;31;CHILENO;;Millenial;COIHAIQUE                     ;AYSEN;0;0;0;0;0;0;0;0;0;Celular Galaxy S21 Ultra Phantom Black 128GB;TELEFONIA
27129446;;M;40;VENEZOLANO;;Extranjero;"";"";0;0;0;0;0;0;0;0;0;CELULAR NOKIA 225 4G BLACK TRI ENTEL;TELEFONIA
3414542;;F;82;CHILENO;;Silencioso;HUALQUI                       ;BIO BIO;0;0;0;0;0;0;0;0;0;Celular A51 128GB LIB OPEN BLANCO;TELEFONIA
20027121;;F;23;CHILENO;;Millenial;PROVIDENCIA                   ;METROPOLITANA;0;0;0;0;0;0;0;0;0;CELULAR VIVO Y11S PHANTOM BLACK OPEN;TELEFONIA
19326867;;M;25;CHILENO;;Z;VALPARAISO                    ;VALPARAISO;0;0;0;0;0;0;0;0;0;CELULAR MOTO ONE FUSION 64GB VERDE 64GB OPEN;TELEFONIA
12397011;Soltero;M;49;CHILENO;;X;RENCA                         ;METROPOLITANA;0;0;0;0;0;0;0;0;0;Celular NOKIA 1.3 NEGRO WOM;TELEFONIA
10993748;;M;55;CHILENO;;Boomers;NANCAGUA                      ;L.G.B.OÂ´HIGGINS;0;0;0;0;0;0;0;0;0;Celular G8 POWER LITE MOVISTAR DIRECTO AZUL;TELEFONIA
17913389;;M;30;CHILENO;;Millenial;MULCHEN                       ;BIO BIO;0;0;0;0;0;0;0;0;0;Celular A11 LIB OPEN BLUE;TELEFONIA
15266895;;F;40;CHILENO;;X;PROVIDENCIA                   ;METROPOLITANA;0;0;0;0;0;0;0;0;0;CELULAR SAMSUNG A21S AZUL OPEN;TELEFONIA
23925118;;M;31;HAITIANO;;Extranjero;QUILICURA                     ;METROPOLITANA;0;0;0;0;0;0;0;0;0;Celular S10 LITE LIB OPEN NEGRO;TELEFONIA
8791040;;M;61;CHILENO;;Boomers;RENCA                         ;METROPOLITANA;0;0;0;0;0;0;0;0;0;Celular SA3 CLARO DIRECTO BLACK;TELEFONIA
19338585;Soltero;M;25;CHILENO;;Z;PROVIDENCIA                   ;METROPOLITANA;0;0;0;0;0;0;0;0;0;Celular A10S LIB OPEN RED;TELEFONIA
17261005;Soltero;F;33;CHILENO;ENFERMERA;Millenial;PROVIDENCIA                   ;METROPOLITANA;0;0;0;0;0;0;0;0;0;Celular S20 FE LIB OPEN Cloud Lavender;TELEFONIA
9480273;;F;60;CHILENO;;Boomers;N/D;N/D;0;0;0;0;0;0;0;0;0;CELULAR A12 128GB ROJO OPEN;TELEFONIA
10239719;;F;59;CHILENO;;Boomers;RENCA                         ;METROPOLITANA;0;0;0;0;0;0;0;0;0;Celular LG K22 ENTEL DIRECTO TITAN;TELEFONIA
11774683;;M;50;CHILENO;;X;TALCAHUANO                    ;BIO BIO;0;0;0;0;0;0;0;0;0;Celular A51 128GB LIB OPEN BLACK;TELEFONIA
10616331;;M;55;CHILENO;;Boomers;TOME                          ;BIO BIO;0;0;0;0;0;0;0;0;0;Celular Y9 PRIME LIB OPEN NEGRO;TELEFONIA
8451910;Soltero;M;62;CHILENO;;Boomers;RENCA                         ;METROPOLITANA;0;0;0;0;0;0;0;0;0;Celular R340 CLARO DIRECTO NEGRO;TELEFONIA
20303753;;F;23;CHILENO;;Z;SAN VICENTE;O HIGGINS;0;0;0;0;0;0;0;0;0;Celular LG K22 MOVISTAR DIRECTO TITAN;TELEFONIA
5015362;;M;76;CHILENO;;Silencioso;VALLENAR;ATACAMA;0;0;0;0;0;0;0;0;0;Celular AL3 CLARO DIRECTO NEGRO;TELEFONIA
13069869;;M;53;CHILENO;;X;RENCA                         ;METROPOLITANA;0;0;0;0;0;0;0;0;0;CELULAR SAMSUNG A21S AZUL OPEN;TELEFONIA
6408274;;M;72;CHILENO;;Silencioso;BUIN                          ;METROPOLITANA;0;0;0;0;0;0;0;0;0;Celular R340 CLARO DIRECTO NEGRO;TELEFONIA
15203603;Casado;F;40;CHILENO;;X;PROVIDENCIA                   ;METROPOLITANA;0;0;0;0;0;0;0;0;0;CELULAR OWN 1026 AZUL ENTEL;TELEFONIA
15286488;;M;41;CHILENO;;X;CALBUCO                       ;LOS LAGOS;0;0;0;0;0;0;0;0;0;Celular Y8P ENTEL TRIANGULADO PIEDRA DE LUNA;TELEFONIA
19721017;;F;24;CHILENO;;Silencioso;PROVIDENCIA                   ;METROPOLITANA;0;0;0;0;0;0;0;0;0;CELULAR XIAOMI REDMI 9A 32GB GRANITE GRAY TRI WO;TELEFONIA
9991277;;F;58;CHILENO;;Boomers;ESTACION CENTRAL              ;METROPOLITANA;0;0;0;0;0;0;0;0;0;Celular A51 128GB LIB OPEN AZUL;TELEFONIA
16528839;;M;35;CHILENO;;Millenial;PROVIDENCIA                   ;METROPOLITANA;0;0;0;0;0;0;0;0;0;CELULAR OWN 1026 AZUL ENTEL;TELEFONIA
7285147;;F;69;CHILENO;;Silencioso;LA FLORIDA                    ;METROPOLITANA;0;0;0;0;0;0;0;0;0;Celular A10S LIB OPEN RED;TELEFONIA
8870116;;F;60;CHILENO;;Boomers;CALLE LARGA                   ;VALPARAISO;0;0;0;0;0;0;0;0;0;CHIP OPEN ENTEL;TELEFONIA
10694675;;F;56;CHILENO;;Boomers;N/D;N/D;0;0;0;0;0;0;0;0;0;Celular A01 CLARO DIRECTO BLACK;TELEFONIA
19793417;;M;24;CHILENO;;Z;PROVIDENCIA                   ;METROPOLITANA;0;0;0;0;0;0;0;0;0;CELULAR IPHONE SE ENT;TELEFONIA
13544016;;F;42;CHILENO;;X;RENCA                         ;METROPOLITANA;0;0;0;0;0;0;0;0;0;CELULAR XIAOMI REDMI 9A 32GB BLACK DIRECTO CLARO;TELEFONIA
12551089;;M;48;CHILENO;;X;CHILLAN                       ;BIO BIO;0;0;0;0;0;0;0;0;0;CELULAR HUAWEI Y9 PRIME BLUE OPEN;TELEFONIA
18843315;;M;28;CHILENO;;Millenial;RENCA                         ;METROPOLITANA;0;0;0;0;0;0;0;0;0;CELULAR XIAOMI REDMI 9A 32GB SKY BLUE TRI WOM;TELEFONIA
4797776;;M;80;CHILENO;;Silencioso;PUNTA ARENAS                  ;MAGALLANES;0;0;0;0;0;0;0;0;0;Celular TIGER V SENIOR CLARO DIRECTO NEGRO;TELEFONIA
18789453;Soltero;M;27;CHILENO;;Millenial;PROVIDENCIA                   ;METROPOLITANA;0;0;0;0;0;0;0;0;0;Celular A01 LIB OPEN NEGRO;TELEFONIA
16720908;Casado;F;34;CHILENO;;Millenial;PROVIDENCIA                   ;METROPOLITANA;0;0;0;0;0;0;0;0;0;Celular Y6P WOM TRIANGULADO NEGRO;TELEFONIA
17369877;;F;32;CHILENO;;Millenial;PROVIDENCIA                   ;METROPOLITANA;0;0;0;0;0;0;0;0;0;CELULAR A12 128GB NEGRO OPEN;TELEFONIA
9220296;;M;60;CHILENO;;Boomers;SANTA BARBARA                 ;BIO BIO;0;0;0;0;0;0;0;0;0;CELULAR MOTO ONE FUSION 64GB VERDE 64GB OPEN;TELEFONIA
9699834;;F;55;CHILENO;;Boomers;LLAILLAY                      ;VALPARAISO;0;0;0;0;0;0;0;0;0;Celular A51 128GB LIB OPEN AZUL;TELEFONIA
15720318;;M;38;CHILENO;;Millenial;VILLA ALEMANA                 ;VALPARAISO;0;0;0;0;0;0;0;0;0;CELULAR SAMSUNG A21S NEGRO OPEN;TELEFONIA
19809696;;F;24;CHILENO;;Z;PROVIDENCIA                   ;METROPOLITANA;0;0;0;0;0;0;0;0;0;Celular A51 128GB LIB OPEN BLANCO;TELEFONIA
15851502;;F;36;CHILENO;;Millenial;PROVIDENCIA                   ;METROPOLITANA;0;0;0;0;0;0;0;0;0;Celular P40 LITE LIB OPEN GREEN;TELEFONIA
20454169;;F;21;CHILENO;;Z;PROVIDENCIA                   ;METROPOLITANA;0;0;0;0;0;0;0;0;0;Celular A51 128GB LIB OPEN BLANCO;TELEFONIA
13506120;;F;43;CHILENO;;X;SAN BERNARDO                  ;METROPOLITANA;0;0;0;0;0;0;0;0;0;Celular XIAOMI REDMI 9A 32 GB DIRECTO CLARO;TELEFONIA
14672380;;F;46;PERUANO;;Extranjero;SANTIAGO                      ;METROPOLITANA;0;0;0;0;0;0;0;0;0;Celular SAMSUNG A11 32GB ENTEL DIRECTO NEGRO;TELEFONIA
15061137;;F;40;CHILENO;;Silencioso;PROVIDENCIA                   ;METROPOLITANA;0;0;0;0;0;0;0;0;0;Celular S20 ULTRA LIB OPEN NEGRO;TELEFONIA
8396211;;M;49;CHILENO;;X;PROVIDENCIA                   ;METROPOLITANA;0;0;0;0;0;0;0;0;0;CELULAR OWN 1026 AZUL ENTEL;TELEFONIA
15566883;Casado;F;38;CHILENO;;Millenial;PROVIDENCIA                   ;METROPOLITANA;0;0;0;0;0;0;0;0;0;CELULAR REDMI NOTE 8 64GB NEPTUNE BLUE OPEN;TELEFONIA
12336903;;M;48;CHILENO;;X;PROVIDENCIA                   ;METROPOLITANA;0;0;0;0;0;0;0;0;0;Celular A01 LIB OPEN ROJO;TELEFONIA
12032048;;F;55;CHILENO;;Boomers;RENCA                         ;METROPOLITANA;0;0;0;0;0;0;0;0;0;Celular XIAOMI REDMI 9A 32 GB DIRECTO CLARO;TELEFONIA
9562877;;M;59;CHILENO;;Boomers;PALMILLA                      ;L.G.B.OÂ´HIGGINS;0;0;0;0;0;0;0;0;0;Celular 2.3 MOVISTAR DIRECTO CHARCOAL;TELEFONIA
19604135;;M;24;CHILENO;;Z;PROVIDENCIA                   ;METROPOLITANA;0;0;0;0;0;0;0;0;0;Celular HUAWEI Y9 PRIME DIRECTO CLARO BLUE;TELEFONIA
8786514;;M;61;CHILENO;;Boomers;PROVIDENCIA                   ;METROPOLITANA;0;0;0;0;0;0;0;0;0;CELULAR SAMSUNG A21S AZUL OPEN;TELEFONIA
13912367;;F;42;CHILENO;;X;PROVIDENCIA                   ;METROPOLITANA;0;0;0;0;0;0;0;0;0;Celular A51 128GB LIB OPEN BLACK;TELEFONIA
11102168;Casado;F;56;CHILENO;;Boomers;PROVIDENCIA                   ;METROPOLITANA;0;0;0;0;0;0;0;0;0;CELULAR REDMI NOTE 8 64GB SPACE BLACK OPEN;TELEFONIA
18166131;Soltero;M;30;CHILENO;TECNICO EN ANALISIS QUIMICO;Millenial;PROVIDENCIA                   ;METROPOLITANA;0;0;0;0;0;0;0;0;0;CELULAR REDMI NOTE 9S 64 GB GLACIER WHITE;TELEFONIA
19274907;;F;26;CHILENO;;Z;SAN FERNANDO                  ;L.G.B.OÂ´HIGGINS;0;0;0;0;0;0;0;0;0;CELULAR NOKIA 225 4G BLACK TRI ENTEL;TELEFONIA
26594785;;M;33;VENEZOLANO;;Extranjero;N/D;N/D;0;0;0;0;0;0;0;0;0;Celular A51 128GB LIB OPEN BLANCO;TELEFONIA
13376198;;F;43;CHILENO;;X;SAN CARLOS                    ;BIO BIO;0;0;0;0;0;0;0;0;0;Celular ZTE A3 2020 ENTEL DIRECTO GRIS;TELEFONIA
14191168;;F;41;CHILENO;;X;PROVIDENCIA                   ;METROPOLITANA;0;0;0;0;0;0;0;0;0;Celular G8 POWER LITE MOVISTAR DIRECTO AZUL;TELEFONIA
17212300;Soltero;M;32;CHILENO;;Millenial;PROVIDENCIA                   ;METROPOLITANA;0;0;0;0;0;0;0;0;0;CELULAR NOKIA 7.2 GREEN TRI WOM;TELEFONIA
15575077;;F;29;CHILENO;;Millenial;OVALLE                        ;COQUIMBO;0;0;0;0;0;0;0;0;0;CELULAR SAMSUNG A21S AZUL OPEN;TELEFONIA
13172828;;F;45;CHILENO;;X;RENCA                         ;METROPOLITANA;0;0;0;0;0;0;0;0;0;CELULAR HUAWEI Y9S BLACK DIRECTO CLARO;TELEFONIA
7659189;Casado;M;60;CHILENO;INGENIERO;Boomers;PROVIDENCIA                   ;METROPOLITANA;0;0;0;0;0;0;0;0;0;Celular A51 128GB LIB OPEN BLACK;TELEFONIA
13387096;;M;44;CHILENO;;X;PROVIDENCIA                   ;METROPOLITANA;0;0;0;0;0;0;0;0;0;Celular XIAOMI REDMI 9 64 GB DIRECTO CLARO NEGRO;TELEFONIA
12315543;;F;48;CHILENO;;X;SAN FERNANDO                  ;L.G.B.OÂ´HIGGINS;0;0;0;0;0;0;0;0;0;CELULAR SAMSUNG A21S ROJO OPEN;TELEFONIA
12566208;Casado;F;50;CHILENO;;X;PROVIDENCIA                   ;METROPOLITANA;0;0;0;0;0;0;0;0;0;Celular a11 azul samsung WOM;TELEFONIA
12597043;;F;47;CHILENO;;X;OVALLE                        ;COQUIMBO;0;0;0;0;0;0;0;0;0;Celular A11 LIB OPEN BLUE;TELEFONIA
10122904;;F;59;CHILENO;;Boomers;SAN CARLOS                    ;BIO BIO;0;0;0;0;0;0;0;0;0;Celular ZTE A3 2020 ENTEL DIRECTO GRIS;TELEFONIA
7642058;;F;68;CHILENO;;Silencioso;RIO BUENO                     ;LOS LAGOS;0;0;0;0;0;0;0;0;0;Celular SAMSUNG A01 CORE AZUL ENTEL;TELEFONIA
20354163;;M;22;CHILENO;;Z;PROVIDENCIA                   ;METROPOLITANA;0;0;0;0;0;0;0;0;0;CELULAR XIAOMI REDMI 9C 64GB TIWLIGHT BLUE TRI M;TELEFONIA
16687346;;M;35;CHILENO;;Millenial;PROVIDENCIA                   ;METROPOLITANA;0;0;0;0;0;0;0;0;0;Celular SAMSUNG A11 32GB ENTEL DIRECTO NEGRO;TELEFONIA
10793328;;F;55;CHILENO;;Boomers;LA FLORIDA                    ;METROPOLITANA;0;0;0;0;0;0;0;0;0;IPHONE REAC 8 64GB ROJO OPEN;TELEFONIA
15346984;;F;40;CHILENO;;X;PROVIDENCIA                   ;METROPOLITANA;0;0;0;0;0;0;0;0;0;Celular SAMSUNG A01 CORE AZUL ENTEL;TELEFONIA
7178758;;F;71;CHILENO;;Silencioso;PROVIDENCIA                   ;METROPOLITANA;0;0;0;0;0;0;0;0;0;Celular A01 LIB OPEN NEGRO;TELEFONIA
10140391;;F;58;CHILENO;;Boomers;CONCHALI                      ;METROPOLITANA;0;0;0;0;0;0;0;0;0;Celular A51 128GB LIB OPEN BLACK;TELEFONIA
17902755;Casado;F;30;CHILENO;;Millenial;"";"";0;0;0;0;0;0;0;0;0;Celular SAMSUNG A11 32GB ENTEL DIRECTO NEGRO;TELEFONIA
15657223;;M;38;CHILENO;;X;LAJA                          ;BIO BIO;0;0;0;0;0;0;0;0;0;Celular A01 CLARO DIRECTO BLACK;TELEFONIA
19713501;;M;25;CHILENO;;Z;PROVIDENCIA                   ;METROPOLITANA;0;0;0;0;0;0;0;0;0;CELULAR REDMI NOTE 8 64GB SPACE BLACK OPEN;TELEFONIA
10573157;;F;57;CHILENO;;Boomers;CHEPICA                       ;L.G.B.OÂ´HIGGINS;0;0;0;0;0;0;0;0;0;Celular SAMSUNG A11 32GB ENTEL DIRECTO NEGRO;TELEFONIA
16130216;Soltero;M;36;CHILENO;;Millenial;RENCA                         ;METROPOLITANA;0;0;0;0;0;0;0;0;0;Celular R340 CLARO DIRECTO NEGRO;TELEFONIA
17940028;;F;30;CHILENO;;Millenial;TEMUCO                        ;ARAUCANIA;0;0;0;0;0;0;0;0;0;Celular A01 CORE MOVISTAR DIRECTO BLACK;TELEFONIA
15579547;Soltero;F;38;CHILENO;;Millenial;PROVIDENCIA                   ;METROPOLITANA;0;0;0;0;0;0;0;0;0;Celular SAMSUNG A11 32GB ENTEL DIRECTO NEGRO;TELEFONIA
12559857;;F;47;CHILENO;;X;PROVIDENCIA                   ;METROPOLITANA;0;0;0;0;0;0;0;0;0;CELULAR SAMSUNG A21S AZUL OPEN;TELEFONIA
8533273;;M;47;CHILENO;;X;RENCA                         ;METROPOLITANA;0;0;0;0;0;0;0;0;0;Celular NOKIA 4.2 ENTEL DIRECTO NEGRO;TELEFONIA
25465833;;F;26;PERUANO;;Extranjero;QUINTA NORMAL                 ;METROPOLITANA;0;0;0;0;0;0;0;0;0;Celular A11 LIB OPEN BLACK;TELEFONIA
16742434;;M;36;CHILENO;;Millenial;MAIPU                         ;METROPOLITANA;0;0;0;0;0;0;0;0;0;CELULAR MOTOROLA G8 POWER LITE AZUL WOM;TELEFONIA
8292782;;M;61;CHILENO;;Boomers;CORONEL                       ;BIO BIO;0;0;0;0;0;0;0;0;0;Celular SAMSUNG A21s CLARO DIRECTO BLACK;TELEFONIA
9877781;;F;53;CHILENO;;X;N/D;N/D;0;0;0;0;0;0;0;0;0;Celular A71 LIB OPEN PLATEADO;TELEFONIA
7332653;Viudo;F;73;CHILENO;;Silencioso;PROVIDENCIA                   ;METROPOLITANA;0;0;0;0;0;0;0;0;0;Celular LG K22 ENTEL DIRECTO TITAN;TELEFONIA
19916247;;M;23;CHILENO;;Z;N/D;N/D;0;0;0;0;0;0;0;0;0;CELULAR MOTO G8 POWER LITE AZUL TRI ENTEL;TELEFONIA
13999077;;F;41;CHILENO;;X;VINA DEL MAR                  ;VALPARAISO;0;0;0;0;0;0;0;0;0;Celular P40 LITE LIB OPEN GREEN;TELEFONIA
12255226;;M;51;CHILENO;;X;N/D;N/D;0;0;0;0;0;0;0;0;0;CELULAR A12 128GB NEGRO OPEN;TELEFONIA
14063941;Casado;M;41;CHILENO;AGRONOMO;X;RENCA                         ;METROPOLITANA;0;0;0;0;0;0;0;0;0;Celular A20S LIB OPEN ROJO;TELEFONIA
13722310;;F;43;CHILENO;;X;CERRILLOS                     ;METROPOLITANA;0;0;0;0;0;0;0;0;0;Celular NOKIA 1.3 NEGRO WOM;TELEFONIA
12278688;;M;49;CHILENO;;X;"";"";0;0;0;0;0;0;0;0;0;CELULAR SAMSUNG A71 AZUL OPEN;TELEFONIA
19018057;;F;27;CHILENO;;Z;RANCAGUA                      ;L.G.B.OÂ´HIGGINS;0;0;0;0;0;0;0;0;0;Celular A01 LIB OPEN AZUL;TELEFONIA
8930111;Soltero;M;61;CHILENO;;Boomers;PROVIDENCIA                   ;METROPOLITANA;0;0;0;0;0;0;0;0;0;Celular HUAWEI Y9 PRIME DIRECTO CLARO BLUE;TELEFONIA
14471210;;M;48;CHILENO;;X;RENCA                         ;METROPOLITANA;0;0;0;0;0;0;0;0;0;Celular A11 LIB OPEN BLUE;TELEFONIA
10045069;;F;56;CHILENO;;Boomers;RENCA                         ;METROPOLITANA;0;0;0;0;0;0;0;0;0;Celular A01 CLARO DIRECTO BLACK;TELEFONIA
17818934;Soltero;M;31;CHILENO;;Millenial;PROVIDENCIA                   ;METROPOLITANA;0;0;0;0;0;0;0;0;0;Celular A11 LIB OPEN BLUE;TELEFONIA
15044886;;M;38;CHILENO;;Millenial;PROVIDENCIA                   ;METROPOLITANA;0;0;0;0;0;0;0;0;0;Celular A71 LIB OPEN PLATEADO;TELEFONIA
24034905;;M;36;PERUANO;;Extranjero;RENCA                         ;METROPOLITANA;0;0;0;0;0;0;0;0;0;CELULAR XIAOMI REDMI 9C 64GB TIWLIGHT BLUE TRI W;TELEFONIA
12621362;Soltero;F;48;CHILENO;INGENIERO;X;RENCA                         ;METROPOLITANA;0;0;0;0;0;0;0;0;0;Celular A01 CORE MOVISTAR DIRECTO BLACK;TELEFONIA
10630462;Casado;M;54;CHILENO;TECNICO EN ELECTROMECANICA;Boomers;PROVIDENCIA                   ;METROPOLITANA;0;0;0;0;0;0;0;0;0;Celular NOKIA 2.3 WOM DIRECTO CHARCOAL;TELEFONIA
18563681;Soltero;M;28;CHILENO;;Millenial;PROVIDENCIA                   ;METROPOLITANA;0;0;0;0;0;0;0;0;0;Celular A51 128GB LIB OPEN AZUL;TELEFONIA
17625071;;M;31;CHILENO;;Millenial;OVALLE                        ;COQUIMBO;0;0;0;0;0;0;0;0;0;Celular A11 LIB OPEN BLUE;TELEFONIA
15443133;;M;39;CHILENO;;X;N/D;N/D;0;0;0;0;0;0;0;0;0;Celular A31 LIB OPEN AZUL;TELEFONIA
17794714;;F;31;CHILENO;;Millenial;CURICO                        ;MAULE;0;0;0;0;0;0;0;0;0;Celular A01 LIB OPEN AZUL;TELEFONIA
10417768;;M;54;CHILENO;;X;QUILLOTA;VALPARAISO;0;0;0;0;0;0;0;0;0;CELULAR HUAWEI Y8S CLARO DIRECTO BLACK;TELEFONIA
12150044;;M;52;CHILENO;;Boomers;N/D;N/D;0;0;0;0;0;0;0;0;0;Celular G8 POWER LITE MOVISTAR DIRECTO AZUL;TELEFONIA
18280466;;F;29;CHILENO;;Millenial;PROVIDENCIA                   ;METROPOLITANA;0;0;0;0;0;0;0;0;0;Celular SAMSUNG A01 CORE BLACK CLARO;TELEFONIA
14379553;;F;45;CHILENO;;X;N/D;N/D;0;0;0;0;0;0;0;0;0;Celular SAMSUNG A11 32GB ENTEL DIRECTO NEGRO;TELEFONIA
18093654;;F;29;CHILENO;;Millenial;LAMPA                         ;METROPOLITANA;0;0;0;0;0;0;0;0;0;CELULAR REDMI NOTE 8 64GB NEPTUNE BLUE OPEN;TELEFONIA
10693475;;F;48;CHILENO;;X;PROVIDENCIA                   ;METROPOLITANA;0;0;0;0;0;0;0;0;0;Celular SAMSUNG A01 CORE BLACK CLARO;TELEFONIA
8251483;;M;63;CHILENO;;Boomers;QUILPUE                       ;VALPARAISO;0;0;0;0;0;0;0;0;0;Celular R340 CLARO DIRECTO NEGRO;TELEFONIA
9090109;Soltero;M;58;CHILENO;;Boomers;RENCA                         ;METROPOLITANA;0;0;0;0;0;0;0;0;0;Celular A51 128GB LIB OPEN BLACK;TELEFONIA
7314577;;M;69;CHILENO;;Silencioso;EL BOSQUE                     ;METROPOLITANA;0;0;0;0;0;0;0;0;0;Celular NOKIA 1.3 NEGRO WOM;TELEFONIA
10430026;Casado;M;57;CHILENO;;Boomers;RENCA                         ;METROPOLITANA;0;0;0;0;0;0;0;0;0;Celular R340 CLARO DIRECTO NEGRO;TELEFONIA
17844081;Soltero;F;31;CHILENO;TECNICO DE NIVEL SUPERIOR EN ENFERMERIA;Millenial;RENCA                         ;METROPOLITANA;0;0;0;0;0;0;0;0;0;Celular XIAOMI REDMI 9A 32 GB DIRECTO CLARO;TELEFONIA
15424384;;F;40;CHILENO;;X;VITACURA                      ;METROPOLITANA;0;0;0;0;0;0;0;0;0;Celular R340 CLARO DIRECTO NEGRO;TELEFONIA
16980347;;M;33;CHILENO;;Millenial;CONCEPCION                    ;BIO BIO;0;0;0;0;0;0;0;0;0;CELULAR MOTO ONE FUSION 64GB VERDE 64GB OPEN;TELEFONIA
9269222;;M;58;CHILENO;;Boomers;RENGO                         ;L.G.B.OÂ´HIGGINS;0;0;0;0;0;0;0;0;0;Celular A11 LIB OPEN BLACK;TELEFONIA
14181161;;F;42;CHILENO;;X;N/D;N/D;0;0;0;0;0;0;0;0;0;CELULAR XIAOMI REDMI 9C 64GB TIWLIGHT BLUE TRI W;TELEFONIA
19365764;;M;25;CHILENO;;Z;PROVIDENCIA                   ;METROPOLITANA;0;0;0;0;0;0;0;0;0;Celular A10S LIB OPEN RED;TELEFONIA
11198653;;F;55;CHILENO;;Boomers;PROVIDENCIA                   ;METROPOLITANA;0;0;0;0;0;0;0;0;0;Celular LG K22 ENTEL DIRECTO TITAN;TELEFONIA
10524124;Soltero;F;56;CHILENO;;Boomers;RENCA                         ;METROPOLITANA;0;0;0;0;0;0;0;0;0;Celular SA3 CLARO DIRECTO BLACK;TELEFONIA
12874567;;F;47;CHILENO;;X;CONCEPCION                    ;BIO BIO;0;0;0;0;0;0;0;0;0;Celular A31 LIB OPEN BLACK;TELEFONIA
10593645;;F;55;CHILENO;;Boomers;PROVIDENCIA                   ;METROPOLITANA;0;0;0;0;0;0;0;0;0;Celular A31 LIB OPEN BLACK;TELEFONIA
12153051;;F;49;CHILENO;;X;PROVIDENCIA                   ;METROPOLITANA;0;0;0;0;0;0;0;0;0;CELULAR REDMI 9 64GB SUNSET PURPLE TRI WOM;TELEFONIA
17770069;;F;31;CHILENO;;Millenial;PROVIDENCIA                   ;METROPOLITANA;0;0;0;0;0;0;0;0;0;Celular A10S LIB OPEN RED;TELEFONIA
10159042;;M;58;CHILENO;;Boomers;PROVIDENCIA                   ;METROPOLITANA;0;0;0;0;0;0;0;0;0;CELULAR LG K22 TRIANGULADO WOM;TELEFONIA
11764550;Casado;F;51;CHILENO;;X;CONSTITUCION                  ;MAULE;0;0;0;0;0;0;0;0;0;Celular R340 CLARO DIRECTO NEGRO;TELEFONIA
14068558;;M;41;CHILENO;;X;LOS ANGELES                   ;BIO BIO;0;0;0;0;0;0;0;0;0;Celular A10S LIB OPEN RED;TELEFONIA
17751762;Soltero;F;31;CHILENO;;Millenial;PROVIDENCIA                   ;METROPOLITANA;0;0;0;0;0;0;0;0;0;Celular A10S LIB OPEN BLUE;TELEFONIA
6941486;;M;70;CHILENO;;Silencioso;SAN CARLOS                    ;BIO BIO;0;0;0;0;0;0;0;0;0;Celular SAMSUNG A01 CORE BLACK CLARO;TELEFONIA
7825932;;F;67;CHILENO;;Boomers;HUALPEN;BIO BIO;0;0;0;0;0;0;0;0;0;Celular Y8P ENTEL TRIANGULADO PIEDRA DE LUNA;TELEFONIA
8573486;;M;65;CHILENO;;Boomers;RENCA                         ;METROPOLITANA;0;0;0;0;0;0;0;0;0;CELULAR HUAWEI Y5 NEO NEGRO WOM;TELEFONIA
18871176;;F;27;CHILENO;;Millenial;N/D;N/D;0;0;0;0;0;0;0;0;0;Celular A51 128GB LIB OPEN AZUL;TELEFONIA
13834333;;M;42;CHILENO;;X;BUIN                          ;METROPOLITANA;0;0;0;0;0;0;0;0;0;Celular A51 128GB LIB OPEN AZUL;TELEFONIA
15600394;;F;38;CHILENO;;X;LOS LAGOS                     ;LOS RIOS;0;0;0;0;0;0;0;0;0;Celular A20S LIB OPEN ROJO;TELEFONIA
19779276;;M;23;CHILENO;;Z;PROVIDENCIA                   ;METROPOLITANA;0;0;0;0;0;0;0;0;0;CELULAR REDMI NOTE 8 64GB SPACE BLACK OPEN;TELEFONIA
13003137;;F;46;CHILENO;;X;PROVIDENCIA                   ;METROPOLITANA;0;0;0;0;0;0;0;0;0;Celular A51 128GB LIB OPEN BLANCO;TELEFONIA
12745106;;M;49;CHILENO;;X;PANGUIPULLI                   ;LOS LAGOS;0;0;0;0;0;0;0;0;0;CELULAR HUAWEI Y5 NEO NEGRO WOM;TELEFONIA
25295957;;F;45;HAITIANO;;Extranjero;SAN JOAQUIN                   ;METROPOLITANA;0;0;0;0;0;0;0;0;0;Celular A11 LIB OPEN BLACK;TELEFONIA
17441624;;F;32;CHILENO;;Millenial;CURICO                        ;MAULE;0;0;0;0;0;0;0;0;0;Celular R340 CLARO DIRECTO NEGRO;TELEFONIA
15083100;;M;39;CHILENO;;X;QUILPUE                       ;VALPARAISO;0;0;0;0;0;0;0;0;0;CELULAR HUAWEI Y8S NEGRO WOM;TELEFONIA
17643561;;F;29;CHILENO;;Millenial;CABILDO                       ;VALPARAISO;0;0;0;0;0;0;0;0;0;Celular SAMSUNG A01 CORE AZUL ENTEL;TELEFONIA
12782346;;M;47;CHILENO;;X;PROVIDENCIA                   ;METROPOLITANA;0;0;0;0;0;0;0;0;0;Celular SAMSUNG A11 32GB ENTEL DIRECTO NEGRO;TELEFONIA
16940357;Soltero;F;33;CHILENO;;Millenial;PROVIDENCIA                   ;METROPOLITANA;0;0;0;0;0;0;0;0;0;Celular A31 LIB OPEN BLACK;TELEFONIA
8593994;;F;62;CHILENO;;Boomers;TIERRA AMARILLA               ;ATACAMA;0;0;0;0;0;0;0;0;0;Celular A11 LIB OPEN BLUE;TELEFONIA
17760732;;F;31;CHILENO;;Millenial;EL TABO                       ;VALPARAISO;0;0;0;0;0;0;0;0;0;Celular R340 CLARO DIRECTO NEGRO;TELEFONIA
14504728;Soltero;M;42;CHILENO;PUBLICISTA;X;PROVIDENCIA                   ;METROPOLITANA;0;0;0;0;0;0;0;0;0;Celular NOKIA 4.2 ENTEL DIRECTO NEGRO;TELEFONIA
12207793;;M;50;CHILENO;;X;TALCAHUANO                    ;BIO BIO;0;0;0;0;0;0;0;0;0;Celular A01 LIB OPEN AZUL;TELEFONIA
12520776;;F;49;CHILENO;;X;TALCA                         ;MAULE;0;0;0;0;0;0;0;0;0;Celular LG K22 ENTEL DIRECTO TITAN;TELEFONIA
12836063;;M;47;CHILENO;;X;ALTO HOSPICIO;TARAPACA;0;0;0;0;0;0;0;0;0;Celular A31 LIB OPEN AZUL;TELEFONIA
11388342;;F;53;CHILENO;;X;VILLA ALEMANA                 ;VALPARAISO;0;0;0;0;0;0;0;0;0;CELULAR LG K22 TRIANGULADO WOM;TELEFONIA
18115907;Soltero;M;30;CHILENO;;Millenial;PROVIDENCIA                   ;METROPOLITANA;0;0;0;0;0;0;0;0;0;Celular Y9S LIB OPEN BLACK;TELEFONIA
10151849;;M;56;CHILENO;;Boomers;NANCAGUA                      ;L.G.B.OÂ´HIGGINS;0;0;0;0;0;0;0;0;0;Celular MOTO G8 POWER LITE TURQUESA OPEN;TELEFONIA
11467051;Casado;F;53;CHILENO;;X;RENCA                         ;METROPOLITANA;0;0;0;0;0;0;0;0;0;CELULAR SAMSUNG A21S AZUL OPEN;TELEFONIA
5948669;;M;74;CHILENO;;Silencioso;VICTORIA                      ;ARAUCANIA;0;0;0;0;0;0;0;0;0;Celular LG K22 MOVISTAR DIRECTO TITAN;TELEFONIA
9879977;Casado;F;54;CHILENO;;X;RENCA                         ;METROPOLITANA;0;0;0;0;0;0;0;0;0;Celular Y8P ENTEL TRIANGULADO NEGRO;TELEFONIA
10892794;;F;55;CHILENO;;Boomers;CABILDO                       ;VALPARAISO;0;0;0;0;0;0;0;0;0;CELULAR XIAOMI REDMI 9A 32GB SKY BLUE TRI WOM;TELEFONIA
9679825;;F;57;CHILENO;;Boomers;PROVIDENCIA                   ;METROPOLITANA;0;0;0;0;0;0;0;0;0;Celular A31 LIB OPEN BLACK;TELEFONIA
20023368;;F;23;CHILENO;;Z;PROVIDENCIA                   ;METROPOLITANA;0;0;0;0;0;0;0;0;0;Celular R340 CLARO DIRECTO NEGRO;TELEFONIA
14310979;Soltero;M;45;CHILENO;ADMINISTRADOR PUBLICO;X;PROVIDENCIA                   ;METROPOLITANA;0;0;0;0;0;0;0;0;0;Celular A51 128GB LIB OPEN BLACK;TELEFONIA
26358872;;M;39;EXTRANJERO - NO INFORMA NACIONALIDAD;;Extranjero;SANTIAGO                      ;METROPOLITANA;0;0;0;0;0;0;0;0;0;Celular A11 LIB OPEN BLACK;TELEFONIA
16194660;;F;36;CHILENO;;Millenial;PROVIDENCIA                   ;METROPOLITANA;0;0;0;0;0;0;0;0;0;Celular A11 LIB OPEN BLUE;TELEFONIA
17935219;;M;30;CHILENO;;Extranjero;RENGO                         ;L.G.B.OÂ´HIGGINS;0;0;0;0;0;0;0;0;0;Celular G8 POWER LITE MOVISTAR DIRECTO AZUL;TELEFONIA
6507066;Divorciado;M;67;CHILENO;;Boomers;PROVIDENCIA                   ;METROPOLITANA;0;0;0;0;0;0;0;0;0;CELULAR SAMSUNG A21S AZUL OPEN;TELEFONIA
19446317;;F;25;CHILENO;;Z;PROVIDENCIA                   ;METROPOLITANA;0;0;0;0;0;0;0;0;0;CELULAR LG K22 TRIANGULADO WOM;TELEFONIA
6356014;;F;69;CHILENO;;Silencioso;LA CISTERNA                   ;METROPOLITANA;0;0;0;0;0;0;0;0;0;Celular A31 LIB OPEN ROJO;TELEFONIA
9809303;;F;57;CHILENO;;Boomers;PROVIDENCIA                   ;METROPOLITANA;0;0;0;0;0;0;0;0;0;Celular A71 LIB OPEN NEGRO;TELEFONIA
6851798;;F;72;CHILENO;;Silencioso;TALCA                         ;MAULE;0;0;0;0;0;0;0;0;0;CELULAR MOTOROLA G8 POWER LITE AZUL WOM;TELEFONIA
11909518;;F;52;CHILENO;;X;RENCA                         ;METROPOLITANA;0;0;0;0;0;0;0;0;0;Celular Y5 NEO CLARO DIRECTO BLACK;TELEFONIA
12432040;;F;48;CHILENO;;X;RENCA                         ;METROPOLITANA;0;0;0;0;0;0;0;0;0;Celular A01 LIB OPEN ROJO;TELEFONIA
13958081;;F;42;CHILENO;;X;"";"";0;0;0;0;0;0;0;0;0;Celular Y9 PRIME LIB OPEN BLUE;TELEFONIA
14217454;;F;40;CHILENO;;X;PROVIDENCIA                   ;METROPOLITANA;0;0;0;0;0;0;0;0;0;CELULAR MOTO ONE FUSION 64GB VERDE 64GB OPEN;TELEFONIA
11729279;;F;51;CHILENO;;X;N/D;N/D;0;0;0;0;0;0;0;0;0;CELULAR HUAWEI Y9S BLACK DIRECTO CLARO;TELEFONIA
18276061;;F;30;CHILENO;;Millenial;N/D;N/D;0;0;0;0;0;0;0;0;0;Celular A11 LIB OPEN BLUE;TELEFONIA
16913829;;M;33;CHILENO;;Millenial;SAN BERNARDO                  ;METROPOLITANA;0;0;0;0;0;0;0;0;0;Celular Y9S LIB OPEN BREATHING CRYSTAL;TELEFONIA
13810756;;M;47;CHILENO;;X;NUEVA IMPERIAL                ;ARAUCANIA;0;0;0;0;0;0;0;0;0;Celular A11 LIB OPEN BLACK;TELEFONIA
17511180;;M;31;CHILENO;;Millenial;PROVIDENCIA                   ;METROPOLITANA;0;0;0;0;0;0;0;0;0;Celular A11 LIB OPEN BLUE;TELEFONIA
17605000;;M;32;CHILENO;;Millenial;LOS LAGOS                     ;LOS RIOS;0;0;0;0;0;0;0;0;0;Celular Y6 2019 MOVISTAR DIRECTO BLUE;TELEFONIA
12115338;;M;41;CHILENO;;X;PROVIDENCIA                   ;METROPOLITANA;0;0;0;0;0;0;0;0;0;CELULAR LG K22 TRIANGULADO WOM;TELEFONIA
18901517;Soltero;M;27;CHILENO;;Z;PROVIDENCIA                   ;METROPOLITANA;0;0;0;0;0;0;0;0;0;Celular A11 LIB OPEN BLUE;TELEFONIA
3659575;Casado;F;74;CHILENO;;Silencioso;RENCA                         ;METROPOLITANA;0;0;0;0;0;0;0;0;0;Celular ZTE A3 2020 WOM DIRECTO NEGRO;TELEFONIA
9683663;;M;56;CHILENO;;Boomers;CHIMBARONGO                   ;L.G.B.OÂ´HIGGINS;0;0;0;0;0;0;0;0;0;CELULAR SAMSUNG A21S AZUL OPEN;TELEFONIA
12816635;Soltero;F;47;CHILENO;;X;RENCA                         ;METROPOLITANA;0;0;0;0;0;0;0;0;0;Celular A10S LIB OPEN RED;TELEFONIA
16945343;;M;33;CHILENO;;Millenial;MACUL                         ;METROPOLITANA;0;0;0;0;0;0;0;0;0;Celular A5 CLARO DIRECTO BLACK;TELEFONIA
14048618;;M;41;CHILENO;;X;PROVIDENCIA                   ;METROPOLITANA;0;0;0;0;0;0;0;0;0;Celular NOKIA 4.2 ENTEL DIRECTO NEGRO;TELEFONIA
18311463;;F;29;CHILENO;;Millenial;ANTOFAGASTA;ANTOFAGASTA;0;0;0;0;0;0;0;0;0;CELULAR LG K41S TITAN DIRECTO MOVISTAR;TELEFONIA
7638333;;F;63;CHILENO;;Boomers;RENCA                         ;METROPOLITANA;0;0;0;0;0;0;0;0;0;Celular NOKIA 2.3 WOM DIRECTO CHARCOAL;TELEFONIA
18296998;Soltero;M;29;CHILENO;;Millenial;PROVIDENCIA                   ;METROPOLITANA;0;0;0;0;0;0;0;0;0;Celular A51 128GB LIB OPEN BLACK;TELEFONIA
26351414;;M;33;VENEZOLANO;;Extranjero;CURICO                        ;MAULE;0;0;0;0;0;0;0;0;0;Celular A11 MOVISTAR DIRECTO BLACK;TELEFONIA
7294439;Casado;M;67;CHILENO;;Boomers;SANTIAGO                      ;METROPOLITANA;0;0;0;0;0;0;0;0;0;Celular Y6 2019 WOM DIRECTO BLACK;TELEFONIA
19746263;;F;24;CHILENO;;Z;PUENTE ALTO                   ;METROPOLITANA;0;0;0;0;0;0;0;0;0;Celular P40 LITE LIB OPEN GREEN;TELEFONIA
14013384;;F;40;CHILENO;;X;PEUMO                         ;L.G.B.OÂ´HIGGINS;0;0;0;0;0;0;0;0;0;Celular A11 LIB OPEN BLUE;TELEFONIA
9996743;;F;65;CHILENO;;Boomers;SAN PEDRO DE LA PAZ           ;BIO BIO;0;0;0;0;0;0;0;0;0;Celular A10S LIB OPEN NEGRO;TELEFONIA
14039274;;M;41;CHILENO;;X;PUYEHUE                       ;LOS LAGOS;0;0;0;0;0;0;0;0;0;CELULAR HUAWEI Y5 NEO NEGRO WOM;TELEFONIA
4976669;;F;85;CHILENO;;Silencioso;VALPARAISO                    ;VALPARAISO;0;0;0;0;0;0;0;0;0;Celular A10S LIB OPEN RED;TELEFONIA
14462679;;M;50;CHILENO;;X;OVALLE                        ;COQUIMBO;0;0;0;0;0;0;0;0;0;Celular 2.3 MOVISTAR DIRECTO CHARCOAL;TELEFONIA
16543365;;M;35;CHILENO;;Millenial;PROVIDENCIA                   ;METROPOLITANA;0;0;0;0;0;0;0;0;0;Celular A51 128GB LIB OPEN AZUL;TELEFONIA
16780429;Soltero;M;35;CHILENO;INGENIERO INFORMATICO;Millenial;PROVIDENCIA                   ;METROPOLITANA;0;0;0;0;0;0;0;0;0;Celular Y9 PRIME LIB OPEN VERDE;TELEFONIA
8530764;Casado;M;61;CHILENO;;Boomers;RENCA                         ;METROPOLITANA;0;0;0;0;0;0;0;0;0;CELULAR XIAOMI REDMI 9C 64GB MIDNIGHT GRAY;TELEFONIA
17555401;Soltero;F;30;CHILENO;;Millenial;VALPARAISO                    ;VALPARAISO;0;0;0;0;0;0;0;0;0;Celular A51 128GB LIB OPEN AZUL;TELEFONIA
16331063;;F;36;CHILENO;;Millenial;N/D;N/D;0;0;0;0;0;0;0;0;0;Celular SAMSUNG A21s CLARO DIRECTO BLACK;TELEFONIA
18007891;;F;30;CHILENO;;Millenial;PROVIDENCIA                   ;METROPOLITANA;0;0;0;0;0;0;0;0;0;Celular NOKIA 4.2 ENTEL DIRECTO NEGRO;TELEFONIA
6208213;Soltero;M;67;CHILENO;;Boomers;RENCA                         ;METROPOLITANA;0;0;0;0;0;0;0;0;0;CELULAR OWN 1026 AZUL ENTEL;TELEFONIA
10527710;;M;55;CHILENO;;Boomers;CONCHALI                      ;METROPOLITANA;0;0;0;0;0;0;0;0;0;Celular A10S LIB OPEN BLUE;TELEFONIA
6688053;;M;70;CHILENO;;Silencioso;RENCA                         ;METROPOLITANA;0;0;0;0;0;0;0;0;0;Celular SAMSUNG A21s CLARO DIRECTO BLACK;TELEFONIA
19924462;;F;24;CHILENO;;Z;MELIPILLA                     ;METROPOLITANA;0;0;0;0;0;0;0;0;0;Celular A51 128GB LIB OPEN BLANCO;TELEFONIA
5092868;;M;77;CHILENO;;Silencioso;ALTO HOSPICIO;TARAPACA;0;0;0;0;0;0;0;0;0;Celular TIGER V SENIOR CLARO DIRECTO NEGRO;TELEFONIA
13158654;;M;44;CHILENO;;X;PROVIDENCIA                   ;METROPOLITANA;0;0;0;0;0;0;0;0;0;Celular A11 LIB OPEN BLUE;TELEFONIA
25173766;;M;38;HAITIANO;;Extranjero;LAMPA                         ;METROPOLITANA;0;0;0;0;0;0;0;0;0;Celular Y7P LIB OPEN NEGRO;TELEFONIA
15801575;;F;38;CHILENO;;Millenial;OVALLE                        ;COQUIMBO;0;0;0;0;0;0;0;0;0;CELULAR NOKIA 1.3 CYAN BLUE TRI ENTEL;TELEFONIA
11975967;;M;49;CHILENO;;X;PROVIDENCIA                   ;METROPOLITANA;0;0;0;0;0;0;0;0;0;Celular NOKIA 4.2 ENTEL DIRECTO NEGRO;TELEFONIA
15974663;;M;37;CHILENO;;Millenial;LIMACHE                       ;VALPARAISO;0;0;0;0;0;0;0;0;0;Celular NOVA 5T LIB OPEN BLACK;TELEFONIA
6091995;Casado;F;68;CHILENO;;Boomers;PROVIDENCIA                   ;METROPOLITANA;0;0;0;0;0;0;0;0;0;Celular A01 LIB OPEN NEGRO;TELEFONIA
16843784;;F;34;CHILENO;;Millenial;TEODORO SCHMIDT               ;ARAUCANIA;0;0;0;0;0;0;0;0;0;Celular Y5 NEO ENTEL DIRECTO BLACK;TELEFONIA
19006539;;F;27;CHILENO;;Z;CURICO                        ;MAULE;0;0;0;0;0;0;0;0;0;Celular A31 LIB OPEN AZUL;TELEFONIA
6892845;;M;68;CHILENO;;Boomers;PROVIDENCIA                   ;METROPOLITANA;0;0;0;0;0;0;0;0;0;Celular A01 LIB OPEN NEGRO;TELEFONIA
9243161;Soltero;M;61;CHILENO;;Boomers;RENCA                         ;METROPOLITANA;0;0;0;0;0;0;0;0;0;Celular A11 LIB OPEN BLACK;TELEFONIA
16142455;;M;37;CHILENO;;Millenial;PROVIDENCIA                   ;METROPOLITANA;0;0;0;0;0;0;0;0;0;Celular A51 128GB LIB OPEN BLACK;TELEFONIA
18976817;;F;27;CHILENO;;Millenial;PENAFLOR                      ;METROPOLITANA;0;0;0;0;0;0;0;0;0;Celular Y6 2019 WOM DIRECTO AZUL;TELEFONIA
18898733;;M;27;CHILENO;;Millenial;N/D;N/D;0;0;0;0;0;0;0;0;0;Celular A3 LITE ENTEL TRIANGULADO NEGRO;TELEFONIA
5821786;;M;69;CHILENO;;Silencioso;CHIGUAYANTE                   ;BIO BIO;0;0;0;0;0;0;0;0;0;CELULAR OWN 1026 AZUL ENTEL;TELEFONIA
16203354;;M;36;CHILENO;;Millenial;RENCA                         ;METROPOLITANA;0;0;0;0;0;0;0;0;0;CELULAR MOTO ONE FUSION 64GB VERDE 64GB OPEN;TELEFONIA
11612890;;F;51;CHILENO;;X;PROVIDENCIA                   ;METROPOLITANA;0;0;0;0;0;0;0;0;0;Celular A31 LIB OPEN AZUL;TELEFONIA
7946806;;M;62;CHILENO;;Boomers;PROVIDENCIA                   ;METROPOLITANA;0;0;0;0;0;0;0;0;0;Celular S10+ LIB OPEN BLANCO;TELEFONIA
26241093;;F;27;CHILENO;;Extranjero;SANTIAGO                      ;METROPOLITANA;0;0;0;0;0;0;0;0;0;Celular A11 LIB OPEN BLACK;TELEFONIA
19555267;;F;25;CHILENO;;Z;PROVIDENCIA                   ;METROPOLITANA;0;0;0;0;0;0;0;0;0;Celular SA3 CLARO DIRECTO BLACK;TELEFONIA
16066337;;M;36;CHILENO;;Millenial;PROVIDENCIA                   ;METROPOLITANA;0;0;0;0;0;0;0;0;0;Celular A11 LIB OPEN WHITE;TELEFONIA
11068757;Soltero;F;55;CHILENO;;Boomers;PROVIDENCIA                   ;METROPOLITANA;0;0;0;0;0;0;0;0;0;CELULAR HUAWEI Y8S BLACK TRI CLARO;TELEFONIA
12420241;;F;51;CHILENO;;X;OVALLE                        ;COQUIMBO;0;0;0;0;0;0;0;0;0;Celular A01 LIB OPEN ROJO;TELEFONIA
12604101;;F;55;CHILENO;;Boomers;RENCA                         ;METROPOLITANA;0;0;0;0;0;0;0;0;0;Celular Y7P LIB OPEN AZUL;TELEFONIA
17880719;;M;30;CHILENO;;Millenial;QUILICURA                     ;METROPOLITANA;0;0;0;0;0;0;0;0;0;Celular SAMSUNG A11 32GB ENTEL DIRECTO NEGRO;TELEFONIA
16346905;Soltero;F;35;CHILENO;INGENIERO COMERCIAL;Millenial;PROVIDENCIA                   ;METROPOLITANA;0;0;0;0;0;0;0;0;0;Celular SAMSUNG A11 32GB ENTEL DIRECTO NEGRO;TELEFONIA
13001704;Soltero;M;46;CHILENO;;X;PROVIDENCIA                   ;METROPOLITANA;0;0;0;0;0;0;0;0;0;Celular A01 LIB OPEN AZUL;TELEFONIA
12349846;;F;49;CHILENO;;X;RENCA                         ;METROPOLITANA;0;0;0;0;0;0;0;0;0;Celular A10S LIB OPEN BLUE;TELEFONIA
20307382;;F;22;CHILENO;;Z;PROVIDENCIA                   ;METROPOLITANA;0;0;0;0;0;0;0;0;0;Celular A71 LIB OPEN PLATEADO;TELEFONIA
6304860;;M;70;CHILENO;;Silencioso;ARICA                         ;ARICA Y PARINACOTA;0;0;0;0;0;0;0;0;0;Celular A20S LIB OPEN ROJO;TELEFONIA
13499777;;F;43;CHILENO;;X;PROVIDENCIA                   ;METROPOLITANA;0;0;0;0;0;0;0;0;0;Celular Y6 2019 WOM DIRECTO AZUL;TELEFONIA
11227317;;F;53;CHILENO;;X;PROVIDENCIA                   ;METROPOLITANA;0;0;0;0;0;0;0;0;0;CELULAR SAMSUNG A21S ROJO OPEN;TELEFONIA
17931163;Soltero;M;31;CHILENO;;Millenial;PROVIDENCIA                   ;METROPOLITANA;0;0;0;0;0;0;0;0;0;CELULAR MOTO ONE FUSION 64GB VERDE 64GB OPEN;TELEFONIA
10331830;;M;54;CHILENO;;X;NUEVA IMPERIAL                ;ARAUCANIA;0;0;0;0;0;0;0;0;0;Celular Y6 2019 WOM DIRECTO BLACK;TELEFONIA
14205615;;M;40;CHILENO;;X;MALLOA                        ;L.G.B.OÂ´HIGGINS;0;0;0;0;0;0;0;0;0;CELULAR SAMSUNG A21S ROJO OPEN;TELEFONIA
17490841;Soltero;M;31;CHILENO;;Millenial;PROVIDENCIA                   ;METROPOLITANA;0;0;0;0;0;0;0;0;0;IPHONE XS 64GB PLATEADO OPEN;TELEFONIA
9069640;;F;60;CHILENO;;Boomers;RENCA                         ;METROPOLITANA;0;0;0;0;0;0;0;0;0;CELULAR HUAWEI Y5P BLUE TRIANGULADO WOM;TELEFONIA
7972485;;F;61;CHILENO;;Boomers;VALLENAR;ATACAMA;0;0;0;0;0;0;0;0;0;Celular A01 LIB OPEN AZUL;TELEFONIA
8473538;Casado;M;63;CHILENO;;Boomers;RENCA                         ;METROPOLITANA;0;0;0;0;0;0;0;0;0;Celular J2 CORE CLARO DIRECTO NEGRO;TELEFONIA
14049103;Casado;F;40;CHILENO;;X;PROVIDENCIA                   ;METROPOLITANA;0;0;0;0;0;0;0;0;0;Celular A20S LIB OPEN ROJO;TELEFONIA
6839266;;F;68;CHILENO;;Silencioso;PROVIDENCIA                   ;METROPOLITANA;0;0;0;0;0;0;0;0;0;Celular Y6 2019 WOM DIRECTO BLACK;TELEFONIA
18032394;;M;30;CHILENO;;Millenial;PROVIDENCIA                   ;METROPOLITANA;0;0;0;0;0;0;0;0;0;Celular S20 + LIB OPEN CELESTE;TELEFONIA
10018250;;F;58;CHILENO;;Boomers;TALCA                         ;MAULE;0;0;0;0;0;0;0;0;0;Celular SA3 CLARO DIRECTO BLACK;TELEFONIA
13641412;;M;43;CHILENO;;X;PROVIDENCIA                   ;METROPOLITANA;0;0;0;0;0;0;0;0;0;BAM ZTE MF920 WOM;TELEFONIA
18974721;;M;27;CHILENO;;Millenial;SAN BERNARDO                  ;METROPOLITANA;0;0;0;0;0;0;0;0;0;Celular SAMSUNG A21s CLARO DIRECTO BLACK;TELEFONIA
15820380;;M;38;CHILENO;;Millenial;SANTIAGO;METROPOLITANA;0;0;0;0;0;0;0;0;0;Celular Y9S LIB OPEN BLACK;TELEFONIA
8713129;;F;46;CHILENO;;X;RENCA                         ;METROPOLITANA;0;0;0;0;0;0;0;0;0;Celular Y5 NEO ENTEL DIRECTO BLACK;TELEFONIA
19721637;;M;24;CHILENO;;Z;PAINE                         ;METROPOLITANA;0;0;0;0;0;0;0;0;0;IPHONE 7 32GB LIB OPEN NEGRO;TELEFONIA
11286194;;F;54;CHILENO;;X;TALCA                         ;MAULE;0;0;0;0;0;0;0;0;0;Celular A20S LIB OPEN AZUL;TELEFONIA
15453465;Soltero;F;40;CHILENO;;X;PROVIDENCIA                   ;METROPOLITANA;0;0;0;0;0;0;0;0;0;Celular A10S LIB OPEN BLUE;TELEFONIA
15152424;;M;40;CHILENO;;X;PROVIDENCIA                   ;METROPOLITANA;0;0;0;0;0;0;0;0;0;Celular SA3 CLARO DIRECTO BLACK;TELEFONIA
18152855;;F;29;CHILENO;;Millenial;PROVIDENCIA                   ;METROPOLITANA;0;0;0;0;0;0;0;0;0;CELULAR A11 CLARO DIRECTO BLACK;TELEFONIA
9793504;;F;62;CHILENO;;Boomers;RENCA                         ;METROPOLITANA;0;0;0;0;0;0;0;0;0;CELULAR HUAWEI Y8S NEGRO WOM;TELEFONIA
7876628;Soltero;F;60;CHILENO;PROFESOR;Boomers;RENCA                         ;METROPOLITANA;0;0;0;0;0;0;0;0;0;Celular A10S LIB OPEN NEGRO;TELEFONIA
5673745;;M;76;CHILENO;;Silencioso;TALCAHUANO                    ;BIO BIO;0;0;0;0;0;0;0;0;0;Celular Y5 NEO MOVISTAR DIRECTO BLACK;TELEFONIA
19142966;;M;26;CHILENO;;Z;SAN ANTONIO                   ;VALPARAISO;0;0;0;0;0;0;0;0;0;Celular A20S LIB OPEN NEGRO;TELEFONIA
22762130;;F;51;CHILENO;;Extranjero;TOCOPILLA                     ;ANTOFAGASTA;0;0;0;0;0;0;0;0;0;IPHONE 8 64 GB LIB OPEN DORADO;TELEFONIA
14394020;;F;53;CHILENO;;X;CALERA                        ;VALPARAISO;0;0;0;0;0;0;0;0;0;Celular Y6 2019 MOVISTAR DIRECTO BLUE;TELEFONIA
17387712;;F;32;CHILENO;;Millenial;CALERA                        ;VALPARAISO;0;0;0;0;0;0;0;0;0;CELULAR HUAWEI Y8S NEGRO WOM;TELEFONIA
26099674;;M;35;HAITIANO;;Extranjero;TEMUCO                        ;ARAUCANIA;0;0;0;0;0;0;0;0;0;Celular A20S LIB OPEN ROJO;TELEFONIA
14681576;;M;65;PERUANO;;Extranjero;SANTIAGO                      ;METROPOLITANA;0;0;0;0;0;0;0;0;0;Celular A11 LIB OPEN BLUE;TELEFONIA
17791421;;F;31;CHILENO;;Millenial;N/D;N/D;0;0;0;0;0;0;0;0;0;Celular A01 CORE MOVISTAR DIRECTO BLACK;TELEFONIA
6335528;;F;81;CHILENO;;Silencioso;VALDIVIA                      ;LOS RIOS;0;0;0;0;0;0;0;0;0;Celular SAMSUNG A01 CORE BLACK CLARO;TELEFONIA
18960718;;F;27;CHILENO;;Z;SANTIAGO                      ;METROPOLITANA;0;0;0;0;0;0;0;0;0;CELULAR SAMSUNG A21S NEGRO OPEN;TELEFONIA
7498954;Divorciado;F;64;CHILENO;MATRONA;Boomers;VINA DEL MAR                  ;VALPARAISO;0;0;0;0;0;0;0;0;0;Celular Y9 PRIME LIB OPEN VERDE;TELEFONIA
8402520;;M;51;CHILENO;;X;PUCHUNCAVI                    ;VALPARAISO;0;0;0;0;0;0;0;0;0;CELULAR Y8S MOVISTAR DIRECTO BLACK;TELEFONIA
7013600;;M;68;CHILENO;;Boomers;SAN RAMON                     ;METROPOLITANA;0;0;0;0;0;0;0;0;0;Celular NOKIA 1.3 NEGRO WOM;TELEFONIA
11539609;Casado;M;52;CHILENO;;X;PROVIDENCIA                   ;METROPOLITANA;0;0;0;0;0;0;0;0;0;Celular NOKIA 2.3 ENTEL DIRECTO CARBON;TELEFONIA
13204317;;F;44;CHILENO;;X;RENCA                         ;METROPOLITANA;0;0;0;0;0;0;0;0;0;Celular A3 LITE ENTEL TRIANGULADO NEGRO;TELEFONIA
8753759;;F;64;CHILENO;;Boomers;RENCA                         ;METROPOLITANA;0;0;0;0;0;0;0;0;0;Celular A11 LIB OPEN BLACK;TELEFONIA
16676638;;F;35;CHILENO;;Millenial;VILLA ALEMANA                 ;VALPARAISO;0;0;0;0;0;0;0;0;0;Celular A51 128GB LIB OPEN BLACK;TELEFONIA
7520825;Casado;F;66;CHILENO;;X;ALTO HOSPICIO;TARAPACA;0;0;0;0;0;0;0;0;0;CELULAR Y8S MOVISTAR DIRECTO BLACK;TELEFONIA
10718892;;M;49;CHILENO;;X;N/D;N/D;0;0;0;0;0;0;0;0;0;CELULAR SAMSUNG A21S AZUL OPEN;TELEFONIA
18118741;Soltero;M;30;CHILENO;;Millenial;PROVIDENCIA                   ;METROPOLITANA;0;0;0;0;0;0;0;0;0;Celular A10S LIB OPEN NEGRO;TELEFONIA
8418936;;F;62;CHILENO;;Boomers;TOME                          ;BIO BIO;0;0;0;0;0;0;0;0;0;Celular A10S LIB OPEN NEGRO;TELEFONIA
15824450;;F;42;CHILENO;;X;PUENTE ALTO                   ;METROPOLITANA;0;0;0;0;0;0;0;0;0;Celular A11 LIB OPEN BLUE;TELEFONIA
11836397;;M;51;CHILENO;;X;PROVIDENCIA                   ;METROPOLITANA;0;0;0;0;0;0;0;0;0;Celular A3 LITE ENTEL TRIANGULADO NEGRO;TELEFONIA
13861482;;F;44;CHILENO;;X;ARAUCO                        ;BIO BIO;0;0;0;0;0;0;0;0;0;Celular SAMSUNG A01 CORE AZUL ENTEL;TELEFONIA
6282137;Divorciado;F;66;CHILENO;PROFESOR;Boomers;SAN VICENTE                   ;L.G.B.OÂ´HIGGINS;0;0;0;0;0;0;0;0;0;Celular A3 LITE ENTEL TRIANGULADO NEGRO;TELEFONIA
18961418;;F;27;CHILENO;;Millenial;TALAGANTE                     ;METROPOLITANA;0;0;0;0;0;0;0;0;0;Celular A3 LITE ENTEL TRIANGULADO NEGRO;TELEFONIA
14189198;;F;40;CHILENO;;X;RANCAGUA;O HIGGINS;0;0;0;0;0;0;0;0;0;Celular A10S LIB OPEN NEGRO;TELEFONIA
14472945;;M;46;CHILENO;;X;SAGRADA FAMILIA               ;MAULE;0;0;0;0;0;0;0;0;0;CELULAR SAMSUNG A21S AZUL OPEN;TELEFONIA
8743097;Soltero;M;62;CHILENO;;Boomers;PROVIDENCIA                   ;METROPOLITANA;0;0;0;0;0;0;0;0;0;Celular TIGER V SENIOR CLARO DIRECTO NEGRO;TELEFONIA
19273898;;M;26;CHILENO;;Millenial;SAN FERNANDO;O HIGGINS;0;0;0;0;0;0;0;0;0;Celular Y9 PRIME LIB OPEN VERDE;TELEFONIA
10803700;;F;54;CHILENO;;X;MULCHEN                       ;BIO BIO;0;0;0;0;0;0;0;0;0;Celular A20S LIB OPEN ROJO;TELEFONIA
6045323;;F;67;CHILENO;;Boomers;ARAUCO                        ;BIO BIO;0;0;0;0;0;0;0;0;0;Celular G8 POWER LITE WOM DIRECTO TURQUESA;TELEFONIA
13773352;;F;41;CHILENO;;X;RENCA                         ;METROPOLITANA;0;0;0;0;0;0;0;0;0;Celular Y9 PRIME LIB OPEN VERDE;TELEFONIA
11188301;;M;55;CHILENO;;Boomers;ILLAPEL                       ;COQUIMBO;0;0;0;0;0;0;0;0;0;Celular SAMSUNG A21s CLARO DIRECTO BLACK;TELEFONIA
10254568;;M;57;CHILENO;;Boomers;RENCA                         ;METROPOLITANA;0;0;0;0;0;0;0;0;0;Celular A11 LIB OPEN BLUE;TELEFONIA
17636467;;M;32;CHILENO;;Millenial;PROVIDENCIA                   ;METROPOLITANA;0;0;0;0;0;0;0;0;0;Celular A10S LIB OPEN NEGRO;TELEFONIA
10246567;;M;57;CHILENO;;Boomers;CAUQUENES                     ;MAULE;0;0;0;0;0;0;0;0;0;Celular A10S LIB OPEN NEGRO;TELEFONIA
13101166;;F;45;CHILENO;;X;SAN CLEMENTE                  ;MAULE;0;0;0;0;0;0;0;0;0;Celular A01 LIB OPEN NEGRO;TELEFONIA
7303963;;M;66;CHILENO;;Boomers;RENCA                         ;METROPOLITANA;0;0;0;0;0;0;0;0;0;CELULAR HUAWEI Y5P CLARO DIRECTO BLUE;TELEFONIA
9293520;Casado;M;59;CHILENO;;Boomers;PROVIDENCIA                   ;METROPOLITANA;0;0;0;0;0;0;0;0;0;Celular A20S LIB OPEN NEGRO;TELEFONIA
15684970;;M;38;CHILENO;;X;PROVIDENCIA                   ;METROPOLITANA;0;0;0;0;0;0;0;0;0;Celular P30 LITE PLUS LIB OPEN BLACK;TELEFONIA
18470975;;F;28;CHILENO;;Millenial;RIO IBANEZ                    ;AYSEN;0;0;0;0;0;0;0;0;0;Celular A31 LIB OPEN ROJO;TELEFONIA
15598473;;M;38;CHILENO;;X;SAN RAFAEL                    ;MAULE;0;0;0;0;0;0;0;0;0;Celular Y9S LIB OPEN BREATHING CRYSTAL;TELEFONIA
10617547;Soltero;F;56;CHILENO;PROFESOR;Boomers;RENCA                         ;METROPOLITANA;0;0;0;0;0;0;0;0;0;CELULAR MOTO ONE FUSION 64GB VERDE 64GB OPEN;TELEFONIA
14017600;;M;40;CHILENO;;X;PROVIDENCIA                   ;METROPOLITANA;0;0;0;0;0;0;0;0;0;Celular A01 CLARO DIRECTO BLACK;TELEFONIA
18312640;Soltero;F;29;CHILENO;;Millenial;PROVIDENCIA                   ;METROPOLITANA;0;0;0;0;0;0;0;0;0;Celular P30 LIB OPEN AURORA;TELEFONIA
16760419;;M;34;CHILENO;;Millenial;PROVIDENCIA                   ;METROPOLITANA;0;0;0;0;0;0;0;0;0;Celular A3 LITE ENTEL TRIANGULADO NEGRO;TELEFONIA
15099666;;F;40;CHILENO;;X;PROVIDENCIA                   ;METROPOLITANA;0;0;0;0;0;0;0;0;0;Celular Y6 2019 CLARO DIRECTO BLACK;TELEFONIA
15217256;;M;39;CHILENO;;Extranjero;CHILLAN VIEJO                 ;BIO BIO;0;0;0;0;0;0;0;0;0;CELULAR HUAWEI Y6P BLACK TEL;TELEFONIA
12852195;;F;47;CHILENO;;X;RENCA                         ;METROPOLITANA;0;0;0;0;0;0;0;0;0;Celular A20S LIB OPEN AZUL;TELEFONIA
9767663;;M;59;CHILENO;;Boomers;CERRO NAVIA                   ;METROPOLITANA;0;0;0;0;0;0;0;0;0;Celular A01 LIB OPEN ROJO;TELEFONIA
13673781;;F;45;CHILENO;;X;RENCA                         ;METROPOLITANA;0;0;0;0;0;0;0;0;0;Celular A11 LIB OPEN BLUE;TELEFONIA
19292592;;F;26;CHILENO;;Millenial;"";"";0;0;0;0;0;0;0;0;0;CELULAR MOTO ONE FUSION 64GB VERDE 64GB OPEN;TELEFONIA
12668148;;M;48;CHILENO;;X;PROVIDENCIA                   ;METROPOLITANA;0;0;0;0;0;0;0;0;0;Celular Y5 NEO CLARO DIRECTO BLACK;TELEFONIA
22248911;;M;35;CHILENO;;Millenial;SAN CARLOS                    ;BIO BIO;0;0;0;0;0;0;0;0;0;Celular A51 128GB LIB OPEN BLACK;TELEFONIA
11206050;;F;55;CHILENO;;Boomers;LA CISTERNA                   ;METROPOLITANA;0;0;0;0;0;0;0;0;0;Celular A11 LIB OPEN WHITE;TELEFONIA
9129523;Casado;M;60;CHILENO;TECNICO;Boomers;PROVIDENCIA                   ;METROPOLITANA;0;0;0;0;0;0;0;0;0;Celular Y9 PRIME LIB OPEN VERDE;TELEFONIA
17295562;;M;32;CHILENO;;Millenial;PROVIDENCIA                   ;METROPOLITANA;0;0;0;0;0;0;0;0;0;CELULAR MOTO ONE FUSION 64GB VERDE 64GB OPEN;TELEFONIA
14071020;;M;41;CHILENO;;X;CURANILAHUE                   ;BIO BIO;0;0;0;0;0;0;0;0;0;CELULAR SAMSUNG A80 BLACK OPEN;TELEFONIA
19426620;;F;26;CHILENO;;Z;PROVIDENCIA                   ;METROPOLITANA;0;0;0;0;0;0;0;0;0;Celular P40 LITE LIB OPEN BLACK;TELEFONIA
17706069;;F;31;CHILENO;;Millenial;PROVIDENCIA                   ;METROPOLITANA;0;0;0;0;0;0;0;0;0;Celular A31 LIB OPEN BLACK;TELEFONIA
12280683;;F;49;CHILENO;;X;SAN RAMON                     ;METROPOLITANA;0;0;0;0;0;0;0;0;0;Celular A51 128GB LIB OPEN BLACK;TELEFONIA
20037413;;F;23;CHILENO;;Z;N/D;N/D;0;0;0;0;0;0;0;0;0;Celular Y5 NEO ENTEL DIRECTO BLACK;TELEFONIA
8429018;;F;77;CHILENO;;Silencioso;PROVIDENCIA                   ;METROPOLITANA;0;0;0;0;0;0;0;0;0;Celular TIGER V SENIOR CLARO DIRECTO NEGRO;TELEFONIA
15399239;;M;39;CHILENO;;X;PROVIDENCIA                   ;METROPOLITANA;0;0;0;0;0;0;0;0;0;BAM ZTE MF920 WOM;TELEFONIA
18008774;;F;30;CHILENO;;Millenial;ANGOL                         ;ARAUCANIA;0;0;0;0;0;0;0;0;0;Celular Y9 PRIME LIB OPEN VERDE;TELEFONIA
17435873;Soltero;M;32;CHILENO;INGENIERO MECANICO;Millenial;PROVIDENCIA                   ;METROPOLITANA;0;0;0;0;0;0;0;0;0;CELULAR HUAWEI Y8S BLACK TRI CLARO;TELEFONIA
12924261;;F;46;CHILENO;;X;RENCA                         ;METROPOLITANA;0;0;0;0;0;0;0;0;0;CELULAR HUAWEI Y5 NEO NEGRO WOM;TELEFONIA
17078295;;F;33;CHILENO;;Millenial;NOGALES                       ;VALPARAISO;0;0;0;0;0;0;0;0;0;Celular G8 POWER LITE WOM DIRECTO TURQUESA;TELEFONIA
17196825;;M;30;CHILENO;;Millenial;SAN CARLOS                    ;BIO BIO;0;0;0;0;0;0;0;0;0;Celular A51 128GB LIB OPEN AZUL;TELEFONIA
15909179;;F;37;CHILENO;;Millenial;PROVIDENCIA                   ;METROPOLITANA;0;0;0;0;0;0;0;0;0;Celular A20S LIB OPEN ROJO;TELEFONIA
5572794;;M;70;CHILENO;;Silencioso;PROVIDENCIA                   ;METROPOLITANA;0;0;0;0;0;0;0;0;0;CELULAR HUAWEI Y5P CLARO DIRECTO BLUE;TELEFONIA
18533646;;F;28;CHILENO;;Millenial;PROVIDENCIA                   ;METROPOLITANA;0;0;0;0;0;0;0;0;0;Celular A51 128GB LIB OPEN AZUL;TELEFONIA
9281071;Casado;F;60;CHILENO;PROFESOR;Boomers;PROVIDENCIA                   ;METROPOLITANA;0;0;0;0;0;0;0;0;0;Celular Y6 2019 WOM DIRECTO BLACK;TELEFONIA
26082790;;M;40;VENEZOLANO;;Extranjero;N/D;N/D;0;0;0;0;0;0;0;0;0;CELULAR HUAWEI P30 LITE PLUS PIEDRA DE LUNA OPEN;TELEFONIA
17667972;;M;31;CHILENO;;Millenial;PROVIDENCIA                   ;METROPOLITANA;0;0;0;0;0;0;0;0;0;Celular A51 128GB LIB OPEN AZUL;TELEFONIA
15446384;;F;39;CHILENO;;X;LOLOL                         ;L.G.B.OÂ´HIGGINS;0;0;0;0;0;0;0;0;0;Celular G8 POWER LITE MOVISTAR DIRECTO AZUL;TELEFONIA
14425446;;F;48;CHILENO;;X;VILLA ALEMANA                 ;VALPARAISO;0;0;0;0;0;0;0;0;0;Celular A10S LIB OPEN NEGRO;TELEFONIA
10405573;;F;52;CHILENO;;X;RANCAGUA                      ;L.G.B.OÂ´HIGGINS;0;0;0;0;0;0;0;0;0;Celular P30 LITE LIB OPEN AZUL;TELEFONIA
15790680;;F;38;CHILENO;;Millenial;PROVIDENCIA                   ;METROPOLITANA;0;0;0;0;0;0;0;0;0;Celular A51 128GB LIB OPEN BLACK;TELEFONIA
15851069;;F;39;CHILENO;;X;N/D;N/D;0;0;0;0;0;0;0;0;0;Celular A20S ENTEL TRIANGULADO NEGRO;TELEFONIA
15542519;;M;39;CHILENO;;X;PROVIDENCIA                   ;METROPOLITANA;0;0;0;0;0;0;0;0;0;Celular A51 128GB LIB OPEN AZUL;TELEFONIA
15446711;;F;39;CHILENO;;X;PROVIDENCIA                   ;METROPOLITANA;417960;4;2;4;2;417960;0;0;0;GALAXY WATCH ACTIVE4 40 MM GOLD;ACCESORIOS
11663473;;M;52;CHILENO;;X;RENCA                         ;METROPOLITANA;24990;1;1;0;0;0;1;1;24990;Parlante Bluetooth Blik Booster 1;ACCESORIOS
14041370;;M;41;CHILENO;;X;ANCUD                         ;LOS LAGOS;121980;2;2;0;0;0;2;2;121980;KIT PREPAGO HD DIRECTV;ACCESORIOS
13858717;;F;42;CHILENO;;X;PROVIDENCIA                   ;METROPOLITANA;16980;2;1;2;1;16980;0;0;0;MICROFONO KARAOKE LIL VOICE SOPORTE METAL GOLD;ACCESORIOS
10623702;;F;53;CHILENO;;X;PROVIDENCIA                   ;METROPOLITANA;109990;1;1;1;1;109990;0;0;0;Galaxy Watch Active4 40 mm Black;ACCESORIOS
19283442;Soltero;F;26;CHILENO;;Z;PROVIDENCIA                   ;METROPOLITANA;28980;2;1;2;1;28980;0;0;0;AUDIFONO WH-CH510/BZ UC;ACCESORIOS
12007399;;F;43;CHILENO;;X;PROVIDENCIA                   ;METROPOLITANA;75940;6;3;6;3;75940;0;0;0;Mousepad Gamer M901;ACCESORIOS
26523039;;M;29;NO INFORMA NACIONALIDAD;;Millenial;N/D;N/D;66060;2;1;0;0;0;2;1;66060;FREEBUDS 4i BLACK HUAWEI;ACCESORIOS
15850736;;F;37;CHILENO;;Millenial;LOS ANGELES                   ;BIO BIO;36980;2;4;0;0;0;2;4;36980;Parlante Karaoke Blik Screamer 2;ACCESORIOS
16835967;;M;34;CHILENO;;Millenial;N/D;N/D;390211;10;6;2;1;175480;8;5;214731;TYPE C TO TYPE C CABLE 3A (MAX 60W);ACCESORIOS
10032645;;M;43;CHILENO;;X;LOS ANGELES                   ;BIO BIO;249200;6;4;0;0;0;6;4;249200;SOPORTE TV 26-56 KTA02 KIOTO FIJO;ACCESORIOS
18557572;Soltero;M;28;CHILENO;;Millenial;LAS CONDES;METROPOLITANA;7990;1;1;1;1;7990;0;0;0;TYPE C TO TYPE C CABLE 3A (MAX 60W);ACCESORIOS
12865083;;F;47;CHILENO;;X;TOCOPILLA                     ;ANTOFAGASTA;678701;5;5;0;0;0;5;5;678701;DISCO DURO CANVIO 2TB BASICS BLACK TOSHIBA;ACCESORIOS
18784094;Soltero;F;27;CHILENO;;Z;PROVIDENCIA                   ;METROPOLITANA;9990;1;1;1;1;9990;0;0;0;Mousepad Gamer M905;ACCESORIOS
13790606;;F;44;CHILENO;;X;LINARES                       ;MAULE;24980;2;2;0;0;0;2;2;24980;Kit gamer 3 en 1;ACCESORIOS
16433819;Casado;F;36;CHILENO;PROFESOR;Millenial;LA ESTRELLA                   ;L.G.B.OÂ´HIGGINS;321960;4;3;0;0;0;4;3;321960;SOPORTE TV 26-56 KTA02 KIOTO FIJO;ACCESORIOS
16023244;;F;37;CHILENO;;Millenial;CURICO                        ;MAULE;137363;5;6;0;0;0;5;6;137363;MEMORIA MICROSD CLASE 10 32GB SANDISK;ACCESORIOS
13850571;;F;44;CHILENO;;X;N/D;N/D;45830;3;2;0;0;0;3;2;45830;ALTEC LANSING AUDIFONO Nano Pods TWS ICE BLUE 89;ACCESORIOS
17448001;;F;32;CHILENO;;Millenial;PROVIDENCIA                   ;METROPOLITANA;167970;3;3;0;0;0;3;3;167970;SOPORTE TV 26-56 KTAT02 KIOTO MOVIL;ACCESORIOS
13158736;;M;50;CHILENO;;X;"";"";159990;1;1;0;0;0;1;1;159990;Silla Gamer Tyrus Negra;ACCESORIOS
20321082;;F;22;CHILENO;;Z;N/D;N/D;18990;1;1;0;0;0;1;1;18990;TWS EARPHONE WITH CHARGING CASE BLANCO FIDDLER;ACCESORIOS
13067264;Soltero;F;46;CHILENO;CONTADOR GENERAL;Silencioso;PROVIDENCIA                   ;METROPOLITANA;5990;1;1;1;1;5990;0;0;0;TECLADO PC 100 NEGRO;ACCESORIOS
17371430;Soltero;M;32;CHILENO;TECNICO DE NIVEL SUPERIOR EN ENFERMERIA;Millenial;PROVIDENCIA                   ;METROPOLITANA;13990;1;1;0;0;0;1;1;13990;SAMSUNG TYPE-C EARPHONES BLACK;ACCESORIOS
20456005;;F;21;CHILENO;;Z;LA FLORIDA;METROPOLITANA;184970;3;2;3;2;184970;0;0;0;MOUSE ALAMBRICO GAMER NEGRO M100;ACCESORIOS
19195294;;F;26;CHILENO;;Z;PROVIDENCIA                   ;METROPOLITANA;117980;2;1;2;1;117980;0;0;0;GALAXY WATCH ACTIVE4 40 MM GOLD;ACCESORIOS
13859467;;F;42;CHILENO;;X;CHILLAN                       ;BIO BIO;117950;5;2;0;0;0;5;2;117950;Mouse Bluetooth Hdwr Black;ACCESORIOS
8033471;;F;66;CHILENO;;Boomers;LA SERENA                     ;COQUIMBO;1135880;24;22;0;0;0;24;22;1135880;SOPORTE TV 26-56 KTA02 KIOTO FIJO;ACCESORIOS
13515769;;M;43;CHILENO;;X;PROVIDENCIA                   ;METROPOLITANA;51950;5;3;0;0;0;5;3;51950;SOPORTE TV 26-56 KTA02 KIOTO FIJO;ACCESORIOS
13543866;;F;43;CHILENO;;X;N/D;N/D;22990;1;1;0;0;0;1;1;22990;SOPORTE ARTICULADO FULL MOTION 32-55 PULGADAS;ACCESORIOS
13716151;;M;42;CHILENO;;X;MAIPU                         ;METROPOLITANA;492960;4;2;4;2;492960;0;0;0;DISCO DURO CANVIO 2TB BASICS BLACK TOSHIBA;ACCESORIOS
18640936;;F;28;CHILENO;;Millenial;N/D;N/D;306980;2;2;2;2;306980;0;0;0;SOPORTE TV 26-56 KTA02 KIOTO FIJO;ACCESORIOS
12837653;;F;47;CHILENO;;X;"";"";963580;9;5;2;1;128640;7;4;834940;Escritorio Gamer RGB;ACCESORIOS
16972497;;M;33;CHILENO;;Millenial;QUILPUE                       ;VALPARAISO;31970;3;3;0;0;0;3;3;31970;Mouse Gamer Expert M814;ACCESORIOS
13093384;;F;45;CHILENO;;X;SAN RAMON                     ;METROPOLITANA;1270360;30;14;0;0;0;30;14;1270360;Producto segunda seleccion Banda 1;ACCESORIOS
19707068;;M;24;CHILENO;;Extranjero;PROVIDENCIA                   ;N/D;12990;1;1;1;1;12990;0;0;0;SAMSUNG TYPE-C EARPHONES BLACK;ACCESORIOS
19169732;;M;26;CHILENO;;Z;SAN CARLOS;BIO-BIO;86980;2;2;0;0;0;2;2;86980;ARO DE LUZ LED 10 PULGADAS + TRIPODE PEQUENO;ACCESORIOS
16339816;;M;36;CHILENO;;Millenial;N/D;N/D;44970;3;1;0;0;0;3;1;44970;SAMSUNG TYPE-C EARPHONES BLACK;ACCESORIOS
15978053;;F;37;CHILENO;;Millenial;SAN FELIPE                    ;VALPARAISO;6990;1;1;0;0;0;1;1;6990;SOPORTE TV 26-56 KTA02 KIOTO FIJO;ACCESORIOS
20276903;;M;22;CHILENO;;Z;N/D;N/D;285130;4;2;2;1;258540;2;1;26590;SAMSUNG TYPE-C EARPHONES BLACK;ACCESORIOS
17683818;;M;31;CHILENO;;Millenial;PROVIDENCIA                   ;METROPOLITANA;77960;4;4;4;4;77960;0;0;0;Reloj Smartwatch Lhotse Track M7 GPS Negro Amari;ACCESORIOS
16426930;Casado;M;36;CHILENO;;Millenial;PROVIDENCIA                   ;METROPOLITANA;6990;1;1;0;0;0;1;1;6990;SOPORTE TV 26-56 KTA02 KIOTO FIJO;ACCESORIOS
20162022;Soltero;M;39;CHILENO;;X;RENCA                         ;METROPOLITANA;120830;3;1;0;0;0;3;1;120830;New GAMEPAD - GLAP;ACCESORIOS
19413001;;F;25;CHILENO;;Z;MELIPILLA                     ;METROPOLITANA;269970;4;3;0;0;0;4;3;269970;Mouse Inalambrico Azul;ACCESORIOS
20449767;;F;21;CHILENO;;Z;SAN RAMON;METROPOLITANA;73980;2;1;2;1;73980;0;0;0;AUDIFONO GALAXY BUDS2 VIOLET;ACCESORIOS
19635118;;M;25;CHILENO;;Z;"";"";21970;3;1;3;1;21970;0;0;0;PARLANTE 6985 MLAB VERTICAL BRITPOP BT;ACCESORIOS
14257991;;F;48;CHILENO;;X;PROVIDENCIA                   ;METROPOLITANA;145009;5;3;0;0;0;5;3;145009;ALTEC LANSING AUDIFONO HEADBAND BLUETOOTH COMFOR;ACCESORIOS
18061208;Soltero;F;30;CHILENO;INGENIERO CIVIL INDUSTRIAL;Extranjero;PROVIDENCIA                   ;METROPOLITANA;44990;1;1;1;1;44990;0;0;0;DISCO DURO CANVIO 1TB BASICS BLACK TOSHIBA;ACCESORIOS
19005317;Soltero;M;27;CHILENO;;Extranjero;PROVIDENCIA                   ;METROPOLITANA;23970;3;1;3;1;23970;0;0;0;Mousepad Gamer M905;ACCESORIOS
7109317;;F;65;CHILENO;;Boomers;LA FLORIDA                    ;METROPOLITANA;65960;4;2;0;0;0;4;2;65960;Teclado Gamer Pro M858;ACCESORIOS
12132060;;F;43;CHILENO;;X;PROVIDENCIA                   ;METROPOLITANA;67980;2;1;2;1;67980;0;0;0;HHSS1C-KB-WT/G AUDIFONO HYPERX CLOUD STINGER COR;ACCESORIOS
19084748;;M;27;CHILENO;;Z;OSORNO                        ;LOS LAGOS;33230;3;1;0;0;0;3;1;33230;Audifonos Gamer Expert MF6;ACCESORIOS
10000899;;F;56;CHILENO;;Boomers;AISEN                         ;AYSEN;224960;4;3;0;0;0;4;3;224960;Silla Gamer Guardian Roja;ACCESORIOS
16642284;;F;35;CHILENO;;Millenial;PROVIDENCIA                   ;METROPOLITANA;8990;1;1;0;0;0;1;1;8990;Mi Compact Bluetooth Speaker 2;ACCESORIOS
20420175;;F;22;CHILENO;;Z;N/D;N/D;89980;2;2;1;1;39990;1;1;49990;AUDIFONOS IN-EAR TRULY WIRELESS JBL W100 TWS BLA;ACCESORIOS
12605381;;M;47;CHILENO;;X;N/D;N/D;376720;3;2;0;0;0;3;2;376720;SOPORTE TV 26-56 KTA02 KIOTO FIJO;ACCESORIOS
16648067;Soltero;F;34;CHILENO;ADMINISTRACION DE EMPRESAS;Millenial;PROVIDENCIA                   ;METROPOLITANA;6990;1;1;1;1;6990;0;0;0;TYPE C TO TYPE C CABLE 3A (MAX 60W);ACCESORIOS
14147766;;M;40;CHILENO;;X;PROVIDENCIA                   ;METROPOLITANA;193810;19;5;19;5;193810;0;0;0;PARLANTES PARA GAMER PARA PC TARGA DIAMOND X;ACCESORIOS
12147018;;F;48;CHILENO;;X;VINA DEL MAR                  ;VALPARAISO;269980;2;1;0;0;0;2;1;269980;Silla Gamer Balderi Negra;ACCESORIOS
12982936;;F;46;CHILENO;;X;SANTIAGO                      ;METROPOLITANA;12990;1;3;1;3;12990;0;0;0;SAMSUNG TYPE-C EARPHONES BLACK;ACCESORIOS
7280166;Casado;M;67;CHILENO;;Boomers;NANCAGUA                      ;L.G.B.OÂ´HIGGINS;66260;3;1;0;0;0;3;1;66260;PARLANTE KARAOKE FD-PKBT82 8 LUCES MIC/FM/BT/USB;ACCESORIOS
17714227;;M;32;CHILENO;;Millenial;ANCUD                         ;LOS LAGOS;6990;1;1;0;0;0;1;1;6990;SOPORTE TV 26-56 KTA02 KIOTO FIJO;ACCESORIOS
16392947;;F;35;CHILENO;;Millenial;CURICO;MAULE;22990;1;5;0;4;0;1;1;22990;AUDIFONO XIAOMI EARBUDS MI TRUE WIRELESS BASIC 2;ACCESORIOS
16804773;;F;34;CHILENO;;Millenial;RECOLETA;METROPOLITANA;61980;2;1;2;1;61980;0;0;0;Reloj Smartwatch Lhotse Runner 219 Gray;ACCESORIOS
12521893;;M;49;CHILENO;;X;TALCA                         ;MAULE;439150;3;2;0;0;0;3;2;439150;SOPORTE TV 26-56 KTA02 KIOTO FIJO;ACCESORIOS
26145966;;M;29;HAITIANO;;Extranjero;ESTACION CENTRAL              ;METROPOLITANA;286200;6;2;0;0;0;6;2;286200;ALTEC LANSING AUDIFONO HEADBAND BLUETOOTH COMFOR;ACCESORIOS
20311959;;F;21;CHILENO;;Z;MELIPILLA;METROPOLITANA;139980;2;2;1;1;69990;1;1;69990;AUDIFONO GALAXY BUDS2 VIOLET;ACCESORIOS
20031947;;F;23;CHILENO;;Z;PROVIDENCIA                   ;METROPOLITANA;198960;4;2;2;1;178980;2;1;19980;TRAVEL ADAPTER 15W - FAST CHARGER (TYPE-C CABLE);ACCESORIOS
26572465;;F;25;NO INFORMA NACIONALIDAD;;Extranjero;"";"";28980;2;1;2;1;28980;0;0;0;PARLANTE BLUETOOTH JBL GO 2 AZUL;ACCESORIOS
17050611;Soltero;F;33;CHILENO;SECRETARIA;Millenial;PROVIDENCIA                   ;METROPOLITANA;14990;1;1;1;1;14990;0;0;0;SAMSUNG TYPE-C EARPHONES WHITE;ACCESORIOS
15407456;;F;40;CHILENO;;X;PROVIDENCIA                   ;METROPOLITANA;8990;1;1;0;0;0;1;1;8990;SOPORTE TV 32-65 KTA03 KIOTO FIJO;ACCESORIOS
13778898;;F;41;CHILENO;;X;TALAGANTE                     ;METROPOLITANA;343950;5;4;2;1;123980;3;3;219970;SOPORTE TV 14-42 KTAM02 KIOTO C/ BRAZO MOVIL;ACCESORIOS
13031344;;M;46;CHILENO;;X;N/D;N/D;19990;1;1;0;0;0;1;1;19990;Audifonos Gamer Expert MF6;ACCESORIOS
19395194;;F;25;CHILENO;;Millenial;N/D;N/D;6990;1;1;0;0;0;1;1;6990;SOPORTE TV 26-56 KTA02 KIOTO FIJO;ACCESORIOS
17945519;Soltero;F;30;CHILENO;;Millenial;PROVIDENCIA                   ;METROPOLITANA;87980;2;1;2;1;87980;0;0;0;Silla Gamer Tyrus Blanco rosadosa;ACCESORIOS
11085818;;F;56;CHILENO;;Boomers;COLLIPULLI                    ;ARAUCANIA;184970;3;2;0;0;0;3;2;184970;SOPORTE TV 14-42 KTAM02 KIOTO C/ BRAZO MOVIL;ACCESORIOS
12393193;;F;49;CHILENO;;X;RENCA                         ;METROPOLITANA;7990;1;1;1;1;7990;0;0;0;SOPORTE TV 26-56 KTAT02 KIOTO MOVIL;ACCESORIOS
18657335;;F;27;CHILENO;;Millenial;PROVIDENCIA                   ;METROPOLITANA;12990;1;1;1;1;12990;0;0;0;SOPORTE TV 14-63 CON BRAZO KT-FM 3L;ACCESORIOS
22628717;;M;65;PERUANO;;Extranjero;ESTACION CENTRAL              ;METROPOLITANA;79990;1;1;0;0;0;1;1;79990;HUAWEI WATCH FIT NEW SAKURA PINK;ACCESORIOS
19678343;;M;24;CHILENO;;Z;RIO HURTADO;COQUIMBO;196991;4;2;1;1;6990;3;1;190001;SOPORTE TV 26-56 KTAT02 KIOTO MOVIL;ACCESORIOS
9087592;;F;58;CHILENO;;Boomers;CHILLAN                       ;BIO BIO;12990;1;1;0;0;0;1;1;12990;SOPORTE TV 14-42 KTAM02 KIOTO C/ BRAZO MOVIL;ACCESORIOS
17314657;;F;32;CHILENO;;Millenial;CAUQUENES                     ;MAULE;2451920;56;43;0;0;0;56;43;2451920;SOPORTE TV 26-56 KTA02 KIOTO FIJO;ACCESORIOS
19301262;Soltero;M;26;CHILENO;;Z;PROVIDENCIA                   ;METROPOLITANA;143960;4;4;0;0;0;4;4;143960;10000mAh Mi 18W Fast Charge Power Bank 3 (Black);ACCESORIOS
19296191;Soltero;F;26;CHILENO;;Z;ILLAPEL                       ;COQUIMBO;50980;2;2;0;0;0;2;2;50980;AUDIFONO XIAOMI EARPHONES MI TRUE WIRELESS 2 BAS;ACCESORIOS
19699252;;M;25;CHILENO;;Z;PROVIDENCIA                   ;METROPOLITANA;43980;2;1;2;1;43980;0;0;0;HUAWEI FREEBUDS 4i SILVER FROST;ACCESORIOS
20272198;;M;22;CHILENO;;Z;"";"";12000;2;1;0;0;0;2;1;12000;SAMSUNG TYPE-C EARPHONES BLACK;ACCESORIOS
19329414;;F;25;CHILENO;;Z;VALPARAISO;VALPARAISO;128320;5;3;0;0;0;5;3;128320;AUDIFONO MOTOROLA BLUETOOTH ESCAPE 220 BLANCO;ACCESORIOS
17242509;;M;33;CHILENO;;Millenial;"";"";3990;1;1;0;0;0;1;1;3990;CABLE DE DATOS MICRO HUAWEI USB AP70;ACCESORIOS
15924670;;F;38;CHILENO;;Millenial;N/D;N/D;47440;6;4;0;0;0;6;4;47440;AUDIFONO PANASONIC IN RP-HV096E-K NEGRO;ACCESORIOS
17429482;;M;31;CHILENO;;Millenial;QUILICURA;METROPOLITANA;213970;3;1;3;1;213970;0;0;0;GALAXY WATCH4 42 MM SILVER;ACCESORIOS
26064507;;F;38;NO INFORMA NACIONALIDAD;;Extranjero;PROVIDENCIA                   ;METROPOLITANA;11990;1;1;1;1;11990;0;0;0;SAMSUNG TYPE-C EARPHONES WHITE;ACCESORIOS
14224865;;F;40;CHILENO;;X;PANGUIPULLI                   ;LOS RIOS;76970;3;3;0;0;0;3;3;76970;TRAVEL ADAPTER 15W - FAST CHARGER (TYPE-C CABLE);ACCESORIOS
10175808;;M;58;CHILENO;;Boomers;N/D;N/D;2000;2;1;0;0;0;2;1;2000;AUDIFONO PANASONIC IN RP-HV096E-K NEGRO;ACCESORIOS
16590436;;F;34;CHILENO;;Millenial;CONSTITUCION                  ;MAULE;58980;2;2;0;0;0;2;2;58980;PARLANTE BLUETOOTH BABYBOOM XL;ACCESORIOS
19255380;;M;26;CHILENO;;Z;COPIAPO                       ;ATACAMA;23240;2;1;0;0;0;2;1;23240;AUDIFONO MOTOROLA BLUETOOTH ESCAPE 220 BLANCO;ACCESORIOS
19118553;;M;26;CHILENO;;Z;SAN BERNARDO                  ;METROPOLITANA;46980;2;1;2;1;46980;0;0;0;AUDIFONOS IN-EAR TRULY WIRELESS JBL W100 TWS BLA;ACCESORIOS
10003710;;F;58;CHILENO;;Extranjero;HUASCO                        ;ATACAMA;25990;1;1;0;0;0;1;1;25990;Redmi Buds 3 Lite Black;ACCESORIOS
15694378;;F;38;CHILENO;;X;COQUIMBO                      ;COQUIMBO;27980;2;1;2;1;27980;0;0;0;AUDIFONO SAMSUNG WIRELESS 103B;ACCESORIOS
18029395;;F;29;CHILENO;;Millenial;"";"";29980;2;1;0;0;0;2;1;29980;Travel Adapter SFC 25W Type C (w/o Cable);ACCESORIOS
8784645;;M;63;CHILENO;;Boomers;COLTAUCO                      ;L.G.B.OÂ´HIGGINS;139960;4;2;0;0;0;4;2;139960;SOPORTE TV 32-65 KTA03 KIOTO FIJO;ACCESORIOS
19302706;Soltero;M;25;CHILENO;;Z;PROVIDENCIA                   ;METROPOLITANA;12990;1;1;0;0;0;1;1;12990;SOPORTE TV 14-63 CON BRAZO KT-FM 3L;ACCESORIOS
18268028;;F;29;CHILENO;;Millenial;SAN CARLOS                    ;BIO BIO;165830;3;2;2;1;145840;1;1;19990;ALTEC LANSING AUDIFONO Nano Pods TWS ICE BLUE 89;ACCESORIOS
20230629;;M;22;CHILENO;;Silencioso;PROVIDENCIA                   ;METROPOLITANA;901120;7;4;0;0;0;7;4;901120;AUDIFONOS GALAXY BUDS PRO SILVER;ACCESORIOS
14048612;;M;41;CHILENO;;X;"";"";286960;4;3;1;1;34990;3;2;251970;AUDIFONO TEEN H AVENGERS IRON MAN ALAMBRICO;ACCESORIOS
13627463;;F;42;CHILENO;;X;CANETE                        ;BIO BIO;390750;4;3;0;0;0;4;3;390750;SOPORTE TV 14-42 KTAM02 KIOTO C/ BRAZO MOVIL;ACCESORIOS
17142638;;F;33;CHILENO;;Millenial;RENCA                         ;METROPOLITANA;22990;2;1;0;0;0;2;1;22990;Redmi Buds 3 Lite Black;ACCESORIOS
19046954;Soltero;M;28;CHILENO;;Millenial;PROVIDENCIA                   ;METROPOLITANA;129970;3;2;3;2;129970;0;0;0;BUNDLE HONOR WATCH GS PRO BLUE;ACCESORIOS
19875734;;M;23;CHILENO;;Z;N/D;N/D;164980;2;2;0;0;0;2;2;164980;AUDIFONO IN GALAXI BUDS;ACCESORIOS
17079068;;F;33;CHILENO;;Millenial;SAN ANTONIO                   ;VALPARAISO;65980;2;1;2;1;65980;0;0;0;DSICO PORTATIL TOSHIBA CANVIO ADVANCE V10 ROJO;ACCESORIOS
10587733;;F;55;CHILENO;;Boomers;N/D;N/D;52960;4;2;0;0;0;4;2;52960;SOPORTE TV 14-63 CON BRAZO KT-FM 3L;ACCESORIOS
17124446;;M;33;CHILENO;;Extranjero;N/D;N/D;14990;1;1;0;0;0;1;1;14990;SOPORTE TV 14-63 CON BRAZO KT-FM 3L;ACCESORIOS
16765522;;F;35;CHILENO;;Millenial;LO PRADO                      ;METROPOLITANA;6990;1;1;0;0;0;1;1;6990;SOPORTE TV 26-56 KTAT02 KIOTO MOVIL;ACCESORIOS
15964140;;M;37;CHILENO;;Millenial;N/D;N/D;29990;1;1;0;0;0;1;1;29990;HONOR TRUE WIRELESS STEREO EARBUDS;ACCESORIOS
9791209;;M;56;CHILENO;;Boomers;MELIPILLA                     ;METROPOLITANA;294940;6;4;0;0;0;6;4;294940;DISCO DURO CANVIO 1TB BASICS BLACK TOSHIBA;ACCESORIOS
8210977;;F;65;CHILENO;;Boomers;MAIPU                         ;METROPOLITANA;49990;1;1;0;0;0;1;1;49990;KIT DIRECTV GO BOX;ACCESORIOS
16679558;;F;34;CHILENO;;Millenial;CONSTITUCION                  ;MAULE;1318030;15;12;0;0;0;15;12;1318030;Redmi Buds 3 Lite White;ACCESORIOS
7767668;;F;63;CHILENO;;Boomers;PROVIDENCIA                   ;METROPOLITANA;9990;1;1;0;0;0;1;1;9990;TRAVEL ADAPTER 15W - FAST CHARGER (TYPE-C CABLE);ACCESORIOS
18726831;Soltero;M;28;CHILENO;;Millenial;PROVIDENCIA                   ;METROPOLITANA;12990;1;1;0;0;0;1;1;12990;SAMSUNG TYPE-C EARPHONES BLACK;ACCESORIOS
19823220;;F;24;CHILENO;;Z;PROVIDENCIA                   ;METROPOLITANA;98970;3;2;3;2;98970;0;0;0;SOPORTE TV 26-56 KTAT02 KIOTO MOVIL;ACCESORIOS
9346571;;M;58;CHILENO;;Boomers;PROVIDENCIA                   ;METROPOLITANA;12990;1;1;0;0;0;1;1;12990;SAMSUNG TYPE-C EARPHONES BLACK;ACCESORIOS
17229512;;M;32;CHILENO;;Millenial;VALDIVIA;LOS LAGOS;9990;1;1;0;0;0;1;1;9990;Mouse 530 Wireless (Abyss Blue);ACCESORIOS
6880764;;M;67;CHILENO;;Boomers;MAIPU                         ;METROPOLITANA;413970;6;2;0;0;0;6;2;413970;Escritorio Gamer RGB;ACCESORIOS
15946059;;M;37;CHILENO;;Millenial;PROVIDENCIA                   ;METROPOLITANA;109990;2;1;2;1;109990;0;0;0;AUDIFONOS GALAXY BUDS PRO BLACK;ACCESORIOS
19209756;;M;25;CHILENO;;Z;CARTAGENA                     ;VALPARAISO;85970;3;3;0;0;0;3;3;85970;EXPRESS MOD 3930 PURPLE;ACCESORIOS
15509442;;F;39;CHILENO;;X;N/D;N/D;21991;1;1;0;0;0;1;1;21991;MOUSE KTF-00016 MS MENTA;ACCESORIOS
8254981;;M;56;CHILENO;;Boomers;ARICA                         ;TARAPACA;488110;8;6;0;0;0;8;6;488110;PARLANTE GBASS MICRO;ACCESORIOS
17338058;;F;32;CHILENO;;Millenial;PROVIDENCIA                   ;METROPOLITANA;13990;1;1;0;0;0;1;1;13990;AUDIFONO SAMSUNG WIRELESS 103B;ACCESORIOS
7475875;;M;67;CHILENO;;Boomers;PROVIDENCIA                   ;METROPOLITANA;12990;1;1;0;0;0;1;1;12990;SOPORTE TV 26-56 KTAT02 KIOTO MOVIL;ACCESORIOS
15575268;;F;29;CHILENO;;Millenial;MONTE PATRIA                  ;COQUIMBO;21980;2;2;0;0;0;2;2;21980;AUDIFONO TEEN H AVENGERS IRON MAN ALAMBRICO;ACCESORIOS
11288011;;F;54;CHILENO;;X;TALCA                         ;MAULE;7990;1;1;0;0;0;1;1;7990;CABLE 2 EN 1 AP55;ACCESORIOS
19116536;Soltero;F;27;CHILENO;;Z;PROVIDENCIA                   ;METROPOLITANA;22990;1;1;0;0;0;1;1;22990;AUDIFONO XIAOMI EARPHONES MI TRUE WIRELESS 2 BAS;ACCESORIOS
16826537;;F;33;CHILENO;;Millenial;TENO                          ;MAULE;5990;1;1;0;0;0;1;1;5990;Mi In-Ear Headphones Basic (Black) XIAOMI;ACCESORIOS
9242127;;M;54;CHILENO;;X;PUNTA ARENAS                  ;MAGALLANES;6990;1;1;0;0;0;1;1;6990;SOPORTE TV 26-56 KTAT02 KIOTO MOVIL;ACCESORIOS
13059239;;M;46;CHILENO;;X;LAMPA                         ;METROPOLITANA;181970;3;2;0;0;0;3;2;181970;KARAOKE MLAB TOWER OUTDOOR MIC BT BK 8568;ACCESORIOS
17740967;;M;31;CHILENO;;Millenial;LAS CONDES;METROPOLITANA;262960;4;2;4;2;262960;0;0;0;Galaxy Watch Active4 44 mm Black;ACCESORIOS
27185718;;F;34;VENEZOLANO;;Extranjero;"";"";69990;1;1;0;0;0;1;1;69990;HUAWEI FREEBUDS 4i SILVER FROST;ACCESORIOS
8112531;;M;61;CHILENO;;Millenial;"";"";9990;1;1;0;0;0;1;1;9990;PARLANTE 7284 MLAB ZUKABASS NARAN/VERDE BT;ACCESORIOS
15431321;;M;40;CHILENO;;X;PENAFLOR                      ;METROPOLITANA;26980;2;2;0;0;0;2;2;26980;SAMSUNG TYPE-C EARPHONES WHITE;ACCESORIOS
27103863;;M;47;EXTRANJERO - NO INFORMA NACIONALIDAD;;Extranjero;CHIGUAYANTE                   ;BIO BIO;29990;1;1;0;0;0;1;1;29990;Porta audifonos M650;ACCESORIOS
20093384;;M;23;CHILENO;;Millenial;N/D;N/D;34990;1;1;0;0;0;1;1;34990;PARLANTE BLUETHOOTH XBOOM GO PM1;ACCESORIOS
17449858;;F;32;CHILENO;;Millenial;"";"";109990;1;1;1;1;109990;0;0;0;AUDIFONOS GALAXY BUDS PRO VIOLET;ACCESORIOS
13373345;;M;44;CHILENO;;X;"";"";2990;1;1;0;0;0;1;1;2990;CABLE MGCATC;ACCESORIOS
13088858;;M;46;CHILENO;;X;PROVIDENCIA                   ;METROPOLITANA;19990;1;1;0;0;0;1;1;19990;Travel Adapter SFC 25W Type C (w/o Cable);ACCESORIOS
4789462;;M;77;CHILENO;;Silencioso;LA GRANJA                     ;METROPOLITANA;6990;1;1;0;0;0;1;1;6990;SOPORTE TV 26-56 KTA02 KIOTO FIJO;ACCESORIOS
16855558;;M;34;CHILENO;;Millenial;INDEPENDENCIA                 ;METROPOLITANA;9990;1;1;0;0;0;1;1;9990;TRAVEL ADAPTER 15W - FAST CHARGER (TYPE-C CABLE);ACCESORIOS
18575221;;M;29;CHILENO;;Millenial;PITRUFQUEN                    ;ARAUCANIA;25980;2;1;0;0;0;2;1;25980;ALTEC LANSING AUDIFONO HEADBAND BLUETOOTH COMFOR;ACCESORIOS
14573533;;M;40;CHILENO;;X;VALLENAR;ATACAMA;189980;2;2;0;0;0;2;2;189980;PARLANTE 8247 MLAB SOUNDLAB BLACK;ACCESORIOS
18142784;;M;30;CHILENO;;Extranjero;COIHAIQUE                     ;AYSEN;10990;1;1;0;0;0;1;1;10990;TRAVEL ADAPTER 15W - FAST CHARGER (TYPE-C CABLE);ACCESORIOS
13959053;Soltero;F;42;CHILENO;;X;RENCA                         ;METROPOLITANA;173970;3;3;2;2;159980;1;1;13990;SOPORTE TV 14-42 KTAM02 KIOTO C/ BRAZO MOVIL;ACCESORIOS
18961165;;F;27;CHILENO;;Millenial;TALAGANTE                     ;METROPOLITANA;597940;6;6;0;0;0;6;6;597940;SOPORTE TV 14-63 CON BRAZO KT-FM 3L;ACCESORIOS
10990275;;M;47;CHILENO;;X;RENCA                         ;METROPOLITANA;3990;1;1;0;0;0;1;1;3990;AUDIFONO MLAB ON HEADBAND P800 BLACK 7403;ACCESORIOS
14273544;;M;47;CHILENO;;X;"";"";16990;1;1;0;0;0;1;1;16990;AUDIFONO TWS FULLY WIRELESS 8873;ACCESORIOS
17095109;;M;33;CHILENO;;Millenial;QUILPUE;VALPARAISO;153950;5;4;2;1;34980;3;3;118970;BAND 4 BLACK;ACCESORIOS
13156511;;M;45;CHILENO;;X;PITRUFQUEN                    ;ARAUCANIA;21990;1;1;0;0;0;1;1;21990;PARLANTE BLUETOOTH TAS2505B;ACCESORIOS
15981949;Soltero;M;37;CHILENO;;Millenial;N/D;N/D;39980;2;2;0;0;0;2;2;39980;ALTEC LANSING AUDIFONO HEADBAND BLUETOOTH COMFOR;ACCESORIOS
14023674;;F;46;CHILENO;;X;MAULE                         ;MAULE;179990;1;1;0;0;0;1;1;179990;AUDIFONOS Airpods 2nd-generation (MRXJ2BE/A);ACCESORIOS
16383723;;M;36;CHILENO;;Millenial;PROVIDENCIA                   ;METROPOLITANA;153070;3;3;3;3;153070;0;0;0;AUDIFONO PANASONIC IN RP-HV096E-K NEGRO;ACCESORIOS
16221391;Casado;F;36;CHILENO;;Millenial;PROVIDENCIA                   ;METROPOLITANA;129990;1;1;0;0;0;1;1;129990;Smartwatch GT 2 BLACK;ACCESORIOS
15500445;;M;39;CHILENO;;X;N/D;N/D;119980;2;2;0;0;0;2;2;119980;AUDIFONO XIAOMI EARBUDS MI TRUE WIRELESS BASIC 2;ACCESORIOS
8494117;Soltero;M;60;CHILENO;PROFESOR;Boomers;VALLENAR;ATACAMA;209990;1;1;0;0;0;1;1;209990;GALAXY WATCH ACTIVE4 40 MM SILVER;ACCESORIOS
19789920;;F;25;CHILENO;;Z;LLANQUIHUE                    ;LOS LAGOS;9990;1;1;0;0;0;1;1;9990;TRAVEL ADAPTER 15W - FAST CHARGER (TYPE-C CABLE);ACCESORIOS
20152380;;F;22;CHILENO;;Z;PROVIDENCIA                   ;METROPOLITANA;193980;2;1;2;1;193980;0;0;0;GALAXY WATCH4 42 MM SILVER;ACCESORIOS
18760580;Soltero;M;27;CHILENO;;Millenial;PROVIDENCIA                   ;METROPOLITANA;69980;2;1;2;1;69980;0;0;0;Wacom Intous Small;ACCESORIOS
13966494;;F;41;CHILENO;;X;RENCA                         ;METROPOLITANA;22990;1;1;1;1;22990;0;0;0;PARLANTE KARAOKE MGGLADIATOR NEGRO;ACCESORIOS
10150703;;F;58;CHILENO;;Boomers;RENCA                         ;METROPOLITANA;14990;1;1;0;0;0;1;1;14990;PARLANTE 6986 MLAB VERTICAL STICKERS BT;ACCESORIOS
16288252;;F;36;CHILENO;;Millenial;PROVIDENCIA                   ;METROPOLITANA;9990;1;1;1;1;9990;0;0;0;TRAVEL ADAPTER 15W - FAST CHARGER (TYPE-C CABLE);ACCESORIOS
18202240;;F;30;CHILENO;;Millenial;CAUQUENES                     ;MAULE;24990;1;1;0;0;0;1;1;24990;PARLANTE KARAOKE MGGLADIATOR NEGRO;ACCESORIOS
6791321;;M;71;CHILENO;;Silencioso;PUNTA ARENAS                  ;MAGALLANES;9990;1;1;0;0;0;1;1;9990;TRAVEL ADAPTER 15W - FAST CHARGER (TYPE-C CABLE);ACCESORIOS
20197503;;M;22;CHILENO;;Millenial;PROVIDENCIA                   ;METROPOLITANA;7990;1;1;0;0;0;1;1;7990;AUDIFONO MOTOROLA EARBUDS M. LIBRES METAL DORADO;ACCESORIOS
26124856;;M;28;EXTRANJERO - NO INFORMA NACIONALIDAD;;Extranjero;N/D;N/D;99990;2;1;2;1;99990;0;0;0;AUDIFONO GALAXY BUDS2 BLACK;ACCESORIOS
18108844;;F;30;CHILENO;;Millenial;N/D;N/D;0;0;2;0;0;0;0;2;0;ALTEC LANSING AUDIFONO Nano Pods TWS PURPLE 8996;ACCESORIOS
19643414;;F;25;CHILENO;;Z;PROVIDENCIA                   ;METROPOLITANA;189990;2;1;2;1;189990;0;0;0;GALAXY WATCH4 42 MM SILVER;ACCESORIOS
7143943;;F;67;CHILENO;;Boomers;OVALLE                        ;COQUIMBO;39990;1;1;0;0;0;1;1;39990;PARLANTE KARAOKE FD-PKBT82 8 LUCES MIC/FM/BT/USB;ACCESORIOS
9596688;;F;59;CHILENO;;Boomers;CAUQUENES                     ;MAULE;7990;1;1;0;0;0;1;1;7990;SOPORTE TV 26-56 KTA02 KIOTO FIJO;ACCESORIOS
12003652;;M;46;CHILENO;;X;VILLA ALEMANA                 ;VALPARAISO;44990;1;1;0;0;0;1;1;44990;Mi Smart Band 6 Negra Xiaomi;ACCESORIOS
25738070;;M;39;VENEZOLANO;;Extranjero;PUERTO MONTT                  ;LOS LAGOS;59990;1;1;1;1;59990;0;0;0;New GAMEPAD - GLAP;ACCESORIOS
11259133;Soltero;M;53;CHILENO;AGRONOMO;X;PROVIDENCIA                   ;METROPOLITANA;40980;2;2;0;0;0;2;2;40980;AUDIFONO XIAOMI EARBUDS MI TRUE WIRELESS BASIC 2;ACCESORIOS
17982398;;F;31;CHILENO;;Millenial;N/D;N/D;25840;2;1;2;1;25840;0;0;0;3-PACK TOMACORRIENTE SMART NEXXT;ACCESORIOS
9752114;;F;60;CHILENO;;Boomers;AISEN                         ;AYSEN;2274780;9;3;0;0;0;9;3;2274780;CABLE MGCATC;ACCESORIOS
13278118;;M;45;CHILENO;;Silencioso;PROVIDENCIA                   ;METROPOLITANA;209990;2;1;2;1;209990;0;0;0;GALAXY WATCH ACTIVE4 40 MM LTE GOLD;ACCESORIOS
19442735;;F;25;CHILENO;;Z;PROVIDENCIA                   ;METROPOLITANA;78980;2;1;0;0;0;2;1;78980;MI WATCH LITE NEGRO XIAOMI;ACCESORIOS
17174844;;M;32;CHILENO;;Millenial;LA SERENA                     ;COQUIMBO;27990;1;1;0;0;0;1;1;27990;PARLANTE GO 2 BLUETOOTH NEGRO;ACCESORIOS
12824539;;F;46;CHILENO;;X;RENCA                         ;METROPOLITANA;17970;3;1;0;0;0;3;1;17970;AUDIFONO ON ZX110 SONY ROSA;ACCESORIOS
20450673;;M;21;CHILENO;;Z;"";"";19990;1;1;0;0;0;1;1;19990;AUDIFONO XIAOMI EARBUDS MI TRUE WIRELESS BASIC 2;ACCESORIOS
10625515;;M;48;CHILENO;;X;ARICA                         ;TARAPACA;89990;1;1;0;0;0;1;1;89990;DISCO DURO CANVIO 4TB BASICS BLACK;ACCESORIOS
9225461;;M;47;CHILENO;;X;PROVIDENCIA                   ;METROPOLITANA;42970;3;3;0;0;0;3;3;42970;ARO DE LUZ LED 10 PULGADAS + TRIPODE PEQUENO;ACCESORIOS
11271237;;M;53;CHILENO;;X;RENCA                         ;METROPOLITANA;49990;1;1;0;0;0;1;1;49990;DISCO DURO CANVIO 1TB BASICS BLACK TOSHIBA;ACCESORIOS
18679558;;F;28;CHILENO;;Millenial;PROVIDENCIA                   ;METROPOLITANA;29990;1;1;0;0;0;1;1;29990;BAND 4 BLACK;ACCESORIOS
5693004;;M;75;CHILENO;;Silencioso;RENCA                         ;METROPOLITANA;33980;2;1;0;0;0;2;1;33980;SOPORTE TV 14-42 KTAM02 KIOTO C/ BRAZO MOVIL;ACCESORIOS
17708281;;M;31;CHILENO;;Millenial;TALAGANTE                     ;METROPOLITANA;22990;1;1;0;0;0;1;1;22990;AUDIFONO MOTO BUDBS 100 TRUE WIRELESS WHITE;ACCESORIOS
8186594;;F;62;CHILENO;;Boomers;COIHAIQUE                     ;AYSEN;44990;1;1;0;0;0;1;1;44990;Mi Smart Band 6 Negra Xiaomi;ACCESORIOS
10398902;;F;57;CHILENO;;Boomers;RENCA                         ;METROPOLITANA;47980;2;2;0;0;0;2;2;47980;BAND 6 BLACK HUAWEI;ACCESORIOS
13401780;;M;43;CHILENO;;X;PROVIDENCIA                   ;METROPOLITANA;19990;1;1;0;0;0;1;1;19990;3-PACK TOMACORRIENTE SMART NEXXT;ACCESORIOS
19460991;;F;26;CHILENO;;Z;PROVIDENCIA                   ;METROPOLITANA;21990;1;1;0;0;0;1;1;21990;KIT PREPAGO HD DIRECTV;ACCESORIOS
20000927;;M;23;CHILENO;;Z;"";"";17990;1;1;1;1;17990;0;0;0;AUDIFONO XIAOMI EARBUDS MI TRUE WIRELESS BASIC 2;ACCESORIOS
5188727;;M;74;CHILENO;;Silencioso;SAN FERNANDO                  ;L.G.B.OÂ´HIGGINS;6990;1;1;0;0;0;1;1;6990;PARLANTE 6984 MLAB VERTICAL ROCK BT;ACCESORIOS
13720528;;F;42;CHILENO;;Millenial;RANCAGUA                      ;L.G.B.OÂ´HIGGINS;19990;1;1;0;0;0;1;1;19990;PARLANTE KARAOKE MGGLADIATOR NEGRO;ACCESORIOS
26450791;;M;30;VENEZOLANO;;Extranjero;CURICO                        ;MAULE;372970;3;2;2;1;361980;1;1;10990;SOPORTE TV 32-65 KTA03 KIOTO FIJO;ACCESORIOS
16407172;;F;36;CHILENO;;Millenial;N/D;N/D;373970;3;2;2;1;183980;1;1;189990;SILLA GAMER MODELO EMPEROR NEGRO/AZUL;ACCESORIOS
22347359;;F;50;PERUANO;;Extranjero;ESTACION CENTRAL              ;METROPOLITANA;14990;1;1;0;0;0;1;1;14990;PARLANTE 8531 MLAB MAX BASS BT;ACCESORIOS
13653479;;M;44;CHILENO;;X;N/D;N/D;6990;1;1;0;0;0;1;1;6990;Audifonos Orejas De Gato Rosado;ACCESORIOS
11599493;;M;52;CHILENO;;X;TOCOPILLA                     ;ANTOFAGASTA;404450;4;2;0;0;0;4;2;404450;PARLANTE 8531 MLAB MAX BASS BT;ACCESORIOS
13337095;;F;43;CHILENO;;X;RENCA                         ;METROPOLITANA;88980;2;1;2;1;88980;0;0;0;PARLANTE FLIP 5 BLUETOOTH AZUL;ACCESORIOS
20442041;;F;22;CHILENO;;Z;PROVIDENCIA                   ;METROPOLITANA;14990;1;1;0;0;0;1;1;14990;AUDIFONO TEEN SPIDERMAN ALAMBRICO;ACCESORIOS
14343466;;M;44;CHILENO;;X;TALAGANTE                     ;METROPOLITANA;40980;2;2;0;0;0;2;2;40980;AUDIFONO MOTO BUDBS 100 TRUE WIRELESS WHITE;ACCESORIOS
12804102;;M;47;CHILENO;;X;VALLENAR;ATACAMA;15990;1;1;0;0;0;1;1;15990;AUDIFONO GAMER ON EAR DHE-8010;ACCESORIOS
13361646;;F;44;CHILENO;;X;CABILDO                       ;VALPARAISO;94980;2;1;2;1;94980;0;0;0;AUDIFONO GALAXY BUDS2 BLACK;ACCESORIOS
11522635;;M;52;CHILENO;;X;LEBU                          ;BIO BIO;199990;1;1;0;0;0;1;1;199990;Silla Gamer Ymer RGB Negra;ACCESORIOS
15058570;;F;39;CHILENO;;X;CABILDO                       ;VALPARAISO;19990;1;1;0;0;0;1;1;19990;AUDIFONO XIAOMI EARBUDS MI TRUE WIRELESS BASIC 2;ACCESORIOS
13592720;;F;43;CHILENO;;X;CONCEPCION                    ;BIO BIO;26990;1;1;0;0;0;1;1;26990;AUDIFONO MOTO BUDBS 100 TRUE WIRELESS WHITE;ACCESORIOS
13414411;;M;50;CHILENO;;X;ARICA                         ;ARICA Y PARINACOTA;21990;1;1;0;0;0;1;1;21990;AUDIFONO INALAMBRICO N68 FIDDLER;ACCESORIOS
15941489;;M;37;CHILENO;;Millenial;PROVIDENCIA                   ;METROPOLITANA;18990;1;1;1;1;18990;0;0;0;AUDIFONO XIAOMI EARBUDS MI TRUE WIRELESS BASIC 2;ACCESORIOS
13666222;;F;43;CHILENO;;X;PROVIDENCIA                   ;METROPOLITANA;19990;1;1;1;1;19990;0;0;0;Mouse G203 LIGHTSYNC Gaming - BLACK;ACCESORIOS
18280505;;F;29;CHILENO;;Millenial;"";"";6000;2;1;0;0;0;2;1;6000;Mi In-Ear Headphones Basic (Black) XIAOMI;ACCESORIOS
11219447;;F;54;CHILENO;;X;ARICA                         ;ARICA Y PARINACOTA;50980;2;2;0;0;0;2;2;50980;BAND 6 BLACK HUAWEI;ACCESORIOS
16027507;Soltero;F;36;CHILENO;PROFESOR;Millenial;PROVIDENCIA                   ;METROPOLITANA;69980;2;1;0;0;0;2;1;69980;SMARTBAND XIAOMI MI BAND 5 NEGRO;ACCESORIOS
18343709;Casado;F;29;CHILENO;TECNICO DE NIVEL SUPERIOR EN ENFERMERIA;Millenial;"";"";139990;1;1;0;0;0;1;1;139990;SMARTWATCH GT 2 LATONA BROWN;ACCESORIOS
16139197;Soltero;F;36;CHILENO;;Millenial;PROVIDENCIA                   ;METROPOLITANA;7990;1;1;0;0;0;1;1;7990;AUDIFONO ON ZX110 SONY NEGRO;ACCESORIOS
18796491;;F;24;CHILENO;;Z;RENCA                         ;METROPOLITANA;14990;1;1;0;0;0;1;1;14990;SAMSUNG TYPE-C EARPHONES BLACK;ACCESORIOS
15658451;Casado;M;38;CHILENO;;X;CANETE                        ;BIO BIO;189990;1;1;0;0;0;1;1;189990;GALAXY WATCH ACTIVE4 40 MM SILVER;ACCESORIOS
17803902;;M;31;CHILENO;;Millenial;ISLA DE MAIPO                 ;METROPOLITANA;39990;1;1;0;0;0;1;1;39990;BAND 6 BLACK HUAWEI;ACCESORIOS
16975906;;M;34;CHILENO;;Millenial;COIHAIQUE                     ;AYSEN;187860;3;3;0;0;0;3;3;187860;ALTEC LANSING AUDIFONO HEADBAND BLUETOOTH COMFOR;ACCESORIOS
17511004;;F;32;CHILENO;;Millenial;PROVIDENCIA                   ;METROPOLITANA;18990;1;1;1;1;18990;0;0;0;AUDIFONO XIAOMI EARBUDS MI TRUE WIRELESS BASIC 2;ACCESORIOS
17423109;;F;32;CHILENO;;Millenial;PROVIDENCIA                   ;METROPOLITANA;17990;1;1;0;0;0;1;1;17990;AUDIFONO XIAOMI EARBUDS MI TRUE WIRELESS BASIC 2;ACCESORIOS
16538359;;F;34;CHILENO;;Millenial;LONGAVI                       ;MAULE;13990;1;1;0;0;0;1;1;13990;Headset Gamer Luces RGB;ACCESORIOS
12371972;;F;50;CHILENO;;X;RENCA                         ;METROPOLITANA;0;0;2;0;0;0;0;2;0;KARAOKE MLAB TOWER OUTDOOR MIC BT BK 8568;ACCESORIOS
20088232;;M;23;CHILENO;;Millenial;COIHAIQUE                     ;AYSEN;109990;1;1;1;1;109990;0;0;0;AUDIFONO GALAXY BUDS LIVE NEGRO;ACCESORIOS
17944338;;M;31;CHILENO;;Millenial;QUILPUE                       ;VALPARAISO;9990;1;1;0;0;0;1;1;9990;TRAVEL ADAPTER 15W - FAST CHARGER (TYPE-C CABLE);ACCESORIOS
18299465;;M;29;CHILENO;;Millenial;VINA DEL MAR;VALPARAISO;199990;1;1;0;0;0;1;1;199990;Galaxy Watch Active4 40 mm Black;ACCESORIOS
16889801;;F;32;CHILENO;;Millenial;PROVIDENCIA                   ;METROPOLITANA;22990;1;1;0;0;0;1;1;22990;SOPORTE TV 14-63 CON BRAZO KT-FM 3L;ACCESORIOS
20297374;;F;22;CHILENO;;Z;PROVIDENCIA                   ;METROPOLITANA;9990;1;1;0;0;0;1;1;9990;AUDIFONO IN SAM FIT EG920 BLANCO;ACCESORIOS
25714001;;F;38;COLOMBIANO;;Extranjero;VALLENAR;ATACAMA;139990;1;1;0;0;0;1;1;139990;SMARTWATCH GT 2 LATONA BROWN;ACCESORIOS
19272089;;M;21;CHILENO;;Millenial;"";"";69990;1;1;0;0;0;1;1;69990;HUAWEI FREEBUDS 3I BLANCOS;ACCESORIOS
17496358;;M;32;CHILENO;;Millenial;TALCA                         ;MAULE;29990;1;1;0;0;0;1;1;29990;Multi BT Keyboard Black;ACCESORIOS
15984194;Soltero;F;37;CHILENO;;Millenial;PROVIDENCIA                   ;METROPOLITANA;24990;1;1;0;0;0;1;1;24990;PARLANTE KARAOKE MGROCKET NEGRO;ACCESORIOS
18107876;;F;30;CHILENO;;Millenial;PROVIDENCIA                   ;METROPOLITANA;19990;1;1;0;0;0;1;1;19990;SOPORTE TV 14-42 KTAM02 KIOTO C/ BRAZO MOVIL;ACCESORIOS
19226604;;F;26;CHILENO;;Z;N/D;N/D;-140990;-1;2;0;0;0;-1;2;-140990;Mouse Wireless M280 Red;ACCESORIOS
12447393;Soltero;M;48;CHILENO;INGENIERO AGROPECUARIO;X;RENCA                         ;METROPOLITANA;9990;1;1;0;0;0;1;1;9990;PARLANTE GBASS MICRO;ACCESORIOS
9537504;;M;57;CHILENO;;Boomers;N/D;N/D;10990;1;1;0;0;0;1;1;10990;AUDIFONO ON ZX110 SONY NEGRO;ACCESORIOS
20305170;;F;22;CHILENO;;Z;YERBAS BUENAS                 ;MAULE;47980;4;4;0;0;0;4;4;47980;MOUSE 100 WIRED;ACCESORIOS
27610000;;M;23;CHILENO;;Extranjero;LO PRADO;METROPOLITANA;123952;5;3;2;1;21980;3;2;101972;BATERY PACK TIPO C 10.000 MAH SAMSUNG;ACCESORIOS
19762196;;M;24;CHILENO;;Millenial;"";"";88970;3;2;0;0;0;3;2;88970;AUDIFONO XIAOMI EARPHONES MI TRUE WIRELESS 2 BAS;ACCESORIOS
15907419;;M;37;CHILENO;;Millenial;N/D;N/D;1454930;8;4;0;0;0;8;4;1454930;AUDIFONO GALAXY BUDS2 BLACK;ACCESORIOS
11598309;;M;51;CHILENO;;X;ANCUD                         ;LOS LAGOS;248990;4;2;0;0;0;4;2;248990;PARLANTE 8247 MLAB SOUNDLAB BLACK;ACCESORIOS
15343236;Soltero;M;38;CHILENO;ARQUITECTO;X;PROVIDENCIA                   ;METROPOLITANA;43980;2;1;2;1;43980;0;0;0;DISCO DURO CANVIO 1TB BASICS BLACK TOSHIBA;ACCESORIOS
15292992;;M;40;CHILENO;;X;N/D;N/D;15990;1;1;0;0;0;1;1;15990;BATERY PACK TIPO C 10.000 MAH SAMSUNG;ACCESORIOS
10348852;;F;55;CHILENO;;Boomers;RENCA                         ;METROPOLITANA;7990;1;1;0;0;0;1;1;7990;AUDIFONO HEADBAND BT NEGRO;ACCESORIOS
17968265;Soltero;F;30;CHILENO;;Millenial;PROVIDENCIA                   ;METROPOLITANA;64080;3;1;3;1;64080;0;0;0;EXPRESS MOD 3930 PURPLE;ACCESORIOS
16684457;Casado;M;34;CHILENO;TECNICO MECANICO;Millenial;RENCA                         ;METROPOLITANA;7990;1;1;0;0;0;1;1;7990;AUDIFONO HEADBAND BT BLANCO FIDDLER;ACCESORIOS
13208784;;M;45;CHILENO;;X;COQUIMBO                      ;COQUIMBO;59990;1;1;0;0;0;1;1;59990;FREEBUDS 4i BLACK HUAWEI;ACCESORIOS
13562741;;F;43;CHILENO;;X;LINARES                       ;MAULE;9980;2;1;0;0;0;2;1;9980;MEMORIA MICROSD CLASE 10 32GB SANDISK;ACCESORIOS
9584515;;M;57;CHILENO;;Boomers;N/D;N/D;246970;3;2;0;0;0;3;2;246970;AUDIFONO XIAOMI EARBUDS MI TRUE WIRELESS BASIC 2;ACCESORIOS
10747140;;F;40;CHILENO;;X;N/D;N/D;209980;2;2;0;0;0;2;2;209980;Headset Gamer Basic;ACCESORIOS
20541104;;F;21;CHILENO;;Z;PROVIDENCIA                   ;METROPOLITANA;6990;1;1;0;0;0;1;1;6990;AUDIFONO IN SAM HS1303C/ MIC NEGRO;ACCESORIOS
13226410;;F;45;CHILENO;;X;N/D;N/D;15980;2;2;1;1;7990;1;1;7990;AUDIFONO HEADBAND BT NEGRO;ACCESORIOS
17171529;;F;33;CHILENO;;Silencioso;PROVIDENCIA                   ;METROPOLITANA;12990;1;1;0;0;0;1;1;12990;PARLANTE ZUKABASS + MICROFONO MLAB BT;ACCESORIOS
10041205;;M;57;CHILENO;;Boomers;LONGAVI                       ;MAULE;9980;2;1;0;0;0;2;1;9980;MEMORIA MICROSD CLASE 10 32GB SANDISK;ACCESORIOS
16330282;;F;35;CHILENO;;Extranjero;QUILPUE                       ;VALPARAISO;11980;2;1;0;0;0;2;1;11980;HUAWEI AUDIFONOS MANOS LIBRES AM115;ACCESORIOS
17732583;;M;31;CHILENO;;Millenial;"";"";68960;4;2;4;2;68960;0;0;0;BAND 6 PINK HUAWEI;ACCESORIOS
20419672;;F;22;CHILENO;;Silencioso;PROVIDENCIA                   ;METROPOLITANA;27980;2;1;2;1;27980;0;0;0;AUDIFONO TAT1235 PHILIPS NEGRO;ACCESORIOS
7935980;;F;63;CHILENO;;Boomers;AISEN                         ;AYSEN;6990;1;1;0;0;0;1;1;6990;AUDIFONO IN SAM HS1303C/ MIC AZUL;ACCESORIOS
4109675;;F;80;CHILENO;;Silencioso;RENCA                         ;METROPOLITANA;8990;1;1;0;0;0;1;1;8990;TRAVEL ADAPTER 15W - FAST CHARGER (TYPE-C CABLE);ACCESORIOS
11622610;;F;52;CHILENO;;X;PROVIDENCIA                   ;METROPOLITANA;15980;2;1;0;0;0;2;1;15980;MINI PODS TOUCH FIDDLER;ACCESORIOS
16669157;;M;34;CHILENO;;Millenial;LOS ALAMOS                    ;BIO BIO;10990;1;1;0;0;0;1;1;10990;MOUSE X200 Inalambrico NEGRO;ACCESORIOS
22346843;;M;57;PERUANO;;Extranjero;N/D;N/D;4990;1;1;0;0;0;1;1;4990;AUDIFONO IN E9LP SONY BZ NEGRO;ACCESORIOS
12184566;;F;49;CHILENO;;Silencioso;PROVIDENCIA                   ;METROPOLITANA;14990;1;1;1;1;14990;0;0;0;Mouse Bluetooth Pastel Blue;ACCESORIOS
17887584;;F;29;CHILENO;;Millenial;PENCO                         ;BIO BIO;49990;1;1;0;0;0;1;1;49990;BAND 6 PINK HUAWEI;ACCESORIOS
19547362;;F;25;CHILENO;;Silencioso;PROVIDENCIA                   ;METROPOLITANA;267970;3;1;3;1;267970;0;0;0;GALAXY WATCH ACTIVE4 40 MM GOLD;ACCESORIOS
16229477;;F;36;CHILENO;;Millenial;CORONEL                       ;BIO BIO;57970;3;1;0;0;0;3;1;57970;BAND 6 BLACK HUAWEI;ACCESORIOS
26244896;;M;32;VENEZOLANO;;Extranjero;SANTIAGO;METROPOLITANA;105570;3;2;2;1;103980;1;1;1590;AUDIFONO PANASONIC IN RP-HV096E-K NEGRO;ACCESORIOS
16131879;;M;36;CHILENO;;Millenial;PUENTE ALTO                   ;METROPOLITANA;787960;3;1;3;1;787960;0;0;0;APPLE WATCH S5 44MM SILVER;ACCESORIOS
13754349;;M;41;CHILENO;;X;RENCA                         ;METROPOLITANA;174980;2;1;2;1;174980;0;0;0;WATCH GT2 PRO BLACK HUAWEI;ACCESORIOS
20254335;;F;23;CHILENO;;Z;PROVIDENCIA                   ;METROPOLITANA;27990;1;1;0;0;0;1;1;27990;SMARTBAND XIAOMI MI BAND 5 NEGRO;ACCESORIOS
13852804;;F;49;CHILENO;;X;CURICO                        ;MAULE;8990;1;1;0;0;0;1;1;8990;PARLANTE 7279 MLAB ZUKABASS NEGRO BT;ACCESORIOS
18580621;;M;28;CHILENO;;Millenial;ILLAPEL                       ;COQUIMBO;8990;1;1;0;0;0;1;1;8990;TRAVEL ADAPTER 15W - FAST CHARGER (TYPE-C CABLE);ACCESORIOS
19478822;;M;25;CHILENO;;Z;N/D;N/D;12990;1;1;0;0;0;1;1;12990;SOPORTE INCLINABLE 37-70 PULGADAS + CABLE;ACCESORIOS
20019201;;F;23;CHILENO;;Z;"";"";7990;1;1;0;0;0;1;1;7990;SOPORTE TV 26-56 KTA02 KIOTO FIJO;ACCESORIOS
19908330;;M;23;CHILENO;;Z;N/D;N/D;12990;1;1;0;0;0;1;1;12990;SOPORTE TV 32-65 KTA03 KIOTO FIJO;ACCESORIOS
15401705;;M;40;CHILENO;;X;RENCA                         ;METROPOLITANA;10990;1;1;0;0;0;1;1;10990;MINI PARLANTE BT GO2;ACCESORIOS
16160226;;M;36;CHILENO;;Millenial;RENCA                         ;METROPOLITANA;21990;1;1;0;0;0;1;1;21990;KIT PREPAGO HD DIRECTV;ACCESORIOS
18977312;;M;27;CHILENO;;Z;SAN BERNARDO                  ;METROPOLITANA;27980;2;1;0;0;0;2;1;27980;SOPORTE ARTICULADO FULL MOTION 32-55 PULGADAS;ACCESORIOS
18471977;;F;29;CHILENO;;Millenial;N/D;N/D;13000;2;1;0;0;0;2;1;13000;PARLANTE 8531 MLAB MAX BASS BT;ACCESORIOS
15217405;;M;39;CHILENO;;X;CORONEL                       ;BIO BIO;10990;1;1;0;0;0;1;1;10990;PARLANTE 7279 MLAB ZUKABASS NEGRO BT;ACCESORIOS
13675280;;M;43;CHILENO;;X;N/D;N/D;89990;1;3;0;0;0;1;3;89990;AUDIFONO GALAXY BUDS PLUS NEGRO;ACCESORIOS
10622229;;F;60;CHILENO;;Boomers;VITACURA                      ;METROPOLITANA;6990;1;1;0;0;0;1;1;6990;AUDIFONO IN SAM HS1303C/ MIC NEGRO;ACCESORIOS
10368933;Casado;M;53;CHILENO;;X;SAN FERNANDO                  ;L.G.B.OÂ´HIGGINS;11990;1;1;0;0;0;1;1;11990;PARLANTE MARLEY BT CHANT MINI NEGRO;ACCESORIOS
17691234;Soltero;M;31;CHILENO;;Millenial;PROVIDENCIA                   ;METROPOLITANA;83980;2;1;2;1;83980;0;0;0;AUDIFONO GALAXY BUDS PLUS NEGRO;ACCESORIOS
11718672;;F;51;CHILENO;;X;CASTRO                        ;LOS LAGOS;10990;1;1;0;0;0;1;1;10990;Mouse Wireless M280 Blue;ACCESORIOS
10795266;;M;54;CHILENO;;Boomers;ANCUD                         ;LOS LAGOS;573830;6;2;0;0;0;6;2;573830;TECLADO K600TV LOGITECH NEGRO;ACCESORIOS
19552251;;M;24;CHILENO;;Z;PROVIDENCIA                   ;METROPOLITANA;19990;1;1;1;1;19990;0;0;0;BAND 4 BLACK;ACCESORIOS
12475121;;M;48;CHILENO;;X;MAIPU                         ;METROPOLITANA;16990;1;1;0;0;0;1;1;16990;AUDIFONO BLUETOOTH PANASONIC RP-HJE120B NEGRO;ACCESORIOS
12016890;;F;58;CHILENO;;Boomers;PROVIDENCIA                   ;METROPOLITANA;11990;1;1;0;0;0;1;1;11990;SOPORTE INCLINABLE 37-70 PULGADAS + CABLE;ACCESORIOS
18763258;;F;27;CHILENO;;Millenial;PUENTE ALTO;METROPOLITANA;19990;1;1;0;0;0;1;1;19990;PARLANTE BAZUCA PB-300BT PORTATIL BLUETOOTH 9W;ACCESORIOS
12295928;;M;50;CHILENO;;X;TALCA                         ;MAULE;17982;2;2;0;0;0;2;2;17982;AUDIFONO IN SAM C/ MIC EG920 BLACK;ACCESORIOS
15438979;;M;40;CHILENO;;X;N/D;N/D;12990;1;1;0;0;0;1;1;12990;PARLANTE 8531 MLAB MAX BASS BT;ACCESORIOS
15258332;;M;40;CHILENO;;X;VILCUN                        ;ARAUCANIA;10990;1;1;0;0;0;1;1;10990;SOPORTE INCLINABLE 37-70 PULGADAS + CABLE;ACCESORIOS
18474982;;F;29;CHILENO;;Millenial;N/D;N/D;0;0;0;0;0;0;0;0;0;SMARTWATCH HUAWEI BAND 4E ACTIVE MINERAL RED;ACCESORIOS
20139036;;F;23;CHILENO;;Millenial;N/D;N/D;0;0;0;0;0;0;0;0;0;PARLANTE GBASS MICRO;ACCESORIOS
5040604;;F;76;CHILENO;;Silencioso;SAN FELIPE                    ;VALPARAISO;0;0;0;0;0;0;0;0;0;KARAOKE MINI MY LIL FIRST SING CON MIC CABLE RED;ACCESORIOS
8174763;Viudo;F;71;CHILENO;;Silencioso;RENCA                         ;METROPOLITANA;0;0;0;0;0;0;0;0;0;PARLANTE KARAOKE MGGLADIATOR NEGRO;ACCESORIOS
17899234;;F;31;CHILENO;;Millenial;PROVIDENCIA                   ;METROPOLITANA;0;0;0;0;0;0;0;0;0;AUDIFONO ON RPHF300E-W BLANCO PNS;ACCESORIOS
8509608;;M;64;CHILENO;;Boomers;"";"";0;0;0;0;0;0;0;0;0;MINI PARLANTE BT GO2;ACCESORIOS
15104089;;F;40;CHILENO;;X;RANCAGUA                      ;L.G.B.OÂ´HIGGINS;0;0;0;0;0;0;0;0;0;PARLANTE ZUKABASS 4 BT USB/SD/FM CALACAS;ACCESORIOS
8260230;;F;60;CHILENO;;Boomers;RENCA                         ;METROPOLITANA;0;0;0;0;0;0;0;0;0;SOPORTE TV 26-56 KTA02 KIOTO FIJO;ACCESORIOS
18363020;Soltero;F;29;CHILENO;PSICOPEDAGOGO;Millenial;PROVIDENCIA                   ;METROPOLITANA;0;0;0;0;0;0;0;0;0;BAND 4 AMBER SUNRISE;ACCESORIOS
18056676;Soltero;M;29;CHILENO;;Millenial;N/D;N/D;0;0;0;0;0;0;0;0;0;AUDIFONO PANASONIC Bluetooth TWS RZ-S300PP-K Neg;ACCESORIOS
16835309;;M;34;CHILENO;;Millenial;PROVIDENCIA                   ;METROPOLITANA;0;0;0;0;0;0;0;0;0;SOPORTE TV 26-56 KTA02 KIOTO FIJO;ACCESORIOS
8422311;;F;64;CHILENO;;Boomers;VALDIVIA                      ;LOS LAGOS;0;0;0;0;0;0;0;0;0;MOUSE MICROSOFT Wireless Mbl 1850 Purple;ACCESORIOS
18857796;;M;30;CHILENO;;Millenial;"";"";0;0;0;0;0;0;0;0;0;SOPORTE TV 14-42 KTAM02 KIOTO C/ BRAZO MOVIL;ACCESORIOS
17684173;Soltero;M;31;CHILENO;;Millenial;PROVIDENCIA                   ;METROPOLITANA;0;0;0;0;0;0;0;0;0;AUDIFONO ON ZX310AP ROJO;ACCESORIOS
15141543;;F;35;CHILENO;;Silencioso;PROVIDENCIA                   ;METROPOLITANA;0;0;0;0;0;0;0;0;0;Funda Con Cierre 14;ACCESORIOS
8563012;;M;61;CHILENO;;Boomers;PROVIDENCIA                   ;METROPOLITANA;0;0;0;0;0;0;0;0;0;KARAOKE MLAB SUITCASE OUTDOOR MIC BT BK 8566;ACCESORIOS
17747024;;F;31;CHILENO;;Millenial;SAN FERNANDO                  ;L.G.B.OÂ´HIGGINS;0;0;0;0;0;0;0;0;0;SOPORTE TV 26-56 KTA02 KIOTO FIJO;ACCESORIOS
19830299;;F;24;CHILENO;;Z;QUINTA NORMAL                 ;METROPOLITANA;0;0;0;0;0;0;0;0;0;PARLANTE KARAOKE FD-PKBT82 8 LUCES MIC/FM/BT/USB;ACCESORIOS
20237733;;F;23;CHILENO;;Silencioso;PROVIDENCIA                   ;METROPOLITANA;0;0;0;0;0;0;0;0;0;CABLE DE DATOS MICRO HUAWEI USB AP70;ACCESORIOS
11240208;;M;53;CHILENO;;Silencioso;PROVIDENCIA                   ;METROPOLITANA;0;0;0;0;0;0;0;0;0;POWERBANK 10000 MAH NEGRO GYRUX;ACCESORIOS
13887652;;M;41;CHILENO;;X;SAN JAVIER                    ;MAULE;0;0;0;0;0;0;0;0;0;AUDIFONO BLUETOOTH RP-HF410BPUA BT 24HRS AZUL;ACCESORIOS
19846628;;M;23;CHILENO;;Z;PROVIDENCIA                   ;METROPOLITANA;0;0;0;0;0;0;0;0;0;AUDIFONO SAMSUNG WIRELESS A08C;ACCESORIOS
19175949;;F;29;CHILENO;;Millenial;PROVIDENCIA                   ;METROPOLITANA;0;0;0;0;0;0;0;0;0;AUDIFONO ON ZX110 SONY NEGRO;ACCESORIOS
10045740;;F;57;CHILENO;;Boomers;LA PINTANA                    ;METROPOLITANA;0;0;0;0;0;0;0;0;0;SMARTBAND SAMSUNG GALAXY FIT 2 NEGRO;ACCESORIOS
19835382;;M;24;CHILENO;;Z;PROVIDENCIA                   ;METROPOLITANA;0;0;0;0;0;0;0;0;0;PARLANTE 8531 MLAB MAX BASS BT;ACCESORIOS
18917760;;M;27;CHILENO;;Z;VALPARAISO                    ;VALPARAISO;0;0;0;0;0;0;0;0;0;Disco Portatil Toshiba Canvio Gaming, Negro 4T;ACCESORIOS
5365110;;M;79;CHILENO;;Silencioso;RENGO                         ;L.G.B.OÂ´HIGGINS;0;0;0;0;0;0;0;0;0;PARLANTE 8247 MLAB SOUNDLAB BLACK;ACCESORIOS
18404450;;M;29;CHILENO;;Millenial;PROVIDENCIA                   ;METROPOLITANA;0;0;0;0;0;0;0;0;0;AUDIFONO MLAB TWS FULLY WIRELESSÂ  WHITE 8721;ACCESORIOS
18781396;;M;27;CHILENO;;Silencioso;PROVIDENCIA                   ;METROPOLITANA;0;0;0;0;0;0;0;0;0;SILLA GAMER SAMURAI TENGU - NEGRO;ACCESORIOS
18375838;;M;29;CHILENO;;Millenial;PROVIDENCIA                   ;METROPOLITANA;0;0;0;0;0;0;0;0;0;AUDIFONO TAT1235 PHILIPS NEGRO;ACCESORIOS
14378280;;M;43;CHILENO;;X;N/D;N/D;0;0;0;0;0;0;0;0;0;SOPORTE TV 14-42 KTAM02 KIOTO C/ BRAZO MOVIL;ACCESORIOS
17412220;;F;32;CHILENO;;Millenial;PROVIDENCIA                   ;METROPOLITANA;0;0;0;0;0;0;0;0;0;AUDIFONO IN PANASONIC RP-TCM130PPA AZUL;ACCESORIOS
7166260;;M;67;CHILENO;;Boomers;CALAMA                        ;ANTOFAGASTA;0;0;0;0;0;0;0;0;0;PARLANTE ZUKABASS 4 BT USB/SD/FM CALACAS;ACCESORIOS
15419749;;M;40;CHILENO;;X;ARICA                         ;TARAPACA;0;0;0;0;0;0;0;0;0;BATERY PACK TIPO C 10.000 MAH SAMSUNG;ACCESORIOS
17061250;;F;33;CHILENO;;Millenial;N/D;N/D;0;0;0;0;0;0;0;0;0;AUDIFONO SAMSUNG WIRELESS A08C;ACCESORIOS
6684839;Casado;M;68;CHILENO;;Silencioso;RENCA                         ;METROPOLITANA;0;0;0;0;0;0;0;0;0;SOPORTE TV 26-56 KTA02 KIOTO FIJO;ACCESORIOS
6109744;Casado;M;74;CHILENO;INGENIERO AGRICOLA;Silencioso;PROVIDENCIA                   ;METROPOLITANA;0;0;0;0;0;0;0;0;0;RADIO RETRO ANTIQUE 8732;ACCESORIOS
6842698;;F;70;CHILENO;;Silencioso;"";"";0;0;0;0;0;0;0;0;0;MI WATCH NEGRO XIAOMI;ACCESORIOS
17456834;;M;31;CHILENO;;Millenial;SANTO DOMINGO                 ;VALPARAISO;0;0;0;0;0;0;0;0;0;PARLANTE ZUKABASS 4 BT USB/SD/FM CALACAS;ACCESORIOS
13770761;;M;41;CHILENO;;X;MARIA PINTO                   ;METROPOLITANA;0;0;0;0;0;0;0;0;0;TRAVEL ADAPTER 15W - FAST CHARGER (TYPE-C CABLE);ACCESORIOS
17015060;;M;33;CHILENO;;Millenial;LA SERENA                     ;COQUIMBO;0;0;0;0;0;0;0;0;0;ITFIT Tripode Selfie Stick;ACCESORIOS
15531052;;M;39;CHILENO;;X;VALDIVIA                      ;LOS RIOS;0;0;0;0;0;0;0;0;0;SOPORTE TV 14-63 CON BRAZO KT-FM 3L;ACCESORIOS
6213847;;F;76;CHILENO;;Silencioso;RENCA                         ;METROPOLITANA;0;0;0;0;0;0;0;0;0;PARLANTE ZUKABASS + MICROFONO MLAB BT ROJO;ACCESORIOS
17447717;Soltero;M;32;CHILENO;;Silencioso;PROVIDENCIA                   ;METROPOLITANA;0;0;0;0;0;0;0;0;0;Smartwatch GT 2E GREEN;ACCESORIOS
18809533;;F;27;CHILENO;;Millenial;ARAUCO                        ;BIO BIO;0;0;0;0;0;0;0;0;0;DISCO DURO CANVIO 2TB BASICS BLACK TOSHIBA;ACCESORIOS
13425451;;M;43;CHILENO;;X;N/D;N/D;0;0;0;0;0;0;0;0;0;AUDIFONO PANASONIC IN RP-HV096E-K NEGRO;ACCESORIOS
19142981;Soltero;F;26;CHILENO;;Silencioso;PROVIDENCIA                   ;METROPOLITANA;0;0;0;0;0;0;0;0;0;RADIO RETRO MINI WOOGIE 8751;ACCESORIOS
20051272;;F;23;CHILENO;;Z;PROVIDENCIA                   ;METROPOLITANA;0;0;0;0;0;0;0;0;0;MOUSE 200 Inalambrico GOLD;ACCESORIOS
19797655;;F;24;CHILENO;;Z;CHILLAN                       ;BIO BIO;0;0;0;0;0;0;0;0;0;BATERY PACK TIPO C 10.000 MAH SAMSUNG;ACCESORIOS
18777257;;F;28;CHILENO;;Millenial;N/D;N/D;0;0;0;0;0;0;0;0;0;BAND 4 BLACK;ACCESORIOS
20570775;;M;21;CHILENO;;Z;N/D;N/D;0;0;0;0;0;0;0;0;0;PARLANTE 8247 MLAB SOUNDLAB BLACK;ACCESORIOS
16497208;;F;35;CHILENO;;Millenial;CHILLAN;BIO-BIO;0;0;0;0;0;0;0;0;0;Smartwatch ACTIVE 1 NEGRO;ACCESORIOS
19206269;;M;26;CHILENO;;Z;N/D;N/D;0;0;0;0;0;0;0;0;0;DISCO DURO CANVIO 4TB BASICS BLACK;ACCESORIOS
12085580;Casado;F;54;CHILENO;;X;PROVIDENCIA                   ;METROPOLITANA;0;0;0;0;0;0;0;0;0;Smartwatch ACTIVE 2 GOLD;ACCESORIOS
12165798;;M;47;CHILENO;;X;PROVIDENCIA                   ;METROPOLITANA;0;0;0;0;0;0;0;0;0;AUDIFONO XIAOMI EARBUDS MI TRUE WIRELESS BASIC 2;ACCESORIOS
7796930;;M;66;CHILENO;;Boomers;LINARES                       ;MAULE;0;0;0;0;0;0;0;0;0;DISCO DURO CANVIO 1TB BASICS BLACK TOSHIBA;ACCESORIOS
18427841;;F;29;CHILENO;;Millenial;PROVIDENCIA                   ;METROPOLITANA;0;0;0;0;0;0;0;0;0;AUDIFONO XIAOMI EARBUDS MI TRUE WIRELESS BASIC 2;ACCESORIOS
18710949;;F;28;CHILENO;;Millenial;COPIAPO                       ;ATACAMA;0;0;0;0;0;0;0;0;0;AUDIFONO IN SAM C/ MIC EG920 BLACK;ACCESORIOS
19463149;Soltero;M;25;CHILENO;;Silencioso;PROVIDENCIA                   ;METROPOLITANA;0;0;0;0;0;0;0;0;0;Smartwatch ACTIVE 1 NEGRO;ACCESORIOS
19248399;;M;26;CHILENO;;Z;PANGUIPULLI                   ;LOS RIOS;0;0;0;0;0;0;0;0;0;PARLANTE 8247 MLAB SOUNDLAB BLACK;ACCESORIOS
19395994;Soltero;M;26;CHILENO;;Silencioso;PROVIDENCIA                   ;METROPOLITANA;0;0;0;0;0;0;0;0;0;Smartwatch ACTIVE 1 NEGRO;ACCESORIOS
8089318;;M;65;CHILENO;;Boomers;RENCA                         ;METROPOLITANA;0;0;0;0;0;0;0;0;0;MEMORIA MICROSD CLASE 10 32GB SANDISK;ACCESORIOS
20379843;;M;22;CHILENO;;Silencioso;PROVIDENCIA                   ;METROPOLITANA;0;0;0;0;0;0;0;0;0;Smartwatch ACTIVE 2 BLACK;ACCESORIOS
18054317;;M;30;CHILENO;;Millenial;PROVIDENCIA                   ;METROPOLITANA;0;0;0;0;0;0;0;0;0;AUDIFONO GALAXY BUDS PLUS NEGRO;ACCESORIOS
16293186;;M;35;CHILENO;;Millenial;CONCEPCION                    ;BIO BIO;0;0;0;0;0;0;0;0;0;PENDRIVE 64GB USB 3.0 DT100G3;ACCESORIOS
19163496;;F;26;CHILENO;;Z;PROVIDENCIA                   ;METROPOLITANA;0;0;0;0;0;0;0;0;0;AUDIFONO TAT1235 PHILIPS BLANCO;ACCESORIOS
26594375;;M;28;EXTRANJERO - NO INFORMA NACIONALIDAD;;Extranjero;N/D;N/D;0;0;0;0;0;0;0;0;0;KIT PENDRIVE 16GB+POWERBANK3000;ACCESORIOS
20400102;;F;22;CHILENO;;Silencioso;PROVIDENCIA                   ;METROPOLITANA;0;0;0;0;0;0;0;0;0;AUDIFONO IN PANASONIC RP-TCM130PPA AZUL;ACCESORIOS
8721868;;M;61;CHILENO;;Boomers;RENCA                         ;METROPOLITANA;0;0;0;0;0;0;0;0;0;TRAVEL ADAPTER 15W - FAST CHARGER (TYPE-C CABLE);ACCESORIOS
11855682;;F;51;CHILENO;;X;ARICA                         ;ARICA Y PARINACOTA;0;0;0;0;0;0;0;0;0;RADIO RETRO ANTIQUE 8732;ACCESORIOS
19492198;;M;25;CHILENO;;Z;PROVIDENCIA                   ;METROPOLITANA;0;0;0;0;0;0;0;0;0;AUDIFONO XIAOMI EARBUDS MI TRUE WIRELESS BASIC 2;ACCESORIOS
15889836;;M;37;CHILENO;;Millenial;N/D;N/D;0;0;0;0;0;0;0;0;0;AUDIFONO XIAOMI EARBUDS MI TRUE WIRELESS BASIC 2;ACCESORIOS
18826664;Soltero;F;27;CHILENO;;Z;PROVIDENCIA                   ;METROPOLITANA;0;0;0;0;0;0;0;0;0;MOUSE HP Z3700 Black WIRELESS;ACCESORIOS
13150636;;F;45;CHILENO;;Silencioso;PROVIDENCIA                   ;METROPOLITANA;0;0;0;0;0;0;0;0;0;TRIPODE SELFIE HUAWEI STICK PRO BLACK;ACCESORIOS
17719828;;F;29;CHILENO;;Millenial;PROVIDENCIA                   ;METROPOLITANA;0;0;0;0;0;0;0;0;0;True Wireless Philips TAT3215 6+18 Hrs Negro;ACCESORIOS
11426979;Casado;M;52;CHILENO;;X;PROVIDENCIA                   ;METROPOLITANA;0;0;0;0;0;0;0;0;0;AUDIFONO IN SAM HS1303C/ MIC NEGRO;ACCESORIOS
19154221;Soltero;F;26;CHILENO;PROFESOR;Z;PROVIDENCIA                   ;METROPOLITANA;0;0;0;0;0;0;0;0;0;Smartwatch ACTIVE 1 NEGRO;ACCESORIOS
20386133;;M;27;CHILENO;;Z;POZO ALMONTE                  ;TARAPACA;0;0;0;0;0;0;0;0;0;DISCO DURO CANVIO 1TB BASICS BLACK TOSHIBA;ACCESORIOS
19091994;;M;26;CHILENO;;Z;N/D;N/D;0;0;0;0;0;0;0;0;0;MOUSE 200 Inalambrico GOLD;ACCESORIOS
13341019;;M;44;CHILENO;;Silencioso;PROVIDENCIA                   ;METROPOLITANA;0;0;0;0;0;0;0;0;0;SMARTBAND SAMSUNG GALAXY FIT 2 ROJO;ACCESORIOS
14315006;;F;46;CHILENO;;X;BUIN                          ;METROPOLITANA;0;0;0;0;0;0;0;0;0;Smartwatch GT 2 BLACK;ACCESORIOS
18685078;;M;27;CHILENO;;Millenial;TALCAHUANO                    ;BIO BIO;0;0;0;0;0;0;0;0;0;Headset G635 7.1 Surround Sound LIGHTSYNC Gaming;ACCESORIOS
26146066;Soltero;M;28;HAITIANO;;Extranjero;PROVIDENCIA                   ;METROPOLITANA;0;0;0;0;0;0;0;0;0;SOPORTE TV 26-56 KTA02 KIOTO FIJO;ACCESORIOS
15606486;;F;38;CHILENO;;Millenial;RECOLETA                      ;METROPOLITANA;0;0;0;0;0;0;0;0;0;Kit gamer 3 en 1;ACCESORIOS
18413065;;M;28;CHILENO;;Silencioso;PROVIDENCIA                   ;METROPOLITANA;0;0;0;0;0;0;0;0;0;Smartwatch ACTIVE 1 DORADO;ACCESORIOS
10104935;;F;58;CHILENO;;Boomers;N/D;N/D;0;0;0;0;0;0;0;0;0;PARLANTE GO 2 BLUETOOTH AZUL;ACCESORIOS
20060342;;M;23;CHILENO;;Z;PROVIDENCIA                   ;METROPOLITANA;0;0;0;0;0;0;0;0;0;Disco Portatil Toshiba Canvio Gaming, Negro 1T;ACCESORIOS
18753088;;F;27;CHILENO;;Millenial;PUERTO MONTT;LOS LAGOS;0;0;0;0;0;0;0;0;0;AUDIFONO IN SAM C/ MIC EG920 BLACK;ACCESORIOS
18940077;;F;27;CHILENO;;Z;PROVIDENCIA                   ;METROPOLITANA;0;0;0;0;0;0;0;0;0;MOUSE HP Z3700 SILVER WIRELESS;ACCESORIOS
26049549;;M;39;VENEZOLANO;;Extranjero;CHILLAN                       ;BIO BIO;0;0;0;0;0;0;0;0;0;True Wireless Philips SHB2505 5+15 Hrs Negro;ACCESORIOS
18328042;Casado;F;29;CHILENO;;Silencioso;PROVIDENCIA                   ;METROPOLITANA;0;0;0;0;0;0;0;0;0;SMARTBAND SAMSUNG GALAXY FIT 2 NEGRO;ACCESORIOS
10258822;;F;51;CHILENO;;Silencioso;PROVIDENCIA                   ;METROPOLITANA;0;0;0;0;0;0;0;0;0;AUDIFONO ON ZX310AP BLANCO;ACCESORIOS
16099106;;F;36;CHILENO;;Millenial;LA CISTERNA                   ;METROPOLITANA;0;0;0;0;0;0;0;0;0;AUDIFONO XIAOMI EARBUDS MI TRUE WIRELESS BASIC 2;ACCESORIOS
19363991;;M;25;CHILENO;;Z;N/D;N/D;0;0;0;0;0;0;0;0;0;AUDIFONO IN PHI C/MIC SHE-3595BL AZUL;ACCESORIOS
19746163;;M;24;CHILENO;;Z;CONCHALI;METROPOLITANA;0;0;0;0;0;0;0;0;0;AUDIFONO GALAXY BUDS LIVE COBRE;ACCESORIOS
12514970;;M;49;CHILENO;;X;RANCAGUA                      ;L.G.B.OÂ´HIGGINS;0;0;0;0;0;0;0;0;0;Smartwatch GT 2 BLACK;ACCESORIOS
25459276;;M;35;HAITIANO;;Extranjero;N/D;N/D;0;0;0;0;0;0;0;0;0;PARLANTE ALTEC LANSING MINI H20 GREY;ACCESORIOS
16542295;;F;35;CHILENO;;Millenial;VILLA ALEGRE                  ;MAULE;0;0;0;0;0;0;0;0;0;PARLANTE 8531 MLAB MAX BASS BT;ACCESORIOS
14349013;;F;42;CHILENO;;X;PROVIDENCIA                   ;METROPOLITANA;0;0;0;0;0;0;0;0;0;AUDIFONO IN E9LP SONY BZ NEGRO;ACCESORIOS
19584964;;F;25;CHILENO;;Z;N/D;N/D;0;0;0;0;0;0;0;0;0;POWERBANK MLAB MOBILE 12.000MAH WHITE 7761;ACCESORIOS
17300118;;F;33;CHILENO;;Millenial;RENCA                         ;METROPOLITANA;0;0;0;0;0;0;0;0;0;AUDIFONO IN SAM C/ MIC EG920 BLACK;ACCESORIOS
16158426;;F;37;CHILENO;;Millenial;PROVIDENCIA                   ;METROPOLITANA;0;0;0;0;0;0;0;0;0;AUDIFONO BLUETOOTH RP-HTX80BPPC PANASONIC CREMA;ACCESORIOS
16102642;Soltero;M;36;CHILENO;;Millenial;PROVIDENCIA                   ;METROPOLITANA;0;0;0;0;0;0;0;0;0;BAND 4 BLACK;ACCESORIOS
17697626;;M;31;CHILENO;;Silencioso;PROVIDENCIA                   ;METROPOLITANA;0;0;0;0;0;0;0;0;0;MOCHILA DENVER 19 MELANGE BURDEO;ACCESORIOS
16832322;;F;33;CHILENO;;Silencioso;PROVIDENCIA                   ;METROPOLITANA;0;0;0;0;0;0;0;0;0;ITFIT Tripode Selfie Stick;ACCESORIOS
17838504;;F;31;CHILENO;;Millenial;PEDRO AGUIRRE CERDA           ;METROPOLITANA;0;0;0;0;0;0;0;0;0;SILLA GAMER MODELO VIKING ROSADO;ACCESORIOS
17780528;Soltero;F;31;CHILENO;TECNICO DE NIVEL SUPERIOR EN ENFERMERIA;Millenial;PROVIDENCIA                   ;METROPOLITANA;0;0;0;0;0;0;0;0;0;MEMORIA MICROSD CLASE 10 128GB SANDISK;ACCESORIOS
12919008;;M;47;CHILENO;;X;CONCEPCION                    ;BIO BIO;0;0;0;0;0;0;0;0;0;AUDIFONO Bluetooth BE7 Azul;ACCESORIOS
18001008;Soltero;F;30;CHILENO;;Millenial;PROVIDENCIA                   ;METROPOLITANA;0;0;0;0;0;0;0;0;0;AUDIFONO ON ZX310AP NEGRO;ACCESORIOS
12280661;;M;49;CHILENO;;X;PUENTE ALTO                   ;METROPOLITANA;0;0;0;0;0;0;0;0;0;RADIO AUTO SONY DSX-A410BT;ACCESORIOS
19067317;;M;26;CHILENO;;Z;PROVIDENCIA                   ;METROPOLITANA;0;0;0;0;0;0;0;0;0;AUDIFONO BLUETOOTH RP-HF410BPUA BT 24HRS AZUL;ACCESORIOS
25977714;;M;42;PERUANO;;Extranjero;N/D;N/D;0;0;0;0;0;0;0;0;0;AUDIFONO SAMSUNG WIRELESS A08C;ACCESORIOS
8010297;Casado;M;65;CHILENO;INGENIERO COMERCIAL;Silencioso;PROVIDENCIA                   ;METROPOLITANA;0;0;0;0;0;0;0;0;0;AUDIFONO Bluetooth BE7 Azul;ACCESORIOS
19119139;Soltero;F;27;CHILENO;;Z;PROVIDENCIA                   ;METROPOLITANA;0;0;0;0;0;0;0;0;0;365 Personal Suscripcion Anual;ACCESORIOS
19213488;Soltero;M;25;CHILENO;;Silencioso;PROVIDENCIA                   ;METROPOLITANA;0;0;0;0;0;0;0;0;0;HUAWEI Sport Bluetooth Headphones Lite Black AM6;ACCESORIOS
17793340;Soltero;M;30;CHILENO;;Millenial;PROVIDENCIA                   ;METROPOLITANA;0;0;0;0;0;0;0;0;0;Mouse Pad G240 Gaming Logitech Negro;ACCESORIOS
16026411;;F;37;CHILENO;;Millenial;RENCA                         ;METROPOLITANA;0;0;0;0;0;0;0;0;0;AUDIFONO IN EX15AP SONY NEGRO;ACCESORIOS
9843970;;M;58;CHILENO;;Boomers;PROVIDENCIA                   ;METROPOLITANA;0;0;0;0;0;0;0;0;0;True Wireless Philips SHB2505 5+15 Hrs Negro;ACCESORIOS
18350833;;F;29;CHILENO;;Millenial;TRAIGUEN                      ;ARAUCANIA;0;0;0;0;0;0;0;0;0;AUDIFONO PANASONIC IN RP-HV096E-K NEGRO;ACCESORIOS
18664314;Soltero;F;29;CHILENO;;Millenial;PROVIDENCIA                   ;METROPOLITANA;0;0;0;0;0;0;0;0;0;SOPORTE TV 26-56 KTA02 KIOTO FIJO;ACCESORIOS
18820311;;F;26;CHILENO;;Z;PROVIDENCIA                   ;METROPOLITANA;0;0;0;0;0;0;0;0;0;AUDIFONO BLUETOOTH PANASONIC RP-HJE120B NEGRO;ACCESORIOS
17998316;;F;30;CHILENO;;Millenial;LA SERENA;COQUIMBO;0;0;0;0;0;0;0;0;0;True Wireless Philips TAT2205 4+8 Hrs Rojo;ACCESORIOS
8022583;;M;64;CHILENO;;Boomers;PROVIDENCIA                   ;METROPOLITANA;0;0;0;0;0;0;0;0;0;RADIO RETRO ANTIQUE 8732;ACCESORIOS
19691382;;M;25;CHILENO;;Z;FREIRINA                      ;ATACAMA;0;0;0;0;0;0;0;0;0;AUDIFONO IN EX15AP SONY NEGRO;ACCESORIOS
7254613;;M;64;CHILENO;;Boomers;LA CISTERNA                   ;METROPOLITANA;0;0;0;0;0;0;0;0;0;Smartwatch GT 2 BLACK;ACCESORIOS
17698930;;M;31;CHILENO;;Silencioso;PROVIDENCIA                   ;METROPOLITANA;0;0;0;0;0;0;0;0;0;AUDIFONO IN SAM FIT EG920 BLANCO;ACCESORIOS
15512726;Soltero;F;38;CHILENO;;X;VILLARICA                     ;ARAUCANIA;0;0;0;0;0;0;0;0;0;AUDIFONO ON ZX110 SONY ROSA;ACCESORIOS
17565952;;F;31;CHILENO;;Millenial;N/D;N/D;0;0;0;0;0;0;0;0;0;AUDIFONO MLAB AIR-VICTORY WHITE 8725;ACCESORIOS
16669406;;M;35;CHILENO;;Millenial;TALAGANTE                     ;METROPOLITANA;0;0;0;0;0;0;0;0;0;AUDIFONO MLAB TWS FULLY WIRELESSÂ  WHITE 8721;ACCESORIOS
17047578;;F;34;CHILENO;;Millenial;"";"";0;0;0;0;0;0;0;0;0;Smartwatch GALAXY WATCH GOLD;ACCESORIOS
18346388;Soltero;M;29;CHILENO;;Silencioso;PROVIDENCIA                   ;METROPOLITANA;0;0;0;0;0;0;0;0;0;Smartwatch GALAXY WATCH GOLD;ACCESORIOS
7034608;;F;57;CHILENO;;Boomers;ANCUD                         ;LOS LAGOS;0;0;0;0;0;0;0;0;0;DISCO DURO CANVIO 2TB BASICS BLACK TOSHIBA;ACCESORIOS
12383772;;M;48;CHILENO;;X;PROVIDENCIA                   ;METROPOLITANA;0;0;0;0;0;0;0;0;0;SOPORTE TV 26-56 KTA02 KIOTO FIJO;ACCESORIOS
20108369;;M;23;CHILENO;;Silencioso;PROVIDENCIA                   ;METROPOLITANA;0;0;0;0;0;0;0;0;0;AUDIFONO AIR-VICTORY BLACK 8724;ACCESORIOS
19758650;;M;24;CHILENO;;Z;PROVIDENCIA                   ;METROPOLITANA;0;0;0;0;0;0;0;0;0;Smartwatch ACTIVE 1 VERDE;ACCESORIOS
16897314;;M;33;CHILENO;;Millenial;PROVIDENCIA                   ;METROPOLITANA;0;0;0;0;0;0;0;0;0;PARLANTE GO 2 BLUETOOTH AZUL;ACCESORIOS
12431465;Soltero;M;49;CHILENO;TECNICO MECANICO;X;PROVIDENCIA                   ;METROPOLITANA;0;0;0;0;0;0;0;0;0;HUAWEI Sport Bluetooth Headphones Lite Black AM6;ACCESORIOS
16063000;;F;36;CHILENO;;Millenial;LOS ANGELES                   ;BIO BIO;0;0;0;0;0;0;0;0;0;KIT PREPAGO HD DIRECTV;ACCESORIOS
12704050;;F;48;CHILENO;;X;CORONEL                       ;BIO BIO;0;0;0;0;0;0;0;0;0;SOPORTE TV 32-65 KTA03 KIOTO FIJO;ACCESORIOS
18342625;Soltero;F;29;CHILENO;ENFERMERA;Millenial;PROVIDENCIA                   ;METROPOLITANA;0;0;0;0;0;0;0;0;0;DISCO DURO CANVIO 1TB BASICS BLACK TOSHIBA;ACCESORIOS
6523985;;M;62;CHILENO;;Boomers;PROVIDENCIA                   ;METROPOLITANA;0;0;0;0;0;0;0;0;0;SMARTBAND SAMSUNG GALAXY FIT 2 NEGRO;ACCESORIOS
14900438;;F;40;CHILENO;;X;RENCA                         ;METROPOLITANA;0;0;0;0;0;0;0;0;0;AUDIFONO MLAB TWS IN-AIR WHITE 8533;ACCESORIOS
20274008;;M;22;CHILENO;;Z;SAN ANTONIO                   ;VALPARAISO;0;0;0;0;0;0;0;0;0;CABLE DE DATOS USB TIPO C HUAWEI SUPER CHARGER A;ACCESORIOS
5915787;;M;72;CHILENO;;Silencioso;PROVIDENCIA                   ;METROPOLITANA;0;0;0;0;0;0;0;0;0;SOPORTE TV 26-56 KTAT02 KIOTO MOVIL;ACCESORIOS
27035501;;M;41;URUGUAYO;;Extranjero;N/D;N/D;0;0;0;0;0;0;0;0;0;SMARTWATCH HUAWEI WATCH FIT BLACK;ACCESORIOS
5506311;;F;77;CHILENO;;Silencioso;RENCA                         ;METROPOLITANA;0;0;0;0;0;0;0;0;0;AUDIFONO IN SAM HS1303C/ MIC BLANCO;ACCESORIOS
7358862;;F;67;CHILENO;;Boomers;PROVIDENCIA                   ;METROPOLITANA;0;0;0;0;0;0;0;0;0;RADIO RETRO MINI WOOGIE 8751;ACCESORIOS
12264877;;M;49;CHILENO;;X;PROVIDENCIA                   ;METROPOLITANA;0;0;0;0;0;0;0;0;0;AUDIFONO MLAB TWS FULLY WIRELESSÂ  WHITE 8721;ACCESORIOS
5727787;Viudo;F;73;CHILENO;;Silencioso;PROVIDENCIA                   ;METROPOLITANA;0;0;0;0;0;0;0;0;0;PARLANTE 7284 MLAB ZUKABASS NARAN/VERDE BT;ACCESORIOS
17682689;;F;32;CHILENO;;Millenial;PROVIDENCIA                   ;METROPOLITANA;0;0;0;0;0;0;0;0;0;PARLANTE 8531 MLAB MAX BASS BT;ACCESORIOS
14848001;;M;39;CHILENO;;X;"";"";0;0;0;0;0;0;0;0;0;MOUSE M170 LOGITECH NEGRO;ACCESORIOS
17713752;;F;31;CHILENO;;Extranjero;N/D;N/D;0;0;0;0;0;0;0;0;0;AUDIFONO MLAB TWS IN-AIR WHITE 8533;ACCESORIOS
18867542;Soltero;F;27;CHILENO;;Millenial;PROVIDENCIA                   ;METROPOLITANA;0;0;0;0;0;0;0;0;0;AUDIFONO ON SONY ZX110 BLANCO;ACCESORIOS
19260475;;F;25;CHILENO;;Extranjero;N/D;N/D;0;0;0;0;0;0;0;0;0;AUDIFONO PANASONIC BT ON RP-HF410BPUK NEGRO;ACCESORIOS
17533914;Soltero;M;32;CHILENO;;Millenial;PROVIDENCIA                   ;METROPOLITANA;0;0;0;0;0;0;0;0;0;MOUSE 300 Dual Mode BLACK;ACCESORIOS
9349635;;F;60;CHILENO;;Boomers;MAIPU                         ;METROPOLITANA;0;0;0;0;0;0;0;0;0;AUDIFONO MLAB AIR-VICTORY WHITE 8725;ACCESORIOS
18692059;Soltero;M;27;CHILENO;TECNICO DE NIVEL SUPERIOR EN LABORATORIO CLINICO BANCO DE SANGRE E IMAGENOLOGIA;Z;PROVIDENCIA                   ;METROPOLITANA;0;0;0;0;0;0;0;0;0;MEMORIA MICROSD CLASE 10 200GB SANDISK;ACCESORIOS
18043900;Soltero;F;29;CHILENO;;Millenial;PROVIDENCIA                   ;METROPOLITANA;0;0;0;0;0;0;0;0;0;365 Personal Suscripcion Anual;ACCESORIOS
17188044;;M;33;CHILENO;;Millenial;TRAIGUEN                      ;ARAUCANIA;0;0;0;0;0;0;0;0;0;AUDIFONO BLUETOOTH RP-HF410BPUA BT 24HRS AZUL;ACCESORIOS
16042341;Soltero;F;37;CHILENO;;Millenial;PROVIDENCIA                   ;METROPOLITANA;0;0;0;0;0;0;0;0;0;AUDIFONO AIR-VICTORY BLACK 8724;ACCESORIOS
13074297;;F;45;CHILENO;;X;PENALOLEN                     ;METROPOLITANA;0;0;0;0;0;0;0;0;0;PARLANTE 7279 MLAB ZUKABASS NEGRO BT;ACCESORIOS
23530132;;M;34;PERUANO;;Extranjero;HUECHURABA                    ;METROPOLITANA;0;0;0;0;0;0;0;0;0;True Wireless Philips TAT1215 6+12 Hrs Negro;ACCESORIOS
18527534;;F;29;CHILENO;;Millenial;PROVIDENCIA                   ;METROPOLITANA;0;0;0;0;0;0;0;0;0;AUDIFONO MLAB TWS IN-AIR WHITE 8533;ACCESORIOS
15866768;;F;37;CHILENO;;Millenial;RENCA                         ;METROPOLITANA;0;0;0;0;0;0;0;0;0;AUDIFONO BLUETOOTH RP-HF410BPUA BT 24HRS AZUL;ACCESORIOS
15715157;;F;39;CHILENO;;X;N/D;N/D;0;0;0;0;0;0;0;0;0;AUDIFONO BLUETOOTH PANASONIC RP-HJE120B NEGRO;ACCESORIOS
19719990;;M;24;CHILENO;;Z;ANGOL                         ;ARAUCANIA;0;0;0;0;0;0;0;0;0;AUDIFONO MLAB TWS IN-AIR WHITE 8533;ACCESORIOS
12399939;;M;49;CHILENO;;X;LA LIGUA                      ;VALPARAISO;0;0;0;0;0;0;0;0;0;SOPORTE TV 32-65 KTA03 KIOTO FIJO;ACCESORIOS
10177130;Divorciado;M;50;CHILENO;AUXILIAR PARAMEDICO DE ENFERMERIA;X;RENCA                         ;METROPOLITANA;0;0;0;0;0;0;0;0;0;ITFIT Tripode Selfie Stick;ACCESORIOS
17845450;Casado;F;30;CHILENO;TECNICO EN ENFERMERIA DE NIVEL SUPERIOR;Millenial;RENCA                         ;METROPOLITANA;0;0;0;0;0;0;0;0;0;AUDIFONO IN SONY BT WI-C200 WHITE;ACCESORIOS
10363521;;F;45;CHILENO;;X;RENCA                         ;METROPOLITANA;0;0;0;0;0;0;0;0;0;MEMORIA MICROSD CLASE 10 32GB SANDISK;ACCESORIOS
11813113;;F;53;CHILENO;;X;ARICA                         ;ARICA Y PARINACOTA;0;0;0;0;0;0;0;0;0;AUDIFONO MLAB TWS IN-AIR WHITE 8533;ACCESORIOS
20400221;;F;21;CHILENO;;Z;PROVIDENCIA                   ;METROPOLITANA;0;0;0;0;0;0;0;0;0;AUDIFONO IN SONY BT WI-C200 BLACK;ACCESORIOS
9118592;;F;58;CHILENO;;Boomers;PROVIDENCIA                   ;METROPOLITANA;0;0;0;0;0;0;0;0;0;PARLANTE 6985 MLAB VERTICAL BRITPOP BT;ACCESORIOS
15680529;;M;37;CHILENO;;Millenial;PROVIDENCIA                   ;METROPOLITANA;0;0;0;0;0;0;0;0;0;DISCO DURO CANVIO 4TB BASICS BLACK;ACCESORIOS
11683819;;M;52;CHILENO;;X;LOTA                          ;BIO BIO;0;0;0;0;0;0;0;0;0;CARCASA ANYMODE, TAB A 8 KIDS COVER;ACCESORIOS
9390283;Casado;F;60;CHILENO;;Boomers;RENCA                         ;METROPOLITANA;0;0;0;0;0;0;0;0;0;PARLANTE ZUKABASS + MICROFONO MLAB BT ROJO;ACCESORIOS
13379944;;M;43;CHILENO;;X;HUALPEN;BIO BIO;0;0;0;0;0;0;0;0;0;Smartwatch GALAXY WATCH SILVER;ACCESORIOS
16195638;;M;36;CHILENO;;Millenial;PROVIDENCIA                   ;METROPOLITANA;0;0;0;0;0;0;0;0;0;AUDIFONO GALAXY BUDS PLUS NEGRO;ACCESORIOS
15915814;Soltero;F;38;CHILENO;PROFESOR;Millenial;RENCA                         ;METROPOLITANA;0;0;0;0;0;0;0;0;0;SOPORTE TV 14-63 CON BRAZO KT-FM 3L;ACCESORIOS
11666947;;M;52;CHILENO;;X;PROVIDENCIA                   ;METROPOLITANA;0;0;0;0;0;0;0;0;0;AUDIFONO ON SONY ZX110 BLANCO;ACCESORIOS
26972457;;F;34;VENEZOLANO;;Extranjero;N/D;N/D;0;0;0;0;0;0;0;0;0;PARLANTE 8531 MLAB MAX BASS BT;ACCESORIOS
17914637;;M;31;CHILENO;;Millenial;TEMUCO                        ;ARAUCANIA;0;0;0;0;0;0;0;0;0;PARLANTE 6985 MLAB VERTICAL BRITPOP BT;ACCESORIOS
13631037;;M;43;CHILENO;;X;TEMUCO                        ;ARAUCANIA;0;0;0;0;0;0;0;0;0;AUDIFONO IN SAM C/ MIC EG920 BLACK;ACCESORIOS
9584072;;M;46;CHILENO;;X;RENCA                         ;METROPOLITANA;0;0;0;0;0;0;0;0;0;APPLE 30WUSB-C POWER ADAPTER;ACCESORIOS
13864207;;M;42;CHILENO;;X;POZO ALMONTE                  ;TARAPACA;0;0;0;0;0;0;0;0;0;PARLANTE ZUKABASS + MICROFONO MLAB BT ROJO;ACCESORIOS
13726298;;F;43;CHILENO;;X;CORONEL                       ;BIO BIO;0;0;0;0;0;0;0;0;0;KIT PREPAGO HD DIRECTV;ACCESORIOS
8971356;Casado;F;61;CHILENO;;Boomers;PROVIDENCIA                   ;METROPOLITANA;0;0;0;0;0;0;0;0;0;KIT PREPAGO HD DIRECTV;ACCESORIOS
15313093;;M;39;CHILENO;;X;PROVIDENCIA                   ;METROPOLITANA;0;0;0;0;0;0;0;0;0;MEMORIA MICROSD CLASE 10 200GB SANDISK;ACCESORIOS
14342320;;M;45;CHILENO;;X;RENCA                         ;METROPOLITANA;0;0;0;0;0;0;0;0;0;AUDIFONO ON SONY ZX110 BLANCO;ACCESORIOS
18245673;Soltero;M;29;CHILENO;LICENCIADO EN HISTORIA;Millenial;PROVIDENCIA                   ;METROPOLITANA;0;0;0;0;0;0;0;0;0;DISCO DURO CANVIO 2TB BASICS BLACK TOSHIBA;ACCESORIOS
18343011;;F;29;CHILENO;;Millenial;COLBUN                        ;MAULE;0;0;0;0;0;0;0;0;0;PARLANTE BT MICRO ALOHA 8648;ACCESORIOS
9930007;;F;57;CHILENO;;Boomers;SAN FERNANDO                  ;L.G.B.OÂ´HIGGINS;0;0;0;0;0;0;0;0;0;AUDIFONO MLAB TWS IN-AIR WHITE 8533;ACCESORIOS
17451148;;F;32;CHILENO;;Millenial;N/D;N/D;0;0;0;0;0;0;0;0;0;AUDIFONO MLAB TWS FULLY WIRELESSÂ  WHITE 8721;ACCESORIOS
13979993;Soltero;M;41;CHILENO;;X;RENCA                         ;METROPOLITANA;0;0;0;0;0;0;0;0;0;KIT DIRECTV GO BOX;ACCESORIOS
17070310;;F;33;CHILENO;;Millenial;PEDRO AGUIRRE CERDA           ;METROPOLITANA;0;0;0;0;0;0;0;0;0;AUDIFONO IN E9LP SONY GRIS;ACCESORIOS
15675018;;M;38;CHILENO;;Millenial;LA SERENA                     ;COQUIMBO;0;0;0;0;0;0;0;0;0;PENDRIVE CRUZERBLADE Z50 SANDISK 16GB;ACCESORIOS
16331976;;M;35;CHILENO;;Millenial;QUILPUE                       ;VALPARAISO;0;0;0;0;0;0;0;0;0;AUDIFONO IN SPORT HS34PC PNS AZUL;ACCESORIOS
17892957;;M;31;CHILENO;;Millenial;N/D;N/D;0;0;0;0;0;0;0;0;0;True Wireless Philips TAT1215 6+12 Hrs Negro;ACCESORIOS
18287095;Soltero;M;29;CHILENO;;Millenial;PROVIDENCIA                   ;METROPOLITANA;0;0;0;0;0;0;0;0;0;AUDIFONO ON SONY WH-CH500 BLACK;ACCESORIOS
14098412;;F;41;CHILENO;;X;RENCA                         ;METROPOLITANA;0;0;0;0;0;0;0;0;0;SMARTBAND SAMSUNG GALAXY FIT 2 NEGRO;ACCESORIOS
16069302;;F;37;CHILENO;;Millenial;PROVIDENCIA                   ;METROPOLITANA;0;0;0;0;0;0;0;0;0;Smartwatch GT 2E GREEN;ACCESORIOS
16888960;;F;33;CHILENO;;Millenial;PROVIDENCIA                   ;METROPOLITANA;0;0;0;0;0;0;0;0;0;DISCO DURO ADVANCE 1TB BLUE TOSHIBA;ACCESORIOS
7004844;;M;68;CHILENO;;Silencioso;COLLIPULLI                    ;ARAUCANIA;0;0;0;0;0;0;0;0;0;SMARTWATCH GT 2 LATONA BROWN;ACCESORIOS
23957348;Casado;M;42;ARGENTINO;;Extranjero;PROVIDENCIA                   ;METROPOLITANA;0;0;0;0;0;0;0;0;0;AUDIFONO ON SONY WH-CH400 GRIS;ACCESORIOS
18127210;;M;30;CHILENO;;Millenial;RENCA                         ;METROPOLITANA;0;0;0;0;0;0;0;0;0;Smartwatch GT 2E GREEN;ACCESORIOS
9675125;;F;57;CHILENO;;Boomers;PROVIDENCIA                   ;METROPOLITANA;0;0;0;0;0;0;0;0;0;Smartwatch GT 2 WHITE;ACCESORIOS
7721126;;M;66;CHILENO;;Boomers;PROVIDENCIA                   ;METROPOLITANA;0;0;0;0;0;0;0;0;0;RADIO RETRO ANTIQUE 8732;ACCESORIOS
19478137;Soltero;F;25;CHILENO;TECNICO DE NIVEL SUPERIOR EN ENFERMERIA;Z;PROVIDENCIA                   ;METROPOLITANA;0;0;0;0;0;0;0;0;0;PARLANTE 6984 MLAB VERTICAL ROCK BT;ACCESORIOS
13425600;;F;43;CHILENO;;X;LA SERENA                     ;COQUIMBO;0;0;0;0;0;0;0;0;0;KARAOKE MLAB SUITCASE OUTDOOR MIC BT BK 8566;ACCESORIOS
17764802;;F;31;CHILENO;;Millenial;PROVIDENCIA                   ;METROPOLITANA;0;0;0;0;0;0;0;0;0;PARLANTE ZUKABASS + MICROFONO MLAB BT ROJO;ACCESORIOS
9837517;;M;59;CHILENO;;Boomers;PROVIDENCIA                   ;METROPOLITANA;0;0;0;0;0;0;0;0;0;SOPORTE TV 26-56 KTAT02 KIOTO MOVIL;ACCESORIOS
12924186;;M;46;CHILENO;;X;N/D;N/D;0;0;0;0;0;0;0;0;0;AUDIFONO IN E9LP SONY BLANCO;ACCESORIOS
16681288;;F;34;CHILENO;;Millenial;N/D;N/D;0;0;0;0;0;0;0;0;0;MOCHILA SERIES B NEGRO/GRIS HP;ACCESORIOS
20148741;;M;23;CHILENO;;Z;PEUMO                         ;L.G.B.OÂ´HIGGINS;0;0;0;0;0;0;0;0;0;AUDIFONO ON SONY WH-CH500 BLACK;ACCESORIOS
15399159;;M;39;CHILENO;;X;PROVIDENCIA                   ;METROPOLITANA;0;0;0;0;0;0;0;0;0;AUDIFONO IN GALAXI BUDS;ACCESORIOS
18094292;Soltero;M;30;CHILENO;;Millenial;PROVIDENCIA                   ;METROPOLITANA;0;0;0;0;0;0;0;0;0;DISCO DURO CANVIO 2TB BASICS BLACK TOSHIBA;ACCESORIOS
11378813;;F;53;CHILENO;;X;RENCA                         ;METROPOLITANA;0;0;0;0;0;0;0;0;0;PARLANTE 8531 MLAB MAX BASS BT;ACCESORIOS
11286537;;M;54;CHILENO;;X;YERBAS BUENAS                 ;MAULE;0;0;0;0;0;0;0;0;0;SOPORTE TV 26-56 KTAT02 KIOTO MOVIL;ACCESORIOS
17830683;;M;31;CHILENO;;Millenial;N/D;N/D;0;0;0;0;0;0;0;0;0;TRAVEL ADAPTER 15W - FAST CHARGER (TYPE-C CABLE);ACCESORIOS
17872266;Soltero;M;30;CHILENO;;Millenial;PROVIDENCIA                   ;METROPOLITANA;0;0;0;0;0;0;0;0;0;AUDIFONO IN SONY BT WI-C200 BLACK;ACCESORIOS
19178132;Soltero;M;26;CHILENO;;Z;PROVIDENCIA                   ;METROPOLITANA;0;0;0;0;0;0;0;0;0;MEMORIA MICROSD CLASE 10 64GB SANDISK;ACCESORIOS
8970745;;M;61;CHILENO;;Boomers;ARAUCO                        ;BIO BIO;0;0;0;0;0;0;0;0;0;MOUSE 200 Inalambrico GOLD;ACCESORIOS
18333597;Soltero;F;29;CHILENO;ENFERMERA;Millenial;PROVIDENCIA                   ;METROPOLITANA;0;0;0;0;0;0;0;0;0;DISCO DURO CANVIO 1TB BASICS BLACK TOSHIBA;ACCESORIOS
15566715;;M;38;CHILENO;;Millenial;PROVIDENCIA                   ;METROPOLITANA;0;0;0;0;0;0;0;0;0;HUAWEI FreeBuds Lite Black;ACCESORIOS
17377862;;M;33;CHILENO;;Millenial;VALDIVIA                      ;LOS RIOS;0;0;0;0;0;0;0;0;0;MLAB KARAOKE OUTDOOR FUN GREEN 8564;ACCESORIOS
13650654;;M;43;CHILENO;;X;PROVIDENCIA                   ;METROPOLITANA;0;0;0;0;0;0;0;0;0;365 Familia 6 usuarios Anual;ACCESORIOS
11491751;;M;53;CHILENO;;X;PUENTE ALTO                   ;METROPOLITANA;0;0;0;0;0;0;0;0;0;TRI PACK PENDRIVE CRUZERBLADE Z50 SANDISC COLORE;ACCESORIOS
17687579;Soltero;M;31;CHILENO;;Millenial;PROVIDENCIA                   ;METROPOLITANA;0;0;0;0;0;0;0;0;0;DISCO DURO CANVIO 1TB BASICS BLACK TOSHIBA;ACCESORIOS
15143454;;M;39;CHILENO;;X;PROVIDENCIA                   ;METROPOLITANA;0;0;0;0;0;0;0;0;0;HUAWEI FreeBuds Lite Black;ACCESORIOS
19572753;;F;25;CHILENO;;Silencioso;PROVIDENCIA                   ;METROPOLITANA;519960;4;2;4;2;519960;0;0;0;BICI ALLEYCAT NEGRA/TURQUESA 28 FITZER;BICICLETAS
14573303;;M;40;CHILENO;;X;N/D;N/D;348520;4;2;4;2;348520;0;0;0;BICICLETA VISION HELIUM CITY ARO 26 ACERO 6V.;BICICLETAS
18291377;Soltero;M;29;CHILENO;;Millenial;PROVIDENCIA                   ;METROPOLITANA;133980;2;1;2;1;133980;0;0;0;BICI VIGORPLUS NEGRA 27,5 V-BRAKE;BICICLETAS
19849418;;F;23;CHILENO;;Z;PROVIDENCIA                   ;METROPOLITANA;99990;1;1;0;0;0;1;1;99990;PRODUCTO 2A BICICLETAS BANDA 6;BICICLETAS
9875031;Soltero;F;58;CHILENO;;Boomers;RENCA                         ;METROPOLITANA;227980;2;1;2;1;227980;0;0;0;BC XTS MTB ALU STRIKER 29 21VEL DISCO NEGRO;BICICLETAS
23185133;;F;30;CHILENO;;Millenial;QUILLOTA                      ;VALPARAISO;765850;4;3;0;0;0;4;3;765850;BICI VIGOR NEGRA 24 V-BRAKE;BICICLETAS
12405999;;F;49;CHILENO;;X;QUINTA NORMAL;METROPOLITANA;375960;4;2;2;1;170980;2;1;204980;BICI VIGORPLUS NEGRA 27,5 V-BRAKE;BICICLETAS
13342883;;M;44;CHILENO;;X;RANCAGUA                      ;L.G.B.OÂ´HIGGINS;337960;4;2;4;2;337960;0;0;0;BC XTS MTB ALU STRIKER 29 21VEL DISCO NEGRO;BICICLETAS
10140187;;M;57;CHILENO;;Boomers;ANGOL                         ;ARAUCANIA;244980;2;1;0;0;0;2;1;244980;BICICLETA VISION GLASS MTB ARO 29 ALUMINIO 21V.;BICICLETAS
18456096;;M;29;CHILENO;;Millenial;PROVIDENCIA                   ;METROPOLITANA;579970;3;2;3;2;579970;0;0;0;UPLAND SANCHEZ HIBRIDA 650B GRIS;BICICLETAS
15527728;;M;35;CHILENO;;Millenial;SAN FERNANDO                  ;L.G.B.OÂ´HIGGINS;215980;2;1;0;0;0;2;1;215980;BICI VIGORPLUS NEGRA 27,5 V-BRAKE;BICICLETAS
13547133;;M;43;CHILENO;;X;SAN ANTONIO                   ;VALPARAISO;149980;2;1;0;0;0;2;1;149980;BICI BMX FREESTYLE ARO 20 AZUL;BICICLETAS
9503325;;F;60;CHILENO;;Boomers;SANTA CRUZ                    ;L.G.B.OÂ´HIGGINS;159990;1;1;0;0;0;1;1;159990;BC XTS MTB ACE MUJ SHINE 27 18VEL DISCO TURQ;BICICLETAS
19732664;;M;24;CHILENO;;Millenial;N/D;N/D;125980;2;1;2;1;125980;0;0;0;BICI ALLEYCAT NEGRA/TURQUESA 28 FITZER;BICICLETAS
9697538;;M;58;CHILENO;;Boomers;N/D;N/D;169990;1;1;0;0;0;1;1;169990;BICI VIGORPLUS NEGRA 27,5 V-BRAKE;BICICLETAS
20120712;;M;23;CHILENO;;Z;PROVIDENCIA                   ;METROPOLITANA;263980;2;1;2;1;263980;0;0;0;MODELO SUNPEED ZERO ARO 27.5 GRAFITO M;BICICLETAS
26866287;;F;28;EXTRANJERO - NO INFORMA NACIONALIDAD;;Extranjero;"";"";149980;2;1;2;1;149980;0;0;0;BICI ALLEYCAT NEGRA 28 FITZER;BICICLETAS
6642503;;F;68;CHILENO;;Silencioso;PROVIDENCIA                   ;METROPOLITANA;279990;1;1;0;0;0;1;1;279990;BICI STRIKER BLANCA 27,5 FRENO DISCO;BICICLETAS
8586387;;F;64;CHILENO;;Boomers;SANTIAGO                      ;METROPOLITANA;700910;9;5;0;0;0;9;5;700910;V-BICICLETA MTB XT-9003 ARO 27.5;BICICLETAS
19667028;;F;25;CHILENO;;Z;OVALLE;COQUIMBO;127540;2;1;2;1;127540;0;0;0;BICICLETA INFANTIL ARO 20 NEGRA;BICICLETAS
8589816;;F;63;CHILENO;;Boomers;PUENTE ALTO                   ;METROPOLITANA;274970;3;2;0;0;0;3;2;274970;BICI SHINEPLUS GRIS 27,5 FRENO DISCO;BICICLETAS
12791436;;F;46;CHILENO;;X;LINARES                       ;MAULE;89990;1;1;0;0;0;1;1;89990;BICICLETA INFANTIL ARO 16 CELESTE;BICICLETAS
17509006;;F;32;CHILENO;;Millenial;PROVIDENCIA                   ;METROPOLITANA;165480;2;1;2;1;165480;0;0;0;BIANCHI 20 CLASSIC GIRL VERDE CLARO;BICICLETAS
12908904;;M;46;CHILENO;;X;PROVIDENCIA                   ;METROPOLITANA;238980;2;1;0;0;0;2;1;238980;BICI VIGORPLUS VERDE 27,5 V-BRAKE;BICICLETAS
8623968;;F;63;CHILENO;;Boomers;OVALLE                        ;COQUIMBO;119990;1;1;0;0;0;1;1;119990;BICICLETA INFANTIL ARO 20 NEGRA;BICICLETAS
15267141;;F;40;CHILENO;;X;PANGUIPULLI                   ;LOS RIOS;267960;4;2;0;0;0;4;2;267960;BICI VIGORPLUS VERDE 27,5 V-BRAKE;BICICLETAS
16838537;;M;33;CHILENO;;Millenial;TALCA                         ;MAULE;1065470;3;2;2;1;195480;1;1;869990;BICI SHINEPLUS BLANCA 27,5 FRENO DISCO;BICICLETAS
18499449;;M;28;CHILENO;;Millenial;EL BOSQUE                     ;METROPOLITANA;159980;2;1;2;1;159980;0;0;0;BICI RETROPLUS VERDE 26 V-BRAKE;BICICLETAS
21441585;;F;23;CHILENO;;Extranjero;PROVIDENCIA                   ;METROPOLITANA;245840;2;1;2;1;245840;0;0;0;BIANCHI STONE MOUNTAIN 27,5 SX SIZE M NEGRO SEMI;BICICLETAS
17513855;;M;32;CHILENO;;Millenial;N/D;N/D;863800;6;3;6;3;863800;0;0;0;BIANCHI STONE MTB29 SX ALLOY NEGRO SEMI MATTE/CE;BICICLETAS
15648092;;F;38;CHILENO;;X;TALCAHUANO                    ;BIO BIO;214980;2;1;2;1;214980;0;0;0;V-BICICLETA PASEO PROVENZA ARO 26;BICICLETAS
6777736;;M;69;CHILENO;;Silencioso;ARAUCO                        ;BIO BIO;249990;1;1;0;0;0;1;1;249990;BICICLETA MONKEL 29 ALUMINIO GRIS;BICICLETAS
17471166;;M;32;CHILENO;;Millenial;SAN FERNANDO                  ;L.G.B.OÂ´HIGGINS;219970;3;1;0;0;0;3;1;219970;BICICLETA INFANTIL ARO 20 AMARILLA;BICICLETAS
18216789;;M;29;CHILENO;;Millenial;RENCA                         ;METROPOLITANA;85840;2;1;2;1;85840;0;0;0;BICICLETA INFANTIL ARO 16 AZUL;BICICLETAS
15148210;;F;39;CHILENO;;Millenial;N/D;N/D;166980;2;1;2;1;166980;0;0;0;BICI RETROPLUS VERDE 26 V-BRAKE;BICICLETAS
10464765;;F;56;CHILENO;;Boomers;N/D;N/D;141480;2;1;0;0;0;2;1;141480;BARBIE 12 ROSADO;BICICLETAS
9234037;;F;56;CHILENO;;Boomers;TALCA                         ;MAULE;89992;1;2;0;0;0;1;2;89992;BICICLETA INFANTIL ARO 16 ROSADA;BICICLETAS
13395711;;M;45;CHILENO;;X;PROVIDENCIA                   ;METROPOLITANA;116980;2;1;2;1;116980;0;0;0;BICICLETA INFANTIL ARO 20 AMARILLA;BICICLETAS
14324363;;F;45;CHILENO;;X;CONSTITUCION                  ;MAULE;228980;2;1;0;0;0;2;1;228980;BICI SHINEPLUS BLANCA 27,5 FRENO DISCO;BICICLETAS
18798771;;M;28;CHILENO;;Millenial;PROVIDENCIA                   ;METROPOLITANA;264540;2;1;2;1;264540;0;0;0;BIANCHI STONE MOUNTAIN 27,5 SX SIZE M PLATA SEMI;BICICLETAS
19300705;;F;26;CHILENO;;Z;OVALLE                        ;COQUIMBO;109990;1;1;0;0;0;1;1;109990;V-MTB ARO 16 HULK VERDE;BICICLETAS
8210986;;F;59;CHILENO;;Boomers;TALCA;MAULE;420960;4;2;4;2;420960;0;0;0;BICICLETA INFANTIL ARO 20 AMARILLA;BICICLETAS
7638498;;F;65;CHILENO;;Boomers;NOGALES                       ;VALPARAISO;69990;1;1;0;0;0;1;1;69990;BICICLETA INFANTIL ARO 12 CELESTE;BICICLETAS
11995490;;F;50;CHILENO;;X;LA ESTRELLA                   ;L.G.B.OÂ´HIGGINS;314970;3;1;0;0;0;3;1;314970;BICI STRIKER AMARILLA 29 V-BRAKE;BICICLETAS
17077403;;M;32;CHILENO;;Millenial;PROVIDENCIA                   ;METROPOLITANA;252980;2;1;0;0;0;2;1;252980;BICI VIGORPLUS VERDE 27,5 V-BRAKE;BICICLETAS
12193235;;F;50;CHILENO;;X;TEMUCO                        ;ARAUCANIA;219990;1;1;0;0;0;1;1;219990;BICI STRIKER AMARILLA 29 V-BRAKE;BICICLETAS
7098114;;M;69;CHILENO;;Silencioso;LOS ANDES                     ;VALPARAISO;149990;1;1;0;0;0;1;1;149990;BICI RETROPLUS CELESTE ARO 26;BICICLETAS
18800626;;M;27;CHILENO;;Silencioso;PROVIDENCIA                   ;METROPOLITANA;233080;2;1;0;0;0;2;1;233080;BICI SHINEPLUS GRIS 27,5 FRENO DISCO;BICICLETAS
14366228;;M;54;CHILENO;;X;VALLENAR;ATACAMA;349980;2;1;0;0;0;2;1;349980;V-BICICLETA MTB XT-9001 ARO 26;BICICLETAS
18069216;;M;29;CHILENO;;Millenial;PROVIDENCIA                   ;METROPOLITANA;233980;2;1;2;1;233980;0;0;0;BC XTS MTB ACE MUJ SHINE 27 18VEL DISCO TURQ;BICICLETAS
18478402;;M;29;CHILENO;;Millenial;PUENTE ALTO                   ;METROPOLITANA;97540;2;1;2;1;97540;0;0;0;BICICLETA INFANTIL ARO 16 CELESTE;BICICLETAS
25767305;;M;30;CHILENO;;Extranjero;SANTIAGO                      ;METROPOLITANA;109990;1;1;0;0;0;1;1;109990;BICI VIGOR NEGRA 24 V-BRAKE;BICICLETAS
17859757;;F;31;CHILENO;;Millenial;"";"";303980;2;1;2;1;303980;0;0;0;MODELO SUNPEED STELLA ARO 27.5 CELESTE S;BICICLETAS
10842994;;F;51;CHILENO;;X;CORONEL                       ;BIO BIO;103980;2;1;2;1;103980;0;0;0;BICICLETA INFANTIL ARO 16 CELESTE;BICICLETAS
15620086;;F;38;CHILENO;;X;SAN FELIPE                    ;VALPARAISO;124980;2;1;2;1;124980;0;0;0;BICICLETA INFANTIL ARO 20 NEGRA;BICICLETAS
17967124;;F;30;CHILENO;;Millenial;RENGO                         ;L.G.B.OÂ´HIGGINS;104540;2;1;2;1;104540;0;0;0;BICICLETA INFANTIL ARO 16 ROSADA;BICICLETAS
13348405;;M;44;CHILENO;;X;SANTA CRUZ                    ;L.G.B.OÂ´HIGGINS;511410;6;4;0;0;0;6;4;511410;BICI STRIKER AMARILLA 29 V-BRAKE;BICICLETAS
17635088;Soltero;F;31;CHILENO;COSMETOLOGA;Millenial;PROVIDENCIA                   ;METROPOLITANA;124980;2;1;2;1;124980;0;0;0;BICICLETA INFANTIL ARO 20 NEGRA;BICICLETAS
8707942;;F;58;CHILENO;;Boomers;QUILLOTA                      ;VALPARAISO;0;0;2;0;0;0;0;2;0;BICICLETA MONKEL 29 ALUMINIO AZUL;BICICLETAS
26699347;;M;32;VENEZOLANO;;Extranjero;ESTACION CENTRAL              ;METROPOLITANA;533730;7;4;2;1;289980;5;3;243750;BICICLETA INFANTIL ARO 16 CELESTE;BICICLETAS
19108899;Soltero;F;26;CHILENO;;Z;CONCEPCION                    ;BIO BIO;139990;1;1;0;0;0;1;1;139990;BICI RETROPLUS CELESTE ARO 26;BICICLETAS
8560920;;M;63;CHILENO;;Silencioso;PROVIDENCIA                   ;METROPOLITANA;385070;2;1;0;0;0;2;1;385070;BIANCHI ADVANTAGE 27,5 SX NEGRO SEMI MATTE / ROJ;BICICLETAS
13769181;;M;41;CHILENO;;X;N/D;N/D;0;0;0;0;0;0;0;0;0;BIANCHI GOLIAT 16 ROJO;BICICLETAS
11539551;;F;52;CHILENO;;X;CONCEPCION                    ;BIO BIO;0;0;0;0;0;0;0;0;0;BICI RETROPLUS CELESTE ARO 26;BICICLETAS
16239736;Soltero;F;36;CHILENO;;Silencioso;PROVIDENCIA                   ;METROPOLITANA;0;0;0;0;0;0;0;0;0;BICI FALCONPLUS AZUL 29 FRENO DISCO;BICICLETAS
14154379;Casado;M;41;CHILENO;INGENIERO DE EJECUCION EN METALURGIA;X;PROVIDENCIA                   ;METROPOLITANA;0;0;0;0;0;0;0;0;0;HOTWHEELS 16 AZUL;BICICLETAS
8101885;;M;61;CHILENO;;Boomers;PROVIDENCIA                   ;METROPOLITANA;0;0;0;0;0;0;0;0;0;BICI CITYCOMMUTER PLATEADA ARO 26;BICICLETAS
19815436;;F;24;CHILENO;;Z;N/D;N/D;0;0;0;0;0;0;0;0;0;BIANCHI STONE MOUNT 29 M CEL ];BICICLETAS
13561195;;F;43;CHILENO;;X;N/D;N/D;0;0;0;0;0;0;0;0;0;BICICLETA INFANTIL ARO 16 ROSADA;BICICLETAS
15135106;;M;40;CHILENO;;X;PROVIDENCIA                   ;METROPOLITANA;0;0;0;0;0;0;0;0;0;BICI FALCONPLUS AZUL 29 FRENO DISCO;BICICLETAS
26797345;;F;51;VENEZOLANO;;Extranjero;SAN PEDRO DE LA PAZ           ;BIO BIO;0;0;0;0;0;0;0;0;0;BIANCHI STONE MOUNTAIN 29 SX ALLOY SIZE M AZUL C;BICICLETAS
8789926;;M;47;CHILENO;;X;COIHAIQUE                     ;AYSEN;0;0;0;0;0;0;0;0;0;BICI VIGOR NEGRA 24 V-BRAKE;BICICLETAS
15676642;Soltero;M;39;CHILENO;;X;PROVIDENCIA                   ;METROPOLITANA;0;0;0;0;0;0;0;0;0;BICI BMX FREESTYLE ARO 20 NEGRA;BICICLETAS
15126650;;M;37;CHILENO;;Millenial;PROVIDENCIA                   ;METROPOLITANA;0;0;0;0;0;0;0;0;0;BICICLETA INFANTIL ARO 20 AMARILLA;BICICLETAS
7439961;Casado;F;70;CHILENO;;Silencioso;RENCA                         ;METROPOLITANA;0;0;0;0;0;0;0;0;0;BICICLETA INFANTIL ARO 16 NEGRA;BICICLETAS
12421488;Casado;M;54;CHILENO;;X;RENCA                         ;METROPOLITANA;0;0;0;0;0;0;0;0;0;BICI VIGORPLUS NEGRA 27,5 V-BRAKE;BICICLETAS
8230688;;F;65;CHILENO;;Boomers;ARICA                         ;ARICA Y PARINACOTA;0;0;0;0;0;0;0;0;0;BICI RETROPLUS VERDE 26 V-BRAKE;BICICLETAS
17100419;;F;33;CHILENO;;Millenial;PROVIDENCIA                   ;METROPOLITANA;0;0;0;0;0;0;0;0;0;BICICLETA INFANTIL ARO 20 ROSADA;BICICLETAS
15223470;;M;39;CHILENO;;X;CONCEPCION                    ;BIO BIO;0;0;0;0;0;0;0;0;0;BICI METROPOLE BLANCA 28 CITYBIKE;BICICLETAS
8419319;;F;59;CHILENO;;Boomers;PROVIDENCIA                   ;METROPOLITANA;0;0;0;0;0;0;0;0;0;BICI VIGORPLUS NEGRA 27,5 V-BRAKE;BICICLETAS
17853104;Soltero;M;31;CHILENO;;Millenial;PROVIDENCIA                   ;METROPOLITANA;0;0;0;0;0;0;0;0;0;BICICLETA INFANTIL ARO 20 NEGRA;BICICLETAS
16216093;;F;36;CHILENO;;Millenial;"";"";0;0;0;0;0;0;0;0;0;BICI VIGORPLUS VERDE 27,5 V-BRAKE;BICICLETAS
12918579;Soltero;M;46;CHILENO;INGENIERO DE EJECUCION ELECTRONICO;X;PROVIDENCIA                   ;METROPOLITANA;0;0;0;0;0;0;0;0;0;BICICLETA INFANTIL ARO 16 ROSADA;BICICLETAS
18997492;Soltero;F;27;CHILENO;DISENADOR GRAFICO;Z;PROVIDENCIA                   ;METROPOLITANA;0;0;0;0;0;0;0;0;0;BICICLETA INFANTIL ARO 20 BLANCA;BICICLETAS
15996171;;F;36;CHILENO;;Millenial;REQUINOA                      ;L.G.B.OÂ´HIGGINS;0;0;0;0;0;0;0;0;0;BICI RETROPLUS VERDE 26 V-BRAKE;BICICLETAS
14059278;;M;41;CHILENO;;X;PROVIDENCIA                   ;METROPOLITANA;0;0;0;0;0;0;0;0;0;BICI CITYPETITE VERDE 24 V-BRAKE;BICICLETAS
16275228;;F;36;CHILENO;;Millenial;LINARES                       ;MAULE;0;0;0;0;0;0;0;0;0;BICI CITYPETITE ROJA 24 V-BRAKE;BICICLETAS
16806529;Soltero;M;34;CHILENO;PROFESOR;Millenial;PROVIDENCIA                   ;METROPOLITANA;0;0;0;0;0;0;0;0;0;BIANCHI XC 240 SX ALLOY AZULINO SEMI MATTE;BICICLETAS
14551819;;M;42;CHILENO;;X;SANTA CRUZ                    ;L.G.B.OÂ´HIGGINS;0;0;0;0;0;0;0;0;0;BICI CITYPETITE ROJA 24 V-BRAKE;BICICLETAS
15675995;Casado;F;36;CHILENO;PROFESOR;Millenial;PROVIDENCIA                   ;METROPOLITANA;0;0;0;0;0;0;0;0;0;BICI VIGORPLUS VERDE 27,5 V-BRAKE;BICICLETAS
15730844;;F;38;CHILENO;;X;LA LIGUA                      ;VALPARAISO;0;0;0;0;0;0;0;0;0;BICICLETA INFANTIL ARO 16 NEGRA;BICICLETAS
11222821;;M;54;CHILENO;;X;LIMACHE                       ;VALPARAISO;0;0;0;0;0;0;0;0;0;BICI BMX FREESTYLE ARO 20 AZUL;BICICLETAS
15489243;Soltero;M;39;CHILENO;;X;PROVIDENCIA                   ;METROPOLITANA;0;0;0;0;0;0;0;0;0;BICI BMX FREESTYLE ARO 20 NEGRA;BICICLETAS
14088001;;F;41;CHILENO;;X;RENCA                         ;METROPOLITANA;0;0;0;0;0;0;0;0;0;BIANCHI 20 CLASSIC GIRL VERDE CLARO;BICICLETAS
16385286;;F;35;CHILENO;;Millenial;RENCA                         ;METROPOLITANA;0;0;0;0;0;0;0;0;0;BICICLETA PLEGABLE BIA;BICICLETAS
19152444;Soltero;F;26;CHILENO;;Z;PROVIDENCIA                   ;METROPOLITANA;0;0;0;0;0;0;0;0;0;BICICLETA APRENDIZAJE CON CASCO ROSADO;BICICLETAS
20414955;;F;22;CHILENO;;Z;ANTOFAGASTA                   ;ANTOFAGASTA;0;0;0;0;0;0;0;0;0;BICI RETROPLUS AZUL 26 V-BRAKE;BICICLETAS
16529273;;F;35;CHILENO;;Millenial;CURACAVI                      ;METROPOLITANA;0;0;0;0;0;0;0;0;0;FREESTYLE PRO ARO 20 NEGRA/NARANJA;BICICLETAS
7940033;;M;61;CHILENO;;Boomers;SAN BERNARDO                  ;METROPOLITANA;839928;6;2;0;0;0;6;2;839928;Cama Tempo 2PBD;DORMITORIO
12081400;;F;48;CHILENO;;X;SAN FERNANDO                  ;L.G.B.OÂ´HIGGINS;1303808;9;4;0;0;0;9;4;1303808;CE EVOLUTION BLACK 1,5P + RESPALDO CASTILLA;DORMITORIO
15998921;;F;37;CHILENO;;Millenial;TIRUA                         ;BIO BIO;299981;3;2;0;0;0;3;2;299981;PACK 2 ALMOHADAS C+L;DORMITORIO
9592350;;F;62;CHILENO;;Boomers;LA SERENA                     ;COQUIMBO;599890;5;3;0;0;0;5;3;599890;BOX AMERICANO MIRAGE 2PBN;DORMITORIO
20311583;;M;22;CHILENO;;Z;N/D;N/D;381950;5;4;0;0;0;5;4;381950;PACK 2 ALMOHADAS C+L;DORMITORIO
22123434;;F;38;PERUANO;;Extranjero;N/D;N/D;356950;5;3;2;1;159980;3;2;196970;COLCHON TERAPEUTIC 1,5P PILLOW TOP;DORMITORIO
15785302;;F;38;CHILENO;;Millenial;ILLAPEL                       ;COQUIMBO;2738530;22;11;11;5;1743880;11;6;994650;CE EVOLUTION BLACK 1,5P + RESPALDO CASTILLA;DORMITORIO
13781567;;F;42;CHILENO;;X;LOLOL                         ;L.G.B.OÂ´HIGGINS;306970;3;2;0;0;0;3;2;306970;CAMA EUROPEA WAVE 1.05X1.90;DORMITORIO
10000415;;F;58;CHILENO;;Boomers;TEMUCO                        ;ARAUCANIA;1455910;9;6;0;0;0;9;6;1455910;COLCHON BAMBOO 2P FIBRAS BAMBOO;DORMITORIO
12166222;;M;46;CHILENO;;X;LA PINTANA                    ;METROPOLITANA;933900;10;5;2;1;289980;8;4;643920;COLCHON BAMBOO 1,5P FIBRAS BAMBOO;DORMITORIO
8554733;;F;72;CHILENO;;Silencioso;RENGO                         ;L.G.B.OÂ´HIGGINS;311940;6;2;0;0;0;6;2;311940;COLCHON CASALINDA CDM 1.5PL X190;DORMITORIO
7569090;;F;71;CHILENO;;Silencioso;HIJUELAS                      ;VALPARAISO;292970;3;2;0;0;0;3;2;292970;CLOSET ROMA 8 PUERTAS EXIT NOGAL 1,77X1,32X0,40;DORMITORIO
8676445;Casado;F;63;CHILENO;;Boomers;RENCA                         ;METROPOLITANA;362270;4;1;0;0;0;4;1;362270;COLCHON BAMBOO 1,5P FIBRAS BAMBOO;DORMITORIO
10325080;;F;56;CHILENO;;Boomers;N/D;N/D;372960;4;2;0;0;0;4;2;372960;COLCHON ERGO T 1P;DORMITORIO
11410124;;F;56;CHILENO;;Boomers;VILLARICA                     ;ARAUCANIA;403960;4;2;0;0;0;4;2;403960;COLCHON SUPREME 2P DUAL SIDE;DORMITORIO
13825632;;M;41;CHILENO;;X;DALCAHUE                      ;LOS LAGOS;476970;3;2;0;0;0;3;2;476970;CAMA EUR WAVE 1.50X1.90 BN RESP TABOR G;DORMITORIO
8441403;;M;63;CHILENO;;Boomers;PEUMO                         ;L.G.B.OÂ´HIGGINS;265190;4;2;0;0;0;4;2;265190;COLCHON CASALINDA CDM 1.5PL X190;DORMITORIO
18995064;;F;26;CHILENO;;Z;N/D;N/D;399970;3;2;1;1;189990;2;1;209980;CE EVOLUTION BLACK 1,5P + RESPALDO CASTILLA;DORMITORIO
21221997;;F;24;CHILENO;;Z;N/D;N/D;817950;5;2;5;2;817950;0;0;0;CAMA AMERICANA SPRING VI 2.0 PL B/D;DORMITORIO
18101323;;M;31;CHILENO;;Millenial;TALCA                         ;MAULE;-126400;-1;4;0;0;0;-1;4;-126400;Almohada Bamboo Classic 70x40;DORMITORIO
11791669;;M;52;CHILENO;;X;ARAUCO                        ;BIO BIO;393370;6;3;0;0;0;6;3;393370;PACK 2 ALMOHADAS C+L;DORMITORIO
14360623;;M;40;CHILENO;;X;ANGOL                         ;ARAUCANIA;785490;7;2;0;0;0;7;2;785490;COLCHON EVOLUTION BLACK 1,5P DUAL SIDE;DORMITORIO
19816665;;M;24;CHILENO;;Z;N/D;N/D;656962;4;5;0;0;0;4;5;656962;ALMOHADA BAMBOO TECH SERIES 65X45 CM;DORMITORIO
19898306;;F;23;CHILENO;;Z;"";"";332961;5;4;1;1;179990;4;3;152971;PACK 2 ALMOHADAS C+L;DORMITORIO
15178176;;F;41;CHILENO;;X;CHIGUAYANTE                   ;BIO BIO;287970;6;3;0;0;0;6;3;287970;Almohada Visco Bamboo Classic Pack 60x40 cm;DORMITORIO
7974704;;M;64;CHILENO;;Boomers;LOS ANGELES                   ;BIO BIO;1436920;8;4;0;0;0;8;4;1436920;CE ERGO T 2P 2MT BD;DORMITORIO
11967716;;M;50;CHILENO;;X;CARAHUE                       ;ARAUCANIA;608410;7;6;0;0;0;7;6;608410;Almohada ViscoGel Cobre 70x40x13 cm;DORMITORIO
26683540;;M;33;ECUATORIANO;;Extranjero;ILLAPEL                       ;COQUIMBO;1166990;6;4;3;2;385530;3;2;781460;BOX AMERICANO MIRAGE 2PBN;DORMITORIO
14701898;;M;57;ECUATORIANO;;Extranjero;SAN FELIPE                    ;VALPARAISO;242720;8;4;2;1;136980;6;3;105740;PACK 2 ALMOHADAS-D VISCO 60 x 40;DORMITORIO
19146184;;M;26;CHILENO;;Z;N/D;N/D;9990;1;1;0;0;0;1;1;9990;PACK 2 ALMOHADAS C+L;DORMITORIO
5934726;;F;72;CHILENO;;Silencioso;SANTA MARIA                   ;VALPARAISO;1174950;5;5;0;0;0;5;5;1174950;CE EVOLUTION BLACK 1,5P + RESPALDO CASTILLA;DORMITORIO
21228498;;F;19;CHILENO;;Extranjero;CASTRO                        ;LOS LAGOS;197980;2;2;0;0;0;2;2;197980;CE EVOLUTION BLACK 1,5P + RESPALDO CASTILLA;DORMITORIO
10623622;;M;51;CHILENO;;X;LOS ANDES                     ;VALPARAISO;189990;1;1;0;0;0;1;1;189990;COLCHON CASALINDA CDM 2PL X200;DORMITORIO
11310680;;F;54;CHILENO;;X;NATALES                       ;MAGALLANES;493940;6;3;0;0;0;6;3;493940;PACK 2 ALMOHADAS C+L;DORMITORIO
9963309;;M;58;CHILENO;;Boomers;PUDAHUEL                      ;METROPOLITANA;453190;7;3;0;0;0;7;3;453190;COLCHON BAMBOO 1,5P FIBRAS BAMBOO;DORMITORIO
12116788;;F;57;CHILENO;;Boomers;VALPARAISO                    ;VALPARAISO;2015950;14;8;0;0;0;14;8;2015950;COLCHON BAMBOO 2P FIBRAS BAMBOO;DORMITORIO
7998425;;F;61;CHILENO;;Boomers;RENCA                         ;METROPOLITANA;192980;2;1;0;0;0;2;1;192980;COLCHON BAMBOO 1,5P FIBRAS BAMBOO;DORMITORIO
15645816;;F;38;CHILENO;;Millenial;N/D;N/D;906520;9;4;0;0;0;9;4;906520;CE EVOLUTION BLACK 1,5P BN DUAL SIDE;DORMITORIO
5951228;;F;75;CHILENO;;Silencioso;COIHAIQUE                     ;AYSEN;359980;2;1;0;0;0;2;1;359980;CE EVOLUTION BLACK 1,5P + RESPALDO CASTILLA;DORMITORIO
11868578;;M;51;CHILENO;;X;SAN FERNANDO                  ;L.G.B.OÂ´HIGGINS;9990;1;1;0;0;0;1;1;9990;PACK 2 ALMOHADAS C+L;DORMITORIO
7119319;;F;69;CHILENO;;Silencioso;TALAGANTE                     ;METROPOLITANA;222970;3;2;0;0;0;3;2;222970;COLCHON ERGO T 1,5P;DORMITORIO
15489687;;M;39;CHILENO;;Extranjero;PROVIDENCIA                   ;N/D;196980;2;1;2;1;196980;0;0;0;CLOSET CONCEPCION TV49 M-402 CASTANO / AVELLANA;DORMITORIO
20210298;;F;22;CHILENO;;Z;N/D;N/D;482980;2;1;0;0;0;2;1;482980;BOX BAMBOO + Respaldo + 2 Veladores ALICANTE;DORMITORIO
19403555;;F;26;CHILENO;;Z;CALBUCO                       ;LOS LAGOS;1265750;14;6;6;3;773940;8;3;491810;Cama Europea Active 1,5P;DORMITORIO
9659869;;F;58;CHILENO;;Boomers;ANCUD                         ;LOS LAGOS;793880;11;5;2;1;164980;9;4;628900;CE EVOLUTION BLACK 1,5P + RESPALDO CASTILLA;DORMITORIO
16136587;;M;36;CHILENO;;Millenial;N/D;N/D;315380;4;2;0;0;0;4;2;315380;CAMA EUROPEA CASALINDA CDM 1.5PL;DORMITORIO
15508661;;M;38;CHILENO;;Millenial;QUEILEN                       ;LOS LAGOS;565960;4;3;2;1;211980;2;2;353980;CAMAROTE TRIPLE CARISMA 1P;DORMITORIO
20392479;;M;22;CHILENO;;Millenial;"";"";284540;4;3;0;0;0;4;3;284540;CAMA EUROPEA EXCELLENCE 2 PLAZAS BASE NORMAL;DORMITORIO
20260878;;M;22;CHILENO;;Z;SANTIAGO;METROPOLITANA;4990;1;1;1;1;4990;0;0;0;PACK 2 ALMOHADAS C+L;DORMITORIO
12333704;;M;48;CHILENO;;X;CUNCO                         ;ARAUCANIA;178980;2;1;2;1;178980;0;0;0;CE EVOLUTION BLACK 1,5P + RESPALDO CASTILLA;DORMITORIO
20512891;;F;22;CHILENO;;Z;PROVIDENCIA                   ;METROPOLITANA;370980;2;1;2;1;370980;0;0;0;DIVAN CAMA ERGO T + RESP TABOR 1.5 PL;DORMITORIO
13219349;;M;45;CHILENO;;X;ANTOFAGASTA                   ;ANTOFAGASTA;374940;6;3;0;0;0;6;3;374940;ALMOHADA BAMBOO TECH SERIES 65X45 CM;DORMITORIO
14418105;;F;50;CHILENO;;X;PROVIDENCIA                   ;METROPOLITANA;163980;2;1;2;1;163980;0;0;0;CLOSET M-801 6P+2C ALTO 1,82 BLANCO NATURAL;DORMITORIO
13941528;;F;41;CHILENO;;X;TALAGANTE                     ;METROPOLITANA;209970;3;1;0;0;0;3;1;209970;COLCHON NEW ORTOPEDIC 1P;DORMITORIO
17443032;;F;32;CHILENO;;Millenial;TENO;MAULE;346980;2;1;2;1;346980;0;0;0;CE EVOLUTION BLACK 2P BD+RESP+2 VEL;DORMITORIO
19464752;;M;25;CHILENO;;Z;NUEVA IMPERIAL                ;ARAUCANIA;541971;4;2;2;1;221980;2;1;319991;BOX AMERICANO EXCELLENCE 1.5 PLAZA + ALM;DORMITORIO
8264516;;F;66;CHILENO;;Boomers;N/D;N/D;863380;12;7;0;0;0;12;7;863380;CE EVOLUTION BLACK 2P BD DUAL SIDE;DORMITORIO
17045919;;F;33;CHILENO;;Millenial;SAN BERNARDO                  ;METROPOLITANA;375960;3;1;3;1;375960;0;0;0;COLCHON NEW ORTOPEDIC 2P 150X190 + CUBREC;DORMITORIO
13408729;Casado;F;44;CHILENO;;X;"";"";1157530;15;7;14;6;1142540;1;1;14990;COLCHON CASALINDA CDM 1.5PL X200;DORMITORIO
17006926;;M;33;CHILENO;;Millenial;ESTACION CENTRAL;METROPOLITANA;51940;6;4;6;4;51940;0;0;0;Almohadas Isidora Soft 50x70 cm;DORMITORIO
27350885;;F;29;NO INFORMA NACIONALIDAD;;Extranjero;PROVIDENCIA                   ;METROPOLITANA;13970;3;1;3;1;13970;0;0;0;PACK 2 ALMOHADAS C+L;DORMITORIO
18193432;;F;30;CHILENO;;Millenial;PROVIDENCIA                   ;METROPOLITANA;209980;2;1;2;1;209980;0;0;0;BOX AMERICANO EXCELLENCE 2P BASE NORMAL+2ALM;DORMITORIO
16919174;;M;34;CHILENO;;Millenial;N/D;N/D;459930;7;3;7;3;459930;0;0;0;CAMA AMERICANA SPRING VI 1.5 PL;DORMITORIO
17420842;;M;32;CHILENO;;Millenial;PUENTE ALTO;METROPOLITANA;57970;3;5;3;5;57970;0;0;0;PACK 2 ALMOHADAS C+L;DORMITORIO
10604781;;F;56;CHILENO;;Boomers;PUERTO MONTT                  ;LOS LAGOS;1145910;8;3;5;2;715940;3;1;429970;CE NEW ORTOPEDIC KING;DORMITORIO
7494865;;F;64;CHILENO;;Boomers;PROVIDENCIA                   ;METROPOLITANA;159980;2;1;2;1;159980;0;0;0;CE EVOLUTION BLACK 1P BN DUAL SIDE;DORMITORIO
7276422;;F;71;CHILENO;;Silencioso;NATALES                       ;MAGALLANES;214220;4;2;0;0;0;4;2;214220;COLCHON BAMBOO 2P FIBRAS BAMBOO;DORMITORIO
15556197;;F;40;CHILENO;;Millenial;VINA DEL MAR                  ;VALPARAISO;346940;6;4;2;1;156980;4;3;189960;CAMA AMERICANA SPRING VI 1.0 PL;DORMITORIO
14081255;;F;43;CHILENO;;X;RIO BUENO                     ;LOS LAGOS;298970;3;2;2;1;178980;1;1;119990;COLCHON THERAPEDIC MAS KING 2MTS;DORMITORIO
27165115;;F;41;CHILENO;;Extranjero;"";"";11980;2;1;0;0;0;2;1;11980;Almohadas Isidora Soft 50x70 cm;DORMITORIO
8263164;;M;64;CHILENO;;Boomers;CATEMU                        ;VALPARAISO;489140;3;1;0;0;0;3;1;489140;CE CAMA ERGO T 1.50X2.00 BD + RESP FERRARA;DORMITORIO
12816162;;M;46;CHILENO;;X;ILLAPEL                       ;COQUIMBO;339990;1;1;0;0;0;1;1;339990;CE EVOLUTION BLACK 2P BN+RESP+2 VEL;DORMITORIO
9170855;;F;60;CHILENO;;Boomers;RENCA                         ;METROPOLITANA;246390;3;1;0;0;0;3;1;246390;CLOSET 6 PUERTAS 1 CAJON 1 ZAPATERA BALI CAOBA;DORMITORIO
6312897;;F;73;CHILENO;;Silencioso;VICTORIA                      ;ARAUCANIA;277970;3;1;0;0;0;3;1;277970;COLCHON BAMBOO 2P FIBRAS BAMBOO;DORMITORIO
23904199;Soltero;F;28;PERUANO;;Extranjero;PROVIDENCIA                   ;METROPOLITANA;415980;2;1;2;1;415980;0;0;0;CE NEW ORTOPEDIC KING;DORMITORIO
19168635;;F;27;CHILENO;;Z;PROVIDENCIA                   ;METROPOLITANA;629820;4;2;4;2;629820;0;0;0;BS ORTO ADVANCE B5 BCK 1.5P+ RESPALDO TIGRIS;DORMITORIO
6873164;;F;71;CHILENO;;Silencioso;SAN JAVIER                    ;MAULE;349970;3;2;0;0;0;3;2;349970;ALMOHADA FLEX-D VISCOLASTICA 60 x 40;DORMITORIO
17531055;;M;31;CHILENO;;Millenial;HUALPEN;BIO BIO;107980;2;1;2;1;107980;0;0;0;COMODA POLUX 8CJNS WENGUE;DORMITORIO
13392760;Casado;F;43;CHILENO;;X;RENCA                         ;METROPOLITANA;336680;2;1;0;0;0;2;1;336680;CAMA EUROPEA IBIZA 1,5 PL;DORMITORIO
26296503;Soltero;M;32;VENEZOLANO;;Extranjero;"";"";189980;2;1;2;1;189980;0;0;0;BOX AMERICANO EXCELLENCE 2P BASE NORMAL+2ALM;DORMITORIO
17124108;;M;33;CHILENO;;Millenial;COIHAIQUE                     ;AYSEN;226980;2;1;2;1;226980;0;0;0;CE CURVE NEW ORTOPEDIC 2P;DORMITORIO
8166336;;F;63;CHILENO;;Boomers;LA SERENA                     ;COQUIMBO;1847101;16;11;3;1;555960;13;10;1291141;ALMOHADA VISCO SLEEP TECH SERIES 65X45 CM;DORMITORIO
8564999;;F;63;CHILENO;;Boomers;PROVIDENCIA                   ;METROPOLITANA;372130;5;3;0;0;0;5;3;372130;CE EVOLUTION BLACK 1,5P + RESPALDO ASTURIAS;DORMITORIO
25311299;;F;22;COLOMBIANO;;Extranjero;"";"";243980;2;1;2;1;243980;0;0;0;CAMA AMERICANA BEAT 2 PLAZAS 150 X 190 CM;DORMITORIO
10904687;Casado;F;55;CHILENO;;Boomers;PROVIDENCIA                   ;METROPOLITANA;639980;2;1;2;1;639980;0;0;0;CAMA NEW STYLE 6 2PBD + RESP + 2 VEL VENETO;DORMITORIO
18672124;;F;29;CHILENO;;Millenial;N/D;N/D;412640;5;3;2;1;346980;3;2;65660;CAMA EUROPEA IBIZA 2 PL BD;DORMITORIO
20057489;;F;23;CHILENO;;Z;PROVIDENCIA                   ;METROPOLITANA;269960;4;2;3;1;258970;1;1;10990;CLOSET ESPANA 6P+4C;DORMITORIO
18344417;;F;30;CHILENO;;Millenial;LOS ANGELES;BIO-BIO;221990;3;1;0;0;0;3;1;221990;CAMA EUROPEA BAMBOO 1,5P;DORMITORIO
16460696;;F;35;CHILENO;;Millenial;ANCUD                         ;LOS LAGOS;519950;6;2;0;0;0;6;2;519950;COLCHON BAMBOO 1,5P FIBRAS BAMBOO;DORMITORIO
8030087;;F;65;CHILENO;;Boomers;CONSTITUCION                  ;MAULE;438950;6;4;0;0;0;6;4;438950;CE EVOLUTION BLACK 1,5P + RESPALDO CASTILLA;DORMITORIO
7917963;;M;66;CHILENO;;Boomers;LAUTARO                       ;ARAUCANIA;1114300;7;2;0;0;0;7;2;1114300;CAMA ERGO T 2PBD + RESP + 2 VEL FERRARA;DORMITORIO
5903885;;F;77;CHILENO;;Silencioso;LONGAVI                       ;MAULE;768470;11;4;0;0;0;11;4;768470;COLCHON TERAPEUTIC 2P PILLOW TOP;DORMITORIO
19045005;;M;26;CHILENO;;Z;TALCA                         ;MAULE;220460;4;3;2;1;85480;2;2;134980;PACK 2 ALMOHADAS C+L;DORMITORIO
20200002;;M;23;CHILENO;;Millenial;PROVIDENCIA                   ;METROPOLITANA;187970;3;2;2;1;149980;1;1;37990;CLOSET CABURGUA 2 PT CORREDERA CEREZO;DORMITORIO
11718539;Casado;M;51;CHILENO;;X;CHONCHI;LOS LAGOS;416980;2;2;0;0;0;2;2;416980;Almohada Bamboo Classic 70x40;DORMITORIO
13940546;;M;42;CHILENO;;X;COPIAPO                       ;ATACAMA;313970;4;2;2;1;279980;2;1;33990;BOX AMERICANO EXCELLENCE 2P BN +2ALM+PLU;DORMITORIO
20128846;;M;23;CHILENO;;Extranjero;PROVIDENCIA                   ;METROPOLITANA;189980;2;1;2;1;189980;0;0;0;CLOSET ROMA 8 PUERTAS EXIT NOGAL 1,77X1,32X0,40;DORMITORIO
12761179;;F;46;CHILENO;;X;RENCA                         ;METROPOLITANA;32940;6;2;0;0;0;6;2;32940;Almohada Imperial Soft 50x70 cm;DORMITORIO
17540728;;M;31;CHILENO;;Millenial;HUALPEN;BIO BIO;356980;2;1;2;1;356980;0;0;0;CE EXCELLENCE PLUS 2P BD+RESP+2VEL NEW MUNICH;DORMITORIO
14903614;;F;41;CHILENO;;X;ANTOFAGASTA                   ;ANTOFAGASTA;343970;3;2;2;1;203980;1;1;139990;CAMA EUROPEA EXCELLENCE 1.5 PLAZA;DORMITORIO
6466235;;F;73;CHILENO;;Silencioso;NATALES                       ;MAGALLANES;918930;7;5;0;0;0;7;5;918930;COLCHON TERAPEUTIC 2P PILLOW TOP;DORMITORIO
18240393;;F;30;CHILENO;;Millenial;PROVIDENCIA                   ;METROPOLITANA;179990;1;1;0;0;0;1;1;179990;COLCHON NEW ORTOPEDIC 1,5P;DORMITORIO
8430869;;F;51;CHILENO;;X;LA FLORIDA;METROPOLITANA;224690;4;1;0;0;0;4;1;224690;COLCHON EXCELLENCE PLUS 1.5P + CUBRECOLCHON;DORMITORIO
7171191;;F;66;CHILENO;;Boomers;RANCAGUA                      ;L.G.B.OÂ´HIGGINS;303980;2;1;0;0;0;2;1;303980;CE ERGO T 2P 2MT BD;DORMITORIO
16108859;;M;36;CHILENO;;Millenial;N/D;N/D;16990;1;1;0;0;0;1;1;16990;ALMOHADA BAMBOO TECH SERIES 65X45 CM;DORMITORIO
6854460;;F;66;CHILENO;;Boomers;MELIPILLA                     ;METROPOLITANA;347020;7;5;0;0;0;7;5;347020;PACK 2 ALMOHADAS C+L;DORMITORIO
15593522;Soltero;M;38;CHILENO;PROFESOR;Millenial;PROVIDENCIA                   ;METROPOLITANA;1173970;3;1;3;1;1173970;0;0;0;CE DRIVEN 2P 2MT BD;DORMITORIO
19415995;;M;25;CHILENO;;Z;PROVIDENCIA                   ;METROPOLITANA;338980;2;1;2;1;338980;0;0;0;CE CAMA ERGO T 1.50X2.00 BD + RESP FERRARA;DORMITORIO
10224625;;M;54;CHILENO;;X;SAN ANTONIO                   ;VALPARAISO;624210;4;2;0;0;0;4;2;624210;COLCHON EVEREST 2P 150X200;DORMITORIO
16963302;;M;33;CHILENO;;Millenial;BUIN                          ;METROPOLITANA;973930;7;4;2;1;323980;5;3;649950;COLCHON BAMBOO 2P FIBRAS BAMBOO;DORMITORIO
20519438;;F;22;CHILENO;;Millenial;"";"";426970;3;1;0;0;0;3;1;426970;COLCHON BAMBOO 2P FIBRAS BAMBOO;DORMITORIO
18438933;;F;28;CHILENO;;Millenial;RIO IBANEZ                    ;AYSEN;894890;10;4;3;1;672960;7;3;221930;ALMOHADA VISCO SLEEP TECH SERIES 65X45 CM;DORMITORIO
9489385;;F;59;CHILENO;;Z;PROVIDENCIA                   ;METROPOLITANA;159990;1;1;0;0;0;1;1;159990;COLCHON NEW ORTOPEDIC 1,5P;DORMITORIO
4345862;;M;80;CHILENO;;Silencioso;SAN ANTONIO                   ;VALPARAISO;517650;5;2;0;0;0;5;2;517650;BA EXCELLENCE 2P BN +RESP+2VEL OLMO +2ALM+PL;DORMITORIO
11797019;;F;51;CHILENO;;X;ANGOL                         ;ARAUCANIA;179980;2;1;0;0;0;2;1;179980;COLCHON 1PZA NEW VERSATILE BY ABCDIN;DORMITORIO
11704969;;F;50;CHILENO;;X;N/D;N/D;480960;3;1;3;1;480960;0;0;0;DUPLEX BOX AMERICANO EXCELLENCE 1 PLAZA +2ALM;DORMITORIO
14053411;;F;40;CHILENO;;X;TALCA                         ;MAULE;835180;6;3;4;2;480460;2;1;354720;CAMA AMERICANA SPRING VI 1.0 PL;DORMITORIO
15758830;;F;38;CHILENO;;Millenial;VALDIVIA                      ;LOS LAGOS;196990;3;1;0;0;0;3;1;196990;CE EVOLUTION BLACK 1P BN DUAL SIDE;DORMITORIO
10724148;;F;57;CHILENO;;Boomers;VINA DEL MAR                  ;VALPARAISO;8990;1;1;0;0;0;1;1;8990;ALMOHADA SOFT MICROGEL;DORMITORIO
7425697;;F;66;CHILENO;;Boomers;ANTOFAGASTA                   ;ANTOFAGASTA;365460;3;2;0;0;0;3;2;365460;ALMOHADA VISCO ELASTICA BAMBOO 60X40 CM;DORMITORIO
10319772;;F;55;CHILENO;;Boomers;AISEN                         ;AYSEN;1419420;17;8;0;0;0;17;8;1419420;BOXET ERGO T 2P + RESP TABOR 2PL;DORMITORIO
16881649;;M;34;CHILENO;;Millenial;N/D;N/D;390520;4;2;4;2;390520;0;0;0;CAMA NEW STYLE 2 2PBN;DORMITORIO
11994044;;F;51;CHILENO;;X;PROVIDENCIA                   ;METROPOLITANA;4990;1;1;0;0;0;1;1;4990;PACK 2 ALMOHADAS C+L;DORMITORIO
15435062;;M;40;CHILENO;;X;RANCAGUA                      ;L.G.B.OÂ´HIGGINS;94980;2;1;0;0;0;2;1;94980;ALMOHADA COOL GEL TECH SERIES 60X40 CM;DORMITORIO
10352171;;M;51;CHILENO;;X;PROVIDENCIA                   ;METROPOLITANA;209980;2;1;2;1;209980;0;0;0;CE EVOLUTION BLACK 1,5P + RESPALDO CASTILLA;DORMITORIO
12912352;Casado;M;47;CHILENO;;X;RENCA                         ;METROPOLITANA;544500;5;2;5;2;544500;0;0;0;CAMA EUROPEA EXCELLENCE 1.5 PLAZA;DORMITORIO
11485004;;F;52;CHILENO;;X;TUCAPEL                       ;BIO BIO;148640;5;3;0;0;0;5;3;148640;PACK 2 ALMOHADAS C+L;DORMITORIO
15897087;;M;47;CHILENO;;X;RENCA                         ;METROPOLITANA;471980;2;1;2;1;471980;0;0;0;BS ORTOP ADVANCE B5BLACK KING+RESP+2VEL LEGNO;DORMITORIO
16991475;;F;33;CHILENO;;Millenial;PANQUEHUE                     ;VALPARAISO;401960;4;1;0;0;0;4;1;401960;CE EVOLUTION BLACK 1,5P + RESPALDO CASTILLA;DORMITORIO
15676168;;M;36;CHILENO;;Millenial;CAUQUENES                     ;MAULE;815850;4;2;0;0;0;4;2;815850;BOX AMERICANO EXCELLENCE PLUS 2P BD +AL+PLU;DORMITORIO
10703805;Casado;F;53;CHILENO;;X;RENCA                         ;METROPOLITANA;75980;2;1;0;0;0;2;1;75980;RESP ITALIA CEDRO 2P CAFE;DORMITORIO
17820199;;F;30;CHILENO;;Millenial;MOLINA;MAULE;242960;4;3;4;3;242960;0;0;0;COLCHON CASALINDA CDM 2PL X200;DORMITORIO
10619829;;M;55;CHILENO;;Boomers;CASTRO                        ;LOS LAGOS;309980;2;1;0;0;0;2;1;309980;CAMA EUROPEA IBIZA 1,5 PL;DORMITORIO
19415325;;F;25;CHILENO;;Z;BULNES;BIO-BIO;104980;2;1;2;1;104980;0;0;0;COLCHON CASALINDA CDM 1.5PL X190;DORMITORIO
24296131;;M;43;DOMINICANO;;Extranjero;LIMACHE                       ;VALPARAISO;714230;5;2;0;0;0;5;2;714230;CE EVOLUTION BLACK 2P BN+RESP+2 VEL;DORMITORIO
15293277;;F;41;CHILENO;;X;PROVIDENCIA                   ;METROPOLITANA;555970;3;2;2;1;205980;1;1;349990;CE EVOLUTION BLACK 1,5P + RESPALDO CASTILLA;DORMITORIO
15394289;;F;39;CHILENO;;X;PROVIDENCIA                   ;METROPOLITANA;409980;2;1;2;1;409980;0;0;0;CE NEW ORTOP 1.5P +RESP+1VEL NEW DUBLIN CHOC;DORMITORIO
13639335;;F;42;CHILENO;;X;ARICA                         ;TARAPACA;225980;2;1;2;1;225980;0;0;0;CAMA EURO GRIS NEW ENTREE-H FULL BOX;DORMITORIO
17902173;;F;31;CHILENO;;Millenial;PROVIDENCIA                   ;METROPOLITANA;239990;1;1;1;1;239990;0;0;0;BA BEAT 2P 2MTS BN;DORMITORIO
10164336;;M;55;CHILENO;;Boomers;PROVIDENCIA                   ;METROPOLITANA;570980;2;1;0;0;0;2;1;570980;CE BAMBOO 2PBD BAMBOO+RES+2V ALICANTE;DORMITORIO
16490135;Soltero;M;35;CHILENO;;Millenial;PROVIDENCIA                   ;METROPOLITANA;575980;2;1;2;1;575980;0;0;0;CE DRIVEN 2P 2MT BD;DORMITORIO
13629262;;F;43;CHILENO;;X;PROVIDENCIA                   ;METROPOLITANA;264960;4;2;0;0;0;4;2;264960;BOX AMERICANO EXCELLENCE 1 PLAZA + ALM+PL;DORMITORIO
6568110;;F;77;CHILENO;;Silencioso;CARTAGENA                     ;VALPARAISO;107980;2;2;0;0;0;2;2;107980;Pack Imperial Soft 45x65 cm.;DORMITORIO
23094773;;F;60;PERUANO;;Extranjero;N/D;N/D;129980;2;1;0;0;0;2;1;129980;COLCHON NEW ORTOPEDIC 1P;DORMITORIO
15411690;;M;40;CHILENO;;X;PROVIDENCIA                   ;METROPOLITANA;129980;2;1;2;1;129980;0;0;0;CLOSET ESPANA 6P+4C;DORMITORIO
9169898;;F;62;CHILENO;;Boomers;HUALPEN;BIO BIO;411950;6;1;0;0;0;6;1;411950;COLCHON THERAPEDIC MAS FULL;DORMITORIO
8762091;;F;63;CHILENO;;Boomers;ARICA                         ;ARICA Y PARINACOTA;559960;4;2;0;0;0;4;2;559960;CAMA EUROPEA IBIZA 2 PL BD;DORMITORIO
7390604;;M;66;CHILENO;;Boomers;SAN FERNANDO                  ;L.G.B.OÂ´HIGGINS;658970;4;2;0;0;0;4;2;658970;BOX BAMBOO + Respaldo + 2 Veladores ALICANTE;DORMITORIO
18575995;;F;28;CHILENO;;Millenial;"";"";5000;2;1;0;0;0;2;1;5000;PACK 2 ALMOHADAS C+L;DORMITORIO
19462178;;F;25;CHILENO;;Z;PROVIDENCIA                   ;METROPOLITANA;283980;2;1;2;1;283980;0;0;0;CE ERGO T 2P 2MT BD;DORMITORIO
20515523;;M;21;CHILENO;;Z;PROVIDENCIA                   ;METROPOLITANA;15980;2;2;0;0;0;2;2;15980;Pack Imperial Soft 45x65 cm.;DORMITORIO
12660587;Soltero;M;48;CHILENO;PSICOLOGO;X;PROVIDENCIA                   ;METROPOLITANA;174980;2;1;0;0;0;2;1;174980;COLCHON ERGO T 2P;DORMITORIO
13944235;;M;42;CHILENO;;X;NATALES                       ;MAGALLANES;199990;1;1;0;0;0;1;1;199990;COLCHON BAMBOO 2P FIBRAS BAMBOO;DORMITORIO
19431204;Soltero;M;25;CHILENO;INGENIERO QUIMICO;Z;PROVIDENCIA                   ;METROPOLITANA;369970;3;1;3;1;369970;0;0;0;CE EVOLUTION BLACK 1,5P + RESPALDO CASTILLA;DORMITORIO
18314095;;F;29;CHILENO;;Millenial;ARICA                         ;ARICA Y PARINACOTA;241540;2;1;2;1;241540;0;0;0;BOX AMERICANO EXCELLENCE PLUS 2P BN +AL+PLU;DORMITORIO
9218088;;M;49;CHILENO;;Millenial;PROVIDENCIA                   ;METROPOLITANA;189980;2;1;2;1;189980;0;0;0;CE EVOLUTION BLACK 1,5P + RESPALDO CASTILLA;DORMITORIO
13315968;;F;45;CHILENO;;X;TEMUCO                        ;ARAUCANIA;24982;2;2;0;0;0;2;2;24982;PACK 2 ALMOHADAS C+L;DORMITORIO
8441992;Soltero;F;66;CHILENO;;Boomers;EL BOSQUE                     ;METROPOLITANA;569980;2;1;0;0;0;2;1;569980;CE EVEREST 2P 2MTS BD DUAL SIDE;DORMITORIO
13254546;;F;45;CHILENO;;X;RENCA                         ;METROPOLITANA;184980;2;1;0;0;0;2;1;184980;COLCHON NEW ORTOPEDIC 1,5 105X200;DORMITORIO
16179557;;F;37;CHILENO;;Extranjero;SAN VICENTE                   ;L.G.B.OÂ´HIGGINS;161980;2;1;0;0;0;2;1;161980;CLOSET M-801 6P+2C ALTO 1,82 BLANCO NATURAL;DORMITORIO
19374724;Soltero;M;26;CHILENO;QUIMICO FARMACEUTICO;Silencioso;NUEVA IMPERIAL                ;ARAUCANIA;204980;2;1;2;1;204980;0;0;0;COLCHON BAMBOO 2P FIBRAS BAMBOO;DORMITORIO
18489365;;F;29;CHILENO;;Millenial;PROVIDENCIA                   ;METROPOLITANA;224980;2;1;2;1;224980;0;0;0;BOX AMERICANO EXCELLENCE FULL PLAZA +2ALM+PLU;DORMITORIO
5599699;;F;74;CHILENO;;Silencioso;CANETE                        ;BIO BIO;543960;4;1;0;0;0;4;1;543960;BOX BAMBOO + Respaldo + 2 Veladores ALICANTE;DORMITORIO
6895084;Soltero;M;67;CHILENO;;Boomers;RENCA                         ;METROPOLITANA;216980;2;1;0;0;0;2;1;216980;COLCHON NEW ORTOPEDIC 1,5P;DORMITORIO
18010745;;M;30;CHILENO;;Millenial;N/D;N/D;7990;1;1;0;0;0;1;1;7990;Almohadas Isidora Soft 50x90 cm;DORMITORIO
7291144;;F;67;CHILENO;;Boomers;RANCAGUA                      ;L.G.B.OÂ´HIGGINS;188980;2;1;2;1;188980;0;0;0;CE EVOLUTION BLACK 1,5P + RESPALDO CASTILLA;DORMITORIO
25917059;;M;46;VENEZOLANO;;Extranjero;RANCAGUA                      ;L.G.B.OÂ´HIGGINS;298980;2;1;2;1;298980;0;0;0;BOXET ERGO T 1,5 P;DORMITORIO
10566338;;F;57;CHILENO;;Boomers;PROVIDENCIA                   ;METROPOLITANA;9980;2;1;0;0;0;2;1;9980;PACK 2 ALMOHADAS C+L;DORMITORIO
26357555;;M;30;COLOMBIANO;PSICOLOGOS;Extranjero;PROVIDENCIA                   ;METROPOLITANA;238980;2;1;2;1;238980;0;0;0;Cama Europea Supreme 1P;DORMITORIO
14048565;;F;41;CHILENO;;X;SAN FERNANDO                  ;L.G.B.OÂ´HIGGINS;81960;4;5;0;0;0;4;5;81960;ALMOHADA ROSEN SOFT PLUS KING;DORMITORIO
10115480;;M;56;CHILENO;;Boomers;N/D;N/D;519980;2;1;0;0;0;2;1;519980;CE NEW ORTOPEDIC 2P BD ARES S/T;DORMITORIO
13907552;;F;42;CHILENO;;X;"";"";7990;1;1;0;0;0;1;1;7990;Pack Imperial Soft 45x65 cm.;DORMITORIO
13804785;;M;42;CHILENO;;X;N/D;N/D;14970;3;1;0;0;0;3;1;14970;PACK 2 ALMOHADAS C+L;DORMITORIO
8911761;;F;65;CHILENO;;Boomers;RENCA                         ;METROPOLITANA;29990;1;2;0;0;0;1;2;29990;Almohada Visco Bamboo Classic Pack 60x40 cm;DORMITORIO
13408929;;F;44;CHILENO;;X;CASTRO                        ;LOS LAGOS;310960;4;3;1;1;229990;3;2;80970;Almohada Imperial Soft 50x70 cm;DORMITORIO
26294254;;M;37;EXTRANJERO - NO INFORMA NACIONALIDAD;;Extranjero;PROVIDENCIA                   ;METROPOLITANA;229980;2;1;2;1;229980;0;0;0;Colchon Supreme 2P 2M;DORMITORIO
21284511;;M;41;ECUATORIANO;;Extranjero;ANTOFAGASTA                   ;ANTOFAGASTA;89640;2;1;2;1;89640;0;0;0;COMODA 5C MOD Y265 - BICOLOR AT;DORMITORIO
8929076;;F;65;CHILENO;;Boomers;SAN JAVIER                    ;MAULE;384970;3;1;0;0;0;3;1;384970;CE ERGO T 2P 2MT BD;DORMITORIO
18648163;;M;28;CHILENO;;Millenial;RANCAGUA                      ;L.G.B.OÂ´HIGGINS;166530;3;2;2;1;154540;1;1;11990;BOX AMERICANO EXCELLENCE 1.5 PLAZA + ALM;DORMITORIO
9886126;;M;58;CHILENO;;Boomers;SAN FERNANDO                  ;L.G.B.OÂ´HIGGINS;774940;6;3;0;0;0;6;3;774940;COLCHON TERAPEUTIC 2P PILLOW TOP;DORMITORIO
19910453;;F;24;CHILENO;;Z;PROVIDENCIA                   ;METROPOLITANA;15980;2;1;0;0;0;2;1;15980;ALMOHADA SOFT MICROGEL;DORMITORIO
16647780;;F;34;CHILENO;;Millenial;N/D;N/D;26460;4;1;0;0;0;4;1;26460;Almohadas Isidora Soft 50x70 cm;DORMITORIO
7835047;;F;65;CHILENO;;Boomers;SAN PEDRO                     ;METROPOLITANA;83980;2;1;2;1;83980;0;0;0;CB Respaldo 2P+ 2 Veladores Chocolate;DORMITORIO
13624285;;F;43;CHILENO;;X;CANETE                        ;BIO BIO;272980;2;1;0;0;0;2;1;272980;COLCHON BAMBOO 2P FIBRAS BAMBOO;DORMITORIO
14524342;;F;45;CHILENO;;X;SAN MIGUEL;METROPOLITANA;499970;3;1;3;1;499970;0;0;0;CE EVOLUTION BLACK 2P BN+RESP+2 VEL;DORMITORIO
11143188;;M;54;CHILENO;;Boomers;N/D;N/D;231980;2;1;0;0;0;2;1;231980;BA EXCELL PLUS 1,5P +RESP+1VEL NEW VILLARRICA;DORMITORIO
17582078;;M;32;CHILENO;;Millenial;PADRE LAS CASAS               ;ARAUCANIA;254980;2;1;2;1;254980;0;0;0;BA BEAT 2P 2MTS BN;DORMITORIO
9084658;;F;59;CHILENO;;Boomers;TEMUCO                        ;ARAUCANIA;99970;3;2;0;0;0;3;2;99970;SET 2 ALMOHADAS VISCO MEDIUM 60X40 CM;DORMITORIO
12467037;;M;49;CHILENO;;X;PROVIDENCIA                   ;METROPOLITANA;211540;2;1;2;1;211540;0;0;0;COLCHON BAMBOO 2P FIBRAS BAMBOO;DORMITORIO
16546802;;F;35;CHILENO;;Silencioso;PROVIDENCIA                   ;METROPOLITANA;403980;2;1;2;1;403980;0;0;0;CAMAROTE ISIDORA +2 COLCHONES EXCELLENCE PLUS;DORMITORIO
11248954;;F;54;CHILENO;;Boomers;PROVIDENCIA                   ;METROPOLITANA;259980;2;1;2;1;259980;0;0;0;DIVAN CAMA ERGO T 1,5P 2 MTS;DORMITORIO
8945016;;M;60;CHILENO;;Boomers;LOS ANGELES                   ;BIO BIO;0;0;2;0;0;0;0;2;0;COLCHON ORTOPEDIC ADVANCE 2P + CUBREC;DORMITORIO
8934635;;F;61;CHILENO;;Silencioso;PROVIDENCIA                   ;METROPOLITANA;332970;3;1;0;0;0;3;1;332970;COLCHON BAMBOO 1,5P FIBRAS BAMBOO;DORMITORIO
20114277;;F;22;CHILENO;;Z;TOCOPILLA                     ;ANTOFAGASTA;79640;2;1;2;1;79640;0;0;0;COMODA ROMA 4 CAJONES EXIT NOGAL 0,93X0,55X0,38;DORMITORIO
22676000;;M;61;BOLIVIANO;;Extranjero;TALCAHUANO                    ;BIO BIO;189970;3;2;0;0;0;3;2;189970;COLCHON EVOLUTION BLACK 1,5P DUAL SIDE;DORMITORIO
19100345;Soltero;F;26;CHILENO;PSICOLOGO;Z;PROVIDENCIA                   ;METROPOLITANA;279980;2;1;2;1;279980;0;0;0;CAMA EUROPEA BAMBOO 1,5P;DORMITORIO
9266841;;F;52;CHILENO;;X;COIHAIQUE                     ;AYSEN;511950;5;1;0;0;0;5;1;511950;BS ORTOPEDIC ADVANCE B5 BLACK 2PBD;DORMITORIO
15514274;Casado;M;39;CHILENO;ABOGADO;X;RENCA                         ;METROPOLITANA;160990;2;1;2;1;160990;0;0;0;CLOSET ARICA TV 32 M302 TEXTURADO CASTANO;DORMITORIO
19822367;;M;24;CHILENO;;Z;N/D;N/D;279640;2;1;2;1;279640;0;0;0;BA EXCELLENCE 2P BN +RESP+2VEL OLMO +2ALM+PL;DORMITORIO
20136096;;F;22;CHILENO;;Silencioso;PROVIDENCIA                   ;METROPOLITANA;256980;2;1;2;1;256980;0;0;0;DUPLEX BOX AMERICANO EXCELLENCE 1 PLAZA;DORMITORIO
7271378;;F;68;CHILENO;;Boomers;PROVIDENCIA                   ;METROPOLITANA;404980;2;1;2;1;404980;0;0;0;CAMA ERGO T 2PBD + RESP + 2 VEL FERRARA;DORMITORIO
17898045;;M;31;CHILENO;;Millenial;FLORIDA                       ;BIO BIO;653950;4;1;0;0;0;4;1;653950;CE EVOLUTION BLACK 2P BD DUAL SIDE;DORMITORIO
14620406;;F;43;CHILENO;;X;PROVIDENCIA                   ;METROPOLITANA;169980;2;1;2;1;169980;0;0;0;BOX AMERICANO EXCELLENCE 1 PLAZA;DORMITORIO
7213727;Casado;F;64;CHILENO;;Boomers;NATALES                       ;MAGALLANES;439980;2;1;0;0;0;2;1;439980;COLCHON IBIZA 2P;DORMITORIO
14482589;;M;40;CHILENO;;X;N/D;N/D;219990;1;1;0;0;0;1;1;219990;CAMA EUROPEA THERAPEDIC MAS 1,5P;DORMITORIO
16214555;;F;36;CHILENO;;Millenial;PROVIDENCIA                   ;METROPOLITANA;135980;2;1;2;1;135980;0;0;0;COLCHON BAMBOO 1,5P FIBRAS BAMBOO;DORMITORIO
15119605;;M;40;CHILENO;;X;N/D;N/D;188980;2;1;2;1;188980;0;0;0;CE EVOLUTION BLACK 1,5P + RESPALDO ASTURIAS;DORMITORIO
11350119;;F;54;CHILENO;;X;TALCAHUANO;BIO-BIO;201680;4;2;4;2;201680;0;0;0;COLCHON EXCELLENCE 1.5 PLAZA + CUBRECOLCHON;DORMITORIO
22363818;Soltero;M;32;EXTRANJERO - NO INFORMA NACIONALIDAD;TECNICO EN TELECOMUNICACIONES;Extranjero;"";"";174950;5;3;5;3;174950;0;0;0;ALMOHADA COOL GEL TECH SERIES 60X40 CM;DORMITORIO
10391129;;M;57;CHILENO;;Boomers;RENCA                         ;METROPOLITANA;192980;2;1;0;0;0;2;1;192980;COLCHON NEW ORTOPEDIC 1P;DORMITORIO
11853454;;M;50;CHILENO;;X;RENCA                         ;METROPOLITANA;129980;2;1;2;1;129980;0;0;0;COLCHON BAMBOO 1,5P FIBRAS BAMBOO;DORMITORIO
4255660;;M;82;CHILENO;;Silencioso;OVALLE                        ;COQUIMBO;341470;3;1;0;0;0;3;1;341470;COLCHON EVOLUTION BLACK 2P DUAL SIDE;DORMITORIO
6217365;;F;73;CHILENO;;Silencioso;TOCOPILLA                     ;ANTOFAGASTA;179460;3;1;0;0;0;3;1;179460;COLCHON NEW ENTREE 1,5P;DORMITORIO
18061088;;F;30;CHILENO;;Millenial;"";"";215980;2;1;2;1;215980;0;0;0;CAMAROTE TRIPLE CORINA CAFE CLARO;DORMITORIO
5970332;Casado;M;74;CHILENO;;Silencioso;RENCA                         ;METROPOLITANA;297980;2;1;0;0;0;2;1;297980;CE EVOLUTION BLACK 1,5P BN RESP+VEL;DORMITORIO
12296930;;F;49;CHILENO;;X;PROVIDENCIA                   ;METROPOLITANA;261980;2;1;2;1;261980;0;0;0;C.EUROPEA NEW ORTOPEDIC 1.5P +RESP+VEL LEGNO;DORMITORIO
10105411;;F;60;CHILENO;;Boomers;TEMUCO                        ;ARAUCANIA;285960;4;2;0;0;0;4;2;285960;COLCHON BAMBOO 1,5P FIBRAS BAMBOO;DORMITORIO
12342857;Casado;M;49;CHILENO;;X;RENCA                         ;METROPOLITANA;265980;2;1;2;1;265980;0;0;0;CE BLACK 2P B/N EVOLUTION +2ALM +CUBRECAMA+SABAN;DORMITORIO
17234214;;M;32;CHILENO;;Millenial;PROVIDENCIA                   ;METROPOLITANA;17980;2;1;0;0;0;2;1;17980;ALMOHADA SOFT MICROGEL;DORMITORIO
17886964;;M;31;CHILENO;;Silencioso;PROVIDENCIA                   ;METROPOLITANA;473530;3;1;3;1;473530;0;0;0;CE ERGO T KING 2MT BD;DORMITORIO
20103839;;F;23;CHILENO;;Z;PROVIDENCIA                   ;METROPOLITANA;7980;2;1;0;0;0;2;1;7980;PACK 2 ALMOHADAS C+L;DORMITORIO
6705472;;F;71;CHILENO;;Silencioso;PROVIDENCIA                   ;METROPOLITANA;128540;2;1;2;1;128540;0;0;0;CLOSET M-802 4P+2 C ALTO 1,82 BLANCO NATURAL;DORMITORIO
7032096;Casado;M;70;CHILENO;;Silencioso;RENCA                         ;METROPOLITANA;345070;2;1;0;0;0;2;1;345070;COLCHON TERAPEUTIC 2P PILLOW TOP;DORMITORIO
7649548;;F;64;CHILENO;;Boomers;ARICA                         ;TARAPACA;44990;1;1;0;0;0;1;1;44990;SET 2 ALMOHADAS VISCO MEDIUM 60X40 CM;DORMITORIO
11420385;;F;53;CHILENO;;X;QUILICURA                     ;METROPOLITANA;654970;3;2;0;0;0;3;2;654970;Cama Europea Everest 2PBN + Resp + 2 Vel Capiton;DORMITORIO
13266161;;F;45;CHILENO;;X;PROVIDENCIA                   ;METROPOLITANA;583980;2;1;2;1;583980;0;0;0;CAMA ART 4 1.50X2.00 BD;DORMITORIO
8649716;;M;62;CHILENO;;Boomers;PROVIDENCIA                   ;METROPOLITANA;6990;1;1;0;0;0;1;1;6990;ALMOHADA SOFT MICROGEL;DORMITORIO
20345129;;F;22;CHILENO;;Z;PROVIDENCIA                   ;METROPOLITANA;169980;2;1;2;1;169980;0;0;0;COLCHON NEW ORTOPEDIC 2P;DORMITORIO
7458715;;F;64;CHILENO;;Boomers;PANGUIPULLI                   ;LOS RIOS;740910;11;2;0;0;0;11;2;740910;COLCHON BAMBOO 1,5P FIBRAS BAMBOO;DORMITORIO
20051874;;F;23;CHILENO;;Z;VICTORIA                      ;ARAUCANIA;274970;3;1;3;1;274970;0;0;0;CE EVOLUTION BLACK 1,5P + RESPALDO CASTILLA;DORMITORIO
17335798;;M;32;CHILENO;;Millenial;SAN FERNANDO                  ;L.G.B.OÂ´HIGGINS;25980;2;1;0;0;0;2;1;25980;Almohada Bamboo Classic 70x40;DORMITORIO
17534774;;F;32;CHILENO;;Millenial;NATALES                       ;MAGALLANES;359980;3;1;3;1;359980;0;0;0;COLCHON BAMBOO 2P FIBRAS BAMBOO;DORMITORIO
15848496;;F;37;CHILENO;;Millenial;MOLINA                        ;MAULE;448940;5;2;4;1;373950;1;1;74990;CE EVOLUTION BLACK 1,5P + RESPALDO CASTILLA;DORMITORIO
18679461;;F;28;CHILENO;;Millenial;LOS ANDES                     ;VALPARAISO;119980;2;1;2;1;119980;0;0;0;CE EVOLUTION BLACK 1,5P + RESPALDO CASTILLA;DORMITORIO
9390940;Casado;F;61;CHILENO;;Boomers;RENCA                         ;METROPOLITANA;4990;1;1;0;0;0;1;1;4990;Almohada Imperial Soft 50x70 cm;DORMITORIO
15025289;;M;36;CHILENO;;Millenial;ANTOFAGASTA                   ;ANTOFAGASTA;679980;2;1;2;1;679980;0;0;0;CAMA NEW STYLE 6 KING + RESP + 2 VEL VENETO;DORMITORIO
12613950;;M;48;CHILENO;;X;RENCA                         ;METROPOLITANA;355070;2;1;0;0;0;2;1;355070;CE BAMBOO 2P BN FIBRAS BAMBOO DUAL SIDE;DORMITORIO
15213805;;F;41;CHILENO;;X;LOS ALAMOS                    ;BIO BIO;135840;2;1;2;1;135840;0;0;0;CLOSET ESPANA 6P+4C;DORMITORIO
9973235;;F;57;CHILENO;;Boomers;PARRAL                        ;MAULE;25980;2;1;0;0;0;2;1;25980;Almohada Bamboo Classic 70x40;DORMITORIO
20046329;;M;23;CHILENO;;Silencioso;PROVIDENCIA                   ;METROPOLITANA;269980;2;1;2;1;269980;0;0;0;CE EVOLUTION BLACK 2P BD+RESP+2 VEL;DORMITORIO
16348638;;F;35;CHILENO;;Millenial;"";"";3990;1;1;0;0;0;1;1;3990;PACK 2 ALMOHADAS C+L;DORMITORIO
7629761;;M;64;CHILENO;;Boomers;N/D;N/D;870500;10;3;0;0;0;10;3;870500;CAMA EUROPEA IBIZA 2 PL BD;DORMITORIO
19193652;;F;26;CHILENO;;Z;N/D;N/D;689980;2;1;2;1;689980;0;0;0;CE SUPER PREMIUM KING +RESP+2VEL NEW TOR CHOC;DORMITORIO
16470090;Soltero;F;36;CHILENO;INGENIERA EN BIOTECNOLOGIA MOLECULAR;Millenial;PROVIDENCIA                   ;METROPOLITANA;158980;2;1;2;1;158980;0;0;0;CE EVOLUTION BLACK 1P BN DUAL SIDE;DORMITORIO
15849924;Casado;M;37;CHILENO;;Millenial;PROVIDENCIA                   ;METROPOLITANA;439990;2;1;2;1;439990;0;0;0;BS ORTO ADVANCE B5 BCK 2PBD RESPALDO EUFRATES;DORMITORIO
18455046;;M;29;CHILENO;;Millenial;SANTIAGO;METROPOLITANA;179980;2;1;2;1;179980;0;0;0;CE EVOLUTION BLACK 1,5P + RESPALDO ASTURIAS;DORMITORIO
12472864;;F;49;CHILENO;;X;PENAFLOR                      ;METROPOLITANA;243980;2;1;2;1;243980;0;0;0;COLCHON IBIZA 2P;DORMITORIO
10415709;Casado;F;56;CHILENO;;Boomers;RENCA                         ;METROPOLITANA;149670;2;1;0;0;0;2;1;149670;COLCHON EVOLUTION BLACK 1P DUAL SIDE;DORMITORIO
12119273;;F;54;CHILENO;;Boomers;SAN FERNANDO                  ;L.G.B.OÂ´HIGGINS;26990;1;1;0;0;0;1;1;26990;Almohada Visco Bamboo Classic Pack 60x40 cm;DORMITORIO
16547484;Casado;F;35;CHILENO;;Millenial;PUENTE ALTO                   ;METROPOLITANA;239980;2;1;0;0;0;2;1;239980;COLCHON ORTOPEDIC ADVANCE 2P;DORMITORIO
15405480;;M;39;CHILENO;;X;PROVIDENCIA                   ;METROPOLITANA;339980;2;1;0;0;0;2;1;339980;COLCHON NEW ORTOPEDIC 1,5P;DORMITORIO
16005830;Soltero;M;37;CHILENO;;Millenial;PROVIDENCIA                   ;METROPOLITANA;128370;2;1;0;0;0;2;1;128370;COLCHON EVOLUTION BLACK 1P DUAL SIDE;DORMITORIO
11988463;;F;50;CHILENO;;X;N/D;N/D;154980;2;1;2;1;154980;0;0;0;COLCHON BAMBOO 1,5P FIBRAS BAMBOO;DORMITORIO
16749090;;F;34;CHILENO;;Silencioso;PROVIDENCIA                   ;METROPOLITANA;256980;2;1;2;1;256980;0;0;0;BOX AMERICANO EXCELLENCE FULL +RESP+2VEL OLMO;DORMITORIO
9449007;;F;61;CHILENO;;Boomers;PROVIDENCIA                   ;METROPOLITANA;173980;2;1;2;1;173980;0;0;0;CE EVOLUTION BLACK 1,5P BN DUAL SIDE;DORMITORIO
7508552;;F;64;CHILENO;;Boomers;RENCA                         ;METROPOLITANA;0;0;0;0;0;0;0;0;0;Almohada Bamboo Classic 70x40;DORMITORIO
9304452;Casado;F;58;CHILENO;;Boomers;MOSTAZAL                      ;L.G.B.OÂ´HIGGINS;0;0;0;0;0;0;0;0;0;CLOSET 6 PUERTAS 2 CAJONES 1 ZAPATERA BALI BICO;DORMITORIO
8531194;;F;69;CHILENO;;Silencioso;ARICA                         ;ARICA Y PARINACOTA;0;0;0;0;0;0;0;0;0;PACK 2 ALMOHADAS 100% PLUMA 50 X 70 CM;DORMITORIO
16205555;;M;36;CHILENO;;Millenial;N/D;N/D;0;0;0;0;0;0;0;0;0;COLCHON EVEREST 2P 150X200;DORMITORIO
25692417;;M;26;COLOMBIANO;;Extranjero;"";"";0;0;0;0;0;0;0;0;0;BS ORTOPEDIC ADVANCE B5 BLACK KING;DORMITORIO
15156885;;F;40;CHILENO;;X;PROVIDENCIA                   ;METROPOLITANA;0;0;0;0;0;0;0;0;0;PACK 2 ALMOHADAS C+L;DORMITORIO
9450854;;F;61;CHILENO;;Boomers;VICTORIA                      ;ARAUCANIA;0;0;0;0;0;0;0;0;0;COLCHON ERGO T 1P;DORMITORIO
10558982;Viudo;F;57;CHILENO;;Boomers;RENCA                         ;METROPOLITANA;0;0;0;0;0;0;0;0;0;PACK 2 ALMOHADAS C+L;DORMITORIO
6511308;;M;71;CHILENO;;Silencioso;LA SERENA                     ;COQUIMBO;0;0;0;0;0;0;0;0;0;CAMA ERGO T 2PBD + RESP + 2 VEL FERRARA;DORMITORIO
15754703;;F;37;CHILENO;;Millenial;N/D;N/D;0;0;0;0;0;0;0;0;0;BS NEW ORTOPEDIC B5BLACK KING+RESP+2VEL LEGNO;DORMITORIO
17472003;;F;32;CHILENO;;Millenial;PROVIDENCIA                   ;METROPOLITANA;0;0;0;0;0;0;0;0;0;CE ERGO T 2P 2MT BD;DORMITORIO
9308704;;F;59;CHILENO;;Boomers;CHILLAN VIEJO                 ;BIO BIO;0;0;0;0;0;0;0;0;0;ALMOHADA ROSEN SOFT PLUS AMERICANA;DORMITORIO
13826531;;F;43;CHILENO;;X;PROVIDENCIA                   ;METROPOLITANA;0;0;0;0;0;0;0;0;0;Almohada Bamboo Classic 70x40;DORMITORIO
10051966;;F;57;CHILENO;;Boomers;N/D;N/D;0;0;0;0;0;0;0;0;0;COLCHON NEW ORTOPEDIC 1,5P;DORMITORIO
10400267;;F;57;CHILENO;;Boomers;PADRE LAS CASAS               ;ARAUCANIA;0;0;0;0;0;0;0;0;0;CE ERGO T 2P 2MT BD;DORMITORIO
9203534;;F;59;CHILENO;;Boomers;N/D;N/D;0;0;0;0;0;0;0;0;0;VELADOR FAVATEX FRANK 3C;DORMITORIO
5765493;;F;77;CHILENO;;Silencioso;OSORNO                        ;LOS LAGOS;0;0;0;0;0;0;0;0;0;PACK 2 ALMOHADAS C+L;DORMITORIO
11187964;;M;55;CHILENO;;Boomers;DALCAHUE                      ;LOS LAGOS;0;0;0;0;0;0;0;0;0;CE BAMBOO 2PBD BAMBOO+RES+2V ALICANTE;DORMITORIO
19298504;;F;26;CHILENO;;Z;CHEPICA                       ;L.G.B.OÂ´HIGGINS;0;0;0;0;0;0;0;0;0;Closet BAKER TV 43 2PT 4CJ CHOCOLATE;DORMITORIO
15631753;;M;38;CHILENO;;Silencioso;PROVIDENCIA                   ;METROPOLITANA;0;0;0;0;0;0;0;0;0;ALMOHADA MEMORY MAX BASIC AMERICANA;DORMITORIO
19583282;;M;25;CHILENO;;Millenial;PEDRO AGUIRRE CERDA           ;METROPOLITANA;0;0;0;0;0;0;0;0;0;CLOSET NIZA 6P+2C;DORMITORIO
11169014;;F;54;CHILENO;;Boomers;LA CISTERNA                   ;METROPOLITANA;0;0;0;0;0;0;0;0;0;COLCHON EXCELLENCE PLUS 2P;DORMITORIO
10950416;;M;53;CHILENO;;Silencioso;PROVIDENCIA                   ;METROPOLITANA;0;0;0;0;0;0;0;0;0;COLCHON ORTOPEDIC ADVANCE 1 1/2P + CUBREC;DORMITORIO
13480278;Casado;M;43;CHILENO;PERIODISTA;Silencioso;PROVIDENCIA                   ;METROPOLITANA;0;0;0;0;0;0;0;0;0;COLCHON BEAT 1,5P;DORMITORIO
19410783;;M;26;CHILENO;;Silencioso;PROVIDENCIA                   ;METROPOLITANA;0;0;0;0;0;0;0;0;0;ALMOHADA BAMBOO TECH SERIES 65X45 CM;DORMITORIO
10444474;;F;56;CHILENO;;Boomers;N/D;N/D;0;0;0;0;0;0;0;0;0;CE ERGO T 2P 2MT BD;DORMITORIO
7979528;;M;63;CHILENO;;Silencioso;PROVIDENCIA                   ;METROPOLITANA;0;0;0;0;0;0;0;0;0;CE ERGO T 2P 2MT BD;DORMITORIO
19450031;Soltero;M;26;CHILENO;;Z;PROVIDENCIA                   ;METROPOLITANA;0;0;0;0;0;0;0;0;0;CAMA EUROPEA CANNABIS 2PBD + RESP + VEL MADRID;DORMITORIO
10904529;;F;56;CHILENO;;Boomers;N/D;N/D;0;0;0;0;0;0;0;0;0;COLCHON ART 4 2P;DORMITORIO
14385231;;F;44;CHILENO;;X;COQUIMBO                      ;COQUIMBO;0;0;0;0;0;0;0;0;0;CLOSET CIPRES MODELO CMS24D, COLOR DEMOLICION, 2;DORMITORIO
10915867;;M;56;CHILENO;;Silencioso;PROVIDENCIA                   ;METROPOLITANA;0;0;0;0;0;0;0;0;0;BOX SPRING NEOSENSE FULL BLACK;DORMITORIO
8087532;;F;60;CHILENO;;Boomers;CONSTITUCION                  ;MAULE;0;0;0;0;0;0;0;0;0;PACK 2 ALMOHADAS-D VISCO 60 x 40;DORMITORIO
16226040;;F;36;CHILENO;;Millenial;ARICA                         ;ARICA Y PARINACOTA;0;0;0;0;0;0;0;0;0;ALMOHADA SOFT MICROGEL;DORMITORIO
17641186;;M;31;CHILENO;;Millenial;N/D;N/D;0;0;0;0;0;0;0;0;0;PACK 2 ALMOHADAS C+L;DORMITORIO
7589094;Casado;M;64;CHILENO;INGENIERO AGRICOLA;Silencioso;PROVIDENCIA                   ;METROPOLITANA;0;0;0;0;0;0;0;0;0;ALMOHADA SOFT MICROGEL;DORMITORIO
14350024;;F;43;CHILENO;;X;PROVIDENCIA                   ;METROPOLITANA;0;0;0;0;0;0;0;0;0;Cama Europea Cannabis 1.5 plazas + Sabanas Imper;DORMITORIO
14357996;;M;43;CHILENO;;X;SAN FELIPE                    ;VALPARAISO;0;0;0;0;0;0;0;0;0;CAMA DRIVEN 1.80X2.00 BILBAO;DORMITORIO
8296549;;F;63;CHILENO;;Boomers;SAN PEDRO DE LA PAZ           ;BIO BIO;0;0;0;0;0;0;0;0;0;SET 2 ALMOHADAS VISCO MEDIUM 60X40 CM;DORMITORIO
13055878;;F;46;CHILENO;;X;PEDRO AGUIRRE CERDA           ;METROPOLITANA;0;0;0;0;0;0;0;0;0;BA EXCELLENCE PLUS 2P BD +RESP+VEL OLMO;DORMITORIO
14513837;;F;42;CHILENO;;Silencioso;PROVIDENCIA                   ;METROPOLITANA;0;0;0;0;0;0;0;0;0;ARMARIO RAM GRANDE PRESTIGE;DORMITORIO
18387602;Soltero;F;29;CHILENO;;Silencioso;PROVIDENCIA                   ;METROPOLITANA;0;0;0;0;0;0;0;0;0;Cama Europea Danubio 2P BD Comprimido;DORMITORIO
7217546;Casado;F;73;CHILENO;;Silencioso;CORONEL                       ;BIO BIO;0;0;0;0;0;0;0;0;0;COLCHON NEW ORTOPEDIC 1P;DORMITORIO
9517814;;M;56;CHILENO;;Boomers;LA SERENA                     ;COQUIMBO;0;0;0;0;0;0;0;0;0;CAMA EUROPEA THERAPEDIC MAS 1,5P;DORMITORIO
17980207;Soltero;M;30;CHILENO;;Millenial;PROVIDENCIA                   ;METROPOLITANA;0;0;0;0;0;0;0;0;0;C.EUR EXCELLENCE PLUS 1P+RESP+1VEL NEW MUNICH;DORMITORIO
19467064;;F;25;CHILENO;;Z;N/D;N/D;0;0;0;0;0;0;0;0;0;CLOSET CROACIA BLANCO 4P;DORMITORIO
15058941;;F;38;CHILENO;;Millenial;LA LIGUA                      ;VALPARAISO;0;0;0;0;0;0;0;0;0;CE ORTO ADVANCE 2PBD +RESP+2VEL NEW DUB CHOC;DORMITORIO
5537605;;M;74;CHILENO;;Silencioso;IQUIQUE                       ;TARAPACA;0;0;0;0;0;0;0;0;0;COLCHON THERAPEDIC 2P;DORMITORIO
18726914;Soltero;M;29;CHILENO;INGENIERO EN TELECOMUNICACIONES;Millenial;PROVIDENCIA                   ;METROPOLITANA;0;0;0;0;0;0;0;0;0;COLCHON SPRING III 1P;DORMITORIO
13438529;;F;44;CHILENO;;X;PANGUIPULLI                   ;LOS LAGOS;0;0;0;0;0;0;0;0;0;DUPLEX CE EVOLUTION BLACK 1P + 2 RESP + VEL CAST;DORMITORIO
11809110;Casado;F;51;CHILENO;PSICOLOGO;X;RENCA                         ;METROPOLITANA;0;0;0;0;0;0;0;0;0;ALMOHADA ROSEN SOFT PLUS AMERICANA;DORMITORIO
19251756;;F;25;CHILENO;;Silencioso;PROVIDENCIA                   ;METROPOLITANA;0;0;0;0;0;0;0;0;0;CE EVOLUTION BLACK 2P BD DUAL SIDE;DORMITORIO
12176379;;F;49;CHILENO;;X;PROVIDENCIA                   ;METROPOLITANA;0;0;0;0;0;0;0;0;0;CAMA NEW STYLE 2 1.50X2.00BD + RESPALDO FERRARA;DORMITORIO
15452410;;F;42;CHILENO;;X;RENCA                         ;METROPOLITANA;0;0;0;0;0;0;0;0;0;ALMOHADA MEMORY MAX BASIC AMERICANA;DORMITORIO
20462507;;M;22;CHILENO;;Silencioso;PROVIDENCIA                   ;METROPOLITANA;0;0;0;0;0;0;0;0;0;CLOSET NEWCAPRI M-330 AVELLANA/CARVALHO4P3C+ESPE;DORMITORIO
18318080;;M;29;CHILENO;;Millenial;N/D;N/D;0;0;0;0;0;0;0;0;0;CAMA NIDO EVOLUTION BLACK 1,5P;DORMITORIO
17969047;Soltero;F;30;CHILENO;EDUCADOR DE PARVULO;Millenial;PROVIDENCIA                   ;METROPOLITANA;0;0;0;0;0;0;0;0;0;BS ORTOP ADVANCE B5BLACK 2PBD+RESP+2VEL LEGNO;DORMITORIO
19579129;;F;25;CHILENO;;Z;PROVIDENCIA                   ;METROPOLITANA;0;0;0;0;0;0;0;0;0;CE CAMA ERGO T 1.50X2.00 BD + RESP FERRARA;DORMITORIO
18691930;;F;27;CHILENO;;Millenial;NUEVA IMPERIAL                ;ARAUCANIA;0;0;0;0;0;0;0;0;0;COLCHON NEW ORTOPEDIC 1,5P;DORMITORIO
12316848;;F;49;CHILENO;;X;LONGAVI                       ;MAULE;0;0;0;0;0;0;0;0;0;COLCHON NEW ORTOPEDIC 1,5P;DORMITORIO
14172838;;M;41;CHILENO;;X;PROVIDENCIA                   ;METROPOLITANA;0;0;0;0;0;0;0;0;0;RACK CLASICO NOGAL AMAZONICO;DORMITORIO
13266874;;M;45;CHILENO;;X;"";"";0;0;0;0;0;0;0;0;0;CE EVEREST KING 2MTS BD HILOS COBRE;DORMITORIO
14419216;Soltero;F;40;CHILENO;ENFERMERA;Silencioso;PROVIDENCIA                   ;METROPOLITANA;0;0;0;0;0;0;0;0;0;CE EVOLUTION BLACK 2P BD DUAL SIDE;DORMITORIO
19194176;Soltero;M;26;CHILENO;;Silencioso;N/D;N/D;0;0;0;0;0;0;0;0;0;COLCHON BEAT 1,5P;DORMITORIO
26065969;;F;40;COLOMBIANO;;Extranjero;SANTIAGO                      ;METROPOLITANA;0;0;0;0;0;0;0;0;0;SET 2 ALMOHADAS VISCO MEDIUM 60X40 CM;DORMITORIO
11942519;;F;50;CHILENO;;X;CABILDO                       ;VALPARAISO;0;0;0;0;0;0;0;0;0;COLCHON ORTOPEDIC ADVANCE 2P;DORMITORIO
11357027;;F;54;CHILENO;;X;CASTRO                        ;LOS LAGOS;0;0;0;0;0;0;0;0;0;BA EXCELLENCE 2P BN +RESP+2VEL OLMO +2ALM+PL;DORMITORIO
5931806;;M;72;CHILENO;;Silencioso;SAN FERNANDO                  ;L.G.B.OÂ´HIGGINS;0;0;0;0;0;0;0;0;0;COLCHON TERAPEUTIC 2P PILLOW TOP;DORMITORIO
19608432;;F;24;CHILENO;;Silencioso;PROVIDENCIA                   ;METROPOLITANA;0;0;0;0;0;0;0;0;0;COLCHON EXCELLENCE PLUS 2P;DORMITORIO
17723762;;F;31;CHILENO;;Millenial;PROVIDENCIA                   ;METROPOLITANA;0;0;0;0;0;0;0;0;0;CAMA NIDO EVOLUTION BLACK 1,5P;DORMITORIO
16400516;;M;36;CHILENO;;Millenial;CALERA                        ;VALPARAISO;0;0;0;0;0;0;0;0;0;CAMA EUROPEA IBIZA 2 PL BD;DORMITORIO
15613135;;M;39;CHILENO;;X;RENCA                         ;METROPOLITANA;0;0;0;0;0;0;0;0;0;COLCHON NEW STYLE 6 2P;DORMITORIO
15084135;;M;39;CHILENO;;X;PROVIDENCIA                   ;METROPOLITANA;0;0;0;0;0;0;0;0;0;RESP ITALIA CEDRO 2P CAFE;DORMITORIO
19273954;;M;26;CHILENO;;Z;CHIMBARONGO                   ;L.G.B.OÂ´HIGGINS;0;0;0;0;0;0;0;0;0;CLOSET MARITTIMA 6P+2C;DORMITORIO
16999622;;F;33;CHILENO;;Millenial;PROVIDENCIA                   ;METROPOLITANA;0;0;0;0;0;0;0;0;0;DIVAN NEW ORTOPEDIC 1,5P BLACK;DORMITORIO
13826271;;M;41;CHILENO;;X;PROVIDENCIA                   ;METROPOLITANA;0;0;0;0;0;0;0;0;0;SET SABANA MICROFIBRA SAND 2P;DORMITORIO
18253841;;F;29;CHILENO;;Millenial;CURICO                        ;MAULE;0;0;0;0;0;0;0;0;0;COLCHON THERAPEDIC 2P;DORMITORIO
9480860;Casado;F;59;CHILENO;;Boomers;RENCA                         ;METROPOLITANA;0;0;0;0;0;0;0;0;0;Almohada Bamboo Classic 70x40;DORMITORIO
16705491;Soltero;F;34;CHILENO;;Millenial;PROVIDENCIA                   ;METROPOLITANA;0;0;0;0;0;0;0;0;0;CE EVOLUTION BLACK 1,5P + RESPALDO CASTILLA;DORMITORIO
18708077;;F;27;CHILENO;;Millenial;PROVIDENCIA                   ;METROPOLITANA;0;0;0;0;0;0;0;0;0;CE NEW STYLE 6 2P 2MT BD;DORMITORIO
4914952;;M;75;CHILENO;;Silencioso;PROVIDENCIA                   ;METROPOLITANA;0;0;0;0;0;0;0;0;0;COLCHON EXCELLENCE 2P;DORMITORIO
17715578;Soltero;F;31;CHILENO;;Millenial;PROVIDENCIA                   ;METROPOLITANA;0;0;0;0;0;0;0;0;0;CE EVOLUTION BLACK 1,5P BN RESP+VEL;DORMITORIO
20201704;;F;22;CHILENO;;Silencioso;PROVIDENCIA                   ;METROPOLITANA;0;0;0;0;0;0;0;0;0;CAMA NIDO EVOLUTION BLACK 1,5P;DORMITORIO
15813938;Casado;F;37;CHILENO;;Millenial;N/D;N/D;0;0;0;0;0;0;0;0;0;BA EXCELLENCE 2P BN +RESP+2VEL OLMO +2ALM+PL;DORMITORIO
17704314;Soltero;F;30;CHILENO;INGENIERO COMERCIAL;Millenial;PROVIDENCIA                   ;METROPOLITANA;0;0;0;0;0;0;0;0;0;Almohada ViscoGel Cobre 70x40x13 cm;DORMITORIO
19685372;;M;24;CHILENO;;Z;SALAMANCA;COQUIMBO;0;0;0;0;0;0;0;0;0;BS NEW ORTOPEDIC B5BLACK 2PBN+RESP+2VEL LEGNO;DORMITORIO
16252306;;F;36;CHILENO;;Millenial;MOSTAZAL                      ;L.G.B.OÂ´HIGGINS;0;0;0;0;0;0;0;0;0;CE EVOLUTION BLACK 1,5P BN RESP+VEL;DORMITORIO
12303215;;F;50;CHILENO;;X;PROVIDENCIA                   ;METROPOLITANA;0;0;0;0;0;0;0;0;0;PACK 2 ALMOHADAS C+L;DORMITORIO
6758431;;M;71;CHILENO;;Silencioso;PUERTO MONTT                  ;LOS LAGOS;0;0;0;0;0;0;0;0;0;COLCHON IBIZA 2P;DORMITORIO
18178306;;F;30;CHILENO;;Millenial;LA SERENA                     ;COQUIMBO;0;0;0;0;0;0;0;0;0;CLOSET CAJONERA NEW BELGICA M-398-NW;DORMITORIO
13089713;;M;46;CHILENO;;X;SANTIAGO                      ;METROPOLITANA;0;0;0;0;0;0;0;0;0;CAMA EUROPEA IBIZA 2 PL BD;DORMITORIO
17785920;Casado;F;30;CHILENO;ENFERMERA;Millenial;PROVIDENCIA                   ;METROPOLITANA;0;0;0;0;0;0;0;0;0;CAMA EUROPEA IBIZA 2 PL BD;DORMITORIO
17656097;;F;31;CHILENO;;Millenial;N/D;N/D;0;0;0;0;0;0;0;0;0;DUPLEX BA EXCELLENCE 1 PLAZA +RESP+VEL OLMO;DORMITORIO
17593355;;F;31;CHILENO;;Millenial;LOS ANGELES                   ;BIO BIO;0;0;0;0;0;0;0;0;0;CLOSET 3 PUERTAS MERLIN EBANO ];DORMITORIO
20732553;;M;21;CHILENO;;Extranjero;"";"";0;0;0;0;0;0;0;0;0;CE ERGO T 2P 2MT BD;DORMITORIO
18965982;;F;26;CHILENO;;Z;EL BOSQUE                     ;METROPOLITANA;0;0;0;0;0;0;0;0;0;COLCHON NEW ORTOPEDIC 2P;DORMITORIO
15981302;;M;34;CHILENO;;Silencioso;N/D;N/D;0;0;0;0;0;0;0;0;0;CE EVOLUTION BLACK 1,5P + RESPALDO ASTURIAS;DORMITORIO
7083772;Divorciado;F;68;CHILENO;ENFERMERA;Boomers;ANTOFAGASTA                   ;ANTOFAGASTA;0;0;0;0;0;0;0;0;0;COLCHON ART 4 2P;DORMITORIO
17406643;Soltero;M;32;CHILENO;;Silencioso;PROVIDENCIA                   ;METROPOLITANA;0;0;0;0;0;0;0;0;0;ALMOHADA VISCO ELASTICA BAMBOO 60X40 CM;DORMITORIO
16399076;;F;36;CHILENO;;Millenial;PROVIDENCIA                   ;METROPOLITANA;0;0;0;0;0;0;0;0;0;CAMA NIDO EVOLUTION BLACK 1,5P;DORMITORIO
12377883;;F;52;CHILENO;;X;LANCO                         ;LOS LAGOS;0;0;0;0;0;0;0;0;0;Closet MAIPO 6PT 6CJ 180 CM CHOCOLATE;DORMITORIO
17396200;;F;32;CHILENO;;Silencioso;PROVIDENCIA                   ;METROPOLITANA;0;0;0;0;0;0;0;0;0;BOX AMERICANO EXCELLENCE 2P BASE NORMAL+2ALM;DORMITORIO
18537391;Soltero;M;29;CHILENO;INGENIERO DE EJECUCION ELECTRICO;Silencioso;PROVIDENCIA                   ;METROPOLITANA;0;0;0;0;0;0;0;0;0;CE EVOLUTION BLACK 1,5P + RESPALDO CASTILLA;DORMITORIO
20055686;;M;23;CHILENO;;Z;PROVIDENCIA                   ;METROPOLITANA;0;0;0;0;0;0;0;0;0;ESCRITORIO ESCOBAR;DORMITORIO
12443631;;M;48;CHILENO;;X;ANTOFAGASTA                   ;ANTOFAGASTA;0;0;0;0;0;0;0;0;0;COLCHON EXCELLENCE PLUS 1P;DORMITORIO
5143218;;F;77;CHILENO;;Silencioso;TOCOPILLA                     ;ANTOFAGASTA;0;0;0;0;0;0;0;0;0;PACK 2 ALMOHADAS C+L;DORMITORIO
18546386;;F;29;CHILENO;;Millenial;PROVIDENCIA                   ;METROPOLITANA;0;0;0;0;0;0;0;0;0;COLCHON EXCELLENCE PLUS 1P;DORMITORIO
16629645;;F;34;CHILENO;;Millenial;PROVIDENCIA                   ;METROPOLITANA;0;0;0;0;0;0;0;0;0;COLCHON BAMBOO 2P FIBRAS BAMBOO;DORMITORIO
19436770;;F;25;CHILENO;;Z;PROVIDENCIA                   ;METROPOLITANA;0;0;0;0;0;0;0;0;0;CE EVOLUTION BLACK 1,5P + RESPALDO CASTILLA;DORMITORIO
15675831;;F;37;CHILENO;;Millenial;PROVIDENCIA                   ;METROPOLITANA;0;0;0;0;0;0;0;0;0;DIVAN CAMA ERGO T 1,5P 2 MTS;DORMITORIO
26420256;;F;27;VENEZOLANO;;Extranjero;N/D;N/D;0;0;0;0;0;0;0;0;0;BS ORTOPEDIC ADVANCE B5 BLACK 2PBD;DORMITORIO
19991272;;M;24;CHILENO;;Z;ISLA DE MAIPO                 ;METROPOLITANA;0;0;0;0;0;0;0;0;0;COLCHON EXCELLENCE PLUS 1.5 PLAZA + ALM;DORMITORIO
6038377;;M;69;CHILENO;;Silencioso;OVALLE                        ;COQUIMBO;0;0;0;0;0;0;0;0;0;COLCHON TERAPEUTIC 2P PILLOW TOP;DORMITORIO
18063975;;F;30;CHILENO;;Millenial;PROVIDENCIA                   ;METROPOLITANA;0;0;0;0;0;0;0;0;0;COLCHON NEW STYLE 6 15P LONG;DORMITORIO
15425138;Casado;M;39;CHILENO;;Silencioso;PROVIDENCIA                   ;METROPOLITANA;0;0;0;0;0;0;0;0;0;DIVAN NEW ORTOPEDIC BCK +RESP+1VEL NEW MUNICH;DORMITORIO
18622886;Soltero;F;27;CHILENO;INGENIERO EN ADMINISTRACION DE EMPRESAS;Z;PROVIDENCIA                   ;METROPOLITANA;0;0;0;0;0;0;0;0;0;SET SABANA MICROFIBRA MUSTARD 2P;DORMITORIO
13099969;;F;47;CHILENO;;X;ARICA                         ;ARICA Y PARINACOTA;0;0;0;0;0;0;0;0;0;Almohada Visco Bamboo Classic Pack 60x40 cm;DORMITORIO
18127423;;F;30;CHILENO;;Millenial;N/D;N/D;0;0;0;0;0;0;0;0;0;SET SABANA MICROFIBRA BLUE 2P;DORMITORIO
13075735;;F;45;CHILENO;;X;NUNOA;METROPOLITANA;0;0;0;0;0;0;0;0;0;Cama Europea Danubio 1,5 P Comprimido;DORMITORIO
9934837;Casado;F;56;CHILENO;;Silencioso;PROVIDENCIA                   ;METROPOLITANA;0;0;0;0;0;0;0;0;0;SET SABANA MICROFIBRA SAND 2P;DORMITORIO
18995665;Soltero;F;26;CHILENO;;Z;PROVIDENCIA                   ;METROPOLITANA;0;0;0;0;0;0;0;0;0;CE ERGO T 2P 2MT BD;DORMITORIO
15610401;;F;39;CHILENO;;X;N/D;N/D;0;0;0;0;0;0;0;0;0;PACK 2 ALMOHADAS C+L;DORMITORIO
9953249;Casado;F;59;CHILENO;;Boomers;RENCA                         ;METROPOLITANA;0;0;0;0;0;0;0;0;0;ALMOHADA BAMBOO TECH SERIES 65X45 CM;DORMITORIO
6242584;;M;67;CHILENO;;Boomers;SAN VICENTE                   ;L.G.B.OÂ´HIGGINS;0;0;0;0;0;0;0;0;0;CLOSET ARICA TV 32 M302 TEXTURADO CASTANO;DORMITORIO
17078000;Soltero;M;33;CHILENO;;Millenial;PROVIDENCIA                   ;METROPOLITANA;0;0;0;0;0;0;0;0;0;CE ERGO T 2P 2MT BD;DORMITORIO
18381606;;F;29;CHILENO;;Millenial;VINA DEL MAR                  ;VALPARAISO;0;0;0;0;0;0;0;0;0;CE ERGO T 2P 2MT BD;DORMITORIO
7112831;;F;60;CHILENO;;Silencioso;PROVIDENCIA                   ;METROPOLITANA;0;0;0;0;0;0;0;0;0;COLCHON SPRING III 1P;DORMITORIO
17666546;;F;31;CHILENO;;Millenial;N/D;N/D;0;0;0;0;0;0;0;0;0;CE EVOLUTION BLACK 1,5P BN DUAL SIDE;DORMITORIO
20211765;;F;23;CHILENO;;Millenial;PROVIDENCIA                   ;METROPOLITANA;0;0;0;0;0;0;0;0;0;CE ERGO T KING 2MT BD;DORMITORIO
17484368;Soltero;M;32;CHILENO;INGENIERO ELECTRICO;Silencioso;PROVIDENCIA                   ;METROPOLITANA;0;0;0;0;0;0;0;0;0;Cama Europea Cannabis 2PBD + Sabanas Imperial;DORMITORIO
10869886;;F;51;CHILENO;;X;TALCA                         ;MAULE;0;0;0;0;0;0;0;0;0;BOX AMERICANO EXCELLENCE PLUS 2P BD;DORMITORIO
16484086;;F;35;CHILENO;;Millenial;TOCOPILLA                     ;ANTOFAGASTA;0;0;0;0;0;0;0;0;0;SET 2 ALMOHADAS VISCO MEDIUM 60X40 CM;DORMITORIO
14377474;;M;44;CHILENO;;Silencioso;PROVIDENCIA                   ;METROPOLITANA;0;0;0;0;0;0;0;0;0;COLCHON TERAPEUTIC 2P PILLOW TOP;DORMITORIO
12276117;;F;50;CHILENO;;X;LA PINTANA                    ;METROPOLITANA;0;0;0;0;0;0;0;0;0;COLCHON SUPER PREMIUM 2P;DORMITORIO
10484174;;M;56;CHILENO;;Boomers;PROVIDENCIA                   ;METROPOLITANA;0;0;0;0;0;0;0;0;0;ALMOHADA ROSEN SOFT PLUS AMERICANA;DORMITORIO
12759669;;F;47;CHILENO;;X;PUERTO MONTT                  ;LOS LAGOS;0;0;0;0;0;0;0;0;0;CE EVEREST 2P 2MTS BD DUAL SIDE;DORMITORIO
14436318;;F;47;CHILENO;;X;PROVIDENCIA                   ;METROPOLITANA;0;0;0;0;0;0;0;0;0;COLCHON SWAG 2P 150 X 190;DORMITORIO
20361541;;M;22;CHILENO;;Z;TALCAHUANO                    ;BIO BIO;0;0;0;0;0;0;0;0;0;BOX AMERICANO BEAT 1,5P;DORMITORIO
19044496;Soltero;F;26;CHILENO;;Z;PROVIDENCIA                   ;METROPOLITANA;0;0;0;0;0;0;0;0;0;CE BAMBOO 2P BN FIBRAS BAMBOO DUAL SIDE;DORMITORIO
13637632;;M;43;CHILENO;;X;ARICA                         ;ARICA Y PARINACOTA;0;0;0;0;0;0;0;0;0;Cama Ergo T 2PBD + Resp +2 Vel Tabor;DORMITORIO
20240139;;F;23;CHILENO;;Silencioso;PROVIDENCIA                   ;METROPOLITANA;0;0;0;0;0;0;0;0;0;Cama Europea Active 1,5P;DORMITORIO
16259227;;F;36;CHILENO;;Millenial;N/D;N/D;0;0;0;0;0;0;0;0;0;CLOSET CROACIA BLANCO 4P;DORMITORIO
7820481;;F;77;CHILENO;;Silencioso;VILLARICA                     ;ARAUCANIA;0;0;0;0;0;0;0;0;0;CE EVEREST 2P 2MTS BD DUAL SIDE;DORMITORIO
26427849;;M;47;VENEZOLANO;;Extranjero;"";"";0;0;0;0;0;0;0;0;0;COLCHON IBIZA 2P;DORMITORIO
16389143;;F;36;CHILENO;;Millenial;PROVIDENCIA                   ;METROPOLITANA;0;0;0;0;0;0;0;0;0;CLOSET CROACIA BLANCO 4P;DORMITORIO
18734810;Soltero;M;28;CHILENO;;Millenial;PUERTO MONTT                  ;LOS LAGOS;0;0;0;0;0;0;0;0;0;Pack Veladores Italia Cedro/Pinus;DORMITORIO
19215003;Casado;M;27;CHILENO;;Silencioso;PROVIDENCIA                   ;METROPOLITANA;0;0;0;0;0;0;0;0;0;COLCHON NEW ORTOPEDIC 2P;DORMITORIO
17388268;;F;32;CHILENO;;Millenial;HIJUELAS                      ;VALPARAISO;0;0;0;0;0;0;0;0;0;RACK BELLINI 50;DORMITORIO
18549560;;F;28;CHILENO;;Millenial;PROVIDENCIA                   ;METROPOLITANA;0;0;0;0;0;0;0;0;0;Cama Ergo T 2PBD + Resp +2 Vel Tabor;DORMITORIO
19824977;;M;24;CHILENO;;Z;PROVIDENCIA                   ;METROPOLITANA;0;0;0;0;0;0;0;0;0;COLCHON EXCELLENCE 1.5 PLAZA + CUBRECOLCHON;DORMITORIO
7663375;;M;63;CHILENO;;Boomers;PROVIDENCIA                   ;METROPOLITANA;0;0;0;0;0;0;0;0;0;COLCHON NEW ORTOPEDIC 1,5 105X200;DORMITORIO
13323041;Casado;M;45;CHILENO;INGENIERO INDUSTRIAL;Silencioso;PROVIDENCIA                   ;METROPOLITANA;0;0;0;0;0;0;0;0;0;CLOSET M-803 3P 2C ALTO 1,82 BLANCO NATURAL;DORMITORIO
11841658;;F;51;CHILENO;;X;CONCEPCION                    ;BIO BIO;0;0;0;0;0;0;0;0;0;RACK 1 PUERTA GANGES NOGAL;DORMITORIO
17655687;;F;31;CHILENO;;Millenial;PROVIDENCIA                   ;METROPOLITANA;0;0;0;0;0;0;0;0;0;CLOSET NIZA 6P+2C;DORMITORIO
8748234;;F;64;CHILENO;;Boomers;SAN CARLOS                    ;BIO BIO;0;0;0;0;0;0;0;0;0;CLOSET MARITTIMA 6P+2C;DORMITORIO
8680021;;M;63;CHILENO;;Boomers;CASTRO                        ;LOS LAGOS;0;0;0;0;0;0;0;0;0;CE EVOLUTION BLACK 2P BD+RESP+2 VEL;DORMITORIO
10810195;;M;55;CHILENO;;Boomers;PROVIDENCIA                   ;METROPOLITANA;0;0;0;0;0;0;0;0;0;COLCHON TERAPEUTIC 2P PILLOW TOP;DORMITORIO
19132536;;F;26;CHILENO;;Z;TEMUCO                        ;ARAUCANIA;0;0;0;0;0;0;0;0;0;ALMOHADA VISCO ELASTICA BAMBOO 60X40 CM;DORMITORIO
8381113;;M;63;CHILENO;;Boomers;ARICA                         ;ARICA Y PARINACOTA;0;0;0;0;0;0;0;0;0;CE EVEREST 2P 2MTS BD DUAL SIDE;DORMITORIO
19702767;;F;23;CHILENO;;Millenial;LAMPA                         ;METROPOLITANA;0;0;0;0;0;0;0;0;0;CLOSET M-803 3P 2C ALTO 1,82 BLANCO NATURAL;DORMITORIO
9335953;;M;56;CHILENO;;Boomers;TALCA                         ;MAULE;0;0;0;0;0;0;0;0;0;COLCHON TERAPEUTIC 1,5P PILLOW TOP;DORMITORIO
19058951;Soltero;M;27;CHILENO;INGENIERO EN PREVENCION DE RIESGOS;Silencioso;PROVIDENCIA                   ;METROPOLITANA;0;0;0;0;0;0;0;0;0;CE ORTOPEDIC ADVANCE 2PBN;DORMITORIO
20028718;;M;23;CHILENO;;Z;PROVIDENCIA                   ;METROPOLITANA;0;0;0;0;0;0;0;0;0;CLOSET M-802 4P+2 C ALTO 1,82 BLANCO NATURAL;DORMITORIO
14901695;;F;40;CHILENO;;X;PROVIDENCIA                   ;METROPOLITANA;0;0;0;0;0;0;0;0;0;COLCHON PREMIUM KING X 2 MTS;DORMITORIO
17384375;Soltero;F;32;CHILENO;CONTADOR AUDITOR;Silencioso;PROVIDENCIA                   ;METROPOLITANA;0;0;0;0;0;0;0;0;0;RACK FAVATEX CAHUIL BLANCO;DORMITORIO
18941051;;F;27;CHILENO;;Z;LO ESPEJO                     ;METROPOLITANA;0;0;0;0;0;0;0;0;0;CLOSET MARITTIMA 6P+2C;DORMITORIO
23999943;;F;39;PERUANO;;Extranjero;CONCHALI;METROPOLITANA;0;0;0;0;0;0;0;0;0;CAMAROTE TRIPLE CORINA CAFE OSCURO;DORMITORIO
7915292;;M;64;CHILENO;;Boomers;PROVIDENCIA                   ;METROPOLITANA;0;0;0;0;0;0;0;0;0;CE NEW ORTOPEDIC 2PBD;DORMITORIO
11975501;;M;50;CHILENO;;X;RENCA                         ;METROPOLITANA;0;0;0;0;0;0;0;0;0;CLOSET CAJONERA NEW BELGICA M-398-NW;DORMITORIO
8220564;Casado;F;65;CHILENO;;Boomers;NUNOA                         ;METROPOLITANA;0;0;0;0;0;0;0;0;0;COLCHON BAMBOO 2P FIBRAS BAMBOO;DORMITORIO
14157165;;M;41;CHILENO;;X;PROVIDENCIA                   ;METROPOLITANA;0;0;0;0;0;0;0;0;0;CE EVOLUTION BLACK 1,5P BN RESP+VEL;DORMITORIO
7213714;;F;67;CHILENO;;Boomers;PUNTA ARENAS                  ;MAGALLANES;0;0;0;0;0;0;0;0;0;DIVAN CAMA ERGO T 1,5P 2 MTS;DORMITORIO
23591055;Soltero;M;45;CHILENO;;Silencioso;PROVIDENCIA                   ;METROPOLITANA;0;0;0;0;0;0;0;0;0;COLCHON IBIZA 2P;DORMITORIO
19721298;;F;24;CHILENO;;Z;PROVIDENCIA                   ;METROPOLITANA;0;0;0;0;0;0;0;0;0;BOX AMERICANO EXCELLENCE 1.5 PLAZA + ALM;DORMITORIO
16496756;;F;35;CHILENO;;Millenial;PROVIDENCIA                   ;METROPOLITANA;0;0;0;0;0;0;0;0;0;CLOSET M-803 3P 2C ALTO 1,82 BLANCO NATURAL;DORMITORIO
6439786;;F;72;CHILENO;;Silencioso;LOS ANDES                     ;VALPARAISO;0;0;0;0;0;0;0;0;0;CAMA EUROPEA IBIZA 2 PL BD;DORMITORIO
17498538;;F;31;CHILENO;;Millenial;N/D;N/D;0;0;0;0;0;0;0;0;0;CE EVOLUTION BLACK 1,5P BN RESP+VEL;DORMITORIO
18047070;;M;30;CHILENO;;Millenial;PROVIDENCIA                   ;METROPOLITANA;0;0;0;0;0;0;0;0;0;CLOSET M-803 3P 2C ALTO 1,82 BLANCO NATURAL;DORMITORIO
8990846;Casado;M;65;CHILENO;;Boomers;RENCA                         ;METROPOLITANA;0;0;0;0;0;0;0;0;0;ALMOHADA SOFT MICROGEL;DORMITORIO
10307810;;F;57;CHILENO;;Boomers;PROVIDENCIA                   ;METROPOLITANA;0;0;0;0;0;0;0;0;0;PACK 2 ALMOHADAS C+L;DORMITORIO
17813707;;M;31;CHILENO;;Millenial;PROVIDENCIA                   ;METROPOLITANA;0;0;0;0;0;0;0;0;0;COLCHON ART 4 2P;DORMITORIO
9524203;;F;58;CHILENO;;Boomers;VILLA ALEMANA                 ;VALPARAISO;0;0;0;0;0;0;0;0;0;BA BEAT 2P 2MTS BN;DORMITORIO
17801824;;F;31;CHILENO;;Millenial;PROVIDENCIA                   ;METROPOLITANA;0;0;0;0;0;0;0;0;0;CLOSET M-803 3P 2C ALTO 1,82 BLANCO NATURAL;DORMITORIO
16761585;;F;34;CHILENO;;Millenial;PROVIDENCIA                   ;METROPOLITANA;0;0;0;0;0;0;0;0;0;COLCHON NEW STYLE 6 2P;DORMITORIO
14326993;;M;44;CHILENO;;X;CURICO;MAULE;0;0;0;0;0;0;0;0;0;COLCHON EXCELLENCE 2 PLAZA + 2 ALM;DORMITORIO
15442729;;F;39;CHILENO;;Silencioso;PROVIDENCIA                   ;METROPOLITANA;0;0;0;0;0;0;0;0;0;DIVAN CAMA ERGO T 1,5P 2 MTS;DORMITORIO
13578339;;M;44;CHILENO;;X;CHILLAN                       ;BIO BIO;0;0;0;0;0;0;0;0;0;CE EVEREST KING 2MTS BD HILOS COBRE;DORMITORIO
15942001;Casado;F;37;CHILENO;TECNICO DE NIVEL SUPERIOR EN ENFERMERIA;Millenial;RENCA                         ;METROPOLITANA;0;0;0;0;0;0;0;0;0;RACK BELLINI 50;DORMITORIO
20287003;;M;22;CHILENO;;Z;PROVIDENCIA                   ;METROPOLITANA;0;0;0;0;0;0;0;0;0;CLOSET TV 6P GRECIA;DORMITORIO
12783463;Casado;M;47;CHILENO;;X;RENCA                         ;METROPOLITANA;0;0;0;0;0;0;0;0;0;CLOSET CONCEPCION TV49 M-402 CASTANO / AVELLANA;DORMITORIO
12761462;;M;48;CHILENO;;X;CHONCHI                       ;LOS LAGOS;0;0;0;0;0;0;0;0;0;PACK 2 ALMOHADAS C+L;DORMITORIO
15535764;;M;39;CHILENO;;X;PROVIDENCIA                   ;METROPOLITANA;0;0;0;0;0;0;0;0;0;COLCHON ART 4 2P;DORMITORIO
18210276;;M;30;CHILENO;;Millenial;PROVIDENCIA                   ;METROPOLITANA;0;0;0;0;0;0;0;0;0;CE EVOLUTION BLACK 2P BD DUAL SIDE;DORMITORIO
9578730;;F;62;CHILENO;;Boomers;SAN BERNARDO                  ;METROPOLITANA;0;0;0;0;0;0;0;0;0;ALMOHADA SOFT MICROGEL;DORMITORIO
15039262;;F;40;CHILENO;;X;OVALLE                        ;COQUIMBO;0;0;0;0;0;0;0;0;0;ALMOHADA ROSEN SOFT PLUS KING;DORMITORIO
9079656;;F;64;CHILENO;;Boomers;PENAFLOR                      ;METROPOLITANA;0;0;0;0;0;0;0;0;0;CLOSET NEW SLIM M-900 CASTANO;DORMITORIO
8915661;Casado;M;61;CHILENO;;Boomers;PROVIDENCIA                   ;METROPOLITANA;0;0;0;0;0;0;0;0;0;COLCHON EXCELLENCE 2P;DORMITORIO
9141286;;F;58;CHILENO;;Boomers;PROVIDENCIA                   ;METROPOLITANA;0;0;0;0;0;0;0;0;0;ALMOHADA SOFT MICROGEL;DORMITORIO
18401568;;M;29;CHILENO;;Millenial;PROVIDENCIA                   ;METROPOLITANA;0;0;0;0;0;0;0;0;0;ALMOHADA ROSEN SOFT PLUS AMERICANA;DORMITORIO
8833674;;M;61;CHILENO;;Boomers;TALCA                         ;MAULE;0;0;0;0;0;0;0;0;0;CE EVOLUTION BLACK 2P BD+RESP+2 VEL;DORMITORIO
18411631;;F;28;CHILENO;;Millenial;PROVIDENCIA                   ;METROPOLITANA;0;0;0;0;0;0;0;0;0;ESCRITORIO JACK CAFE;DORMITORIO
14397525;Soltero;F;43;CHILENO;;X;RENCA                         ;METROPOLITANA;0;0;0;0;0;0;0;0;0;COLCHON EXCELLENCE FULL + 2 ALM;DORMITORIO
11349701;;F;54;CHILENO;;X;RENCA                         ;METROPOLITANA;0;0;0;0;0;0;0;0;0;BS NEW ORTOPEDIC B5 BLACK 2PBN;DORMITORIO
9907164;;F;44;CHILENO;;Silencioso;PROVIDENCIA                   ;METROPOLITANA;0;0;0;0;0;0;0;0;0;CLOSET CROACIA BLANCO 4P;DORMITORIO
13886760;;F;42;CHILENO;;X;PROVIDENCIA                   ;METROPOLITANA;0;0;0;0;0;0;0;0;0;CE EVOLUTION BLACK 1P BN DUAL SIDE;DORMITORIO
11555293;Casado;F;52;CHILENO;;X;RENCA                         ;METROPOLITANA;0;0;0;0;0;0;0;0;0;ALMOHADA SOFT MICROGEL;DORMITORIO
8991306;;F;62;CHILENO;;Boomers;RENCA                         ;METROPOLITANA;0;0;0;0;0;0;0;0;0;PACK 2 ALMOHADAS C+L;DORMITORIO
26395542;;F;41;VENEZOLANO;;Extranjero;CONCEPCION                    ;BIO BIO;0;0;0;0;0;0;0;0;0;COLCHON BEAT 2P;DORMITORIO
13200876;;F;45;CHILENO;;X;CHIMBARONGO                   ;L.G.B.OÂ´HIGGINS;0;0;0;0;0;0;0;0;0;ALMOHADA ROSEN SOFT PLUS AMERICANA;DORMITORIO
18398888;;F;29;CHILENO;;Millenial;PROVIDENCIA                   ;METROPOLITANA;0;0;0;0;0;0;0;0;0;CAMA EUROPEA EXCELLENCE 2P BN +RESP+2VEL OLMO;DORMITORIO
15717120;;M;39;CHILENO;;X;PROVIDENCIA                   ;METROPOLITANA;0;0;0;0;0;0;0;0;0;CAMA ART 4 1.80X2.00;DORMITORIO
14049987;;F;41;CHILENO;;X;PROVIDENCIA                   ;METROPOLITANA;0;0;0;0;0;0;0;0;0;PACK ALMOHADA VISCO ELASTICA CANNABIS 60X40CM;DORMITORIO
17427474;;F;32;CHILENO;;Millenial;PAINE                         ;METROPOLITANA;0;0;0;0;0;0;0;0;0;COLCHON ORTOPEDIC ADVANCE 2P;DORMITORIO
15828701;;M;37;CHILENO;;Millenial;PROVIDENCIA                   ;METROPOLITANA;0;0;0;0;0;0;0;0;0;RESPALDO 2 PL + 2 VELADORES FIORENZZA;DORMITORIO
25776737;;M;27;CHILENO;;Extranjero;RANCAGUA                      ;L.G.B.OÂ´HIGGINS;0;0;0;0;0;0;0;0;0;COLCHON NEW ORTOPEDIC 2P;DORMITORIO
8006699;;F;63;CHILENO;;Boomers;HUALQUI                       ;BIO BIO;0;0;0;0;0;0;0;0;0;CE EVOLUTION BLACK 1,5P BN DUAL SIDE;DORMITORIO
18259821;;F;29;CHILENO;;Millenial;N/D;N/D;0;0;0;0;0;0;0;0;0;CE EVEREST 2P 2MTS BD DUAL SIDE;DORMITORIO
18780956;;F;27;CHILENO;;Millenial;MAULE                         ;MAULE;0;0;0;0;0;0;0;0;0;COLCHON EXCELLENCE 1P;DORMITORIO
19076229;;F;26;CHILENO;;Z;TEMUCO                        ;ARAUCANIA;0;0;0;0;0;0;0;0;0;CLOSET ESPANA 6P+4C;DORMITORIO
14280218;;F;49;CHILENO;;X;CONCEPCION                    ;BIO BIO;0;0;0;0;0;0;0;0;0;COLCHON EXCELLENCE PLUS 1P;DORMITORIO
15938475;;M;37;CHILENO;;Millenial;PROVIDENCIA                   ;METROPOLITANA;0;0;0;0;0;0;0;0;0;CE NEW STYLE 2 2P 2MT BD;DORMITORIO
13528677;;M;42;CHILENO;;X;PROVIDENCIA                   ;METROPOLITANA;0;0;0;0;0;0;0;0;0;COLCHON ERGO T 1P;DORMITORIO
10772797;Casado;F;57;CHILENO;;Boomers;RENCA                         ;METROPOLITANA;0;0;0;0;0;0;0;0;0;COLCHON EXCELLENCE 2P;DORMITORIO
8888599;;F;61;CHILENO;;Boomers;PUENTE ALTO                   ;METROPOLITANA;0;0;0;0;0;0;0;0;0;CLOSET NIZA 6P+2C;DORMITORIO
15250727;;M;38;CHILENO;;X;PROVIDENCIA                   ;METROPOLITANA;0;0;0;0;0;0;0;0;0;CAMAROTE DESMONTABLE ISIDORA;DORMITORIO
10340621;;F;51;CHILENO;;X;NUNOA                         ;METROPOLITANA;0;0;0;0;0;0;0;0;0;BOX AMERICANO EXCELLENCE 1.5 PLAZAS;DORMITORIO
17953536;;F;30;CHILENO;;Millenial;LA PINTANA                    ;METROPOLITANA;0;0;0;0;0;0;0;0;0;SET 2 ALMOHADAS VISCO MEDIUM 60X40 CM;DORMITORIO
14552465;;F;44;CHILENO;;X;N/D;N/D;0;0;0;0;0;0;0;0;0;CE NEW STYLE 2 2P 2MT BD;DORMITORIO
16661796;;M;34;CHILENO;;Millenial;RENCA                         ;METROPOLITANA;0;0;0;0;0;0;0;0;0;BOXET ERGO T 2P;DORMITORIO
15247898;;F;38;CHILENO;;Millenial;MELIPEUCO                     ;ARAUCANIA;0;0;0;0;0;0;0;0;0;CE ERGO T KING 2MT BD;DORMITORIO
9099255;Casado;F;60;CHILENO;;Boomers;RENCA                         ;METROPOLITANA;0;0;0;0;0;0;0;0;0;COLCHON THERAPEDIC 2P;DORMITORIO
19370539;;M;26;CHILENO;;Z;"";"";0;0;0;0;0;0;0;0;0;CE EVOLUTION BLACK 2P BD DUAL SIDE;DORMITORIO
19490572;;F;25;CHILENO;;Z;PROVIDENCIA                   ;METROPOLITANA;0;0;0;0;0;0;0;0;0;BOX AMERICANO EXCELLENCE 1.5 PLAZAS;DORMITORIO
13590305;;F;44;CHILENO;;X;OSORNO                        ;LOS LAGOS;0;0;0;0;0;0;0;0;0;COLCHON BAMBOO 2P FIBRAS BAMBOO;DORMITORIO
12682633;;M;48;CHILENO;;X;N/D;N/D;0;0;0;0;0;0;0;0;0;CLOSET CAJONERA BELGICA;DORMITORIO
17723476;;F;31;CHILENO;;Millenial;PROVIDENCIA                   ;METROPOLITANA;0;0;0;0;0;0;0;0;0;COLCHON NEW ORTOPEDIC 1.50 x 2 M;DORMITORIO
17372309;Soltero;F;32;CHILENO;;Millenial;PROVIDENCIA                   ;METROPOLITANA;0;0;0;0;0;0;0;0;0;BOX AMERICANO EXCELLENCE 1.5 PLAZAS;DORMITORIO
16056063;;M;37;CHILENO;;Millenial;PROVIDENCIA                   ;METROPOLITANA;0;0;0;0;0;0;0;0;0;CAMA ERGO T 2PBD + RESP + 2 VEL FERRARA;DORMITORIO
10045614;;M;58;CHILENO;;Boomers;RENCA                         ;METROPOLITANA;0;0;0;0;0;0;0;0;0;COLCHON BEAT 1P;DORMITORIO
13823624;;F;42;CHILENO;;X;CALBUCO                       ;LOS LAGOS;0;0;0;0;0;0;0;0;0;DIVAN CAMA ERGO T 1,5P 2 MTS;DORMITORIO
13362261;;F;44;CHILENO;;X;SANTA MARIA                   ;VALPARAISO;0;0;0;0;0;0;0;0;0;SET 2 ALMOHADAS VISCO MEDIUM 60X40 CM;DORMITORIO
25629457;;M;41;VENEZOLANO;;Extranjero;N/D;N/D;0;0;0;0;0;0;0;0;0;COLCHON THERAPEDIC 2P;DORMITORIO
18624589;Soltero;F;28;CHILENO;TECNICO DE NIVEL SUPERIOR EN ENFERMERIA;Millenial;PROVIDENCIA                   ;METROPOLITANA;0;0;0;0;0;0;0;0;0;CE EVOLUTION BLACK 1,5P + RESPALDO CASTILLA;DORMITORIO
18647319;;M;28;CHILENO;;Millenial;MOSTAZAL                      ;L.G.B.OÂ´HIGGINS;0;0;0;0;0;0;0;0;0;COLCHON NEW STYLE 4 2P;DORMITORIO
13237712;;F;45;CHILENO;;X;PICHIDEGUA                    ;L.G.B.OÂ´HIGGINS;0;0;0;0;0;0;0;0;0;PACK 2 ALMOHADAS C+L;DORMITORIO
12516248;;M;49;CHILENO;;X;"";"";0;0;0;0;0;0;0;0;0;COLCHON ADAPTA 6 1,5P;DORMITORIO
12237424;Soltero;F;49;CHILENO;;X;RENCA                         ;METROPOLITANA;0;0;0;0;0;0;0;0;0;RACK GANGES;DORMITORIO
18569044;;F;29;CHILENO;;Millenial;PROVIDENCIA                   ;METROPOLITANA;0;0;0;0;0;0;0;0;0;ALMOHADA ROSEN SOFT PLUS AMERICANA;DORMITORIO
16072866;;F;36;CHILENO;;Millenial;MAIPU                         ;METROPOLITANA;0;0;0;0;0;0;0;0;0;CAMA ART 4 1.80X2.00;DORMITORIO
19418944;;M;25;CHILENO;;Millenial;N/D;N/D;0;0;0;0;0;0;0;0;0;COLCHON NEW ORTOPEDIC 2P 150X190 + CUBREC;DORMITORIO
12520457;;F;49;CHILENO;;X;RENCA                         ;METROPOLITANA;0;0;0;0;0;0;0;0;0;NEW Closet 4 PTAS. LUCERNA BLANCO;DORMITORIO
7376249;Casado;M;66;CHILENO;INGENIERO;Boomers;CONCON                        ;VALPARAISO;0;0;0;0;0;0;0;0;0;BOX AMERICANO BEAT 1,5P;DORMITORIO
18959976;;F;27;CHILENO;;Millenial;TALAGANTE                     ;METROPOLITANA;0;0;0;0;0;0;0;0;0;COLCHON NEW ORTOPEDIC 2P;DORMITORIO
13154626;Casado;F;45;CHILENO;;X;NUEVA IMPERIAL                ;ARAUCANIA;0;0;0;0;0;0;0;0;0;COLCHON NEW STYLE 4 2P;DORMITORIO
19918987;;F;23;CHILENO;;Z;PROVIDENCIA                   ;METROPOLITANA;0;0;0;0;0;0;0;0;0;Cama Europea Cannabis 1.5 plazas + Sabanas Imper;DORMITORIO
7700326;;F;67;CHILENO;;Boomers;VALLENAR;ATACAMA;0;0;0;0;0;0;0;0;0;PACK 2 ALMOHADAS C+L;DORMITORIO
19399319;;M;26;CHILENO;;Z;CASTRO                        ;LOS LAGOS;0;0;0;0;0;0;0;0;0;PACK 2 ALMOHADAS C+L;DORMITORIO
18117134;Soltero;M;30;CHILENO;;Millenial;PROVIDENCIA                   ;METROPOLITANA;0;0;0;0;0;0;0;0;0;COLCHON TERAPEUTIC 1P PILLOW TOP;DORMITORIO
12264403;;F;50;CHILENO;;X;PROVIDENCIA                   ;METROPOLITANA;0;0;0;0;0;0;0;0;0;COLCHON EXCELLENCE PLUS 1.5P 2M +CUBRECOLCHON;DORMITORIO
15466264;;M;40;CHILENO;;X;PROVIDENCIA                   ;METROPOLITANA;0;0;0;0;0;0;0;0;0;COLCHON EVOLUTION BLACK 1P DUAL SIDE;DORMITORIO
4985074;;F;78;CHILENO;;Silencioso;PROVIDENCIA                   ;METROPOLITANA;0;0;0;0;0;0;0;0;0;COLCHON EXCELLENCE PLUS 1,5P;DORMITORIO
17076840;;F;33;CHILENO;;Millenial;PROVIDENCIA                   ;METROPOLITANA;0;0;0;0;0;0;0;0;0;CE EVOLUTION BLACK 1,5P + RESPALDO CASTILLA;DORMITORIO
17966391;;F;31;CHILENO;;Millenial;CURACAVI                      ;METROPOLITANA;0;0;0;0;0;0;0;0;0;BOX AMERICANO MIRAGE 2PBN;DORMITORIO
7885464;;M;66;CHILENO;;Boomers;CASABLANCA                    ;VALPARAISO;0;0;0;0;0;0;0;0;0;Closet Austria 2013 6P2C 204x165x0,47;DORMITORIO
16313429;Soltero;F;36;CHILENO;;Millenial;PROVIDENCIA                   ;METROPOLITANA;0;0;0;0;0;0;0;0;0;BOX AM NEW ENTREE 1,5P+ Resp + 1 Vel ASTURIAS +;DORMITORIO
9110490;;M;56;CHILENO;;Boomers;CALAMA                        ;ANTOFAGASTA;0;0;0;0;0;0;0;0;0;COLCHON NEW ENTREE 1P;DORMITORIO
15275849;;F;39;CHILENO;;X;N/D;N/D;0;0;0;0;0;0;0;0;0;CLOSET MARITTIMA 6P+2C;DORMITORIO
15550364;;F;37;CHILENO;;Millenial;TEMUCO                        ;ARAUCANIA;0;0;0;0;0;0;0;0;0;DUPLEX BOX AMERICANO EXCELLENCE 1 PLAZA;DORMITORIO
15120110;;F;38;CHILENO;;Millenial;SAN FERNANDO                  ;L.G.B.OÂ´HIGGINS;0;0;0;0;0;0;0;0;0;COLCHON NEW ORTOPEDIC 1,5P;DORMITORIO
12752543;;F;47;CHILENO;;X;RENCA                         ;METROPOLITANA;0;0;0;0;0;0;0;0;0;BA BEAT 2P 2MTS BN;DORMITORIO
17143607;Soltero;F;33;CHILENO;TECNICO DE NIVEL SUPERIOR PARAMEDICO EN ODONTOLOGIA;Millenial;PROVIDENCIA                   ;METROPOLITANA;0;0;0;0;0;0;0;0;0;CAMAROTE TRIPLE CORINA CAFE OSCURO;DORMITORIO
8976953;;M;62;CHILENO;;Boomers;MARIA PINTO                   ;METROPOLITANA;0;0;0;0;0;0;0;0;0;COLCHON BAMBOO 2P FIBRAS BAMBOO;DORMITORIO
6576447;;M;68;CHILENO;;Silencioso;PROVIDENCIA                   ;METROPOLITANA;0;0;0;0;0;0;0;0;0;CAMA EUROPEA BAMBOO 1,5P;DORMITORIO
18475411;Soltero;F;29;CHILENO;NUTRICIONISTA;Millenial;PENCAHUE                      ;MAULE;0;0;0;0;0;0;0;0;0;COLCHON NEW STYLE 4 2P;DORMITORIO
18011953;Soltero;F;30;CHILENO;PSICOLOGA;Millenial;PROVIDENCIA                   ;METROPOLITANA;0;0;0;0;0;0;0;0;0;COLCHON THERAPEDIC MAS 2P;DORMITORIO
20193094;;F;24;CHILENO;;Z;PROVIDENCIA                   ;METROPOLITANA;0;0;0;0;0;0;0;0;0;CLOSET M-801 6P+2C ALTO 1,82 BLANCO NATURAL;DORMITORIO
13547166;;M;43;CHILENO;;X;SAN ANTONIO                   ;VALPARAISO;0;0;0;0;0;0;0;0;0;COLCHON ERGO T 1,5P;DORMITORIO
18978842;;F;27;CHILENO;;Z;TOME                          ;BIO BIO;0;0;0;0;0;0;0;0;0;CE EVOLUTION BLACK 2P BD DUAL SIDE;DORMITORIO
18808991;;F;28;CHILENO;;Millenial;"";"";0;0;0;0;0;0;0;0;0;CE EVOLUTION BLACK 1P + RESPALDO CASTILLA;DORMITORIO
13524791;;M;44;CHILENO;;X;PROVIDENCIA                   ;METROPOLITANA;0;0;0;0;0;0;0;0;0;RACK CLASICO NOGAL AMAZONICO;DORMITORIO
10817825;;M;54;CHILENO;;X;TALCAHUANO                    ;BIO BIO;0;0;0;0;0;0;0;0;0;Colchon Cannabis Pillow Top 1P + Almohada Cannab;DORMITORIO
6644896;;F;73;CHILENO;;Silencioso;NUEVA IMPERIAL                ;ARAUCANIA;0;0;0;0;0;0;0;0;0;CE NEW ORTOPEDIC 2PBD;DORMITORIO
16837778;Soltero;M;34;CHILENO;;Millenial;PROVIDENCIA                   ;METROPOLITANA;0;0;0;0;0;0;0;0;0;CLOSET TOKIO M-460 AVELLANA / CASTANO 6P1C1Z;DORMITORIO
9916131;;M;58;CHILENO;;Boomers;PENAFLOR                      ;METROPOLITANA;0;0;0;0;0;0;0;0;0;CE BAMBOO 2PBD BAMBOO+RES+2V ALICANTE;DORMITORIO
19408857;;F;26;CHILENO;;Z;PENALOLEN                     ;METROPOLITANA;0;0;0;0;0;0;0;0;0;COLCHON EVOLUTION BLACK 1P DUAL SIDE;DORMITORIO
12896730;;M;47;CHILENO;;X;PROVIDENCIA                   ;METROPOLITANA;0;0;0;0;0;0;0;0;0;CE EVOLUTION BLACK 1,5P + RESPALDO CASTILLA;DORMITORIO
7929264;;M;65;CHILENO;;Boomers;N/D;N/D;0;0;0;0;0;0;0;0;0;DIVAN NEW ORTOPEDIC BLACK ALM+PL;DORMITORIO
16667277;;M;34;CHILENO;;Millenial;QUILICURA                     ;METROPOLITANA;0;0;0;0;0;0;0;0;0;CE EVOLUTION BLACK 2P BD+RESP+2 VEL;DORMITORIO
18234242;;M;29;CHILENO;;Millenial;PROVIDENCIA                   ;METROPOLITANA;0;0;0;0;0;0;0;0;0;CE ERGO T 2P 2MT BD;DORMITORIO
9118882;;F;61;CHILENO;;Boomers;N/D;N/D;260980;2;1;2;1;260980;0;0;0;TAB S6 Lite (610) 4GB 64GB 10.4P DARK GREY;COMPUTACION
11521727;Casado;M;52;CHILENO;;X;RENCA                         ;METROPOLITANA;79990;1;1;0;0;0;1;1;79990;PROYECTOR Powerlite S41;COMPUTACION
16018131;;F;37;CHILENO;;Millenial;TALAGANTE;METROPOLITANA;129990;1;1;1;1;129990;0;0;0;Multifuncional DCPT220;COMPUTACION
14338969;;M;45;CHILENO;;X;SAN BERNARDO;METROPOLITANA;631489;10;4;10;4;631489;0;0;0;NTBK BR11 Celeron N4500/4GB/64GB eMMC/11P;COMPUTACION
16830059;;M;33;CHILENO;;Millenial;PANGUIPULLI                   ;LOS LAGOS;1026881;13;9;0;0;0;13;9;1026881;TAB MLAB 7 MB4 PLUS 3G 1+16GB WHITE 8762;COMPUTACION
18585661;;F;28;CHILENO;;Millenial;N/D;N/D;396930;7;4;6;3;369940;1;1;26990;NTBK BR11 Celeron N4500/4GB/64GB eMMC/11P;COMPUTACION
15344022;;M;40;CHILENO;;X;PROVIDENCIA                   ;METROPOLITANA;415960;4;2;4;2;415960;0;0;0;TAB S6 Lite (610) 4GB 64GB 10.4P PINK;COMPUTACION
12735312;;M;47;CHILENO;;X;RENCA                         ;METROPOLITANA;169990;1;1;0;0;0;1;1;169990;NTBK 240 G8 Celeron N4020/4GB/500GB/14P;COMPUTACION
17780244;;F;31;CHILENO;;Millenial;"";"";119980;2;2;2;1;79980;0;1;40000;Tab M7 1G-8GB 7 IPS HD WiFi onix black;COMPUTACION
16314355;;F;36;CHILENO;;Millenial;PADRE LAS CASAS               ;ARAUCANIA;314980;2;2;1;1;249990;1;1;64990;TAB S6 Lite (610) 4GB 64GB 10.4P PINK;COMPUTACION
13169831;;F;45;CHILENO;;X;CASTRO                        ;LOS LAGOS;922360;7;2;0;0;0;7;2;922360;Multifuncional EcoTank L3250 Wifi;COMPUTACION
18118344;;M;30;CHILENO;;Millenial;N/D;N/D;1242920;8;4;8;4;1242920;0;0;0;Monitor 27GL650F-B.AWH 27P 144Hz Full HD IPS;COMPUTACION
19049200;;F;26;CHILENO;;Z;QUILLOTA;VALPARAISO;390080;2;1;0;0;0;2;1;390080;NTBK IP3 Ryzen 3-5300U/8GB/256GB SSD/14P FHD;COMPUTACION
8925279;;F;62;CHILENO;;Boomers;SAN CARLOS                    ;BIO BIO;939928;7;4;0;0;0;7;4;939928;TAB S6 Lite (610) 4GB 64GB 10.4P PINK;COMPUTACION
12889090;Viudo;F;47;CHILENO;;X;PROVIDENCIA                   ;METROPOLITANA;543980;2;1;2;1;543980;0;0;0;NTBK GalaxyBook2 Ci5-1235U/8GB/512GB SSD/15P FHD;COMPUTACION
19779123;;M;23;CHILENO;;Z;PROVIDENCIA                   ;METROPOLITANA;295980;2;1;2;1;295980;0;0;0;Galaxy Tab S6 Lite + Book Cover (10.4,128GB,Blue;COMPUTACION
20537179;;M;21;CHILENO;;Z;NUNOA                         ;METROPOLITANA;323980;2;1;2;1;323980;0;0;0;NTBK IP3 Ryzen 3-5300U/8GB/256GB SSD/14P FHD;COMPUTACION
26937486;Soltero;M;35;EXTRANJERO - NO INFORMA NACIONALIDAD;;Extranjero;ESTACION CENTRAL;METROPOLITANA;383960;3;1;3;1;383960;0;0;0;Multifuncional DCPT720DW Wifi, Duplex y ADF;COMPUTACION
6900582;;M;68;CHILENO;;Boomers;ISLA DE MAIPO                 ;METROPOLITANA;783630;6;5;0;0;0;6;5;783630;TAB Galaxy A7 Lite (8.7, 32GB, WIFI + 4G);COMPUTACION
15045474;;F;40;CHILENO;;X;RENCA                         ;METROPOLITANA;250480;2;1;0;0;0;2;1;250480;TAB S6 Lite (610) 4GB 64GB 10.4P BLUE;COMPUTACION
19776519;;M;23;CHILENO;;Z;PROVIDENCIA                   ;METROPOLITANA;25480;2;1;0;0;0;2;1;25480;TINTA 664 NEGRA;COMPUTACION
16897206;;M;34;CHILENO;;Millenial;N/D;N/D;127928;8;3;0;0;0;8;3;127928;Multifuncional XP-2101 wifi;COMPUTACION
16527800;;F;34;CHILENO;;Millenial;N/D;N/D;224980;2;2;0;0;0;2;2;224980;Multifuncional DCPT720DW Wifi, Duplex y ADF;COMPUTACION
13975834;;F;41;CHILENO;;X;OVALLE                        ;COQUIMBO;26493;1;1;0;0;0;1;1;26493;TAB 7 PLAY AND LEARN PLUS BLUE 8868;COMPUTACION
10390290;Casado;M;55;CHILENO;;Boomers;REQUINOA                      ;L.G.B.OÂ´HIGGINS;1265590;11;6;0;0;0;11;6;1265590;Multifuncional EcoTank L3250 Wifi;COMPUTACION
26737069;;M;43;VENEZOLANO;;Extranjero;TALCA                         ;MAULE;2262090;11;2;0;0;0;11;2;2262090;NTBK M3500 Ryzen 5 -5600H/8GB/512GB SSD/15P FHD;COMPUTACION
17414643;;F;32;CHILENO;;Millenial;PUERTO MONTT;LOS LAGOS;129990;1;1;1;1;129990;0;0;0;NTBK D330 Celeron N4020/4GB/64GB/10P+OfficeHS;COMPUTACION
14927014;;M;49;CHILENO;;X;COIHUECO                      ;BIO BIO;934290;9;7;0;0;0;9;7;934290;TAB 7 PLAY AND LEARN PLUS PURPLE 8867;COMPUTACION
9592823;;M;60;CHILENO;;Boomers;VILLARICA                     ;ARAUCANIA;119990;1;1;0;0;0;1;1;119990;TAB Galaxy A7 Lite (8.7, 32GB, WIFI);COMPUTACION
15300785;;M;45;CHILENO;;X;PROVIDENCIA                   ;METROPOLITANA;288980;2;1;2;1;288980;0;0;0;NTBK 240 G8 Core i3-1005G1/8GB/256GB SSD/14P;COMPUTACION
5625520;;M;73;CHILENO;;Silencioso;RIO HURTADO                   ;COQUIMBO;252530;3;2;2;1;137540;1;1;114990;Multifuncional DCPT220;COMPUTACION
16725279;Soltero;M;34;CHILENO;DISENADOR GRAFICO;Millenial;PROVIDENCIA                   ;METROPOLITANA;49990;1;1;1;1;49990;0;0;0;Impresora Laser HL-1202 Monocromatica;COMPUTACION
17785012;;M;30;CHILENO;;Millenial;SAN MIGUEL;METROPOLITANA;203980;2;1;2;1;203980;0;0;0;NTBK Inspiron 3501 Ci3-1115G4/4GB/1TB/14P;COMPUTACION
13526798;;F;43;CHILENO;;X;N/D;N/D;1486920;8;4;8;4;1486920;0;0;0;NTBK GAMER GF66 Ci5-11400H/8GB/512GB/GTX1650 4GB;COMPUTACION
16276113;;F;36;CHILENO;;Millenial;LO ESPEJO                     ;METROPOLITANA;430220;4;2;0;0;0;4;2;430220;TAB Galaxy A7 Lite (8.7, 32GB, WIFI);COMPUTACION
17967688;;F;30;CHILENO;;Millenial;PELLUHUE                      ;MAULE;524360;14;9;12;8;347380;2;1;176980;NTBK Inspiron 3502 Celeron/4GB/128GB SSD/+O365;COMPUTACION
17301138;;M;32;CHILENO;;Millenial;RINCONADA                     ;VALPARAISO;0;0;4;0;2;0;0;2;0;TAB 7 MB4 Plus 4Core 1GB 16GB 7 Plata;COMPUTACION
17401903;;M;32;CHILENO;;Millenial;N/D;N/D;283980;2;1;2;1;283980;0;0;0;TAB P11 6G-128GB Case + KB + Pen + Wifi +Â  Slate;COMPUTACION
26645734;;F;24;VENEZOLANO;;Extranjero;MACUL;METROPOLITANA;433970;3;2;2;1;233980;1;1;199990;NTBK ASUS Ci3/4GB/128GB Win+Tec Ingles+S/adap;COMPUTACION
12863052;;M;46;CHILENO;;X;"";"";156980;2;1;2;1;156980;0;0;0;NTBK Inspiron 3502 Celeron/4GB/128GB SSD/+O365;COMPUTACION
15254808;;F;39;CHILENO;;X;N/D;N/D;8990;1;1;0;0;0;1;1;8990;TINTA EPSON T504 CYAN BOTELLA C13T03N22A;COMPUTACION
17916113;;M;31;CHILENO;;Millenial;N/D;N/D;159990;1;1;0;0;0;1;1;159990;Multifuncional EcoTank L3210;COMPUTACION
15777933;;M;35;CHILENO;;Millenial;SAN CARLOS                    ;BIO BIO;1512720;14;8;13;7;1382730;1;1;129990;Tab M10 Plus FHD 4GB 64GB 10.3P platinum grey;COMPUTACION
11386923;;F;53;CHILENO;;X;EL BOSQUE                     ;METROPOLITANA;339670;5;2;0;0;0;5;2;339670;Tablet Matepad 10.4;COMPUTACION
12916971;;M;47;CHILENO;;X;N/D;N/D;305990;1;1;0;0;0;1;1;305990;NTBK Aspire 5 R3/4GB/128SSD/15P FHD W+T Ingles;COMPUTACION
17520100;;F;31;CHILENO;;Millenial;MACHALI;O HIGGINS;1145550;11;6;1;1;39990;10;5;1105560;TAB MLAB 7 MB4 PLUS 3G 1+16GB WHITE 8762;COMPUTACION
13958072;;F;42;CHILENO;;X;CORONEL;BIO-BIO;209990;1;1;0;0;0;1;1;209990;Galaxy Tab A8 (10.5, 64GB, WIFI) Silver;COMPUTACION
10838149;;F;47;CHILENO;;X;RENCA                         ;METROPOLITANA;449990;1;1;0;0;0;1;1;449990;NTBK Yoga Slim7 Ryzen 5-4500U/8GB/256GB/14P FHD;COMPUTACION
18534204;Soltero;M;28;CHILENO;ENFERMERO;Millenial;PROVIDENCIA                   ;METROPOLITANA;626230;3;2;0;0;0;3;2;626230;Galaxy Tab A8 (10.5, 32GB, LTE) Gray;COMPUTACION
7031981;;F;70;CHILENO;;Silencioso;QUINTERO                      ;VALPARAISO;1164770;13;2;0;0;0;13;2;1164770;NTBK IP3 Core i3-1115G4/4GB/512GB SSD/14P FHD;COMPUTACION
19586684;;F;24;CHILENO;;Z;PROVIDENCIA                   ;N/D;365340;2;1;0;0;0;2;1;365340;NTBK IP3 Ryzen 3-5300U/8GB/256GB SSD/14P FHD;COMPUTACION
7631448;;M;65;CHILENO;;Boomers;PARRAL                        ;MAULE;349990;1;1;0;0;0;1;1;349990;NTBK IP3 Ryzen 3-5300U/8GB/256GB SSD/14P FHD;COMPUTACION
15711603;;F;38;CHILENO;;X;PUERTO MONTT                  ;LOS LAGOS;192980;2;1;0;0;0;2;1;192980;NTBK 240 G8 Celeron N4020/4GB/500GB/14P;COMPUTACION
16786827;;M;34;CHILENO;;Millenial;PROVIDENCIA                   ;METROPOLITANA;253980;2;1;2;1;253980;0;0;0;TAB S6 Lite (610) 4GB 64GB 10.4P DARK GREY;COMPUTACION
13835776;;M;42;CHILENO;;X;CONCON                        ;VALPARAISO;89990;1;1;1;1;89990;0;0;0;Multifuncional Laser DCP-1602 Monocromatica;COMPUTACION
6653444;;M;64;CHILENO;;Boomers;COIHAIQUE                     ;AYSEN;606090;5;3;0;0;0;5;3;606090;Multifuncional Smart Tank 515 Wifi;COMPUTACION
6584725;;M;69;CHILENO;;Silencioso;RENCA                         ;METROPOLITANA;159990;1;1;0;0;0;1;1;159990;Multifuncional EcoTank L3210;COMPUTACION
19263956;;F;25;CHILENO;;Z;PROVIDENCIA                   ;METROPOLITANA;39990;1;1;1;1;39990;0;0;0;TAB 7 PLAY AND LEARN PLUS PURPLE 8867;COMPUTACION
12138488;;F;56;CHILENO;;Boomers;SAN RAMON                     ;METROPOLITANA;693400;10;3;0;0;0;10;3;693400;NTBK 15-dw1080la Celeron N4020/4GB/1TB/15P;COMPUTACION
18810673;;F;27;CHILENO;;Millenial;CHIGUAYANTE;BIO-BIO;49990;1;1;1;1;49990;0;0;0;Impresora Monocromatica Xerox B210-NDI;COMPUTACION
7118607;;F;64;CHILENO;;Boomers;PIRQUE                        ;METROPOLITANA;820370;2;1;0;0;0;2;1;820370;NTBK FX506 Ci5-10300H/8GB/512GB SSD/GTX1650 4GB;COMPUTACION
27199361;;M;28;NO INFORMA NACIONALIDAD;;Extranjero;"";"";349990;1;1;0;0;0;1;1;349990;NTBK IP3 Ryzen 3-5300U/8GB/256GB SSD/14P FHD;COMPUTACION
18830518;;F;28;CHILENO;;Millenial;PEUMO                         ;L.G.B.OÂ´HIGGINS;156980;2;1;2;1;156980;0;0;0;NTBK Inspiron 3502 Celeron/4GB/128GB SSD/+O365;COMPUTACION
17769475;;F;31;CHILENO;;Millenial;"";"";318960;4;2;4;2;318960;0;0;0;NTBK Inspiron 3501 Ci3-1115G4/4GB/1TB/14P;COMPUTACION
9815859;;M;59;CHILENO;;Boomers;RENCA                         ;METROPOLITANA;369990;1;1;0;0;0;1;1;369990;NTBK IP3 Ryzen 3-5300U/8GB/256GB SSD/14P FHD;COMPUTACION
11611549;;F;52;CHILENO;;X;ALTO HOSPICIO;TARAPACA;379980;3;2;0;0;0;3;2;379980;NTBK 15-ef1015la Ryzen 3-4300U/4GB/256GBSSD/15P;COMPUTACION
12325276;;F;48;CHILENO;;X;ANTUCO                        ;BIO BIO;419980;2;1;0;0;0;2;1;419980;NTBK 15-ef1015la Ryzen 3-4300U/4GB/256GBSSD/15P;COMPUTACION
15583729;;M;39;CHILENO;;X;COIHAIQUE                     ;AYSEN;268540;4;1;0;0;0;4;1;268540;Monitor Gamer Redragon Jade 27P 165Hz Full HD;COMPUTACION
8160304;;M;61;CHILENO;;Boomers;PAINE                         ;METROPOLITANA;272970;3;2;0;0;0;3;2;272970;Monitor Y25-25 (D19245FY0) 24.5inch-HDMI;COMPUTACION
10889392;;F;52;CHILENO;;X;SANTA CRUZ                    ;L.G.B.OÂ´HIGGINS;651959;5;2;0;0;0;5;2;651959;NBTK IP3 Core i5-10210U/8GB/512GB SSD/15P;COMPUTACION
10984037;;M;52;CHILENO;;X;CALAMA                        ;ANTOFAGASTA;38980;2;1;2;1;38980;0;0;0;TAB 7 MB4 Plus 4Core 1GB 16GB 7 Negra;COMPUTACION
15569121;;M;39;CHILENO;;X;VALPARAISO;VALPARAISO;304150;6;2;0;0;0;6;2;304150;TAB Galaxy A7 Lite (8.7, 32GB, WIFI + 4G);COMPUTACION
13933604;;M;41;CHILENO;;X;QUILICURA                     ;METROPOLITANA;416330;6;5;1;3;99990;5;2;316340;NTBK 2en1 Hi10x Celeron N4100/6GB/128SSD/10P FHD;COMPUTACION
16829292;;F;34;CHILENO;;Millenial;PANGUIPULLI                   ;LOS RIOS;649980;2;2;0;0;0;2;2;649980;NTBK 15-ef1015la Ryzen 3-4300U/4GB/256GBSSD/15P;COMPUTACION
11853467;Divorciado;F;50;CHILENO;INGENIERO CIVIL INDUSTRIAL;X;RENCA                         ;METROPOLITANA;193980;2;1;2;1;193980;0;0;0;NTBK IP3i Celeron N4020/4G/500GB/14P/Rojo;COMPUTACION
7010195;;F;69;CHILENO;;Silencioso;PUCON                         ;ARAUCANIA;319990;1;1;0;0;0;1;1;319990;NTBK 15-ef1015la Ryzen 3-4300U/4GB/256GBSSD/15P;COMPUTACION
7482861;;F;67;CHILENO;;Boomers;PARRAL                        ;MAULE;454980;2;1;0;0;0;2;1;454980;NTBK Aspire 5 Ci3-10110U/12GB/512GB SSD/15P FHD;COMPUTACION
6075657;;M;71;CHILENO;;Silencioso;PROVIDENCIA                   ;METROPOLITANA;32960;4;1;0;0;0;4;1;32960;TINTA EPSON T504 NG BOTELLA C13T03N12A;COMPUTACION
14253211;;M;48;CHILENO;;X;SAN FELIPE                    ;VALPARAISO;324970;3;2;3;2;324970;0;0;0;Tab M10 Plus FHD 4GB 64GB 10.3P platinum grey;COMPUTACION
19821480;;F;24;CHILENO;;Z;QUIRIHUE;BIO-BIO;138960;4;2;4;2;138960;0;0;0;Multifuncional DeskJet Ink Advantage 2775 Wifi;COMPUTACION
14411319;;M;46;CHILENO;;X;RENCA                         ;METROPOLITANA;369980;2;2;0;0;0;2;2;369980;Galaxy Tab A8 (10.5, 32GB, LTE) Gray;COMPUTACION
17748339;;M;31;CHILENO;;Millenial;CHILLAN                       ;BIO BIO;0;0;2;1;1;30990;-1;1;-30990;TAB 7 MB4 Plus 4Core 1GB 16GB 7 Plata;COMPUTACION
13466339;;M;45;CHILENO;;X;"";"";739980;2;1;2;1;739980;0;0;0;NTBK IP3 Ryzen 3-5300U/8GB/256GB SSD/14P FHD;COMPUTACION
13071560;Soltero;F;46;CHILENO;PROFESOR;X;EL BOSQUE                     ;METROPOLITANA;140000;2;1;0;0;0;2;1;140000;Tab M10 Plus FHD 4GB 64GB 10.3P platinum grey;COMPUTACION
18232013;Soltero;F;30;CHILENO;;Millenial;N/D;N/D;174960;4;3;4;3;174960;0;0;0;TAB MLAB MBX 8 QUAD CORE 1G+16G 8716;COMPUTACION
14261081;;F;48;CHILENO;;X;SAN FERNANDO                  ;L.G.B.OÂ´HIGGINS;139990;1;1;1;1;139990;0;0;0;Multifuncional EcoTank L3210;COMPUTACION
10070942;;F;56;CHILENO;;Boomers;VALPARAISO                    ;VALPARAISO;264980;2;1;2;1;264980;0;0;0;NTBK 15-ef1015la Ryzen 3-4300U/4GB/256GBSSD/15P;COMPUTACION
19417399;;M;25;CHILENO;;Z;PROVIDENCIA                   ;METROPOLITANA;31960;4;1;4;1;31960;0;0;0;TINTA BOTELLA EPSON T664120 NEGRA SERIE L;COMPUTACION
19381404;Soltero;F;26;CHILENO;;Z;PROVIDENCIA                   ;METROPOLITANA;349990;1;1;0;0;0;1;1;349990;NTBK IP3 Ryzen 3-5300U/8GB/256GB SSD/14P FHD;COMPUTACION
12283473;;M;50;CHILENO;;X;COIHAIQUE                     ;AYSEN;612960;4;5;0;0;0;4;5;612960;Tab Yoga Smart;COMPUTACION
9978908;;M;53;CHILENO;;X;PROVIDENCIA                   ;METROPOLITANA;483980;2;1;2;1;483980;0;0;0;NTBK M14 Core i5-1155G7/8GB/256GB SSD/14P FHD;COMPUTACION
16151711;;M;37;CHILENO;;Millenial;AISEN                         ;AYSEN;561960;4;4;0;0;0;4;4;561960;Galaxy Tab A8 (10.5, 32GB, WIFI) Silver;COMPUTACION
19832085;;F;24;CHILENO;;Silencioso;PROVIDENCIA                   ;METROPOLITANA;353980;2;1;2;1;353980;0;0;0;NTBK 348 G7 Core i5-10210U/4GB/1TB/14P;COMPUTACION
12956476;;F;45;CHILENO;;X;VINA DEL MAR                  ;VALPARAISO;44990;1;1;0;0;0;1;1;44990;Multifuncional DeskJet Ink Advantage 2775 Wifi;COMPUTACION
16488391;;M;35;CHILENO;;Millenial;QUILLOTA                      ;VALPARAISO;356980;2;1;2;1;356980;0;0;0;NTBK IP3 Ryzen 3-5300U/8GB/256GB SSD/14P FHD;COMPUTACION
17646647;;F;31;CHILENO;;Millenial;PROVIDENCIA                   ;METROPOLITANA;379990;2;1;2;1;379990;0;0;0;NTBK M!4 Core i3-10110U/8GB/256GB SSD/14P FHD;COMPUTACION
8768829;;M;48;CHILENO;;X;RENCA                         ;METROPOLITANA;149990;1;1;0;0;0;1;1;149990;Tab M10 Plus FHD 4GB 64GB 10.3P platinum grey;COMPUTACION
7807721;;F;63;CHILENO;;Boomers;RENCA                         ;METROPOLITANA;105980;2;1;2;1;105980;0;0;0;NTBK DATACHABLE IDEAPAD D330 N4020 4G 128G W10PR;COMPUTACION
20663520;;F;21;CHILENO;;Z;PROVIDENCIA;METROPOLITANA;219990;1;1;0;0;0;1;1;219990;NTBK HT14 Celeron N4020 4GB/128GB SSD/14P;COMPUTACION
16717591;;F;34;CHILENO;;Millenial;RENCA                         ;METROPOLITANA;54990;2;1;2;1;54990;0;0;0;TAB M7 3ra Gen MT8766 2+32GB 7 Wifi Iron grey;COMPUTACION
18139645;;F;29;CHILENO;;Millenial;VILLARICA                     ;ARAUCANIA;753590;2;1;0;0;0;2;1;753590;NTBK Aspire 5 R5-3500U/12GB/256SSD GB/15P FHD;COMPUTACION
16927643;;F;34;CHILENO;;Millenial;ILLAPEL                       ;COQUIMBO;279980;2;1;0;0;0;2;1;279980;Multifuncional EcoTank L3210;COMPUTACION
24484945;;F;29;PERUANO;;Extranjero;IQUIQUE                       ;TARAPACA;205650;2;1;0;0;0;2;1;205650;Multifuncional DCPT520W Wifi;COMPUTACION
21893961;;F;36;PERUANO;;Extranjero;SANTIAGO                      ;METROPOLITANA;368360;3;2;0;0;0;3;2;368360;Galaxy Tab A8 (10.5, 32GB, WIFI) Silver;COMPUTACION
19212014;;M;26;CHILENO;;Z;PROVIDENCIA                   ;METROPOLITANA;718980;2;1;0;0;0;2;1;718980;NTBK FX506 Ci5-10300H/8GB/512GB SSD/GTX1650 4GB;COMPUTACION
17559904;;F;31;CHILENO;;Millenial;PROVIDENCIA                   ;METROPOLITANA;66980;2;1;2;1;66980;0;0;0;Multifuncional Pixma TR4522 Wifi;COMPUTACION
18290274;;F;30;CHILENO;;Millenial;PUCHUNCAVI                    ;VALPARAISO;402260;4;3;0;0;0;4;3;402260;TAB Galaxy A7 Lite (8.7, 32GB, WIFI + 4G);COMPUTACION
19888274;;F;23;CHILENO;;Z;LOS ANDES                     ;VALPARAISO;159990;1;1;0;0;0;1;1;159990;Multifuncional EcoTank L3210;COMPUTACION
17320491;Soltero;M;33;CHILENO;INGENIERO CIVIL INDUSTRIAL;Millenial;PROVIDENCIA                   ;METROPOLITANA;23970;3;1;3;1;23970;0;0;0;TINTA EPSON T504 CYAN BOTELLA C13T03N22A;COMPUTACION
16098944;;F;36;CHILENO;;Millenial;N/D;N/D;0;0;2;0;2;0;0;0;0;NTBK Zenbook Ryzen 5-5500U/8GB/512GB SSD/13P FHD;COMPUTACION
14018240;;M;41;CHILENO;;X;TALCA                         ;MAULE;169990;1;1;0;0;0;1;1;169990;Galaxy Tab A8 (10.5, 32GB, WIFI) Silver;COMPUTACION
19263278;;F;26;CHILENO;;Z;MOSTAZAL;O HIGGINS;146980;2;1;2;1;146980;0;0;0;Multifuncional DCPT520W Wifi;COMPUTACION
15078907;;M;39;CHILENO;;X;VALPARAISO                    ;VALPARAISO;179990;1;1;0;0;0;1;1;179990;NTBK 240G7 CelN4020 14 4GB/500 PC;COMPUTACION
15621998;;M;38;CHILENO;;Millenial;N/D;N/D;54990;2;1;2;1;54990;0;0;0;TAB M7 3ra Gen MT8766 2+32GB 7 Wifi Iron grey;COMPUTACION
14901308;Casado;F;40;CHILENO;CIRUJANO DENTISTA;X;PROVIDENCIA                   ;METROPOLITANA;349990;2;1;2;1;349990;0;0;0;NTBK IP3 Ryzen 3-5300U/8GB/256GB SSD/14P FHD;COMPUTACION
20039750;;F;22;CHILENO;;Z;SAN VICENTE;O HIGGINS;226830;5;1;0;0;0;5;1;226830;TAB M8 QC 2GB 32GB 8P Gris;COMPUTACION
9477068;;M;57;CHILENO;;Boomers;N/D;N/D;2252500;9;6;2;2;499980;7;4;1752520;NTBK HT14 Celeron N4020 4GB/128GB SSD/14P;COMPUTACION
9914154;;F;53;CHILENO;;X;PROVIDENCIA                   ;METROPOLITANA;69980;2;1;2;1;69980;0;0;0;Multifuncional Pixma TR4522 Wifi;COMPUTACION
18909306;Soltero;M;30;CHILENO;;Millenial;PROVIDENCIA                   ;METROPOLITANA;7990;1;1;1;1;7990;0;0;0;TINTA BOTELLA EPSON T664120 NEGRA SERIE L;COMPUTACION
15408310;;F;39;CHILENO;;X;PROVIDENCIA                   ;METROPOLITANA;149990;1;1;0;0;0;1;1;149990;Tab M10 Plus FHD 4GB 64GB 10.3P platinum grey;COMPUTACION
18616599;;F;28;CHILENO;;Millenial;SANTA CRUZ                    ;L.G.B.OÂ´HIGGINS;3529870;13;6;0;0;0;13;6;3529870;AIO IC A340 Core i3/4GB/1TB/24P Full HD;COMPUTACION
7819899;;F;62;CHILENO;;Boomers;N/D;N/D;153980;2;1;2;1;153980;0;0;0;Tab M10 Plus FHD 4GB 64GB 10.3P platinum grey;COMPUTACION
16138392;;F;36;CHILENO;;Millenial;CURANILAHUE                   ;BIO BIO;906800;6;4;4;2;429820;2;2;476980;TAB Galaxy S7 FE (12.4, 64GB WIFI) LIGHT PINK;COMPUTACION
18120941;Soltero;F;30;CHILENO;;Millenial;PROVIDENCIA                   ;METROPOLITANA;34980;2;1;2;1;34980;0;0;0;TAB 7 MB4 Plus 4Core 1GB 16GB 7 Negra;COMPUTACION
19544786;;M;25;CHILENO;;Z;PROVIDENCIA                   ;METROPOLITANA;293980;2;1;2;1;293980;0;0;0;NTBK 15-ef1015la Ryzen 3-4300U/4GB/256GBSSD/15P;COMPUTACION
5517855;;F;73;CHILENO;;Silencioso;PUENTE ALTO                   ;METROPOLITANA;424960;4;3;0;0;0;4;3;424960;TAB Galaxy A7 Lite (8.7, 32GB, WIFI);COMPUTACION
20324805;;F;21;CHILENO;;Z;N/D;N/D;125970;3;2;3;2;125970;0;0;0;NTBK DATACHABLE IDEAPAD D330 N4020 4G 128G W10PR;COMPUTACION
25976757;;F;24;PERUANO;;Extranjero;"";"";255370;6;2;3;1;188970;3;1;66400;NTBK BR11 Celeron N4500/4GB/64GB eMMC/11P;COMPUTACION
17212135;;F;32;CHILENO;;Millenial;CONSTITUCION                  ;MAULE;436960;4;3;0;0;0;4;3;436960;NTBK 15-dw1080la Celeron N4020/4GB/1TB/15P;COMPUTACION
26295821;Soltero;F;26;VENEZOLANO;;Extranjero;N/D;N/D;347960;4;2;4;2;347960;0;0;0;NTBK 15-ef1015la Ryzen 3-4300U/4GB/256GBSSD/15P;COMPUTACION
19043879;Soltero;M;26;CHILENO;;Z;PROVIDENCIA                   ;METROPOLITANA;149990;1;1;0;0;0;1;1;149990;Tab M10 Plus FHD 4GB 64GB 10.3P platinum grey;COMPUTACION
26808981;;F;33;VENEZOLANO;;Extranjero;N/D;N/D;278980;2;1;2;1;278980;0;0;0;NTBK ASUS Ci3/4GB/128GB Win+Tec Ingles+S/adap;COMPUTACION
24017998;Soltero;F;37;PARAGUAYO;TECNICO EN CONTABILIDAD;Extranjero;PROVIDENCIA                   ;METROPOLITANA;163980;2;1;2;1;163980;0;0;0;Multifuncional EcoTank L3210;COMPUTACION
7624988;;M;64;CHILENO;;Boomers;MAIPU                         ;METROPOLITANA;506970;4;2;4;2;506970;0;0;0;NTBK 240 G8 Celeron N4020/4GB/500GB/14P;COMPUTACION
12363098;;F;49;CHILENO;;X;CANETE                        ;BIO BIO;477470;5;3;0;0;0;5;3;477470;Multifuncional EcoTank L3250 Wifi;COMPUTACION
20407709;;F;21;CHILENO;;Z;PROVIDENCIA                   ;METROPOLITANA;152990;1;1;1;1;152990;0;0;0;Galaxy Tab A8 (10.5, 32GB, WIFI) Silver;COMPUTACION
10720668;;F;57;CHILENO;;Boomers;LINARES                       ;MAULE;1525860;14;8;0;0;0;14;8;1525860;TAB Galaxy A7 Lite (8.7, 32GB, WIFI);COMPUTACION
11819128;;F;51;CHILENO;;X;CALAMA                        ;ANTOFAGASTA;294910;4;3;0;0;0;4;3;294910;NTBK IP S145 AMD A4-9125/4GB/500GB/14P;COMPUTACION
20521052;;F;21;CHILENO;;Z;SAN JAVIER;MAULE;432960;6;3;1;1;99990;5;2;332970;TAB Galaxy A7 Lite (8.7, 32GB, WIFI);COMPUTACION
18517875;Soltero;F;28;CHILENO;;Millenial;PANGUIPULLI                   ;LOS LAGOS;449980;2;2;0;0;0;2;2;449980;Multifuncional EcoTank L4260 Wifi y Duplex;COMPUTACION
13584258;;M;43;CHILENO;;X;ANGOL                         ;ARAUCANIA;338110;5;3;0;0;0;5;3;338110;NTBK 15-dw1080la Celeron N4020/4GB/1TB/15P;COMPUTACION
8005934;;M;51;CHILENO;;X;CAUQUENES                     ;MAULE;174990;1;1;0;0;0;1;1;174990;Multifuncional EcoTank L3250 Wifi;COMPUTACION
8078566;;M;61;CHILENO;;Boomers;COPIAPO                       ;ATACAMA;169990;1;1;0;0;0;1;1;169990;Galaxy Tab A8 (10.5, 32GB, WIFI) Silver;COMPUTACION
13721259;;M;43;CHILENO;;Millenial;CERRO NAVIA                   ;METROPOLITANA;159990;1;1;0;0;0;1;1;159990;Tab M10 Plus FHD 4GB 64GB 10.3P platinum grey;COMPUTACION
8881808;;M;59;CHILENO;;Boomers;BUIN                          ;METROPOLITANA;159990;1;1;0;0;0;1;1;159990;Multifuncional EcoTank L3210;COMPUTACION
17558967;;F;32;CHILENO;;Millenial;PROVIDENCIA                   ;METROPOLITANA;584980;2;1;2;1;584980;0;0;0;NTBK 2en1 Flex5 R5-4500U/8GB/256SSD/14P FHD+Pen;COMPUTACION
19877486;;F;24;CHILENO;;Millenial;OVALLE;COQUIMBO;97960;4;2;0;0;0;4;2;97960;TAB MLAB MBX 8 QUAD CORE 1G+16G 8716;COMPUTACION
12518077;;F;48;CHILENO;;X;RANCAGUA                      ;L.G.B.OÂ´HIGGINS;653120;5;3;0;0;0;5;3;653120;NTBK 15-ef1015la Ryzen 3-4300U/4GB/256GBSSD/15P;COMPUTACION
16741991;;M;35;CHILENO;;Millenial;N/D;N/D;250510;5;5;2;1;29540;3;4;220970;NTBK D330 Celeron N4020/4GB/64GB/10P+OfficeHS;COMPUTACION
16533061;;F;35;CHILENO;;Millenial;CHIMBARONGO                   ;L.G.B.OÂ´HIGGINS;488020;9;3;0;0;0;9;3;488020;NTBK 15-dw1080la Celeron N4020/4GB/1TB/15P;COMPUTACION
12012330;;F;50;CHILENO;;X;MULCHEN                       ;BIO BIO;149990;1;1;0;0;0;1;1;149990;Multifuncional Ink Tank 415 Wifi;COMPUTACION
17982532;;F;30;CHILENO;;Millenial;PROVIDENCIA                   ;METROPOLITANA;423600;4;3;0;0;0;4;3;423600;NTBK 15-ef1015la Ryzen 3-4300U/4GB/256GBSSD/15P;COMPUTACION
15953923;Soltero;F;37;CHILENO;PROFDE HISTORIA Y GEOGRAFIA;Millenial;PROVIDENCIA                   ;METROPOLITANA;435980;2;1;2;1;435980;0;0;0;TAB Galaxy S7 FE (12.4, 128GB WIFI) SILVER;COMPUTACION
13582808;;M;43;CHILENO;;X;ANTOFAGASTA                   ;ANTOFAGASTA;99990;1;1;0;0;0;1;1;99990;TAB Galaxy A7 Lite (8.7, 32GB, WIFI);COMPUTACION
15217753;;M;39;CHILENO;;X;CHILLAN;BIO-BIO;225980;2;1;0;0;0;2;1;225980;NTBK IP3i Celeron N4020/4G/500GB/14P/Rojo;COMPUTACION
14286658;Casado;F;48;CHILENO;;X;RENCA                         ;METROPOLITANA;99990;1;1;1;1;99990;0;0;0;TAB Galaxy A7 Lite (8.7, 32GB, WIFI);COMPUTACION
9930844;;M;60;CHILENO;;Boomers;CAUQUENES                     ;MAULE;538600;4;3;0;0;0;4;3;538600;NTBK 15-ef1015la Ryzen 3-4300U/4GB/256GBSSD/15P;COMPUTACION
17252815;;F;32;CHILENO;;Millenial;"";"";39990;1;1;1;1;39990;0;0;0;TAB 7 MB4 Plus 4Core 1GB 16GB 7 Plata;COMPUTACION
10871630;;F;56;CHILENO;;Boomers;CURACAVI                      ;METROPOLITANA;352540;5;2;0;0;0;5;2;352540;Multifuncional EcoTank L3210;COMPUTACION
26291573;Soltero;F;46;PERUANO;;Extranjero;"";"";135990;1;1;1;1;135990;0;0;0;Galaxy Tab A8 (10.5, 32GB, WIFI) Silver;COMPUTACION
16195199;;F;35;CHILENO;;Millenial;LA SERENA                     ;COQUIMBO;325510;4;2;0;0;0;4;2;325510;Multifuncional EcoTank L3250 Wifi;COMPUTACION
11672844;Casado;F;51;CHILENO;;X;PROVIDENCIA                   ;METROPOLITANA;205980;2;1;2;1;205980;0;0;0;Multifuncional DCPT720DW Wifi, Duplex y ADF;COMPUTACION
5299441;;M;78;CHILENO;;Silencioso;NATALES                       ;MAGALLANES;270980;2;5;0;0;0;2;5;270980;NTBK IP3 Ryzen 3-5300U/8GB/256GB SSD/14P FHD;COMPUTACION
16959463;;F;38;CHILENO;;Millenial;PROVIDENCIA                   ;METROPOLITANA;409980;2;2;0;0;0;2;2;409980;NTBK HT14 Celeron N4020 4GB/128GB SSD/14P;COMPUTACION
23794859;Soltero;F;36;CHINO;;Extranjero;PROVIDENCIA                   ;METROPOLITANA;183980;2;1;2;1;183980;0;0;0;Multifuncional EcoTank L3250 Wifi;COMPUTACION
18752058;;M;28;CHILENO;;Millenial;N/D;N/D;369980;2;1;0;0;0;2;1;369980;NTBK 14-ck2091la i3-10110U 4GB 128GB 14 HD;COMPUTACION
8427059;;F;65;CHILENO;;Boomers;LA FLORIDA                    ;METROPOLITANA;1066910;9;3;9;3;1066910;0;0;0;Galaxy Tab A8 (10.5, 32GB, WIFI) Pink Gold;COMPUTACION
12066053;;F;57;CHILENO;;Boomers;MONTE PATRIA                  ;COQUIMBO;1222960;4;2;0;0;0;4;2;1222960;NTBK GAMER GF66 Ci5-11400H/8GB/512GB/GTX1650 4GB;COMPUTACION
17933922;Soltero;M;30;CHILENO;PROFESOR;Millenial;PROVIDENCIA                   ;METROPOLITANA;165480;2;1;2;1;165480;0;0;0;Multifuncional EcoTank L3210;COMPUTACION
11385223;;F;53;CHILENO;;X;PUERTO MONTT;LOS LAGOS;139990;1;1;1;1;139990;0;0;0;Multifuncional EcoTank L3210;COMPUTACION
8927408;;F;60;CHILENO;;X;N/D;N/D;343970;3;3;0;0;0;3;3;343970;Multifuncional EcoTank L3210;COMPUTACION
11998869;;M;50;CHILENO;;X;LINARES                       ;MAULE;599990;1;1;0;0;0;1;1;599990;NTBK Zenbook Ryzen 5-5500U/8GB/512GB SSD/13P FHD;COMPUTACION
17820980;;F;31;CHILENO;;Millenial;TALCA                         ;MAULE;679963;6;4;0;0;0;6;4;679963;Multifuncional EcoTank L3210;COMPUTACION
18137992;;F;29;CHILENO;;Millenial;LEBU;BIO-BIO;245950;5;3;0;0;0;5;3;245950;Multifuncional EcoTank L3210;COMPUTACION
12623210;;F;47;CHILENO;;X;VINA DEL MAR                  ;VALPARAISO;154980;2;1;2;1;154980;0;0;0;Multifuncional EcoTank L3210;COMPUTACION
16739998;;F;36;CHILENO;;Millenial;VALLENAR;ATACAMA;439970;3;3;0;0;0;3;3;439970;Multifuncional EcoTank L3250 Wifi;COMPUTACION
19637463;;F;24;CHILENO;;Z;PROVIDENCIA                   ;METROPOLITANA;310980;2;1;2;1;310980;0;0;0;NTBK X415 Core i3-10110U/4GB/256GB SSD/14P FHD;COMPUTACION
14108309;;M;40;CHILENO;;X;"";"";61980;2;1;0;0;0;2;1;61980;TAB MLAB MBX 8 QUAD CORE 1G+16G 8716;COMPUTACION
8272284;;F;65;CHILENO;;Boomers;VINA DEL MAR                  ;VALPARAISO;256970;3;1;0;0;0;3;1;256970;NTBK IP S145 AMD A4-9125/4GB/500GB/14P;COMPUTACION
11556529;;M;51;CHILENO;;X;RENCA                         ;METROPOLITANA;59990;1;1;0;0;0;1;1;59990;Multifuncional DeskJet Ink Advantage 3775 Wifi;COMPUTACION
16140716;;M;36;CHILENO;;Millenial;"";"";174990;1;1;1;1;174990;0;0;0;IMPRESORA MONOCR B215V-DNI;COMPUTACION
19691108;;F;25;CHILENO;;Z;ANTOFAGASTA                   ;ANTOFAGASTA;279990;2;3;0;0;0;2;3;279990;NTBK 240 G8 Celeron N4020/4GB/500GB/14P;COMPUTACION
19370775;;F;26;CHILENO;;Z;LOS ANGELES                   ;BIO BIO;224990;1;1;0;0;0;1;1;224990;NTBK IP3i Celeron N4020/4G/500GB/14P/Rojo;COMPUTACION
20113075;;F;23;CHILENO;;Silencioso;PROVIDENCIA                   ;METROPOLITANA;49990;1;1;1;1;49990;0;0;0;Impresora Laser HL-1202 Monocromatica;COMPUTACION
16532550;Soltero;M;35;CHILENO;;Millenial;VILLA ALEMANA                 ;VALPARAISO;149990;1;1;0;0;0;1;1;149990;Multifuncional EcoTank L3210;COMPUTACION
17435388;;F;32;CHILENO;;Millenial;N/D;N/D;9990;1;1;0;0;0;1;1;9990;TINTA BOTELLA EPSON T664120 NEGRA SERIE L;COMPUTACION
16383465;;M;36;CHILENO;;Millenial;N/D;N/D;203980;2;1;2;1;203980;0;0;0;Multifuncional DCPT720DW Wifi, Duplex y ADF;COMPUTACION
26666775;;F;43;VENEZOLANO;;Extranjero;N/D;N/D;327660;6;3;6;3;327660;0;0;0;Multifuncional EcoTank L3250 Wifi;COMPUTACION
6460852;;F;70;CHILENO;;Silencioso;ARAUCO                        ;BIO BIO;439619;7;4;0;0;0;7;4;439619;AIO IC Athlon 3050U 4GB 1TB 21.5P;COMPUTACION
14199094;;M;40;CHILENO;;X;N/D;N/D;2258210;14;6;0;0;0;14;6;2258210;Galaxy Tab A8 (10.5, 32GB, WIFI) Silver;COMPUTACION
16388299;;F;35;CHILENO;;Millenial;PROVIDENCIA                   ;METROPOLITANA;485960;4;2;0;0;0;4;2;485960;NTBK 15-dw1080la Celeron N4020/4GB/1TB/15P;COMPUTACION
9692366;;M;59;CHILENO;;Boomers;PUENTE ALTO                   ;METROPOLITANA;507950;5;2;0;0;0;5;2;507950;NTBK 15-dw1080la Celeron N4020/4GB/1TB/15P;COMPUTACION
25449733;;F;25;COLOMBIANO;;Extranjero;"";"";252980;2;1;0;0;0;2;1;252980;NTBK D330 Celeron N4020/4GB/64GB/10P+OfficeHS;COMPUTACION
18252574;;F;29;CHILENO;;Millenial;TENO                          ;MAULE;66980;2;1;2;1;66980;0;0;0;TAB GAMER 7 QUAD CORE 2G+16G 8715;COMPUTACION
26981008;;F;45;VENEZOLANO;;Extranjero;"";"";142970;3;2;0;0;0;3;2;142970;Monitor 22 FHD 75Hz HDMI VGA/Flat IPS/Black;COMPUTACION
10003144;;M;57;CHILENO;;Boomers;RENCA                         ;METROPOLITANA;429990;1;1;0;0;0;1;1;429990;NTBK IP3 Ryzen 3-5300U/8GB/256GB SSD/14P FHD;COMPUTACION
15587749;;F;38;CHILENO;;X;MELIPILLA                     ;METROPOLITANA;433980;2;1;2;1;433980;0;0;0;TAB Galaxy S7 FE (12.4, 128GB WIFI) LIGHT GREEN;COMPUTACION
5124177;;F;74;CHILENO;;Silencioso;MELIPILLA                     ;METROPOLITANA;189980;2;1;0;0;0;2;1;189980;TAB Galaxy A7 Lite (8.7, 32GB, WIFI + 4G);COMPUTACION
11646904;;F;51;CHILENO;;X;N/D;N/D;184990;1;1;0;0;0;1;1;184990;Multifuncional Smart tank 530 WiFi ADF;COMPUTACION
15683317;Soltero;F;38;CHILENO;PROFESOR;X;PROVIDENCIA                   ;METROPOLITANA;248980;2;1;2;1;248980;0;0;0;Multifuncional EcoTank L4260 Wifi y Duplex;COMPUTACION
10659652;;F;51;CHILENO;;X;PROVIDENCIA                   ;METROPOLITANA;213980;2;1;0;0;0;2;1;213980;Multifuncional EcoTank L3210;COMPUTACION
10786507;;M;51;CHILENO;;Millenial;"";"";259990;1;1;0;0;0;1;1;259990;BUNDLE TAB P11 6GB 128SSD Slate Grey;COMPUTACION
26122148;;F;25;COLOMBIANO;;Extranjero;PUDAHUEL                      ;METROPOLITANA;303980;2;1;2;1;303980;0;0;0;TAB Galaxy S7 FE (12.4, 64GB WIFI) LIGHT PINK;COMPUTACION
7100641;;F;70;CHILENO;;Silencioso;YUNGAY                        ;BIO BIO;521980;2;1;0;0;0;2;1;521980;NTBK 255 G8 Ryzen 5-5500U/8GB/256GB SSD/15P;COMPUTACION
8645549;;F;63;CHILENO;;Boomers;"";"";149990;1;1;0;0;0;1;1;149990;Multifuncional EcoTank L3210;COMPUTACION
10300547;;F;57;CHILENO;;Boomers;RENCA                         ;METROPOLITANA;49990;1;1;0;0;0;1;1;49990;TAB MLAB MBX 8 QUAD CORE 1G+16G 8716;COMPUTACION
5292719;;M;77;CHILENO;;Silencioso;RENCA                         ;METROPOLITANA;193980;2;1;0;0;0;2;1;193980;Multifuncional Pixma TR4522 Wifi;COMPUTACION
16029800;;F;37;CHILENO;;Millenial;N/D;N/D;199990;1;1;0;0;0;1;1;199990;NTBK IP S145 AMD A4-9125/4GB/500GB/14P;COMPUTACION
12940221;;M;46;CHILENO;;X;PROVIDENCIA                   ;METROPOLITANA;89990;1;1;1;1;89990;0;0;0;TAB Galaxy A7 Lite (8.7, 32GB, WIFI);COMPUTACION
18204688;;F;30;CHILENO;;Silencioso;PROVIDENCIA                   ;METROPOLITANA;159990;1;1;0;0;0;1;1;159990;Multifuncional EcoTank L3210;COMPUTACION
26494111;Soltero;M;45;NO INFORMA NACIONALIDAD;;Extranjero;PROVIDENCIA                   ;METROPOLITANA;139990;1;1;1;1;139990;0;0;0;Multifuncional DCPT220;COMPUTACION
8975949;;M;61;CHILENO;;Millenial;COQUIMBO                      ;COQUIMBO;89990;1;1;0;0;0;1;1;89990;TAB M8 QC 2GB 32GB 8P Gris;COMPUTACION
14127779;;M;41;CHILENO;;X;PROVIDENCIA                   ;METROPOLITANA;423980;2;1;2;1;423980;0;0;0;TAB Galaxy S7 FE (12.4, 128GB WIFI) BLACK;COMPUTACION
12965759;;M;46;CHILENO;;X;PARRAL                        ;MAULE;559980;2;1;0;0;0;2;1;559980;NTBK 255 G8 Ryzen 5-5500U/8GB/256GB SSD/15P;COMPUTACION
12328007;Soltero;F;48;CHILENO;AUXILIAR DE ENFERMERIA;X;LOS ANGELES                   ;BIO BIO;988470;3;1;0;0;0;3;1;988470;NTBK G14 R7-4800HS/16GB/512SSD/1650 4G/14P 120Hz;COMPUTACION
19278916;;F;27;CHILENO;;Millenial;PROVIDENCIA                   ;METROPOLITANA;48980;2;1;2;1;48980;0;0;0;TAB MLAB MBX 8 QUAD CORE 1G+16G 8716;COMPUTACION
16260048;;M;36;CHILENO;;Silencioso;PROVIDENCIA                   ;METROPOLITANA;499990;1;1;1;1;499990;0;0;0;NTBK M14 Ryzen 5-5500U 8GB/256GB SSD/14P FHD;COMPUTACION
14326218;;M;45;CHILENO;;X;PROVIDENCIA                   ;METROPOLITANA;403980;2;1;2;1;403980;0;0;0;TABLET MatePad Pro 10.8 + M-Pencil;COMPUTACION
5665250;;M;69;CHILENO;;Silencioso;MAULE                         ;MAULE;164990;1;1;0;0;0;1;1;164990;Galaxy Tab A7 (10.4 ,32GB, WIFI) Dark Gray;COMPUTACION
12297854;;M;50;CHILENO;;X;RENCA                         ;METROPOLITANA;427980;2;1;0;0;0;2;1;427980;NTBK 240 G8 Core i3-1005G1/4GB/1TB/14P;COMPUTACION
9515368;;F;58;CHILENO;;Boomers;LITUECHE                      ;L.G.B.OÂ´HIGGINS;27960;4;1;0;0;0;4;1;27960;T544 DYE MAGENTA INK BOTTLE (65ml);COMPUTACION
15631263;;M;38;CHILENO;;Millenial;"";"";266960;4;2;1;1;34990;3;1;231970;TAB 7 MB4 Plus 4Core 1GB 16GB 7 Negra;COMPUTACION
16068498;;M;37;CHILENO;;Millenial;TALAGANTE                     ;METROPOLITANA;579980;2;2;0;0;0;2;2;579980;NTBK IP3 Ryzen 3-5300U/8GB/256GB SSD/14P FHD;COMPUTACION
18042559;;F;29;CHILENO;;Millenial;PROVIDENCIA                   ;METROPOLITANA;149990;1;1;1;1;149990;0;0;0;Multifuncional EcoTank L3210;COMPUTACION
18777523;;M;28;CHILENO;;Millenial;SAN PEDRO                     ;METROPOLITANA;251980;2;1;0;0;0;2;1;251980;Tab Yoga Smart;COMPUTACION
20611040;Soltero;M;29;CHILENO;;Millenial;PROVIDENCIA                   ;METROPOLITANA;54990;1;1;1;1;54990;0;0;0;TAB MLAB MBX 8 QUAD CORE 1G+16G 8716;COMPUTACION
10290012;;M;51;CHILENO;;X;COIHAIQUE                     ;AYSEN;411980;2;2;0;0;0;2;2;411980;NTBK 14-cf2097la Pentium Gold 6405U/8GB/256GB/14;COMPUTACION
9225550;;F;80;CHILENO;;Silencioso;RENCA                         ;METROPOLITANA;169990;1;1;0;0;0;1;1;169990;Multifuncional Ink Tank 415 Wifi;COMPUTACION
21150872;;F;50;PERUANO;;Extranjero;VALPARAISO                    ;VALPARAISO;93980;2;1;2;1;93980;0;0;0;TAB M8 QC 2GB 32GB 8P Gris;COMPUTACION
10069772;;M;58;CHILENO;;Boomers;PROVIDENCIA                   ;METROPOLITANA;264980;2;1;0;0;0;2;1;264980;NTBK 240 G8 Celeron N4020/4GB/500GB/14P;COMPUTACION
16668391;;M;34;CHILENO;;Millenial;PROVIDENCIA                   ;METROPOLITANA;273970;3;1;3;1;273970;0;0;0;Galaxy Tab A7 (10.4 ,32GB, WIFI) Gold;COMPUTACION
16323903;;F;36;CHILENO;;Millenial;RENCA                         ;METROPOLITANA;510970;3;1;0;0;0;3;1;510970;NTBK IP3 Ryzen 3-5300U/8GB/256GB SSD/14P FHD;COMPUTACION
9463342;;M;60;CHILENO;;Boomers;LAS CONDES                    ;METROPOLITANA;119980;2;1;0;0;0;2;1;119980;TAB M8 QC 2GB 32GB 8P Gris;COMPUTACION
10458681;;F;58;CHILENO;;Boomers;PAILLACO                      ;LOS LAGOS;139990;1;1;0;0;0;1;1;139990;Tab M10 FHD Plus LTE 10.3IN 2GB 32GB;COMPUTACION
13940647;;F;41;CHILENO;;X;LA PINTANA                    ;METROPOLITANA;279990;1;1;0;0;0;1;1;279990;NTBK 240 G8 Core i3-1005G1/4GB/1TB/14P;COMPUTACION
10372120;;F;58;CHILENO;;Boomers;COPIAPO                       ;ATACAMA;246950;5;1;0;0;0;5;1;246950;TAB GAMER 7 QUAD CORE 2G+16G 8715;COMPUTACION
12532848;;F;48;CHILENO;;X;MELIPILLA                     ;METROPOLITANA;467940;6;2;0;0;0;6;2;467940;AIO/Athlon 3050U/4GB/1TB + 256GB/UMA/White;COMPUTACION
26227124;;M;40;VENEZOLANO;;Extranjero;SANTIAGO                      ;METROPOLITANA;88980;2;1;2;1;88980;0;0;0;TAB M8 QC 2GB 32GB 8P Gris;COMPUTACION
14197609;;F;41;CHILENO;;X;LA GRANJA                     ;METROPOLITANA;142100;2;1;0;0;0;2;1;142100;TAB Galaxy A7 Lite (8.7, 32GB, WIFI);COMPUTACION
18939711;;M;27;CHILENO;;Z;N/D;N/D;99990;1;1;1;1;99990;0;0;0;TAB Galaxy A7 Lite (8.7, 32GB, WIFI);COMPUTACION
12563953;;F;48;CHILENO;;X;CONTULMO                      ;BIO BIO;419990;1;1;0;0;0;1;1;419990;NTBK IP3 Core i3-1115G4/4GB/512GB SSD/14P FHD;COMPUTACION
15460823;;M;39;CHILENO;;X;RENCA                         ;METROPOLITANA;199990;1;1;1;1;199990;0;0;0;BUNDLE TAB P11 6GB 128SSD Slate Grey;COMPUTACION
15912702;Soltero;M;37;CHILENO;;Millenial;PROVIDENCIA                   ;METROPOLITANA;34990;1;1;1;1;34990;0;0;0;TAB 7 MB4 Plus 4Core 1GB 16GB 7 Negra;COMPUTACION
17482042;;F;31;CHILENO;;Millenial;ZAPALLAR                      ;VALPARAISO;63980;2;1;0;0;0;2;1;63980;TAB MLAB MBX 8 QUAD CORE 1G+16G 8716;COMPUTACION
13661771;;M;43;CHILENO;;X;VALLENAR;ATACAMA;599972;5;2;1;1;199990;4;1;399982;NTBK IP3i Celeron N4020/4G/500GB/14P/Rojo;COMPUTACION
16600328;;F;34;CHILENO;;Millenial;N/D;N/D;442960;4;2;0;0;0;4;2;442960;NTBK IP3 Ryzen 3-3250U/8GB/1TB/15P;COMPUTACION
15608161;;M;38;CHILENO;;Millenial;PROVIDENCIA                   ;METROPOLITANA;103970;3;1;3;1;103970;0;0;0;TAB MLAB 7 MB4 PLUS 3G 1+16GB WHITE 8762;COMPUTACION
13428157;;F;43;CHILENO;;X;"";"";139990;1;3;0;0;0;1;3;139990;Tab M10 FHD Plus LTE 10.3IN 2GB 32GB;COMPUTACION
19853668;;M;23;CHILENO;;Z;PROVIDENCIA                   ;METROPOLITANA;104990;1;1;1;1;104990;0;0;0;Matepad T10S WIFI 2+32 GB;COMPUTACION
26916322;;M;34;EXTRANJERO - NO INFORMA NACIONALIDAD;;Extranjero;"";"";439990;1;1;0;0;0;1;1;439990;NTBK 14-dq2025la Ci3-1115G4/4GB/256GB+16GB/14P;COMPUTACION
18566226;Soltero;M;28;CHILENO;;Millenial;PROVIDENCIA                   ;METROPOLITANA;279980;2;1;2;1;279980;0;0;0;Tab M10 FHD Plus LTE 10.3IN 2GB 32GB;COMPUTACION
13243811;;F;45;CHILENO;;X;LA FLORIDA                    ;METROPOLITANA;248970;3;1;0;0;0;3;1;248970;Tab M10 HD 2G-32GB 10.1 Iron grey WiFi;COMPUTACION
10116160;;M;58;CHILENO;;Boomers;VILLA ALEMANA                 ;VALPARAISO;1233950;5;2;5;2;1233950;0;0;0;PC ARGUS Serie IRX570BSB;COMPUTACION
14338968;Casado;M;45;CHILENO;;X;RENCA                         ;METROPOLITANA;203980;2;1;2;1;203980;0;0;0;Monitor Emerald 27P 165Hz Full HD;COMPUTACION
19146964;;F;27;CHILENO;;Z;ARICA                         ;ARICA Y PARINACOTA;519960;4;2;0;0;0;4;2;519960;Tab M10 FHD Plus LTE 10.3IN 2GB 32GB;COMPUTACION
8303601;;M;55;CHILENO;;Boomers;VALPARAISO                    ;VALPARAISO;199990;1;1;1;1;199990;0;0;0;Monitor Emerald 27P 165Hz Full HD;COMPUTACION
26193142;;F;35;VENEZOLANO;;Extranjero;"";"";388230;3;1;0;0;0;3;1;388230;NTBK S145-14IIL I3 10/4G 128SSD/14HD;COMPUTACION
16720677;;F;34;CHILENO;;Millenial;EL BOSQUE                     ;METROPOLITANA;373200;6;4;0;0;0;6;4;373200;NTBK 240 G8 Celeron N4020/4GB/500GB/14P;COMPUTACION
9316332;;F;59;CHILENO;;Boomers;PROVIDENCIA                   ;METROPOLITANA;659980;2;1;0;0;0;2;1;659980;NTBK 15-dk1028la Ci5-10300H/8GB/256SSD/1050 3GB;COMPUTACION
13752166;;M;42;CHILENO;;X;PANQUEHUE                     ;VALPARAISO;632980;2;1;0;0;0;2;1;632980;NTBK 255 G8 Ryzen 5-5500U/8GB/256GB SSD/15P;COMPUTACION
12328762;;F;49;CHILENO;;X;CURICO                        ;MAULE;311970;3;1;0;0;0;3;1;311970;NTBK IP1 AMD 3020e/4GB/64GB eMMC/14P;COMPUTACION
13002705;;M;45;CHILENO;;X;PUERTO MONTT                  ;LOS LAGOS;264970;3;3;0;0;0;3;3;264970;TAB MLAB MBX 8 QUAD CORE 1G+16G 8716;COMPUTACION
15595570;;M;38;CHILENO;;Millenial;COQUIMBO                      ;COQUIMBO;457540;2;1;2;1;457540;0;0;0;NTBK 14-dy0501laCi3-1125G4/8GB/256SSD/FHD/Pen;COMPUTACION
14099953;;M;40;CHILENO;;X;RENCA                         ;METROPOLITANA;109990;1;1;0;0;0;1;1;109990;Multifuncional Pixma TR4522 Wifi;COMPUTACION
9821768;Casado;M;55;CHILENO;TECNICO EN ANALISIS QUIMICO;Boomers;PROVIDENCIA                   ;METROPOLITANA;403980;2;1;2;1;403980;0;0;0;TAB Galaxy S7 FE (12.4, 64GB WIFI) LIGHT GREEN;COMPUTACION
17425899;;M;32;CHILENO;;Millenial;INDEPENDENCIA                 ;METROPOLITANA;312970;3;1;0;0;0;3;1;312970;NTBK HT14 Celeron N4020 4GB/128GB SSD/14P;COMPUTACION
26627622;;M;30;VENEZOLANO;;Extranjero;"";"";0;0;2;0;0;0;0;2;0;Multifuncional EcoTank L3210;COMPUTACION
16773607;;F;34;CHILENO;;Millenial;ANTOFAGASTA;ANTOFAGASTA;139640;2;1;2;1;139640;0;0;0;Galaxy Tab A7 (10.4 ,32GB, WIFI) Gold;COMPUTACION
19274891;;M;26;CHILENO;;Z;SAN FERNANDO                  ;L.G.B.OÂ´HIGGINS;46140;2;1;0;0;0;2;1;46140;TAB MLAB MBX 8 QUAD CORE 1G+16G 8716;COMPUTACION
17248501;;F;33;CHILENO;;Millenial;N/D;N/D;250970;3;2;2;1;233980;1;1;16990;NTBK 14-cf2097la Pentium Gold 6405U/8GB/256GB/14;COMPUTACION
18086080;Soltero;F;30;CHILENO;TECNICO DE NIVEL SUPERIOR EN ENFERMERIA;Millenial;PROVIDENCIA                   ;METROPOLITANA;38980;2;1;2;1;38980;0;0;0;TAB 7 MB4 Plus 4Core 1GB 16GB 7 Negra;COMPUTACION
15972576;;F;37;CHILENO;;Millenial;"";"";125840;2;1;2;1;125840;0;0;0;TAB Galaxy A7 Lite (8.7, 64GB, WIFI);COMPUTACION
15139355;;M;39;CHILENO;;X;MAULE                         ;MAULE;863550;4;2;1;1;139990;3;1;723560;Tab M10 FHD Plus LTE 10.3IN 2GB 32GB;COMPUTACION
18373841;;M;29;CHILENO;;Millenial;N/D;N/D;139990;1;1;1;1;139990;0;0;0;TAB-X306X 10-INCH 4G+64G HD WIFI+4G LTE;COMPUTACION
7124797;;M;67;CHILENO;;Boomers;"";"";275980;2;1;0;0;0;2;1;275980;NTBK IP S145 AMD 3020E/4GB/500GB/14P;COMPUTACION
18745906;;F;27;CHILENO;;Millenial;CORONEL                       ;BIO BIO;90140;2;2;0;0;0;2;2;90140;TAB M8 QC 2GB 32GB 8P Gris;COMPUTACION
17739567;;F;30;CHILENO;;Millenial;RENCA;METROPOLITANA;79990;1;1;1;1;79990;0;0;0;TAB Galaxy A7 Lite (8.7, 32GB, WIFI);COMPUTACION
15045767;;M;39;CHILENO;;X;ILLAPEL                       ;COQUIMBO;822540;2;1;2;1;822540;0;0;0;TABLET GALAXY S7+ (T970) 256GB 12.4P Gris;COMPUTACION
14535762;;F;45;CHILENO;;X;PROVIDENCIA                   ;METROPOLITANA;527040;8;6;8;6;527040;0;0;0;TABLET MLAB 7 MB4 PLUS 1+16GB RED;COMPUTACION
18372235;Soltero;F;28;CHILENO;;Silencioso;PROVIDENCIA                   ;METROPOLITANA;703980;2;1;2;1;703980;0;0;0;NTBK Zenbook Ryzen 5-5500U/8GB/512GB SSD/13P FHD;COMPUTACION
9464521;;F;57;CHILENO;;Boomers;"";"";299990;1;1;0;0;0;1;1;299990;NTBK Herobook Celeron N4020/8GB/256SSD/14P FHD;COMPUTACION
7576557;;F;64;CHILENO;;Boomers;N/D;N/D;129990;1;1;0;0;0;1;1;129990;TAB Galaxy A7 Lite (8.7, 32GB, WIFI + 4G);COMPUTACION
12780142;;F;47;CHILENO;;X;N/D;N/D;127970;3;1;0;0;0;3;1;127970;TAB M8 QC 2GB 32GB 8P Gris;COMPUTACION
17061584;;F;33;CHILENO;;Millenial;CHILLAN;BIO-BIO;259980;2;2;2;2;259980;0;0;0;TAB-X306X 10-INCH 4G+64G HD WIFI+4G LTE;COMPUTACION
9140769;;F;60;CHILENO;;Boomers;CHILLAN                       ;BIO BIO;388350;3;2;0;0;0;3;2;388350;NTBK 240 G8 Celeron N4020/4GB/500GB/14P;COMPUTACION
16394273;Soltero;M;36;CHILENO;;Millenial;LOS ANGELES                   ;BIO BIO;179990;1;1;0;0;0;1;1;179990;Monitor Emerald 27P 165Hz Full HD;COMPUTACION
18793099;;F;27;CHILENO;;Millenial;N/D;N/D;396970;3;2;0;0;0;3;2;396970;NTBK 240 G8 Core i3-1005G1/4GB/1TB/14P;COMPUTACION
20281878;;M;21;CHILENO;;Z;N/D;N/D;379990;2;1;2;1;379990;0;0;0;NTBK IP3 Ryzen 3-3250U/8GB/1TB/15P;COMPUTACION
13675270;;M;43;CHILENO;;X;PROVIDENCIA                   ;METROPOLITANA;99990;1;1;1;1;99990;0;0;0;TAB Galaxy A7 Lite (8.7, 32GB, WIFI);COMPUTACION
12776921;;M;46;CHILENO;;X;ANTOFAGASTA                   ;ANTOFAGASTA;149990;1;1;0;0;0;1;1;149990;TAB Galaxy A7 Lite (8.7, 32GB, WIFI + 4G);COMPUTACION
8890738;;M;47;CHILENO;;X;N/D;N/D;432980;2;1;0;0;0;2;1;432980;NTBK IP3 Ryzen 3-3250U/8GB/1TB/15P;COMPUTACION
18423987;;M;29;CHILENO;;Millenial;PROVIDENCIA                   ;METROPOLITANA;239990;2;1;2;1;239990;0;0;0;TAB S6 Lite (610) 4GB 64GB 10.4P BLUE;COMPUTACION
25936651;;M;40;PERUANO;;Extranjero;RENCA                         ;METROPOLITANA;987960;3;1;3;1;987960;0;0;0;NBTK IP3 Core i5-10210U/8GB/512GB SSD/15P;COMPUTACION
18040848;;F;30;CHILENO;;Millenial;PROVIDENCIA                   ;METROPOLITANA;74980;2;1;0;0;0;2;1;74980;TAB MLAB MBX 8 QUAD CORE 1G+16G 8716;COMPUTACION
18098739;;M;29;CHILENO;;Millenial;PUENTE ALTO;METROPOLITANA;163980;2;1;2;1;163980;0;0;0;Galaxy Tab A7 (10.4 ,32GB, WIFI + 4G) Dark Gray;COMPUTACION
17592218;;F;32;CHILENO;;Millenial;N/D;N/D;49990;1;1;1;1;49990;0;0;0;TAB MLAB MBX 8 QUAD CORE 1G+16G 8716;COMPUTACION
7836114;;M;66;CHILENO;;Boomers;LOS ANGELES                   ;BIO BIO;335260;2;1;0;0;0;2;1;335260;NTBK 240 G8 Celeron N4020/4GB/500GB/14P;COMPUTACION
11309776;;M;54;CHILENO;;X;PUNTA ARENAS                  ;MAGALLANES;166460;3;2;0;0;0;3;2;166460;TAB M8 QC 2GB 32GB 8P Gris;COMPUTACION
19021741;;F;27;CHILENO;;Millenial;PROVIDENCIA                   ;METROPOLITANA;318670;5;1;0;0;0;5;1;318670;NTBK 240 G8 Celeron N4020/4GB/500GB/14P;COMPUTACION
7588490;;M;57;CHILENO;;Boomers;PROVIDENCIA                   ;METROPOLITANA;539990;1;1;1;1;539990;0;0;0;NTBK 255 G8 Ryzen 5-5500U/8GB/256GB SSD/15P;COMPUTACION
16076547;;F;36;CHILENO;;Millenial;MAIPU                         ;METROPOLITANA;139990;2;1;2;1;139990;0;0;0;TAB-X306X 10-INCH 4G+64G HD WIFI+4G LTE;COMPUTACION
9649925;;M;59;CHILENO;;Boomers;RANCAGUA                      ;L.G.B.OÂ´HIGGINS;109990;1;1;0;0;0;1;1;109990;TAB Galaxy Tab A+SPen 8Core 3GB 32GB 8 Gris;COMPUTACION
16311651;;F;36;CHILENO;;Millenial;N/D;N/D;249990;1;1;0;0;0;1;1;249990;NTBK 240 G8 Celeron N4020/4GB/500GB/14P;COMPUTACION
17358438;;M;32;CHILENO;;Millenial;N/D;N/D;34990;2;1;2;1;34990;0;0;0;TAB 7 MB4 Plus 4Core 1GB 16GB 7 Plata;COMPUTACION
15406531;;F;40;CHILENO;;X;TALAGANTE                     ;METROPOLITANA;114990;1;1;0;0;0;1;1;114990;MULTIFUNCIONAL ECOTANK L3110;COMPUTACION
19769934;;F;24;CHILENO;;Silencioso;PROVIDENCIA                   ;METROPOLITANA;149990;1;1;0;0;0;1;1;149990;TAB Galaxy A 8 + S Pen (8, 32GB, WIFI);COMPUTACION
13534551;;F;43;CHILENO;;X;OVALLE                        ;COQUIMBO;149990;1;3;0;0;0;1;3;149990;Multifuncional EcoTank L3210;COMPUTACION
15755902;;F;33;CHILENO;;Millenial;RANCAGUA                      ;L.G.B.OÂ´HIGGINS;379990;1;1;1;1;379990;0;0;0;AIO/Athlon 3050U/4GB/1TB + 256GB/UMA/White;COMPUTACION
25212928;;M;27;ECUATORIANO;;Extranjero;COQUIMBO                      ;COQUIMBO;465370;4;1;0;0;0;4;1;465370;NTBK Herobook Celeron N4020/8GB/256SSD/14P FHD;COMPUTACION
12037842;;M;55;CHILENO;;Boomers;ALTO DEL CARMEN               ;ATACAMA;190220;2;1;0;0;0;2;1;190220;TAB Galaxy A7 Lite (8.7, 32GB, WIFI + 4G);COMPUTACION
17569381;;F;31;CHILENO;;Millenial;PROVIDENCIA                   ;METROPOLITANA;629990;2;1;2;1;629990;0;0;0;NTBK Gaming 3 Ryzen 5 4600H 8GB 512SSD G1650 4GB;COMPUTACION
19103181;;M;26;CHILENO;;Silencioso;PROVIDENCIA                   ;METROPOLITANA;639640;2;1;2;1;639640;0;0;0;NTBK Gaming 3 Ryzen 5 4600H 8GB 512SSD G1650 4GB;COMPUTACION
19360909;;F;25;CHILENO;;Z;PROVIDENCIA                   ;METROPOLITANA;119990;1;1;1;1;119990;0;0;0;TAB Galaxy A 8 + S Pen (8, 32GB, WIFI);COMPUTACION
17038765;;F;33;CHILENO;;Millenial;PROVIDENCIA                   ;METROPOLITANA;148640;2;1;2;1;148640;0;0;0;Multifuncional DCPT520W Wifi;COMPUTACION
25826348;;M;45;COLOMBIANO;;Extranjero;MAULE                         ;MAULE;1065670;2;1;0;0;0;2;1;1065670;NTBK GAMER N5 Ci5-10300H/16GB/512SSD/GTX1650 4GB;COMPUTACION
13015797;;M;45;CHILENO;;X;N/D;N/D;468380;3;2;0;0;0;3;2;468380;NTBK GemiBook Celeron/12GB/256GB/2K/Tec-Ingles;COMPUTACION
19196839;Soltero;M;26;CHILENO;;Z;PROVIDENCIA                   ;METROPOLITANA;179990;1;1;1;1;179990;0;0;0;Monitor Emerald 27P 165Hz Full HD;COMPUTACION
26508712;;F;51;CHILENO;;Extranjero;QUINTA NORMAL                 ;METROPOLITANA;345360;3;2;0;0;0;3;2;345360;NTBK IP1 AMD 3020e/4GB/64GB eMMC/14P;COMPUTACION
18012448;Soltero;M;29;CHILENO;;Millenial;PROVIDENCIA                   ;METROPOLITANA;119990;1;1;1;1;119990;0;0;0;TAB Galaxy A 8 + S Pen (8, 32GB, WIFI);COMPUTACION
13153133;Casado;M;45;CHILENO;;X;RENCA                         ;METROPOLITANA;84990;2;1;2;1;84990;0;0;0;Tab M10 HD 2G-32GB 10.1 Iron grey WiFi;COMPUTACION
24986817;;F;28;PERUANO;;Extranjero;N/D;N/D;79990;2;1;2;1;79990;0;0;0;TAB Galaxy A7 Lite (8.7, 32GB, WIFI);COMPUTACION
11630438;;F;52;CHILENO;;X;RENCA                         ;METROPOLITANA;329990;2;1;2;1;329990;0;0;0;NTBK IP3 Athlon 3050U/8GB/1TB/14P;COMPUTACION
19555600;;M;24;CHILENO;;Silencioso;PROVIDENCIA                   ;METROPOLITANA;478540;2;1;2;1;478540;0;0;0;TAB Galaxy S7 FE (12.4, 64GB WIFI) BLACK;COMPUTACION
15369440;;M;39;CHILENO;;X;N/D;N/D;113980;2;1;2;1;113980;0;0;0;Monitor 23,8 (1920 x 1080) con panel IPS 169;COMPUTACION
18006482;;M;30;CHILENO;;Millenial;PROVIDENCIA                   ;METROPOLITANA;99990;1;1;0;0;0;1;1;99990;TAB Galaxy A7 Lite (8.7, 32GB, WIFI + 4G);COMPUTACION
17600805;;F;31;CHILENO;;Millenial;CALAMA                        ;ANTOFAGASTA;469970;3;2;3;2;469970;0;0;0;Galaxy Tab A7 (10.4 ,32GB, WIFI) Dark Gray;COMPUTACION
14044486;;F;41;CHILENO;;X;N/D;N/D;361540;2;1;2;1;361540;0;0;0;NTBK GemiBook Celeron/12GB/256GB/2K/Tec-Ingles;COMPUTACION
19308732;;F;26;CHILENO;;Silencioso;PROVIDENCIA                   ;METROPOLITANA;546000;1;1;1;1;546000;0;0;0;NTBK M14 Ryzen 5-5500U 8GB/256GB SSD/14P FHD;COMPUTACION
19775576;;F;23;CHILENO;;Z;PROVIDENCIA                   ;METROPOLITANA;19980;2;1;2;1;19980;0;0;0;TINTA 664 TRI COLOR;COMPUTACION
13002635;Soltero;F;46;CHILENO;;X;COIHAIQUE                     ;AYSEN;299990;1;1;0;0;0;1;1;299990;NTBK IP3 Athlon 3050U/8GB/1TB/14P;COMPUTACION
9881378;;M;52;CHILENO;;X;PROVIDENCIA                   ;METROPOLITANA;89990;2;1;2;1;89990;0;0;0;TAB Galaxy A7 Lite (8.7, 32GB, WIFI);COMPUTACION
17566536;;M;32;CHILENO;;Millenial;N/D;N/D;1204980;2;1;2;1;1204980;0;0;0;IMAC 24 BLU/8C CPU/7C GPU/8GB/256GB (MJV93CI/A);COMPUTACION
18512664;;F;29;CHILENO;;Silencioso;PROVIDENCIA                   ;METROPOLITANA;629990;2;1;2;1;629990;0;0;0;NTBK Gaming 3 Ryzen 5 4600H 8GB 512SSD G1650 4GB;COMPUTACION
6847948;Casado;M;67;CHILENO;INGENIERO CIVIL;Boomers;SANTIAGO                      ;METROPOLITANA;7990;1;1;0;0;0;1;1;7990;T544 DYE BLACK INK BOTTLE (65ml);COMPUTACION
19146756;Soltero;F;27;CHILENO;TECNICO EN ADMINISTRACION DE EMPRESAS;Z;PROVIDENCIA                   ;METROPOLITANA;79990;1;1;1;1;79990;0;0;0;Tab M10 HD 2G-32GB 10.1 Iron grey WiFi;COMPUTACION
19665862;;M;23;CHILENO;;Z;PROVIDENCIA                   ;METROPOLITANA;474980;2;1;2;1;474980;0;0;0;TAB Galaxy S7 FE (12.4, 64GB WIFI) BLACK;COMPUTACION
17375326;;M;32;CHILENO;;Silencioso;PROVIDENCIA                   ;METROPOLITANA;89990;2;1;2;1;89990;0;0;0;TAB Galaxy A7 Lite (8.7, 32GB, WIFI);COMPUTACION
25233576;;F;43;PERUANO;;X;LAMPA                         ;METROPOLITANA;457070;2;1;0;0;0;2;1;457070;AIO/Athlon 3050U/4GB/1TB + 256GB/UMA/White;COMPUTACION
16539695;;M;35;CHILENO;;Silencioso;PROVIDENCIA                   ;METROPOLITANA;290970;3;1;3;1;290970;0;0;0;NTBK Herobook Celeron N4020/8GB/256SSD/14P FHD;COMPUTACION
24496789;Casado;M;34;VENEZOLANO;;Extranjero;PROVIDENCIA                   ;METROPOLITANA;333980;2;1;2;1;333980;0;0;0;NTBK IP3 Athlon 3050U/8GB/1TB/14P;COMPUTACION
16556087;;F;35;CHILENO;;Millenial;RENCA                         ;METROPOLITANA;35480;2;1;2;1;35480;0;0;0;Impresora Laser HL-1202 Monocromatica;COMPUTACION
7778332;;M;51;CHILENO;;X;PROVIDENCIA                   ;METROPOLITANA;1053980;2;1;2;1;1053980;0;0;0;NTBK Legion 5 R7 16GB 1TB 128SSD 6V W10H;COMPUTACION
18562325;;F;29;CHILENO;;Millenial;N/D;N/D;23970;3;1;0;0;0;3;1;23970;T544 DYE MAGENTA INK BOTTLE (65ml);COMPUTACION
9054464;;M;61;CHILENO;;Boomers;PROVIDENCIA                   ;METROPOLITANA;63670;2;1;0;0;0;2;1;63670;Impresora Monofuncional Laser 107w;COMPUTACION
17518477;;F;32;CHILENO;;Millenial;N/D;N/D;150980;2;1;0;0;0;2;1;150980;MULTIFUNCIONAL ECOTANK L3110;COMPUTACION
15018333;Soltero;F;35;CHILENO;INGENIERO COMERCIAL;Millenial;RENCA                         ;METROPOLITANA;797870;2;1;0;0;0;2;1;797870;NTBK 15-dk1028la Ci5-10300H/8GB/256SSD/1050 3GB;COMPUTACION
12674131;;M;48;CHILENO;;Millenial;N/D;N/D;212570;2;1;0;0;0;2;1;212570;Galaxy Tab A7 (10.4 ,32GB, WIFI) Dark Gray;COMPUTACION
12648902;;M;49;CHILENO;;X;N/D;N/D;349940;5;2;5;2;349940;0;0;0;Multifuncional DCPT720DW Wifi, Duplex y ADF;COMPUTACION
18421266;;F;28;CHILENO;;Silencioso;PROVIDENCIA                   ;METROPOLITANA;703980;2;1;2;1;703980;0;0;0;NTBK Gaming 3 Ryzen 5 4600H 8GB 512SSD G1650 4GB;COMPUTACION
17164785;;F;33;CHILENO;;Silencioso;PROVIDENCIA                   ;METROPOLITANA;169990;1;1;0;0;0;1;1;169990;MULTIFUNCIONAL ECOTANK L3150 Wifi;COMPUTACION
16811479;;M;33;CHILENO;;Millenial;PROVIDENCIA                   ;METROPOLITANA;259980;2;1;2;1;259980;0;0;0;Galaxy Tab A7 (10.4 ,32GB, WIFI) Dark Gray;COMPUTACION
14683505;;F;63;PERUANO;;Extranjero;SANTIAGO                      ;METROPOLITANA;105370;2;1;0;0;0;2;1;105370;Tab M7 1G-16GB 7 IPS HD LTE/4G;COMPUTACION
18624464;;M;28;CHILENO;;Silencioso;PROVIDENCIA                   ;METROPOLITANA;703980;2;1;2;1;703980;0;0;0;NTBK Gaming 3 Ryzen 5 4600H 8GB 512SSD G1650 4GB;COMPUTACION
15192073;;M;40;CHILENO;;Silencioso;PROVIDENCIA                   ;METROPOLITANA;435190;2;1;0;0;0;2;1;435190;NTBK Herobook Celeron N4020/8GB/256SSD/14P FHD;COMPUTACION
13670563;;M;43;CHILENO;;X;PROVIDENCIA                   ;METROPOLITANA;0;0;0;0;0;0;0;0;0;TINTA 664 TRI COLOR;COMPUTACION
17683715;Soltero;M;31;CHILENO;NUTRICIONISTA;Millenial;PROVIDENCIA                   ;METROPOLITANA;0;0;0;0;0;0;0;0;0;Multifuncional DCPT720DW Wifi, Duplex y ADF;COMPUTACION
11213009;;M;55;CHILENO;;Boomers;CALAMA                        ;ANTOFAGASTA;0;0;0;0;0;0;0;0;0;TAB Galaxy S6 Lite +Book Cover (10.4,64GB,WIFI+4;COMPUTACION
13190152;;M;45;CHILENO;;X;VILLA ALEMANA                 ;VALPARAISO;0;0;0;0;0;0;0;0;0;Multifuncional XP-2101 wifi;COMPUTACION
19146738;;M;27;CHILENO;;Z;N/D;N/D;0;0;0;0;0;0;0;0;0;NTBK 240 G8 Core i3-1005G1/4GB/1TB/14P;COMPUTACION
19063827;;F;27;CHILENO;;Silencioso;PROVIDENCIA                   ;METROPOLITANA;0;0;0;0;0;0;0;0;0;Multifuncional DCPT720DW Wifi, Duplex y ADF;COMPUTACION
10993401;;F;51;CHILENO;;X;ARICA                         ;TARAPACA;0;0;0;0;0;0;0;0;0;TAB Galaxy Tab A+SPen 8Core 3GB 32GB 8 Gris;COMPUTACION
19720483;;F;25;CHILENO;;Z;PROVIDENCIA                   ;METROPOLITANA;0;0;0;0;0;0;0;0;0;Tab M10 HD 2G-32GB 10.1 Iron grey WiFi;COMPUTACION
17988319;;M;31;CHILENO;;Millenial;N/D;N/D;0;0;0;0;0;0;0;0;0;Galaxy Tab A7 (10.4 ,32GB, WIFI + 4G) Dark Gray;COMPUTACION
8503917;;M;58;CHILENO;;Boomers;PROVIDENCIA                   ;METROPOLITANA;0;0;0;0;0;0;0;0;0;TAB 7 MB4 Plus 4Core 1GB 16GB 7 Plata;COMPUTACION
13138237;;F;45;CHILENO;;X;BULNES                        ;BIO BIO;0;0;0;0;0;0;0;0;0;NTBK 14-ck2091la i3-10110U 4GB 128GB 14 HD;COMPUTACION
11095294;;F;55;CHILENO;;Boomers;PUERTO VARAS                  ;LOS LAGOS;0;0;0;0;0;0;0;0;0;Multifuncional Ink Tank 415 Wifi;COMPUTACION
8574535;;M;63;CHILENO;;Silencioso;PROVIDENCIA                   ;METROPOLITANA;0;0;0;0;0;0;0;0;0;Tab Yoga Smart;COMPUTACION
17763242;;F;31;CHILENO;;Millenial;N/D;N/D;0;0;0;0;0;0;0;0;0;Multifuncional DCPT720DW Wifi, Duplex y ADF;COMPUTACION
8906443;;F;62;CHILENO;;Boomers;PROVIDENCIA                   ;METROPOLITANA;0;0;0;0;0;0;0;0;0;NTBK GemiBook Celeron/12GB/256GB/2K/Tec-Ingles;COMPUTACION
21850818;;M;59;PERUANO;;Extranjero;N/D;N/D;0;0;0;0;0;0;0;0;0;Tab M10 HD 2G-32GB 10.1 Iron grey WiFi;COMPUTACION
18986644;;F;26;CHILENO;;Z;PROVIDENCIA                   ;METROPOLITANA;0;0;0;0;0;0;0;0;0;MULTIFUNCIONAL ECOTANK L3110;COMPUTACION
17393120;Soltero;M;32;CHILENO;INGENIERO METALURGICO;Millenial;PROVIDENCIA                   ;METROPOLITANA;0;0;0;0;0;0;0;0;0;NTBK 348G7 i3-10110U 14 4GB/1T PC WHOME;COMPUTACION
18826853;;F;27;CHILENO;;Millenial;CALAMA                        ;ANTOFAGASTA;0;0;0;0;0;0;0;0;0;NTBK GemiBook Celeron/12GB/256GB/2K/Tec-Ingles;COMPUTACION
16917278;;F;33;CHILENO;;Millenial;N/D;N/D;0;0;0;0;0;0;0;0;0;Multifuncional DCPT520W Wifi;COMPUTACION
10579783;;F;51;CHILENO;;X;MACUL                         ;METROPOLITANA;0;0;0;0;0;0;0;0;0;Monitor 24 FHD 75Hz HDMI VGA/Flat IPS/Black;COMPUTACION
17757184;Casado;F;31;CHILENO;;Millenial;COIHUECO                      ;BIO BIO;0;0;0;0;0;0;0;0;0;Tab M10 HD 2G-32GB 10.1 Iron grey WiFi;COMPUTACION
26079866;;F;32;VENEZOLANO;;Extranjero;"";"";0;0;0;0;0;0;0;0;0;NTBK 15-dk1028la Ci5-10300H/8GB/256SSD/1050 3GB;COMPUTACION
15198467;;M;39;CHILENO;;X;N/D;N/D;0;0;0;0;0;0;0;0;0;NTBK 348G7 i3-10110U 14 4GB/1T PC WHOME;COMPUTACION
10586761;;F;55;CHILENO;;Boomers;N/D;N/D;0;0;0;0;0;0;0;0;0;MULTIFUNCIONAL ECOTANK L3150 Wifi;COMPUTACION
16964912;;F;33;CHILENO;;Millenial;NATALES                       ;MAGALLANES;0;0;0;0;0;0;0;0;0;NTBK 14-ck2091la i3-10110U 4GB 128GB 14 HD;COMPUTACION
17847821;;F;30;CHILENO;;Millenial;N/D;N/D;0;0;0;0;0;0;0;0;0;Multifuncional Smart tank 530 WiFi ADF;COMPUTACION
19066963;;F;26;CHILENO;;Z;N/D;N/D;0;0;0;0;0;0;0;0;0;Galaxy Tab A7 (10.4 ,32GB, WIFI) Dark Gray;COMPUTACION
8162289;;M;59;CHILENO;;Boomers;PROVIDENCIA                   ;METROPOLITANA;0;0;0;0;0;0;0;0;0;MULTIFUNCIONAL ECOTANK L5190 Wifi/ Fax;COMPUTACION
16084138;;F;37;CHILENO;;Silencioso;PROVIDENCIA                   ;METROPOLITANA;0;0;0;0;0;0;0;0;0;MULTIFUNCIONAL ECOTANK L3110;COMPUTACION
12816532;;M;47;CHILENO;;X;LA LIGUA                      ;VALPARAISO;0;0;0;0;0;0;0;0;0;MULTIFUNCIONAL ECOTANK L4160 Wifi;COMPUTACION
7009298;;M;69;CHILENO;;Silencioso;QUILLOTA                      ;VALPARAISO;0;0;0;0;0;0;0;0;0;TAB Galaxy A7 Lite (8.7, 32GB, WIFI + 4G);COMPUTACION
20344951;;M;22;CHILENO;;Silencioso;PROVIDENCIA                   ;METROPOLITANA;0;0;0;0;0;0;0;0;0;Monitor 23.6 FHD HDMI 24GL600F Negro;COMPUTACION
7622717;;F;65;CHILENO;;Boomers;RENCA                         ;METROPOLITANA;0;0;0;0;0;0;0;0;0;Tab M10 HD 2G-32GB 10.1 Iron grey WiFi;COMPUTACION
13485962;;F;44;CHILENO;;X;LA PINTANA                    ;METROPOLITANA;0;0;0;0;0;0;0;0;0;Tab M10 HD 2G-32GB 10.1 Iron grey WiFi;COMPUTACION
16208909;Casado;M;36;CHILENO;;Silencioso;PROVIDENCIA                   ;METROPOLITANA;0;0;0;0;0;0;0;0;0;NTBK Y11 11.6 Intel Celeron 8GB RAM + 256GB SDD;COMPUTACION
12376693;;M;49;CHILENO;;Silencioso;PROVIDENCIA                   ;METROPOLITANA;0;0;0;0;0;0;0;0;0;NTBK 15-dk1028la Ci5-10300H/8GB/256SSD/1050 3GB;COMPUTACION
15172614;;F;37;CHILENO;;Millenial;CONCEPCION                    ;BIO BIO;0;0;0;0;0;0;0;0;0;TAB P11 6GB 128GB Platinium Grey;COMPUTACION
6413135;;F;77;CHILENO;;Silencioso;N/D;N/D;0;0;0;0;0;0;0;0;0;NTBK 240 G8 Core i3-1005G1/4GB/1TB/14P;COMPUTACION
12474945;Soltero;M;48;CHILENO;;Millenial;"";"";0;0;0;0;0;0;0;0;0;Monitor 24 FHD 75Hz HDMI VGA/Flat IPS/White;COMPUTACION
6606068;;M;68;CHILENO;;Boomers;ARICA                         ;ARICA Y PARINACOTA;0;0;0;0;0;0;0;0;0;Tab M10 HD 2G-32GB 10.1 Iron grey WiFi;COMPUTACION
14047915;;F;41;CHILENO;;Silencioso;PROVIDENCIA                   ;METROPOLITANA;0;0;0;0;0;0;0;0;0;Multifuncional DCPT220;COMPUTACION
17413275;Soltero;M;32;CHILENO;;Silencioso;PROVIDENCIA                   ;METROPOLITANA;0;0;0;0;0;0;0;0;0;Galaxy Tab A7 (10.4 ,32GB, WIFI) Dark Gray;COMPUTACION
10796054;;M;49;CHILENO;;Millenial;"";"";0;0;0;0;0;0;0;0;0;NTBK 15-dk1043la i5-10300H 8GB512SSD4V W10H;COMPUTACION
18412290;;F;28;CHILENO;;Millenial;VALPARAISO                    ;VALPARAISO;0;0;0;0;0;0;0;0;0;MULTIFUNCIONAL ECOTANK L3110;COMPUTACION
16571169;;M;35;CHILENO;;Millenial;"";"";0;0;0;0;0;0;0;0;0;NTBK 15-dk1028la Ci5-10300H/8GB/256SSD/1050 3GB;COMPUTACION
18354077;;F;29;CHILENO;;Millenial;PROVIDENCIA                   ;METROPOLITANA;0;0;0;0;0;0;0;0;0;Galaxy Tab A7 (10.4 ,32GB, WIFI) Silver;COMPUTACION
12288327;;F;49;CHILENO;;X;PROVIDENCIA                   ;METROPOLITANA;0;0;0;0;0;0;0;0;0;Tab M10 HD 2G-32GB 10.1 Iron grey WiFi;COMPUTACION
17868882;;F;31;CHILENO;;Millenial;PROVIDENCIA                   ;METROPOLITANA;0;0;0;0;0;0;0;0;0;TAB Galaxy Tab A 8 4Core 2GB 32GB 8 Gris;COMPUTACION
17118857;Soltero;M;33;CHILENO;INGENIERO INFORMATICO;Millenial;PROVIDENCIA                   ;METROPOLITANA;0;0;0;0;0;0;0;0;0;Router Huawei AX3 WIFI Quad core;COMPUTACION
17126887;;F;33;CHILENO;;Millenial;LOS ANGELES                   ;BIO BIO;0;0;0;0;0;0;0;0;0;TAB Galaxy S6 Lite +Book Cover (10.4,64GB,WIFI+4;COMPUTACION
10973028;;M;46;CHILENO;;X;COIHAIQUE                     ;AYSEN;0;0;0;0;0;0;0;0;0;NTBK Y11 11.6 Intel Celeron 8GB RAM + 256GB SDD;COMPUTACION
16402072;;M;36;CHILENO;;Millenial;LAS CONDES                    ;METROPOLITANA;0;0;0;0;0;0;0;0;0;Galaxy Tab A7 (10.4 ,32GB, WIFI) Silver;COMPUTACION
19308312;;F;26;CHILENO;;Z;PROVIDENCIA                   ;METROPOLITANA;0;0;0;0;0;0;0;0;0;NTBK 14-ck2096la CeleronN4020 4GB500GB W10H;COMPUTACION
16104674;;F;36;CHILENO;;Millenial;N/D;N/D;0;0;0;0;0;0;0;0;0;NTBK 15-dk1028la Ci5-10300H/8GB/256SSD/1050 3GB;COMPUTACION
16433389;;F;35;CHILENO;;Millenial;SANTA CRUZ                    ;L.G.B.OÂ´HIGGINS;0;0;0;0;0;0;0;0;0;AIO 21-b0021la Pentium J5040 8GB 1TB;COMPUTACION
19903469;;M;24;CHILENO;;Silencioso;PROVIDENCIA                   ;METROPOLITANA;0;0;0;0;0;0;0;0;0;NTBK 15-dk1043la i5-10300H 8GB512SSD4V W10H;COMPUTACION
8363504;;F;64;CHILENO;;Boomers;RENCA                         ;METROPOLITANA;0;0;0;0;0;0;0;0;0;NTBK 15-dk1028la Ci5-10300H/8GB/256SSD/1050 3GB;COMPUTACION
17066085;;F;33;CHILENO;;Millenial;PROVIDENCIA                   ;METROPOLITANA;0;0;0;0;0;0;0;0;0;NTBK INSPIRON 15 3505 AMD ATHLON SILVER 8GB 256G;COMPUTACION
8634837;;M;60;CHILENO;;Boomers;SAN FERNANDO                  ;L.G.B.OÂ´HIGGINS;0;0;0;0;0;0;0;0;0;MULTIFUNCIONAL ECOTANK L4160 Wifi;COMPUTACION
20628126;;F;21;CHILENO;;Z;PROVIDENCIA                   ;METROPOLITANA;0;0;0;0;0;0;0;0;0;NTBK 14-cf2051la i3-10110U 4GB 256GB+16GB 14 HD;COMPUTACION
8049395;Casado;F;61;CHILENO;;Boomers;RENCA                         ;METROPOLITANA;0;0;0;0;0;0;0;0;0;Multifuncional Smart Tank 515 Wifi;COMPUTACION
15027001;;F;39;CHILENO;;Silencioso;PROVIDENCIA                   ;METROPOLITANA;0;0;0;0;0;0;0;0;0;TAB M7 QC 1GB 8GB 7P Gris;COMPUTACION
10049123;;M;53;CHILENO;;X;TALCA                         ;MAULE;0;0;0;0;0;0;0;0;0;AIO 21-b0021la Pentium J5040 8GB 1TB;COMPUTACION
15471526;;M;39;CHILENO;;Silencioso;PROVIDENCIA                   ;METROPOLITANA;0;0;0;0;0;0;0;0;0;Multifuncional Laser DCP-1602 Monocromatica;COMPUTACION
17952384;Soltero;F;30;CHILENO;KINESIOLOGA;Silencioso;PROVIDENCIA                   ;METROPOLITANA;0;0;0;0;0;0;0;0;0;NTBK 15-dk1043la i5-10300H 8GB512SSD4V W10H;COMPUTACION
26280192;;M;34;HAITIANO;;Extranjero;CALERA                        ;VALPARAISO;0;0;0;0;0;0;0;0;0;TAB Galaxy Tab A 8 4G 4Core 2GB 32GB 8 Gris;COMPUTACION
19148187;Soltero;M;26;CHILENO;;Silencioso;PROVIDENCIA                   ;METROPOLITANA;0;0;0;0;0;0;0;0;0;MONITOR 22x 21.5-inch Display;COMPUTACION
19262522;;M;26;CHILENO;;Z;"";"";0;0;0;0;0;0;0;0;0;MULTIFUNCIONAL ECOTANK L4160 Wifi;COMPUTACION
16845508;;M;34;CHILENO;;Millenial;PROVIDENCIA                   ;METROPOLITANA;0;0;0;0;0;0;0;0;0;AIO 21-b0021la Pentium J5040 8GB 1TB;COMPUTACION
19498424;;F;25;CHILENO;;Z;PROVIDENCIA                   ;METROPOLITANA;0;0;0;0;0;0;0;0;0;NTBK 14-cf2051la i3-10110U 4GB 256GB+16GB 14 HD;COMPUTACION
26399513;;M;28;VENEZOLANO;;Extranjero;N/D;N/D;0;0;0;0;0;0;0;0;0;Monitor 27 TN HDMI/VESA 27MK400H Negro;COMPUTACION
12857662;;F;47;CHILENO;;X;PROVIDENCIA                   ;METROPOLITANA;0;0;0;0;0;0;0;0;0;NTBK 15-dk1043la i5-10300H 8GB512SSD4V W10H;COMPUTACION
17727428;Soltero;M;31;CHILENO;INGENIERO EN MINAS Y METALURGIA;Silencioso;PROVIDENCIA                   ;METROPOLITANA;0;0;0;0;0;0;0;0;0;TAB S6 Lite (610) 4GB 64GB 10.4P BLUE;COMPUTACION
7393502;;M;68;CHILENO;;Silencioso;CATEMU                        ;VALPARAISO;0;0;0;0;0;0;0;0;0;Galaxy Tab A7 (10.4 ,32GB, WIFI + 4G) Dark Gray;COMPUTACION
18975288;;F;27;CHILENO;;Millenial;CHANARAL                      ;ATACAMA;0;0;0;0;0;0;0;0;0;TAB M7 7 1GB RAM 8 GB ROM Platinum Grey;COMPUTACION
12212304;;M;50;CHILENO;;X;ALTO HOSPICIO;TARAPACA;0;0;0;0;0;0;0;0;0;NTBK 14-ck2091la i3-10110U 4GB 128GB 14 HD;COMPUTACION
12397179;;M;48;CHILENO;;Silencioso;PROVIDENCIA                   ;METROPOLITANA;0;0;0;0;0;0;0;0;0;NTBK 14-dq1004la Core i5-1035G1 8GB 256SSD 14P;COMPUTACION
18285156;;F;30;CHILENO;;Millenial;MARIQUINA                     ;LOS LAGOS;0;0;0;0;0;0;0;0;0;TAB MBXR 8717 4Core 2GB 16GB 10 Negra;COMPUTACION
15582128;;M;38;CHILENO;;Millenial;RENCA                         ;METROPOLITANA;0;0;0;0;0;0;0;0;0;TABLET GALAXY S7 (T870) 128GB 11P Negra;COMPUTACION
18316057;;F;28;CHILENO;;Millenial;"";"";0;0;0;0;0;0;0;0;0;MULTIFUNCIONAL ECOTANK L3150 Wifi;COMPUTACION
15191914;;M;40;CHILENO;;X;CORONEL                       ;BIO BIO;0;0;0;0;0;0;0;0;0;MULTIFUNCIONAL ECOTANK L3150 Wifi;COMPUTACION
18173585;Soltero;M;29;CHILENO;;Silencioso;PROVIDENCIA                   ;METROPOLITANA;0;0;0;0;0;0;0;0;0;NTBK 14-dq1004la Core i5-1035G1 8GB 256SSD 14P;COMPUTACION
20284823;;M;22;CHILENO;;Silencioso;PROVIDENCIA                   ;METROPOLITANA;0;0;0;0;0;0;0;0;0;IPAD WI-FI 32GB GOLD (MYLC2CI/A);COMPUTACION
17385414;;M;32;CHILENO;;Millenial;LA PINTANA                    ;METROPOLITANA;0;0;0;0;0;0;0;0;0;AIO 21-b0021la Pentium J5040 8GB 1TB;COMPUTACION
9957464;;M;54;CHILENO;;X;PROVIDENCIA                   ;METROPOLITANA;0;0;0;0;0;0;0;0;0;NTBK 14-dk1004la OPP R3-3250U DC 4GB 1TB 14INHD;COMPUTACION
19896189;;F;23;CHILENO;;Z;PROVIDENCIA                   ;METROPOLITANA;0;0;0;0;0;0;0;0;0;NTBK 14-ck2091la i3-10110U 4GB 128GB 14 HD;COMPUTACION
13851003;;M;41;CHILENO;;X;PROVIDENCIA                   ;METROPOLITANA;0;0;0;0;0;0;0;0;0;Multifuncional Ink Tank 415 Wifi;COMPUTACION
10191323;;M;57;CHILENO;;Boomers;LANCO                         ;LOS LAGOS;0;0;0;0;0;0;0;0;0;TAB Galaxy Tab A 8 4Core 2GB 32GB 8 Gris;COMPUTACION
11954209;Soltero;F;50;CHILENO;;X;RENCA                         ;METROPOLITANA;0;0;0;0;0;0;0;0;0;NTBK 245 G7 AMD Ryzen 5 3500U 8GB 1TB 14P;COMPUTACION
18085031;Soltero;M;30;CHILENO;;Millenial;PROVIDENCIA                   ;METROPOLITANA;0;0;0;0;0;0;0;0;0;TAB S6 Lite (610) 4GB 64GB 10.4P DARK GREY;COMPUTACION
19841752;;F;24;CHILENO;;Silencioso;PROVIDENCIA                   ;METROPOLITANA;0;0;0;0;0;0;0;0;0;Multifuncional Laser DCP-1602 Monocromatica;COMPUTACION
17734851;;F;31;CHILENO;;Millenial;ANTOFAGASTA                   ;ANTOFAGASTA;0;0;0;0;0;0;0;0;0;TAB Galaxy Tab A 8 4Core 2GB 32GB 8 Negra;COMPUTACION
19595076;;F;25;CHILENO;;Z;PROVIDENCIA                   ;METROPOLITANA;0;0;0;0;0;0;0;0;0;TAB S6 Lite (610) 4GB 64GB 10.4P BLUE;COMPUTACION
12509061;;F;49;CHILENO;;X;RENCA                         ;METROPOLITANA;0;0;0;0;0;0;0;0;0;Tab M10 HD 2G-32GB 10.1 Iron grey WiFi;COMPUTACION
13337076;;M;44;CHILENO;;X;LO PRADO                      ;METROPOLITANA;0;0;0;0;0;0;0;0;0;NTBK 15-dk1043la i5-10300H 8GB512SSD4V W10H;COMPUTACION
8387299;Divorciado;F;62;CHILENO;PROFESOR;Boomers;PROVIDENCIA                   ;METROPOLITANA;0;0;0;0;0;0;0;0;0;Multifuncional Ink Tank 415 Wifi;COMPUTACION
18666205;Soltero;M;28;CHILENO;TECNICO EN ADMINISTRACION DE EMPRESAS;Millenial;PROVIDENCIA                   ;METROPOLITANA;0;0;0;0;0;0;0;0;0;NTBK 15-dk1043la i5-10300H 8GB512SSD4V W10H;COMPUTACION
18331066;;F;28;CHILENO;;Millenial;PROVIDENCIA                   ;METROPOLITANA;0;0;0;0;0;0;0;0;0;TAB Galaxy Tab A 8 4G 4Core 2GB 32GB 8 Gris;COMPUTACION
6359196;;F;73;CHILENO;;Silencioso;LA PINTANA                    ;METROPOLITANA;0;0;0;0;0;0;0;0;0;iPad Air 10.9 Wi-Fi 64GB - Space Grey / Apple;COMPUTACION
19190949;Soltero;M;26;CHILENO;ENFERMERO;Z;PROVIDENCIA                   ;METROPOLITANA;0;0;0;0;0;0;0;0;0;TABLET GALAXY S7 (T870) 128GB 11P Negra;COMPUTACION
11536232;;M;52;CHILENO;;X;TEMUCO                        ;ARAUCANIA;0;0;0;0;0;0;0;0;0;TAB M8 QC 2GB 32GB 8P Gris;COMPUTACION
17094362;;M;34;CHILENO;;Millenial;IQUIQUE                       ;TARAPACA;0;0;0;0;0;0;0;0;0;TAB Matepad T10S 3GB 64GB 10P;COMPUTACION
11837913;;M;50;CHILENO;;X;TALAGANTE                     ;METROPOLITANA;0;0;0;0;0;0;0;0;0;TAB Galaxy Tab A 8 4Core 2GB 32GB 8 Gris;COMPUTACION
18442244;;F;29;CHILENO;;Millenial;PUDAHUEL                      ;METROPOLITANA;0;0;0;0;0;0;0;0;0;TAB GAMER 7 QUAD CORE 2G+16G 8715;COMPUTACION
16835273;;F;34;CHILENO;;Millenial;SAN VICENTE                   ;L.G.B.OÂ´HIGGINS;0;0;0;0;0;0;0;0;0;NTBK HP da0083la Pentium N5000/8GB/1TB Gray 15P;COMPUTACION
19799093;;F;23;CHILENO;;Silencioso;PROVIDENCIA                   ;METROPOLITANA;0;0;0;0;0;0;0;0;0;IPAD WI-FI 32GB GOLD (MYLC2CI/A);COMPUTACION
18129099;Soltero;F;30;CHILENO;MATRONA;Millenial;PROVIDENCIA                   ;METROPOLITANA;0;0;0;0;0;0;0;0;0;Notebook Ideapad Flex 5 i3;COMPUTACION
18480252;;F;29;CHILENO;;Millenial;LA FLORIDA                    ;METROPOLITANA;0;0;0;0;0;0;0;0;0;NTBK 15-cw1006la Ryzen 7-3700U 8GB 512SSD 15P;COMPUTACION
12700332;;F;48;CHILENO;;X;SAN PEDRO DE LA PAZ           ;BIO BIO;0;0;0;0;0;0;0;0;0;TAB S6 Lite (610) 4GB 64GB 10.4P BLUE;COMPUTACION
19795911;;M;23;CHILENO;;Z;PROVIDENCIA                   ;METROPOLITANA;0;0;0;0;0;0;0;0;0;Impresora Laser HL-1202 Monocromatica;COMPUTACION
12355862;;M;49;CHILENO;;X;PROVIDENCIA                   ;METROPOLITANA;0;0;0;0;0;0;0;0;0;TAB Galaxy Tab A 8 4Core 2GB 32GB 8 Negra;COMPUTACION
18286635;Soltero;F;29;CHILENO;PROFESOR;Millenial;PROVIDENCIA                   ;METROPOLITANA;0;0;0;0;0;0;0;0;0;TAB S6 Lite (610) 4GB 64GB 10.4P DARK GREY;COMPUTACION
18311146;Soltero;F;29;CHILENO;INGENIERO EN PREVENCION DE RIESGOS;Millenial;PROVIDENCIA                   ;METROPOLITANA;0;0;0;0;0;0;0;0;0;NTBK 245 G7 AMD Ryzen 5 3500U 8GB 1TB 14P;COMPUTACION
11109183;Casado;M;55;CHILENO;DISENADOR DE AMBIENTES;Boomers;RENCA                         ;METROPOLITANA;0;0;0;0;0;0;0;0;0;NTBK 14-cf2051la i3-10110U 4GB 256GB+16GB 14 HD;COMPUTACION
6285422;;M;64;CHILENO;;Silencioso;PROVIDENCIA                   ;METROPOLITANA;0;0;0;0;0;0;0;0;0;NTBK Inspiron 5301 Intel Core i5 11TH 8GB 256SSD;COMPUTACION
19085386;Soltero;F;26;CHILENO;;Z;PROVIDENCIA                   ;METROPOLITANA;0;0;0;0;0;0;0;0;0;TAB S6 Lite (610) 4GB 64GB 10.4P PINK;COMPUTACION
10535674;;M;56;CHILENO;;Boomers;PROVIDENCIA                   ;METROPOLITANA;0;0;0;0;0;0;0;0;0;TAB Galaxy Tab A 8 4Core 2GB 32GB 8 Gris;COMPUTACION
15118211;Casado;F;39;CHILENO;PROFESOR;X;RENCA                         ;METROPOLITANA;0;0;0;0;0;0;0;0;0;MULTIFUNCIONAL ECOTANK L5190 Wifi/ Fax;COMPUTACION
13708632;;M;43;CHILENO;;X;N/D;N/D;0;0;0;0;0;0;0;0;0;MULTIFUNCIONAL ECOTANK L3110;COMPUTACION
16394705;;F;36;CHILENO;;Millenial;LINARES                       ;MAULE;0;0;0;0;0;0;0;0;0;NTBK 14-ck2091la i3-10110U 4GB 128GB 14 HD;COMPUTACION
15705232;;F;39;CHILENO;;X;PROVIDENCIA                   ;METROPOLITANA;0;0;0;0;0;0;0;0;0;NTBK 15-cw1006la Ryzen 7-3700U 8GB 512SSD 15P;COMPUTACION
6163110;;M;69;CHILENO;;Silencioso;SANTA CRUZ                    ;L.G.B.OÂ´HIGGINS;0;0;0;0;0;0;0;0;0;Multifuncional DCPT520W Wifi;COMPUTACION
17029427;Soltero;M;33;CHILENO;;Millenial;PROVIDENCIA                   ;METROPOLITANA;0;0;0;0;0;0;0;0;0;NTBK G5 5500 Core i7 10750H 16GB 512SSD 2060 6GB;COMPUTACION
16611911;;M;34;CHILENO;;Millenial;PROVIDENCIA                   ;METROPOLITANA;0;0;0;0;0;0;0;0;0;NTBK VOSTRO 5402 Ci7-1165G7 8GB 256SSD WinPro;COMPUTACION
8692573;;M;63;CHILENO;;Boomers;CURICO                        ;MAULE;0;0;0;0;0;0;0;0;0;Tab M10 Plus FHD 4GB 64GB 10.3P platinum grey;COMPUTACION
13569549;;F;43;CHILENO;;X;N/D;N/D;0;0;0;0;0;0;0;0;0;NTBK G7 240 Intel Celeron 4GB 500GB 14;COMPUTACION
17272810;;M;32;CHILENO;;Millenial;LIMACHE                       ;VALPARAISO;0;0;0;0;0;0;0;0;0;NTBK 14-dq1004la Core i5-1035G1 8GB 256SSD 14P;COMPUTACION
19521052;;F;25;CHILENO;;Z;PROVIDENCIA                   ;METROPOLITANA;0;0;0;0;0;0;0;0;0;TINTA 664 NEGRA;COMPUTACION
20261282;;F;22;CHILENO;;Silencioso;PROVIDENCIA                   ;METROPOLITANA;0;0;0;0;0;0;0;0;0;Macbook Air Core I5 8GB 128SSD 13P;COMPUTACION
19183707;Soltero;F;27;CHILENO;;Silencioso;PROVIDENCIA                   ;METROPOLITANA;0;0;0;0;0;0;0;0;0;TAB Galaxy Tab A 8 4Core 2GB 32GB 8 Gris;COMPUTACION
12621098;;M;48;CHILENO;;X;PROVIDENCIA                   ;METROPOLITANA;0;0;0;0;0;0;0;0;0;NTBK G7 240 Intel Celeron 4GB 500GB 14;COMPUTACION
8626783;;F;63;CHILENO;;Boomers;SAN VICENTE                   ;L.G.B.OÂ´HIGGINS;0;0;0;0;0;0;0;0;0;TAB M5 Lite Octa Core 32GB 10P FHD;COMPUTACION
10473429;;M;55;CHILENO;;Boomers;RENCA                         ;METROPOLITANA;0;0;0;0;0;0;0;0;0;NTBK Ideapad 5i Core i5 11va 8GB 512GB 15P FHD;COMPUTACION
16314800;;F;37;CHILENO;;Millenial;NUEVA IMPERIAL                ;ARAUCANIA;0;0;0;0;0;0;0;0;0;NTBK 14-dq1004la Core i5-1035G1 8GB 256SSD 14P;COMPUTACION
24227398;;M;54;PERUANO;;Extranjero;LO PRADO                      ;METROPOLITANA;0;0;0;0;0;0;0;0;0;TAB GAMER 7 QUAD CORE 2G+16G 8715;COMPUTACION
16327043;;M;36;CHILENO;;Silencioso;PROVIDENCIA                   ;METROPOLITANA;0;0;0;0;0;0;0;0;0;Galaxy Tab A7 (10.4 ,32GB, WIFI) Dark Gray;COMPUTACION
13464724;;F;44;CHILENO;;Silencioso;PROVIDENCIA                   ;METROPOLITANA;0;0;0;0;0;0;0;0;0;NTBK 15-DA2034LA PENTIUM GOLD 6405U 8GB1TB W10;COMPUTACION
10909405;;F;48;CHILENO;;X;PROVIDENCIA                   ;METROPOLITANA;0;0;0;0;0;0;0;0;0;NTBK Ideapad 5i Core i5 11va 8GB 512GB 15P FHD;COMPUTACION
16383756;;F;35;CHILENO;;Millenial;PROVIDENCIA                   ;METROPOLITANA;0;0;0;0;0;0;0;0;0;TINTA 664 TRI COLOR;COMPUTACION
11757967;;M;51;CHILENO;;X;DONIHUE                       ;L.G.B.OÂ´HIGGINS;0;0;0;0;0;0;0;0;0;TAB Matepad 10.4;COMPUTACION
15880648;Soltero;F;40;CHILENO;;X;PROVIDENCIA                   ;METROPOLITANA;0;0;0;0;0;0;0;0;0;Impresora Laser HL-1202 Monocromatica;COMPUTACION
16229588;;M;36;CHILENO;;Millenial;N/D;N/D;0;0;0;0;0;0;0;0;0;NTBK G7 240 Intel Celeron 4GB 500GB 14;COMPUTACION
5650539;;F;78;CHILENO;;Silencioso;SAN FERNANDO                  ;L.G.B.OÂ´HIGGINS;0;0;0;0;0;0;0;0;0;NTBK 14-DQ1001 Core i3-1005G1 4+16 256SSD 14;COMPUTACION
15646348;Soltero;M;32;CHILENO;;Millenial;PROVIDENCIA                   ;METROPOLITANA;0;0;0;0;0;0;0;0;0;NTBK INSPIRON 3505 AMD Athlon Silver 3050U 4GB 1;COMPUTACION
15913562;Soltero;M;35;CHILENO;;Millenial;PROVIDENCIA                   ;METROPOLITANA;0;0;0;0;0;0;0;0;0;Galaxy Tab A7 (10.4 ,32GB, WIFI) Dark Gray;COMPUTACION
15993515;;F;37;CHILENO;;Millenial;RANCAGUA                      ;L.G.B.OÂ´HIGGINS;0;0;0;0;0;0;0;0;0;NTBK 14-DQ1001 Core i3-1005G1 4+16 256SSD 14;COMPUTACION
5058728;;M;78;CHILENO;;Silencioso;RENCA                         ;METROPOLITANA;0;0;0;0;0;0;0;0;0;NTBK A314-22-R7EL-1 Ryzen 3-3250U 8GB 256SSD 14P;COMPUTACION
16801086;;M;34;CHILENO;;Silencioso;PROVIDENCIA                   ;METROPOLITANA;0;0;0;0;0;0;0;0;0;TAB Galaxy Tab A 8 4G 4Core 2GB 32GB 8 Gris;COMPUTACION
16705094;Casado;F;34;CHILENO;;Millenial;PROVIDENCIA                   ;METROPOLITANA;0;0;0;0;0;0;0;0;0;NTBK 240 G7 Core i3-1005G1 4GB 1TB 14P;COMPUTACION
19940546;;F;24;CHILENO;;Silencioso;PROVIDENCIA                   ;METROPOLITANA;0;0;0;0;0;0;0;0;0;NTBK 14-dw0002la Ci5-1035G1 8GB 256GBSSD 14P;COMPUTACION
9401465;;F;58;CHILENO;;Boomers;N/D;N/D;0;0;0;0;0;0;0;0;0;MULTIFUNCIONAL EPSON ECOTANK L850 fotografica;COMPUTACION
19443492;;F;25;CHILENO;;Z;PROVIDENCIA                   ;METROPOLITANA;0;0;0;0;0;0;0;0;0;NTBK 14-dq1004la Core i5-1035G1 8GB 256SSD 14P;COMPUTACION
25880689;;M;43;PERUANO;;Extranjero;PEDRO AGUIRRE CERDA           ;METROPOLITANA;0;0;0;0;0;0;0;0;0;NTBK 330 A4-9125 4GB 500GB 14;COMPUTACION
18270327;Soltero;F;29;CHILENO;;Millenial;PROVIDENCIA                   ;METROPOLITANA;0;0;0;0;0;0;0;0;0;TAB Mediapad T3 10 4Core 2GB 16GB 9,6 Gris;COMPUTACION
6731401;;M;72;CHILENO;;Silencioso;SAN BERNARDO                  ;METROPOLITANA;0;0;0;0;0;0;0;0;0;TINTA EPSON T504 NG BOTELLA C13T03N12A;COMPUTACION
13044661;;F;46;CHILENO;;X;N/D;N/D;0;0;0;0;0;0;0;0;0;NTBK S150 AMD A4-9120e 4GB 64GB eMMc 14P;COMPUTACION
19267603;;M;26;CHILENO;;Z;PROVIDENCIA                   ;METROPOLITANA;0;0;0;0;0;0;0;0;0;NTBK S150 AMD A4-9120e 4GB 64GB eMMc 14P;COMPUTACION
14034861;;F;49;CHILENO;;X;TEMUCO                        ;ARAUCANIA;0;0;0;0;0;0;0;0;0;TAB Galaxy Tab A 8 4Core 2GB 32GB 8 Negra;COMPUTACION
18080028;;M;30;CHILENO;;Millenial;PROVIDENCIA                   ;METROPOLITANA;0;0;0;0;0;0;0;0;0;TAB GAMER 7 QUAD CORE 2G+16G 8715;COMPUTACION
17171368;Casado;M;33;CHILENO;;Millenial;PROVIDENCIA                   ;METROPOLITANA;0;0;0;0;0;0;0;0;0;NTBK 15-cw1006la Ryzen 7-3700U 8GB 512SSD 15P;COMPUTACION
18515365;;F;29;CHILENO;;Millenial;NANCAGUA                      ;L.G.B.OÂ´HIGGINS;0;0;0;0;0;0;0;0;0;TINTA EPSON T504 NG BOTELLA C13T03N12A;COMPUTACION
12196962;;M;49;CHILENO;;X;PENALOLEN                     ;METROPOLITANA;0;0;0;0;0;0;0;0;0;TAB Galaxy Tab A 8 4Core 2GB 32GB 8 Negra;COMPUTACION
19829377;;F;24;CHILENO;;Silencioso;PROVIDENCIA                   ;METROPOLITANA;0;0;0;0;0;0;0;0;0;TAB S6 Lite (610) 4GB 64GB 10.4P DARK GREY;COMPUTACION
8642355;;M;61;CHILENO;;Boomers;N/D;N/D;0;0;0;0;0;0;0;0;0;TAB Galaxy Tab A 8 4Core 2GB 32GB 8 Gris;COMPUTACION
26427618;;M;31;VENEZOLANO;;Extranjero;N/D;N/D;0;0;0;0;0;0;0;0;0;NTBK 15-cw1021la Ryzen 3-3300U 12GB 256SSD 15P;COMPUTACION
18425905;Soltero;F;28;CHILENO;;Silencioso;PROVIDENCIA                   ;METROPOLITANA;0;0;0;0;0;0;0;0;0;TAB Galaxy Tab A 8 4Core 2GB 32GB 8 Gris;COMPUTACION
6183370;Casado;F;72;CHILENO;;Silencioso;PROVIDENCIA                   ;METROPOLITANA;0;0;0;0;0;0;0;0;0;NTBK 14-dq1004la Core i5-1035G1 8GB 256SSD 14P;COMPUTACION
18777659;;F;28;CHILENO;;Millenial;PROVIDENCIA                   ;METROPOLITANA;0;0;0;0;0;0;0;0;0;TAB Galaxy Tab A 8 4Core 2GB 32GB 8 Gris;COMPUTACION
15119661;;M;39;CHILENO;;X;CHIMBARONGO                   ;L.G.B.OÂ´HIGGINS;0;0;0;0;0;0;0;0;0;TAB Galaxy Tab A 8 4Core 2GB 32GB 8 Negra;COMPUTACION
7501573;;F;66;CHILENO;;Boomers;COLLIPULLI                    ;ARAUCANIA;0;0;0;0;0;0;0;0;0;NTBK 15-cw1021la Ryzen 3-3300U 12GB 256SSD 15P;COMPUTACION
10925057;;F;51;CHILENO;;X;RENCA                         ;METROPOLITANA;0;0;0;0;0;0;0;0;0;NTBK A315-42-R0W1-1 Ryzen 7-3700U 8GB 256SSD 15P;COMPUTACION
16475338;;F;35;CHILENO;;Millenial;N/D;N/D;0;0;0;0;0;0;0;0;0;TABLET MatePad Pro 10.8 + M-Pencil;COMPUTACION
18005540;Soltero;F;30;CHILENO;CIRUJANO DENTISTA;Millenial;PROVIDENCIA                   ;METROPOLITANA;0;0;0;0;0;0;0;0;0;NTBK Matebook 13 Core i5-10210U 8GB 512SSD 13P;COMPUTACION
12720616;;M;47;CHILENO;;X;PROVIDENCIA                   ;METROPOLITANA;0;0;0;0;0;0;0;0;0;NTBK S150 AMD A4-9120e 4GB 64GB eMMc 14P;COMPUTACION
8407268;;F;63;CHILENO;;Boomers;SANTA CRUZ                    ;L.G.B.OÂ´HIGGINS;0;0;0;0;0;0;0;0;0;NTBK IP3 Ryzen 3-3250U/8GB/1TB/15P;COMPUTACION
18484943;;M;29;CHILENO;;Millenial;PUDAHUEL                      ;METROPOLITANA;0;0;0;0;0;0;0;0;0;NTBK Gaming 3i Core i5-10300H 8GB 1TB 1650 4GB;COMPUTACION
14398283;;M;44;CHILENO;;X;LAS CONDES                    ;METROPOLITANA;0;0;0;0;0;0;0;0;0;TAB Galaxy Tab A+SPen 8Core 3GB 32GB 8 Gris;COMPUTACION
10479242;;M;56;CHILENO;;Boomers;RENCA                         ;METROPOLITANA;0;0;0;0;0;0;0;0;0;TAB S6 Lite (615) 4GB 64GB 10.4P SILVER 4G;COMPUTACION
8911661;;M;61;CHILENO;;Boomers;RENCA                         ;METROPOLITANA;0;0;0;0;0;0;0;0;0;TAB MBX Cinema 8866 OctaCore 2GB 32GB 10P;COMPUTACION
10987896;;M;44;CHILENO;;X;AISEN                         ;AYSEN;0;0;0;0;0;0;0;0;0;NTBK 15-dk0015 Core i5-9300H 8GB 256SSD 1050 3GB;COMPUTACION
9808941;;F;55;CHILENO;;Boomers;RENCA                         ;METROPOLITANA;0;0;0;0;0;0;0;0;0;NTBK S150 AMD A4-9120e 4GB 64GB eMMc 14P;COMPUTACION
18416665;Soltero;M;29;CHILENO;;Millenial;PROVIDENCIA                   ;METROPOLITANA;0;0;0;0;0;0;0;0;0;NTBK G7 240 Intel Celeron 4GB 500GB 14;COMPUTACION
16001899;Casado;M;37;CHILENO;LICENCIADO EN LENGUA Y LITERATURA HISPANICA CON MENCION EN LINGUISTICA;Millenial;PROVIDENCIA                   ;METROPOLITANA;0;0;0;0;0;0;0;0;0;NTBK Matebook D14 AMD Ryzen 5 8GB 512SSD 14P;COMPUTACION
13467023;;M;44;CHILENO;;X;RENCA                         ;METROPOLITANA;0;0;0;0;0;0;0;0;0;NTBK 16-a0001 Core i5-10300H 8GB 512SSD 1650 4GB;COMPUTACION
18735843;;F;27;CHILENO;;Millenial;N/D;N/D;0;0;0;0;0;0;0;0;0;TINTA 664 TRI COLOR;COMPUTACION
19144115;;F;26;CHILENO;;Z;"";"";0;0;0;0;0;0;0;0;0;NTBK G7 240 Intel Celeron 4GB 500GB 14;COMPUTACION
19944715;;F;24;CHILENO;;Z;PROVIDENCIA                   ;METROPOLITANA;0;0;0;0;0;0;0;0;0;NTBK G7 240 Intel Celeron 4GB 500GB 14;COMPUTACION
14334120;;M;49;CHILENO;;X;CASTRO                        ;LOS LAGOS;0;0;0;0;0;0;0;0;0;NTBK G7 240 Intel Celeron 4GB 500GB 14;COMPUTACION
18558162;;F;28;CHILENO;;Millenial;RENGO;O HIGGINS;0;0;0;0;0;0;0;0;0;TAB M8 QC 2GB 32GB 8P Gris;COMPUTACION
13144755;;F;44;CHILENO;;X;SANTIAGO                      ;METROPOLITANA;0;0;0;0;0;0;0;0;0;NTBK IP3 Ryzen 3-3250U/8GB/1TB/15P;COMPUTACION
8442505;Soltero;F;50;CHILENO;;X;PROVIDENCIA                   ;METROPOLITANA;0;0;0;0;0;0;0;0;0;NTBK AN515-54-59UV-1 Core i5 8GB 1TB 1650 4GB;COMPUTACION
11952157;;M;50;CHILENO;;X;SAN FERNANDO                  ;L.G.B.OÂ´HIGGINS;0;0;0;0;0;0;0;0;0;TAB MBXR 8717 4Core 2GB 16GB 10 Negra;COMPUTACION
15472503;;F;39;CHILENO;;X;MACUL                         ;METROPOLITANA;0;0;0;0;0;0;0;0;0;TAB 7 MB4 Plus 4Core 1GB 16GB 7 Plata;COMPUTACION
15031247;;M;56;CHILENO;;Boomers;RENCA                         ;METROPOLITANA;0;0;0;0;0;0;0;0;0;TAB MLAB MBX 8 QUAD CORE 1G+16G 8716;COMPUTACION
6970789;;M;67;CHILENO;;Boomers;PROVIDENCIA                   ;METROPOLITANA;0;0;0;0;0;0;0;0;0;NTBK IP3 Athlon 3050U/4GB/500GB/15P;COMPUTACION
10016719;;M;56;CHILENO;;Boomers;RENCA                         ;METROPOLITANA;0;0;0;0;0;0;0;0;0;NTBK 15-cw1020la Ryzen 5-3500U 8GB 256GB 15P;COMPUTACION
10884382;;F;52;CHILENO;;X;CALDERA                       ;ATACAMA;0;0;0;0;0;0;0;0;0;TAB 7 MB4 Plus 4Core 1GB 16GB 7 Plata;COMPUTACION
13974409;Soltero;M;40;CHILENO;;X;PROVIDENCIA                   ;METROPOLITANA;0;0;0;0;0;0;0;0;0;TAB Galaxy Tab A 8 4Core 2GB 32GB 8 Gris;COMPUTACION
10926347;Casado;M;44;CHILENO;INGENIERO CIVIL;X;PROVIDENCIA                   ;METROPOLITANA;0;0;0;0;0;0;0;0;0;TAB Galaxy Tab A+SPen 8Core 3GB 32GB 8 Gris;COMPUTACION
12610541;;M;47;CHILENO;;X;ARICA                         ;ARICA Y PARINACOTA;0;0;0;0;0;0;0;0;0;Tab M10 Plus FHD 4GB 64GB 10.3P platinum grey;COMPUTACION
14364220;;M;41;CHILENO;;X;PROVIDENCIA                   ;METROPOLITANA;0;0;0;0;0;0;0;0;0;Tab Yoga Smart;COMPUTACION
19059922;;F;25;CHILENO;;Z;CAUQUENES;MAULE;0;0;0;0;0;0;0;0;0;TAB S6 Lite (610) 4GB 64GB 10.4P BLUE;COMPUTACION
16270883;;M;36;CHILENO;;Millenial;TALCA                         ;MAULE;0;0;0;0;0;0;0;0;0;NTBK G7 240 Intel Celeron 4GB 500GB 14;COMPUTACION
19457104;;M;36;CHILENO;;Millenial;MELIPILLA                     ;METROPOLITANA;0;0;0;0;0;0;0;0;0;TAB 7 PLAY AND LEARN PLUS PURPLE 8867;COMPUTACION
10189766;;M;47;CHILENO;;Extranjero;COIHAIQUE                     ;AYSEN;0;0;0;0;0;0;0;0;0;NTBK IP3 Athlon 3050U/4GB/500GB/15P;COMPUTACION
12214398;;M;50;CHILENO;;X;CURICO                        ;MAULE;0;0;0;0;0;0;0;0;0;TAB MediaPad T5 10 3GB 32GB 10.1P Azul;COMPUTACION
12255800;;M;50;CHILENO;;X;PROVIDENCIA                   ;METROPOLITANA;0;0;0;0;0;0;0;0;0;TAB MBX Cinema 8866 OctaCore 2GB 32GB 10P;COMPUTACION
16396734;;F;35;CHILENO;;Millenial;PROVIDENCIA                   ;METROPOLITANA;0;0;0;0;0;0;0;0;0;NTBK 240 G7 Core i3-1005G1 4GB 1TB 14P;COMPUTACION
15027833;;M;40;CHILENO;;X;SALAMANCA                     ;COQUIMBO;0;0;0;0;0;0;0;0;0;NTBK IP3 Ryzen 3-3250U/8GB/1TB/15P;COMPUTACION
19185178;Soltero;M;26;CHILENO;;Z;PROVIDENCIA                   ;METROPOLITANA;0;0;0;0;0;0;0;0;0;NTBK 15-ek0010la Core i5 8+32 512SSD 2060 6GB;COMPUTACION
8905808;Casado;M;58;CHILENO;INGENIERO;Boomers;RENCA                         ;METROPOLITANA;0;0;0;0;0;0;0;0;0;TAB S6 Lite (610) 4GB 64GB 10.4P BLUE;COMPUTACION
13351862;;M;44;CHILENO;;X;PROVIDENCIA                   ;METROPOLITANA;0;0;0;0;0;0;0;0;0;IMPRESORA EPSON L120;COMPUTACION
18219379;;M;29;CHILENO;;Millenial;N/D;N/D;0;0;0;0;0;0;0;0;0;TAB MBXR 8717 4Core 2GB 16GB 10 Negra;COMPUTACION
17984404;Soltero;M;30;CHILENO;;Millenial;VILCUN                        ;ARAUCANIA;0;0;0;0;0;0;0;0;0;TAB 7 MB4 Plus 4Core 1GB 16GB 7 Plata;COMPUTACION
22721514;;M;43;CHILENO;;Extranjero;PROVIDENCIA                   ;METROPOLITANA;0;0;0;0;0;0;0;0;0;NTBK G7 240 Intel Celeron 4GB 500GB 14;COMPUTACION
16447186;;M;35;CHILENO;;Millenial;PROVIDENCIA                   ;METROPOLITANA;0;0;0;0;0;0;0;0;0;Tab M10 Plus FHD 4GB 64GB 10.3P platinum grey;COMPUTACION
12399524;;M;48;CHILENO;;X;CABILDO                       ;VALPARAISO;0;0;0;0;0;0;0;0;0;TAB Galaxy Tab A 8 4Core 2GB 32GB 8 Gris;COMPUTACION
16326618;;F;35;CHILENO;;Millenial;RENCA                         ;METROPOLITANA;0;0;0;0;0;0;0;0;0;TAB M8 QC 2GB 32GB 8P Gris;COMPUTACION
11845880;;F;50;CHILENO;;X;RENCA                         ;METROPOLITANA;0;0;0;0;0;0;0;0;0;TAB Galaxy Tab A 10.1 8Core 2GB 32GB 10 Negra;COMPUTACION
18087198;;F;30;CHILENO;;Millenial;BUIN;METROPOLITANA;0;0;0;0;0;0;0;0;0;TAB 7 MB4 Plus 4Core 1GB 16GB 7 Plata;COMPUTACION
10333986;;M;53;CHILENO;;X;PAINE                         ;METROPOLITANA;0;0;0;0;0;0;0;0;0;NTBK G7 240 Intel Celeron 4GB 500GB 14;COMPUTACION
17559729;Soltero;M;31;CHILENO;PROFESOR;Millenial;PROVIDENCIA                   ;METROPOLITANA;0;0;0;0;0;0;0;0;0;Tab M10 Plus FHD 4GB 64GB 10.3P platinum grey;COMPUTACION
12258611;;M;50;CHILENO;;X;LA PINTANA                    ;METROPOLITANA;0;0;0;0;0;0;0;0;0;NTBK IP3 Ryzen 3-3250U/8GB/1TB/15P;COMPUTACION
16465802;;M;36;CHILENO;;Millenial;ARICA                         ;ARICA Y PARINACOTA;0;0;0;0;0;0;0;0;0;TAB Matepad 10.4;COMPUTACION
15045429;;M;40;CHILENO;;X;PROVIDENCIA                   ;METROPOLITANA;0;0;0;0;0;0;0;0;0;NTBK G7 240 Intel Celeron 4GB 500GB 14;COMPUTACION
17192142;;M;33;CHILENO;;Millenial;PROVIDENCIA                   ;METROPOLITANA;0;0;0;0;0;0;0;0;0;NTBK IP3 Athlon 3050U/4GB/500GB/15P;COMPUTACION
8184653;;M;65;CHILENO;;Boomers;TALCAHUANO                    ;BIO BIO;0;0;0;0;0;0;0;0;0;NTBK G7 240 Intel Celeron 4GB 500GB 14;COMPUTACION
13726778;;F;42;CHILENO;;X;N/D;N/D;0;0;0;0;0;0;0;0;0;NTBK IP S340 Core I5-1035G4 4GB 256GB SSD 14P;COMPUTACION
16008298;;F;37;CHILENO;;Millenial;PROVIDENCIA                   ;METROPOLITANA;0;0;0;0;0;0;0;0;0;NTBK Matebook D15 AMD Ryzen 5 8GB 256SSD+1TB 15P;COMPUTACION
9675231;;F;59;CHILENO;;Boomers;LA PINTANA                    ;METROPOLITANA;0;0;0;0;0;0;0;0;0;NTBK IP3 Athlon 3050U/4GB/500GB/15P;COMPUTACION
12426196;;F;49;CHILENO;;X;LA SERENA                     ;COQUIMBO;0;0;0;0;0;0;0;0;0;TAB M5 Lite Octa Core 32GB 10P FHD;COMPUTACION
13436066;;M;43;CHILENO;;X;PROVIDENCIA                   ;METROPOLITANA;0;0;0;0;0;0;0;0;0;AIO 20-c421la CeleroN 4 GB 1TB Windows;COMPUTACION
5894209;;F;68;CHILENO;;Silencioso;MAIPU                         ;METROPOLITANA;0;0;0;0;0;0;0;0;0;NTBK IP3 Athlon 3050U/4GB/500GB/15P;COMPUTACION
12440479;;M;49;CHILENO;;X;PROVIDENCIA                   ;METROPOLITANA;0;0;0;0;0;0;0;0;0;NTBK A315-42-R0W1-1 Ryzen 7-3700U 8GB 256SSD 15P;COMPUTACION
9687702;;F;57;CHILENO;;Boomers;OVALLE                        ;COQUIMBO;0;0;0;0;0;0;0;0;0;TAB 7 MB4 PLUS 3G 1+16GB BLACK 8761;COMPUTACION
17760279;;F;30;CHILENO;;Millenial;PROVIDENCIA                   ;METROPOLITANA;0;0;0;0;0;0;0;0;0;Impresora Laser HL-1202 Monocromatica;COMPUTACION
16100187;Soltero;M;36;CHILENO;BIOQUIMICO;Millenial;PROVIDENCIA                   ;METROPOLITANA;0;0;0;0;0;0;0;0;0;TAB Galaxy Tab A 8 4Core 2GB 32GB 8 Gris;COMPUTACION
15871130;Soltero;M;37;CHILENO;PROFESOR;Millenial;PROVIDENCIA                   ;METROPOLITANA;0;0;0;0;0;0;0;0;0;NTBK 15-dw1051la Core i5-10210U 8GB 256SSD 15P;COMPUTACION
9725447;;F;58;CHILENO;;Boomers;RENCA                         ;METROPOLITANA;0;0;0;0;0;0;0;0;0;NTBK IP3 Athlon 3050U/4GB/500GB/15P;COMPUTACION
14154586;Casado;M;41;CHILENO;ADMINISTRACION DE EMPRESAS;X;PROVIDENCIA                   ;METROPOLITANA;0;0;0;0;0;0;0;0;0;TAB GALAXY S6 (T860) 6GB 128GB 10.5;COMPUTACION
10987284;;M;45;CHILENO;;X;PROVIDENCIA                   ;METROPOLITANA;0;0;0;0;0;0;0;0;0;NTBK 15-dw1051la Core i5-10210U 8GB 256SSD 15P;COMPUTACION
12218643;Casado;M;50;CHILENO;INGENIERO;X;PROVIDENCIA                   ;METROPOLITANA;0;0;0;0;0;0;0;0;0;NTBK A514-53-59FH-1 Core i5 8GB 512SSD 14P;COMPUTACION
5403757;;M;76;CHILENO;;Silencioso;COIHAIQUE                     ;AYSEN;0;0;0;0;0;0;0;0;0;NTBK 16-a0001 Core i5-10300H 8GB 512SSD 1650 4GB;COMPUTACION
12967507;;F;46;CHILENO;;X;NIQUEN                        ;BIO BIO;0;0;0;0;0;0;0;0;0;NTBK IP3 Athlon 3050U/4GB/500GB/15P;COMPUTACION
18179062;;F;29;CHILENO;;Millenial;LA SERENA                     ;COQUIMBO;0;0;0;0;0;0;0;0;0;NTBK G7 240 Intel Celeron 4GB 500GB 14;COMPUTACION
9838871;;F;58;CHILENO;;Boomers;LA PINTANA                    ;METROPOLITANA;0;0;0;0;0;0;0;0;0;Multifuncional Smart Tank 515 Wifi;COMPUTACION
16817443;Soltero;M;34;CHILENO;INGENIERO EN AUTOMATIZACION Y CONTROL INDUSTRIAL;Millenial;PROVIDENCIA                   ;METROPOLITANA;0;0;0;0;0;0;0;0;0;NTBK 15-dk0015 Core i5-9300H 8GB 256SSD 1050 3GB;COMPUTACION
19675176;;F;24;CHILENO;;Millenial;N/D;N/D;0;0;0;0;0;0;0;0;0;NTBK Matebook D14 AMD Ryzen 5 8GB 256SSD 14P;COMPUTACION
17009224;;M;33;CHILENO;;Millenial;PROVIDENCIA                   ;METROPOLITANA;0;0;0;0;0;0;0;0;0;TAB Mediapad T3 7 4Core 1GB 8GB 7 Gris;COMPUTACION
19817269;;F;24;CHILENO;;Z;PROVIDENCIA                   ;METROPOLITANA;0;0;0;0;0;0;0;0;0;TAB Galaxy Tab A 8 4Core 2GB 32GB 8 Gris;COMPUTACION
11697038;;M;51;CHILENO;;X;RENCA                         ;METROPOLITANA;0;0;0;0;0;0;0;0;0;NTBK HP da0083la Pentium N5000/8GB/1TB Gray 15P;COMPUTACION
10085152;;F;57;CHILENO;;Boomers;VINA DEL MAR                  ;VALPARAISO;0;0;0;0;0;0;0;0;0;NTBK Matebook D14 AMD Ryzen 5 8GB 256SSD 14P;COMPUTACION
18098367;Soltero;M;29;CHILENO;;Millenial;PROVIDENCIA                   ;METROPOLITANA;0;0;0;0;0;0;0;0;0;NTBK 15-dk0015 Core i5-9300H 8GB 256SSD 1050 3GB;COMPUTACION
12598611;;M;48;CHILENO;;X;N/D;N/D;0;0;0;0;0;0;0;0;0;TINTA HP BOTELLA MAGENTA GT52;COMPUTACION
4858317;;F;77;CHILENO;;Silencioso;N/D;N/D;0;0;0;0;0;0;0;0;0;NTBK IP3 Athlon 3050U/4GB/500GB/15P;COMPUTACION
12649552;;F;47;CHILENO;;X;RENCA                         ;METROPOLITANA;0;0;0;0;0;0;0;0;0;NTBK S150 AMD A4-9120e 4GB 64GB eMMc 14P;COMPUTACION
13074838;;M;46;CHILENO;;X;PROVIDENCIA                   ;METROPOLITANA;0;0;0;0;0;0;0;0;0;NTBK Matebook 13 AMD Ryzen 5 8GB 512SSD 13P;COMPUTACION
17416776;Soltero;M;32;CHILENO;;Millenial;PROVIDENCIA                   ;METROPOLITANA;0;0;0;0;0;0;0;0;0;NTBK IP3 AMD Ryzen 5-4500U 8GB 1TB 15P;COMPUTACION
17714192;;F;31;CHILENO;;Millenial;N/D;N/D;0;0;0;0;0;0;0;0;0;TAB 7 MB4 Plus 4Core 1GB 16GB 7 Plata;COMPUTACION
20259523;;M;23;CHILENO;;Z;N/D;N/D;0;0;0;0;0;0;0;0;0;PROYECTOR Powerlite S41;COMPUTACION
9734583;;M;58;CHILENO;;Boomers;SAN NICOLAS                   ;BIO BIO;0;0;0;0;0;0;0;0;0;Multifuncional Smart Tank 515 Wifi;COMPUTACION
11437766;;F;53;CHILENO;;X;PROVIDENCIA                   ;METROPOLITANA;0;0;0;0;0;0;0;0;0;NTBK G7 240 Intel Celeron 4GB 500GB 14;COMPUTACION
8015335;;M;64;CHILENO;;Boomers;BUIN                          ;METROPOLITANA;0;0;0;0;0;0;0;0;0;NTBK G7 240 Intel Celeron 4GB 500GB 14;COMPUTACION
11404952;;M;52;CHILENO;;X;RENCA                         ;METROPOLITANA;0;0;0;0;0;0;0;0;0;TAB Galaxy Tab A 8 4G 4Core 2GB 32GB 8 Gris;COMPUTACION
8339849;;M;63;CHILENO;;Boomers;RENCA                         ;METROPOLITANA;0;0;0;0;0;0;0;0;0;TAB M5 Lite Octa Core 32GB 10P FHD;COMPUTACION
10464973;;M;57;CHILENO;;Boomers;CHANCO                        ;MAULE;0;0;0;0;0;0;0;0;0;NTBK G7 240 Intel Celeron 4GB 500GB 14;COMPUTACION
17504644;;F;32;CHILENO;;Millenial;PROVIDENCIA                   ;METROPOLITANA;0;0;0;0;0;0;0;0;0;NTBK G7 240 Intel Celeron 4GB 500GB 14;COMPUTACION
15212992;;F;39;CHILENO;;X;RENCA                         ;METROPOLITANA;0;0;0;0;0;0;0;0;0;NTBK G7 240 Intel Celeron 4GB 500GB 14;COMPUTACION
12226195;;F;50;CHILENO;;X;QUILPUE                       ;VALPARAISO;0;0;0;0;0;0;0;0;0;TAB S6 Lite (615) 4GB 64GB 10.4P SILVER 4G;COMPUTACION
11606352;Casado;M;52;CHILENO;;X;RENCA                         ;METROPOLITANA;0;0;0;0;0;0;0;0;0;TAB MediaPad T5 10 3GB 32GB 10.1P Azul;COMPUTACION
19645588;;F;25;CHILENO;;Z;N/D;N/D;0;0;0;0;0;0;0;0;0;Multifuncional Smart Tank 515 Wifi;COMPUTACION
6544108;;M;69;CHILENO;;Silencioso;RENCA                         ;METROPOLITANA;0;0;0;0;0;0;0;0;0;NTBK 240 G7 Core i3-1005G1 4GB 1TB 14P;COMPUTACION
18407990;Soltero;M;28;CHILENO;;Silencioso;PROVIDENCIA                   ;METROPOLITANA;0;0;0;0;0;0;0;0;0;NTBK 16-a0001 Core i5-10300H 8GB 512SSD 1650 4GB;COMPUTACION
19266098;;M;26;CHILENO;;Z;"";"";0;0;0;0;0;0;0;0;0;NTBK 16-a0001 Core i5-10300H 8GB 512SSD 1650 4GB;COMPUTACION
17606441;;M;33;CHILENO;;Millenial;PROVIDENCIA                   ;METROPOLITANA;0;0;0;0;0;0;0;0;0;TAB S6 Lite (610) 4GB 64GB 10.4P PINK;COMPUTACION
7452198;Casado;M;66;CHILENO;;Boomers;PROVIDENCIA                   ;METROPOLITANA;0;0;0;0;0;0;0;0;0;Multifuncional Laser DCP-1602 Monocromatica;COMPUTACION
14327412;;F;45;CHILENO;;X;LAS CABRAS                    ;L.G.B.OÂ´HIGGINS;0;0;0;0;0;0;0;0;0;NTBK 14-ds002la AMD A4 4GB 64GB eMMC 14P;COMPUTACION
19680760;;F;25;CHILENO;;Millenial;PROVIDENCIA                   ;METROPOLITANA;0;0;0;0;0;0;0;0;0;TAB S6 Lite (610) 4GB 64GB 10.4P DARK GREY;COMPUTACION
17172897;Soltero;M;32;CHILENO;;Millenial;PROVIDENCIA                   ;METROPOLITANA;0;0;0;0;0;0;0;0;0;TAB MediaPad T5 10 3GB 32GB 10.1P Azul;COMPUTACION
12483648;;F;48;CHILENO;;X;CHIMBARONGO                   ;L.G.B.OÂ´HIGGINS;0;0;0;0;0;0;0;0;0;TAB Galaxy Tab A 10.1 8Core 2GB 32GB 10 Negra;COMPUTACION
16548018;;M;35;CHILENO;;Millenial;"";"";0;0;0;0;0;0;0;0;0;NTBK IP3 Ryzen 3-3250U/8GB/1TB/15P;COMPUTACION
16003498;;M;37;CHILENO;;Millenial;SAN JAVIER                    ;MAULE;0;0;0;0;0;0;0;0;0;MULTIFUNCIONAL ECOTANK L3110;COMPUTACION
11577884;;M;52;CHILENO;;X;PROVIDENCIA                   ;METROPOLITANA;0;0;0;0;0;0;0;0;0;TAB Mediapad T3 7 4Core 1GB 8GB 7 Gris;COMPUTACION
8839585;Casado;M;60;CHILENO;;Boomers;RENCA                         ;METROPOLITANA;0;0;0;0;0;0;0;0;0;NTBK G7 240 Intel Celeron 4GB 500GB 14;COMPUTACION
9171828;;M;56;CHILENO;;Boomers;PROVIDENCIA                   ;METROPOLITANA;0;0;0;0;0;0;0;0;0;NTBK HP 14-cf0011la Ci3-8130U 4GB 128SSD 14P;COMPUTACION
19573970;;F;25;CHILENO;;Z;PROVIDENCIA                   ;METROPOLITANA;0;0;0;0;0;0;0;0;0;TAB S6 Lite (610) 4GB 64GB 10.4P BLUE;COMPUTACION
7449353;;M;68;CHILENO;;Boomers;MELIPILLA                     ;METROPOLITANA;0;0;0;0;0;0;0;0;0;NTBK HP 14-cf0011la Ci3-8130U 4GB 128SSD 14P;COMPUTACION
8023402;;M;64;CHILENO;;Boomers;LOS ANGELES                   ;BIO BIO;0;0;0;0;0;0;0;0;0;NTBK 240 G7 Core i3-1005G1 4GB 1TB 14P;COMPUTACION
17838551;;F;31;CHILENO;;Millenial;MAIPU                         ;METROPOLITANA;0;0;0;0;0;0;0;0;0;NTBK HP 15-da0082la Pentium 4GB 500GB 15P;COMPUTACION
16163192;;M;36;CHILENO;;Millenial;PROVIDENCIA                   ;METROPOLITANA;0;0;0;0;0;0;0;0;0;NTBK 14-ds002la AMD A4 4GB 64GB eMMC 14P;COMPUTACION
6835517;;F;72;CHILENO;;Silencioso;RENCA                         ;METROPOLITANA;0;0;0;0;0;0;0;0;0;TABLET HUAWEI T3 8 WIFI;COMPUTACION
10172628;;M;58;CHILENO;;Boomers;ANGOL                         ;ARAUCANIA;0;0;0;0;0;0;0;0;0;NTBK HP 15-da0082la Pentium 4GB 500GB 15P;COMPUTACION
15691372;;M;38;CHILENO;;X;PROVIDENCIA                   ;METROPOLITANA;0;0;0;0;0;0;0;0;0;NTBK HP 14-cf0011la Ci3-8130U 4GB 128SSD 14P;COMPUTACION
10317284;Soltero;F;58;CHILENO;;Boomers;PROVIDENCIA                   ;METROPOLITANA;0;0;0;0;0;0;0;0;0;NTBK 240 G7 Core i3-1005G1 4GB 1TB 14P;COMPUTACION
19309013;Soltero;F;26;CHILENO;;Z;PROVIDENCIA                   ;METROPOLITANA;0;0;0;0;0;0;0;0;0;NTBK IP3 Athlon 3050U/4GB/500GB/15P;COMPUTACION
16294680;Soltero;M;36;CHILENO;;Millenial;PROVIDENCIA                   ;METROPOLITANA;341980;2;1;2;1;341980;0;0;0;JGO LIVING FRANCIA 3,1,1 AZUL;MERCADO ABC
14302451;;F;46;CHILENO;;X;N/D;N/D;118950;5;3;5;3;118950;0;0;0;OLLA PRESION FAST 5,7 LTS;MERCADO ABC
25276374;;M;47;HAITIANO;;Extranjero;LO BARNECHEA                  ;METROPOLITANA;377700;5;2;2;1;348980;3;1;28720;Trotadora RUNNER 300 Negro;MERCADO ABC
9271616;;M;61;CHILENO;;Boomers;CALBUCO                       ;LOS LAGOS;682931;7;6;2;1;336980;5;5;345951;Soldadora Mig-250pvo;MERCADO ABC
8301624;;F;64;CHILENO;;Boomers;N/D;N/D;481440;8;4;2;1;52480;6;3;428960;Casa Para Perro Medium Con Ventilacion Coolpets;MERCADO ABC
14079082;;F;40;CHILENO;;X;PROVIDENCIA                   ;METROPOLITANA;32980;2;2;0;0;0;2;2;32980;BATMAN REALIDAD VIRTUAL 765 FYF;MERCADO ABC
12707539;Casado;F;47;CHILENO;ABOGADO;X;TEMUCO                        ;ARAUCANIA;98980;2;1;2;1;98980;0;0;0;APARADOR SALON Z 80 - ANDRORRA BLB 7426;MERCADO ABC
13416896;;F;44;CHILENO;;X;RENCA                         ;METROPOLITANA;566960;4;2;4;2;566960;0;0;0;JUEGO LIVING BELEN 3,1,1 TELA CAFE;MERCADO ABC
13514406;;M;43;CHILENO;;X;SANTIAGO;METROPOLITANA;809940;6;3;6;3;809940;0;0;0;SOFA MIRA 3 CPO CUE BITONO RSN;MERCADO ABC
18598871;;F;32;CHILENO;;Millenial;"";"";48980;2;1;2;1;48980;0;0;0;OLLA PRESION VITAL EXPRESS 9 LTS.;MERCADO ABC
12472202;;F;49;CHILENO;;X;MAIPU                         ;METROPOLITANA;84960;4;1;4;1;84960;0;0;0;Cama De Mascota Con Cojin Xl Coolpets 99.5Ã65.5Ã;MERCADO ABC
19331342;;M;26;CHILENO;;Z;ANTOFAGASTA;ANTOFAGASTA;113950;5;2;5;2;113950;0;0;0;BATERIA 7 PZS SLIDE AZUL;MERCADO ABC
10643972;;M;54;CHILENO;;X;OSORNO                        ;LOS LAGOS;35980;2;1;2;1;35980;0;0;0;AUTO CORREPASILLOS CON LUZ AMARILLO;MERCADO ABC
12630501;Casado;F;48;CHILENO;CIRUJANO DENTISTA;X;RENCA                         ;METROPOLITANA;84980;2;1;2;1;84980;0;0;0;KIT COCINA 120 PORRA;MERCADO ABC
8757651;Casado;F;61;CHILENO;;Boomers;PROVIDENCIA                   ;METROPOLITANA;52980;2;1;2;1;52980;0;0;0;TREN CAMINADOR CON LUCES;MERCADO ABC
16672128;;M;34;CHILENO;;Silencioso;PROVIDENCIA                   ;METROPOLITANA;763260;5;2;5;2;763260;0;0;0;COMEDOR FLORA 6 SILLAS;MERCADO ABC
10088786;;F;59;CHILENO;;Boomers;LA FLORIDA                    ;METROPOLITANA;169970;3;1;3;1;169970;0;0;0;ESCRITORIO HOME VIBES SAN FRANCISCO/REPISA;MERCADO ABC
7252413;Casado;F;58;CHILENO;PROFESOR;Boomers;PROVIDENCIA                   ;METROPOLITANA;38980;2;1;2;1;38980;0;0;0;Alfombra Frise Boutique 160x230 Patna;MERCADO ABC
16025706;;M;37;CHILENO;;Millenial;N/D;N/D;590970;4;2;4;2;590970;0;0;0;COMEDOR LORENZI+6S TAMBURATO;MERCADO ABC
8085535;;M;64;CHILENO;;Boomers;SAN FERNANDO                  ;L.G.B.OÂ´HIGGINS;465960;4;2;4;2;465960;0;0;0;COMEDOR LORENZI+6S TAMBURATO;MERCADO ABC
12369542;;M;48;CHILENO;;X;"";"";73510;4;1;4;1;73510;0;0;0;MULTITESTER DIGITAL UNIT;MERCADO ABC
17516483;;F;46;CHILENO;;X;RENCA                         ;METROPOLITANA;82940;6;2;5;1;57950;1;1;24990;Cortina Blackout Argolla 140x220 cms Selecta Gri;MERCADO ABC
17119172;;F;33;CHILENO;;Millenial;PROVIDENCIA                   ;METROPOLITANA;106980;2;1;2;1;106980;0;0;0;BIBLIOTECA ESCALERA BEIJING - ROVERE BLR 1856;MERCADO ABC
6367151;;F;71;CHILENO;;Silencioso;EL BOSQUE                     ;METROPOLITANA;58970;3;2;0;0;0;3;2;58970;Alfombra Frise 1.6k Venecia 50x90 Trieste;MERCADO ABC
18700919;Soltero;F;28;CHILENO;ABOGADO;Millenial;PROVIDENCIA                   ;METROPOLITANA;39980;2;1;2;1;39980;0;0;0;CASA PARA PERRO RIMAX PEQUENA TECHO AZUL;MERCADO ABC
20046226;;F;23;CHILENO;;Z;PROVIDENCIA                   ;METROPOLITANA;32980;2;1;2;1;32980;0;0;0;Plumon Coral Sherpa 2 P Terracota;MERCADO ABC
15286939;;F;39;CHILENO;;X;CALBUCO;LOS LAGOS;346980;2;1;2;1;346980;0;0;0;Seccional Derecho Isabella Chocolate;MERCADO ABC
12073712;;F;45;CHILENO;;X;HUALPEN;BIO BIO;167980;2;1;2;1;167980;0;0;0;Trotadora Plegable K-FIT 4 En 1 Bowden;MERCADO ABC
19071811;;M;27;CHILENO;;Z;"";"";20980;2;1;2;1;20980;0;0;0;Cubrecolchon impermeable y respirable x 1.90 mts;MERCADO ABC
26043103;Casado;M;39;NO INFORMA NACIONALIDAD;;Extranjero;PROVIDENCIA                   ;METROPOLITANA;58970;3;2;3;2;58970;0;0;0;MESA DE CENTRO RT3020;MERCADO ABC
27239423;;M;33;CHILENO;;Extranjero;N/D;N/D;123960;4;2;3;1;70970;1;1;52990;RACK MAORI TV46 - ROVERE RLR 3517;MERCADO ABC
17467338;;M;32;CHILENO;;Millenial;ARICA                         ;ARICA Y PARINACOTA;34980;2;1;2;1;34980;0;0;0;CORREPASILLO CON TIRADOR ROSADO;MERCADO ABC
20191280;;F;22;CHILENO;;Z;N/D;N/D;217950;5;3;4;2;167960;1;1;49990;Trotadora Plegable K-FIT Bekele;MERCADO ABC
11847803;Casado;M;51;CHILENO;INGENIERO;X;RENCA                         ;METROPOLITANA;76980;2;1;2;1;76980;0;0;0;ESCRITORIO OFFICE 15 - WENGUE CLW 3107;MERCADO ABC
15641769;Casado;F;38;CHILENO;;X;N/D;N/D;32980;2;1;2;1;32980;0;0;0;Mopa giratoria con balde M2 Boomjoy;MERCADO ABC
11446072;;M;53;CHILENO;;X;VINA DEL MAR                  ;VALPARAISO;619820;4;2;4;2;619820;0;0;0;Bicicleta Estatica Spinning Negra Lhotse Fit;MERCADO ABC
10680852;Casado;M;53;CHILENO;;X;PROVIDENCIA                   ;METROPOLITANA;74980;2;1;2;1;74980;0;0;0;Banca De Pesas Multifuncional Plegable K-FIT;MERCADO ABC
26549323;Soltero;M;37;EXTRANJERO - NO INFORMA NACIONALIDAD;;Extranjero;"";"";104980;2;1;2;1;104980;0;0;0;ZAPATERO LETO CON ESPEJO 46x137x6;MERCADO ABC
12973667;;M;46;CHILENO;;X;PROVIDENCIA                   ;METROPOLITANA;39840;2;1;2;1;39840;0;0;0;Coche paragua 5126SXAZUL;MERCADO ABC
18549956;;M;27;CHILENO;;Millenial;PROVIDENCIA                   ;METROPOLITANA;38980;2;1;2;1;38980;0;0;0;Set Mancuernas Con Barra Ajustable 30Kg K-FIT;MERCADO ABC
9166442;;F;56;CHILENO;;Boomers;SAN CARLOS                    ;BIO BIO;145840;2;1;2;1;145840;0;0;0;Bicicleta De Spinning Boonen K-FIT;MERCADO ABC
20002471;;F;23;CHILENO;;Z;PROVIDENCIA                   ;METROPOLITANA;88980;2;1;2;1;88980;0;0;0;CUNA 3 POSICIONES BLANCA;MERCADO ABC
19481003;;F;24;CHILENO;;Z;N/D;N/D;31980;2;1;2;1;31980;0;0;0;Set Mancuernas Con Barra Ajustable 10Kg K-FIT;MERCADO ABC
18753911;;M;30;CHILENO;;Millenial;PROVIDENCIA                   ;METROPOLITANA;154540;2;1;2;1;154540;0;0;0;Coche Explorer 5010 Rosa;MERCADO ABC
16358066;;F;36;CHILENO;;Millenial;PROVIDENCIA                   ;METROPOLITANA;42980;2;1;2;1;42980;0;0;0;Plumon Single Colo Colo Invencible;MERCADO ABC
17624545;;M;32;CHILENO;;Millenial;ANTOFAGASTA                   ;ANTOFAGASTA;5990;1;1;0;0;0;1;1;5990;Balon World Cup Fan Ball Roja;MERCADO ABC
16285145;;F;35;CHILENO;;Millenial;PROVIDENCIA                   ;METROPOLITANA;24840;2;1;2;1;24840;0;0;0;CAMARA DIGITAL ASD-DCA1010 NEGRO;MERCADO ABC
13604010;;F;43;CHILENO;;X;CORONEL                       ;BIO BIO;28840;2;1;2;1;28840;0;0;0;CORREPASILLO ROJO CON TIRADOR;MERCADO ABC
19388751;;F;26;CHILENO;;Z;PROVIDENCIA                   ;METROPOLITANA;95980;2;1;2;1;95980;0;0;0;ZAPATERO LETO CON ESPEJO 46x137x6;MERCADO ABC
16052360;;M;36;CHILENO;;Millenial;VICTORIA                      ;ARAUCANIA;95970;3;1;0;0;0;3;1;95970;Andador Rocking Walker H0742;MERCADO ABC
6806938;;F;75;CHILENO;;Silencioso;ANTOFAGASTA                   ;ANTOFAGASTA;429980;2;1;2;1;429980;0;0;0;Comedor 6 sillas modelo zara color imbuia;MERCADO ABC
14265173;;M;50;CHILENO;;X;SAN CARLOS                    ;BIO BIO;538980;2;1;2;1;538980;0;0;0;Trotadora RUNNER 500 con masajeador Negro;MERCADO ABC
12703139;;F;47;CHILENO;;X;"";"";4990;1;1;0;0;0;1;1;4990;TOALLA MICROFIBRA COOLER;MERCADO ABC
16961811;;F;34;CHILENO;;Millenial;PROVIDENCIA                   ;METROPOLITANA;54960;3;1;3;1;54960;0;0;0;CORREPASILLOS CON TOLDO AZUL;MERCADO ABC
12549609;;F;48;CHILENO;;X;CHILLAN                       ;BIO BIO;215840;2;1;2;1;215840;0;0;0;Trotadora Plegable K-FIT 4 En 1 Bowden;MERCADO ABC
13725418;Casado;M;42;CHILENO;INGENIERO;X;LOS ANGELES                   ;BIO BIO;93840;2;1;2;1;93840;0;0;0;Plataforma Vibratoria FullFit 1000 Rojo;MERCADO ABC
9214011;Casado;F;61;CHILENO;SECRETARIA;Boomers;PROVIDENCIA                   ;METROPOLITANA;379980;2;1;2;1;379980;0;0;0;COMEDOR BERLIN MADERA NOGAL - 6 SILLAS;MERCADO ABC
12398921;;F;48;CHILENO;;X;PROVIDENCIA                   ;METROPOLITANA;22980;2;1;2;1;22980;0;0;0;CAMARA DIGITAL ASD-DCA1010 NEGRO;MERCADO ABC
17972703;;F;34;CHILENO;;Millenial;PROVIDENCIA                   ;METROPOLITANA;169990;1;1;0;0;0;1;1;169990;TECLADO CT-S200BKC2 ESTANDAR CASIOTONE C/ TRANSF;MERCADO ABC
19330410;;M;24;CHILENO;;Z;PROVIDENCIA                   ;METROPOLITANA;0;0;0;0;0;0;0;0;0;Camara Deportiva 4k Lhotse H1 Video Con Accesori;MERCADO ABC
11700973;;F;51;CHILENO;;X;N/D;N/D;0;0;0;0;0;0;0;0;0;Arenero De Gato Con Pala Gris Coolpets 6141.541C;MERCADO ABC
19200630;;F;38;CHILENO;;X;CHILLAN                       ;BIO BIO;0;0;0;0;0;0;0;0;0;TECLADO MONOFONICO NINO;MERCADO ABC
26086975;;M;32;HAITIANO;;Extranjero;N/D;N/D;0;0;0;0;0;0;0;0;0;JUEGO DE COMEDOR FAVATEX ISI 6 SILLAS;MERCADO ABC
9513639;;F;59;CHILENO;;Boomers;LOTA                          ;BIO BIO;0;0;0;0;0;0;0;0;0;BERGERE VALENCIA CAFE;MERCADO ABC
8131474;;F;67;CHILENO;;Boomers;PUENTE ALTO                   ;METROPOLITANA;0;0;0;0;0;0;0;0;0;SOFA MIRA 3 CPO EBCA VISON RSN;MERCADO ABC
19127865;Casado;M;25;CHILENO;;Z;PROVIDENCIA                   ;METROPOLITANA;0;0;0;0;0;0;0;0;0;JUEGO COMEDOR VENUS 6 SILLAS;MERCADO ABC
15458138;Soltero;M;39;CHILENO;TECNICO EN TELECOMUNICACIONES;X;PROVIDENCIA                   ;METROPOLITANA;0;0;0;0;0;0;0;0;0;SET DE JUEGO ASCENSOR FRESH METAL;MERCADO ABC
18727157;Soltero;F;28;CHILENO;;Millenial;PROVIDENCIA                   ;METROPOLITANA;0;0;0;0;0;0;0;0;0;CORREPASILLO CARITA PINK;MERCADO ABC
17210646;;F;32;CHILENO;;Millenial;PROVIDENCIA                   ;METROPOLITANA;0;0;0;0;0;0;0;0;0;CASA PARA PERRO GRANDE VERDECOOLPETS87.7x78.5X81;MERCADO ABC
13921225;Soltero;M;42;CHILENO;PROFESOR;X;PROVIDENCIA                   ;METROPOLITANA;0;0;0;0;0;0;0;0;0;SOFA MIRA 3 CPO EBCA ACERO;MERCADO ABC
14037584;;F;41;CHILENO;;X;PROVIDENCIA                   ;METROPOLITANA;0;0;0;0;0;0;0;0;0;PUCHIMBOL PEDESTAL;MERCADO ABC
20299481;;M;22;CHILENO;;Silencioso;PROVIDENCIA                   ;METROPOLITANA;0;0;0;0;0;0;0;0;0;TECLADO CT-S300C2 ESTANDAR CASIOTONE CASIO C/TRA;MERCADO ABC
15646558;;F;38;CHILENO;;Millenial;N/D;N/D;0;0;0;0;0;0;0;0;0;CORREPASILLO AUTO ROJO;MERCADO ABC
13753611;;M;41;CHILENO;;X;PROVIDENCIA                   ;METROPOLITANA;0;0;0;0;0;0;0;0;0;CAJONERO RATTAN 3 CAJONES RIMAX MOCA;MERCADO ABC
13249645;;M;45;CHILENO;;Silencioso;PROVIDENCIA                   ;METROPOLITANA;0;0;0;0;0;0;0;0;0;BERGERE T101 NEGRO RSN;MERCADO ABC
14346936;;M;42;CHILENO;;X;PROVIDENCIA                   ;METROPOLITANA;0;0;0;0;0;0;0;0;0;BERGERE SAVERNE NEGRO RSN;MERCADO ABC
14214559;;F;41;CHILENO;;X;LOTA                          ;BIO BIO;0;0;0;0;0;0;0;0;0;SET CAMION + PISTA VUELTA AUTOS;MERCADO ABC
7914615;Casado;F;64;CHILENO;;Boomers;PROVIDENCIA                   ;METROPOLITANA;0;0;0;0;0;0;0;0;0;CORREPASILLO AUTO AZUL;MERCADO ABC
17757682;Soltero;M;31;CHILENO;CONSTRUCTOR CIVIL;Millenial;PROVIDENCIA                   ;METROPOLITANA;0;0;0;0;0;0;0;0;0;SOFA CAMA MURANO TELA GRAFITO RSN;MERCADO ABC
8543620;;F;62;CHILENO;;Boomers;RENCA                         ;METROPOLITANA;0;0;0;0;0;0;0;0;0;Cajonero Rimax Rattan 4G Mocca;MERCADO ABC
8043909;Casado;M;65;CHILENO;;Boomers;PROVIDENCIA                   ;METROPOLITANA;0;0;0;0;0;0;0;0;0;Cajonero Rimax Rattan 4G Mocca;MERCADO ABC
18355016;;F;29;CHILENO;;Millenial;PROVIDENCIA                   ;METROPOLITANA;0;0;0;0;0;0;0;0;0;BERGER SAVERNE TELA CHEX CAFE RSN;MERCADO ABC
18187471;;F;30;CHILENO;;Millenial;N/D;N/D;0;0;0;0;0;0;0;0;0;JUEGO DE CORTE DE COMIDA;MERCADO ABC
19420012;;F;25;CHILENO;;Z;PROVIDENCIA                   ;METROPOLITANA;0;0;0;0;0;0;0;0;0;GIMNASIO ALFOMBRA CON PIANO Y MP3;MERCADO ABC
15878464;Casado;M;37;CHILENO;;Millenial;RENCA                         ;METROPOLITANA;0;0;0;0;0;0;0;0;0;SILLA COMEDOR TERRAZA;MERCADO ABC
18454147;;F;28;CHILENO;;Millenial;RENCA                         ;METROPOLITANA;0;0;0;0;0;0;0;0;0;SILLA COMEDOR TERRAZA;MERCADO ABC
7525111;Casado;F;57;CHILENO;INGENIERO;Boomers;PROVIDENCIA                   ;METROPOLITANA;0;0;0;0;0;0;0;0;0;Bianchi Bicicleta Magnetica M-1300;MERCADO ABC
17806463;;M;32;CHILENO;;Millenial;PROVIDENCIA                   ;METROPOLITANA;0;0;0;0;0;0;0;0;0;SOFA MIRA 3 CPO EBCA ACERO;MERCADO ABC
17682146;;F;30;CHILENO;;Millenial;MAIPU                         ;METROPOLITANA;0;0;0;0;0;0;0;0;0;PIANO FASHION CON MICROFONO Y PISO;MERCADO ABC
18689524;;F;27;CHILENO;;Millenial;OVALLE                        ;COQUIMBO;0;0;0;0;0;0;0;0;0;JUEGO DE CORTE DE FRUTAS;MERCADO ABC
18707342;;F;28;CHILENO;;Millenial;LA REINA                      ;METROPOLITANA;0;0;0;0;0;0;0;0;0;SET LANZA DARDOS CON ACCESORIOS;MERCADO ABC
18396578;;M;29;CHILENO;;Silencioso;PROVIDENCIA                   ;METROPOLITANA;0;0;0;0;0;0;0;0;0;V-BIANCHI ELIPTICA MAGNETICA E-1600;MERCADO ABC
8200336;;F;63;CHILENO;;Boomers;SAN PEDRO DE LA PAZ           ;BIO BIO;0;0;0;0;0;0;0;0;0;MI MASCOTA DRAGON;MERCADO ABC
16332511;Soltero;F;35;CHILENO;TECNICO JURIDICO;Millenial;PROVIDENCIA                   ;METROPOLITANA;0;0;0;0;0;0;0;0;0;ESTACIONAMIENTO EVOLUTION PRO 5 PISOS;MERCADO ABC
15802705;Soltero;F;37;CHILENO;MEDICO CIRUJANO;Millenial;PROVIDENCIA                   ;METROPOLITANA;0;0;0;0;0;0;0;0;0;SET INSTITUTO DINOSAURIO CON CERCA;MERCADO ABC
13710920;;M;43;CHILENO;;Millenial;SAN BERNARDO                  ;METROPOLITANA;0;0;0;0;0;0;0;0;0;TECLADO CT-S200WE 61 TECLAS CON TRANSFORMADOR;MERCADO ABC
17093754;;M;40;CHILENO;;X;N/D;N/D;0;0;0;0;0;0;0;0;0;HW SURTIDO DE PISTAS DE CAMPEONATO;MERCADO ABC
7288311;;F;68;CHILENO;;Boomers;PROVIDENCIA                   ;METROPOLITANA;0;0;0;0;0;0;0;0;0;LITTLE MOMMY BEBITA INTERACTIVA HORA IR AL BANO;MERCADO ABC
9730138;;F;60;CHILENO;;Boomers;CASTRO                        ;LOS LAGOS;0;0;0;0;0;0;0;0;0;PIRAMIDE BLOQUES 10 PIEZAS;MERCADO ABC
13910067;;F;41;CHILENO;;X;COPIAPO                       ;ATACAMA;0;0;0;0;0;0;0;0;0;AVENGERS TITAN HERO DELUXE WARRIOR THANOS E4018;MERCADO ABC
18048389;;F;30;CHILENO;;Millenial;CASTRO                        ;LOS LAGOS;0;0;0;0;0;0;0;0;0;SILLA METALICA ACERO;MERCADO ABC
10090303;;F;57;CHILENO;;Boomers;RENCA                         ;METROPOLITANA;0;0;0;0;0;0;0;0;0;PACK SABANAS 1,5P GRANATE;MERCADO ABC
12456241;Soltero;F;52;CHILENO;MEDICO CIRUJANO;X;PROVIDENCIA                   ;METROPOLITANA;0;0;0;0;0;0;0;0;0;GUITARRA CLASICA MS139 39 NEGRO;MERCADO ABC
10989422;;M;42;CHILENO;;X;PROVIDENCIA                   ;METROPOLITANA;0;0;0;0;0;0;0;0;0;GUITARRA CLASICA MS139 39 NATURAL;MERCADO ABC
20307743;;F;23;CHILENO;;Z;OVALLE                        ;COQUIMBO;0;0;0;0;0;0;0;0;0;SET MUNECA CON ACCESORIOS SPARKLE GIRLZ;MERCADO ABC
16655794;Soltero;M;35;CHILENO;;Millenial;PROVIDENCIA                   ;METROPOLITANA;0;0;0;0;0;0;0;0;0;PISTA CITY TRACK SERIE;MERCADO ABC
7614035;;F;69;CHILENO;;Silencioso;TALCA                         ;MAULE;0;0;0;0;0;0;0;0;0;PLUMON MICROFIBRA MUSTARD 2P;MERCADO ABC
15761828;;M;37;CHILENO;;Millenial;SAN FELIPE                    ;VALPARAISO;0;0;0;0;0;0;0;0;0;CAMARA FOTO DSC-HX 400 V;MERCADO ABC
6256030;;F;74;CHILENO;;Silencioso;YERBAS BUENAS                 ;MAULE;0;0;0;0;0;0;0;0;0;BATERIA ACERO 5P;MERCADO ABC
16552299;;F;34;CHILENO;;Millenial;"";"";0;0;0;0;0;0;0;0;0;DINOSAURIOS;MERCADO ABC
13091484;;F;46;CHILENO;;X;N/D;N/D;0;0;0;0;0;0;0;0;0;SABANA 144H WHITE KING;MERCADO ABC
15314766;;F;39;CHILENO;;X;N/D;N/D;0;0;0;0;0;0;0;0;0;SUPER GIMNASTA EL DESAFIO E2263;MERCADO ABC
18646821;Soltero;F;28;CHILENO;DISENADOR GRAFICO;Millenial;PROVIDENCIA                   ;METROPOLITANA;0;0;0;0;0;0;0;0;0;PLUMON ESTAMPADO 2P OCRE;MERCADO ABC
17530529;Soltero;F;31;CHILENO;PEDAGOGIA EN EDUCACION MEDIA CON MENCION EN INGLES;Millenial;PROVIDENCIA                   ;METROPOLITANA;0;0;0;0;0;0;0;0;0;CAMIONETA 4X4 EL DEMOLEDOR R/C;MERCADO ABC
25654097;;F;30;VENEZOLANO;;Extranjero;INDEPENDENCIA                 ;METROPOLITANA;0;0;0;0;0;0;0;0;0;SILLA METALICA NEGRO;MERCADO ABC
19496655;;F;25;CHILENO;;Z;"";"";0;0;0;0;0;0;0;0;0;SABANA 144H LIGHT ROUGE 2P;MERCADO ABC
11599841;Casado;M;52;CHILENO;;X;RENCA                         ;METROPOLITANA;0;0;0;0;0;0;0;0;0;UKELELE SOPRANO;MERCADO ABC
7191097;Casado;F;64;CHILENO;MATRONA;Boomers;PROVIDENCIA                   ;METROPOLITANA;0;0;0;0;0;0;0;0;0;COLUMPIO TERRAZA C/QUITASOL VERDE 469 PLI;MERCADO ABC
13858125;;M;42;CHILENO;;X;TALCA                         ;MAULE;0;0;0;0;0;0;0;0;0;SABANA 144H LIGHT BLUE 1,5P;MERCADO ABC
10439766;Casado;F;56;CHILENO;;Boomers;RENCA                         ;METROPOLITANA;0;0;0;0;0;0;0;0;0;SABANA 144H LIGHT MUSTARD 2P;MERCADO ABC
9155348;;F;59;CHILENO;;Boomers;SANTIAGO;METROPOLITANA;0;0;0;0;0;0;0;0;0;MI PRIMERA MASCOTA;MERCADO ABC
7355788;Casado;F;61;CHILENO;;Boomers;SANTIAGO                      ;METROPOLITANA;0;0;0;0;0;0;0;0;0;PISO BANO OVALADO 40X60;MERCADO ABC
16811730;;F;34;CHILENO;;Millenial;COIHAIQUE                     ;AYSEN;479970;3;2;2;1;429980;1;1;49990;Lavadora Secadora MLSF-13510SC01I 13,5Kg/10Kg Gr;LINEA BLANCA
7450623;;M;68;CHILENO;;Boomers;DONIHUE                       ;L.G.B.OÂ´HIGGINS;1083530;12;5;0;0;0;12;5;1083530;Lavadora Semiautomatica Twister 5300 4Kg;LINEA BLANCA
9637636;;F;54;CHILENO;;Boomers;PAINE                         ;METROPOLITANA;933220;8;2;0;0;0;8;2;933220;COCINA CH-6700IN 4P;LINEA BLANCA
18643853;;F;28;CHILENO;;Millenial;N/D;N/D;249990;1;1;1;1;249990;0;0;0;Lavadora Efficace SZG 17,5Kg Silver;LINEA BLANCA
9361686;;M;60;CHILENO;;Boomers;SAN FELIPE                    ;VALPARAISO;419980;2;2;0;0;0;2;2;419980;Lavadora Efficace SZG 17,5Kg Silver;LINEA BLANCA
8195590;;F;65;CHILENO;;Boomers;PROVIDENCIA                   ;METROPOLITANA;727750;6;2;0;0;0;6;2;727750;Refrigerador 432Lts Side by Side MDRS619FGE46;LINEA BLANCA
5074569;;F;77;CHILENO;;Silencioso;BUIN                          ;METROPOLITANA;189980;2;1;0;0;0;2;1;189980;Lavadora 9,5Kg BZG Blanca;LINEA BLANCA
18217970;;F;29;CHILENO;;Millenial;N/D;N/D;401980;2;1;2;1;401980;0;0;0;Lavadora Secadora MLSF-13510SC01I 13,5Kg/10Kg Gr;LINEA BLANCA
13852023;Soltero;M;41;CHILENO;PSICOLOGO;X;PROVIDENCIA                   ;METROPOLITANA;459960;4;2;4;2;459960;0;0;0;Lavadora Efficace SZG 17,5Kg Silver;LINEA BLANCA
16805226;;M;34;CHILENO;;Millenial;PROVIDENCIA                   ;METROPOLITANA;553500;6;4;2;1;78540;4;3;474960;Freezer 162 Lts SFV-205 SI Vertical;LINEA BLANCA
8858030;;M;62;CHILENO;;Millenial;"";"";603770;4;2;0;0;0;4;2;603770;Refrigerador 317 Lts No frost IF32;LINEA BLANCA
19782614;;M;24;CHILENO;;Z;PROVIDENCIA                   ;METROPOLITANA;279980;2;1;0;0;0;2;1;279980;Lavadora Efficace SZG 17,5Kg Silver;LINEA BLANCA
9285550;;F;64;CHILENO;;Boomers;N/D;N/D;323200;3;2;0;0;0;3;2;323200;Lavadora Efficace SZG 17,5Kg Silver;LINEA BLANCA
8553253;;M;59;CHILENO;;Boomers;PENAFLOR                      ;METROPOLITANA;270700;5;1;0;0;0;5;1;270700;Lavadora Efficace SZG 17,5Kg Silver;LINEA BLANCA
15278501;;F;40;CHILENO;;X;PROVIDENCIA                   ;METROPOLITANA;398980;2;1;2;1;398980;0;0;0;Lavadora Secadora MLSF-13510SC01I 13,5Kg/10Kg Gr;LINEA BLANCA
7633742;Casado;M;65;CHILENO;;Boomers;SAN FELIPE                    ;VALPARAISO;314970;3;2;0;0;0;3;2;314970;Refrigerador 244Lts Frio Directo Progress 3100;LINEA BLANCA
13417812;;F;44;CHILENO;;X;PROVIDENCIA                   ;METROPOLITANA;639970;3;3;0;0;0;3;3;639970;Lavadora Efficace SZG 17,5Kg Silver;LINEA BLANCA
16891570;;F;25;CHILENO;;Z;"";"";1070240;7;4;3;2;618970;4;2;451270;Refrigerador 432Lts Side by Side MDRS619FGE46;LINEA BLANCA
16013328;;M;37;CHILENO;;Millenial;ARAUCO;BIO-BIO;1930930;9;7;2;2;829980;7;5;1100950;Lavadora Secadora WD10WVC4S6 10,5/6Kg Blanca;LINEA BLANCA
8795371;;F;67;CHILENO;;Boomers;N/D;N/D;766910;9;7;0;0;0;9;7;766910;Lavadora Efficace SZG 15,5Kg Silver;LINEA BLANCA
10166304;;M;57;CHILENO;;Boomers;LA FLORIDA                    ;METROPOLITANA;326110;5;2;0;0;0;5;2;326110;Lavadora WA80H4200SW1ZS 8Kg Blanca;LINEA BLANCA
9957909;;M;58;CHILENO;;Boomers;RENGO                         ;L.G.B.OÂ´HIGGINS;109990;1;3;0;0;0;1;3;109990;Calefont 5Lts GL Essenetial ECO;LINEA BLANCA
7040884;;M;63;CHILENO;;Boomers;NUEVA IMPERIAL                ;ARAUCANIA;189980;2;1;0;0;0;2;1;189980;Calefont 8Lts GL Essenetial ECO;LINEA BLANCA
9016477;;F;62;CHILENO;;Boomers;SAN ANTONIO                   ;VALPARAISO;1724560;12;9;3;2;470970;9;7;1253590;Cocina MCG-4QI24NS 4P;LINEA BLANCA
17889200;Soltero;F;31;CHILENO;INGENIERO CIVIL ELECTRICO;Millenial;PROVIDENCIA                   ;METROPOLITANA;179980;2;1;2;1;179980;0;0;0;Secadora 7Kg 7D BZG Ventilacion Blanca;LINEA BLANCA
13709798;;F;43;CHILENO;;X;PEDRO AGUIRRE CERDA;METROPOLITANA;189980;2;1;2;1;189980;0;0;0;Lavadora 9,5Kg BZG Blanca;LINEA BLANCA
19032131;;M;27;CHILENO;;Z;CANETE                        ;BIO BIO;4701267;25;18;0;0;0;25;18;4701267;CANASTO TEXTURA RATAN TAPA ABATIBLE;LINEA BLANCA
10064181;;M;58;CHILENO;;Boomers;MAIPU                         ;METROPOLITANA;16525017;110;39;10;2;1463000;100;37;15062017;Cocina CMC20AXX-1 4P Inox;LINEA BLANCA
9209522;;M;60;CHILENO;;Boomers;MELIPILLA                     ;METROPOLITANA;553670;4;2;0;0;0;4;2;553670;Refrigerador 303Lts BF Frio Directo Nordik 480;LINEA BLANCA
12136112;;M;47;CHILENO;;Extranjero;MONTE PATRIA;COQUIMBO;271980;2;1;2;1;271980;0;0;0;Lavadora Efficace SZG 17,5Kg Silver;LINEA BLANCA
12394032;;M;48;CHILENO;;X;PUNTA ARENAS                  ;MAGALLANES;911720;8;3;0;0;0;8;3;911720;Refrigerador 535Lts Side by Side RS54N3003SL/ZS;LINEA BLANCA
18922722;;M;27;CHILENO;;Millenial;COQUIMBO                      ;COQUIMBO;259990;1;1;0;0;0;1;1;259990;Refrigerador 260Lts BF Frio Direc MRFI2660SR346W;LINEA BLANCA
9671340;;F;60;CHILENO;;Boomers;N/D;N/D;627000;8;3;2;1;224980;6;2;402020;Cocina CH-7400 4P;LINEA BLANCA
19506750;;M;25;CHILENO;;Z;PROVIDENCIA                   ;METROPOLITANA;299980;2;2;1;1;109990;1;1;189990;Secadora Ropa MD100A90/W 9Kg Ventilacion Blanca;LINEA BLANCA
9968557;;F;54;CHILENO;;Boomers;QUEILEN;LOS LAGOS;342960;4;2;2;1;122980;2;1;219980;ENCIMERA AT-XNG FEIN FF GL 4P ALBIN TROTTER;LINEA BLANCA
6804625;;F;69;CHILENO;;Silencioso;HUALPEN;BIO BIO;267980;2;1;0;0;0;2;1;267980;Lavadora Efficace SZG 17,5Kg Silver;LINEA BLANCA
9544061;;F;62;CHILENO;;Boomers;MULCHEN                       ;BIO BIO;578920;4;2;0;0;0;4;2;578920;Lavadora Premium Care 20SZ 20Kg Silver;LINEA BLANCA
18333296;Soltero;M;30;CHILENO;;Millenial;LAS CABRAS                    ;L.G.B.OÂ´HIGGINS;412130;3;2;0;0;0;3;2;412130;Secadora Electrica SEM101BDBY Blanca 10 KG;LINEA BLANCA
16126787;;F;36;CHILENO;;Millenial;RANCAGUA;O HIGGINS;169980;2;1;2;1;169980;0;0;0;Lavadora MLS-090GE04N 9Kg Gris;LINEA BLANCA
6412223;;M;71;CHILENO;;Silencioso;SAN BERNARDO                  ;METROPOLITANA;393350;4;4;0;0;0;4;4;393350;Lavadora Premium Care Pro 16Kg Silver;LINEA BLANCA
19882365;;F;24;CHILENO;;Z;PROVIDENCIA                   ;METROPOLITANA;990080;8;4;3;2;402970;5;2;587110;Cocina CH-7400 4P;LINEA BLANCA
14043414;;F;43;CHILENO;;X;CHILE CHICO                   ;AYSEN;1412530;6;8;0;0;0;6;8;1412530;Lavadora WT13WSBP 13Kg Blanca;LINEA BLANCA
18691770;;F;28;CHILENO;;Millenial;PUNTA ARENAS                  ;MAGALLANES;976190;7;5;0;0;0;7;5;976190;Cocina MCG-5QI30NS 5P;LINEA BLANCA
5627680;;F;74;CHILENO;;Silencioso;EL MONTE                      ;METROPOLITANA;802900;10;7;0;0;0;10;7;802900;Cocina F 2608 T 4P Reflex Silver;LINEA BLANCA
5923917;;F;73;CHILENO;;Silencioso;QUILICURA                     ;METROPOLITANA;924750;13;7;0;0;0;13;7;924750;Cocina F 2608 T 4P Reflex Silver;LINEA BLANCA
10368263;Divorciado;F;52;CHILENO;ASISTENTE SOCIAL;X;RENCA                         ;METROPOLITANA;159980;2;1;2;1;159980;0;0;0;Freezer 145 Lts FDHM150BY0 Horizontal;LINEA BLANCA
17828383;;F;30;CHILENO;;Millenial;OVALLE                        ;COQUIMBO;202970;3;3;0;0;0;3;3;202970;Lavadora MLS-090GE04N 9Kg Gris;LINEA BLANCA
18871253;;F;27;CHILENO;;Millenial;PROVIDENCIA                   ;METROPOLITANA;281980;2;1;2;1;281980;0;0;0;Lavadora Efficace SZG 17,5Kg Silver;LINEA BLANCA
16514766;;M;35;CHILENO;;Millenial;CANETE                        ;BIO BIO;526960;4;3;0;0;0;4;3;526960;Calefont 10Lts GL Essenetial ECO;LINEA BLANCA
7246064;Soltero;M;66;CHILENO;;Boomers;PROVIDENCIA                   ;METROPOLITANA;244130;4;1;0;0;0;4;1;244130;Freezer 145 Lts FDHM150BY0 Horizontal;LINEA BLANCA
20475212;;F;21;CHILENO;;Z;"";"";313030;5;3;0;0;0;5;3;313030;Secadora 7Kg 7D BZG Ventilacion Blanca;LINEA BLANCA
16414385;;F;35;CHILENO;;Silencioso;PROVIDENCIA                   ;METROPOLITANA;229980;2;1;0;0;0;2;1;229980;Secadora 9 Kg 9D BZG Ventilacion Blanca;LINEA BLANCA
15682328;;M;39;CHILENO;;X;LA FLORIDA                    ;METROPOLITANA;391640;5;2;0;0;0;5;2;391640;Lavadora 9,5Kg BZG Blanca;LINEA BLANCA
8601288;;F;62;CHILENO;;Boomers;CATEMU                        ;VALPARAISO;166620;4;3;0;0;0;4;3;166620;Calefont 5Lts GL Essenetial ECO;LINEA BLANCA
27029879;;F;35;VENEZOLANO;;Extranjero;N/D;N/D;300370;2;1;0;0;0;2;1;300370;Lavadora Efficace SZG 17,5Kg Silver;LINEA BLANCA
13983516;;F;41;CHILENO;;X;ISLA DE PASCUA                ;VALPARAISO;1081940;6;4;0;0;0;6;4;1081940;Refrigerador 527Lts Side by Side MRSBS5300G689WE;LINEA BLANCA
9104696;;F;59;CHILENO;;Boomers;OVALLE                        ;COQUIMBO;955960;4;2;0;0;0;4;2;955960;Calefont 5Lts GL Essenetial ECO;LINEA BLANCA
10799888;;M;50;CHILENO;;X;RENCA                         ;METROPOLITANA;139980;2;1;2;1;139980;0;0;0;Freezer Horizontal M100 99Lts;LINEA BLANCA
11850709;;M;51;CHILENO;;Millenial;"";"";269110;5;3;0;0;0;5;3;269110;Freezer 145 Lts FDHM150BY0 Horizontal;LINEA BLANCA
17446465;;F;32;CHILENO;;Millenial;ISLA DE MAIPO                 ;METROPOLITANA;707610;8;5;0;0;0;8;5;707610;Lavadora 9 Kg Carga Superior Blanca;LINEA BLANCA
11852878;;F;51;CHILENO;;X;N/D;N/D;619960;4;5;0;0;0;4;5;619960;Cocina MCG-5QI30NS 5P;LINEA BLANCA
12566816;;F;48;CHILENO;;X;TOCOPILLA                     ;ANTOFAGASTA;522060;5;3;0;0;0;5;3;522060;REFRIGERADOR TOP MOUNT NO FROST RD-32WRD 246L;LINEA BLANCA
17923359;;M;31;CHILENO;;Millenial;PUENTE ALTO                   ;METROPOLITANA;301980;2;1;0;0;0;2;1;301980;Lavadora WA13T5260BW/ZS 13Kg Blanca;LINEA BLANCA
13725994;;F;43;CHILENO;;X;CORONEL                       ;BIO BIO;783810;4;2;2;1;358980;2;1;424830;Lavadora Premium Care 20SZ 20Kg Silver;LINEA BLANCA
13705453;;F;43;CHILENO;;X;EL BOSQUE                     ;METROPOLITANA;367880;3;1;0;0;0;3;1;367880;Lavadora Efficace SZG 17,5Kg Silver;LINEA BLANCA
17151946;Soltero;M;33;CHILENO;INGENIERIA EN MAQUINARIA VEHICULOS AUTOMOTRICES Y SISTEMAS ELECTRONICOS;Silencioso;PROVIDENCIA                   ;METROPOLITANA;189980;2;1;2;1;189980;0;0;0;Lavadora 9,5Kg BZG Blanca;LINEA BLANCA
17517181;;F;31;CHILENO;;Millenial;PROVIDENCIA                   ;N/D;269290;2;1;0;0;0;2;1;269290;Cocina CH-7400 4P;LINEA BLANCA
17068509;;F;33;CHILENO;;Silencioso;PANGUIPULLI                   ;LOS LAGOS;979310;8;3;0;0;0;8;3;979310;Lavadora Efficace SZG 17,5Kg Silver;LINEA BLANCA
14699584;;F;50;BOLIVIANO;;X;ARICA                         ;TARAPACA;1188180;12;6;0;0;0;12;6;1188180;Lavadora Efficace SZG 17,5Kg Silver;LINEA BLANCA
8799240;;F;60;CHILENO;;Boomers;TALCA                         ;MAULE;393080;4;1;0;0;0;4;1;393080;Refrigerador 303Lts BF Frio Directo Nordik 480;LINEA BLANCA
19725892;;F;24;CHILENO;;Z;EL CARMEN;BIO-BIO;215830;3;2;3;2;215830;0;0;0;Centrifuga Primma 5B 5,5Kilos;LINEA BLANCA
6585824;;M;70;CHILENO;;Silencioso;RENCA                         ;METROPOLITANA;139990;1;1;0;0;0;1;1;139990;Calefon ionizado 5 litros GL HydroSense;LINEA BLANCA
10884209;;M;54;CHILENO;;X;VALDIVIA                      ;LOS LAGOS;506370;3;1;0;0;0;3;1;506370;Lavadora Secadora WD95T4046CE/ZS 9,5Kg/6Kg Blanc;LINEA BLANCA
10835538;;F;53;CHILENO;;X;PUENTE ALTO                   ;METROPOLITANA;574310;7;3;0;0;0;7;3;574310;Cocina F 2608 T 4P Reflex Silver;LINEA BLANCA
15627343;;M;39;CHILENO;;X;"";"";501980;2;1;0;0;0;2;1;501980;Lavadora Secadora WD10WVC4S6 10,5/6Kg Blanca;LINEA BLANCA
14073440;;F;42;CHILENO;;X;N/D;N/D;529007;6;4;0;0;0;6;4;529007;Secadora 7Kg 7D BZG Ventilacion Blanca;LINEA BLANCA
11152633;;F;55;CHILENO;;Boomers;CORONEL                       ;BIO BIO;395060;2;1;0;0;0;2;1;395060;Lavadora Efficace SZG 19,5Kg Silver;LINEA BLANCA
16378447;;M;36;CHILENO;;Millenial;N/D;N/D;619930;7;5;3;2;179970;4;3;439960;Centrifuga Primma 5B 5,5Kilos;LINEA BLANCA
13917994;;M;41;CHILENO;;X;N/D;N/D;950850;8;3;0;0;0;8;3;950850;Cocina F 2525 T 4P Silver;LINEA BLANCA
12065431;;F;50;CHILENO;;X;PROVIDENCIA                   ;METROPOLITANA;209990;2;1;2;1;209990;0;0;0;Refrigerador 241Lts BF Frio Directo Nordik 415;LINEA BLANCA
15544672;;M;38;CHILENO;;Millenial;PROVIDENCIA                   ;METROPOLITANA;760910;9;5;0;0;0;9;5;760910;Lavadora MLS-190GC03N 19Kg Gris;LINEA BLANCA
17750624;;F;31;CHILENO;;Millenial;LOS ALAMOS                    ;BIO BIO;567950;5;3;0;0;0;5;3;567950;Lavadora WT19DSBP 19Kg Silver;LINEA BLANCA
17900234;;F;30;CHILENO;;Millenial;PROVIDENCIA                   ;METROPOLITANA;208980;2;1;2;1;208980;0;0;0;TERMO ELECTRICO 50 LITROS (SPLENDID);LINEA BLANCA
25192701;;M;34;HAITIANO;;Extranjero;RENCA                         ;METROPOLITANA;259980;2;1;2;1;259980;0;0;0;Lavadora Efficace SZG 17,5Kg Silver;LINEA BLANCA
18345716;;F;29;CHILENO;;Millenial;LOS ANGELES                   ;BIO BIO;169990;1;1;0;0;0;1;1;169990;Lavadora MLS-090GE04N 9Kg Gris;LINEA BLANCA
12626434;;M;47;CHILENO;;Silencioso;PROVIDENCIA                   ;METROPOLITANA;366970;3;2;3;2;366970;0;0;0;Lavadora Frontal MLF-085BE08N 8,5Kg Blanca;LINEA BLANCA
16260757;;M;36;CHILENO;;Millenial;CABILDO                       ;VALPARAISO;333960;4;3;0;0;0;4;3;333960;Secadora Electrica SEM101BDBY Blanca 10 KG;LINEA BLANCA
16761656;;M;34;CHILENO;;Millenial;PROVIDENCIA                   ;METROPOLITANA;228980;2;1;2;1;228980;0;0;0;Secadora 9 Kg 9D BZG Ventilacion Blanca;LINEA BLANCA
11355503;;F;54;CHILENO;;X;CALBUCO                       ;LOS LAGOS;695940;6;5;0;0;0;6;5;695940;Calefont 8Lts GL Essenetial ECO;LINEA BLANCA
14374447;Casado;M;46;CHILENO;;Extranjero;PROVIDENCIA                   ;N/D;397980;2;1;2;1;397980;0;0;0;KIT - TRIO HE KURZ-BREIT4P-REIN60;LINEA BLANCA
23945757;;M;54;ECUATORIANO;;Extranjero;CHILLAN                       ;BIO BIO;649980;2;1;0;0;0;2;1;649980;Refrigerador 254Lts No Frost GT29WPPDC;LINEA BLANCA
8747123;;M;60;CHILENO;;Boomers;MELIPILLA                     ;METROPOLITANA;987920;9;5;0;0;0;9;5;987920;Secadora Ropa MD100A90/W 9Kg Ventilacion Blanca;LINEA BLANCA
8717902;;F;62;CHILENO;;Boomers;LA PINTANA                    ;METROPOLITANA;283950;2;1;0;0;0;2;1;283950;Lavadora Efficace SZG 17,5Kg Silver;LINEA BLANCA
25003788;Soltero;M;40;VENEZOLANO;;Extranjero;PROVIDENCIA                   ;METROPOLITANA;243980;2;1;2;1;243980;0;0;0;TERMO ELECTRICO 80 LITROS (SPLENDID);LINEA BLANCA
6644539;;F;73;CHILENO;;Silencioso;LA FLORIDA                    ;METROPOLITANA;983610;8;3;0;0;0;8;3;983610;Refrigerador 318Lts No Frost RT32K5730SL/ZS;LINEA BLANCA
5715122;Casado;M;70;CHILENO;;Silencioso;SAN JAVIER                    ;MAULE;990170;8;2;0;0;0;8;2;990170;Lavadora Efficace SZG 17,5Kg Silver;LINEA BLANCA
18313939;;M;29;CHILENO;;Millenial;ALTO HOSPICIO;TARAPACA;532460;4;2;2;1;153980;2;1;378480;CAMPANA T A/I CTE 80CM ALBIN TROTTER;LINEA BLANCA
15091648;;M;39;CHILENO;;X;"";"";224960;4;5;0;0;0;4;5;224960;Secadora Ropa MD100A90/W 9Kg Ventilacion Blanca;LINEA BLANCA
10691654;;F;55;CHILENO;;Boomers;SAN VICENTE                   ;L.G.B.OÂ´HIGGINS;610360;4;2;0;0;0;4;2;610360;Lavadora Premium Care 20SZ 20Kg Silver;LINEA BLANCA
13323608;;M;45;CHILENO;;X;NATALES                       ;MAGALLANES;1659900;10;4;0;0;0;10;4;1659900;Refrigerador 527Lts Side by Side MRSBS5300G689WE;LINEA BLANCA
17824932;Casado;F;30;CHILENO;PSICOLOGA;Millenial;PROVIDENCIA                   ;METROPOLITANA;176980;2;1;2;1;176980;0;0;0;Lavadora MLS-090GE04N 9Kg Gris;LINEA BLANCA
6313217;;M;72;CHILENO;;Silencioso;HUASCO                        ;ATACAMA;139990;1;1;0;0;0;1;1;139990;Calefon ionizado 5 litros GL HydroSense;LINEA BLANCA
19093164;;F;27;CHILENO;;Z;PROVIDENCIA                   ;METROPOLITANA;69980;2;1;2;1;69980;0;0;0;SECADORA SR-10 8KG GRIS SINDELEN;LINEA BLANCA
11960863;;F;50;CHILENO;;X;ARAUCO                        ;BIO BIO;278860;3;1;0;0;0;3;1;278860;Lavadora Efficace SZG 17,5Kg Silver;LINEA BLANCA
5433287;;F;77;CHILENO;;Silencioso;NUNOA                         ;METROPOLITANA;289980;2;1;0;0;0;2;1;289980;Cocina F 2608 T 4P Reflex Silver;LINEA BLANCA
11393133;;F;53;CHILENO;;X;PUENTE ALTO;METROPOLITANA;483950;6;3;6;3;483950;0;0;0;Lavadora WA90H4400SW1ZS 9Kg Blanca;LINEA BLANCA
17145956;Soltero;F;33;CHILENO;;Millenial;CAUQUENES                     ;MAULE;288380;7;3;0;0;0;7;3;288380;Secadora Ropa MD100A90/W 9Kg Ventilacion Blanca;LINEA BLANCA
16746784;;F;34;CHILENO;;Millenial;N/D;N/D;963860;17;7;0;0;0;17;7;963860;Lavadora Efficace SZG 19,5Kg Silver;LINEA BLANCA
6000100;;M;74;CHILENO;;Silencioso;RENCA                         ;METROPOLITANA;201970;3;2;0;0;0;3;2;201970;Centrifuga Primma 5B 5,5Kilos;LINEA BLANCA
18778066;;M;27;CHILENO;;Millenial;MARIA PINTO                   ;METROPOLITANA;1019970;3;2;0;0;0;3;2;1019970;Lavadora Efficace SZG 15,5Kg Silver;LINEA BLANCA
13777627;;F;42;CHILENO;;X;PROVIDENCIA                   ;METROPOLITANA;173980;2;1;2;1;173980;0;0;0;Refrigerador 180Lts BF Frio Directo MDRB275FGF42;LINEA BLANCA
4565494;;M;77;CHILENO;;Silencioso;PUCON                         ;ARAUCANIA;435970;3;1;0;0;0;3;1;435970;Lavadora MLS-190GC03N 19Kg Gris;LINEA BLANCA
9599874;;M;59;CHILENO;;Boomers;ANGOL                         ;ARAUCANIA;303950;2;1;0;0;0;2;1;303950;Cocina F 2608 T 4P Reflex Silver;LINEA BLANCA
9357131;;F;61;CHILENO;;Boomers;PALMILLA                      ;L.G.B.OÂ´HIGGINS;381970;4;2;0;0;0;4;2;381970;Secadora 9 Kg 9D BZG Ventilacion Blanca;LINEA BLANCA
6421778;;M;72;CHILENO;;Silencioso;PERALILLO                     ;L.G.B.OÂ´HIGGINS;382860;3;2;0;0;0;3;2;382860;Lavadora Efficace SZG 15,5Kg Silver;LINEA BLANCA
15409127;;M;38;CHILENO;;X;SAAVEDRA                      ;ARAUCANIA;430660;4;3;0;0;0;4;3;430660;Secadora Ropa MD100A90/W 9Kg Ventilacion Blanca;LINEA BLANCA
11375938;;M;53;CHILENO;;X;N/D;N/D;1412860;14;8;2;1;313980;12;7;1098880;Lavadora Efficace SZG 19,5Kg Silver;LINEA BLANCA
15257527;;M;40;CHILENO;;X;VILLARICA                     ;ARAUCANIA;199990;1;1;0;0;0;1;1;199990;Freezer Horizontal M 150 142Lts;LINEA BLANCA
14354557;;F;43;CHILENO;;X;RENCA                         ;METROPOLITANA;129990;2;1;2;1;129990;0;0;0;Calefont 10Lts GL Essenetial ECO;LINEA BLANCA
15733055;Soltero;M;38;CHILENO;PROFESOR;Millenial;RENCA                         ;METROPOLITANA;159990;2;1;2;1;159990;0;0;0;Lavadora Semiautomatica Twister 5100 4Kg;LINEA BLANCA
12738772;;M;47;CHILENO;;X;LA PINTANA                    ;METROPOLITANA;371770;6;4;0;0;0;6;4;371770;Secadora Electrica SEM101BDBY Blanca 10 KG;LINEA BLANCA
9210362;;M;59;CHILENO;;Boomers;VILLARICA                     ;ARAUCANIA;500630;6;3;0;0;0;6;3;500630;Cocina CMC20AXX-1 4P Inox;LINEA BLANCA
10274266;;F;57;CHILENO;;Boomers;VILLARICA                     ;ARAUCANIA;268880;2;2;0;0;0;2;2;268880;Secadora 9 Kg 9D BZG Ventilacion Blanca;LINEA BLANCA
16761012;;M;34;CHILENO;;Millenial;PENCO                         ;BIO BIO;401970;3;2;0;0;0;3;2;401970;Cocina F 5500 T 5P Reflex Silver;LINEA BLANCA
13254513;;F;45;CHILENO;;X;RENCA                         ;METROPOLITANA;169980;2;1;2;1;169980;0;0;0;Lavadora MLS-090GE04N 9Kg Gris;LINEA BLANCA
11071563;;F;56;CHILENO;;Boomers;MAULE                         ;MAULE;119990;1;1;0;0;0;1;1;119990;Calefont 5Lts GL Essenetial ECO;LINEA BLANCA
6138879;;M;72;CHILENO;;Silencioso;ILLAPEL                       ;COQUIMBO;1313800;8;8;0;0;0;8;8;1313800;Lavadora Premium Care 20SZ 20Kg Silver;LINEA BLANCA
20567883;;M;21;CHILENO;;Z;SAN ANTONIO;VALPARAISO;431800;4;2;0;0;0;4;2;431800;Secadora Ropa MD100A90/W 9Kg Ventilacion Blanca;LINEA BLANCA
17001654;;M;34;CHILENO;;Millenial;"";"";289980;2;1;0;0;0;2;1;289980;Lavadora Efficace SZG 19,5Kg Silver;LINEA BLANCA
26278864;;F;42;ECUATORIANO;;Extranjero;N/D;N/D;1527260;11;6;0;0;0;11;6;1527260;Calefont 10Lts GL Essenetial ECO;LINEA BLANCA
11946331;;F;52;CHILENO;;X;N/D;N/D;607962;10;6;4;2;194960;6;4;413002;Refrigerador MDRT414FGE02 294 Lts Frio Directo;LINEA BLANCA
18661266;Soltero;F;28;CHILENO;PROFESOR;Millenial;PROVIDENCIA                   ;METROPOLITANA;64980;2;1;2;1;64980;0;0;0;SECADORA SR-10 8KG GRIS SINDELEN;LINEA BLANCA
7668538;;M;64;CHILENO;;Boomers;PAINE                         ;METROPOLITANA;179970;3;2;0;0;0;3;2;179970;Lavadora MLS-090GE04N 9Kg Gris;LINEA BLANCA
6359879;;F;76;CHILENO;;Silencioso;RENCA                         ;METROPOLITANA;309250;2;1;0;0;0;2;1;309250;Cocina M 775 ST 4P Silver;LINEA BLANCA
19211938;;M;26;CHILENO;;Silencioso;TALAGANTE                     ;METROPOLITANA;366240;6;2;0;0;0;6;2;366240;Lavadora Efficace SZG 15,5Kg Silver;LINEA BLANCA
6526946;;F;68;CHILENO;;Boomers;RENGO                         ;L.G.B.OÂ´HIGGINS;221430;2;1;0;0;0;2;1;221430;Secadora Ropa MD100A90/W 9Kg Ventilacion Blanca;LINEA BLANCA
7724934;;M;63;CHILENO;;Silencioso;FREIRE                        ;ARAUCANIA;404730;3;1;0;0;0;3;1;404730;Lavadora WA17T6260BW/ZS 17Kg Blanca;LINEA BLANCA
16395734;;F;35;CHILENO;;Millenial;N/D;N/D;181980;2;1;2;1;181980;0;0;0;Lavadora WA80H4200SW1ZS 8Kg Blanca;LINEA BLANCA
7056218;;M;68;CHILENO;;Boomers;CALERA                        ;VALPARAISO;393860;3;2;0;0;0;3;2;393860;Cocina CH-8700IN 5P;LINEA BLANCA
6311672;;F;69;CHILENO;;Silencioso;N/D;N/D;2321100;15;6;0;0;0;15;6;2321100;Cocina Lena Angelina Blanca;LINEA BLANCA
12407350;;F;49;CHILENO;;X;SAN BERNARDO                  ;METROPOLITANA;257490;3;1;0;0;0;3;1;257490;Refrigerador 249Lts No Frost RMA250PHUG;LINEA BLANCA
11580920;;F;52;CHILENO;;X;LOS ALAMOS                    ;BIO BIO;1643780;8;7;9;5;1604630;-1;2;39150;Cocina F 5500 T 5P Reflex Silver;LINEA BLANCA
11267095;;M;54;CHILENO;;X;PUENTE ALTO                   ;METROPOLITANA;626940;6;5;0;0;0;6;5;626940;Lavadora Semiautomatica Twister 5300 4Kg;LINEA BLANCA
14007885;;F;40;CHILENO;;X;"";"";590980;2;1;2;1;590980;0;0;0;COCINA LENA ENLOZADA 72x56;LINEA BLANCA
13568272;;F;43;CHILENO;;X;N/D;N/D;523960;4;2;4;2;523960;0;0;0;Secadora 9 Kg 9D BZG Ventilacion Blanca;LINEA BLANCA
5652401;;F;78;CHILENO;;Silencioso;CHILLAN                       ;BIO BIO;296960;5;2;0;0;0;5;2;296960;Secadora 7Kg 7D BZG Ventilacion Blanca;LINEA BLANCA
8213223;;F;66;CHILENO;;Boomers;PENAFLOR                      ;METROPOLITANA;279460;5;2;0;0;0;5;2;279460;Secadora 9 Kg 9D BZG Ventilacion Blanca;LINEA BLANCA
7339152;Casado;M;69;CHILENO;TECNOLOGO MEDICO;Silencioso;PROVIDENCIA                   ;METROPOLITANA;370870;2;1;0;0;0;2;1;370870;Lavadora WA17T6260BW/ZS 17Kg Blanca;LINEA BLANCA
19482071;;F;26;CHILENO;;Z;LINARES                       ;MAULE;288470;3;2;0;0;0;3;2;288470;Refrigerador 260Lts BF Frio Direc MRFI2660SR346W;LINEA BLANCA
14111488;;M;41;CHILENO;;X;ANTOFAGASTA                   ;ANTOFAGASTA;279970;3;1;3;1;279970;0;0;0;Lavadora Efficace SZG 17,5Kg Silver;LINEA BLANCA
8011179;;F;49;CHILENO;;X;RENCA                         ;METROPOLITANA;324980;2;1;2;1;324980;0;0;0;Lavadora WA17T6260BW/ZS 17Kg Blanca;LINEA BLANCA
10466482;;F;58;CHILENO;;Boomers;SAN JAVIER                    ;MAULE;1097490;6;3;1;1;299990;5;2;797500;Refrigerador 290Lts BF No Frost RB30N4020S8;LINEA BLANCA
18351801;;F;29;CHILENO;;Millenial;PROVIDENCIA                   ;METROPOLITANA;330980;2;1;0;0;0;2;1;330980;Refrigerador 290LTS No Frost RMB302PXLRS0;LINEA BLANCA
13168458;Soltero;F;44;CHILENO;;X;RENCA                         ;METROPOLITANA;284980;2;2;0;0;0;2;2;284980;Lavadora MLS-160BSC03T 16Kg Blanca;LINEA BLANCA
14321705;;F;45;CHILENO;;X;N/D;N/D;3339660;23;5;0;0;0;23;5;3339660;Cocina F 5500 T 5P Reflex Silver;LINEA BLANCA
12687428;;M;47;CHILENO;;X;SAN RAMON                     ;METROPOLITANA;313520;3;1;0;0;0;3;1;313520;Cocina CH-6900IN 4P;LINEA BLANCA
16090347;;F;37;CHILENO;;Millenial;CONSTITUCION                  ;MAULE;597940;7;4;0;0;0;7;4;597940;Calefont 5Lts GL Essenetial ECO;LINEA BLANCA
26546584;;F;34;VENEZOLANO;;Extranjero;N/D;N/D;849890;8;1;0;0;0;8;1;849890;Refrigerador 322Lts No Frost BF DB60S;LINEA BLANCA
15015025;;F;40;CHILENO;;Silencioso;PROVIDENCIA                   ;METROPOLITANA;159990;1;1;1;1;159990;0;0;0;Lavadora Semiautomatica Twister 5300 4Kg;LINEA BLANCA
5975100;;F;70;CHILENO;;Millenial;"";"";259970;3;2;0;0;0;3;2;259970;Campana Cocina CA610EIN 60Cms Inox;LINEA BLANCA
10372861;;F;55;CHILENO;;Boomers;RENCA                         ;METROPOLITANA;306980;2;1;0;0;0;2;1;306980;Lavadora Efficace SZG 15,5Kg Silver;LINEA BLANCA
15113256;;M;39;CHILENO;;X;RENGO                         ;L.G.B.OÂ´HIGGINS;179990;1;1;0;0;0;1;1;179990;Secadora Ropa MSV-90 9K Blanca Ventilacion;LINEA BLANCA
18881180;;F;27;CHILENO;;Millenial;PROVIDENCIA                   ;METROPOLITANA;269980;2;1;2;1;269980;0;0;0;Refrigerador MDRB424FGE46 302 Lts No Frost;LINEA BLANCA
26587055;Soltero;M;40;NO INFORMA NACIONALIDAD;;Extranjero;N/D;N/D;377980;2;1;2;1;377980;0;0;0;Lavadora Secadora MLSF-13510SC01I 13,5Kg/10Kg Gr;LINEA BLANCA
5463709;;M;79;CHILENO;;Silencioso;CARTAGENA                     ;VALPARAISO;311980;2;1;0;0;0;2;1;311980;Refrigerador 256Lts No Frost Advantage 5200;LINEA BLANCA
11662584;;F;52;CHILENO;;X;N/D;N/D;319180;4;3;0;0;0;4;3;319180;Secadora 9 Kg 9D BZG Ventilacion Blanca;LINEA BLANCA
4818347;;M;79;CHILENO;;Z;PROVIDENCIA                   ;METROPOLITANA;272470;3;1;0;0;0;3;1;272470;COCINA CH-6700IN 4P;LINEA BLANCA
11532325;;F;52;CHILENO;;X;CAUQUENES                     ;MAULE;939420;7;4;5;2;684440;2;2;254980;Secadora Electrica SEM101BDBY Blanca 10 KG;LINEA BLANCA
7493660;;F;66;CHILENO;;Boomers;OVALLE                        ;COQUIMBO;723920;6;2;0;0;0;6;2;723920;Cocina F 2608 T 4P Reflex Silver;LINEA BLANCA
9027782;;M;62;CHILENO;;Boomers;MELIPILLA                     ;METROPOLITANA;492460;10;4;0;0;0;10;4;492460;Secadora 9 Kg 9D BZG Ventilacion Blanca;LINEA BLANCA
10757211;;M;53;CHILENO;;X;PUTAENDO                      ;VALPARAISO;169990;1;1;0;0;0;1;1;169990;Lavadora Semiautomatica Twister 5300 4Kg;LINEA BLANCA
16857936;;M;34;CHILENO;;Millenial;CURICO;MAULE;409090;4;2;0;0;0;4;2;409090;Lavadora MLS-090GE04N 9Kg Gris;LINEA BLANCA
12596663;;M;52;CHILENO;;X;COQUIMBO                      ;COQUIMBO;199990;1;1;0;0;0;1;1;199990;Cocina CH-9400 4P SILVER;LINEA BLANCA
10292759;;M;57;CHILENO;;Boomers;VICTORIA                      ;ARAUCANIA;226110;2;1;0;0;0;2;1;226110;Secadora Ropa MD100A90/W 9Kg Ventilacion Blanca;LINEA BLANCA
15183527;;F;39;CHILENO;;X;N/D;N/D;197980;2;1;2;1;197980;0;0;0;Secadora Ropa MD100A90/W 9Kg Ventilacion Blanca;LINEA BLANCA
18550984;;F;29;CHILENO;;Millenial;NATALES                       ;MAGALLANES;569980;2;1;0;0;0;2;1;569980;REFRIGERADOR TOP MOUNT GT29BPPK NO FROST 254 Lt;LINEA BLANCA
11819539;;F;51;CHILENO;;X;PAINE                         ;METROPOLITANA;458930;7;5;0;0;0;7;5;458930;Secadora Ropa MSV-90 9K Blanca Ventilacion;LINEA BLANCA
18752061;;F;27;CHILENO;;Millenial;VALLENAR;ATACAMA;335940;6;3;0;0;0;6;3;335940;Refrigerador 166 Lts Frio Directo BF MED165;LINEA BLANCA
14281855;Casado;F;47;CHILENO;;X;VALDIVIA                      ;LOS LAGOS;265890;4;3;0;0;0;4;3;265890;Freezer Horizontal M 150 142Lts;LINEA BLANCA
16857544;Soltero;M;34;CHILENO;;Millenial;PROVIDENCIA                   ;METROPOLITANA;137980;2;1;2;1;137980;0;0;0;Centrifuga Primma 5B 5,5Kilos;LINEA BLANCA
7729348;;M;67;CHILENO;;Boomers;PALMILLA                      ;L.G.B.OÂ´HIGGINS;402180;3;1;0;0;0;3;1;402180;Refrigerador 290Lts BF No Frost RB30N4020S8;LINEA BLANCA
9556196;;M;59;CHILENO;;Boomers;TEMUCO                        ;ARAUCANIA;220910;2;1;0;0;0;2;1;220910;Lavadora MLS-090GE04N 9Kg Gris;LINEA BLANCA
6112882;;F;77;CHILENO;;Silencioso;VINA DEL MAR                  ;VALPARAISO;407180;3;1;0;0;0;3;1;407180;Refrigerador 300Lts No Frost RT29K500JS8/ZS;LINEA BLANCA
8844474;Viudo;M;62;CHILENO;AGROINDUSTRIA;Boomers;PROVIDENCIA                   ;METROPOLITANA;400190;2;1;0;0;0;2;1;400190;Refrigerador 290Lts BF No Frost RB30N4020S8;LINEA BLANCA
7920953;Casado;F;67;CHILENO;;Boomers;LONCOCHE;ARAUCANIA;130000;2;1;0;0;0;2;1;130000;Centrifuga Primma 5B 5,5Kilos;LINEA BLANCA
25999069;;F;28;CHILENO;;Extranjero;EL MONTE                      ;METROPOLITANA;551970;3;1;0;0;0;3;1;551970;Lavadora MLS-190GC03N 19Kg Gris;LINEA BLANCA
15263522;;M;37;CHILENO;;Millenial;N/D;N/D;1001190;10;4;0;0;0;10;4;1001190;Lavadora MLS-190GC03N 19Kg Gris;LINEA BLANCA
12984350;;F;46;CHILENO;;X;"";"";428950;6;3;0;0;0;6;3;428950;Lavadora Efficace SZG 15,5Kg Silver;LINEA BLANCA
16280385;Soltero;F;36;CHILENO;FONOAUDIOLOGA;Millenial;N/D;N/D;133980;2;1;2;1;133980;0;0;0;Centrifuga Primma 5B 5,5Kilos;LINEA BLANCA
25869000;Soltero;F;39;VENEZOLANO;;Extranjero;SANTIAGO                      ;METROPOLITANA;199980;2;1;2;1;199980;0;0;0;Lavadora WA90H4400SW1ZS 9Kg Blanca;LINEA BLANCA
26050592;Soltero;F;41;VENEZOLANO;;Extranjero;PROVIDENCIA                   ;METROPOLITANA;189980;2;1;2;1;189980;0;0;0;Lavadora WA80H4200SW1ZS 8Kg Blanca;LINEA BLANCA
8210775;;F;66;CHILENO;;Boomers;ANCUD                         ;LOS LAGOS;548840;5;2;0;0;0;5;2;548840;Centrifuga Primma 5B 5,5Kilos;LINEA BLANCA
19271004;Soltero;F;25;CHILENO;;Z;"";"";462000;2;1;0;0;0;2;1;462000;Lavadora WT19DSBP 19Kg Silver;LINEA BLANCA
10791326;;F;55;CHILENO;;Boomers;RANCAGUA                      ;L.G.B.OÂ´HIGGINS;261980;3;1;0;0;0;3;1;261980;Lavadora Efficace SZG 17,5Kg Silver;LINEA BLANCA
12227063;;F;49;CHILENO;;X;"";"";189990;1;1;0;0;0;1;1;189990;Lavadora WA90H4400SW1ZS 9Kg Blanca;LINEA BLANCA
18041046;;M;30;CHILENO;;Millenial;OLIVAR                        ;L.G.B.OÂ´HIGGINS;191980;2;1;0;0;0;2;1;191980;Lavadora Semiautomatica LC-6550 6,5Kg;LINEA BLANCA
18812702;Soltero;M;28;CHILENO;;Millenial;PROVIDENCIA                   ;METROPOLITANA;138980;2;1;2;1;138980;0;0;0;Centrifuga Primma 5B 5,5Kilos;LINEA BLANCA
15234896;;M;39;CHILENO;;X;LAUTARO;ARAUCANIA;289990;1;1;1;1;289990;0;0;0;Refrigerador 244Lts Frio Directo Progress 3100;LINEA BLANCA
5563715;;F;75;CHILENO;;Silencioso;SAN ANTONIO                   ;VALPARAISO;370980;2;1;0;0;0;2;1;370980;Lavadora Secadora MLSF-1108BN05N 11Kg/8Kg Blanca;LINEA BLANCA
8264037;;F;61;CHILENO;;Boomers;PANGUIPULLI                   ;LOS RIOS;770960;4;3;0;0;0;4;3;770960;Refrigerador 260Lts BF Frio Direc MRFI2660SR346W;LINEA BLANCA
16554691;;F;35;CHILENO;;Millenial;PROVIDENCIA                   ;METROPOLITANA;681980;2;1;2;1;681980;0;0;0;Refrigerador 626Lt Side by Side GS65MPP1 APZPECL;LINEA BLANCA
24789382;;F;56;COLOMBIANO;;Extranjero;PROVIDENCIA                   ;METROPOLITANA;137980;2;1;2;1;137980;0;0;0;Centrifuga Primma 5B 5,5Kilos;LINEA BLANCA
18803411;;F;28;CHILENO;;Millenial;LOS ANGELES                   ;BIO BIO;564730;4;3;0;0;0;4;3;564730;Lavadora WA17T6260BW/ZS 17Kg Blanca;LINEA BLANCA
9085841;;F;64;CHILENO;;Boomers;CHILLAN                       ;BIO BIO;329990;1;1;0;0;0;1;1;329990;Refrigerador 303Lts BF Frio Directo Nordik 480;LINEA BLANCA
8285427;;F;66;CHILENO;;Boomers;N/D;N/D;396290;6;3;0;0;0;6;3;396290;Secadora Ropa MD100A90/W 9Kg Ventilacion Blanca;LINEA BLANCA
14159786;;F;41;CHILENO;;X;"";"";893730;9;4;0;0;0;9;4;893730;Refrigerador 432Lts Side by Side MDRS619FGE46;LINEA BLANCA
20137361;;F;23;CHILENO;;Z;PROVIDENCIA                   ;METROPOLITANA;189980;2;1;2;1;189980;0;0;0;Lavadora Efficace BZG 11,5Kg Blanca;LINEA BLANCA
13922232;;F;42;CHILENO;;X;CONSTITUCION                  ;MAULE;400460;4;2;4;2;400460;0;0;0;Secadora 9 Kg 9D BZG Ventilacion Blanca;LINEA BLANCA
8057538;;F;68;CHILENO;;Silencioso;ARICA                         ;ARICA Y PARINACOTA;259990;1;1;0;0;0;1;1;259990;Cocina M 775 ST 4P Silver;LINEA BLANCA
8342986;;F;60;CHILENO;;Boomers;EL MONTE                      ;METROPOLITANA;117980;2;1;0;0;0;2;1;117980;Calefont 5Lts GL Essenetial ECO;LINEA BLANCA
12793176;;F;47;CHILENO;;X;BUIN                          ;METROPOLITANA;212890;6;3;0;0;0;6;3;212890;Secadora Ropa MSV-90 9K Blanca Ventilacion;LINEA BLANCA
11988889;Casado;F;49;CHILENO;;X;PROVIDENCIA                   ;METROPOLITANA;210910;2;1;0;0;0;2;1;210910;Lavadora MLS-090GE04N 9Kg Gris;LINEA BLANCA
8645787;;M;66;CHILENO;;Boomers;SAN CLEMENTE                  ;MAULE;983410;5;4;0;0;0;5;4;983410;Secadora 9 Kg Premium Care Pro 9D;LINEA BLANCA
19392109;;F;25;CHILENO;;Z;PAINE                         ;METROPOLITANA;189980;2;1;0;0;0;2;1;189980;Lavadora Semiautomatica LC-6550 6,5Kg;LINEA BLANCA
13507055;;M;44;CHILENO;;X;TALCA                         ;MAULE;366980;2;1;0;0;0;2;1;366980;Cocina MCG-5QI30NS 5P;LINEA BLANCA
9403206;;F;61;CHILENO;;Boomers;NUEVA IMPERIAL                ;ARAUCANIA;673240;5;2;0;0;0;5;2;673240;Refrigerador 210Lts Rojo Frio Dir MRFS2100R273FN;LINEA BLANCA
25673665;;F;33;VENEZOLANO;;Extranjero;PROVIDENCIA                   ;METROPOLITANA;199980;2;1;2;1;199980;0;0;0;Lavadora WA90H4400SW1ZS 9Kg Blanca;LINEA BLANCA
10768946;;M;56;CHILENO;;Boomers;PROVIDENCIA                   ;METROPOLITANA;470180;3;1;0;0;0;3;1;470180;Cocina Andes7650FX 5P Inox;LINEA BLANCA
7882661;Divorciado;M;64;CHILENO;;Boomers;RENCA                         ;METROPOLITANA;302970;2;1;0;0;0;2;1;302970;Secadora 9 Kg Premium Care Pro 9D;LINEA BLANCA
16846807;Soltero;F;34;CHILENO;AUTOMATIZACION Y CONTROL INDUSTRIAL;Millenial;CHANCO                        ;MAULE;322970;3;1;0;0;0;3;1;322970;Refrigerador 244Lts Frio Directo Progress 3100;LINEA BLANCA
9317807;;F;60;CHILENO;;Boomers;TALCA                         ;MAULE;319980;2;2;0;0;0;2;2;319980;Calefont 5Lts GL Essenetial ECO;LINEA BLANCA
15583557;;F;39;CHILENO;;X;VINA DEL MAR;VALPARAISO;196980;2;1;2;1;196980;0;0;0;Secadora Ropa MD100A90/W 9Kg Ventilacion Blanca;LINEA BLANCA
18868125;Soltero;F;27;CHILENO;;Millenial;N/D;N/D;289980;2;1;2;1;289980;0;0;0;Refrigerador RB27N4020S8/ZS BF 257Lts;LINEA BLANCA
24318424;Soltero;F;36;ESPAÃOL;;Extranjero;PROVIDENCIA                   ;METROPOLITANA;209980;2;1;2;1;209980;0;0;0;Lavadora 9 Kg Carga Superior Blanca;LINEA BLANCA
13671924;Casado;F;43;CHILENO;CONTADOR AUDITOR;X;PROVIDENCIA                   ;METROPOLITANA;393960;3;1;3;1;393960;0;0;0;Cocina CH-9905SI 5P;LINEA BLANCA
10896774;;M;56;CHILENO;;Boomers;N/D;N/D;209980;2;1;0;0;0;2;1;209980;Secadora 9 Kg 9D BZG Ventilacion Blanca;LINEA BLANCA
19272129;;F;26;CHILENO;;Z;N/D;N/D;470520;4;2;4;2;470520;0;0;0;Lavadora Secadora MLSF-1108BN05N 11Kg/8Kg Blanca;LINEA BLANCA
16686398;;M;34;CHILENO;;Millenial;N/D;N/D;528530;7;3;6;2;338540;1;1;189990;Lavadora Efficace BZG 11,5Kg Blanca;LINEA BLANCA
10333420;Casado;M;54;CHILENO;INGENIERO CIVIL EN COMPUTACION  E INFORMATICA;Boomers;PENALOLEN;METROPOLITANA;555840;15;7;15;7;555840;0;0;0;Horno Empotrado 60 cm. Bosch Mod. HAF010BR0;LINEA BLANCA
6364721;;F;71;CHILENO;;Silencioso;ARICA                         ;ARICA Y PARINACOTA;298720;5;3;0;0;0;5;3;298720;Lavadora Semiautomatica Twister 5100 4Kg;LINEA BLANCA
16527387;;F;34;CHILENO;;Millenial;VALLENAR;ATACAMA;419980;2;2;2;2;419980;0;0;0;Lavadora MLS-090GE04N 9Kg Gris;LINEA BLANCA
5727773;;M;75;CHILENO;;Silencioso;SAN FELIPE                    ;VALPARAISO;290888;3;1;0;0;0;3;1;290888;Lavadora Efficace SZG 19,5Kg Silver;LINEA BLANCA
6862187;;F;74;CHILENO;;Silencioso;RENCA                         ;METROPOLITANA;205180;3;1;0;0;0;3;1;205180;Freezer 99Lts MFH-1000B131CN Horizontal;LINEA BLANCA
19173596;;M;27;CHILENO;;Millenial;"";"";500960;4;2;4;2;500960;0;0;0;Lavadora WT16DSBP 16Kg Silver;LINEA BLANCA
9669862;;M;58;CHILENO;;Boomers;N/D;N/D;398940;6;3;0;0;0;6;3;398940;Lavadora MLS-080BE04N 8Kg Blanca;LINEA BLANCA
15940910;;F;37;CHILENO;;Millenial;MAIPU;METROPOLITANA;457930;7;3;7;3;457930;0;0;0;Lavadora Premium Care 20SZ 20Kg Silver;LINEA BLANCA
13330207;;F;43;CHILENO;;X;"";"";179990;3;1;3;1;179990;0;0;0;Refrigerador 167Lts MRFI-1700R234RN F.Direc Rojo;LINEA BLANCA
10789059;;F;56;CHILENO;;Boomers;SAN BERNARDO                  ;METROPOLITANA;153690;2;1;0;0;0;2;1;153690;Calefon ionizado 7 litros GL AS0;LINEA BLANCA
9276085;;M;54;CHILENO;;Boomers;PROVIDENCIA                   ;METROPOLITANA;390950;4;1;4;1;390950;0;0;0;Cocina CMC20AXX-1 4P Inox;LINEA BLANCA
15109845;;F;40;CHILENO;;X;SAN VICENTE                   ;L.G.B.OÂ´HIGGINS;271970;3;2;0;0;0;3;2;271970;COCINA CH-6700IN 4P;LINEA BLANCA
17476892;;F;32;CHILENO;;Millenial;RANCAGUA;O HIGGINS;341970;3;2;3;2;341970;0;0;0;Refrigerador 166 Lts Frio Directo BF MED165;LINEA BLANCA
6648303;;F;68;CHILENO;;Silencioso;LA LIGUA                      ;VALPARAISO;498980;2;1;0;0;0;2;1;498980;Refrigerador 527Lts Side by Side MRSBS5300G689WE;LINEA BLANCA
19305231;;F;26;CHILENO;;Z;PROVIDENCIA                   ;METROPOLITANA;219980;2;1;2;1;219980;0;0;0;Secadora 9 Kg 9D BZG Ventilacion Blanca;LINEA BLANCA
18981985;Soltero;M;27;CHILENO;;Z;PROVIDENCIA                   ;METROPOLITANA;420960;4;2;4;2;420960;0;0;0;Secadora 9 Kg Premium Care Pro 9D;LINEA BLANCA
15267055;;M;39;CHILENO;;X;PANGUIPULLI                   ;LOS LAGOS;348440;3;1;0;0;0;3;1;348440;Lavadora Efficace SZG 17,5Kg Silver;LINEA BLANCA
13223141;;F;44;CHILENO;;X;PAIGUANO                      ;COQUIMBO;233050;3;1;0;0;0;3;1;233050;Lavadora Semiautomatica Twister 5100 4Kg;LINEA BLANCA
12099641;;F;52;CHILENO;;X;PUENTE ALTO                   ;METROPOLITANA;1821930;17;7;0;0;0;17;7;1821930;Refrigerador 251Lts No Frost Altus 1250;LINEA BLANCA
19213104;;F;26;CHILENO;;Z;LOS ANGELES;BIO-BIO;211980;2;1;2;1;211980;0;0;0;Secadora Ropa MD100A90/W 9Kg Ventilacion Blanca;LINEA BLANCA
11578881;;M;52;CHILENO;;X;LOS ANGELES                   ;BIO BIO;628630;6;4;0;0;0;6;4;628630;Refrigerador 244Lts Frio Directo Progress 3100;LINEA BLANCA
13575443;;F;42;CHILENO;;X;CONSTITUCION                  ;MAULE;371170;8;3;0;0;0;8;3;371170;Secadora 7Kg 7D BZG Ventilacion Blanca;LINEA BLANCA
9738052;;M;58;CHILENO;;Boomers;RENGO                         ;L.G.B.OÂ´HIGGINS;417430;3;1;0;0;0;3;1;417430;Refrigerador 290Lts BF No Frost RB30N4020S8;LINEA BLANCA
15846789;;M;38;CHILENO;;Millenial;RENCA                         ;METROPOLITANA;199980;2;1;2;1;199980;0;0;0;Secadora 9 Kg 9D BZG Ventilacion Blanca;LINEA BLANCA
8855772;;F;64;CHILENO;;Boomers;PROVIDENCIA                   ;METROPOLITANA;268980;2;1;2;1;268980;0;0;0;Lavadora MA200W140/G 14 kg Gris;LINEA BLANCA
13745509;Casado;F;42;CHILENO;;Silencioso;PROVIDENCIA                   ;METROPOLITANA;212510;3;1;0;0;0;3;1;212510;Lavadora Semiautomatica LC-6550 6,5Kg;LINEA BLANCA
18937305;;F;26;CHILENO;;Z;N/D;N/D;451950;5;2;2;1;198980;3;1;252970;Secadora Ropa MD100A90/W 9Kg Ventilacion Blanca;LINEA BLANCA
16216813;;F;36;CHILENO;;Millenial;N/D;N/D;441980;2;1;2;1;441980;0;0;0;Lavadora Secadora MLSF-13510SC01I 13,5Kg/10Kg Gr;LINEA BLANCA
9397065;;M;58;CHILENO;;Boomers;PENCO                         ;BIO BIO;130000;2;1;0;0;0;2;1;130000;Calefont 8Lts GL Essenetial ECO;LINEA BLANCA
10479607;;F;56;CHILENO;;Boomers;TALCA                         ;MAULE;408000;3;1;0;0;0;3;1;408000;Lavadora MLS-190GC03N 19Kg Gris;LINEA BLANCA
15571029;Casado;M;38;CHILENO;;X;PROVIDENCIA                   ;METROPOLITANA;322550;2;1;0;0;0;2;1;322550;Refrigerador 244Lts Frio Directo Progress 3100;LINEA BLANCA
9339665;;F;61;CHILENO;;Boomers;SANTA MARIA                   ;VALPARAISO;762110;5;2;0;0;0;5;2;762110;Lavadora WT19DSBP 19Kg Silver;LINEA BLANCA
15568283;;M;34;CHILENO;;Millenial;N/D;N/D;224750;3;1;0;0;0;3;1;224750;Secadora Ropa MD100A90/W 9Kg Ventilacion Blanca;LINEA BLANCA
7390649;;F;64;CHILENO;;Boomers;PUENTE ALTO                   ;METROPOLITANA;327820;2;1;0;0;0;2;1;327820;Lavadora Efficace SZG 17,5Kg Silver;LINEA BLANCA
19235334;Soltero;M;26;CHILENO;;Z;PROVIDENCIA                   ;METROPOLITANA;179980;2;1;2;1;179980;0;0;0;Lavadora MLS-090GE04N 9Kg Gris;LINEA BLANCA
15103554;Casado;M;41;CHILENO;;X;RENCA                         ;METROPOLITANA;81980;2;1;2;1;81980;0;0;0;SECADORA SR-10 8KG GRIS SINDELEN;LINEA BLANCA
14507788;;F;48;CHILENO;;X;CALBUCO                       ;LOS LAGOS;238740;4;1;0;0;0;4;1;238740;Secadora Ropa MD100A90/W 9Kg Ventilacion Blanca;LINEA BLANCA
9411669;;F;63;CHILENO;;Boomers;OSORNO                        ;LOS LAGOS;478350;4;3;0;0;0;4;3;478350;Cocina CH-7400 4P;LINEA BLANCA
10563370;;M;54;CHILENO;;X;SANTA JUANA                   ;BIO BIO;634970;3;2;0;0;0;3;2;634970;COCINA LENA ENLOZADA 72x56;LINEA BLANCA
15617311;;M;38;CHILENO;;Millenial;SAN PEDRO DE LA PAZ           ;BIO BIO;277500;4;2;0;0;0;4;2;277500;Secadora Ropa MD100A90/W 9Kg Ventilacion Blanca;LINEA BLANCA
9312915;;F;55;CHILENO;;Boomers;CALERA                        ;VALPARAISO;873950;4;1;0;0;0;4;1;873950;Refrigerador 303Lts BF Frio Directo Nordik 480;LINEA BLANCA
5728131;;F;79;CHILENO;;Silencioso;SAN VICENTE                   ;L.G.B.OÂ´HIGGINS;189980;2;2;0;0;0;2;2;189980;Lavadora MLS-090GE04N 9Kg Gris;LINEA BLANCA
18931536;;F;27;CHILENO;;Z;LOLOL                         ;L.G.B.OÂ´HIGGINS;263980;2;1;0;0;0;2;1;263980;Lavadora MLS-160BSC03T 16Kg Blanca;LINEA BLANCA
7667212;;F;67;CHILENO;;Boomers;CALAMA                        ;ANTOFAGASTA;199990;1;1;0;0;0;1;1;199990;Lavadora WA90H4400SW1ZS 9Kg Blanca;LINEA BLANCA
20150993;;F;24;CHILENO;;Z;PROVIDENCIA                   ;METROPOLITANA;364520;4;2;4;2;364520;0;0;0;Secadora 9 Kg 9D BZG Ventilacion Blanca;LINEA BLANCA
9504136;;M;58;CHILENO;;Boomers;CHIGUAYANTE                   ;BIO BIO;332550;2;1;0;0;0;2;1;332550;Cocina MCG-4QI24NS 4P;LINEA BLANCA
6518833;;M;72;CHILENO;;Silencioso;ARICA                         ;ARICA Y PARINACOTA;994510;6;2;0;0;0;6;2;994510;Refrigerador 425Lts No Frost Altus 1430W;LINEA BLANCA
14280326;;F;51;CHILENO;;X;PUENTE ALTO                   ;METROPOLITANA;149990;1;1;0;0;0;1;1;149990;Calefont 10Lts GL Essenetial ECO;LINEA BLANCA
9466752;;F;60;CHILENO;;Boomers;CALAMA                        ;ANTOFAGASTA;129990;1;1;0;0;0;1;1;129990;Calefont 8Lts GL Essenetial ECO;LINEA BLANCA
7571537;;M;66;CHILENO;;Boomers;BUIN                          ;METROPOLITANA;303970;3;2;0;0;0;3;2;303970;Calefont 10Lts GL Essenetial ECO;LINEA BLANCA
12886970;;M;47;CHILENO;;X;PROVIDENCIA                   ;METROPOLITANA;129990;1;1;0;0;0;1;1;129990;Centrifuga Primma 5B 5,5Kilos;LINEA BLANCA
6382610;;M;68;CHILENO;;Silencioso;PROVIDENCIA                   ;METROPOLITANA;59990;1;1;0;0;0;1;1;59990;Campana Cocina CA610EIN 60Cms Inox;LINEA BLANCA
13244252;;M;45;CHILENO;;Z;PIRQUE                        ;METROPOLITANA;349990;1;1;0;0;0;1;1;349990;Refrigerador 303Lts BF Frio Directo Nordik 480;LINEA BLANCA
10983438;;M;48;CHILENO;;X;N/D;N/D;204990;2;1;0;0;0;2;1;204990;Producto Segunda Seleccion Banda 5;LINEA BLANCA
16535061;;M;36;CHILENO;;Millenial;N/D;N/D;267980;2;2;0;0;0;2;2;267980;Lavadora Efficace SZG 15,5Kg Silver;LINEA BLANCA
5789430;;M;73;CHILENO;;Silencioso;COIHAIQUE                     ;AYSEN;269990;1;1;0;0;0;1;1;269990;Refrigerador 252Lts No Frost MRFS-2700G333FW;LINEA BLANCA
10756083;;M;56;CHILENO;;Boomers;CAUQUENES                     ;MAULE;514960;4;2;2;1;209980;2;1;304980;Refrigerador 210Lts Rojo Frio Dir MRFS2100R273FN;LINEA BLANCA
14253625;;M;48;CHILENO;;X;LA LIGUA                      ;VALPARAISO;874840;5;3;0;0;0;5;3;874840;FREEZER Z200 196LTS HORIZONTAL FENSA;LINEA BLANCA
16379378;;F;36;CHILENO;;Millenial;RENAICO                       ;ARAUCANIA;573660;4;2;0;0;0;4;2;573660;Refrigerador 527Lts Side by Side MRSBS5300G689WE;LINEA BLANCA
6942387;;F;71;CHILENO;;Silencioso;CUNCO                         ;ARAUCANIA;271970;4;1;0;0;0;4;1;271970;Secadora Ropa MD100A90/W 9Kg Ventilacion Blanca;LINEA BLANCA
6788093;;F;76;CHILENO;;Silencioso;CANETE                        ;BIO BIO;428000;2;1;0;0;0;2;1;428000;Lavadora WT16DSBP 16Kg Silver;LINEA BLANCA
24771546;;M;31;PERUANO;;Extranjero;N/D;N/D;680560;3;1;0;0;0;3;1;680560;Refrigerador 525Lts Side by Side SFX500;LINEA BLANCA
14083264;;M;40;CHILENO;;X;PROVIDENCIA                   ;METROPOLITANA;205980;2;1;2;1;205980;0;0;0;Secadora Ropa MD100A90/W 9Kg Ventilacion Blanca;LINEA BLANCA
12190733;;M;49;CHILENO;;X;RENCA                         ;METROPOLITANA;202980;3;2;2;1;137990;1;1;64990;Calefont 10Lts GL Essenetial ECO;LINEA BLANCA
5015096;;M;75;CHILENO;;Silencioso;QUILPUE                       ;VALPARAISO;359990;1;1;0;0;0;1;1;359990;Refrigerador 290Lts BF No Frost RB30N4020S8;LINEA BLANCA
5444603;;F;78;CHILENO;;Silencioso;PROVIDENCIA                   ;METROPOLITANA;127980;2;1;2;1;127980;0;0;0;CENTRIFUGA C-752;LINEA BLANCA
9212866;Casado;M;58;CHILENO;;Boomers;RENCA                         ;METROPOLITANA;270980;2;1;0;0;0;2;1;270980;Freezer Horizontal M 150 142Lts;LINEA BLANCA
8561186;;F;51;CHILENO;;X;PROVIDENCIA                   ;METROPOLITANA;309980;2;1;2;1;309980;0;0;0;Refrigerador RB27N4020S8/ZS BF 257Lts;LINEA BLANCA
11906560;Soltero;F;51;CHILENO;CONSTRUCTOR CIVIL;X;PROVIDENCIA                   ;METROPOLITANA;204980;2;1;2;1;204980;0;0;0;Refrigerador 167Lts Frio Directo 1700-S;LINEA BLANCA
17665435;;F;31;CHILENO;;Millenial;QUILLOTA                      ;VALPARAISO;664930;7;3;2;1;201980;5;2;462950;Lavadora WA90H4400SW1ZS 9Kg Blanca;LINEA BLANCA
13791371;;F;42;CHILENO;;X;CAUQUENES                     ;MAULE;664540;5;2;0;0;0;5;2;664540;Lavadora Efficace SZG 17,5Kg Blanca;LINEA BLANCA
19273366;Soltero;M;26;CHILENO;INGENIERO INFORMATICO;Z;PROVIDENCIA                   ;METROPOLITANA;133980;2;1;2;1;133980;0;0;0;FRIGOBAR 93 LTS MFB-930S121LN;LINEA BLANCA
10589480;;F;54;CHILENO;;Boomers;NANCAGUA                      ;L.G.B.OÂ´HIGGINS;403970;3;2;0;0;0;3;2;403970;Lavadora WT19DSBP 19Kg Silver;LINEA BLANCA
14248096;;F;48;CHILENO;;X;"";"";361960;4;2;4;2;361960;0;0;0;Lavadora MLS-090GE04N 9Kg Gris;LINEA BLANCA
13397564;;F;43;CHILENO;;X;PROVIDENCIA                   ;METROPOLITANA;224960;4;2;0;0;0;4;2;224960;Lavadora Semiautomatica Twister 5100 4Kg;LINEA BLANCA
14580435;;M;42;CHILENO;;X;"";"";956512;8;3;0;0;0;8;3;956512;Refrigerador 527Lts Side by Side MRSBS5300G689WE;LINEA BLANCA
10881250;;F;59;CHILENO;;Boomers;SAN VICENTE                   ;L.G.B.OÂ´HIGGINS;357483;2;2;0;0;0;2;2;357483;Refrigerador 256Lts No Frost Advantage 5200;LINEA BLANCA
19722714;;M;24;CHILENO;;Z;N/D;N/D;389970;3;2;3;2;389970;0;0;0;Lavadora Secadora WD95T4046CE/ZS 9,5Kg/6Kg Blanc;LINEA BLANCA
8928975;;F;61;CHILENO;;Boomers;NATALES                       ;MAGALLANES;459970;3;2;0;0;0;3;2;459970;Refrigerador 262Lts No Frost MRFI-2760S349RW-DA;LINEA BLANCA
15094667;;F;41;CHILENO;;X;RENCA                         ;METROPOLITANA;201980;2;1;2;1;201980;0;0;0;Cocina CMC20AXX 4P Inox;LINEA BLANCA
19372568;;F;25;CHILENO;;Z;LOS ANGELES                   ;BIO BIO;464460;4;2;0;0;0;4;2;464460;Refrigerador 262Lts No Frost MRFI-2760S349RW-DA;LINEA BLANCA
13155952;;M;44;CHILENO;;X;N/D;N/D;429980;2;1;0;0;0;2;1;429980;Refrigerador 260Lts BF Frio Direc MRFI2660SR346W;LINEA BLANCA
19718281;;F;24;CHILENO;;Z;VICHUQUEN                     ;MAULE;269990;1;1;0;0;0;1;1;269990;Cocina M 775 ST 4P Silver;LINEA BLANCA
26007429;;F;51;PERUANO;;Extranjero;ESTACION CENTRAL              ;METROPOLITANA;318960;4;2;0;0;0;4;2;318960;Lavadora MLS-160BSC03T 16Kg Blanca;LINEA BLANCA
6481530;;M;70;CHILENO;;Silencioso;LA FLORIDA                    ;METROPOLITANA;269980;2;1;0;0;0;2;1;269980;Lavadora Efficace SZG 17,5Kg Silver;LINEA BLANCA
12043608;Soltero;M;66;ESPAÃOL;;Silencioso;ANTOFAGASTA                   ;ANTOFAGASTA;213980;2;1;0;0;0;2;1;213980;Lavadora Semiautomatica LC-6550 6,5Kg;LINEA BLANCA
15041056;;F;39;CHILENO;;X;PROVIDENCIA                   ;METROPOLITANA;219980;2;1;2;1;219980;0;0;0;Secadora Electrica SEM101BDBY Blanca 10 KG;LINEA BLANCA
6732635;Casado;F;71;CHILENO;;Silencioso;CORONEL                       ;BIO BIO;391460;3;1;0;0;0;3;1;391460;Cocina Andes76HG0 6P Inox;LINEA BLANCA
19472682;;F;25;CHILENO;;Z;SAN CLEMENTE                  ;MAULE;451970;3;1;0;0;0;3;1;451970;Lavadora Secadora MLSF-1108BN05N 11Kg/8Kg Blanca;LINEA BLANCA
6909179;;F;68;CHILENO;;Boomers;LIMACHE                       ;VALPARAISO;319990;1;3;0;0;0;1;3;319990;Refrigerador 255Lts No Frost RT25FARADS8/ZS;LINEA BLANCA
9226145;;F;60;CHILENO;;Boomers;CABILDO                       ;VALPARAISO;370970;3;1;0;0;0;3;1;370970;Refrigerador 300Lts No Frost RT29K500JS8/ZS;LINEA BLANCA
7138615;;M;67;CHILENO;;Boomers;TOCOPILLA                     ;ANTOFAGASTA;622950;5;2;0;0;0;5;2;622950;Cocina CH-8700IN 5P;LINEA BLANCA
5768554;;M;74;CHILENO;;Silencioso;ARICA                         ;ARICA Y PARINACOTA;732950;5;2;0;0;0;5;2;732950;Refrigerador 322Lts No Frost BF DB60S;LINEA BLANCA
17813228;;M;30;CHILENO;;Millenial;PROVIDENCIA                   ;METROPOLITANA;144980;2;1;2;1;144980;0;0;0;Freezer 99Lts MFH-1000B131CN Horizontal;LINEA BLANCA
17237297;Soltero;M;32;CHILENO;;Millenial;PROVIDENCIA                   ;METROPOLITANA;565970;3;1;3;1;565970;0;0;0;Refrigerador 331Lts No Frost BF RB34T632FSA/ZS;LINEA BLANCA
22574661;Soltero;F;50;PERUANO;;Extranjero;ARICA                         ;TARAPACA;427960;4;1;0;0;0;4;1;427960;Cocina M 775 ST 4P Silver;LINEA BLANCA
14360221;;M;41;CHILENO;;X;PROVIDENCIA                   ;METROPOLITANA;73980;2;2;0;0;0;2;2;73980;Campana Cocina CA610EIN 60Cms Inox;LINEA BLANCA
17897136;;F;31;CHILENO;;Millenial;N/D;N/D;393970;3;1;0;0;0;3;1;393970;Lavadora WA80H4200SW1ZS 8Kg Blanca;LINEA BLANCA
17602139;;M;31;CHILENO;;Millenial;PROVIDENCIA                   ;METROPOLITANA;910950;4;1;4;1;910950;0;0;0;Lavadora WT16DSBP 16Kg Silver;LINEA BLANCA
16185162;;F;36;CHILENO;;Millenial;VILCUN;ARAUCANIA;157980;2;1;2;1;157980;0;0;0;TERMO ATD-50 1,5 KW ALBIN TROTTER;LINEA BLANCA
7467041;;F;64;CHILENO;;Boomers;RANCAGUA                      ;L.G.B.OÂ´HIGGINS;194970;3;1;0;0;0;3;1;194970;Lavadora Semiautomatica Twister 5100 4Kg;LINEA BLANCA
19068655;Soltero;F;26;CHILENO;;Z;PROVIDENCIA                   ;METROPOLITANA;243980;2;1;0;0;0;2;1;243980;Freezer 145 Lts FDHM150BY0 Horizontal;LINEA BLANCA
18077526;;F;30;CHILENO;;Millenial;OVALLE                        ;COQUIMBO;1052790;11;3;0;0;0;11;3;1052790;Lavadora WT19DSBP 19Kg Silver;LINEA BLANCA
16418401;Soltero;M;35;CHILENO;;Z;PROVIDENCIA                   ;METROPOLITANA;259990;1;1;1;1;259990;0;0;0;Refrigerador 244Lts Frio Directo Progress 3100;LINEA BLANCA
19790102;;M;24;CHILENO;;Z;PUERTO VARAS;LOS LAGOS;364940;6;3;6;3;364940;0;0;0;Secadora Ropa MD100A90/W 9Kg Ventilacion Blanca;LINEA BLANCA
16562953;Soltero;M;35;CHILENO;;Millenial;CHILLAN                       ;BIO BIO;428460;4;1;0;0;0;4;1;428460;Lavadora MLS-160BSC03T 16Kg Blanca;LINEA BLANCA
18255273;;M;29;CHILENO;;Millenial;N/D;N/D;301980;2;1;0;0;0;2;1;301980;Lavadora Efficace SZG 15,5Kg Silver;LINEA BLANCA
15171780;Casado;F;53;CHILENO;;X;LA PINTANA                    ;METROPOLITANA;0;0;2;0;0;0;0;2;0;Lavadora Efficace SZG 17,5Kg Silver;LINEA BLANCA
18800696;Soltero;M;27;CHILENO;;Z;LOS ANGELES                   ;BIO BIO;179990;1;1;0;0;0;1;1;179990;Cocina CH-7400 4P;LINEA BLANCA
12948907;;M;46;CHILENO;;X;CATEMU                        ;VALPARAISO;771011;9;6;0;0;0;9;6;771011;Lavadora Efficace SZG 19,5Kg Silver;LINEA BLANCA
9514732;;F;57;CHILENO;;Boomers;CHONCHI                       ;LOS LAGOS;513970;3;1;0;0;0;3;1;513970;Refrigerador 244Lts Frio Directo Progress 3100;LINEA BLANCA
20377319;;F;22;CHILENO;;Z;PROVIDENCIA                   ;METROPOLITANA;236950;5;3;4;2;186960;1;1;49990;CALEFON 10 LTS GAS LICUADO SILVER SINDELEN;LINEA BLANCA
13744614;;F;41;CHILENO;;X;N/D;N/D;896590;6;3;6;3;896590;0;0;0;Lavadora WT16DSBP 16Kg Silver;LINEA BLANCA
16940856;;F;33;CHILENO;;Millenial;RENCA                         ;METROPOLITANA;416980;2;1;2;1;416980;0;0;0;Lavadora Secadora WD10WVC4S6 10,5/6Kg Blanca;LINEA BLANCA
13970389;;M;47;CHILENO;;X;COIHAIQUE                     ;AYSEN;184990;1;1;0;0;0;1;1;184990;Freezer Horizontal M 150 142Lts;LINEA BLANCA
18010305;Soltero;M;30;CHILENO;;Millenial;PROVIDENCIA                   ;METROPOLITANA;289980;2;1;2;1;289980;0;0;0;Refrigerador 255Lts No Frost RT25FARADS8/ZS;LINEA BLANCA
7421421;;M;67;CHILENO;;Boomers;NATALES                       ;MAGALLANES;459980;2;1;0;0;0;2;1;459980;Refrigerador No Frost con Dispensador 312 Lts GT;LINEA BLANCA
17715105;;F;31;CHILENO;;Millenial;PROVIDENCIA                   ;METROPOLITANA;159990;1;1;0;0;0;1;1;159990;Cocina F-2525 4P;LINEA BLANCA
18062196;;F;30;CHILENO;;Millenial;PROVIDENCIA                   ;METROPOLITANA;293980;2;1;2;1;293980;0;0;0;Refrigerador 255Lts No Frost RT25FARADS8/ZS;LINEA BLANCA
9550949;;M;59;CHILENO;;Boomers;LA SERENA                     ;COQUIMBO;339980;2;1;0;0;0;2;1;339980;Refrigerador 241Lts BF Frio Directo Nordik 415;LINEA BLANCA
10020582;;F;58;CHILENO;;Boomers;TALCA                         ;MAULE;516980;2;1;0;0;0;2;1;516980;Refrigerador 527Lts Side by Side MRSBS5300G689WE;LINEA BLANCA
14535344;Casado;M;47;CHILENO;;X;RENCA                         ;METROPOLITANA;269990;1;1;0;0;0;1;1;269990;Cocina M 775 ST 4P Silver;LINEA BLANCA
15502105;;F;39;CHILENO;;X;RENCA                         ;METROPOLITANA;579960;5;2;5;2;579960;0;0;0;Lavadora WT16DSBP 16Kg Silver;LINEA BLANCA
12854777;;F;47;CHILENO;;X;RECOLETA                      ;METROPOLITANA;207370;2;1;0;0;0;2;1;207370;Cocina CH-7400 4P;LINEA BLANCA
14568726;;M;42;CHILENO;;X;MONTE PATRIA                  ;COQUIMBO;285980;2;1;0;0;0;2;1;285980;Lavadora WT13WSBP 13Kg Blanca;LINEA BLANCA
13445643;;F;44;CHILENO;;X;N/D;N/D;209980;2;1;0;0;0;2;1;209980;Lavadora MLS-090GE04N 9Kg Gris;LINEA BLANCA
18562590;;F;28;CHILENO;;Millenial;PROVIDENCIA                   ;METROPOLITANA;166980;2;1;2;1;166980;0;0;0;Lavadora Semiautomatica LC-6550 6,5Kg;LINEA BLANCA
9188429;;M;58;CHILENO;;Boomers;QUEILEN                       ;LOS LAGOS;855970;3;2;0;0;0;3;2;855970;Cocina F-5500 Premium 5P;LINEA BLANCA
10421973;;M;56;CHILENO;;Boomers;LO PRADO                      ;METROPOLITANA;299980;2;1;0;0;0;2;1;299980;Lavadora Efficace SZG 17,5Kg Blanca;LINEA BLANCA
15825126;;F;38;CHILENO;;Millenial;VINA DEL MAR                  ;VALPARAISO;229970;3;2;0;0;0;3;2;229970;Lavadora Semiautomatica Twister 5300 4Kg;LINEA BLANCA
10868663;;F;56;CHILENO;;Boomers;PANGUIPULLI                   ;LOS LAGOS;205980;2;1;0;0;0;2;1;205980;Lavadora MLS-140GSC03T 14Kg Gris;LINEA BLANCA
6065778;;M;69;CHILENO;;Silencioso;RENCA                         ;METROPOLITANA;439980;2;1;0;0;0;2;1;439980;Refrigerador 252Lts No Frost MRFS-2700G333FW;LINEA BLANCA
10779381;;F;49;CHILENO;;Boomers;COPIAPO                       ;ATACAMA;377940;6;2;0;0;0;6;2;377940;Freezer 150 Lts SFH-151 BL Horizontal;LINEA BLANCA
19218926;Soltero;M;25;CHILENO;PROFESOR;Z;PROVIDENCIA                   ;METROPOLITANA;206980;2;1;2;1;206980;0;0;0;Lavadora LMA0920WGCL0 9,5Kg Gris;LINEA BLANCA
13436983;;M;44;CHILENO;;X;PUERTO MONTT                  ;LOS LAGOS;274950;5;4;0;0;0;5;4;274950;Minibar MMB91S 94Lts;LINEA BLANCA
7733893;;M;64;CHILENO;;Boomers;CALERA                        ;VALPARAISO;249980;2;2;0;0;0;2;2;249980;Freezer Horizontal M 150 142Lts;LINEA BLANCA
13947727;;M;42;CHILENO;;X;SAN VICENTE                   ;L.G.B.OÂ´HIGGINS;260970;3;1;0;0;0;3;1;260970;Lavadora MLS-140GSC03T 14Kg Gris;LINEA BLANCA
16688717;;M;34;CHILENO;;Millenial;N/D;N/D;195980;2;1;2;1;195980;0;0;0;Lavadora LMA0920WGCL0 9,5Kg Gris;LINEA BLANCA
9316734;;M;58;CHILENO;;Boomers;TOCOPILLA                     ;ANTOFAGASTA;924950;5;4;0;0;0;5;4;924950;Lavadora MLS-160BSC03T 16Kg Blanca;LINEA BLANCA
18069787;;M;29;CHILENO;;Millenial;SAN PEDRO DE LA PAZ           ;BIO BIO;786960;4;2;0;0;0;4;2;786960;Refrigerador 341Lts BF No Frost GB37MPD;LINEA BLANCA
6215847;;F;72;CHILENO;;Silencioso;SAN FERNANDO                  ;L.G.B.OÂ´HIGGINS;393960;4;2;0;0;0;4;2;393960;Lavadora Semiautomatica Twister 5100 4Kg;LINEA BLANCA
13101354;;F;45;CHILENO;;X;PROVIDENCIA                   ;METROPOLITANA;151980;2;1;0;0;0;2;1;151980;Freezer 99Lts MFH-1000B131CN Horizontal;LINEA BLANCA
7977054;;M;65;CHILENO;;Boomers;COMBARBALA                    ;COQUIMBO;118980;2;1;0;0;0;2;1;118980;Campana Cocina CAR-610 Retractil 60Cms Inox;LINEA BLANCA
8692292;;F;64;CHILENO;;Boomers;SAN FELIPE                    ;VALPARAISO;249980;2;1;0;0;0;2;1;249980;Freezer 145 Lts FDHM150BY0 Horizontal;LINEA BLANCA
26504532;;F;44;VENEZOLANO;;Extranjero;N/D;N/D;352970;3;1;0;0;0;3;1;352970;Lavadora Secadora MLSF-1108BN05N 11Kg/8Kg Blanca;LINEA BLANCA
9583308;;F;59;CHILENO;;Boomers;PUENTE ALTO                   ;METROPOLITANA;309980;2;1;0;0;0;2;1;309980;Lavadora WT13WSBP 13Kg Blanca;LINEA BLANCA
9849146;;F;57;CHILENO;;Boomers;NATALES                       ;MAGALLANES;369970;3;2;0;0;0;3;2;369970;Freezer Horizontal M 150 142Lts;LINEA BLANCA
5704079;;F;76;CHILENO;;Silencioso;NATALES                       ;MAGALLANES;329980;2;1;0;0;0;2;1;329980;Lavadora Efficace SZG 15,5Kg Silver;LINEA BLANCA
13001493;;F;46;CHILENO;;X;CASTRO                        ;LOS LAGOS;793449;4;3;0;0;0;4;3;793449;Refrigerador 341Lts BF No Frost GB37MPD;LINEA BLANCA
18087231;;M;30;CHILENO;;Millenial;N/D;N/D;139980;2;1;2;1;139980;0;0;0;Freezer 99Lts MFH-1000B131CN Horizontal;LINEA BLANCA
11491198;;M;52;CHILENO;;X;RENCA                         ;METROPOLITANA;195980;2;1;2;1;195980;0;0;0;Cocina CH-7400 4P;LINEA BLANCA
10713662;;M;55;CHILENO;;Boomers;PICHILEMU                     ;L.G.B.OÂ´HIGGINS;179990;1;1;0;0;0;1;1;179990;Cocina CH-7400 4P;LINEA BLANCA
19520408;;M;34;CHILENO;;Millenial;TALCAHUANO                    ;BIO BIO;413970;3;1;0;0;0;3;1;413970;Refrigerador 210Lts Rojo Frio Dir MRFS2100R273FN;LINEA BLANCA
13811143;Soltero;F;43;CHILENO;;X;RENCA                         ;METROPOLITANA;231980;2;1;0;0;0;2;1;231980;Freezer 142Lts MFH-1430B186C Horizontal;LINEA BLANCA
16756632;Soltero;F;35;CHILENO;;Millenial;CHILLAN                       ;BIO BIO;381970;3;1;0;0;0;3;1;381970;Cocina CH-8900IN 5P;LINEA BLANCA
7053297;;F;65;CHILENO;;Boomers;COIHAIQUE                     ;AYSEN;769990;1;1;0;0;0;1;1;769990;Refrigerador 626Lt Side by Side GS65MPP1 APZPECL;LINEA BLANCA
18902540;;F;27;CHILENO;;Z;PROVIDENCIA                   ;METROPOLITANA;349980;2;1;2;1;349980;0;0;0;Lavadora Secadora WD95T4046CE/ZS 9,5Kg/6Kg Blanc;LINEA BLANCA
14226480;;F;41;CHILENO;;X;PUERTO MONTT                  ;LOS LAGOS;249990;1;1;0;0;0;1;1;249990;Cocina Andes60TX4 4P Inox;LINEA BLANCA
19383927;;M;26;CHILENO;;Z;SANTIAGO;METROPOLITANA;159990;1;1;1;1;159990;0;0;0;Calefon 11Lts GL Master;LINEA BLANCA
7570325;;F;68;CHILENO;;Boomers;N/D;N/D;428970;3;1;0;0;0;3;1;428970;Lavadora Efficace SZG 17,5Kg Silver;LINEA BLANCA
19926187;;F;24;CHILENO;;Silencioso;PROVIDENCIA                   ;METROPOLITANA;176980;2;1;2;1;176980;0;0;0;Lavadora MLS-080BE04N 8Kg Blanca;LINEA BLANCA
7500588;;F;68;CHILENO;;Boomers;PUERTO MONTT                  ;LOS LAGOS;301980;2;1;0;0;0;2;1;301980;Lavadora Efficace SZG 17,5Kg Blanca;LINEA BLANCA
13308065;;M;45;CHILENO;;X;N/D;N/D;593980;2;1;0;0;0;2;1;593980;Refrigerador 525Lts Side by Side SFX500;LINEA BLANCA
12419005;;M;48;CHILENO;;X;CONSTITUCION                  ;MAULE;187970;5;3;0;0;0;5;3;187970;Calefon 10Lts GL ATMD;LINEA BLANCA
13293220;;F;45;CHILENO;;X;PROVIDENCIA                   ;METROPOLITANA;189990;1;1;0;0;0;1;1;189990;Cocina CMC20AXX 4P Inox;LINEA BLANCA
10514720;;M;57;CHILENO;;Boomers;CHILLAN                       ;BIO BIO;186480;2;1;0;0;0;2;1;186480;Lavadora Semiautomatica Twister 5300 4Kg;LINEA BLANCA
11171775;;F;55;CHILENO;;Boomers;RENCA                         ;METROPOLITANA;459980;2;1;0;0;0;2;1;459980;Lavadora WT16DSBP 16Kg Silver;LINEA BLANCA
14701537;;F;30;BOLIVIANO;;Extranjero;N/D;N/D;437980;2;1;0;0;0;2;1;437980;Lavadora WT19DSBP 19Kg Silver;LINEA BLANCA
6818023;;F;74;CHILENO;;Silencioso;CONSTITUCION                  ;MAULE;167980;2;1;0;0;0;2;1;167980;Lavadora WA90H4400SW/ZS 9Kg Blanca;LINEA BLANCA
11960598;;F;50;CHILENO;;X;PROVIDENCIA                   ;METROPOLITANA;531680;4;2;4;2;531680;0;0;0;Lavadora Brilliant SG 11,5Kg Silver;LINEA BLANCA
26822484;;F;28;VENEZOLANO;;Extranjero;VALDIVIA                      ;LOS RIOS;705970;3;2;2;1;505980;1;1;199990;Lavadora Secadora WD10N64FOOX/ZS 10,5/6Kg Silver;LINEA BLANCA
13469979;;F;43;CHILENO;;X;RECOLETA                      ;METROPOLITANA;419960;4;2;0;0;0;4;2;419960;Cocina CH-9500 NG 4P;LINEA BLANCA
16261250;;F;36;CHILENO;;Millenial;SANTA CRUZ                    ;L.G.B.OÂ´HIGGINS;653050;7;4;7;4;653050;0;0;0;Refrigerador 167Lts Frio Directo 1700-S;LINEA BLANCA
6633375;;M;72;CHILENO;;Silencioso;SALAMANCA                     ;COQUIMBO;707918;9;2;0;0;0;9;2;707918;Cocina Diva 920 5P;LINEA BLANCA
7232516;;M;66;CHILENO;;Boomers;COPIAPO                       ;ATACAMA;167980;2;1;0;0;0;2;1;167980;Lavadora MLS-080BE04N 8Kg Blanca;LINEA BLANCA
6230974;;F;73;CHILENO;;Silencioso;OSORNO                        ;LOS LAGOS;303970;3;1;0;0;0;3;1;303970;Cocina 775X 4P;LINEA BLANCA
12282317;;F;50;CHILENO;;X;LA PINTANA                    ;METROPOLITANA;309980;2;1;0;0;0;2;1;309980;Lavadora MLS-190GC03N 19Kg Gris;LINEA BLANCA
6342094;;F;70;CHILENO;;Silencioso;EL BOSQUE                     ;METROPOLITANA;309980;2;3;0;0;0;2;3;309980;Cocina F-2808 4P;LINEA BLANCA
11505325;;M;51;CHILENO;;X;"";"";186530;3;2;3;2;186530;0;0;0;Freezer 99Lts MFH-1000B131CN Horizontal;LINEA BLANCA
11895111;;M;51;CHILENO;;X;TALCA                         ;MAULE;371980;2;1;0;0;0;2;1;371980;Cocina F-5500 Premium 5P;LINEA BLANCA
12768040;Casado;F;46;CHILENO;;X;ARAUCO                        ;BIO BIO;326980;2;1;0;0;0;2;1;326980;Cocina F-2808 4P;LINEA BLANCA
9627616;;M;59;CHILENO;;Boomers;CARAHUE                       ;ARAUCANIA;647840;5;2;0;0;0;5;2;647840;Freezer Vertical MFV-2400S312FW 227Lts;LINEA BLANCA
12006323;;F;46;CHILENO;;X;IQUIQUE                       ;TARAPACA;475980;2;1;0;0;0;2;1;475980;Lavadora WT19DSBP 19Kg Silver;LINEA BLANCA
17456034;;M;32;CHILENO;;Millenial;PROVIDENCIA                   ;METROPOLITANA;459980;2;1;0;0;0;2;1;459980;Refrigerador 260Lts BF Frio Direc MRFI2660SR346W;LINEA BLANCA
8477224;;F;62;CHILENO;;Boomers;PROVIDENCIA                   ;METROPOLITANA;149990;1;1;0;0;0;1;1;149990;Freezer 99Lts MFH-1000B131CN Horizontal;LINEA BLANCA
11783885;;F;51;CHILENO;;X;ILLAPEL                       ;COQUIMBO;758580;9;4;9;4;758580;0;0;0;Cocina CH-9600RJ 4P;LINEA BLANCA
18959425;Casado;F;30;CHILENO;TECNICO DE NIVEL SUPERIOR EN ENFERMERIA;Millenial;PROVIDENCIA                   ;METROPOLITANA;224980;2;2;1;1;169990;1;1;54990;Cocina CMC20AXX 4P Inox;LINEA BLANCA
13536423;;M;43;CHILENO;;Silencioso;N/D;N/D;847470;3;1;0;0;0;3;1;847470;Refrigerador 626Lt Side by Side GS65MPP1 APZPECL;LINEA BLANCA
11747475;;F;50;CHILENO;;X;LINARES                       ;MAULE;190000;2;1;0;0;0;2;1;190000;Cocina CH-9400 4P SILVER;LINEA BLANCA
12068391;;F;54;CHILENO;;Boomers;PROVIDENCIA                   ;METROPOLITANA;376980;2;1;0;0;0;2;1;376980;Lavadora Secadora MLSF-1108BN05N 11Kg/8Kg Blanca;LINEA BLANCA
15130990;;F;39;CHILENO;;X;SAGRADA FAMILIA               ;MAULE;706440;6;3;6;3;706440;0;0;0;Secadora Ropa MSV-90 9K Blanca Ventilacion;LINEA BLANCA
15064810;;F;39;CHILENO;;X;QUILPUE;VALPARAISO;139980;2;1;2;1;139980;0;0;0;Freezer 99Lts MFH-1000B131CN Horizontal;LINEA BLANCA
9813429;;F;58;CHILENO;;Boomers;PROVIDENCIA                   ;METROPOLITANA;276480;2;1;0;0;0;2;1;276480;Cocina 775X 4P;LINEA BLANCA
17777505;;M;31;CHILENO;;Millenial;PENALOLEN                     ;METROPOLITANA;199980;2;1;0;0;0;2;1;199980;Refrigerador 210Lts Rojo Frio Dir MRFS2100R273FN;LINEA BLANCA
8971811;;F;65;CHILENO;;Boomers;MAULE                         ;MAULE;277872;3;2;2;1;235480;1;1;42392;Lavadora Brilliant SG 11,5Kg Silver;LINEA BLANCA
9514367;;F;59;CHILENO;;Boomers;IQUIQUE                       ;TARAPACA;120970;3;1;0;0;0;3;1;120970;Calefon 7Lts GL ATMD;LINEA BLANCA
6763073;;F;67;CHILENO;;Boomers;PROVIDENCIA                   ;METROPOLITANA;169990;1;1;0;0;0;1;1;169990;Freezer 142Lts MFH-1430B186C Horizontal;LINEA BLANCA
16701084;;F;34;CHILENO;;Millenial;LA LIGUA                      ;VALPARAISO;234980;2;1;2;1;234980;0;0;0;SECADORA VENT UT VD 8K7P;LINEA BLANCA
16224939;;F;36;CHILENO;;Millenial;"";"";1249500;5;2;3;1;819520;2;1;429980;Lavadora Efficace SZG 15,5Kg Silver;LINEA BLANCA
10106323;Casado;M;58;CHILENO;ANALISTA DE SISTEMAS;Boomers;RENCA                         ;METROPOLITANA;222980;2;1;0;0;0;2;1;222980;Freezer 142Lts MFH-1430B186C Horizontal;LINEA BLANCA
14221049;;F;43;CHILENO;;X;TEMUCO                        ;ARAUCANIA;311980;2;1;0;0;0;2;1;311980;Refrigerador 252Lts No Frost MRFS-2700G333FW;LINEA BLANCA
12416133;;M;49;CHILENO;;X;CURICO                        ;MAULE;187961;4;3;0;0;0;4;3;187961;Lavadora WA17T6260BW/ZS 17Kg Blanca;LINEA BLANCA
18752343;;F;27;CHILENO;;Z;VALLENAR;ATACAMA;195980;2;1;0;0;0;2;1;195980;Freezer 99Lts MFH-1000B131CN Horizontal;LINEA BLANCA
9643895;;M;59;CHILENO;;Boomers;OLIVAR                        ;L.G.B.OÂ´HIGGINS;643800;10;7;0;0;0;10;7;643800;Lavadora Efficace SZG 19,5Kg Silver;LINEA BLANCA
18973485;Soltero;M;27;CHILENO;;Z;PROVIDENCIA                   ;METROPOLITANA;381980;2;2;0;0;0;2;2;381980;REFRIGERADOR TOP MOUNT GT29BPPK NO FROST 254 Lt;LINEA BLANCA
21749225;Soltero;M;28;NO INFORMA NACIONALIDAD;;Extranjero;PROVIDENCIA                   ;METROPOLITANA;259990;1;1;1;1;259990;0;0;0;Refrigerador 252Lts No Frost MRFS-2700G333FW;LINEA BLANCA
12867195;;F;46;CHILENO;;X;PROVIDENCIA                   ;METROPOLITANA;609980;2;1;0;0;0;2;1;609980;Refrigerador 535Lts Side by Side RS54N3003SL/ZS;LINEA BLANCA
7020419;;F;71;CHILENO;;Silencioso;TALCA                         ;MAULE;299990;1;1;0;0;0;1;1;299990;Lavadora Efficace SZG 17,5Kg Blanca;LINEA BLANCA
16708602;Divorciado;F;35;CHILENO;ENFERMERA;Millenial;PROVIDENCIA                   ;METROPOLITANA;1069970;3;1;3;1;1069970;0;0;0;Refrigerador 525Lts Side by Side SFX500;LINEA BLANCA
11498964;;F;52;CHILENO;;X;CASTRO                        ;LOS LAGOS;269990;1;1;0;0;0;1;1;269990;Lavadora MLS-160BSC03T 16Kg Blanca;LINEA BLANCA
16707711;;F;35;CHILENO;;Millenial;N/D;N/D;268980;2;1;2;1;268980;0;0;0;Lavadora Efficace SZG 17,5Kg Silver;LINEA BLANCA
12063262;;F;59;CHILENO;;Boomers;RANCAGUA                      ;L.G.B.OÂ´HIGGINS;179980;2;1;0;0;0;2;1;179980;Freezer 142Lts MFH-1430B186C Horizontal;LINEA BLANCA
12732255;;M;47;CHILENO;;X;PROVIDENCIA                   ;METROPOLITANA;229990;1;1;0;0;0;1;1;229990;Freezer 200 Lts FDHM200BY0 Horizontal;LINEA BLANCA
18543160;;F;28;CHILENO;;Millenial;NACIMIENTO                    ;BIO BIO;593460;3;1;0;0;0;3;1;593460;Refrigerador 527Lts Side by Side MRSBS5300G689WE;LINEA BLANCA
19760791;;F;24;CHILENO;;Z;NOGALES                       ;VALPARAISO;482960;4;3;0;0;0;4;3;482960;Calefon 7Lts GL Master;LINEA BLANCA
14068269;;F;44;CHILENO;;X;PROVIDENCIA                   ;METROPOLITANA;265830;3;1;3;1;265830;0;0;0;Refrigerador 167Lts Frio Directo 1700-S;LINEA BLANCA
8149014;;F;62;CHILENO;;Boomers;EL TABO                       ;VALPARAISO;210980;2;1;0;0;0;2;1;210980;Refrigerador 260Lts BF Frio Direc MRFI2660SR346W;LINEA BLANCA
8124189;;M;66;CHILENO;;Boomers;RENCA                         ;METROPOLITANA;364970;3;1;0;0;0;3;1;364970;Lavadora WA13T5260BW/ZS 13Kg Blanca;LINEA BLANCA
12917993;;F;47;CHILENO;;X;SAN FERNANDO                  ;L.G.B.OÂ´HIGGINS;511960;4;1;0;0;0;4;1;511960;Lavadora MLS-160BSC03T 16Kg Blanca;LINEA BLANCA
11651796;Soltero;M;52;CHILENO;;X;CORONEL                       ;BIO BIO;236970;3;1;0;0;0;3;1;236970;Cocina CH-9400 4P SILVER;LINEA BLANCA
19347061;Soltero;M;25;CHILENO;;Z;PROVIDENCIA                   ;METROPOLITANA;666450;5;2;5;2;666450;0;0;0;Freezer 99Lts MFH-1000B131CN Horizontal;LINEA BLANCA
17473715;;F;32;CHILENO;;Millenial;N/D;N/D;490970;3;1;0;0;0;3;1;490970;Lavadora Efficace SZG 17,5Kg Silver;LINEA BLANCA
11762615;;M;51;CHILENO;;X;CURICO                        ;MAULE;193980;2;1;0;0;0;2;1;193980;Cocina CH-7400 4P;LINEA BLANCA
7875988;;M;64;CHILENO;;Boomers;GRANEROS                      ;L.G.B.OÂ´HIGGINS;291970;4;1;0;0;0;4;1;291970;Cocina Diva 820 6P;LINEA BLANCA
14075458;;M;41;CHILENO;;X;PROVIDENCIA                   ;METROPOLITANA;740940;6;1;0;0;0;6;1;740940;Cocina Andes60TX4 4P Inox;LINEA BLANCA
10027491;;F;56;CHILENO;;Boomers;ISLA DE MAIPO                 ;METROPOLITANA;299990;1;1;0;0;0;1;1;299990;REFRIGERADOR TOP MOUNT GT29BPPK NO FROST 254 Lt;LINEA BLANCA
12043595;;F;51;CHILENO;;X;SAN RAMON                     ;METROPOLITANA;359980;2;1;0;0;0;2;1;359980;Refrigerador 254Lts No Frost GT29WPPDC;LINEA BLANCA
9995399;;M;56;CHILENO;;Boomers;QUELLON                       ;LOS LAGOS;459980;3;1;0;0;0;3;1;459980;Refrigerador 252Lts No Frost MRFS-2700G333FW;LINEA BLANCA
13364785;;F;44;CHILENO;;X;N/D;N/D;1450850;15;7;0;0;0;15;7;1450850;Freezer 200 Lts SFH-201 BL Horizontal;LINEA BLANCA
14287503;;F;49;CHILENO;;X;PUENTE ALTO                   ;METROPOLITANA;179980;2;1;0;0;0;2;1;179980;Refrigerador 167Lts MRFI-1700R234RN F.Direc Rojo;LINEA BLANCA
6851190;Casado;M;69;CHILENO;;Silencioso;VINA DEL MAR                  ;VALPARAISO;276970;3;1;0;0;0;3;1;276970;Lavadora WA90H4400SW/ZS 9Kg Blanca;LINEA BLANCA
20413026;;F;22;CHILENO;;Z;N/D;N/D;224980;2;2;0;0;0;2;2;224980;Refrigerador 167Lts Frio Directo 1700-S;LINEA BLANCA
5218062;;M;78;CHILENO;;Silencioso;PUERTO MONTT                  ;LOS LAGOS;618960;4;1;0;0;0;4;1;618960;Lavadora Efficace SZG 15,5Kg Silver;LINEA BLANCA
6031782;Divorciado;M;75;CHILENO;AGRONOMO;Silencioso;RENCA                         ;METROPOLITANA;295980;2;1;0;0;0;2;1;295980;Refrigerador 252Lts No Frost MRFS-2700G333FW;LINEA BLANCA
10518879;;M;55;CHILENO;;Boomers;TEMUCO                        ;ARAUCANIA;377980;2;1;0;0;0;2;1;377980;Refrigerador 262Lts No Frost MRFI-2760S349RW-DA;LINEA BLANCA
19363108;;M;26;CHILENO;;Z;N/D;N/D;434970;3;2;0;0;0;3;2;434970;Cocina F-2808 4P;LINEA BLANCA
9432747;;F;60;CHILENO;;Boomers;SAN PEDRO DE LA PAZ           ;BIO BIO;416857;4;2;0;0;0;4;2;416857;Freezer 150 Lts SFH-151 BL Horizontal;LINEA BLANCA
11752209;;M;50;CHILENO;;X;ANTOFAGASTA                   ;ANTOFAGASTA;355980;2;1;0;0;0;2;1;355980;Lavadora WA17T6260BW/ZS 17Kg Blanca;LINEA BLANCA
11951156;;M;49;CHILENO;;X;RENGO                         ;L.G.B.OÂ´HIGGINS;179980;2;1;0;0;0;2;1;179980;Freezer 142Lts MFH-1430B186C Horizontal;LINEA BLANCA
9428508;;F;57;CHILENO;;Boomers;VALDIVIA                      ;LOS LAGOS;511950;5;1;0;0;0;5;1;511950;Refrigerador 244Lts Frio Directo Progress 3100;LINEA BLANCA
9916230;;F;59;CHILENO;;Boomers;BUIN                          ;METROPOLITANA;279980;2;1;0;0;0;2;1;279980;Lavadora Efficace SZG 17,5Kg Silver;LINEA BLANCA
15707553;;F;38;CHILENO;;X;ALTO HOSPICIO;TARAPACA;355980;2;1;2;1;355980;0;0;0;Lavadora Superior WA17T6260BY/ZS 17Kg;LINEA BLANCA
6660812;;M;67;CHILENO;;Boomers;QUILLOTA                      ;VALPARAISO;352770;2;1;0;0;0;2;1;352770;Lavadora Efficace SZG 19,5Kg Silver;LINEA BLANCA
18560043;Soltero;F;28;CHILENO;;Millenial;PROVIDENCIA                   ;METROPOLITANA;441980;2;1;2;1;441980;0;0;0;Lavadora 19 Kg Carga Superior Negro;LINEA BLANCA
11263209;Divorciado;F;54;CHILENO;;X;RENCA                         ;METROPOLITANA;155480;2;1;2;1;155480;0;0;0;Lavadora MLS-090GE04N 9Kg Gris;LINEA BLANCA
2901224;;M;87;CHILENO;;Silencioso;ARICA                         ;ARICA Y PARINACOTA;261540;2;1;2;1;261540;0;0;0;Cocina 775X 4P;LINEA BLANCA
18898140;;F;27;CHILENO;;Millenial;IQUIQUE                       ;TARAPACA;315980;2;1;2;1;315980;0;0;0;Lavadora Secadora MLSF-1108BN05N 11Kg/8Kg Blanca;LINEA BLANCA
11598218;;M;52;CHILENO;;X;ANCUD                         ;LOS LAGOS;337450;4;1;0;0;0;4;1;337450;Lavadora MLS-090GE04N 9Kg Gris;LINEA BLANCA
11508651;;M;52;CHILENO;;X;COPIAPO                       ;ATACAMA;306980;2;1;0;0;0;2;1;306980;Lavadora MLS-140GSC03T 14Kg Gris;LINEA BLANCA
15610419;;F;39;CHILENO;;X;PROVIDENCIA                   ;METROPOLITANA;297360;3;1;0;0;0;3;1;297360;Cocina CH-7400 4P;LINEA BLANCA
16587627;;M;35;CHILENO;;Millenial;ILLAPEL                       ;COQUIMBO;259990;1;1;0;0;0;1;1;259990;Lavadora WA13T5260BW/ZS 13Kg Blanca;LINEA BLANCA
9241788;;M;59;CHILENO;;Boomers;PICHILEMU                     ;L.G.B.OÂ´HIGGINS;343980;2;1;0;0;0;2;1;343980;Cocina Diva 920 5P;LINEA BLANCA
14129904;Casado;M;40;CHILENO;;X;RENCA                         ;METROPOLITANA;357970;4;1;4;1;357970;0;0;0;Lavadora MLS-160BSC03T 16Kg Blanca;LINEA BLANCA
22334076;;F;37;CHILENO;;Extranjero;ARICA                         ;TARAPACA;230980;2;1;0;0;0;2;1;230980;Lavadora WA90H4400SW/ZS 9Kg Blanca;LINEA BLANCA
25078466;;M;31;COLOMBIANO;;Extranjero;ANTOFAGASTA                   ;ANTOFAGASTA;358560;3;1;0;0;0;3;1;358560;Lavadora WA13T5260BW/ZS 13Kg Blanca;LINEA BLANCA
19932005;;F;23;CHILENO;;Z;"";"";309370;2;1;0;0;0;2;1;309370;Refrigerador 249Lts No Frost RMA250PHUG;LINEA BLANCA
16119004;;M;36;CHILENO;;Millenial;LO PRADO;METROPOLITANA;113980;2;1;2;1;113980;0;0;0;CAMPANA COCINA UT VF 80 INOX 2M;LINEA BLANCA
8443917;;F;65;CHILENO;;Boomers;CORONEL                       ;BIO BIO;306360;3;1;0;0;0;3;1;306360;Refrigerador 244Lts Frio Directo Progress 3100;LINEA BLANCA
16390748;;M;36;CHILENO;;Millenial;CERRO NAVIA                   ;METROPOLITANA;215950;4;1;4;1;215950;0;0;0;CAMPANA COCINA UT VF 80 INOX 2M;LINEA BLANCA
10401156;;F;52;CHILENO;;X;QUINTA NORMAL                 ;METROPOLITANA;219980;2;1;0;0;0;2;1;219980;Cocina CH-9500 NG 4P;LINEA BLANCA
14501563;;M;47;CHILENO;;Extranjero;LA PINTANA                    ;METROPOLITANA;521270;2;3;0;0;0;2;3;521270;Refrigerador 400Lts No Frost RMP400FHUG;LINEA BLANCA
17729705;;F;31;CHILENO;;Millenial;PROVIDENCIA                   ;METROPOLITANA;269990;1;1;0;0;0;1;1;269990;Refrigerador 252Lts No Frost MRFS-2700G333FW;LINEA BLANCA
14319774;;M;45;CHILENO;;X;BUIN                          ;METROPOLITANA;1111270;7;4;0;0;0;7;4;1111270;Refrigerador 527Lts Side by Side MRSBS5300G689WE;LINEA BLANCA
18535697;;F;28;CHILENO;;Millenial;PROVIDENCIA                   ;METROPOLITANA;194980;2;1;2;1;194980;0;0;0;Cocina MV 220 4P;LINEA BLANCA
19729923;;F;25;CHILENO;;Z;PROVIDENCIA                   ;METROPOLITANA;343980;2;1;2;1;343980;0;0;0;ENCIMERA QUADRA 90 GL 4P ALBIN TROTTER;LINEA BLANCA
6582264;;F;69;CHILENO;;Silencioso;RETIRO                        ;MAULE;185470;2;1;0;0;0;2;1;185470;Lavadora Semiautomatica Twister 5300 4Kg;LINEA BLANCA
22772362;;M;28;EXTRANJERO - NO INFORMA NACIONALIDAD;;Extranjero;LAS CONDES                    ;METROPOLITANA;459980;2;1;0;0;0;2;1;459980;Refrigerador 290LTS No Frost RMB302PXLRS0;LINEA BLANCA
7291318;Soltero;M;69;CHILENO;;Silencioso;PROVIDENCIA                   ;METROPOLITANA;237360;3;1;0;0;0;3;1;237360;Refrigerador 167Lts Frio Directo 1700-S;LINEA BLANCA
18757102;;M;28;CHILENO;;Millenial;LA SERENA                     ;COQUIMBO;230480;2;1;0;0;0;2;1;230480;Cocina CH-9400 4P SILVER;LINEA BLANCA
18970216;;F;26;CHILENO;;Z;PROVIDENCIA                   ;METROPOLITANA;233630;3;2;3;2;233630;0;0;0;Cocina CMC20AXX 4P Inox;LINEA BLANCA
7883688;Soltero;M;64;CHILENO;;Boomers;CASTRO                        ;LOS LAGOS;199990;1;1;0;0;0;1;1;199990;Cocina CH-7400 4P;LINEA BLANCA
11172681;Soltero;F;55;CHILENO;;Boomers;SANTA CRUZ                    ;L.G.B.OÂ´HIGGINS;171270;2;1;0;0;0;2;1;171270;Calefon Neckar 10 litros GL;LINEA BLANCA
19306299;Soltero;M;25;CHILENO;;Z;PROVIDENCIA                   ;METROPOLITANA;374980;2;1;2;1;374980;0;0;0;Refrigerador LB33MPP 306Lts Bottom No Frost;LINEA BLANCA
17111133;;M;33;CHILENO;;Millenial;N/D;N/D;161480;2;1;2;1;161480;0;0;0;Lavadora MLS-090GE04N 9Kg Gris;LINEA BLANCA
9024883;;M;62;CHILENO;;Boomers;TEMUCO                        ;ARAUCANIA;395320;6;3;0;0;0;6;3;395320;Cocina CMC20AXX 4P Inox;LINEA BLANCA
18522518;;M;28;CHILENO;;Millenial;MAFIL                         ;LOS RIOS;218540;2;1;2;1;218540;0;0;0;Secadora Ropa Solare 9100 9K Ventilacion;LINEA BLANCA
12563030;;F;48;CHILENO;;X;N/D;N/D;321980;2;1;0;0;0;2;1;321980;Lavadora Efficace SZG 15,5Kg Silver;LINEA BLANCA
5305256;;F;78;CHILENO;;Silencioso;PARRAL                        ;MAULE;383560;3;2;0;0;0;3;2;383560;Cocina 775X 4P;LINEA BLANCA
17312867;;F;32;CHILENO;;Millenial;"";"";353980;2;1;2;1;353980;0;0;0;Refrigerador 290Lts BF No Frost RB30N4020S8;LINEA BLANCA
17876653;;F;31;CHILENO;;Millenial;N/D;N/D;231980;2;1;2;1;231980;0;0;0;Lavadora MLS-140GSC03T 14Kg Gris;LINEA BLANCA
4803266;;M;77;CHILENO;;Silencioso;VALPARAISO                    ;VALPARAISO;399980;2;1;2;1;399980;0;0;0;Refrigerador 318Lts No Frost RT32K5730SL/ZS;LINEA BLANCA
18259785;;M;29;CHILENO;;Millenial;N/D;N/D;399950;5;3;5;3;399950;0;0;0;Freezer Horizontal MFH-1990B258CN 198Lts;LINEA BLANCA
15022045;;M;39;CHILENO;;X;N/D;N/D;149640;2;1;2;1;149640;0;0;0;Freezer 99Lts MFH-1000B131CN Horizontal;LINEA BLANCA
7486488;;F;72;CHILENO;;Silencioso;MELIPILLA                     ;METROPOLITANA;248970;3;1;0;0;0;3;1;248970;Lavadora superior MLS-110GE04N 11Kg;LINEA BLANCA
24176643;;F;41;HAITIANO;;Extranjero;QUILICURA                     ;METROPOLITANA;197370;2;1;0;0;0;2;1;197370;Cocina CH-7400 4P;LINEA BLANCA
19240160;;F;26;CHILENO;;Silencioso;PROVIDENCIA                   ;METROPOLITANA;199980;2;1;2;1;199980;0;0;0;Lavadora superior MLS-110GE04N 11Kg;LINEA BLANCA
19073144;;F;26;CHILENO;;Z;SAN IGNACIO;BIO-BIO;574000;8;2;0;0;0;8;2;574000;Cocina CH-7400 4P;LINEA BLANCA
18910230;;M;40;CHILENO;;Extranjero;ISLA DE MAIPO                 ;METROPOLITANA;183980;2;1;2;1;183980;0;0;0;Cocina MV 120 4 Platos;LINEA BLANCA
15651999;;F;39;CHILENO;;X;TEMUCO                        ;ARAUCANIA;227980;2;1;0;0;0;2;1;227980;Freezer 142Lts EFC14A5MNW Horizontal;LINEA BLANCA
16021684;;F;31;CHILENO;;Millenial;VINA DEL MAR                  ;VALPARAISO;155840;2;1;2;1;155840;0;0;0;Lavadora WA80H4200SW/ZS 8Kg Blanca;LINEA BLANCA
17856849;;F;30;CHILENO;;Millenial;VILCUN                        ;ARAUCANIA;309370;2;1;0;0;0;2;1;309370;Refrigerador 249Lts No Frost RMA250PHUG;LINEA BLANCA
12438099;;M;50;CHILENO;;X;ARICA                         ;TARAPACA;212980;2;1;0;0;0;2;1;212980;Lavadora WA80H4200SW/ZS 8Kg Blanca;LINEA BLANCA
7985846;;F;62;CHILENO;;Boomers;NUNOA                         ;METROPOLITANA;143980;2;1;2;1;143980;0;0;0;Lavadora WA80H4200SW/ZS 8Kg Blanca;LINEA BLANCA
15791886;;F;37;CHILENO;;Millenial;N/D;N/D;269980;2;1;2;1;269980;0;0;0;Refrigerador 244Lts Frio Directo Progress 3100;LINEA BLANCA
3840058;;M;86;CHILENO;;Silencioso;SAN JAVIER                    ;MAULE;384980;2;1;0;0;0;2;1;384980;Cocina Diva 920 5P;LINEA BLANCA
16485330;;M;36;CHILENO;;Millenial;VINA DEL MAR                  ;VALPARAISO;144980;2;1;2;1;144980;0;0;0;Lavadora WA80H4200SW/ZS 8Kg Blanca;LINEA BLANCA
7705226;;F;68;CHILENO;;Silencioso;CARAHUE                       ;ARAUCANIA;545060;3;1;0;0;0;3;1;545060;Refrigerador 322Lts No Frost BF DB60S;LINEA BLANCA
17574247;;F;31;CHILENO;;Millenial;LOS ANGELES                   ;BIO BIO;363980;2;1;2;1;363980;0;0;0;Lavadora WT19DSBP 19Kg Silver;LINEA BLANCA
6964279;;F;69;CHILENO;;Silencioso;PENALOLEN                     ;METROPOLITANA;204980;2;1;0;0;0;2;1;204980;Cocina CMC20AXX 4P Inox;LINEA BLANCA
16503785;Soltero;F;35;CHILENO;;Millenial;PROVIDENCIA                   ;METROPOLITANA;125840;2;1;2;1;125840;0;0;0;ENCIMERA A GAS CMG6044SD-0CL 4Q MABE;LINEA BLANCA
17832144;;F;31;CHILENO;;Millenial;PROVIDENCIA                   ;METROPOLITANA;153980;2;1;2;1;153980;0;0;0;Lavadora WA80H4200SW/ZS 8Kg Blanca;LINEA BLANCA
7895224;;F;63;CHILENO;;Boomers;RENCA                         ;METROPOLITANA;154980;2;1;2;1;154980;0;0;0;Cocina CMC20AXX 4P Inox;LINEA BLANCA
7870135;;M;65;CHILENO;;Boomers;LAUTARO                       ;ARAUCANIA;392980;2;1;0;0;0;2;1;392980;Cocina Andes60TX4 4P Inox;LINEA BLANCA
14211386;;M;40;CHILENO;;X;CONCEPCION                    ;BIO BIO;173980;2;1;2;1;173980;0;0;0;Secadora Ropa MSV-90 9K Blanca Ventilacion;LINEA BLANCA
7090181;;F;68;CHILENO;;Boomers;MAIPU                         ;METROPOLITANA;109990;1;1;0;0;0;1;1;109990;Calefon 7Lts GL Master;LINEA BLANCA
8725347;;M;62;CHILENO;;Boomers;RANCAGUA                      ;L.G.B.OÂ´HIGGINS;329980;2;1;0;0;0;2;1;329980;Refrigerador 244Lts Frio Directo Progress 3100;LINEA BLANCA
10117878;;F;58;CHILENO;;Boomers;N/D;N/D;621980;2;1;2;1;621980;0;0;0;Cocina 76DXR Doble Horno;LINEA BLANCA
14402110;;F;54;CHILENO;;X;QUILLOTA                      ;VALPARAISO;229980;2;1;2;1;229980;0;0;0;Refrigerador 260Lts BF Frio Direc MRFI2660SR346W;LINEA BLANCA
10528799;;M;54;CHILENO;;X;N/D;N/D;366980;2;1;0;0;0;2;1;366980;Refrigerador 290Lts BF No Frost RB30N4020S8;LINEA BLANCA
13368571;;F;44;CHILENO;;X;N/D;N/D;89990;1;1;0;0;0;1;1;89990;Calefon 5Lts GL Master;LINEA BLANCA
8699536;Viudo;F;65;CHILENO;;Boomers;RENCA                         ;METROPOLITANA;352770;2;1;0;0;0;2;1;352770;Refrigerador 252Lts No Frost MRFS-2700G333FW;LINEA BLANCA
16291277;;F;36;CHILENO;;Millenial;N/D;N/D;179990;1;1;0;0;0;1;1;179990;Lavadora MLS-090GE04N 9Kg Gris;LINEA BLANCA
13372258;;F;44;CHILENO;;X;SAN JAVIER                    ;MAULE;364980;2;1;0;0;0;2;1;364980;Cocina Diva 920 5P;LINEA BLANCA
13025002;;M;45;CHILENO;;X;PUNTA ARENAS                  ;MAGALLANES;960960;4;2;0;0;0;4;2;960960;Refrigerador 535Lts Side by Side RS54N3003SL/ZS;LINEA BLANCA
12208623;;F;51;CHILENO;;X;RENCA                         ;METROPOLITANA;167980;2;1;0;0;0;2;1;167980;Freezer 99Lts MFH-1000B131CN Horizontal;LINEA BLANCA
15320716;;M;40;CHILENO;;X;RENCA                         ;METROPOLITANA;153980;2;1;2;1;153980;0;0;0;Cocina CMC20AXX 4P Inox;LINEA BLANCA
10364524;;F;48;CHILENO;;X;N/D;N/D;198979;2;1;0;0;0;2;1;198979;Cocina CMC20AXX 4P Inox;LINEA BLANCA
7416902;;M;65;CHILENO;;Boomers;LAS CONDES                    ;METROPOLITANA;359980;2;1;0;0;0;2;1;359980;Lavadora Superior WW10J6410CW1ZS 10Kg;LINEA BLANCA
15750955;;M;38;CHILENO;;X;COQUIMBO                      ;COQUIMBO;345980;2;1;2;1;345980;0;0;0;KIT-138 HORNO HE-7200IN+CEG-4600IN+CA-610EIN;LINEA BLANCA
9652333;;F;60;CHILENO;;Boomers;QUILPUE                       ;VALPARAISO;407460;3;1;0;0;0;3;1;407460;Lavadora Efficace SZG 19,5Kg Silver;LINEA BLANCA
19856456;;M;24;CHILENO;;Z;CANETE                        ;BIO BIO;481760;3;1;0;0;0;3;1;481760;Lavadora Premium Care 20SZ 20Kg Silver;LINEA BLANCA
18645706;;M;28;CHILENO;;Millenial;COLTAUCO                      ;L.G.B.OÂ´HIGGINS;21980;2;3;0;0;0;2;3;21980;Lavadora Efficace SZG 17,5Kg Silver;LINEA BLANCA
7367470;;M;67;CHILENO;;Extranjero;RENCA                         ;METROPOLITANA;279980;2;1;0;0;0;2;1;279980;Cocina 785FX 4P;LINEA BLANCA
9140207;;F;65;CHILENO;;Boomers;RENCA                         ;METROPOLITANA;526960;4;1;0;0;0;4;1;526960;Lavadora Efficace SZG 17,5Kg Silver;LINEA BLANCA
26943110;;M;26;VENEZOLANO;;Extranjero;N/D;N/D;207540;2;1;2;1;207540;0;0;0;HORNO EMPOTRABLE HE-7200 INOX 2250W 57L SINDELEN;LINEA BLANCA
8050389;;M;65;CHILENO;;Boomers;CHILLAN                       ;BIO BIO;24480;2;2;0;0;0;2;2;24480;Cocina 775X 4P;LINEA BLANCA
8731679;Casado;M;63;CHILENO;;Boomers;PICHIDEGUA                    ;L.G.B.OÂ´HIGGINS;311360;3;1;0;0;0;3;1;311360;Refrigerador 241Lts BF Frio Directo Nordik 415;LINEA BLANCA
9568686;;M;61;CHILENO;;Boomers;RENCA                         ;METROPOLITANA;159990;1;1;0;0;0;1;1;159990;Calefont 10Lts GL Essenetial ECO;LINEA BLANCA
15878905;;F;38;CHILENO;;Millenial;QUIRIHUE                      ;BIO BIO;255520;4;1;4;1;255520;0;0;0;Lavadora Semiautomatica LC-6550 6,5Kg;LINEA BLANCA
18526798;;M;29;CHILENO;;Silencioso;PROVIDENCIA                   ;METROPOLITANA;205980;2;1;2;1;205980;0;0;0;Secadora Ropa MSV-90 9K Blanca Ventilacion;LINEA BLANCA
9279187;Soltero;F;59;CHILENO;PROFESOR;Boomers;MELIPILLA                     ;METROPOLITANA;229980;2;1;0;0;0;2;1;229980;Cocina MV 110 4 Platos;LINEA BLANCA
13946803;;F;42;CHILENO;;X;N/D;N/D;250360;3;1;0;0;0;3;1;250360;Cocina CMC5515GCH-1 4P;LINEA BLANCA
26477092;;F;23;CHILENO;;Extranjero;ANTOFAGASTA                   ;ANTOFAGASTA;229990;1;1;0;0;0;1;1;229990;Freezer FDHM200BY1 200Lts Horizontal;LINEA BLANCA
9468142;;F;54;CHILENO;;X;RENCA                         ;METROPOLITANA;159990;1;1;0;0;0;1;1;159990;Calefont 10Lts GL Essenetial ECO;LINEA BLANCA
11091227;;F;56;CHILENO;;Boomers;OVALLE                        ;COQUIMBO;220570;2;1;0;0;0;2;1;220570;Cocina CMC20AXX 4P Inox;LINEA BLANCA
16587785;;F;35;CHILENO;;Millenial;N/D;N/D;234980;2;1;2;1;234980;0;0;0;Lavadora superior MLS-110GE04N 11Kg;LINEA BLANCA
8130803;;F;64;CHILENO;;Boomers;LINARES                       ;MAULE;217370;2;1;0;0;0;2;1;217370;Cocina CMC20AXX 4P Inox;LINEA BLANCA
20901446;;M;62;CHILENO;;Boomers;COIHAIQUE                     ;AYSEN;89990;1;1;0;0;0;1;1;89990;Calefon 5Lts GL Master;LINEA BLANCA
9879181;;F;58;CHILENO;;Boomers;N/D;N/D;277860;3;1;0;0;0;3;1;277860;Refrigerador 210Lts Rojo Frio Dir MRFS2100R273FN;LINEA BLANCA
17395104;;M;32;CHILENO;;Millenial;N/D;N/D;158250;3;2;0;0;0;3;2;158250;Calefon 5Lts GL Master;LINEA BLANCA
15529081;;F;39;CHILENO;;X;RENCA                         ;METROPOLITANA;203980;2;1;2;1;203980;0;0;0;Secadora Ropa MSV-90 9K Blanca Ventilacion;LINEA BLANCA
12036640;;F;46;CHILENO;;X;CHILLAN VIEJO                 ;BIO BIO;829200;8;3;0;0;0;8;3;829200;Refrigerador 525Lts Side by Side SFX500;LINEA BLANCA
5960767;;M;73;CHILENO;;Silencioso;PROVIDENCIA                   ;METROPOLITANA;375460;3;1;0;0;0;3;1;375460;Lavadora Superior WA15T5260BY/ZS 15 Kg;LINEA BLANCA
6556944;Casado;M;67;CHILENO;CONTADOR GENERAL;Boomers;DALCAHUE                      ;LOS LAGOS;260970;4;2;2;1;235980;2;1;24990;Lavadora superior MLS-110GE04N 11Kg;LINEA BLANCA
7624215;;M;66;CHILENO;;Boomers;N/D;N/D;319990;1;1;0;0;0;1;1;319990;Refrigerador 255Lts No Frost RT25FARADS8/ZS;LINEA BLANCA
12281095;;F;53;CHILENO;;X;MELIPEUCO                     ;ARAUCANIA;332980;2;1;0;0;0;2;1;332980;Cocina Diva 820 6P;LINEA BLANCA
9430833;Casado;M;59;CHILENO;;Boomers;RENCA                         ;METROPOLITANA;317870;2;1;0;0;0;2;1;317870;Refrigerador 241Lts BF Frio Directo Nordik 415;LINEA BLANCA
19722319;;M;24;CHILENO;;Silencioso;PROVIDENCIA                   ;METROPOLITANA;215980;2;1;2;1;215980;0;0;0;Lavadora WA90H4400SW/ZS 9Kg Blanca;LINEA BLANCA
10403299;;M;57;CHILENO;;Boomers;EL BOSQUE                     ;METROPOLITANA;365470;2;1;0;0;0;2;1;365470;Lavadora WT16DSBP 16Kg Silver;LINEA BLANCA
7926812;;M;65;CHILENO;;Silencioso;PROVIDENCIA                   ;METROPOLITANA;733740;4;1;0;0;0;4;1;733740;Refrigerador 244Lts Frio Directo Progress 3100;LINEA BLANCA
6406781;;F;77;CHILENO;;Silencioso;VINA DEL MAR                  ;VALPARAISO;220570;2;1;0;0;0;2;1;220570;Cocina CH-7400 4P;LINEA BLANCA
9052597;;M;60;CHILENO;;Boomers;SAN FELIPE                    ;VALPARAISO;219990;1;1;0;0;0;1;1;219990;Secadora Ropa Reverplus 6470 7Kg Gris Ventilacio;LINEA BLANCA
17128471;;F;33;CHILENO;;Millenial;PROVIDENCIA                   ;METROPOLITANA;372770;2;1;0;0;0;2;1;372770;Refrigerador 244Lts Frio Directo Progress 3100;LINEA BLANCA
12031825;;F;55;CHILENO;;Boomers;QUILLOTA                      ;VALPARAISO;0;0;0;0;0;0;0;0;0;Lavadora WA80H4200SW/ZS 8Kg Blanca;LINEA BLANCA
10622955;;F;55;CHILENO;;Boomers;QUILICURA                     ;METROPOLITANA;0;0;0;0;0;0;0;0;0;Cocina CMC5515GCH-1 4P;LINEA BLANCA
19228880;;M;26;CHILENO;;Z;SAN BERNARDO                  ;METROPOLITANA;0;0;0;0;0;0;0;0;0;TERMO ELECTRICO 100 LITROS (SPLENDID);LINEA BLANCA
6995480;;F;73;CHILENO;;Silencioso;PUERTO MONTT                  ;LOS LAGOS;0;0;0;0;0;0;0;0;0;Cocina 775X 4P;LINEA BLANCA
7438906;Casado;F;64;CHILENO;;Boomers;LA GRANJA                     ;METROPOLITANA;0;0;0;0;0;0;0;0;0;Lavadora Premium Care 20SZ 20Kg Silver;LINEA BLANCA
11957602;;M;49;CHILENO;;X;PORTEZUELO                    ;BIO BIO;0;0;0;0;0;0;0;0;0;Cocina CH-9950NG-1 6P Negro;LINEA BLANCA
6454558;;F;77;CHILENO;;Silencioso;ANTOFAGASTA                   ;ANTOFAGASTA;0;0;0;0;0;0;0;0;0;Lavadora Secadora WD90M4453JW/ZS 9/5Kg Blanca;LINEA BLANCA
12204947;;F;50;CHILENO;;X;N/D;N/D;0;0;0;0;0;0;0;0;0;Lavadora WT13WSBP 13Kg Blanca;LINEA BLANCA
7258220;;F;64;CHILENO;;Boomers;PROVIDENCIA                   ;METROPOLITANA;0;0;0;0;0;0;0;0;0;COCINA SINDELEN CH-5050NG 4P;LINEA BLANCA
10473018;;M;57;CHILENO;;Boomers;RENCA                         ;METROPOLITANA;0;0;0;0;0;0;0;0;0;Cocina CH-8900IN 5P;LINEA BLANCA
12771023;Divorciado;F;47;CHILENO;;X;RENCA                         ;METROPOLITANA;0;0;0;0;0;0;0;0;0;Lavadora Superior WA13T5260BY/ZS 13Kg;LINEA BLANCA
8250280;;F;63;CHILENO;;Boomers;VALLENAR;ATACAMA;0;0;0;0;0;0;0;0;0;Refrigerador 260Lts BF Frio Direc MRFI2660SR346W;LINEA BLANCA
11230133;;F;55;CHILENO;;Boomers;RENCA                         ;METROPOLITANA;0;0;0;0;0;0;0;0;0;Freezer Horizontal M100 99Lts;LINEA BLANCA
9198922;;F;66;CHILENO;;Boomers;N/D;N/D;0;0;0;0;0;0;0;0;0;Refrigerador 300Lts No Frost RT29K500JS8/ZS;LINEA BLANCA
18423036;;F;29;CHILENO;;Millenial;COLINA                        ;METROPOLITANA;0;0;0;0;0;0;0;0;0;CENTRIFUGA C-752;LINEA BLANCA
16186132;;M;37;CHILENO;;Millenial;PROVIDENCIA                   ;METROPOLITANA;0;0;0;0;0;0;0;0;0;Refrigerador 260Lts BF Frio Direc MRFI2660SR346W;LINEA BLANCA
7978870;Soltero;M;62;CHILENO;;Boomers;PROVIDENCIA                   ;METROPOLITANA;0;0;0;0;0;0;0;0;0;Refrigerador 2100-S 207Lts Frio Directo;LINEA BLANCA
15989483;;F;36;CHILENO;;Millenial;N/D;N/D;0;0;0;0;0;0;0;0;0;Freezer FDHM150BY1 150Lts Horizontal;LINEA BLANCA
16735239;;F;34;CHILENO;;Millenial;N/D;N/D;0;0;0;0;0;0;0;0;0;Lavadora WA13T5260BW/ZS 13Kg Blanca;LINEA BLANCA
15663222;;F;38;CHILENO;;Silencioso;PROVIDENCIA                   ;METROPOLITANA;0;0;0;0;0;0;0;0;0;Lavadora LMA0920WGCL0 9,5Kg Gris;LINEA BLANCA
13635153;;F;43;CHILENO;;X;ARICA                         ;TARAPACA;0;0;0;0;0;0;0;0;0;Lavadora MLS-160BSC03T 16Kg Blanca;LINEA BLANCA
15548789;Casado;F;38;CHILENO;;X;PROVIDENCIA                   ;METROPOLITANA;0;0;0;0;0;0;0;0;0;Lavadora Secadora WD90M4453JW/ZS 9/5Kg Blanca;LINEA BLANCA
9644040;;F;60;CHILENO;;Boomers;SANTA CRUZ                    ;L.G.B.OÂ´HIGGINS;0;0;0;0;0;0;0;0;0;Refrigerador 260Lts BF Frio Direc MRFI2660SR346W;LINEA BLANCA
16761032;;F;34;CHILENO;;Millenial;ANGOL                         ;ARAUCANIA;0;0;0;0;0;0;0;0;0;Calefon 5Lts GL Master;LINEA BLANCA
7583586;;F;69;CHILENO;;Silencioso;CONSTITUCION                  ;MAULE;0;0;0;0;0;0;0;0;0;Lavadora WT19DSBP 19Kg Silver;LINEA BLANCA
10447161;;M;57;CHILENO;;Boomers;SAN VICENTE                   ;L.G.B.OÂ´HIGGINS;0;0;0;0;0;0;0;0;0;Lavadora MLS-160BSC03T 16Kg Blanca;LINEA BLANCA
16965499;;F;34;CHILENO;;Millenial;PROVIDENCIA                   ;METROPOLITANA;0;0;0;0;0;0;0;0;0;Cocina CH-9950NG-1 6P Negro;LINEA BLANCA
8183894;;M;65;CHILENO;;Boomers;PUNTA ARENAS                  ;MAGALLANES;0;0;0;0;0;0;0;0;0;Lavadora Efficace SZG 15,5Kg Silver;LINEA BLANCA
7880412;;F;62;CHILENO;;Boomers;N/D;N/D;0;0;0;0;0;0;0;0;0;Refrigerador 167Lts Frio Directo 1700-S;LINEA BLANCA
15498456;;M;38;CHILENO;;X;PETORCA                       ;VALPARAISO;0;0;0;0;0;0;0;0;0;Lavadora Efficace SZG 17,5Kg Silver;LINEA BLANCA
12546374;;F;48;CHILENO;;X;SAN CARLOS                    ;BIO BIO;0;0;0;0;0;0;0;0;0;Cocina Diva 920 5P;LINEA BLANCA
9639714;;M;57;CHILENO;;Boomers;LOS ANDES                     ;VALPARAISO;0;0;0;0;0;0;0;0;0;Refrigerador 241Lts BF Frio Directo Nordik 415;LINEA BLANCA
25996196;;F;44;CHILENO;;Extranjero;N/D;N/D;0;0;0;0;0;0;0;0;0;Refrigerador 341Lts BF No Frost GB37MPD;LINEA BLANCA
8508786;Casado;M;63;CHILENO;;Boomers;RENCA                         ;METROPOLITANA;0;0;0;0;0;0;0;0;0;Cocina CH-7400 4P;LINEA BLANCA
8181332;;F;62;CHILENO;;Boomers;HUASCO                        ;ATACAMA;0;0;0;0;0;0;0;0;0;Lavadora Efficace BZG 11,5Kg Blanca;LINEA BLANCA
9821260;;F;56;CHILENO;;Boomers;PUNITAQUI                     ;COQUIMBO;0;0;0;0;0;0;0;0;0;Cocina CH-7400 4P;LINEA BLANCA
19425079;;M;27;CHILENO;;Z;PROVIDENCIA                   ;METROPOLITANA;0;0;0;0;0;0;0;0;0;Cocina Nova CH9850NG 6P;LINEA BLANCA
9130745;;F;64;CHILENO;;Boomers;PUENTE ALTO                   ;METROPOLITANA;0;0;0;0;0;0;0;0;0;Cocina F-2608 4P Inox;LINEA BLANCA
9526669;;F;56;CHILENO;;Boomers;EL CARMEN                     ;BIO BIO;0;0;0;0;0;0;0;0;0;Freezer Horizontal FFH Z300 291Lts;LINEA BLANCA
5392102;Casado;F;72;CHILENO;CONTADOR GENERAL;Silencioso;LA CISTERNA                   ;METROPOLITANA;0;0;0;0;0;0;0;0;0;Lavadora MLS-090GE04N 9Kg Gris;LINEA BLANCA
10191022;;F;57;CHILENO;;Boomers;LINARES                       ;MAULE;0;0;0;0;0;0;0;0;0;Refrigerador 535Lts Side by Side RS54N3003SL/ZS;LINEA BLANCA
6743782;;M;68;CHILENO;;Boomers;N/D;N/D;0;0;0;0;0;0;0;0;0;Cocina Andes60TX4 4P Inox;LINEA BLANCA
13912309;;M;42;CHILENO;;X;EL BOSQUE                     ;METROPOLITANA;0;0;0;0;0;0;0;0;0;Lavadora MLS-160BSC03T 16Kg Blanca;LINEA BLANCA
18135447;;M;30;CHILENO;;Millenial;LOTA                          ;BIO BIO;0;0;0;0;0;0;0;0;0;Refrigerador 254Lts No Frost GT29WPPDC;LINEA BLANCA
12672203;;M;47;CHILENO;;X;PROVIDENCIA                   ;METROPOLITANA;0;0;0;0;0;0;0;0;0;Refrigerador Advantage 5300E 320Lts No Frost;LINEA BLANCA
7354399;Viudo;F;73;CHILENO;;Silencioso;PROVIDENCIA                   ;METROPOLITANA;0;0;0;0;0;0;0;0;0;Cocina F-2525 4P;LINEA BLANCA
12975809;;M;46;CHILENO;;X;PROVIDENCIA                   ;METROPOLITANA;0;0;0;0;0;0;0;0;0;Lavadora WA80H4200SW/ZS 8Kg Blanca;LINEA BLANCA
13396707;Casado;F;47;CHILENO;;X;PROVIDENCIA                   ;METROPOLITANA;0;0;0;0;0;0;0;0;0;Lavadora WA13T5260BW/ZS 13Kg Blanca;LINEA BLANCA
11539630;Soltero;M;52;CHILENO;;X;VICTORIA                      ;ARAUCANIA;0;0;0;0;0;0;0;0;0;Lavadora WA13T5260BW/ZS 13Kg Blanca;LINEA BLANCA
8106370;Casado;F;65;CHILENO;;Boomers;RENCA                         ;METROPOLITANA;0;0;0;0;0;0;0;0;0;Lavadora WT16DSBP 16Kg Silver;LINEA BLANCA
10221590;;F;54;CHILENO;;X;ISLA DE MAIPO                 ;METROPOLITANA;0;0;0;0;0;0;0;0;0;Cocina MCG-4QI24AME4 4P Inox;LINEA BLANCA
15631946;;F;38;CHILENO;;Millenial;PROVIDENCIA                   ;METROPOLITANA;0;0;0;0;0;0;0;0;0;Horno Empotrado FHE1060 66Lts Inox;LINEA BLANCA
10389701;;M;56;CHILENO;;Boomers;PROVIDENCIA                   ;METROPOLITANA;0;0;0;0;0;0;0;0;0;Lavadora WA13T5260BW/ZS 13Kg Blanca;LINEA BLANCA
6730094;;M;69;CHILENO;;Silencioso;TALCAHUANO                    ;BIO BIO;0;0;0;0;0;0;0;0;0;Cocina F-2808 4P;LINEA BLANCA
20253596;;F;22;CHILENO;;Z;VALDIVIA                      ;LOS LAGOS;0;0;0;0;0;0;0;0;0;Lavadora MLS-090GE04N 9Kg Gris;LINEA BLANCA
16066255;;F;36;CHILENO;;Millenial;"";"";0;0;0;0;0;0;0;0;0;CALEFON 14 LITROS FULLCONTROL GL (SPLENDID);LINEA BLANCA
15629636;;M;38;CHILENO;;X;LOS ANGELES                   ;BIO BIO;0;0;0;0;0;0;0;0;0;Lavadora MLS-160BSC03T 16Kg Blanca;LINEA BLANCA
24061704;;F;44;COLOMBIANO;;Extranjero;ANTOFAGASTA                   ;ANTOFAGASTA;0;0;0;0;0;0;0;0;0;Refrigerador 290Lts BF No Frost RB30N4020S8;LINEA BLANCA
15098105;;M;39;CHILENO;;X;PROVIDENCIA                   ;METROPOLITANA;0;0;0;0;0;0;0;0;0;Lavadora Secadora WD10WVC4S6 10,5/6Kg Blanca;LINEA BLANCA
10949053;;F;56;CHILENO;;Boomers;LA CISTERNA                   ;METROPOLITANA;0;0;0;0;0;0;0;0;0;Lavadora Secadora WD12N64FR2X/ZS 12/7Kg Silver;LINEA BLANCA
7069740;;M;69;CHILENO;;Silencioso;RETIRO                        ;MAULE;0;0;0;0;0;0;0;0;0;Lavadora MLS-090GE04N 9Kg Gris;LINEA BLANCA
19983941;;F;23;CHILENO;;X;LA SERENA                     ;COQUIMBO;0;0;0;0;0;0;0;0;0;Cocina CH-7400 4P;LINEA BLANCA
9738858;Casado;M;59;CHILENO;DIBUJANTE TECNICO;Boomers;CORONEL                       ;BIO BIO;0;0;0;0;0;0;0;0;0;Lavadora Frontal 9Kg Blanca;LINEA BLANCA
18921663;;F;27;CHILENO;;Z;MELIPILLA                     ;METROPOLITANA;0;0;0;0;0;0;0;0;0;Calefont 8Lts GL Essenetial ECO;LINEA BLANCA
7549461;;F;65;CHILENO;;Boomers;RENCA                         ;METROPOLITANA;0;0;0;0;0;0;0;0;0;Cocina CMC5515GCH-1 4P;LINEA BLANCA
8412110;;F;64;CHILENO;;Boomers;VILLARICA                     ;ARAUCANIA;0;0;0;0;0;0;0;0;0;Lavadora MLS-160BSC03T 16Kg Blanca;LINEA BLANCA
17338835;Casado;M;32;CHILENO;;Millenial;RENCA                         ;METROPOLITANA;0;0;0;0;0;0;0;0;0;Lavadora Premium Care 20SZ 20Kg Silver;LINEA BLANCA
8822364;;F;63;CHILENO;;Boomers;N/D;N/D;0;0;0;0;0;0;0;0;0;Cocina CH-7400 4P;LINEA BLANCA
9212422;;F;62;CHILENO;;Boomers;LAMPA                         ;METROPOLITANA;0;0;0;0;0;0;0;0;0;Cocina CH-8900IN 5P;LINEA BLANCA
15439019;;F;40;CHILENO;;X;PROVIDENCIA                   ;METROPOLITANA;0;0;0;0;0;0;0;0;0;Cocina CMC5515GCH-1 4P;LINEA BLANCA
16224963;Casado;F;36;CHILENO;;Millenial;RENCA                         ;METROPOLITANA;0;0;0;0;0;0;0;0;0;Cocina F-2808 4P;LINEA BLANCA
17902827;;M;31;CHILENO;;Millenial;PROVIDENCIA                   ;METROPOLITANA;0;0;0;0;0;0;0;0;0;Lavadora 19 Kg Carga Superior Negro;LINEA BLANCA
9824219;;F;58;CHILENO;;Boomers;RENGO                         ;L.G.B.OÂ´HIGGINS;0;0;0;0;0;0;0;0;0;Cocina CH-7400 4P;LINEA BLANCA
12146860;Casado;F;49;CHILENO;CONTADOR AUDITOR;X;RENCA                         ;METROPOLITANA;0;0;0;0;0;0;0;0;0;Cocina CMC20AXX 4P Inox;LINEA BLANCA
6447296;;F;70;CHILENO;;Silencioso;PROVIDENCIA                   ;METROPOLITANA;0;0;0;0;0;0;0;0;0;Cocina MV 110 4 Platos;LINEA BLANCA
10547035;;M;56;CHILENO;;Boomers;N/D;N/D;0;0;0;0;0;0;0;0;0;Lavadora WA13T5260BW/ZS 13Kg Blanca;LINEA BLANCA
12492341;;F;49;CHILENO;;X;PROVIDENCIA                   ;METROPOLITANA;0;0;0;0;0;0;0;0;0;Refrigerador 260Lts BF Frio Direc MRFI2660SR346W;LINEA BLANCA
4760748;;M;84;CHILENO;;Silencioso;CHIGUAYANTE                   ;BIO BIO;0;0;0;0;0;0;0;0;0;Refrigerador 249Lts No Frost RMA250PHUG;LINEA BLANCA
17614370;;F;31;CHILENO;;Millenial;CORONEL                       ;BIO BIO;0;0;0;0;0;0;0;0;0;Lavadora Premium Care Pro 16Kg Silver;LINEA BLANCA
7809165;;F;61;CHILENO;;Boomers;RENCA                         ;METROPOLITANA;0;0;0;0;0;0;0;0;0;Lavadora MLS-160BSC03T 16Kg Blanca;LINEA BLANCA
15070743;Casado;F;38;CHILENO;PSICOLOGO;Silencioso;PROVIDENCIA                   ;METROPOLITANA;0;0;0;0;0;0;0;0;0;Lavadora Secadora WD10WVC4S6 10,5/6Kg Blanca;LINEA BLANCA
12500679;Casado;F;49;CHILENO;;X;RENCA                         ;METROPOLITANA;0;0;0;0;0;0;0;0;0;Lavadora WA13T5260BW/ZS 13Kg Blanca;LINEA BLANCA
12165773;;F;54;CHILENO;;X;QUILLOTA                      ;VALPARAISO;0;0;0;0;0;0;0;0;0;Refrigerador 244Lts Frio Directo Progress 3100;LINEA BLANCA
11072904;;F;56;CHILENO;;Boomers;RENCA                         ;METROPOLITANA;0;0;0;0;0;0;0;0;0;Lavadora MLS-080BE04N 8Kg Blanca;LINEA BLANCA
20170475;;F;22;CHILENO;;Silencioso;TALCA                         ;MAULE;0;0;0;0;0;0;0;0;0;Refrigerador 244Lts Frio Directo Progress 3100;LINEA BLANCA
15715368;Casado;M;38;CHILENO;PROFESOR;Silencioso;PROVIDENCIA                   ;METROPOLITANA;0;0;0;0;0;0;0;0;0;Refrigerador RB31K3210S9/ZS 311 LTRS No Frost;LINEA BLANCA
16455069;;F;35;CHILENO;;Millenial;PROVIDENCIA                   ;METROPOLITANA;0;0;0;0;0;0;0;0;0;Refrigerador 244Lts Frio Directo Progress 3100;LINEA BLANCA
8703952;;F;65;CHILENO;;Boomers;N/D;N/D;0;0;0;0;0;0;0;0;0;Cocina Andes76HG0 6P Inox;LINEA BLANCA
12276732;;M;50;CHILENO;;X;PUDAHUEL                      ;METROPOLITANA;0;0;0;0;0;0;0;0;0;Secadora Ropa Solare 7100 7K Ventilacion;LINEA BLANCA
7519355;;M;66;CHILENO;;Boomers;PROVIDENCIA                   ;METROPOLITANA;0;0;0;0;0;0;0;0;0;Lavadora WA13T5260BW/ZS 13Kg Blanca;LINEA BLANCA
11660536;;F;51;CHILENO;;X;N/D;N/D;0;0;0;0;0;0;0;0;0;Freezer FDHM200BY1 200Lts Horizontal;LINEA BLANCA
20294328;;M;22;CHILENO;;Millenial;PROVIDENCIA                   ;METROPOLITANA;0;0;0;0;0;0;0;0;0;Secadora Ropa MSV-90 9K Blanca Ventilacion;LINEA BLANCA
11749276;;M;51;CHILENO;;X;CERRO NAVIA                   ;METROPOLITANA;0;0;0;0;0;0;0;0;0;Refrigerador 244Lts Frio Directo Progress 3100;LINEA BLANCA
17275070;;F;32;CHILENO;;Millenial;N/D;N/D;0;0;0;0;0;0;0;0;0;ENCIMERA A GAS 4 PLATOS CEG-4600 INOX;LINEA BLANCA
15901928;Soltero;M;37;CHILENO;;Silencioso;PROVIDENCIA                   ;METROPOLITANA;0;0;0;0;0;0;0;0;0;Lavadora Secadora WD10WVC4S6 10,5/6Kg Blanca;LINEA BLANCA
17251502;;F;33;CHILENO;;Millenial;PROVIDENCIA                   ;METROPOLITANA;0;0;0;0;0;0;0;0;0;CENTRIFUGA C-752;LINEA BLANCA
15442264;;F;39;CHILENO;;X;CABRERO                       ;BIO BIO;0;0;0;0;0;0;0;0;0;Cocina CH-9950NG-1 6P Negro;LINEA BLANCA
7090196;;M;66;CHILENO;;Boomers;TALCAHUANO                    ;BIO BIO;0;0;0;0;0;0;0;0;0;Lavadora LMA0920WGCL0 9,5Kg Gris;LINEA BLANCA
13454294;;F;44;CHILENO;;X;PROVIDENCIA                   ;METROPOLITANA;0;0;0;0;0;0;0;0;0;Lavadora Efficace SZG 9,5Kg Silver;LINEA BLANCA
20148659;;F;23;CHILENO;;Z;PROVIDENCIA                   ;METROPOLITANA;0;0;0;0;0;0;0;0;0;Secadora Ropa Solare 7100 7K Ventilacion;LINEA BLANCA
16099055;;F;36;CHILENO;;Millenial;PROVIDENCIA                   ;METROPOLITANA;0;0;0;0;0;0;0;0;0;Lavadora Efficace BZG 11,5Kg Blanca;LINEA BLANCA
11603340;;M;53;CHILENO;;X;CONTULMO                      ;BIO BIO;0;0;0;0;0;0;0;0;0;Lavadora MLS-160GSC03T 16Kg Gris;LINEA BLANCA
12387049;;F;49;CHILENO;;X;RANCAGUA                      ;L.G.B.OÂ´HIGGINS;0;0;0;0;0;0;0;0;0;CENTRIFUGA C-752;LINEA BLANCA
12079921;;M;53;CHILENO;;X;ALTO HOSPICIO;TARAPACA;0;0;0;0;0;0;0;0;0;Cocina Andes60TX4 4P Inox;LINEA BLANCA
17908801;;M;31;CHILENO;;Silencioso;PROVIDENCIA                   ;METROPOLITANA;0;0;0;0;0;0;0;0;0;Secadora Ropa Reverplus 6470 7Kg Gris Ventilacio;LINEA BLANCA
18297713;Casado;F;29;CHILENO;;Silencioso;PROVIDENCIA                   ;METROPOLITANA;0;0;0;0;0;0;0;0;0;Cocina CH-6900IN 4P;LINEA BLANCA
16226204;Casado;M;36;CHILENO;;Millenial;PROVIDENCIA                   ;METROPOLITANA;0;0;0;0;0;0;0;0;0;Refrigerador RMN222PXLRS0 222LTS No Frost;LINEA BLANCA
15178107;;F;39;CHILENO;;X;PROVIDENCIA                   ;METROPOLITANA;0;0;0;0;0;0;0;0;0;Secadora Ropa Solare 9100 9K Ventilacion;LINEA BLANCA
8910614;;M;62;CHILENO;;Boomers;ANTOFAGASTA                   ;ANTOFAGASTA;0;0;0;0;0;0;0;0;0;Calefont 8Lts GL Essenetial ECO;LINEA BLANCA
7061493;;F;67;CHILENO;;Boomers;N/D;N/D;0;0;0;0;0;0;0;0;0;Cocina MCG-4QI24AME4 4P Inox;LINEA BLANCA
17551363;;F;36;CHILENO;;Millenial;N/D;N/D;0;0;0;0;0;0;0;0;0;Lavadora MLS-160BSC03T 16Kg Blanca;LINEA BLANCA
17457860;;F;32;CHILENO;;Millenial;RENCA                         ;METROPOLITANA;0;0;0;0;0;0;0;0;0;Lavadora Secadora WD10WVC4S6 10,5/6Kg Blanca;LINEA BLANCA
25904068;;M;28;COLOMBIANO;;Extranjero;PADRE HURTADO                 ;METROPOLITANA;0;0;0;0;0;0;0;0;0;Secadora Ropa Solare 7100 7K Ventilacion;LINEA BLANCA
20221376;;F;23;CHILENO;;Z;PROVIDENCIA                   ;METROPOLITANA;0;0;0;0;0;0;0;0;0;Secadora Ropa Solare 7100 7K Ventilacion;LINEA BLANCA
16282357;Soltero;F;35;CHILENO;MEDICO VETERINARIO;Millenial;PROVIDENCIA                   ;METROPOLITANA;0;0;0;0;0;0;0;0;0;Lavadora MLS-080BE04N 8Kg Blanca;LINEA BLANCA
10538590;;F;50;CHILENO;;X;RENCA                         ;METROPOLITANA;0;0;0;0;0;0;0;0;0;Calefon 7Lts GL Master;LINEA BLANCA
12619020;;M;48;CHILENO;;X;PROVIDENCIA                   ;METROPOLITANA;0;0;0;0;0;0;0;0;0;Cocina MCG-4QI24AME4 4P Inox;LINEA BLANCA
8435655;;M;60;CHILENO;;Boomers;N/D;N/D;0;0;0;0;0;0;0;0;0;Cocina CMC20AXX 4P Inox;LINEA BLANCA
18575095;Soltero;M;28;CHILENO;;Millenial;PROVIDENCIA                   ;METROPOLITANA;0;0;0;0;0;0;0;0;0;Refrigerador 244Lts Frio Directo Progress 3100;LINEA BLANCA
6841877;;F;71;CHILENO;;Silencioso;RENCA                         ;METROPOLITANA;0;0;0;0;0;0;0;0;0;Lavadora Secadora WD10WVC4S6 10,5/6Kg Blanca;LINEA BLANCA
18441704;;M;29;CHILENO;;Millenial;PROVIDENCIA                   ;METROPOLITANA;0;0;0;0;0;0;0;0;0;Refrigerador 244Lts Frio Directo Progress 3100;LINEA BLANCA
16949306;;F;34;CHILENO;;Millenial;PROVIDENCIA                   ;METROPOLITANA;0;0;0;0;0;0;0;0;0;Secadora Electrica SEM101BDBY Blanca 10 KG;LINEA BLANCA
8690815;;F;49;CHILENO;;X;QUILPUE                       ;VALPARAISO;0;0;0;0;0;0;0;0;0;Refrigerador 251Lts No Frost Altus 1250;LINEA BLANCA
7861176;;M;65;CHILENO;;Boomers;N/D;N/D;0;0;0;0;0;0;0;0;0;Lavadora Superior WW10J6410CW1ZS 10Kg;LINEA BLANCA
24612791;;M;37;COLOMBIANO;;Extranjero;ANTOFAGASTA                   ;ANTOFAGASTA;0;0;0;0;0;0;0;0;0;Lavadora WA90H4400SW/ZS 9Kg Blanca;LINEA BLANCA
19213365;;M;26;CHILENO;;Z;TALAGANTE                     ;METROPOLITANA;0;0;0;0;0;0;0;0;0;Refrigerador 252Lts No Frost MRFS-2700G333FW;LINEA BLANCA
9634531;;F;59;CHILENO;;Boomers;ARICA                         ;TARAPACA;0;0;0;0;0;0;0;0;0;Cocina Andes76HG0 6P Inox;LINEA BLANCA
18119802;;F;30;CHILENO;;Millenial;PROVIDENCIA                   ;METROPOLITANA;0;0;0;0;0;0;0;0;0;HORNO EMPOTRABLE HE-7200 INOX 2250W 57L SINDELEN;LINEA BLANCA
7761914;;F;67;CHILENO;;Boomers;CATEMU                        ;VALPARAISO;0;0;0;0;0;0;0;0;0;Calefont 5Lts GL Essenetial ECO;LINEA BLANCA
8899226;;F;62;CHILENO;;Boomers;N/D;N/D;0;0;0;0;0;0;0;0;0;Lavadora WA17T6260BW/ZS 17Kg Blanca;LINEA BLANCA
9993757;Viudo;F;64;CHILENO;;Boomers;PROVIDENCIA                   ;METROPOLITANA;0;0;0;0;0;0;0;0;0;Refrigerador Combi RD-2600IN 262Lts;LINEA BLANCA
13914135;;F;42;CHILENO;;X;PROVIDENCIA                   ;METROPOLITANA;0;0;0;0;0;0;0;0;0;Lavadora LMA0920WGCL0 9,5Kg Gris;LINEA BLANCA
13786300;;F;43;CHILENO;;X;CONSTITUCION                  ;MAULE;0;0;0;0;0;0;0;0;0;Calefont 8Lts GL Essenetial ECO;LINEA BLANCA
19789694;;M;24;CHILENO;;Z;SAN VICENTE                   ;L.G.B.OÂ´HIGGINS;0;0;0;0;0;0;0;0;0;Lavadora Secadora WD10WVC4S6 10,5/6Kg Blanca;LINEA BLANCA
19126779;Soltero;M;26;CHILENO;TECNICO EN ADMINISTRACION DE EMPRESAS;Silencioso;LAUTARO                       ;ARAUCANIA;0;0;0;0;0;0;0;0;0;Secadora Ropa Reverplus 6470 7Kg Gris Ventilacio;LINEA BLANCA
8586061;;F;65;CHILENO;;Boomers;PROVIDENCIA                   ;METROPOLITANA;0;0;0;0;0;0;0;0;0;Lavadora Efficace SZG 19,5Kg Silver;LINEA BLANCA
9676940;;M;58;CHILENO;;Boomers;N/D;N/D;0;0;0;0;0;0;0;0;0;Lavadora WA17T6260BW/ZS 17Kg Blanca;LINEA BLANCA
10531264;;M;57;CHILENO;;Boomers;LO ESPEJO                     ;METROPOLITANA;0;0;0;0;0;0;0;0;0;Cocina Andes7650FX 5P Inox;LINEA BLANCA
8807708;;F;57;CHILENO;;Boomers;CAUQUENES                     ;MAULE;0;0;0;0;0;0;0;0;0;Lavadora MLS-160BSC03T 16Kg Blanca;LINEA BLANCA
9570151;;M;58;CHILENO;;Silencioso;PROVIDENCIA                   ;METROPOLITANA;0;0;0;0;0;0;0;0;0;Cocina CH-9700IN 4P;LINEA BLANCA
16500511;;F;35;CHILENO;;Millenial;PROVIDENCIA                   ;METROPOLITANA;0;0;0;0;0;0;0;0;0;Refrigerador 626Lt Side by Side GS65MPP1 APZPECL;LINEA BLANCA
15403173;;M;39;CHILENO;;X;PENAFLOR                      ;METROPOLITANA;0;0;0;0;0;0;0;0;0;Refrigerador 303Lts BF Frio Directo Nordik 480;LINEA BLANCA
18761248;Soltero;F;27;CHILENO;;Millenial;N/D;N/D;0;0;0;0;0;0;0;0;0;Lavadora WA80H4200SW/ZS 8Kg Blanca;LINEA BLANCA
7004546;;M;60;CHILENO;;Boomers;PROVIDENCIA                   ;METROPOLITANA;0;0;0;0;0;0;0;0;0;Calefon ionizado 13 litros GL;LINEA BLANCA
6415574;;F;75;CHILENO;;Silencioso;LOS ANGELES                   ;BIO BIO;0;0;0;0;0;0;0;0;0;Refrigerador 322Lts No Frost BF DB60S;LINEA BLANCA
15554107;;F;38;CHILENO;;Millenial;PUCON                         ;ARAUCANIA;0;0;0;0;0;0;0;0;0;Lavadora MLS-160BSC03T 16Kg Blanca;LINEA BLANCA
8430939;;F;51;CHILENO;;X;N/D;N/D;0;0;0;0;0;0;0;0;0;Lavadora MLS-090GE04N 9Kg Gris;LINEA BLANCA
17402556;;M;36;CHILENO;;Silencioso;"";"";0;0;0;0;0;0;0;0;0;Lavadora MLS-090GE04N 9Kg Gris;LINEA BLANCA
15239041;;M;44;CHILENO;;Silencioso;TEMUCO                        ;ARAUCANIA;0;0;0;0;0;0;0;0;0;Cocina F-5500 Premium 5P;LINEA BLANCA
6899003;;F;68;CHILENO;;Silencioso;RENCA                         ;METROPOLITANA;0;0;0;0;0;0;0;0;0;Lavadora WA90H4400SW/ZS 9Kg Blanca;LINEA BLANCA
16809386;;F;34;CHILENO;;Millenial;PROVIDENCIA                   ;METROPOLITANA;0;0;0;0;0;0;0;0;0;Lavadora Secadora MLSF-1108BN05N 11Kg/8Kg Blanca;LINEA BLANCA
15285552;;M;39;CHILENO;;X;PROVIDENCIA                   ;METROPOLITANA;0;0;0;0;0;0;0;0;0;LAVAVAJILLA S MLV-12SI5203;LINEA BLANCA
20332511;;F;22;CHILENO;;Silencioso;PROVIDENCIA                   ;METROPOLITANA;0;0;0;0;0;0;0;0;0;Cocina F-2525 4P;LINEA BLANCA
10395483;;F;56;CHILENO;;Boomers;PROVIDENCIA                   ;METROPOLITANA;0;0;0;0;0;0;0;0;0;Cocina F-2808 4P;LINEA BLANCA
18988511;Soltero;F;27;CHILENO;;Z;PROVIDENCIA                   ;METROPOLITANA;0;0;0;0;0;0;0;0;0;Lavadora Premium Care 20SZ 20Kg Silver;LINEA BLANCA
17223531;;F;32;CHILENO;;Millenial;LOS ANGELES                   ;BIO BIO;0;0;0;0;0;0;0;0;0;Freezer FDHM150BY1 150Lts Horizontal;LINEA BLANCA
14023682;;F;40;CHILENO;;X;N/D;N/D;0;0;0;0;0;0;0;0;0;Lavadora WA80H4200SW/ZS 8Kg Blanca;LINEA BLANCA
5642672;;M;74;CHILENO;;Z;QUILPUE                       ;VALPARAISO;0;0;0;0;0;0;0;0;0;Cocina F-2525 4P;LINEA BLANCA
16132070;;M;36;CHILENO;;Millenial;PROVIDENCIA                   ;METROPOLITANA;0;0;0;0;0;0;0;0;0;Lavadora Secadora WD10J6410AW/ZS 10,5/6Kg Blanca;LINEA BLANCA
17590103;;M;31;CHILENO;;Millenial;PROVIDENCIA                   ;METROPOLITANA;0;0;0;0;0;0;0;0;0;Freezer Horizontal MFH-1990B258CN 198Lts;LINEA BLANCA
16271131;;F;36;CHILENO;;Millenial;PROVIDENCIA                   ;METROPOLITANA;0;0;0;0;0;0;0;0;0;Lavadora Efficace SZG 19,5Kg Silver;LINEA BLANCA
13763364;Casado;F;42;CHILENO;;X;PROVIDENCIA                   ;METROPOLITANA;0;0;0;0;0;0;0;0;0;Centrifuga Primma 5B 5,5Kilos;LINEA BLANCA
15044419;;M;39;CHILENO;;Silencioso;PROVIDENCIA                   ;METROPOLITANA;0;0;0;0;0;0;0;0;0;Lavadora MLS-140GSC03T 14Kg Gris;LINEA BLANCA
9478785;;M;58;CHILENO;;Boomers;RENCA                         ;METROPOLITANA;0;0;0;0;0;0;0;0;0;Lavadora WT13WSBP 13Kg Blanca;LINEA BLANCA
12498298;;F;48;CHILENO;;Silencioso;PROVIDENCIA                   ;METROPOLITANA;0;0;0;0;0;0;0;0;0;Refrigerador 525Lts Side by Side SFX500;LINEA BLANCA
11769723;;F;52;CHILENO;;X;PENAFLOR                      ;METROPOLITANA;0;0;0;0;0;0;0;0;0;Cocina F-2525 4P;LINEA BLANCA
15254550;;F;39;CHILENO;;X;RENCA                         ;METROPOLITANA;0;0;0;0;0;0;0;0;0;Refrigerador No Frost BMF 284 Lts c/disp;LINEA BLANCA
10905969;;M;54;CHILENO;;X;ANTOFAGASTA                   ;ANTOFAGASTA;0;0;0;0;0;0;0;0;0;Lavadora MLS-160BSC03T 16Kg Blanca;LINEA BLANCA
18955719;;M;27;CHILENO;;Z;PROVIDENCIA                   ;METROPOLITANA;0;0;0;0;0;0;0;0;0;Lavadora WA90H4400SW/ZS 9Kg Blanca;LINEA BLANCA
6952782;;F;69;CHILENO;;Silencioso;CONCEPCION                    ;BIO BIO;0;0;0;0;0;0;0;0;0;Secadora Ropa MSV-90 9K Blanca Ventilacion;LINEA BLANCA
7598232;;F;67;CHILENO;;Boomers;PROVIDENCIA                   ;METROPOLITANA;0;0;0;0;0;0;0;0;0;CALEFON CALEFON RHEEM TN 10L GL;LINEA BLANCA
18855470;;F;27;CHILENO;;Millenial;N/D;N/D;0;0;0;0;0;0;0;0;0;Lavadora WT19DSBP 19Kg Silver;LINEA BLANCA
17054343;;M;33;CHILENO;;Millenial;"";"";0;0;0;0;0;0;0;0;0;Refrigerador 331Lts No Frost BF RB34T632FSA/ZS;LINEA BLANCA
9175063;;M;61;CHILENO;;Boomers;RENCA                         ;METROPOLITANA;0;0;0;0;0;0;0;0;0;Cocina CMC20AXX 4P Inox;LINEA BLANCA
12067456;;F;58;CHILENO;;Boomers;VINA DEL MAR                  ;VALPARAISO;0;0;0;0;0;0;0;0;0;Refrigerador Altus 1200V 197Lts No Frost;LINEA BLANCA
22693906;;F;48;COLOMBIANO;;Extranjero;EL MONTE                      ;METROPOLITANA;0;0;0;0;0;0;0;0;0;Secadora Ropa Solare 7100 7K Ventilacion;LINEA BLANCA
9789283;;F;57;CHILENO;;Boomers;PROVIDENCIA                   ;METROPOLITANA;0;0;0;0;0;0;0;0;0;Lavadora WA90H4400SW/ZS 9Kg Blanca;LINEA BLANCA
11964415;;F;49;CHILENO;;X;CURANILAHUE                   ;BIO BIO;0;0;0;0;0;0;0;0;0;Cocina MCG-4QI24AME4 4P Inox;LINEA BLANCA
11562603;;M;51;CHILENO;;X;SAN MIGUEL                    ;METROPOLITANA;0;0;0;0;0;0;0;0;0;Secadora Ropa MSV-90 9K Blanca Ventilacion;LINEA BLANCA
17233298;Soltero;M;32;CHILENO;;Millenial;PROVIDENCIA                   ;METROPOLITANA;0;0;0;0;0;0;0;0;0;Refrigerador 322Lts No Frost BF DB60S;LINEA BLANCA
15527536;;F;65;CHILENO;;Boomers;CURICO                        ;MAULE;0;0;0;0;0;0;0;0;0;Lavadora MLS-160BSC03T 16Kg Blanca;LINEA BLANCA
17633747;;F;37;CHILENO;;Millenial;PUERTO MONTT                  ;LOS LAGOS;0;0;0;0;0;0;0;0;0;Secadora Ropa Reverplus 6470 7Kg Gris Ventilacio;LINEA BLANCA
17816459;;M;31;CHILENO;;Millenial;N/D;N/D;0;0;0;0;0;0;0;0;0;Secadora Ropa MSV-90 9K Blanca Ventilacion;LINEA BLANCA
8937506;;F;62;CHILENO;;Boomers;PUNTA ARENAS                  ;MAGALLANES;0;0;0;0;0;0;0;0;0;Lavadora MLS-160BSC03T 16Kg Blanca;LINEA BLANCA
18629190;;F;28;CHILENO;;Millenial;N/D;N/D;0;0;0;0;0;0;0;0;0;Calefon 7Lts GL Master;LINEA BLANCA
16765264;;M;34;CHILENO;;Extranjero;CONCEPCION                    ;BIO BIO;0;0;0;0;0;0;0;0;0;Lavadora WA90H4400SW/ZS 9Kg Blanca;LINEA BLANCA
7605957;;M;67;CHILENO;;Boomers;ARAUCO                        ;BIO BIO;0;0;0;0;0;0;0;0;0;Refrigerador 290Lts BF No Frost RB30N4020S8;LINEA BLANCA
8852203;Casado;F;61;CHILENO;PROFESOR;Boomers;PROVIDENCIA                   ;METROPOLITANA;0;0;0;0;0;0;0;0;0;HORNO EMPOTRABLE 2250W 57LTS HE-7220R NEGRO;LINEA BLANCA
16913521;;M;33;CHILENO;;Millenial;PROVIDENCIA                   ;METROPOLITANA;0;0;0;0;0;0;0;0;0;Secadora 9Kg Solare 9200 Ventilacion;LINEA BLANCA
12353474;Casado;F;53;CHILENO;;X;RENCA                         ;METROPOLITANA;0;0;0;0;0;0;0;0;0;Campana Cocina FXU6160 60CM;LINEA BLANCA
18890738;;F;27;CHILENO;;Z;RENGO                         ;L.G.B.OÂ´HIGGINS;0;0;0;0;0;0;0;0;0;Secadora Ropa MSV-90 9K Blanca Ventilacion;LINEA BLANCA
10743774;Casado;F;55;CHILENO;;Boomers;RENCA                         ;METROPOLITANA;0;0;0;0;0;0;0;0;0;Refrigerador 290Lts BF No Frost RB30N4020S8;LINEA BLANCA
19949168;;F;23;CHILENO;;Z;ILLAPEL;COQUIMBO;0;0;0;0;0;0;0;0;0;ENCIMERA ELECTRICA MEE-4E MADEMSA;LINEA BLANCA
14301874;;M;47;CHILENO;;X;PADRE HURTADO                 ;METROPOLITANA;0;0;0;0;0;0;0;0;0;Refrigerador 300Lts No Frost RT29K500JS8/ZS;LINEA BLANCA
10487358;;F;51;CHILENO;;X;PROVIDENCIA                   ;METROPOLITANA;0;0;0;0;0;0;0;0;0;Refrigerador 260Lts BF Frio Direc MRFI2660SR346W;LINEA BLANCA
9575770;;F;60;CHILENO;;Boomers;MELIPILLA                     ;METROPOLITANA;0;0;0;0;0;0;0;0;0;Lavadora WA15T5260BW/ZS 15Kg Blanca;LINEA BLANCA
19511189;;F;25;CHILENO;;Z;SAN PEDRO DE LA PAZ           ;BIO BIO;0;0;0;0;0;0;0;0;0;ENCIMERA A GAS 4 PLATOS CEG-4600 INOX;LINEA BLANCA
15675533;;F;40;CHILENO;;X;N/D;N/D;0;0;0;0;0;0;0;0;0;Secadora 9Kg Solare 9200 Ventilacion;LINEA BLANCA
17345360;Soltero;F;32;CHILENO;;Silencioso;PROVIDENCIA                   ;METROPOLITANA;0;0;0;0;0;0;0;0;0;Refrigerador 300Lts No Frost RT29K500JS8/ZS;LINEA BLANCA
17871560;;F;31;CHILENO;;Millenial;BUIN;METROPOLITANA;0;0;0;0;0;0;0;0;0;Frigobar LFB-101S 85Lts Inox;LINEA BLANCA
16770997;;F;34;CHILENO;;Millenial;PROVIDENCIA                   ;METROPOLITANA;0;0;0;0;0;0;0;0;0;Cocina CMC20AXX 4P Inox;LINEA BLANCA
24500497;;M;50;HAITIANO;;Extranjero;QUILICURA                     ;METROPOLITANA;0;0;0;0;0;0;0;0;0;Cocina CH-9950NG-1 6P Negro;LINEA BLANCA
10890328;;F;56;CHILENO;;Boomers;PENALOLEN                     ;METROPOLITANA;0;0;0;0;0;0;0;0;0;Lavadora Superior 8 Kg Blanca;LINEA BLANCA
8896098;;M;57;CHILENO;;Boomers;RENCA                         ;METROPOLITANA;0;0;0;0;0;0;0;0;0;Lavadora Brilliant SG 11,5Kg Silver;LINEA BLANCA
9207057;;F;61;CHILENO;;Silencioso;PROVIDENCIA                   ;METROPOLITANA;0;0;0;0;0;0;0;0;0;Secadora LG DF9WPN por condensacion 9K con Smart;LINEA BLANCA
7491901;;M;66;CHILENO;;Boomers;CURICO                        ;MAULE;0;0;0;0;0;0;0;0;0;Secadora Ropa Reverplus 6470 7Kg Gris Ventilacio;LINEA BLANCA
12684993;;F;48;CHILENO;;X;LA GRANJA                     ;METROPOLITANA;0;0;0;0;0;0;0;0;0;Lavadora MLS-090GE04N 9Kg Gris;LINEA BLANCA
7422330;;F;67;CHILENO;;Boomers;VALPARAISO                    ;VALPARAISO;0;0;0;0;0;0;0;0;0;Cocina Andes60TX4 4P Inox;LINEA BLANCA
9558784;;F;65;CHILENO;;Boomers;RENCA                         ;METROPOLITANA;0;0;0;0;0;0;0;0;0;Refrigerador 244Lts Frio Directo Progress 3100;LINEA BLANCA
18967808;;F;26;CHILENO;;Z;MOLINA                        ;MAULE;0;0;0;0;0;0;0;0;0;Lavadora Efficace BZG 15,5Kg Blanca;LINEA BLANCA
15503493;;F;39;CHILENO;;X;N/D;N/D;0;0;0;0;0;0;0;0;0;Lavadora Efficace SZG 19,5Kg Silver;LINEA BLANCA
20331913;;M;22;CHILENO;;Z;PROVIDENCIA                   ;METROPOLITANA;0;0;0;0;0;0;0;0;0;Cocina Andes76HG0 6P Inox;LINEA BLANCA
21106271;;F;29;CHILENO;;Extranjero;PROVIDENCIA                   ;METROPOLITANA;0;0;0;0;0;0;0;0;0;Cocina 775X 4P;LINEA BLANCA
13131656;;M;44;CHILENO;;Silencioso;PROVIDENCIA                   ;METROPOLITANA;0;0;0;0;0;0;0;0;0;Campana Cocina CA-610EBL 60Cms Blanca;LINEA BLANCA
10220645;;M;57;CHILENO;;Boomers;COLINA                        ;METROPOLITANA;0;0;0;0;0;0;0;0;0;Lavadora Efficace SZG 19,5Kg Silver;LINEA BLANCA
17024289;;M;33;CHILENO;;Millenial;PROVIDENCIA                   ;METROPOLITANA;0;0;0;0;0;0;0;0;0;Refrigerador 252Lts No Frost MRFS-2700G333FW;LINEA BLANCA
18273581;;F;29;CHILENO;;Millenial;PROVIDENCIA                   ;METROPOLITANA;0;0;0;0;0;0;0;0;0;Freezer Horizontal M100 99Lts;LINEA BLANCA
6487094;;F;70;CHILENO;;Silencioso;LAS CABRAS                    ;L.G.B.OÂ´HIGGINS;0;0;0;0;0;0;0;0;0;Lavadora MLS-160BSC03T 16Kg Blanca;LINEA BLANCA
10399490;;F;53;CHILENO;;X;BUIN                          ;METROPOLITANA;0;0;0;0;0;0;0;0;0;Producto Segunda Seleccion Banda 2;LINEA BLANCA
16526064;Soltero;F;35;CHILENO;;Millenial;PROVIDENCIA                   ;METROPOLITANA;0;0;0;0;0;0;0;0;0;CALEFON ATMD TIRO NATURAL 7 LT GN ALBIN TROTTER;LINEA BLANCA
8019004;;F;66;CHILENO;;Boomers;PUNTA ARENAS                  ;MAGALLANES;0;0;0;0;0;0;0;0;0;Cocina CH-7400 4P;LINEA BLANCA
18928258;Soltero;F;27;CHILENO;TERAPEUTA OCUPACIONAL;Millenial;PROVIDENCIA                   ;METROPOLITANA;0;0;0;0;0;0;0;0;0;Refrigerador LT39WPP 393Lts No Frost;LINEA BLANCA
20222736;;F;22;CHILENO;;Silencioso;PROVIDENCIA                   ;METROPOLITANA;0;0;0;0;0;0;0;0;0;Secadora Ropa Solare 7100 7K Ventilacion;LINEA BLANCA
17845408;;F;30;CHILENO;;Millenial;TALCAHUANO                    ;BIO BIO;0;0;0;0;0;0;0;0;0;Cocina MV 110 4 Platos;LINEA BLANCA
13232190;;F;45;CHILENO;;X;PROVIDENCIA                   ;METROPOLITANA;0;0;0;0;0;0;0;0;0;REFRIGERADOR SBS RS62R5011M9/ZS 647 LT SAMSUNG;LINEA BLANCA
6266236;;M;72;CHILENO;;Silencioso;CODEGUA                       ;L.G.B.OÂ´HIGGINS;0;0;0;0;0;0;0;0;0;Refrigerador MRFI1800S234RN 180Lts BF Frio Direc;LINEA BLANCA
7338779;;F;68;CHILENO;;Boomers;CHILLAN                       ;BIO BIO;0;0;0;0;0;0;0;0;0;Cocina 785FX 4P;LINEA BLANCA
16549639;;F;35;CHILENO;;Millenial;PROVIDENCIA                   ;METROPOLITANA;0;0;0;0;0;0;0;0;0;Cocina CH-7400 4P;LINEA BLANCA
11710615;;F;51;CHILENO;;X;PUERTO MONTT                  ;LOS LAGOS;0;0;0;0;0;0;0;0;0;Lavadora Efficace BZG 9,5Kg Blanca;LINEA BLANCA
12103007;;M;51;CHILENO;;X;CHANARAL                      ;ATACAMA;0;0;0;0;0;0;0;0;0;Refrigerador LRT-200DFI 168Lts Frio Directo;LINEA BLANCA
16846058;Soltero;M;34;CHILENO;ABOGADO;Millenial;PROVIDENCIA                   ;METROPOLITANA;0;0;0;0;0;0;0;0;0;SECADORA SR-10 8KG GRIS SINDELEN;LINEA BLANCA
16304512;;M;36;CHILENO;;Silencioso;PROVIDENCIA                   ;METROPOLITANA;0;0;0;0;0;0;0;0;0;Cocina F-2608 4P Inox;LINEA BLANCA
6072291;;F;75;CHILENO;;Silencioso;PUERTO MONTT                  ;LOS LAGOS;0;0;0;0;0;0;0;0;0;Cocina Andes60TX4 4P Inox;LINEA BLANCA
16511360;;F;35;CHILENO;;Millenial;PROVIDENCIA                   ;METROPOLITANA;0;0;0;0;0;0;0;0;0;Lavadora MLS-160BSC03T 16Kg Blanca;LINEA BLANCA
9199278;;F;56;CHILENO;;Boomers;PROVIDENCIA                   ;METROPOLITANA;0;0;0;0;0;0;0;0;0;Refrigerador LB37SPGK 336Lts Dispensador No Fros;LINEA BLANCA
10263991;;M;56;CHILENO;;Boomers;FREIRINA                      ;ATACAMA;0;0;0;0;0;0;0;0;0;Lavadora MLS-160BSC03T 16Kg Blanca;LINEA BLANCA
15129297;;F;40;CHILENO;;X;CURICO                        ;MAULE;0;0;0;0;0;0;0;0;0;Cocina CMC20AXX 4P Inox;LINEA BLANCA
16469346;Casado;F;35;CHILENO;KINESIOLOGA;Silencioso;PROVIDENCIA                   ;METROPOLITANA;0;0;0;0;0;0;0;0;0;ENCIMERA QUADRA 75 GL 5P ALBIN TROTTER;LINEA BLANCA
18777540;;F;28;CHILENO;;Millenial;MELIPILLA                     ;METROPOLITANA;0;0;0;0;0;0;0;0;0;Lavadora MLS-140GSC03T 14Kg Gris;LINEA BLANCA
15312228;Soltero;M;40;CHILENO;INGENIERO EN ADMINISTRACION DE EMPRESAS;X;PROVIDENCIA                   ;METROPOLITANA;0;0;0;0;0;0;0;0;0;Refrigerador 626Lt Side by Side GS65MPP1 APZPECL;LINEA BLANCA
14356748;;M;43;CHILENO;;X;MALLOA                        ;L.G.B.OÂ´HIGGINS;0;0;0;0;0;0;0;0;0;Lavadora MLS-160BSC03T 16Kg Blanca;LINEA BLANCA
17931176;;M;31;CHILENO;;Millenial;TALCA                         ;MAULE;0;0;0;0;0;0;0;0;0;Freezer Horizontal M 150 142Lts;LINEA BLANCA
13150319;;F;44;CHILENO;;X;CANETE                        ;BIO BIO;0;0;0;0;0;0;0;0;0;Lavadora Efficace SZG 19,5Kg Silver;LINEA BLANCA
11240043;;F;54;CHILENO;;Silencioso;PROVIDENCIA                   ;METROPOLITANA;0;0;0;0;0;0;0;0;0;Lavadora/Centrifuga LC4550 4,5Kg Blanca;LINEA BLANCA
13529971;;M;43;CHILENO;;X;LA SERENA                     ;COQUIMBO;0;0;0;0;0;0;0;0;0;Refrigerador 535Lts Side by Side RS54N3003SL/ZS;LINEA BLANCA
10934274;;F;54;CHILENO;;X;ALTO HOSPICIO;TARAPACA;0;0;0;0;0;0;0;0;0;Refrigerador 290LTS No Frost RMB302PXLRS0;LINEA BLANCA
13255291;;F;45;CHILENO;;X;N/D;N/D;0;0;0;0;0;0;0;0;0;Secadora Ropa MSV-90 9K Blanca Ventilacion;LINEA BLANCA
9675136;;F;59;CHILENO;;Boomers;RENCA                         ;METROPOLITANA;0;0;0;0;0;0;0;0;0;Lavadora LMA0920WGCL0 9,5Kg Gris;LINEA BLANCA
8396762;;M;58;CHILENO;;Silencioso;PENALOLEN                     ;METROPOLITANA;0;0;0;0;0;0;0;0;0;Refrigerador 244Lts Frio Directo Progress 3100;LINEA BLANCA
9516389;;F;61;CHILENO;;Boomers;PROVIDENCIA                   ;METROPOLITANA;0;0;0;0;0;0;0;0;0;Cocina CH-9600RJ 4P;LINEA BLANCA
18296666;;F;29;CHILENO;;Millenial;CHIMBARONGO                   ;L.G.B.OÂ´HIGGINS;0;0;0;0;0;0;0;0;0;HORNO EMPOTRABLE 2250W 57LTS HE-7220R NEGRO;LINEA BLANCA
12137823;;F;59;CHILENO;;Boomers;SAN JOSE DE MAIPO             ;METROPOLITANA;0;0;0;0;0;0;0;0;0;Freezer 142Lts EFC14A5MNW Horizontal;LINEA BLANCA
11833836;Casado;F;51;CHILENO;PERIODISTA;Silencioso;PROVIDENCIA                   ;METROPOLITANA;0;0;0;0;0;0;0;0;0;Lavadora WT16DSBP 16Kg Silver;LINEA BLANCA
8749336;;F;62;CHILENO;;Boomers;LOS ANGELES                   ;BIO BIO;0;0;0;0;0;0;0;0;0;Refrigerador 244Lts Frio Directo Progress 3100;LINEA BLANCA
18838011;Soltero;F;27;CHILENO;;Millenial;PROVIDENCIA                   ;METROPOLITANA;0;0;0;0;0;0;0;0;0;Lavadora LMA0920WGCL0 9,5Kg Gris;LINEA BLANCA
18612149;Soltero;F;28;CHILENO;ENFERMERA;Millenial;PROVIDENCIA                   ;METROPOLITANA;0;0;0;0;0;0;0;0;0;Refrigerador RDNF-2570IN 255Lts No Frost;LINEA BLANCA
7494879;;M;66;CHILENO;;Boomers;PROVIDENCIA                   ;METROPOLITANA;0;0;0;0;0;0;0;0;0;Freezer Horizontal M100 99Lts;LINEA BLANCA
10150992;;F;57;CHILENO;;Boomers;PROVIDENCIA                   ;METROPOLITANA;0;0;0;0;0;0;0;0;0;Freezer Vertical SFV-100 SILVER 100Lts;LINEA BLANCA
13206603;;F;45;CHILENO;;X;CERRO NAVIA                   ;METROPOLITANA;0;0;0;0;0;0;0;0;0;Lavadora MLS-160BSC03T 16Kg Blanca;LINEA BLANCA
17679818;Soltero;M;30;CHILENO;;Millenial;PROVIDENCIA                   ;METROPOLITANA;0;0;0;0;0;0;0;0;0;Lavadora Efficace BZG 9,5Kg Blanca;LINEA BLANCA
16357952;;F;38;CHILENO;;Silencioso;PROVIDENCIA                   ;METROPOLITANA;0;0;0;0;0;0;0;0;0;Cocina MV 110 4 Platos;LINEA BLANCA
10439649;;M;56;CHILENO;;Boomers;LA PINTANA                    ;METROPOLITANA;0;0;0;0;0;0;0;0;0;Lavadora Efficace SZG 17,5Kg Silver;LINEA BLANCA
13316604;;F;45;CHILENO;;X;TEMUCO                        ;ARAUCANIA;0;0;0;0;0;0;0;0;0;Lavadora Efficace BZG 9,5Kg Blanca;LINEA BLANCA
18504713;;F;28;CHILENO;;Millenial;LIMACHE                       ;VALPARAISO;0;0;0;0;0;0;0;0;0;Refrigerador 527Lts Side by Side MRSBS5300G689WE;LINEA BLANCA
7869902;;M;66;CHILENO;;Boomers;PROVIDENCIA                   ;METROPOLITANA;0;0;0;0;0;0;0;0;0;Freezer FDHM200BY1 200Lts Horizontal;LINEA BLANCA
20020403;;F;23;CHILENO;;Silencioso;PROVIDENCIA                   ;METROPOLITANA;0;0;0;0;0;0;0;0;0;ENCIMERA A GAS 4 PLATOS CEG-4600 INOX;LINEA BLANCA
8086430;;F;56;CHILENO;;Boomers;VILLA ALEMANA                 ;VALPARAISO;0;0;0;0;0;0;0;0;0;Refrigerador 254Lts No Frost GT29WPPDC;LINEA BLANCA
15844344;;F;37;CHILENO;;Silencioso;PROVIDENCIA                   ;METROPOLITANA;0;0;0;0;0;0;0;0;0;Freezaer Vertical MFV 545B 165Lts;LINEA BLANCA
10363571;Casado;M;54;CHILENO;PROFESOR;X;PROVIDENCIA                   ;METROPOLITANA;0;0;0;0;0;0;0;0;0;Refrigerador RMN222PXLRS0 222LTS No Frost;LINEA BLANCA
9095177;;F;60;CHILENO;;Boomers;SANTIAGO                      ;METROPOLITANA;0;0;0;0;0;0;0;0;0;Lavadora MLS-090GE04N 9Kg Gris;LINEA BLANCA
5952719;;M;73;CHILENO;;Silencioso;HUALPEN;BIO BIO;0;0;0;0;0;0;0;0;0;Lavadora MLS-160BSC03T 16Kg Blanca;LINEA BLANCA
9287543;Casado;M;57;CHILENO;;Boomers;RENCA                         ;METROPOLITANA;0;0;0;0;0;0;0;0;0;Refrigerador 251Lts No Frost Altus 1250;LINEA BLANCA
15511725;Soltero;F;43;CHILENO;;X;PANGUIPULLI                   ;LOS LAGOS;0;0;0;0;0;0;0;0;0;Refrigerador 400Lts No Frost RMP400FZUC Dispen;LINEA BLANCA
19303136;;F;25;CHILENO;;Z;PROVIDENCIA                   ;METROPOLITANA;0;0;0;0;0;0;0;0;0;Refrigerador 251Lts No Frost Altus 1250;LINEA BLANCA
19553390;;F;25;CHILENO;;Z;PROVIDENCIA                   ;METROPOLITANA;0;0;0;0;0;0;0;0;0;ENCIMERA A GAS 4 PLATOS CEG-4600 INOX;LINEA BLANCA
7080532;;F;68;CHILENO;;Boomers;QUINTERO                      ;VALPARAISO;0;0;0;0;0;0;0;0;0;Centrifuga Primma 5B 5,5Kilos;LINEA BLANCA
6533559;;F;73;CHILENO;;Silencioso;PROVIDENCIA                   ;METROPOLITANA;0;0;0;0;0;0;0;0;0;Lavadora Frontal Premium Care 11W 11Kg Blanca;LINEA BLANCA
11348334;;F;54;CHILENO;;Millenial;PROVIDENCIA                   ;METROPOLITANA;0;0;0;0;0;0;0;0;0;Cava de vino Winecool12 12Botellas;LINEA BLANCA
9933419;;M;56;CHILENO;;Boomers;PROVIDENCIA                   ;METROPOLITANA;0;0;0;0;0;0;0;0;0;Refrigerador 260Lts BF Frio Direc MRFI2660SR346W;LINEA BLANCA
10675234;;M;54;CHILENO;;Boomers;PUENTE ALTO                   ;METROPOLITANA;0;0;0;0;0;0;0;0;0;Lavadora MLS-090GE04N 9Kg Gris;LINEA BLANCA
15813948;Soltero;F;37;CHILENO;INGENIERO METALURGICO;Millenial;PROVIDENCIA                   ;METROPOLITANA;0;0;0;0;0;0;0;0;0;Cocina CMC20AXX 4P Inox;LINEA BLANCA
6196988;Casado;F;70;CHILENO;;Silencioso;LO ESPEJO                     ;METROPOLITANA;0;0;0;0;0;0;0;0;0;Lavadora Semiautomatica Twister 5100 4Kg;LINEA BLANCA
13761543;;M;42;CHILENO;;X;N/D;N/D;0;0;0;0;0;0;0;0;0;Refrigerador 260Lts BF Frio Direc MRFI2660SR346W;LINEA BLANCA
8518224;;F;48;CHILENO;;X;SAN RAMON                     ;METROPOLITANA;0;0;0;0;0;0;0;0;0;Lavadora LMA0920WGCL0 9,5Kg Gris;LINEA BLANCA
18754121;;M;27;CHILENO;;Millenial;VILCUN                        ;ARAUCANIA;0;0;0;0;0;0;0;0;0;Refrigerador 322Lts No Frost BF DB60S;LINEA BLANCA
9745947;Casado;M;64;CHILENO;AGRONOMO;Boomers;PROVIDENCIA                   ;METROPOLITANA;0;0;0;0;0;0;0;0;0;Lavadora WA90H4400SW/ZS 9Kg Blanca;LINEA BLANCA
16559425;Soltero;M;35;CHILENO;;Millenial;COPIAPO                       ;ATACAMA;0;0;0;0;0;0;0;0;0;Lavadora WA17T6260BW/ZS 17Kg Blanca;LINEA BLANCA
8638542;;M;64;CHILENO;;Boomers;MELIPILLA                     ;METROPOLITANA;0;0;0;0;0;0;0;0;0;Refrigerador 322Lts No Frost BF DB60S;LINEA BLANCA
26003805;;M;57;CHILENO;;Extranjero;INDEPENDENCIA                 ;METROPOLITANA;0;0;0;0;0;0;0;0;0;Cocina Andes60TX4 4P Inox;LINEA BLANCA
11980727;;F;49;CHILENO;;X;PROVIDENCIA                   ;METROPOLITANA;0;0;0;0;0;0;0;0;0;Lavadora WA13T5260BW/ZS 13Kg Blanca;LINEA BLANCA
15096021;;F;40;CHILENO;;X;RENCA                         ;METROPOLITANA;0;0;0;0;0;0;0;0;0;Lavadora Semiautomatica LS-6100 6Kg Gris;LINEA BLANCA
12225283;;F;50;CHILENO;;X;PROVIDENCIA                   ;METROPOLITANA;0;0;0;0;0;0;0;0;0;Lavadora WA80H4200SW/ZS 8Kg Blanca;LINEA BLANCA
7640931;;M;66;CHILENO;;Boomers;PUNTA ARENAS                  ;MAGALLANES;0;0;0;0;0;0;0;0;0;Cocina F-2808 4P;LINEA BLANCA
10133193;;M;57;CHILENO;;Boomers;SAN CARLOS                    ;BIO BIO;0;0;0;0;0;0;0;0;0;Lavadora WA80H4200SW/ZS 8Kg Blanca;LINEA BLANCA
5832346;;F;77;CHILENO;;Silencioso;PROVIDENCIA                   ;METROPOLITANA;0;0;0;0;0;0;0;0;0;Cocina F-5500 Premium 5P;LINEA BLANCA
5419757;;F;82;CHILENO;;Silencioso;PROVIDENCIA                   ;METROPOLITANA;0;0;0;0;0;0;0;0;0;Lavadora Efficace SZG 17,5Kg Silver;LINEA BLANCA
19633366;;F;25;CHILENO;;Z;PROVIDENCIA                   ;METROPOLITANA;0;0;0;0;0;0;0;0;0;Cocina CH-9400 4P SILVER;LINEA BLANCA
9838367;;F;57;CHILENO;;Boomers;TENO                          ;MAULE;0;0;0;0;0;0;0;0;0;Lavadora WA80H4200SW/ZS 8Kg Blanca;LINEA BLANCA
14329007;;F;45;CHILENO;;X;LAS CABRAS                    ;L.G.B.OÂ´HIGGINS;0;0;0;0;0;0;0;0;0;Lavadora MLS-160BSC03T 16Kg Blanca;LINEA BLANCA
11847511;Soltero;M;50;CHILENO;TECNICO MECANICO;Silencioso;PROVIDENCIA                   ;METROPOLITANA;0;0;0;0;0;0;0;0;0;Refrigerador 535Lts Side by Side RS54N3003SL/ZS;LINEA BLANCA
10207744;;M;58;CHILENO;;Boomers;PROVIDENCIA                   ;METROPOLITANA;0;0;0;0;0;0;0;0;0;Lavadora LMA0920WGCL0 9,5Kg Gris;LINEA BLANCA
18358747;Soltero;M;29;CHILENO;;Silencioso;PROVIDENCIA                   ;METROPOLITANA;0;0;0;0;0;0;0;0;0;Lavadora Semiautomatica LS-6100 6Kg Gris;LINEA BLANCA
9686815;;M;57;CHILENO;;Boomers;RENCA                         ;METROPOLITANA;0;0;0;0;0;0;0;0;0;Lavadora WA90H4400SW/ZS 9Kg Blanca;LINEA BLANCA
12035866;;F;54;CHILENO;;X;SAN BERNARDO                  ;METROPOLITANA;0;0;0;0;0;0;0;0;0;Refrigerador 249Lts No Frost RMA250PHUG;LINEA BLANCA
23445367;;F;31;PERUANO;;Extranjero;RECOLETA                      ;METROPOLITANA;0;0;0;0;0;0;0;0;0;COCINA 76GS 5P Glass Negro;LINEA BLANCA
6206867;Casado;F;75;CHILENO;;Silencioso;RENCA                         ;METROPOLITANA;0;0;0;0;0;0;0;0;0;Refrigerador 249Lts No Frost RMA250PHUG;LINEA BLANCA
18331354;Soltero;F;28;CHILENO;;Millenial;PROVIDENCIA                   ;METROPOLITANA;0;0;0;0;0;0;0;0;0;Refrigerador 322Lts No Frost BF DB60S;LINEA BLANCA
7468746;;M;68;CHILENO;;Boomers;TALCA                         ;MAULE;0;0;0;0;0;0;0;0;0;Lavadora WA15T5260BW/ZS 15Kg Blanca;LINEA BLANCA
12171840;;F;50;CHILENO;;X;VALLENAR;ATACAMA;0;0;0;0;0;0;0;0;0;Lavadora Efficace SZG 17,5Kg Silver;LINEA BLANCA
12652499;;M;48;CHILENO;;X;PROVIDENCIA                   ;METROPOLITANA;0;0;0;0;0;0;0;0;0;Calefon Neckar 10 litros GL;LINEA BLANCA
10712118;;F;55;CHILENO;;Boomers;LONGAVI                       ;MAULE;0;0;0;0;0;0;0;0;0;Refrigerador RT25FARADSP/ZS 260Lts No Frost;LINEA BLANCA
5476335;Soltero;M;75;CHILENO;;Silencioso;ALGARROBO                     ;VALPARAISO;0;0;0;0;0;0;0;0;0;Refrigerador 322Lts No Frost BF DB60S;LINEA BLANCA
16708142;;M;34;CHILENO;;Millenial;RENCA                         ;METROPOLITANA;0;0;0;0;0;0;0;0;0;FRIGOBAR 93 LTS MFB-930S121LN;LINEA BLANCA
10642760;;M;56;CHILENO;;Boomers;TALCA                         ;MAULE;0;0;0;0;0;0;0;0;0;Cocina 785FX 4P;LINEA BLANCA
18665917;Soltero;F;28;CHILENO;KINESIOLOGO;Millenial;PROVIDENCIA                   ;METROPOLITANA;0;0;0;0;0;0;0;0;0;FRIGOBAR 93 LTS MFB-930S121LN;LINEA BLANCA
11396094;;F;52;CHILENO;;X;PENALOLEN                     ;METROPOLITANA;0;0;0;0;0;0;0;0;0;Lavadora WA90H4400SW/ZS 9Kg Blanca;LINEA BLANCA
8450612;;F;67;CHILENO;;Boomers;LEBU                          ;BIO BIO;0;0;0;0;0;0;0;0;0;Cocina 775X 4P;LINEA BLANCA
16936070;Soltero;M;34;CHILENO;INGENIERO COMERCIAL;Millenial;PROVIDENCIA                   ;METROPOLITANA;0;0;0;0;0;0;0;0;0;Refrigerador 290LTS No Frost RMB302PXLRS0;LINEA BLANCA
8609910;;F;64;CHILENO;;Boomers;RENCA                         ;METROPOLITANA;0;0;0;0;0;0;0;0;0;Campana Cocina FXU6160 60CM;LINEA BLANCA
17678350;;F;31;CHILENO;;Millenial;N/D;N/D;0;0;0;0;0;0;0;0;0;Freezer 142Lts MFH-1430B186C Horizontal;LINEA BLANCA
5062838;Viudo;F;74;CHILENO;;Silencioso;SAN VICENTE                   ;L.G.B.OÂ´HIGGINS;0;0;0;0;0;0;0;0;0;Refrigerador 290Lts BF No Frost RB30N4020S8;LINEA BLANCA
9529365;;F;58;CHILENO;;Boomers;MAIPU                         ;METROPOLITANA;0;0;0;0;0;0;0;0;0;Lavadora MLS-090GE04N 9Kg Gris;LINEA BLANCA
6040378;Casado;M;70;CHILENO;;Silencioso;CASABLANCA                    ;VALPARAISO;0;0;0;0;0;0;0;0;0;Cocina F-5500 Premium 5P;LINEA BLANCA
11530530;;M;51;CHILENO;;X;PROVIDENCIA                   ;METROPOLITANA;0;0;0;0;0;0;0;0;0;LAVAVAJILLAS ACQUARELLE 920B MADEMSA;LINEA BLANCA
18847357;;M;28;CHILENO;;Millenial;RENCA                         ;METROPOLITANA;0;0;0;0;0;0;0;0;0;Cocina CH-9950NG-1 6P Negro;LINEA BLANCA
8953735;;F;63;CHILENO;;Boomers;RENCA                         ;METROPOLITANA;0;0;0;0;0;0;0;0;0;Refrigerador RMN222PXLRS0 222LTS No Frost;LINEA BLANCA
7527574;Soltero;M;68;CHILENO;AGRONOMO;Boomers;NUEVA IMPERIAL                ;ARAUCANIA;0;0;0;0;0;0;0;0;0;FREEZER SFH-150 14OL BLANCO SINDELEN;LINEA BLANCA
10989440;;M;48;CHILENO;;X;PROVIDENCIA                   ;METROPOLITANA;0;0;0;0;0;0;0;0;0;Cocina Nova CH9850NG 6P;LINEA BLANCA
13977283;;M;41;CHILENO;;X;RENCA                         ;METROPOLITANA;0;0;0;0;0;0;0;0;0;Calefon 5Lts GL Master;LINEA BLANCA
11059040;;F;56;CHILENO;;Boomers;RANCAGUA                      ;L.G.B.OÂ´HIGGINS;0;0;0;0;0;0;0;0;0;Cocina CMC20AXX 4P Inox;LINEA BLANCA
19431407;;F;25;CHILENO;;Z;PROVIDENCIA                   ;METROPOLITANA;0;0;0;0;0;0;0;0;0;FRIGOBAR 93 LTS MFB-930S121LN;LINEA BLANCA
12915303;;F;47;CHILENO;;X;PICHIDEGUA                    ;L.G.B.OÂ´HIGGINS;0;0;0;0;0;0;0;0;0;Lavadora WA17T6260BW/ZS 17Kg Blanca;LINEA BLANCA
7797616;Viudo;M;65;CHILENO;;Boomers;PROVIDENCIA                   ;METROPOLITANA;0;0;0;0;0;0;0;0;0;Cocina CH-7400 4P;LINEA BLANCA
10153569;;M;58;CHILENO;;Boomers;CERRO NAVIA                   ;METROPOLITANA;0;0;0;0;0;0;0;0;0;Freezer FDHM200BY1 200Lts Horizontal;LINEA BLANCA
10266461;;M;55;CHILENO;;X;RENCA                         ;METROPOLITANA;0;0;0;0;0;0;0;0;0;Refrigerador 249Lts No Frost RMA250PHUG;LINEA BLANCA
9990590;;F;59;CHILENO;;Boomers;PENALOLEN;METROPOLITANA;0;0;0;0;0;0;0;0;0;Freezer 142Lts MFH-1430B186C Horizontal;LINEA BLANCA
10169402;;F;61;CHILENO;;Boomers;PROVIDENCIA                   ;METROPOLITANA;0;0;0;0;0;0;0;0;0;Refrigerador 252Lts No Frost MRFS-2700G333FW;LINEA BLANCA
18681738;Soltero;F;28;CHILENO;;Millenial;PROVIDENCIA                   ;METROPOLITANA;0;0;0;0;0;0;0;0;0;Cocina CH-9050SI 4P;LINEA BLANCA
11572768;;F;51;CHILENO;;X;PROVIDENCIA                   ;METROPOLITANA;0;0;0;0;0;0;0;0;0;Refrigerador 303Lts BF Frio Directo Nordik 480;LINEA BLANCA
16846244;;F;34;CHILENO;;Millenial;SAN VICENTE                   ;L.G.B.OÂ´HIGGINS;0;0;0;0;0;0;0;0;0;Freezer 99Lts MFH-1000B131CN Horizontal;LINEA BLANCA
9701183;;F;56;CHILENO;;Boomers;RENCA                         ;METROPOLITANA;0;0;0;0;0;0;0;0;0;Lavadora Semiautomatica Twister 5100 4Kg;LINEA BLANCA
18486827;Soltero;F;29;CHILENO;;Millenial;PROVIDENCIA                   ;METROPOLITANA;0;0;0;0;0;0;0;0;0;Freezer FDHM150BY1 150Lts Horizontal;LINEA BLANCA
6588822;Viudo;F;68;CHILENO;;Silencioso;PROVIDENCIA                   ;METROPOLITANA;0;0;0;0;0;0;0;0;0;Lavadora Efficace SZG 17,5Kg Silver;LINEA BLANCA
18312650;Soltero;F;29;CHILENO;;Millenial;PROVIDENCIA                   ;METROPOLITANA;0;0;0;0;0;0;0;0;0;Refrigerador DW44S 400Lts Dispen No Frost;LINEA BLANCA
12746833;;F;47;CHILENO;;X;RENCA                         ;METROPOLITANA;0;0;0;0;0;0;0;0;0;Lavadora Efficace SZG 15,5Kg Silver;LINEA BLANCA
8517669;;M;64;CHILENO;;Boomers;PUENTE ALTO                   ;METROPOLITANA;0;0;0;0;0;0;0;0;0;Lavadora Efficace SZG 17,5Kg Silver;LINEA BLANCA
6338543;Casado;F;73;CHILENO;;Silencioso;SAN BERNARDO                  ;METROPOLITANA;0;0;0;0;0;0;0;0;0;Cocina MCG-5QI30AME5 5P Inox;LINEA BLANCA
15742742;;M;38;CHILENO;;X;SAN MIGUEL                    ;METROPOLITANA;0;0;0;0;0;0;0;0;0;Encimera CE2-435I 2P Inox;LINEA BLANCA
25573345;;M;34;HAITIANO;;Extranjero;QUILICURA                     ;METROPOLITANA;0;0;0;0;0;0;0;0;0;Refrigerador 244Lts Frio Directo Progress 3100;LINEA BLANCA
12013704;;M;53;CHILENO;;X;ANTOFAGASTA                   ;ANTOFAGASTA;0;0;0;0;0;0;0;0;0;Freezer Horizontal M100 99Lts;LINEA BLANCA
5814118;;F;72;CHILENO;;Silencioso;RENCA                         ;METROPOLITANA;0;0;0;0;0;0;0;0;0;Refrigerador 252Lts No Frost MRFS-2700G333FW;LINEA BLANCA
9726112;;M;57;CHILENO;;Boomers;SAN ANTONIO                   ;VALPARAISO;0;0;0;0;0;0;0;0;0;Cocina CH-7400 4P;LINEA BLANCA
9275720;;F;62;CHILENO;;Boomers;RENCA                         ;METROPOLITANA;0;0;0;0;0;0;0;0;0;Lavadora Efficace BZG 9,5Kg Blanca;LINEA BLANCA
8163937;Soltero;M;65;CHILENO;;Boomers;LOS ANGELES                   ;BIO BIO;0;0;0;0;0;0;0;0;0;Lavadora Efficace BZG 9,5Kg Blanca;LINEA BLANCA
17163303;Soltero;M;33;CHILENO;;Millenial;VINA DEL MAR                  ;VALPARAISO;0;0;0;0;0;0;0;0;0;Cocina MCG-5QI30AME5 5P Inox;LINEA BLANCA
8689564;;M;59;CHILENO;;Boomers;CALAMA                        ;ANTOFAGASTA;0;0;0;0;0;0;0;0;0;Refrigerador MBF60X 322Lts BF No Frost;LINEA BLANCA
19874739;;F;24;CHILENO;;Millenial;"";"";0;0;0;0;0;0;0;0;0;Lavadora MLS-090GE04N 9Kg Gris;LINEA BLANCA
8054531;Casado;F;68;CHILENO;;Boomers;RENCA                         ;METROPOLITANA;0;0;0;0;0;0;0;0;0;Lavadora Efficace SZG 19,5Kg Silver;LINEA BLANCA
12981702;;F;46;CHILENO;;X;LOS ANGELES                   ;BIO BIO;0;0;0;0;0;0;0;0;0;Cocina Andes7650FX 5P Inox;LINEA BLANCA
8142817;;F;66;CHILENO;;Boomers;PROVIDENCIA                   ;METROPOLITANA;0;0;0;0;0;0;0;0;0;Cocina Diva 920 5P;LINEA BLANCA
19185858;Soltero;F;26;CHILENO;;Z;N/D;N/D;0;0;0;0;0;0;0;0;0;Lavadora Efficace BZG 9,5Kg Blanca;LINEA BLANCA
15404487;;F;36;CHILENO;;Millenial;PROVIDENCIA                   ;METROPOLITANA;0;0;0;0;0;0;0;0;0;Cocina 56DXQ 4P Doble Horno;LINEA BLANCA
17112074;;F;33;CHILENO;;Millenial;PROVIDENCIA                   ;METROPOLITANA;0;0;0;0;0;0;0;0;0;Cocina Diva 920 5P;LINEA BLANCA
18073023;;M;42;CHILENO;;X;SAN BERNARDO                  ;METROPOLITANA;0;0;0;0;0;0;0;0;0;Refrigerador 527Lts Side by Side MRSBS5300G689WE;LINEA BLANCA
12333616;;F;49;CHILENO;;X;PROVIDENCIA                   ;METROPOLITANA;0;0;0;0;0;0;0;0;0;Freezer 99Lts MFH-1000B131CN Horizontal;LINEA BLANCA
12727520;;M;47;CHILENO;;X;PROVIDENCIA                   ;METROPOLITANA;0;0;0;0;0;0;0;0;0;Cocina Diva 820 6P;LINEA BLANCA
16708210;Casado;F;35;CHILENO;;Millenial;PROVIDENCIA                   ;METROPOLITANA;0;0;0;0;0;0;0;0;0;Refrigerador MBF60X 322Lts BF No Frost;LINEA BLANCA
15529209;;F;38;CHILENO;;X;PROVIDENCIA                   ;METROPOLITANA;0;0;0;0;0;0;0;0;0;Cocina F-2525 4P;LINEA BLANCA
14207958;;F;40;CHILENO;;X;PROVIDENCIA                   ;METROPOLITANA;0;0;0;0;0;0;0;0;0;Cocina Diva 920 5P;LINEA BLANCA
14688235;;F;50;PERUANO;;Extranjero;IQUIQUE                       ;TARAPACA;0;0;0;0;0;0;0;0;0;Refrigerador 244Lts Frio Directo Progress 3100;LINEA BLANCA
12478533;;F;55;CHILENO;;Boomers;RENCA                         ;METROPOLITANA;0;0;0;0;0;0;0;0;0;Lavadora Efficace BZG 9,5Kg Blanca;LINEA BLANCA
14419986;;M;48;CHILENO;;X;LOS ANDES                     ;VALPARAISO;0;0;0;0;0;0;0;0;0;Lavadora Efficace SZG 17,5Kg Silver;LINEA BLANCA
5347424;;F;74;CHILENO;;Silencioso;MELIPILLA                     ;METROPOLITANA;0;0;0;0;0;0;0;0;0;Refrigerador 244Lts Frio Directo Progress 3100;LINEA BLANCA
5973512;;M;71;CHILENO;;Silencioso;RENCA                         ;METROPOLITANA;0;0;0;0;0;0;0;0;0;Cocina F-5500 Premium 5P;LINEA BLANCA
7589647;;M;66;CHILENO;;Boomers;SALAMANCA                     ;COQUIMBO;0;0;0;0;0;0;0;0;0;Lavadora WA90H4400SW/ZS 9Kg Blanca;LINEA BLANCA
17692637;;M;31;CHILENO;;Millenial;PROVIDENCIA                   ;METROPOLITANA;0;0;0;0;0;0;0;0;0;Lavadora WT9WPB2 9K Blanca;LINEA BLANCA
17169103;;M;33;CHILENO;;Millenial;PROVIDENCIA                   ;METROPOLITANA;0;0;0;0;0;0;0;0;0;Cocina CH-6900IN 4P;LINEA BLANCA
8580098;;M;66;CHILENO;;Boomers;SAN FERNANDO                  ;L.G.B.OÂ´HIGGINS;0;0;0;0;0;0;0;0;0;Refrigerador 525Lts Side by Side SFX500;LINEA BLANCA
17555997;;M;30;CHILENO;;Millenial;TOCOPILLA                     ;ANTOFAGASTA;0;0;0;0;0;0;0;0;0;Cocina 775X 4P;LINEA BLANCA
6840120;;F;77;CHILENO;;Silencioso;PROVIDENCIA                   ;METROPOLITANA;0;0;0;0;0;0;0;0;0;Lavadora MLS-090GE04N 9Kg Gris;LINEA BLANCA
15395503;;F;52;CHILENO;;X;TALCA                         ;MAULE;0;0;0;0;0;0;0;0;0;Lavadora Efficace SZG 15,5Kg Silver;LINEA BLANCA
9117656;;M;60;CHILENO;;Boomers;CALAMA                        ;ANTOFAGASTA;0;0;0;0;0;0;0;0;0;Lavadora Efficace SZG 15,5Kg Silver;LINEA BLANCA
13416143;;F;43;CHILENO;;X;PROVIDENCIA                   ;METROPOLITANA;0;0;0;0;0;0;0;0;0;Lavadora MLS-140GSC03T 14Kg Gris;LINEA BLANCA
10490343;;M;49;CHILENO;;X;LA GRANJA                     ;METROPOLITANA;0;0;0;0;0;0;0;0;0;Lavadora LMA6120WGCL0 16Kg Gris;LINEA BLANCA
13343587;;F;44;CHILENO;;X;"";"";0;0;0;0;0;0;0;0;0;HORNO EMPOTRABLE HE-7200 INOX 2250W 57L SINDELEN;LINEA BLANCA
14407460;;F;48;CHILENO;;X;RENCA                         ;METROPOLITANA;0;0;0;0;0;0;0;0;0;Freezer 99Lts MFH-1000B131CN Horizontal;LINEA BLANCA
4364977;;M;80;CHILENO;;Silencioso;RENCA                         ;METROPOLITANA;0;0;0;0;0;0;0;0;0;Freezer Horizontal M100 99Lts;LINEA BLANCA
6477372;Casado;M;72;CHILENO;;Silencioso;CONCEPCION                    ;BIO BIO;0;0;0;0;0;0;0;0;0;Cocina 775X 4P;LINEA BLANCA
16404934;;F;35;CHILENO;;Millenial;SAN PEDRO DE LA PAZ           ;BIO BIO;0;0;0;0;0;0;0;0;0;Cocina F-2525 4P;LINEA BLANCA
7508389;;F;67;CHILENO;;Boomers;CHILLAN                       ;BIO BIO;0;0;0;0;0;0;0;0;0;Lavadora Efficace SZG 15,5Kg Silver;LINEA BLANCA
5736015;;F;72;CHILENO;;Silencioso;QUILLOTA                      ;VALPARAISO;0;0;0;0;0;0;0;0;0;Cocina MV 110 4 Platos;LINEA BLANCA
14627894;;M;42;CHILENO;;X;CURICO                        ;MAULE;0;0;0;0;0;0;0;0;0;Lavadora Semiautomatica Twister 5300 4Kg;LINEA BLANCA
14145762;;M;41;CHILENO;;X;RECOLETA                      ;METROPOLITANA;0;0;0;0;0;0;0;0;0;Campana Cocina CA-610EBL 60Cms Blanca;LINEA BLANCA
19366218;;F;26;CHILENO;;Z;PROVIDENCIA                   ;METROPOLITANA;0;0;0;0;0;0;0;0;0;Freezer 142Lts MFH-1430B186C Horizontal;LINEA BLANCA
16429043;Divorciado;M;35;CHILENO;;Millenial;PROVIDENCIA                   ;METROPOLITANA;0;0;0;0;0;0;0;0;0;Lavadora WT16DSBP 16Kg Silver;LINEA BLANCA
14566247;;F;43;CHILENO;;X;COLINA                        ;METROPOLITANA;0;0;0;0;0;0;0;0;0;Refrigerador 400Lts No Frost RMP400FHUG;LINEA BLANCA
26424838;;M;42;VENEZOLANO;;Extranjero;N/D;N/D;0;0;0;0;0;0;0;0;0;Cocina MCG-4QI24AME4 4P Inox;LINEA BLANCA
18569976;;M;28;CHILENO;;Millenial;PROVIDENCIA                   ;METROPOLITANA;0;0;0;0;0;0;0;0;0;Cocina MV 110 4 Platos;LINEA BLANCA
18678854;Soltero;F;28;CHILENO;;Millenial;PROVIDENCIA                   ;METROPOLITANA;0;0;0;0;0;0;0;0;0;Cocina MV 110 4 Platos;LINEA BLANCA
5791387;;M;72;CHILENO;;Silencioso;SAN JAVIER                    ;MAULE;0;0;0;0;0;0;0;0;0;Lavadora WT13WSBP 13Kg Blanca;LINEA BLANCA
8412502;;M;65;CHILENO;;Boomers;CURANILAHUE                   ;BIO BIO;0;0;0;0;0;0;0;0;0;Freezer FDHM150BY1 150Lts Horizontal;LINEA BLANCA
10446120;Soltero;F;57;CHILENO;;Boomers;FREIRE                        ;ARAUCANIA;0;0;0;0;0;0;0;0;0;Refrigerador 260Lts BF Frio Direc MRFI2660SR346W;LINEA BLANCA
17395947;;F;32;CHILENO;;Millenial;N/D;N/D;0;0;0;0;0;0;0;0;0;Freezer 142Lts MFH-1430B186C Horizontal;LINEA BLANCA
15414611;;M;39;CHILENO;;X;PROVIDENCIA                   ;METROPOLITANA;0;0;0;0;0;0;0;0;0;Refrigerador 244Lts Frio Directo Progress 3100;LINEA BLANCA
18894667;;F;27;CHILENO;;Millenial;N/D;N/D;1225470;14;6;0;0;0;14;6;1225470;Consola PlayStation 4 500GB;VIDEO JUEGOS
15010927;;M;40;CHILENO;;X;TOCOPILLA                     ;ANTOFAGASTA;719980;2;2;0;0;0;2;2;719980;Consola PlayStation 5 con Disco (Internacional);VIDEO JUEGOS
16943071;;M;33;CHILENO;;Extranjero;PROVIDENCIA                   ;N/D;39990;2;1;2;1;39990;0;0;0;HORIZON FORBIDDEN WEST - LATAM PS4;VIDEO JUEGOS
7792426;;F;66;CHILENO;;Boomers;RENCA                         ;METROPOLITANA;502980;2;1;0;0;0;2;1;502980;Consola PlayStation 4 500GB;VIDEO JUEGOS
6792534;;F;69;CHILENO;;Silencioso;LA CISTERNA                   ;METROPOLITANA;509010;2;1;0;0;0;2;1;509010;Consola PlayStation 4 500GB;VIDEO JUEGOS
11256959;;M;53;CHILENO;;X;HUECHURABA                    ;METROPOLITANA;39990;1;1;0;0;0;1;1;39990;JUEGO SPIDER-MAN MILES MORALES - LATAM PS5;VIDEO JUEGOS
14091854;;F;41;CHILENO;;X;N/D;N/D;871950;5;2;5;2;871950;0;0;0;Consola PlayStation 5 con Disco;VIDEO JUEGOS
17172920;;F;32;CHILENO;;Millenial;PAINE                         ;METROPOLITANA;1109970;3;3;0;0;0;3;3;1109970;Consola PlayStation 5 con Disco (Internacional);VIDEO JUEGOS
24651814;;M;42;VENEZOLANO;;Extranjero;SANTIAGO                      ;METROPOLITANA;469990;1;1;0;0;0;1;1;469990;Consola PlayStation 4 500GB;VIDEO JUEGOS
13607123;Casado;M;42;CHILENO;INGENIERO CIVIL INDUSTRIAL;X;RENCA                         ;METROPOLITANA;82980;2;1;2;1;82980;0;0;0;ACC JOY CON L R NEON PURPLE NEON ORANGE;VIDEO JUEGOS
15399813;;F;44;CHILENO;;X;PUENTE ALTO                   ;METROPOLITANA;803980;2;1;2;1;803980;0;0;0;Consola PlayStation 5 con Disco;VIDEO JUEGOS
11973629;;F;50;CHILENO;;X;EL BOSQUE                     ;METROPOLITANA;999990;1;1;0;0;0;1;1;999990;Consola PlayStation 5 con Disco (Internacional);VIDEO JUEGOS
17134345;;M;33;CHILENO;;Millenial;N/D;N/D;499990;1;1;0;0;0;1;1;499990;Consola PlayStation 4 500GB;VIDEO JUEGOS
13567741;;M;43;CHILENO;;X;GRANEROS;O HIGGINS;911980;2;1;0;0;0;2;1;911980;Consola PlayStation 5 con Disco (Internacional);VIDEO JUEGOS
11975353;;M;50;CHILENO;;X;RENCA                         ;METROPOLITANA;41980;2;1;2;1;41980;0;0;0;SW SWITCH ZELDA SKYWARD SWORD;VIDEO JUEGOS
17128417;Soltero;M;33;CHILENO;;Millenial;PROVIDENCIA                   ;METROPOLITANA;42980;2;1;2;1;42980;0;0;0;JUEGO SWITCH Mario Kart 8 Deluxe;VIDEO JUEGOS
13301094;;F;45;CHILENO;;X;DONIHUE                       ;L.G.B.OÂ´HIGGINS;899990;1;1;0;0;0;1;1;899990;Consola PlayStation 5 con Disco (Internacional);VIDEO JUEGOS
16911294;;M;34;CHILENO;;Millenial;RENCA                         ;METROPOLITANA;41980;2;1;2;1;41980;0;0;0;JUEGO SWITCH Super Mario Party;VIDEO JUEGOS
13887329;;M;41;CHILENO;;X;PROVIDENCIA                   ;METROPOLITANA;849990;2;1;0;0;0;2;1;849990;Consola PlayStation 5 con Disco (Internacional);VIDEO JUEGOS
9552386;;F;44;CHILENO;;Millenial;ANTOFAGASTA                   ;ANTOFAGASTA;458960;4;1;0;0;0;4;1;458960;CONSOLA SWITCH LT2 NEON;VIDEO JUEGOS
18538960;;M;29;CHILENO;;Millenial;"";"";41980;2;1;2;1;41980;0;0;0;SW SWITCH POKEMON SHINING PEARL;VIDEO JUEGOS
18333297;;F;29;CHILENO;;Millenial;"";"";175940;6;1;6;1;175940;0;0;0;SW SWITCH POKEMON SHINING PEARL;VIDEO JUEGOS
19156129;;M;27;CHILENO;;Millenial;N/D;N/D;355840;2;1;2;1;355840;0;0;0;CONSOLA SWITCH LT2 NEON;VIDEO JUEGOS
17903056;;F;31;CHILENO;;Millenial;TALAGANTE                     ;METROPOLITANA;597960;4;2;4;2;597960;0;0;0;CONSOLA SWITCH LT2 NEON;VIDEO JUEGOS
16746607;Casado;F;34;CHILENO;ADMINISTRADOR PUBLICO;Millenial;PROVIDENCIA                   ;METROPOLITANA;44980;2;1;2;1;44980;0;0;0;JUEGO SWITCH Super Smash Bros Ultimate;VIDEO JUEGOS
13759851;;M;42;CHILENO;;X;CHANARAL                      ;ATACAMA;127620;4;1;4;1;127620;0;0;0;MARVELS GUARDIANS OF THE GALAXY - LATAM PS4;VIDEO JUEGOS
5996902;;F;77;CHILENO;;Silencioso;ANCUD                         ;LOS LAGOS;402980;2;1;0;0;0;2;1;402980;CONSOLA SWITCH LT2 NEON;VIDEO JUEGOS
13004505;;M;45;CHILENO;;X;SAN FERNANDO                  ;L.G.B.OÂ´HIGGINS;899990;1;1;0;0;0;1;1;899990;Consola PlayStation 5 con Disco (Internacional);VIDEO JUEGOS
15326754;;F;40;CHILENO;;X;PROVIDENCIA                   ;METROPOLITANA;44980;2;1;2;1;44980;0;0;0;JUEGO SWITCH Super Smash Bros Ultimate;VIDEO JUEGOS
15048696;;F;38;CHILENO;;X;LOS VILOS                     ;COQUIMBO;666080;4;2;4;2;666080;0;0;0;JGO FIFA 22 ROLA PS4;VIDEO JUEGOS
18071756;;M;30;CHILENO;;Millenial;PROVIDENCIA                   ;METROPOLITANA;53980;2;1;2;1;53980;0;0;0;Control inalambrico Xbox + cable USB-C Negro;VIDEO JUEGOS
19147908;;F;26;CHILENO;;Millenial;QUILPUE                       ;VALPARAISO;70960;4;1;4;1;70960;0;0;0;JGO FIFA 22 ROLA PS4;VIDEO JUEGOS
18075146;;M;30;CHILENO;;Millenial;PROVIDENCIA                   ;METROPOLITANA;63980;2;1;2;1;63980;0;0;0;CONTROL PS4 Midnight Blue;VIDEO JUEGOS
16766144;;M;34;CHILENO;;Millenial;PROVIDENCIA                   ;METROPOLITANA;703980;2;1;2;1;703980;0;0;0;Consola PlayStation 5 con Disco;VIDEO JUEGOS
18325398;Soltero;F;29;CHILENO;;Millenial;PROVIDENCIA                   ;METROPOLITANA;63980;2;1;2;1;63980;0;0;0;ACC SWITCH JOY CON L R PG PINK GREEN;VIDEO JUEGOS
15226788;;F;42;CHILENO;;X;ANGOL                         ;ARAUCANIA;296980;2;1;2;1;296980;0;0;0;Consola Xbox Series S 512GB;VIDEO JUEGOS
19909067;;M;23;CHILENO;;Z;PROVIDENCIA                   ;METROPOLITANA;305840;2;1;2;1;305840;0;0;0;Consola Xbox Series S 512GB;VIDEO JUEGOS
5628288;;F;74;CHILENO;;Silencioso;ANTOFAGASTA                   ;ANTOFAGASTA;1212020;7;1;0;0;0;7;1;1212020;Consola PlayStation 5 con Disco;VIDEO JUEGOS
19188560;;M;26;CHILENO;;Z;N/D;N/D;313980;2;1;2;1;313980;0;0;0;Consola Xbox Series S 512GB;VIDEO JUEGOS
17906347;;F;31;CHILENO;;Millenial;N/D;N/D;467870;2;1;0;0;0;2;1;467870;PS4 HW 1TB MEGA 18 - R C, GOT, GOW BNDL;VIDEO JUEGOS
17408533;;M;32;CHILENO;;Millenial;PROVIDENCIA                   ;METROPOLITANA;0;0;0;0;0;0;0;0;0;Consola PlayStation 5 con Disco;VIDEO JUEGOS
15691736;;M;38;CHILENO;;X;N/D;N/D;0;0;0;0;0;0;0;0;0;CONSOLA SWITCH LT2 NEON;VIDEO JUEGOS
19483922;;M;25;CHILENO;;Z;RETIRO                        ;MAULE;0;0;0;0;0;0;0;0;0;PS5 DUALSENSE;VIDEO JUEGOS
17769805;Soltero;M;31;CHILENO;;Millenial;PROVIDENCIA                   ;METROPOLITANA;0;0;0;0;0;0;0;0;0;Consola Xbox Series S 512GB;VIDEO JUEGOS
17836519;;M;31;CHILENO;;Silencioso;PROVIDENCIA                   ;METROPOLITANA;0;0;0;0;0;0;0;0;0;JUEGO SWITCH Mario Kart 8 Deluxe;VIDEO JUEGOS
14532500;;M;47;CHILENO;;X;SAN CARLOS                    ;BIO BIO;0;0;0;0;0;0;0;0;0;CONSOLA SWITCH LT2 NEON;VIDEO JUEGOS
26648358;;M;34;VENEZOLANO;;Extranjero;SANTIAGO                      ;METROPOLITANA;0;0;0;0;0;0;0;0;0;JUEGO SWITCH Super Mario Maker 2;VIDEO JUEGOS
19408239;;M;26;CHILENO;;Millenial;PROVIDENCIA                   ;METROPOLITANA;0;0;0;0;0;0;0;0;0;Consola Xbox Series S 512GB;VIDEO JUEGOS
17769546;Soltero;F;31;CHILENO;;Millenial;PROVIDENCIA                   ;METROPOLITANA;0;0;0;0;0;0;0;0;0;PS4 HW 1TB MEGA 15 - SPDMN GOTY, R C, HZDCE BNDL;VIDEO JUEGOS
16921927;;M;34;CHILENO;;Millenial;PROVIDENCIA                   ;METROPOLITANA;0;0;0;0;0;0;0;0;0;Consola Xbox Series S 512GB;VIDEO JUEGOS
17307754;Soltero;M;32;CHILENO;INGENIERO CIVIL INDUSTRIAL;Silencioso;PROVIDENCIA                   ;METROPOLITANA;0;0;0;0;0;0;0;0;0;JUEGO SWITCH Super Mario Party;VIDEO JUEGOS
17608134;Soltero;M;32;CHILENO;INGENIERO INFORMATICO;Millenial;PROVIDENCIA                   ;METROPOLITANA;0;0;0;0;0;0;0;0;0;Consola PlayStation 5 con Disco;VIDEO JUEGOS
18018506;;M;30;CHILENO;;Millenial;PUENTE ALTO                   ;METROPOLITANA;0;0;0;0;0;0;0;0;0;ACC SWITCH JOY CON L R PG PINK GREEN;VIDEO JUEGOS
17597042;Soltero;F;32;CHILENO;PROFESOR;Silencioso;PROVIDENCIA                   ;METROPOLITANA;0;0;0;0;0;0;0;0;0;JUEGO SWITCH Zelda: Breath of the Wild;VIDEO JUEGOS
18039965;;M;30;CHILENO;;Millenial;PROVIDENCIA                   ;METROPOLITANA;0;0;0;0;0;0;0;0;0;Control inalambrico Xbox + cable USB-C Negro;VIDEO JUEGOS
17676453;Soltero;M;31;CHILENO;;Silencioso;PROVIDENCIA                   ;METROPOLITANA;0;0;0;0;0;0;0;0;0;Consola Series X;VIDEO JUEGOS
18856482;;M;27;CHILENO;;Millenial;PROVIDENCIA                   ;METROPOLITANA;0;0;0;0;0;0;0;0;0;CONSOLA SWITCH LITE GREY;VIDEO JUEGOS
11902223;;M;51;CHILENO;;X;CORONEL                       ;BIO BIO;0;0;0;0;0;0;0;0;0;PS4 SLIM 1TB MEGAPACK HIT 13;VIDEO JUEGOS
17634144;;F;32;CHILENO;;Millenial;PROVIDENCIA                   ;METROPOLITANA;0;0;0;0;0;0;0;0;0;CONSOLA SWITCH LT2 NEON;VIDEO JUEGOS
15094254;Soltero;M;39;CHILENO;CONTADOR AUDITOR;X;RENCA                         ;METROPOLITANA;0;0;0;0;0;0;0;0;0;JUEGO COD BLACK OPS COLD WAR - LATAM PS5;VIDEO JUEGOS
18544418;;M;29;CHILENO;;Millenial;PROVIDENCIA                   ;METROPOLITANA;0;0;0;0;0;0;0;0;0;PS4 SLIM 1TB MEGAPACK HIT 13;VIDEO JUEGOS
7158267;;M;67;CHILENO;;Boomers;COQUIMBO                      ;COQUIMBO;0;0;0;0;0;0;0;0;0;PS4 SLIM 1TB MEGAPACK HIT 13;VIDEO JUEGOS
13326029;Divorciado;F;45;CHILENO;INGENIERO CIVIL;X;RENCA                         ;METROPOLITANA;0;0;0;0;0;0;0;0;0;Headset for PS4 A10 Logitech (Grey/Blue);VIDEO JUEGOS
15157457;;F;35;CHILENO;;Millenial;LINARES                       ;MAULE;0;0;0;0;0;0;0;0;0;PS4 SLIM 1TB MEGAPACK HIT 13;VIDEO JUEGOS
17327862;;F;33;CHILENO;;Millenial;PROVIDENCIA                   ;METROPOLITANA;0;0;0;0;0;0;0;0;0;CONSOLA ONE S XBOX BLANCA;VIDEO JUEGOS
16899291;;M;34;CHILENO;;Millenial;PROVIDENCIA                   ;METROPOLITANA;0;0;0;0;0;0;0;0;0;PS4 SLIM 1TB MEGAPACK HIT 13;VIDEO JUEGOS
15459960;;F;39;CHILENO;;X;EL BOSQUE                     ;METROPOLITANA;0;0;0;0;0;0;0;0;0;PS4 SLIM 1TB MEGAPACK HIT 13;VIDEO JUEGOS
17367739;Soltero;F;33;CHILENO;;Millenial;PUTAENDO;VALPARAISO;0;0;0;0;0;0;0;0;0;JUEGO SWITCH SUPER MARIO 3D ALL STARS;VIDEO JUEGOS
17330491;;F;32;CHILENO;;Millenial;N/D;N/D;0;0;0;0;0;0;0;0;0;PS4 SLIM 1TB MEGAPACK HIT 13;VIDEO JUEGOS
7658811;;M;63;CHILENO;;Boomers;LA SERENA                     ;COQUIMBO;0;0;0;0;0;0;0;0;0;CONSOLA PS4 Slim 1TB;VIDEO JUEGOS
14584704;;M;42;CHILENO;;X;N/D;N/D;0;0;0;0;0;0;0;0;0;CONSOLA SWITCH LT2 NEON;VIDEO JUEGOS
15312359;;M;41;CHILENO;;X;PROVIDENCIA                   ;METROPOLITANA;0;0;0;0;0;0;0;0;0;CONTROL XBOX Inalambrico Negro;VIDEO JUEGOS
16395130;Soltero;F;36;CHILENO;;Millenial;PROVIDENCIA                   ;METROPOLITANA;0;0;2;0;2;0;0;0;0;TERMOVENTILADOR KIOTO BLANCO 2000W KTE-1028B;CLIMATIZACION
16306753;;F;35;CHILENO;;Millenial;PROVIDENCIA                   ;METROPOLITANA;19990;1;3;1;1;7990;0;2;12000;MINI OLEOELECTRICA KIOTO 500W BLANCO KTE-1081B;CLIMATIZACION
19902719;;M;24;CHILENO;;Z;SAN BERNARDO                  ;METROPOLITANA;30450;5;3;5;3;30450;0;0;0;ESTUFA CUARZO KIOTO 800W KTE-011A;CLIMATIZACION
19060568;;F;27;CHILENO;;Z;TALAGANTE                     ;METROPOLITANA;110370;13;5;13;5;110370;0;0;0;ESTUFA CUARZO KIOTO 800W KTE-011A;CLIMATIZACION
15073509;;M;40;CHILENO;;X;LIMACHE;VALPARAISO;0;0;2;0;2;0;0;0;0;CALIENTACAMA KIOTO DIGITAL 1 PLAZA KTC-1005;CLIMATIZACION
18419833;;F;28;CHILENO;;Millenial;PROVIDENCIA                   ;METROPOLITANA;169990;1;3;2;2;179980;-1;1;-9990;ESTUFA CUARZO KIOTO 800W KTE-011A;CLIMATIZACION
5943703;Divorciado;F;72;CHILENO;;Silencioso;LOS ANGELES                   ;BIO BIO;56350;2;1;0;0;0;2;1;56350;CHIMENEA ELECTRICA KIOTO 2000W KTE-1101;CLIMATIZACION
15797477;;M;38;CHILENO;;Millenial;N/D;N/D;59990;1;1;1;1;59990;0;0;0;CHIMENEA ELECTRICA KIOTO 2000W KTE-1101;CLIMATIZACION
20209796;;F;22;CHILENO;;Z;TALCAHUANO;BIO-BIO;6490;1;1;1;1;6490;0;0;0;ESTUFA CUARZO KIOTO 800W KTE-011A;CLIMATIZACION
10736100;;M;54;CHILENO;;Boomers;VALLENAR;ATACAMA;366970;3;2;0;0;0;3;2;366970;TERMOVENTILADOR KIOTO BLANCO 2000W KTE-1028B;CLIMATIZACION
19491910;Soltero;F;25;CHILENO;PSICOLOGA;Z;PROVIDENCIA                   ;METROPOLITANA;0;0;2;0;2;0;0;0;0;TERMOVENTILADOR KIOTO BLANCO 2000W KTE-1028B;CLIMATIZACION
16448637;;M;35;CHILENO;;Millenial;CASTRO                        ;LOS LAGOS;31990;1;1;0;0;0;1;1;31990;CALIENTACAMAS MANUAL 2N SG-5120D4 1PL;CLIMATIZACION
7047888;;F;65;CHILENO;;Boomers;N/D;N/D;93950;6;4;0;0;0;6;4;93950;CALIENTACAMAS MANUAL 2N SG-5120D4 1PL;CLIMATIZACION
17752237;Soltero;F;31;CHILENO;TECNOLOGO MEDICO;Silencioso;PROVIDENCIA                   ;METROPOLITANA;26970;3;1;3;1;26970;0;0;0;ESTUFA CUARZO KIOTO 800W KTE-011A;CLIMATIZACION
4038238;;F;79;CHILENO;;Silencioso;RENCA                         ;METROPOLITANA;0;0;2;0;0;0;0;2;0;ESTUFA CUARZO KIOTO 800W KTE-011A;CLIMATIZACION
4388368;;M;76;CHILENO;;Silencioso;PROVIDENCIA                   ;METROPOLITANA;299950;5;3;4;2;69960;1;1;229990;CHIMENEA ELECTRICA KIOTO 2000W KTE-1101;CLIMATIZACION
15995572;;F;36;CHILENO;;Millenial;RANCAGUA                      ;L.G.B.OÂ´HIGGINS;159950;5;4;5;4;159950;0;0;0;ESTUFA CUARZO KIOTO 800W KTE-011A;CLIMATIZACION
13552289;Casado;F;46;CHILENO;PERIODISTA;X;TALCA                         ;MAULE;9990;1;1;0;0;0;1;1;9990;ESTUFA CUARZO KIOTO 800W KTE-011A;CLIMATIZACION
16405546;;F;35;CHILENO;;Millenial;BULNES                        ;BIO BIO;801500;8;4;6;3;787520;2;1;13980;ESTUFA CUARZO KIOTO 800W KTE-011A;CLIMATIZACION
26496137;;F;29;NO INFORMA NACIONALIDAD;;Extranjero;LAMPA;METROPOLITANA;71900;16;4;10;2;71900;6;2;0;ESTUFA CUARZO KIOTO 800W KTE-011A;CLIMATIZACION
13815082;;F;42;CHILENO;;X;PROVIDENCIA                   ;METROPOLITANA;169990;1;1;0;0;0;1;1;169990;ESTUFA A GAS CALMA 15 KG HELIUS;CLIMATIZACION
15758571;Soltero;F;37;CHILENO;;Millenial;PROVIDENCIA                   ;METROPOLITANA;33970;3;1;3;1;33970;0;0;0;ESTUFA ELECTRICA CUARZO KIOTO 1200W KTE 1033;CLIMATIZACION
17134552;Soltero;M;33;CHILENO;CIRUJANO DENTISTA;Millenial;PROVIDENCIA                   ;METROPOLITANA;9990;1;1;0;0;0;1;1;9990;TERMOVENTILADOR KIOTO NEGRO 2000W KTE-1028N;CLIMATIZACION
17169012;;F;33;CHILENO;;Millenial;COLINA                        ;METROPOLITANA;44960;4;2;0;0;0;4;2;44960;ESTUFA CUARZO KIOTO 800W KTE-011A;CLIMATIZACION
19142463;;F;26;CHILENO;;Z;SAN ANTONIO                   ;VALPARAISO;125972;3;2;0;0;0;3;2;125972;CHIMENEA ELECTRICA KIOTO 2000W KTE-1101;CLIMATIZACION
19116986;;F;26;CHILENO;;Z;N/D;N/D;96970;3;2;3;2;96970;0;0;0;CALIENTACAMA KIOTO ANALOGO 1 PLAZA KTC-1004;CLIMATIZACION
6726328;;F;69;CHILENO;;Silencioso;ARAUCO                        ;BIO BIO;61980;2;2;0;0;0;2;2;61980;CALIENTACAMA KIOTO DIGITAL 2 PLAZAS KTC-1006;CLIMATIZACION
9330753;Casado;F;61;CHILENO;;Boomers;RENCA                         ;METROPOLITANA;6990;1;1;0;0;0;1;1;6990;ESTUFA CUARZO KIOTO 800W KTE-011A;CLIMATIZACION
13663361;;F;42;CHILENO;;X;CERRO NAVIA;METROPOLITANA;300910;9;3;9;3;300910;0;0;0;CALIENTACAMA KIOTO ANALOGO 1 PLAZA KTC-1004;CLIMATIZACION
20669294;;F;21;CHILENO;;Z;PROVIDENCIA                   ;METROPOLITANA;7990;1;1;1;1;7990;0;0;0;TERMOVENTILADOR KIOTO BLANCO 2000W KTE-1028B;CLIMATIZACION
9941039;;F;56;CHILENO;;Boomers;PROVIDENCIA                   ;METROPOLITANA;19980;2;1;0;0;0;2;1;19980;ESTUFA CUARZO KIOTO 800W KTE-011A;CLIMATIZACION
15584467;;M;39;CHILENO;;X;PROVIDENCIA                   ;METROPOLITANA;9990;1;1;0;0;0;1;1;9990;TERMOVENTILADOR KIOTO BLANCO 2000W KTE-1028B;CLIMATIZACION
20035006;;F;23;CHILENO;;Z;TALAGANTE                     ;METROPOLITANA;420960;4;3;0;0;0;4;3;420960;ESTUFA ELECTRICA CUARZO KIOTO 1200W KTE 1033;CLIMATIZACION
18870520;;F;27;CHILENO;;Millenial;OSORNO;LOS LAGOS;7990;1;1;1;1;7990;0;0;0;TERMOVENTILADOR KIOTO NEGRO 2000W KTE-1028N;CLIMATIZACION
17809290;;M;31;CHILENO;;Millenial;VINA DEL MAR;VALPARAISO;6990;1;1;0;0;0;1;1;6990;ESTUFA CUARZO KIOTO 800W KTE-011A;CLIMATIZACION
15744432;;F;38;CHILENO;;Millenial;"";"";301950;5;3;0;0;0;5;3;301950;TERMOVENTILADOR KIOTO BLANCO 2000W KTE-1028B;CLIMATIZACION
12008414;;F;45;CHILENO;;X;SANTA CRUZ                    ;L.G.B.OÂ´HIGGINS;546740;7;7;0;0;0;7;7;546740;CALIENTACAMA KIOTO DIGITAL 2 PLAZAS KTC-1006;CLIMATIZACION
5556399;;F;80;CHILENO;;Silencioso;NOGALES                       ;VALPARAISO;18470;2;1;0;0;0;2;1;18470;TERMOVENTILADOR KIOTO BLANCO 2000W KTE-1028B;CLIMATIZACION
24574601;;F;48;ECUATORIANO;;Extranjero;CONCHALI                      ;METROPOLITANA;36960;4;1;4;1;36960;0;0;0;CALIENTACAMA KIOTO ANALOGO 1 PLAZA KTC-1004;CLIMATIZACION
19631671;;F;25;CHILENO;;Z;PROVIDENCIA                   ;METROPOLITANA;46960;4;3;4;3;46960;0;0;0;TERMOVENTILADOR KIOTO NEGRO 2000W KTE-1028N;CLIMATIZACION
13888168;;F;41;CHILENO;;X;PROVIDENCIA                   ;METROPOLITANA;167930;7;3;7;3;167930;0;0;0;TERMOVENTILADOR KIOTO BLANCO 2000W KTE-1028B;CLIMATIZACION
10026626;;F;59;CHILENO;;Boomers;PROVIDENCIA                   ;METROPOLITANA;49990;1;1;0;0;0;1;1;49990;CHIMENEA ELECTRICA KIOTO 2000W KTE-1101;CLIMATIZACION
18663838;;F;28;CHILENO;;Millenial;PROVIDENCIA                   ;METROPOLITANA;179920;6;1;6;1;179920;0;0;0;ESTUFA ELEC. CHIMENEA TH-FP75 NG 1000W-2000W;CLIMATIZACION
26824109;;M;48;VENEZOLANO;;Extranjero;"";"";218402;4;2;0;0;0;4;2;218402;ESTUFA CUARZO KIOTO 800W KTE-011A;CLIMATIZACION
17824208;;F;30;CHILENO;;Millenial;PROVIDENCIA                   ;METROPOLITANA;15980;2;1;2;1;15980;0;0;0;TERMOVENTILADOR KIOTO BLANCO 2000W KTE-1028B;CLIMATIZACION
15883320;;M;38;CHILENO;;Extranjero;VALDIVIA                      ;LOS RIOS;271810;3;2;0;0;0;3;2;271810;CHIMENEA ELECTRICA KIOTO 2000W KTE-1101;CLIMATIZACION
19653206;;F;24;CHILENO;;Z;PROVIDENCIA                   ;METROPOLITANA;9990;1;1;0;0;0;1;1;9990;TERMOVENTILADOR KIOTO BLANCO 2000W KTE-1028B;CLIMATIZACION
9987614;;F;56;CHILENO;;Boomers;CORONEL                       ;BIO BIO;601050;11;6;0;0;0;11;6;601050;ESTUFA INFRARROJA ELECTRICA KIOTO 1500W KTE-1045;CLIMATIZACION
17747502;;M;31;CHILENO;;Millenial;SAN FERNANDO                  ;L.G.B.OÂ´HIGGINS;48970;3;3;0;0;0;3;3;48970;ESTUFA CUARZO KIOTO 800W KTE-011A;CLIMATIZACION
17510557;Soltero;F;31;CHILENO;;Millenial;PROVIDENCIA                   ;METROPOLITANA;0;0;2;0;2;0;0;0;0;TERMOVENTILADOR KIOTO BLANCO 2000W KTE-1028B;CLIMATIZACION
3766814;;F;84;CHILENO;;Silencioso;LAS CABRAS                    ;L.G.B.OÂ´HIGGINS;50660;3;4;0;0;0;3;4;50660;ESTUFA CUARZO KIOTO 800W KTE-011A;CLIMATIZACION
15601144;;M;38;CHILENO;;X;CHANARAL                      ;ATACAMA;580330;5;2;3;1;410630;2;1;169700;ESTUFA A GAS CALMA 15 KG HELIUS;CLIMATIZACION
13301441;;M;45;CHILENO;;X;RENCA                         ;METROPOLITANA;64990;1;1;1;1;64990;0;0;0;CHIMENEA ELECTRICA KIOTO 2000W KTE-1101;CLIMATIZACION
16630884;;F;35;CHILENO;;Millenial;CALBUCO                       ;LOS LAGOS;781219;11;5;0;0;0;11;5;781219;ESTUFA INFRARROJA ELECTRICA KIOTO 1500W KTE-1045;CLIMATIZACION
11072552;Soltero;F;57;CHILENO;;Boomers;PROVIDENCIA                   ;METROPOLITANA;31990;1;1;0;0;0;1;1;31990;CALIENTACAMA KIOTO DIGITAL 2 PLAZAS KTC-1006;CLIMATIZACION
20044900;;F;23;CHILENO;;Z;N/D;N/D;11980;2;1;2;1;11980;0;0;0;TERMOVENTILADOR KIOTO NEGRO 2000W KTE-1028N;CLIMATIZACION
20363808;;F;22;CHILENO;;Millenial;"";"";45960;4;3;3;2;25970;1;1;19990;TERMOVENTILADOR KIOTO NEGRO 2000W KTE-1028N;CLIMATIZACION
16316005;;M;36;CHILENO;;Millenial;"";"";19980;2;1;0;0;0;2;1;19980;ESTUFA CUARZO KIOTO 800W KTE-011A;CLIMATIZACION
24419619;;M;38;COLOMBIANO;;Extranjero;"";"";141930;8;6;1;1;7990;7;5;133940;CALIENTACAMA KIOTO ANALOGO 1 PLAZA KTC-1004;CLIMATIZACION
14129341;;F;40;CHILENO;;X;N/D;N/D;0;0;2;2;1;15980;-2;1;-15980;TERMOVENTILADOR KIOTO BLANCO 2000W KTE-1028B;CLIMATIZACION
19873776;;M;24;CHILENO;;Extranjero;LINARES                       ;MAULE;9990;1;1;0;0;0;1;1;9990;TERMOVENTILADOR KIOTO NEGRO 2000W KTE-1028N;CLIMATIZACION
18904580;;F;27;CHILENO;;Millenial;MAIPU                         ;METROPOLITANA;14990;1;1;0;0;0;1;1;14990;CALIENTACAMA KIOTO ANALOGO 1 PLAZA KTC-1004;CLIMATIZACION
15037224;Casado;F;38;CHILENO;;X;RENCA                         ;METROPOLITANA;13980;2;2;2;2;13980;0;0;0;TERMOVENTILADOR KIOTO NEGRO 2000W KTE-1028N;CLIMATIZACION
9716419;;M;57;CHILENO;;Boomers;QUILPUE                       ;VALPARAISO;29990;1;1;0;0;0;1;1;29990;CALIENTACAMA KIOTO DIGITAL 2 PLAZAS KTC-1006;CLIMATIZACION
19550695;;F;25;CHILENO;;Z;CHEPICA;O HIGGINS;310573;3;3;1;1;5593;2;2;304980;ESTUFA CUARZO KIOTO 800W KTE-011A;CLIMATIZACION
13591442;;M;51;CHILENO;;X;OSORNO                        ;LOS LAGOS;21470;5;1;0;0;0;5;1;21470;ESTUFA CUARZO KIOTO 800W KTE-011A;CLIMATIZACION
13396099;;M;43;CHILENO;;X;PROVIDENCIA                   ;METROPOLITANA;6990;1;1;0;0;0;1;1;6990;ESTUFA CUARZO KIOTO 800W KTE-011A;CLIMATIZACION
13595561;;F;47;CHILENO;;X;BUIN                          ;METROPOLITANA;145190;8;4;0;0;0;8;4;145190;ESTUFA CUARZO KIOTO 800W KTE-011A;CLIMATIZACION
9053314;;F;61;CHILENO;;Boomers;N/D;N/D;161980;2;2;0;0;0;2;2;161980;CALIENTACAMA KIOTO DIGITAL 2 PLAZAS KTC-1006;CLIMATIZACION
14135039;Soltero;M;41;CHILENO;;X;PROVIDENCIA                   ;METROPOLITANA;49990;1;1;0;0;0;1;1;49990;CHIMENEA ELECTRICA KIOTO 2000W KTE-1101;CLIMATIZACION
11435062;Casado;M;53;CHILENO;AGROINDUSTRIA;X;PROVIDENCIA                   ;METROPOLITANA;9990;1;1;0;0;0;1;1;9990;TERMOVENTILADOR KIOTO NEGRO 2000W KTE-1028N;CLIMATIZACION
26390242;Soltero;F;68;EXTRANJERO - NO INFORMA NACIONALIDAD;;Extranjero;CONCHALI                      ;METROPOLITANA;246410;10;3;0;0;0;10;3;246410;ESTUFA ELECTRICA CUARZO KIOTO 1200W KTE 1033;CLIMATIZACION
18942417;;F;27;CHILENO;;Millenial;PROVIDENCIA                   ;METROPOLITANA;7990;1;1;1;1;7990;0;0;0;TERMOVENTILADOR KIOTO BLANCO 2000W KTE-1028B;CLIMATIZACION
16563925;;F;35;CHILENO;;Millenial;PROVIDENCIA                   ;METROPOLITANA;9990;1;1;0;0;0;1;1;9990;TERMOVENTILADOR KIOTO BLANCO 2000W KTE-1028B;CLIMATIZACION
6994118;Soltero;F;68;CHILENO;;Boomers;LOS ANDES                     ;VALPARAISO;6990;1;1;0;0;0;1;1;6990;ESTUFA CUARZO KIOTO 800W KTE-011A;CLIMATIZACION
12538629;;F;49;CHILENO;;X;PUERTO MONTT                  ;LOS LAGOS;43960;4;1;4;1;43960;0;0;0;CALIENTACAMA KIOTO ANALOGO 1 PLAZA KTC-1004;CLIMATIZACION
13503814;;M;43;CHILENO;;X;TRAIGUEN                      ;ARAUCANIA;174370;5;3;0;0;0;5;3;174370;TERMOVENTILADOR KIOTO BLANCO 2000W KTE-1028B;CLIMATIZACION
7393856;;F;67;CHILENO;;Boomers;RENCA                         ;METROPOLITANA;10240;2;2;0;0;0;2;2;10240;TERMOVENTILADOR KIOTO BLANCO 2000W KTE-1028B;CLIMATIZACION
15411466;Soltero;F;40;CHILENO;;X;PROVIDENCIA                   ;METROPOLITANA;11980;2;1;2;1;11980;0;0;0;TERMOVENTILADOR KIOTO BLANCO 2000W KTE-1028B;CLIMATIZACION
18058819;Soltero;F;30;CHILENO;;Millenial;PROVIDENCIA                   ;METROPOLITANA;28472;5;1;0;0;0;5;1;28472;ESTUFA CUARZO KIOTO 800W KTE-011A;CLIMATIZACION
17384053;;F;32;CHILENO;;Millenial;SAN RAMON                     ;METROPOLITANA;23970;3;1;3;1;23970;0;0;0;ESTUFA CUARZO KIOTO 800W KTE-011A;CLIMATIZACION
14323345;;M;45;CHILENO;;X;PROVIDENCIA                   ;METROPOLITANA;6990;1;1;0;0;0;1;1;6990;ESTUFA CUARZO KIOTO 800W KTE-011A;CLIMATIZACION
10043211;;F;50;CHILENO;;X;CORONEL                       ;BIO BIO;21980;2;1;0;0;0;2;1;21980;TERMOVENTILADOR KIOTO BLANCO 2000W KTE-1028B;CLIMATIZACION
8930806;;F;58;CHILENO;;Boomers;ANCUD                         ;LOS LAGOS;13980;2;1;0;0;0;2;1;13980;ESTUFA CUARZO KIOTO 800W KTE-011A;CLIMATIZACION
27530954;;M;30;"";;Extranjero;N/D;N/D;0;0;2;0;2;0;0;0;0;TERMOVENTILADOR KIOTO NEGRO 2000W KTE-1028N;CLIMATIZACION
17878531;;F;30;CHILENO;;Millenial;CERRO NAVIA                   ;METROPOLITANA;47950;5;1;5;1;47950;0;0;0;CALIENTACAMA KIOTO ANALOGO 1 PLAZA KTC-1004;CLIMATIZACION
10055586;;M;49;CHILENO;;X;TALCAHUANO;BIO-BIO;29990;1;1;0;0;0;1;1;29990;CALIENTACAMA KIOTO DIGITAL 2 PLAZAS KTC-1006;CLIMATIZACION
15191176;;F;36;CHILENO;;Millenial;LAJA                          ;BIO BIO;9990;1;1;0;0;0;1;1;9990;TERMOVENTILADOR KIOTO BLANCO 2000W KTE-1028B;CLIMATIZACION
15183597;;F;39;CHILENO;;X;CORONEL                       ;BIO BIO;40442;2;1;0;0;0;2;1;40442;CHIMENEA ELECTRICA KIOTO 2000W KTE-1101;CLIMATIZACION
11403616;;M;53;CHILENO;;X;PROVIDENCIA                   ;METROPOLITANA;17990;1;3;0;0;0;1;3;17990;ESTUFA CUARZO KIOTO 800W KTE-011A;CLIMATIZACION
10016099;;M;54;CHILENO;;Boomers;RENCA                         ;METROPOLITANA;0;0;2;0;2;0;0;0;0;TERMOVENTILADOR KIOTO NEGRO 2000W KTE-1028N;CLIMATIZACION
5015567;;M;78;CHILENO;;Silencioso;MAULE                         ;MAULE;197300;2;1;0;0;0;2;1;197300;ESTUFA GAS EH2500 5K NEGRO;CLIMATIZACION
16376796;;M;35;CHILENO;;Millenial;"";"";9990;1;1;0;0;0;1;1;9990;TERMOVENTILADOR KIOTO NEGRO 2000W KTE-1028N;CLIMATIZACION
14214137;;M;41;CHILENO;;X;CORONEL                       ;BIO BIO;868923;10;5;0;0;0;10;5;868923;MINI OLEOELECTRICA KIOTO 500W BLANCO KTE-1081B;CLIMATIZACION
14076124;;M;41;CHILENO;;X;TEMUCO                        ;ARAUCANIA;1102920;8;5;0;0;0;8;5;1102920;MINI OLEOELECTRICA KIOTO 500W BLANCO KTE-1081B;CLIMATIZACION
12079436;Soltero;F;56;CHILENO;;Boomers;LA SERENA                     ;COQUIMBO;9990;1;1;0;0;0;1;1;9990;TERMOVENTILADOR KIOTO NEGRO 2000W KTE-1028N;CLIMATIZACION
19802371;;M;24;CHILENO;;Z;"";"";19970;3;1;3;1;19970;0;0;0;TERMOVENTILADOR KIOTO BLANCO 2000W KTE-1028B;CLIMATIZACION
20217466;;M;22;CHILENO;;Extranjero;PROVIDENCIA                   ;N/D;19980;2;1;2;1;19980;0;0;0;ESTUFA CUARZO KIOTO 800W KTE-011A;CLIMATIZACION
8671592;Viudo;F;71;CHILENO;;Millenial;"";"";0;0;4;0;0;0;0;4;0;TERMOVENTILADOR KIOTO NEGRO 2000W KTE-1028N;CLIMATIZACION
18662389;;F;28;CHILENO;;Millenial;LA PINTANA;METROPOLITANA;14980;2;1;2;1;14980;0;0;0;CALIENTACAMA KIOTO ANALOGO 1 PLAZA KTC-1004;CLIMATIZACION
14004631;;M;41;CHILENO;;X;PROVIDENCIA                   ;METROPOLITANA;6990;1;1;0;0;0;1;1;6990;ESTUFA CUARZO KIOTO 800W KTE-011A;CLIMATIZACION
16543898;;F;35;CHILENO;;Millenial;EL BOSQUE                     ;METROPOLITANA;9990;1;1;0;0;0;1;1;9990;TERMOVENTILADOR KIOTO NEGRO 2000W KTE-1028N;CLIMATIZACION
7133681;Casado;M;67;CHILENO;;Boomers;N/D;N/D;55050;4;2;0;0;0;4;2;55050;ESTUFA ELECTRICA CUARZO KIOTO 1200W KTE 1033;CLIMATIZACION
20069521;;F;23;CHILENO;;Z;LONGAVI                       ;MAULE;273940;6;6;0;0;0;6;6;273940;CHIMENEA ELECTRICA KIOTO 2000W KTE-1101;CLIMATIZACION
17816469;;M;30;CHILENO;;Millenial;N/D;N/D;39980;2;2;0;0;0;2;2;39980;ESTUFA CUARZO KIOTO 800W KTE-011A;CLIMATIZACION
15467877;;F;40;CHILENO;;X;PROVIDENCIA                   ;METROPOLITANA;12990;1;1;1;1;12990;0;0;0;CALIENTACAMA KIOTO ANALOGO 1 PLAZA KTC-1004;CLIMATIZACION
14049899;Soltero;M;43;CHILENO;;X;RENCA                         ;METROPOLITANA;9990;1;1;0;0;0;1;1;9990;TERMOVENTILADOR KIOTO BLANCO 2000W KTE-1028B;CLIMATIZACION
11288474;;M;53;CHILENO;;X;RENCA                         ;METROPOLITANA;49990;1;1;0;0;0;1;1;49990;CHIMENEA ELECTRICA KIOTO 2000W KTE-1101;CLIMATIZACION
15409548;;F;39;CHILENO;;X;ALHUE                         ;METROPOLITANA;31980;2;1;2;1;31980;0;0;0;TERMOVENTILADOR OSCILANTE FH-120S BL;CLIMATIZACION
10477142;;F;58;CHILENO;;Boomers;PERALILLO                     ;L.G.B.OÂ´HIGGINS;1285330;6;4;0;0;0;6;4;1285330;TERMOVENTILADOR KIOTO BLANCO 2000W KTE-1028B;CLIMATIZACION
17481611;;F;31;CHILENO;;Extranjero;N/D;N/D;15990;1;1;0;0;0;1;1;15990;ESTUFA ELECTRICA CUARZO KIOTO 1200W KTE 1033;CLIMATIZACION
10829617;;F;48;CHILENO;;X;PARRAL                        ;MAULE;18990;1;1;0;0;0;1;1;18990;CALIENTACAMA KIOTO DIGITAL 1 PLAZA KTC-1005;CLIMATIZACION
12968560;;F;45;CHILENO;;X;PORTEZUELO                    ;BIO BIO;14990;1;1;0;0;0;1;1;14990;CALIENTACAMA KIOTO ANALOGO 1 PLAZA KTC-1004;CLIMATIZACION
20019102;;F;24;CHILENO;;Z;N/D;N/D;214950;5;3;0;0;0;5;3;214950;TERMOVENTILADOR KIOTO NEGRO 2000W KTE-1028N;CLIMATIZACION
15752381;;M;38;CHILENO;;Millenial;PROVIDENCIA                   ;METROPOLITANA;49990;1;1;1;1;49990;0;0;0;CHIMENEA ELECTRICA KIOTO 2000W KTE-1101;CLIMATIZACION
18852205;;F;29;CHILENO;;Millenial;LA UNION                      ;LOS LAGOS;9990;1;1;0;0;0;1;1;9990;ESTUFA CUARZO KIOTO 800W KTE-011A;CLIMATIZACION
8654426;;F;59;CHILENO;;Boomers;PROVIDENCIA                   ;METROPOLITANA;17990;1;3;0;0;0;1;3;17990;ESTUFA ELECTRICA CUARZO KIOTO 1200W KTE 1033;CLIMATIZACION
16433704;;M;34;CHILENO;;Silencioso;PROVIDENCIA                   ;METROPOLITANA;44990;1;1;0;0;0;1;1;44990;CALIENTACAMAS MANUAL 2N SG-5120D4 1PL;CLIMATIZACION
26706560;Soltero;M;48;VENEZOLANO;;Extranjero;PROVIDENCIA                   ;METROPOLITANA;7990;1;1;1;1;7990;0;0;0;TERMOVENTILADOR KIOTO BLANCO 2000W KTE-1028B;CLIMATIZACION
9915237;;F;58;CHILENO;;Boomers;"";"";122980;2;2;0;0;0;2;2;122980;CHIMENEA ELECTRICA KIOTO 2000W KTE-1101;CLIMATIZACION
16979141;;M;32;CHILENO;;Millenial;PROVIDENCIA                   ;METROPOLITANA;84970;3;3;2;2;72980;1;1;11990;CALIENTACAMA KIOTO DIGITAL 2 PLAZAS KTC-1006;CLIMATIZACION
18123125;;M;29;CHILENO;;Millenial;RENCA                         ;METROPOLITANA;27990;1;1;0;0;0;1;1;27990;CALIENTACAMA KIOTO DIGITAL 2 PLAZAS KTC-1006;CLIMATIZACION
15596603;;M;39;CHILENO;;X;TALCA                         ;MAULE;8990;1;1;0;0;0;1;1;8990;ESTUFA CUARZO KIOTO 800W KTE-011A;CLIMATIZACION
19238053;;M;26;CHILENO;;Millenial;PROVIDENCIA                   ;METROPOLITANA;26970;3;2;3;2;26970;0;0;0;ESTUFA ELECTRICA CUARZO KIOTO 1200W KTE 1033;CLIMATIZACION
15850889;;F;37;CHILENO;;Millenial;N/D;N/D;268960;4;3;0;0;0;4;3;268960;CALIENTACAMA KIOTO DIGITAL 1 PLAZA KTC-1005;CLIMATIZACION
7708843;;F;56;CHILENO;;Boomers;LA SERENA;COQUIMBO;341960;4;3;2;1;279980;2;2;61980;TERMOVENTILADOR KIOTO BLANCO 2000W KTE-1028B;CLIMATIZACION
17987242;;F;30;CHILENO;;Millenial;SANTIAGO                      ;METROPOLITANA;197950;4;1;4;1;197950;0;0;0;ESTUFA ELEC. RADIADOR TH-RFC50 800W-1600W-2000W;CLIMATIZACION
18752580;;M;27;CHILENO;;Z;VALLENAR;ATACAMA;27990;1;1;0;0;0;1;1;27990;CALIENTACAMA KIOTO DIGITAL 2 PLAZAS KTC-1006;CLIMATIZACION
12289841;;F;49;CHILENO;;X;SAN BERNARDO                  ;METROPOLITANA;71960;4;2;0;0;0;4;2;71960;ESTUFA ELECTRICA CUARZO KIOTO 1200W KTE 1033;CLIMATIZACION
11312080;;F;54;CHILENO;;X;SAN RAFAEL                    ;MAULE;1157210;4;2;0;0;0;4;2;1157210;ESTUFA FIAMMA PRO;CLIMATIZACION
12378225;;M;48;CHILENO;;X;CHILLAN                       ;BIO BIO;341370;8;4;0;0;0;8;4;341370;CHIMENEA ELECTRICA KIOTO 2000W KTE-1101;CLIMATIZACION
18911477;;F;35;CHILENO;;Millenial;VILLARICA                     ;ARAUCANIA;0;0;2;1;1;54990;-1;1;-54990;CHIMENEA ELECTRICA KIOTO 2000W KTE-1101;CLIMATIZACION
20059581;;M;23;CHILENO;;Z;N/D;N/D;9000;2;1;0;0;0;2;1;9000;TERMOVENTILADOR KIOTO NEGRO 2000W KTE-1028N;CLIMATIZACION
8327561;;M;63;CHILENO;;Boomers;BUIN                          ;METROPOLITANA;14990;1;1;0;0;0;1;1;14990;CALIENTACAMA KIOTO ANALOGO 1 PLAZA KTC-1004;CLIMATIZACION
13145101;;M;44;CHILENO;;X;CHILLAN                       ;BIO BIO;8990;1;1;0;0;0;1;1;8990;TERMOVENTILADOR KIOTO NEGRO 2000W KTE-1028N;CLIMATIZACION
15497741;;F;36;CHILENO;;Millenial;SANTA CRUZ                    ;L.G.B.OÂ´HIGGINS;41980;2;2;1;1;29990;1;1;11990;CALIENTACAMA KIOTO DIGITAL 2 PLAZAS KTC-1006;CLIMATIZACION
26729944;Soltero;F;27;VENEZOLANO;;Extranjero;PROVIDENCIA                   ;METROPOLITANA;35950;5;2;5;2;35950;0;0;0;TERMOVENTILADOR KIOTO BLANCO 2000W KTE-1028B;CLIMATIZACION
27190505;;M;45;EXTRANJERO - NO INFORMA NACIONALIDAD;;Extranjero;"";"";29970;3;3;0;0;0;3;3;29970;TERMOVENTILADOR KIOTO BLANCO 2000W KTE-1028B;CLIMATIZACION
13082255;Casado;F;46;CHILENO;;X;PROVIDENCIA                   ;METROPOLITANA;12990;1;1;1;1;12990;0;0;0;CALIENTACAMA KIOTO ANALOGO 1 PLAZA KTC-1004;CLIMATIZACION
14073561;;M;48;CHILENO;;X;N/D;N/D;66960;4;1;4;1;66960;0;0;0;CALIENTACAMA KIOTO ANALOGO 1 PLAZA KTC-1004;CLIMATIZACION
20527751;;M;21;CHILENO;;Z;ANGOL                         ;ARAUCANIA;454960;4;3;0;0;0;4;3;454960;ESTUFA ELEC. FIBRA DE CARBONO NSB120K5 SILVER;CLIMATIZACION
13306753;;F;45;CHILENO;;X;N/D;N/D;12990;1;1;1;1;12990;0;0;0;CALIENTACAMA KIOTO ANALOGO 1 PLAZA KTC-1004;CLIMATIZACION
5927945;;M;68;CHILENO;;Silencioso;RENCA                         ;METROPOLITANA;83980;2;1;2;1;83980;0;0;0;ESTUFA GAS EH2500 5K NEGRO;CLIMATIZACION
12374489;;M;48;CHILENO;;X;TALCA                         ;MAULE;8990;1;1;0;0;0;1;1;8990;TERMOVENTILADOR KIOTO BLANCO 2000W KTE-1028B;CLIMATIZACION
20363298;;F;22;CHILENO;;Z;PROVIDENCIA                   ;METROPOLITANA;140970;3;2;3;2;140970;0;0;0;TERMOVENTILADOR KIOTO NEGRO 2000W KTE-1028N;CLIMATIZACION
5726661;;F;77;CHILENO;;Silencioso;COIHAIQUE                     ;AYSEN;466930;7;5;2;1;203980;5;4;262950;TERMOVENTILADOR KIOTO BLANCO 2000W KTE-1028B;CLIMATIZACION
17364157;;F;32;CHILENO;;Millenial;N/D;N/D;1135970;9;4;0;0;0;9;4;1135970;TERMOVENTILADOR KIOTO NEGRO 2000W KTE-1028N;CLIMATIZACION
17978010;Soltero;F;30;CHILENO;;Millenial;PROVIDENCIA                   ;METROPOLITANA;7990;1;1;1;1;7990;0;0;0;TERMOVENTILADOR KIOTO BLANCO 2000W KTE-1028B;CLIMATIZACION
24999936;;F;52;COLOMBIANO;;Extranjero;QUILLOTA                      ;VALPARAISO;39980;2;2;0;0;0;2;2;39980;CALIENTACAMA KIOTO DIGITAL 1 PLAZA KTC-1005;CLIMATIZACION
6255412;;F;67;CHILENO;;Boomers;CANETE                        ;BIO BIO;522820;7;5;0;0;0;7;5;522820;CALIENTACAMA KIOTO DIGITAL 2 PLAZAS KTC-1006;CLIMATIZACION
16616509;;M;35;CHILENO;;Millenial;NUNOA                         ;METROPOLITANA;11980;2;1;2;1;11980;0;0;0;TERMOVENTILADOR KIOTO BLANCO 2000W KTE-1028B;CLIMATIZACION
13082731;;M;46;CHILENO;;X;VALPARAISO                    ;VALPARAISO;12980;2;1;2;1;12980;0;0;0;ESTUFA CUARZO KIOTO 800W KTE-011A;CLIMATIZACION
8000764;;F;65;CHILENO;;Boomers;SANTIAGO                      ;METROPOLITANA;846970;6;4;0;0;0;6;4;846970;PANEL RADIANTE CALMA GREEN PG4000;CLIMATIZACION
17277770;;F;33;CHILENO;;Millenial;N/D;N/D;25980;2;1;2;1;25980;0;0;0;CALIENTACAMA KIOTO ANALOGO 1 PLAZA KTC-1004;CLIMATIZACION
13951265;;F;42;CHILENO;;X;SAN FELIPE                    ;VALPARAISO;17980;2;1;2;1;17980;0;0;0;ESTUFA CUARZO KIOTO 800W KTE-011A;CLIMATIZACION
19544612;Soltero;F;25;CHILENO;;Z;PROVIDENCIA                   ;METROPOLITANA;21970;3;1;3;1;21970;0;0;0;ESTUFA CUARZO KIOTO 800W KTE-011A;CLIMATIZACION
15122868;;M;40;CHILENO;;X;PROVIDENCIA                   ;METROPOLITANA;17980;2;1;0;0;0;2;1;17980;TERMOVENTILADOR KIOTO NEGRO 2000W KTE-1028N;CLIMATIZACION
10344444;;F;56;CHILENO;;Boomers;CALAMA                        ;ANTOFAGASTA;567560;13;4;0;0;0;13;4;567560;CALIENTACAMA KIOTO DIGITAL 2 PLAZAS KTC-1006;CLIMATIZACION
15442657;;F;39;CHILENO;;X;PUENTE ALTO;METROPOLITANA;263960;4;4;4;4;263960;0;0;0;TERMOVENTILADOR KIOTO BLANCO 2000W KTE-1028B;CLIMATIZACION
17757001;Casado;M;30;CHILENO;;Millenial;PROVIDENCIA                   ;METROPOLITANA;272980;2;2;2;2;272980;0;0;0;CALIENTACAMA KIOTO ANALOGO 1 PLAZA KTC-1004;CLIMATIZACION
17249202;;F;33;CHILENO;;Millenial;OSORNO;LOS LAGOS;17990;1;1;1;1;17990;0;0;0;ESTUFA ELECTRICA CUARZO KIOTO 1200W KTE 1033;CLIMATIZACION
17304907;;F;32;CHILENO;;Millenial;PROVIDENCIA                   ;METROPOLITANA;17990;1;1;1;1;17990;0;0;0;ESTUFA ELECTRICA CUARZO KIOTO 1200W KTE 1033;CLIMATIZACION
8907568;;F;62;CHILENO;;Boomers;VINA DEL MAR                  ;VALPARAISO;49660;2;1;0;0;0;2;1;49660;CALEFACTOR CUARZO 1600W EEH-1300 NEGRO;CLIMATIZACION
19633494;;F;25;CHILENO;;Z;CARTAGENA;VALPARAISO;27990;1;1;0;0;0;1;1;27990;CALIENTACAMA KIOTO DIGITAL 2 PLAZAS KTC-1006;CLIMATIZACION
11724779;;F;51;CHILENO;;X;N/D;N/D;292971;4;3;0;0;0;4;3;292971;CALIENTACAMA KIOTO ANALOGO 1 PLAZA KTC-1004;CLIMATIZACION
15616165;;F;38;CHILENO;;Millenial;PROVIDENCIA                   ;METROPOLITANA;151960;4;3;2;1;66980;2;2;84980;Radiador Oleoelectrico 2000W Rb2209Tp;CLIMATIZACION
11786272;;M;50;CHILENO;;X;RENCA                         ;METROPOLITANA;17990;1;1;0;0;0;1;1;17990;CALIENTACAMA KIOTO DIGITAL 1 PLAZA KTC-1005;CLIMATIZACION
12985423;;M;46;CHILENO;;X;VICTORIA                      ;ARAUCANIA;284960;4;2;0;0;0;4;2;284960;CALIENTACAMA KIOTO DIGITAL 2 PLAZAS KTC-1006;CLIMATIZACION
15455841;;F;40;CHILENO;;Silencioso;PROVIDENCIA                   ;METROPOLITANA;209970;3;1;0;0;0;3;1;209970;CHIMENEA ELECTRICA KIOTO 2000W KTE-1101;CLIMATIZACION
25309940;;F;52;PERUANO;;Extranjero;"";"";68550;3;1;0;0;0;3;1;68550;CALIENTACAMA KIOTO DIGITAL 2 PLAZAS KTC-1006;CLIMATIZACION
18720375;Soltero;F;27;CHILENO;;Millenial;COIHAIQUE                     ;AYSEN;59430;5;3;0;0;0;5;3;59430;CALIENTACAMA KIOTO ANALOGO 1 PLAZA KTC-1004;CLIMATIZACION
9202658;;F;68;BOLIVIANO;;Extranjero;CALAMA                        ;ANTOFAGASTA;28460;2;1;0;0;0;2;1;28460;CALIENTACAMA KIOTO DIGITAL 1 PLAZA KTC-1005;CLIMATIZACION
19276396;;F;27;CHILENO;;Z;PROVIDENCIA                   ;METROPOLITANA;17990;1;1;0;0;0;1;1;17990;ESTUFA ELECTRICA CUARZO KIOTO 1200W KTE 1033;CLIMATIZACION
16810214;Soltero;F;34;CHILENO;;Millenial;PROVIDENCIA                   ;METROPOLITANA;24970;3;2;3;2;24970;0;0;0;TERMOVENTILADOR KIOTO BLANCO 2000W KTE-1028B;CLIMATIZACION
9733780;;F;57;CHILENO;;Boomers;RENCA                         ;METROPOLITANA;27990;1;2;0;0;0;1;2;27990;CALIENTACAMA KIOTO DIGITAL 2 PLAZAS KTC-1006;CLIMATIZACION
9227960;;F;56;CHILENO;;Boomers;ILLAPEL                       ;COQUIMBO;65376;3;2;0;0;0;3;2;65376;TERMOVENTILADOR KIOTO BLANCO 2000W KTE-1028B;CLIMATIZACION
15743735;;F;38;CHILENO;;X;LA GRANJA;METROPOLITANA;39980;2;1;2;1;39980;0;0;0;CALIENTACAMA KIOTO DIGITAL 2 PLAZAS KTC-1006;CLIMATIZACION
17503025;;F;32;CHILENO;;Millenial;RANCAGUA                      ;L.G.B.OÂ´HIGGINS;17990;1;1;0;0;0;1;1;17990;ESTUFA ELECTRICA CUARZO KIOTO 1200W KTE 1033;CLIMATIZACION
11783199;;F;51;CHILENO;;X;"";"";57970;3;2;3;2;57970;0;0;0;TERMOVENTILADOR KIOTO BLANCO 2000W KTE-1028B;CLIMATIZACION
19234388;Soltero;M;26;CHILENO;;Z;PROVIDENCIA                   ;METROPOLITANA;7990;1;1;1;1;7990;0;0;0;TERMOVENTILADOR KIOTO BLANCO 2000W KTE-1028B;CLIMATIZACION
6098748;;M;73;CHILENO;;Silencioso;"";"";8990;1;1;0;0;0;1;1;8990;ESTUFA CUARZO KIOTO 800W KTE-011A;CLIMATIZACION
15871528;;M;38;CHILENO;;Millenial;N/D;N/D;779660;8;4;0;0;0;8;4;779660;CALIENTACAMA KIOTO ANALOGO 1 PLAZA KTC-1004;CLIMATIZACION
10924932;;F;56;CHILENO;;Boomers;PROVIDENCIA                   ;METROPOLITANA;41970;3;2;0;0;0;3;2;41970;CALIENTACAMA KIOTO ANALOGO 1 PLAZA KTC-1004;CLIMATIZACION
14217647;Casado;F;41;CHILENO;;X;SAN BERNARDO                  ;METROPOLITANA;7990;1;1;1;1;7990;0;0;0;ESTUFA CUARZO KIOTO 800W KTE-011A;CLIMATIZACION
16577007;;F;33;CHILENO;;Millenial;MELIPILLA                     ;METROPOLITANA;239940;6;3;5;2;39950;1;1;199990;ESTUFA ELECTRICA CUARZO KIOTO 1200W KTE 1033;CLIMATIZACION
10344108;;F;43;CHILENO;;Millenial;"";"";8990;1;1;0;0;0;1;1;8990;TERMOVENTILADOR KIOTO NEGRO 2000W KTE-1028N;CLIMATIZACION
6775246;;F;67;CHILENO;;Boomers;SAN ANTONIO                   ;VALPARAISO;183880;4;3;0;0;0;4;3;183880;CHIMENEA ELECTRICA KIOTO 2000W KTE-1101;CLIMATIZACION
25801456;;M;28;VENEZOLANO;;Extranjero;N/D;N/D;59990;1;1;1;1;59990;0;0;0;CHIMENEA ELECTRICA KIOTO 2000W KTE-1101;CLIMATIZACION
16321017;;M;38;CHILENO;;Millenial;PROVIDENCIA                   ;METROPOLITANA;8990;1;1;0;0;0;1;1;8990;ESTUFA CUARZO KIOTO 800W KTE-011A;CLIMATIZACION
15841822;;F;38;CHILENO;;X;CASTRO                        ;LOS LAGOS;49970;3;1;0;0;0;3;1;49970;CALIENTACAMA KIOTO DIGITAL 2 PLAZAS KTC-1006;CLIMATIZACION
12617317;;M;48;CHILENO;;X;PROVIDENCIA                   ;METROPOLITANA;234960;4;3;0;0;0;4;3;234960;TERMOVENTILADOR KIOTO BLANCO 2000W KTE-1028B;CLIMATIZACION
18759947;Soltero;F;28;CHILENO;;Millenial;NAVIDAD                       ;L.G.B.OÂ´HIGGINS;53450;3;2;1;1;29990;2;1;23460;ESTUFA ELECTRICA CUARZO KIOTO 1200W KTE 1033;CLIMATIZACION
16293428;;F;35;CHILENO;;Millenial;PROVIDENCIA                   ;METROPOLITANA;19990;1;1;0;0;0;1;1;19990;ESTUFA ELECTRICA CUARZO KIOTO 1200W KTE 1033;CLIMATIZACION
17338413;;M;32;CHILENO;;Millenial;PROVIDENCIA                   ;METROPOLITANA;99900;2;1;0;0;0;2;1;99900;ESTUFA INFRARROJA ELECTRICA KIOTO 1500W KTE-1045;CLIMATIZACION
16228566;;F;36;CHILENO;;Millenial;NIQUEN                        ;BIO BIO;17990;1;1;0;0;0;1;1;17990;ESTUFA ELECTRICA CUARZO KIOTO 1200W KTE 1033;CLIMATIZACION
24789821;;M;27;PERUANO;;Extranjero;"";"";0;0;2;0;2;0;0;0;0;TERMOVENTILADOR KIOTO BLANCO 2000W KTE-1028B;CLIMATIZACION
19719880;;F;24;CHILENO;;Z;PROVIDENCIA                   ;METROPOLITANA;17990;1;1;0;0;0;1;1;17990;ESTUFA ELECTRICA CUARZO KIOTO 1200W KTE 1033;CLIMATIZACION
18348025;;F;29;CHILENO;;Millenial;CASTRO                        ;LOS LAGOS;20970;3;1;0;0;0;3;1;20970;TERMOVENTILADOR KIOTO BLANCO 2000W KTE-1028B;CLIMATIZACION
17870811;;F;30;CHILENO;;Millenial;N/D;N/D;12990;1;1;1;1;12990;0;0;0;CALIENTACAMA KIOTO ANALOGO 1 PLAZA KTC-1004;CLIMATIZACION
23807399;;F;51;PERUANO;;Extranjero;LA FLORIDA                    ;METROPOLITANA;387950;4;2;4;2;387950;0;0;0;ESTUFA INFRARROJA ELECTRICA KIOTO 1500W KTE-1045;CLIMATIZACION
13554652;;F;43;CHILENO;;X;"";"";15990;3;1;0;0;0;3;1;15990;TERMOVENTILADOR KIOTO NEGRO 2000W KTE-1028N;CLIMATIZACION
7027799;;F;71;CHILENO;;Silencioso;CALBUCO                       ;LOS LAGOS;59990;1;1;0;0;0;1;1;59990;ESTUFA ELEC. FIBRA DE CARBONO NSB120K5 SILVER;CLIMATIZACION
11075207;;F;56;CHILENO;;Boomers;N/D;N/D;609110;8;6;0;0;0;8;6;609110;Termoventilador 2000W Ht 2018;CLIMATIZACION
26843885;Soltero;M;57;NO INFORMA NACIONALIDAD;;Extranjero;N/D;N/D;15980;2;1;2;1;15980;0;0;0;CALIENTACAMA KIOTO ANALOGO 1 PLAZA KTC-1004;CLIMATIZACION
15219331;;F;39;CHILENO;;X;N/D;N/D;818160;13;10;12;7;508170;1;3;309990;CALIENTACAMA KIOTO ANALOGO 1 PLAZA KTC-1004;CLIMATIZACION
23024213;;M;40;ARGENTINO;;Extranjero;PROVIDENCIA                   ;METROPOLITANA;7990;1;1;1;1;7990;0;0;0;ESTUFA CUARZO KIOTO 800W KTE-011A;CLIMATIZACION
7522229;;F;64;CHILENO;;Boomers;NUNOA                         ;METROPOLITANA;212970;3;3;0;0;0;3;3;212970;ESTUFA GAS EH2500 5K NEGRO;CLIMATIZACION
15311367;;M;39;CHILENO;;X;COLBUN                        ;MAULE;17990;1;1;0;0;0;1;1;17990;ESTUFA ELECTRICA CUARZO KIOTO 1200W KTE 1033;CLIMATIZACION
70008500;;M;32;CHILENO;;Extranjero;CAUQUENES                     ;MAULE;835940;6;4;0;0;0;6;4;835940;ESTUFA ELECTRICA CUARZO KIOTO 1200W KTE 1033;CLIMATIZACION
25751925;;M;32;HAITIANO;;Extranjero;TALCA                         ;MAULE;625890;6;2;0;0;0;6;2;625890;ESTUFA A GAS CALMA 15 KG HELIUS;CLIMATIZACION
25208327;;M;33;HAITIANO;;Extranjero;LA CISTERNA                   ;METROPOLITANA;9990;1;1;0;0;0;1;1;9990;TERMOVENTILADOR KIOTO NEGRO 2000W KTE-1028N;CLIMATIZACION
27101542;Soltero;F;31;EXTRANJERO - NO INFORMA NACIONALIDAD;;Extranjero;PROVIDENCIA                   ;METROPOLITANA;9990;1;1;1;1;9990;0;0;0;TERMOVENTILADOR KIOTO BLANCO 2000W KTE-1028B;CLIMATIZACION
18676428;Soltero;F;27;CHILENO;;Millenial;PROVIDENCIA                   ;METROPOLITANA;34960;4;1;4;1;34960;0;0;0;TERMOVENTILADOR KIOTO BLANCO 2000W KTE-1028B;CLIMATIZACION
14323122;;M;45;CHILENO;;X;PROVIDENCIA                   ;METROPOLITANA;27990;1;1;0;0;0;1;1;27990;CALIENTACAMA KIOTO DIGITAL 2 PLAZAS KTC-1006;CLIMATIZACION
11921253;;M;50;CHILENO;;X;RIO BUENO                     ;LOS RIOS;180000;2;1;0;0;0;2;1;180000;ESTUFA VITTALE-40 15K;CLIMATIZACION
14398320;;M;44;CHILENO;;X;TALCA                         ;MAULE;98950;5;2;0;0;0;5;2;98950;TERMOVENTILADOR KIOTO BLANCO 2000W KTE-1028B;CLIMATIZACION
20281808;;M;21;CHILENO;;Z;PROVIDENCIA                   ;METROPOLITANA;153980;2;1;2;1;153980;0;0;0;ESTUFA PARAFINA KPM-23;CLIMATIZACION
12985320;;F;45;CHILENO;;X;ANGOL                         ;ARAUCANIA;245970;3;2;0;0;0;3;2;245970;TERMOVENTILADOR KIOTO NEGRO 2000W KTE-1028N;CLIMATIZACION
18811464;Casado;F;27;CHILENO;;Millenial;PROVIDENCIA                   ;METROPOLITANA;18220;2;1;0;0;0;2;1;18220;TERMOVENTILADOR KIOTO NEGRO 2000W KTE-1028N;CLIMATIZACION
20434691;;M;22;CHILENO;;Z;PROVIDENCIA                   ;METROPOLITANA;12980;2;1;2;1;12980;0;0;0;TERMOVENTILADOR KIOTO NEGRO 2000W KTE-1028N;CLIMATIZACION
17717607;;F;31;CHILENO;;Millenial;RETIRO                        ;MAULE;95990;3;1;0;0;0;3;1;95990;CHIMENEA ELECTRICA KIOTO 2000W KTE-1101;CLIMATIZACION
9697040;;F;59;CHILENO;;Boomers;QUELLON                       ;LOS LAGOS;129990;1;1;0;0;0;1;1;129990;ESTUFA PARAFINA KPM-3300;CLIMATIZACION
15543110;;M;38;CHILENO;;Millenial;PARRAL                        ;MAULE;14990;1;1;0;0;0;1;1;14990;CALIENTACAMA KIOTO ANALOGO 1 PLAZA KTC-1004;CLIMATIZACION
11254264;Casado;M;53;CHILENO;;X;N/D;N/D;399970;3;3;0;0;0;3;3;399970;ESTUFA A GAS UT GRX-6200 ET ROJA 15 KILOS;CLIMATIZACION
19559142;;F;25;CHILENO;;Z;N/D;N/D;9000;2;1;0;0;0;2;1;9000;TERMOVENTILADOR KIOTO BLANCO 2000W KTE-1028B;CLIMATIZACION
19036958;;F;27;CHILENO;;Z;LA CISTERNA                   ;METROPOLITANA;646920;8;4;7;3;506930;1;1;139990;CALIENTACAMA KIOTO DIGITAL 2 PLAZAS KTC-1006;CLIMATIZACION
25605247;Soltero;M;51;VENEZOLANO;;Extranjero;PROVIDENCIA                   ;METROPOLITANA;144980;2;2;2;2;144980;0;0;0;CALIENTACAMA KIOTO ANALOGO 1 PLAZA KTC-1004;CLIMATIZACION
15304342;;M;40;CHILENO;;X;PROVIDENCIA                   ;METROPOLITANA;9990;1;1;0;0;0;1;1;9990;TERMOVENTILADOR KIOTO BLANCO 2000W KTE-1028B;CLIMATIZACION
7754280;;M;71;CHILENO;;Silencioso;LA LIGUA                      ;VALPARAISO;135440;3;2;0;0;0;3;2;135440;ESTUFA ELECTRICA CUARZO KIOTO 1200W KTE 1033;CLIMATIZACION
20221742;;F;22;CHILENO;;Z;PROVIDENCIA                   ;METROPOLITANA;8990;1;1;1;1;8990;0;0;0;TERMOVENTILADOR KIOTO NEGRO 2000W KTE-1028N;CLIMATIZACION
14380912;;F;48;CHILENO;;X;QUILPUE                       ;VALPARAISO;19980;2;1;2;1;19980;0;0;0;TERMOVENTILADOR KIOTO BLANCO 2000W KTE-1028B;CLIMATIZACION
11016283;;F;57;CHILENO;;Boomers;TALCAHUANO                    ;BIO BIO;121250;6;4;0;0;0;6;4;121250;ESTUFA ELECTRICA CUARZO KIOTO 1200W KTE 1033;CLIMATIZACION
26663124;;M;35;COLOMBIANO;;Extranjero;CURICO                        ;MAULE;606940;6;4;0;0;0;6;4;606940;CALIENTACAMA KIOTO DIGITAL 2 PLAZAS KTC-1006;CLIMATIZACION
20502330;;M;21;CHILENO;;Z;"";"";29990;1;1;0;0;0;1;1;29990;CALIENTACAMA KIOTO DIGITAL 2 PLAZAS KTC-1006;CLIMATIZACION
11851669;;M;50;CHILENO;;X;PROVIDENCIA                   ;METROPOLITANA;94980;2;2;0;0;0;2;2;94980;CALIENTACAMA KIOTO ANALOGO 1 PLAZA KTC-1004;CLIMATIZACION
14299076;;F;47;CHILENO;;X;LOS ANGELES;BIO-BIO;12990;1;1;1;1;12990;0;0;0;CALIENTACAMA KIOTO ANALOGO 1 PLAZA KTC-1004;CLIMATIZACION
13842060;;F;41;CHILENO;;X;PARRAL                        ;MAULE;10990;1;1;0;0;0;1;1;10990;TERMOVENTILADOR KIOTO NEGRO 2000W KTE-1028N;CLIMATIZACION
13672674;Divorciado;F;42;CHILENO;;X;RENCA                         ;METROPOLITANA;172950;5;2;5;2;172950;0;0;0;CHIMENEA ELECTRICA KIOTO 2000W KTE-1101;CLIMATIZACION
17450345;;M;32;CHILENO;;Millenial;N/D;N/D;39980;2;1;0;0;0;2;1;39980;CALIENTACAMA KIOTO DIGITAL 2 PLAZAS KTC-1006;CLIMATIZACION
15404275;;M;40;CHILENO;;X;"";"";69990;1;1;0;0;0;1;1;69990;CHIMENEA ELECTRICA KIOTO 2000W KTE-1101;CLIMATIZACION
18826195;;M;28;CHILENO;;Millenial;CALAMA                        ;ANTOFAGASTA;41990;1;1;0;0;0;1;1;41990;Ventilador BOX 20 Metalico FE-45 20Â¿;CLIMATIZACION
15552696;;F;36;CHILENO;;Millenial;LONCOCHE                      ;ARAUCANIA;12990;1;1;1;1;12990;0;0;0;TERMOVENTILADOR KIOTO NEGRO 2000W KTE-1028N;CLIMATIZACION
11275664;;M;54;CHILENO;;X;GRANEROS                      ;L.G.B.OÂ´HIGGINS;39980;2;1;0;0;0;2;1;39980;CALIENTACAMA KIOTO DIGITAL 1 PLAZA KTC-1005;CLIMATIZACION
11364259;;F;53;CHILENO;;X;RETIRO                        ;MAULE;547289;8;4;0;0;0;8;4;547289;TERMOVENTILADOR CALMA IPX1 T2000;CLIMATIZACION
19017256;Soltero;F;27;CHILENO;;Z;PROVIDENCIA                   ;METROPOLITANA;19990;1;1;0;0;0;1;1;19990;TERMOVENTILADOR TH-FH30 BLANCO 1000W-2000W;CLIMATIZACION
13168828;;F;44;CHILENO;;X;PROVIDENCIA                   ;METROPOLITANA;39980;2;2;0;0;0;2;2;39980;ESTUFA ELECTRICA CUARZO KIOTO 1200W KTE 1033;CLIMATIZACION
13237037;;F;45;CHILENO;;X;PICHIDEGUA                    ;L.G.B.OÂ´HIGGINS;79980;2;1;0;0;0;2;1;79980;ESTUFA ELECTRICA CUARZO KC 220 ROJA;CLIMATIZACION
5165209;;F;79;CHILENO;;Silencioso;LINARES                       ;MAULE;328938;6;3;0;0;0;6;3;328938;ESTUFA FIAMMA PRO;CLIMATIZACION
12448153;Casado;F;49;CHILENO;;X;RENCA                         ;METROPOLITANA;8990;1;1;1;1;8990;0;0;0;TERMOVENTILADOR KIOTO NEGRO 2000W KTE-1028N;CLIMATIZACION
7875359;;F;63;CHILENO;;Boomers;SAN BERNARDO                  ;METROPOLITANA;149990;1;1;0;0;0;1;1;149990;ESTUFA GAS KGQ15N 15K NEGRO EUROPEA;CLIMATIZACION
8951312;;M;61;CHILENO;;Boomers;RENCA                         ;METROPOLITANA;9990;1;1;0;0;0;1;1;9990;ESTUFA CUARZO KIOTO 800W KTE-011A;CLIMATIZACION
24438729;;M;39;CHILENO;;Extranjero;COIHAIQUE                     ;AYSEN;491270;4;3;0;0;0;4;3;491270;TERMOVENTILADOR KIOTO NEGRO 2000W KTE-1028N;CLIMATIZACION
18625252;Soltero;M;28;CHILENO;;Millenial;PROVIDENCIA                   ;METROPOLITANA;81980;2;1;0;0;0;2;1;81980;CALIENTACAMAS MANUAL 3N SG-5011 2PL;CLIMATIZACION
11287275;;F;53;CHILENO;;X;LINARES                       ;MAULE;14990;1;1;0;0;0;1;1;14990;CALIENTACAMA KIOTO ANALOGO 1 PLAZA KTC-1004;CLIMATIZACION
13744849;Casado;M;41;CHILENO;INGENIERO EN MAQUINARIA;X;RENCA                         ;METROPOLITANA;41980;2;1;0;0;0;2;1;41980;TURBO CALEFACTOR VERT. TC-2100V BLANCO;CLIMATIZACION
10304128;;F;54;CHILENO;;Boomers;SAN CLEMENTE                  ;MAULE;119990;1;1;0;0;0;1;1;119990;ESTUFA GAS KG5 5K NEGRO EUROPEA;CLIMATIZACION
18087001;;M;30;CHILENO;;Millenial;PROVIDENCIA                   ;METROPOLITANA;193960;4;2;4;2;193960;0;0;0;CHIMENEA ELECTRICA KIOTO 2000W KTE-1101;CLIMATIZACION
12729939;;F;46;CHILENO;;X;SAN ANTONIO                   ;VALPARAISO;9990;1;1;0;0;0;1;1;9990;ESTUFA CUARZO KIOTO 800W KTE-011A;CLIMATIZACION
19548522;Soltero;F;25;CHILENO;;Z;PROVIDENCIA                   ;METROPOLITANA;9990;1;1;1;1;9990;0;0;0;TERMOVENTILADOR KIOTO BLANCO 2000W KTE-1028B;CLIMATIZACION
10959146;;F;54;CHILENO;;X;EL BOSQUE;METROPOLITANA;356950;5;3;0;0;0;5;3;356950;ESTUFA ELEC. FIBRA DE CARBONO NSB120K5 ROJA;CLIMATIZACION
10012962;;M;56;CHILENO;;Boomers;ILLAPEL                       ;COQUIMBO;160841;4;2;0;0;0;4;2;160841;ESTUFA GAS EH2500 5K NEGRO;CLIMATIZACION
6840799;Soltero;F;70;CHILENO;;Silencioso;PROVIDENCIA                   ;METROPOLITANA;14990;1;1;0;0;0;1;1;14990;CALIENTACAMA KIOTO ANALOGO 1 PLAZA KTC-1004;CLIMATIZACION
15597860;;F;38;CHILENO;;X;N/D;N/D;38980;2;2;0;0;0;2;2;38980;ESTUFA ELECTRICA CUARZO KIOTO 1200W KTE 1033;CLIMATIZACION
9946082;;F;58;CHILENO;;Boomers;RENCA                         ;METROPOLITANA;27990;1;1;1;1;27990;0;0;0;CALIENTACAMA KIOTO DIGITAL 2 PLAZAS KTC-1006;CLIMATIZACION
10464557;;M;53;CHILENO;;X;RENCA                         ;METROPOLITANA;10990;1;1;0;0;0;1;1;10990;TERMOVENTILADOR KIOTO NEGRO 2000W KTE-1028N;CLIMATIZACION
9209670;;M;61;CHILENO;;Boomers;RANCAGUA                      ;L.G.B.OÂ´HIGGINS;29990;1;1;0;0;0;1;1;29990;Calefactor Halogeno Ha-10T 1000W;CLIMATIZACION
12685388;;F;54;CHILENO;;X;EL BOSQUE                     ;METROPOLITANA;12990;1;1;0;0;0;1;1;12990;CALIENTACAMA KIOTO ANALOGO 1 PLAZA KTC-1004;CLIMATIZACION
13490156;;M;43;CHILENO;;X;LA PINTANA                    ;METROPOLITANA;28980;2;1;0;0;0;2;1;28980;ESTUFA ELECTRICA CUARZO KIOTO 1200W KTE 1033;CLIMATIZACION
18060687;Soltero;M;30;CHILENO;;Millenial;PROVIDENCIA                   ;METROPOLITANA;179990;1;1;1;1;179990;0;0;0;ESTUFA A GAS CALMA 15 KG HELIUS;CLIMATIZACION
13703852;Casado;M;43;CHILENO;;X;RENCA                         ;METROPOLITANA;29980;2;1;0;0;0;2;1;29980;CALIENTACAMA KIOTO ANALOGO 1 PLAZA KTC-1004;CLIMATIZACION
16168892;;F;36;CHILENO;;Millenial;PUENTE ALTO;METROPOLITANA;104980;2;2;0;0;0;2;2;104980;CHIMENEA ELECTRICA KIOTO 2000W KTE-1101;CLIMATIZACION
10400052;;F;52;CHILENO;;X;LOS ANDES                     ;VALPARAISO;44990;1;1;0;0;0;1;1;44990;TERMOVENTILADOR CERAMICO HTC 2013 OSCILANTE;CLIMATIZACION
16861577;;M;34;CHILENO;;Millenial;SAN RAMON                     ;METROPOLITANA;355630;4;3;0;0;0;4;3;355630;ESTUFA GAS KG5 5K NEGRO EUROPEA;CLIMATIZACION
18343144;;M;29;CHILENO;;Millenial;NATALES                       ;MAGALLANES;346460;4;3;1;1;99990;3;2;246470;ESTUFA GAS KGQ15N 15K NEGRO EUROPEA;CLIMATIZACION
8355215;;F;56;CHILENO;;Boomers;QUELLON                       ;LOS LAGOS;109960;4;3;0;0;0;4;3;109960;TERMOVENTILADOR KIOTO NEGRO 2000W KTE-1028N;CLIMATIZACION
19982463;;F;23;CHILENO;;Z;PROVIDENCIA                   ;METROPOLITANA;42970;3;2;2;1;36980;1;1;5990;TERMOVENTILADOR CERAMICO TH-CH40;CLIMATIZACION
10512786;;F;57;CHILENO;;Boomers;COLINA                        ;METROPOLITANA;120960;4;4;0;0;0;4;4;120960;ESTUFA CUARZO KIOTO 800W KTE-011A;CLIMATIZACION
9927163;;F;55;CHILENO;;Boomers;RENCA                         ;METROPOLITANA;8990;1;1;0;0;0;1;1;8990;TERMOVENTILADOR KIOTO NEGRO 2000W KTE-1028N;CLIMATIZACION
20311105;;F;22;CHILENO;;Z;PROVIDENCIA                   ;METROPOLITANA;54950;5;1;0;0;0;5;1;54950;CALIENTACAMAS ANALOGO BASICO 1PL;CLIMATIZACION
18873534;;M;27;CHILENO;;Millenial;PROVIDENCIA                   ;METROPOLITANA;18220;2;1;0;0;0;2;1;18220;TERMOVENTILADOR KIOTO NEGRO 2000W KTE-1028N;CLIMATIZACION
14484218;;F;48;CHILENO;;X;PUREN                         ;ARAUCANIA;215630;4;2;0;0;0;4;2;215630;ESTUFA GAS EH2500 5K NEGRO;CLIMATIZACION
6937055;;F;68;CHILENO;;Boomers;LLAILLAY                      ;VALPARAISO;18220;2;1;0;0;0;2;1;18220;TERMOVENTILADOR KIOTO BLANCO 2000W KTE-1028B;CLIMATIZACION
9749211;;F;57;CHILENO;;Boomers;RENCA                         ;METROPOLITANA;29980;2;1;0;0;0;2;1;29980;CALIENTACAMA KIOTO ANALOGO 1 PLAZA KTC-1004;CLIMATIZACION
19663439;;F;25;CHILENO;;Z;N/D;N/D;59980;2;1;0;0;0;2;1;59980;CALIENTACAMA KIOTO DIGITAL 2 PLAZAS KTC-1006;CLIMATIZACION
15331085;;F;40;CHILENO;;X;SAN BERNARDO;METROPOLITANA;30230;3;2;0;0;0;3;2;30230;TERMOVENTILADOR KIOTO BLANCO 2000W KTE-1028B;CLIMATIZACION
20377018;;F;22;CHILENO;;Z;PAINE;METROPOLITANA;29990;1;1;0;0;0;1;1;29990;CALIENTACAMA KIOTO DIGITAL 2 PLAZAS KTC-1006;CLIMATIZACION
13607627;;M;42;CHILENO;;X;PROVIDENCIA                   ;METROPOLITANA;16990;1;1;0;0;0;1;1;16990;CALIENTACAMA KIOTO DIGITAL 1 PLAZA KTC-1005;CLIMATIZACION
14037204;;M;41;CHILENO;;X;N/D;N/D;180822;4;2;0;0;0;4;2;180822;CHIMENEA ELECTRICA KIOTO 2000W KTE-1101;CLIMATIZACION
18412647;;F;28;CHILENO;;Millenial;COLINA                        ;METROPOLITANA;9990;1;1;0;0;0;1;1;9990;TERMOVENTILADOR KIOTO NEGRO 2000W KTE-1028N;CLIMATIZACION
10774558;;F;40;CHILENO;;Millenial;"";"";20000;2;1;0;0;0;2;1;20000;ESTUFA ELECTRICA CUARZO KIOTO 1200W KTE 1033;CLIMATIZACION
19005649;;F;28;CHILENO;;Millenial;CURICO                        ;MAULE;409440;6;4;4;2;377460;2;2;31980;CALIENTACAMA KIOTO DIGITAL 1 PLAZA KTC-1005;CLIMATIZACION
12612340;;M;47;CHILENO;;X;ALTO HOSPICIO;TARAPACA;169990;1;1;0;0;0;1;1;169990;ESTUFA A GAS CALMA 15 KG HELIUS;CLIMATIZACION
27066345;;M;45;PERUANO;;Extranjero;LA GRANJA;METROPOLITANA;96950;5;3;4;2;61960;1;1;34990;CALEFACTOR HALOGENO 1200W EEH-1210 GRIS;CLIMATIZACION
12607133;;M;47;CHILENO;;X;SAN JAVIER                    ;MAULE;29970;3;2;0;0;0;3;2;29970;TERMOVENTILADOR KIOTO NEGRO 2000W KTE-1028N;CLIMATIZACION
9138196;;F;62;CHILENO;;Boomers;LINARES                       ;MAULE;219980;2;2;0;0;0;2;2;219980;ESTUFA A GAS UT GRX-6200 ET ROJA 15 KILOS;CLIMATIZACION
5634968;;M;72;CHILENO;;Silencioso;PAINE                         ;METROPOLITANA;9990;1;1;0;0;0;1;1;9990;ESTUFA CUARZO KIOTO 800W KTE-011A;CLIMATIZACION
17845131;;F;30;CHILENO;;Millenial;PENCO;BIO-BIO;34990;1;1;1;1;34990;0;0;0;CALIENTACAMAS MANUAL 2N SG-5120D4 1PL;CLIMATIZACION
12991707;;M;46;CHILENO;;X;VALDIVIA                      ;LOS RIOS;9990;1;1;0;0;0;1;1;9990;TERMOVENTILADOR KIOTO NEGRO 2000W KTE-1028N;CLIMATIZACION
18688032;;F;28;CHILENO;;Millenial;OVALLE                        ;COQUIMBO;17990;1;1;0;0;0;1;1;17990;CALIENTACAMA KIOTO DIGITAL 1 PLAZA KTC-1005;CLIMATIZACION
8432524;;M;63;CHILENO;;Boomers;PARRAL                        ;MAULE;69970;3;5;0;0;0;3;5;69970;CALIENTACAMA KIOTO ANALOGO 1 PLAZA KTC-1004;CLIMATIZACION
9556411;;F;59;CHILENO;;Boomers;CURANILAHUE                   ;BIO BIO;106960;4;3;0;0;0;4;3;106960;TERMOVENTILADOR TH-FH30 BLANCO 1000W-2000W;CLIMATIZACION
6913127;;F;72;CHILENO;;Silencioso;PUERTO MONTT                  ;LOS LAGOS;212980;2;1;0;0;0;2;1;212980;ESTUFA KEROSENE 720+;CLIMATIZACION
8641563;;F;62;CHILENO;;Boomers;RENCA                         ;METROPOLITANA;19990;1;1;0;0;0;1;1;19990;CALIENTACAMA KIOTO DIGITAL 1 PLAZA KTC-1005;CLIMATIZACION
15723466;;F;38;CHILENO;;Millenial;PROVIDENCIA                   ;METROPOLITANA;101520;4;2;4;2;101520;0;0;0;TURBO CALEFACTOR VERT. TC-2100V BLANCO;CLIMATIZACION
26256273;;M;33;VENEZOLANO;;Extranjero;TALCA                         ;MAULE;149990;1;1;0;0;0;1;1;149990;ESTUFA GAS KGQ15N 15K NEGRO EUROPEA;CLIMATIZACION
9085346;;F;58;CHILENO;;Boomers;PROVIDENCIA                   ;METROPOLITANA;21990;1;1;0;0;0;1;1;21990;TERMOVENTILADOR OSCILANTE FH-120S BL;CLIMATIZACION
18291683;;M;29;CHILENO;;Millenial;PROVIDENCIA                   ;METROPOLITANA;857980;2;1;2;1;857980;0;0;0;CALEFACTOR PELLET HERA + CHARCOAL;CLIMATIZACION
11383385;Casado;F;53;CHILENO;;Silencioso;PROVIDENCIA                   ;METROPOLITANA;89970;3;1;0;0;0;3;1;89970;CALIENTACAMA KIOTO DIGITAL 2 PLAZAS KTC-1006;CLIMATIZACION
9716526;;F;57;CHILENO;;Boomers;CHANARAL                      ;ATACAMA;493950;5;3;0;0;0;5;3;493950;CALIENTACAMAS MANUAL 3N SG-5010 1PL;CLIMATIZACION
10158017;;F;58;CHILENO;;Boomers;LEBU                          ;BIO BIO;831800;6;3;3;1;735830;3;2;95970;TERMOVENTILADOR OSCILANTE FH-120S BL;CLIMATIZACION
18952220;Soltero;M;27;CHILENO;;Millenial;PROVIDENCIA                   ;METROPOLITANA;29980;2;1;0;0;0;2;1;29980;TURBO CALEFACTOR VERT. TC-2070V BLANCO;CLIMATIZACION
19616091;;F;25;CHILENO;;Z;"";"";187970;3;2;0;0;0;3;2;187970;TURBO CALEFACTOR VERT. TC-2070V BLANCO;CLIMATIZACION
15898024;Casado;F;38;CHILENO;TECNICO DE NIVEL SUPERIOR LABORATORISTA DENTAL;Millenial;RANCAGUA                      ;L.G.B.OÂ´HIGGINS;789970;3;2;0;0;0;3;2;789970;ESTUFA A GAS UT GRX-4200 15 KILOS;CLIMATIZACION
10275326;;F;57;CHILENO;;Boomers;ISLA DE MAIPO                 ;METROPOLITANA;116980;2;2;0;0;0;2;2;116980;CALIENTACAMA KIOTO DIGITAL 1 PLAZA KTC-1005;CLIMATIZACION
26663034;;F;30;EXTRANJERO - NO INFORMA NACIONALIDAD;;Extranjero;N/D;N/D;901890;10;3;10;3;901890;0;0;0;ESTUFA A GAS UT GRX-4200 15 KILOS;CLIMATIZACION
15313231;;M;39;CHILENO;;X;PROVIDENCIA                   ;METROPOLITANA;133980;2;1;2;1;133980;0;0;0;ESTUFA PARAFINA KPM-3300;CLIMATIZACION
19868021;;F;24;CHILENO;;Z;PROVIDENCIA                   ;METROPOLITANA;54990;1;1;0;0;0;1;1;54990;TERMOVENTILADOR CERAMICO TH-CH41 NG 1000W-2000W;CLIMATIZACION
18082590;;F;29;CHILENO;;Millenial;PUDAHUEL;METROPOLITANA;95140;6;1;0;0;0;6;1;95140;TURBO CALEFACTOR VERT. TC-2100V BLANCO;CLIMATIZACION
19312472;;F;26;CHILENO;;Z;N/D;N/D;34990;1;1;0;0;0;1;1;34990;CALIENTACAMAS ANALOGO BASICO 1PL;CLIMATIZACION
7431425;;M;66;CHILENO;;Boomers;PROVIDENCIA                   ;METROPOLITANA;179990;1;1;0;0;0;1;1;179990;ESTUFA VITTALE-40 15K;CLIMATIZACION
9347847;;M;56;CHILENO;;Boomers;CHILLAN                       ;BIO BIO;34990;1;1;0;0;0;1;1;34990;CALIENTACAMAS ANALOGO BASICO 1PL;CLIMATIZACION
14085954;;F;41;CHILENO;;X;LLANQUIHUE                    ;LOS LAGOS;235440;3;2;0;0;0;3;2;235440;TERMOVENTILADOR CERAMICO TH-CH41 NG 1000W-2000W;CLIMATIZACION
16802308;Casado;F;34;CHILENO;TECNICO DE NIVEL SUPERIOR EN ENFERMERIA;Millenial;PROVIDENCIA                   ;METROPOLITANA;18990;1;1;1;1;18990;0;0;0;CALEFACTOR HALOGENO 1200W EEH-1210 GRIS;CLIMATIZACION
9961524;;F;56;CHILENO;;Boomers;TALCAHUANO                    ;BIO BIO;64990;1;1;0;0;0;1;1;64990;ESTUFA ELEC. FIBRA DE CARBONO NSB120K5 ROJA;CLIMATIZACION
20927266;;M;20;CHILENO;;Silencioso;PROVIDENCIA                   ;METROPOLITANA;29160;2;1;0;0;0;2;1;29160;CALEFACTOR HALOGENO 1200W EEH-1210 GRIS;CLIMATIZACION
15548392;;M;39;CHILENO;;X;VALDIVIA                      ;LOS LAGOS;66980;2;2;0;0;0;2;2;66980;TERMOVENTILADOR CERAMICO TH-CH41 NG 1000W-2000W;CLIMATIZACION
10139131;;F;56;CHILENO;;Boomers;RENCA                         ;METROPOLITANA;29990;1;1;1;1;29990;0;0;0;CALIENTACAMA KIOTO DIGITAL 2 PLAZAS KTC-1006;CLIMATIZACION
18005360;Casado;M;30;CHILENO;MEDICO CIRUJANO;Millenial;PROVIDENCIA                   ;METROPOLITANA;37970;3;1;3;1;37970;0;0;0;TERMOVENTILADOR OSCILANTE FH-120S BL;CLIMATIZACION
13517355;;F;44;CHILENO;;X;RENCA                         ;METROPOLITANA;24990;1;1;0;0;0;1;1;24990;TERMOVENTILADOR NICROM VFH500 BL 2000W;CLIMATIZACION
18771876;Soltero;F;27;CHILENO;;Millenial;LAGO VERDE                    ;AYSEN;21990;1;1;0;0;0;1;1;21990;CALIENTACAMA KIOTO DIGITAL 1 PLAZA KTC-1005;CLIMATIZACION
20267734;;F;22;CHILENO;;Z;N/D;N/D;127610;5;3;2;1;127480;3;2;130;ESTUFA GAS EH5200 15K GRAFITO;CLIMATIZACION
13185886;;F;45;CHILENO;;X;SANTIAGO                      ;METROPOLITANA;44990;1;1;0;0;0;1;1;44990;VENTILADOR PEDESTAL16 PLG MODELO CPE 160 3 EN 1;CLIMATIZACION
7905580;;M;64;CHILENO;;Boomers;SAN JAVIER                    ;MAULE;24990;1;1;0;0;0;1;1;24990;VENTILADOR PEDESTAL KTP-1015;CLIMATIZACION
7238127;Casado;M;66;CHILENO;ELECTROMECANICO;Boomers;SAN RAMON                     ;METROPOLITANA;30970;3;2;3;2;30970;0;0;0;ESTUFA ELECTRICA CUARZO KIOTO 1200W KTE 1033;CLIMATIZACION
7715695;;F;62;CHILENO;;Boomers;ILLAPEL                       ;COQUIMBO;34980;2;1;0;0;0;2;1;34980;CALIENTACAMA KIOTO DIGITAL 2 PLAZAS KTC-1006;CLIMATIZACION
15046573;;F;40;CHILENO;;X;RENCA                         ;METROPOLITANA;83980;2;1;0;0;0;2;1;83980;VENTILADOR PEDESTAL16 PLG MODELO CPE 160 3 EN 1;CLIMATIZACION
10493916;;M;56;CHILENO;;Boomers;PANGUIPULLI                   ;LOS LAGOS;38990;1;1;0;0;0;1;1;38990;VENTILADOR PEDESTAL KTP-1015;CLIMATIZACION
15967793;;F;37;CHILENO;;Millenial;N/D;N/D;36990;1;1;0;0;0;1;1;36990;VENTILADOR PEDESTAL KTP-1015;CLIMATIZACION
6017166;Casado;F;72;CHILENO;PROFESOR;Silencioso;RENCA                         ;METROPOLITANA;22990;1;1;0;0;0;1;1;22990;Ventilador BOX 12 Plastico KF-12B3;CLIMATIZACION
11073414;;F;58;CHILENO;;Boomers;LONGAVI                       ;MAULE;34990;1;1;0;0;0;1;1;34990;VENTILADOR PEDESTAL KTP-1015;CLIMATIZACION
12064531;;M;49;CHILENO;;Silencioso;PROVIDENCIA                   ;METROPOLITANA;34990;1;1;0;0;0;1;1;34990;VENTILADOR POWER BREEZE (160T);CLIMATIZACION
12315766;Soltero;M;48;CHILENO;CONTADOR AUDITOR;Silencioso;PROVIDENCIA                   ;METROPOLITANA;29990;1;1;0;0;0;1;1;29990;VENTILADOR PEDESTAL KTP-1015;CLIMATIZACION
11697928;Casado;F;54;CHILENO;;X;PROVIDENCIA                   ;METROPOLITANA;39990;1;1;0;0;0;1;1;39990;VENTILADOR WIND BREEZE (160S);CLIMATIZACION
13497534;;F;43;CHILENO;;X;SAN BERNARDO                  ;METROPOLITANA;110330;5;3;0;0;0;5;3;110330;V-VENTILADOR SOBREMESA 12 AIROLITE;CLIMATIZACION
14379243;;F;44;CHILENO;;X;ILLAPEL                       ;COQUIMBO;79990;1;3;0;0;0;1;3;79990;A/C FRIO/CALOR PORTATIL 12000BTU;CLIMATIZACION
11176468;;F;55;CHILENO;;Boomers;CAUQUENES                     ;MAULE;68980;2;2;0;0;0;2;2;68980;VENTILADOR PEDESTAL KTP-1015;CLIMATIZACION
7725469;Viudo;M;67;CHILENO;;Boomers;PROVIDENCIA                   ;METROPOLITANA;109990;1;1;0;0;0;1;1;109990;ENFRIADOR DE AIRE CE IONIZER;CLIMATIZACION
9258062;;M;60;CHILENO;;Boomers;N/D;N/D;29990;1;1;0;0;0;1;1;29990;VENTILADOR PEDESTAL KTP-1015;CLIMATIZACION
9924328;;M;59;CHILENO;;Boomers;SAN JAVIER                    ;MAULE;44990;1;1;0;0;0;1;1;44990;VENTILADOR PEDESTAL16 PLG MODELO CPE 160 3 EN 1;CLIMATIZACION
17208120;;M;33;CHILENO;;Millenial;PROVIDENCIA                   ;METROPOLITANA;26990;1;1;0;0;0;1;1;26990;V-VENTILADOR PEDESTAL 16 AIROLITE;CLIMATIZACION
19762636;;M;24;CHILENO;;Z;TEMUCO                        ;ARAUCANIA;29990;1;1;1;1;29990;0;0;0;VENTILADOR INDUSTRIAL KTI-1013;CLIMATIZACION
25574359;;M;30;HAITIANO;;Extranjero;LOS ANDES                     ;VALPARAISO;19990;1;1;0;0;0;1;1;19990;VENTILADOR BOX NVB1210 12P;CLIMATIZACION
6399537;;M;70;CHILENO;;Silencioso;RENCA                         ;METROPOLITANA;99990;1;1;0;0;0;1;1;99990;VENTILADOR CALMA 18PLG CPE GUN METAL;CLIMATIZACION
17256738;Soltero;M;32;CHILENO;INGENIERO CONECTIVIDAD Y REDES;Millenial;PROVIDENCIA                   ;METROPOLITANA;319990;2;1;2;1;319990;0;0;0;A/C FRIO/CALOR PORTATIL 12000BTU;CLIMATIZACION
10917753;;F;54;CHILENO;;Boomers;MELIPILLA                     ;METROPOLITANA;389980;2;2;0;0;0;2;2;389980;A/C FRIO/CALOR PORTATI 9000BTU;CLIMATIZACION
15812060;;M;38;CHILENO;;Millenial;PROVIDENCIA                   ;METROPOLITANA;14990;1;1;0;0;0;1;1;14990;VENTILADOR TURBO NVB802EA 8P;CLIMATIZACION
14588107;;F;46;CHILENO;;X;PROVIDENCIA                   ;METROPOLITANA;24990;1;1;1;1;24990;0;0;0;VENTILADOR PEDESTAL KTP-1015;CLIMATIZACION
9798344;;F;59;CHILENO;;Boomers;LO PRADO                      ;METROPOLITANA;49990;1;3;0;0;0;1;3;49990;Ventilador BOX 20 Metalico FE-45 20Â¿;CLIMATIZACION
15308381;;M;39;CHILENO;;X;RENCA                         ;METROPOLITANA;34990;1;1;0;0;0;1;1;34990;VENTILADOR PEDESTAL KTP-1015;CLIMATIZACION
15071230;;F;38;CHILENO;;Millenial;N/D;N/D;61980;2;2;0;0;0;2;2;61980;VENTILADOR INDUSTRIAL KTI-1013;CLIMATIZACION
16711142;;M;34;CHILENO;;Millenial;PROVIDENCIA                   ;METROPOLITANA;51970;3;1;3;1;51970;0;0;0;VENTILADOR DE PEDESTAL F804;CLIMATIZACION
8782660;;F;61;CHILENO;;Boomers;LINARES                       ;MAULE;49990;3;1;0;0;0;3;1;49990;VENTILADOR PEDESTAL KTP-1015;CLIMATIZACION
14050273;;M;40;CHILENO;;X;PROVIDENCIA                   ;METROPOLITANA;34990;1;1;0;0;0;1;1;34990;VENTILADOR PEDESTAL KTP-1015;CLIMATIZACION
17497598;;F;31;CHILENO;;Millenial;TALCA                         ;MAULE;29990;1;1;0;0;0;1;1;29990;VENTILADOR PEDESTAL KTP-1015;CLIMATIZACION
11746164;;F;51;CHILENO;;X;CAUQUENES                     ;MAULE;355470;3;2;2;1;325480;1;1;29990;VENTILADOR PEDESTAL KTP-1015;CLIMATIZACION
6312730;;M;73;CHILENO;;Silencioso;PARRAL                        ;MAULE;114980;2;1;0;0;0;2;1;114980;VENTILADOR CALMA 18PLG CPE GUN METAL;CLIMATIZACION
14565522;;M;42;CHILENO;;X;RENCA                         ;METROPOLITANA;29990;1;1;0;0;0;1;1;29990;VENTILADOR PEDESTAL KTP-1016;CLIMATIZACION
7708110;;M;63;CHILENO;;Boomers;LINARES                       ;MAULE;305300;9;4;0;0;0;9;4;305300;VENTILADOR 18 PLG CP 18 GUN METAL C/ SOPORTE;CLIMATIZACION
20419328;;F;23;CHILENO;;Z;PROVIDENCIA                   ;METROPOLITANA;24990;1;1;0;0;0;1;1;24990;VENTILADOR PEDESTAL KTP-1015;CLIMATIZACION
15865236;;M;37;CHILENO;;Millenial;PROVIDENCIA                   ;METROPOLITANA;104060;3;2;0;0;0;3;2;104060;VENTILADOR PISO 20PLG CP 20 MULTIFLOW C/ SOP;CLIMATIZACION
6307665;;M;70;CHILENO;;Silencioso;RENCA                         ;METROPOLITANA;19990;1;1;0;0;0;1;1;19990;Ventilador Sobremesa Plastico KF 12D;CLIMATIZACION
8753316;;F;63;CHILENO;;Boomers;TALCA                         ;MAULE;24990;1;1;0;0;0;1;1;24990;VENTILADOR PEDESTAL KF-16P;CLIMATIZACION
12251798;;F;50;CHILENO;;X;PROVIDENCIA                   ;METROPOLITANA;27980;2;1;2;1;27980;0;0;0;VENTILADOR DE PEDESTAL F804;CLIMATIZACION
11267340;;F;54;CHILENO;;X;TEMUCO                        ;ARAUCANIA;29990;1;1;0;0;0;1;1;29990;VENTILADOR INDUSTRIAL KTI-1013;CLIMATIZACION
4735461;;M;80;CHILENO;;Silencioso;RENCA                         ;METROPOLITANA;79990;1;1;0;0;0;1;1;79990;VENTILADOR INDUSTRIAL PEDESTAL 20;CLIMATIZACION
15780887;Casado;F;38;CHILENO;;Millenial;PROVIDENCIA                   ;METROPOLITANA;339980;2;1;2;1;339980;0;0;0;CALEFACTOR BOSCA LIMIT 360;CLIMATIZACION
23091780;;F;40;COLOMBIANO;;Extranjero;LINARES                       ;MAULE;111960;4;1;0;0;0;4;1;111960;VENTILADOR PEDESTAL KF-16P;CLIMATIZACION
18868973;;F;28;CHILENO;;Millenial;PROVIDENCIA                   ;METROPOLITANA;43990;1;1;0;0;0;1;1;43990;VENTILADOR DE TORRE 361E;CLIMATIZACION
11580136;;F;51;CHILENO;;X;LOS ANGELES                   ;BIO BIO;47990;1;1;0;0;0;1;1;47990;VENTILADOR WIND BREEZE (160S);CLIMATIZACION
18815467;;M;27;CHILENO;;Millenial;"";"";34840;2;1;2;1;34840;0;0;0;VENTILADOR DE PEDESTAL F804;CLIMATIZACION
15982609;;F;37;CHILENO;;Millenial;PROVIDENCIA                   ;METROPOLITANA;16990;1;1;1;1;16990;0;0;0;Ventilador Sobremesa Plastico KF 12D;CLIMATIZACION
14499901;;M;40;CHILENO;;X;CERRO NAVIA                   ;METROPOLITANA;369990;2;1;2;1;369990;0;0;0;A/C FRIO/CALOR PORTATIL 12000BTU;CLIMATIZACION
24517989;;M;30;COLOMBIANO;;Extranjero;RANCAGUA                      ;L.G.B.OÂ´HIGGINS;39990;1;1;0;0;0;1;1;39990;V-VENTILADOR PEDESTAL 16 AIROLITE;CLIMATIZACION
18803307;;M;28;CHILENO;;Millenial;PROVIDENCIA                   ;METROPOLITANA;0;0;2;0;2;0;0;0;0;ESTUFA CUARZO KIOTO 800W KTE-011A;CLIMATIZACION
6048329;;F;70;CHILENO;;Silencioso;PROVIDENCIA                   ;METROPOLITANA;-8990;-1;1;0;0;0;-1;1;-8990;TERMOVENTILADOR KIOTO NEGRO 2000W KTE-1028N;CLIMATIZACION
12589737;Casado;F;47;CHILENO;ASISTENTE SOCIAL;X;RENCA                         ;METROPOLITANA;121920;5;1;5;1;121920;0;0;0;CALIENTACAMA KIOTO DIGITAL 2 PLAZAS KTC-1006;CLIMATIZACION
16481324;;F;35;CHILENO;;Millenial;PROVIDENCIA                   ;METROPOLITANA;-8990;-1;1;0;0;0;-1;1;-8990;TERMOVENTILADOR KIOTO NEGRO 2000W KTE-1028N;CLIMATIZACION
18728332;;M;28;CHILENO;;Millenial;TEMUCO                        ;ARAUCANIA;0;0;0;0;0;0;0;0;0;CALIENTACAMA KIOTO DIGITAL 1 PLAZA KTC-1005;CLIMATIZACION
20106749;;F;22;CHILENO;;Z;PROVIDENCIA                   ;METROPOLITANA;0;0;0;0;0;0;0;0;0;CALIENTACAMA KIOTO DIGITAL 1 PLAZA KTC-1005;CLIMATIZACION
11964319;;F;50;CHILENO;;X;N/D;N/D;0;0;0;0;0;0;0;0;0;CHIMENEA ELECTRICA KIOTO 2000W KTE-1101;CLIMATIZACION
6894042;;F;73;CHILENO;;Silencioso;PROVIDENCIA                   ;METROPOLITANA;0;0;0;0;0;0;0;0;0;ESTUFA INFRARROJA UT-IRH-S1500;CLIMATIZACION
13082438;;M;46;CHILENO;;X;SAN PEDRO DE LA PAZ           ;BIO BIO;0;0;0;0;0;0;0;0;0;CALIENTACAMA KIOTO DIGITAL 2 PLAZAS KTC-1006;CLIMATIZACION
13324227;;F;44;CHILENO;;X;PUERTO MONTT                  ;LOS LAGOS;0;0;0;0;0;0;0;0;0;CHIMENEA ELECTRICA KIOTO 2000W KTE-1101;CLIMATIZACION
13518160;;F;43;CHILENO;;X;PROVIDENCIA                   ;METROPOLITANA;0;0;0;0;0;0;0;0;0;CALIENTACAMA KIOTO DIGITAL 1 PLAZA KTC-1005;CLIMATIZACION
7667243;;M;59;CHILENO;;Boomers;RENCA                         ;METROPOLITANA;0;0;0;0;0;0;0;0;0;CALIENTACAMAS DIGITAL TIMER SG-5350 1PL;CLIMATIZACION
19459898;;F;25;CHILENO;;Z;LEBU                          ;BIO BIO;0;0;0;0;0;0;0;0;0;CHIMENEA ELECTRICA KIOTO 2000W KTE-1101;CLIMATIZACION
14557401;Casado;F;43;CHILENO;PROFESOR;X;CASTRO                        ;LOS LAGOS;0;0;0;0;0;0;0;0;0;ESTUFA INFRARROJA ELECTRICA KIOTO 1500W KTE-1045;CLIMATIZACION
19784072;;M;24;CHILENO;;Z;N/D;N/D;0;0;0;0;0;0;0;0;0;TERMOVENTILADOR KIOTO BLANCO 2000W KTE-1028B;CLIMATIZACION
12677215;;F;48;CHILENO;;X;PROVIDENCIA                   ;METROPOLITANA;0;0;0;0;0;0;0;0;0;TERMOVENTILADOR KIOTO BLANCO 2000W KTE-1028B;CLIMATIZACION
18079484;Soltero;M;30;CHILENO;;Millenial;PROVIDENCIA                   ;METROPOLITANA;0;0;0;0;0;0;0;0;0;ESTUFA ELECTRICA CUARZO KIOTO 1200W KTE 1033;CLIMATIZACION
14347038;;M;44;CHILENO;;X;CALBUCO                       ;LOS LAGOS;0;0;0;0;0;0;0;0;0;ESTUFA ELEC. FIBRA DE CARBONO NSB120K5 SILVER;CLIMATIZACION
26871866;;M;31;EXTRANJERO - NO INFORMA NACIONALIDAD;;Extranjero;SANTA CRUZ;O HIGGINS;0;0;0;0;0;0;0;0;0;MINI OLEOELECTRICA KIOTO 500W BLANCO KTE-1081B;CLIMATIZACION
18245715;Soltero;F;29;CHILENO;;Millenial;PROVIDENCIA                   ;METROPOLITANA;0;0;0;0;0;0;0;0;0;ESTUFA ELECTRICA CUARZO KIOTO 1200W KTE 1033;CLIMATIZACION
9467370;;F;54;CHILENO;;X;PROVIDENCIA                   ;METROPOLITANA;0;0;0;0;0;0;0;0;0;TERMOVENTILADOR KIOTO BLANCO 2000W KTE-1028B;CLIMATIZACION
15595995;;F;38;CHILENO;;Millenial;RENCA                         ;METROPOLITANA;0;0;0;0;0;0;0;0;0;ESTUFA CUARZO KIOTO 800W KTE-011A;CLIMATIZACION
20330405;;M;22;CHILENO;;Z;COLINA;METROPOLITANA;0;0;0;0;0;0;0;0;0;TERMOVENTILADOR TH-FH30 BLANCO 1000W-2000W;CLIMATIZACION
7658679;;M;64;CHILENO;;Boomers;PUDAHUEL                      ;METROPOLITANA;0;0;0;0;0;0;0;0;0;CALIENTACAMA KIOTO DIGITAL 2 PLAZAS KTC-1006;CLIMATIZACION
16413798;;F;35;CHILENO;;Millenial;PROVIDENCIA                   ;METROPOLITANA;0;0;0;0;0;0;0;0;0;KIT PELLET MURO ACERO;CLIMATIZACION
4789192;;F;78;CHILENO;;Silencioso;PROVIDENCIA                   ;METROPOLITANA;0;0;0;0;0;0;0;0;0;CONVECTOR ELECTRICO KIOTO 2000W KTE-1105;CLIMATIZACION
24141037;;F;58;COLOMBIANO;;Extranjero;N/D;N/D;0;0;0;0;0;0;0;0;0;CONVECTOR TH-CV51 BL 750W - 1250W - 2000W;CLIMATIZACION
17870361;;F;30;CHILENO;;Millenial;LOS ANGELES                   ;BIO BIO;0;0;0;0;0;0;0;0;0;CONVECTOR ELECTRICO KIOTO 2000W KTE-1105;CLIMATIZACION
18284521;;F;29;CHILENO;;Millenial;PUNTA ARENAS                  ;MAGALLANES;0;0;0;0;0;0;0;0;0;TERMOVENTILADOR KIOTO BLANCO 2000W KTE-1028B;CLIMATIZACION
9554568;;M;59;CHILENO;;Boomers;CURANILAHUE                   ;BIO BIO;0;0;0;0;0;0;0;0;0;ESTUFA INFRARROJA ELECTRICA KIOTO 1500W KTE-1045;CLIMATIZACION
19345711;;M;26;CHILENO;;Z;LINARES                       ;MAULE;0;0;0;0;0;0;0;0;0;CALIENTACAMA KIOTO DIGITAL 1 PLAZA KTC-1005;CLIMATIZACION
9204495;Casado;M;61;CHILENO;CONTADOR AUDITOR;Boomers;PROVIDENCIA                   ;METROPOLITANA;0;0;0;0;0;0;0;0;0;CONVECTOR TH-CV51 BL 750W - 1250W - 2000W;CLIMATIZACION
23088328;;F;53;PERUANO;;Extranjero;CONCHALI                      ;METROPOLITANA;0;0;0;0;0;0;0;0;0;ESTUFA ELEC. FIBRA DE CARBONO NSB120K5 ROJA;CLIMATIZACION
19147230;Soltero;M;27;CHILENO;PSICOLOGO;Z;PROVIDENCIA                   ;METROPOLITANA;0;0;0;0;0;0;0;0;0;TERMOVENTILADOR NICROM VFH500 BL 2000W;CLIMATIZACION
16599688;;M;35;CHILENO;;Silencioso;PROVIDENCIA                   ;METROPOLITANA;0;0;0;0;0;0;0;0;0;ESTUFA ELEC. CHIMENEA TH-FP70 NG 1000W-2000W;CLIMATIZACION
15880749;Soltero;F;38;CHILENO;;Silencioso;PROVIDENCIA                   ;METROPOLITANA;0;0;0;0;0;0;0;0;0;ESTUFA CUARZO KIOTO 800W KTE-011A;CLIMATIZACION
13543362;Casado;F;43;CHILENO;;X;RENCA                         ;METROPOLITANA;0;0;0;0;0;0;0;0;0;CALIENTACAMA KIOTO DIGITAL 2 PLAZAS KTC-1006;CLIMATIZACION
7569763;;F;66;CHILENO;;Boomers;PROVIDENCIA                   ;METROPOLITANA;0;0;0;0;0;0;0;0;0;CALIENTACAMA KIOTO DIGITAL 2 PLAZAS KTC-1006;CLIMATIZACION
17335428;Soltero;M;32;CHILENO;;Silencioso;PROVIDENCIA                   ;METROPOLITANA;0;0;0;0;0;0;0;0;0;KIT INSTALACION PLUS 5PULGADAS ACERO;CLIMATIZACION
19325593;Soltero;M;26;CHILENO;;Silencioso;PROVIDENCIA                   ;METROPOLITANA;0;0;0;0;0;0;0;0;0;CALIENTACAMA KIOTO ANALOGO 1 PLAZA KTC-1004;CLIMATIZACION
17529145;;F;31;CHILENO;;Millenial;PROVIDENCIA                   ;METROPOLITANA;0;0;0;0;0;0;0;0;0;CALIENTACAMA KIOTO DIGITAL 2 PLAZAS KTC-1006;CLIMATIZACION
12691507;;M;48;CHILENO;;X;PROVIDENCIA                   ;METROPOLITANA;0;0;0;0;0;0;0;0;0;MINI OLEOELECTRICA KIOTO 500W NEGRO KTE-1081N;CLIMATIZACION
19129012;Soltero;F;26;CHILENO;;Z;PROVIDENCIA                   ;METROPOLITANA;0;0;0;0;0;0;0;0;0;TERMOVENTILADOR KIOTO NEGRO 2000W KTE-1028N;CLIMATIZACION
14526698;;F;46;CHILENO;;X;RENCA                         ;METROPOLITANA;0;0;0;0;0;0;0;0;0;ESTUFA CUARZO KIOTO 800W KTE-011A;CLIMATIZACION
13339822;;M;43;CHILENO;;X;PROVIDENCIA                   ;METROPOLITANA;0;0;0;0;0;0;0;0;0;CHIMENEA ELECTRICA KIOTO 2000W KTE-1101;CLIMATIZACION
8893794;Casado;F;61;CHILENO;;Boomers;RENCA                         ;METROPOLITANA;0;0;0;0;0;0;0;0;0;TERMOVENTILADOR KIOTO BLANCO 2000W KTE-1028B;CLIMATIZACION
6132532;;F;72;CHILENO;;Silencioso;CURANILAHUE                   ;BIO BIO;0;0;0;0;0;0;0;0;0;TERMOVENTILADOR KIOTO NEGRO 2000W KTE-1028N;CLIMATIZACION
14394468;;M;44;CHILENO;;X;RENCA                         ;METROPOLITANA;0;0;0;0;0;0;0;0;0;ESTUFA FIBRA DE CARBONO KFC 90 - NEGRA ROJA;CLIMATIZACION
16372690;;M;36;CHILENO;;Millenial;PROVIDENCIA                   ;METROPOLITANA;0;0;0;0;0;0;0;0;0;ESTUFA CUARZO KIOTO 800W KTE-011A;CLIMATIZACION
14286022;;F;48;CHILENO;;X;PAINE                         ;METROPOLITANA;0;0;0;0;0;0;0;0;0;CALIENTACAMA KIOTO DIGITAL 2 PLAZAS KTC-1006;CLIMATIZACION
18373472;;F;28;CHILENO;;Millenial;ALTO HOSPICIO;TARAPACA;0;0;0;0;0;0;0;0;0;ESTUFA CUARZO KIOTO 800W KTE-011A;CLIMATIZACION
15412121;;M;40;CHILENO;;X;PROVIDENCIA                   ;METROPOLITANA;0;0;0;0;0;0;0;0;0;CHIMENEA ELECTRICA KIOTO 2000W KTE-1101;CLIMATIZACION
16418660;;F;36;CHILENO;;Millenial;N/D;N/D;0;0;0;0;0;0;0;0;0;ESTUFA CUARZO KIOTO 800W KTE-011A;CLIMATIZACION
7490398;;F;64;CHILENO;;Boomers;SANTIAGO                      ;METROPOLITANA;0;0;0;0;0;0;0;0;0;CALIENTACAMA KIOTO DIGITAL 1 PLAZA KTC-1005;CLIMATIZACION
18619535;Soltero;M;26;CHILENO;;Z;PROVIDENCIA                   ;METROPOLITANA;0;0;0;0;0;0;0;0;0;ESTUFA CUARZO KIOTO 800W KTE-011A;CLIMATIZACION
12038777;;M;53;CHILENO;;X;EL CARMEN                     ;BIO BIO;0;0;0;0;0;0;0;0;0;CALIENTACAMA KIOTO DIGITAL 2 PLAZAS KTC-1006;CLIMATIZACION
17098996;;F;33;CHILENO;;Millenial;PROVIDENCIA                   ;METROPOLITANA;0;0;0;0;0;0;0;0;0;TERMOVENTILADOR KIOTO BLANCO 2000W KTE-1028B;CLIMATIZACION
8388566;;M;63;CHILENO;;Silencioso;PROVIDENCIA                   ;METROPOLITANA;0;0;0;0;0;0;0;0;0;CALIENTACAMA KIOTO DIGITAL 1 PLAZA KTC-1005;CLIMATIZACION
7136875;;M;67;CHILENO;;Silencioso;PROVIDENCIA                   ;METROPOLITANA;0;0;0;0;0;0;0;0;0;ESTUFA INFRARROJA UT-IRH-S1500;CLIMATIZACION
10110230;;F;57;CHILENO;;Boomers;RENCA                         ;METROPOLITANA;0;0;0;0;0;0;0;0;0;CALIENTACAMAS DIGITAL TIMER SG-5350 1PL;CLIMATIZACION
16240653;;F;36;CHILENO;;Millenial;N/D;N/D;0;0;0;0;0;0;0;0;0;ESTUFA A GAS UT GRX-6200 ET ROJA 15 KILOS;CLIMATIZACION
8575253;;F;59;CHILENO;;Silencioso;PROVIDENCIA                   ;METROPOLITANA;0;0;0;0;0;0;0;0;0;KIT PELLET TECHO ACERO INOX;CLIMATIZACION
18008198;;M;33;CHILENO;;Millenial;N/D;N/D;0;0;0;0;0;0;0;0;0;CHIMENEA ELECTRICA ROBLE NEGRA;CLIMATIZACION
10509084;;M;56;CHILENO;;Boomers;RENCA                         ;METROPOLITANA;0;0;0;0;0;0;0;0;0;CALIENTACAMA KIOTO DIGITAL 2 PLAZAS KTC-1006;CLIMATIZACION
11830006;;F;51;CHILENO;;X;PROVIDENCIA                   ;METROPOLITANA;0;0;0;0;0;0;0;0;0;ESTUFA CUARZO KIOTO 800W KTE-011A;CLIMATIZACION
15909508;;F;37;CHILENO;;Millenial;PROVIDENCIA                   ;METROPOLITANA;0;0;0;0;0;0;0;0;0;CALIENTACAMA KIOTO ANALOGO 1 PLAZA KTC-1004;CLIMATIZACION
12165534;;F;48;CHILENO;;X;QUILPUE                       ;VALPARAISO;0;0;0;0;0;0;0;0;0;ESTUFA CUARZO KIOTO 800W KTE-011A;CLIMATIZACION
14039863;;F;40;CHILENO;;X;RIO NEGRO                     ;LOS LAGOS;0;0;0;0;0;0;0;0;0;TERMOVENTILADOR KIOTO NEGRO 2000W KTE-1028N;CLIMATIZACION
10464871;;F;53;CHILENO;;X;PROVIDENCIA                   ;METROPOLITANA;0;0;0;0;0;0;0;0;0;ESTUFA CUARZO KIOTO 800W KTE-011A;CLIMATIZACION
15934044;;F;36;CHILENO;;Millenial;PROVIDENCIA                   ;METROPOLITANA;0;0;0;0;0;0;0;0;0;CALIENTACAMA KIOTO DIGITAL 2 PLAZAS KTC-1006;CLIMATIZACION
18498474;;F;28;CHILENO;;Millenial;RENCA                         ;METROPOLITANA;0;0;0;0;0;0;0;0;0;ESTUFA ELECTRICA CUARZO KIOTO 1200W KTE 1033;CLIMATIZACION
8621340;;F;63;CHILENO;;Boomers;SAN FELIPE                    ;VALPARAISO;0;0;0;0;0;0;0;0;0;ESTUFA ELECTRICA CUARZO KIOTO 1200W KTE 1033;CLIMATIZACION
19816422;;M;24;CHILENO;;Silencioso;PROVIDENCIA                   ;METROPOLITANA;0;0;0;0;0;0;0;0;0;TERMOVENTILADOR KIOTO BLANCO 2000W KTE-1028B;CLIMATIZACION
12843945;;F;47;CHILENO;;X;SAN RAMON;METROPOLITANA;0;0;0;0;0;0;0;0;0;CALIENTACAMA KIOTO DIGITAL 1 PLAZA KTC-1005;CLIMATIZACION
17835176;;F;31;CHILENO;;Millenial;N/D;N/D;0;0;0;0;0;0;0;0;0;ESTUFA ELECTRICA CUARZO KIOTO 1200W KTE 1033;CLIMATIZACION
18980571;Soltero;M;27;CHILENO;;Silencioso;QUILPUE;VALPARAISO;0;0;0;0;0;0;0;0;0;ESTUFA CUARZO KIOTO 800W KTE-011A;CLIMATIZACION
19999456;;F;23;CHILENO;;Z;CURICO                        ;MAULE;0;0;0;0;0;0;0;0;0;TERMOVENTILADOR KIOTO NEGRO 2000W KTE-1028N;CLIMATIZACION
14664390;;M;47;ARGENTINO;;Extranjero;MAIPU                         ;METROPOLITANA;0;0;0;0;0;0;0;0;0;CONVECTOR KCH 2010F BL 2000W;CLIMATIZACION
19523172;Soltero;F;25;CHILENO;;Z;PROVIDENCIA                   ;METROPOLITANA;0;0;0;0;0;0;0;0;0;ESTUFA ELEC. RADIADOR TH-RFC50 800W-1600W-2000W;CLIMATIZACION
19249745;Soltero;M;26;CHILENO;;Silencioso;PROVIDENCIA                   ;METROPOLITANA;0;0;0;0;0;0;0;0;0;ESTUFA ELECTRICA CARBONO ECOHEATEH1000 1000W;CLIMATIZACION
14341989;;M;45;CHILENO;;X;SAN JAVIER                    ;MAULE;0;0;0;0;0;0;0;0;0;TERMOVENTILADOR CERAMICO TH-CH41 NG 1000W-2000W;CLIMATIZACION
6255480;Casado;F;70;CHILENO;;Silencioso;PROVIDENCIA                   ;METROPOLITANA;0;0;0;0;0;0;0;0;0;TERMOVENTILADOR NICROM VFH300 BL 1800W;CLIMATIZACION
5902815;Casado;M;70;CHILENO;PROFESOR;Silencioso;RENCA                         ;METROPOLITANA;0;0;0;0;0;0;0;0;0;CALEFACTOR LENA LIMIT380 CHARCOAL;CLIMATIZACION
11745576;;F;51;CHILENO;;X;LINARES                       ;MAULE;0;0;0;0;0;0;0;0;0;CALIENTACAMAS DIGITAL TIMER SG-5150 1PL;CLIMATIZACION
10037323;;F;53;CHILENO;;X;LOTA                          ;BIO BIO;0;0;0;0;0;0;0;0;0;TERMOVENTILADOR TH-FH30 BLANCO 1000W-2000W;CLIMATIZACION
19449905;;F;25;CHILENO;;Z;PROVIDENCIA                   ;METROPOLITANA;0;0;0;0;0;0;0;0;0;CALIENTACAMA KIOTO DIGITAL 1 PLAZA KTC-1005;CLIMATIZACION
18492514;;M;28;CHILENO;;Millenial;N/D;N/D;0;0;0;0;0;0;0;0;0;Calefactor Bosca a Lena Gold 500 Burdeo CERT.;CLIMATIZACION
15846671;;F;38;CHILENO;;Millenial;PROVIDENCIA                   ;METROPOLITANA;0;0;0;0;0;0;0;0;0;CHIMENEA ELECTRICA KIOTO 2000W KTE-1101;CLIMATIZACION
15363042;;M;40;CHILENO;;Silencioso;PROVIDENCIA                   ;METROPOLITANA;0;0;0;0;0;0;0;0;0;TERMOVENTILADOR CERAMICO TH-CH41 NG 1000W-2000W;CLIMATIZACION
20066784;;F;23;CHILENO;;Silencioso;PROVIDENCIA                   ;METROPOLITANA;0;0;0;0;0;0;0;0;0;CALIENTACAMA KIOTO ANALOGO 1 PLAZA KTC-1004;CLIMATIZACION
16536855;;F;35;CHILENO;;Millenial;LONGAVI                       ;MAULE;0;0;0;0;0;0;0;0;0;CALEFACTOR LENA ECO350 CHARCOAL;CLIMATIZACION
14162234;;F;40;CHILENO;;X;PROVIDENCIA                   ;METROPOLITANA;0;0;0;0;0;0;0;0;0;CALIENTACAMAS ANALOGO BASICO 2 PL;CLIMATIZACION
16416531;;M;35;CHILENO;;Silencioso;PROVIDENCIA                   ;METROPOLITANA;0;0;0;0;0;0;0;0;0;CALIENTACAMAS UFESA MATRIMONIAL CONFORTÂ  CMNÂ ;CLIMATIZACION
15061265;;M;39;CHILENO;;X;PROVIDENCIA                   ;METROPOLITANA;0;0;0;0;0;0;0;0;0;CALIENTACAMA KIOTO ANALOGO 1 PLAZA KTC-1004;CLIMATIZACION
9706510;;M;59;CHILENO;;Boomers;MAIPU                         ;METROPOLITANA;0;0;0;0;0;0;0;0;0;ESTUFA ELECTRICA CUARZO KIOTO 1200W KTE 1033;CLIMATIZACION
15368801;;F;39;CHILENO;;X;MAIPU                         ;METROPOLITANA;0;0;0;0;0;0;0;0;0;ESTUFA CUARZO KIOTO 800W KTE-011A;CLIMATIZACION
8443178;;F;62;CHILENO;;Boomers;N/D;N/D;0;0;0;0;0;0;0;0;0;ESTUFA ELECTRICA CUARZO KIOTO 1200W KTE 1033;CLIMATIZACION
7089784;;F;67;CHILENO;;Boomers;NUEVA IMPERIAL                ;ARAUCANIA;0;0;0;0;0;0;0;0;0;ESTUFA CUARZO KIOTO 800W KTE-011A;CLIMATIZACION
17302604;;M;32;CHILENO;;Millenial;PROVIDENCIA                   ;METROPOLITANA;0;0;0;0;0;0;0;0;0;CALEFACTOR INFRAROJO GR2800 R NEGRO;CLIMATIZACION
17680972;;F;30;CHILENO;;Millenial;PROVIDENCIA                   ;METROPOLITANA;0;0;0;0;0;0;0;0;0;ESTUFA PARAFINA KPM-23;CLIMATIZACION
17720906;;M;28;CHILENO;;Millenial;RENCA                         ;METROPOLITANA;0;0;0;0;0;0;0;0;0;TERMOVENTILADOR NICROM VFH300 BL 1800W;CLIMATIZACION
16649209;;M;35;CHILENO;;Millenial;ESTACION CENTRAL              ;METROPOLITANA;0;0;0;0;0;0;0;0;0;TERMOVENTILADOR NICROM VFH300 BL 1800W;CLIMATIZACION
6857238;Casado;F;72;CHILENO;;Silencioso;RENCA                         ;METROPOLITANA;0;0;0;0;0;0;0;0;0;ESTUFA VITTALE-40 15K;CLIMATIZACION
12937937;;M;46;CHILENO;;X;RENCA                         ;METROPOLITANA;0;0;0;0;0;0;0;0;0;CHIMENEA ELECTRICA KIOTO 2000W KTE-1101;CLIMATIZACION
11215374;;F;54;CHILENO;;Boomers;PROVIDENCIA                   ;METROPOLITANA;0;0;0;0;0;0;0;0;0;ESTUFA CUARZO KIOTO 800W KTE-011A;CLIMATIZACION
24155601;;F;31;COLOMBIANO;;Extranjero;N/D;N/D;0;0;0;0;0;0;0;0;0;TERMOVENTILADOR KIOTO BLANCO 2000W KTE-1028B;CLIMATIZACION
18480680;Soltero;M;29;CHILENO;ADMINISTRADOR PUBLICO;Millenial;PROVIDENCIA                   ;METROPOLITANA;0;0;0;0;0;0;0;0;0;CONVECTOR TURBO KCH 2000 BL;CLIMATIZACION
15231018;;M;39;CHILENO;;X;PROVIDENCIA                   ;METROPOLITANA;0;0;0;0;0;0;0;0;0;MINI OLEOELECTRICA KIOTO 500W BLANCO KTE-1081B;CLIMATIZACION
19778180;;M;24;CHILENO;;Z;PROVIDENCIA                   ;METROPOLITANA;0;0;0;0;0;0;0;0;0;TURBO CALEFACTOR VERT. TC-2100V BLANCO;CLIMATIZACION
14325199;Casado;F;45;CHILENO;AUXILIAR PARAMEDICO DE RADIOLOGIA LABORATORIO Y BANCO DE SANGRE;X;RENCA                         ;METROPOLITANA;0;0;0;0;0;0;0;0;0;VITTALE 8;CLIMATIZACION
16119785;;F;36;CHILENO;;Millenial;NATALES                       ;MAGALLANES;0;0;0;0;0;0;0;0;0;CALIENTACAMA KIOTO DIGITAL 1 PLAZA KTC-1005;CLIMATIZACION
18840950;;M;28;CHILENO;;Millenial;RENGO                         ;L.G.B.OÂ´HIGGINS;0;0;0;0;0;0;0;0;0;CALIENTACAMA KIOTO ANALOGO 1 PLAZA KTC-1004;CLIMATIZACION
11366652;;F;53;CHILENO;;X;PROVIDENCIA                   ;METROPOLITANA;0;0;0;0;0;0;0;0;0;TERMOVENTILADOR KIOTO NEGRO 2000W KTE-1028N;CLIMATIZACION
6622877;;F;68;CHILENO;;Boomers;LOS ANDES                     ;VALPARAISO;0;0;0;0;0;0;0;0;0;TERMOVENTILADOR KIOTO NEGRO 2000W KTE-1028N;CLIMATIZACION
10556650;Casado;M;57;CHILENO;;X;PROVIDENCIA                   ;METROPOLITANA;0;0;0;0;0;0;0;0;0;CONVECTOR VC 1800 1750 WATT GRIS/BLANCO;CLIMATIZACION
4209830;;M;81;CHILENO;;Silencioso;PROVIDENCIA                   ;METROPOLITANA;0;0;0;0;0;0;0;0;0;ESTUFA ELECTRICA CUARZO KIOTO 1200W KTE 1033;CLIMATIZACION
17873253;;F;31;CHILENO;;Silencioso;PROVIDENCIA                   ;METROPOLITANA;0;0;0;0;0;0;0;0;0;ESTUFA ELEC. INFRAROJA TH-IR61 NG 900W - 1800W;CLIMATIZACION
15957296;Casado;F;37;CHILENO;PROFESOR;Millenial;RENCA                         ;METROPOLITANA;0;0;0;0;0;0;0;0;0;TERMOVENTILADOR CERAMICO HTC 2013 OSCILANTE;CLIMATIZACION
19528851;;M;25;CHILENO;;Z;PROVIDENCIA                   ;METROPOLITANA;0;0;0;0;0;0;0;0;0;CALIENTACAMAS DIGITAL SUBLIME MAXI 1.5PL;CLIMATIZACION
12810398;;F;47;CHILENO;;X;RENCA                         ;METROPOLITANA;0;0;0;0;0;0;0;0;0;CALIENTACAMAS DIGITAL SUBLIME MAXI 1.5PL;CLIMATIZACION
9488879;;M;59;CHILENO;;Boomers;PROVIDENCIA                   ;METROPOLITANA;0;0;0;0;0;0;0;0;0;CALIENTACAMA KIOTO DIGITAL 2 PLAZAS KTC-1006;CLIMATIZACION
15121166;;F;35;CHILENO;;Millenial;NANCAGUA                      ;L.G.B.OÂ´HIGGINS;0;0;0;0;0;0;0;0;0;CALEFACTOR CUARZO 1600W EEH-1300 NEGRO;CLIMATIZACION
13575550;;M;42;CHILENO;;X;PROVIDENCIA                   ;METROPOLITANA;0;0;0;0;0;0;0;0;0;TERMOVENTILADOR KIOTO NEGRO 2000W KTE-1028N;CLIMATIZACION
11566111;;F;52;CHILENO;;X;N/D;N/D;0;0;0;0;0;0;0;0;0;CHIMENEA ELECTRICA KIOTO 2000W KTE-1101;CLIMATIZACION
16295404;;M;36;CHILENO;;Silencioso;PROVIDENCIA                   ;METROPOLITANA;0;0;0;0;0;0;0;0;0;ESTUFA ELECTRICA CUARZO KIOTO 1200W KTE 1033;CLIMATIZACION
25571667;;M;42;VENEZOLANO;;Extranjero;CONCEPCION                    ;BIO BIO;0;0;0;0;0;0;0;0;0;TERMOVENTILADOR KIOTO NEGRO 2000W KTE-1028N;CLIMATIZACION
5685341;;F;72;CHILENO;;Silencioso;MARIA PINTO                   ;METROPOLITANA;0;0;0;0;0;0;0;0;0;ESTUFA CUARZO KIOTO 800W KTE-011A;CLIMATIZACION
16812900;;F;34;CHILENO;;Silencioso;PROVIDENCIA                   ;METROPOLITANA;0;0;0;0;0;0;0;0;0;CONVECTOR ELECT. UT HMC-2000;CLIMATIZACION
12739118;;M;47;CHILENO;;X;PROVIDENCIA                   ;METROPOLITANA;0;0;0;0;0;0;0;0;0;ESTUFA VITTALE-40 15K;CLIMATIZACION
16275096;Casado;F;36;CHILENO;MEDICO CIRUJANO;Silencioso;PROVIDENCIA                   ;METROPOLITANA;0;0;0;0;0;0;0;0;0;MINI OLEOELECTRICA KIOTO 500W BLANCO KTE-1081B;CLIMATIZACION
16252134;;M;36;CHILENO;;Millenial;DONIHUE                       ;L.G.B.OÂ´HIGGINS;0;0;0;0;0;0;0;0;0;ESTUFA FOGUITA PRO;CLIMATIZACION
19852518;;F;24;CHILENO;;Z;PROVIDENCIA                   ;METROPOLITANA;0;0;0;0;0;0;0;0;0;KIT INSTALACION PLUS 6PULGADAS ACERO;CLIMATIZACION
15465839;;F;40;CHILENO;;X;RENCA                         ;METROPOLITANA;0;0;0;0;0;0;0;0;0;ESTUFA POTENZA;CLIMATIZACION
10779206;;F;45;CHILENO;;X;N/D;N/D;0;0;0;0;0;0;0;0;0;CALEFACTOR LENA SCANTEK380 GRIS CHARCOAL;CLIMATIZACION
18938334;;F;27;CHILENO;;Millenial;PROVIDENCIA                   ;METROPOLITANA;0;0;0;0;0;0;0;0;0;ESTUFA VITTALE-40 15K;CLIMATIZACION
17483789;;M;32;CHILENO;;Millenial;TOME                          ;BIO BIO;0;0;0;0;0;0;0;0;0;ESTUFA A GAS SUNNY CLASSIC WOOD 6600 NEGRA;CLIMATIZACION
6992270;Soltero;F;67;CHILENO;;Boomers;CALBUCO                       ;LOS LAGOS;0;0;0;0;0;0;0;0;0;TERMOVENTILADOR KIOTO NEGRO 2000W KTE-1028N;CLIMATIZACION
9389256;;F;59;CHILENO;;Boomers;PROVIDENCIA                   ;METROPOLITANA;0;0;0;0;0;0;0;0;0;Estufa a gas Kaly 15;CLIMATIZACION
17050820;Soltero;F;33;CHILENO;PROFESOR;Millenial;PROVIDENCIA                   ;METROPOLITANA;0;0;0;0;0;0;0;0;0;CALIENTACAMAS ANALOGO BASICO 1PL;CLIMATIZACION
17223466;;F;32;CHILENO;;Millenial;PROVIDENCIA                   ;METROPOLITANA;0;0;0;0;0;0;0;0;0;CALIENTACAMA KIOTO ANALOGO 1 PLAZA KTC-1004;CLIMATIZACION
15329418;Soltero;M;39;CHILENO;;X;PROVIDENCIA                   ;METROPOLITANA;0;0;0;0;0;0;0;0;0;ESTUFA ELECTRICA CUARZO KC 220 ROJA;CLIMATIZACION
14376073;;M;47;CHILENO;;Silencioso;PROVIDENCIA                   ;METROPOLITANA;0;0;0;0;0;0;0;0;0;ESTUFA GAS KGQ15N 15K NEGRO EUROPEA;CLIMATIZACION
19643963;Casado;F;25;CHILENO;;Z;PROVIDENCIA                   ;METROPOLITANA;0;0;0;0;0;0;0;0;0;CHIMENEA ELECTRICA KIOTO 2000W KTE-1101;CLIMATIZACION
8572391;;F;49;CHILENO;;Silencioso;PROVIDENCIA                   ;METROPOLITANA;0;0;0;0;0;0;0;0;0;ESTUFA FOGUITA PRO;CLIMATIZACION
12763459;Soltero;F;47;CHILENO;TECNICO JURIDICO;X;RENCA                         ;METROPOLITANA;0;0;0;0;0;0;0;0;0;KIT INSTALACION PLUS 6PULGADAS ACERO;CLIMATIZACION
12261735;Casado;F;50;CHILENO;ELECTRICIDAD INDUSTRIAL;X;RENCA                         ;METROPOLITANA;0;0;0;0;0;0;0;0;0;ESTUFA FOGUITA PRO;CLIMATIZACION
11896270;Soltero;M;51;CHILENO;;Silencioso;PROVIDENCIA                   ;METROPOLITANA;0;0;0;0;0;0;0;0;0;ESTUFA ELEC. CHIMENEA TH-FP100 CAFE 1000W-2000W;CLIMATIZACION
18274659;;M;29;CHILENO;;Millenial;SAN PEDRO DE LA PAZ           ;BIO BIO;0;0;0;0;0;0;0;0;0;KIT INSTALACION PLUS 5PULGADAS ACERO;CLIMATIZACION
16652699;;F;34;CHILENO;;Millenial;"";"";0;0;0;0;0;0;0;0;0;ESTUFA INFRARROJA ELECTRICA KIOTO 1500W KTE-1045;CLIMATIZACION
19613057;;M;25;CHILENO;;Z;PROVIDENCIA                   ;METROPOLITANA;0;0;0;0;0;0;0;0;0;ESTUFA A GAS UT GRX-4200 15 KILOS;CLIMATIZACION
18047902;;F;30;CHILENO;;Silencioso;PROVIDENCIA                   ;METROPOLITANA;0;0;0;0;0;0;0;0;0;ESTUFA A GAS UT GRX-4200 15 KILOS;CLIMATIZACION
9227331;;F;60;CHILENO;;Boomers;CHIMBARONGO                   ;L.G.B.OÂ´HIGGINS;0;0;0;0;0;0;0;0;0;TERMOVENTILADOR TH-FH31 BLANCO 1000W-2000W;CLIMATIZACION
19089119;Soltero;M;27;CHILENO;;Silencioso;PROVIDENCIA                   ;METROPOLITANA;0;0;0;0;0;0;0;0;0;CALEFACTOR PELLET ITALY8100 BLANCO;CLIMATIZACION
13977868;;F;41;CHILENO;;X;SALAMANCA                     ;COQUIMBO;0;0;0;0;0;0;0;0;0;CALEFACTOR LENA LIMIT350 CHARCOAL;CLIMATIZACION
16312315;;M;36;CHILENO;;Millenial;PROVIDENCIA                   ;METROPOLITANA;0;0;0;0;0;0;0;0;0;CHIMENEA ELECTRICA KIOTO 2000W KTE-1116;CLIMATIZACION
16282808;;M;35;CHILENO;;Millenial;CONCEPCION;BIO-BIO;0;0;0;0;0;0;0;0;0;CALEFACTOR INFRAROJO GR2800 ET;CLIMATIZACION
14045344;Soltero;M;40;CHILENO;;Silencioso;PROVIDENCIA                   ;METROPOLITANA;0;0;0;0;0;0;0;0;0;ESTUFA GAS KGQ15N 15K NEGRO EUROPEA;CLIMATIZACION
12327755;;M;48;CHILENO;;X;PROVIDENCIA                   ;METROPOLITANA;0;0;0;0;0;0;0;0;0;CALEFACTOR LENA ECO380 CHARCOAL;CLIMATIZACION
17460526;;M;32;CHILENO;;Millenial;PROVIDENCIA                   ;METROPOLITANA;0;0;0;0;0;0;0;0;0;CALEFACTOR LENA LIMIT350 CHARCOAL;CLIMATIZACION
15322651;Soltero;M;45;CHILENO;;X;RENCA                         ;METROPOLITANA;0;0;0;0;0;0;0;0;0;VENTILADOR SOBREMESA 12 METAL-MADERA;CLIMATIZACION
16295476;;M;36;CHILENO;;Millenial;CANETE                        ;BIO BIO;0;0;0;0;0;0;0;0;0;ESTUFA CUARZO KIOTO 800W KTE-011A;CLIMATIZACION
19879844;;F;24;CHILENO;;Z;N/D;N/D;0;0;0;0;0;0;0;0;0;V-VENTILADOR SOBREMESA 12 AIROLITE;CLIMATIZACION
9208393;;F;62;CHILENO;;Boomers;RENCA                         ;METROPOLITANA;0;0;0;0;0;0;0;0;0;Ventilador BOX 12 Plastico KF-12B3;CLIMATIZACION
9232396;;F;64;CHILENO;;Extranjero;VILLARICA                     ;ARAUCANIA;0;0;0;0;0;0;0;0;0;VENTILADOR POWER BREEZE (120T);CLIMATIZACION
15935772;Soltero;F;37;CHILENO;PERIODISTA;Millenial;RENCA                         ;METROPOLITANA;0;0;0;0;0;0;0;0;0;VENTILADOR VALORY VSF 9 SOBREMESA 9Â¿ 35W;CLIMATIZACION
17754851;;F;31;CHILENO;;Millenial;PORTEZUELO                    ;BIO BIO;0;0;0;0;0;0;0;0;0;VENTILADOR INDUSTRIAL KTI-1013;CLIMATIZACION
12140672;;F;46;CHILENO;;X;N/D;N/D;0;0;0;0;0;0;0;0;0;VENTILADOR WIND BREEZE PRO 2 EN 1;CLIMATIZACION
16291777;;M;36;CHILENO;;Millenial;MARIA PINTO                   ;METROPOLITANA;0;0;0;0;0;0;0;0;0;VENTILADOR PEDESTAL KTP-1015;CLIMATIZACION
14209569;;M;41;CHILENO;;X;PROVIDENCIA                   ;METROPOLITANA;0;0;0;0;0;0;0;0;0;V-AIRE PORTATIL MIDEA MPPD-12KHRN1;CLIMATIZACION
10707024;;M;43;CHILENO;;X;PROVIDENCIA                   ;METROPOLITANA;0;0;0;0;0;0;0;0;0;CALEFACTOR INFRAROJO GR2800 ET;CLIMATIZACION
18327370;;M;29;CHILENO;;Millenial;N/D;N/D;0;0;0;0;0;0;0;0;0;Enfriador KSH-16R;CLIMATIZACION
13570070;;F;43;CHILENO;;X;PROVIDENCIA                   ;METROPOLITANA;0;0;0;0;0;0;0;0;0;VENTILADOR PEDESTAL KTP-1015;CLIMATIZACION
9949366;;F;56;CHILENO;;Boomers;PUENTE ALTO                   ;METROPOLITANA;0;0;0;0;0;0;0;0;0;V-VENTILADOR SOBREMESA 16 AIROLITE;CLIMATIZACION
3958221;;M;82;CHILENO;;Silencioso;TALCAHUANO                    ;BIO BIO;0;0;0;0;0;0;0;0;0;Ventilador Sobremesa Plastico KF 9D;CLIMATIZACION
19934450;;F;24;CHILENO;;Z;PUERTO MONTT                  ;LOS LAGOS;0;0;0;0;0;0;0;0;0;TERMOVENTILADOR KIOTO BLANCO 2000W KTE-1028B;CLIMATIZACION
12230633;;M;49;CHILENO;;X;VILLA ALEMANA                 ;VALPARAISO;0;0;0;0;0;0;0;0;0;Enfriador KSH-16R;CLIMATIZACION
8098490;;F;63;CHILENO;;Boomers;SAN CARLOS                    ;BIO BIO;0;0;0;0;0;0;0;0;0;VENTILADOR THOMAS TH-08NM;CLIMATIZACION
16335636;;F;36;CHILENO;;Millenial;N/D;N/D;0;0;0;0;0;0;0;0;0;VENTILADOR INDUSTRIAL KTI-1013;CLIMATIZACION
10656015;;F;51;CHILENO;;X;RENCA                         ;METROPOLITANA;0;0;0;0;0;0;0;0;0;VENTILADOR PEDESTAL KF-16P;CLIMATIZACION
17563672;;F;32;CHILENO;;Millenial;PROVIDENCIA                   ;METROPOLITANA;0;0;0;0;0;0;0;0;0;VENTILADOR VALORY VSF 9 SOBREMESA 9Â¿ 35W;CLIMATIZACION
5651903;;F;84;CHILENO;;Silencioso;LOS ANGELES                   ;BIO BIO;0;0;0;0;0;0;0;0;0;VENTILADOR PEDESTAL KTP-1015;CLIMATIZACION
10183929;;F;54;CHILENO;;X;LONGAVI                       ;MAULE;0;0;0;0;0;0;0;0;0;Ventilador BOX 20 Metalico FE-45 20Â¿;CLIMATIZACION
11849974;;F;51;CHILENO;;X;BUIN                          ;METROPOLITANA;0;0;0;0;0;0;0;0;0;VENTILADOR PEDESTAL KTP-1016;CLIMATIZACION
6436798;Casado;F;75;CHILENO;;Silencioso;RENCA                         ;METROPOLITANA;0;0;0;0;0;0;0;0;0;CHIMENEA ELECTRICA KIOTO 2000W KTE-1101;CLIMATIZACION
18776737;;M;26;CHILENO;;Z;N/D;N/D;0;0;0;0;0;0;0;0;0;CHIMENEA ELECTRICA KIOTO 2000W KTE-1101;CLIMATIZACION
11767815;;F;51;CHILENO;;X;RENCA                         ;METROPOLITANA;0;0;0;0;0;0;0;0;0;ESTUFA ELECTRICA CUARZO KIOTO 1200W KTE 1033;CLIMATIZACION
17332983;;F;32;CHILENO;;Millenial;RENCA                         ;METROPOLITANA;0;0;0;0;0;0;0;0;0;CALIENTACAMA KIOTO ANALOGO 1 PLAZA KTC-1004;CLIMATIZACION
10895341;;F;51;CHILENO;;X;COIHAIQUE                     ;AYSEN;0;0;0;0;0;0;0;0;0;CALIENTACAMA KIOTO DIGITAL 2 PLAZAS KTC-1006;CLIMATIZACION
17886449;;F;30;CHILENO;;Millenial;PROVIDENCIA                   ;METROPOLITANA;56980;2;2;1;1;39990;1;1;16990;ALISADOR DE PELO S12A(220) Shine Therapy PALTA M;PERSONAL CARE
18360737;;F;29;CHILENO;;Millenial;PROVIDENCIA                   ;METROPOLITANA;43980;2;1;2;1;43980;0;0;0;ALISADOR DE PELO S12A(220) Shine Therapy PALTA M;PERSONAL CARE
4847327;;M;71;CHILENO;;Silencioso;RENCA                         ;METROPOLITANA;21990;1;1;0;0;0;1;1;21990;AFEITADORA SG-7210 NEGRO;PERSONAL CARE
10354377;;F;54;CHILENO;;Boomers;PROVIDENCIA                   ;METROPOLITANA;19990;1;3;0;2;0;1;1;19990;ALISADOR GAMA BELLA SHINE;PERSONAL CARE
11611124;;M;52;CHILENO;;X;ARICA                         ;TARAPACA;1346540;16;11;3;1;483080;13;10;863460;SECADOR DE PELO SG-3012 NEGRO;PERSONAL CARE
18673228;;F;28;CHILENO;;Millenial;"";"";19990;1;1;0;0;0;1;1;19990;SECADOR DE PELO SIEGEN SG-3035;PERSONAL CARE
6727207;;F;72;CHILENO;;Silencioso;CALERA                        ;VALPARAISO;17990;1;1;0;0;0;1;1;17990;SECADOR DIAMOND STD;PERSONAL CARE
14100533;;F;41;CHILENO;;X;N/D;N/D;107490;3;2;0;0;0;3;2;107490;ALISADOR DE PELO HP8321;PERSONAL CARE
15157342;;F;47;CHILENO;;X;RENCA                         ;METROPOLITANA;26990;1;1;0;0;0;1;1;26990;SECADOR DE PELO SE-3049C01 FUCSIA;PERSONAL CARE
8722376;;M;60;CHILENO;;Boomers;RENCA                         ;METROPOLITANA;26990;1;1;0;0;0;1;1;26990;SECADOR DE PELO SE-3049C01 FUCSIA;PERSONAL CARE
16664217;;F;35;CHILENO;;Millenial;ALTO BIO BIO;BIO BIO;46980;2;2;0;0;0;2;2;46980;CORTA PELO SG-8200;PERSONAL CARE
15437593;;M;40;CHILENO;;X;ANGOL                         ;ARAUCANIA;203980;2;2;0;0;0;2;2;203980;ALISADOR DE PELO SG-3540 MORADO MORADO;PERSONAL CARE
6273176;;M;72;CHILENO;;Silencioso;ARICA                         ;ARICA Y PARINACOTA;49990;1;1;0;0;0;1;1;49990;AFEITADORA GAMA SH 1527 WD;PERSONAL CARE
27202678;;M;28;CHILENO;;Extranjero;ESTACION CENTRAL;METROPOLITANA;82980;2;2;2;2;82980;0;0;0;ALISADOR CP14 Titanio D 4D Bvt.;PERSONAL CARE
7677632;;F;67;CHILENO;;Boomers;CHIMBARONGO                   ;L.G.B.OÂ´HIGGINS;103970;3;2;0;0;0;3;2;103970;COMBO SIEGEN AFEITADORA + MULTISTYLER SG-8440;PERSONAL CARE
17581362;;M;32;CHILENO;;Millenial;VICTORIA                      ;ARAUCANIA;16990;1;1;0;0;0;1;1;16990;SECADOR DE PELO SG-3025 SILVER;PERSONAL CARE
15598910;;F;38;CHILENO;;Millenial;TALCA                         ;MAULE;436940;6;5;4;3;396960;2;2;39980;SECADOR DE PELO SIEGEN SG-3035;PERSONAL CARE
9668243;;F;59;CHILENO;;Boomers;CAUQUENES                     ;MAULE;230672;4;2;1;1;179990;3;1;50682;AFEITADORA SPORT SH 886 BAT;PERSONAL CARE
27234470;;M;41;CHILENO;;X;"";"";15240;2;1;0;0;0;2;1;15240;SECADOR DIAMOND 3D TITAN KERATIN;PERSONAL CARE
11675229;;F;51;CHILENO;;X;COIHAIQUE                     ;AYSEN;127821;3;3;0;0;0;3;3;127821;CORTA PELO HC3505;PERSONAL CARE
10010368;;M;40;CHILENO;;X;SANTA CRUZ;O HIGGINS;31980;2;2;0;0;0;2;2;31980;KIT CORTABARBA MG3711;PERSONAL CARE
13980796;;M;40;CHILENO;;X;SAN FELIPE                    ;VALPARAISO;189970;3;2;2;1;164980;1;1;24990;SECADOR DE PELO SE-3049C01 FUCSIA;PERSONAL CARE
15818123;;F;37;CHILENO;;Millenial;PROVIDENCIA                   ;METROPOLITANA;12990;1;1;0;0;0;1;1;12990;SECADOR GAMA EOLIC MINI TRAVEL;PERSONAL CARE
12767954;Casado;F;47;CHILENO;SECRETARIA;X;RENCA                         ;METROPOLITANA;13990;1;1;0;0;0;1;1;13990;SECADOR DE PELO SG-3012C23 VERDE;PERSONAL CARE
6099817;;F;76;CHILENO;;Millenial;N/D;N/D;76220;4;2;0;0;0;4;2;76220;ALISADOR DE PELO S12A(220) Shine Therapy PALTA M;PERSONAL CARE
16253024;;F;36;CHILENO;;Millenial;RENGO                         ;L.G.B.OÂ´HIGGINS;24990;1;1;0;0;0;1;1;24990;SECADOR DE PELO SE-3049C01 FUCSIA;PERSONAL CARE
6085193;;F;71;CHILENO;;Silencioso;PROVIDENCIA                   ;METROPOLITANA;87440;3;2;0;0;0;3;2;87440;SECADOR TEMPO TITAN KERATIN;PERSONAL CARE
26642144;;F;26;VENEZOLANO;;Extranjero;SANTIAGO                      ;METROPOLITANA;38980;2;1;2;1;38980;0;0;0;ALISADOR REMIG. WET2 S27A (BV) R;PERSONAL CARE
16508823;;M;35;CHILENO;;Millenial;SAN ANTONIO                   ;VALPARAISO;17990;1;1;0;0;0;1;1;17990;SECADOR DIAMOND STD;PERSONAL CARE
22489173;;F;35;BOLIVIANO;;Extranjero;HUASCO                        ;ATACAMA;248960;4;4;1;1;159990;3;3;88970;CORTA PELO SG-8200;PERSONAL CARE
26447399;;M;51;VENEZOLANO;;Extranjero;CONCEPCION                    ;BIO BIO;12990;1;1;0;0;0;1;1;12990;SECADOR DE PELO SG-3012C29 MORADO;PERSONAL CARE
9437648;;M;59;CHILENO;;Extranjero;CAUQUENES                     ;MAULE;63970;3;3;0;0;0;3;3;63970;SECADOR DE PELO SE-3049C01 FUCSIA;PERSONAL CARE
7553631;;M;66;CHILENO;;Boomers;N/D;N/D;1945310;17;9;0;0;0;17;9;1945310;SECADOR DE PELO SG-3012 NEGRO;PERSONAL CARE
11278982;;F;54;CHILENO;;X;"";"";822910;9;7;4;3;518960;5;4;303950;Secador de Pelo 3000 Series Philips BHD340/10;PERSONAL CARE
24779874;;F;31;BOLIVIANO;;Extranjero;TOCOPILLA                     ;ANTOFAGASTA;24990;1;1;0;0;0;1;1;24990;ALISADOR SG-3510C11 VERDE;PERSONAL CARE
10542455;;F;53;CHILENO;;X;RENCA                         ;METROPOLITANA;39990;1;1;0;0;0;1;1;39990;COMBO GAMA SECADOR+ALISADOR+CEPILLO;PERSONAL CARE
12080879;;F;45;CHILENO;;X;VILLA ALEMANA                 ;VALPARAISO;335940;6;4;0;0;0;6;4;335940;COMBO GAMA SECADOR+ALISADOR+CEPILLO;PERSONAL CARE
18280120;;F;29;CHILENO;;Millenial;LOS ANGELES                   ;BIO BIO;531850;8;5;0;0;0;8;5;531850;AFEITADORA GAMA SH 1527 WD;PERSONAL CARE
19190811;;M;26;CHILENO;;Z;LEBU;BIO-BIO;49980;2;1;0;0;0;2;1;49980;AFEITADORA S1223/41 ELECTRICA;PERSONAL CARE
9617237;;F;59;CHILENO;;Boomers;N/D;N/D;201270;3;2;0;0;0;3;2;201270;SECADOR DIAMOND STD;PERSONAL CARE
16551310;;F;34;CHILENO;;Millenial;LOS ANDES                     ;VALPARAISO;877920;8;8;0;0;0;8;8;877920;SECADOR DE PELO SIEGEN SG-3035;PERSONAL CARE
13843907;;F;42;CHILENO;;X;LOS ANGELES                   ;BIO BIO;93910;4;2;0;0;0;4;2;93910;ALISADOR AQUA THERAPY LED;PERSONAL CARE
11122142;;M;54;CHILENO;;Boomers;PROVIDENCIA                   ;METROPOLITANA;20990;1;1;0;0;0;1;1;20990;SECADOR DE PELO SG-3043 DC CAFE 2200 WATTS;PERSONAL CARE
14054728;;M;41;CHILENO;;X;CONSTITUCION                  ;MAULE;60970;3;3;0;0;0;3;3;60970;SECADOR DE VIAJE REMINGTON D2400;PERSONAL CARE
20228485;;M;22;CHILENO;;Z;"";"";121980;2;2;1;1;99990;1;1;21990;SECADOR DE PELO SG-3043 DC CAFE 2200 WATTS;PERSONAL CARE
16392209;;M;35;CHILENO;;Millenial;RENCA                         ;METROPOLITANA;25840;3;1;0;0;0;3;1;25840;Secador de Pelo 3000 Series Philips BHD302/00;PERSONAL CARE
16932534;Soltero;M;33;CHILENO;;Millenial;"";"";14990;1;1;0;0;0;1;1;14990;CORTAPELO GAMA TITANIUM T827;PERSONAL CARE
6185730;;M;71;CHILENO;;Silencioso;RENCA                         ;METROPOLITANA;12990;1;1;0;0;0;1;1;12990;SECADOR GAMA EOLIC MINI TRAVEL;PERSONAL CARE
16878209;;F;33;CHILENO;;Millenial;PROVIDENCIA                   ;N/D;39990;1;1;0;0;0;1;1;39990;ALISADOR DE PELO S12A(220) Shine Therapy PALTA M;PERSONAL CARE
11318193;;F;54;CHILENO;;X;LA FLORIDA                    ;METROPOLITANA;34990;1;1;0;0;0;1;1;34990;AFEITADORA SG-7250 NEGRO;PERSONAL CARE
19550011;;F;24;CHILENO;;Z;PROVIDENCIA                   ;METROPOLITANA;13990;1;1;0;0;0;1;1;13990;SECADOR DE PELO SG-3012C29 MORADO;PERSONAL CARE
7090471;;F;67;CHILENO;;Boomers;LA SERENA                     ;COQUIMBO;45478;2;2;0;0;0;2;2;45478;AFEITADORA SH 1525 USB;PERSONAL CARE
8674255;;M;61;CHILENO;;Boomers;QUEMCHI                       ;LOS LAGOS;108080;3;2;0;0;0;3;2;108080;AFEITADORA SG-7210 NEGRO;PERSONAL CARE
16237278;Soltero;F;36;CHILENO;;Millenial;PROVIDENCIA                   ;METROPOLITANA;56980;2;2;0;0;0;2;2;56980;SECADOR TEMPO TITAN KERATIN;PERSONAL CARE
15243229;;F;45;CHILENO;;X;TEMUCO                        ;ARAUCANIA;232700;4;3;0;0;0;4;3;232700;SECADOR DE PELO SE-3049C01 FUCSIA;PERSONAL CARE
10730766;;M;52;CHILENO;;X;QUELLON                       ;LOS LAGOS;38990;1;1;0;0;0;1;1;38990;DEPILADORA SG-9004EX;PERSONAL CARE
18930844;Soltero;F;27;CHILENO;;Millenial;PROVIDENCIA                   ;METROPOLITANA;21990;1;1;1;1;21990;0;0;0;SECADOR GAMA BORA KERATION;PERSONAL CARE
6931699;;F;68;CHILENO;;Boomers;CARTAGENA                     ;VALPARAISO;53970;3;2;2;1;39980;1;1;13990;ALISADOR REMIG. WET2 S27A (BV) R;PERSONAL CARE
25985436;;F;57;EXTRANJERO - NO INFORMA NACIONALIDAD;;Extranjero;RECOLETA                      ;METROPOLITANA;289154;5;3;0;0;0;5;3;289154;CORTA PELO SG-8520;PERSONAL CARE
15583984;Soltero;F;39;CHILENO;;X;RENCA                         ;METROPOLITANA;26990;1;1;0;0;0;1;1;26990;SECADOR TEMPO TITAN KERATIN;PERSONAL CARE
11790142;;M;50;CHILENO;;X;PROVIDENCIA                   ;METROPOLITANA;26990;1;1;0;0;0;1;1;26990;SECADOR DE PELO SE-3049C01 FUCSIA;PERSONAL CARE
19404507;Soltero;F;26;CHILENO;;Z;NAVIDAD                       ;L.G.B.OÂ´HIGGINS;26990;1;1;0;0;0;1;1;26990;SECADOR TEMPO TITAN KERATIN;PERSONAL CARE
18983982;;F;27;CHILENO;;Millenial;MOSTAZAL;O HIGGINS;14990;1;1;0;0;0;1;1;14990;SECADOR DE PELO MISTRAL STD;PERSONAL CARE
10223737;;M;56;CHILENO;;Boomers;LEBU                          ;BIO BIO;227470;5;5;0;0;0;5;5;227470;SECADOR TEMPO TITAN KERATIN;PERSONAL CARE
24316684;;M;31;BOLIVIANO;;Extranjero;ANTOFAGASTA                   ;ANTOFAGASTA;219970;4;3;0;0;0;4;3;219970;SECADOR DE PELO SIEGEN SG-3035;PERSONAL CARE
17996994;Casado;F;30;CHILENO;PSICOLOGA;Millenial;PROVIDENCIA                   ;METROPOLITANA;42980;2;2;0;0;0;2;2;42980;SECADOR DE PELO SG-3012C29 MORADO;PERSONAL CARE
17322012;;F;32;CHILENO;;Millenial;PROVIDENCIA                   ;METROPOLITANA;519450;5;3;2;1;355480;3;2;163970;ALISADOR DE PELO I X-WIDE ST TITAN KERATIN GRIS;PERSONAL CARE
15662436;;M;38;CHILENO;;X;PROVIDENCIA                   ;METROPOLITANA;21990;1;1;0;0;0;1;1;21990;AFEITADORA SG-7210 NEGRO;PERSONAL CARE
11735471;;M;51;CHILENO;;X;QUILPUE                       ;VALPARAISO;19990;1;1;0;0;0;1;1;19990;AFEITADORA S1121/41 ELECTRICA;PERSONAL CARE
22352979;;F;45;PERUANO;;Extranjero;QUINTA NORMAL                 ;METROPOLITANA;29460;2;1;0;0;0;2;1;29460;SECADOR GAMA BRILLIAN AQUA;PERSONAL CARE
16204383;;M;36;CHILENO;;Millenial;N/D;N/D;296940;6;6;0;0;0;6;6;296940;CORTA PELO SPORT GCX 623 BVT;PERSONAL CARE
14346815;;F;43;CHILENO;;X;PUERTO MONTT                  ;LOS LAGOS;25140;2;1;0;0;0;2;1;25140;CORTA PELO SG-8520;PERSONAL CARE
17154082;;M;32;CHILENO;;Millenial;VICTORIA                      ;ARAUCANIA;136470;7;3;0;0;0;7;3;136470;AFEITADORA SG-7210 NEGRO;PERSONAL CARE
4891179;;M;78;CHILENO;;Silencioso;TUCAPEL                       ;BIO BIO;244970;3;2;0;0;0;3;2;244970;AFEITADORA SH 1525 USB;PERSONAL CARE
20096678;;M;22;CHILENO;;Z;N/D;N/D;33980;2;2;0;0;0;2;2;33980;CORTA PELO SG-8520;PERSONAL CARE
26270921;;M;37;VENEZOLANO;;Extranjero;ESTACION CENTRAL              ;METROPOLITANA;40000;2;1;0;0;0;2;1;40000;TRICOMBO SECADOR+ALISADOR+ONDULAD;PERSONAL CARE
16509528;;F;35;CHILENO;;Millenial;PROVIDENCIA                   ;METROPOLITANA;16990;1;1;0;0;0;1;1;16990;SECADOR DIAMOND STD;PERSONAL CARE
11442459;;F;53;CHILENO;;X;CAUQUENES                     ;MAULE;151230;3;2;1;1;129990;2;1;21240;Secador de Pelo 3000 Series Philips BHD340/10;PERSONAL CARE
19003034;Casado;F;27;CHILENO;;Z;PUENTE ALTO                   ;METROPOLITANA;90970;3;4;0;0;0;3;4;90970;SECADOR DE PELO SG-3049 NEGRO;PERSONAL CARE
19066905;;F;26;CHILENO;;Z;PROVIDENCIA                   ;METROPOLITANA;39980;2;2;0;0;0;2;2;39980;CORTA PELO SG-8520;PERSONAL CARE
12328164;;F;48;CHILENO;;X;SAN JAVIER                    ;MAULE;13990;1;1;0;0;0;1;1;13990;ONDULADOR DE PELO SG-2420 33MM;PERSONAL CARE
17039042;;M;33;CHILENO;;Millenial;VALLENAR;ATACAMA;20990;1;1;0;0;0;1;1;20990;KIT CORTABARBA MG3711;PERSONAL CARE
17410710;;F;32;CHILENO;;Millenial;PROVIDENCIA                   ;METROPOLITANA;128950;5;2;3;1;96970;2;1;31980;ALISADOR DE PELO SG-4651 ROJO;PERSONAL CARE
24670630;;M;58;ESPAÃOL;;Extranjero;COIHAIQUE                     ;AYSEN;57980;2;2;0;0;0;2;2;57980;CORTA PELO SG-8520;PERSONAL CARE
11271021;;F;53;CHILENO;;X;PROVIDENCIA                   ;METROPOLITANA;28990;1;2;0;0;0;1;2;28990;ALISADOR DE PELO SG-3512D1 ROSA;PERSONAL CARE
11983600;;M;50;CHILENO;;X;CONSTITUCION                  ;MAULE;219980;2;2;0;0;0;2;2;219980;COMBO SIEGEN AFEITADORA + MULTISTYLER SG-8440;PERSONAL CARE
15483770;Soltero;F;41;CHILENO;;Millenial;N/D;N/D;433940;6;3;2;1;139980;4;2;293960;SECADOR GAMA EOLIC MINI TRAVEL;PERSONAL CARE
23411042;;M;39;PERUANO;;Extranjero;COQUIMBO                      ;COQUIMBO;27140;2;1;0;0;0;2;1;27140;DEPILADORA GAMA ESSENCIAL;PERSONAL CARE
5247257;Soltero;F;75;CHILENO;;Silencioso;CHANARAL                      ;ATACAMA;41570;3;1;0;0;0;3;1;41570;ALISADOR DE PELO SG-3512D1 ROSA;PERSONAL CARE
14468008;;F;43;CHILENO;;X;QUILLOTA                      ;VALPARAISO;314960;4;3;2;1;101980;2;2;212980;AFEITADORA S1223/41 ELECTRICA;PERSONAL CARE
13789296;;F;42;CHILENO;;X;PROVIDENCIA                   ;METROPOLITANA;39980;2;2;0;0;0;2;2;39980;SECADOR DE PELO SG-3043 DC CAFE 2200 WATTS;PERSONAL CARE
20332998;;F;22;CHILENO;;Z;PROVIDENCIA                   ;METROPOLITANA;29990;1;1;1;1;29990;0;0;0;ALISADOR +SECADOR PELO;PERSONAL CARE
7525842;;M;67;CHILENO;;Boomers;IQUIQUE                       ;TARAPACA;652850;4;4;0;0;0;4;4;652850;AFEITADORA SG-7250 NEGRO;PERSONAL CARE
17787356;;M;31;CHILENO;;Millenial;"";"";174711;4;3;0;0;0;4;3;174711;CORTAPELO GAMA TITANIUM T827;PERSONAL CARE
25875853;;M;29;HAITIANO;;Extranjero;PUERTO MONTT                  ;LOS LAGOS;60710;2;1;0;0;0;2;1;60710;CORTA PELO HC-5850;PERSONAL CARE
14360220;;F;41;CHILENO;;X;COLINA;METROPOLITANA;83970;3;2;2;1;38980;1;1;44990;ALISADOR ELEGANCE LED KER;PERSONAL CARE
25755680;;M;31;EXTRANJERO - NO INFORMA NACIONALIDAD;;Extranjero;ANTOFAGASTA                   ;ANTOFAGASTA;29990;1;1;0;0;0;1;1;29990;COMBO GAMA SECADOR+ALISADOR+CEPILLO;PERSONAL CARE
18536162;;F;28;CHILENO;;Extranjero;N/D;N/D;30240;2;1;0;0;0;2;1;30240;COMBO GAMA SECADOR+ALISADOR+CEPILLO;PERSONAL CARE
19363268;Soltero;M;26;CHILENO;;Z;PROVIDENCIA                   ;METROPOLITANA;19990;1;1;0;0;0;1;1;19990;AFEITADORA SG-7210 NEGRO;PERSONAL CARE
10740230;;F;51;CHILENO;;X;INDEPENDENCIA                 ;METROPOLITANA;24990;1;1;0;0;0;1;1;24990;SECADOR DE PELO SE-3049C01 FUCSIA;PERSONAL CARE
13762766;;M;42;CHILENO;;X;LA LIGUA                      ;VALPARAISO;33980;2;1;0;0;0;2;1;33980;SECADOR GAMA BRILLIAN AQUA;PERSONAL CARE
18127865;;M;29;CHILENO;;Millenial;"";"";25000;2;1;0;0;0;2;1;25000;CORTA PELO SG-8520;PERSONAL CARE
19975481;;F;23;CHILENO;;Z;SAN ANTONIO;VALPARAISO;35970;3;1;3;1;35970;0;0;0;ONDULADOR GAMA 33MM TURMALINA;PERSONAL CARE
7559018;;M;63;CHILENO;;Boomers;SAN ANTONIO                   ;VALPARAISO;12990;1;1;0;0;0;1;1;12990;CORTAPELO GAMA MG 566;PERSONAL CARE
16628906;;F;34;CHILENO;;Millenial;MAIPU                         ;METROPOLITANA;232220;4;2;0;0;0;4;2;232220;ALISADOR +SECADOR PELO;PERSONAL CARE
14184784;;F;41;CHILENO;;X;"";"";19990;1;1;0;0;0;1;1;19990;SECADOR DE PELO SIEGEN SG-3035;PERSONAL CARE
19131680;;F;26;CHILENO;;Z;SAN FELIPE;VALPARAISO;59552;3;1;0;0;0;3;1;59552;ALISADOR ELEGANCE LED BLOOM OE;PERSONAL CARE
18651559;;F;27;CHILENO;;Z;CABILDO;VALPARAISO;40990;1;1;0;0;0;1;1;40990;ALISADOR REMIG. WET2 S27A (BV) R;PERSONAL CARE
7557998;;M;65;CHILENO;;Boomers;TALCAHUANO                    ;BIO BIO;375203;7;4;2;1;125840;5;3;249363;COMBO GAMA SECADOR+ALISADOR+CEPILLO;PERSONAL CARE
13387554;;F;43;CHILENO;;X;LOS ANGELES                   ;BIO BIO;270160;5;4;0;0;0;5;4;270160;ALISADOR AQUA THERAPY LED;PERSONAL CARE
12659295;;M;48;CHILENO;;Millenial;"";"";64990;1;1;0;0;0;1;1;64990;ALISADOR CP14 Titanio D 4D Bvt.;PERSONAL CARE
19255520;Soltero;F;26;CHILENO;;Z;CONSTITUCION                  ;MAULE;560920;6;2;6;2;560920;0;0;0;SECADOR GAMA BORA KERATION;PERSONAL CARE
17160297;;F;33;CHILENO;;Millenial;PUENTE ALTO                   ;METROPOLITANA;7990;1;1;0;0;0;1;1;7990;SECADOR PHILIPS BHC010;PERSONAL CARE
13092255;;M;46;CHILENO;;X;N/D;N/D;250850;4;3;2;1;175980;2;2;74870;AFEITADORA S1121/41 ELECTRICA;PERSONAL CARE
11698503;;F;51;CHILENO;;X;RENCA                         ;METROPOLITANA;26990;1;1;0;0;0;1;1;26990;SECADOR DE PELO SG-3049 NEGRO;PERSONAL CARE
12751901;;F;50;CHILENO;;X;OSORNO                        ;LOS LAGOS;79130;3;2;0;0;0;3;2;79130;Pack depiladoras HP6306/00 + BRE225/00;PERSONAL CARE
18549529;;F;28;CHILENO;;Millenial;QUELLON                       ;LOS LAGOS;36990;2;1;0;0;0;2;1;36990;TRICOMBO SECADOR+ALISADOR+ONDULADOR;PERSONAL CARE
16293120;;F;36;CHILENO;;Millenial;N/D;N/D;347960;4;4;0;0;0;4;4;347960;ALISADOR DE PELO S6300 GRIS;PERSONAL CARE
12593907;;F;48;CHILENO;;X;RENCA                         ;METROPOLITANA;16990;1;1;0;0;0;1;1;16990;ALISADOR DE PELO SG-3510 FUCSIA;PERSONAL CARE
17034317;Soltero;F;33;CHILENO;KINESIOLOGO;Millenial;ILLAPEL                       ;COQUIMBO;34990;1;1;0;0;0;1;1;34990;DEPILADORA OASIS SENSATION;PERSONAL CARE
18110082;;F;30;CHILENO;;Millenial;INDEPENDENCIA                 ;METROPOLITANA;343980;2;2;0;0;0;2;2;343980;ALISADOR DE PELO SG-3540 MORADO MORADO;PERSONAL CARE
7991323;;F;63;CHILENO;;Boomers;ANCUD                         ;LOS LAGOS;24990;1;1;0;0;0;1;1;24990;ALISADOR DE PELO SG-3512D1 ROSA;PERSONAL CARE
19518644;;F;25;CHILENO;;Z;PROVIDENCIA                   ;METROPOLITANA;14990;1;1;0;0;0;1;1;14990;CORTAPELO GAMA TITANIUM T827;PERSONAL CARE
11135867;;F;54;CHILENO;;Boomers;ILLAPEL                       ;COQUIMBO;37980;2;2;0;0;0;2;2;37980;SECADOR DE PELO SG-3043 DC CAFE 2200 WATTS;PERSONAL CARE
12030117;;M;53;CHILENO;;Silencioso;PROVIDENCIA                   ;METROPOLITANA;19990;1;1;0;0;0;1;1;19990;Secador de Pelo 3000 Series Philips BHD340/10;PERSONAL CARE
8283847;;M;64;CHILENO;;Boomers;RENCA                         ;METROPOLITANA;16990;1;1;0;0;0;1;1;16990;CORTAPELO GAMA MG 566;PERSONAL CARE
8704976;;M;59;CHILENO;;Boomers;QUILLOTA                      ;VALPARAISO;44990;1;1;0;0;0;1;1;44990;DEPILADORA 3170 BRAUN;PERSONAL CARE
20186843;;F;23;CHILENO;;Z;PUENTE ALTO                   ;METROPOLITANA;85711;7;2;0;0;0;7;2;85711;ALISADOR ELEGANCE LED BLOOM OE;PERSONAL CARE
5951727;;M;75;CHILENO;;Silencioso;RENCA                         ;METROPOLITANA;53410;2;1;0;0;0;2;1;53410;AFEITADORA SG-7250 NEGRO;PERSONAL CARE
13163674;;M;44;CHILENO;;X;PUERTO VARAS                  ;LOS LAGOS;21990;1;1;0;0;0;1;1;21990;DEPILADORA BRE225/00;PERSONAL CARE
11961378;;M;53;CHILENO;;X;CALERA                        ;VALPARAISO;286083;2;2;0;0;0;2;2;286083;AFEITADORA SPORT SH 886 BAT;PERSONAL CARE
15420908;;F;40;CHILENO;;X;PARRAL                        ;MAULE;13990;1;1;0;0;0;1;1;13990;SECADOR DE PELO SG-3012 NEGRO;PERSONAL CARE
13351729;;M;44;CHILENO;;X;CURICO                        ;MAULE;24990;1;1;0;0;0;1;1;24990;CORTAPELOS GM 596;PERSONAL CARE
19392131;;M;25;CHILENO;;Z;PROVIDENCIA                   ;METROPOLITANA;13990;1;1;0;0;0;1;1;13990;ONDULADOR DE PELO SG-2420 33MM;PERSONAL CARE
12395234;;F;49;CHILENO;;X;CALAMA                        ;ANTOFAGASTA;57970;3;3;0;0;0;3;3;57970;ALISADOR MATCHA;PERSONAL CARE
14333259;;M;45;CHILENO;;X;ANGOL                         ;ARAUCANIA;311980;2;2;0;0;0;2;2;311980;SECADOR DE PELO SIEGEN SG-3035;PERSONAL CARE
17618979;;F;29;CHILENO;;Millenial;HIJUELAS;VALPARAISO;482950;5;3;5;3;482950;0;0;0;COMBO SIEGEN AFEITADORA + MULTISTYLER SG-8440;PERSONAL CARE
10315924;;M;56;CHILENO;;Boomers;CURICO                        ;MAULE;9990;1;1;0;0;0;1;1;9990;SECADOR DE PELO SG-3012 NEGRO;PERSONAL CARE
18258783;;F;29;CHILENO;;Millenial;SAN FELIPE                    ;VALPARAISO;19990;1;1;0;0;0;1;1;19990;SECADOR DE PELO SIEGEN SG-3035;PERSONAL CARE
17123723;;M;33;CHILENO;;Millenial;RENCA                         ;METROPOLITANA;31980;2;2;0;0;0;2;2;31980;ALISADOR +SECADOR PELO;PERSONAL CARE
10036332;;F;52;CHILENO;;X;N/D;N/D;329950;8;4;1;1;24990;7;3;304960;SECADOR GAMA BORA KERATION;PERSONAL CARE
15441198;;M;40;CHILENO;;X;N/D;N/D;245100;6;5;0;0;0;6;5;245100;AFEITADORA SG-7250 NEGRO;PERSONAL CARE
13407455;Soltero;M;43;CHILENO;;X;PROVIDENCIA                   ;METROPOLITANA;38980;2;2;0;0;0;2;2;38980;CORTAPELOS GM 596;PERSONAL CARE
19151430;;F;26;CHILENO;;Z;PROVIDENCIA                   ;METROPOLITANA;34990;1;1;0;0;0;1;1;34990;AFEITADORA SH 887 WD BAT;PERSONAL CARE
17009212;;F;33;CHILENO;;Millenial;N/D;N/D;173980;2;2;0;0;0;2;2;173980;ONDULADOR DE PELO SG-2420 33MM;PERSONAL CARE
20032545;;F;23;CHILENO;;Z;PROVIDENCIA                   ;METROPOLITANA;24990;1;1;0;0;0;1;1;24990;SECADOR DE PELO SG-3051;PERSONAL CARE
18184204;Soltero;M;29;CHILENO;INGENIERO GEOMENSOR;Silencioso;PROVIDENCIA                   ;METROPOLITANA;14990;1;1;0;0;0;1;1;14990;CORTAPELO GAMA TITANIUM T827;PERSONAL CARE
21581484;;F;35;CHILENO;;Extranjero;PROVIDENCIA                   ;METROPOLITANA;41980;2;1;0;0;0;2;1;41980;SECADOR DE PELO SG-3051;PERSONAL CARE
17347489;;F;32;CHILENO;;Millenial;LAJA                          ;BIO BIO;55980;2;2;0;0;0;2;2;55980;TRICOMBO SECADOR+ALISADOR+ONDULADOR;PERSONAL CARE
14519010;;F;46;CHILENO;;X;NAVIDAD                       ;L.G.B.OÂ´HIGGINS;623480;8;4;8;4;623480;0;0;0;DEPILADORA IPL Allevia;PERSONAL CARE
26480305;;M;49;VENEZOLANO;;Extranjero;"";"";26990;1;1;0;0;0;1;1;26990;AFEITADORA S1121/41 ELECTRICA;PERSONAL CARE
12865750;;F;47;CHILENO;;X;N/D;N/D;126320;5;3;0;0;0;5;3;126320;SECADOR DE PELO SG-3012 NEGRO;PERSONAL CARE
16033488;;M;37;CHILENO;;Millenial;DIEGO DE ALMAGRO              ;ATACAMA;16990;1;1;0;0;0;1;1;16990;SECADOR GAMA BRILLIAN AQUA;PERSONAL CARE
11045341;;F;56;CHILENO;;Boomers;TALCA                         ;MAULE;119510;3;2;0;0;0;3;2;119510;DEPILADORA IPL MAGNA PK;PERSONAL CARE
13408855;;F;44;CHILENO;;X;CASTRO                        ;LOS LAGOS;34990;1;1;0;0;0;1;1;34990;ALISADOR ELEGANCE LED KER;PERSONAL CARE
15111748;;F;39;CHILENO;;X;PROVIDENCIA                   ;METROPOLITANA;10990;1;1;0;0;0;1;1;10990;SECADOR GAMA EOLIC MINI TRAVEL;PERSONAL CARE
16432545;;M;35;CHILENO;;Millenial;BUIN                          ;METROPOLITANA;44990;1;1;0;0;0;1;1;44990;AFEITADORA S1323/41 ELECTRICA;PERSONAL CARE
20037572;;F;22;CHILENO;;Z;N/D;N/D;608960;4;3;3;2;583970;1;1;24990;SECADOR DE PELO SG-3051;PERSONAL CARE
18770626;;F;28;CHILENO;;Millenial;PROVIDENCIA                   ;METROPOLITANA;24990;1;1;1;1;24990;0;0;0;ALISADOR +SECADOR PELO;PERSONAL CARE
12828449;;F;47;CHILENO;;X;PIRQUE                        ;METROPOLITANA;37190;2;1;0;0;0;2;1;37190;ALISADOR +SECADOR PELO;PERSONAL CARE
12574596;;F;47;CHILENO;;X;PROVIDENCIA                   ;METROPOLITANA;15990;1;1;0;0;0;1;1;15990;SECADOR DE PELO SG-3025 SILVER;PERSONAL CARE
19238276;;F;26;CHILENO;;Z;SAN PABLO;LOS LAGOS;29990;2;1;0;0;0;2;1;29990;CORTA PELO SG-8520;PERSONAL CARE
9514161;;M;58;CHILENO;;Boomers;PROVIDENCIA                   ;METROPOLITANA;19990;1;1;0;0;0;1;1;19990;SECADOR DE PELO SIEGEN SG-3035;PERSONAL CARE
16856663;;M;34;CHILENO;;Millenial;N/D;N/D;24990;1;1;0;0;0;1;1;24990;SECADOR DE PELO SG-3051;PERSONAL CARE
13207398;;M;45;CHILENO;;X;RETIRO                        ;MAULE;454960;4;3;0;0;0;4;3;454960;AFEITADORA SG-7250 NEGRO;PERSONAL CARE
19503225;;F;25;CHILENO;;Z;PROVIDENCIA                   ;METROPOLITANA;22990;1;1;0;0;0;1;1;22990;SECADOR GAMA BORA KERATION;PERSONAL CARE
18873313;;F;27;CHILENO;;Millenial;PROVIDENCIA                   ;METROPOLITANA;15140;2;1;0;0;0;2;1;15140;SECADOR DE PELO SG-3025 SILVER;PERSONAL CARE
10923891;;F;56;CHILENO;;Boomers;RETIRO                        ;MAULE;39980;2;2;0;0;0;2;2;39980;ALISADOR DE PELO SG-3510 FUCSIA;PERSONAL CARE
7365538;;F;67;CHILENO;;Boomers;LA GRANJA                     ;METROPOLITANA;16990;1;1;0;0;0;1;1;16990;SECADOR DE PELO MISTRAL STD;PERSONAL CARE
18705678;;F;27;CHILENO;;Millenial;LIMACHE;VALPARAISO;36970;3;1;3;1;36970;0;0;0;DEPILADORA BRE225/00;PERSONAL CARE
9056169;;M;61;CHILENO;;Boomers;VALPARAISO                    ;VALPARAISO;104480;4;1;0;0;0;4;1;104480;DEPILADORA SG-9040;PERSONAL CARE
19449043;;F;25;CHILENO;;Z;SAN FELIPE                    ;VALPARAISO;21980;2;2;0;0;0;2;2;21980;SECADOR DE PELO SG-3012 NEGRO;PERSONAL CARE
11353193;;F;54;CHILENO;;X;RENCA                         ;METROPOLITANA;11990;1;1;0;0;0;1;1;11990;ALISADOR SG3510C09 MORADO PLACAS DE CERAMICA 21;PERSONAL CARE
20123211;;F;23;CHILENO;;Z;PROVIDENCIA                   ;METROPOLITANA;59990;1;1;0;0;0;1;1;59990;DEPILADORA BRE700/00 MID-END CLOSED BOX;PERSONAL CARE
16454633;;F;35;CHILENO;;Millenial;TALCA                         ;MAULE;16990;1;1;0;0;0;1;1;16990;SECADOR DE PELO MISTRAL STD;PERSONAL CARE
3659263;;F;83;CHILENO;;Silencioso;TALCAHUANO                    ;BIO BIO;13990;1;1;0;0;0;1;1;13990;SECADOR GAMA EOLIC MINI TRAVEL;PERSONAL CARE
9315461;;F;60;CHILENO;;Boomers;N/D;N/D;37980;2;2;1;1;22990;1;1;14990;SECADOR TEMPO TITAN KERATIN;PERSONAL CARE
9071537;;F;57;CHILENO;;Boomers;RENCA                         ;METROPOLITANA;24990;1;1;0;0;0;1;1;24990;SECADOR DE PELO SG-3051;PERSONAL CARE
8237816;;M;65;CHILENO;;Boomers;N/D;N/D;21990;1;1;0;0;0;1;1;21990;AFEITADORA SPORT;PERSONAL CARE
16994841;;F;33;CHILENO;;Millenial;PROVIDENCIA                   ;METROPOLITANA;13990;1;1;0;0;0;1;1;13990;SECADOR DE PELO SG-3025 SILVER;PERSONAL CARE
18196121;;M;30;CHILENO;;Millenial;TEMUCO                        ;ARAUCANIA;51980;2;1;0;0;0;2;1;51980;ALISADOR DE PELO SG-3540 MORADO MORADO;PERSONAL CARE
18153889;;F;29;CHILENO;;Millenial;QUILLOTA                      ;VALPARAISO;19990;1;1;0;0;0;1;1;19990;SECADOR DE PELO SIEGEN SG-3035;PERSONAL CARE
11725983;;F;51;CHILENO;;X;LA SERENA                     ;COQUIMBO;48980;2;1;0;0;0;2;1;48980;AFEITADORA SG-7250 NEGRO;PERSONAL CARE
7419318;Casado;M;64;CHILENO;;Boomers;QUILICURA                     ;METROPOLITANA;19990;1;1;0;0;0;1;1;19990;KIT CORTABARBA MG3711;PERSONAL CARE
19896435;;F;23;CHILENO;;Z;PROVIDENCIA                   ;METROPOLITANA;29980;2;2;0;0;0;2;2;29980;Secador de Pelo 3000 Series Philips BHD302/00;PERSONAL CARE
15235438;Divorciado;M;39;CHILENO;;X;LAUTARO                       ;ARAUCANIA;23980;2;1;0;0;0;2;1;23980;AFEITADORA SG-7210 NEGRO;PERSONAL CARE
13364009;;F;44;CHILENO;;X;"";"";26980;2;1;0;0;0;2;1;26980;CORTA PELO SPORT GCX 623 BVT;PERSONAL CARE
9263263;;F;58;CHILENO;;Boomers;LA SERENA                     ;COQUIMBO;289970;3;2;2;1;89980;1;1;199990;DEPILADORA IPL MAGNA PK;PERSONAL CARE
15771202;Soltero;F;38;CHILENO;PROFESOR;Millenial;COIHAIQUE                     ;AYSEN;253970;3;2;0;0;0;3;2;253970;SECADOR DE PELO SG-3051;PERSONAL CARE
16520884;;F;35;CHILENO;;Millenial;ANCUD                         ;LOS LAGOS;18990;1;1;0;0;0;1;1;18990;CORTA PELO SG-8200;PERSONAL CARE
18432598;;M;28;CHILENO;;Millenial;"";"";35250;3;1;0;0;0;3;1;35250;AFEITADORA SH 887 WD BAT;PERSONAL CARE
18975530;;M;27;CHILENO;;Millenial;PROVIDENCIA                   ;METROPOLITANA;24990;1;1;0;0;0;1;1;24990;SECADOR DE PELO SG-3051;PERSONAL CARE
13547085;;F;43;CHILENO;;X;RENCA                         ;METROPOLITANA;93970;3;2;3;2;93970;0;0;0;ALISADOR DE PELO S12A(220) Shine Therapy PALTA M;PERSONAL CARE
20412364;;F;22;CHILENO;;Z;"";"";32990;1;1;0;0;0;1;1;32990;DEPILADORA BRE255/00;PERSONAL CARE
13252825;;M;45;CHILENO;;Millenial;"";"";9990;1;1;1;1;9990;0;0;0;SECADOR DIAMOND STD;PERSONAL CARE
12232157;;F;50;CHILENO;;X;PROVIDENCIA                   ;METROPOLITANA;291942;6;4;0;0;0;6;4;291942;SECADOR GAMA BORA KERATION;PERSONAL CARE
13175883;;F;45;CHILENO;;X;LA SERENA                     ;COQUIMBO;73222;3;2;0;0;0;3;2;73222;SECADOR DE PELO SG-3051;PERSONAL CARE
25038983;;M;31;COLOMBIANO;;Extranjero;N/D;N/D;59980;2;2;1;1;29990;1;1;29990;ALISADOR DE PELO SG-3540 MORADO MORADO;PERSONAL CARE
20123808;;F;23;CHILENO;;Silencioso;PROVIDENCIA                   ;METROPOLITANA;36980;2;2;0;0;0;2;2;36980;CORTA PELO SPORT GCX 623 BVT;PERSONAL CARE
11396369;;F;53;CHILENO;;X;RENCA                         ;METROPOLITANA;10990;1;1;0;0;0;1;1;10990;SECADOR GAMA EOLIC MINI TRAVEL;PERSONAL CARE
7624875;;F;63;CHILENO;;Boomers;"";"";16990;1;1;0;0;0;1;1;16990;CORTA PELO SG-8200;PERSONAL CARE
6155930;;F;69;CHILENO;;Silencioso;TOCOPILLA                     ;ANTOFAGASTA;194940;8;3;0;0;0;8;3;194940;ALISADOR SG-3510C11 VERDE;PERSONAL CARE
15809171;;F;38;CHILENO;;Millenial;PEDRO AGUIRRE CERDA;METROPOLITANA;43980;2;1;2;1;43980;0;0;0;CORTA PELO HC-5850;PERSONAL CARE
8962151;;M;59;CHILENO;;Boomers;PROVIDENCIA                   ;METROPOLITANA;14990;1;1;0;0;0;1;1;14990;SECADOR DE VIAJE REMINGTON D2400;PERSONAL CARE
20723488;;F;21;CHILENO;;Z;PROVIDENCIA                   ;METROPOLITANA;18990;1;1;0;0;0;1;1;18990;SECADOR DE PELO D3019 PRO TITANIO;PERSONAL CARE
26919347;;M;26;EXTRANJERO - NO INFORMA NACIONALIDAD;;Extranjero;CHILLAN                       ;BIO BIO;74980;2;2;0;0;0;2;2;74980;ALISADOR DE PELO S12A(220) Shine Therapy PALTA M;PERSONAL CARE
25375615;;M;52;BOLIVIANO;;Extranjero;COPIAPO                       ;ATACAMA;44990;1;1;0;0;0;1;1;44990;CORTA PELO HC-5850;PERSONAL CARE
18293003;;M;30;CHILENO;;Millenial;QUINTA NORMAL;METROPOLITANA;29990;1;1;0;0;0;1;1;29990;ALISADOR DE PELO SG-3540 MORADO MORADO;PERSONAL CARE
18316511;;M;29;CHILENO;;Millenial;PUERTO MONTT                  ;LOS LAGOS;47980;2;2;0;0;0;2;2;47980;SECADOR DE PELO SG-3012 NEGRO;PERSONAL CARE
15405778;Casado;F;39;CHILENO;;X;PROVIDENCIA                   ;METROPOLITANA;33980;2;2;0;0;0;2;2;33980;SECADOR DE PELO SG-3025 SILVER;PERSONAL CARE
17717029;;F;31;CHILENO;;Millenial;PARRAL                        ;MAULE;105990;3;4;0;0;0;3;4;105990;ALISADOR DE PELO SG-4651 ROJO;PERSONAL CARE
15624297;;F;38;CHILENO;;Millenial;MELIPILLA                     ;METROPOLITANA;9990;1;1;0;0;0;1;1;9990;SECADOR PHILIPS BHC010;PERSONAL CARE
15712797;;F;38;CHILENO;;Millenial;PROVIDENCIA                   ;METROPOLITANA;18990;1;1;0;0;0;1;1;18990;SECADOR DE VIAJE REMINGTON D2400;PERSONAL CARE
19170253;;M;27;CHILENO;;Z;COLINA;METROPOLITANA;97980;2;2;0;0;0;2;2;97980;ALISADOR DE PELO S12A(220) Shine Therapy PALTA M;PERSONAL CARE
5513692;;F;79;CHILENO;;Silencioso;PROVIDENCIA                   ;METROPOLITANA;24980;2;1;0;0;0;2;1;24980;SECADOR DE PELO SG-3025 SILVER;PERSONAL CARE
17736676;;F;32;CHILENO;;Millenial;BUIN                          ;METROPOLITANA;34990;1;1;0;0;0;1;1;34990;TRICOMBO SECADOR+ALISADOR+ONDULADOR;PERSONAL CARE
18698947;;M;27;CHILENO;;Z;MELIPILLA                     ;METROPOLITANA;276980;2;2;0;0;0;2;2;276980;AFEITADORA S1121/41 ELECTRICA;PERSONAL CARE
12738140;;F;49;CHILENO;;X;LONCOCHE                      ;ARAUCANIA;94970;3;2;0;0;0;3;2;94970;CORTA PELO SG-8410;PERSONAL CARE
15907548;;M;37;CHILENO;;Millenial;PROVIDENCIA                   ;METROPOLITANA;24990;1;1;0;0;0;1;1;24990;SECADOR DE PELO SG-3051;PERSONAL CARE
17719605;;F;30;CHILENO;;Millenial;N/D;N/D;665830;6;4;0;0;0;6;4;665830;AFEITADORA SPORT SH 886 BAT;PERSONAL CARE
12726939;;M;47;CHILENO;;X;RENCA                         ;METROPOLITANA;12990;1;1;0;0;0;1;1;12990;SECADOR DE PELO SG-3012 NEGRO;PERSONAL CARE
7981980;;F;62;CHILENO;;Boomers;PROVIDENCIA                   ;METROPOLITANA;17990;1;1;0;0;0;1;1;17990;SECADOR DE PELO SG-3043 DC CAFE 2200 WATTS;PERSONAL CARE
20433917;;M;22;CHILENO;;Millenial;N/D;N/D;214960;4;3;0;0;0;4;3;214960;CORTA PELO SPORT GCX 623 BVT;PERSONAL CARE
12659983;;M;50;CHILENO;;Millenial;LOS ANGELES                   ;BIO BIO;24980;2;2;0;0;0;2;2;24980;AFEITADORA SPORT;PERSONAL CARE
9737065;;M;59;CHILENO;;Boomers;LEBU                          ;BIO BIO;27990;1;1;0;0;0;1;1;27990;CORTA PELO SG-8410;PERSONAL CARE
18191869;;F;29;CHILENO;;Millenial;PUENTE ALTO;METROPOLITANA;29990;1;1;1;1;29990;0;0;0;COMBO GAMA SECADOR+ALISADOR+CEPILLO;PERSONAL CARE
18156535;;M;33;CHILENO;;Millenial;RENCA                         ;METROPOLITANA;19990;1;1;0;0;0;1;1;19990;ALISADORA SIEGEN SG-3510C06;PERSONAL CARE
18063274;;F;30;CHILENO;;Silencioso;PROVIDENCIA                   ;METROPOLITANA;24990;1;1;0;0;0;1;1;24990;SECADOR DE PELO DIVA NEGRO;PERSONAL CARE
16398454;;M;35;CHILENO;;Millenial;N/D;N/D;13000;2;1;0;0;0;2;1;13000;SECADOR DE PELO SIEGEN SG-3035;PERSONAL CARE
17041535;;M;34;CHILENO;;Millenial;N/D;N/D;141080;4;2;2;1;85840;2;1;55240;DEPILADORA BRE285/00 CONVENCIONAL;PERSONAL CARE
9599004;;M;57;CHILENO;;Boomers;RENCA                         ;METROPOLITANA;29990;1;1;0;0;0;1;1;29990;ALISADOR +SECADOR PELO;PERSONAL CARE
17254414;;M;32;CHILENO;;Millenial;PROVIDENCIA                   ;METROPOLITANA;44990;1;1;0;0;0;1;1;44990;CORTA PELO HC-5850;PERSONAL CARE
19337307;;F;26;CHILENO;;Z;N/D;N/D;49990;1;1;1;1;49990;0;0;0;DEPILADORA SES 5/500 PINK BOX MN;PERSONAL CARE
6292427;;F;62;CHILENO;;Boomers;PROVIDENCIA                   ;METROPOLITANA;37980;2;1;0;0;0;2;1;37980;SECADOR GAMA BORA KERATION;PERSONAL CARE
11515911;;F;54;CHILENO;;X;LA LIGUA                      ;VALPARAISO;126960;4;2;0;0;0;4;2;126960;DEPILADORA OASIS SENSATION;PERSONAL CARE
8059582;;F;60;CHILENO;;Boomers;SAN FELIPE                    ;VALPARAISO;70960;4;2;0;0;0;4;2;70960;ALISADOR +SECADOR PELO;PERSONAL CARE
18213577;;F;29;CHILENO;;Millenial;N/D;N/D;66980;2;2;1;1;44990;1;1;21990;AFEITADORA GAMA SH 860;PERSONAL CARE
17661119;;F;31;CHILENO;;Millenial;COLINA                        ;METROPOLITANA;43980;2;2;0;0;0;2;2;43980;SECADOR DE PELO SE-3049C01 FUCSIA;PERSONAL CARE
15056001;;F;39;CHILENO;;X;COQUIMBO                      ;COQUIMBO;41980;2;1;0;0;0;2;1;41980;AFEITADORA SPORT SH 886 BAT;PERSONAL CARE
6962744;Casado;M;66;CHILENO;;Boomers;RENCA                         ;METROPOLITANA;33980;2;1;0;0;0;2;1;33980;AFEITADORA SPORT;PERSONAL CARE
10621781;;F;53;CHILENO;;X;PROVIDENCIA                   ;METROPOLITANA;27990;1;1;0;0;0;1;1;27990;SECADOR DE PELO DIVA NEGRO;PERSONAL CARE
5344226;;M;77;CHILENO;;Silencioso;CONCON                        ;VALPARAISO;864910;7;3;0;0;0;7;3;864910;COMBO GAMA DEPILADORA+SET MANICURE;PERSONAL CARE
12705383;Soltero;F;48;CHILENO;;X;RENCA                         ;METROPOLITANA;32990;1;1;0;0;0;1;1;32990;AFEITADORA S1223/41 ELECTRICA;PERSONAL CARE
15805704;;F;38;CHILENO;;Millenial;RANCAGUA                      ;L.G.B.OÂ´HIGGINS;31980;2;2;0;0;0;2;2;31980;ALISADOR PELO FINA CP1;PERSONAL CARE
15232048;;F;40;CHILENO;;X;PROVIDENCIA                   ;METROPOLITANA;14990;1;1;0;0;0;1;1;14990;CORTAPELO GAMA MG 566;PERSONAL CARE
10867205;;F;55;CHILENO;;Boomers;ANTOFAGASTA                   ;ANTOFAGASTA;24990;1;1;0;0;0;1;1;24990;ALISADOR +SECADOR PELO;PERSONAL CARE
16586111;;F;35;CHILENO;;Millenial;PUERTO MONTT                  ;LOS LAGOS;70240;4;3;0;0;0;4;3;70240;COMBO GAMA DEPILADORA+SET MANICURE;PERSONAL CARE
7454710;Casado;M;66;CHILENO;;Boomers;RENCA                         ;METROPOLITANA;127980;2;2;1;1;99990;1;1;27990;KIT CORTABARBA MG3711;PERSONAL CARE
19664675;;F;23;CHILENO;;Z;VINA DEL MAR                  ;VALPARAISO;34990;1;1;0;0;0;1;1;34990;AFEITADORA SH 887 WD BAT;PERSONAL CARE
12963577;;F;45;CHILENO;;X;LINARES                       ;MAULE;32483;2;2;0;0;0;2;2;32483;CORTAPELO GAMA MG 566;PERSONAL CARE
17040911;;F;34;CHILENO;;Millenial;RENCA                         ;METROPOLITANA;41980;2;2;0;0;0;2;2;41980;ALISADOR +SECADOR PELO;PERSONAL CARE
26704968;;F;32;EXTRANJERO - NO INFORMA NACIONALIDAD;;Extranjero;N/D;N/D;103980;2;1;2;1;103980;0;0;0;DEPILADORA LASER SIEGEN SG-9302;PERSONAL CARE
15047992;;F;37;CHILENO;;Millenial;N/D;N/D;782860;3;2;0;0;0;3;2;782860;ALISADOR DE PELO S12A(220) Shine Therapy PALTA M;PERSONAL CARE
13327515;;M;44;CHILENO;;X;VALLENAR;ATACAMA;39990;1;1;0;0;0;1;1;39990;ALISADOR DE PELO S12A(220) Shine Therapy PALTA M;PERSONAL CARE
18169094;;F;30;CHILENO;;Millenial;CHILLAN VIEJO                 ;BIO BIO;55990;1;1;0;0;0;1;1;55990;ALISADOR DE PELO SG-4651 ROJO;PERSONAL CARE
11779127;;F;51;CHILENO;;X;LEBU                          ;BIO BIO;24990;1;1;0;0;0;1;1;24990;ALISADOR +SECADOR PELO;PERSONAL CARE
17295823;Soltero;F;32;CHILENO;PSICOLOGO;Millenial;PROVIDENCIA                   ;METROPOLITANA;25990;1;1;0;0;0;1;1;25990;SECADOR DE PELO SE-3049C01 FUCSIA;PERSONAL CARE
13572947;;F;43;CHILENO;;X;N/D;N/D;29990;1;1;0;0;0;1;1;29990;AFEITADORA SG-7250 NEGRO;PERSONAL CARE
19498658;Soltero;F;25;CHILENO;INGENIERO AGRICOLA;Z;PROVIDENCIA                   ;METROPOLITANA;30980;2;1;0;0;0;2;1;30980;SECADOR GAMA BRILLIAN AQUA;PERSONAL CARE
15199784;;F;40;CHILENO;;X;CONTULMO                      ;BIO BIO;16990;1;1;0;0;0;1;1;16990;ONDULADOR GAMA 33MM TURMALINA;PERSONAL CARE
17111753;;M;32;CHILENO;;Millenial;N/D;N/D;14990;1;1;0;0;0;1;1;14990;CORTAPELO GAMA MG 566;PERSONAL CARE
10818831;;F;54;CHILENO;;Boomers;COQUIMBO                      ;COQUIMBO;24990;1;1;0;0;0;1;1;24990;AFEITADORA QP2521/50 ONE BLADE GRAFITO;PERSONAL CARE
17987800;;M;30;CHILENO;;Millenial;PARRAL                        ;MAULE;25990;1;1;0;0;0;1;1;25990;SECADOR DE PELO SE-3049C01 FUCSIA;PERSONAL CARE
16716560;;M;34;CHILENO;;Millenial;"";"";34990;1;1;0;0;0;1;1;34990;Pack depiladoras HP6306/00 + BRE225/00;PERSONAL CARE
15071565;;F;40;CHILENO;;X;PROVIDENCIA                   ;METROPOLITANA;9990;1;1;0;0;0;1;1;9990;SECADOR GAMA EOLIC MINI TRAVEL;PERSONAL CARE
18298945;;M;29;CHILENO;;Millenial;"";"";194980;2;1;2;1;194980;0;0;0;DEPILADORA BRI920/00 IPL LUMEA ADVANCE;PERSONAL CARE
9794082;;F;58;CHILENO;;Boomers;MAIPU                         ;METROPOLITANA;60230;3;1;0;0;0;3;1;60230;AFEITADORA SG-7250 NEGRO;PERSONAL CARE
15546658;;F;38;CHILENO;;Millenial;PROVIDENCIA                   ;METROPOLITANA;12990;1;1;0;0;0;1;1;12990;CORTA PELO SG-8200;PERSONAL CARE
16566238;;F;35;CHILENO;;Millenial;CALAMA                        ;ANTOFAGASTA;76764;4;2;0;0;0;4;2;76764;SECADOR DE PELO SG-3043 DC CAFE 2200 WATTS;PERSONAL CARE
12803982;;F;47;CHILENO;;X;VALLENAR;ATACAMA;38990;1;1;0;0;0;1;1;38990;AFEITADORA SH 887 WD BAT;PERSONAL CARE
14431214;Soltero;F;52;CHILENO;;X;RENCA                         ;METROPOLITANA;37980;2;2;0;0;0;2;2;37980;AFEITADORA SG-7210 NEGRO;PERSONAL CARE
12832855;;F;47;CHILENO;;X;N/D;N/D;24990;1;1;0;0;0;1;1;24990;CORTAPELOS GM 596;PERSONAL CARE
18943270;;F;27;CHILENO;;Millenial;ANGOL                         ;ARAUCANIA;261830;3;2;0;0;0;3;2;261830;CORTA PELO SG-8200;PERSONAL CARE
13540077;;M;43;CHILENO;;X;PUCHUNCAVI                    ;VALPARAISO;24990;1;1;0;0;0;1;1;24990;COMBO GAMA DEPILADORA+SET MANICURE;PERSONAL CARE
13720947;;F;44;CHILENO;;X;RANCAGUA;O HIGGINS;24990;1;1;0;0;0;1;1;24990;ALISADOR +SECADOR PELO;PERSONAL CARE
16090049;;M;37;CHILENO;;Millenial;N/D;N/D;89960;4;2;0;0;0;4;2;89960;COMBO GAMA DEPILADORA+SET MANICURE;PERSONAL CARE
12816277;;M;47;CHILENO;;X;PETORCA                       ;VALPARAISO;10990;1;1;0;0;0;1;1;10990;SECADOR DE PELO SG-3012 NEGRO;PERSONAL CARE
15949566;Casado;F;37;CHILENO;;Millenial;RENCA                         ;METROPOLITANA;28980;2;1;2;1;28980;0;0;0;COMBO GAMA DEPILADORA+SET MANICURE;PERSONAL CARE
18980410;Soltero;M;27;CHILENO;INGENIERO EN MINAS;Millenial;CABILDO;VALPARAISO;149980;2;1;0;0;0;2;1;149980;DEPILADORA LASER SIEGEN SG-9302;PERSONAL CARE
17908909;;F;36;CHILENO;;Millenial;"";"";80210;5;2;0;0;0;5;2;80210;AFEITADORA SG-7210 NEGRO;PERSONAL CARE
11934311;;F;50;CHILENO;;Extranjero;VALLENAR;ATACAMA;304960;4;4;0;0;0;4;4;304960;ALISADOR GAMA BELLA SHINE;PERSONAL CARE
17801744;;M;31;CHILENO;;Millenial;ERCILLA                       ;ARAUCANIA;21990;1;1;0;0;0;1;1;21990;DEPILADORA SG-9003;PERSONAL CARE
13400615;;F;43;CHILENO;;X;PROVIDENCIA                   ;METROPOLITANA;89980;3;1;0;0;0;3;1;89980;COMBO SIEGEN AFEITADORA + MULTISTYLER SG-8440;PERSONAL CARE
18687427;;M;28;CHILENO;;Millenial;"";"";16990;1;1;0;0;0;1;1;16990;CORTA PELO SG-8410;PERSONAL CARE
13440195;;F;43;CHILENO;;X;SAN BERNARDO;METROPOLITANA;88980;2;1;2;1;88980;0;0;0;DEPILADORA IPL Verina Bvt;PERSONAL CARE
9646636;;M;58;CHILENO;;Boomers;LA LIGUA                      ;VALPARAISO;26990;1;1;0;0;0;1;1;26990;CORTA PELO SG-8520;PERSONAL CARE
16527664;;M;35;CHILENO;;Millenial;PAINE                         ;METROPOLITANA;40980;2;1;0;0;0;2;1;40980;DEPILADORA SG-9004;PERSONAL CARE
18008489;;M;30;CHILENO;;Millenial;PROVIDENCIA                   ;METROPOLITANA;19990;1;1;0;0;0;1;1;19990;CORTA PELO SG-8410;PERSONAL CARE
20437598;;F;22;CHILENO;;Z;PROVIDENCIA                   ;METROPOLITANA;39980;2;1;2;1;39980;0;0;0;DEPILADORA OASIS NEXT BVT;PERSONAL CARE
26730005;;M;28;EXTRANJERO - NO INFORMA NACIONALIDAD;;Extranjero;PAINE                         ;METROPOLITANA;39990;1;1;0;0;0;1;1;39990;COMBO SIEGEN AFEITADORA + MULTISTYLER SG-8440;PERSONAL CARE
13482581;;M;44;CHILENO;;Silencioso;N/D;N/D;549980;4;2;4;2;549980;0;0;0;CORTA PELO SG-8550 MULTISTYLER;PERSONAL CARE
15645691;;F;38;CHILENO;;Millenial;CASTRO                        ;LOS LAGOS;29990;1;1;0;0;0;1;1;29990;ALISADOR DE PELO SG-3540 MORADO MORADO;PERSONAL CARE
17881651;;F;30;CHILENO;;Millenial;PROVIDENCIA                   ;METROPOLITANA;19990;1;1;1;1;19990;0;0;0;DEPILADORA BRE225/00;PERSONAL CARE
14634980;;F;60;ECUATORIANO;;Extranjero;BUIN                          ;METROPOLITANA;21990;1;1;0;0;0;1;1;21990;DEPILADORA BRE225/00;PERSONAL CARE
19110161;;F;26;CHILENO;;Z;N/D;N/D;124980;2;4;0;0;0;2;4;124980;SPA PARA PIES SG-1560;PERSONAL CARE
6279076;;M;72;CHILENO;;Silencioso;RENCA                         ;METROPOLITANA;16990;1;1;0;0;0;1;1;16990;AFEITADORA SG-7210 NEGRO;PERSONAL CARE
10930308;Casado;F;53;CHILENO;;X;RENCA                         ;METROPOLITANA;14990;1;1;0;0;0;1;1;14990;SECADOR GAMA BRILLIAN AQUA;PERSONAL CARE
16191068;;F;37;CHILENO;;Millenial;N/D;N/D;29990;1;1;0;0;0;1;1;29990;ALISADOR AQUA THERAPY LED;PERSONAL CARE
6361813;Viudo;F;69;CHILENO;PROFESOR;Silencioso;RENCA                         ;METROPOLITANA;26990;1;1;1;1;26990;0;0;0;AFEITADORA S1223/41 ELECTRICA;PERSONAL CARE
11577100;;F;51;CHILENO;;X;TUCAPEL                       ;BIO BIO;34990;1;1;0;0;0;1;1;34990;COMBO SIEGEN AFEITADORA + MULTISTYLER SG-8440;PERSONAL CARE
19093898;;F;28;CHILENO;;Millenial;N/D;N/D;107860;4;2;0;0;0;4;2;107860;ALISADOR DE PELO SG-3540 MORADO MORADO;PERSONAL CARE
18516312;Soltero;F;28;CHILENO;CIRUJANA DENTISTA;Millenial;PROVIDENCIA                   ;METROPOLITANA;29990;2;1;2;1;29990;0;0;0;TRICOMBO SECADOR+ALISADOR+ONDULADOR;PERSONAL CARE
16404587;;M;36;CHILENO;;Millenial;QUIRIHUE                      ;BIO BIO;29990;1;1;0;0;0;1;1;29990;COMBO GAMA SECADOR+ALISADOR+CEPILLO;PERSONAL CARE
15943484;;F;36;CHILENO;;Millenial;DALCAHUE                      ;LOS LAGOS;390970;3;2;0;0;0;3;2;390970;DEPILADORA GAMA ESSENCIAL;PERSONAL CARE
19971643;;F;23;CHILENO;;Z;ANGOL                         ;ARAUCANIA;34990;1;1;1;1;34990;0;0;0;DEPILADORA OASIS SENSATION;PERSONAL CARE
15972709;Casado;F;37;CHILENO;AUXILIAR PARAMEDICO DE ALIMENTACION;Millenial;PROVIDENCIA                   ;METROPOLITANA;44990;1;1;0;0;0;1;1;44990;COMBO SIEGEN AFEITADORA + MULTISTYLER SG-8440;PERSONAL CARE
10485175;;F;54;CHILENO;;Boomers;N/D;N/D;42970;3;3;0;0;0;3;3;42970;CORTAPELO GAMA MG 566;PERSONAL CARE
15196006;;F;40;CHILENO;;X;CURANILAHUE                   ;BIO BIO;238980;2;2;0;0;0;2;2;238980;ALISADOR REMIG. WET2 S27A (BV) R;PERSONAL CARE
20277025;;F;22;CHILENO;;Millenial;N/D;N/D;27990;1;1;0;0;0;1;1;27990;ALISADOR +SECADOR PELO;PERSONAL CARE
11982363;;F;50;CHILENO;;X;N/D;N/D;34990;1;1;0;0;0;1;1;34990;CORTADOR DE PELO SIEGEN SG-8590;PERSONAL CARE
17225587;;F;33;CHILENO;;Millenial;TALAGANTE                     ;METROPOLITANA;14990;1;1;0;0;0;1;1;14990;DEPILADORA SG-9003;PERSONAL CARE
13627457;;F;42;CHILENO;;X;CURANILAHUE                   ;BIO BIO;24990;1;1;0;0;0;1;1;24990;DEPILADORA BRE225/00;PERSONAL CARE
15436805;;F;40;CHILENO;;Millenial;N/D;N/D;44990;1;1;0;0;0;1;1;44990;ALISADOR SIEGEN SG-4716;PERSONAL CARE
15189284;;F;39;CHILENO;;X;N/D;N/D;151980;3;2;0;0;0;3;2;151980;ALISADOR DE PELO SG-4651 ROJO;PERSONAL CARE
11992488;;F;50;CHILENO;;X;QUILPUE                       ;VALPARAISO;94980;2;2;2;2;94980;0;0;0;ALISADOR DE PELO S12A(220) Shine Therapy PALTA M;PERSONAL CARE
17920859;;F;30;CHILENO;;Silencioso;PROVIDENCIA                   ;METROPOLITANA;25840;2;1;2;1;25840;0;0;0;HUAWEI Scale 3;PERSONAL CARE
19843586;;M;24;CHILENO;;Z;PROVIDENCIA                   ;METROPOLITANA;173970;3;2;3;2;173970;0;0;0;Pack Secador de pelo BHD004/10 + Alisador HP8321;PERSONAL CARE
6440090;;M;68;CHILENO;;Silencioso;PROVIDENCIA                   ;METROPOLITANA;26990;1;1;0;0;0;1;1;26990;SECADOR DE PELO SG-3051;PERSONAL CARE
10087387;;F;55;CHILENO;;Boomers;N/D;N/D;34980;2;3;0;0;0;2;3;34980;ONDULADOR DE PELO SG-2411 25MM;PERSONAL CARE
7582976;;M;64;CHILENO;;Boomers;MELIPILLA                     ;METROPOLITANA;29990;1;1;0;0;0;1;1;29990;DEPILADORA OASIS LOOK BVT;PERSONAL CARE
14026135;;M;41;CHILENO;;X;N/D;N/D;141960;4;2;0;0;0;4;2;141960;SECADOR DE PELO SG-3043 DC CAFE 2200 WATTS;PERSONAL CARE
16110686;;F;36;CHILENO;;Millenial;PROVIDENCIA                   ;METROPOLITANA;167540;2;1;2;1;167540;0;0;0;DEPILADORA BRI920/00 IPL LUMEA ADVANCE;PERSONAL CARE
11834811;;F;50;CHILENO;;Silencioso;PROVIDENCIA                   ;METROPOLITANA;13990;1;1;0;0;0;1;1;13990;SECADOR DE PELO MISTRAL STD;PERSONAL CARE
15169807;;F;40;CHILENO;;Silencioso;PROVIDENCIA                   ;METROPOLITANA;39990;1;1;0;0;0;1;1;39990;DEPILADORA OASIS SENSATION;PERSONAL CARE
17153896;;F;34;CHILENO;;Millenial;VICTORIA                      ;ARAUCANIA;8000;0;2;0;0;0;0;2;8000;ALISADOR DE PELO S12A(220) Shine Therapy PALTA M;PERSONAL CARE
23829046;;M;35;BOLIVIANO;;Extranjero;RIO CLARO                     ;MAULE;107370;2;1;0;0;0;2;1;107370;DEPILADORA IPL MAGNA PK;PERSONAL CARE
26630196;;F;35;VENEZOLANO;;Extranjero;PROVIDENCIA                   ;METROPOLITANA;21990;1;1;0;0;0;1;1;21990;SECADOR DE PELO SE-3049C01 FUCSIA;PERSONAL CARE
17299907;;F;33;CHILENO;;Millenial;"";"";29990;1;1;0;0;0;1;1;29990;DEPILADORA SG-9004;PERSONAL CARE
6727733;;F;69;CHILENO;;Silencioso;CURANILAHUE                   ;BIO BIO;43990;1;1;0;0;0;1;1;43990;AFEITADORA S1323/41 ELECTRICA;PERSONAL CARE
9808754;;M;58;CHILENO;;Boomers;LA GRANJA                     ;METROPOLITANA;13990;1;1;0;0;0;1;1;13990;SECADOR DE PELO MISTRAL STD;PERSONAL CARE
13617164;;M;43;CHILENO;;X;SAN CARLOS                    ;BIO BIO;54384;2;1;0;0;0;2;1;54384;DEPILADORA SG-9004EX;PERSONAL CARE
18809504;;F;27;CHILENO;;Millenial;PROVIDENCIA                   ;METROPOLITANA;21990;1;1;1;1;21990;0;0;0;DEPILADORA BRE255/00;PERSONAL CARE
18891468;;F;27;CHILENO;;Millenial;LA SERENA                     ;COQUIMBO;19990;1;1;0;0;0;1;1;19990;ALISADOR GAMA BELLA SHINE;PERSONAL CARE
15199025;;F;40;CHILENO;;X;PROVIDENCIA                   ;METROPOLITANA;15990;1;1;0;0;0;1;1;15990;SECADOR DE PELO MISTRAL STD;PERSONAL CARE
17739909;;F;31;CHILENO;;Silencioso;PROVIDENCIA                   ;METROPOLITANA;79990;2;1;2;1;79990;0;0;0;DEPILADORA IPL Verina Bvt;PERSONAL CARE
8247398;;F;70;CHILENO;;Silencioso;PROVIDENCIA                   ;METROPOLITANA;21990;1;1;0;0;0;1;1;21990;DEPILADORA SG-9003;PERSONAL CARE
13878268;;F;42;CHILENO;;X;CASABLANCA                    ;VALPARAISO;22980;2;2;0;0;0;2;2;22980;Trimmer Gama GT 527;PERSONAL CARE
6715080;;F;71;CHILENO;;Silencioso;RENCA                         ;METROPOLITANA;13990;1;1;0;0;0;1;1;13990;SECADOR DE PELO MISTRAL STD;PERSONAL CARE
10949277;;F;54;CHILENO;;X;PANGUIPULLI                   ;LOS LAGOS;29990;1;1;0;0;0;1;1;29990;CORTAPELOS GM 596;PERSONAL CARE
19545061;;F;25;CHILENO;;Z;PROVIDENCIA                   ;METROPOLITANA;26990;1;1;1;1;26990;0;0;0;CORTAPELOS GM 596;PERSONAL CARE
16804815;;F;34;CHILENO;;Silencioso;PROVIDENCIA                   ;METROPOLITANA;33240;2;1;0;0;0;2;1;33240;ALISADOR DE PELO SG-3540 MORADO MORADO;PERSONAL CARE
16967895;;F;34;CHILENO;;Millenial;CONSTITUCION                  ;MAULE;20990;1;1;0;0;0;1;1;20990;AFEITADORA SG-7210 NEGRO;PERSONAL CARE
12934958;Casado;F;46;CHILENO;;X;RENCA                         ;METROPOLITANA;26990;1;1;0;0;0;1;1;26990;CORTAPELOS GM 596;PERSONAL CARE
20136896;;F;23;CHILENO;;Z;PROVIDENCIA                   ;METROPOLITANA;23990;1;1;0;0;0;1;1;23990;SECADOR DE PELO SIEGEN SG-3049C02;PERSONAL CARE
13613757;;M;43;CHILENO;;X;RENCA                         ;METROPOLITANA;35670;2;1;0;0;0;2;1;35670;AFEITADORA S1121/41 ELECTRICA;PERSONAL CARE
15223023;Casado;F;39;CHILENO;;X;PROVIDENCIA                   ;METROPOLITANA;27980;2;1;0;0;0;2;1;27980;SECADOR DE PELO SG-3012 NEGRO;PERSONAL CARE
18793055;;F;27;CHILENO;;Millenial;N/D;N/D;26990;1;1;0;0;0;1;1;26990;SECADOR DE PELO SG-3051;PERSONAL CARE
12774168;;F;46;CHILENO;;X;CABILDO                       ;VALPARAISO;15990;1;1;0;0;0;1;1;15990;CORTA PELO GM 562;PERSONAL CARE
13632497;;F;43;CHILENO;;Millenial;N/D;N/D;39990;1;1;0;0;0;1;1;39990;DEPILADORA OASIS SENSATION;PERSONAL CARE
19462272;;F;25;CHILENO;;Z;PROVIDENCIA                   ;METROPOLITANA;27990;1;1;0;0;0;1;1;27990;SECADOR DE PELO DIVA NEGRO;PERSONAL CARE
16101143;Casado;F;35;CHILENO;;Millenial;CALBUCO                       ;LOS LAGOS;84980;2;2;0;0;0;2;2;84980;SECADOR DE PELO DIVA NEGRO;PERSONAL CARE
15528302;;F;37;CHILENO;;Millenial;PROVIDENCIA                   ;METROPOLITANA;23990;1;1;0;0;0;1;1;23990;SECADOR DE PELO SE-3049C01 FUCSIA;PERSONAL CARE
17716758;Soltero;F;31;CHILENO;ENFERMERA;Millenial;PROVIDENCIA                   ;METROPOLITANA;20990;1;1;0;0;0;1;1;20990;SECADOR DE PELO SG-3043 DC CAFE 2200 WATTS;PERSONAL CARE
5269729;;M;77;CHILENO;;Silencioso;PROVIDENCIA                   ;METROPOLITANA;16990;1;1;0;0;0;1;1;16990;SECADOR DE PELO SG-3043 DC CAFE 2200 WATTS;PERSONAL CARE
19298754;;M;26;CHILENO;;Z;PROVIDENCIA                   ;METROPOLITANA;24990;1;1;0;0;0;1;1;24990;KIT CORTABARBA MG3711;PERSONAL CARE
12716987;;F;47;CHILENO;;X;PROVIDENCIA                   ;METROPOLITANA;49990;1;1;0;0;0;1;1;49990;ALISADOR DE PELO S12A(220) Shine Therapy PALTA M;PERSONAL CARE
18950252;;F;27;CHILENO;;Silencioso;PROVIDENCIA                   ;METROPOLITANA;32990;1;1;0;0;0;1;1;32990;TRICOMBO SECADOR+ALISADOR+ONDULADOR;PERSONAL CARE
19916100;;F;24;CHILENO;;Z;SAN BERNARDO                  ;METROPOLITANA;7990;1;1;0;0;0;1;1;7990;ONDULADOR DE PELO GAMA TURMALINA 19MM;PERSONAL CARE
19932049;;F;23;CHILENO;;Z;PROVIDENCIA                   ;METROPOLITANA;50240;2;1;0;0;0;2;1;50240;ALISADOR DE PELO S12A(220) Shine Therapy PALTA M;PERSONAL CARE
18267543;;M;29;CHILENO;;Millenial;N/D;N/D;39990;1;1;0;0;0;1;1;39990;DEPILADORA OASIS SENSATION;PERSONAL CARE
18503935;;F;28;CHILENO;;Silencioso;PROVIDENCIA                   ;METROPOLITANA;29990;1;1;0;0;0;1;1;29990;AFEITADORA SG-7250 NEGRO;PERSONAL CARE
17075918;;F;33;CHILENO;;Millenial;CORONEL                       ;BIO BIO;59990;1;1;0;0;0;1;1;59990;ALISADOR DE PELO SG-4651 ROJO;PERSONAL CARE
15292717;;M;40;CHILENO;;X;CORRAL                        ;LOS LAGOS;26990;1;1;0;0;0;1;1;26990;CORTAPELOS GM 596;PERSONAL CARE
18135430;;F;30;CHILENO;;Millenial;PROVIDENCIA                   ;METROPOLITANA;31990;1;1;0;0;0;1;1;31990;AFEITADORA QP2521/50 ONE BLADE GRAFITO;PERSONAL CARE
17335790;;F;32;CHILENO;;Millenial;PROVIDENCIA                   ;METROPOLITANA;19990;1;1;0;0;0;1;1;19990;DEPILADORA GAMA ESSENCIAL;PERSONAL CARE
17040634;;M;33;CHILENO;;Millenial;N/D;N/D;19990;1;1;0;0;0;1;1;19990;CORTA PELO SG-8410;PERSONAL CARE
17505317;;F;32;CHILENO;;Millenial;PROVIDENCIA                   ;METROPOLITANA;29990;1;1;0;0;0;1;1;29990;AFEITADORA SG-7250 NEGRO;PERSONAL CARE
19286552;;M;27;CHILENO;;Z;N/D;N/D;0;0;0;0;0;0;0;0;0;AFEITADORA SG-7250 NEGRO;PERSONAL CARE
18452202;;F;29;CHILENO;;Millenial;N/D;N/D;0;0;0;0;0;0;0;0;0;ALISADOR PELO FINA CP1;PERSONAL CARE
19374544;;F;26;CHILENO;;Z;PROVIDENCIA                   ;METROPOLITANA;0;0;0;0;0;0;0;0;0;ALISADOR DE PELO S12A(220) Shine Therapy PALTA M;PERSONAL CARE
13211535;;F;45;CHILENO;;X;QUILLOTA                      ;VALPARAISO;0;0;0;0;0;0;0;0;0;ALISADOR DE PELO SG-3540 MORADO MORADO;PERSONAL CARE
9053022;;M;58;CHILENO;;Boomers;RENCA                         ;METROPOLITANA;0;0;0;0;0;0;0;0;0;SECADOR PELO SG-3012C19;PERSONAL CARE
14596593;;F;42;CHILENO;;X;PROVIDENCIA                   ;METROPOLITANA;0;0;0;0;0;0;0;0;0;SECADOR DE PELO SG-3049 NEGRO;PERSONAL CARE
19130568;Soltero;F;26;CHILENO;;Z;PROVIDENCIA                   ;METROPOLITANA;0;0;0;0;0;0;0;0;0;ALISADOR GAMA BELLA SHINE;PERSONAL CARE
21871665;;F;23;CHILENO;;Z;PROVIDENCIA                   ;METROPOLITANA;0;0;0;0;0;0;0;0;0;ALISADOR ELEGANCE LED BLOOM VT;PERSONAL CARE
12123276;;F;42;CHILENO;;X;CALBUCO                       ;LOS LAGOS;0;0;0;0;0;0;0;0;0;ALISADOR GAMA BELLA SHINE;PERSONAL CARE
19104432;;F;26;CHILENO;;Z;N/D;N/D;0;0;0;0;0;0;0;0;0;ALISADOR SIEGEN SG-4716;PERSONAL CARE
16417745;;F;35;CHILENO;;Millenial;PROVIDENCIA                   ;METROPOLITANA;0;0;0;0;0;0;0;0;0;ALISADOR +SECADOR PELO;PERSONAL CARE
17091400;;M;33;CHILENO;;Millenial;PARRAL                        ;MAULE;0;0;0;0;0;0;0;0;0;CORTADOR DE PELO SIEGEN SG-8590;PERSONAL CARE
19301051;Soltero;F;26;CHILENO;;Z;PROVIDENCIA                   ;METROPOLITANA;0;0;0;0;0;0;0;0;0;SECADOR PELO SG-3012C19;PERSONAL CARE
19011207;;F;34;CHILENO;;Millenial;CARAHUE                       ;ARAUCANIA;0;0;0;0;0;0;0;0;0;ALISADOR DE PELO SG-3540 MORADO MORADO;PERSONAL CARE
13400466;;M;44;CHILENO;;X;RENCA                         ;METROPOLITANA;0;0;0;0;0;0;0;0;0;SECADOR DE PELO SE-3049C01 FUCSIA;PERSONAL CARE
17595958;;F;32;CHILENO;;Millenial;PROVIDENCIA                   ;METROPOLITANA;0;0;0;0;0;0;0;0;0;SECADOR DE PELO SG-3043 DC CAFE 2200 WATTS;PERSONAL CARE
10396585;Casado;M;52;CHILENO;;X;RENCA                         ;METROPOLITANA;0;0;0;0;0;0;0;0;0;SECADOR DE PELO SG-3012 NEGRO;PERSONAL CARE
9487107;;F;61;CHILENO;;Boomers;LOS ANDES                     ;VALPARAISO;0;0;0;0;0;0;0;0;0;SECADOR DIAMOND STD;PERSONAL CARE
19572126;;F;25;CHILENO;;Z;PROVIDENCIA                   ;METROPOLITANA;0;0;0;0;0;0;0;0;0;ALISADOR ELEGANCE LED BLOOM VT;PERSONAL CARE
19796874;;F;24;CHILENO;;Z;PROVIDENCIA                   ;METROPOLITANA;0;0;0;0;0;0;0;0;0;SECADOR PELO SG-3012C19;PERSONAL CARE
6702004;;F;70;CHILENO;;Silencioso;CURANILAHUE                   ;BIO BIO;0;0;0;0;0;0;0;0;0;AFEITADORA SG-7250 NEGRO;PERSONAL CARE
18221103;;F;30;CHILENO;;Millenial;"";"";0;0;0;0;0;0;0;0;0;SECADOR DE PELO SG-3012 NEGRO;PERSONAL CARE
19128563;;F;26;CHILENO;;Z;PROVIDENCIA                   ;METROPOLITANA;0;0;0;0;0;0;0;0;0;ALISADOR +SECADOR PELO;PERSONAL CARE
13813697;;F;42;CHILENO;;Silencioso;PROVIDENCIA                   ;METROPOLITANA;0;0;0;0;0;0;0;0;0;SECADOR PELO SG-3012C19;PERSONAL CARE
18254872;Soltero;F;29;CHILENO;;Millenial;PROVIDENCIA                   ;METROPOLITANA;0;0;0;0;0;0;0;0;0;SECADOR DE PELO SG-3025 SILVER;PERSONAL CARE
26693905;;F;30;VENEZOLANO;;Extranjero;N/D;N/D;0;0;0;0;0;0;0;0;0;SECADOR DE PELO SE-3049C01 FUCSIA;PERSONAL CARE
16067377;;F;37;CHILENO;;Millenial;MAULE                         ;MAULE;0;0;0;0;0;0;0;0;0;ALISADOR SIEGEN SG-4716;PERSONAL CARE
18696043;;M;28;CHILENO;;Silencioso;PROVIDENCIA                   ;METROPOLITANA;0;0;0;0;0;0;0;0;0;AFEITADORA QP2521/50 ONE BLADE GRAFITO;PERSONAL CARE
19612017;;F;25;CHILENO;;Z;VALPARAISO                    ;VALPARAISO;0;0;0;0;0;0;0;0;0;ALISADOR DE PELO S12A(220) Shine Therapy PALTA M;PERSONAL CARE
12095945;;M;51;CHILENO;;X;"";"";0;0;0;0;0;0;0;0;0;SECADOR DIAMOND STD;PERSONAL CARE
17154123;Casado;F;33;CHILENO;;Millenial;RENCA                         ;METROPOLITANA;0;0;0;0;0;0;0;0;0;SECADOR DE PELO MISTRAL STD;PERSONAL CARE
19242093;Soltero;F;26;CHILENO;;Silencioso;PROVIDENCIA                   ;METROPOLITANA;0;0;0;0;0;0;0;0;0;SECADOR DE PELO DIAMOND ST BLOOM VT 220;PERSONAL CARE
15690938;;F;38;CHILENO;;X;ANTOFAGASTA                   ;ANTOFAGASTA;0;0;0;0;0;0;0;0;0;ALISADOR DE PELO SG-4651 ROJO;PERSONAL CARE
10373935;;M;55;CHILENO;;Boomers;CISNES                        ;AYSEN;0;0;0;0;0;0;0;0;0;CORTADOR DE PELO PACL GC 542 Sport Bat GT 527;PERSONAL CARE
12807000;;F;47;CHILENO;;Silencioso;PROVIDENCIA                   ;METROPOLITANA;0;0;0;0;0;0;0;0;0;SECADOR PELO SG-3012C19;PERSONAL CARE
9938514;Soltero;M;58;CHILENO;;Boomers;RENCA                         ;METROPOLITANA;0;0;0;0;0;0;0;0;0;AFEITADORA SPORT SH 886 BAT;PERSONAL CARE
18705943;Soltero;M;27;CHILENO;TECNICO DE NIVEL MEDIO EN ALIMENTACION;Millenial;PROVIDENCIA                   ;METROPOLITANA;0;0;0;0;0;0;0;0;0;ALISADOR DE PELO SG-3540 MORADO MORADO;PERSONAL CARE
18456297;;F;29;CHILENO;;Millenial;N/D;N/D;0;0;0;0;0;0;0;0;0;TRICOMBO SECADOR+ALISADOR+ONDULADOR;PERSONAL CARE
6622011;;F;71;CHILENO;;Silencioso;PROVIDENCIA                   ;METROPOLITANA;0;0;0;0;0;0;0;0;0;SECADOR DE PELO SG-3012 NEGRO;PERSONAL CARE
16312127;;F;36;CHILENO;;Millenial;PUERTO MONTT                  ;LOS LAGOS;0;0;0;0;0;0;0;0;0;SECADOR DE PELO SG-3012 NEGRO;PERSONAL CARE
18648539;Soltero;F;28;CHILENO;PROFESOR;Millenial;PROVIDENCIA                   ;METROPOLITANA;0;0;0;0;0;0;0;0;0;ALISADOR DE PELO S12A(220) Shine Therapy PALTA M;PERSONAL CARE
16575151;Soltero;F;35;CHILENO;BIOQUIMICO;Millenial;QUILLOTA                      ;VALPARAISO;0;0;0;0;0;0;0;0;0;ALISADOR PHILIPS BHS376;PERSONAL CARE
18342821;Soltero;M;29;CHILENO;PROFESOR;Millenial;PROVIDENCIA                   ;METROPOLITANA;0;0;0;0;0;0;0;0;0;CORTA PELO SG-8520;PERSONAL CARE
18416030;;M;29;CHILENO;;Millenial;"";"";0;0;0;0;0;0;0;0;0;ALISADOR DE PELO SG-3540 MORADO MORADO;PERSONAL CARE
16653519;;F;34;CHILENO;;Silencioso;PROVIDENCIA                   ;METROPOLITANA;0;0;0;0;0;0;0;0;0;SECADOR DE VIAJE REMINGTON D2400;PERSONAL CARE
18897336;;F;28;CHILENO;;Millenial;IQUIQUE                       ;TARAPACA;0;0;0;0;0;0;0;0;0;SECADOR DE PELO SE-3049C01 FUCSIA;PERSONAL CARE
14420201;;M;51;CHILENO;;X;RENCA                         ;METROPOLITANA;0;0;0;0;0;0;0;0;0;AFEITADORA SPORT SH 886 BAT;PERSONAL CARE
14905033;;F;42;CHILENO;;X;"";"";0;0;0;0;0;0;0;0;0;SECADOR DE PELO SG-3043 DC CAFE 2200 WATTS;PERSONAL CARE
18895341;;M;27;CHILENO;;Z;TALCA                         ;MAULE;0;0;0;0;0;0;0;0;0;SECADOR DIAMOND STD;PERSONAL CARE
19602634;Soltero;F;30;CHILENO;TECNICO EN RECURSOS HUMANOS;Millenial;SAN PEDRO                     ;METROPOLITANA;0;0;0;0;0;0;0;0;0;SECADOR DIAMOND STD;PERSONAL CARE
16728271;;F;34;CHILENO;;Millenial;PROVIDENCIA                   ;METROPOLITANA;0;0;0;0;0;0;0;0;0;ALISADOR DE PELO SG-3512D1 ROSA;PERSONAL CARE
10347909;;M;54;CHILENO;;Boomers;"";"";0;0;0;0;0;0;0;0;0;AFEITADORA XR1430 NEGRO;PERSONAL CARE
17649965;;F;31;CHILENO;;Millenial;QUELLON                       ;LOS LAGOS;0;0;0;0;0;0;0;0;0;SECADOR DE PELO SG-3025 SILVER;PERSONAL CARE
11231483;;M;53;CHILENO;;X;VILLARICA                     ;ARAUCANIA;0;0;0;0;0;0;0;0;0;ALISADOR SIEGEN SG-4716;PERSONAL CARE
19758037;;M;24;CHILENO;;Z;PROVIDENCIA                   ;METROPOLITANA;0;0;0;0;0;0;0;0;0;AFEITADORA SPORT SH 886 BAT;PERSONAL CARE
17646170;;F;31;CHILENO;;Millenial;SAN FELIPE                    ;VALPARAISO;0;0;0;0;0;0;0;0;0;CORTA PELO GC-625;PERSONAL CARE
16048660;;F;37;CHILENO;;Silencioso;PROVIDENCIA                   ;METROPOLITANA;0;0;0;0;0;0;0;0;0;ALISADOR DE PELO HP8321;PERSONAL CARE
19129023;Soltero;F;26;CHILENO;TECNICO EN ENFERMERIA DE NIVEL SUPERIOR;Z;N/D;N/D;0;0;0;0;0;0;0;0;0;SECADOR DE PELO DIAMOND ST BLOOM VT 220;PERSONAL CARE
5738755;;M;69;CHILENO;;Silencioso;RENCA                         ;METROPOLITANA;0;0;0;0;0;0;0;0;0;SECADOR PELO SG-3012C20;PERSONAL CARE
18321093;;F;29;CHILENO;;Millenial;LONQUIMAY                     ;ARAUCANIA;0;0;0;0;0;0;0;0;0;SECADOR TEMPO TITAN KERATIN;PERSONAL CARE
14030454;;M;40;CHILENO;;X;TALCAHUANO                    ;BIO BIO;0;0;0;0;0;0;0;0;0;PACK AFEITADORA S1223/41+CORTA PELO HC3505/15;PERSONAL CARE
18558048;;M;29;CHILENO;;Millenial;PROVIDENCIA                   ;METROPOLITANA;0;0;0;0;0;0;0;0;0;DEPILADORA BRE225/00;PERSONAL CARE
18583985;;F;29;CHILENO;;Millenial;PROVIDENCIA                   ;METROPOLITANA;0;0;0;0;0;0;0;0;0;SECADOR DE PELO SIEGEN SG-3035;PERSONAL CARE
11556962;;M;52;CHILENO;;X;RENCA                         ;METROPOLITANA;0;0;0;0;0;0;0;0;0;SECADOR DE PELO SG-3012 NEGRO;PERSONAL CARE
13918854;;M;44;CHILENO;;X;N/D;N/D;0;0;0;0;0;0;0;0;0;SECADOR DE PELO SIEGEN SG-3035;PERSONAL CARE
26722863;;F;28;VENEZOLANO;;Extranjero;N/D;N/D;0;0;0;0;0;0;0;0;0;AFEITADORA SG-7250 NEGRO;PERSONAL CARE
11983863;;M;49;CHILENO;;X;CONSTITUCION                  ;MAULE;0;0;0;0;0;0;0;0;0;AFEITADORA SG-7250 NEGRO;PERSONAL CARE
18334626;Soltero;F;29;CHILENO;;Millenial;PROVIDENCIA                   ;METROPOLITANA;0;0;0;0;0;0;0;0;0;DEPILADORA BRE255/00;PERSONAL CARE
11708689;;M;51;CHILENO;;X;OSORNO                        ;LOS LAGOS;0;0;0;0;0;0;0;0;0;ALISADOR DE PELO SG-4651 ROJO;PERSONAL CARE
11388716;;M;52;CHILENO;;X;RENCA                         ;METROPOLITANA;0;0;0;0;0;0;0;0;0;Trimmer Gama GT 527;PERSONAL CARE
10379661;;F;54;CHILENO;;Boomers;PROVIDENCIA                   ;METROPOLITANA;0;0;0;0;0;0;0;0;0;SPA PARA PIES SG-1560;PERSONAL CARE
11995045;Divorciado;F;51;CHILENO;;X;LA PINTANA                    ;METROPOLITANA;0;0;0;0;0;0;0;0;0;CORTADOR DE PELO PACL GC 542 Sport Bat GT 527;PERSONAL CARE
17440853;;M;32;CHILENO;;Millenial;TALTAL                        ;ANTOFAGASTA;0;0;0;0;0;0;0;0;0;SECADOR PELO SG-3012C20;PERSONAL CARE
16929003;;M;33;CHILENO;;Millenial;CHIMBARONGO                   ;L.G.B.OÂ´HIGGINS;0;0;0;0;0;0;0;0;0;CORTA PELO PG6025 KIT RECORTE;PERSONAL CARE
11286681;;F;54;CHILENO;;X;PROVIDENCIA                   ;METROPOLITANA;0;0;0;0;0;0;0;0;0;CORTA PELO HC3520;PERSONAL CARE
10209854;Casado;F;56;CHILENO;;Boomers;RENCA                         ;METROPOLITANA;0;0;0;0;0;0;0;0;0;SECADOR DE PELO PEGABLE D1500 NEGRO;PERSONAL CARE
14584487;;F;42;CHILENO;;X;RENCA                         ;METROPOLITANA;0;0;0;0;0;0;0;0;0;SECADOR DIAMOND STD;PERSONAL CARE
18432924;;F;29;CHILENO;;Millenial;"";"";0;0;0;0;0;0;0;0;0;SPA PARA PIES SG-1560;PERSONAL CARE
9289039;Casado;F;61;CHILENO;;Boomers;RENCA                         ;METROPOLITANA;0;0;0;0;0;0;0;0;0;CORTA PELO PG6025 KIT RECORTE;PERSONAL CARE
11278257;;M;54;CHILENO;;X;MAIPU                         ;METROPOLITANA;0;0;0;0;0;0;0;0;0;COMBO SIEGEN AFEITADORA + MULTISTYLER SG-8440;PERSONAL CARE
10074194;;F;63;CHILENO;;Silencioso;PROVIDENCIA                   ;METROPOLITANA;0;0;0;0;0;0;0;0;0;CORTA PELO HC3520;PERSONAL CARE
20275482;;F;22;CHILENO;;Silencioso;PROVIDENCIA                   ;METROPOLITANA;0;0;0;0;0;0;0;0;0;SECADOR DE PELO SE-3049C01 FUCSIA;PERSONAL CARE
19781289;;F;24;CHILENO;;Z;PROVIDENCIA                   ;METROPOLITANA;0;0;0;0;0;0;0;0;0;SECADOR TEMPO TITAN KERATIN;PERSONAL CARE
14209353;Soltero;M;41;CHILENO;;X;RENCA                         ;METROPOLITANA;0;0;0;0;0;0;0;0;0;SECADOR GAMA EOLIC MINI TRAVEL;PERSONAL CARE
19523679;Soltero;F;25;CHILENO;;Silencioso;PROVIDENCIA                   ;METROPOLITANA;0;0;0;0;0;0;0;0;0;CORTA PELO GC-625;PERSONAL CARE
20156006;;M;22;CHILENO;;Z;PENCO                         ;BIO BIO;0;0;0;0;0;0;0;0;0;ALISADOR DE PELO SG-3540 MORADO MORADO;PERSONAL CARE
18956715;;M;27;CHILENO;;Z;"";"";0;0;0;0;0;0;0;0;0;AFEITADORA QP2521/50 ONE BLADE GRAFITO;PERSONAL CARE
19018262;;F;27;CHILENO;;Millenial;PROVIDENCIA                   ;METROPOLITANA;0;0;0;0;0;0;0;0;0;SECADOR TEMPO TITAN KERATIN;PERSONAL CARE
20241405;;M;22;CHILENO;;Z;PROVIDENCIA                   ;METROPOLITANA;0;0;0;0;0;0;0;0;0;Afeitadora Corporal Serie 3000 Philips BG105/11;PERSONAL CARE
20869012;;F;20;CHILENO;;Silencioso;PROVIDENCIA                   ;METROPOLITANA;0;0;0;0;0;0;0;0;0;ALISADOR DE PELO SG-3540 MORADO MORADO;PERSONAL CARE
9886559;;M;58;CHILENO;;Boomers;PROVIDENCIA                   ;METROPOLITANA;0;0;0;0;0;0;0;0;0;SECADOR DE PELO SE-3049C01 FUCSIA;PERSONAL CARE
24783134;;F;48;VENEZOLANO;;Extranjero;HUECHURABA                    ;METROPOLITANA;0;0;0;0;0;0;0;0;0;DEPILADORA GAMA ESSENCIAL;PERSONAL CARE
16442926;;F;35;CHILENO;;Millenial;PROVIDENCIA                   ;METROPOLITANA;0;0;0;0;0;0;0;0;0;SECADOR PELO SG-3012C19;PERSONAL CARE
11551713;;F;51;CHILENO;;X;PROVIDENCIA                   ;METROPOLITANA;0;0;0;0;0;0;0;0;0;SECADOR DE PELO SIEGEN SG-3035;PERSONAL CARE
26294307;;F;34;BOLIVIANO;;Extranjero;PROVIDENCIA                   ;METROPOLITANA;0;0;0;0;0;0;0;0;0;DEPILADORA IPL MAGNA PK;PERSONAL CARE
16045953;;M;36;CHILENO;;Millenial;N/D;N/D;0;0;0;0;0;0;0;0;0;DEPILADORA GAMA ESSENCIAL;PERSONAL CARE
18811025;;F;27;CHILENO;;Silencioso;PROVIDENCIA                   ;METROPOLITANA;0;0;0;0;0;0;0;0;0;ALISADORA SG-4653;PERSONAL CARE
20576936;;F;20;CHILENO;;Z;PROVIDENCIA                   ;METROPOLITANA;0;0;0;0;0;0;0;0;0;ALISADOR DE PELO SG-3510 FUCSIA;PERSONAL CARE
11671867;;F;52;CHILENO;;X;PROVIDENCIA                   ;METROPOLITANA;0;0;0;0;0;0;0;0;0;SECADOR PELO SG-3012C19;PERSONAL CARE
13768500;;F;42;CHILENO;;X;SANTIAGO                      ;METROPOLITANA;0;0;0;0;0;0;0;0;0;DEPILADORA IPL 3500 LUZ PULSADA;PERSONAL CARE
19878087;;F;24;CHILENO;;Z;PROVIDENCIA                   ;METROPOLITANA;0;0;0;0;0;0;0;0;0;ALISADOR ELEGANCE KERATION ST BVT;PERSONAL CARE
24131920;;F;49;COLOMBIANO;;Extranjero;PUERTO MONTT                  ;LOS LAGOS;0;0;0;0;0;0;0;0;0;DEPILADORA IPL MAGNA PK;PERSONAL CARE
19760563;;F;25;CHILENO;;Z;PROVIDENCIA                   ;METROPOLITANA;0;0;0;0;0;0;0;0;0;SECADOR DE PELO MISTRAL STD;PERSONAL CARE
10486203;;F;47;CHILENO;;Silencioso;PROVIDENCIA                   ;METROPOLITANA;0;0;0;0;0;0;0;0;0;CORTA PELO SG-8200;PERSONAL CARE
16614136;;M;35;CHILENO;;Millenial;PROVIDENCIA                   ;METROPOLITANA;0;0;0;0;0;0;0;0;0;ALISADOR DE PELO SG-4651 ROJO;PERSONAL CARE
8287001;;M;65;CHILENO;;Boomers;LINARES                       ;MAULE;0;0;0;0;0;0;0;0;0;SECADOR GAMA EOLIC MINI TRAVEL;PERSONAL CARE
16463994;;F;36;CHILENO;;Millenial;"";"";0;0;0;0;0;0;0;0;0;ALISADOR ELEGANCE LED KER;PERSONAL CARE
20441244;;F;22;CHILENO;;Z;PROVIDENCIA                   ;METROPOLITANA;0;0;0;0;0;0;0;0;0;ALISADOR AQUA THERAPY LED;PERSONAL CARE
8248030;;F;68;CHILENO;;Silencioso;VALLENAR;ATACAMA;0;0;0;0;0;0;0;0;0;ALISADOR REMIGNTON S1305 (BV) R;PERSONAL CARE
16831258;;F;34;CHILENO;;Millenial;OSORNO                        ;LOS LAGOS;0;0;0;0;0;0;0;0;0;ALISADOR DE PELO SG-4651 ROJO;PERSONAL CARE
17248856;Casado;M;33;CHILENO;;Silencioso;PROVIDENCIA                   ;METROPOLITANA;0;0;0;0;0;0;0;0;0;AFEITADORA BRAUN S3040;PERSONAL CARE
18748662;;F;28;CHILENO;;Millenial;CERRILLOS                     ;METROPOLITANA;0;0;0;0;0;0;0;0;0;DEPILADORA SE1170 BRAUN;PERSONAL CARE
17463061;;M;32;CHILENO;;Millenial;PROVIDENCIA                   ;METROPOLITANA;0;0;0;0;0;0;0;0;0;KIT CORTABARBA MG3731;PERSONAL CARE
18985431;;F;27;CHILENO;;Millenial;"";"";0;0;0;0;0;0;0;0;0;ALISADOR GAMA BELLA SHINE;PERSONAL CARE
12511230;;M;49;CHILENO;;X;EL BOSQUE                     ;METROPOLITANA;0;0;0;0;0;0;0;0;0;AFEITADORA SG-7250 NEGRO;PERSONAL CARE
13838634;;F;42;CHILENO;;X;LA CISTERNA                   ;METROPOLITANA;0;0;0;0;0;0;0;0;0;ONDULADOR DE PELO GAMA TURMALINA 19MM;PERSONAL CARE
15606407;;M;38;CHILENO;;Millenial;PROVIDENCIA                   ;METROPOLITANA;0;0;0;0;0;0;0;0;0;Depiladora E SkinPro Go Bvt;PERSONAL CARE
20230455;;F;22;CHILENO;;Silencioso;PROVIDENCIA                   ;METROPOLITANA;0;0;0;0;0;0;0;0;0;CORTA PELO SG-8200;PERSONAL CARE
10917947;;M;50;CHILENO;;X;PROVIDENCIA                   ;METROPOLITANA;0;0;0;0;0;0;0;0;0;AFEITADORA S1323/41 ELECTRICA;PERSONAL CARE
10104743;;M;58;CHILENO;;Boomers;PROVIDENCIA                   ;METROPOLITANA;0;0;0;0;0;0;0;0;0;CORTA PELO HC3505;PERSONAL CARE
20143946;;F;23;CHILENO;;Z;N/D;N/D;0;0;0;0;0;0;0;0;0;ALISADOR DE PELO SG-4651 ROJO;PERSONAL CARE
13410583;;M;44;CHILENO;;X;COIHAIQUE                     ;AYSEN;0;0;0;0;0;0;0;0;0;SECADOR DE PELO SG-3012 NEGRO;PERSONAL CARE
15304247;;M;38;CHILENO;;Millenial;PROVIDENCIA                   ;METROPOLITANA;0;0;0;0;0;0;0;0;0;AFEITADORA QP2521/50 ONE BLADE GRAFITO;PERSONAL CARE
25469648;;M;34;VENEZOLANO;;Extranjero;"";"";0;0;0;0;0;0;0;0;0;ALISADOR ELEGANCE LED KER;PERSONAL CARE
19170186;Soltero;F;27;CHILENO;;Z;PROVIDENCIA                   ;METROPOLITANA;0;0;0;0;0;0;0;0;0;SECADOR GAMA EOLIC MINI TRAVEL;PERSONAL CARE
18043893;;F;29;CHILENO;;Millenial;"";"";0;0;0;0;0;0;0;0;0;SECADOR DE PELO SG-3012 NEGRO;PERSONAL CARE
16951362;;M;34;CHILENO;;Millenial;N/D;N/D;0;0;0;0;0;0;0;0;0;ALISADOR ELEGANCE LED KER;PERSONAL CARE
11513259;;F;52;CHILENO;;X;RENCA                         ;METROPOLITANA;0;0;0;0;0;0;0;0;0;DEPILADORA GAMA ESSENCIAL;PERSONAL CARE
16817626;;F;34;CHILENO;;Millenial;EL BOSQUE;METROPOLITANA;0;0;0;0;0;0;0;0;0;DEPILADORA BRE225/00;PERSONAL CARE
11934400;;M;49;CHILENO;;X;VALLENAR;ATACAMA;0;0;0;0;0;0;0;0;0;DEPILADORA SG-9004;PERSONAL CARE
9063629;Casado;M;57;CHILENO;;Boomers;PROVIDENCIA                   ;METROPOLITANA;0;0;0;0;0;0;0;0;0;SECADOR DE PELO SG-3049 NEGRO;PERSONAL CARE
19576758;;F;24;CHILENO;;Z;PROVIDENCIA                   ;METROPOLITANA;0;0;0;0;0;0;0;0;0;DEPILADORA IPL 3500 LUZ PULSADA;PERSONAL CARE
16306273;;F;36;CHILENO;;Millenial;PROVIDENCIA                   ;METROPOLITANA;0;0;0;0;0;0;0;0;0;SECADOR DE PELO SE-3049C01 FUCSIA;PERSONAL CARE
13977577;;M;40;CHILENO;;X;ILLAPEL                       ;COQUIMBO;0;0;0;0;0;0;0;0;0;CORTA PELO SG-8520;PERSONAL CARE
8253148;;M;64;CHILENO;;Boomers;TENO                          ;MAULE;0;0;0;0;0;0;0;0;0;ONDULADOR DE PELO SG-2411 25MM;PERSONAL CARE
17912720;;F;30;CHILENO;;Millenial;PROVIDENCIA                   ;METROPOLITANA;0;0;0;0;0;0;0;0;0;SECADOR DIAMOND STD;PERSONAL CARE
8673957;;F;63;CHILENO;;Boomers;PEUMO                         ;L.G.B.OÂ´HIGGINS;0;0;0;0;0;0;0;0;0;ALISADOR +SECADOR PELO;PERSONAL CARE
12634837;;F;47;CHILENO;;X;N/D;N/D;0;0;0;0;0;0;0;0;0;ALISADOR +SECADOR PELO;PERSONAL CARE
19090047;;F;26;CHILENO;;Z;PROVIDENCIA                   ;METROPOLITANA;0;0;0;0;0;0;0;0;0;AFEITADORA S1121/41 ELECTRICA;PERSONAL CARE
17776750;Soltero;M;32;CHILENO;;Millenial;PROVIDENCIA                   ;METROPOLITANA;0;0;0;0;0;0;0;0;0;CORTA PELO GM 562;PERSONAL CARE
17870208;;M;30;CHILENO;;Silencioso;PROVIDENCIA                   ;METROPOLITANA;0;0;0;0;0;0;0;0;0;SECADOR GAMA EOLIC MINI TRAVEL;PERSONAL CARE
15939455;;F;37;CHILENO;;Millenial;MELIPILLA                     ;METROPOLITANA;0;0;0;0;0;0;0;0;0;ALISADOR DE PELO SG-3512D1 ROSA;PERSONAL CARE
10450291;;F;55;CHILENO;;Boomers;RENCA                         ;METROPOLITANA;0;0;0;0;0;0;0;0;0;SECADOR DE PELO SG-3012C17 NARANJO;PERSONAL CARE
13099324;Casado;F;45;CHILENO;;X;RENCA                         ;METROPOLITANA;0;0;0;0;0;0;0;0;0;DEPILADORA SG-9004;PERSONAL CARE
15120065;Casado;F;43;CHILENO;;X;PROVIDENCIA                   ;METROPOLITANA;0;0;0;0;0;0;0;0;0;SECADOR DIAMOND STD;PERSONAL CARE
10533974;;M;57;CHILENO;;Silencioso;PROVIDENCIA                   ;METROPOLITANA;0;0;0;0;0;0;0;0;0;COMBO SIEGEN AFEITADORA + MULTISTYLER SG-8440;PERSONAL CARE
17367325;;F;32;CHILENO;;Millenial;PROVIDENCIA                   ;METROPOLITANA;0;0;0;0;0;0;0;0;0;ALISADOR ATTIVA STD;PERSONAL CARE
20710013;;M;21;CHILENO;;Z;QUILLOTA                      ;VALPARAISO;0;0;0;0;0;0;0;0;0;CORTA PELO GM 562;PERSONAL CARE
10591972;Casado;M;55;CHILENO;TECNICO AGRICOLA;Boomers;PROVIDENCIA                   ;METROPOLITANA;0;0;0;0;0;0;0;0;0;ALISADOR DE PELO HP8321;PERSONAL CARE
15674389;;F;38;CHILENO;;Silencioso;PROVIDENCIA                   ;METROPOLITANA;0;0;0;0;0;0;0;0;0;SECADOR DE PELO STD TITAN KERATIN PLATA;PERSONAL CARE
16855197;Casado;F;34;CHILENO;;Millenial;PROVIDENCIA                   ;METROPOLITANA;0;0;0;0;0;0;0;0;0;CORTA PELO GM 562;PERSONAL CARE
14610350;Casado;F;41;CHILENO;AUXILIAR PARAMEDICO DE ODONTOLOGIA;X;RENCA                         ;METROPOLITANA;0;0;0;0;0;0;0;0;0;SECADOR DE PELO SG-3049 NEGRO;PERSONAL CARE
19071135;;M;26;CHILENO;;Z;PROVIDENCIA                   ;METROPOLITANA;0;0;0;0;0;0;0;0;0;CORTA PELO SPORT GCX 623 BVT;PERSONAL CARE
14099114;;M;41;CHILENO;;X;TOCOPILLA                     ;ANTOFAGASTA;0;0;0;0;0;0;0;0;0;DEPILADORA BRE700/00 MID-END CLOSED BOX;PERSONAL CARE
9105825;;M;55;CHILENO;;Boomers;COYHAIQUE;AYSEN;0;0;0;0;0;0;0;0;0;SECADOR DE PELO SE-3049C01 FUCSIA;PERSONAL CARE
9603524;;M;60;CHILENO;;Boomers;SAN RAMON                     ;METROPOLITANA;0;0;0;0;0;0;0;0;0;DEPILADORA SG-9004;PERSONAL CARE
15047102;;F;42;CHILENO;;X;SALAMANCA                     ;COQUIMBO;0;0;0;0;0;0;0;0;0;DEPILADORA BRE285/00 CONVENCIONAL;PERSONAL CARE
10160212;;M;57;CHILENO;;Boomers;PUNTA ARENAS                  ;MAGALLANES;0;0;0;0;0;0;0;0;0;CORTA PELO SPORT GC 542 BVT;PERSONAL CARE
7211490;Viudo;F;68;CHILENO;PROFESOR;Boomers;PROVIDENCIA                   ;METROPOLITANA;0;0;0;0;0;0;0;0;0;ALISADOR DE PELO SG-3540 MORADO MORADO;PERSONAL CARE
13914319;;M;42;CHILENO;;X;LA FLORIDA                    ;METROPOLITANA;0;0;0;0;0;0;0;0;0;BALANZA FIT ULTRA;PERSONAL CARE
19668569;;F;25;CHILENO;;Z;PROVIDENCIA                   ;METROPOLITANA;0;0;0;0;0;0;0;0;0;ALISADOR DE PELO SG-3512D1 ROSA;PERSONAL CARE
16535094;;F;35;CHILENO;;Millenial;NIQUEN                        ;BIO BIO;0;0;0;0;0;0;0;0;0;DEPILADORA BRE225/00;PERSONAL CARE
9276680;;M;58;CHILENO;;Boomers;PROVIDENCIA                   ;METROPOLITANA;0;0;0;0;0;0;0;0;0;SECADOR PELO SG-3012C19;PERSONAL CARE
19804264;;F;24;CHILENO;;Z;CERRO NAVIA                   ;METROPOLITANA;0;0;0;0;0;0;0;0;0;DEPILADORA BRE225/00;PERSONAL CARE
14320115;;M;46;CHILENO;;X;PROVIDENCIA                   ;METROPOLITANA;0;0;0;0;0;0;0;0;0;SECADOR DE PELO SE-3049C01 FUCSIA;PERSONAL CARE
16576932;Soltero;F;33;CHILENO;PROFESOR;Millenial;PROVIDENCIA                   ;METROPOLITANA;0;0;0;0;0;0;0;0;0;DEPILADORA SG-9004EX;PERSONAL CARE
15589584;;M;40;CHILENO;;X;CHIGUAYANTE                   ;BIO BIO;0;0;0;0;0;0;0;0;0;AFEITADORA GSH930 CHI NEGRA;PERSONAL CARE
16772844;;M;34;CHILENO;;Millenial;RENCA                         ;METROPOLITANA;0;0;0;0;0;0;0;0;0;ALISADOR DE PELO S8607 DE COCO VERDE;PERSONAL CARE
14025654;;M;41;CHILENO;;X;RENCA                         ;METROPOLITANA;0;0;0;0;0;0;0;0;0;KIT CORTABARBA MG3711;PERSONAL CARE
10633202;;F;54;CHILENO;;X;RENCA                         ;METROPOLITANA;0;0;0;0;0;0;0;0;0;SECADOR DE PELO DIVA NEGRO;PERSONAL CARE
17532875;Soltero;M;31;CHILENO;;Millenial;PROVIDENCIA                   ;METROPOLITANA;0;0;0;0;0;0;0;0;0;DEPILADORA CYBELE IPL GOLD 200 MIL PULSACIONES;PERSONAL CARE
7915916;;M;66;CHILENO;;Boomers;PROVIDENCIA                   ;METROPOLITANA;0;0;0;0;0;0;0;0;0;AFEITADORA PR1342 ROTATIVA RECARGABLE;PERSONAL CARE
7402827;;M;64;CHILENO;;Boomers;MELIPILLA                     ;METROPOLITANA;0;0;0;0;0;0;0;0;0;DEPILADORA IPL 3500 LUZ PULSADA;PERSONAL CARE
14046342;;M;41;CHILENO;;X;N/D;N/D;0;0;0;0;0;0;0;0;0;DEPILADORA SG-9004;PERSONAL CARE
19720065;;F;24;CHILENO;;Z;PROVIDENCIA                   ;METROPOLITANA;0;0;0;0;0;0;0;0;0;ALISADOR DE PELO HP8321;PERSONAL CARE
14155754;;F;40;CHILENO;;X;LA SERENA                     ;COQUIMBO;0;0;0;0;0;0;0;0;0;CORTA PELO SG-8200;PERSONAL CARE
9884094;;M;56;CHILENO;;Boomers;NANCAGUA                      ;L.G.B.OÂ´HIGGINS;0;0;0;0;0;0;0;0;0;AFEITADORA S1121/41 ELECTRICA;PERSONAL CARE
12668555;;F;48;CHILENO;;X;LA FLORIDA                    ;METROPOLITANA;0;0;0;0;0;0;0;0;0;ALISADOR DE PELO S12A(220) Shine Therapy PALTA M;PERSONAL CARE
17556327;;F;32;CHILENO;;Millenial;"";"";0;0;0;0;0;0;0;0;0;ALISADOR DE PELO SG-3510 FUCSIA;PERSONAL CARE
25976305;;M;31;EXTRANJERO - NO INFORMA NACIONALIDAD;;Extranjero;N/D;N/D;0;0;0;0;0;0;0;0;0;ALISADOR SIEGEN SG-4716;PERSONAL CARE
6150132;Soltero;F;71;CHILENO;;Silencioso;RENCA                         ;METROPOLITANA;0;0;0;0;0;0;0;0;0;ALISADOR DE PELO HP8321;PERSONAL CARE
17251730;;F;33;CHILENO;;Millenial;PROVIDENCIA                   ;METROPOLITANA;0;0;0;0;0;0;0;0;0;CORTA PELO SG-8200;PERSONAL CARE
14534677;;F;47;CHILENO;;X;PROVIDENCIA                   ;METROPOLITANA;0;0;0;0;0;0;0;0;0;CORTA PELO SPORT GCX 623 BVT;PERSONAL CARE
16929626;;F;33;CHILENO;;Millenial;PROVIDENCIA                   ;METROPOLITANA;0;0;0;0;0;0;0;0;0;CORTA PELO SPORT GCX 623 BVT;PERSONAL CARE
12540149;;F;48;CHILENO;;X;PROVIDENCIA                   ;METROPOLITANA;0;0;0;0;0;0;0;0;0;SECADOR PELO SG-3012C20;PERSONAL CARE
11205107;Soltero;M;54;CHILENO;;Boomers;LA SERENA                     ;COQUIMBO;0;0;0;0;0;0;0;0;0;Secador Potenza Keration;PERSONAL CARE
17438340;;M;32;CHILENO;;Millenial;N/D;N/D;0;0;0;0;0;0;0;0;0;DEPILADORA SG-9003;PERSONAL CARE
17472828;;F;32;CHILENO;;Millenial;COIHAIQUE                     ;AYSEN;0;0;0;0;0;0;0;0;0;DEPILADORA SG-9003;PERSONAL CARE
10756684;;M;52;CHILENO;;X;RENCA                         ;METROPOLITANA;0;0;0;0;0;0;0;0;0;DEPILADORA SG-9004;PERSONAL CARE
8898202;;F;62;CHILENO;;Boomers;PROVIDENCIA                   ;METROPOLITANA;0;0;0;0;0;0;0;0;0;CORTA PELO GM 562;PERSONAL CARE
12060007;;F;62;BOLIVIANO;;Extranjero;CALAMA                        ;ANTOFAGASTA;0;0;0;0;0;0;0;0;0;SECADOR DIAMOND STD;PERSONAL CARE
9665424;;F;58;CHILENO;;Boomers;PROVIDENCIA                   ;METROPOLITANA;0;0;0;0;0;0;0;0;0;CORTA PELO SG-8200;PERSONAL CARE
12312404;;M;49;CHILENO;;X;LOS ANDES                     ;VALPARAISO;0;0;0;0;0;0;0;0;0;AFEITADORA SG-7250 NEGRO;PERSONAL CARE
18179361;Soltero;F;29;CHILENO;;Millenial;PROVIDENCIA                   ;METROPOLITANA;0;0;0;0;0;0;0;0;0;SECADOR DIAMOND STD;PERSONAL CARE
11088329;;F;56;CHILENO;;Boomers;YUNGAY                        ;BIO BIO;0;0;0;0;0;0;0;0;0;OLLA CERA DEPILACION 500CC;PERSONAL CARE
17761199;;F;31;CHILENO;;Millenial;PROVIDENCIA                   ;METROPOLITANA;0;0;0;0;0;0;0;0;0;AFEITADORA SG-7250 NEGRO;PERSONAL CARE
10196123;;M;56;CHILENO;;Boomers;RENCA                         ;METROPOLITANA;0;0;0;0;0;0;0;0;0;DEPILADORA SG-9004EX;PERSONAL CARE
8554493;;F;61;CHILENO;;Boomers;MELIPILLA                     ;METROPOLITANA;0;0;0;0;0;0;0;0;0;ALISADOR DE PELO SG-3540 MORADO MORADO;PERSONAL CARE
19273805;;F;26;CHILENO;;Z;PROVIDENCIA                   ;METROPOLITANA;0;0;0;0;0;0;0;0;0;ALISADOR DE PELO SG-3540 MORADO MORADO;PERSONAL CARE
26442099;;M;35;VENEZOLANO;;Extranjero;N/D;N/D;0;0;0;0;0;0;0;0;0;ALISADOR ELEGANCE LED BLOOM VT;PERSONAL CARE
6478738;;M;69;CHILENO;;Silencioso;CONCEPCION                    ;BIO BIO;0;0;0;0;0;0;0;0;0;DEPILADORA OASIS SENSATION;PERSONAL CARE
15451901;;F;40;CHILENO;;X;SAN BERNARDO                  ;METROPOLITANA;0;0;0;0;0;0;0;0;0;CORTA PELO SPORT GC 542 BVT;PERSONAL CARE
19281687;Soltero;M;26;CHILENO;TECNICO ELECTRICO;Z;PROVIDENCIA                   ;METROPOLITANA;0;0;0;0;0;0;0;0;0;KIT PG181;PERSONAL CARE
7675103;;F;69;CHILENO;;Silencioso;SAN IGNACIO                   ;BIO BIO;0;0;0;0;0;0;0;0;0;SECADOR PELO SG-3012C20;PERSONAL CARE
25332005;;F;26;BOLIVIANO;;Extranjero;MEJILLONES                    ;ANTOFAGASTA;0;0;0;0;0;0;0;0;0;CORTA PELO SPORT GCX 623 BVT;PERSONAL CARE
6614959;;M;67;CHILENO;;Boomers;LA CISTERNA                   ;METROPOLITANA;0;0;0;0;0;0;0;0;0;AFEITADORA S-5050;PERSONAL CARE
13372853;;F;44;CHILENO;;X;PROVIDENCIA                   ;METROPOLITANA;0;0;0;0;0;0;0;0;0;DEPILADORA BRE225/00;PERSONAL CARE
15155239;;M;40;CHILENO;;X;RENCA                         ;METROPOLITANA;0;0;0;0;0;0;0;0;0;ALISADOR DE PELO SG-4651 ROJO;PERSONAL CARE
20128695;;F;23;CHILENO;;Z;"";"";0;0;0;0;0;0;0;0;0;ALISADOR DE PELO S12A(220) Shine Therapy PALTA M;PERSONAL CARE
17113053;;F;33;CHILENO;;Millenial;RENCA                         ;METROPOLITANA;0;0;0;0;0;0;0;0;0;ALISADOR +SECADOR PELO;PERSONAL CARE
15821141;;F;37;CHILENO;;Millenial;N/D;N/D;0;0;0;0;0;0;0;0;0;ALISADOR DE PELO SG-3540 MORADO MORADO;PERSONAL CARE
14079218;Soltero;M;41;CHILENO;;X;RENCA                         ;METROPOLITANA;0;0;0;0;0;0;0;0;0;KIT CORTABARBA MG3731;PERSONAL CARE
18016560;;M;30;CHILENO;;Millenial;PROVIDENCIA                   ;METROPOLITANA;0;0;0;0;0;0;0;0;0;CORTA PELO SG-8520;PERSONAL CARE
12137749;;F;40;CHILENO;;X;PROVIDENCIA                   ;METROPOLITANA;0;0;0;0;0;0;0;0;0;CORTA PELO GM 562;PERSONAL CARE
15060453;;F;40;CHILENO;;Silencioso;PROVIDENCIA                   ;METROPOLITANA;0;0;0;0;0;0;0;0;0;ALISADOR DE PELO S12A(220) Shine Therapy PALTA M;PERSONAL CARE
9608214;;F;55;CHILENO;;Boomers;CERRO NAVIA                   ;METROPOLITANA;0;0;0;0;0;0;0;0;0;AFEITADORA SG-7250 NEGRO;PERSONAL CARE
6730716;Casado;F;70;CHILENO;;Silencioso;RENCA                         ;METROPOLITANA;0;0;0;0;0;0;0;0;0;SECADOR DE PELO TEMPO MORADO;PERSONAL CARE
16241990;;M;36;CHILENO;;Millenial;PROVIDENCIA                   ;METROPOLITANA;0;0;0;0;0;0;0;0;0;ALISADOR DE PELO SG-3540 MORADO MORADO;PERSONAL CARE
11532444;Viudo;F;52;CHILENO;;X;RENCA                         ;METROPOLITANA;0;0;0;0;0;0;0;0;0;DEPILADORA SG-9004;PERSONAL CARE
15677640;;F;38;CHILENO;;X;CHILLAN                       ;BIO BIO;0;0;0;0;0;0;0;0;0;AFEITADORA SG-7210 NEGRO;PERSONAL CARE
10254027;;M;54;CHILENO;;Boomers;PAINE                         ;METROPOLITANA;0;0;0;0;0;0;0;0;0;CORTAPELOS GM 596;PERSONAL CARE
14262329;;F;48;CHILENO;;X;SANTA CRUZ                    ;L.G.B.OÂ´HIGGINS;0;0;0;0;0;0;0;0;0;COMBO SECADOR+ALISADOR+ONDULADOR DE PELO;PERSONAL CARE
19588795;;M;25;CHILENO;;Z;MOSTAZAL                      ;L.G.B.OÂ´HIGGINS;0;0;0;0;0;0;0;0;0;CORTA PELO SG-8520;PERSONAL CARE
12275275;;M;50;CHILENO;;X;PUENTE ALTO                   ;METROPOLITANA;0;0;0;0;0;0;0;0;0;CORTAPELOS GM 596;PERSONAL CARE
11817495;;M;50;CHILENO;;X;TOCOPILLA                     ;ANTOFAGASTA;0;0;0;0;0;0;0;0;0;AFEITADORA SG-7210 NEGRO;PERSONAL CARE
7831323;;F;61;CHILENO;;Boomers;LOS ANDES                     ;VALPARAISO;0;0;0;0;0;0;0;0;0;DEPILADORA SG-9003;PERSONAL CARE
18277396;;F;29;CHILENO;;Millenial;N/D;N/D;0;0;0;0;0;0;0;0;0;ALISADOR ELEGANCE LED BLOOM VT;PERSONAL CARE
11579746;;F;51;CHILENO;;X;LOS ANGELES                   ;BIO BIO;0;0;0;0;0;0;0;0;0;SECADOR DE PELO SG-3025 SILVER;PERSONAL CARE
15025106;;F;37;CHILENO;;Millenial;COPIAPO                       ;ATACAMA;0;0;0;0;0;0;0;0;0;ONDULADOR DE PELO TURMALINA 25MM;PERSONAL CARE
7265437;;M;69;CHILENO;;Silencioso;COLBUN                        ;MAULE;0;0;0;0;0;0;0;0;0;SECADOR DE PELO SG-3025 SILVER;PERSONAL CARE
17249674;Soltero;M;33;CHILENO;;Millenial;PROVIDENCIA                   ;METROPOLITANA;0;0;0;0;0;0;0;0;0;CORTA PELO GM 562;PERSONAL CARE
12568611;;F;48;CHILENO;;X;RENCA                         ;METROPOLITANA;0;0;0;0;0;0;0;0;0;COMBO SECADOR+ALISADOR+ONDULADOR DE PELO;PERSONAL CARE
15508654;;M;38;CHILENO;;Millenial;PROVIDENCIA                   ;METROPOLITANA;0;0;0;0;0;0;0;0;0;CORTA PELO GM 562;PERSONAL CARE
19052334;;F;26;CHILENO;;Z;N/D;N/D;0;0;0;0;0;0;0;0;0;SECADOR DE PELO SE-3049C01 FUCSIA;PERSONAL CARE
7665186;;M;63;CHILENO;;Boomers;CHANARAL                      ;ATACAMA;0;0;0;0;0;0;0;0;0;DEPILADORA GAMA ESSENCIAL;PERSONAL CARE
15989855;;M;41;CHILENO;;X;SAN PEDRO DE LA PAZ           ;BIO BIO;0;0;0;0;0;0;0;0;0;DEPILADORA SG-9004EX;PERSONAL CARE
10616799;;F;46;CHILENO;;X;RENCA                         ;METROPOLITANA;0;0;0;0;0;0;0;0;0;DEPILADORA OASIS LOOK BVT;PERSONAL CARE
9666180;Soltero;M;58;CHILENO;ANALISTA DE SISTEMAS;Boomers;PROVIDENCIA                   ;METROPOLITANA;0;0;0;0;0;0;0;0;0;AFEITADORA R0050;PERSONAL CARE
18076138;;M;30;CHILENO;;Millenial;LOS ANDES                     ;VALPARAISO;0;0;0;0;0;0;0;0;0;CORTEPELO GT420;PERSONAL CARE
16495760;;F;34;CHILENO;;Millenial;RENCA                         ;METROPOLITANA;0;0;0;0;0;0;0;0;0;DEPILADORA SG-9004;PERSONAL CARE
5797184;;F;69;CHILENO;;Silencioso;RENCA                         ;METROPOLITANA;0;0;0;0;0;0;0;0;0;BALANZA FIT ULTRA;PERSONAL CARE
10358834;;F;56;CHILENO;;X;N/D;N/D;0;0;0;0;0;0;0;0;0;ALISADOR SIEGEN SG-4720;PERSONAL CARE
10928889;;F;55;CHILENO;;Boomers;RENCA                         ;METROPOLITANA;0;0;0;0;0;0;0;0;0;ALISADOR CP1 NOVAIHT DIG WL 5D SENSI NIGHT;PERSONAL CARE
17760604;;M;30;CHILENO;;Millenial;PARRAL                        ;MAULE;0;0;0;0;0;0;0;0;0;DEPILADORA HP-6543;PERSONAL CARE
18177527;Soltero;F;29;CHILENO;;Millenial;PROVIDENCIA                   ;METROPOLITANA;0;0;0;0;0;0;0;0;0;CORTA PELO GM 562;PERSONAL CARE
16451473;;M;36;CHILENO;;Millenial;INDEPENDENCIA;METROPOLITANA;0;0;0;0;0;0;0;0;0;CORTA PELO GM 562;PERSONAL CARE
5538308;;F;75;CHILENO;;Silencioso;TALAGANTE                     ;METROPOLITANA;313950;4;3;0;0;0;4;3;313950;MAQUINA COSER 2250;ELECTRODOMESTICOS
12315047;;F;49;CHILENO;;X;SAN VICENTE                   ;L.G.B.OÂ´HIGGINS;168843;6;5;0;0;0;6;5;168843;Horno Microondas Digital TH-20S01 20Lts;ELECTRODOMESTICOS
8550646;;M;51;CHILENO;;X;MONTE PATRIA                  ;COQUIMBO;24990;1;1;0;0;0;1;1;24990;Plancha THOMAS TH-7170 2200Watts Base Ceramica;ELECTRODOMESTICOS
16620843;;M;35;CHILENO;;Millenial;"";"";29990;1;1;0;0;0;1;1;29990;Hervidor Electrico Tetera UT-LECKER18R 1,8Lts;ELECTRODOMESTICOS
7605151;;F;65;CHILENO;;Boomers;RENCA                         ;METROPOLITANA;1502910;9;5;0;0;0;9;5;1502910;Horno Microondas Digital TH-25DM 25Lts;ELECTRODOMESTICOS
16459506;;F;35;CHILENO;;Millenial;PROVIDENCIA                   ;METROPOLITANA;24990;1;1;0;0;0;1;1;24990;Plancha THOMAS TH-7170 2200Watts Base Ceramica;ELECTRODOMESTICOS
4143161;;F;86;CHILENO;;Silencioso;OVALLE                        ;COQUIMBO;69990;1;1;0;0;0;1;1;69990;Horno Microondas Mecanico TH-18B05 18Lts;ELECTRODOMESTICOS
8611384;;F;61;CHILENO;;Boomers;LOS ANGELES                   ;BIO BIO;216970;3;6;0;0;0;3;6;216970;Hervidor Electrico UT-KLAR20PW 2Lts Blanco;ELECTRODOMESTICOS
10345748;;M;45;CHILENO;;X;QUILPUE                       ;VALPARAISO;62970;3;1;0;0;0;3;1;62970;Aspiradora Handy Clean Black 1400;ELECTRODOMESTICOS
10888397;;M;55;CHILENO;;Boomers;PROVIDENCIA                   ;METROPOLITANA;14990;1;1;0;0;0;1;1;14990;Hervidor Electrico HA-3300 2,5Lts Blanco;ELECTRODOMESTICOS
9306443;;F;59;CHILENO;;Boomers;N/D;N/D;353950;5;4;0;0;0;5;4;353950;Plancha a Vapor 5001;ELECTRODOMESTICOS
13408141;Casado;F;43;CHILENO;;X;RENCA                         ;METROPOLITANA;18990;1;1;0;0;0;1;1;18990;HERVIDOR TH-4340;ELECTRODOMESTICOS
14303707;;M;47;CHILENO;;X;RENCA                         ;METROPOLITANA;75980;2;2;0;0;0;2;2;75980;Picadora TH-9020V Vaso Vidrio 2Lts;ELECTRODOMESTICOS
5065550;;F;80;CHILENO;;Silencioso;RENCA                         ;METROPOLITANA;385250;6;3;0;0;0;6;3;385250;Hervidor Family Kettle HE500;ELECTRODOMESTICOS
25907952;;M;51;VENEZOLANO;;Extranjero;CONCHALI                      ;METROPOLITANA;17990;1;1;0;0;0;1;1;17990;Hervidor Family Kettle HE500;ELECTRODOMESTICOS
8364872;;M;62;CHILENO;;Boomers;MELIPILLA                     ;METROPOLITANA;109990;1;1;0;0;0;1;1;109990;Horno Microondas Digital L UT-25KROMM 25Lts;ELECTRODOMESTICOS
11241756;;F;54;CHILENO;;X;LOS ANGELES                   ;BIO BIO;131970;3;2;0;0;0;3;2;131970;HORNO ELECTRICO BREMEN 23 LITROS;ELECTRODOMESTICOS
8019365;;M;63;CHILENO;;Boomers;MOLINA                        ;MAULE;64980;2;2;0;0;0;2;2;64980;Hervidor Electrico Tetera UT-LECKER18R 1,8Lts;ELECTRODOMESTICOS
5239160;;F;72;CHILENO;;Silencioso;ANTOFAGASTA                   ;ANTOFAGASTA;119980;2;2;0;0;0;2;2;119980;Horno Microondas Mecanico M-2020NG 20Lts;ELECTRODOMESTICOS
6713144;;F;74;CHILENO;;Silencioso;VINA DEL MAR                  ;VALPARAISO;149593;4;2;0;0;0;4;2;149593;Horno Microondas Digital UT-CLASSY720 20Lts;ELECTRODOMESTICOS
15579546;Casado;F;38;CHILENO;;Millenial;RENCA                         ;METROPOLITANA;36990;1;1;0;0;0;1;1;36990;Aspiradora TH1407 Arrastre 1400Watts;ELECTRODOMESTICOS
6227129;;F;67;CHILENO;;Boomers;PAPUDO                        ;VALPARAISO;117960;4;2;0;0;0;4;2;117960;Hervidor Electrico Tetera TH-6505RT 1,7Lts Rojo;ELECTRODOMESTICOS
16190558;;M;37;CHILENO;;Millenial;N/D;N/D;352970;3;2;0;0;0;3;2;352970;Horno Electrico UT-BACKOFEN26 26Lts;ELECTRODOMESTICOS
25780541;;M;42;EXTRANJERO - NO INFORMA NACIONALIDAD;;Extranjero;TEMUCO                        ;ARAUCANIA;91980;2;1;0;0;0;2;1;91980;Aspiradora TH1870 Arrastre 1800Watts Gris;ELECTRODOMESTICOS
20037029;;M;23;CHILENO;;Z;PADRE LAS CASAS               ;ARAUCANIA;29990;1;1;0;0;0;1;1;29990;Licuadora L-5500IN 1,5Lts;ELECTRODOMESTICOS
9737287;Casado;M;56;CHILENO;;Boomers;RENCA                         ;METROPOLITANA;195830;3;2;2;1;135840;1;1;59990;Licuadora Oster Clasica Azul 4134 1,25 lt;ELECTRODOMESTICOS
13000630;;F;46;CHILENO;;X;N/D;N/D;156020;6;2;0;0;0;6;2;156020;Horno Electrico TH62I 60Lts;ELECTRODOMESTICOS
11537136;;F;52;CHILENO;;X;TOME                          ;BIO BIO;473320;6;3;2;1;275840;4;2;197480;Enceradora EA-5000;ELECTRODOMESTICOS
4082965;;M;78;CHILENO;;Silencioso;VALLENAR;ATACAMA;1030260;8;5;2;1;251980;6;4;778280;Maquina de coser Singer 024;ELECTRODOMESTICOS
7970173;;F;59;CHILENO;;Boomers;LOS ANDES                     ;VALPARAISO;34990;1;3;0;0;0;1;3;34990;Hervidor Electrico Tetera TH-6505RT 1,7Lts Rojo;ELECTRODOMESTICOS
11402261;;F;52;CHILENO;;X;"";"";54990;2;1;0;0;0;2;1;54990;Freidora de Aire 18M Oster;ELECTRODOMESTICOS
15941594;;F;37;CHILENO;;Millenial;PROVIDENCIA                   ;METROPOLITANA;21990;1;1;0;0;0;1;1;21990;Combo Hervidor + Batidora;ELECTRODOMESTICOS
12940304;;M;46;CHILENO;;X;N/D;N/D;212960;4;2;0;0;0;4;2;212960;Batidora Manual 3532;ELECTRODOMESTICOS
14482570;;M;42;CHILENO;;X;LA LIGUA                      ;VALPARAISO;12990;1;1;0;0;0;1;1;12990;Hervidor Inox One Midea;ELECTRODOMESTICOS
6885624;;F;66;CHILENO;;Boomers;COPIAPO                       ;ATACAMA;547970;8;3;0;0;0;8;3;547970;Horno Electrico TH62I 60Lts;ELECTRODOMESTICOS
8026720;Casado;F;61;CHILENO;;Boomers;RENCA                         ;METROPOLITANA;59990;1;1;0;0;0;1;1;59990;Horno Electrico TH-25N01 25Lts;ELECTRODOMESTICOS
14586770;;M;40;CHILENO;;X;LINARES                       ;MAULE;34980;2;2;0;0;0;2;2;34980;Batidora Vertical Multimixer TH-8720;ELECTRODOMESTICOS
25633044;;F;57;ECUATORIANO;;Extranjero;PUENTE ALTO                   ;METROPOLITANA;240940;6;4;0;0;0;6;4;240940;Licuadora Berry Blender Roja 1400 Vaso Vidrio;ELECTRODOMESTICOS
11438641;;F;53;CHILENO;;X;MAULE                         ;MAULE;101130;3;1;0;0;0;3;1;101130;Licuadora Oster Clasica Azul 4134 1,25 lt;ELECTRODOMESTICOS
12292018;;M;50;CHILENO;;X;DONIHUE                       ;L.G.B.OÂ´HIGGINS;152630;3;1;0;0;0;3;1;152630;Horno Microondas Digital L UT-25KROMM 25Lts;ELECTRODOMESTICOS
12830015;;F;47;CHILENO;;X;"";"";26990;1;1;0;0;0;1;1;26990;Licuadora TH-320 Roja/Negro 1,5 Lts Vaso Vidrio;ELECTRODOMESTICOS
10858773;;F;53;CHILENO;;X;PERALILLO                     ;L.G.B.OÂ´HIGGINS;127530;5;3;0;0;0;5;3;127530;Combo Hervidor + Batidora;ELECTRODOMESTICOS
12158827;;M;48;CHILENO;;X;PROVIDENCIA                   ;METROPOLITANA;33980;2;1;2;1;33980;0;0;0;Hervidor Electrico Tetera HA-4100 4Lts Iox;ELECTRODOMESTICOS
16206274;;M;36;CHILENO;;Millenial;PROVIDENCIA                   ;METROPOLITANA;209970;3;3;0;0;0;3;3;209970;Licuadora Roja 550W 1,5Lts Vaso Vidrio;ELECTRODOMESTICOS
14480410;;M;45;CHILENO;;X;SAN VICENTE                   ;L.G.B.OÂ´HIGGINS;24990;1;1;0;0;0;1;1;24990;Hervidor Electrico TH-5407i 2Lts;ELECTRODOMESTICOS
15715068;;F;38;CHILENO;;X;CERRO NAVIA                   ;METROPOLITANA;39970;3;2;0;0;0;3;2;39970;Combo Hervidor + Batidora;ELECTRODOMESTICOS
7080936;;M;70;CHILENO;;Silencioso;SAN VICENTE                   ;L.G.B.OÂ´HIGGINS;241980;3;2;0;0;0;3;2;241980;Licuadora TH-401V Roja 1,75Lts Vaso Vidrio;ELECTRODOMESTICOS
26083148;;F;36;VENEZOLANO;;Millenial;PROVIDENCIA                   ;METROPOLITANA;24990;1;1;1;1;24990;0;0;0;FREIDORA DE AIRE HESSIA 2,0 LITROS;ELECTRODOMESTICOS
11404606;;M;52;CHILENO;;X;SAN BERNARDO                  ;METROPOLITANA;82960;4;2;4;2;82960;0;0;0;Hervidor Termo BA-6928 Inox 2,8Lts;ELECTRODOMESTICOS
18904830;Soltero;M;27;CHILENO;;Millenial;PROVIDENCIA                   ;METROPOLITANA;47980;2;2;0;0;0;2;2;47980;Hervidor Electrico TH-5407i 2Lts;ELECTRODOMESTICOS
16511734;;M;35;CHILENO;;Millenial;LOS ANGELES                   ;BIO BIO;11990;1;1;0;0;0;1;1;11990;Hervidor Electrico TH-4212N 1,7Lts Negro;ELECTRODOMESTICOS
11754209;;M;50;CHILENO;;X;"";"";27990;1;1;0;0;0;1;1;27990;HORNO ELECTRICO THOMAS TH-38i;ELECTRODOMESTICOS
19168220;;M;25;CHILENO;;Z;N/D;N/D;453960;4;5;0;0;0;4;5;453960;LICUADORA HANOVER 1,5 LITROS;ELECTRODOMESTICOS
4714992;;M;79;CHILENO;;Silencioso;VALLENAR;ATACAMA;13990;1;1;0;0;0;1;1;13990;Hervidor Electrico TH-4212N 1,7Lts Negro;ELECTRODOMESTICOS
13580743;;F;43;CHILENO;;X;RANCAGUA                      ;L.G.B.OÂ´HIGGINS;198950;5;2;0;0;0;5;2;198950;Maquina de Coser JS-2135CL Calipso;ELECTRODOMESTICOS
12772347;;F;47;CHILENO;;X;ANGOL                         ;ARAUCANIA;24990;1;1;0;0;0;1;1;24990;Plancha TH-7052 2000Watts Base Inox;ELECTRODOMESTICOS
6871986;;F;66;CHILENO;;Boomers;SAN BERNARDO                  ;METROPOLITANA;133530;7;4;0;0;0;7;4;133530;HERVIDOR TH-4340;ELECTRODOMESTICOS
8070416;;M;63;CHILENO;;Boomers;RENCA                         ;METROPOLITANA;52980;2;1;0;0;0;2;1;52980;Batidora Vertical Minipimer UT-KLOT400P;ELECTRODOMESTICOS
17967827;;F;30;CHILENO;;Millenial;N/D;N/D;167970;3;2;0;0;0;3;2;167970;Aspiradora Trapeadora Robot Ut-Excellenza (B);ELECTRODOMESTICOS
11566492;;M;52;CHILENO;;X;PARRAL                        ;MAULE;606941;6;4;0;0;0;6;4;606941;Horno Microondas Digital TH-25DM 25Lts;ELECTRODOMESTICOS
17963999;;F;34;CHILENO;;Millenial;VALDIVIA;LOS LAGOS;664950;5;3;4;2;629960;1;1;34990;Hervidor Electrico Tetera TH-6505RT 1,7Lts Rojo;ELECTRODOMESTICOS
8575859;;F;61;CHILENO;;Boomers;LA FLORIDA                    ;METROPOLITANA;203970;3;4;2;1;189980;1;3;13990;HERVIDOR TH-4340;ELECTRODOMESTICOS
10667944;;F;57;CHILENO;;Boomers;VICTORIA                      ;ARAUCANIA;71060;2;1;0;0;0;2;1;71060;Aspiradora UT-SILENT1603 Arrastre 1600Watts;ELECTRODOMESTICOS
8865107;;M;60;CHILENO;;Boomers;LOS ANGELES                   ;BIO BIO;429980;2;2;0;0;0;2;2;429980;Horno Microondas Mecanico M-2020NG 20Lts;ELECTRODOMESTICOS
6560348;;F;68;CHILENO;;Boomers;LAJA                          ;BIO BIO;79301;3;2;0;0;0;3;2;79301;Aspiradora VCC4190V3E/XZS Arrastre 2000Watts;ELECTRODOMESTICOS
19894305;;F;24;CHILENO;;Z;PROVIDENCIA                   ;METROPOLITANA;89990;1;1;0;0;0;1;1;89990;Horno Electrico TH-48N 48Lts;ELECTRODOMESTICOS
9130254;;M;60;CHILENO;;Boomers;CAUQUENES                     ;MAULE;36990;1;1;0;0;0;1;1;36990;Hervidor Electrico Tetera TH-6505RT 1,7Lts Rojo;ELECTRODOMESTICOS
9727242;;F;58;CHILENO;;Boomers;PROVIDENCIA                   ;METROPOLITANA;428010;10;7;0;0;0;10;7;428010;HERVIDOR TH-4340;ELECTRODOMESTICOS
16288645;;F;36;CHILENO;;Millenial;N/D;N/D;36990;1;1;0;0;0;1;1;36990;Aspiradora TH1407 Arrastre 1400Watts;ELECTRODOMESTICOS
16309474;;M;36;CHILENO;;Millenial;QUELLON                       ;LOS LAGOS;54990;1;1;0;0;0;1;1;54990;PROCESADOR THOMAS TH-9160;ELECTRODOMESTICOS
10688266;;F;55;CHILENO;;Boomers;MELIPILLA                     ;METROPOLITANA;76981;2;2;0;0;0;2;2;76981;Hervidor Electrico UT-DUNKEL17P 2Lts Negro;ELECTRODOMESTICOS
9622119;;F;61;CHILENO;;Boomers;RENCA                         ;METROPOLITANA;24990;1;1;0;0;0;1;1;24990;Hervidor Electrico TH-5407i 2Lts;ELECTRODOMESTICOS
4960817;;F;82;CHILENO;;Silencioso;SAN ANTONIO                   ;VALPARAISO;86049;3;1;0;0;0;3;1;86049;FREIDORA DE AIRE BAVIERA 3,8 LITROS;ELECTRODOMESTICOS
7273330;;F;69;CHILENO;;Silencioso;BUIN                          ;METROPOLITANA;1027940;6;5;0;0;0;6;5;1027940;HERVIDOR TH-4340;ELECTRODOMESTICOS
14573540;;F;45;CHILENO;;X;N/D;N/D;605940;6;4;6;4;605940;0;0;0;ASPIRADORA ROBOT THOMAS TH-1060SC;ELECTRODOMESTICOS
12793881;;F;46;CHILENO;;X;PARRAL                        ;MAULE;89490;1;4;0;0;0;1;4;89490;Batidora Vertical Stick Mixer 2609;ELECTRODOMESTICOS
8006509;;M;61;CHILENO;;Boomers;PROVIDENCIA                   ;METROPOLITANA;0;0;2;0;0;0;0;2;0;Batidora Pedestal TH910PN 4,6Lts 1300Watts;ELECTRODOMESTICOS
6571866;;F;66;CHILENO;;Boomers;MELIPILLA                     ;METROPOLITANA;1401300;17;7;0;0;0;17;7;1401300;Horno Microondas Digital TH-25DM 25Lts;ELECTRODOMESTICOS
9080851;;F;61;CHILENO;;Boomers;BUIN                          ;METROPOLITANA;599950;11;7;2;1;189980;9;6;409970;Hervidor Electrico TH-4515N 2Lts Negro;ELECTRODOMESTICOS
9518509;;F;58;CHILENO;;Boomers;PROVIDENCIA                   ;METROPOLITANA;16990;1;1;0;0;0;1;1;16990;Batidora Manual 3532;ELECTRODOMESTICOS
11046418;;F;56;CHILENO;;Boomers;PROVIDENCIA                   ;METROPOLITANA;29990;1;1;0;0;0;1;1;29990;Procesador TH-9010 Multimixer 1,5Lts Vaso Vidrio;ELECTRODOMESTICOS
6480502;;F;68;CHILENO;;Silencioso;N/D;N/D;500371;8;5;2;1;332980;6;4;167391;Plancha TH-7052 2000Watts Base Inox;ELECTRODOMESTICOS
14259975;;F;47;CHILENO;;X;ARICA                         ;ARICA Y PARINACOTA;37980;2;2;0;0;0;2;2;37980;Plancha UT-DUNST 2200Watts Base Ceramica;ELECTRODOMESTICOS
6446256;;F;71;CHILENO;;Silencioso;PAINE                         ;METROPOLITANA;1302450;14;6;0;0;0;14;6;1302450;Hervidor Electrico UT-KLAR20PW 2Lts Blanco;ELECTRODOMESTICOS
11911187;;M;51;CHILENO;;X;PROVIDENCIA                   ;METROPOLITANA;154970;3;2;0;0;0;3;2;154970;Hervidor Electrico TH-4515N 2Lts Negro;ELECTRODOMESTICOS
7261644;;M;68;CHILENO;;Silencioso;COLINA                        ;METROPOLITANA;372950;5;4;0;0;0;5;4;372950;Parrilla Electrica TH-180;ELECTRODOMESTICOS
17939408;;M;30;CHILENO;;Millenial;PROVIDENCIA                   ;METROPOLITANA;508610;6;3;6;3;508610;0;0;0;HORNO ELECTRICO MUNICH 60 LITROS;ELECTRODOMESTICOS
19085580;;F;26;CHILENO;;Z;PUENTE ALTO                   ;METROPOLITANA;79980;2;1;0;0;0;2;1;79980;Parrilla Electrica TH-224;ELECTRODOMESTICOS
14114933;;F;41;CHILENO;;X;COPIAPO                       ;ATACAMA;885350;7;4;0;0;0;7;4;885350;Batidora Manual TH-8830;ELECTRODOMESTICOS
10065650;;F;59;CHILENO;;Boomers;RENCA                         ;METROPOLITANA;69990;1;1;0;0;0;1;1;69990;ASPIRADORA THOMAS TH-1640;ELECTRODOMESTICOS
11458353;;F;53;CHILENO;;X;CAUQUENES                     ;MAULE;563701;5;3;0;0;0;5;3;563701;Horno Electrico TH62I 60Lts;ELECTRODOMESTICOS
9302657;;F;61;CHILENO;;Boomers;PARRAL                        ;MAULE;779950;5;3;0;0;0;5;3;779950;Horno Electrico TH-80i 80Lts;ELECTRODOMESTICOS
7294055;;M;56;CHILENO;;Boomers;CASTRO                        ;LOS LAGOS;13990;1;1;0;0;0;1;1;13990;Set Hervidor Valory VK330 Blanco + Tostador de;ELECTRODOMESTICOS
15046250;Soltero;F;39;CHILENO;TECNICO EN PREVENCION DE RIESGOS;X;PROVIDENCIA                   ;METROPOLITANA;406520;4;2;4;2;406520;0;0;0;Batidora Manual BM-490IN Multi Accesorios;ELECTRODOMESTICOS
17076852;;F;33;CHILENO;;Millenial;PROVIDENCIA                   ;METROPOLITANA;339970;3;2;0;0;0;3;2;339970;Hervidor Electrico 3101 1,7Lts Negro;ELECTRODOMESTICOS
6008139;;F;66;CHILENO;;Boomers;RENCA                         ;METROPOLITANA;14990;1;1;0;0;0;1;1;14990;HERVIDOR HAMBURGO 2,0 LITROS;ELECTRODOMESTICOS
9301288;Divorciado;M;60;CHILENO;;Boomers;RENCA                         ;METROPOLITANA;17990;1;1;0;0;0;1;1;17990;Hervidor Family Kettle HE500;ELECTRODOMESTICOS
19883010;;F;24;CHILENO;;Z;LAMPA;METROPOLITANA;168960;4;2;4;2;168960;0;0;0;HERVIDOR THOMAS TH-4720V;ELECTRODOMESTICOS
7662331;;F;68;CHILENO;;Silencioso;ANCUD                         ;LOS LAGOS;119970;3;2;0;0;0;3;2;119970;Horno electrico Black Oven 42lts;ELECTRODOMESTICOS
16826911;;F;34;CHILENO;;Millenial;PARRAL                        ;MAULE;336940;6;5;2;1;186980;4;4;149960;Parrilla Electrica Chef Grill;ELECTRODOMESTICOS
17904211;;F;31;CHILENO;;Millenial;SAN BERNARDO                  ;METROPOLITANA;24990;1;1;1;1;24990;0;0;0;Parrilla Electrica TH-180;ELECTRODOMESTICOS
25431334;;F;32;BOLIVIANO;;Extranjero;N/D;N/D;1284542;15;7;0;0;0;15;7;1284542;Hervidor Electrico TH-4515N 2Lts Negro;ELECTRODOMESTICOS
12109355;;F;52;CHILENO;;X;MAIPU                         ;METROPOLITANA;28990;1;1;0;0;0;1;1;28990;Plancha UT-PLATTEISEN 2000Watts Base Ceramica;ELECTRODOMESTICOS
11920009;;M;49;CHILENO;;X;RENCA                         ;METROPOLITANA;109990;1;1;0;0;0;1;1;109990;Horno Microondas Digital TH-25DM 25Lts;ELECTRODOMESTICOS
9330639;Casado;F;55;CHILENO;EDUCADOR DE PARVULOS;Boomers;RENCA                         ;METROPOLITANA;36990;1;1;0;0;0;1;1;36990;Aspiradora Handy Clean Black 1400;ELECTRODOMESTICOS
16215275;;F;36;CHILENO;;Millenial;VINA DEL MAR                  ;VALPARAISO;193940;6;3;0;0;0;6;3;193940;Horno Microondas Digital L UT-25KROMM 25Lts;ELECTRODOMESTICOS
16461992;;F;34;CHILENO;;Millenial;VICTORIA                      ;ARAUCANIA;68970;3;3;0;0;0;3;3;68970;HERVIDOR COLONIA 1,7 LITROS;ELECTRODOMESTICOS
15147503;;M;39;CHILENO;;X;PROVIDENCIA                   ;METROPOLITANA;13990;1;1;0;0;0;1;1;13990;Exprimidor de Jugo CJ-2000 1Lts;ELECTRODOMESTICOS
17254108;;F;32;CHILENO;;Millenial;"";"";369960;4;4;4;2;369960;0;2;0;Aspiradora UT-SILENT1804 Arrastre 1800Watts;ELECTRODOMESTICOS
7064118;;M;67;CHILENO;;Boomers;CONCEPCION                    ;BIO BIO;367860;6;3;0;0;0;6;3;367860;Horno Electrico TH62I 60Lts;ELECTRODOMESTICOS
5336798;;M;77;CHILENO;;Silencioso;VALLENAR;ATACAMA;304980;2;2;0;0;0;2;2;304980;ASPIRADORA VCC4580V3K/XZS SAMSUNG BLACK;ELECTRODOMESTICOS
18648766;;F;27;CHILENO;;Millenial;"";"";439520;4;3;2;1;39540;2;2;399980;Hervidor Electrico TH-4515N 2Lts Negro;ELECTRODOMESTICOS
19650819;;F;25;CHILENO;;Z;LOS ANDES                     ;VALPARAISO;146960;5;4;0;0;0;5;4;146960;Hervidor Inox One Midea;ELECTRODOMESTICOS
13151704;;M;45;CHILENO;;X;N/D;N/D;115950;5;3;0;0;0;5;3;115950;BATIDORA PEDESTAL RENANIA 5 LITROS;ELECTRODOMESTICOS
15683660;;M;39;CHILENO;;X;RIO IBANEZ                    ;AYSEN;992890;11;8;0;0;0;11;8;992890;Licuadora Oster Clasica Azul 4134 1,25 lt;ELECTRODOMESTICOS
14002917;;M;41;CHILENO;;X;SAN ANTONIO                   ;VALPARAISO;51980;2;1;2;1;51980;0;0;0;Horno Microondas Mecanico Fancy 20Lts;ELECTRODOMESTICOS
6015926;;M;71;CHILENO;;Silencioso;LEBU                          ;BIO BIO;25980;2;2;0;0;0;2;2;25980;Hervidor Inox One Midea;ELECTRODOMESTICOS
9521924;;F;58;CHILENO;;Boomers;VALDIVIA                      ;LOS LAGOS;112980;2;1;0;0;0;2;1;112980;Horno Microondas Digital TH-25DM 25Lts;ELECTRODOMESTICOS
15744537;;F;38;CHILENO;;X;RENCA                         ;METROPOLITANA;98980;2;1;0;0;0;2;1;98980;Horno Microondas Digital MS23K3513AK/ZS 23Lts;ELECTRODOMESTICOS
8268630;;F;63;CHILENO;;Boomers;QUILPUE                       ;VALPARAISO;54840;2;1;0;0;0;2;1;54840;Horno Electrico TH-25N01 25Lts;ELECTRODOMESTICOS
8099601;;F;66;CHILENO;;Boomers;COIHAIQUE                     ;AYSEN;595950;5;5;0;0;0;5;5;595950;Maquina de Coser VX1445 con 14 puntadas;ELECTRODOMESTICOS
19349711;Soltero;F;25;CHILENO;PROFESOR;Z;PROVIDENCIA                   ;METROPOLITANA;69980;2;1;2;1;69980;0;0;0;Olla Multiuso TH-40PC 0,5Lts;ELECTRODOMESTICOS
17637830;;F;31;CHILENO;;Millenial;CARAHUE                       ;ARAUCANIA;677920;8;8;2;1;178980;6;7;498940;Aspiradora TH1870 Arrastre 1800Watts Gris;ELECTRODOMESTICOS
20002395;;F;23;CHILENO;;Z;RENGO;O HIGGINS;17990;1;1;0;0;0;1;1;17990;Tostador de Pan TH-116 2 Rebanadas Negro;ELECTRODOMESTICOS
16922485;;M;34;CHILENO;;Millenial;PROVIDENCIA                   ;METROPOLITANA;318970;3;2;3;2;318970;0;0;0;Horno Microondas Digital MS23K3513AK/ZS 23Lts;ELECTRODOMESTICOS
17268664;;F;32;CHILENO;;Millenial;PANGUIPULLI                   ;LOS RIOS;148560;5;4;0;0;0;5;4;148560;HORNO ELECTRICO DORTMUND 45 LITROS;ELECTRODOMESTICOS
15588795;;M;38;CHILENO;;Millenial;"";"";233920;8;4;8;4;233920;0;0;0;Hervidor Electrico TH-4515N 2Lts Negro;ELECTRODOMESTICOS
17917042;Soltero;F;30;CHILENO;;Millenial;PROVIDENCIA                   ;METROPOLITANA;94970;3;3;0;0;0;3;3;94970;BATIDORA MANUAL 260R;ELECTRODOMESTICOS
15011588;;F;39;CHILENO;;X;N/D;N/D;990810;10;4;2;1;309980;8;3;680830;BATIDORA PEDESTAL RENANIA 5 LITROS;ELECTRODOMESTICOS
18735693;;M;28;CHILENO;;Millenial;LANCO                         ;LOS RIOS;316600;6;2;0;0;0;6;2;316600;Licuadora Berry Blender Roja 1400 Vaso Vidrio;ELECTRODOMESTICOS
9510259;;M;58;CHILENO;;Boomers;CANETE                        ;BIO BIO;324980;2;2;0;0;0;2;2;324980;Horno Electrico TH-80i 80Lts;ELECTRODOMESTICOS
15524914;;M;39;CHILENO;;X;RANCAGUA                      ;L.G.B.OÂ´HIGGINS;682940;6;3;0;0;0;6;3;682940;CAFETERA PRIMA LATTE 6603 ROJA;ELECTRODOMESTICOS
10469907;;F;53;CHILENO;;X;N/D;N/D;89990;1;1;0;0;0;1;1;89990;Aspiradora TH1870 Arrastre 1800Watts Gris;ELECTRODOMESTICOS
19709895;;M;23;CHILENO;;Z;COLINA                        ;METROPOLITANA;99990;1;1;0;0;0;1;1;99990;Horno Electrico TH62I 60Lts;ELECTRODOMESTICOS
4845174;;F;80;CHILENO;;Silencioso;N/D;N/D;212890;3;2;0;0;0;3;2;212890;Horno Microondas Mecanico Fancy 20Lts;ELECTRODOMESTICOS
9553948;;F;59;CHILENO;;Boomers;ANTOFAGASTA                   ;ANTOFAGASTA;213960;4;3;0;0;0;4;3;213960;Licuadora L-25000NG;ELECTRODOMESTICOS
20113310;;F;23;CHILENO;;Z;NACIMIENTO;BIO-BIO;593940;6;4;3;2;479970;3;2;113970;Horno Microondas Digital UT-CLASSY720 20Lts;ELECTRODOMESTICOS
18100808;Soltero;M;30;CHILENO;;Millenial;PROVIDENCIA                   ;METROPOLITANA;1288660;6;3;3;1;971690;3;2;316970;ASPIRADORA ROBOT THOMAS TH-1060SC;ELECTRODOMESTICOS
18774964;;F;27;CHILENO;;Millenial;LAUTARO;ARAUCANIA;57480;2;1;2;1;57480;0;0;0;BATIDORA PEDESTAL RENANIA 5 LITROS;ELECTRODOMESTICOS
11870424;;F;50;CHILENO;;X;PEDRO AGUIRRE CERDA           ;METROPOLITANA;0;0;2;0;0;0;0;2;0;Hervidor Electrico TH-4515N 2Lts Negro;ELECTRODOMESTICOS
5991647;;F;72;CHILENO;;Silencioso;LA SERENA                     ;COQUIMBO;302908;8;5;0;0;0;8;5;302908;Hervidor Electrico UT-REIN17SS;ELECTRODOMESTICOS
11010707;;F;56;CHILENO;;Boomers;N/D;N/D;98980;2;1;2;1;98980;0;0;0;FREIDORA DE AIRE TELEFUNKEN;ELECTRODOMESTICOS
22738440;;F;53;PERUANO;;Extranjero;N/D;N/D;125360;3;2;0;0;0;3;2;125360;Hervidor Electrico TH-4515N 2Lts Negro;ELECTRODOMESTICOS
10527708;;M;56;CHILENO;;Boomers;MARIA PINTO                   ;METROPOLITANA;360320;8;5;0;0;0;8;5;360320;Horno Microondas Mecanico TH-18B05 18Lts;ELECTRODOMESTICOS
11485935;;M;53;CHILENO;;X;PUDAHUEL                      ;METROPOLITANA;101210;2;1;0;0;0;2;1;101210;HORNO ELECTRICO MUNICH 60 LITROS;ELECTRODOMESTICOS
13736965;;F;44;CHILENO;;X;COLINA                        ;METROPOLITANA;548940;5;2;0;0;0;5;2;548940;Hervidor Electrico UT-KLAR20PW 2Lts Blanco;ELECTRODOMESTICOS
8476773;;M;62;CHILENO;;Boomers;RENCA                         ;METROPOLITANA;12990;1;1;0;0;0;1;1;12990;Batidora Vertical Stick Mixer 2609;ELECTRODOMESTICOS
18377265;;F;29;CHILENO;;Millenial;OLMUE                         ;VALPARAISO;39990;1;1;0;0;0;1;1;39990;Aspiradora TH1407 Arrastre 1400Watts;ELECTRODOMESTICOS
7955131;;M;59;CHILENO;;Boomers;NUEVA IMPERIAL                ;ARAUCANIA;151990;3;2;0;0;0;3;2;151990;LICUADORA HANOVER 1,5 LITROS;ELECTRODOMESTICOS
15378613;Soltero;M;40;CHILENO;INGENIERO CIVIL INDUSTRIAL;Silencioso;PROVIDENCIA                   ;METROPOLITANA;317920;8;3;8;3;317920;0;0;0;Horno Electrico TH-25N01 25Lts;ELECTRODOMESTICOS
5511688;;F;76;CHILENO;;Silencioso;PUENTE ALTO                   ;METROPOLITANA;609435;6;4;0;0;0;6;4;609435;Licuadora L-1630V Negra 1,5Lts Vaso Vidrio;ELECTRODOMESTICOS
26665577;Soltero;F;33;EXTRANJERO - NO INFORMA NACIONALIDAD;;Extranjero;INDEPENDENCIA;METROPOLITANA;53980;2;1;2;1;53980;0;0;0;Batidora Pedestal TH-870P;ELECTRODOMESTICOS
7215986;Soltero;F;70;CHILENO;MECANICO AUTOMOTRIZ EN MAQUINARIA PESADA;Silencioso;PROVIDENCIA                   ;METROPOLITANA;109990;1;1;0;0;0;1;1;109990;Maquina de coser Singer 1605;ELECTRODOMESTICOS
16825398;;M;34;CHILENO;;Millenial;VICUNA;COQUIMBO;69980;3;1;0;0;0;3;1;69980;FREIDORA DE AIRE BAVIERA 3,8 LITROS;ELECTRODOMESTICOS
15617892;;M;39;CHILENO;;X;MAIPU;METROPOLITANA;183930;6;2;6;2;183930;0;0;0;ASPIRADORA THOMAS TH-1022C;ELECTRODOMESTICOS
16815194;;M;34;CHILENO;;Millenial;PROVIDENCIA                   ;METROPOLITANA;678950;5;4;0;0;0;5;4;678950;Horno Microondas Digital MS23K3513AK/ZS 23Lts;ELECTRODOMESTICOS
8163441;;F;63;CHILENO;;Z;N/D;N/D;299950;7;3;2;1;103980;5;2;195970;BATIDORA PEDESTAL RENANIA 5 LITROS;ELECTRODOMESTICOS
13958028;;M;42;CHILENO;;X;CALAMA                        ;ANTOFAGASTA;1118960;4;4;0;0;0;4;4;1118960;Horno Electrico TH-48N 48Lts;ELECTRODOMESTICOS
14012073;;F;41;CHILENO;;X;N/D;N/D;46980;2;2;0;0;0;2;2;46980;HORNO 10 LITROS OSTER ROJO;ELECTRODOMESTICOS
9623869;;M;60;CHILENO;;Boomers;EL BOSQUE                     ;METROPOLITANA;29990;1;1;0;0;0;1;1;29990;FREIDORA DE AIRE HESSIA 2,0 LITROS;ELECTRODOMESTICOS
9084549;;F;61;CHILENO;;Boomers;SAN JAVIER                    ;MAULE;146960;4;2;0;0;0;4;2;146960;Horno Electrico UT-BACKOFEN60 60Lts;ELECTRODOMESTICOS
17219120;;M;33;CHILENO;;Millenial;N/D;N/D;105900;2;1;0;0;0;2;1;105900;Horno Electrico TH62I 60Lts;ELECTRODOMESTICOS
7078270;;M;67;CHILENO;;Boomers;ARICA                         ;ARICA Y PARINACOTA;89990;1;1;0;0;0;1;1;89990;Horno Microondas Digital L UT-25KROMM 25Lts;ELECTRODOMESTICOS
18723621;;F;27;CHILENO;;Millenial;PICHILEMU;O HIGGINS;108940;5;3;5;3;108940;0;0;0;Horno Microondas Mecanico Easy Wave 20Lts;ELECTRODOMESTICOS
9674969;;F;59;CHILENO;;Boomers;PUENTE ALTO                   ;METROPOLITANA;464950;5;3;0;0;0;5;3;464950;Aspiradora Handy Clean Black 1400;ELECTRODOMESTICOS
12903484;;M;47;CHILENO;;X;RENCA                         ;METROPOLITANA;19990;1;1;0;0;0;1;1;19990;Hervidor Electrico TH-4515N 2Lts Negro;ELECTRODOMESTICOS
17012338;;M;33;CHILENO;;Millenial;RENCA                         ;METROPOLITANA;44980;2;1;0;0;0;2;1;44980;Licuadora L-1630V Negra 1,5Lts Vaso Vidrio;ELECTRODOMESTICOS
3981479;;M;85;CHILENO;;Silencioso;MELIPILLA                     ;METROPOLITANA;106659;5;6;0;0;0;5;6;106659;Hervidor Family Kettle HE500;ELECTRODOMESTICOS
8550159;;M;63;CHILENO;;Boomers;PADRE LAS CASAS               ;ARAUCANIA;75900;2;1;0;0;0;2;1;75900;Aspiradora VCC4190V3E/XZS Arrastre 2000Watts;ELECTRODOMESTICOS
15350069;;M;39;CHILENO;;Extranjero;"";"";74990;1;1;0;0;0;1;1;74990;Horno Microondas Mecanico M-2020NG 20Lts;ELECTRODOMESTICOS
17424471;Soltero;M;32;CHILENO;;Millenial;RENCA                         ;METROPOLITANA;34990;1;1;0;0;0;1;1;34990;Picadora 1-2-3 AD6011CL 750W;ELECTRODOMESTICOS
16595789;;M;35;CHILENO;;Millenial;OVALLE                        ;COQUIMBO;22990;1;1;0;0;0;1;1;22990;HERVIDOR ELECTRICO UT-STARK18;ELECTRODOMESTICOS
13793229;Soltero;M;47;CHILENO;;X;RENCA                         ;METROPOLITANA;19990;1;1;0;0;0;1;1;19990;Hervidor Electrico TH-4515N 2Lts Negro;ELECTRODOMESTICOS
6204529;;F;78;CHILENO;;Silencioso;SAN ANTONIO                   ;VALPARAISO;209980;2;2;0;0;0;2;2;209980;Horno Electrico TH-80i 80Lts;ELECTRODOMESTICOS
8855336;;F;76;CHILENO;;Silencioso;LOS ANGELES                   ;BIO BIO;65900;2;1;0;0;0;2;1;65900;Horno Microondas Mecanico Easy Wave 20Lts;ELECTRODOMESTICOS
6409691;;M;72;CHILENO;;Silencioso;PROVIDENCIA                   ;METROPOLITANA;31980;2;2;0;0;0;2;2;31980;HERVIDOR HAMBURGO 2,0 LITROS;ELECTRODOMESTICOS
11265913;;M;54;CHILENO;;X;CERRILLOS                     ;METROPOLITANA;-123990;-1;2;-2;1;-163980;1;1;39990;Aspiradora TH1407 Arrastre 1400Watts;ELECTRODOMESTICOS
16526784;;M;35;CHILENO;;Millenial;N/D;N/D;299950;5;2;5;2;299950;0;0;0;Olla Multiuso 6801 5,7Lts;ELECTRODOMESTICOS
4690549;;M;81;CHILENO;;Silencioso;MELIPILLA                     ;METROPOLITANA;131959;4;2;0;0;0;4;2;131959;Exprimidor de Jugo 407W 1Lts;ELECTRODOMESTICOS
11179835;Casado;F;55;CHILENO;;Boomers;RENCA                         ;METROPOLITANA;95900;2;1;0;0;0;2;1;95900;Enceradora EA-5000;ELECTRODOMESTICOS
12087441;;M;51;CHILENO;;X;PAINE                         ;METROPOLITANA;272949;5;3;0;0;0;5;3;272949;Tostador de Pan TH-126 4 Rebanadas Negro;ELECTRODOMESTICOS
11114550;Divorciado;M;54;CHILENO;;Boomers;RENCA                         ;METROPOLITANA;54990;1;1;0;0;0;1;1;54990;Horno Electrico UT-BACKOFEN26 26Lts;ELECTRODOMESTICOS
13152099;;F;44;CHILENO;;X;VICTORIA                      ;ARAUCANIA;171721;3;3;0;0;0;3;3;171721;FREIDORA DE AIRE THOMAS TH-AF60Mi;ELECTRODOMESTICOS
8228596;;F;61;CHILENO;;Boomers;N/D;N/D;418960;4;4;0;0;0;4;4;418960;Plancha UT-KERAMIK1 2200Watts Base Ceramica;ELECTRODOMESTICOS
19069885;;F;26;CHILENO;;Millenial;N/D;N/D;658900;10;6;0;0;0;10;6;658900;Exprimidor Fauna 500 cc;ELECTRODOMESTICOS
13374382;;M;44;CHILENO;;X;SANTA CRUZ                    ;L.G.B.OÂ´HIGGINS;28990;1;1;0;0;0;1;1;28990;Tostador de Pan TP-1400 4 Rebanadas Inox;ELECTRODOMESTICOS
14310207;;M;45;CHILENO;;X;QUEILEN                       ;LOS LAGOS;17990;1;1;0;0;0;1;1;17990;Hervidor Electrico HA-3300 2,5Lts Blanco;ELECTRODOMESTICOS
5522599;;M;76;CHILENO;;Silencioso;RENCA                         ;METROPOLITANA;16990;1;1;0;0;0;1;1;16990;HERVIDOR BERLIN 1,7 LITROS;ELECTRODOMESTICOS
15992599;;F;37;CHILENO;;Millenial;CODEGUA                       ;L.G.B.OÂ´HIGGINS;968260;13;6;0;0;0;13;6;968260;Hervidor Family Kettle HE500;ELECTRODOMESTICOS
10025679;;F;58;CHILENO;;Boomers;RENCA                         ;METROPOLITANA;31990;1;1;0;0;0;1;1;31990;Extractor de Jugo EX800 1,4Lts;ELECTRODOMESTICOS
13376202;;F;43;CHILENO;;X;COIHUECO                      ;NUBLE;325851;9;8;0;0;0;9;8;325851;FREIDORA DE AIRE HESSIA 2,0 LITROS;ELECTRODOMESTICOS
6954229;;M;67;CHILENO;;Boomers;PROVIDENCIA                   ;METROPOLITANA;79990;1;1;0;0;0;1;1;79990;Horno Microondas Digital TH20DM 20Lts Espejado;ELECTRODOMESTICOS
15155411;;F;40;CHILENO;;X;"";"";669390;10;5;0;0;0;10;5;669390;Batidora Pedestal TH910PN 4,6Lts 1300Watts;ELECTRODOMESTICOS
19579806;;M;29;CHILENO;;Millenial;LIMACHE                       ;VALPARAISO;29990;1;1;0;0;0;1;1;29990;Wafflera time blanca WJ170112 700W;ELECTRODOMESTICOS
6469676;;F;66;CHILENO;;Boomers;"";"";67980;2;2;0;0;0;2;2;67980;Tostador de Pan TP-1400 4 Rebanadas Inox;ELECTRODOMESTICOS
10583835;;F;53;CHILENO;;X;PICHIDEGUA                    ;L.G.B.OÂ´HIGGINS;945280;12;7;0;0;0;12;7;945280;Batidora Vertical Stick Mixer 2609;ELECTRODOMESTICOS
26711474;Soltero;M;41;EXTRANJERO - NO INFORMA NACIONALIDAD;;Extranjero;PROVIDENCIA                   ;METROPOLITANA;29990;1;1;1;1;29990;0;0;0;Licuadora Roja 550W 1,5Lts Vaso Vidrio;ELECTRODOMESTICOS
18360221;;F;29;CHILENO;;Millenial;SAN JAVIER                    ;MAULE;1887616;38;27;2;1;401980;36;26;1485636;Horno Microondas Digital MS23K3513AK/ZS 23Lts;ELECTRODOMESTICOS
10324852;;F;59;CHILENO;;Boomers;AISEN                         ;AYSEN;328960;4;3;0;0;0;4;3;328960;FREIDORA DE AIRE HESSIA 2,0 LITROS;ELECTRODOMESTICOS
20568852;;M;21;CHILENO;;Z;CARTAGENA;VALPARAISO;148980;2;1;2;1;148980;0;0;0;CAFETERA PRIMA LATTE 6603 ROJA;ELECTRODOMESTICOS
11903660;;M;51;CHILENO;;X;LOTA                          ;BIO BIO;268573;3;3;0;0;0;3;3;268573;Picadora TH-9020V Vaso Vidrio 2Lts;ELECTRODOMESTICOS
7969488;;M;63;CHILENO;;Boomers;LOS ALAMOS                    ;BIO BIO;185792;5;2;0;0;0;5;2;185792;BATIDORA PEDESTAL RENANIA 5 LITROS;ELECTRODOMESTICOS
10850148;Soltero;M;55;CHILENO;;Boomers;RENCA                         ;METROPOLITANA;124980;2;2;0;0;0;2;2;124980;Horno Electrico TH-38N 38Lts;ELECTRODOMESTICOS
5332950;;M;73;CHILENO;;Silencioso;LOS LAGOS                     ;LOS LAGOS;1020030;15;13;0;0;0;15;13;1020030;BATIDORA PEDESTAL RENANIA 5 LITROS;ELECTRODOMESTICOS
15130265;;F;39;CHILENO;;X;PROVIDENCIA                   ;METROPOLITANA;286980;2;2;0;0;0;2;2;286980;Hervidor Electrico HA-3300 2,5Lts Blanco;ELECTRODOMESTICOS
18467774;Soltero;F;28;CHILENO;INGENIERO INFORMATICO;Millenial;PROVIDENCIA                   ;METROPOLITANA;44980;2;2;0;0;0;2;2;44980;Hervidor Electrico TH-4515N 2Lts Negro;ELECTRODOMESTICOS
10624697;Divorciado;F;61;CHILENO;;Boomers;RENGO                         ;L.G.B.OÂ´HIGGINS;16990;1;1;0;0;0;1;1;16990;HERVIDOR BERLIN 1,7 LITROS;ELECTRODOMESTICOS
19984166;;F;24;CHILENO;;Z;PROVIDENCIA                   ;METROPOLITANA;0;0;2;1;1;11990;-1;1;-11990;Plancha a Vapor 5001;ELECTRODOMESTICOS
14036372;;M;51;CHILENO;;X;TALAGANTE                     ;METROPOLITANA;190970;3;3;0;0;0;3;3;190970;Horno Electrico UT-BACKOFEN38 38Lts;ELECTRODOMESTICOS
15135933;;M;39;CHILENO;;X;CONSTITUCION                  ;MAULE;2373320;19;13;4;2;754460;15;11;1618860;Batidora Vertical Minipimer UT-KLOT400P;ELECTRODOMESTICOS
17645879;;M;32;CHILENO;;Millenial;SAN FELIPE                    ;VALPARAISO;508980;2;1;2;1;508980;0;0;0;TEJEDORA GEOSOFIA MOD LK-150;ELECTRODOMESTICOS
13757725;Divorciado;F;45;CHILENO;;X;RENCA                         ;METROPOLITANA;48980;2;1;2;1;48980;0;0;0;Horno Microondas Mecanico Fancy 20Lts;ELECTRODOMESTICOS
20034548;;F;23;CHILENO;;Z;N/D;N/D;46970;3;2;2;1;24980;1;1;21990;Licuadora Berry Blender Roja 1400 Vaso Vidrio;ELECTRODOMESTICOS
23748833;;F;43;BOLIVIANO;;Extranjero;CALAMA                        ;ANTOFAGASTA;29590;2;1;0;0;0;2;1;29590;Batidora Manual TH-8830;ELECTRODOMESTICOS
12545381;;F;48;CHILENO;;X;PROVIDENCIA                   ;METROPOLITANA;102980;2;2;0;0;0;2;2;102980;Horno Electrico TH-48N 48Lts;ELECTRODOMESTICOS
16498827;Casado;F;35;CHILENO;TECNICO DE NIVEL SUPERIOR EN ENFERMERIA;Millenial;RENCA                         ;METROPOLITANA;20980;2;1;2;1;20980;0;0;0;HERVIDOR HA-3800NG NEGRO SINDELEN;ELECTRODOMESTICOS
6366808;;F;69;CHILENO;;Silencioso;RECOLETA                      ;METROPOLITANA;676950;5;2;0;0;0;5;2;676950;BATIDORA INMERSION S MIX 2616;ELECTRODOMESTICOS
15874036;;F;37;CHILENO;;Millenial;"";"";12990;1;1;0;0;0;1;1;12990;Hervidor Electrico TH-4212N 1,7Lts Negro;ELECTRODOMESTICOS
16671027;;F;34;CHILENO;;Millenial;PROVIDENCIA                   ;METROPOLITANA;69990;1;1;1;1;69990;0;0;0;HORNO ELECTRICO MUNICH 60 LITROS;ELECTRODOMESTICOS
19266642;;M;25;CHILENO;;Extranjero;CASTRO                        ;LOS LAGOS;409860;15;12;0;0;0;15;12;409860;Horno Digital TSSTTVDFL1-052;ELECTRODOMESTICOS
7650332;;F;63;CHILENO;;Boomers;"";"";99980;2;2;0;0;0;2;2;99980;Licuadora TH-320 Roja/Negro 1,5 Lts Vaso Vidrio;ELECTRODOMESTICOS
18448232;;F;29;CHILENO;;Millenial;N/D;N/D;101970;5;1;0;0;0;5;1;101970;FREIDORA DE AIRE BAVIERA 3,8 LITROS;ELECTRODOMESTICOS
21457690;;F;48;PERUANO;;Extranjero;TOCOPILLA                     ;ANTOFAGASTA;84980;2;2;0;0;0;2;2;84980;Horno Microondas Mecanico TH-18B05 18Lts;ELECTRODOMESTICOS
26299571;;M;36;HAITIANO;;Extranjero;"";"";64990;1;1;0;0;0;1;1;64990;Horno Microondas Mecanico UT-SYDNEY18 18Lts;ELECTRODOMESTICOS
20177169;;F;26;CHILENO;;Z;TEODORO SCHMIDT               ;ARAUCANIA;57980;2;2;0;0;0;2;2;57980;Aspiradora TH1407 Arrastre 1400Watts;ELECTRODOMESTICOS
9748185;;F;57;CHILENO;;Millenial;PROVIDENCIA                   ;METROPOLITANA;24990;1;1;0;0;0;1;1;24990;HORNO 10 LITROS OSTER ROJO;ELECTRODOMESTICOS
8079760;;F;62;CHILENO;;Boomers;"";"";102990;3;2;0;0;0;3;2;102990;Horno Microondas Mecanico Easy Wave 20Lts;ELECTRODOMESTICOS
7177934;Casado;F;69;CHILENO;TECNOLOGO MEDICO;Silencioso;CONCEPCION                    ;BIO BIO;29990;1;1;0;0;0;1;1;29990;HORNO ELECTRICO BREMEN 23 LITROS;ELECTRODOMESTICOS
17351336;;M;32;CHILENO;;Millenial;CHILLAN                       ;BIO BIO;103960;3;1;0;0;0;3;1;103960;Freidora electrica Ut-KeramikAir;ELECTRODOMESTICOS
11148635;;M;54;CHILENO;;Boomers;CHILLAN                       ;BIO BIO;29990;1;1;0;0;0;1;1;29990;Batidora Pedestal B5300 Inox;ELECTRODOMESTICOS
14604572;;F;41;CHILENO;;X;CANETE                        ;BIO BIO;27293;1;1;0;0;0;1;1;27293;Hervidor Electrico Tetera TH-6505RT 1,7Lts Rojo;ELECTRODOMESTICOS
10927131;;F;49;CHILENO;;X;MAIPU                         ;METROPOLITANA;60000;2;1;0;0;0;2;1;60000;Horno Microondas Mecanico TH-18B05 18Lts;ELECTRODOMESTICOS
15485786;;M;40;CHILENO;;X;ANTUCO                        ;BIO BIO;54980;2;2;0;0;0;2;2;54980;Hervidor Electrico Tetera TH-6505RT 1,7Lts Rojo;ELECTRODOMESTICOS
18203462;;M;29;CHILENO;;Millenial;GRANEROS                      ;L.G.B.OÂ´HIGGINS;157970;3;3;1;1;49990;2;2;107980;BATIDORA PEDESTAL RENANIA 5 LITROS;ELECTRODOMESTICOS
10374316;Divorciado;F;59;CHILENO;TECNICO JURIDICO;Boomers;RENCA                         ;METROPOLITANA;42560;2;1;0;0;0;2;1;42560;HORNO ELECTRICO BREMEN 23 LITROS;ELECTRODOMESTICOS
12670699;;F;47;CHILENO;;X;N/D;N/D;748630;11;5;0;0;0;11;5;748630;PROCESADOR THOMAS TH-9160;ELECTRODOMESTICOS
6707199;;F;67;CHILENO;;Boomers;PROVIDENCIA                   ;METROPOLITANA;217980;2;1;2;1;217980;0;0;0;Lustraspiradora BrightMax FP3000;ELECTRODOMESTICOS
13987310;;F;40;CHILENO;;X;N/D;N/D;173960;3;1;3;1;173960;0;0;0;Aspiradora Trapeadora Robot Ut-Excellenza (B);ELECTRODOMESTICOS
17874119;;F;30;CHILENO;;Millenial;ARAUCO                        ;BIO BIO;18990;1;1;0;0;0;1;1;18990;Hervidor Electrico HA-3300 2,5Lts Blanco;ELECTRODOMESTICOS
15879900;;M;37;CHILENO;;Millenial;ANTOFAGASTA                   ;ANTOFAGASTA;120470;3;2;3;2;120470;0;0;0;Batidora de Pedestal FDV Venus Red;ELECTRODOMESTICOS
4269340;;F;82;CHILENO;;Silencioso;VICTORIA                      ;ARAUCANIA;16000;2;1;0;0;0;2;1;16000;Hervidor Electrico 3101 1,7Lts Negro;ELECTRODOMESTICOS
15250584;;M;41;CHILENO;;Millenial;"";"";44000;2;1;0;0;0;2;1;44000;LICUADORA CROMADA CON TECLAS PLUS;ELECTRODOMESTICOS
13932814;;F;41;CHILENO;;X;N/D;N/D;71982;4;2;0;0;0;4;2;71982;Horno Microondas Digital Deli (2017 DM) 20Lts;ELECTRODOMESTICOS
10569001;;F;44;CHILENO;;X;COLINA                        ;METROPOLITANA;229980;2;2;0;0;0;2;2;229980;SUPER FREIDORA DE AIRE OV3;ELECTRODOMESTICOS
26007904;;M;34;HAITIANO;;Extranjero;LA PINTANA                    ;METROPOLITANA;377360;5;3;0;0;0;5;3;377360;Horno Microondas Mecanico Easy Wave 20Lts;ELECTRODOMESTICOS
5207620;;M;76;CHILENO;;Silencioso;RENCA                         ;METROPOLITANA;44990;1;1;0;0;0;1;1;44990;Horno Microondas Mecanico Fancy 20Lts;ELECTRODOMESTICOS
18700003;;M;30;CHILENO;;Millenial;N/D;N/D;564619;6;2;0;0;0;6;2;564619;Horno Electrico TH62I 60Lts;ELECTRODOMESTICOS
14622234;;F;40;CHILENO;;X;VALLENAR;ATACAMA;437010;10;4;0;0;0;10;4;437010;Horno Microondas Digital TH-25DM 25Lts;ELECTRODOMESTICOS
16649449;;F;35;CHILENO;;Millenial;N/D;N/D;447383;5;3;2;1;420000;3;2;27383;Hervidor Electrico TH-4515N 2Lts Negro;ELECTRODOMESTICOS
11089625;;F;56;CHILENO;;Boomers;PROVIDENCIA                   ;METROPOLITANA;111980;2;2;0;0;0;2;2;111980;Aspiradora VCC4190V3E/XZS Arrastre 2000Watts;ELECTRODOMESTICOS
19549410;;F;25;CHILENO;;Z;PROVIDENCIA                   ;METROPOLITANA;34990;1;1;0;0;0;1;1;34990;Hervidor Electrico Tetera TH-6505RT 1,7Lts Rojo;ELECTRODOMESTICOS
14519098;;F;46;CHILENO;;X;PAINE                         ;METROPOLITANA;65980;2;2;0;0;0;2;2;65980;Batidora Vertical Stick Mixer 2609;ELECTRODOMESTICOS
12758754;Casado;F;47;CHILENO;;X;RENCA                         ;METROPOLITANA;64980;2;2;0;0;0;2;2;64980;Tostador de Pan TH-116 2 Rebanadas Negro;ELECTRODOMESTICOS
8665823;Casado;M;62;CHILENO;;Boomers;RENCA                         ;METROPOLITANA;19990;1;1;0;0;0;1;1;19990;Plancha TH-7052 2000Watts Base Inox;ELECTRODOMESTICOS
15995973;;F;36;CHILENO;;Millenial;RANCAGUA                      ;L.G.B.OÂ´HIGGINS;19990;1;1;0;0;0;1;1;19990;Plancha TH-7052 2000Watts Base Inox;ELECTRODOMESTICOS
26865205;;F;33;VENEZOLANO;;Extranjero;"";"";159980;2;1;2;1;159980;0;0;0;Maquina de coser Singer 024;ELECTRODOMESTICOS
17531307;;M;32;CHILENO;;Millenial;TALCA                         ;MAULE;16990;1;1;0;0;0;1;1;16990;HERVIDOR BERLIN 1,7 LITROS;ELECTRODOMESTICOS
17830946;;F;31;CHILENO;;Millenial;ARICA                         ;ARICA Y PARINACOTA;1070110;16;5;0;0;0;16;5;1070110;Parrilla Electrica M18W;ELECTRODOMESTICOS
12500722;;F;49;CHILENO;;X;PUENTE ALTO                   ;METROPOLITANA;123970;3;1;0;0;0;3;1;123970;Aspiradora Trapeadora Robot Ut-Excellenza (B);ELECTRODOMESTICOS
10476748;;F;57;CHILENO;;Boomers;PENALOLEN                     ;METROPOLITANA;139980;3;2;0;0;0;3;2;139980;Licuadora TH-501V 1,5Lts Vaso Vidrio;ELECTRODOMESTICOS
7321671;;M;71;CHILENO;;Silencioso;QUILLOTA                      ;VALPARAISO;14990;1;1;0;0;0;1;1;14990;HERVIDOR HAMBURGO 2,0 LITROS;ELECTRODOMESTICOS
6909460;;F;68;CHILENO;;Boomers;SAN ANTONIO                   ;VALPARAISO;109970;3;1;0;0;0;3;1;109970;Horno Microondas Mecanico UT-SYDNEY18 18Lts;ELECTRODOMESTICOS
13614202;Soltero;M;42;CHILENO;;X;RENCA                         ;METROPOLITANA;179970;3;2;1;1;99990;2;1;79980;Aspiradora VCC4190V3E/XZS Arrastre 2000Watts;ELECTRODOMESTICOS
12369212;;M;49;CHILENO;;X;N/D;N/D;149980;2;2;0;0;0;2;2;149980;ASPIRADORA THOMAS TH-1640;ELECTRODOMESTICOS
10611047;;M;54;CHILENO;;X;PUENTE ALTO;METROPOLITANA;242970;3;3;0;0;0;3;3;242970;Combo Juguera + Hervidor;ELECTRODOMESTICOS
20373778;;M;22;CHILENO;;Z;CHILLAN                       ;BIO BIO;160690;4;1;0;0;0;4;1;160690;Horno Electrico UT-BACKOFEN48 48Lts;ELECTRODOMESTICOS
12745239;;M;47;CHILENO;;X;PANGUIPULLI                   ;LOS RIOS;18990;1;1;0;0;0;1;1;18990;HERVIDOR BERLIN 1,7 LITROS;ELECTRODOMESTICOS
13824789;;F;42;CHILENO;;X;"";"";75000;2;1;0;0;0;2;1;75000;Horno Electrico TH-48N 48Lts;ELECTRODOMESTICOS
15537701;;M;40;CHILENO;;X;COLINA                        ;METROPOLITANA;14990;1;1;0;0;0;1;1;14990;HERVIDOR HAMBURGO 2,0 LITROS;ELECTRODOMESTICOS
10038205;;F;55;CHILENO;;Boomers;COLINA                        ;METROPOLITANA;440690;4;2;0;0;0;4;2;440690;Horno Microondas Mecanico M-2020NG 20Lts;ELECTRODOMESTICOS
13117400;;M;45;CHILENO;;X;"";"";288940;8;5;1;1;34990;7;4;253950;HORNO ELECTRICO 16N01 16LTS NEGRO;ELECTRODOMESTICOS
10133589;;F;58;CHILENO;;Boomers;CORONEL                       ;BIO BIO;366970;3;2;0;0;0;3;2;366970;Horno Electrico TH62I 60Lts;ELECTRODOMESTICOS
19115162;;F;27;CHILENO;;Millenial;"";"";118940;5;2;5;2;118940;0;0;0;Horno Microondas Digital Deli (2017 DM) 20Lts;ELECTRODOMESTICOS
6872566;;F;69;CHILENO;;Silencioso;LO ESPEJO                     ;METROPOLITANA;131430;2;1;0;0;0;2;1;131430;Batidora essential blanca QA150110 800w;ELECTRODOMESTICOS
15118772;;M;39;CHILENO;;X;N/D;N/D;418930;8;7;1;1;179990;7;6;238940;Hervidor Electrico UT-MANLY17 1,7Lts Negro;ELECTRODOMESTICOS
6425309;;M;66;CHILENO;;Boomers;RENCA                         ;METROPOLITANA;26990;1;1;0;0;0;1;1;26990;Licuadora L-1630V Negra 1,5Lts Vaso Vidrio;ELECTRODOMESTICOS
13575253;;M;43;CHILENO;;X;N/D;N/D;19990;1;1;0;0;0;1;1;19990;Plancha TH-7052 2000Watts Base Inox;ELECTRODOMESTICOS
13375939;;M;44;CHILENO;;X;N/D;N/D;49990;1;1;0;0;0;1;1;49990;FREIDORA DE AIRE BAVIERA 3,8 LITROS;ELECTRODOMESTICOS
12372524;;M;49;CHILENO;;X;LINARES                       ;MAULE;384970;3;2;0;0;0;3;2;384970;Licuadora L-25000NG;ELECTRODOMESTICOS
11796605;;F;50;CHILENO;;X;LEBU                          ;BIO BIO;596930;7;7;0;0;0;7;7;596930;Batidora Vertical Stick Mixer 2609;ELECTRODOMESTICOS
11156295;;F;55;CHILENO;;Boomers;RANCAGUA                      ;L.G.B.OÂ´HIGGINS;189990;1;1;0;0;0;1;1;189990;Horno Electrico TH-100i 100Lts;ELECTRODOMESTICOS
7467106;;F;68;CHILENO;;Boomers;N/D;N/D;1479630;16;7;0;0;0;16;7;1479630;Hervidor Electrico Tetera HA-4100 4Lts Iox;ELECTRODOMESTICOS
8416165;Casado;F;58;CHILENO;;Boomers;PROVIDENCIA                   ;METROPOLITANA;83960;4;1;4;1;83960;0;0;0;Cafetera TH-130;ELECTRODOMESTICOS
26133957;;M;46;COLOMBIANO;;Extranjero;"";"";19990;1;1;0;0;0;1;1;19990;Hervidor Electrico TH-4515N 2Lts Negro;ELECTRODOMESTICOS
8909254;;M;61;CHILENO;;Boomers;PUERTO MONTT                  ;LOS LAGOS;419550;4;3;0;0;0;4;3;419550;Maquina de Coser BM-3850CL Lila;ELECTRODOMESTICOS
8601627;Casado;M;61;CHILENO;;Boomers;RENCA                         ;METROPOLITANA;112981;3;2;0;0;0;3;2;112981;HERVIDOR COLONIA 1,7 LITROS;ELECTRODOMESTICOS
7712459;;F;65;CHILENO;;Boomers;PROVIDENCIA                   ;METROPOLITANA;49990;1;1;0;0;0;1;1;49990;BATIDORA PEDESTAL RENANIA 5 LITROS;ELECTRODOMESTICOS
5050164;;F;76;CHILENO;;Silencioso;IQUIQUE                       ;TARAPACA;29990;1;1;0;0;0;1;1;29990;HORNO ELECTRICO BREMEN 23 LITROS;ELECTRODOMESTICOS
15965237;;F;37;CHILENO;;Millenial;N/D;N/D;1638790;18;8;15;6;1181820;3;2;456970;Horno Electrico TH-100i 100Lts;ELECTRODOMESTICOS
15367727;;F;39;CHILENO;;Millenial;PANGUIPULLI                   ;LOS RIOS;29990;1;1;1;1;29990;0;0;0;Aspiradora Handy Clean Black 1400;ELECTRODOMESTICOS
13484747;;F;49;CHILENO;;Millenial;"";"";80710;2;1;0;0;0;2;1;80710;Horno Microondas Mecanico TH-18B05 18Lts;ELECTRODOMESTICOS
18230533;;F;29;CHILENO;;Millenial;LOS ALAMOS                    ;BIO BIO;353770;9;3;9;3;353770;0;0;0;Batidora Berry Mixer (KM3000) 1300 watts;ELECTRODOMESTICOS
13564443;;F;43;CHILENO;;X;N/D;N/D;24990;1;1;0;0;0;1;1;24990;Licuadora TH-320 Roja/Negro 1,5 Lts Vaso Vidrio;ELECTRODOMESTICOS
10290664;Casado;F;58;CHILENO;;Boomers;RENCA                         ;METROPOLITANA;19990;1;1;0;0;0;1;1;19990;Plancha UT-DUNST 2200Watts Base Ceramica;ELECTRODOMESTICOS
12779355;;M;47;CHILENO;;X;LA PINTANA                    ;METROPOLITANA;34990;1;1;0;0;0;1;1;34990;Licuadora Kaliman Negra con Teclas;ELECTRODOMESTICOS
13703034;;M;43;CHILENO;;X;SAAVEDRA                      ;ARAUCANIA;349970;4;2;0;0;0;4;2;349970;Horno Electrico TH-100i 100Lts;ELECTRODOMESTICOS
10123702;;F;57;CHILENO;;Boomers;RENCA                         ;METROPOLITANA;36980;2;2;0;0;0;2;2;36980;Hervidor Electrico TH-4515N 2Lts Negro;ELECTRODOMESTICOS
15328616;;F;39;CHILENO;;Extranjero;"";"";29990;1;1;0;0;0;1;1;29990;Batidora Pedestal Bowl 300 Inox;ELECTRODOMESTICOS
12161435;Casado;F;48;CHILENO;;X;RENCA                         ;METROPOLITANA;103970;3;2;0;0;0;3;2;103970;ASPIRADORA THOMAS TH-1640;ELECTRODOMESTICOS
11132995;;F;54;CHILENO;;Boomers;RANCAGUA                      ;L.G.B.OÂ´HIGGINS;13990;1;1;0;0;0;1;1;13990;Hervidor Electrico 3101 1,7Lts Negro;ELECTRODOMESTICOS
17739527;;F;30;CHILENO;;Millenial;MAIPU                         ;METROPOLITANA;69990;1;1;0;0;0;1;1;69990;Horno Microondas Digital UT-CLASSY720 20Lts;ELECTRODOMESTICOS
9549158;Soltero;F;60;CHILENO;;Boomers;RENCA                         ;METROPOLITANA;273350;5;3;0;0;0;5;3;273350;Licuadora Roja 550W 1,5Lts Vaso Vidrio;ELECTRODOMESTICOS
7063915;Casado;M;70;CHILENO;AGRONOMO;Silencioso;PROVIDENCIA                   ;METROPOLITANA;59990;1;1;0;0;0;1;1;59990;ASPIRADORA THOMAS TH-1640;ELECTRODOMESTICOS
21988445;;M;40;PERUANO;;Extranjero;IQUIQUE                       ;TARAPACA;1670470;46;14;0;0;0;46;14;1670470;Licuadora Kaliman Negra con Teclas;ELECTRODOMESTICOS
11895400;;F;50;CHILENO;;X;RENCA                         ;METROPOLITANA;10990;1;1;0;0;0;1;1;10990;Exprimidor de Jugo CJ-2000 1Lts;ELECTRODOMESTICOS
11745213;;F;50;CHILENO;;X;SAN JAVIER                    ;MAULE;19990;1;1;0;0;0;1;1;19990;Hervidor Electrico TH-4515N 2Lts Negro;ELECTRODOMESTICOS
17685593;;M;31;CHILENO;;Millenial;RENCA                         ;METROPOLITANA;49990;1;1;0;0;0;1;1;49990;FREIDORA DE AIRE BAVIERA 3,8 LITROS;ELECTRODOMESTICOS
7743865;;F;66;CHILENO;;Boomers;N/D;N/D;234330;6;3;2;1;23980;4;2;210350;Hervidor Electrico TH-4212N 1,7Lts Negro;ELECTRODOMESTICOS
12553422;;F;51;CHILENO;;X;"";"";49990;1;1;0;0;0;1;1;49990;BATIDORA PEDESTAL RENANIA 5 LITROS;ELECTRODOMESTICOS
9093303;;M;59;CHILENO;;Boomers;HUECHURABA                    ;METROPOLITANA;19990;1;1;0;0;0;1;1;19990;Hervidor Electrico UT-DUNKEL17P 2Lts Negro;ELECTRODOMESTICOS
12419552;;F;49;CHILENO;;X;COIHAIQUE                     ;AYSEN;194970;3;2;0;0;0;3;2;194970;Licuadora UT-METALLEK505P 1,5Lts Vaso Vidrio;ELECTRODOMESTICOS
11339396;;M;54;CHILENO;;X;PROVIDENCIA                   ;METROPOLITANA;647960;4;2;4;2;647960;0;0;0;Multiolla Bioceramic Oster;ELECTRODOMESTICOS
14184923;;F;41;CHILENO;;X;PROVIDENCIA                   ;METROPOLITANA;313970;3;2;2;1;173980;1;1;139990;Maquina de Coser VX1445 con 14 puntadas;ELECTRODOMESTICOS
13099844;;F;46;CHILENO;;X;SAN VICENTE                   ;L.G.B.OÂ´HIGGINS;1081490;10;6;0;0;0;10;6;1081490;Picadora UT-PETRUS320 1Lts Vaso Vidrio;ELECTRODOMESTICOS
20169425;;F;23;CHILENO;;Z;TALCA;MAULE;74970;3;2;0;0;0;3;2;74970;HERVIDOR HAMBURGO 2,0 LITROS;ELECTRODOMESTICOS
19702731;;M;23;CHILENO;;Millenial;N/D;N/D;14990;1;1;0;0;0;1;1;14990;HERVIDOR HAMBURGO 2,0 LITROS;ELECTRODOMESTICOS
18400644;;F;29;CHILENO;;Millenial;PAINE;METROPOLITANA;15990;1;1;0;0;0;1;1;15990;Hervidor Electrico UT-MANLY17 1,7Lts Negro;ELECTRODOMESTICOS
8899669;Soltero;F;61;CHILENO;AUXILIAR DE ENFERMERIA;Boomers;SAN ANTONIO                   ;VALPARAISO;372960;4;3;0;0;0;4;3;372960;Horno Electrico UT-LEIF36 36Lts;ELECTRODOMESTICOS
18901947;Soltero;F;27;CHILENO;;Millenial;ANCUD                         ;LOS LAGOS;32990;1;1;0;0;0;1;1;32990;Combo Licuadora + Batidora;ELECTRODOMESTICOS
12989985;Soltero;F;45;CHILENO;ASISTENTE SOCIAL;X;PROVIDENCIA                   ;METROPOLITANA;78950;6;3;6;3;78950;0;0;0;Horno Electrico UT-BACKOFEN26 26Lts;ELECTRODOMESTICOS
14561302;;F;46;CHILENO;;X;RENCA                         ;METROPOLITANA;341430;5;2;0;0;0;5;2;341430;Horno Electrico TH-25N01 25Lts;ELECTRODOMESTICOS
4775720;;M;73;CHILENO;;Silencioso;PROVIDENCIA                   ;METROPOLITANA;397950;5;2;5;2;397950;0;0;0;Freidora FDV Airflow;ELECTRODOMESTICOS
13420711;;F;44;CHILENO;;X;RENCA                         ;METROPOLITANA;34990;1;1;1;1;34990;0;0;0;HORNO ELECTRICO 16N01 16LTS NEGRO;ELECTRODOMESTICOS
9762694;;F;59;CHILENO;;Boomers;PROVIDENCIA                   ;METROPOLITANA;159990;1;1;0;0;0;1;1;159990;Horno Electrico TH-100i 100Lts;ELECTRODOMESTICOS
16845633;;M;33;CHILENO;;Millenial;RENCA                         ;METROPOLITANA;101980;2;1;0;0;0;2;1;101980;Aspiradora TH1870 Arrastre 1800Watts Gris;ELECTRODOMESTICOS
7534848;;M;68;CHILENO;;Boomers;LOS ANGELES                   ;BIO BIO;14990;1;1;0;0;0;1;1;14990;TOSTADOR OLDEMBURGO 2 REBANADAS;ELECTRODOMESTICOS
17696027;;F;32;CHILENO;;Millenial;"";"";1464589;14;9;0;0;0;14;9;1464589;Picadora TH-9020V Vaso Vidrio 2Lts;ELECTRODOMESTICOS
6767486;;M;70;CHILENO;;Silencioso;PROVIDENCIA                   ;METROPOLITANA;84990;1;1;0;0;0;1;1;84990;Horno Electrico UT-BACKOFEN38 38Lts;ELECTRODOMESTICOS
12949943;;F;46;CHILENO;;X;SAN FELIPE                    ;VALPARAISO;39082;2;1;0;0;0;2;1;39082;Combo Juguera + Hervidor;ELECTRODOMESTICOS
16196575;;M;35;CHILENO;;Millenial;LAS CABRAS                    ;L.G.B.OÂ´HIGGINS;16990;1;1;0;0;0;1;1;16990;HERVIDOR TH-4340;ELECTRODOMESTICOS
8171008;;F;62;CHILENO;;Boomers;PROVIDENCIA                   ;METROPOLITANA;19990;1;1;0;0;0;1;1;19990;Plancha TH-7052 2000Watts Base Inox;ELECTRODOMESTICOS
11674759;;F;52;CHILENO;;X;TALCA                         ;MAULE;44990;1;1;0;0;0;1;1;44990;Horno Microondas Mecanico Fancy 20Lts;ELECTRODOMESTICOS
13448616;;F;44;CHILENO;;Silencioso;PROVIDENCIA                   ;METROPOLITANA;24990;1;1;0;0;0;1;1;24990;HORNO 10 LITROS OSTER ROJO;ELECTRODOMESTICOS
13186257;Casado;F;45;CHILENO;SECRETARIA;X;RENCA                         ;METROPOLITANA;34990;1;1;0;0;0;1;1;34990;Plancha UT-SHANGRILA Inalambrica 2200Watss;ELECTRODOMESTICOS
17165708;;F;32;CHILENO;;Millenial;ARAUCO;BIO-BIO;34990;1;1;0;0;0;1;1;34990;Aspiradora AP1700 Arrastre 1700Watts;ELECTRODOMESTICOS
18523967;;F;29;CHILENO;;Millenial;PROVIDENCIA                   ;METROPOLITANA;99990;1;1;1;1;99990;0;0;0;CAFETERA PRIMA LATTE 6603 ROJA;ELECTRODOMESTICOS
12196993;;F;49;CHILENO;;X;TALCA                         ;MAULE;49990;1;1;0;0;0;1;1;49990;Horno Electrico UT-BACKOFEN26 26Lts;ELECTRODOMESTICOS
9539626;;F;59;CHILENO;;Boomers;SAN ANTONIO                   ;VALPARAISO;309970;3;2;0;0;0;3;2;309970;Batidora Vertical Minipimer UT-KLOT400P;ELECTRODOMESTICOS
18696169;;F;28;CHILENO;;Millenial;EL BOSQUE                     ;METROPOLITANA;732340;13;4;1;1;159990;12;3;572350;Freidora de Aire 18M Oster;ELECTRODOMESTICOS
11534926;;M;52;CHILENO;;X;PROVIDENCIA                   ;METROPOLITANA;117480;2;1;2;1;117480;0;0;0;SUPER FREIDORA DE AIRE OV3;ELECTRODOMESTICOS
19127306;Soltero;M;26;CHILENO;;Z;PROVIDENCIA                   ;METROPOLITANA;15990;1;1;0;0;0;1;1;15990;Hervidor Inox One Midea;ELECTRODOMESTICOS
12606830;;M;48;CHILENO;;X;"";"";13000;2;1;0;0;0;2;1;13000;Exprimidor Fauna 500 cc;ELECTRODOMESTICOS
14094300;;F;41;CHILENO;;Millenial;"";"";74990;1;1;0;0;0;1;1;74990;Horno Electrico TH-48N 48Lts;ELECTRODOMESTICOS
8408540;;F;52;CHILENO;;X;PUDAHUEL                      ;METROPOLITANA;49990;1;1;0;0;0;1;1;49990;Horno Microondas Mecanico Easy Wave 20Lts;ELECTRODOMESTICOS
13978048;;F;41;CHILENO;;X;PROVIDENCIA                   ;METROPOLITANA;12990;1;1;1;1;12990;0;0;0;PLANCHA A VAPOR 4070 SUELA CERAMICA 2500W;ELECTRODOMESTICOS
7634087;;M;65;CHILENO;;Boomers;TEMUCO                        ;ARAUCANIA;524950;6;3;0;0;0;6;3;524950;Tostador de PanTH-120R 2 Rebanadas Rojo;ELECTRODOMESTICOS
11161463;;M;55;CHILENO;;Boomers;LINARES                       ;MAULE;132350;3;1;0;0;0;3;1;132350;Maquina de coser Singer 1605;ELECTRODOMESTICOS
10021406;;F;57;CHILENO;;X;RENCA                         ;METROPOLITANA;387230;3;2;0;0;0;3;2;387230;Exprimidor de Jugo 407W 1Lts;ELECTRODOMESTICOS
15057761;;F;38;CHILENO;;Millenial;CABILDO                       ;VALPARAISO;565850;4;2;0;0;0;4;2;565850;Batidora Pedestal TH910PN 4,6Lts 1300Watts;ELECTRODOMESTICOS
13638738;;M;42;CHILENO;;X;RENCA                         ;METROPOLITANA;149990;1;1;1;1;149990;0;0;0;CAFETERA PRIMA LATTE 6603 ROJA;ELECTRODOMESTICOS
17584331;Casado;F;31;CHILENO;;Millenial;PROVIDENCIA                   ;METROPOLITANA;36990;1;1;0;0;0;1;1;36990;Combo Hervidor + Tostador + Sandwichera;ELECTRODOMESTICOS
10696344;;F;52;CHILENO;;X;DIEGO DE ALMAGRO              ;ATACAMA;79990;1;1;0;0;0;1;1;79990;Enceradora EA-5000;ELECTRODOMESTICOS
10646501;;F;56;CHILENO;;Boomers;VALLENAR;ATACAMA;599970;3;3;0;0;0;3;3;599970;Horno Electrico TH-48N 48Lts;ELECTRODOMESTICOS
8232170;;F;65;CHILENO;;Boomers;CORONEL                       ;BIO BIO;109980;2;1;0;0;0;2;1;109980;Horno Electrico TH-38N 38Lts;ELECTRODOMESTICOS
20032086;;M;23;CHILENO;;Z;"";"";38990;1;1;0;0;0;1;1;38990;Aspiradora Handy Clean Black 1400;ELECTRODOMESTICOS
10572485;;F;56;CHILENO;;Boomers;RENCA                         ;METROPOLITANA;-10000;0;2;0;0;0;0;2;-10000;Horno Electrico UT-BACKOFEN38 38Lts;ELECTRODOMESTICOS
26877607;;F;25;VENEZOLANO;;Extranjero;MAULE                         ;MAULE;277870;6;3;0;0;0;6;3;277870;Olla Multiuso 6801 5,7Lts;ELECTRODOMESTICOS
12667370;;M;48;CHILENO;;X;SANTIAGO;METROPOLITANA;133960;4;1;0;0;0;4;1;133960;Horno Microondas Digital TH-20S01 20Lts;ELECTRODOMESTICOS
16891274;;F;27;CHILENO;;Z;QUILLOTA                      ;VALPARAISO;86011;4;4;0;0;0;4;4;86011;Combo Juguera + Hervidor;ELECTRODOMESTICOS
7495444;;F;69;CHILENO;;Silencioso;CORONEL                       ;BIO BIO;491620;7;3;0;0;0;7;3;491620;Hervidor Electrico TH-5407i 2Lts;ELECTRODOMESTICOS
8557264;;F;64;CHILENO;;Boomers;N/D;N/D;569910;10;6;5;3;398960;5;3;170950;Hervidor Electrico TH-4515N 2Lts Negro;ELECTRODOMESTICOS
14598964;Soltero;F;46;CHILENO;;X;RENCA                         ;METROPOLITANA;24990;1;1;1;1;24990;0;0;0;PLANCHA VAPOR TH-7146;ELECTRODOMESTICOS
11953124;;F;50;CHILENO;;X;RENCA                         ;METROPOLITANA;58970;3;2;0;0;0;3;2;58970;Licuadora Berry Blender Roja 1400 Vaso Vidrio;ELECTRODOMESTICOS
6130930;Casado;F;74;CHILENO;TECNICO EN ENFERMERIA DE NIVEL SUPERIOR;Silencioso;PROVIDENCIA                   ;METROPOLITANA;85970;3;3;0;0;0;3;3;85970;Licuadora Personal TH-300PB;ELECTRODOMESTICOS
7416923;;F;63;CHILENO;;Boomers;N/D;N/D;246950;5;3;0;0;0;5;3;246950;HERVIDOR HAMBURGO 2,0 LITROS;ELECTRODOMESTICOS
18103938;Soltero;M;29;CHILENO;TECNICO EN TELECOMUNICACIONES;Millenial;COIHAIQUE                     ;AYSEN;34990;2;1;0;0;0;2;1;34990;Aspiradora AP1700 Arrastre 1700Watts;ELECTRODOMESTICOS
19315992;;F;25;CHILENO;;Z;N/D;N/D;14990;1;1;0;0;0;1;1;14990;HERVIDOR HAMBURGO 2,0 LITROS;ELECTRODOMESTICOS
19504383;;F;25;CHILENO;;Z;TALAGANTE;METROPOLITANA;59970;3;1;0;0;0;3;1;59970;Freidora de Aire 18M Oster;ELECTRODOMESTICOS
11334627;;M;54;CHILENO;;X;RETIRO                        ;MAULE;59990;3;1;0;0;0;3;1;59990;FREIDORA DE AIRE HESSIA 2,0 LITROS;ELECTRODOMESTICOS
19800816;;M;24;CHILENO;;Z;N/D;N/D;88970;3;4;2;1;63980;1;3;24990;Batidora de Pedestal FDV Venus Grey;ELECTRODOMESTICOS
22301562;;F;26;CHILENO;;Z;PUENTE ALTO                   ;METROPOLITANA;103980;2;1;2;1;103980;0;0;0;SUPER FREIDORA DE AIRE OV3;ELECTRODOMESTICOS
14022760;;F;41;CHILENO;;X;PELLUHUE                      ;MAULE;35970;3;1;0;0;0;3;1;35970;TOSTADOR OLDEMBURGO 2 REBANADAS;ELECTRODOMESTICOS
7797520;;F;62;CHILENO;;Boomers;SAN FERNANDO                  ;L.G.B.OÂ´HIGGINS;672730;6;4;0;0;0;6;4;672730;Plancha UT-KERAMIKTOP 2200Watts Base Ceramica;ELECTRODOMESTICOS
9756044;;F;58;CHILENO;;Boomers;SAN PEDRO                     ;METROPOLITANA;655580;9;3;0;0;0;9;3;655580;PLANCHA VAPOR TH-7146;ELECTRODOMESTICOS
19091038;;F;26;CHILENO;;Z;PROVIDENCIA                   ;METROPOLITANA;13990;1;1;0;0;0;1;1;13990;Hervidor Electrico 3101 1,7Lts Negro;ELECTRODOMESTICOS
6457117;;F;66;CHILENO;;Boomers;PROVIDENCIA                   ;METROPOLITANA;36990;1;1;0;0;0;1;1;36990;Combo Hervidor + Tostador + Sandwichera;ELECTRODOMESTICOS
15956465;;F;37;CHILENO;;Millenial;MELIPILLA                     ;METROPOLITANA;15990;1;1;0;0;0;1;1;15990;Hervidor Electrico UT-MANLY17 1,7Lts Negro;ELECTRODOMESTICOS
7635584;;M;67;CHILENO;;Boomers;TALCAHUANO                    ;BIO BIO;205640;6;2;0;0;0;6;2;205640;Horno Electrico TH62I 60Lts;ELECTRODOMESTICOS
15315035;;M;39;CHILENO;;X;PROVIDENCIA                   ;METROPOLITANA;74960;4;2;4;2;74960;0;0;0;Freidora de Aire 18M Oster;ELECTRODOMESTICOS
16275441;;M;36;CHILENO;;Millenial;N/D;N/D;44990;1;1;0;0;0;1;1;44990;PROCESADOR THOMAS TH-9160;ELECTRODOMESTICOS
6607781;;F;70;CHILENO;;Silencioso;CHILLAN                       ;BIO BIO;44990;1;1;0;0;0;1;1;44990;Horno Microondas Mecanico Easy Wave 20Lts;ELECTRODOMESTICOS
19518365;Soltero;M;25;CHILENO;;Z;PROVIDENCIA                   ;METROPOLITANA;109990;1;1;1;1;109990;0;0;0;SUPER FREIDORA DE AIRE OV3;ELECTRODOMESTICOS
26602652;;F;42;VENEZOLANO;;Extranjero;CHILLAN                       ;BIO BIO;79990;1;1;1;1;79990;0;0;0;FREIDORA DE AIRE THOMAS TH-AF60Mi;ELECTRODOMESTICOS
18164167;Soltero;F;30;CHILENO;TECNICO EN ADMINISTRACION DE EMPRESAS;Millenial;PROVIDENCIA                   ;METROPOLITANA;0;0;2;0;0;0;0;2;0;Batidora Vertical Stick Mixer 2609;ELECTRODOMESTICOS
25756505;;F;43;COLOMBIANO;;Extranjero;SAN CARLOS                    ;BIO BIO;166873;3;2;0;0;0;3;2;166873;Hervidor Electrico UT-MANLY17 1,7Lts Negro;ELECTRODOMESTICOS
19974863;;F;23;CHILENO;;Z;EL TABO                       ;VALPARAISO;42350;3;1;0;0;0;3;1;42350;Licuadora BL1500 Silver 1,75Lts Vaso Vidrio;ELECTRODOMESTICOS
10609419;;F;55;CHILENO;;Boomers;COPIAPO;ATACAMA;25990;1;1;0;0;0;1;1;25990;Plancha UT-KERAMIKTOP 2200Watts Base Ceramica;ELECTRODOMESTICOS
19365371;;M;25;CHILENO;;Silencioso;PROVIDENCIA                   ;METROPOLITANA;179820;4;2;4;2;179820;0;0;0;CAFETERA PRIMA LATTE 6603 ROJA;ELECTRODOMESTICOS
14199996;;F;43;CHILENO;;X;RANCAGUA;O HIGGINS;239980;2;2;0;0;0;2;2;239980;SUPER FREIDORA DE AIRE OV3;ELECTRODOMESTICOS
25104118;;M;26;HAITIANO;;Extranjero;LA CISTERNA                   ;METROPOLITANA;129990;1;1;1;1;129990;0;0;0;MAQUINA COSER 2250;ELECTRODOMESTICOS
8759492;Casado;M;61;CHILENO;;Boomers;RENCA                         ;METROPOLITANA;34990;1;1;0;0;0;1;1;34990;Hervidor Electrico Tetera TH-6505RT 1,7Lts Rojo;ELECTRODOMESTICOS
15698469;;F;38;CHILENO;;Millenial;N/D;N/D;228950;5;3;2;1;168980;3;2;59970;TOSTADOR OLDEMBURGO 2 REBANADAS;ELECTRODOMESTICOS
17672531;Soltero;M;31;CHILENO;PATRON DE NAVE MR;Millenial;PROVIDENCIA                   ;METROPOLITANA;83980;2;1;2;1;83980;0;0;0;Prensadora de Jugo en Frio Slow Juicer Pro;ELECTRODOMESTICOS
20124124;;M;23;CHILENO;;Z;MELIPILLA                     ;METROPOLITANA;19990;1;1;0;0;0;1;1;19990;Combo Hervidor + Batidora;ELECTRODOMESTICOS
6721367;;M;65;CHILENO;;Boomers;CONCEPCION                    ;BIO BIO;252980;4;3;0;0;0;4;3;252980;Exprimidor Fauna 500 cc;ELECTRODOMESTICOS
12531057;;F;49;CHILENO;;X;N/D;N/D;129990;1;1;0;0;0;1;1;129990;CAFETERA PRIMA LATTE 6603 ROJA;ELECTRODOMESTICOS
6265768;;F;73;CHILENO;;Silencioso;RENCA                         ;METROPOLITANA;180590;3;2;0;0;0;3;2;180590;Horno Electrico TH-38N 38Lts;ELECTRODOMESTICOS
8649609;;M;63;CHILENO;;Boomers;TALCA                         ;MAULE;83774;3;2;0;0;0;3;2;83774;Hervidor Electrico TH-4212N 1,7Lts Negro;ELECTRODOMESTICOS
26373044;;M;35;VENEZOLANO;;Extranjero;"";"";49990;1;1;0;0;0;1;1;49990;FREIDORA DE AIRE BAVIERA 3,8 LITROS;ELECTRODOMESTICOS
7495895;;F;65;CHILENO;;Boomers;GRANEROS                      ;L.G.B.OÂ´HIGGINS;97970;3;2;0;0;0;3;2;97970;Licuadora TH-320 Roja/Negro 1,5 Lts Vaso Vidrio;ELECTRODOMESTICOS
7006757;;F;68;CHILENO;;Silencioso;SAGRADA FAMILIA               ;MAULE;204970;3;2;0;0;0;3;2;204970;Combo Hervidor + Batidora;ELECTRODOMESTICOS
14903262;;M;41;CHILENO;;X;SAN CARLOS                    ;BIO BIO;904800;7;5;3;2;455830;4;3;448970;MULTIMIXER THOMAS TH- 8706;ELECTRODOMESTICOS
9648153;;F;56;CHILENO;;Boomers;"";"";20990;1;3;0;0;0;1;3;20990;Hervidor Electrico TH-4515N 2Lts Negro;ELECTRODOMESTICOS
6356475;;F;78;CHILENO;;Silencioso;CONSTITUCION                  ;MAULE;105970;3;1;0;0;0;3;1;105970;Licuadora TH-401V Roja 1,75Lts Vaso Vidrio;ELECTRODOMESTICOS
4992084;;F;77;CHILENO;;Silencioso;CASTRO                        ;LOS LAGOS;319980;2;2;0;0;0;2;2;319980;Horno Electrico UT-BACKOFEN60 60Lts;ELECTRODOMESTICOS
18049600;;M;30;CHILENO;;Millenial;PUDAHUEL                      ;METROPOLITANA;49990;1;1;1;1;49990;0;0;0;Horno Microondas Digital TH-20S01 20Lts;ELECTRODOMESTICOS
6997187;;F;60;CHILENO;;Boomers;CALERA                        ;VALPARAISO;325570;6;3;0;0;0;6;3;325570;Horno Microondas Digital TH-25DM 25Lts;ELECTRODOMESTICOS
6722905;;M;69;CHILENO;;Silencioso;MOSTAZAL                      ;L.G.B.OÂ´HIGGINS;257691;3;2;0;0;0;3;2;257691;Horno Electrico TH-48N 48Lts;ELECTRODOMESTICOS
15352632;;M;39;CHILENO;;X;PROVIDENCIA                   ;METROPOLITANA;554063;5;3;3;1;487970;2;2;66093;TOSTADOR OLDEMBURGO 2 REBANADAS;ELECTRODOMESTICOS
6021723;;M;69;CHILENO;;Silencioso;"";"";73980;2;1;2;1;73980;0;0;0;Freidora FDV Airflow;ELECTRODOMESTICOS
15779359;;F;37;CHILENO;;Millenial;TALAGANTE;METROPOLITANA;328870;12;5;6;3;251930;6;2;76940;Exprimidor Fauna 500 cc;ELECTRODOMESTICOS
25439930;;M;34;PERUANO;;Extranjero;RECOLETA                      ;METROPOLITANA;74990;1;1;0;0;0;1;1;74990;Horno Microondas Mecanico M-2020NG 20Lts;ELECTRODOMESTICOS
16378133;;F;36;CHILENO;;Millenial;"";"";83980;2;1;2;1;83980;0;0;0;Batidora Berry Mixer (KM3000) 1300 watts;ELECTRODOMESTICOS
18554596;;F;29;CHILENO;;Millenial;PROVIDENCIA                   ;METROPOLITANA;29540;3;1;0;0;0;3;1;29540;Sandwichera TH-952 2 Panes Blanca;ELECTRODOMESTICOS
8054977;Casado;F;63;CHILENO;;Boomers;RENCA                         ;METROPOLITANA;113980;2;1;2;1;113980;0;0;0;SUPER FREIDORA DE AIRE OV3;ELECTRODOMESTICOS
11519956;;F;52;CHILENO;;X;N/D;N/D;381940;6;4;5;3;366950;1;1;14990;MAQUINA DE COSER ALFA MOD STYLE 20;ELECTRODOMESTICOS
11455363;;M;53;CHILENO;;X;MAIPU                         ;METROPOLITANA;50410;2;1;0;0;0;2;1;50410;ASPIRADORA ROBOT WIFI FIDDLER HOME BLANCA;ELECTRODOMESTICOS
11940102;;F;50;CHILENO;;X;ILLAPEL                       ;COQUIMBO;498510;5;4;3;2;307530;2;2;190980;SUPER FREIDORA DE AIRE OV3;ELECTRODOMESTICOS
12155616;;F;53;CHILENO;;X;PAINE                         ;METROPOLITANA;64980;2;1;0;0;0;2;1;64980;Horno Microondas Mecanico Easy Wave 20Lts;ELECTRODOMESTICOS
7123801;;F;68;CHILENO;;Silencioso;EL QUISCO                     ;VALPARAISO;143761;4;4;0;0;0;4;4;143761;Picadora UT-PETRUS320 1Lts Vaso Vidrio;ELECTRODOMESTICOS
6810681;;F;71;CHILENO;;Silencioso;CORONEL                       ;BIO BIO;65450;2;1;0;0;0;2;1;65450;Horno Microondas Mecanico Easy Wave 20Lts;ELECTRODOMESTICOS
16304671;;F;36;CHILENO;;Millenial;ARAUCO                        ;BIO BIO;186243;3;2;0;0;0;3;2;186243;Licuadora TH-501V 1,5Lts Vaso Vidrio;ELECTRODOMESTICOS
6528384;;M;70;CHILENO;;Silencioso;PROVIDENCIA                   ;METROPOLITANA;20990;1;1;0;0;0;1;1;20990;Hervidor Electrico TH-4515N 2Lts Negro;ELECTRODOMESTICOS
25600973;;F;61;PERUANO;;Extranjero;N/D;N/D;0;0;2;0;0;0;0;2;0;HERVIDOR COLONIA 1,7 LITROS;ELECTRODOMESTICOS
17905569;;F;32;CHILENO;;Millenial;"";"";77980;2;2;0;0;0;2;2;77980;Licuadora TH-320 Roja/Negro 1,5 Lts Vaso Vidrio;ELECTRODOMESTICOS
10919765;;F;53;CHILENO;;X;PROVIDENCIA                   ;METROPOLITANA;241980;2;1;2;1;241980;0;0;0;OVERLOCK ALFA MOD 8708;ELECTRODOMESTICOS
18136702;;F;29;CHILENO;;Millenial;ILLAPEL;COQUIMBO;798670;11;9;9;8;553910;2;1;244760;Licuadora Personal TH-300PB;ELECTRODOMESTICOS
18852975;;F;28;CHILENO;;Millenial;N/D;N/D;13000;2;1;0;0;0;2;1;13000;HERVIDOR COLONIA 1,7 LITROS;ELECTRODOMESTICOS
9362229;;F;62;CHILENO;;Boomers;ANTOFAGASTA                   ;ANTOFAGASTA;145970;3;2;0;0;0;3;2;145970;Licuadora TH-501V 1,5Lts Vaso Vidrio;ELECTRODOMESTICOS
13793054;;F;42;CHILENO;;X;SAN CARLOS                    ;BIO BIO;289711;4;4;0;0;0;4;4;289711;Batidora Vertical Stick Mixer 2609;ELECTRODOMESTICOS
18347163;;F;29;CHILENO;;Millenial;PROVIDENCIA                   ;METROPOLITANA;582870;7;4;0;0;0;7;4;582870;Horno Microondas Mecanico Easy Wave 20Lts;ELECTRODOMESTICOS
12246033;;M;49;CHILENO;;X;PROVIDENCIA                   ;METROPOLITANA;25990;1;1;0;0;0;1;1;25990;Plancha UT-KERAMIKTOP 2200Watts Base Ceramica;ELECTRODOMESTICOS
9627860;;M;56;CHILENO;;Boomers;PROVIDENCIA                   ;METROPOLITANA;355660;3;2;0;0;0;3;2;355660;BATIDORA PEDESTAL RENANIA 5 LITROS;ELECTRODOMESTICOS
9676674;;M;59;CHILENO;;Boomers;LA PINTANA                    ;METROPOLITANA;19990;1;1;0;0;0;1;1;19990;Hervidor Electrico TH-4515N 2Lts Negro;ELECTRODOMESTICOS
9570706;;M;58;CHILENO;;Boomers;PROVIDENCIA                   ;METROPOLITANA;144960;4;1;4;1;144960;0;0;0;ASPIRADORA SAMSUNG VC18M3110VB/ZS;ELECTRODOMESTICOS
8829019;;M;62;CHILENO;;Boomers;PEDRO AGUIRRE CERDA;METROPOLITANA;19990;1;1;0;0;0;1;1;19990;Hervidor Electrico TH-4515N 2Lts Negro;ELECTRODOMESTICOS
8768777;;M;62;CHILENO;;Boomers;IQUIQUE                       ;TARAPACA;72980;2;2;0;0;0;2;2;72980;Horno Microondas Mecanico Fancy 20Lts;ELECTRODOMESTICOS
25525337;;F;41;COLOMBIANO;;Extranjero;PROVIDENCIA                   ;METROPOLITANA;138970;3;2;2;1;113980;1;1;24990;Maquina de Coser 3008 Janome Blanco;ELECTRODOMESTICOS
10066334;;M;58;CHILENO;;Boomers;COLINA                        ;METROPOLITANA;40280;3;1;0;0;0;3;1;40280;HERVIDOR COLONIA 1,7 LITROS;ELECTRODOMESTICOS
16061844;Soltero;F;37;CHILENO;ABOGADO;Millenial;PROVIDENCIA                   ;METROPOLITANA;268940;6;3;6;3;268940;0;0;0;SUPER FREIDORA DE AIRE OV3;ELECTRODOMESTICOS
10368797;Casado;M;54;CHILENO;;Boomers;RENCA                         ;METROPOLITANA;69990;1;1;0;0;0;1;1;69990;Horno Microondas Mecanico TH-18B05 18Lts;ELECTRODOMESTICOS
25043668;;F;27;PERUANO;;Extranjero;N/D;N/D;110450;2;1;0;0;0;2;1;110450;Olla Multiuso 6801 5,7Lts;ELECTRODOMESTICOS
17555422;;F;30;CHILENO;;Millenial;SANTA JUANA                   ;BIO BIO;39990;1;1;0;0;0;1;1;39990;Aspiradora AP1700 Arrastre 1700Watts;ELECTRODOMESTICOS
10885081;;F;57;CHILENO;;Boomers;N/D;N/D;109980;2;2;0;0;0;2;2;109980;Horno Electrico TH-48N 48Lts;ELECTRODOMESTICOS
17881581;;F;29;CHILENO;;Millenial;N/D;N/D;494542;6;4;4;2;436960;2;2;57582;Batidora Pedestal TH910PN 4,6Lts 1300Watts;ELECTRODOMESTICOS
17920753;;M;30;CHILENO;;Millenial;VILLARICA                     ;ARAUCANIA;21990;1;1;0;0;0;1;1;21990;Exprimidor de Jugo TH-1215 1,5Lts;ELECTRODOMESTICOS
18596061;;M;28;CHILENO;;Millenial;PROVIDENCIA                   ;METROPOLITANA;139990;1;1;1;1;139990;0;0;0;SUPER FREIDORA DE AIRE OV3;ELECTRODOMESTICOS
25704916;;F;40;VENEZOLANO;;Extranjero;TEMUCO                        ;ARAUCANIA;113980;2;1;2;1;113980;0;0;0;Arrocera Oster 10 en 1 con freidora de aire CKST;ELECTRODOMESTICOS
24907376;;F;21;PERUANO;;Extranjero;N/D;N/D;481960;4;4;2;2;329980;2;2;151980;Extractor de Jugo EX800 1,4Lts;ELECTRODOMESTICOS
9192781;;F;61;CHILENO;;Boomers;CALAMA                        ;ANTOFAGASTA;12990;1;1;0;0;0;1;1;12990;HERVIDOR COLONIA 1,7 LITROS;ELECTRODOMESTICOS
10111665;;F;54;CHILENO;;Boomers;IQUIQUE                       ;TARAPACA;202440;6;3;0;0;0;6;3;202440;Picadora P-123TOPBL 1,5Lts;ELECTRODOMESTICOS
15134548;;F;40;CHILENO;;X;SAN CLEMENTE                  ;MAULE;25980;2;1;0;0;0;2;1;25980;TOSTADOR OLDEMBURGO 2 REBANADAS;ELECTRODOMESTICOS
13003395;;F;46;CHILENO;;X;SAN FERNANDO                  ;L.G.B.OÂ´HIGGINS;109990;1;1;0;0;0;1;1;109990;HORNO ELECTRICO HE-600IN INOX SINDELEN;ELECTRODOMESTICOS
18983539;;M;26;CHILENO;;Z;N/D;N/D;189980;2;2;0;0;0;2;2;189980;Horno Microondas Mecanico TH-18B05 18Lts;ELECTRODOMESTICOS
17973206;;M;30;CHILENO;;Millenial;N/D;N/D;524960;4;3;0;0;0;4;3;524960;Hervidor Electrico UT-MANLY17 1,7Lts Negro;ELECTRODOMESTICOS
9813965;;M;58;CHILENO;;Boomers;N/D;N/D;184980;2;2;0;0;0;2;2;184980;Horno Electrico TH62I 60Lts;ELECTRODOMESTICOS
12814348;Divorciado;F;47;CHILENO;PROFESOR;X;RENCA                         ;METROPOLITANA;26990;1;1;0;0;0;1;1;26990;Tostador de Pan TP-1400 4 Rebanadas Inox;ELECTRODOMESTICOS
8720245;;M;63;CHILENO;;Boomers;SANTA BARBARA                 ;BIO BIO;334960;4;2;0;0;0;4;2;334960;Horno Electrico TH-25N01 25Lts;ELECTRODOMESTICOS
10781693;;M;53;CHILENO;;X;N/D;N/D;885310;8;5;0;0;0;8;5;885310;Licuadora L2000VNG 1,5Lts Vaso Vidrio;ELECTRODOMESTICOS
8694550;;F;64;CHILENO;;Boomers;RENCA                         ;METROPOLITANA;97980;2;1;0;0;0;2;1;97980;Enceradora EA-5000;ELECTRODOMESTICOS
14382689;;F;42;CHILENO;;X;PROVIDENCIA                   ;METROPOLITANA;43980;2;1;2;1;43980;0;0;0;Horno Microondas Mecanico C1700N 17Lts Blanco;ELECTRODOMESTICOS
17607421;;F;32;CHILENO;;Millenial;ARAUCO                        ;BIO BIO;109990;1;1;0;0;0;1;1;109990;Horno Electrico UT-BACKOFEN60 60Lts;ELECTRODOMESTICOS
9046711;;M;62;CHILENO;;Boomers;PICHIDEGUA                    ;L.G.B.OÂ´HIGGINS;150330;3;1;0;0;0;3;1;150330;Horno Electrico TH62I 60Lts;ELECTRODOMESTICOS
19989905;;F;23;CHILENO;;Z;N/D;N/D;49990;1;1;0;0;0;1;1;49990;FREIDORA DE AIRE BAVIERA 3,8 LITROS;ELECTRODOMESTICOS
6547917;Viudo;F;70;CHILENO;;Silencioso;VINA DEL MAR                  ;VALPARAISO;24990;1;1;0;0;0;1;1;24990;HORNO 10 LITROS OSTER ROJO;ELECTRODOMESTICOS
10592147;;M;54;CHILENO;;X;VALLENAR;ATACAMA;188970;3;5;0;0;0;3;5;188970;Horno Microondas Digital TH-20S01 20Lts;ELECTRODOMESTICOS
16325554;;F;35;CHILENO;;Millenial;OVALLE                        ;COQUIMBO;244970;3;2;2;1;209980;1;1;34990;Aspiradora AP1700 Arrastre 1700Watts;ELECTRODOMESTICOS
13551033;;F;42;CHILENO;;X;SAN VICENTE                   ;L.G.B.OÂ´HIGGINS;69990;1;1;0;0;0;1;1;69990;Aspiradora UT-SILENT1804 Arrastre 1800Watts;ELECTRODOMESTICOS
7521848;;F;61;CHILENO;;Boomers;PROVIDENCIA                   ;METROPOLITANA;322960;4;2;4;2;322960;0;0;0;MICROONDAS 40L MG402MADXBB/ZS SAMSUNG;ELECTRODOMESTICOS
7805746;;F;62;CHILENO;;Boomers;COPIAPO                       ;ATACAMA;11990;1;1;0;0;0;1;1;11990;Plancha a Vapor 5001;ELECTRODOMESTICOS
11300679;;F;54;CHILENO;;X;ANGOL                         ;ARAUCANIA;166960;4;4;0;0;0;4;4;166960;Licuadora Berry Blender Roja 1400 Vaso Vidrio;ELECTRODOMESTICOS
17112653;Soltero;F;33;CHILENO;;Millenial;PROVIDENCIA                   ;METROPOLITANA;39990;1;1;0;0;0;1;1;39990;Aspiradora Handy Clean Black 1400;ELECTRODOMESTICOS
20198404;;F;23;CHILENO;;Millenial;LA REINA;METROPOLITANA;575110;5;2;2;1;28980;3;1;546130;Licuadora TH-320 Roja/Negro 1,5 Lts Vaso Vidrio;ELECTRODOMESTICOS
15462455;;M;39;CHILENO;;X;MAIPU;METROPOLITANA;53980;2;1;2;1;53980;0;0;0;H MICROONDA MMP-23GABV 23L;ELECTRODOMESTICOS
13240550;;F;44;CHILENO;;X;N/D;N/D;49990;1;1;0;0;0;1;1;49990;ASPIRADORA THOMAS TH-1640;ELECTRODOMESTICOS
6750611;;F;71;CHILENO;;Silencioso;PROVIDENCIA                   ;METROPOLITANA;24990;1;1;0;0;0;1;1;24990;HORNO 10 LITROS OSTER ROJO;ELECTRODOMESTICOS
9200509;;F;61;CHILENO;;Boomers;SAN ESTEBAN                   ;VALPARAISO;19990;1;1;0;0;0;1;1;19990;Combo Hervidor + Batidora;ELECTRODOMESTICOS
18655486;Soltero;F;28;CHILENO;;Millenial;"";"";84950;5;4;0;2;0;5;2;84950;Horno Microondas Mecanico Fancy 20Lts;ELECTRODOMESTICOS
8528173;;F;52;CHILENO;;X;COIHAIQUE                     ;AYSEN;120340;2;1;0;0;0;2;1;120340;Maquina de coser Singer 1605;ELECTRODOMESTICOS
10479802;;F;57;CHILENO;;Boomers;RENCA                         ;METROPOLITANA;252940;6;5;0;0;0;6;5;252940;Aspiradora TH1415 Arrastre 1500Watts;ELECTRODOMESTICOS
5748696;;F;74;CHILENO;;Silencioso;CALAMA                        ;ANTOFAGASTA;14990;1;1;0;0;0;1;1;14990;HERVIDOR HAMBURGO 2,0 LITROS;ELECTRODOMESTICOS
17437509;;F;32;CHILENO;;Millenial;"";"";12990;1;1;0;0;0;1;1;12990;Plancha Easy Steam (PV4500);ELECTRODOMESTICOS
13099100;;M;45;CHILENO;;X;RANCAGUA                      ;L.G.B.OÂ´HIGGINS;75980;2;1;2;1;75980;0;0;0;Mi Smart Air Fryer 3.5L;ELECTRODOMESTICOS
20340449;;M;45;CHILENO;;X;N/D;N/D;184970;3;3;0;0;0;3;3;184970;Horno Microondas Digital TH20DM 20Lts Espejado;ELECTRODOMESTICOS
6767065;;F;71;CHILENO;;Silencioso;PARRAL                        ;MAULE;80382;2;2;0;0;0;2;2;80382;Aspiradora TH1407 Arrastre 1400Watts;ELECTRODOMESTICOS
12828638;;F;52;CHILENO;;X;N/D;N/D;143980;2;1;2;1;143980;0;0;0;SUPER FREIDORA DE AIRE OV3;ELECTRODOMESTICOS
14388367;;F;44;CHILENO;;X;PROVIDENCIA                   ;METROPOLITANA;79990;1;1;0;0;0;1;1;79990;Horno Microondas Digital TH-25DM 25Lts;ELECTRODOMESTICOS
11603020;;F;52;CHILENO;;X;N/D;N/D;1840380;12;9;2;1;327980;10;8;1512400;Batidora Manual 3532;ELECTRODOMESTICOS
16865762;;M;34;CHILENO;;Millenial;RENCA                         ;METROPOLITANA;14990;1;1;0;0;0;1;1;14990;Hervidor Electrico TH-4212N 1,7Lts Negro;ELECTRODOMESTICOS
26434622;;M;32;NO INFORMA NACIONALIDAD;;Extranjero;PROVIDENCIA                   ;METROPOLITANA;50980;2;1;2;1;50980;0;0;0;Olla a Presion Multiolla Daily Food 6L;ELECTRODOMESTICOS
10368356;;F;48;CHILENO;;X;RENCA                         ;METROPOLITANA;23980;2;1;2;1;23980;0;0;0;Licuadora Berry Blender Roja 1400 Vaso Vidrio;ELECTRODOMESTICOS
12157035;Soltero;M;48;CHILENO;;X;RENCA                         ;METROPOLITANA;34990;1;1;0;0;0;1;1;34990;Hervidor Electrico Tetera TH-6505RT 1,7Lts Rojo;ELECTRODOMESTICOS
27184928;Soltero;M;45;EXTRANJERO - NO INFORMA NACIONALIDAD;;X;SANTIAGO;METROPOLITANA;143980;2;1;2;1;143980;0;0;0;SUPER FREIDORA DE AIRE OV3;ELECTRODOMESTICOS
18112247;;F;30;CHILENO;;Millenial;N/D;N/D;174970;3;2;0;0;0;3;2;174970;Aspiradora Handy Clean Black 1400;ELECTRODOMESTICOS
26651688;;M;48;VENEZOLANO;;Extranjero;LOS ANGELES                   ;BIO BIO;186970;3;2;0;0;0;3;2;186970;Batidora Manual BA-5010 Inox;ELECTRODOMESTICOS
9114069;;F;58;CHILENO;;Boomers;IQUIQUE                       ;TARAPACA;60222;3;1;0;0;0;3;1;60222;HORNO ELECTRICO BREMEN 23 LITROS;ELECTRODOMESTICOS
10891200;;M;56;CHILENO;;Boomers;N/D;N/D;28990;1;1;0;0;0;1;1;28990;Hervidor Electrico UT-REIN17SS;ELECTRODOMESTICOS
10239920;;M;55;CHILENO;;Boomers;RENCA                         ;METROPOLITANA;16980;2;1;2;1;16980;0;0;0;PLANCHA A VAPOR 4070 SUELA CERAMICA 2500W;ELECTRODOMESTICOS
19867105;;M;23;CHILENO;;Z;ILLAPEL                       ;COQUIMBO;22393;1;1;0;0;0;1;1;22393;Hervidor Electrico Tetera HA-4100 4Lts Iox;ELECTRODOMESTICOS
13748682;;F;42;CHILENO;;X;"";"";160000;2;1;0;0;0;2;1;160000;Horno Electrico TH-100i 100Lts;ELECTRODOMESTICOS
9633315;;F;60;CHILENO;;Boomers;CORONEL                       ;BIO BIO;695950;5;3;0;0;0;5;3;695950;Parrilla Electrica M18W;ELECTRODOMESTICOS
15696820;;M;38;CHILENO;;X;PARRAL                        ;MAULE;79970;3;2;0;0;0;3;2;79970;Freidora de Aire 18M Oster;ELECTRODOMESTICOS
17304377;;F;32;CHILENO;;Millenial;CERRO NAVIA;METROPOLITANA;486930;7;3;7;3;486930;0;0;0;H MICROONDA MMP-23GABV 23L;ELECTRODOMESTICOS
6186270;;F;74;CHILENO;;Silencioso;SAN BERNARDO                  ;METROPOLITANA;60220;4;3;0;0;0;4;3;60220;Hervidor Family Kettle HE500;ELECTRODOMESTICOS
8634425;;F;62;CHILENO;;Boomers;PROVIDENCIA                   ;METROPOLITANA;12990;1;1;0;0;0;1;1;12990;Plancha Easy Steam (PV4500);ELECTRODOMESTICOS
13617344;;F;43;CHILENO;;X;SAN CARLOS                    ;BIO BIO;49980;2;2;0;0;0;2;2;49980;HERVIDOR COLONIA 1,7 LITROS;ELECTRODOMESTICOS
24503791;;F;33;PERUANO;;Extranjero;SAN VICENTE                   ;L.G.B.OÂ´HIGGINS;59990;1;1;0;0;0;1;1;59990;ASPIRADORA THOMAS TH-1640;ELECTRODOMESTICOS
21103436;;F;40;CHILENO;;X;PROVIDENCIA                   ;METROPOLITANA;12990;1;1;1;1;12990;0;0;0;PLANCHA A VAPOR 4070 SUELA CERAMICA 2500W;ELECTRODOMESTICOS
10519589;;M;57;CHILENO;;Boomers;"";"";15000;2;1;0;0;0;2;1;15000;Batidora Vertical Stick Mixer 2609;ELECTRODOMESTICOS
25647927;;M;28;VENEZOLANO;;Extranjero;N/D;N/D;17990;1;1;0;0;0;1;1;17990;Batidora Manual 3532;ELECTRODOMESTICOS
18277484;;F;29;CHILENO;;Millenial;PROVIDENCIA                   ;METROPOLITANA;53980;2;1;2;1;53980;0;0;0;Molinillo de Cafe Delonghi KG89;ELECTRODOMESTICOS
26418106;;M;28;EXTRANJERO - NO INFORMA NACIONALIDAD;;Extranjero;MAIPU                         ;METROPOLITANA;214220;3;2;1;1;159990;2;1;54230;Licuadora TH-501V 1,5Lts Vaso Vidrio;ELECTRODOMESTICOS
8366440;;F;64;CHILENO;;Silencioso;PROVIDENCIA                   ;METROPOLITANA;64990;1;1;0;0;0;1;1;64990;PROCESADOR DE ALIMENTOS UT-PROCESSOR750;ELECTRODOMESTICOS
7715019;;F;69;CHILENO;;Silencioso;TALCAHUANO                    ;BIO BIO;227960;4;4;0;0;0;4;4;227960;Horno Microondas Mecanico Fancy 20Lts;ELECTRODOMESTICOS
9465118;Divorciado;M;59;CHILENO;;Boomers;PROVIDENCIA                   ;METROPOLITANA;39990;1;1;0;0;0;1;1;39990;Aspiradora AP1700 Arrastre 1700Watts;ELECTRODOMESTICOS
6961050;;F;73;CHILENO;;Silencioso;LOS ANDES                     ;VALPARAISO;239980;2;2;0;0;0;2;2;239980;Licuadora Osterizer 4112/72 1,25Lts Vaso Vidrio;ELECTRODOMESTICOS
7947703;;F;62;CHILENO;;Boomers;RENCA                         ;METROPOLITANA;36990;1;1;0;0;0;1;1;36990;Combo Hervidor + Tostador + Sandwichera;ELECTRODOMESTICOS
16810879;;F;34;CHILENO;;Millenial;MONTE PATRIA                  ;COQUIMBO;107960;4;3;0;0;0;4;3;107960;Combo Licuadora + Batidora;ELECTRODOMESTICOS
5952697;;M;73;CHILENO;;Silencioso;CARTAGENA                     ;VALPARAISO;18990;1;1;0;0;0;1;1;18990;Batidora Manual UT-TEKLA300;ELECTRODOMESTICOS
7281858;;F;70;CHILENO;;Silencioso;SAN FERNANDO                  ;L.G.B.OÂ´HIGGINS;21990;1;1;0;0;0;1;1;21990;Plancha TH-7052 2000Watts Base Inox;ELECTRODOMESTICOS
8376349;;F;64;CHILENO;;Boomers;RENCA                         ;METROPOLITANA;10990;1;1;0;0;0;1;1;10990;Exprimidor de Jugo CJ-2000 1Lts;ELECTRODOMESTICOS
9381971;;F;60;CHILENO;;Boomers;PROVIDENCIA                   ;METROPOLITANA;523950;5;3;5;3;523950;0;0;0;SUPER FREIDORA DE AIRE OV3;ELECTRODOMESTICOS
6741823;;M;69;CHILENO;;Silencioso;CALERA                        ;VALPARAISO;69783;2;2;0;0;0;2;2;69783;BATIDORA PEDESTAL RENANIA 5 LITROS;ELECTRODOMESTICOS
19450521;;M;25;CHILENO;;Z;"";"";74990;2;7;0;0;0;2;7;74990;Enceradora EA-5000;ELECTRODOMESTICOS
17519885;;F;31;CHILENO;;Millenial;PROVIDENCIA                   ;METROPOLITANA;99980;2;2;0;0;0;2;2;99980;Horno Microondas Digital TH-25DM 25Lts;ELECTRODOMESTICOS
11911152;;F;53;CHILENO;;X;N/D;N/D;129144;5;3;0;0;0;5;3;129144;HERVIDOR ELECTRICO UT-STARK18;ELECTRODOMESTICOS
15219408;;F;38;CHILENO;;X;CHILLAN                       ;BIO BIO;517930;7;6;0;0;0;7;6;517930;Tostador de Pan TH-116 2 Rebanadas Negro;ELECTRODOMESTICOS
12907472;;M;47;CHILENO;;X;PROVIDENCIA                   ;METROPOLITANA;59990;1;1;1;1;59990;0;0;0;Horno Electrico TH-38N 38Lts;ELECTRODOMESTICOS
19073842;Soltero;F;26;CHILENO;;Z;PROVIDENCIA                   ;METROPOLITANA;22990;1;1;0;0;0;1;1;22990;Tostador de PanTH-120R 2 Rebanadas Rojo;ELECTRODOMESTICOS
16394831;;M;36;CHILENO;;Millenial;N/D;N/D;39990;1;1;1;1;39990;0;0;0;FREIDORA DE AIRE BAVIERA 3,8 LITROS;ELECTRODOMESTICOS
12056501;;F;42;CHILENO;;X;PROVIDENCIA                   ;METROPOLITANA;233980;2;1;2;1;233980;0;0;0;Maquina Overlock 3534T Azul;ELECTRODOMESTICOS
9590684;;M;60;CHILENO;;Boomers;N/D;N/D;54990;2;1;0;0;0;2;1;54990;Horno Electrico UT-BACKOFEN26 26Lts;ELECTRODOMESTICOS
13408926;;F;44;CHILENO;;X;CASTRO                        ;LOS LAGOS;493940;6;4;0;0;0;6;4;493940;Horno Electrico TH-80i 80Lts;ELECTRODOMESTICOS
15532521;;F;26;CHILENO;;Millenial;"";"";13240;2;1;0;0;0;2;1;13240;TOSTADOR OLDEMBURGO 2 REBANADAS;ELECTRODOMESTICOS
11409135;;F;53;CHILENO;;X;PUERTO MONTT                  ;LOS LAGOS;255140;6;2;0;0;0;6;2;255140;Batidora Pedestal Bowl 300 Inox;ELECTRODOMESTICOS
16537489;;F;35;CHILENO;;Millenial;PROVIDENCIA                   ;METROPOLITANA;212970;3;2;0;0;0;3;2;212970;Horno Electrico TH-48N 48Lts;ELECTRODOMESTICOS
8091184;;M;62;CHILENO;;Boomers;RENCA                         ;METROPOLITANA;39990;1;1;0;0;0;1;1;39990;Licuadora TH-501V 1,5Lts Vaso Vidrio;ELECTRODOMESTICOS
11580911;;F;52;CHILENO;;X;LOS ALAMOS                    ;BIO BIO;28980;2;1;0;0;0;2;1;28980;Plancha Easy Steam (PV4500);ELECTRODOMESTICOS
10395081;;M;54;CHILENO;;Boomers;RENCA                         ;METROPOLITANA;12990;1;1;0;0;0;1;1;12990;HERVIDOR COLONIA 1,7 LITROS;ELECTRODOMESTICOS
13201537;;F;45;CHILENO;;X;TALCA                         ;MAULE;49990;1;1;0;0;0;1;1;49990;Horno Microondas Mecanico Easy Wave 20Lts;ELECTRODOMESTICOS
12516192;;F;49;CHILENO;;X;RANCAGUA                      ;L.G.B.OÂ´HIGGINS;99980;2;1;0;0;0;2;1;99980;Aspiradora UT-SILENT1804 Arrastre 1800Watts;ELECTRODOMESTICOS
18055690;;F;29;CHILENO;;Millenial;PROVIDENCIA                   ;METROPOLITANA;12990;1;1;0;0;0;1;1;12990;Hervidor Electrico TH-4212N 1,7Lts Negro;ELECTRODOMESTICOS
9265034;;F;56;CHILENO;;Boomers;LOS ANDES                     ;VALPARAISO;12990;1;1;0;0;0;1;1;12990;Hervidor Inox One Midea;ELECTRODOMESTICOS
17731240;;M;31;CHILENO;;Millenial;QUILICURA;METROPOLITANA;112940;6;3;6;3;112940;0;0;0;Hervidor Electrico TH-4515N 2Lts Negro;ELECTRODOMESTICOS
16486048;;M;35;CHILENO;;Millenial;N/D;N/D;409950;5;5;4;4;369960;1;1;39990;Freidora de Aire 18M Oster;ELECTRODOMESTICOS
17497080;;F;31;CHILENO;;Millenial;TALCA                         ;MAULE;12990;1;1;1;1;12990;0;0;0;PLANCHA A VAPOR 4070 SUELA CERAMICA 2500W;ELECTRODOMESTICOS
8654073;Casado;F;64;CHILENO;;Boomers;RENCA                         ;METROPOLITANA;59990;1;1;0;0;0;1;1;59990;Aspiradora TH1870 Arrastre 1800Watts Gris;ELECTRODOMESTICOS
14248636;;F;48;CHILENO;;X;CURICO                        ;MAULE;15990;1;1;0;0;0;1;1;15990;Hervidor Electrico UT-MANLY17 1,7Lts Negro;ELECTRODOMESTICOS
9667666;;F;60;CHILENO;;Boomers;MAIPU                         ;METROPOLITANA;99980;2;1;0;0;0;2;1;99980;Horno Microondas Digital TH20DM 20Lts Espejado;ELECTRODOMESTICOS
24231022;;M;38;BOLIVIANO;;Extranjero;CALAMA                        ;ANTOFAGASTA;385940;6;3;0;0;0;6;3;385940;HERVIDOR HAMBURGO 2,0 LITROS;ELECTRODOMESTICOS
13591143;;M;42;CHILENO;;X;N/D;N/D;54990;1;1;0;0;0;1;1;54990;Aspiradora UT-SILENT1603 Arrastre 1600Watts;ELECTRODOMESTICOS
15974247;;F;37;CHILENO;;Millenial;PROVIDENCIA                   ;METROPOLITANA;389950;5;4;3;2;349970;2;2;39980;Hervidor Electrico Tetera HA-4100 4Lts Iox;ELECTRODOMESTICOS
12021136;;F;54;CHILENO;;Boomers;CHONCHI                       ;LOS LAGOS;616950;5;2;0;0;0;5;2;616950;FREIDORA DE AIRE THOMAS TH-AF60Mi;ELECTRODOMESTICOS
12057567;;F;54;CHILENO;;X;CONTULMO                      ;BIO BIO;106970;3;2;0;0;0;3;2;106970;Horno Electrico UT-BACKOFEN26 26Lts;ELECTRODOMESTICOS
15030016;;F;40;CHILENO;;X;PROVIDENCIA                   ;METROPOLITANA;19990;1;1;0;0;0;1;1;19990;Plancha TH-7052 2000Watts Base Inox;ELECTRODOMESTICOS
12350043;;F;48;CHILENO;;X;VALLENAR;ATACAMA;49990;1;1;0;0;0;1;1;49990;Picadora TH-9020V Vaso Vidrio 2Lts;ELECTRODOMESTICOS
17518842;;F;37;CHILENO;;Millenial;EL MONTE;METROPOLITANA;18990;1;1;0;0;0;1;1;18990;Batidora Manual UT-TEKLA300;ELECTRODOMESTICOS
8186848;;M;63;CHILENO;;Boomers;PROVIDENCIA                   ;METROPOLITANA;74990;1;1;0;0;0;1;1;74990;Horno Microondas Digital UT-CLASSY720 20Lts;ELECTRODOMESTICOS
21104586;;M;60;CHILENO;;Boomers;VILLARICA                     ;ARAUCANIA;32990;1;1;0;0;0;1;1;32990;Combo Juguera + Hervidor;ELECTRODOMESTICOS
25753931;;F;32;VENEZOLANO;;Extranjero;SANTIAGO                      ;METROPOLITANA;68220;4;2;2;1;53980;2;1;14240;Hervidor Electrico 3101 1,7Lts Negro;ELECTRODOMESTICOS
12136856;;F;53;CHILENO;;X;MAIPU                         ;METROPOLITANA;64980;2;2;0;0;0;2;2;64980;Exprimidor de Jugo TH-1215 1,5Lts;ELECTRODOMESTICOS
7768445;;F;66;CHILENO;;Boomers;RENCA                         ;METROPOLITANA;15990;1;1;0;0;0;1;1;15990;Hervidor Electrico UT-MANLY17 1,7Lts Negro;ELECTRODOMESTICOS
19897710;;M;24;CHILENO;;Z;PROVIDENCIA                   ;METROPOLITANA;21990;1;1;0;0;0;1;1;21990;Hervidor Electrico TH-5407i 2Lts;ELECTRODOMESTICOS
13789092;;M;42;CHILENO;;X;LINARES                       ;MAULE;59990;1;1;0;0;0;1;1;59990;Aspiradora TH1870 Arrastre 1800Watts Gris;ELECTRODOMESTICOS
5345233;;M;75;CHILENO;;Silencioso;NOGALES                       ;VALPARAISO;115550;4;2;0;0;0;4;2;115550;Parrilla Electrica TH-180;ELECTRODOMESTICOS
15047840;;F;37;CHILENO;;Millenial;SALAMANCA                     ;COQUIMBO;84980;2;2;1;1;9990;1;1;74990;Plancha a Vapor Oster 3803;ELECTRODOMESTICOS
9308758;;F;61;CHILENO;;Boomers;CHILLAN                       ;BIO BIO;99990;1;1;0;0;0;1;1;99990;FREIDORA DE AIRE THOMAS TH-AF60Mi;ELECTRODOMESTICOS
11967875;;M;51;CHILENO;;Silencioso;PROVIDENCIA                   ;METROPOLITANA;21990;1;1;0;0;0;1;1;21990;HERVIDOR ELECTRICO UT-STARK18;ELECTRODOMESTICOS
10337252;;F;58;CHILENO;;Boomers;N/D;N/D;68970;3;2;0;0;0;3;2;68970;Licuadora Roja 550W 1,5Lts Vaso Vidrio;ELECTRODOMESTICOS
12936953;;M;47;CHILENO;;X;N/D;N/D;90980;2;2;0;0;0;2;2;90980;Plancha UT-PLATTEISEN 2000Watts Base Ceramica;ELECTRODOMESTICOS
10922978;;F;54;CHILENO;;X;PICHIDEGUA                    ;L.G.B.OÂ´HIGGINS;24431;2;1;0;0;0;2;1;24431;HERVIDOR TH-4340;ELECTRODOMESTICOS
10969005;;M;41;CHILENO;;X;N/D;N/D;178980;2;3;2;3;178980;0;0;0;Exprimidor Fauna 500 cc;ELECTRODOMESTICOS
13779199;;F;41;CHILENO;;X;N/D;N/D;169980;2;2;0;0;0;2;2;169980;Horno Electrico UT-BACKOFEN60 60Lts;ELECTRODOMESTICOS
11954432;;F;49;CHILENO;;X;N/D;N/D;269960;4;3;4;1;264960;0;2;5000;Horno Microondas Digital MS28F303TAS/ZS 28Lts;ELECTRODOMESTICOS
12979536;Casado;M;45;CHILENO;;X;PROVIDENCIA                   ;METROPOLITANA;54990;1;1;0;0;0;1;1;54990;Horno Microondas Mecanico TH-18B05 18Lts;ELECTRODOMESTICOS
8636097;;M;64;CHILENO;;Boomers;CHILLAN VIEJO                 ;BIO BIO;139980;2;2;0;0;0;2;2;139980;Horno Microondas Digital L UT-25KROMM 25Lts;ELECTRODOMESTICOS
14493850;;F;46;CHILENO;;X;"";"";45980;2;1;2;1;45980;0;0;0;TERMOHERVIDOR 3,1L ELECTRON BA6932 INX;ELECTRODOMESTICOS
8962369;;M;62;CHILENO;;Boomers;LA PINTANA                    ;METROPOLITANA;357460;6;3;2;1;273980;4;2;83480;Combo Licuadora + Batidora;ELECTRODOMESTICOS
13467282;;F;44;CHILENO;;X;MAIPU                         ;METROPOLITANA;422210;5;3;2;1;373980;3;2;48230;PLANCHA A VAPOR 4070 SUELA CERAMICA 2500W;ELECTRODOMESTICOS
13916255;;M;42;CHILENO;;X;QUINTA NORMAL;METROPOLITANA;68980;2;1;0;0;0;2;1;68980;Licuadora L-25000NG;ELECTRODOMESTICOS
12403919;Casado;F;48;CHILENO;ENFERMERA;X;PROVIDENCIA                   ;METROPOLITANA;16980;2;1;2;1;16980;0;0;0;Cafetera TH-130;ELECTRODOMESTICOS
19579496;;F;24;CHILENO;;Z;PROVIDENCIA                   ;METROPOLITANA;28980;2;2;1;1;12990;1;1;15990;PLANCHA A VAPOR 4070 SUELA CERAMICA 2500W;ELECTRODOMESTICOS
18750896;;F;28;CHILENO;;Millenial;PICHILEMU                     ;L.G.B.OÂ´HIGGINS;822760;4;2;0;0;0;4;2;822760;Licuadora Roja 550W 1,5Lts Vaso Vidrio;ELECTRODOMESTICOS
9559763;;F;60;CHILENO;;Boomers;RENCA                         ;METROPOLITANA;169990;1;1;0;0;0;1;1;169990;Maquina de Coser 311;ELECTRODOMESTICOS
12150118;;F;41;CHILENO;;X;PEMUCO                        ;BIO BIO;26980;2;1;0;0;0;2;1;26980;Sandwichera TH-952 2 Panes Blanca;ELECTRODOMESTICOS
18213858;;F;29;CHILENO;;Millenial;N/D;N/D;29990;1;1;0;0;0;1;1;29990;Licuadora TH-320 Roja/Negro 1,5 Lts Vaso Vidrio;ELECTRODOMESTICOS
18778325;;F;27;CHILENO;;Millenial;MELIPILLA                     ;METROPOLITANA;167970;3;2;2;1;153980;1;1;13990;CAFETERA PRIMA LATTE 6603 NEGRA;ELECTRODOMESTICOS
14313511;;F;46;CHILENO;;X;OVALLE                        ;COQUIMBO;29990;1;1;0;0;0;1;1;29990;HORNO ELECTRICO 16N01 16LTS NEGRO;ELECTRODOMESTICOS
25593281;;M;33;HAITIANO;;Extranjero;N/D;N/D;17203;2;1;0;0;0;2;1;17203;Batidora Manual TH-8830;ELECTRODOMESTICOS
12139924;;M;48;CHILENO;;X;RENCA                         ;METROPOLITANA;482110;7;3;0;0;0;7;3;482110;Horno Microondas Digital TH-20S01 20Lts;ELECTRODOMESTICOS
10455103;;M;57;CHILENO;;Boomers;RENCA                         ;METROPOLITANA;12990;1;1;0;0;0;1;1;12990;HERVIDOR COLONIA 1,7 LITROS;ELECTRODOMESTICOS
13750277;;F;49;CHILENO;;X;CALAMA                        ;ANTOFAGASTA;109990;1;1;0;0;0;1;1;109990;MAQUINA COSER 2250;ELECTRODOMESTICOS
13147986;;M;45;CHILENO;;X;N/D;N/D;49990;1;1;0;0;0;1;1;49990;Horno Microondas Mecanico TH-18B05 18Lts;ELECTRODOMESTICOS
11141675;;M;55;CHILENO;;Boomers;CALERA DE TANGO               ;METROPOLITANA;378960;4;6;0;0;0;4;6;378960;HERVIDOR COLONIA 1,7 LITROS;ELECTRODOMESTICOS
10011047;;F;52;CHILENO;;X;N/D;N/D;22990;1;1;0;0;0;1;1;22990;Tostador de PanTH-120R 2 Rebanadas Rojo;ELECTRODOMESTICOS
10175128;;F;56;CHILENO;;Boomers;COINCO                        ;L.G.B.OÂ´HIGGINS;134980;2;2;0;0;0;2;2;134980;Licuadora L2000VNG 1,5Lts Vaso Vidrio;ELECTRODOMESTICOS
11697039;;M;52;CHILENO;;X;SAN ANTONIO                   ;VALPARAISO;748930;7;4;0;0;0;7;4;748930;Aspiradora TH1407 Arrastre 1400Watts;ELECTRODOMESTICOS
14377055;;F;45;CHILENO;;X;BUIN                          ;METROPOLITANA;29990;1;1;0;0;0;1;1;29990;Combo Licuadora + Batidora;ELECTRODOMESTICOS
9165292;Soltero;F;60;CHILENO;;Boomers;RENCA                         ;METROPOLITANA;265970;3;3;0;0;0;3;3;265970;Horno Electrico TH-80i 80Lts;ELECTRODOMESTICOS
9003106;;M;61;CHILENO;;Boomers;ALTO HOSPICIO;TARAPACA;21990;1;1;0;0;0;1;1;21990;Combo Hervidor + Batidora;ELECTRODOMESTICOS
4790105;;F;83;CHILENO;;Silencioso;N/D;N/D;384960;4;3;0;0;0;4;3;384960;Licuadora L-1630V Negra 1,5Lts Vaso Vidrio;ELECTRODOMESTICOS
19021902;Soltero;F;26;CHILENO;;Z;"";"";146960;4;2;0;0;0;4;2;146960;Horno Electrico TH-38N 38Lts;ELECTRODOMESTICOS
12397525;;M;49;CHILENO;;X;OVALLE                        ;COQUIMBO;174980;3;2;0;0;0;3;2;174980;Combo Hervidor + Batidora;ELECTRODOMESTICOS
16734819;;F;34;CHILENO;;Millenial;"";"";228970;3;2;2;1;180980;1;1;47990;Aspiradora Roomba 621;ELECTRODOMESTICOS
24535701;;F;72;PERUANO;;Extranjero;TALCA                         ;MAULE;71982;4;2;0;0;0;4;2;71982;Licuadora Kaliman Negra con Teclas;ELECTRODOMESTICOS
18661054;;M;28;CHILENO;;Millenial;PROVIDENCIA                   ;METROPOLITANA;-5000;0;2;0;0;0;0;2;-5000;PLANCHA VAPOR TH-7146;ELECTRODOMESTICOS
18234785;;F;29;CHILENO;;Millenial;PROVIDENCIA                   ;METROPOLITANA;13990;1;1;0;0;0;1;1;13990;Hervidor Electrico 3101 1,7Lts Negro;ELECTRODOMESTICOS
10797138;;F;52;CHILENO;;X;"";"";12990;1;1;0;0;0;1;1;12990;Cafetera TH-130;ELECTRODOMESTICOS
19070417;Soltero;F;26;CHILENO;;Z;PROVIDENCIA                   ;METROPOLITANA;104980;3;2;3;2;104980;0;0;0;Aspiradora TH1407 Arrastre 1400Watts;ELECTRODOMESTICOS
15122293;;M;40;CHILENO;;X;RENCA                         ;METROPOLITANA;73970;3;2;0;0;0;3;2;73970;Horno Microondas Mecanico Easy Wave 20Lts;ELECTRODOMESTICOS
9124519;Soltero;F;60;CHILENO;PROFESOR;Boomers;RENCA                         ;METROPOLITANA;19990;1;1;0;0;0;1;1;19990;Hervidor Electrico TH-4515N 2Lts Negro;ELECTRODOMESTICOS
12102914;;M;53;CHILENO;;X;LINARES                       ;MAULE;738120;7;4;0;0;0;7;4;738120;Hervidor Electrico 3101 1,7Lts Negro;ELECTRODOMESTICOS
12872000;;F;46;CHILENO;;X;REQUINOA                      ;L.G.B.OÂ´HIGGINS;131980;2;2;0;0;0;2;2;131980;MAQUINA COSER 2250;ELECTRODOMESTICOS
13858435;;M;41;CHILENO;;X;TALCA                         ;MAULE;75970;3;2;0;0;0;3;2;75970;PLANCHA A VAPOR 4070 SUELA CERAMICA 2500W;ELECTRODOMESTICOS
13540711;;F;43;CHILENO;;X;CALERA                        ;VALPARAISO;39980;2;2;0;0;0;2;2;39980;Plancha TH-7052 2000Watts Base Inox;ELECTRODOMESTICOS
9025080;;F;60;CHILENO;;Boomers;RENCA                         ;METROPOLITANA;70980;2;2;0;0;0;2;2;70980;Aspiradora TH1407 Arrastre 1400Watts;ELECTRODOMESTICOS
18080332;;M;30;CHILENO;;Millenial;CONCHALI;METROPOLITANA;121980;2;1;0;0;0;2;1;121980;Horno Microondas Digital L UT-25KROMM 25Lts;ELECTRODOMESTICOS
10722765;;F;51;CHILENO;;X;PROVIDENCIA                   ;METROPOLITANA;12990;1;1;0;0;0;1;1;12990;PLANCHA A VAPOR 4070 SUELA CERAMICA 2500W;ELECTRODOMESTICOS
16016252;Soltero;M;37;CHILENO;INGENIERIA EN ADMINISTRACION DE EMPRESAS MENCION FINANZAS;Millenial;PROVIDENCIA                   ;METROPOLITANA;295980;2;1;2;1;295980;0;0;0;Robot aspirador Roomba E5;ELECTRODOMESTICOS
26016607;;M;28;HAITIANO;;Extranjero;OSORNO                        ;LOS LAGOS;34990;1;1;0;0;0;1;1;34990;Licuadora Roja 550W 1,5Lts Vaso Vidrio;ELECTRODOMESTICOS
20618484;;F;21;CHILENO;;Z;LA SERENA;COQUIMBO;464960;4;2;3;1;447970;1;1;16990;Hervidor Family Kettle HE500;ELECTRODOMESTICOS
18248925;;F;29;CHILENO;;Millenial;CANETE                        ;BIO BIO;842670;5;3;4;2;811680;1;1;30990;Plancha UT-PLATTEISEN 2000Watts Base Ceramica;ELECTRODOMESTICOS
14253506;;F;47;CHILENO;;X;QUILLOTA                      ;VALPARAISO;337950;5;3;0;0;0;5;3;337950;Batidora Vertical Stick Mixer 2609;ELECTRODOMESTICOS
7464677;;F;70;CHILENO;;Silencioso;SAN CARLOS                    ;BIO BIO;250560;3;2;0;0;0;3;2;250560;Hervidor Electrico TH-4212N 1,7Lts Negro;ELECTRODOMESTICOS
15864777;;M;37;CHILENO;;Millenial;RENCA                         ;METROPOLITANA;700960;4;4;0;0;0;4;4;700960;Batidora Pedestal TH910PN 4,6Lts 1300Watts;ELECTRODOMESTICOS
12053382;;F;55;CHILENO;;Boomers;PROVIDENCIA                   ;METROPOLITANA;10990;1;1;0;0;0;1;1;10990;Plancha a Vapor Oster 3803;ELECTRODOMESTICOS
10380103;;F;48;CHILENO;;X;N/D;N/D;17990;1;1;0;0;0;1;1;17990;Hervidor Electrico UT-MANLY17 1,7Lts Negro;ELECTRODOMESTICOS
26437332;Casado;F;30;NO INFORMA NACIONALIDAD;;Extranjero;N/D;N/D;13000;2;1;0;0;0;2;1;13000;PLANCHA A VAPOR 4070 SUELA CERAMICA 2500W;ELECTRODOMESTICOS
9438105;;F;59;CHILENO;;Boomers;CALDERA                       ;ATACAMA;15393;1;1;0;0;0;1;1;15393;HERVIDOR ELECTRICO UT-STARK18;ELECTRODOMESTICOS
18781129;Soltero;F;27;CHILENO;;Millenial;TALCA;MAULE;24980;2;1;0;0;0;2;1;24980;Batidora Vertical Stick Mixer 2609;ELECTRODOMESTICOS
7228352;;M;68;CHILENO;;Silencioso;PUERTO OCTAY                  ;LOS LAGOS;430250;4;2;0;0;0;4;2;430250;Hervidor Electrico HA-3300 2,5Lts Blanco;ELECTRODOMESTICOS
9104047;;M;59;CHILENO;;Boomers;MAIPU                         ;METROPOLITANA;47980;2;2;0;0;0;2;2;47980;Licuadora L-5500IN 1,5Lts;ELECTRODOMESTICOS
12006155;;F;53;CHILENO;;X;LA GRANJA                     ;METROPOLITANA;12990;1;1;0;0;0;1;1;12990;HERVIDOR COLONIA 1,7 LITROS;ELECTRODOMESTICOS
15253250;Soltero;F;39;CHILENO;;X;PROVIDENCIA                   ;METROPOLITANA;133980;2;1;2;1;133980;0;0;0;Maquina de Coser 3008 Janome Blanco;ELECTRODOMESTICOS
19651343;;F;24;CHILENO;;Z;PROVIDENCIA                   ;METROPOLITANA;38980;2;1;0;0;0;2;1;38980;Batidora Pedestal B5300 Inox;ELECTRODOMESTICOS
10567144;;M;56;CHILENO;;Boomers;CONCEPCION                    ;BIO BIO;89970;3;2;0;0;0;3;2;89970;Hervidor Electrico Tetera HA-4100 4Lts Iox;ELECTRODOMESTICOS
18333254;;M;29;CHILENO;;Millenial;SAAVEDRA                      ;ARAUCANIA;42990;1;3;0;0;0;1;3;42990;LICUADORA CROMADA CON TECLAS PLUS;ELECTRODOMESTICOS
10878578;;F;51;CHILENO;;X;RENCA                         ;METROPOLITANA;49990;1;1;1;1;49990;0;0;0;Horno Microondas Mecanico Easy Wave 20Lts;ELECTRODOMESTICOS
10290191;;F;54;CHILENO;;X;PROVIDENCIA                   ;METROPOLITANA;29990;1;1;0;0;0;1;1;29990;Combo Juguera + Hervidor;ELECTRODOMESTICOS
13006232;;M;47;CHILENO;;X;ARICA                         ;TARAPACA;64980;2;1;0;0;0;2;1;64980;Aspiradora Tambor APA1000 1000Watts;ELECTRODOMESTICOS
10472455;;F;58;CHILENO;;Boomers;VILLARICA                     ;ARAUCANIA;345970;3;2;0;0;0;3;2;345970;HERVIDOR BERLIN 1,7 LITROS;ELECTRODOMESTICOS
6158231;;F;72;CHILENO;;Silencioso;CURICO                        ;MAULE;94969;3;2;0;0;0;3;2;94969;HERVIDOR TH-4340;ELECTRODOMESTICOS
14558347;;F;45;CHILENO;;X;COIHAIQUE                     ;AYSEN;149990;1;1;0;0;0;1;1;149990;Horno Electrico TH-80i 80Lts;ELECTRODOMESTICOS
18454004;;M;29;CHILENO;;Millenial;N/D;N/D;94970;3;2;1;1;39990;2;1;54980;Horno Electrico UT-BACKOFEN26 26Lts;ELECTRODOMESTICOS
15662939;;M;38;CHILENO;;X;PROVIDENCIA                   ;METROPOLITANA;49990;1;1;0;0;0;1;1;49990;Batidora Vertical Minipimer UT-KLOT800SS;ELECTRODOMESTICOS
19261568;Soltero;M;26;CHILENO;;Z;PROVIDENCIA                   ;METROPOLITANA;93980;2;1;0;0;0;2;1;93980;Horno Electrico TH-48N 48Lts;ELECTRODOMESTICOS
15737745;;M;39;CHILENO;;X;N/D;N/D;39990;1;1;0;0;0;1;1;39990;Parrilla Electrica M18W;ELECTRODOMESTICOS
8914852;;F;65;CHILENO;;Boomers;N/D;N/D;677490;7;4;6;3;537500;1;1;139990;Aspiradora VCC4190V3E/XZS Arrastre 2000Watts;ELECTRODOMESTICOS
15555248;Soltero;M;46;CHILENO;PROFESOR;X;RENCA                         ;METROPOLITANA;49990;1;1;0;0;0;1;1;49990;ASPIRADORA THOMAS TH-1640;ELECTRODOMESTICOS
6729178;Divorciado;M;71;CHILENO;;Silencioso;RENCA                         ;METROPOLITANA;11990;1;1;0;0;0;1;1;11990;Hervidor Electrico 3101 1,7Lts Negro;ELECTRODOMESTICOS
9224597;;M;60;CHILENO;;Boomers;EL BOSQUE                     ;METROPOLITANA;646460;4;3;0;0;0;4;3;646460;Horno Microondas Digital TH-20S01 20Lts;ELECTRODOMESTICOS
17241540;;F;32;CHILENO;;Millenial;PROVIDENCIA                   ;METROPOLITANA;60970;3;1;0;0;0;3;1;60970;Aspiradora TH1407 Arrastre 1400Watts;ELECTRODOMESTICOS
6276488;;M;71;CHILENO;;Silencioso;RENCA                         ;METROPOLITANA;89990;1;1;0;0;0;1;1;89990;Horno Microondas Digital TH-25DM 25Lts;ELECTRODOMESTICOS
19940908;;F;24;CHILENO;;Z;PROVIDENCIA                   ;METROPOLITANA;25980;2;2;2;2;25980;0;0;0;PLANCHA A VAPOR 4070 SUELA CERAMICA 2500W;ELECTRODOMESTICOS
13424976;;M;44;CHILENO;;Millenial;N/D;N/D;64990;1;1;0;0;0;1;1;64990;Horno Microondas Mecanico UT-SYDNEY18 18Lts;ELECTRODOMESTICOS
6414157;;M;70;CHILENO;;Silencioso;ALTO HOSPICIO;TARAPACA;59980;2;1;0;0;0;2;1;59980;Freidora de Aire 18M Oster;ELECTRODOMESTICOS
5306009;;M;75;CHILENO;;Silencioso;LINARES                       ;MAULE;77980;2;2;0;0;0;2;2;77980;Licuadora L2000VNG 1,5Lts Vaso Vidrio;ELECTRODOMESTICOS
6052956;Viudo;F;73;CHILENO;;Silencioso;RENCA                         ;METROPOLITANA;34990;1;1;0;0;0;1;1;34990;Licuadora Roja 550W 1,5Lts Vaso Vidrio;ELECTRODOMESTICOS
7493274;;M;69;CHILENO;;Silencioso;CHILLAN                       ;BIO BIO;39990;1;1;0;0;0;1;1;39990;Licuadora TH-501V 1,5Lts Vaso Vidrio;ELECTRODOMESTICOS
6574390;;F;65;CHILENO;;Boomers;PROVIDENCIA                   ;METROPOLITANA;44230;3;2;0;0;0;3;2;44230;Licuadora L-5500IN 1,5Lts;ELECTRODOMESTICOS
19679516;;F;24;CHILENO;;Z;PROVIDENCIA                   ;METROPOLITANA;136980;2;1;2;1;136980;0;0;0;HORNO ELECTRICO HE-850IN INOX SINDELEN;ELECTRODOMESTICOS
10566739;;M;54;CHILENO;;Boomers;RENCA                         ;METROPOLITANA;39990;2;1;2;1;39990;0;0;0;Horno Microondas Mecanico C1700N 17Lts Blanco;ELECTRODOMESTICOS
15156793;;M;29;CHILENO;;Millenial;PROVIDENCIA                   ;METROPOLITANA;64990;1;1;0;0;0;1;1;64990;Horno Microondas Mecanico TH-18B05 18Lts;ELECTRODOMESTICOS
19120233;;F;26;CHILENO;;Extranjero;CONCEPCION                    ;BIO BIO;80960;4;2;0;0;0;4;2;80960;Licuadora Berry Blender Roja 1400 Vaso Vidrio;ELECTRODOMESTICOS
11590631;;F;51;CHILENO;;Millenial;N/D;N/D;19990;1;1;0;0;0;1;1;19990;Plancha TH-7052 2000Watts Base Inox;ELECTRODOMESTICOS
15990819;;M;37;CHILENO;;Millenial;PROVIDENCIA                   ;METROPOLITANA;26990;1;1;0;0;0;1;1;26990;Licuadora Berry Blender Roja 1400 Vaso Vidrio;ELECTRODOMESTICOS
10109302;;F;56;CHILENO;;Boomers;PROVIDENCIA                   ;METROPOLITANA;95480;2;1;2;1;95480;0;0;0;Freidora de Aire Oster 40M;ELECTRODOMESTICOS
9232631;;M;61;CHILENO;;Boomers;TALCAHUANO                    ;BIO BIO;229660;3;2;0;0;0;3;2;229660;Horno Microondas Mecanico Fancy 20Lts;ELECTRODOMESTICOS
11095743;;F;55;CHILENO;;Boomers;COELEMU                       ;BIO BIO;37560;3;2;0;0;0;3;2;37560;Hervidor Acero Inoxidable 40989-CL Hamilton Beac;ELECTRODOMESTICOS
17571694;Soltero;F;32;CHILENO;TECNICO DE NIVEL SUPERIOR EN ENFERMERIA;Millenial;PROVIDENCIA                   ;METROPOLITANA;26990;1;1;0;0;0;1;1;26990;Cafetera TH-138i;ELECTRODOMESTICOS
8886570;;F;60;CHILENO;;Boomers;PROVIDENCIA                   ;METROPOLITANA;69990;1;1;0;0;0;1;1;69990;Horno Microondas Mecanico M-2030 NG 20Lts;ELECTRODOMESTICOS
6734188;;F;70;CHILENO;;Silencioso;SAN BERNARDO                  ;METROPOLITANA;87220;4;2;0;0;0;4;2;87220;Aspiradora TH1407 Arrastre 1400Watts;ELECTRODOMESTICOS
11769461;;M;50;CHILENO;;X;RETIRO;MAULE;114980;2;2;0;0;0;2;2;114980;Horno Electrico TH62I 60Lts;ELECTRODOMESTICOS
15248372;;F;48;CHILENO;;X;N/D;N/D;34990;1;1;0;0;0;1;1;34990;Licuadora L1000 Inox 1,7LtsVaso Vidrio;ELECTRODOMESTICOS
9828131;;M;59;CHILENO;;Boomers;N/D;N/D;109980;2;1;0;0;0;2;1;109980;HORNO ELECTRICO MUNICH 60 LITROS;ELECTRODOMESTICOS
19419112;;F;25;CHILENO;;Z;PROVIDENCIA                   ;METROPOLITANA;251970;3;2;2;1;196980;1;1;54990;Aspiradora Tambor APA1000 1000Watts;ELECTRODOMESTICOS
18817061;;M;28;CHILENO;;Millenial;SAN PEDRO DE LA PAZ           ;BIO BIO;79980;2;2;1;1;39990;1;1;39990;Freidora de Aire 18M Oster;ELECTRODOMESTICOS
8901445;Soltero;F;63;CHILENO;;Boomers;RENCA                         ;METROPOLITANA;18990;1;1;0;0;0;1;1;18990;MULTIMIXER THOMAS TH- 8706;ELECTRODOMESTICOS
13498562;;M;43;CHILENO;;X;PROVIDENCIA                   ;METROPOLITANA;29990;1;1;0;0;0;1;1;29990;Batidora Vertical Multimixer TH-8720;ELECTRODOMESTICOS
10552590;;M;55;CHILENO;;Boomers;"";"";104970;3;2;0;0;0;3;2;104970;HERVIDOR ELECTRICO UT-STARK18;ELECTRODOMESTICOS
17448492;;F;32;CHILENO;;Millenial;LONGAVI                       ;MAULE;119990;1;1;0;0;0;1;1;119990;MAQUINA COSER 2250;ELECTRODOMESTICOS
26858569;;M;41;VENEZOLANO;;Extranjero;"";"";59990;3;1;0;0;0;3;1;59990;LICUADORA CROMADA CON TECLAS PLUS;ELECTRODOMESTICOS
9187001;;F;61;CHILENO;;Boomers;CHIGUAYANTE                   ;BIO BIO;46980;2;1;0;0;0;2;1;46980;Licuadora L-5500IN 1,5Lts;ELECTRODOMESTICOS
9627903;;F;59;CHILENO;;Boomers;OLMUE                         ;VALPARAISO;423440;5;3;2;1;165980;3;2;257460;ASPIRADORA ROBOT VR05R5050WK/ZS;ELECTRODOMESTICOS
9800120;;M;58;CHILENO;;Boomers;DIEGO DE ALMAGRO              ;ATACAMA;224970;3;3;0;0;0;3;3;224970;PLANCHA VAPOR TH-7146;ELECTRODOMESTICOS
18873342;;F;27;CHILENO;;Millenial;TEMUCO                        ;ARAUCANIA;48980;2;1;2;1;48980;0;0;0;Horno Microondas Mecanico C1700N 17Lts Blanco;ELECTRODOMESTICOS
15573377;;M;38;CHILENO;;Millenial;LA SERENA;COQUIMBO;187530;3;2;3;2;187530;0;0;0;Aspiradora VCC4190V3E/XZS Arrastre 2000Watts;ELECTRODOMESTICOS
13044607;Soltero;M;46;CHILENO;;X;PROVIDENCIA                   ;METROPOLITANA;33980;2;1;2;1;33980;0;0;0;Hervidor Termo BA-6928 Inox 2,8Lts;ELECTRODOMESTICOS
6108077;;F;74;CHILENO;;Silencioso;CHILLAN                       ;BIO BIO;92980;2;2;0;0;0;2;2;92980;Licuadora L-25000NG;ELECTRODOMESTICOS
13978813;Soltero;F;41;CHILENO;;X;PETORCA                       ;VALPARAISO;54990;1;1;0;0;0;1;1;54990;Horno Microondas Mecanico Easy Wave 20Lts;ELECTRODOMESTICOS
13371334;;M;44;CHILENO;;X;SAN RAFAEL                    ;MAULE;16990;1;1;0;0;0;1;1;16990;Batidora Manual TH-8830;ELECTRODOMESTICOS
7886649;;M;64;CHILENO;;Boomers;OVALLE                        ;COQUIMBO;39990;1;1;0;0;0;1;1;39990;Picadora TH-9020V Vaso Vidrio 2Lts;ELECTRODOMESTICOS
7384543;;F;67;CHILENO;;Boomers;ZAPALLAR                      ;VALPARAISO;21990;1;1;1;1;21990;0;0;0;Licuadora L-1630V Negra 1,5Lts Vaso Vidrio;ELECTRODOMESTICOS
8658931;;M;64;CHILENO;;Boomers;VALDIVIA                      ;LOS RIOS;145980;2;2;0;0;0;2;2;145980;Horno Microondas Mecanico UT-SYDNEY18 18Lts;ELECTRODOMESTICOS
25763585;;M;29;PERUANO;;Extranjero;N/D;N/D;29990;1;1;0;0;0;1;1;29990;PLANCHA VAPOR TH-7146;ELECTRODOMESTICOS
18770763;Soltero;M;28;CHILENO;TECNICO EN PREVENCION DE RIESGOS;Millenial;SAN CARLOS                    ;BIO BIO;68980;2;1;0;0;0;2;1;68980;Licuadora BL1500 Silver 1,75Lts Vaso Vidrio;ELECTRODOMESTICOS
19121681;;F;26;CHILENO;;Z;PROVIDENCIA                   ;METROPOLITANA;41990;1;1;0;0;0;1;1;41990;Licuadora Kaliman Negra con Teclas;ELECTRODOMESTICOS
14316739;;M;46;CHILENO;;X;SAN ANTONIO                   ;VALPARAISO;218980;2;2;0;0;0;2;2;218980;Hervidor Electrico TH-4515N 2Lts Negro;ELECTRODOMESTICOS
15538943;;M;38;CHILENO;;X;BUIN                          ;METROPOLITANA;63980;2;1;0;0;0;2;1;63980;Parrilla Electrica TH-224;ELECTRODOMESTICOS
12599217;;F;49;CHILENO;;X;MACHALI                       ;L.G.B.OÂ´HIGGINS;84990;1;1;0;0;0;1;1;84990;Horno Microondas Digital TH-20S01 20Lts;ELECTRODOMESTICOS
18218938;;F;29;CHILENO;;Millenial;FREIRINA                      ;ATACAMA;24990;1;1;0;0;0;1;1;24990;Licuadora L2000VNG 1,5Lts Vaso Vidrio;ELECTRODOMESTICOS
8249645;;F;66;CHILENO;;Extranjero;CHILLAN                       ;BIO BIO;0;0;2;0;0;0;0;2;0;LICUADORA CROMADA CON TECLAS PLUS;ELECTRODOMESTICOS
7243586;Divorciado;F;64;CHILENO;;Boomers;VILLA ALEMANA                 ;VALPARAISO;32000;2;1;0;0;0;2;1;32000;Extractor de Jugo EX800 1,4Lts;ELECTRODOMESTICOS
10993349;;F;49;CHILENO;;X;PROVIDENCIA                   ;METROPOLITANA;189990;1;1;0;0;0;1;1;189990;Maquina de Coser 311;ELECTRODOMESTICOS
14571272;;F;42;CHILENO;;X;"";"";39990;1;1;0;0;0;1;1;39990;Licuadora Kaliman Negra con Teclas;ELECTRODOMESTICOS
9082412;;F;62;CHILENO;;Boomers;SANTA CRUZ                    ;L.G.B.OÂ´HIGGINS;127970;3;2;0;0;0;3;2;127970;Licuadora L-1630V Negra 1,5Lts Vaso Vidrio;ELECTRODOMESTICOS
10213688;;M;57;CHILENO;;Boomers;RANCAGUA                      ;L.G.B.OÂ´HIGGINS;34990;1;1;0;0;0;1;1;34990;HORNO ELECTRICO 16N01 16LTS NEGRO;ELECTRODOMESTICOS
8729252;;F;58;CHILENO;;Boomers;OLMUE                         ;VALPARAISO;202980;2;1;0;0;0;2;1;202980;Maquina de Coser ME9100;ELECTRODOMESTICOS
8925514;Casado;F;61;CHILENO;;Boomers;RENCA                         ;METROPOLITANA;14990;1;1;0;0;0;1;1;14990;PLANCHA A VAPOR 4070 SUELA CERAMICA 2500W;ELECTRODOMESTICOS
14542254;;M;48;CHILENO;;X;ANCUD                         ;LOS LAGOS;12990;1;1;0;0;0;1;1;12990;PLANCHA A VAPOR 4070 SUELA CERAMICA 2500W;ELECTRODOMESTICOS
15992884;;M;37;CHILENO;;Millenial;RENGO                         ;L.G.B.OÂ´HIGGINS;245960;4;2;0;0;0;4;2;245960;Maquina de Coser ME9100;ELECTRODOMESTICOS
11740642;;F;50;CHILENO;;X;PROVIDENCIA                   ;METROPOLITANA;19990;1;1;0;0;0;1;1;19990;Licuadora Berry Blender Roja 1400 Vaso Vidrio;ELECTRODOMESTICOS
9314668;;F;54;CHILENO;;Boomers;COIHAIQUE                     ;AYSEN;72980;2;2;0;0;0;2;2;72980;Aspiradora TH1870 Arrastre 1800Watts Gris;ELECTRODOMESTICOS
10727022;;M;79;CHILENO;;Silencioso;QUILPUE                       ;VALPARAISO;49990;1;1;0;0;0;1;1;49990;Horno Microondas Mecanico Easy Wave 20Lts;ELECTRODOMESTICOS
6460525;;F;69;CHILENO;;Silencioso;EL BOSQUE                     ;METROPOLITANA;414960;4;3;0;0;0;4;3;414960;Licuadora Kaliman Negra con Teclas;ELECTRODOMESTICOS
10999551;;F;46;CHILENO;;X;RENCA                         ;METROPOLITANA;30980;2;1;2;1;30980;0;0;0;Combo Licuadora + Batidora;ELECTRODOMESTICOS
9080029;;M;61;CHILENO;;Boomers;TOCOPILLA                     ;ANTOFAGASTA;495950;5;2;0;0;0;5;2;495950;Horno Electrico TH-25N01 25Lts;ELECTRODOMESTICOS
13665388;Casado;M;43;CHILENO;;X;RENCA                         ;METROPOLITANA;24990;1;1;0;0;0;1;1;24990;Licuadora L2000VNG 1,5Lts Vaso Vidrio;ELECTRODOMESTICOS
18325271;;F;29;CHILENO;;Millenial;PROVIDENCIA                   ;METROPOLITANA;18990;1;1;0;0;0;1;1;18990;Plancha UT-DUNST 2200Watts Base Ceramica;ELECTRODOMESTICOS
25368070;;F;38;COLOMBIANO;;Extranjero;TALCA                         ;MAULE;24990;1;1;0;0;0;1;1;24990;Tostador de Pan TP-1400 4 Rebanadas Inox;ELECTRODOMESTICOS
11765030;;F;50;CHILENO;;X;N/D;N/D;73980;2;3;0;0;0;2;3;73980;PLANCHA A VAPOR 6953 BASE AEROCERAMICA AUTAPA.22;ELECTRODOMESTICOS
11484719;;F;52;CHILENO;;X;RENCA                         ;METROPOLITANA;14990;1;1;0;0;0;1;1;14990;Hervidor Electrico 3101 1,7Lts Negro;ELECTRODOMESTICOS
13381387;;F;44;CHILENO;;X;MARIA PINTO                   ;METROPOLITANA;692100;8;5;0;0;0;8;5;692100;Hervidor Electrico TH-4212N 1,7Lts Negro;ELECTRODOMESTICOS
9844496;;F;58;CHILENO;;Boomers;SAN CARLOS                    ;BIO BIO;47990;1;1;0;0;0;1;1;47990;Picadora TH-9020V Vaso Vidrio 2Lts;ELECTRODOMESTICOS
15207536;;M;39;CHILENO;;X;ILLAPEL                       ;COQUIMBO;13990;1;1;0;0;0;1;1;13990;Hervidor Electrico HA-2650NG;ELECTRODOMESTICOS
14359531;;M;43;CHILENO;;X;PROVIDENCIA                   ;METROPOLITANA;14990;1;1;0;0;0;1;1;14990;Batidora Manual 3532;ELECTRODOMESTICOS
5885251;;F;74;CHILENO;;Silencioso;LOS ANDES                     ;VALPARAISO;19990;1;1;0;0;0;1;1;19990;MULTIMIXER THOMAS TH- 8706;ELECTRODOMESTICOS
6838935;;M;80;CHILENO;;Silencioso;CHIMBARONGO                   ;L.G.B.OÂ´HIGGINS;21990;1;1;0;0;0;1;1;21990;Hervidor Electrico TH-4515N 2Lts Negro;ELECTRODOMESTICOS
11431861;;F;53;CHILENO;;X;PROVIDENCIA                   ;METROPOLITANA;109990;1;1;0;0;0;1;1;109990;Horno Electrico TH62I 60Lts;ELECTRODOMESTICOS
7677711;;M;65;CHILENO;;Boomers;TALCA                         ;MAULE;44990;1;1;0;0;0;1;1;44990;Licuadora TH-501V 1,5Lts Vaso Vidrio;ELECTRODOMESTICOS
18375422;;F;29;CHILENO;;Millenial;PROVIDENCIA                   ;METROPOLITANA;34990;1;1;0;0;0;1;1;34990;Licuadora Roja 550W 1,5Lts Vaso Vidrio;ELECTRODOMESTICOS
7813536;Casado;M;63;CHILENO;;Boomers;SAN FELIPE                    ;VALPARAISO;32363;2;2;0;0;0;2;2;32363;Plancha Easy Steam (PV4500);ELECTRODOMESTICOS
9990277;;F;55;CHILENO;;Boomers;PROVIDENCIA                   ;METROPOLITANA;233960;4;2;4;2;233960;0;0;0;Horno Electrico TH-80i 80Lts;ELECTRODOMESTICOS
12532186;;M;48;CHILENO;;X;PROVIDENCIA                   ;METROPOLITANA;29990;1;1;0;0;0;1;1;29990;Licuadora UT-METALLEK505P 1,5Lts Vaso Vidrio;ELECTRODOMESTICOS
16851061;;M;33;CHILENO;;Millenial;SALAMANCA                     ;COQUIMBO;99980;2;2;0;0;0;2;2;99980;Horno Microondas Mecanico TH-18B05 18Lts;ELECTRODOMESTICOS
13251018;;F;45;CHILENO;;X;PROVIDENCIA                   ;METROPOLITANA;8990;1;1;0;0;0;1;1;8990;Plancha a Vapor Oster 3803;ELECTRODOMESTICOS
13773261;;M;41;CHILENO;;X;MARIA PINTO                   ;METROPOLITANA;86970;3;2;0;0;0;3;2;86970;PROCESADOR DE ALIMENTOS UT-PROCESSOR750;ELECTRODOMESTICOS
26751814;;M;51;VENEZOLANO;;Extranjero;"";"";54980;2;1;2;1;54980;0;0;0;Licuadora TH-501V 1,5Lts Vaso Vidrio;ELECTRODOMESTICOS
6350985;;M;69;CHILENO;;Silencioso;PROVIDENCIA                   ;METROPOLITANA;29990;1;1;0;0;0;1;1;29990;Licuadora L-5500IN 1,5Lts;ELECTRODOMESTICOS
14549941;;F;43;CHILENO;;X;"";"";55840;2;1;2;1;55840;0;0;0;Batidora de Pedestal FDV Venus Grey;ELECTRODOMESTICOS
8973912;;M;62;CHILENO;;Boomers;CASTRO                        ;LOS LAGOS;49990;1;1;0;0;0;1;1;49990;Licuadora TH-501V 1,5Lts Vaso Vidrio;ELECTRODOMESTICOS
18619722;;F;28;CHILENO;;Millenial;N/D;N/D;28990;3;2;0;0;0;3;2;28990;Licuadora TH-320 Roja/Negro 1,5 Lts Vaso Vidrio;ELECTRODOMESTICOS
9186270;;F;61;CHILENO;;Boomers;CANETE                        ;BIO BIO;19990;1;1;0;0;0;1;1;19990;Hervidor Electrico TH-4515N 2Lts Negro;ELECTRODOMESTICOS
6880795;;F;70;CHILENO;;Silencioso;SAN VICENTE                   ;L.G.B.OÂ´HIGGINS;36980;2;1;0;0;0;2;1;36980;Hervidor Electrico TH-5407i 2Lts;ELECTRODOMESTICOS
13584591;;M;45;CHILENO;;X;TEMUCO                        ;ARAUCANIA;14990;1;1;0;0;0;1;1;14990;Batidora Vertical Stick Mixer 2609;ELECTRODOMESTICOS
14306167;;F;47;CHILENO;;X;SANTA CRUZ                    ;L.G.B.OÂ´HIGGINS;29990;1;1;0;0;0;1;1;29990;Licuadora UT-METALLEK505P 1,5Lts Vaso Vidrio;ELECTRODOMESTICOS
12314342;;F;49;CHILENO;;X;EL MONTE                      ;METROPOLITANA;84990;1;1;0;0;0;1;1;84990;Horno Microondas Digital TH-20S01 20Lts;ELECTRODOMESTICOS
17544196;;F;32;CHILENO;;Millenial;N/D;N/D;451940;6;3;6;3;451940;0;0;0;Aspiradora VCC4190V3E/XZS Arrastre 2000Watts;ELECTRODOMESTICOS
16922421;;F;34;CHILENO;;Millenial;LA FLORIDA                    ;METROPOLITANA;24990;1;1;0;0;0;1;1;24990;Hervidor Electrico TH-5407i 2Lts;ELECTRODOMESTICOS
18448347;;F;28;CHILENO;;Millenial;N/D;N/D;707960;4;3;3;2;689970;1;1;17990;Hervidor Family Kettle HE500;ELECTRODOMESTICOS
7186011;;M;68;CHILENO;;Boomers;NIQUEN                        ;BIO BIO;108980;2;1;0;0;0;2;1;108980;Batidora Pedestal TH910PN 4,6Lts 1300Watts;ELECTRODOMESTICOS
10320926;;F;57;CHILENO;;Boomers;TALCA                         ;MAULE;114980;2;1;0;0;0;2;1;114980;Horno Electrico UT-BACKOFEN48 48Lts;ELECTRODOMESTICOS
7642206;Casado;F;64;CHILENO;;Boomers;PROVIDENCIA                   ;METROPOLITANA;27990;1;1;0;0;0;1;1;27990;Picadora UT-PETRUS320 1Lts Vaso Vidrio;ELECTRODOMESTICOS
16078260;;F;37;CHILENO;;Millenial;SAN FELIPE                    ;VALPARAISO;21990;1;1;0;0;0;1;1;21990;HERVIDOR ELECTRICO UT-STARK18;ELECTRODOMESTICOS
14271519;;F;48;CHILENO;;X;N/D;N/D;9990;1;1;0;0;0;1;1;9990;Plancha a Vapor Oster 3803;ELECTRODOMESTICOS
11389141;;F;53;CHILENO;;X;QUILPUE                       ;VALPARAISO;14990;1;1;0;0;0;1;1;14990;Batidora Manual 3532;ELECTRODOMESTICOS
6315815;;F;69;CHILENO;;Silencioso;RENCA                         ;METROPOLITANA;79990;1;1;0;0;0;1;1;79990;Enceradora EA-5000;ELECTRODOMESTICOS
6039706;;F;70;CHILENO;;Silencioso;PUERTO MONTT                  ;LOS LAGOS;69970;3;1;0;0;0;3;1;69970;Horno Electrico TH-25N01 25Lts;ELECTRODOMESTICOS
14042377;;M;41;CHILENO;;X;QUEILEN                       ;LOS LAGOS;254550;4;3;0;0;0;4;3;254550;Batidora Vertical Minipimer UT-KLOT800SS;ELECTRODOMESTICOS
16296893;;F;36;CHILENO;;Millenial;LO ESPEJO                     ;METROPOLITANA;27990;1;1;0;0;0;1;1;27990;Hervidor Electrico Tetera TH-6505RT 1,7Lts Rojo;ELECTRODOMESTICOS
8103408;;F;61;CHILENO;;Boomers;SAN CARLOS                    ;BIO BIO;100980;2;2;0;0;0;2;2;100980;Plancha TH-7052 2000Watts Base Inox;ELECTRODOMESTICOS
24950104;;M;42;PERUANO;;Extranjero;RECOLETA                      ;METROPOLITANA;14990;1;1;0;0;0;1;1;14990;Hervidor Electrico HA-3300 2,5Lts Blanco;ELECTRODOMESTICOS
15573159;Soltero;F;38;CHILENO;;X;OVALLE;COQUIMBO;26990;1;1;0;0;0;1;1;26990;PICADORA 123 SILHQUETTE;ELECTRODOMESTICOS
13193724;Casado;M;45;CHILENO;;X;PROVIDENCIA                   ;METROPOLITANA;23990;1;1;0;0;0;1;1;23990;Hervidor Electrico TH-4515N 2Lts Negro;ELECTRODOMESTICOS
6935948;;F;76;CHILENO;;Silencioso;LA SERENA                     ;COQUIMBO;83980;2;1;0;0;0;2;1;83980;Horno electrico Black Oven 42lts;ELECTRODOMESTICOS
15880349;Soltero;F;37;CHILENO;TECNICO UNIVERSITARIO EN ENFERMERIA;Millenial;CANETE                        ;BIO BIO;74990;1;1;0;0;0;1;1;74990;ASPIRADORA SAMSUNG VC18M3110VB/ZS;ELECTRODOMESTICOS
5798826;;M;72;CHILENO;;Silencioso;MOSTAZAL                      ;L.G.B.OÂ´HIGGINS;719729;6;2;0;0;0;6;2;719729;HERVIDOR TETERA RELOJ 900R 2,5L ROJO;ELECTRODOMESTICOS
16468363;;F;35;CHILENO;;Millenial;ARICA                         ;ARICA Y PARINACOTA;31980;2;1;0;0;0;2;1;31980;Exprimidor de Jugo 407W 1Lts;ELECTRODOMESTICOS
12166121;;F;45;CHILENO;;X;N/D;N/D;78980;2;1;0;0;0;2;1;78980;Horno Microondas Mecanico Easy Wave 20Lts;ELECTRODOMESTICOS
16456605;;M;35;CHILENO;;Millenial;TALCA;MAULE;49990;1;1;0;0;0;1;1;49990;Parrilla Electrica Chef Grill;ELECTRODOMESTICOS
15449383;;F;39;CHILENO;;X;PROVIDENCIA                   ;METROPOLITANA;231960;4;3;0;0;0;4;3;231960;Hervidor Electrico Tetera TH-6505RT 1,7Lts Rojo;ELECTRODOMESTICOS
12726359;;M;47;CHILENO;;X;PROVIDENCIA                   ;METROPOLITANA;148140;5;2;0;0;0;5;2;148140;Licuadora L-5500IN 1,5Lts;ELECTRODOMESTICOS
11701983;;F;52;CHILENO;;X;RENCA                         ;METROPOLITANA;18990;1;1;0;0;0;1;1;18990;Plancha Easy Steam (PV4500);ELECTRODOMESTICOS
8868341;;M;60;CHILENO;;Boomers;MACUL                         ;METROPOLITANA;12990;1;1;0;0;0;1;1;12990;Hervidor Electrico HA-2650NG;ELECTRODOMESTICOS
10380461;;F;58;CHILENO;;Boomers;TOME                          ;BIO BIO;39990;1;1;0;0;0;1;1;39990;Horno Electrico UT-BACKOFEN26 26Lts;ELECTRODOMESTICOS
17560419;;M;31;CHILENO;;Millenial;PROVIDENCIA                   ;METROPOLITANA;17980;2;1;2;1;17980;0;0;0;PLANCHA A VAPOR 4070 SUELA CERAMICA 2500W;ELECTRODOMESTICOS
16968580;;F;34;CHILENO;;Millenial;PROVIDENCIA                   ;METROPOLITANA;134980;2;1;2;1;134980;0;0;0;CAFETERA PRIMA LATTE 6603 ROJA;ELECTRODOMESTICOS
7397416;;M;65;CHILENO;;Boomers;PAINE                         ;METROPOLITANA;224970;3;2;0;0;0;3;2;224970;Horno Electrico TH-38N 38Lts;ELECTRODOMESTICOS
11949545;;F;49;CHILENO;;X;LA PINTANA                    ;METROPOLITANA;45230;3;2;0;0;0;3;2;45230;Sandwichera TH-952 2 Panes Blanca;ELECTRODOMESTICOS
19773666;;M;24;CHILENO;;Z;N/D;N/D;33980;2;2;0;0;0;2;2;33980;Batidora Manual UT-TEKLA300;ELECTRODOMESTICOS
16168209;;F;37;CHILENO;;Millenial;MAULLIN;LOS LAGOS;89990;1;1;1;1;89990;0;0;0;FREIDORA DE AIRE THOMAS TH-AF60Mi;ELECTRODOMESTICOS
18806864;Soltero;F;26;CHILENO;;Z;PROVIDENCIA                   ;METROPOLITANA;28980;2;1;0;0;0;2;1;28980;Picadora UT-PETRUS320 1Lts Vaso Vidrio;ELECTRODOMESTICOS
16801785;Casado;F;33;CHILENO;FONOAUDIOLOGA;Millenial;QUILPUE                       ;VALPARAISO;54990;1;1;0;0;0;1;1;54990;Horno Microondas Digital UT-CLASSY720 20Lts;ELECTRODOMESTICOS
16669057;;M;34;CHILENO;;Millenial;N/D;N/D;135950;5;2;0;0;0;5;2;135950;Horno electrico Black Oven 42lts;ELECTRODOMESTICOS
10693965;Viudo;F;56;CHILENO;;Boomers;PROVIDENCIA                   ;METROPOLITANA;64980;2;2;0;0;0;2;2;64980;Licuadora Roja 550W 1,5Lts Vaso Vidrio;ELECTRODOMESTICOS
11785124;Casado;M;51;CHILENO;;X;PROVIDENCIA                   ;METROPOLITANA;88980;2;2;0;0;0;2;2;88980;Aspiradora TH1415 Arrastre 1500Watts;ELECTRODOMESTICOS
5086832;Casado;M;74;CHILENO;;Silencioso;RENCA                         ;METROPOLITANA;14990;1;1;0;0;0;1;1;14990;HERVIDOR TH-4340;ELECTRODOMESTICOS
12898378;;F;47;CHILENO;;X;PUENTE ALTO                   ;METROPOLITANA;229980;2;5;0;0;0;2;5;229980;Tostador de Pan TH-126 4 Rebanadas Negro;ELECTRODOMESTICOS
12362014;;F;49;CHILENO;;Extranjero;ANGOL                         ;ARAUCANIA;16990;1;1;0;0;0;1;1;16990;Hervidor Electrico UT-MANLY17 1,7Lts Negro;ELECTRODOMESTICOS
19868466;;M;23;CHILENO;;Silencioso;LEBU                          ;BIO BIO;119980;2;1;0;0;0;2;1;119980;Freidora de Aire 18M Oster;ELECTRODOMESTICOS
8300428;;M;65;CHILENO;;Boomers;LA FLORIDA                    ;METROPOLITANA;49990;1;1;0;0;0;1;1;49990;Aspiradora TH1407 Arrastre 1400Watts;ELECTRODOMESTICOS
11865949;;F;51;CHILENO;;X;PROVIDENCIA                   ;METROPOLITANA;21990;1;1;0;0;0;1;1;21990;Plancha TH-7052 2000Watts Base Inox;ELECTRODOMESTICOS
16373103;;F;36;CHILENO;;Millenial;RENCA                         ;METROPOLITANA;104980;2;1;0;0;0;2;1;104980;Aspiradora TH1415 Arrastre 1500Watts;ELECTRODOMESTICOS
16108072;Casado;F;36;CHILENO;;Millenial;PROVIDENCIA                   ;METROPOLITANA;13990;1;1;0;0;0;1;1;13990;Exprimidor Fauna 500 cc;ELECTRODOMESTICOS
16470659;Soltero;M;35;CHILENO;PSICOLOGO;Millenial;PELLUHUE                      ;MAULE;60480;2;1;2;1;60480;0;0;0;ASPIRADORA POLVO Y AGUA APA-1150 IN;ELECTRODOMESTICOS
9328889;;F;61;CHILENO;;Boomers;LOS ANDES                     ;VALPARAISO;32990;1;1;0;0;0;1;1;32990;Licuadora L-5500IN 1,5Lts;ELECTRODOMESTICOS
12726973;Casado;F;47;CHILENO;;X;RENCA                         ;METROPOLITANA;34990;1;1;0;0;0;1;1;34990;Plancha UT-SHANGRILA Inalambrica 2200Watss;ELECTRODOMESTICOS
16948678;;F;35;CHILENO;;Millenial;NUEVA IMPERIAL                ;ARAUCANIA;57970;3;3;0;0;0;3;3;57970;Horno Electrico TH-25N01 25Lts;ELECTRODOMESTICOS
15026987;;F;39;CHILENO;;X;CHANARAL                      ;ATACAMA;300210;5;2;0;0;0;5;2;300210;Horno Electrico TH62I 60Lts;ELECTRODOMESTICOS
7942414;;F;69;CHILENO;;Silencioso;PARRAL                        ;MAULE;21990;1;1;0;0;0;1;1;21990;Licuadora TH-320 Roja/Negro 1,5 Lts Vaso Vidrio;ELECTRODOMESTICOS
10375864;;M;55;CHILENO;;Boomers;GORBEA                        ;ARAUCANIA;30990;1;1;0;0;0;1;1;30990;Hervidor Electrico Tetera TH-6505RT 1,7Lts Rojo;ELECTRODOMESTICOS
11221638;Casado;M;54;CHILENO;;X;RENCA                         ;METROPOLITANA;21990;1;1;0;0;0;1;1;21990;Plancha TH-7052 2000Watts Base Inox;ELECTRODOMESTICOS
17644705;;F;31;CHILENO;;Millenial;N/D;N/D;84990;1;2;0;0;0;1;2;84990;Horno Microondas Digital TH-25DM 25Lts;ELECTRODOMESTICOS
11111022;;M;55;CHILENO;;Boomers;"";"";139980;2;2;0;0;0;2;2;139980;Horno Electrico TH62I 60Lts;ELECTRODOMESTICOS
15226053;;F;45;CHILENO;;X;CURICO                        ;MAULE;35980;2;2;0;0;0;2;2;35980;Hervidor Electrico TH-4212N 1,7Lts Negro;ELECTRODOMESTICOS
18760931;;M;27;CHILENO;;Millenial;PROVIDENCIA                   ;METROPOLITANA;34990;1;1;0;0;0;1;1;34990;Licuadora Roja 550W 1,5Lts Vaso Vidrio;ELECTRODOMESTICOS
19803955;;F;24;CHILENO;;Z;N/D;N/D;52980;2;1;0;0;0;2;1;52980;Aspiradora AP1700 Arrastre 1700Watts;ELECTRODOMESTICOS
4938966;;F;84;CHILENO;;Silencioso;NUEVA IMPERIAL                ;ARAUCANIA;18990;1;1;0;0;0;1;1;18990;Plancha Easy Steam (PV4500);ELECTRODOMESTICOS
18728117;;F;28;CHILENO;;Millenial;N/D;N/D;124980;2;1;2;1;124980;0;0;0;CAFETERA PRIMA LATTE 6603 ROJA;ELECTRODOMESTICOS
15100077;Soltero;F;40;CHILENO;CONTADOR AUDITOR;X;PROVIDENCIA                   ;METROPOLITANA;28990;1;1;1;1;28990;0;0;0;Licuadora Personal TH-300PB;ELECTRODOMESTICOS
15453338;;F;40;CHILENO;;X;TALAGANTE                     ;METROPOLITANA;44990;1;1;1;1;44990;0;0;0;Horno Microondas Mecanico Easy Wave 20Lts;ELECTRODOMESTICOS
12142969;;F;53;CHILENO;;Millenial;"";"";14990;1;1;0;0;0;1;1;14990;HERVIDOR TH-4340;ELECTRODOMESTICOS
18983178;Soltero;F;26;CHILENO;;Z;LINARES                       ;MAULE;42980;2;1;0;0;0;2;1;42980;HORNO ELECTRICO 16N01 16LTS NEGRO;ELECTRODOMESTICOS
16832638;;F;34;CHILENO;;Millenial;PROVIDENCIA                   ;METROPOLITANA;44990;1;1;0;0;0;1;1;44990;Horno Microondas Mecanico Easy Wave 20Lts;ELECTRODOMESTICOS
10328864;;F;57;CHILENO;;Boomers;RENCA                         ;METROPOLITANA;74990;1;1;0;0;0;1;1;74990;Horno Microondas Digital UT-CLASSY720 20Lts;ELECTRODOMESTICOS
19224375;;M;26;CHILENO;;Z;VICTORIA;ARAUCANIA;44990;1;1;1;1;44990;0;0;0;Batidora Vertical Minipimer UT-KLOT800SS;ELECTRODOMESTICOS
6206753;;M;72;CHILENO;;Silencioso;VALDIVIA                      ;LOS LAGOS;108970;3;2;0;0;0;3;2;108970;Horno Microondas Digital TH20DM 20Lts Espejado;ELECTRODOMESTICOS
6422342;;M;70;CHILENO;;Silencioso;MELIPILLA                     ;METROPOLITANA;419050;4;3;0;0;0;4;3;419050;Hervidor Electrico TH-4212N 1,7Lts Negro;ELECTRODOMESTICOS
12174523;;F;49;CHILENO;;X;PROVIDENCIA                   ;METROPOLITANA;49980;2;1;0;0;0;2;1;49980;Picadora TH-9020V Vaso Vidrio 2Lts;ELECTRODOMESTICOS
8533417;;F;68;CHILENO;;Silencioso;PROVIDENCIA                   ;METROPOLITANA;25990;1;1;0;0;0;1;1;25990;Plancha UT-KERAMIKTOP 2200Watts Base Ceramica;ELECTRODOMESTICOS
7055091;;F;64;CHILENO;;Boomers;VALDIVIA                      ;LOS RIOS;27990;1;1;0;0;0;1;1;27990;Plancha THOMAS TH-7170 2200Watts Base Ceramica;ELECTRODOMESTICOS
6089887;Viudo;F;73;CHILENO;;Silencioso;RENCA                         ;METROPOLITANA;39990;1;1;0;0;0;1;1;39990;Horno Electrico UT-BACKOFEN26 26Lts;ELECTRODOMESTICOS
26096847;;M;26;HAITIANO;;Extranjero;N/D;N/D;290970;3;2;3;2;290970;0;0;0;Extractor de Jugo TH-2540i;ELECTRODOMESTICOS
10160795;;F;58;CHILENO;;Boomers;ARAUCO                        ;BIO BIO;906980;8;4;2;1;198540;6;3;708440;Batidora Pedestal TH910PN 4,6Lts 1300Watts;ELECTRODOMESTICOS
17351347;;F;32;CHILENO;;Millenial;PROVIDENCIA                   ;METROPOLITANA;29990;1;1;0;0;0;1;1;29990;Picadora UT-PETRUS320 1Lts Vaso Vidrio;ELECTRODOMESTICOS
5595086;;F;76;CHILENO;;Silencioso;IQUIQUE                       ;TARAPACA;64990;1;1;0;0;0;1;1;64990;Horno Microondas Digital TH-20S01 20Lts;ELECTRODOMESTICOS
7635119;;M;67;CHILENO;;Boomers;ANTOFAGASTA                   ;ANTOFAGASTA;49990;1;1;0;0;0;1;1;49990;HERVIDOR TETERA RELOJ 900R 2,5L ROJO;ELECTRODOMESTICOS
5310674;;M;72;CHILENO;;Silencioso;PROVIDENCIA                   ;METROPOLITANA;12990;1;1;0;0;0;1;1;12990;Hervidor Electrico HE420 2lts Negro;ELECTRODOMESTICOS
9707599;;F;47;CHILENO;;X;VILLA ALEMANA;VALPARAISO;43980;2;1;0;0;0;2;1;43980;Parrilla Electrica TH-180;ELECTRODOMESTICOS
18737357;;F;28;CHILENO;;Millenial;ILLAPEL                       ;COQUIMBO;50980;2;1;0;0;0;2;1;50980;Licuadora TH-501V 1,5Lts Vaso Vidrio;ELECTRODOMESTICOS
18300092;Soltero;M;29;CHILENO;ADMINISTRADOR PUBLICO;Millenial;PROVIDENCIA                   ;METROPOLITANA;21980;2;1;2;1;21980;0;0;0;HERVIDOR 889B 2,5L Negro;ELECTRODOMESTICOS
19119426;;M;27;CHILENO;;Z;SAN PEDRO DE LA PAZ           ;BIO BIO;56980;2;2;0;0;0;2;2;56980;Horno Microondas Mecanico TH-18B05 18Lts;ELECTRODOMESTICOS
11696595;;F;54;CHILENO;;Boomers;MELIPILLA                     ;METROPOLITANA;29990;1;1;0;0;0;1;1;29990;Licuadora BL1500 Silver 1,75Lts Vaso Vidrio;ELECTRODOMESTICOS
10764212;;M;56;CHILENO;;Boomers;ILLAPEL                       ;COQUIMBO;695640;5;2;0;0;0;5;2;695640;PLANCHA A VAPOR 6953 BASE AEROCERAMICA AUTAPA.22;ELECTRODOMESTICOS
9310914;Casado;F;59;CHILENO;;Boomers;RENCA                         ;METROPOLITANA;21990;1;1;0;0;0;1;1;21990;Hervidor Electrico UT-DUNKEL17P 2Lts Negro;ELECTRODOMESTICOS
8495559;;M;53;CHILENO;;X;PROVIDENCIA                   ;METROPOLITANA;39990;1;1;0;0;0;1;1;39990;Horno Electrico TH-25N01 25Lts;ELECTRODOMESTICOS
19096753;;F;26;CHILENO;;Silencioso;PROVIDENCIA                   ;METROPOLITANA;28990;1;1;1;1;28990;0;0;0;Licuadora Personal TH-300PB;ELECTRODOMESTICOS
12029061;;F;50;CHILENO;;X;RENCA                         ;METROPOLITANA;26990;1;1;0;0;0;1;1;26990;Licuadora L2000VNG 1,5Lts Vaso Vidrio;ELECTRODOMESTICOS
10337239;;F;54;CHILENO;;Boomers;PADRE LAS CASAS               ;ARAUCANIA;84990;1;1;0;0;0;1;1;84990;Batidora Pedestal TH910PN 4,6Lts 1300Watts;ELECTRODOMESTICOS
13323785;;F;45;CHILENO;;X;PUERTO MONTT                  ;LOS LAGOS;83210;5;3;0;0;0;5;3;83210;Aspiradora TH1870 Arrastre 1800Watts Gris;ELECTRODOMESTICOS
17594397;;M;32;CHILENO;;Millenial;COIHAIQUE                     ;AYSEN;159990;1;1;0;0;0;1;1;159990;Maquina de Coser 311;ELECTRODOMESTICOS
13359968;;M;44;CHILENO;;X;IQUIQUE                       ;TARAPACA;34990;1;1;0;0;0;1;1;34990;Licuadora Kaliman Negra con Teclas;ELECTRODOMESTICOS
20015168;;F;23;CHILENO;;Z;VALLENAR;ATACAMA;158640;2;1;2;1;158640;0;0;0;HORNO ELECTRICO HE-850IN INOX SINDELEN;ELECTRODOMESTICOS
20010015;;F;23;CHILENO;;Z;PROVIDENCIA                   ;METROPOLITANA;119980;2;1;0;0;0;2;1;119980;ASPIRADORA VCC4580V3K/XZS SAMSUNG BLACK;ELECTRODOMESTICOS
9009893;;F;61;CHILENO;;Boomers;PROVIDENCIA                   ;METROPOLITANA;28990;1;1;0;0;0;1;1;28990;PICADORA 123 SILHQUETTE;ELECTRODOMESTICOS
15428263;;M;40;CHILENO;;X;LO ESPEJO;METROPOLITANA;108970;3;1;0;0;0;3;1;108970;Freidora de Aire 18M Oster;ELECTRODOMESTICOS
14339494;;F;45;CHILENO;;X;"";"";123960;4;2;1;1;24990;3;1;98970;Aspiradora TH1870 Arrastre 1800Watts Gris;ELECTRODOMESTICOS
17539332;;F;32;CHILENO;;Millenial;"";"";31990;1;1;0;0;0;1;1;31990;Licuadora Personal TH-300PB;ELECTRODOMESTICOS
7702782;;F;70;CHILENO;;Silencioso;RANCAGUA                      ;L.G.B.OÂ´HIGGINS;79970;3;1;0;0;0;3;1;79970;PROCESADOR THOMAS TH-9160;ELECTRODOMESTICOS
17581745;Soltero;F;32;CHILENO;;Millenial;PROVIDENCIA                   ;METROPOLITANA;38990;1;1;1;1;38990;0;0;0;Picadora TH-9020V Vaso Vidrio 2Lts;ELECTRODOMESTICOS
10581452;;F;50;CHILENO;;X;PROVIDENCIA                   ;METROPOLITANA;1303980;2;1;2;1;1303980;0;0;0;Maquina Bordadora MC550E;ELECTRODOMESTICOS
6821581;Casado;M;70;CHILENO;INGENIERO;Silencioso;RENCA                         ;METROPOLITANA;19990;1;1;0;0;0;1;1;19990;Licuadora L-1630V Negra 1,5Lts Vaso Vidrio;ELECTRODOMESTICOS
8755167;Divorciado;M;63;CHILENO;;Boomers;TOCOPILLA                     ;ANTOFAGASTA;39980;2;1;0;0;0;2;1;39980;Batidora Pedestal Bowl 300 Inox;ELECTRODOMESTICOS
12520174;Casado;M;49;CHILENO;;X;TALCA                         ;MAULE;94980;2;2;0;0;0;2;2;94980;Horno Microondas Mecanico Easy Wave 20Lts;ELECTRODOMESTICOS
11162551;;M;54;CHILENO;;Boomers;OVALLE                        ;COQUIMBO;19990;1;1;0;0;0;1;1;19990;Combo Hervidor + Batidora;ELECTRODOMESTICOS
25090285;;M;32;BOLIVIANO;;Extranjero;CALAMA                        ;ANTOFAGASTA;41980;2;1;0;0;0;2;1;41980;Licuadora Osterizer 4112/72 1,25Lts Vaso Vidrio;ELECTRODOMESTICOS
19200420;;F;31;CHILENO;;Millenial;OLMUE                         ;VALPARAISO;34990;1;1;0;0;0;1;1;34990;Batidora Vertical Minipimer UT-KLOT400P;ELECTRODOMESTICOS
5492329;;F;76;CHILENO;;Silencioso;TALAGANTE                     ;METROPOLITANA;288360;3;2;0;0;0;3;2;288360;Combo Juguera + Hervidor;ELECTRODOMESTICOS
20187218;;M;23;CHILENO;;Silencioso;PROVIDENCIA                   ;METROPOLITANA;29990;1;1;1;1;29990;0;0;0;Combo Juguera + Hervidor;ELECTRODOMESTICOS
4827769;;F;75;CHILENO;;Silencioso;RENCA                         ;METROPOLITANA;14990;1;1;0;0;0;1;1;14990;Hervidor Electrico UT-MANLY17 1,7Lts Negro;ELECTRODOMESTICOS
17497351;;M;31;CHILENO;;Millenial;PROVIDENCIA                   ;METROPOLITANA;29990;1;1;1;1;29990;0;0;0;Procesador TH-9010 Multimixer 1,5Lts Vaso Vidrio;ELECTRODOMESTICOS
7679523;;F;65;CHILENO;;Boomers;SAN PEDRO DE LA PAZ           ;BIO BIO;61960;4;3;0;0;0;4;3;61960;Licuadora L-1630V Negra 1,5Lts Vaso Vidrio;ELECTRODOMESTICOS
12599947;;F;48;CHILENO;;X;SAN FELIPE                    ;VALPARAISO;16990;1;1;0;0;0;1;1;16990;MULTIMIXER THOMAS TH- 8706;ELECTRODOMESTICOS
15697196;;M;38;CHILENO;;X;PARRAL                        ;MAULE;14990;1;1;0;0;0;1;1;14990;Batidora Manual 3532;ELECTRODOMESTICOS
8703380;;M;56;CHILENO;;Boomers;OSORNO                        ;LOS LAGOS;129990;1;1;0;0;0;1;1;129990;Horno Electrico TH-80i 80Lts;ELECTRODOMESTICOS
13168577;;M;45;CHILENO;;X;PROVIDENCIA                   ;METROPOLITANA;26990;1;1;0;0;0;1;1;26990;Cafetera TH-138i;ELECTRODOMESTICOS
15577800;;F;38;CHILENO;;X;COIHUECO                      ;BIO BIO;39980;2;1;0;0;0;2;1;39980;Licuadora Sport Blender BSE10;ELECTRODOMESTICOS
13716026;;F;42;CHILENO;;X;MAIPU                         ;METROPOLITANA;95950;4;1;4;1;95950;0;0;0;LICUADORA CROMADA CON TECLAS PLUS;ELECTRODOMESTICOS
6790992;;F;68;CHILENO;;Silencioso;RENCA                         ;METROPOLITANA;84980;2;2;0;0;0;2;2;84980;Horno electrico Black Oven 42lts;ELECTRODOMESTICOS
10540789;;M;55;CHILENO;;Boomers;PROVIDENCIA                   ;METROPOLITANA;12990;1;1;0;0;0;1;1;12990;Hervidor Electrico HA-2650NG;ELECTRODOMESTICOS
5123066;;F;79;CHILENO;;Silencioso;RENCA                         ;METROPOLITANA;14990;1;1;0;0;0;1;1;14990;Hervidor Electrico TH-4515N 2Lts Negro;ELECTRODOMESTICOS
8788729;;F;60;CHILENO;;Boomers;LOS ANGELES                   ;BIO BIO;26990;1;1;0;0;0;1;1;26990;Licuadora L2000VNG 1,5Lts Vaso Vidrio;ELECTRODOMESTICOS
19103433;;F;26;CHILENO;;Z;N/D;N/D;14990;1;1;1;1;14990;0;0;0;Combo Hervidor + Batidora;ELECTRODOMESTICOS
8739367;;M;61;CHILENO;;Boomers;PICHIDEGUA                    ;L.G.B.OÂ´HIGGINS;64980;2;1;0;0;0;2;1;64980;Licuadora TH-401V Roja 1,75Lts Vaso Vidrio;ELECTRODOMESTICOS
17180002;;M;33;CHILENO;;Millenial;SANTIAGO                      ;METROPOLITANA;161970;3;2;0;0;0;3;2;161970;Aspiradora TH1870 Arrastre 1800Watts Gris;ELECTRODOMESTICOS
19491634;;F;24;CHILENO;;Z;N/D;N/D;59990;1;1;0;0;0;1;1;59990;Aspiradora TH1870 Arrastre 1800Watts Gris;ELECTRODOMESTICOS
26258920;;M;48;EXTRANJERO - NO INFORMA NACIONALIDAD;;Extranjero;VICTORIA                      ;ARAUCANIA;138970;3;1;0;0;0;3;1;138970;Aspiradora Tambor APA1000 1000Watts;ELECTRODOMESTICOS
18921754;;F;26;CHILENO;;Z;PROVIDENCIA                   ;METROPOLITANA;24990;1;1;0;0;0;1;1;24990;Combo Licuadora + Batidora;ELECTRODOMESTICOS
11406471;;F;53;CHILENO;;X;CURANILAHUE                   ;BIO BIO;84372;3;2;0;0;0;3;2;84372;Licuadora L-1630V Negra 1,5Lts Vaso Vidrio;ELECTRODOMESTICOS
7753552;;M;65;CHILENO;;Boomers;RENCA                         ;METROPOLITANA;56970;3;1;0;0;0;3;1;56970;Licuadora L2000VNG 1,5Lts Vaso Vidrio;ELECTRODOMESTICOS
11684082;;M;52;CHILENO;;X;RENCA                         ;METROPOLITANA;95980;2;1;0;0;0;2;1;95980;Horno Electrico TH-25N01 25Lts;ELECTRODOMESTICOS
8440920;;M;65;CHILENO;;Boomers;VILLARICA                     ;ARAUCANIA;78681;2;2;0;0;0;2;2;78681;Licuadora TH-320 Roja/Negro 1,5 Lts Vaso Vidrio;ELECTRODOMESTICOS
8798308;Casado;M;59;CHILENO;;Boomers;PROVIDENCIA                   ;METROPOLITANA;34990;1;1;0;0;0;1;1;34990;Combo Hervidor + Tostador + Sandwichera;ELECTRODOMESTICOS
7562762;;F;72;CHILENO;;Silencioso;PROVIDENCIA                   ;METROPOLITANA;19990;1;1;0;0;0;1;1;19990;Hervidor Electrico TH-5407i 2Lts;ELECTRODOMESTICOS
11981916;;M;49;CHILENO;;X;SAN VICENTE                   ;L.G.B.OÂ´HIGGINS;12990;1;1;0;0;0;1;1;12990;Hervidor Electrico 3101 1,7Lts Negro;ELECTRODOMESTICOS
11888311;;F;50;CHILENO;;X;PROVIDENCIA                   ;METROPOLITANA;14990;1;1;0;0;0;1;1;14990;Hervidor Electrico UT-MANLY17 1,7Lts Negro;ELECTRODOMESTICOS
8179838;Divorciado;F;64;CHILENO;;Boomers;PROVIDENCIA                   ;METROPOLITANA;29990;1;1;0;0;0;1;1;29990;Licuadora L2000VNG 1,5Lts Vaso Vidrio;ELECTRODOMESTICOS
16368608;Soltero;F;35;CHILENO;;Silencioso;PROVIDENCIA                   ;METROPOLITANA;48980;2;1;2;1;48980;0;0;0;PROCESADOR THOMAS TH-9160;ELECTRODOMESTICOS
18182892;;F;30;CHILENO;;Millenial;CALAMA;ANTOFAGASTA;274630;3;2;2;1;189640;1;1;84990;Batidora Pedestal TH910PN 4,6Lts 1300Watts;ELECTRODOMESTICOS
14681072;;M;44;PERUANO;;Extranjero;N/D;N/D;49990;1;1;0;0;0;1;1;49990;Olla Arrocera Multiuso Oster 7129S;ELECTRODOMESTICOS
17507781;;M;31;CHILENO;;Millenial;PALMILLA                      ;L.G.B.OÂ´HIGGINS;129990;1;1;0;0;0;1;1;129990;Horno Electrico TH-80i 80Lts;ELECTRODOMESTICOS
9153503;;F;61;CHILENO;;Boomers;CERRILLOS                     ;METROPOLITANA;134970;3;3;0;0;0;3;3;134970;Horno Microondas Digital TH-20S01 20Lts;ELECTRODOMESTICOS
9266309;;F;57;CHILENO;;Boomers;CHIGUAYANTE                   ;BIO BIO;104980;2;1;0;0;0;2;1;104980;Horno Electrico TH-48N 48Lts;ELECTRODOMESTICOS
9100146;;M;62;CHILENO;;Boomers;RENCA                         ;METROPOLITANA;103980;2;1;2;1;103980;0;0;0;ASPIRADORA VC21K5130VB/ZS SAMSUNG BLUE;ELECTRODOMESTICOS
12861402;Casado;F;46;CHILENO;;X;RENCA                         ;METROPOLITANA;63980;2;1;2;1;63980;0;0;0;Horno Electrico TH-38N 38Lts;ELECTRODOMESTICOS
18560186;;F;28;CHILENO;;Millenial;PARRAL                        ;MAULE;39990;1;1;0;0;0;1;1;39990;Horno Electrico TH-25N01 25Lts;ELECTRODOMESTICOS
9018212;;M;59;CHILENO;;Boomers;ISLA DE MAIPO                 ;METROPOLITANA;172980;2;2;0;0;0;2;2;172980;Batidora Manual BA-5010 Inox;ELECTRODOMESTICOS
13528949;;F;43;CHILENO;;X;CALAMA                        ;ANTOFAGASTA;16990;1;1;0;0;0;1;1;16990;MULTIMIXER THOMAS TH- 8706;ELECTRODOMESTICOS
17521470;Soltero;F;31;CHILENO;PROFESOR;Millenial;PROVIDENCIA                   ;METROPOLITANA;124980;2;1;2;1;124980;0;0;0;CAFETERA PRIMA LATTE 6603 ROJA;ELECTRODOMESTICOS
9025123;;M;61;CHILENO;;Boomers;RENCA                         ;METROPOLITANA;69980;2;1;0;0;0;2;1;69980;Horno Microondas Mecanico Easy Wave 20Lts;ELECTRODOMESTICOS
9452628;Soltero;F;57;CHILENO;;Boomers;PAINE                         ;METROPOLITANA;415520;3;2;0;0;0;3;2;415520;Horno Microondas Mecanico M-2030 NG 20Lts;ELECTRODOMESTICOS
18559070;Soltero;F;29;CHILENO;;Millenial;PROVIDENCIA                   ;METROPOLITANA;54990;1;1;1;1;54990;0;0;0;ASPIRADORA THOMAS TH-1640;ELECTRODOMESTICOS
18967871;Soltero;F;26;CHILENO;;Z;PROVIDENCIA                   ;METROPOLITANA;69990;1;1;0;0;0;1;1;69990;Horno Microondas Digital TH-20S01 20Lts;ELECTRODOMESTICOS
7334291;;F;74;CHILENO;;Silencioso;CHILLAN                       ;BIO BIO;19990;1;1;0;0;0;1;1;19990;Hervidor Electrico UT-DUNKEL17P 2Lts Negro;ELECTRODOMESTICOS
26363394;;M;31;VENEZOLANO;;Extranjero;VALDIVIA                      ;LOS RIOS;29990;1;1;1;1;29990;0;0;0;LICUADORA CROMADA CON TECLAS PLUS;ELECTRODOMESTICOS
19581440;;F;25;CHILENO;;Z;PROVIDENCIA                   ;METROPOLITANA;144980;2;1;2;1;144980;0;0;0;Maquina de Coser 3008 Janome Blanco;ELECTRODOMESTICOS
10035543;;F;56;CHILENO;;Boomers;SAN JAVIER                    ;MAULE;69990;1;1;0;0;0;1;1;69990;Horno Electrico TH-48N 48Lts;ELECTRODOMESTICOS
16239000;;F;36;CHILENO;;Millenial;PROVIDENCIA                   ;METROPOLITANA;19990;1;1;0;0;0;1;1;19990;Hervidor Electrico TH-5407i 2Lts;ELECTRODOMESTICOS
11346663;;F;54;CHILENO;;X;LA SERENA                     ;COQUIMBO;25990;1;1;0;0;0;1;1;25990;Combo Licuadora + Batidora;ELECTRODOMESTICOS
16880219;;F;34;CHILENO;;Millenial;"";"";129980;2;2;0;0;0;2;2;129980;Batidora Pedestal UT-KLEIN700;ELECTRODOMESTICOS
19262673;;M;26;CHILENO;;Z;N/D;N/D;338130;8;2;8;2;338130;0;0;0;Horno Electrico TH-25N01 25Lts;ELECTRODOMESTICOS
7756072;;F;69;CHILENO;;Silencioso;RENCA                         ;METROPOLITANA;34990;1;1;0;0;0;1;1;34990;LICUADORA CROMADA CON TECLAS PLUS;ELECTRODOMESTICOS
7587564;;F;67;CHILENO;;Boomers;QUILLOTA                      ;VALPARAISO;26990;1;3;0;0;0;1;3;26990;Hervidor Electrico Tetera UT-LECKER18R 1,8Lts;ELECTRODOMESTICOS
18463989;;M;28;CHILENO;;Millenial;PROVIDENCIA                   ;METROPOLITANA;38980;2;1;2;1;38980;0;0;0;Aspiradora TH1407 Arrastre 1400Watts;ELECTRODOMESTICOS
9550450;Soltero;M;59;CHILENO;;Boomers;PROVIDENCIA                   ;METROPOLITANA;15990;1;1;0;0;0;1;1;15990;HERVIDOR TH-4340;ELECTRODOMESTICOS
15654988;;M;38;CHILENO;;Millenial;CURARREHUE                    ;ARAUCANIA;23992;1;1;0;0;0;1;1;23992;Licuadora Berry Blender Roja 1400 Vaso Vidrio;ELECTRODOMESTICOS
7140362;;F;67;CHILENO;;Boomers;LINARES                       ;MAULE;94990;1;1;0;0;0;1;1;94990;Horno Microondas Digital TH-25DM 25Lts;ELECTRODOMESTICOS
17167000;;F;33;CHILENO;;Millenial;"";"";44990;2;1;2;1;44990;0;0;0;Horno Microondas Mecanico C1700N 17Lts Blanco;ELECTRODOMESTICOS
17789667;;M;30;CHILENO;;Millenial;PROVIDENCIA                   ;METROPOLITANA;49990;1;1;0;0;0;1;1;49990;Aspiradora VCC4190V3E/XZS Arrastre 2000Watts;ELECTRODOMESTICOS
10256454;;M;57;CHILENO;;Boomers;ANTOFAGASTA                   ;ANTOFAGASTA;484970;3;2;0;0;0;3;2;484970;Horno Microondas Digital ME0113MB1/XZS 32Lts;ELECTRODOMESTICOS
16288747;Soltero;F;36;CHILENO;;Millenial;RENCA                         ;METROPOLITANA;9990;1;1;0;0;0;1;1;9990;Plancha a Vapor Oster 3803;ELECTRODOMESTICOS
24789930;;M;31;BOLIVIANO;;Extranjero;N/D;N/D;37670;2;1;0;0;0;2;1;37670;Hervidor Electrico Tetera HA-4100 4Lts Iox;ELECTRODOMESTICOS
13407356;Casado;F;44;CHILENO;;X;PROVIDENCIA                   ;METROPOLITANA;24990;1;1;0;0;0;1;1;24990;Licuadora Roja 550W 1,5Lts Vaso Vidrio;ELECTRODOMESTICOS
6831958;Casado;F;70;CHILENO;;Silencioso;RENCA                         ;METROPOLITANA;224980;2;1;2;1;224980;0;0;0;Horno Electrico TH-80i 80Lts;ELECTRODOMESTICOS
6848467;;F;69;CHILENO;;Silencioso;RANCAGUA                      ;L.G.B.OÂ´HIGGINS;579950;4;2;0;0;0;4;2;579950;Licuadora TH-401V Roja 1,75Lts Vaso Vidrio;ELECTRODOMESTICOS
16829986;;F;34;CHILENO;;Millenial;PROVIDENCIA                   ;METROPOLITANA;34990;1;1;0;0;0;1;1;34990;LICUADORA CROMADA CON TECLAS PLUS;ELECTRODOMESTICOS
18052335;;F;30;CHILENO;;Millenial;CALERA DE TANGO;METROPOLITANA;47990;1;1;0;0;0;1;1;47990;PROCESADOR THOMAS TH-9160;ELECTRODOMESTICOS
18333037;;M;29;CHILENO;;Millenial;NUEVA IMPERIAL                ;ARAUCANIA;242950;5;3;0;0;0;5;3;242950;Horno Microondas Mecanico Easy Wave 20Lts;ELECTRODOMESTICOS
16006747;;F;37;CHILENO;;Millenial;MAIPU                         ;METROPOLITANA;63980;2;1;2;1;63980;0;0;0;ASPIRADORA THOR POWER CYCLONIC;ELECTRODOMESTICOS
9628102;Casado;F;58;CHILENO;;Boomers;RENCA                         ;METROPOLITANA;71990;1;1;0;0;0;1;1;71990;Licuadora Reversible Roja;ELECTRODOMESTICOS
6601763;Casado;F;68;CHILENO;;Boomers;RECOLETA                      ;METROPOLITANA;64980;2;1;0;0;0;2;1;64980;Horno Electrico UT-LEIF36 36Lts;ELECTRODOMESTICOS
14265118;;M;50;CHILENO;;X;MOLINA                        ;MAULE;50480;2;1;2;1;50480;0;0;0;Licuadora L-25000NG;ELECTRODOMESTICOS
16189069;;F;36;CHILENO;;Millenial;LA SERENA                     ;COQUIMBO;22990;1;1;0;0;0;1;1;22990;PLANCHA VAPOR TH-7146;ELECTRODOMESTICOS
12336566;;F;49;CHILENO;;X;MARIQUINA                     ;LOS LAGOS;91240;4;1;0;0;0;4;1;91240;Horno Microondas Mecanico Easy Wave 20Lts;ELECTRODOMESTICOS
10316553;;F;56;CHILENO;;Boomers;SAN IGNACIO                   ;BIO BIO;17990;1;1;0;0;0;1;1;17990;Hervidor Electrico TH-4515N 2Lts Negro;ELECTRODOMESTICOS
18867889;;F;27;CHILENO;;Z;PROVIDENCIA                   ;METROPOLITANA;40980;2;1;0;0;0;2;1;40980;Licuadora L2000VNG 1,5Lts Vaso Vidrio;ELECTRODOMESTICOS
25885838;Soltero;F;39;VENEZOLANO;;Extranjero;PROVIDENCIA                   ;METROPOLITANA;28980;2;1;2;1;28980;0;0;0;Licuadora Roja 550W 1,5Lts Vaso Vidrio;ELECTRODOMESTICOS
13129047;;F;45;CHILENO;;X;N/D;N/D;17990;1;1;0;0;0;1;1;17990;Hervidor Electrico UT-KLAR20PW 2Lts Blanco;ELECTRODOMESTICOS
18803050;;F;33;CHILENO;;Millenial;LOS ANGELES                   ;BIO BIO;34990;1;1;0;0;0;1;1;34990;Aspiradora TH1407 Arrastre 1400Watts;ELECTRODOMESTICOS
10760126;;M;55;CHILENO;;Boomers;N/D;N/D;79990;1;1;0;0;0;1;1;79990;Batidora Pedestal TH910PN 4,6Lts 1300Watts;ELECTRODOMESTICOS
15669273;;F;38;CHILENO;;Millenial;SANTIAGO                      ;METROPOLITANA;28980;2;1;2;1;28980;0;0;0;HORNO 10 LITROS OSTER ROJO;ELECTRODOMESTICOS
16296856;;F;36;CHILENO;;Millenial;N/D;N/D;103980;2;1;2;1;103980;0;0;0;Horno Electrico TH62I 60Lts;ELECTRODOMESTICOS
15657296;;F;38;CHILENO;;Millenial;TEMUCO                        ;ARAUCANIA;24990;1;1;0;0;0;1;1;24990;Combo Juguera + Hervidor;ELECTRODOMESTICOS
6188364;;M;69;CHILENO;;Silencioso;PROVIDENCIA                   ;METROPOLITANA;14990;1;1;0;0;0;1;1;14990;HERVIDOR TH-4340;ELECTRODOMESTICOS
7210457;Soltero;M;64;CHILENO;;Boomers;PANGUIPULLI                   ;LOS RIOS;39990;1;1;0;0;0;1;1;39990;Horno Electrico TH-25N01 25Lts;ELECTRODOMESTICOS
19369497;;M;25;CHILENO;;Z;LOS ANGELES                   ;BIO BIO;64990;1;1;0;0;0;1;1;64990;Aspiradora TH1870 Arrastre 1800Watts Gris;ELECTRODOMESTICOS
8312946;;M;64;CHILENO;;Boomers;PALMILLA                      ;L.G.B.OÂ´HIGGINS;79980;2;1;0;0;0;2;1;79980;Freidora de Aire 18M Oster;ELECTRODOMESTICOS
18628701;;F;28;CHILENO;;Millenial;PROVIDENCIA                   ;METROPOLITANA;19990;1;1;0;0;0;1;1;19990;Batidora Manual UT-TEKLA300;ELECTRODOMESTICOS
6881021;;M;71;CHILENO;;Silencioso;RENCA                         ;METROPOLITANA;54990;1;1;0;0;0;1;1;54990;Parrilla Electrica TH-224;ELECTRODOMESTICOS
12563759;;M;47;CHILENO;;X;ANGOL                         ;ARAUCANIA;94990;1;1;0;0;0;1;1;94990;Horno Microondas Digital TH-25DM 25Lts;ELECTRODOMESTICOS
16697541;;M;34;CHILENO;;Millenial;LA PINTANA;METROPOLITANA;24990;1;1;0;0;0;1;1;24990;Tostador de Pan TH-126 4 Rebanadas Negro;ELECTRODOMESTICOS
13912526;;F;42;CHILENO;;X;EL BOSQUE                     ;METROPOLITANA;29990;1;1;0;0;0;1;1;29990;Licuadora L-5500IN 1,5Lts;ELECTRODOMESTICOS
9401663;;F;60;CHILENO;;Boomers;ESTACION CENTRAL              ;METROPOLITANA;17493;1;1;0;0;0;1;1;17493;Combo Juguera + Hervidor;ELECTRODOMESTICOS
14663939;;F;35;CHILENO;;Extranjero;RECOLETA                      ;METROPOLITANA;169990;1;1;0;0;0;1;1;169990;Horno Electrico TH-100i 100Lts;ELECTRODOMESTICOS
16058302;;F;37;CHILENO;;Millenial;LOS VILOS                     ;COQUIMBO;31240;2;1;0;0;0;2;1;31240;PICADORA 123 SILHQUETTE;ELECTRODOMESTICOS
12816483;;F;47;CHILENO;;X;LA LIGUA                      ;VALPARAISO;28990;1;1;0;0;0;1;1;28990;Hervidor Electrico Tetera UT-LECKER18R 1,8Lts;ELECTRODOMESTICOS
10841320;;M;40;CHILENO;;X;PROVIDENCIA                   ;METROPOLITANA;69990;1;1;1;1;69990;0;0;0;Horno Electrico TH-48N 48Lts;ELECTRODOMESTICOS
15505454;;F;39;CHILENO;;X;PROVIDENCIA                   ;METROPOLITANA;145940;6;2;5;1;130950;1;1;14990;Horno Microondas Mecanico Fancy 20Lts;ELECTRODOMESTICOS
18788146;;M;27;CHILENO;;Z;SAN FERNANDO                  ;L.G.B.OÂ´HIGGINS;44990;1;1;0;0;0;1;1;44990;Aspiradora TH1415 Arrastre 1500Watts;ELECTRODOMESTICOS
20004296;;F;23;CHILENO;;Z;ESTACION CENTRAL              ;METROPOLITANA;19990;1;1;0;0;0;1;1;19990;Hervidor Electrico TH-5407i 2Lts;ELECTRODOMESTICOS
8839241;;F;62;CHILENO;;Boomers;RENCA                         ;METROPOLITANA;20990;1;1;0;0;0;1;1;20990;Batidora Manual 3532;ELECTRODOMESTICOS
8235375;;M;64;CHILENO;;Boomers;MULCHEN                       ;BIO BIO;93170;2;1;0;0;0;2;1;93170;Horno Electrico TH62I 60Lts;ELECTRODOMESTICOS
17623256;;M;33;CHILENO;;Millenial;ANTOFAGASTA;ANTOFAGASTA;49990;1;1;1;1;49990;0;0;0;ASPIRADORA ROBOT WIFI FIDDLER HOME BLANCA;ELECTRODOMESTICOS
26104518;;M;37;EXTRANJERO - NO INFORMA NACIONALIDAD;;Extranjero;N/D;N/D;64990;1;1;0;0;0;1;1;64990;Aspiradora TH1870 Arrastre 1800Watts Gris;ELECTRODOMESTICOS
26577497;;M;40;VENEZOLANO;;Extranjero;RECOLETA                      ;METROPOLITANA;19990;1;1;0;0;0;1;1;19990;Batidora Manual UT-TEKLA300;ELECTRODOMESTICOS
9468215;;F;56;CHILENO;;Boomers;SAN FERNANDO                  ;L.G.B.OÂ´HIGGINS;9990;1;1;0;0;0;1;1;9990;Exprimidor Fauna 500 cc;ELECTRODOMESTICOS
19576372;;M;24;CHILENO;;Z;N/D;N/D;124980;2;2;0;0;0;2;2;124980;Horno Electrico TH-80i 80Lts;ELECTRODOMESTICOS
8129387;;F;64;CHILENO;;Boomers;EL BOSQUE                     ;METROPOLITANA;47990;1;1;0;0;0;1;1;47990;PROCESADOR THOMAS TH-9160;ELECTRODOMESTICOS
8644211;;F;65;CHILENO;;Silencioso;PROVIDENCIA                   ;METROPOLITANA;29990;1;1;0;0;0;1;1;29990;Licuadora Kaliman Negra con Teclas;ELECTRODOMESTICOS
15999168;;F;36;CHILENO;;Millenial;TIRUA                         ;BIO BIO;74980;2;2;0;0;0;2;2;74980;Hervidor Electrico TH-4515N 2Lts Negro;ELECTRODOMESTICOS
16412407;;F;35;CHILENO;;Millenial;SAN RAMON                     ;METROPOLITANA;98160;3;1;0;0;0;3;1;98160;Aspiradora TH1870 Arrastre 1800Watts Gris;ELECTRODOMESTICOS
11355506;;F;54;CHILENO;;X;TEMUCO                        ;ARAUCANIA;69990;1;1;0;0;0;1;1;69990;Aspiradora UT-SILENT1804 Arrastre 1800Watts;ELECTRODOMESTICOS
4166426;;M;78;CHILENO;;Silencioso;QUILICURA                     ;METROPOLITANA;16990;1;1;0;0;0;1;1;16990;Hervidor Electrico UT-MANLY17 1,7Lts Negro;ELECTRODOMESTICOS
16625552;;F;34;CHILENO;;Millenial;MAIPU                         ;METROPOLITANA;48980;2;1;2;1;48980;0;0;0;Horno Microondas Mecanico Easy Wave 20Lts;ELECTRODOMESTICOS
19244321;;M;26;CHILENO;;Silencioso;PROVIDENCIA                   ;METROPOLITANA;28980;2;1;2;1;28980;0;0;0;Licuadora Roja 550W 1,5Lts Vaso Vidrio;ELECTRODOMESTICOS
11695745;;M;50;CHILENO;;X;RENCA                         ;METROPOLITANA;100970;3;3;0;0;0;3;3;100970;Horno Electrico TH-48N 48Lts;ELECTRODOMESTICOS
16680587;;F;35;CHILENO;;Millenial;SAN BERNARDO                  ;METROPOLITANA;94990;1;1;0;0;0;1;1;94990;Horno Electrico UT-BACKOFEN48 48Lts;ELECTRODOMESTICOS
19983594;;F;23;CHILENO;;Z;PROVIDENCIA                   ;METROPOLITANA;16990;1;1;0;0;0;1;1;16990;Cafetera TH-130;ELECTRODOMESTICOS
16407347;Soltero;M;36;CHILENO;;Millenial;PROVIDENCIA                   ;METROPOLITANA;24990;1;1;0;0;0;1;1;24990;Licuadora L2000VNG 1,5Lts Vaso Vidrio;ELECTRODOMESTICOS
16722920;;M;34;CHILENO;;Millenial;N/D;N/D;189980;2;2;1;1;59990;1;1;129990;Horno electrico Black Oven 42lts;ELECTRODOMESTICOS
15763251;;M;38;CHILENO;;Millenial;PROVIDENCIA                   ;METROPOLITANA;53980;2;1;2;1;53980;0;0;0;Cafetera P65 Silver;ELECTRODOMESTICOS
5237213;;F;72;CHILENO;;Silencioso;RENCA                         ;METROPOLITANA;14990;1;1;0;0;0;1;1;14990;Tostador de Pan TH-116 2 Rebanadas Negro;ELECTRODOMESTICOS
7474142;;F;67;CHILENO;;Boomers;QUILICURA                     ;METROPOLITANA;36990;1;1;0;0;0;1;1;36990;HORNO ELECTRICO 16N01 16LTS NEGRO;ELECTRODOMESTICOS
7446866;;F;69;CHILENO;;Silencioso;SAN PEDRO                     ;METROPOLITANA;9793;1;1;0;0;0;1;1;9793;Batidora Vertical Stick Mixer 2609;ELECTRODOMESTICOS
12355937;;F;49;CHILENO;;X;RENCA                         ;METROPOLITANA;89990;1;1;0;0;0;1;1;89990;Horno Electrico UT-BACKOFEN38 38Lts;ELECTRODOMESTICOS
10793801;;F;59;CHILENO;;Boomers;PROVIDENCIA                   ;METROPOLITANA;69990;1;1;0;0;0;1;1;69990;Aspiradora TH1870 Arrastre 1800Watts Gris;ELECTRODOMESTICOS
7391320;;F;62;CHILENO;;Boomers;CHILLAN                       ;BIO BIO;14990;1;1;0;0;0;1;1;14990;Tostador de Pan TH-116 2 Rebanadas Negro;ELECTRODOMESTICOS
7309972;;M;67;CHILENO;;Boomers;PROVIDENCIA                   ;METROPOLITANA;19990;1;1;0;0;0;1;1;19990;Hervidor Electrico TH-5407i 2Lts;ELECTRODOMESTICOS
10708389;;F;54;CHILENO;;X;RENCA                         ;METROPOLITANA;9990;1;1;0;0;0;1;1;9990;Plancha a Vapor Oster 3803;ELECTRODOMESTICOS
15114915;;M;40;CHILENO;;Silencioso;PROVIDENCIA                   ;METROPOLITANA;12990;1;1;0;0;0;1;1;12990;Hervidor Electrico 3101 1,7Lts Negro;ELECTRODOMESTICOS
9273063;;F;56;CHILENO;;Boomers;LA SERENA                     ;COQUIMBO;25990;1;1;0;0;0;1;1;25990;Combo Licuadora + Batidora;ELECTRODOMESTICOS
6958795;;M;64;CHILENO;;Boomers;MELIPILLA                     ;METROPOLITANA;42960;4;2;0;0;0;4;2;42960;BATIDORA INMERSION S MIX 2616;ELECTRODOMESTICOS
6545097;Casado;F;71;CHILENO;;Silencioso;PROVIDENCIA                   ;METROPOLITANA;22240;2;1;0;0;0;2;1;22240;Licuadora L-1630V Negra 1,5Lts Vaso Vidrio;ELECTRODOMESTICOS
13839053;;M;41;CHILENO;;X;PROVIDENCIA                   ;METROPOLITANA;26992;1;2;0;0;0;1;2;26992;Licuadora TH-320 Roja/Negro 1,5 Lts Vaso Vidrio;ELECTRODOMESTICOS
18181691;Soltero;F;29;CHILENO;;Millenial;PROVIDENCIA                   ;METROPOLITANA;41980;2;1;2;1;41980;0;0;0;ASPIRADORA THOMAS TH-1640;ELECTRODOMESTICOS
18871223;;M;27;CHILENO;;Silencioso;PROVIDENCIA                   ;METROPOLITANA;29990;1;1;1;1;29990;0;0;0;Horno Electrico TH-25N01 25Lts;ELECTRODOMESTICOS
12473563;;M;49;CHILENO;;X;ESTACION CENTRAL              ;METROPOLITANA;52980;2;1;0;0;0;2;1;52980;Hervidor Electrico Tetera TH-6505RT 1,7Lts Rojo;ELECTRODOMESTICOS
9127706;Soltero;M;68;CHILENO;;Silencioso;RENCA                         ;METROPOLITANA;14990;1;1;0;0;0;1;1;14990;Hervidor Family Kettle HE500;ELECTRODOMESTICOS
5973063;;M;74;CHILENO;;Silencioso;BUIN                          ;METROPOLITANA;517070;5;3;0;0;0;5;3;517070;PROCESADOR DE ALIMENTOS UT-PROCESSOR750;ELECTRODOMESTICOS
15288711;;F;38;CHILENO;;X;ANCUD                         ;LOS LAGOS;78160;3;1;0;0;0;3;1;78160;Freidora de Aire 18M Oster;ELECTRODOMESTICOS
12763820;;F;47;CHILENO;;X;PENCO                         ;BIO BIO;41980;2;2;0;0;0;2;2;41980;Plancha THOMAS TH-7170 2200Watts Base Ceramica;ELECTRODOMESTICOS
7118648;;F;58;CHILENO;;Boomers;PUNTA ARENAS                  ;MAGALLANES;41980;2;1;0;0;0;2;1;41980;BATIDORA MANUAL 260R;ELECTRODOMESTICOS
10858786;;F;55;CHILENO;;Boomers;RENCA                         ;METROPOLITANA;83170;2;1;0;0;0;2;1;83170;Enceradora EA-5000;ELECTRODOMESTICOS
17151346;;F;33;CHILENO;;Silencioso;PROVIDENCIA                   ;METROPOLITANA;53980;2;1;2;1;53980;0;0;0;Cafetera P65 Silver;ELECTRODOMESTICOS
8768623;;F;61;CHILENO;;Boomers;RENCA                         ;METROPOLITANA;49990;1;1;0;0;0;1;1;49990;ASPIRADORA THOMAS TH-1640;ELECTRODOMESTICOS
13227558;;F;44;CHILENO;;X;SANTIAGO                      ;METROPOLITANA;19990;1;1;0;0;0;1;1;19990;Hervidor Electrico TH-5407i 2Lts;ELECTRODOMESTICOS
11255526;;F;54;CHILENO;;X;PAINE                         ;METROPOLITANA;45980;2;1;0;0;0;2;1;45980;Hervidor Electrico Tetera TH-6505RT 1,7Lts Rojo;ELECTRODOMESTICOS
14634507;;M;41;CHILENO;;X;RENCA                         ;METROPOLITANA;16990;1;1;1;1;16990;0;0;0;Combo Hervidor + Batidora;ELECTRODOMESTICOS
10127742;;F;56;CHILENO;;Boomers;CALAMA                        ;ANTOFAGASTA;22990;1;1;0;0;0;1;1;22990;PLANCHA VAPOR TH-7146;ELECTRODOMESTICOS
17663916;;F;31;CHILENO;;Millenial;PROVIDENCIA                   ;METROPOLITANA;38980;2;1;2;1;38980;0;0;0;LICUADORA THOMAS TH-700VR;ELECTRODOMESTICOS
7063434;;M;66;CHILENO;;Boomers;VILLA ALEMANA                 ;VALPARAISO;26990;1;1;0;0;0;1;1;26990;Hervidor Electrico Tetera UT-LECKER18R 1,8Lts;ELECTRODOMESTICOS
7882310;;F;68;CHILENO;;Boomers;VALLENAR;ATACAMA;22990;1;1;0;0;0;1;1;22990;PLANCHA VAPOR TH-7146;ELECTRODOMESTICOS
15015354;;M;51;CHILENO;;X;CALAMA                        ;ANTOFAGASTA;94990;1;1;0;0;0;1;1;94990;Horno Microondas Digital L UT-25KROMM 25Lts;ELECTRODOMESTICOS
19040948;;F;27;CHILENO;;Z;N/D;N/D;17980;2;1;0;0;0;2;1;17980;Exprimidor de Jugo CJ-2000 1Lts;ELECTRODOMESTICOS
17503250;Soltero;M;32;CHILENO;;Millenial;PROVIDENCIA                   ;METROPOLITANA;18990;1;1;0;0;0;1;1;18990;Plancha UT-DUNST 2200Watts Base Ceramica;ELECTRODOMESTICOS
12295544;;F;52;CHILENO;;X;TALCA                         ;MAULE;26990;1;1;0;0;0;1;1;26990;Licuadora L2000VNG 1,5Lts Vaso Vidrio;ELECTRODOMESTICOS
6690746;;F;71;CHILENO;;Silencioso;MAIPU                         ;METROPOLITANA;179990;1;1;0;0;0;1;1;179990;Horno Electrico TH-100i 100Lts;ELECTRODOMESTICOS
15576245;;F;39;CHILENO;;X;N/D;N/D;72960;3;1;3;1;72960;0;0;0;Horno Microondas Mecanico Fancy 20Lts;ELECTRODOMESTICOS
18487230;;F;29;CHILENO;;Millenial;PROVIDENCIA                   ;METROPOLITANA;21990;1;1;0;0;0;1;1;21990;HERVIDOR ELECTRICO UT-STARK18;ELECTRODOMESTICOS
9139470;;F;58;CHILENO;;Boomers;SAN CARLOS                    ;BIO BIO;18570;2;1;0;0;0;2;1;18570;Exprimidor Fauna 500 cc;ELECTRODOMESTICOS
13920916;;F;41;CHILENO;;X;PUENTE ALTO                   ;METROPOLITANA;347960;3;1;3;1;347960;0;0;0;Robot aspirador Roomba 675;ELECTRODOMESTICOS
13110919;;M;50;CHILENO;;X;TRAIGUEN                      ;ARAUCANIA;254360;3;1;0;0;0;3;1;254360;Maquina de coser computarizada SH7700;ELECTRODOMESTICOS
17410272;Soltero;M;32;CHILENO;;Millenial;PROVIDENCIA                   ;METROPOLITANA;85480;2;1;2;1;85480;0;0;0;FREIDORA DE AIRE THOMAS TH-AF60Mi;ELECTRODOMESTICOS
15577391;;M;38;CHILENO;;Millenial;ARICA                         ;ARICA Y PARINACOTA;109990;1;1;0;0;0;1;1;109990;Horno Electrico TH62I 60Lts;ELECTRODOMESTICOS
14483415;;F;48;CHILENO;;X;LIMACHE                       ;VALPARAISO;129979;2;1;0;0;0;2;1;129979;Horno Microondas Digital TH-25DM 25Lts;ELECTRODOMESTICOS
5720595;Casado;M;75;CHILENO;;Silencioso;RENCA                         ;METROPOLITANA;12990;1;1;0;0;0;1;1;12990;Hervidor Electrico TH-4212N 1,7Lts Negro;ELECTRODOMESTICOS
12588845;;M;48;CHILENO;;X;PROVIDENCIA                   ;METROPOLITANA;16990;1;1;0;0;0;1;1;16990;MULTIMIXER THOMAS TH- 8706;ELECTRODOMESTICOS
10782360;;F;55;CHILENO;;Boomers;LA FLORIDA                    ;METROPOLITANA;83980;2;1;2;1;83980;0;0;0;Batidora Pedestal UT-KLEIN700;ELECTRODOMESTICOS
13387083;;M;44;CHILENO;;X;N/D;N/D;105260;3;1;0;0;0;3;1;105260;Aspiradora TH1870 Arrastre 1800Watts Gris;ELECTRODOMESTICOS
19065724;Soltero;F;27;CHILENO;ENFERMERA;Silencioso;PROVIDENCIA                   ;METROPOLITANA;48980;2;1;2;1;48980;0;0;0;PLANCHA VERTICAL V-1600VBL;ELECTRODOMESTICOS
7379833;;F;75;CHILENO;;Silencioso;EL MONTE                      ;METROPOLITANA;77980;2;2;0;0;0;2;2;77980;Picadora UT-PETRUS320 1Lts Vaso Vidrio;ELECTRODOMESTICOS
10311386;;M;51;CHILENO;;X;N/D;N/D;89990;1;1;0;0;0;1;1;89990;Horno Electrico UT-BACKOFEN38 38Lts;ELECTRODOMESTICOS
15552382;;F;38;CHILENO;;Millenial;N/D;N/D;76980;2;1;0;0;0;2;1;76980;Freidora de Aire 18M Oster;ELECTRODOMESTICOS
7948129;;F;63;CHILENO;;Boomers;TOCOPILLA                     ;ANTOFAGASTA;19990;1;1;0;0;0;1;1;19990;Hervidor Electrico TH-5407i 2Lts;ELECTRODOMESTICOS
7595807;;F;71;CHILENO;;Silencioso;LAJA                          ;BIO BIO;49990;1;1;0;0;0;1;1;49990;Horno Microondas Mecanico UT-SYDNEY18 18Lts;ELECTRODOMESTICOS
13612471;;F;44;CHILENO;;X;SAN RAFAEL                    ;MAULE;15000;2;1;0;0;0;2;1;15000;Hervidor Electrico UT-MANLY17 1,7Lts Negro;ELECTRODOMESTICOS
20024505;;F;23;CHILENO;;Z;PROVIDENCIA                   ;METROPOLITANA;9990;1;1;1;1;9990;0;0;0;Exprimidor de Jugo CJ-2000 1Lts;ELECTRODOMESTICOS
25940317;;M;33;VENEZOLANO;;Extranjero;SANTIAGO                      ;METROPOLITANA;49990;1;1;0;0;0;1;1;49990;Horno Microondas Digital TH-20S01 20Lts;ELECTRODOMESTICOS
15714986;;F;37;CHILENO;;Millenial;OSORNO                        ;LOS LAGOS;83540;2;1;2;1;83540;0;0;0;FREIDORA DE AIRE THOMAS TH-AF60Mi;ELECTRODOMESTICOS
25866268;;M;32;COLOMBIANO;;Extranjero;N/D;N/D;15990;1;1;0;0;0;1;1;15990;ARROCERA ROJA 4723;ELECTRODOMESTICOS
15881221;;F;37;CHILENO;;Millenial;NUEVA IMPERIAL                ;ARAUCANIA;27990;1;1;0;0;0;1;1;27990;Combo Juguera + Hervidor;ELECTRODOMESTICOS
16178127;;M;36;CHILENO;;Millenial;NUEVA IMPERIAL                ;ARAUCANIA;39992;1;1;0;0;0;1;1;39992;Aspiradora TH1415 Arrastre 1500Watts;ELECTRODOMESTICOS
9302206;;F;60;CHILENO;;Boomers;RAUCO                         ;MAULE;79990;1;1;0;0;0;1;1;79990;Horno Electrico TH62I 60Lts;ELECTRODOMESTICOS
17367788;;F;33;CHILENO;;Millenial;ARICA                         ;ARICA Y PARINACOTA;16990;1;1;0;0;0;1;1;16990;Plancha a vapor 6052 Oster;ELECTRODOMESTICOS
10576079;;M;56;CHILENO;;Boomers;PROVIDENCIA                   ;METROPOLITANA;44990;1;1;0;0;0;1;1;44990;Licuadora L-25000NG;ELECTRODOMESTICOS
27082279;;F;39;EXTRANJERO - NO INFORMA NACIONALIDAD;;Extranjero;N/D;N/D;111860;3;2;2;1;63980;1;1;47880;Aspiradora TH1870 Arrastre 1800Watts Gris;ELECTRODOMESTICOS
12500815;;F;49;CHILENO;;X;RENCA                         ;METROPOLITANA;133980;2;1;2;1;133980;0;0;0;Maquina de Coser JS-2135CL Calipso;ELECTRODOMESTICOS
6426738;;F;71;CHILENO;;Silencioso;MELIPILLA                     ;METROPOLITANA;22990;1;1;0;0;0;1;1;22990;PLANCHA VAPOR TH-7146;ELECTRODOMESTICOS
19146596;;F;26;CHILENO;;Z;CASTRO                        ;LOS LAGOS;16990;1;1;0;0;0;1;1;16990;Plancha a vapor 6052 Oster;ELECTRODOMESTICOS
8653786;;M;62;CHILENO;;Boomers;VALLENAR;ATACAMA;30990;1;1;0;0;0;1;1;30990;Plancha THOMAS TH-7170 2200Watts Base Ceramica;ELECTRODOMESTICOS
26593814;;M;38;VENEZOLANO;;Extranjero;N/D;N/D;49980;2;1;0;0;0;2;1;49980;LICUADORA CROMADA CON TECLAS PLUS;ELECTRODOMESTICOS
13521577;;M;44;CHILENO;;X;PROVIDENCIA                   ;METROPOLITANA;195480;2;1;2;1;195480;0;0;0;Robot aspirador Roomba 675;ELECTRODOMESTICOS
20219129;;M;23;CHILENO;;Millenial;"";"";40840;2;1;2;1;40840;0;0;0;Combo Hervidor + Tostador + Sandwichera;ELECTRODOMESTICOS
6692073;;F;68;CHILENO;;Boomers;"";"";108270;2;1;0;0;0;2;1;108270;Batidora Pedestal TH910PN 4,6Lts 1300Watts;ELECTRODOMESTICOS
5966248;;M;73;CHILENO;;Silencioso;N/D;N/D;129990;1;1;1;1;129990;0;0;0;Horno Electrico TH-80i 80Lts;ELECTRODOMESTICOS
18349867;;F;29;CHILENO;;Millenial;MOLINA                        ;MAULE;80480;2;1;2;1;80480;0;0;0;FREIDORA DE AIRE THOMAS TH-AF60Mi;ELECTRODOMESTICOS
26656175;;M;44;VENEZOLANO;;Extranjero;RANCAGUA                      ;L.G.B.OÂ´HIGGINS;5000;0;2;0;0;0;0;2;5000;Hervidor Electrico UT-REIN17SS;ELECTRODOMESTICOS
25248700;;M;40;BOLIVIANO;;Extranjero;ANTOFAGASTA                   ;ANTOFAGASTA;57560;3;1;0;0;0;3;1;57560;LICUADORA CROMADA CON TECLAS PLUS;ELECTRODOMESTICOS
9993821;;F;59;CHILENO;;Boomers;EL BOSQUE                     ;METROPOLITANA;39980;2;1;0;0;0;2;1;39980;Licuadora L-5500IN 1,5Lts;ELECTRODOMESTICOS
7614397;;F;64;CHILENO;;Boomers;PROVIDENCIA                   ;METROPOLITANA;109990;1;1;0;0;0;1;1;109990;Horno Electrico TH62I 60Lts;ELECTRODOMESTICOS
11146624;;M;54;CHILENO;;Boomers;TALCA                         ;MAULE;127040;4;1;0;0;0;4;1;127040;ASPIRADORA THOMAS TH-1640;ELECTRODOMESTICOS
17624076;;M;32;CHILENO;;Millenial;PROVIDENCIA                   ;METROPOLITANA;30240;2;1;0;0;0;2;1;30240;Licuadora UT-METALLEK505P 1,5Lts Vaso Vidrio;ELECTRODOMESTICOS
7417876;;F;64;CHILENO;;Boomers;RENGO                         ;L.G.B.OÂ´HIGGINS;16990;1;1;0;0;0;1;1;16990;Hervidor Electrico HA-3300 2,5Lts Blanco;ELECTRODOMESTICOS
5347820;;M;77;CHILENO;;Silencioso;MELIPILLA                     ;METROPOLITANA;16990;1;1;0;0;0;1;1;16990;Batidora Manual 3532;ELECTRODOMESTICOS
9941856;;M;53;CHILENO;;X;ARICA                         ;TARAPACA;23990;1;1;0;0;0;1;1;23990;Olla Arrocera OA-400NG 1,8Lts;ELECTRODOMESTICOS
8076494;;M;63;CHILENO;;Boomers;VALPARAISO                    ;VALPARAISO;148260;3;1;0;0;0;3;1;148260;Horno Electrico TH62I 60Lts;ELECTRODOMESTICOS
9175559;;F;59;CHILENO;;Boomers;RENCA                         ;METROPOLITANA;237470;2;1;0;0;0;2;1;237470;Maquina de Coser BM-3850CL Lila;ELECTRODOMESTICOS
18732689;;F;27;CHILENO;;Silencioso;PROVIDENCIA                   ;METROPOLITANA;73980;2;1;2;1;73980;0;0;0;Horno Microondas Digital MS23K3513AK/ZS 23Lts;ELECTRODOMESTICOS
11441963;Casado;F;53;CHILENO;;X;RENCA                         ;METROPOLITANA;36980;2;1;0;0;0;2;1;36980;Hervidor Electrico TH-5407i 2Lts;ELECTRODOMESTICOS
5894287;;F;75;CHILENO;;Silencioso;HUECHURABA                    ;METROPOLITANA;21990;1;1;0;0;0;1;1;21990;Licuadora L-1630V Negra 1,5Lts Vaso Vidrio;ELECTRODOMESTICOS
7724390;;F;67;CHILENO;;Boomers;ARAUCO                        ;BIO BIO;108270;2;1;0;0;0;2;1;108270;Horno Microondas Digital TH20DM 20Lts Espejado;ELECTRODOMESTICOS
17036286;;F;33;CHILENO;;Millenial;PROVIDENCIA                   ;METROPOLITANA;201960;4;1;0;0;0;4;1;201960;Horno Electrico UT-BACKOFEN38 38Lts;ELECTRODOMESTICOS
16530894;;F;33;CHILENO;;Millenial;PROVIDENCIA                   ;METROPOLITANA;74980;2;2;0;0;0;2;2;74980;Batidora Pedestal Bowl 300 Inox;ELECTRODOMESTICOS
16075343;;F;36;CHILENO;;Millenial;N/D;N/D;34990;1;1;0;0;0;1;1;34990;Licuadora TH-401V Roja 1,75Lts Vaso Vidrio;ELECTRODOMESTICOS
18517550;;M;29;CHILENO;;Millenial;PROVIDENCIA                   ;METROPOLITANA;109990;1;1;0;0;0;1;1;109990;Horno Electrico TH62I 60Lts;ELECTRODOMESTICOS
12402550;;M;48;CHILENO;;X;LA CRUZ                       ;VALPARAISO;59990;1;1;0;0;0;1;1;59990;Horno Microondas Mecanico Fancy 20Lts;ELECTRODOMESTICOS
6339649;Divorciado;F;71;CHILENO;;Silencioso;PROVIDENCIA                   ;METROPOLITANA;33990;1;1;0;0;0;1;1;33990;Extractor de Jugo EX800 1,4Lts;ELECTRODOMESTICOS
11160026;;M;55;CHILENO;;Boomers;RENCA                         ;METROPOLITANA;24990;1;1;0;0;0;1;1;24990;Licuadora TH-320 Roja/Negro 1,5 Lts Vaso Vidrio;ELECTRODOMESTICOS
17801914;;F;31;CHILENO;;Millenial;TEMUCO                        ;ARAUCANIA;17990;1;1;0;0;0;1;1;17990;Hervidor Electrico TH-4515N 2Lts Negro;ELECTRODOMESTICOS
8144334;;F;70;CHILENO;;Silencioso;PUNTA ARENAS                  ;MAGALLANES;48673;2;1;0;0;0;2;1;48673;Aspiradora TH1415 Arrastre 1500Watts;ELECTRODOMESTICOS
16542414;Soltero;F;35;CHILENO;;Millenial;PROVIDENCIA                   ;METROPOLITANA;21990;1;1;0;0;0;1;1;21990;Licuadora L-1630V Negra 1,5Lts Vaso Vidrio;ELECTRODOMESTICOS
11333266;;F;54;CHILENO;;X;CALAMA                        ;ANTOFAGASTA;34990;1;1;0;0;0;1;1;34990;Plancha UT-SHANGRILA Inalambrica 2200Watss;ELECTRODOMESTICOS
7968535;;M;63;CHILENO;;Boomers;RENCA                         ;METROPOLITANA;179990;1;1;0;0;0;1;1;179990;Horno Electrico TH-100i 100Lts;ELECTRODOMESTICOS
8745714;;F;62;CHILENO;;Boomers;CALAMA                        ;ANTOFAGASTA;29990;1;3;0;0;0;1;3;29990;Hervidor Electrico Tetera HA-4100 4Lts Iox;ELECTRODOMESTICOS
4783261;;F;81;CHILENO;;Silencioso;COLINA                        ;METROPOLITANA;223440;4;1;0;0;0;4;1;223440;Maquina de Coser Remington J011;ELECTRODOMESTICOS
14305350;;F;47;CHILENO;;X;SANTA MARIA                   ;VALPARAISO;22990;1;1;0;0;0;1;1;22990;PLANCHA VAPOR TH-7146;ELECTRODOMESTICOS
13975965;;F;41;CHILENO;;X;PROVIDENCIA                   ;METROPOLITANA;12990;1;1;0;0;0;1;1;12990;Hervidor Acero Inoxidable 40989-CL Hamilton Beac;ELECTRODOMESTICOS
12184241;;F;50;CHILENO;;X;CONSTITUCION                  ;MAULE;59992;1;1;0;0;0;1;1;59992;Aspiradora UT-SILENT1804 Arrastre 1800Watts;ELECTRODOMESTICOS
7991802;Casado;F;63;CHILENO;;Boomers;RENCA                         ;METROPOLITANA;27990;1;1;0;0;0;1;1;27990;Plancha THOMAS TH-7170 2200Watts Base Ceramica;ELECTRODOMESTICOS
7667467;;F;65;CHILENO;;Boomers;ARICA                         ;ARICA Y PARINACOTA;27990;1;1;0;0;0;1;1;27990;Combo Juguera + Hervidor;ELECTRODOMESTICOS
6686687;;M;70;CHILENO;;Silencioso;RENCA                         ;METROPOLITANA;139990;1;1;0;0;0;1;1;139990;Horno Electrico TH-80i 80Lts;ELECTRODOMESTICOS
13224053;;M;45;CHILENO;;X;LA SERENA                     ;COQUIMBO;36990;1;1;0;0;0;1;1;36990;Aspiradora AP1700 Arrastre 1700Watts;ELECTRODOMESTICOS
5996575;;M;72;CHILENO;;Silencioso;HUECHURABA                    ;METROPOLITANA;14990;1;1;0;0;0;1;1;14990;HERVIDOR TH-4340;ELECTRODOMESTICOS
10553174;;M;55;CHILENO;;Boomers;N/D;N/D;31992;1;1;0;0;0;1;1;31992;Picadora TH-9020V Vaso Vidrio 2Lts;ELECTRODOMESTICOS
26147744;;M;47;VENEZOLANO;;Extranjero;N/D;N/D;145840;2;1;2;1;145840;0;0;0;SUPER FREIDORA DE AIRE OV3;ELECTRODOMESTICOS
7433948;;F;66;CHILENO;;Boomers;LA SERENA                     ;COQUIMBO;13990;1;1;0;0;0;1;1;13990;Hervidor Electrico HA-2650NG;ELECTRODOMESTICOS
4690051;;F;82;CHILENO;;Silencioso;TALCA                         ;MAULE;16990;1;1;0;0;0;1;1;16990;Batidora Manual TH-8830;ELECTRODOMESTICOS
14214352;;F;41;CHILENO;;X;PROVIDENCIA                   ;METROPOLITANA;24990;1;1;0;0;0;1;1;24990;Parrilla Electrica TH-180;ELECTRODOMESTICOS
8889899;;F;61;CHILENO;;Boomers;SAN PEDRO DE LA PAZ;BIO-BIO;52990;1;1;0;0;0;1;1;52990;Horno Microondas Mecanico Easy Wave 20Lts;ELECTRODOMESTICOS
15923514;;M;38;CHILENO;;Millenial;CANELA                        ;COQUIMBO;31990;1;1;0;0;0;1;1;31990;Licuadora Roja 550W 1,5Lts Vaso Vidrio;ELECTRODOMESTICOS
13124674;Soltero;M;46;CHILENO;;X;RENCA                         ;METROPOLITANA;11990;1;1;0;0;0;1;1;11990;Exprimidor de Jugo CJ-2000 1Lts;ELECTRODOMESTICOS
13516028;;M;44;CHILENO;;X;PADRE LAS CASAS               ;ARAUCANIA;19990;1;1;0;0;0;1;1;19990;Hervidor Electrico UT-DUNKEL17P 2Lts Negro;ELECTRODOMESTICOS
23967375;;M;39;PERUANO;;Extranjero;N/D;N/D;39990;1;1;0;0;0;1;1;39990;LICUADORA CROMADA CON TECLAS PLUS;ELECTRODOMESTICOS
16867677;;F;34;CHILENO;;Millenial;LAS CABRAS                    ;L.G.B.OÂ´HIGGINS;74990;1;1;0;0;0;1;1;74990;Horno Electrico TH-48N 48Lts;ELECTRODOMESTICOS
8502592;;F;58;CHILENO;;Boomers;N/D;N/D;49990;1;1;0;0;0;1;1;49990;Aspiradora TH1415 Arrastre 1500Watts;ELECTRODOMESTICOS
12332600;;M;49;CHILENO;;X;RENCA                         ;METROPOLITANA;64990;1;1;0;0;0;1;1;64990;Aspiradora TH1870 Arrastre 1800Watts Gris;ELECTRODOMESTICOS
15506099;;F;39;CHILENO;;X;N/D;N/D;254970;3;2;0;0;0;3;2;254970;Horno Electrico TH62I 60Lts;ELECTRODOMESTICOS
18286520;;M;29;CHILENO;;Millenial;N/D;N/D;18893;1;1;0;0;0;1;1;18893;Licuadora L2000VNG 1,5Lts Vaso Vidrio;ELECTRODOMESTICOS
19666239;;M;25;CHILENO;;Z;COQUIMBO                      ;COQUIMBO;49990;1;1;0;0;0;1;1;49990;Horno Microondas Mecanico Fancy 20Lts;ELECTRODOMESTICOS
11769734;;F;51;CHILENO;;X;PROVIDENCIA                   ;METROPOLITANA;15990;1;1;0;0;0;1;1;15990;HERVIDOR TH-4340;ELECTRODOMESTICOS
16151630;;F;38;CHILENO;;Millenial;N/D;N/D;17990;1;1;0;0;0;1;1;17990;Cafetera TH-130;ELECTRODOMESTICOS
19072670;;F;26;CHILENO;;Z;PROVIDENCIA                   ;METROPOLITANA;33980;2;1;0;0;0;2;1;33980;Cafetera TH-130;ELECTRODOMESTICOS
15734556;;M;38;CHILENO;;X;N/D;N/D;143980;2;1;2;1;143980;0;0;0;SUPER FREIDORA DE AIRE OV3;ELECTRODOMESTICOS
9932119;;F;76;CHILENO;;Silencioso;LUMACO                        ;ARAUCANIA;21990;1;1;0;0;0;1;1;21990;Plancha TH-7052 2000Watts Base Inox;ELECTRODOMESTICOS
11110208;;M;55;CHILENO;;Boomers;NANCAGUA                      ;L.G.B.OÂ´HIGGINS;29990;1;1;0;0;0;1;1;29990;PLANCHA A VAPOR 6953 BASE AEROCERAMICA AUTAPA.22;ELECTRODOMESTICOS
10989523;;F;42;CHILENO;;X;RANCAGUA                      ;L.G.B.OÂ´HIGGINS;12990;1;1;0;0;0;1;1;12990;Exprimidor de Jugo CJ-2000 1Lts;ELECTRODOMESTICOS
27068874;;F;39;VENEZOLANO;;Extranjero;N/D;N/D;13990;2;1;0;0;0;2;1;13990;Hervidor Electrico HA-2650NG;ELECTRODOMESTICOS
16023828;;F;37;CHILENO;;Millenial;RENCA                         ;METROPOLITANA;14990;1;1;0;0;0;1;1;14990;Exprimidor de Jugo 407W 1Lts;ELECTRODOMESTICOS
13240087;;M;44;CHILENO;;Silencioso;N/D;N/D;169990;1;1;0;0;0;1;1;169990;Horno Electrico TH-100i 100Lts;ELECTRODOMESTICOS
16998265;Soltero;F;33;CHILENO;CIRUJANO DENTISTA;Silencioso;PROVIDENCIA                   ;METROPOLITANA;64990;1;1;0;0;0;1;1;64990;Horno Microondas Digital TH-20S01 20Lts;ELECTRODOMESTICOS
15371556;;F;39;CHILENO;;X;VILLARICA                     ;ARAUCANIA;129980;2;1;0;0;0;2;1;129980;Horno Microondas Digital TH-20S01 20Lts;ELECTRODOMESTICOS
8190957;;F;64;CHILENO;;Boomers;RENCA                         ;METROPOLITANA;19990;1;1;0;0;0;1;1;19990;Hervidor Family Kettle HE500;ELECTRODOMESTICOS
11423624;;F;52;CHILENO;;X;RENCA                         ;METROPOLITANA;129960;3;1;3;1;129960;0;0;0;H. Microondas Fancy (2000rd);ELECTRODOMESTICOS
6263686;;F;69;CHILENO;;Silencioso;RENCA                         ;METROPOLITANA;40990;1;1;0;0;0;1;1;40990;Aspiradora AP1700 Arrastre 1700Watts;ELECTRODOMESTICOS
8175597;;F;69;CHILENO;;Silencioso;MAIPU                         ;METROPOLITANA;29990;1;1;0;0;0;1;1;29990;PICADORA 123 SILHQUETTE;ELECTRODOMESTICOS
12493048;;F;49;CHILENO;;X;N/D;N/D;34990;1;1;0;0;0;1;1;34990;Plancha UT-SHANGRILA Inalambrica 2200Watss;ELECTRODOMESTICOS
10864886;;F;55;CHILENO;;Boomers;EL BOSQUE                     ;METROPOLITANA;203980;2;1;2;1;203980;0;0;0;Maquina de coser computarizada SH7700;ELECTRODOMESTICOS
18212806;;F;30;CHILENO;;Millenial;MELIPILLA                     ;METROPOLITANA;428960;4;2;0;0;0;4;2;428960;Exprimidor de Jugo 407W 1Lts;ELECTRODOMESTICOS
25281878;;F;45;BOLIVIANO;;Extranjero;N/D;N/D;21990;1;1;0;0;0;1;1;21990;Licuadora L-1630V Negra 1,5Lts Vaso Vidrio;ELECTRODOMESTICOS
12780995;;F;46;CHILENO;;X;SAN FERNANDO                  ;L.G.B.OÂ´HIGGINS;12990;1;1;0;0;0;1;1;12990;Hervidor Electrico TH-4212N 1,7Lts Negro;ELECTRODOMESTICOS
11498714;Casado;F;53;CHILENO;;X;TRAIGUEN                      ;ARAUCANIA;19000;2;1;0;0;0;2;1;19000;Hervidor Electrico HE420 2lts Negro;ELECTRODOMESTICOS
18616619;;F;28;CHILENO;;Millenial;PALMILLA                      ;L.G.B.OÂ´HIGGINS;169990;1;1;0;0;0;1;1;169990;Horno Electrico TH-100i 100Lts;ELECTRODOMESTICOS
23503615;;M;36;PERUANO;;Extranjero;RECOLETA                      ;METROPOLITANA;0;0;0;0;0;0;0;0;0;Plancha a Vapor Oster 3803;ELECTRODOMESTICOS
20005228;;F;23;CHILENO;;Z;PROVIDENCIA                   ;METROPOLITANA;0;0;0;0;0;0;0;0;0;Aspiradora AP1700 Arrastre 1700Watts;ELECTRODOMESTICOS
11802046;;F;52;CHILENO;;X;RENCA                         ;METROPOLITANA;0;0;0;0;0;0;0;0;0;ASPIRADORA THOMAS TH-1640;ELECTRODOMESTICOS
5840108;;M;73;CHILENO;;Silencioso;ARICA                         ;ARICA Y PARINACOTA;0;0;0;0;0;0;0;0;0;Horno Microondas Digital TH-20S01 20Lts;ELECTRODOMESTICOS
7695700;;M;63;CHILENO;;Boomers;PROVIDENCIA                   ;METROPOLITANA;0;0;0;0;0;0;0;0;0;Hervidor Electrico UT-DUNKEL17P 2Lts Negro;ELECTRODOMESTICOS
4698648;;F;79;CHILENO;;Silencioso;CASTRO                        ;LOS LAGOS;0;0;0;0;0;0;0;0;0;Aspiradora Trapeadora Robot Ut-Excellenza (B);ELECTRODOMESTICOS
16159495;;F;37;CHILENO;;Millenial;TALAGANTE                     ;METROPOLITANA;0;0;0;0;0;0;0;0;0;Exprimidor de Jugo 407W 1Lts;ELECTRODOMESTICOS
18155275;;M;30;CHILENO;;Millenial;N/D;N/D;0;0;0;0;0;0;0;0;0;Exprimidor de Jugo 407W 1Lts;ELECTRODOMESTICOS
12340395;;M;49;CHILENO;;X;N/D;N/D;0;0;0;0;0;0;0;0;0;Aspiradora AP1700 Arrastre 1700Watts;ELECTRODOMESTICOS
20111295;;F;23;CHILENO;;Millenial;PROVIDENCIA                   ;METROPOLITANA;0;0;0;0;0;0;0;0;0;Hervidor Acero Inoxidable 40989-CL Hamilton Beac;ELECTRODOMESTICOS
15136371;;M;39;CHILENO;;X;TALCA                         ;MAULE;0;0;0;0;0;0;0;0;0;Plancha UT-SHANGRILA Inalambrica 2200Watss;ELECTRODOMESTICOS
13999752;;M;40;CHILENO;;X;VILLA ALEMANA                 ;VALPARAISO;0;0;0;0;0;0;0;0;0;Licuadora Personal TH-300PB;ELECTRODOMESTICOS
10177558;;M;48;CHILENO;;X;TIERRA AMARILLA               ;ATACAMA;0;0;0;0;0;0;0;0;0;Horno Electrico TH-25N01 25Lts;ELECTRODOMESTICOS
12663158;;F;48;CHILENO;;X;PROVIDENCIA                   ;METROPOLITANA;0;0;0;0;0;0;0;0;0;Aspiradora UT-SILENT1603 Arrastre 1600Watts;ELECTRODOMESTICOS
8892549;;F;55;CHILENO;;Boomers;PROVIDENCIA                   ;METROPOLITANA;0;0;0;0;0;0;0;0;0;Licuadora Kaliman Negra con Teclas;ELECTRODOMESTICOS
11609657;;F;51;CHILENO;;X;N/D;N/D;0;0;0;0;0;0;0;0;0;Batidora Manual 3532;ELECTRODOMESTICOS
9522689;;F;59;CHILENO;;Boomers;ANCUD                         ;LOS LAGOS;0;0;0;0;0;0;0;0;0;BATIDORA MANUAL 260R;ELECTRODOMESTICOS
19293296;Soltero;F;26;CHILENO;;Z;PROVIDENCIA                   ;METROPOLITANA;0;0;0;0;0;0;0;0;0;Exprimidor de Jugo 407W 1Lts;ELECTRODOMESTICOS
15307353;;F;38;CHILENO;;Millenial;NATALES                       ;MAGALLANES;0;0;0;0;0;0;0;0;0;LICUADORA CROMADA CON TECLAS PLUS;ELECTRODOMESTICOS
14371478;;F;51;CHILENO;;X;TOCOPILLA                     ;ANTOFAGASTA;0;0;0;0;0;0;0;0;0;Batidora Pedestal TH910PN 4,6Lts 1300Watts;ELECTRODOMESTICOS
25690297;;F;28;NO INFORMA NACIONALIDAD;;Extranjero;PROVIDENCIA                   ;METROPOLITANA;0;0;0;0;0;0;0;0;0;Freidora de Aire Digital 40D;ELECTRODOMESTICOS
9181010;;M;60;CHILENO;;Boomers;CHANCO                        ;MAULE;0;0;0;0;0;0;0;0;0;Horno Microondas Mecanico Easy Wave 20Lts;ELECTRODOMESTICOS
14297478;;F;47;CHILENO;;X;LEBU                          ;BIO BIO;0;0;0;0;0;0;0;0;0;Plancha THOMAS TH-7170 2200Watts Base Ceramica;ELECTRODOMESTICOS
8765119;;F;61;CHILENO;;Boomers;RENCA                         ;METROPOLITANA;0;0;0;0;0;0;0;0;0;Plancha THOMAS TH-7170 2200Watts Base Ceramica;ELECTRODOMESTICOS
6762788;;F;68;CHILENO;;Boomers;VALDIVIA                      ;LOS LAGOS;0;0;0;0;0;0;0;0;0;Horno Microondas Mecanico TH-18B05 18Lts;ELECTRODOMESTICOS
13958983;;F;42;CHILENO;;X;SAN PEDRO DE LA PAZ           ;BIO BIO;0;0;0;0;0;0;0;0;0;Hervidor Electrico Tetera TH-6505RT 1,7Lts Rojo;ELECTRODOMESTICOS
10449500;;F;58;CHILENO;;Boomers;PROVIDENCIA                   ;METROPOLITANA;0;0;0;0;0;0;0;0;0;Exprimidor Fauna 500 cc;ELECTRODOMESTICOS
11391949;;F;53;CHILENO;;X;PUENTE ALTO                   ;METROPOLITANA;0;0;0;0;0;0;0;0;0;SUPER FREIDORA DE AIRE OV3;ELECTRODOMESTICOS
9682142;;M;60;CHILENO;;Boomers;PROVIDENCIA                   ;METROPOLITANA;0;0;0;0;0;0;0;0;0;Horno Electrico TH-100i 100Lts;ELECTRODOMESTICOS
8809204;;F;63;CHILENO;;Boomers;COPIAPO                       ;ATACAMA;0;0;0;0;0;0;0;0;0;Batidora Pedestal TH910PN 4,6Lts 1300Watts;ELECTRODOMESTICOS
17453669;;M;32;CHILENO;;Millenial;ARAUCO                        ;BIO BIO;0;0;0;0;0;0;0;0;0;Licuadora TH-320 Roja/Negro 1,5 Lts Vaso Vidrio;ELECTRODOMESTICOS
8671287;;F;62;CHILENO;;Boomers;CALERA                        ;VALPARAISO;0;0;0;0;0;0;0;0;0;Horno Microondas Digital MS23K3513AK/ZS 23Lts;ELECTRODOMESTICOS
7333412;Casado;M;68;CHILENO;AGRONOMO;Silencioso;PROVIDENCIA                   ;METROPOLITANA;0;0;0;0;0;0;0;0;0;HORNO ELECTRICO 16N01 16LTS NEGRO;ELECTRODOMESTICOS
11945912;;M;50;CHILENO;;X;PROVIDENCIA                   ;METROPOLITANA;0;0;0;0;0;0;0;0;0;Aspiradora TH1407 Arrastre 1400Watts;ELECTRODOMESTICOS
8608357;;F;61;CHILENO;;Boomers;PROVIDENCIA                   ;METROPOLITANA;0;0;0;0;0;0;0;0;0;Hervidor Electrico TH-5407i 2Lts;ELECTRODOMESTICOS
4984543;;M;75;CHILENO;;Silencioso;RENCA                         ;METROPOLITANA;0;0;0;0;0;0;0;0;0;Plancha UT-PLATTEISEN 2000Watts Base Ceramica;ELECTRODOMESTICOS
16076946;;F;37;CHILENO;;Millenial;RENCA                         ;METROPOLITANA;0;0;0;0;0;0;0;0;0;PLANCHA A VAPOR 6953 BASE AEROCERAMICA AUTAPA.22;ELECTRODOMESTICOS
16980450;;F;33;CHILENO;;Millenial;PROVIDENCIA                   ;METROPOLITANA;0;0;0;0;0;0;0;0;0;Licuadora Kaliman Negra con Teclas;ELECTRODOMESTICOS
14220621;;F;41;CHILENO;;X;N/D;N/D;0;0;0;0;0;0;0;0;0;Hervidor Electrico TH-5407i 2Lts;ELECTRODOMESTICOS
13605715;;F;43;CHILENO;;X;RENCA                         ;METROPOLITANA;0;0;0;0;0;0;0;0;0;Licuadora TH-320 Roja/Negro 1,5 Lts Vaso Vidrio;ELECTRODOMESTICOS
15210571;;F;40;CHILENO;;Silencioso;PROVIDENCIA                   ;METROPOLITANA;0;0;0;0;0;0;0;0;0;Tostador de Pan TH-126 4 Rebanadas Negro;ELECTRODOMESTICOS
13645733;Casado;M;42;CHILENO;;X;RENCA                         ;METROPOLITANA;0;0;0;0;0;0;0;0;0;Plancha UT-KERAMIK1 2200Watts Base Ceramica;ELECTRODOMESTICOS
13348892;Soltero;M;44;CHILENO;;X;PROVIDENCIA                   ;METROPOLITANA;0;0;0;0;0;0;0;0;0;Hervidor Electrico Tetera TH-6505RT 1,7Lts Rojo;ELECTRODOMESTICOS
10178456;;F;56;CHILENO;;Boomers;CALAMA                        ;ANTOFAGASTA;0;0;0;0;0;0;0;0;0;Plancha UT-DUNST 2200Watts Base Ceramica;ELECTRODOMESTICOS
13991754;;M;41;CHILENO;;X;N/D;N/D;0;0;0;0;0;0;0;0;0;Horno Microondas Digital MMP-20GC3D 20Lts;ELECTRODOMESTICOS
15135482;;F;39;CHILENO;;X;TALCA                         ;MAULE;0;0;0;0;0;0;0;0;0;Horno Microondas Digital MS23K3513AK/ZS 23Lts;ELECTRODOMESTICOS
9842036;;M;57;CHILENO;;Boomers;PROVIDENCIA                   ;METROPOLITANA;0;0;0;0;0;0;0;0;0;Hervidor Family Kettle HE500;ELECTRODOMESTICOS
16721145;;F;35;CHILENO;;Millenial;N/D;N/D;0;0;0;0;0;0;0;0;0;Plancha UT-KERAMIK1 2200Watts Base Ceramica;ELECTRODOMESTICOS
15527528;;F;36;CHILENO;;Millenial;SAN FERNANDO                  ;L.G.B.OÂ´HIGGINS;0;0;0;0;0;0;0;0;0;Hervidor Electrico Tetera HA-4100 4Lts Iox;ELECTRODOMESTICOS
19802332;;M;24;CHILENO;;Silencioso;PROVIDENCIA                   ;METROPOLITANA;0;0;0;0;0;0;0;0;0;Horno Electrico TH62I 60Lts;ELECTRODOMESTICOS
8191471;Casado;F;65;CHILENO;;Boomers;RENCA                         ;METROPOLITANA;0;0;0;0;0;0;0;0;0;Hervidor Electrico 3101 1,7Lts Negro;ELECTRODOMESTICOS
12224526;;F;49;CHILENO;;X;VINA DEL MAR                  ;VALPARAISO;0;0;0;0;0;0;0;0;0;Plancha Paninis 2880;ELECTRODOMESTICOS
12420747;;F;52;CHILENO;;X;N/D;N/D;0;0;0;0;0;0;0;0;0;Hervidor Electrico TH-5407i 2Lts;ELECTRODOMESTICOS
17972487;;F;30;CHILENO;;Millenial;SAN FELIPE                    ;VALPARAISO;0;0;0;0;0;0;0;0;0;Horno Microondas Digital MMP-20GC3D 20Lts;ELECTRODOMESTICOS
19300876;;F;26;CHILENO;;Z;PROVIDENCIA                   ;METROPOLITANA;0;0;0;0;0;0;0;0;0;Parrilla Electrica TH-180;ELECTRODOMESTICOS
19448009;;M;26;CHILENO;;Z;N/D;N/D;0;0;0;0;0;0;0;0;0;Hervidor Electrico HA-2650NG;ELECTRODOMESTICOS
12950497;;F;45;CHILENO;;X;PROVIDENCIA                   ;METROPOLITANA;0;0;0;0;0;0;0;0;0;Maquina de Coser 311;ELECTRODOMESTICOS
19971709;;F;24;CHILENO;;Silencioso;PROVIDENCIA                   ;METROPOLITANA;0;0;0;0;0;0;0;0;0;Hervidor Electrico UT-MANLY17 1,7Lts Negro;ELECTRODOMESTICOS
8955533;Casado;F;62;CHILENO;;Boomers;LA GRANJA                     ;METROPOLITANA;0;0;0;0;0;0;0;0;0;Batidora Manual BA-5010 Inox;ELECTRODOMESTICOS
9368422;;F;61;CHILENO;;Silencioso;PROVIDENCIA                   ;METROPOLITANA;0;0;0;0;0;0;0;0;0;Hervidor Electrico TH-4515N 2Lts Negro;ELECTRODOMESTICOS
9040018;;M;61;CHILENO;;Silencioso;PROVIDENCIA                   ;METROPOLITANA;0;0;0;0;0;0;0;0;0;Horno Microondas Digital MS23K3513AK/ZS 23Lts;ELECTRODOMESTICOS
7852580;;F;62;CHILENO;;Boomers;ARICA                         ;TARAPACA;0;0;0;0;0;0;0;0;0;Horno Electrico TH-38N 38Lts;ELECTRODOMESTICOS
10898719;;F;53;CHILENO;;X;CAUQUENES                     ;MAULE;0;0;0;0;0;0;0;0;0;Hervidor Electrico TH-4515N 2Lts Negro;ELECTRODOMESTICOS
16617888;Soltero;F;34;CHILENO;;Millenial;PROVIDENCIA                   ;METROPOLITANA;0;0;0;0;0;0;0;0;0;SUPER FREIDORA DE AIRE OV3;ELECTRODOMESTICOS
10115989;;M;55;CHILENO;;Boomers;PROVIDENCIA                   ;METROPOLITANA;0;0;0;0;0;0;0;0;0;Horno Microondas Mecanico Easy Wave 20Lts;ELECTRODOMESTICOS
19345553;;F;26;CHILENO;;Z;LINARES                       ;MAULE;0;0;0;0;0;0;0;0;0;SUPER FREIDORA DE AIRE OV3;ELECTRODOMESTICOS
8784051;;F;63;CHILENO;;Boomers;OVALLE                        ;COQUIMBO;0;0;0;0;0;0;0;0;0;Aspiradora TH1407 Arrastre 1400Watts;ELECTRODOMESTICOS
9712381;;F;60;CHILENO;;Boomers;SAN CLEMENTE                  ;MAULE;0;0;0;0;0;0;0;0;0;Batidora Pedestal TH910PN 4,6Lts 1300Watts;ELECTRODOMESTICOS
8187653;;F;66;CHILENO;;Boomers;SAN PABLO                     ;LOS LAGOS;0;0;0;0;0;0;0;0;0;PICADORA 123 SILHQUETTE;ELECTRODOMESTICOS
12338004;Soltero;F;49;CHILENO;;X;RENCA                         ;METROPOLITANA;0;0;0;0;0;0;0;0;0;Licuadora L2000VNG 1,5Lts Vaso Vidrio;ELECTRODOMESTICOS
9424898;Casado;M;57;CHILENO;;Boomers;RENCA                         ;METROPOLITANA;0;0;0;0;0;0;0;0;0;Maquina de Coser 311;ELECTRODOMESTICOS
19218396;;F;26;CHILENO;;Silencioso;PROVIDENCIA                   ;METROPOLITANA;0;0;0;0;0;0;0;0;0;Horno Microondas Mecanico Easy Wave 20Lts;ELECTRODOMESTICOS
6228466;;F;69;CHILENO;;Silencioso;PROVIDENCIA                   ;METROPOLITANA;0;0;0;0;0;0;0;0;0;Horno Electrico TH-25N01 25Lts;ELECTRODOMESTICOS
26169973;Soltero;F;37;EXTRANJERO - NO INFORMA NACIONALIDAD;;Extranjero;SANTIAGO                      ;METROPOLITANA;0;0;0;0;0;0;0;0;0;Batidora Vertical Stick Mixer 2609;ELECTRODOMESTICOS
11638329;;F;53;CHILENO;;X;PROVIDENCIA                   ;METROPOLITANA;0;0;0;0;0;0;0;0;0;Licuadora Personal TH-300PB;ELECTRODOMESTICOS
9512706;;F;58;CHILENO;;Boomers;CHILLAN                       ;BIO BIO;0;0;0;0;0;0;0;0;0;BATIDORA INMERSION S MIX 2616;ELECTRODOMESTICOS
4911806;;F;79;CHILENO;;Silencioso;RENCA                         ;METROPOLITANA;0;0;0;0;0;0;0;0;0;Hervidor Electrico 3100 1,7Lts Negro;ELECTRODOMESTICOS
8900763;Casado;F;46;CHILENO;ABOGADO;X;RENCA                         ;METROPOLITANA;0;0;0;0;0;0;0;0;0;Hervidor Electrico TH-5407i 2Lts;ELECTRODOMESTICOS
12921763;;M;47;CHILENO;;X;CHIGUAYANTE                   ;BIO BIO;0;0;0;0;0;0;0;0;0;Licuadora L-5500IN 1,5Lts;ELECTRODOMESTICOS
8151316;;F;62;CHILENO;;Boomers;ARICA                         ;ARICA Y PARINACOTA;0;0;0;0;0;0;0;0;0;Hervidor Electrico TH-4212N 1,7Lts Negro;ELECTRODOMESTICOS
6886207;;F;69;CHILENO;;Boomers;N/D;N/D;0;0;0;0;0;0;0;0;0;Horno Electrico TH-38N 38Lts;ELECTRODOMESTICOS
9880478;;F;56;CHILENO;;Boomers;PROVIDENCIA                   ;METROPOLITANA;0;0;0;0;0;0;0;0;0;ARROCERA ROJA 4723;ELECTRODOMESTICOS
24220930;;F;52;COLOMBIANO;;Extranjero;LIMACHE                       ;VALPARAISO;0;0;0;0;0;0;0;0;0;Batidora de Pedestal FDV Venus Grey;ELECTRODOMESTICOS
12299747;;F;50;CHILENO;;X;RENCA                         ;METROPOLITANA;0;0;0;0;0;0;0;0;0;Horno Electrico UT-BACKOFEN38 38Lts;ELECTRODOMESTICOS
9769842;;F;57;CHILENO;;Boomers;N/D;N/D;0;0;0;0;0;0;0;0;0;Horno Electrico TH-100i 100Lts;ELECTRODOMESTICOS
18965155;;M;27;CHILENO;;Z;MELIPILLA                     ;METROPOLITANA;0;0;0;0;0;0;0;0;0;Aspiradora Tambor APA1000 1000Watts;ELECTRODOMESTICOS
17824429;;F;30;CHILENO;;Millenial;SAN JAVIER                    ;MAULE;0;0;0;0;0;0;0;0;0;Parrilla Electrica TH-224;ELECTRODOMESTICOS
11862246;;M;51;CHILENO;;Silencioso;PROVIDENCIA                   ;METROPOLITANA;0;0;0;0;0;0;0;0;0;Horno Microondas Digital UT-CLASSY720 20Lts;ELECTRODOMESTICOS
19317699;;M;26;CHILENO;;Z;N/D;N/D;0;0;0;0;0;0;0;0;0;Horno Microondas Digital TH-25DM 25Lts;ELECTRODOMESTICOS
12391538;;M;49;CHILENO;;X;COIHAIQUE                     ;AYSEN;0;0;0;0;0;0;0;0;0;Licuadora TH-501V 1,5Lts Vaso Vidrio;ELECTRODOMESTICOS
9274831;;F;57;CHILENO;;Boomers;PICHILEMU                     ;L.G.B.OÂ´HIGGINS;0;0;0;0;0;0;0;0;0;Cafetera TH-130;ELECTRODOMESTICOS
14635464;Soltero;F;42;CHILENO;;X;RENCA                         ;METROPOLITANA;0;0;0;0;0;0;0;0;0;Hervidor Electrico TH-5407i 2Lts;ELECTRODOMESTICOS
12549021;;F;48;CHILENO;;X;N/D;N/D;0;0;0;0;0;0;0;0;0;Combo Licuadora + Batidora;ELECTRODOMESTICOS
10243273;;M;56;CHILENO;;Boomers;RENCA                         ;METROPOLITANA;0;0;0;0;0;0;0;0;0;BATIDORA INMERSION S MIX 2616;ELECTRODOMESTICOS
7997388;;M;65;CHILENO;;Boomers;VINA DEL MAR                  ;VALPARAISO;0;0;0;0;0;0;0;0;0;Hervidor Electrico UT-MANLY17 1,7Lts Negro;ELECTRODOMESTICOS
18190735;;F;29;CHILENO;;Millenial;N/D;N/D;0;0;0;0;0;0;0;0;0;Hervidor Electrico UT-MANLY17 1,7Lts Negro;ELECTRODOMESTICOS
10248281;;F;58;CHILENO;;Boomers;SAN FERNANDO                  ;L.G.B.OÂ´HIGGINS;0;0;0;0;0;0;0;0;0;HERVIDOR TETERA RELOJ 900R 2,5L ROJO;ELECTRODOMESTICOS
13172644;;F;44;CHILENO;;X;ANTOFAGASTA                   ;ANTOFAGASTA;0;0;0;0;0;0;0;0;0;Plancha UT-SHANGRILA Inalambrica 2200Watss;ELECTRODOMESTICOS
9359291;;F;60;CHILENO;;Boomers;RENGO                         ;L.G.B.OÂ´HIGGINS;0;0;0;0;0;0;0;0;0;Batidora Manual UT-TEKLA300;ELECTRODOMESTICOS
15322423;;F;42;CHILENO;;X;N/D;N/D;0;0;0;0;0;0;0;0;0;Freidora FE-2510 BL 3Lts;ELECTRODOMESTICOS
5805085;Casado;M;69;CHILENO;ANALISTA DE SISTEMAS;Silencioso;RENCA                         ;METROPOLITANA;0;0;0;0;0;0;0;0;0;Hervidor Electrico 3100 1,7Lts Negro;ELECTRODOMESTICOS
12893684;Casado;F;46;CHILENO;ASISTENTE SOCIAL;X;RENCA                         ;METROPOLITANA;0;0;0;0;0;0;0;0;0;Cafetera UT-KAFFEEKLASSIK;ELECTRODOMESTICOS
8622471;;M;63;CHILENO;;Boomers;CHILLAN                       ;BIO BIO;0;0;0;0;0;0;0;0;0;Licuadora L-1630V Negra 1,5Lts Vaso Vidrio;ELECTRODOMESTICOS
8561233;;M;59;CHILENO;;Boomers;LA SERENA                     ;COQUIMBO;0;0;0;0;0;0;0;0;0;Olla Arrocera TH38IF 1,8Lts;ELECTRODOMESTICOS
13542833;;F;43;CHILENO;;X;N/D;N/D;0;0;0;0;0;0;0;0;0;Aspiradora AP1700 Arrastre 1700Watts;ELECTRODOMESTICOS
17818619;;F;31;CHILENO;;Millenial;SAN ESTEBAN                   ;VALPARAISO;0;0;0;0;0;0;0;0;0;Licuadora TH-501V 1,5Lts Vaso Vidrio;ELECTRODOMESTICOS
17031216;Soltero;M;33;CHILENO;INGENIERO EN TELECOMUNICACIONES;Millenial;PROVIDENCIA                   ;METROPOLITANA;0;0;0;0;0;0;0;0;0;Parrilla Electrica 25335-CL Hamilton Beach;ELECTRODOMESTICOS
10481837;;F;57;CHILENO;;Boomers;ANCUD                         ;LOS LAGOS;0;0;0;0;0;0;0;0;0;Horno Microondas Digital TH-25DM 25Lts;ELECTRODOMESTICOS
4997823;;M;75;CHILENO;;Silencioso;PROVIDENCIA                   ;METROPOLITANA;0;0;0;0;0;0;0;0;0;Licuadora L-25000NG;ELECTRODOMESTICOS
19621921;;F;23;CHILENO;;Z;PROVIDENCIA                   ;METROPOLITANA;0;0;0;0;0;0;0;0;0;Licuadora Berry Blender Roja 1400 Vaso Vidrio;ELECTRODOMESTICOS
18296844;;F;28;CHILENO;;Silencioso;PROVIDENCIA                   ;METROPOLITANA;0;0;0;0;0;0;0;0;0;Hervidor Electrico TH-5407i 2Lts;ELECTRODOMESTICOS
8567370;;F;63;CHILENO;;Boomers;COPIAPO                       ;ATACAMA;0;0;0;0;0;0;0;0;0;Licuadora TH-320 Roja/Negro 1,5 Lts Vaso Vidrio;ELECTRODOMESTICOS
8170692;Casado;F;60;CHILENO;;Boomers;RENCA                         ;METROPOLITANA;0;0;0;0;0;0;0;0;0;Hervidor Electrico UT-DUNKEL17P 2Lts Negro;ELECTRODOMESTICOS
12940693;;F;45;CHILENO;;X;LA SERENA                     ;COQUIMBO;0;0;0;0;0;0;0;0;0;HERVIDOR ELECTRICO UT-STARK18;ELECTRODOMESTICOS
16426088;;M;35;CHILENO;;Millenial;CARAHUE                       ;ARAUCANIA;0;0;0;0;0;0;0;0;0;Batidora Pedestal TH910PN 4,6Lts 1300Watts;ELECTRODOMESTICOS
13901500;;M;42;CHILENO;;X;MAIPU                         ;METROPOLITANA;0;0;0;0;0;0;0;0;0;Horno Microondas Mecanico UT-SYDNEY18 18Lts;ELECTRODOMESTICOS
15008345;;F;39;CHILENO;;Silencioso;LINARES                       ;MAULE;0;0;0;0;0;0;0;0;0;Horno Electrico UT-BACKOFEN38 38Lts;ELECTRODOMESTICOS
7237756;Soltero;F;68;CHILENO;;Boomers;RENCA                         ;METROPOLITANA;0;0;0;0;0;0;0;0;0;Maquina de coser Singer 024;ELECTRODOMESTICOS
14615946;;F;46;CHILENO;;X;PROVIDENCIA                   ;METROPOLITANA;0;0;0;0;0;0;0;0;0;Exprimidor de Jugo 407W 1Lts;ELECTRODOMESTICOS
17436449;;F;32;CHILENO;;Millenial;"";"";0;0;0;0;0;0;0;0;0;Batidora Manual 3532;ELECTRODOMESTICOS
18783237;Soltero;M;27;CHILENO;;Millenial;PROVIDENCIA                   ;METROPOLITANA;0;0;0;0;0;0;0;0;0;Aspiradora TH1870 Arrastre 1800Watts Gris;ELECTRODOMESTICOS
13748948;;F;42;CHILENO;;X;ILLAPEL                       ;COQUIMBO;0;0;0;0;0;0;0;0;0;Exprimidor Fauna 500 cc;ELECTRODOMESTICOS
13126773;;F;45;CHILENO;;X;SAN CARLOS                    ;BIO BIO;0;0;0;0;0;0;0;0;0;Hervidor Electrico TH-4515N 2Lts Negro;ELECTRODOMESTICOS
14383901;;F;41;CHILENO;;X;PUENTE ALTO                   ;METROPOLITANA;0;0;0;0;0;0;0;0;0;Horno Electrico TH62I 60Lts;ELECTRODOMESTICOS
15378558;Soltero;F;40;CHILENO;NUTRICIONISTA;Silencioso;PROVIDENCIA                   ;METROPOLITANA;0;0;0;0;0;0;0;0;0;Parrilla Electrica TH-224;ELECTRODOMESTICOS
19679871;;F;24;CHILENO;;Z;PROVIDENCIA                   ;METROPOLITANA;0;0;0;0;0;0;0;0;0;Parrilla Electrica TH-180;ELECTRODOMESTICOS
7338541;;F;63;CHILENO;;Boomers;CERRILLOS                     ;METROPOLITANA;0;0;0;0;0;0;0;0;0;Batidora Pedestal TH910PN 4,6Lts 1300Watts;ELECTRODOMESTICOS
18823722;;M;42;CHILENO;;X;VICUNA                        ;COQUIMBO;0;0;0;0;0;0;0;0;0;Horno Microondas Mecanico M-2030 NG 20Lts;ELECTRODOMESTICOS
7440993;Soltero;F;69;CHILENO;;Silencioso;RANCAGUA                      ;L.G.B.OÂ´HIGGINS;0;0;0;0;0;0;0;0;0;Hervidor Electrico TH-4515N 2Lts Negro;ELECTRODOMESTICOS
17054157;;M;33;CHILENO;;Millenial;CASABLANCA                    ;VALPARAISO;0;0;0;0;0;0;0;0;0;Horno Electrico TH-25N01 25Lts;ELECTRODOMESTICOS
7770553;;M;65;CHILENO;;Boomers;SAN MIGUEL                    ;METROPOLITANA;0;0;0;0;0;0;0;0;0;Hervidor Electrico HA-3300 2,5Lts Blanco;ELECTRODOMESTICOS
11586712;;F;52;CHILENO;;X;CUNCO                         ;ARAUCANIA;0;0;0;0;0;0;0;0;0;Hervidor Electrico Tetera HA-4100 4Lts Iox;ELECTRODOMESTICOS
7457663;;F;65;CHILENO;;Boomers;LA PINTANA                    ;METROPOLITANA;0;0;0;0;0;0;0;0;0;Licuadora TH-501V 1,5Lts Vaso Vidrio;ELECTRODOMESTICOS
7966340;;M;64;CHILENO;;Boomers;YERBAS BUENAS                 ;MAULE;0;0;0;0;0;0;0;0;0;Aspiradora TH1870 Arrastre 1800Watts Gris;ELECTRODOMESTICOS
18525382;Soltero;M;28;CHILENO;;Millenial;PROVIDENCIA                   ;METROPOLITANA;0;0;0;0;0;0;0;0;0;Horno Electrico UT-BACKOFEN48 48Lts;ELECTRODOMESTICOS
7923048;;F;64;CHILENO;;Boomers;ARICA                         ;TARAPACA;0;0;0;0;0;0;0;0;0;Plancha TH-7052 2000Watts Base Inox;ELECTRODOMESTICOS
17744173;Casado;F;31;CHILENO;ENFERMERA;Silencioso;PROVIDENCIA                   ;METROPOLITANA;0;0;0;0;0;0;0;0;0;Horno Electrico UT-BACKOFEN60 60Lts;ELECTRODOMESTICOS
13561737;;F;43;CHILENO;;X;NANCAGUA                      ;L.G.B.OÂ´HIGGINS;0;0;0;0;0;0;0;0;0;Horno Electrico TH-38N 38Lts;ELECTRODOMESTICOS
8859062;;F;62;CHILENO;;Boomers;RINCONADA                     ;VALPARAISO;0;0;0;0;0;0;0;0;0;Hervidor Electrico 3101 1,7Lts Negro;ELECTRODOMESTICOS
11513119;;F;52;CHILENO;;X;MONTE PATRIA                  ;COQUIMBO;0;0;0;0;0;0;0;0;0;Hervidor Electrico TH-4212N 1,7Lts Negro;ELECTRODOMESTICOS
18884088;;F;27;CHILENO;;Millenial;N/D;N/D;0;0;0;0;0;0;0;0;0;Hervidor Electrico Tetera HA-4100 4Lts Iox;ELECTRODOMESTICOS
15100984;;M;39;CHILENO;;X;SAN CARLOS                    ;BIO BIO;0;0;0;0;0;0;0;0;0;Aspiradora TH1870 Arrastre 1800Watts Gris;ELECTRODOMESTICOS
7575156;;F;69;CHILENO;;Silencioso;PUENTE ALTO                   ;METROPOLITANA;0;0;0;0;0;0;0;0;0;Horno Electrico TH-100i 100Lts;ELECTRODOMESTICOS
9092896;;M;52;CHILENO;;X;COLINA;METROPOLITANA;0;0;0;0;0;0;0;0;0;Horno Microondas Mecanico TH-18B05 18Lts;ELECTRODOMESTICOS
19346923;Soltero;M;25;CHILENO;;Z;LINARES                       ;MAULE;0;0;0;0;0;0;0;0;0;Tostador de Pan TH-116 2 Rebanadas Negro;ELECTRODOMESTICOS
9856444;;M;57;CHILENO;;Boomers;N/D;N/D;0;0;0;0;0;0;0;0;0;Aspiradora UT-MEINER1803 Arrastre 1800Watts;ELECTRODOMESTICOS
9413620;;F;59;CHILENO;;Boomers;PROVIDENCIA                   ;METROPOLITANA;0;0;0;0;0;0;0;0;0;Combo Juguera + Hervidor;ELECTRODOMESTICOS
19173752;;M;26;CHILENO;;Z;PROVIDENCIA                   ;METROPOLITANA;0;0;0;0;0;0;0;0;0;Aspiradora Tambor APA1000 1000Watts;ELECTRODOMESTICOS
9636048;;F;59;CHILENO;;Boomers;LOS ANDES                     ;VALPARAISO;0;0;0;0;0;0;0;0;0;Batidora Manual 3532;ELECTRODOMESTICOS
16047346;;F;37;CHILENO;;Millenial;N/D;N/D;0;0;0;0;0;0;0;0;0;Aspiradora TH1870 Arrastre 1800Watts Gris;ELECTRODOMESTICOS
18810489;Soltero;M;27;CHILENO;MEDICO CIRUJANO;Millenial;PROVIDENCIA                   ;METROPOLITANA;0;0;0;0;0;0;0;0;0;Horno Microondas Digital MS23K3513AK/ZS 23Lts;ELECTRODOMESTICOS
26819220;;M;30;VENEZOLANO;;Extranjero;LA SERENA                     ;COQUIMBO;0;0;0;0;0;0;0;0;0;Horno Microondas Digital UT-CLASSY720 20Lts;ELECTRODOMESTICOS
8106192;;F;63;CHILENO;;Boomers;NUEVA IMPERIAL                ;ARAUCANIA;0;0;0;0;0;0;0;0;0;Hervidor Electrico HA-3300 2,5Lts Blanco;ELECTRODOMESTICOS
15937226;;F;40;CHILENO;;X;TIRUA                         ;BIO BIO;0;0;0;0;0;0;0;0;0;ASPIRADORA THOMAS TH-1640;ELECTRODOMESTICOS
18858605;Soltero;F;27;CHILENO;TECNICO DE NIVEL SUPERIOR EN COSMETOLOGIA;Z;PROVIDENCIA                   ;METROPOLITANA;0;0;0;0;0;0;0;0;0;Horno Microondas Digital TH-20S01 20Lts;ELECTRODOMESTICOS
19674484;;F;25;CHILENO;;Millenial;N/D;N/D;0;0;0;0;0;0;0;0;0;HERVIDOR ELECTRICO UT-STARK18;ELECTRODOMESTICOS
19045126;;M;26;CHILENO;;Z;PROVIDENCIA                   ;METROPOLITANA;0;0;0;0;0;0;0;0;0;Licuadora L2000VNG 1,5Lts Vaso Vidrio;ELECTRODOMESTICOS
15266906;;F;40;CHILENO;;X;LA PINTANA                    ;METROPOLITANA;0;0;0;0;0;0;0;0;0;Hervidor Electrico TH-4515N 2Lts Negro;ELECTRODOMESTICOS
4993607;;M;78;CHILENO;;Silencioso;PROVIDENCIA                   ;METROPOLITANA;0;0;0;0;0;0;0;0;0;Licuadora Osterizer 4112/72 1,25Lts Vaso Vidrio;ELECTRODOMESTICOS
26567493;;M;38;EXTRANJERO - NO INFORMA NACIONALIDAD;;Extranjero;N/D;N/D;0;0;0;0;0;0;0;0;0;Batidora Pedestal Bowl 300 Inox;ELECTRODOMESTICOS
13415917;;M;44;CHILENO;;X;ARICA                         ;ARICA Y PARINACOTA;0;0;0;0;0;0;0;0;0;PLANCHA A VAPOR 6953 BASE AEROCERAMICA AUTAPA.22;ELECTRODOMESTICOS
11417669;;F;52;CHILENO;;X;EL BOSQUE                     ;METROPOLITANA;0;0;0;0;0;0;0;0;0;Licuadora TH-401V Roja 1,75Lts Vaso Vidrio;ELECTRODOMESTICOS
4929521;;F;78;CHILENO;;Silencioso;MAIPU                         ;METROPOLITANA;0;0;0;0;0;0;0;0;0;ASPIRADORA THOMAS TH-1640;ELECTRODOMESTICOS
12858847;;F;47;CHILENO;;X;PROVIDENCIA                   ;METROPOLITANA;0;0;0;0;0;0;0;0;0;Hervidor Electrico UT-MANLY17 1,7Lts Negro;ELECTRODOMESTICOS
17155002;;M;33;CHILENO;;Millenial;ROMERAL                       ;MAULE;0;0;0;0;0;0;0;0;0;Hervidor Electrico HA-3300 2,5Lts Blanco;ELECTRODOMESTICOS
16179671;;F;36;CHILENO;;Millenial;N/D;N/D;0;0;0;0;0;0;0;0;0;Sandwichera TH-952 2 Panes Blanca;ELECTRODOMESTICOS
18212915;;M;30;CHILENO;;Silencioso;PROVIDENCIA                   ;METROPOLITANA;0;0;0;0;0;0;0;0;0;Horno Microondas Digital UT-CLASSY720 20Lts;ELECTRODOMESTICOS
7803372;;M;67;CHILENO;;Boomers;RENCA                         ;METROPOLITANA;0;0;0;0;0;0;0;0;0;Enceradora EA-5000;ELECTRODOMESTICOS
13859075;;F;42;CHILENO;;X;CHILLAN                       ;BIO BIO;0;0;0;0;0;0;0;0;0;Horno Electrico TH62I 60Lts;ELECTRODOMESTICOS
11498986;;F;52;CHILENO;;X;ANGOL                         ;ARAUCANIA;0;0;0;0;0;0;0;0;0;Hervidor Electrico UT-DUNKEL17P 2Lts Negro;ELECTRODOMESTICOS
18547339;Soltero;F;28;CHILENO;;Millenial;PROVIDENCIA                   ;METROPOLITANA;0;0;0;0;0;0;0;0;0;Freidora de Aire 18M Oster;ELECTRODOMESTICOS
10351883;;M;55;CHILENO;;Boomers;RENCA                         ;METROPOLITANA;0;0;0;0;0;0;0;0;0;Horno Electrico TH-25N01 25Lts;ELECTRODOMESTICOS
17245135;Soltero;M;32;CHILENO;;Silencioso;PROVIDENCIA                   ;METROPOLITANA;0;0;0;0;0;0;0;0;0;Cafetera TH-138i;ELECTRODOMESTICOS
19812512;;M;24;CHILENO;;Z;PROVIDENCIA                   ;METROPOLITANA;0;0;0;0;0;0;0;0;0;Horno Electrico TH-25N01 25Lts;ELECTRODOMESTICOS
18417138;;F;28;CHILENO;;Millenial;PROVIDENCIA                   ;METROPOLITANA;0;0;0;0;0;0;0;0;0;Licuadora L-5500IN 1,5Lts;ELECTRODOMESTICOS
15457932;;M;40;CHILENO;;X;"";"";0;0;0;0;0;0;0;0;0;Exprimidor de Jugo CJ-2000 1Lts;ELECTRODOMESTICOS
10819558;;M;55;CHILENO;;Boomers;SAN JAVIER                    ;MAULE;0;0;0;0;0;0;0;0;0;Horno Microondas Digital L UT-25KROMM 25Lts;ELECTRODOMESTICOS
20361108;;M;22;CHILENO;;Silencioso;PROVIDENCIA                   ;METROPOLITANA;0;0;0;0;0;0;0;0;0;Batidora Manual BM-490IN Multi Accesorios;ELECTRODOMESTICOS
20567941;;F;22;CHILENO;;Z;SAN ANTONIO                   ;VALPARAISO;0;0;0;0;0;0;0;0;0;Licuadora L2000VNG 1,5Lts Vaso Vidrio;ELECTRODOMESTICOS
9420384;;F;59;CHILENO;;Boomers;PROVIDENCIA                   ;METROPOLITANA;0;0;0;0;0;0;0;0;0;Horno Electrico TH62I 60Lts;ELECTRODOMESTICOS
13234956;;F;44;CHILENO;;X;LA CISTERNA                   ;METROPOLITANA;0;0;0;0;0;0;0;0;0;Sandwichera TH-952 2 Panes Blanca;ELECTRODOMESTICOS
8730291;;M;62;CHILENO;;Boomers;SAN CARLOS                    ;BIO BIO;0;0;0;0;0;0;0;0;0;Hervidor Electrico TH-4515N 2Lts Negro;ELECTRODOMESTICOS
10174224;;M;57;CHILENO;;Boomers;ARICA                         ;TARAPACA;0;0;0;0;0;0;0;0;0;Horno Electrico TH-48N 48Lts;ELECTRODOMESTICOS
15538371;;F;39;CHILENO;;Silencioso;PROVIDENCIA                   ;METROPOLITANA;0;0;0;0;0;0;0;0;0;Batidora de Pedestal FDV Venus Red;ELECTRODOMESTICOS
15924810;;F;37;CHILENO;;Millenial;IQUIQUE                       ;TARAPACA;0;0;0;0;0;0;0;0;0;HERVIDOR TH-4340;ELECTRODOMESTICOS
16612180;Soltero;M;33;CHILENO;;Millenial;PROVIDENCIA                   ;METROPOLITANA;0;0;0;0;0;0;0;0;0;Aspiradora Trapeadora Robot Ut-Excellenza (B);ELECTRODOMESTICOS
11786589;Soltero;M;51;CHILENO;;X;RENCA                         ;METROPOLITANA;0;0;0;0;0;0;0;0;0;Horno Microondas Mecanico Easy Wave 20Lts;ELECTRODOMESTICOS
13615938;;F;43;CHILENO;;X;PARRAL                        ;MAULE;0;0;0;0;0;0;0;0;0;Robot aspirador Roomba E5;ELECTRODOMESTICOS
11973786;;F;50;CHILENO;;Silencioso;PROVIDENCIA                   ;METROPOLITANA;0;0;0;0;0;0;0;0;0;BATIDORA VERTICAL MA-4100;ELECTRODOMESTICOS
11414574;;F;53;CHILENO;;X;CHONCHI                       ;LOS LAGOS;0;0;0;0;0;0;0;0;0;Hervidor Electrico TH-4515N 2Lts Negro;ELECTRODOMESTICOS
12111153;Viudo;F;55;CHILENO;;Boomers;PROVIDENCIA                   ;METROPOLITANA;0;0;0;0;0;0;0;0;0;Tostador de Pan TP-1310 NG;ELECTRODOMESTICOS
17401807;Soltero;M;32;CHILENO;;Silencioso;PROVIDENCIA                   ;METROPOLITANA;0;0;0;0;0;0;0;0;0;Horno Electrico UT-LEIF36 36Lts;ELECTRODOMESTICOS
19242187;Soltero;F;26;CHILENO;PROFESOR;Z;PROVIDENCIA                   ;METROPOLITANA;0;0;0;0;0;0;0;0;0;Horno Microondas Digital MMP-20GC3D 20Lts;ELECTRODOMESTICOS
19050050;;F;27;CHILENO;;Z;COLINA                        ;METROPOLITANA;0;0;0;0;0;0;0;0;0;Horno Microondas Mecanico Easy Wave 20Lts;ELECTRODOMESTICOS
16165704;;F;36;CHILENO;;Millenial;RENCA                         ;METROPOLITANA;0;0;0;0;0;0;0;0;0;Robot aspirador Roomba 675;ELECTRODOMESTICOS
16476951;;F;35;CHILENO;;Millenial;N/D;N/D;0;0;0;0;0;0;0;0;0;Cafetera TH-138i;ELECTRODOMESTICOS
16973702;;F;33;CHILENO;;Millenial;SAN FERNANDO                  ;L.G.B.OÂ´HIGGINS;0;0;0;0;0;0;0;0;0;Picadora TH-9020V Vaso Vidrio 2Lts;ELECTRODOMESTICOS
15094120;;F;39;CHILENO;;X;PROVIDENCIA                   ;METROPOLITANA;0;0;0;0;0;0;0;0;0;Hervidor Electrico HA-3300 2,5Lts Blanco;ELECTRODOMESTICOS
26411789;;F;41;EXTRANJERO - NO INFORMA NACIONALIDAD;;Extranjero;CONCHALI                      ;METROPOLITANA;0;0;0;0;0;0;0;0;0;Aspiradora AP1700 Arrastre 1700Watts;ELECTRODOMESTICOS
7697804;Casado;M;62;CHILENO;AUXILIAR PARAMEDICO DE ENFERMERIA;Silencioso;PROVIDENCIA                   ;METROPOLITANA;0;0;0;0;0;0;0;0;0;PLANCHA A VAPOR 6953 BASE AEROCERAMICA AUTAPA.22;ELECTRODOMESTICOS
16915498;Soltero;M;33;CHILENO;PSICOLOGO;Silencioso;PROVIDENCIA                   ;METROPOLITANA;0;0;0;0;0;0;0;0;0;Freidora electrica Ut-KeramikAir;ELECTRODOMESTICOS
15703194;;F;38;CHILENO;;X;"";"";0;0;0;0;0;0;0;0;0;Plancha OSTER 4801T 1200Watts Base Ceramica;ELECTRODOMESTICOS
12119011;;F;49;CHILENO;;Silencioso;PROVIDENCIA                   ;METROPOLITANA;0;0;0;0;0;0;0;0;0;Hervidor Electrico HA-3300 2,5Lts Blanco;ELECTRODOMESTICOS
16273510;;F;36;CHILENO;;Millenial;LONGAVI                       ;MAULE;0;0;0;0;0;0;0;0;0;ASPIRADORA THOMAS TH-1640;ELECTRODOMESTICOS
13613960;;M;43;CHILENO;;X;PROVIDENCIA                   ;METROPOLITANA;0;0;0;0;0;0;0;0;0;Freidora FE-2510 BL 3Lts;ELECTRODOMESTICOS
11163769;;F;55;CHILENO;;Silencioso;PROVIDENCIA                   ;METROPOLITANA;0;0;0;0;0;0;0;0;0;Horno Microondas Digital TH-20S01 20Lts;ELECTRODOMESTICOS
17836778;;F;31;CHILENO;;Millenial;PROVIDENCIA                   ;METROPOLITANA;0;0;0;0;0;0;0;0;0;Maquina de Coser XB-2500CL Rosado;ELECTRODOMESTICOS
17104359;;M;33;CHILENO;;Millenial;"";"";0;0;0;0;0;0;0;0;0;Horno Electrico TH-48N 48Lts;ELECTRODOMESTICOS
15913405;;F;37;CHILENO;;Millenial;PROVIDENCIA                   ;METROPOLITANA;0;0;0;0;0;0;0;0;0;FREIDORA DE AIRE CKSTAF15B 1850W;ELECTRODOMESTICOS
15532625;;M;39;CHILENO;;X;TALAGANTE                     ;METROPOLITANA;0;0;0;0;0;0;0;0;0;Exprimidor de Jugo CJ-2000 1Lts;ELECTRODOMESTICOS
18069160;Soltero;M;30;CHILENO;;Millenial;VILCUN                        ;ARAUCANIA;0;0;0;0;0;0;0;0;0;Aspiradora UT-SILENT1804 Arrastre 1800Watts;ELECTRODOMESTICOS
11539565;Soltero;F;54;CHILENO;;Boomers;RENCA                         ;METROPOLITANA;0;0;0;0;0;0;0;0;0;Horno Microondas Mecanico UT-SYDNEY18 18Lts;ELECTRODOMESTICOS
8743828;;M;47;CHILENO;;X;N/D;N/D;0;0;0;0;0;0;0;0;0;Parrilla Electrica M18W;ELECTRODOMESTICOS
13544063;;M;42;CHILENO;;X;LLAILLAY                      ;VALPARAISO;0;0;0;0;0;0;0;0;0;Horno Electrico UT-BACKOFEN60 60Lts;ELECTRODOMESTICOS
19194501;;F;25;CHILENO;;Z;N/D;N/D;0;0;0;0;0;0;0;0;0;Horno Electrico UT-BACKOFEN60 60Lts;ELECTRODOMESTICOS
7419786;;M;67;CHILENO;;Boomers;PROVIDENCIA                   ;METROPOLITANA;0;0;0;0;0;0;0;0;0;Horno Electrico TH-38N 38Lts;ELECTRODOMESTICOS
8086442;;F;65;CHILENO;;Boomers;VALDIVIA                      ;LOS LAGOS;0;0;0;0;0;0;0;0;0;Plancha OSTER 4801T 1200Watts Base Ceramica;ELECTRODOMESTICOS
16309515;Casado;M;36;CHILENO;;Millenial;PROVIDENCIA                   ;METROPOLITANA;0;0;0;0;0;0;0;0;0;Freidora FE4000 4Lts;ELECTRODOMESTICOS
10333611;Casado;F;51;CHILENO;;X;RENCA                         ;METROPOLITANA;0;0;0;0;0;0;0;0;0;Aspiradora VCC4190V3E/XZS Arrastre 2000Watts;ELECTRODOMESTICOS
13691750;;F;43;CHILENO;;X;N/D;N/D;0;0;0;0;0;0;0;0;0;Horno Electrico UT-BACKOFEN26 26Lts;ELECTRODOMESTICOS
5889220;;M;72;CHILENO;;Silencioso;ANCUD                         ;LOS LAGOS;0;0;0;0;0;0;0;0;0;Batidora Pedestal Bowl 300 Inox;ELECTRODOMESTICOS
18254541;Soltero;M;29;CHILENO;;Millenial;PROVIDENCIA                   ;METROPOLITANA;0;0;0;0;0;0;0;0;0;Batidora Manual BA-5010 Inox;ELECTRODOMESTICOS
13448378;;M;44;CHILENO;;Silencioso;PROVIDENCIA                   ;METROPOLITANA;0;0;0;0;0;0;0;0;0;Cafetera P65 Silver;ELECTRODOMESTICOS
10912359;;M;53;CHILENO;;X;"";"";0;0;0;0;0;0;0;0;0;Batidora Vertical Minipimer UT-KLOT400P;ELECTRODOMESTICOS
15801096;;M;37;CHILENO;;Silencioso;PROVIDENCIA                   ;METROPOLITANA;0;0;0;0;0;0;0;0;0;ASPIRADORA IROBOT ROOMBA 960;ELECTRODOMESTICOS
5799521;;M;73;CHILENO;;Silencioso;SAN BERNARDO                  ;METROPOLITANA;0;0;0;0;0;0;0;0;0;Batidora Pedestal B5300 Inox;ELECTRODOMESTICOS
20124055;;M;23;CHILENO;;Z;PROVIDENCIA                   ;METROPOLITANA;0;0;0;0;0;0;0;0;0;Aspiradora UT-SILENT1804 Arrastre 1800Watts;ELECTRODOMESTICOS
11501970;;F;52;CHILENO;;X;RENCA                         ;METROPOLITANA;0;0;0;0;0;0;0;0;0;Maquina de Coser ME9100;ELECTRODOMESTICOS
14104252;;F;41;CHILENO;;Silencioso;PROVIDENCIA                   ;METROPOLITANA;0;0;0;0;0;0;0;0;0;Maquina de Coser 3008 Janome Blanco;ELECTRODOMESTICOS
19290152;;F;26;CHILENO;;Z;N/D;N/D;0;0;0;0;0;0;0;0;0;Combo Licuadora + Batidora;ELECTRODOMESTICOS
22729194;;M;58;PERUANO;;Extranjero;SAN BERNARDO                  ;METROPOLITANA;0;0;0;0;0;0;0;0;0;Hervidor Electrico TH-5407i 2Lts;ELECTRODOMESTICOS
12184360;;M;50;CHILENO;;X;CAUQUENES                     ;MAULE;0;0;0;0;0;0;0;0;0;Horno Electrico TH-38N 38Lts;ELECTRODOMESTICOS
9482906;;M;57;CHILENO;;Boomers;RENCA                         ;METROPOLITANA;0;0;0;0;0;0;0;0;0;Batidora Pedestal B5300 Inox;ELECTRODOMESTICOS
18096232;;F;30;CHILENO;;Millenial;PROVIDENCIA                   ;METROPOLITANA;0;0;0;0;0;0;0;0;0;Parrilla Electrica TH-180;ELECTRODOMESTICOS
5329342;Soltero;F;70;CHILENO;INGENIERO;Silencioso;RENCA                         ;METROPOLITANA;0;0;0;0;0;0;0;0;0;Robot aspirador Roomba 675;ELECTRODOMESTICOS
17132299;Casado;M;33;CHILENO;MEDICO CIRUJANO;Silencioso;PROVIDENCIA                   ;METROPOLITANA;0;0;0;0;0;0;0;0;0;Aspiradora UT-SILENT1804 Arrastre 1800Watts;ELECTRODOMESTICOS
15117187;;F;40;CHILENO;;X;SAN FERNANDO                  ;L.G.B.OÂ´HIGGINS;0;0;0;0;0;0;0;0;0;Licuadora TH-501V 1,5Lts Vaso Vidrio;ELECTRODOMESTICOS
10507866;Soltero;M;55;CHILENO;;Boomers;PROVIDENCIA                   ;METROPOLITANA;0;0;0;0;0;0;0;0;0;Aspiradora VCC4190V3E/XZS Arrastre 2000Watts;ELECTRODOMESTICOS
5151674;;F;78;CHILENO;;Silencioso;QUINTA NORMAL                 ;METROPOLITANA;0;0;0;0;0;0;0;0;0;Horno Electrico UT-BACKOFEN26 26Lts;ELECTRODOMESTICOS
13823950;;M;41;CHILENO;;X;N/D;N/D;0;0;0;0;0;0;0;0;0;FREIDORA DE AIRE CKSTAF15B 1850W;ELECTRODOMESTICOS
14025299;;M;40;CHILENO;;Silencioso;PROVIDENCIA                   ;METROPOLITANA;0;0;0;0;0;0;0;0;0;Plancha OSTER 4801T 1200Watts Base Ceramica;ELECTRODOMESTICOS
18267918;Soltero;F;29;CHILENO;ENFERMERA;Millenial;PROVIDENCIA                   ;METROPOLITANA;0;0;0;0;0;0;0;0;0;Horno Microondas Digital TH20DM 20Lts Espejado;ELECTRODOMESTICOS
15677919;;F;38;CHILENO;;Millenial;N/D;N/D;0;0;0;0;0;0;0;0;0;Horno Microondas Digital MMP-20GC3D 20Lts;ELECTRODOMESTICOS
16192341;Soltero;F;36;CHILENO;AUXILIAR PARAMEDICO DE ENFERMERIA;Silencioso;PROVIDENCIA                   ;METROPOLITANA;0;0;0;0;0;0;0;0;0;Freidora electrica Ut-KeramikAir;ELECTRODOMESTICOS
20003386;;F;23;CHILENO;;Silencioso;PROVIDENCIA                   ;METROPOLITANA;0;0;0;0;0;0;0;0;0;Horno Electrico UT-BACKOFEN26 26Lts;ELECTRODOMESTICOS
13778091;;F;42;CHILENO;;X;MALLOA                        ;L.G.B.OÂ´HIGGINS;0;0;0;0;0;0;0;0;0;Hervidor Electrico TH-4515N 2Lts Negro;ELECTRODOMESTICOS
16851298;Soltero;M;34;CHILENO;;Millenial;PROVIDENCIA                   ;METROPOLITANA;0;0;0;0;0;0;0;0;0;Aspiradora Tambor APA1000 1000Watts;ELECTRODOMESTICOS
18019691;Soltero;F;30;CHILENO;INGENIERO COMERCIAL;Silencioso;PROVIDENCIA                   ;METROPOLITANA;0;0;0;0;0;0;0;0;0;Aspiradora VCC4190V3E/XZS Arrastre 2000Watts;ELECTRODOMESTICOS
8346367;;F;51;CHILENO;;X;PUERTO MONTT                  ;LOS LAGOS;0;0;0;0;0;0;0;0;0;Hervidor Electrico UT-KLAR20PW 2Lts Blanco;ELECTRODOMESTICOS
11204702;Divorciado;F;55;CHILENO;;Silencioso;PROVIDENCIA                   ;METROPOLITANA;0;0;0;0;0;0;0;0;0;Horno Electrico TH-16N 16Lts;ELECTRODOMESTICOS
12127677;;F;47;CHILENO;;X;PROVIDENCIA                   ;METROPOLITANA;0;0;0;0;0;0;0;0;0;Horno Electrico UT-BACKOFEN26 26Lts;ELECTRODOMESTICOS
19809026;;F;24;CHILENO;;Z;PROVIDENCIA                   ;METROPOLITANA;0;0;0;0;0;0;0;0;0;Horno Microondas Digital MS28F303TAS/ZS 28Lts;ELECTRODOMESTICOS
6033858;;M;75;CHILENO;;Silencioso;COLINA                        ;METROPOLITANA;0;0;0;0;0;0;0;0;0;Hervidor Electrico TH-4350 3Lts Blanco;ELECTRODOMESTICOS
25437576;;F;47;COLOMBIANO;;Extranjero;ANTOFAGASTA                   ;ANTOFAGASTA;0;0;0;0;0;0;0;0;0;ARROCERA ROJA 4723;ELECTRODOMESTICOS
19453032;;F;31;CHILENO;;Millenial;N/D;N/D;0;0;0;0;0;0;0;0;0;Horno Electrico UT-BACKOFEN26 26Lts;ELECTRODOMESTICOS
18929310;Soltero;F;27;CHILENO;;Millenial;PROVIDENCIA                   ;METROPOLITANA;0;0;0;0;0;0;0;0;0;Tostador de Pan TP-1310 NG;ELECTRODOMESTICOS
18234364;Soltero;M;29;CHILENO;;Millenial;PROVIDENCIA                   ;METROPOLITANA;0;0;0;0;0;0;0;0;0;Batidora Vertical Minipimer UT-KLOT800SS;ELECTRODOMESTICOS
18906463;;M;27;CHILENO;;Millenial;MAIPU                         ;METROPOLITANA;0;0;0;0;0;0;0;0;0;Horno Electrico UT-BACKOFEN48 48Lts;ELECTRODOMESTICOS
15190513;;F;39;CHILENO;;X;SANTIAGO                      ;METROPOLITANA;0;0;0;0;0;0;0;0;0;Maquina de Coser JS-2135CL Calipso;ELECTRODOMESTICOS
16753423;;F;34;CHILENO;;Silencioso;PROVIDENCIA                   ;METROPOLITANA;0;0;0;0;0;0;0;0;0;Horno Electrico TH-16N 16Lts;ELECTRODOMESTICOS
19781843;;F;24;CHILENO;;Z;PROVIDENCIA                   ;METROPOLITANA;0;0;0;0;0;0;0;0;0;Horno Electrico UT-BACKOFEN26 26Lts;ELECTRODOMESTICOS
16387873;Casado;F;36;CHILENO;PROFESOR;Millenial;RENCA                         ;METROPOLITANA;0;0;0;0;0;0;0;0;0;Horno Electrico UT-BACKOFEN48 48Lts;ELECTRODOMESTICOS
14614344;;M;43;CHILENO;;X;VINA DEL MAR                  ;VALPARAISO;0;0;0;0;0;0;0;0;0;Combo Hervidor + Batidora;ELECTRODOMESTICOS
17510749;;M;32;CHILENO;;Millenial;SAN VICENTE                   ;L.G.B.OÂ´HIGGINS;0;0;0;0;0;0;0;0;0;Aspiradora TH1870 Arrastre 1800Watts Gris;ELECTRODOMESTICOS
17273886;;F;33;CHILENO;;Millenial;PROVIDENCIA                   ;METROPOLITANA;0;0;0;0;0;0;0;0;0;Horno Electrico TH-80i 80Lts;ELECTRODOMESTICOS
16755342;Soltero;M;34;CHILENO;;Silencioso;PROVIDENCIA                   ;METROPOLITANA;0;0;0;0;0;0;0;0;0;Horno Electrico TH-25N01 25Lts;ELECTRODOMESTICOS
18885489;;F;28;CHILENO;;Millenial;VILLARICA                     ;ARAUCANIA;0;0;0;0;0;0;0;0;0;Batidora Manual 2532;ELECTRODOMESTICOS
10582339;;M;54;CHILENO;;Boomers;RENCA                         ;METROPOLITANA;0;0;0;0;0;0;0;0;0;MICROONDAS ME83X/XZS SAMSUNG MIRROR;ELECTRODOMESTICOS
14388968;;M;44;CHILENO;;X;COQUIMBO                      ;COQUIMBO;0;0;0;0;0;0;0;0;0;Aspiradora Tambor APA1000 1000Watts;ELECTRODOMESTICOS
12585407;;M;47;CHILENO;;X;N/D;N/D;0;0;0;0;0;0;0;0;0;Horno Electrico TH-48N 48Lts;ELECTRODOMESTICOS
26516702;;F;29;CHILENO;;Extranjero;N/D;N/D;0;0;0;0;0;0;0;0;0;Freidora FE4000 4Lts;ELECTRODOMESTICOS
17369293;;F;32;CHILENO;;Millenial;PROVIDENCIA                   ;METROPOLITANA;0;0;0;0;0;0;0;0;0;Aspiradora TH1415 Arrastre 1500Watts;ELECTRODOMESTICOS
19016437;;M;26;CHILENO;;Z;PROVIDENCIA                   ;METROPOLITANA;0;0;0;0;0;0;0;0;0;BATIDORA PLANETARIA BP-4500 BL;ELECTRODOMESTICOS
17015131;;M;33;CHILENO;;Silencioso;PROVIDENCIA                   ;METROPOLITANA;0;0;0;0;0;0;0;0;0;Horno Microondas Mecanico Easy Wave 20Lts;ELECTRODOMESTICOS
19495397;;F;24;CHILENO;;Z;PROVIDENCIA                   ;METROPOLITANA;0;0;0;0;0;0;0;0;0;Horno Electrico TH62I 60Lts;ELECTRODOMESTICOS
20389844;;F;22;CHILENO;;Silencioso;PROVIDENCIA                   ;METROPOLITANA;0;0;0;0;0;0;0;0;0;Horno Electrico UT-BACKOFEN38 38Lts;ELECTRODOMESTICOS
10401881;;F;56;CHILENO;;Boomers;PROVIDENCIA                   ;METROPOLITANA;0;0;0;0;0;0;0;0;0;Horno Electrico UT-BACKOFEN26 26Lts;ELECTRODOMESTICOS
14422634;;F;56;CHILENO;;Boomers;CHEPICA                       ;L.G.B.OÂ´HIGGINS;0;0;0;0;0;0;0;0;0;Olla Arrocera OA-400NG 1,8Lts;ELECTRODOMESTICOS
6217710;;F;76;CHILENO;;Silencioso;SAN FERNANDO                  ;L.G.B.OÂ´HIGGINS;0;0;0;0;0;0;0;0;0;Licuadora Osterizer 4112/72 1,25Lts Vaso Vidrio;ELECTRODOMESTICOS
9975766;;F;54;CHILENO;;X;"";"";0;0;0;0;0;0;0;0;0;Horno Electrico TH-48N 48Lts;ELECTRODOMESTICOS
10356964;;M;56;CHILENO;;Boomers;PROVIDENCIA                   ;METROPOLITANA;0;0;0;0;0;0;0;0;0;Licuadora TH-401V Roja 1,75Lts Vaso Vidrio;ELECTRODOMESTICOS
24612065;;M;36;COLOMBIANO;;Extranjero;ANTOFAGASTA                   ;ANTOFAGASTA;0;0;0;0;0;0;0;0;0;Horno Microondas Digital TH20DM 20Lts Espejado;ELECTRODOMESTICOS
7927142;;F;65;CHILENO;;Boomers;SAAVEDRA                      ;ARAUCANIA;0;0;0;0;0;0;0;0;0;Licuadora Berry Blender Roja 1400 Vaso Vidrio;ELECTRODOMESTICOS
19756023;;F;24;CHILENO;;Silencioso;PROVIDENCIA                   ;METROPOLITANA;0;0;0;0;0;0;0;0;0;BATIDORA INMERSION S MIX 2616;ELECTRODOMESTICOS
19635703;;F;25;CHILENO;;Z;PROVIDENCIA                   ;METROPOLITANA;0;0;0;0;0;0;0;0;0;Horno Electrico UT-LEIF36 36Lts;ELECTRODOMESTICOS
13023081;;M;46;CHILENO;;X;VINA DEL MAR                  ;VALPARAISO;0;0;0;0;0;0;0;0;0;Hervidor Electrico TH-6200 R 1,7Lts Rojo;ELECTRODOMESTICOS
17630332;Soltero;F;32;CHILENO;;Millenial;PROVIDENCIA                   ;METROPOLITANA;0;0;0;0;0;0;0;0;0;Parrilla Electrica TH-224;ELECTRODOMESTICOS
18815210;;F;27;CHILENO;;Millenial;CONCEPCION                    ;BIO BIO;0;0;0;0;0;0;0;0;0;Licuadora TH-501V 1,5Lts Vaso Vidrio;ELECTRODOMESTICOS
19621263;;F;24;CHILENO;;Silencioso;PROVIDENCIA                   ;METROPOLITANA;0;0;0;0;0;0;0;0;0;Combo Juguera + Hervidor;ELECTRODOMESTICOS
11409476;;M;52;CHILENO;;X;PROVIDENCIA                   ;METROPOLITANA;0;0;0;0;0;0;0;0;0;Horno Electrico UT-BACKOFEN26 26Lts;ELECTRODOMESTICOS
4939514;;F;79;CHILENO;;Silencioso;TALCAHUANO                    ;BIO BIO;0;0;0;0;0;0;0;0;0;HERVIDOR ELECTRICO UT-STARK18;ELECTRODOMESTICOS
8137092;;M;62;CHILENO;;Boomers;RENCA                         ;METROPOLITANA;0;0;0;0;0;0;0;0;0;Horno Electrico TH-48N 48Lts;ELECTRODOMESTICOS
18985341;;F;27;CHILENO;;Z;OVALLE                        ;COQUIMBO;0;0;0;0;0;0;0;0;0;Batidora Manual UT-TEKLA300;ELECTRODOMESTICOS
16600518;Soltero;M;34;CHILENO;INGENIERO INFORMATICO;Millenial;PROVIDENCIA                   ;METROPOLITANA;0;0;0;0;0;0;0;0;0;Maquina Bordadora MC400E;ELECTRODOMESTICOS
8670305;Casado;M;61;CHILENO;;Boomers;RENCA                         ;METROPOLITANA;0;0;0;0;0;0;0;0;0;BATIDORA VERTICAL MA-4100;ELECTRODOMESTICOS
7396598;;F;72;CHILENO;;Silencioso;VALLENAR;ATACAMA;0;0;0;0;0;0;0;0;0;ARROCERA ROJA 4723;ELECTRODOMESTICOS
19771955;;F;23;CHILENO;;Silencioso;PROVIDENCIA                   ;METROPOLITANA;0;0;0;0;0;0;0;0;0;Horno Electrico TH-16N 16Lts;ELECTRODOMESTICOS
16101721;;F;37;CHILENO;;Millenial;AISEN                         ;AYSEN;0;0;0;0;0;0;0;0;0;Aspiradora TH1415 Arrastre 1500Watts;ELECTRODOMESTICOS
15016449;;M;39;CHILENO;;X;CALAMA                        ;ANTOFAGASTA;0;0;0;0;0;0;0;0;0;Horno Microondas Digital L UT-25KROMM 25Lts;ELECTRODOMESTICOS
17708815;Soltero;M;30;CHILENO;INGENIERO CIVIL INDUSTRIAL;Silencioso;PROVIDENCIA                   ;METROPOLITANA;0;0;0;0;0;0;0;0;0;Aspiradora VCC4190V3E/XZS Arrastre 2000Watts;ELECTRODOMESTICOS
19029294;Soltero;F;27;CHILENO;;Silencioso;PROVIDENCIA                   ;METROPOLITANA;0;0;0;0;0;0;0;0;0;Batidora Manual TH-8830;ELECTRODOMESTICOS
19055129;Soltero;F;27;CHILENO;;Z;ESTACION CENTRAL;METROPOLITANA;0;0;0;0;0;0;0;0;0;FREIDORA DE AIRE CKSTAF15B 1850W;ELECTRODOMESTICOS
13837655;;M;42;CHILENO;;X;LA PINTANA                    ;METROPOLITANA;0;0;0;0;0;0;0;0;0;Maquina para Hacer Pan MPP-600 BL;ELECTRODOMESTICOS
10585821;Soltero;F;53;CHILENO;;Silencioso;PROVIDENCIA                   ;METROPOLITANA;0;0;0;0;0;0;0;0;0;Combo Juguera + Hervidor;ELECTRODOMESTICOS
20275494;;F;24;CHILENO;;Silencioso;PROVIDENCIA                   ;METROPOLITANA;0;0;0;0;0;0;0;0;0;CAFETERA THOMAS TH-150E;ELECTRODOMESTICOS
13721512;;F;43;CHILENO;;X;SAN VICENTE                   ;L.G.B.OÂ´HIGGINS;0;0;0;0;0;0;0;0;0;Cafetera TH-130;ELECTRODOMESTICOS
6273009;;M;69;CHILENO;;Silencioso;CANETE                        ;BIO BIO;0;0;0;0;0;0;0;0;0;Licuadora L-25000NG;ELECTRODOMESTICOS
15846669;;F;38;CHILENO;;Millenial;N/D;N/D;0;0;0;0;0;0;0;0;0;Extractor de Jugo EX800 1,4Lts;ELECTRODOMESTICOS
13745325;;M;41;CHILENO;;X;SANTIAGO                      ;METROPOLITANA;0;0;0;0;0;0;0;0;0;Hervidor Electrico HE420 2lts Negro;ELECTRODOMESTICOS
20305651;;F;22;CHILENO;;Z;PROVIDENCIA                   ;METROPOLITANA;0;0;0;0;0;0;0;0;0;MAQ. DE COSER REMINGTON SJ9800.;ELECTRODOMESTICOS
9186217;Casado;F;61;CHILENO;;Silencioso;PROVIDENCIA                   ;METROPOLITANA;0;0;0;0;0;0;0;0;0;Maquina de coser Singer 024;ELECTRODOMESTICOS
5472763;Casado;M;70;CHILENO;;Silencioso;RENCA                         ;METROPOLITANA;0;0;0;0;0;0;0;0;0;Horno Electrico TH-16N 16Lts;ELECTRODOMESTICOS
17206299;;F;34;CHILENO;;Millenial;PROVIDENCIA                   ;METROPOLITANA;0;0;0;0;0;0;0;0;0;Tostador de Pan TP-1400 4 Rebanadas Inox;ELECTRODOMESTICOS
13721178;;F;43;CHILENO;;X;RENCA                         ;METROPOLITANA;0;0;0;0;0;0;0;0;0;Hervidor Electrico UT-MANLY17 1,7Lts Negro;ELECTRODOMESTICOS
5832602;;F;72;CHILENO;;Silencioso;RENCA                         ;METROPOLITANA;0;0;0;0;0;0;0;0;0;Exprimidor de Jugo CJ-2000 1Lts;ELECTRODOMESTICOS
9074602;;M;62;CHILENO;;Boomers;CORONEL                       ;BIO BIO;0;0;0;0;0;0;0;0;0;Aspiradora TH1870 Arrastre 1800Watts Gris;ELECTRODOMESTICOS
20106774;;F;22;CHILENO;;Silencioso;PROVIDENCIA                   ;METROPOLITANA;0;0;0;0;0;0;0;0;0;ASPIRADORA VC21K5130VB/ZS SAMSUNG BLUE;ELECTRODOMESTICOS
18494509;;F;29;CHILENO;;Millenial;QUILLOTA                      ;VALPARAISO;0;0;0;0;0;0;0;0;0;Hervidor Electrico UT-DUNKEL17P 2Lts Negro;ELECTRODOMESTICOS
15602260;;F;39;CHILENO;;X;N/D;N/D;0;0;0;0;0;0;0;0;0;Licuadora Roja 550W 1,5Lts Vaso Vidrio;ELECTRODOMESTICOS
8654473;;F;64;CHILENO;;Boomers;ILLAPEL                       ;COQUIMBO;0;0;0;0;0;0;0;0;0;Horno Electrico UT-BACKOFEN38 38Lts;ELECTRODOMESTICOS
4660320;;M;79;CHILENO;;Silencioso;"";"";0;0;0;0;0;0;0;0;0;Hervidor 41020-CL 1,7Lts Inox;ELECTRODOMESTICOS
8326541;;F;62;CHILENO;;Boomers;QUILLOTA                      ;VALPARAISO;0;0;0;0;0;0;0;0;0;Hervidor Electrico HA-3300 2,5Lts Blanco;ELECTRODOMESTICOS
19841183;;F;24;CHILENO;;Silencioso;PROVIDENCIA                   ;METROPOLITANA;0;0;0;0;0;0;0;0;0;Robot aspirador Roomba 614;ELECTRODOMESTICOS
4905744;;F;77;CHILENO;;Silencioso;PROVIDENCIA                   ;METROPOLITANA;0;0;0;0;0;0;0;0;0;Licuadora Roja 550W 1,5Lts Vaso Vidrio;ELECTRODOMESTICOS
12950482;;F;45;CHILENO;;X;PROVIDENCIA                   ;METROPOLITANA;0;0;0;0;0;0;0;0;0;Maquina para Hacer Pan MPP-600 BL;ELECTRODOMESTICOS
11837890;;F;51;CHILENO;;X;NIQUEN                        ;BIO BIO;0;0;0;0;0;0;0;0;0;Horno Electrico TH62I 60Lts;ELECTRODOMESTICOS
17384196;Soltero;M;32;CHILENO;;Millenial;PROVIDENCIA                   ;METROPOLITANA;0;0;0;0;0;0;0;0;0;PROCESADOR THOMAS TH-9160;ELECTRODOMESTICOS
16471541;Soltero;M;35;CHILENO;;Silencioso;PROVIDENCIA                   ;METROPOLITANA;0;0;0;0;0;0;0;0;0;Hervidor 41020-CL 1,7Lts Inox;ELECTRODOMESTICOS
24151168;;F;39;BOLIVIANO;;Extranjero;N/D;N/D;0;0;0;0;0;0;0;0;0;Licuadora UT-METALLEK605P 1,55Lts;ELECTRODOMESTICOS
13190305;;F;44;CHILENO;;X;PROVIDENCIA                   ;METROPOLITANA;0;0;0;0;0;0;0;0;0;BATIDORA MANUAL 260R;ELECTRODOMESTICOS
20240855;;F;22;CHILENO;;Z;PROVIDENCIA                   ;METROPOLITANA;0;0;0;0;0;0;0;0;0;Picadora UT-PETRUS320 1Lts Vaso Vidrio;ELECTRODOMESTICOS
19472358;;M;25;CHILENO;;Z;SAN CLEMENTE                  ;MAULE;0;0;0;0;0;0;0;0;0;Combo Juguera + Hervidor;ELECTRODOMESTICOS
18758882;Soltero;F;27;CHILENO;CONTADOR GENERAL;Millenial;COQUIMBO;COQUIMBO;0;0;0;0;0;0;0;0;0;Batidora Pedestal B5300 Inox;ELECTRODOMESTICOS
12200189;;F;50;CHILENO;;X;VALDIVIA                      ;LOS RIOS;0;0;0;0;0;0;0;0;0;Licuadora Osterizer 4112/72 1,25Lts Vaso Vidrio;ELECTRODOMESTICOS
8989528;;F;66;CHILENO;;Boomers;RENCA                         ;METROPOLITANA;0;0;0;0;0;0;0;0;0;Exprimidor Fauna 500 cc;ELECTRODOMESTICOS
20212561;;M;23;CHILENO;;Silencioso;PROVIDENCIA                   ;METROPOLITANA;0;0;0;0;0;0;0;0;0;HORNO OSTER 42 LTS PUERTA FRANCESA;ELECTRODOMESTICOS
13033885;;F;45;CHILENO;;X;PUDAHUEL                      ;METROPOLITANA;0;0;0;0;0;0;0;0;0;Enceradora EA-5000;ELECTRODOMESTICOS
13885664;Soltero;F;42;CHILENO;;X;PROVIDENCIA                   ;METROPOLITANA;0;0;0;0;0;0;0;0;0;Horno Microondas Digital L UT-25KROMM 25Lts;ELECTRODOMESTICOS
13741479;;F;43;CHILENO;;X;N/D;N/D;0;0;0;0;0;0;0;0;0;Extractor de Jugo TH-2551 2Lts;ELECTRODOMESTICOS
7135474;;F;69;CHILENO;;Silencioso;PUNTA ARENAS                  ;MAGALLANES;0;0;0;0;0;0;0;0;0;Licuadora Personal TH-300PB;ELECTRODOMESTICOS
16154553;;M;36;CHILENO;;Millenial;PROVIDENCIA                   ;METROPOLITANA;0;0;0;0;0;0;0;0;0;Horno Microondas Digital MS23K3513AK/ZS 23Lts;ELECTRODOMESTICOS
8136889;;F;62;CHILENO;;Boomers;RENCA                         ;METROPOLITANA;0;0;0;0;0;0;0;0;0;Aspiradora UT-MEINER1803 Arrastre 1800Watts;ELECTRODOMESTICOS
6371761;;F;65;CHILENO;;Boomers;PROVIDENCIA                   ;METROPOLITANA;0;0;0;0;0;0;0;0;0;Batidora Pedestal Desmontable 64650-CL;ELECTRODOMESTICOS
13920713;;M;41;CHILENO;;X;PROVIDENCIA                   ;METROPOLITANA;0;0;0;0;0;0;0;0;0;Licuadora TH-320 Roja/Negro 1,5 Lts Vaso Vidrio;ELECTRODOMESTICOS
17272319;Casado;M;32;CHILENO;;Silencioso;PROVIDENCIA                   ;METROPOLITANA;0;0;0;0;0;0;0;0;0;Horno Electrico TH-16N 16Lts;ELECTRODOMESTICOS
15240138;;F;38;CHILENO;;X;CARAHUE                       ;ARAUCANIA;0;0;0;0;0;0;0;0;0;Licuadora Osterizer 4112/72 1,25Lts Vaso Vidrio;ELECTRODOMESTICOS
18123647;;F;29;CHILENO;;Millenial;PROVIDENCIA                   ;METROPOLITANA;0;0;0;0;0;0;0;0;0;Horno Microondas Mecanico Easy Wave 20Lts;ELECTRODOMESTICOS
7164866;;M;66;CHILENO;;Boomers;PROVIDENCIA                   ;METROPOLITANA;0;0;0;0;0;0;0;0;0;Horno Microondas Digital MS28F303TAS/ZS 28Lts;ELECTRODOMESTICOS
7944841;;F;64;CHILENO;;Boomers;PROVIDENCIA                   ;METROPOLITANA;0;0;0;0;0;0;0;0;0;Cafetera TH-130;ELECTRODOMESTICOS
17853964;Soltero;M;30;CHILENO;INGENIERIA EN MAQUINARIA VEHICULOS AUTOMOTRICES Y SISTEMAS ELECTRONICOS;Millenial;PROVIDENCIA                   ;METROPOLITANA;0;0;0;0;0;0;0;0;0;Horno Electrico UT-LEIF36 36Lts;ELECTRODOMESTICOS
7957900;;F;63;CHILENO;;Boomers;PAINE                         ;METROPOLITANA;0;0;0;0;0;0;0;0;0;HORNO OSTER 42 LTS PUERTA FRANCESA;ELECTRODOMESTICOS
13270991;;M;45;CHILENO;;X;COIHAIQUE                     ;AYSEN;0;0;0;0;0;0;0;0;0;Licuadora L-5500IN 1,5Lts;ELECTRODOMESTICOS
19275463;Soltero;M;25;CHILENO;;Silencioso;PROVIDENCIA                   ;METROPOLITANA;0;0;0;0;0;0;0;0;0;Aspiradora UT-SILENT1603 Arrastre 1600Watts;ELECTRODOMESTICOS
17873940;;F;31;CHILENO;;Millenial;LEBU                          ;BIO BIO;0;0;0;0;0;0;0;0;0;Horno Electrico UT-LEIF36 36Lts;ELECTRODOMESTICOS
8790130;;F;60;CHILENO;;Boomers;N/D;N/D;0;0;0;0;0;0;0;0;0;Hervidor Electrico Tetera HA-4100 4Lts Iox;ELECTRODOMESTICOS
20103502;;M;23;CHILENO;;Z;TEMUCO                        ;ARAUCANIA;0;0;0;0;0;0;0;0;0;Maquina de Coser 3223;ELECTRODOMESTICOS
19499883;;F;25;CHILENO;;Z;SAN BERNARDO                  ;METROPOLITANA;0;0;0;0;0;0;0;0;0;Horno Microondas Digital ME0113MB1/XZS 32Lts;ELECTRODOMESTICOS
16328502;Soltero;F;36;CHILENO;TRABAJADOR SOCIAL;Millenial;RENCA                         ;METROPOLITANA;0;0;0;0;0;0;0;0;0;Licuadora L-1630V Negra 1,5Lts Vaso Vidrio;ELECTRODOMESTICOS
11892094;;F;50;CHILENO;;X;RENCA                         ;METROPOLITANA;0;0;0;0;0;0;0;0;0;Licuadora Roja 550W 1,5Lts Vaso Vidrio;ELECTRODOMESTICOS
5479776;;M;72;CHILENO;;Silencioso;SAN RAMON                     ;METROPOLITANA;0;0;0;0;0;0;0;0;0;Horno Electrico TH-38N 38Lts;ELECTRODOMESTICOS
9042220;;M;62;CHILENO;;Silencioso;PROVIDENCIA                   ;METROPOLITANA;0;0;0;0;0;0;0;0;0;Horno Electrico UT-LEIF36 36Lts;ELECTRODOMESTICOS
9952025;;M;56;CHILENO;;Boomers;PROVIDENCIA                   ;METROPOLITANA;0;0;0;0;0;0;0;0;0;Hervidor Electrico 3100 1,7Lts Negro;ELECTRODOMESTICOS
17876431;Soltero;F;31;CHILENO;PROFESOR;Millenial;PROVIDENCIA                   ;METROPOLITANA;0;0;0;0;0;0;0;0;0;Aspiradora UT-ZYKLON1402 Arrastre 1400Watts;ELECTRODOMESTICOS
15984359;;M;37;CHILENO;;Millenial;PROVIDENCIA                   ;METROPOLITANA;0;0;0;0;0;0;0;0;0;Aspiradora UT-SILENT1603 Arrastre 1600Watts;ELECTRODOMESTICOS
10382980;;F;57;CHILENO;;Boomers;PROVIDENCIA                   ;METROPOLITANA;0;0;0;0;0;0;0;0;0;Horno Microondas Mecanico Easy Wave 20Lts;ELECTRODOMESTICOS
15062796;;F;40;CHILENO;;X;PROVIDENCIA                   ;METROPOLITANA;0;0;0;0;0;0;0;0;0;Hervidor Electrico Tetera UT-LECKER18R 1,8Lts;ELECTRODOMESTICOS
12266147;;F;50;CHILENO;;X;PROVIDENCIA                   ;METROPOLITANA;0;0;0;0;0;0;0;0;0;Horno Microondas Mecanico TH-18B05 18Lts;ELECTRODOMESTICOS
15971843;;M;37;CHILENO;;Millenial;SAN JAVIER                    ;MAULE;0;0;0;0;0;0;0;0;0;Horno Electrico UT-LEIF36 36Lts;ELECTRODOMESTICOS
15768621;;F;35;CHILENO;;Millenial;CALAMA                        ;ANTOFAGASTA;0;0;0;0;0;0;0;0;0;Plancha UT-KERAMIKTOP 2200Watts Base Ceramica;ELECTRODOMESTICOS
8510558;;F;54;CHILENO;;X;PROVIDENCIA                   ;METROPOLITANA;0;0;0;0;0;0;0;0;0;Extractor de Jugo EX800 1,4Lts;ELECTRODOMESTICOS
9658992;;F;57;CHILENO;;Boomers;RENCA                         ;METROPOLITANA;0;0;0;0;0;0;0;0;0;Licuadora Osterizer 4112/72 1,25Lts Vaso Vidrio;ELECTRODOMESTICOS
10830337;;M;55;CHILENO;;Boomers;RENCA                         ;METROPOLITANA;0;0;0;0;0;0;0;0;0;Aspiradora AP1700 Arrastre 1700Watts;ELECTRODOMESTICOS
6186424;;F;71;CHILENO;;Silencioso;RENCA                         ;METROPOLITANA;0;0;0;0;0;0;0;0;0;Batidora Vertical Minipimer UT-KLOT400P;ELECTRODOMESTICOS
26644990;;M;36;EXTRANJERO - NO INFORMA NACIONALIDAD;;Extranjero;N/D;N/D;0;0;0;0;0;0;0;0;0;Horno Electrico UT-BACKOFEN26 26Lts;ELECTRODOMESTICOS
16147832;;F;36;CHILENO;;Millenial;PROVIDENCIA                   ;METROPOLITANA;0;0;0;0;0;0;0;0;0;Horno Microondas Mecanico Easy Wave 20Lts;ELECTRODOMESTICOS
17114389;;F;33;CHILENO;;Millenial;PROVIDENCIA                   ;METROPOLITANA;0;0;0;0;0;0;0;0;0;Licuadora TH-320 Roja/Negro 1,5 Lts Vaso Vidrio;ELECTRODOMESTICOS
9643885;;M;59;CHILENO;;Boomers;PROVIDENCIA                   ;METROPOLITANA;0;0;0;0;0;0;0;0;0;Horno Electrico TH-48N 48Lts;ELECTRODOMESTICOS
19299819;Soltero;F;26;CHILENO;ABOGADO;Z;PROVIDENCIA                   ;METROPOLITANA;0;0;0;0;0;0;0;0;0;Plancha OSTER 4801T 1200Watts Base Ceramica;ELECTRODOMESTICOS
11563601;;M;52;CHILENO;;X;EMPEDRADO                     ;MAULE;0;0;0;0;0;0;0;0;0;Aspiradora TH1870 Arrastre 1800Watts Gris;ELECTRODOMESTICOS
19284770;Soltero;F;25;CHILENO;;Z;PROVIDENCIA                   ;METROPOLITANA;0;0;0;0;0;0;0;0;0;MAQ. DE COSER REMINGTON STF16;ELECTRODOMESTICOS
16108315;;F;37;CHILENO;;Millenial;LEBU                          ;BIO BIO;0;0;0;0;0;0;0;0;0;Hervidor Electrico HA-3300 2,5Lts Blanco;ELECTRODOMESTICOS
11915613;;M;49;CHILENO;;X;RENCA                         ;METROPOLITANA;0;0;0;0;0;0;0;0;0;LICUADORA MA-4210;ELECTRODOMESTICOS
7113731;;F;65;CHILENO;;Boomers;QUINTA NORMAL                 ;METROPOLITANA;0;0;0;0;0;0;0;0;0;Exprimidor de Jugo 407W 1Lts;ELECTRODOMESTICOS
12575633;;M;47;CHILENO;;X;RENCA                         ;METROPOLITANA;0;0;0;0;0;0;0;0;0;Licuadora L-5500IN 1,5Lts;ELECTRODOMESTICOS
24464611;;M;36;BOLIVIANO;;Extranjero;CALAMA                        ;ANTOFAGASTA;0;0;0;0;0;0;0;0;0;Hervidor Electrico TH-5407i 2Lts;ELECTRODOMESTICOS
10790799;;F;56;CHILENO;;Boomers;N/D;N/D;0;0;0;0;0;0;0;0;0;Hervidor Electrico TH-4515N 2Lts Negro;ELECTRODOMESTICOS
14067642;;M;42;CHILENO;;Millenial;"";"";0;0;0;0;0;0;0;0;0;Horno Electrico UT-LEIF36 36Lts;ELECTRODOMESTICOS
13334623;;M;44;CHILENO;;X;SANTIAGO                      ;METROPOLITANA;0;0;0;0;0;0;0;0;0;Hervidor Electrico HE420 2lts Negro;ELECTRODOMESTICOS
18650280;;F;27;CHILENO;;Millenial;REQUINOA                      ;L.G.B.OÂ´HIGGINS;0;0;0;0;0;0;0;0;0;Batidora Manual BA-5010 Inox;ELECTRODOMESTICOS
14312572;;F;46;CHILENO;;X;MELIPILLA                     ;METROPOLITANA;0;0;0;0;0;0;0;0;0;Hervidor Electrico TH-4212N 1,7Lts Negro;ELECTRODOMESTICOS
13918813;;F;43;CHILENO;;X;PROVIDENCIA                   ;METROPOLITANA;0;0;0;0;0;0;0;0;0;BATIDORA MANUAL 260R;ELECTRODOMESTICOS
25532681;;M;31;HAITIANO;;Extranjero;LA FLORIDA                    ;METROPOLITANA;0;0;0;0;0;0;0;0;0;Horno Microondas Digital TH-20S01 20Lts;ELECTRODOMESTICOS
17467484;;M;32;CHILENO;;Millenial;PROVIDENCIA                   ;METROPOLITANA;0;0;0;0;0;0;0;0;0;Plancha UT-DUNST 2200Watts Base Ceramica;ELECTRODOMESTICOS
19359836;;M;25;CHILENO;;Silencioso;PROVIDENCIA                   ;METROPOLITANA;0;0;0;0;0;0;0;0;0;Aspiradora UT-ZYKLON1402 Arrastre 1400Watts;ELECTRODOMESTICOS
16712135;Soltero;M;34;CHILENO;;Silencioso;"";"";0;0;0;0;0;0;0;0;0;Horno Electrico TH-48N 48Lts;ELECTRODOMESTICOS
19802049;;F;24;CHILENO;;Z;N/D;N/D;0;0;0;0;0;0;0;0;0;Horno Electrico UT-LEIF36 36Lts;ELECTRODOMESTICOS
4691108;;M;80;CHILENO;;Silencioso;RENCA                         ;METROPOLITANA;0;0;0;0;0;0;0;0;0;Hervidor Electrico UT-KLAR20PW 2Lts Blanco;ELECTRODOMESTICOS
8836827;;F;61;CHILENO;;Boomers;LOTA                          ;BIO BIO;0;0;0;0;0;0;0;0;0;Horno Electrico TH-25N01 25Lts;ELECTRODOMESTICOS
9118443;;F;63;CHILENO;;Boomers;RENCA                         ;METROPOLITANA;0;0;0;0;0;0;0;0;0;Procesador TH-9010 Multimixer 1,5Lts Vaso Vidrio;ELECTRODOMESTICOS
7868578;;F;66;CHILENO;;Boomers;RENCA                         ;METROPOLITANA;0;0;0;0;0;0;0;0;0;Licuadora TH-501V 1,5Lts Vaso Vidrio;ELECTRODOMESTICOS
15999049;;F;37;CHILENO;;Millenial;PROVIDENCIA                   ;METROPOLITANA;0;0;0;0;0;0;0;0;0;Batidora Manual BA-5010 Inox;ELECTRODOMESTICOS
14308422;;M;46;CHILENO;;X;ANTOFAGASTA                   ;ANTOFAGASTA;0;0;0;0;0;0;0;0;0;Plancha TH-7052 2000Watts Base Inox;ELECTRODOMESTICOS
16587990;;F;35;CHILENO;;Millenial;RENCA                         ;METROPOLITANA;0;0;0;0;0;0;0;0;0;Hervidor Electrico HA-2650NG;ELECTRODOMESTICOS
18812301;;F;27;CHILENO;;Millenial;NATALES                       ;MAGALLANES;0;0;0;0;0;0;0;0;0;Horno Microondas Digital MS28F303TAS/ZS 28Lts;ELECTRODOMESTICOS
15048674;;M;39;CHILENO;;Silencioso;PROVIDENCIA                   ;METROPOLITANA;0;0;0;0;0;0;0;0;0;Licuadora TH-401V Roja 1,75Lts Vaso Vidrio;ELECTRODOMESTICOS
20128912;;M;23;CHILENO;;Z;N/D;N/D;0;0;0;0;0;0;0;0;0;Maquina de Coser ME9100;ELECTRODOMESTICOS
16918525;;F;34;CHILENO;;Millenial;N/D;N/D;0;0;0;0;0;0;0;0;0;Horno Electrico TH62I 60Lts;ELECTRODOMESTICOS
10124791;Casado;F;62;CHILENO;;Silencioso;PROVIDENCIA                   ;METROPOLITANA;0;0;0;0;0;0;0;0;0;Licuadora Personal TH-300PB;ELECTRODOMESTICOS
8897213;;F;60;CHILENO;;Boomers;PROVIDENCIA                   ;METROPOLITANA;0;0;0;0;0;0;0;0;0;Aspiradora TH1415 Arrastre 1500Watts;ELECTRODOMESTICOS
19641276;;M;25;CHILENO;;Z;ANCUD                         ;LOS LAGOS;0;0;0;0;0;0;0;0;0;Aspiradora TH1870 Arrastre 1800Watts Gris;ELECTRODOMESTICOS
19993926;;F;23;CHILENO;;Z;PROVIDENCIA                   ;METROPOLITANA;0;0;0;0;0;0;0;0;0;Horno Electrico HE-300NG 30Lts;ELECTRODOMESTICOS
5772661;;F;71;CHILENO;;Silencioso;NOGALES                       ;VALPARAISO;0;0;0;0;0;0;0;0;0;Enceradora EA-5000;ELECTRODOMESTICOS
16108354;;F;37;CHILENO;;Millenial;LEBU                          ;BIO BIO;0;0;0;0;0;0;0;0;0;Batidora Vertical Multimixer TH-8720;ELECTRODOMESTICOS
18815731;;F;27;CHILENO;;Millenial;PROVIDENCIA                   ;METROPOLITANA;0;0;0;0;0;0;0;0;0;Licuadora Roja 550W 1,5Lts Vaso Vidrio;ELECTRODOMESTICOS
11782169;;M;51;CHILENO;;X;PROVIDENCIA                   ;METROPOLITANA;0;0;0;0;0;0;0;0;0;ASPIRADORA THOMAS TH-1640;ELECTRODOMESTICOS
5896855;;F;71;CHILENO;;Silencioso;PROVIDENCIA                   ;METROPOLITANA;0;0;0;0;0;0;0;0;0;Maquina de Coser JS-2135CL Calipso;ELECTRODOMESTICOS
18165856;Soltero;M;30;CHILENO;CIRUJANO DENTISTA;Silencioso;PROVIDENCIA                   ;METROPOLITANA;0;0;0;0;0;0;0;0;0;Aspiradora TH2206 Arrastre 1800Watts;ELECTRODOMESTICOS
6515437;;M;67;CHILENO;;Boomers;RENCA                         ;METROPOLITANA;0;0;0;0;0;0;0;0;0;Batidora Manual BA-5010 Inox;ELECTRODOMESTICOS
6653390;;M;66;CHILENO;;Boomers;RENCA                         ;METROPOLITANA;0;0;0;0;0;0;0;0;0;Horno Electrico UT-LEIF36 36Lts;ELECTRODOMESTICOS
9262850;;M;59;CHILENO;;Boomers;RENCA                         ;METROPOLITANA;0;0;0;0;0;0;0;0;0;Procesador TH-9010 Multimixer 1,5Lts Vaso Vidrio;ELECTRODOMESTICOS
18794539;;F;30;CHILENO;;Millenial;EL BOSQUE                     ;METROPOLITANA;0;0;0;0;0;0;0;0;0;Licuadora Roja 550W 1,5Lts Vaso Vidrio;ELECTRODOMESTICOS
18457969;;M;28;CHILENO;;Millenial;PROVIDENCIA                   ;METROPOLITANA;0;0;0;0;0;0;0;0;0;Robot aspirador Roomba E5;ELECTRODOMESTICOS
9344010;Soltero;F;57;CHILENO;;Boomers;RENCA                         ;METROPOLITANA;0;0;0;0;0;0;0;0;0;Aspiradora TH1870 Arrastre 1800Watts Gris;ELECTRODOMESTICOS
15099114;;F;39;CHILENO;;X;VILLA ALEMANA                 ;VALPARAISO;0;0;0;0;0;0;0;0;0;Hervidor Electrico Tetera HA-4100 4Lts Iox;ELECTRODOMESTICOS
12788079;;M;46;CHILENO;;X;SAN CLEMENTE                  ;MAULE;0;0;0;0;0;0;0;0;0;Aspiradora TH1407 Arrastre 1400Watts;ELECTRODOMESTICOS
6852057;;F;72;CHILENO;;Silencioso;LINARES                       ;MAULE;0;0;0;0;0;0;0;0;0;Batidora Vertical Multimixer TH-8720;ELECTRODOMESTICOS
9957209;;M;54;CHILENO;;X;PROVIDENCIA                   ;METROPOLITANA;0;0;0;0;0;0;0;0;0;Licuadora TH-501V 1,5Lts Vaso Vidrio;ELECTRODOMESTICOS
7576550;;M;64;CHILENO;;Boomers;QUILICURA                     ;METROPOLITANA;0;0;0;0;0;0;0;0;0;Hervidor Electrico HA-2650NG;ELECTRODOMESTICOS
7825930;;F;62;CHILENO;;Boomers;INDEPENDENCIA                 ;METROPOLITANA;0;0;0;0;0;0;0;0;0;Maquina de Coser ST-371HD Heavy Duty;ELECTRODOMESTICOS
13077414;;F;46;CHILENO;;X;PEDRO AGUIRRE CERDA           ;METROPOLITANA;0;0;0;0;0;0;0;0;0;Hervidor Electrico Tetera TH-6505RT 1,7Lts Rojo;ELECTRODOMESTICOS
7499070;;F;66;CHILENO;;Boomers;LOS VILOS                     ;COQUIMBO;0;0;0;0;0;0;0;0;0;Hervidor Electrico Tetera UT-LECKER18R 1,8Lts;ELECTRODOMESTICOS
8485177;Soltero;F;65;CHILENO;;Boomers;PROVIDENCIA                   ;METROPOLITANA;0;0;0;0;0;0;0;0;0;Aspiradora UT-SILENT1603 Arrastre 1600Watts;ELECTRODOMESTICOS
9631044;Casado;F;59;CHILENO;;Boomers;PROVIDENCIA                   ;METROPOLITANA;0;0;0;0;0;0;0;0;0;Licuadora TH-501V 1,5Lts Vaso Vidrio;ELECTRODOMESTICOS
14592024;Soltero;M;41;CHILENO;TEC PROGR DE COMPUTACIONES;X;RENCA                         ;METROPOLITANA;0;0;0;0;0;0;0;0;0;Horno Microondas Mecanico C1700N 17Lts Blanco;ELECTRODOMESTICOS
11883404;;F;51;CHILENO;;X;RENCA                         ;METROPOLITANA;0;0;0;0;0;0;0;0;0;HERVIDOR TH-4340;ELECTRODOMESTICOS
15465207;;F;40;CHILENO;;Millenial;LA REINA                      ;METROPOLITANA;0;0;0;0;0;0;0;0;0;Procesador TH-9010 Multimixer 1,5Lts Vaso Vidrio;ELECTRODOMESTICOS
16695746;;F;34;CHILENO;;Millenial;PROVIDENCIA                   ;METROPOLITANA;0;0;0;0;0;0;0;0;0;Hervidor Electrico Tetera TH-6505RT 1,7Lts Rojo;ELECTRODOMESTICOS
6780302;Soltero;M;70;CHILENO;;Silencioso;PROVIDENCIA                   ;METROPOLITANA;0;0;0;0;0;0;0;0;0;Hervidor Electrico HE420 2lts Negro;ELECTRODOMESTICOS
17842193;;F;31;CHILENO;;Millenial;PROVIDENCIA                   ;METROPOLITANA;0;0;0;0;0;0;0;0;0;Hervidor Electrico TH-4800 2Lts Negro Azul;ELECTRODOMESTICOS
9766121;;F;58;CHILENO;;Boomers;PROVIDENCIA                   ;METROPOLITANA;0;0;0;0;0;0;0;0;0;Batidora Manual UT-TEKLA300;ELECTRODOMESTICOS
11743254;;M;50;CHILENO;;Silencioso;PROVIDENCIA                   ;METROPOLITANA;0;0;0;0;0;0;0;0;0;Licuadora TH-320 Roja/Negro 1,5 Lts Vaso Vidrio;ELECTRODOMESTICOS
5533754;;M;77;CHILENO;;Silencioso;PROVIDENCIA                   ;METROPOLITANA;0;0;0;0;0;0;0;0;0;Horno Electrico UT-BACKOFEN26 26Lts;ELECTRODOMESTICOS
9907744;Casado;M;48;CHILENO;;Silencioso;PROVIDENCIA                   ;METROPOLITANA;0;0;0;0;0;0;0;0;0;Horno Microondas Mecanico C1700N 17Lts Blanco;ELECTRODOMESTICOS
14381009;;F;48;CHILENO;;X;QUILICURA                     ;METROPOLITANA;0;0;0;0;0;0;0;0;0;Horno Electrico TH-25N01 25Lts;ELECTRODOMESTICOS
12465611;Casado;M;49;CHILENO;;X;RENCA                         ;METROPOLITANA;0;0;0;0;0;0;0;0;0;Horno Electrico TH-48N 48Lts;ELECTRODOMESTICOS
16246737;Soltero;M;37;CHILENO;;Millenial;VICTORIA;ARAUCANIA;0;0;0;0;0;0;0;0;0;Freidora electrica Ut-KeramikAir;ELECTRODOMESTICOS
20088736;;F;23;CHILENO;;Z;SAN FELIPE                    ;VALPARAISO;0;0;0;0;0;0;0;0;0;Aspiradora TH1415 Arrastre 1500Watts;ELECTRODOMESTICOS
9528271;Casado;M;56;CHILENO;;Boomers;PROVIDENCIA                   ;METROPOLITANA;0;0;0;0;0;0;0;0;0;Maquina de Coser ME9100;ELECTRODOMESTICOS
13530099;;M;43;CHILENO;;X;OVALLE                        ;COQUIMBO;0;0;0;0;0;0;0;0;0;Exprimidor Fauna 500 cc;ELECTRODOMESTICOS
7864939;;F;68;CHILENO;;Boomers;N/D;N/D;0;0;0;0;0;0;0;0;0;Licuadora Personal TH-300PB;ELECTRODOMESTICOS
15197841;Casado;F;40;CHILENO;;X;PROVIDENCIA                   ;METROPOLITANA;0;0;0;0;0;0;0;0;0;Horno Electrico TH-80i 80Lts;ELECTRODOMESTICOS
7623114;Casado;M;63;CHILENO;;Boomers;PUENTE ALTO                   ;METROPOLITANA;0;0;0;0;0;0;0;0;0;Aspiradora TH1415 Arrastre 1500Watts;ELECTRODOMESTICOS
11795965;;F;50;CHILENO;;X;RENCA                         ;METROPOLITANA;0;0;0;0;0;0;0;0;0;Plancha Durathon;ELECTRODOMESTICOS
22625975;Soltero;F;39;BOLIVIANO;;Extranjero;PROVIDENCIA                   ;METROPOLITANA;0;0;0;0;0;0;0;0;0;Licuadora TH-320 Roja/Negro 1,5 Lts Vaso Vidrio;ELECTRODOMESTICOS
18648175;;M;27;CHILENO;;Millenial;REQUINOA                      ;L.G.B.OÂ´HIGGINS;0;0;0;0;0;0;0;0;0;Picadora UT-PETRUS320 1Lts Vaso Vidrio;ELECTRODOMESTICOS
14424559;;F;53;CHILENO;;X;PROVIDENCIA                   ;METROPOLITANA;0;0;0;0;0;0;0;0;0;Tostador de PanTH-120R 2 Rebanadas Rojo;ELECTRODOMESTICOS
19442176;;M;25;CHILENO;;Z;PROVIDENCIA                   ;METROPOLITANA;0;0;0;0;0;0;0;0;0;ASPIRADORA THOMAS TH-1640;ELECTRODOMESTICOS
14301821;Soltero;F;48;CHILENO;;X;RENCA                         ;METROPOLITANA;0;0;0;0;0;0;0;0;0;Hervidor Electrico TH-4515N 2Lts Negro;ELECTRODOMESTICOS
10323783;;F;56;CHILENO;;Boomers;MOLINA                        ;MAULE;0;0;0;0;0;0;0;0;0;Aspiradora UT-SILENT1603 Arrastre 1600Watts;ELECTRODOMESTICOS
15806478;;F;37;CHILENO;;Millenial;RANCAGUA                      ;L.G.B.OÂ´HIGGINS;0;0;0;0;0;0;0;0;0;Licuadora TH-320 Roja/Negro 1,5 Lts Vaso Vidrio;ELECTRODOMESTICOS
13512519;;F;43;CHILENO;;X;GRANEROS                      ;L.G.B.OÂ´HIGGINS;0;0;0;0;0;0;0;0;0;Hervidor Electrico HE420 2lts Negro;ELECTRODOMESTICOS
13743799;;F;41;CHILENO;;X;N/D;N/D;0;0;0;0;0;0;0;0;0;Enceradora EA-5000;ELECTRODOMESTICOS
8363827;;F;62;CHILENO;;Boomers;CHILLAN                       ;BIO BIO;0;0;0;0;0;0;0;0;0;Licuadora TH-501V 1,5Lts Vaso Vidrio;ELECTRODOMESTICOS
8661404;;F;59;CHILENO;;Boomers;PROVIDENCIA                   ;METROPOLITANA;0;0;0;0;0;0;0;0;0;Aspiradora UT-SILENT1603 Arrastre 1600Watts;ELECTRODOMESTICOS
7504907;Casado;M;65;CHILENO;;Boomers;PROVIDENCIA                   ;METROPOLITANA;0;0;0;0;0;0;0;0;0;Licuadora UT-METALLEK505P 1,5Lts Vaso Vidrio;ELECTRODOMESTICOS
19898485;;F;22;CHILENO;;Z;PROVIDENCIA                   ;METROPOLITANA;0;0;0;0;0;0;0;0;0;Aspiradora AP1700 Arrastre 1700Watts;ELECTRODOMESTICOS
19857114;;M;24;CHILENO;;Z;RENCA                         ;METROPOLITANA;0;0;0;0;0;0;0;0;0;Licuadora TH-501V 1,5Lts Vaso Vidrio;ELECTRODOMESTICOS
6434758;Casado;M;70;CHILENO;;Silencioso;RENCA                         ;METROPOLITANA;0;0;0;0;0;0;0;0;0;Licuadora TH-401V Roja 1,75Lts Vaso Vidrio;ELECTRODOMESTICOS
16829383;Casado;F;34;CHILENO;;Millenial;PROVIDENCIA                   ;METROPOLITANA;0;0;0;0;0;0;0;0;0;Hervidor Electrico 3100 1,7Lts Negro;ELECTRODOMESTICOS
19596793;;F;25;CHILENO;;Extranjero;N/D;N/D;0;0;0;0;0;0;0;0;0;Plancha UT-KERAMIK1 2200Watts Base Ceramica;ELECTRODOMESTICOS
8118262;;F;60;CHILENO;;Boomers;RENCA                         ;METROPOLITANA;0;0;0;0;0;0;0;0;0;Hervidor Electrico TH-5407i 2Lts;ELECTRODOMESTICOS
7451127;;F;67;CHILENO;;Boomers;RANCAGUA                      ;L.G.B.OÂ´HIGGINS;0;0;0;0;0;0;0;0;0;Plancha UT-DUNST 2200Watts Base Ceramica;ELECTRODOMESTICOS
17756581;Soltero;F;31;CHILENO;TECNICO DE NIVEL SUPERIOR EN ODONTOLOGIA;Millenial;PROVIDENCIA                   ;METROPOLITANA;0;0;0;0;0;0;0;0;0;Horno Electrico TH-48N 48Lts;ELECTRODOMESTICOS
17825751;;M;31;CHILENO;;Millenial;CONSTITUCION                  ;MAULE;0;0;0;0;0;0;0;0;0;Licuadora TH-401V Roja 1,75Lts Vaso Vidrio;ELECTRODOMESTICOS
10814917;;F;61;CHILENO;;Boomers;TALAGANTE                     ;METROPOLITANA;0;0;0;0;0;0;0;0;0;Hervidor Electrico UT-MANLY17 1,7Lts Negro;ELECTRODOMESTICOS
8824547;Divorciado;F;61;CHILENO;;Boomers;PROVIDENCIA                   ;METROPOLITANA;0;0;0;0;0;0;0;0;0;Horno Microondas Digital TH-20S01 20Lts;ELECTRODOMESTICOS
16032715;;M;37;CHILENO;;Millenial;BUIN                          ;METROPOLITANA;0;0;0;0;0;0;0;0;0;Hervidor Electrico HE420 2lts Negro;ELECTRODOMESTICOS
7938754;Casado;M;60;CHILENO;;Boomers;RENCA                         ;METROPOLITANA;0;0;0;0;0;0;0;0;0;Horno Microondas Mecanico Easy Wave 20Lts;ELECTRODOMESTICOS
10578788;Casado;F;40;CHILENO;INGENIERO EN MARKETING;X;PROVIDENCIA                   ;METROPOLITANA;0;0;0;0;0;0;0;0;0;Hervidor Electrico UT-MANLY17 1,7Lts Negro;ELECTRODOMESTICOS
15080091;;M;39;CHILENO;;X;LIMACHE                       ;VALPARAISO;0;0;0;0;0;0;0;0;0;Licuadora L-1630V Negra 1,5Lts Vaso Vidrio;ELECTRODOMESTICOS
13916700;Soltero;M;41;CHILENO;;X;RENCA                         ;METROPOLITANA;0;0;0;0;0;0;0;0;0;Hervidor Electrico UT-KLAR20PW 2Lts Blanco;ELECTRODOMESTICOS
17815076;Soltero;M;31;CHILENO;ABOGADO;Millenial;PROVIDENCIA                   ;METROPOLITANA;0;0;0;0;0;0;0;0;0;Batidora Pedestal B5300 Inox;ELECTRODOMESTICOS
13020416;;M;46;CHILENO;;X;COIHAIQUE                     ;AYSEN;0;0;0;0;0;0;0;0;0;Aspiradora AP1700 Arrastre 1700Watts;ELECTRODOMESTICOS
12730924;Casado;F;46;CHILENO;;X;PROVIDENCIA                   ;METROPOLITANA;0;0;0;0;0;0;0;0;0;Horno Electrico TH-38N 38Lts;ELECTRODOMESTICOS
6899760;;M;69;CHILENO;;Silencioso;PROVIDENCIA                   ;METROPOLITANA;0;0;0;0;0;0;0;0;0;Licuadora TH-501V 1,5Lts Vaso Vidrio;ELECTRODOMESTICOS
12843204;Soltero;M;47;CHILENO;ABOGADO;X;RENCA                         ;METROPOLITANA;0;0;0;0;0;0;0;0;0;Horno Microondas Digital TH-25DM 25Lts;ELECTRODOMESTICOS
19588727;;F;25;CHILENO;;Z;PROVIDENCIA                   ;METROPOLITANA;0;0;0;0;0;0;0;0;0;Licuadora Roja 550W 1,5Lts Vaso Vidrio;ELECTRODOMESTICOS
18802942;;M;28;CHILENO;;Millenial;PROVIDENCIA                   ;METROPOLITANA;0;0;0;0;0;0;0;0;0;MAQ. DE COSER REMINGTON STF16;ELECTRODOMESTICOS
9350371;;M;59;CHILENO;;Boomers;RENCA                         ;METROPOLITANA;0;0;0;0;0;0;0;0;0;Aspiradora Handy Clean Black 1400;ELECTRODOMESTICOS
7298437;;F;68;CHILENO;;Silencioso;PROVIDENCIA                   ;METROPOLITANA;0;0;0;0;0;0;0;0;0;Batidora Manual UT-TEKLA300;ELECTRODOMESTICOS
24480281;;M;30;BOLIVIANO;;Extranjero;CALAMA                        ;ANTOFAGASTA;0;0;0;0;0;0;0;0;0;Licuadora TH-320 Roja/Negro 1,5 Lts Vaso Vidrio;ELECTRODOMESTICOS
17754808;;M;31;CHILENO;;Millenial;TOCOPILLA                     ;ANTOFAGASTA;0;0;0;0;0;0;0;0;0;Horno Electrico TH-38N 38Lts;ELECTRODOMESTICOS
9916134;;M;54;CHILENO;;X;PENAFLOR                      ;METROPOLITANA;0;0;0;0;0;0;0;0;0;Horno Electrico TH-38N 38Lts;ELECTRODOMESTICOS
7694244;Casado;F;63;CHILENO;PSICOLOGA;Boomers;RENCA                         ;METROPOLITANA;0;0;0;0;0;0;0;0;0;Licuadora L2000VNG 1,5Lts Vaso Vidrio;ELECTRODOMESTICOS
18083882;Soltero;M;29;CHILENO;;Millenial;PROVIDENCIA                   ;METROPOLITANA;0;0;0;0;0;0;0;0;0;LICUADORA BLANCA CON ROTOR 1,5LTS;ELECTRODOMESTICOS
26554338;;F;31;EXTRANJERO - NO INFORMA NACIONALIDAD;;Extranjero;N/D;N/D;0;0;0;0;0;0;0;0;0;Batidora Manual UT-TEKLA300;ELECTRODOMESTICOS
18620266;Soltero;M;28;CHILENO;;Millenial;CARAHUE                       ;ARAUCANIA;0;0;0;0;0;0;0;0;0;Batidora Vertical Minipimer UT-KLOT800SS;ELECTRODOMESTICOS
18688868;Casado;F;31;CHILENO;;Millenial;PROVIDENCIA                   ;METROPOLITANA;0;0;0;0;0;0;0;0;0;Hervidor Electrico TH-4212N 1,7Lts Negro;ELECTRODOMESTICOS
10311101;;F;58;CHILENO;;Boomers;PARRAL                        ;MAULE;0;0;0;0;0;0;0;0;0;Aspiradora UT-SILENT1804 Arrastre 1800Watts;ELECTRODOMESTICOS
10063858;Casado;F;53;CHILENO;;X;PROVIDENCIA                   ;METROPOLITANA;0;0;0;0;0;0;0;0;0;Picadora TH-9020V Vaso Vidrio 2Lts;ELECTRODOMESTICOS
18149111;Soltero;M;30;CHILENO;TECNICO EN CONSTRUCCION;Millenial;PROVIDENCIA                   ;METROPOLITANA;0;0;0;0;0;0;0;0;0;Hervidor Electrico UT-DUNKEL17P 2Lts Negro;ELECTRODOMESTICOS
17792337;;M;31;CHILENO;;Millenial;PROVIDENCIA                   ;METROPOLITANA;0;0;0;0;0;0;0;0;0;PARRILLA ELECTRICA UT-ECOKERAMIK;ELECTRODOMESTICOS
15381088;;M;39;CHILENO;;X;PROVIDENCIA                   ;METROPOLITANA;0;0;0;0;0;0;0;0;0;MICROONDAS ME83X/XZS SAMSUNG MIRROR;ELECTRODOMESTICOS
13107231;;F;45;CHILENO;;X;TALCAHUANO                    ;BIO BIO;0;0;0;0;0;0;0;0;0;Robot aspirador Roomba 675;ELECTRODOMESTICOS
15311204;Soltero;M;40;CHILENO;INGENIERO INFORMATICO;X;PROVIDENCIA                   ;METROPOLITANA;0;0;0;0;0;0;0;0;0;Horno Microondas Digital Deli (2017 DM) 20Lts;ELECTRODOMESTICOS
19548365;;F;25;CHILENO;;Z;PROVIDENCIA                   ;METROPOLITANA;0;0;0;0;0;0;0;0;0;Licuadora/Exprimidora 58149-CL 1,5Lts Vaso Vidri;ELECTRODOMESTICOS
6447748;Casado;F;65;CHILENO;ENFERMERA;Boomers;PROVIDENCIA                   ;METROPOLITANA;0;0;0;0;0;0;0;0;0;Horno Electrico UT-BACKOFEN26 26Lts;ELECTRODOMESTICOS
9409464;;F;59;CHILENO;;Boomers;SAN ANTONIO                   ;VALPARAISO;0;0;0;0;0;0;0;0;0;Horno Electrico TH-80i 80Lts;ELECTRODOMESTICOS
8912478;;F;61;CHILENO;;Boomers;RENCA                         ;METROPOLITANA;0;0;0;0;0;0;0;0;0;Licuadora TH-320 Roja/Negro 1,5 Lts Vaso Vidrio;ELECTRODOMESTICOS
8808322;Casado;F;62;CHILENO;;Boomers;RENCA                         ;METROPOLITANA;0;0;0;0;0;0;0;0;0;Hervidor Electrico Tetera UT-LECKER18R 1,8Lts;ELECTRODOMESTICOS
18479246;;F;29;CHILENO;;Millenial;PUENTE ALTO                   ;METROPOLITANA;0;0;0;0;0;0;0;0;0;Set Picador KP-123BL 1,2Lts;ELECTRODOMESTICOS
16204384;;F;36;CHILENO;;Millenial;PROVIDENCIA                   ;METROPOLITANA;0;0;0;0;0;0;0;0;0;Licuadora TH-501V 1,5Lts Vaso Vidrio;ELECTRODOMESTICOS
19215665;Soltero;M;25;CHILENO;;Z;PROVIDENCIA                   ;METROPOLITANA;0;0;0;0;0;0;0;0;0;Hervidor 41020-CL 1,7Lts Inox;ELECTRODOMESTICOS
18688027;;F;29;CHILENO;;Millenial;OVALLE                        ;COQUIMBO;0;0;0;0;0;0;0;0;0;Hervidor Electrico TH-4515N 2Lts Negro;ELECTRODOMESTICOS
10084245;;F;57;CHILENO;;Boomers;N/D;N/D;0;0;0;0;0;0;0;0;0;Hervidor Electrico UT-MANLY17 1,7Lts Negro;ELECTRODOMESTICOS
13721588;Casado;F;43;CHILENO;;X;SAN VICENTE                   ;L.G.B.OÂ´HIGGINS;0;0;0;0;0;0;0;0;0;Hervidor Electrico Tetera UT-LECKER18R 1,8Lts;ELECTRODOMESTICOS
9263600;;F;58;CHILENO;;Boomers;PUTAENDO                      ;VALPARAISO;0;0;0;0;0;0;0;0;0;Hervidor Electrico HA-3300 2,5Lts Blanco;ELECTRODOMESTICOS
10559911;;F;53;CHILENO;;X;SANTIAGO                      ;METROPOLITANA;0;0;0;0;0;0;0;0;0;Licuadora UT-METALLEK505P 1,5Lts Vaso Vidrio;ELECTRODOMESTICOS
18343069;Soltero;F;29;CHILENO;FONOAUDIOLOGO;Millenial;PROVIDENCIA                   ;METROPOLITANA;0;0;0;0;0;0;0;0;0;Horno Electrico TH-48N 48Lts;ELECTRODOMESTICOS
13019896;Divorciado;M;46;CHILENO;;X;PROVIDENCIA                   ;METROPOLITANA;0;0;0;0;0;0;0;0;0;Extractor de Jugo de giro lento EXL-200RJ;ELECTRODOMESTICOS
11444440;Casado;M;53;CHILENO;;X;PROVIDENCIA                   ;METROPOLITANA;0;0;0;0;0;0;0;0;0;Batidora Vertical Stick Mixer 2609;ELECTRODOMESTICOS
6253161;;M;70;CHILENO;;Silencioso;PROVIDENCIA                   ;METROPOLITANA;0;0;0;0;0;0;0;0;0;Procesador TH-9010 Multimixer 1,5Lts Vaso Vidrio;ELECTRODOMESTICOS
6709068;Soltero;F;69;CHILENO;;Silencioso;RENCA                         ;METROPOLITANA;0;0;0;0;0;0;0;0;0;Extractor de Jugo EX800 1,4Lts;ELECTRODOMESTICOS
14343072;;F;45;CHILENO;;X;RENCA                         ;METROPOLITANA;0;0;0;0;0;0;0;0;0;Hervidor Electrico TH-4515N 2Lts Negro;ELECTRODOMESTICOS
7861244;;M;66;CHILENO;;Boomers;PROVIDENCIA                   ;METROPOLITANA;0;0;0;0;0;0;0;0;0;Horno Microondas Mecanico TH-18B05 18Lts;ELECTRODOMESTICOS
12229592;;F;50;CHILENO;;X;RENCA                         ;METROPOLITANA;0;0;0;0;0;0;0;0;0;Horno Electrico TH-48N 48Lts;ELECTRODOMESTICOS
14516004;Soltero;F;50;CHILENO;;X;RENCA                         ;METROPOLITANA;0;0;0;0;0;0;0;0;0;Licuadora UT-METALLEK505P 1,5Lts Vaso Vidrio;ELECTRODOMESTICOS
13644315;;M;43;CHILENO;;X;ANTOFAGASTA                   ;ANTOFAGASTA;0;0;0;0;0;0;0;0;0;Plancha UT-SHANGRILA Inalambrica 2200Watss;ELECTRODOMESTICOS
8192515;;F;62;CHILENO;;Boomers;RENCA                         ;METROPOLITANA;0;0;0;0;0;0;0;0;0;Tostador de PanTH-120R 2 Rebanadas Rojo;ELECTRODOMESTICOS
11329626;;F;54;CHILENO;;X;VALDIVIA                      ;LOS RIOS;0;0;0;0;0;0;0;0;0;Hervidor Electrico HA-3300 2,5Lts Blanco;ELECTRODOMESTICOS
10089968;Casado;F;57;CHILENO;;Boomers;RENCA                         ;METROPOLITANA;0;0;0;0;0;0;0;0;0;Picadora UT-PETRUS320 1Lts Vaso Vidrio;ELECTRODOMESTICOS
8988923;;M;66;CHILENO;;Boomers;RENCA                         ;METROPOLITANA;0;0;0;0;0;0;0;0;0;Horno Electrico TH-48N 48Lts;ELECTRODOMESTICOS
8359387;;M;62;CHILENO;;Boomers;RENCA                         ;METROPOLITANA;0;0;0;0;0;0;0;0;0;Plancha TH-7052 2000Watts Base Inox;ELECTRODOMESTICOS
15404463;;M;50;CHILENO;;X;RENCA                         ;METROPOLITANA;0;0;0;0;0;0;0;0;0;Horno Microondas Mecanico TH-18B05 18Lts;ELECTRODOMESTICOS
16649562;;M;34;CHILENO;;Millenial;LEBU                          ;BIO BIO;0;0;0;0;0;0;0;0;0;Aspiradora UT-SILENT1603 Arrastre 1600Watts;ELECTRODOMESTICOS
15716105;;M;38;CHILENO;;X;PROVIDENCIA                   ;METROPOLITANA;0;0;0;0;0;0;0;0;0;Horno Electrico TH-38N 38Lts;ELECTRODOMESTICOS
17166697;;F;33;CHILENO;;Millenial;RANCAGUA                      ;L.G.B.OÂ´HIGGINS;0;0;0;0;0;0;0;0;0;Horno Microondas Mecanico C1700N 17Lts Blanco;ELECTRODOMESTICOS
13477452;;M;44;CHILENO;;X;PUENTE ALTO                   ;METROPOLITANA;0;0;0;0;0;0;0;0;0;ASPIRADORA THOMAS TH-1640;ELECTRODOMESTICOS
13975754;Soltero;M;41;CHILENO;;X;RENCA                         ;METROPOLITANA;0;0;0;0;0;0;0;0;0;Horno Microondas Digital UT-CLASSY720 20Lts;ELECTRODOMESTICOS
10267832;;F;56;CHILENO;;Boomers;RENCA                         ;METROPOLITANA;0;0;0;0;0;0;0;0;0;Horno Microondas Digital TH-20S01 20Lts;ELECTRODOMESTICOS
18786009;;F;30;CHILENO;;Millenial;SAN VICENTE                   ;L.G.B.OÂ´HIGGINS;0;0;0;0;0;0;0;0;0;Parrilla Electrica TH-180;ELECTRODOMESTICOS
9214683;;F;49;CHILENO;;X;RENCA                         ;METROPOLITANA;0;0;0;0;0;0;0;0;0;Plancha UT-KERAMIK1 2200Watts Base Ceramica;ELECTRODOMESTICOS
19210425;Soltero;M;26;CHILENO;;Z;PROVIDENCIA                   ;METROPOLITANA;0;0;0;0;0;0;0;0;0;Horno Microondas Mecanico UT-SYDNEY18 18Lts;ELECTRODOMESTICOS
6317493;Casado;M;72;CHILENO;PROFESOR;Silencioso;RENCA                         ;METROPOLITANA;0;0;0;0;0;0;0;0;0;Horno Microondas Mecanico UT-SYDNEY18 18Lts;ELECTRODOMESTICOS
13844087;Casado;M;42;CHILENO;TECNICO;X;PROVIDENCIA                   ;METROPOLITANA;0;0;0;0;0;0;0;0;0;Aspiradora Roomba 621;ELECTRODOMESTICOS
18604600;;F;28;CHILENO;;Millenial;PROVIDENCIA                   ;METROPOLITANA;0;0;0;0;0;0;0;0;0;Horno Microondas Mecanico C1700N 17Lts Blanco;ELECTRODOMESTICOS
7430217;Soltero;M;67;CHILENO;;Boomers;PROVIDENCIA                   ;METROPOLITANA;0;0;0;0;0;0;0;0;0;Hervidor Electrico HA-3300 2,5Lts Blanco;ELECTRODOMESTICOS
13278287;;M;45;CHILENO;;X;PROVIDENCIA                   ;METROPOLITANA;0;0;0;0;0;0;0;0;0;Horno Electrico TH-48N 48Lts;ELECTRODOMESTICOS
12520185;;F;49;CHILENO;;X;TALCA                         ;MAULE;0;0;0;0;0;0;0;0;0;Hervidor Electrico TH-4212N 1,7Lts Negro;ELECTRODOMESTICOS
15419464;;M;40;CHILENO;;X;RENCA                         ;METROPOLITANA;0;0;0;0;0;0;0;0;0;Licuadora Roja 550W 1,5Lts Vaso Vidrio;ELECTRODOMESTICOS
9831078;;M;59;CHILENO;;Boomers;N/D;N/D;0;0;0;0;0;0;0;0;0;Picadora UT-PETRUS320 1Lts Vaso Vidrio;ELECTRODOMESTICOS
15202565;;F;40;CHILENO;;X;RENCA                         ;METROPOLITANA;0;0;0;0;0;0;0;0;0;Horno Electrico UT-BACKOFEN48 48Lts;ELECTRODOMESTICOS
12702229;;M;48;CHILENO;;X;PROVIDENCIA                   ;METROPOLITANA;0;0;0;0;0;0;0;0;0;Hervidor Electrico UT-MANLY17 1,7Lts Negro;ELECTRODOMESTICOS
13570835;Casado;M;42;CHILENO;;X;PROVIDENCIA                   ;METROPOLITANA;0;0;0;0;0;0;0;0;0;Batidora Manual 2532;ELECTRODOMESTICOS
20055158;;F;23;CHILENO;;Millenial;N/D;N/D;0;0;0;0;0;0;0;0;0;Horno Microondas Digital UT-CLASSY720 20Lts;ELECTRODOMESTICOS
7582812;Casado;M;67;CHILENO;;Boomers;PROVIDENCIA                   ;METROPOLITANA;0;0;0;0;0;0;0;0;0;Hervidor Electrico 3100 1,7Lts Negro;ELECTRODOMESTICOS
15105759;;F;36;CHILENO;;Millenial;RANCAGUA                      ;L.G.B.OÂ´HIGGINS;0;0;0;0;0;0;0;0;0;Picadora TH-9005 1Lts Vaso Vidrio;ELECTRODOMESTICOS
18926338;;M;27;CHILENO;;Millenial;PROVIDENCIA                   ;METROPOLITANA;0;0;0;0;0;0;0;0;0;MOPA A VAPOR SINDELEN MV-1305 GR;ELECTRODOMESTICOS
15832549;;F;38;CHILENO;;X;PROVIDENCIA                   ;METROPOLITANA;0;0;0;0;0;0;0;0;0;Picadora TH-9020V Vaso Vidrio 2Lts;ELECTRODOMESTICOS
10846791;;F;55;CHILENO;;Boomers;VALPARAISO                    ;VALPARAISO;0;0;0;0;0;0;0;0;0;Maquina de Coser ST-371HD Heavy Duty;ELECTRODOMESTICOS
8723228;;M;61;CHILENO;;Boomers;RENCA                         ;METROPOLITANA;0;0;0;0;0;0;0;0;0;Aspiradora TH1415 Arrastre 1500Watts;ELECTRODOMESTICOS
10317579;;F;56;CHILENO;;Boomers;PROVIDENCIA                   ;METROPOLITANA;0;0;0;0;0;0;0;0;0;Licuadora TH-320 Roja/Negro 1,5 Lts Vaso Vidrio;ELECTRODOMESTICOS
17970911;;F;31;CHILENO;;Millenial;SAN FELIPE                    ;VALPARAISO;0;0;0;0;0;0;0;0;0;Hervidor Electrico TH-5407i 2Lts;ELECTRODOMESTICOS
7140845;Casado;M;67;CHILENO;INGENIERO;Boomers;MELIPILLA                     ;METROPOLITANA;0;0;0;0;0;0;0;0;0;Hervidor Electrico UT-DUNKEL17P 2Lts Negro;ELECTRODOMESTICOS
15902951;;F;37;CHILENO;;Millenial;PROVIDENCIA                   ;METROPOLITANA;0;0;0;0;0;0;0;0;0;Batidora Pedestal B5300 Inox;ELECTRODOMESTICOS
7733831;;F;67;CHILENO;;Boomers;MONTE PATRIA                  ;COQUIMBO;0;0;0;0;0;0;0;0;0;Maquina de coser computarizada 60 puntadas SH660;ELECTRODOMESTICOS
10007115;;F;57;CHILENO;;Boomers;CALAMA                        ;ANTOFAGASTA;0;0;0;0;0;0;0;0;0;Batidora Pedestal UT-KLEIN700;ELECTRODOMESTICOS
12779324;;M;47;CHILENO;;X;SAN FERNANDO                  ;L.G.B.OÂ´HIGGINS;0;0;0;0;0;0;0;0;0;Plancha V-2300 1950Watts Base Inox;ELECTRODOMESTICOS
9260685;;M;59;CHILENO;;Boomers;ANTOFAGASTA                   ;ANTOFAGASTA;0;0;0;0;0;0;0;0;0;Plancha THOMAS TH-7170 2200Watts Base Ceramica;ELECTRODOMESTICOS
6073930;;F;78;CHILENO;;Silencioso;RENCA                         ;METROPOLITANA;0;0;0;0;0;0;0;0;0;Plancha TH-7052 2000Watts Base Inox;ELECTRODOMESTICOS
17172116;Soltero;M;33;CHILENO;PSICOLOGO;Millenial;PROVIDENCIA                   ;METROPOLITANA;0;0;0;0;0;0;0;0;0;Extractor de Jugo EX800 1,4Lts;ELECTRODOMESTICOS
15555326;;F;39;CHILENO;;X;PROVIDENCIA                   ;METROPOLITANA;0;0;0;0;0;0;0;0;0;Licuadora TH-501V 1,5Lts Vaso Vidrio;ELECTRODOMESTICOS
11944781;;F;49;CHILENO;;X;PROVIDENCIA                   ;METROPOLITANA;0;0;0;0;0;0;0;0;0;Hervidor Electrico UT-MANLY17 1,7Lts Negro;ELECTRODOMESTICOS
9819668;;M;57;CHILENO;;Boomers;HUASCO                        ;ATACAMA;0;0;0;0;0;0;0;0;0;Plancha Paninis 2880;ELECTRODOMESTICOS
18296057;;M;29;CHILENO;;Millenial;PUERTO MONTT                  ;LOS LAGOS;0;0;0;0;0;0;0;0;0;Horno Electrico TH-38N 38Lts;ELECTRODOMESTICOS
16440251;Soltero;M;36;CHILENO;;Millenial;PROVIDENCIA                   ;METROPOLITANA;0;0;0;0;0;0;0;0;0;Hervidor Electrico UT-DUNKEL17P 2Lts Negro;ELECTRODOMESTICOS
5884773;Soltero;F;72;CHILENO;;Silencioso;PROVIDENCIA                   ;METROPOLITANA;0;0;0;0;0;0;0;0;0;Exprimidor de Jugo CJ-2000 1Lts;ELECTRODOMESTICOS
19897108;;F;23;CHILENO;;Z;PROVIDENCIA                   ;METROPOLITANA;0;0;0;0;0;0;0;0;0;Batidora Vertical BM-450 Negra;ELECTRODOMESTICOS
17566783;;M;32;CHILENO;;Millenial;PROVIDENCIA                   ;METROPOLITANA;0;0;0;0;0;0;0;0;0;Batidora Pedestal TH910PN 4,6Lts 1300Watts;ELECTRODOMESTICOS
15876310;;F;37;CHILENO;;Millenial;CHILLAN                       ;BIO BIO;0;0;0;0;0;0;0;0;0;Horno Electrico TH-48N 48Lts;ELECTRODOMESTICOS
7887692;;F;65;CHILENO;;Boomers;MELIPILLA                     ;METROPOLITANA;0;0;0;0;0;0;0;0;0;Horno Electrico UT-LEIF36 36Lts;ELECTRODOMESTICOS
10606152;Casado;M;52;CHILENO;;X;PROVIDENCIA                   ;METROPOLITANA;0;0;0;0;0;0;0;0;0;Horno Electrico UT-BACKOFEN38 38Lts;ELECTRODOMESTICOS
10156030;;F;59;CHILENO;;Boomers;RENCA                         ;METROPOLITANA;0;0;0;0;0;0;0;0;0;Licuadora TH-320 Roja/Negro 1,5 Lts Vaso Vidrio;ELECTRODOMESTICOS
5910769;;F;77;CHILENO;;Silencioso;RENCA                         ;METROPOLITANA;0;0;0;0;0;0;0;0;0;Horno Electrico TH-25N01 25Lts;ELECTRODOMESTICOS
24505877;;M;31;PERUANO;;Extranjero;CALAMA                        ;ANTOFAGASTA;0;0;0;0;0;0;0;0;0;Horno Microondas Mecanico Easy Wave 20Lts;ELECTRODOMESTICOS
18873137;;F;27;CHILENO;;Millenial;SAN PEDRO DE LA PAZ           ;BIO BIO;0;0;0;0;0;0;0;0;0;Licuadora L2000VNG 1,5Lts Vaso Vidrio;ELECTRODOMESTICOS
17820706;Soltero;M;31;CHILENO;;Millenial;PROVIDENCIA                   ;METROPOLITANA;0;0;0;0;0;0;0;0;0;Licuadora L-1630V Negra 1,5Lts Vaso Vidrio;ELECTRODOMESTICOS
26471866;;F;30;VENEZOLANO;;Extranjero;SAN FELIPE                    ;VALPARAISO;0;0;0;0;0;0;0;0;0;Batidora Vertical Multimixer TH-8720;ELECTRODOMESTICOS
7200122;Casado;M;65;CHILENO;;Boomers;LA CISTERNA                   ;METROPOLITANA;0;0;0;0;0;0;0;0;0;Horno Microondas Digital L UT-25KROMM 25Lts;ELECTRODOMESTICOS
10920334;;F;53;CHILENO;;X;PROVIDENCIA                   ;METROPOLITANA;0;0;0;0;0;0;0;0;0;Aspiradora UT-MEINER1803 Arrastre 1800Watts;ELECTRODOMESTICOS
18445354;Casado;M;34;CHILENO;;Millenial;CHIGUAYANTE                   ;BIO BIO;0;0;0;0;0;0;0;0;0;Horno Electrico TH62I 60Lts;ELECTRODOMESTICOS
14406778;;F;58;CHILENO;;Boomers;LA SERENA                     ;COQUIMBO;0;0;0;0;0;0;0;0;0;Exprimidor de Jugo CJ-2000 1Lts;ELECTRODOMESTICOS
13749555;;F;46;CHILENO;;X;ILLAPEL                       ;COQUIMBO;0;0;0;0;0;0;0;0;0;Batidora Pedestal UT-KLEIN700;ELECTRODOMESTICOS
15565640;Casado;F;38;CHILENO;ADMINISTRADOR PUBLICO;X;PROVIDENCIA                   ;METROPOLITANA;0;0;0;0;0;0;0;0;0;Aspiradora Handy Clean Black 1400;ELECTRODOMESTICOS
12701570;Casado;M;47;CHILENO;;X;RENCA                         ;METROPOLITANA;0;0;0;0;0;0;0;0;0;Horno Electrico UT-LEIF36 36Lts;ELECTRODOMESTICOS
17201549;;F;32;CHILENO;;Millenial;N/D;N/D;0;0;0;0;0;0;0;0;0;Tostador de PanTH-120R 2 Rebanadas Rojo;ELECTRODOMESTICOS
15999927;;F;38;CHILENO;;Millenial;LA LIGUA                      ;VALPARAISO;0;0;0;0;0;0;0;0;0;Licuadora L2000VNG 1,5Lts Vaso Vidrio;ELECTRODOMESTICOS
11757420;Casado;M;51;CHILENO;;X;RENCA                         ;METROPOLITANA;0;0;0;0;0;0;0;0;0;Hervidor Electrico UT-MANLY17 1,7Lts Negro;ELECTRODOMESTICOS
20095411;;M;23;CHILENO;;Z;PROVIDENCIA                   ;METROPOLITANA;0;0;0;0;0;0;0;0;0;Batidora Pedestal TH910PN 4,6Lts 1300Watts;ELECTRODOMESTICOS
16836589;Soltero;F;34;CHILENO;;Millenial;PROVIDENCIA                   ;METROPOLITANA;0;0;0;0;0;0;0;0;0;Batidora Manual TH-8830;ELECTRODOMESTICOS
5479071;;F;72;CHILENO;;Silencioso;LA CISTERNA                   ;METROPOLITANA;0;0;0;0;0;0;0;0;0;Hervidor Electrico TH-4800 2Lts Negro Azul;ELECTRODOMESTICOS
8028399;;F;67;CHILENO;;Boomers;RENCA                         ;METROPOLITANA;0;0;0;0;0;0;0;0;0;Cafetera P65 Silver;ELECTRODOMESTICOS
7876691;;M;63;CHILENO;;Boomers;PROVIDENCIA                   ;METROPOLITANA;0;0;0;0;0;0;0;0;0;Licuadora TH-501V 1,5Lts Vaso Vidrio;ELECTRODOMESTICOS
18162539;Soltero;F;29;CHILENO;;Millenial;PROVIDENCIA                   ;METROPOLITANA;0;0;0;0;0;0;0;0;0;Hervidor Electrico UT-DUNKEL17P 2Lts Negro;ELECTRODOMESTICOS
18225067;;F;30;CHILENO;;Millenial;PROVIDENCIA                   ;METROPOLITANA;0;0;0;0;0;0;0;0;0;Combo Hervidor + Batidora;ELECTRODOMESTICOS
19129366;Soltero;F;25;CHILENO;;Z;TENO;MAULE;0;0;0;0;0;0;0;0;0;Licuadora TH-501V 1,5Lts Vaso Vidrio;ELECTRODOMESTICOS
13332087;Soltero;M;43;CHILENO;;X;CONCON                        ;VALPARAISO;0;0;0;0;0;0;0;0;0;Licuadora UT-METALLEK605P 1,55Lts;ELECTRODOMESTICOS
14567017;;F;47;CHILENO;;X;RENCA                         ;METROPOLITANA;0;0;0;0;0;0;0;0;0;Horno Microondas Digital TH-20S01 20Lts;ELECTRODOMESTICOS
10102292;;F;49;CHILENO;;X;CAUQUENES                     ;MAULE;0;0;0;0;0;0;0;0;0;Tostador de PanTH-120R 2 Rebanadas Rojo;ELECTRODOMESTICOS
17171584;Soltero;F;33;CHILENO;ENFERMERA;Millenial;PROVIDENCIA                   ;METROPOLITANA;0;0;0;0;0;0;0;0;0;Horno Microondas Mecanico Easy Wave 20Lts;ELECTRODOMESTICOS
20041949;;F;23;CHILENO;;Millenial;N/D;N/D;0;0;0;0;0;0;0;0;0;Licuadora TH-501V 1,5Lts Vaso Vidrio;ELECTRODOMESTICOS
19351318;;M;25;CHILENO;;Z;PROVIDENCIA                   ;METROPOLITANA;0;0;0;0;0;0;0;0;0;Licuadora L-1630V Negra 1,5Lts Vaso Vidrio;ELECTRODOMESTICOS
10283735;Casado;M;55;CHILENO;CONTADOR GENERAL;Boomers;RENCA                         ;METROPOLITANA;0;0;0;0;0;0;0;0;0;Horno Microondas Digital UT-CLASSY720 20Lts;ELECTRODOMESTICOS
9581761;Casado;M;58;CHILENO;;Boomers;PROVIDENCIA                   ;METROPOLITANA;0;0;0;0;0;0;0;0;0;Aspiradora GT2000 PRO 1250 watts;ELECTRODOMESTICOS
18094135;Soltero;F;30;CHILENO;;Millenial;RENCA                         ;METROPOLITANA;0;0;0;0;0;0;0;0;0;Horno Microondas Mecanico Easy Wave 20Lts;ELECTRODOMESTICOS
12447579;Casado;F;48;CHILENO;;X;PROVIDENCIA                   ;METROPOLITANA;0;0;0;0;0;0;0;0;0;Licuadora TH-401V Roja 1,75Lts Vaso Vidrio;ELECTRODOMESTICOS
11513333;Casado;F;52;CHILENO;;X;RENCA                         ;METROPOLITANA;0;0;0;0;0;0;0;0;0;Hervidor Electrico 388R Rojo;ELECTRODOMESTICOS
10434801;;F;57;CHILENO;;Boomers;N/D;N/D;0;0;0;0;0;0;0;0;0;Batidora Vertical Minipimer UT-KLOT400P;ELECTRODOMESTICOS
8020590;;F;64;CHILENO;;Boomers;PROVIDENCIA                   ;METROPOLITANA;0;0;0;0;0;0;0;0;0;Procesador TH-9010 Multimixer 1,5Lts Vaso Vidrio;ELECTRODOMESTICOS
16828427;;F;34;CHILENO;;Millenial;CHEPICA                       ;L.G.B.OÂ´HIGGINS;0;0;0;0;0;0;0;0;0;Horno Microondas Digital TH-20S01 20Lts;ELECTRODOMESTICOS
11181748;;F;57;CHILENO;;Boomers;COMBARBALA                    ;COQUIMBO;0;0;0;0;0;0;0;0;0;Batidora Manual BA-5010 Inox;ELECTRODOMESTICOS
10107646;;F;56;CHILENO;;Boomers;PROVIDENCIA                   ;METROPOLITANA;0;0;0;0;0;0;0;0;0;Licuadora TH-501V 1,5Lts Vaso Vidrio;ELECTRODOMESTICOS
10380864;Casado;F;56;CHILENO;;Boomers;RENCA                         ;METROPOLITANA;0;0;0;0;0;0;0;0;0;Licuadora L-1630V Negra 1,5Lts Vaso Vidrio;ELECTRODOMESTICOS
8072463;Soltero;F;61;CHILENO;;Boomers;RENCA                         ;METROPOLITANA;0;0;0;0;0;0;0;0;0;Aspiradora Handy Clean Black 1400;ELECTRODOMESTICOS
8984414;;F;64;CHILENO;;Boomers;RENCA                         ;METROPOLITANA;0;0;0;0;0;0;0;0;0;ASPIRADORA THOMAS TH-1640;ELECTRODOMESTICOS
26253388;;M;30;VENEZOLANO;;Extranjero;INDEPENDENCIA                 ;METROPOLITANA;0;0;0;0;0;0;0;0;0;Horno Microondas Digital ME0113MB1/XZS 32Lts;ELECTRODOMESTICOS
14052097;;M;41;CHILENO;;X;N/D;N/D;0;0;0;0;0;0;0;0;0;Hervidor Electrico TH-4515N 2Lts Negro;ELECTRODOMESTICOS
12546428;Casado;F;48;CHILENO;;X;RENCA                         ;METROPOLITANA;0;0;0;0;0;0;0;0;0;Horno Electrico UT-BACKOFEN26 26Lts;ELECTRODOMESTICOS
10996223;;M;42;CHILENO;;X;PARRAL                        ;MAULE;0;0;0;0;0;0;0;0;0;Tostador de Pan TH-126 4 Rebanadas Negro;ELECTRODOMESTICOS
19466889;;F;25;CHILENO;;Z;PROVIDENCIA                   ;METROPOLITANA;0;0;0;0;0;0;0;0;0;Maquina de coser Computarizada Computer Friend R;ELECTRODOMESTICOS
19486397;;M;25;CHILENO;;Z;PROVIDENCIA                   ;METROPOLITANA;0;0;0;0;0;0;0;0;0;Horno Microondas Mecanico M-2030 NG 20Lts;ELECTRODOMESTICOS
9422534;;F;56;CHILENO;;Boomers;RENCA                         ;METROPOLITANA;0;0;0;0;0;0;0;0;0;Maquina de Coser ST-371HD Heavy Duty;ELECTRODOMESTICOS
6923152;;F;70;CHILENO;;Silencioso;RENCA                         ;METROPOLITANA;0;0;0;0;0;0;0;0;0;Licuadora TH-320 Roja/Negro 1,5 Lts Vaso Vidrio;ELECTRODOMESTICOS
16447169;;F;35;CHILENO;;Millenial;CHILLAN VIEJO                 ;BIO BIO;0;0;0;0;0;0;0;0;0;Hervidor Electrico TH-4515N 2Lts Negro;ELECTRODOMESTICOS
15119186;Soltero;M;39;CHILENO;KINESIOLOGO;X;PROVIDENCIA                   ;METROPOLITANA;0;0;0;0;0;0;0;0;0;Tostador de Pan TP-1400 4 Rebanadas Inox;ELECTRODOMESTICOS
16967162;Soltero;M;33;CHILENO;ENFERMERO;Millenial;PROVIDENCIA                   ;METROPOLITANA;0;0;0;0;0;0;0;0;0;Cafetera P65 Silver;ELECTRODOMESTICOS
14312711;;F;45;CHILENO;;X;VALPARAISO                    ;VALPARAISO;0;0;0;0;0;0;0;0;0;Hervidor Electrico TH-6200 R 1,7Lts Rojo;ELECTRODOMESTICOS
19006873;Casado;F;27;CHILENO;FONOAUDIOLOGO;Millenial;PROVIDENCIA                   ;METROPOLITANA;0;0;0;0;0;0;0;0;0;Hervidor Electrico UT-MANLY17 1,7Lts Negro;ELECTRODOMESTICOS
7865435;;F;63;CHILENO;;Boomers;SANTIAGO                      ;METROPOLITANA;0;0;0;0;0;0;0;0;0;Licuadora TH-320 Roja/Negro 1,5 Lts Vaso Vidrio;ELECTRODOMESTICOS
9361805;;F;61;CHILENO;;Boomers;TRAIGUEN                      ;ARAUCANIA;0;0;0;0;0;0;0;0;0;Tostador de Pan TH-116 2 Rebanadas Negro;ELECTRODOMESTICOS
17991454;;M;30;CHILENO;;Millenial;IQUIQUE                       ;TARAPACA;0;0;0;0;0;0;0;0;0;Horno Microondas Digital L UT-25KROMM 25Lts;ELECTRODOMESTICOS
14309196;;F;45;CHILENO;;X;N/D;N/D;0;0;0;0;0;0;0;0;0;Enceradora EA-5000;ELECTRODOMESTICOS
11940061;;M;49;CHILENO;;X;RENCA                         ;METROPOLITANA;0;0;0;0;0;0;0;0;0;Horno Electrico UT-BACKOFEN60 60Lts;ELECTRODOMESTICOS
14100480;;M;46;CHILENO;;X;RENCA                         ;METROPOLITANA;0;0;0;0;0;0;0;0;0;Horno Electrico TH-38N 38Lts;ELECTRODOMESTICOS
17518943;Soltero;M;32;CHILENO;INGENIERO EN PREVENCION DE RIESGOS;Millenial;PROVIDENCIA                   ;METROPOLITANA;0;0;0;0;0;0;0;0;0;Licuadora TH-501V 1,5Lts Vaso Vidrio;ELECTRODOMESTICOS
4856392;;F;79;CHILENO;;Silencioso;LA LIGUA                      ;VALPARAISO;0;0;0;0;0;0;0;0;0;Licuadora TH-320 Roja/Negro 1,5 Lts Vaso Vidrio;ELECTRODOMESTICOS
10287832;;M;64;CHILENO;;Boomers;CURICO                        ;MAULE;0;0;0;0;0;0;0;0;0;Horno Electrico TH62I 60Lts;ELECTRODOMESTICOS
17196824;Soltero;F;30;CHILENO;PROFESOR;Millenial;PROVIDENCIA                   ;METROPOLITANA;0;0;0;0;0;0;0;0;0;Plancha OSTER 4801T 1200Watts Base Ceramica;ELECTRODOMESTICOS
18163194;;F;29;CHILENO;;Millenial;N/D;N/D;0;0;0;0;0;0;0;0;0;CORTA FIAMBRES TH-9200;ELECTRODOMESTICOS
12371913;Casado;F;48;CHILENO;;X;RENCA                         ;METROPOLITANA;0;0;0;0;0;0;0;0;0;Hervidor Electrico UT-MANLY17 1,7Lts Negro;ELECTRODOMESTICOS
16597979;;F;34;CHILENO;;Millenial;ANGOL                         ;ARAUCANIA;0;0;0;0;0;0;0;0;0;Horno Microondas Mecanico TH-18B05 18Lts;ELECTRODOMESTICOS
14020429;;M;41;CHILENO;;X;RENCA                         ;METROPOLITANA;0;0;0;0;0;0;0;0;0;Batidora Vertical Multimixer TH-8720;ELECTRODOMESTICOS
18260357;;F;30;CHILENO;;Millenial;QUILLOTA                      ;VALPARAISO;0;0;0;0;0;0;0;0;0;Batidora Vertical Multimixer TH-8720;ELECTRODOMESTICOS
15146309;;M;42;CHILENO;;X;LINARES                       ;MAULE;0;0;0;0;0;0;0;0;0;Licuadora L-1630V Negra 1,5Lts Vaso Vidrio;ELECTRODOMESTICOS
7953767;;M;62;CHILENO;;Boomers;RENCA                         ;METROPOLITANA;0;0;0;0;0;0;0;0;0;Horno Electrico UT-BACKOFEN48 48Lts;ELECTRODOMESTICOS
10307749;;F;56;CHILENO;;Boomers;PROVIDENCIA                   ;METROPOLITANA;0;0;0;0;0;0;0;0;0;Aspiradora TH1870 Arrastre 1800Watts Gris;ELECTRODOMESTICOS
24499316;;F;45;ECUATORIANO;;Extranjero;ESTACION CENTRAL              ;METROPOLITANA;0;0;0;0;0;0;0;0;0;Hervidor Electrico TH-4515N 2Lts Negro;ELECTRODOMESTICOS
18057515;Soltero;F;31;CHILENO;RELACIONADOR PUBLICO;Millenial;PROVIDENCIA                   ;METROPOLITANA;0;0;0;0;0;0;0;0;0;Hervidor Termo TH-5440TK 1,5Lts Inox;ELECTRODOMESTICOS
16215264;;M;36;CHILENO;;Millenial;PROVIDENCIA                   ;METROPOLITANA;0;0;0;0;0;0;0;0;0;Hervidor Electrico TH-4212N 1,7Lts Negro;ELECTRODOMESTICOS
18008189;;M;30;CHILENO;;Millenial;N/D;N/D;0;0;0;0;0;0;0;0;0;Licuadora TH-401V Roja 1,75Lts Vaso Vidrio;ELECTRODOMESTICOS
8431769;Casado;F;53;CHILENO;;X;RENCA                         ;METROPOLITANA;0;0;0;0;0;0;0;0;0;Aspiradora TH1407 Arrastre 1400Watts;ELECTRODOMESTICOS
9294640;Casado;M;60;CHILENO;AGROINDUSTRIA;Boomers;RENCA                         ;METROPOLITANA;0;0;0;0;0;0;0;0;0;Horno Microondas Digital TH-20S01 20Lts;ELECTRODOMESTICOS
8670005;;M;48;CHILENO;;X;PROVIDENCIA                   ;METROPOLITANA;0;0;0;0;0;0;0;0;0;Hervidor Electrico UT-MANLY17 1,7Lts Negro;ELECTRODOMESTICOS
18262049;;F;29;CHILENO;;Millenial;N/D;N/D;0;0;0;0;0;0;0;0;0;Aspiradora UT-SILENT1804 Arrastre 1800Watts;ELECTRODOMESTICOS
12396388;Divorciado;F;49;CHILENO;;X;RENCA                         ;METROPOLITANA;0;0;0;0;0;0;0;0;0;Tostador de PanTH-120R 2 Rebanadas Rojo;ELECTRODOMESTICOS
6835150;Casado;F;68;CHILENO;;Silencioso;RENCA                         ;METROPOLITANA;0;0;0;0;0;0;0;0;0;Licuadora TH-320 Roja/Negro 1,5 Lts Vaso Vidrio;ELECTRODOMESTICOS
9450462;;F;59;CHILENO;;Boomers;PROVIDENCIA                   ;METROPOLITANA;0;0;0;0;0;0;0;0;0;Exprimidor de Jugo 407W 1Lts;ELECTRODOMESTICOS
11557501;;F;52;CHILENO;;X;ROMERAL                       ;MAULE;0;0;0;0;0;0;0;0;0;Horno Electrico TH-25N01 25Lts;ELECTRODOMESTICOS
9691504;;F;60;CHILENO;;Boomers;SANTA BARBARA                 ;BIO BIO;0;0;0;0;0;0;0;0;0;Hervidor Electrico UT-DUNKEL17P 2Lts Negro;ELECTRODOMESTICOS
13445162;Casado;F;44;CHILENO;QUIMICO FARMACEUTICO;X;RENCA                         ;METROPOLITANA;0;0;0;0;0;0;0;0;0;Combo Juguera + Hervidor;ELECTRODOMESTICOS
13742434;;M;42;CHILENO;;X;RENCA                         ;METROPOLITANA;0;0;0;0;0;0;0;0;0;Tostador de PanTH-120R 2 Rebanadas Rojo;ELECTRODOMESTICOS
20117249;;M;22;CHILENO;;Z;PROVIDENCIA                   ;METROPOLITANA;0;0;0;0;0;0;0;0;0;Horno Microondas Digital L UT-25KROMM 25Lts;ELECTRODOMESTICOS
26136965;;F;31;VENEZOLANO;;Extranjero;PUERTO MONTT                  ;LOS LAGOS;0;0;0;0;0;0;0;0;0;Horno Microondas Digital UT-CLASSY720 20Lts;ELECTRODOMESTICOS
13384725;;F;43;CHILENO;;X;RENCA                         ;METROPOLITANA;0;0;0;0;0;0;0;0;0;Tostador de PanTH-120R 2 Rebanadas Rojo;ELECTRODOMESTICOS
15117263;;F;40;CHILENO;;X;SAN FERNANDO                  ;L.G.B.OÂ´HIGGINS;0;0;0;0;0;0;0;0;0;Hervidor Electrico UT-DUNKEL17P 2Lts Negro;ELECTRODOMESTICOS
15490283;;M;39;CHILENO;;X;PROVIDENCIA                   ;METROPOLITANA;0;0;0;0;0;0;0;0;0;Aspiradora AP1700 Arrastre 1700Watts;ELECTRODOMESTICOS
19072203;;F;27;CHILENO;;Z;CHILLAN;BIO-BIO;0;0;0;0;0;0;0;0;0;Horno Electrico TH62I 60Lts;ELECTRODOMESTICOS
16258374;;M;35;CHILENO;;Millenial;RENCA                         ;METROPOLITANA;0;0;0;0;0;0;0;0;0;Aspiradora TH2220 Arrastre 2200Watts;ELECTRODOMESTICOS
6547230;;M;69;CHILENO;;Silencioso;PROVIDENCIA                   ;METROPOLITANA;0;0;0;0;0;0;0;0;0;Tostador de PanTH-120R 2 Rebanadas Rojo;ELECTRODOMESTICOS
7976184;;M;64;CHILENO;;Boomers;ARAUCO                        ;BIO BIO;0;0;0;0;0;0;0;0;0;Aspiradora UT-KRAFT(DIG) Arrastre 2200Watts;ELECTRODOMESTICOS
12292910;Casado;F;49;CHILENO;;X;RENCA                         ;METROPOLITANA;0;0;0;0;0;0;0;0;0;Cafetera Dolce Gusto Piccolo Red Nescafe;ELECTRODOMESTICOS
10389764;;F;44;CHILENO;;X;PROVIDENCIA                   ;METROPOLITANA;0;0;0;0;0;0;0;0;0;Cafetera Dolce Gusto MiniMeRedW Nescafe;ELECTRODOMESTICOS
18889183;Soltero;F;26;CHILENO;;Z;PROVIDENCIA                   ;METROPOLITANA;0;0;0;0;0;0;0;0;0;Hervidor Electrico UT-MANLY17 1,7Lts Negro;ELECTRODOMESTICOS
6999542;;M;66;CHILENO;;Boomers;ANCUD                         ;LOS LAGOS;0;0;0;0;0;0;0;0;0;Cafetera TH-138i;ELECTRODOMESTICOS
8387636;;F;62;CHILENO;;Boomers;N/D;N/D;0;0;0;0;0;0;0;0;0;Maquina de Coser 1412;ELECTRODOMESTICOS
19237846;;M;26;CHILENO;;Z;BUIN                          ;METROPOLITANA;0;0;0;0;0;0;0;0;0;Extractor de Jugo TH-2551 2Lts;ELECTRODOMESTICOS
9830371;;F;58;CHILENO;;Boomers;PROVIDENCIA                   ;METROPOLITANA;0;0;0;0;0;0;0;0;0;Maquina de Coser XB-2500CL Rosado;ELECTRODOMESTICOS
8714088;;M;69;CHILENO;;Silencioso;RENCA                         ;METROPOLITANA;0;0;0;0;0;0;0;0;0;Plancha TH-7052 2000Watts Base Inox;ELECTRODOMESTICOS
17965133;;F;31;CHILENO;;Millenial;LONCOCHE                      ;ARAUCANIA;0;0;0;0;0;0;0;0;0;Hervidor Electrico TH-4515N 2Lts Negro;ELECTRODOMESTICOS
7798747;Casado;F;61;CHILENO;;Boomers;RENCA                         ;METROPOLITANA;0;0;0;0;0;0;0;0;0;Aspiradora TH1870 Arrastre 1800Watts Gris;ELECTRODOMESTICOS
6941827;;F;70;CHILENO;;Silencioso;CURICO                        ;MAULE;0;0;0;0;0;0;0;0;0;Batidora Vertical Multimixer TH-8720;ELECTRODOMESTICOS
13531227;;M;43;CHILENO;;X;ILLAPEL                       ;COQUIMBO;414970;3;2;0;0;0;3;2;414970;PARLANTE ULTRASENSATION;ELECTRONICA MAYOR
20689992;;F;21;CHILENO;;Z;SANTA CRUZ;O HIGGINS;139990;1;1;0;0;0;1;1;139990;PARLANTE ULTRAFORCE-I;ELECTRONICA MAYOR
20349412;;F;22;CHILENO;;Z;PROVIDENCIA                   ;METROPOLITANA;107980;2;1;2;1;107980;0;0;0;LED 32 32PHD6825 HD SMART TV;ELECTRONICA MAYOR
13720266;;M;42;CHILENO;;X;COLTAUCO                      ;L.G.B.OÂ´HIGGINS;295980;2;1;0;0;0;2;1;295980;MINICOMPONENTE MX-T70/ZS ALL IN ONE;ELECTRONICA MAYOR
19464026;Soltero;M;25;CHILENO;TECNICO DE NIVEL MEDIO EN ALIMENTACION;Z;PROVIDENCIA                   ;METROPOLITANA;258940;2;1;0;0;0;2;1;258940;LED 43 43S5195 ROKU TV FHD;ELECTRONICA MAYOR
15249843;;F;38;CHILENO;;Millenial;PROVIDENCIA                   ;METROPOLITANA;113980;2;1;2;1;113980;0;0;0;LED 32 32PHD6825 HD SMART TV;ELECTRONICA MAYOR
13123974;;M;47;CHILENO;;X;COIHAIQUE                     ;AYSEN;1688910;9;6;0;0;0;9;6;1688910;LED 43 UN43T5202AGXZS FHD SMART TV;ELECTRONICA MAYOR
11688791;;M;52;CHILENO;;Z;ARICA                         ;ARICA Y PARINACOTA;84640;2;2;0;0;0;2;2;84640;PARLANTE SCREAMER 4;ELECTRONICA MAYOR
11955452;;M;50;CHILENO;;X;CONSTITUCION                  ;MAULE;579509;7;4;0;0;0;7;4;579509;LED 32 32PHD6825 HD SMART TV;ELECTRONICA MAYOR
10594456;;F;58;CHILENO;;Boomers;ANGOL                         ;ARAUCANIA;1425660;11;8;0;0;0;11;8;1425660;LED 42 42S6500 ANDROID TV FHD;ELECTRONICA MAYOR
16253266;Soltero;F;36;CHILENO;ABOGADO;Millenial;PROVIDENCIA                   ;METROPOLITANA;269990;1;1;1;1;269990;0;0;0;LED SAMSUNG 50 AU7090 CRYSTAL UHD 4K SMART TV 20;ELECTRONICA MAYOR
16850874;;F;33;CHILENO;;Millenial;TRAIGUEN                      ;ARAUCANIA;243962;4;2;0;0;0;4;2;243962;LED 40 KEHD4020 SMART TV;ELECTRONICA MAYOR
17331694;;M;32;CHILENO;;Millenial;VALLENAR;ATACAMA;1234600;8;5;0;0;0;8;5;1234600;PARLANTE ULTRABOOSTER 1;ELECTRONICA MAYOR
18967311;;F;27;CHILENO;;Z;TALCA                         ;MAULE;159990;1;1;0;0;0;1;1;159990;LED 32 32S60-32P ANDROID TV SMART LINE HD;ELECTRONICA MAYOR
11522370;;F;52;CHILENO;;X;SAN ANTONIO                   ;VALPARAISO;735990;11;5;0;0;0;11;5;735990;LED 40 KEHD4020 SMART TV;ELECTRONICA MAYOR
18035958;;F;30;CHILENO;;Millenial;N/D;N/D;189990;1;1;0;0;0;1;1;189990;LED 32 UN32T4300AGXZS HD SMART TV;ELECTRONICA MAYOR
12770743;;F;47;CHILENO;;X;NOGALES                       ;VALPARAISO;418210;3;2;0;0;0;3;2;418210;LED 43 43S5195 ROKU TV FHD;ELECTRONICA MAYOR
17806133;;M;31;CHILENO;;Millenial;"";"";229990;1;1;1;1;229990;0;0;0;LED 43 UN43T5202AGXZS FHD SMART TV;ELECTRONICA MAYOR
17013249;;F;33;CHILENO;;Millenial;COPIAPO                       ;ATACAMA;837970;3;2;3;2;837970;0;0;0;LED 40 UN40T5290AGXZS FHD SMART TV;ELECTRONICA MAYOR
15825036;;F;38;CHILENO;;Millenial;N/D;N/D;49960;4;1;4;1;49960;0;0;0;KARAOKE TOWER OUTDOOR POWER MIC BT BK 8571;ELECTRONICA MAYOR
19594724;;F;25;CHILENO;;Z;PROVIDENCIA                   ;METROPOLITANA;607760;8;7;0;0;0;8;7;607760;MINICOMPONENTE CJ45;ELECTRONICA MAYOR
14048159;Casado;M;41;CHILENO;;X;PROVIDENCIA                   ;METROPOLITANA;199990;1;1;0;0;0;1;1;199990;LED 32 UN32T4300AGXZS HD SMART TV;ELECTRONICA MAYOR
14035180;;F;41;CHILENO;;X;RENCA                         ;METROPOLITANA;0;0;2;0;2;0;0;0;0;LED 40 UN40T5290AGXZS FHD SMART TV;ELECTRONICA MAYOR
14310354;;F;45;CHILENO;;X;CASTRO                        ;LOS LAGOS;834980;2;1;0;0;0;2;1;834980;LED SAMSUNG 75 BU82000 CRYSTAL UHD 4K SMART TV;ELECTRONICA MAYOR
16440507;;F;36;CHILENO;;Millenial;N/D;N/D;167500;2;1;0;0;0;2;1;167500;MINICOMPONENTE OL45;ELECTRONICA MAYOR
10964193;;M;53;CHILENO;;X;RECOLETA;METROPOLITANA;279980;2;1;2;1;279980;0;0;0;LED SAMSUNG 50 AU7090 CRYSTAL UHD 4K SMART TV 20;ELECTRONICA MAYOR
12492674;Soltero;M;49;CHILENO;INGENIERO EN PREVENCION DE RIESGOS;X;RENCA                         ;METROPOLITANA;159990;1;1;0;0;0;1;1;159990;PARLANTE MGULTRAEXTREME;ELECTRONICA MAYOR
7867792;;M;65;CHILENO;;Boomers;LINARES                       ;MAULE;122732;3;2;0;0;0;3;2;122732;PARLANTE SCREAMER 5;ELECTRONICA MAYOR
8506156;;M;63;CHILENO;;Boomers;PROVIDENCIA                   ;METROPOLITANA;179332;5;2;0;0;0;5;2;179332;PARLANTE SENSEIGTH K3175;ELECTRONICA MAYOR
11447676;Casado;M;52;CHILENO;INGENIERO AGRICOLA;X;PROVIDENCIA                   ;METROPOLITANA;255210;3;1;0;0;0;3;1;255210;LED 40 KEHD4020 SMART TV;ELECTRONICA MAYOR
8103754;;M;61;CHILENO;;Boomers;COIHAIQUE                     ;AYSEN;349990;1;3;0;0;0;1;3;349990;PARLANTE KARAOKE 8 MAXEIGHT;ELECTRONICA MAYOR
6760332;;M;71;CHILENO;;Silencioso;PROVIDENCIA                   ;METROPOLITANA;152980;2;1;0;0;0;2;1;152980;LED 32 32PHD6825 HD SMART TV;ELECTRONICA MAYOR
5589210;;M;71;CHILENO;;Silencioso;RENCA                         ;METROPOLITANA;289990;1;1;0;0;0;1;1;289990;LED SAMSUNG 50 AU7090 CRYSTAL UHD 4K SMART TV 20;ELECTRONICA MAYOR
13675923;;M;43;CHILENO;;X;"";"";285972;3;1;0;0;0;3;1;285972;LED 58 KEUH5821 SMART TV UHD;ELECTRONICA MAYOR
14912527;;M;44;CHILENO;;X;VICTORIA                      ;ARAUCANIA;741310;7;3;0;0;0;7;3;741310;PARLANTE MEGALUX K2777;ELECTRONICA MAYOR
18330357;;F;28;CHILENO;;Millenial;RECOLETA                      ;METROPOLITANA;323970;3;3;0;0;0;3;3;323970;LED 43 43S5195 ROKU TV FHD;ELECTRONICA MAYOR
10274110;;F;57;CHILENO;;Boomers;NUEVA IMPERIAL                ;ARAUCANIA;440700;5;3;0;0;0;5;3;440700;LED 32 32PHD6825 HD SMART TV;ELECTRONICA MAYOR
12314253;;M;48;CHILENO;;X;PUERTO VARAS;LOS LAGOS;364980;2;1;0;0;0;2;1;364980;LED SAMSUNG 50 AU7090 CRYSTAL UHD 4K SMART TV 20;ELECTRONICA MAYOR
11807384;;F;51;CHILENO;;X;N/D;N/D;490118;4;4;3;3;489970;1;1;148;LED 50 KEUH50 SMART TV UHD;ELECTRONICA MAYOR
15033187;;M;40;CHILENO;;X;ALTO DEL CARMEN               ;ATACAMA;746780;6;4;0;0;0;6;4;746780;PARLANTE ULTRA BOOSTER Z2;ELECTRONICA MAYOR
15253834;;F;40;CHILENO;;X;VILLARICA                     ;ARAUCANIA;785662;7;4;0;0;0;7;4;785662;LED 58 KEUH5821 SMART TV UHD;ELECTRONICA MAYOR
17433881;;M;32;CHILENO;;Millenial;PROVIDENCIA                   ;METROPOLITANA;149990;1;1;0;0;0;1;1;149990;LED KIOTO 32 MI3228 SMART TV;ELECTRONICA MAYOR
15682037;;M;38;CHILENO;;Millenial;N/D;N/D;523670;4;1;0;0;0;4;1;523670;LED 55UP7500 UHD SMART;ELECTRONICA MAYOR
15149267;;F;40;CHILENO;;X;CURICO                        ;MAULE;351110;9;9;0;0;0;9;9;351110;LED KIOTO 32 MI3228 SMART TV;ELECTRONICA MAYOR
20433117;;M;22;CHILENO;;Z;PUDAHUEL;METROPOLITANA;546710;10;5;3;1;75960;7;4;470750;LED 43 CS43S1USM UHD SMART TV NEGRO;ELECTRONICA MAYOR
8025883;;M;63;CHILENO;;Boomers;CANETE                        ;BIO BIO;439700;6;3;0;0;0;6;3;439700;LED 42 KHFH4221 SMART TV;ELECTRONICA MAYOR
17687012;;F;31;CHILENO;;Millenial;RENGO;O HIGGINS;89990;1;1;1;1;89990;0;0;0;LED 32 32PHD6825 HD SMART TV;ELECTRONICA MAYOR
8804517;;M;61;CHILENO;;Boomers;VALLENAR;ATACAMA;1082710;5;4;0;0;0;5;4;1082710;PARLANTE SCREAMER 4;ELECTRONICA MAYOR
5594969;;M;75;CHILENO;;Silencioso;HUALPEN;BIO BIO;800518;9;5;0;0;0;9;5;800518;LED SAMSUNG 43 UN43AU7090GXZS SMART TV UHD 4K;ELECTRONICA MAYOR
16550682;;F;35;CHILENO;;Millenial;PROVIDENCIA                   ;METROPOLITANA;108980;2;1;2;1;108980;0;0;0;LED 32 32PHD6825 HD SMART TV;ELECTRONICA MAYOR
16419311;;F;36;CHILENO;;Millenial;PROVIDENCIA                   ;METROPOLITANA;199990;1;1;0;0;0;1;1;199990;LED 32 UN32T4300AGXZS HD SMART TV;ELECTRONICA MAYOR
13587846;;M;42;CHILENO;;X;"";"";919960;4;4;2;3;616980;2;1;302980;LED 55 KEUH5521 SMART TV UHD;ELECTRONICA MAYOR
18201841;;M;29;CHILENO;;Millenial;N/D;N/D;189990;1;1;0;0;0;1;1;189990;LED 43 43S5195 ROKU TV FHD;ELECTRONICA MAYOR
16697675;Divorciado;F;34;CHILENO;TECNICO EN ENFERMERIA DE NIVEL SUPERIOR;Millenial;CORONEL                       ;BIO BIO;1507080;9;2;0;0;0;9;2;1507080;LED 50 50NANO75 NanoCell UHD SMART + MAGIC;ELECTRONICA MAYOR
20484708;;F;21;CHILENO;;Z;VINA DEL MAR;VALPARAISO;355970;3;2;3;2;355970;0;0;0;LED SAMSUNG 50 AU7090 CRYSTAL UHD 4K SMART TV 20;ELECTRONICA MAYOR
14420229;;F;49;CHILENO;;X;PROVIDENCIA                   ;METROPOLITANA;209990;1;1;0;0;0;1;1;209990;LED LG 32 SMART TV FHD 32LQ630BPSA.AWH;ELECTRONICA MAYOR
9429122;;F;58;CHILENO;;Boomers;CURICO                        ;MAULE;329980;3;2;0;0;0;3;2;329980;LED 40 KEHD4020 SMART TV;ELECTRONICA MAYOR
19140387;;F;26;CHILENO;;Z;CORONEL                       ;BIO BIO;264691;4;2;0;0;0;4;2;264691;SOUNDBAR BLIK SURREAL 2.0;ELECTRONICA MAYOR
5901864;;M;75;CHILENO;;Silencioso;PEUMO                         ;L.G.B.OÂ´HIGGINS;66970;3;1;3;1;66970;0;0;0;MLAB KARAOKE 8 CITY SET MICROFONO INALAMBRICO AT;ELECTRONICA MAYOR
16761969;;F;34;CHILENO;;Millenial;SAN PEDRO DE LA PAZ           ;BIO BIO;29990;1;1;0;0;0;1;1;29990;MLAB KARAOKE 8 CITY SET MICROFONO INALAMBRICO AT;ELECTRONICA MAYOR
18853758;;F;27;CHILENO;;Millenial;N/D;N/D;147170;8;3;2;1;103980;6;2;43190;LED 32 32PHD6825 HD SMART TV;ELECTRONICA MAYOR
9051888;;F;59;CHILENO;;Boomers;ARICA                         ;ARICA Y PARINACOTA;462960;4;2;0;0;0;4;2;462960;LED 43 43UP7500 UHD SMART TV;ELECTRONICA MAYOR
15289961;;M;40;CHILENO;;X;LLANQUIHUE                    ;LOS LAGOS;866910;9;7;0;0;0;9;7;866910;PARLANTE SCREAMER 4;ELECTRONICA MAYOR
16984789;;F;33;CHILENO;;Millenial;TALAGANTE                     ;METROPOLITANA;1118420;7;3;0;0;0;7;3;1118420;LED 55 55P615 UHD ANDROID TV 4K;ELECTRONICA MAYOR
26385069;;M;26;PERUANO;;Extranjero;N/D;N/D;916820;9;7;0;0;0;9;7;916820;LED KIOTO 32 MI3228 SMART TV;ELECTRONICA MAYOR
15012053;;F;38;CHILENO;;Millenial;N/D;N/D;1020937;12;12;0;0;0;12;12;1020937;LED 60 UN60AU8000GXZS UHD SMART TV;ELECTRONICA MAYOR
10376040;Casado;M;56;CHILENO;;Boomers;RENCA                         ;METROPOLITANA;531160;6;2;0;0;0;6;2;531160;LED 50 KEUH50 SMART TV UHD;ELECTRONICA MAYOR
13167871;;M;51;CHILENO;;X;PUERTO MONTT                  ;LOS LAGOS;3216840;30;9;0;0;0;30;9;3216840;PARLANTE ULTRABUZZ;ELECTRONICA MAYOR
14065612;;M;42;CHILENO;;X;PROVIDENCIA                   ;METROPOLITANA;207130;5;2;0;0;0;5;2;207130;MINICOMPONENTE CJ45;ELECTRONICA MAYOR
20076726;;F;23;CHILENO;;Millenial;N/D;N/D;469980;4;3;0;0;0;4;3;469980;LED 50 KEUH50 SMART TV UHD;ELECTRONICA MAYOR
16263981;;M;36;CHILENO;;Millenial;COIHAIQUE                     ;AYSEN;901461;9;7;0;0;0;9;7;901461;LED SAMSUNG 50 AU7090 CRYSTAL UHD 4K SMART TV 20;ELECTRONICA MAYOR
12329485;;M;48;CHILENO;;X;LEBU                          ;BIO BIO;699950;5;5;0;0;0;5;5;699950;PARLANTE KARAOKE K3421;ELECTRONICA MAYOR
8141459;;F;63;CHILENO;;Boomers;MALLOA                        ;L.G.B.OÂ´HIGGINS;537200;6;2;0;0;0;6;2;537200;LED 50 50U6305 SMART TV ULTRA HD;ELECTRONICA MAYOR
10655657;Casado;F;55;CHILENO;;Boomers;MELIPILLA                     ;METROPOLITANA;449460;4;2;0;0;0;4;2;449460;PARLANTE ULTRABOOSTER 1;ELECTRONICA MAYOR
19224170;;F;26;CHILENO;;Z;VICTORIA                      ;ARAUCANIA;204980;3;2;0;0;0;3;2;204980;PARLANTE SCREAMER 4;ELECTRONICA MAYOR
13931621;;F;41;CHILENO;;X;LA PINTANA                    ;METROPOLITANA;404980;2;2;0;0;0;2;2;404980;LED 50 50U6305 SMART TV ULTRA HD;ELECTRONICA MAYOR
6572933;;M;67;CHILENO;;Boomers;SAN FELIPE                    ;VALPARAISO;388700;3;1;0;0;0;3;1;388700;LED SAMSUNG 43 UN43AU7090GXZS SMART TV UHD 4K;ELECTRONICA MAYOR
18626246;Soltero;M;28;CHILENO;;Millenial;PROVIDENCIA                   ;METROPOLITANA;185060;2;1;0;0;0;2;1;185060;LED 40 KEHD4020 SMART TV;ELECTRONICA MAYOR
15495431;;M;39;CHILENO;;X;RENAICO                       ;ARAUCANIA;219980;2;1;2;1;219980;0;0;0;LED 55 KEUH5521 SMART TV UHD;ELECTRONICA MAYOR
11594267;;M;51;CHILENO;;X;PROVIDENCIA                   ;METROPOLITANA;179990;1;1;1;1;179990;0;0;0;LED 50 KEUH50 SMART TV UHD;ELECTRONICA MAYOR
20007573;;F;24;CHILENO;;Z;TALCA;MAULE;329990;1;1;0;0;0;1;1;329990;LED 65 KEUH6521 SMART TV UHD;ELECTRONICA MAYOR
19287734;;F;27;CHILENO;;Z;PUDAHUEL                      ;METROPOLITANA;179990;1;1;0;0;0;1;1;179990;LED 43 Full HD Smart TV 43PFD6825;ELECTRONICA MAYOR
11519523;;M;52;CHILENO;;X;LLAILLAY                      ;VALPARAISO;339990;1;1;1;1;339990;0;0;0;LED SAMSUNG 55 4K UHD SMART TV UN55AU7090GXZS;ELECTRONICA MAYOR
4003726;;M;84;CHILENO;;Silencioso;MAIPU                         ;METROPOLITANA;828270;5;2;0;0;0;5;2;828270;LED 55 KEUH5521 SMART TV UHD;ELECTRONICA MAYOR
12896582;;F;47;CHILENO;;X;PUENTE ALTO                   ;METROPOLITANA;396010;-1;2;0;0;0;-1;2;396010;LED TCL 70 70P615 ANDROID TV 4K UHD;ELECTRONICA MAYOR
8333048;;M;64;CHILENO;;Boomers;VALDIVIA                      ;LOS LAGOS;194980;2;1;2;1;194980;0;0;0;LED 50 KEUH50 SMART TV UHD;ELECTRONICA MAYOR
17085360;;M;33;CHILENO;;Millenial;LA CISTERNA                   ;METROPOLITANA;179990;1;1;1;1;179990;0;0;0;LED 50 KEUH50 SMART TV UHD;ELECTRONICA MAYOR
17453815;;F;32;CHILENO;;Millenial;CURANILAHUE                   ;BIO BIO;189970;3;2;0;0;0;3;2;189970;PARLANTE KARAOKE 12 FM/BT/USB;ELECTRONICA MAYOR
10884569;;F;57;CHILENO;;Boomers;ILLAPEL                       ;COQUIMBO;129990;1;1;0;0;0;1;1;129990;LED 40 KEHD4020 SMART TV;ELECTRONICA MAYOR
18486469;;F;29;CHILENO;;Millenial;ANTOFAGASTA                   ;ANTOFAGASTA;314980;2;2;1;1;299990;1;1;14990;LED 65 KEUH6521 SMART TV UHD;ELECTRONICA MAYOR
12935200;;F;46;CHILENO;;X;PUERTO MONTT                  ;LOS LAGOS;359990;1;1;0;0;0;1;1;359990;LED 55UP7500 UHD SMART;ELECTRONICA MAYOR
14301236;;F;48;CHILENO;;X;BUIN                          ;METROPOLITANA;1398300;17;8;0;0;0;17;8;1398300;LED 40 40S65A-40P ANDROID TV SMART LINE FHD;ELECTRONICA MAYOR
15992596;;F;37;CHILENO;;Millenial;REQUINOA                      ;L.G.B.OÂ´HIGGINS;159990;1;1;0;0;0;1;1;159990;LED 42 KHFH4221 SMART TV;ELECTRONICA MAYOR
9554800;;M;56;CHILENO;;Boomers;PARRAL                        ;MAULE;1327840;5;3;0;0;0;5;3;1327840;LED 60UP7750 UHD SMART + MAGIC;ELECTRONICA MAYOR
18584433;Soltero;M;29;CHILENO;;Millenial;PROVIDENCIA                   ;METROPOLITANA;123980;2;1;2;1;123980;0;0;0;MINICOMPONENTE CJ45;ELECTRONICA MAYOR
18655956;;F;28;CHILENO;;Millenial;N/D;N/D;245960;4;5;0;0;0;4;5;245960;LED 42 KHFH4221 SMART TV;ELECTRONICA MAYOR
10002738;;M;56;CHILENO;;Boomers;ANGOL                         ;ARAUCANIA;430290;3;2;0;0;0;3;2;430290;LED 43 43UP7500 UHD SMART TV;ELECTRONICA MAYOR
5774815;Casado;M;73;CHILENO;;Silencioso;QUILPUE                       ;VALPARAISO;109990;1;1;0;0;0;1;1;109990;LED 32 32S5305 HD HDR10/HLG;ELECTRONICA MAYOR
9631074;;M;59;CHILENO;;Boomers;LLAILLAY                      ;VALPARAISO;175060;2;1;0;0;0;2;1;175060;LED KIOTO 32 MI3228 SMART TV;ELECTRONICA MAYOR
11861023;;M;51;CHILENO;;X;CASTRO                        ;LOS LAGOS;42560;2;1;0;0;0;2;1;42560;PARLANTE SCREAMER 3;ELECTRONICA MAYOR
25963930;;M;31;EXTRANJERO - NO INFORMA NACIONALIDAD;;Extranjero;N/D;N/D;199990;2;1;0;0;0;2;1;199990;LED 42 KHFH4221 SMART TV;ELECTRONICA MAYOR
15064936;Soltero;F;39;CHILENO;PROFESOR;X;PROVIDENCIA                   ;METROPOLITANA;148980;2;1;2;1;148980;0;0;0;LED 40 KEHD4020 SMART TV;ELECTRONICA MAYOR
7132004;;M;67;CHILENO;;Boomers;PUERTO MONTT                  ;LOS LAGOS;339980;2;2;0;0;0;2;2;339980;LED 43 UN43T5202AGXZS FHD SMART TV;ELECTRONICA MAYOR
18950534;;F;27;CHILENO;;Z;CHIMBARONGO                   ;L.G.B.OÂ´HIGGINS;199990;1;1;1;1;199990;0;0;0;LED 55 KEUH5521 SMART TV UHD;ELECTRONICA MAYOR
15909973;;M;38;CHILENO;;X;LA SERENA                     ;COQUIMBO;223970;4;2;0;0;0;4;2;223970;PARLANTE SCREAMER 4;ELECTRONICA MAYOR
10460407;Soltero;M;57;CHILENO;;Boomers;RENCA                         ;METROPOLITANA;137720;2;1;0;0;0;2;1;137720;LED KIOTO 32 MI3228 SMART TV;ELECTRONICA MAYOR
6331673;;F;63;CHILENO;;Boomers;DALCAHUE                      ;LOS LAGOS;666490;11;6;0;0;0;11;6;666490;LED 55 KEUH5521 SMART TV UHD;ELECTRONICA MAYOR
7272480;;F;67;CHILENO;;Boomers;ANCUD                         ;LOS LAGOS;339300;5;3;0;0;0;5;3;339300;LED 42 KHFH4221 SMART TV;ELECTRONICA MAYOR
8915766;;F;62;CHILENO;;Boomers;NACIMIENTO                    ;BIO BIO;419970;3;2;0;0;0;3;2;419970;LED 43 Full HD Smart TV 43PFD6825;ELECTRONICA MAYOR
8209768;;M;65;CHILENO;;Boomers;RENCA                         ;METROPOLITANA;419350;8;2;0;0;0;8;2;419350;LED KIOTO 32 MI3228 SMART TV;ELECTRONICA MAYOR
10569129;;M;56;CHILENO;;Boomers;PUDAHUEL                      ;METROPOLITANA;1045940;6;4;0;0;0;6;4;1045940;LED 50 50P615-50P ANDROID TV PASSION LINE UHD 4K;ELECTRONICA MAYOR
16411393;;M;35;CHILENO;;Millenial;"";"";489970;3;2;0;0;0;3;2;489970;LED 55 KEUH5521 SMART TV UHD;ELECTRONICA MAYOR
5285835;;M;78;CHILENO;;Silencioso;CHIMBARONGO                   ;L.G.B.OÂ´HIGGINS;364970;3;2;0;0;0;3;2;364970;LED 50 UN50TU7090GXZS UHD SMART TV;ELECTRONICA MAYOR
11033087;;F;57;CHILENO;;Boomers;SAN CARLOS                    ;BIO BIO;166980;2;1;0;0;0;2;1;166980;LED 42 KHFH4221 SMART TV;ELECTRONICA MAYOR
10594967;;M;57;CHILENO;;Boomers;LA PINTANA                    ;METROPOLITANA;468782;7;4;0;0;0;7;4;468782;LED 43 UN43T5202AGXZS FHD SMART TV;ELECTRONICA MAYOR
20424415;;F;22;CHILENO;;Z;"";"";334300;4;3;2;1;123980;2;2;210320;LED 50 50P615-50P ANDROID TV PASSION LINE UHD 4K;ELECTRONICA MAYOR
15868463;;F;37;CHILENO;;Millenial;RENAICO                       ;ARAUCANIA;254150;3;1;0;0;0;3;1;254150;LED 43 43S5195 ROKU TV FHD;ELECTRONICA MAYOR
18526944;;F;29;CHILENO;;Millenial;CASTRO                        ;LOS LAGOS;179990;1;1;1;1;179990;0;0;0;LED 50 KEUH50 SMART TV UHD;ELECTRONICA MAYOR
6381887;;F;66;CHILENO;;Boomers;PROVIDENCIA                   ;METROPOLITANA;119990;1;1;0;0;0;1;1;119990;MINICOMPONENTE OL45;ELECTRONICA MAYOR
14486812;Casado;M;50;CHILENO;HOMEOPATA;X;COLTAUCO                      ;L.G.B.OÂ´HIGGINS;1535010;21;4;0;0;0;21;4;1535010;LED 40 KEHD4020 SMART TV;ELECTRONICA MAYOR
16951144;;M;34;CHILENO;;Millenial;LA PINTANA;METROPOLITANA;127970;3;2;0;0;0;3;2;127970;PARLANTE BOLA DISCO CON MICROFONO INAL;ELECTRONICA MAYOR
8936210;;F;63;CHILENO;;Boomers;N/D;N/D;609960;4;3;0;0;0;4;3;609960;LED SAMSUNG 50 AU7090 CRYSTAL UHD 4K SMART TV 20;ELECTRONICA MAYOR
12399947;;F;49;CHILENO;;X;N/D;N/D;247160;2;1;0;0;0;2;1;247160;LED 55 KEUH5521 SMART TV UHD;ELECTRONICA MAYOR
26576267;;M;29;EXTRANJERO - NO INFORMA NACIONALIDAD;;Extranjero;N/D;N/D;339220;6;2;0;0;0;6;2;339220;LED 50 KEUH50 SMART TV UHD;ELECTRONICA MAYOR
17233312;;M;33;CHILENO;;Millenial;COIHAIQUE                     ;AYSEN;1362730;4;2;0;0;0;4;2;1362730;LED 60UP7750 UHD SMART + MAGIC;ELECTRONICA MAYOR
5104631;;M;76;CHILENO;;Silencioso;N/D;N/D;964790;5;3;2;1;169980;3;2;794810;LED 70 UN70AU7000GXZS UHD;ELECTRONICA MAYOR
8444553;;F;64;CHILENO;;Boomers;VALDIVIA                      ;LOS RIOS;652070;7;4;0;0;0;7;4;652070;LED 58 KEUH5821 SMART TV UHD;ELECTRONICA MAYOR
12359775;;F;49;CHILENO;;X;CALBUCO                       ;LOS LAGOS;550970;3;1;3;1;550970;0;0;0;LED 43 43UP7500 UHD SMART TV;ELECTRONICA MAYOR
7568291;;M;68;CHILENO;;Boomers;"";"";159990;1;1;0;0;0;1;1;159990;LED 42 KHFH4221 SMART TV;ELECTRONICA MAYOR
11788850;;F;51;CHILENO;;X;CAUQUENES                     ;MAULE;233960;4;4;0;0;0;4;4;233960;LED 55 KEUH5521 SMART TV UHD;ELECTRONICA MAYOR
7404814;;M;66;CHILENO;;Boomers;LOS ANGELES                   ;BIO BIO;562150;6;3;0;0;0;6;3;562150;LED 43 43UP7500 UHD SMART TV;ELECTRONICA MAYOR
9192019;;F;61;CHILENO;;Boomers;ILLAPEL                       ;COQUIMBO;84090;2;1;0;0;0;2;1;84090;PARLANTE SCREAMER 4;ELECTRONICA MAYOR
8834854;;F;61;CHILENO;;Boomers;LOS ANDES                     ;VALPARAISO;392940;6;4;3;1;94970;3;3;297970;LED 58 KEUH5821 SMART TV UHD;ELECTRONICA MAYOR
10605820;;F;57;CHILENO;;Boomers;COIHUECO                      ;BIO BIO;754110;6;2;0;0;0;6;2;754110;LED 42 KHFH4221 SMART TV;ELECTRONICA MAYOR
7111149;;F;70;CHILENO;;Silencioso;COIHAIQUE                     ;AYSEN;800060;4;3;0;0;0;4;3;800060;KARAOKE 15 HEAVY BASS MIC INA CON ATRIL 8892;ELECTRONICA MAYOR
7337412;;F;63;CHILENO;;Boomers;COLLIPULLI                    ;ARAUCANIA;367290;3;1;0;0;0;3;1;367290;LED 55 KEUH5521 SMART TV UHD;ELECTRONICA MAYOR
13623605;;F;43;CHILENO;;X;ANGOL;ARAUCANIA;552920;8;5;7;4;530930;1;1;21990;LED 50 KEUH50 SMART TV UHD;ELECTRONICA MAYOR
7330643;;M;64;CHILENO;;Boomers;TALAGANTE                     ;METROPOLITANA;199990;1;1;0;0;0;1;1;199990;LED 55 KEUH5521 SMART TV UHD;ELECTRONICA MAYOR
12140795;;M;51;CHILENO;;X;LOS VILOS                     ;COQUIMBO;344960;4;4;0;0;0;4;4;344960;LED 40 KEHD4020 SMART TV;ELECTRONICA MAYOR
8619942;;F;61;CHILENO;;Boomers;OVALLE                        ;COQUIMBO;580290;3;3;0;0;0;3;3;580290;LED 55 KEUH5521 SMART TV UHD;ELECTRONICA MAYOR
17574779;;M;31;CHILENO;;Millenial;N/D;N/D;749940;7;5;0;0;0;7;5;749940;PARLANTE ULTRA BOOSTER Z2;ELECTRONICA MAYOR
10026832;;M;58;CHILENO;;Boomers;ILLAPEL                       ;COQUIMBO;239990;1;1;0;0;0;1;1;239990;LED 55 KEUH5521 SMART TV UHD;ELECTRONICA MAYOR
7610616;Casado;F;68;CHILENO;;Boomers;VALDIVIA                      ;LOS LAGOS;319990;3;1;0;0;0;3;1;319990;LED 40 UN40T5290AGXZS FHD SMART TV;ELECTRONICA MAYOR
16793860;;M;34;CHILENO;;Millenial;TEMUCO                        ;ARAUCANIA;312980;2;2;0;0;0;2;2;312980;LED 43 43UP7500 UHD SMART TV;ELECTRONICA MAYOR
16872485;;M;33;CHILENO;;Millenial;RENAICO                       ;ARAUCANIA;179990;1;1;1;1;179990;0;0;0;LED 50 KEUH50 SMART TV UHD;ELECTRONICA MAYOR
9708848;;M;57;CHILENO;;Boomers;LA CISTERNA                   ;METROPOLITANA;199990;1;1;0;0;0;1;1;199990;LED 50 KEUH50 SMART TV UHD;ELECTRONICA MAYOR
18745375;;M;28;CHILENO;;Millenial;N/D;N/D;1812710;12;3;5;2;494810;7;1;1317900;LED 55 KEUH5521 SMART TV UHD;ELECTRONICA MAYOR
15020265;Soltero;F;39;CHILENO;PSICOLOGO;X;VILLARICA                     ;ARAUCANIA;528660;4;2;0;0;0;4;2;528660;LED 32 UN32T4300AGXZS HD SMART TV;ELECTRONICA MAYOR
20179820;;M;22;CHILENO;;Z;SAN FERNANDO                  ;L.G.B.OÂ´HIGGINS;288940;6;3;0;0;0;6;3;288940;LED 40 KEHD4020 SMART TV;ELECTRONICA MAYOR
16871622;;M;34;CHILENO;;Millenial;PROVIDENCIA                   ;METROPOLITANA;379990;1;1;1;1;379990;0;0;0;LED 58 UN58AU7000GXZS UHD 4K SMART TV;ELECTRONICA MAYOR
8005341;;F;63;CHILENO;;Boomers;PROVIDENCIA                   ;METROPOLITANA;226970;3;2;0;0;0;3;2;226970;LED KIOTO 32 MI3228 SMART TV;ELECTRONICA MAYOR
18534385;Soltero;M;28;CHILENO;PSICOLOGO;Millenial;PROVIDENCIA                   ;METROPOLITANA;130960;3;1;3;1;130960;0;0;0;LED 32 32S5305 HD HDR10/HLG;ELECTRONICA MAYOR
5019791;;F;77;CHILENO;;Silencioso;PROVIDENCIA                   ;METROPOLITANA;203980;2;1;2;1;203980;0;0;0;LED 43 UN43T5202AGXZS FHD SMART TV;ELECTRONICA MAYOR
10196696;;F;51;CHILENO;;X;N/D;N/D;199990;1;1;0;0;0;1;1;199990;LED 50 KEUH50 SMART TV UHD;ELECTRONICA MAYOR
6865156;;F;67;CHILENO;;Boomers;SAN RAMON                     ;METROPOLITANA;1223890;11;9;0;0;0;11;9;1223890;LED 43 UN43T5202AGXZS FHD SMART TV;ELECTRONICA MAYOR
3521951;;M;82;CHILENO;;Silencioso;RENCA                         ;METROPOLITANA;202980;2;1;0;0;0;2;1;202980;LED 40 KEHD4020 SMART TV;ELECTRONICA MAYOR
18520476;;F;29;CHILENO;;Millenial;VALLENAR;ATACAMA;377080;3;2;0;0;0;3;2;377080;PARLANTE MGULTRAEXTREME;ELECTRONICA MAYOR
27160252;;M;30;"";;Extranjero;PROVIDENCIA                   ;METROPOLITANA;313980;2;1;2;1;313980;0;0;0;LED SAMSUNG 50 AU7090 CRYSTAL UHD 4K SMART TV 20;ELECTRONICA MAYOR
17567539;;F;32;CHILENO;;Millenial;N/D;N/D;212800;8;3;0;0;0;8;3;212800;LED KIOTO 32 MI3228 SMART TV;ELECTRONICA MAYOR
6230286;;F;72;CHILENO;;Silencioso;N/D;N/D;286360;3;1;0;0;0;3;1;286360;LED 32 UN32T4300AGXZS HD SMART TV;ELECTRONICA MAYOR
11507248;;M;52;CHILENO;;X;MEJILLONES                    ;ANTOFAGASTA;185740;4;2;0;0;0;4;2;185740;PARLANTE KARAOKE 12 FM/BT/USB;ELECTRONICA MAYOR
16742397;;F;34;CHILENO;;Millenial;MAIPU                         ;METROPOLITANA;537940;7;3;7;3;537940;0;0;0;LED 40 40S65A-40P ANDROID TV SMART LINE FHD;ELECTRONICA MAYOR
27072902;;M;39;EXTRANJERO - NO INFORMA NACIONALIDAD;;Extranjero;"";"";160000;2;1;0;0;0;2;1;160000;LED 32 AOC ROKU TV HD 32S5195;ELECTRONICA MAYOR
10461536;;F;56;CHILENO;;Boomers;SAN JOAQUIN;METROPOLITANA;113980;2;1;2;1;113980;0;0;0;MINICOMPONENTE CJ45;ELECTRONICA MAYOR
16270700;;M;36;CHILENO;;Millenial;MAULE;MAULE;149980;2;3;0;0;0;2;3;149980;PARLANTE ULTRABUZZ;ELECTRONICA MAYOR
18743437;;F;34;CHILENO;;Millenial;OSORNO                        ;LOS LAGOS;280000;2;1;0;0;0;2;1;280000;LED 43 43UP7500 UHD SMART TV;ELECTRONICA MAYOR
15704055;;F;38;CHILENO;;X;LA HIGUERA                    ;COQUIMBO;226270;2;1;0;0;0;2;1;226270;PARLANTE ULTRAFORCE-I;ELECTRONICA MAYOR
17205475;;M;33;CHILENO;;Millenial;LAMPA                         ;METROPOLITANA;943940;7;4;0;0;0;7;4;943940;LED 55 KEUH5521 SMART TV UHD;ELECTRONICA MAYOR
26764324;;M;58;VENEZOLANO;;Extranjero;N/D;N/D;885940;6;2;0;0;0;6;2;885940;LED NanoCell 55NANO80 UHD SMART + MAGIC;ELECTRONICA MAYOR
20338837;;F;22;CHILENO;;Millenial;PROVIDENCIA                   ;METROPOLITANA;309990;1;1;1;1;309990;0;0;0;LED SAMSUNG 50 AU7090 CRYSTAL UHD 4K SMART TV 20;ELECTRONICA MAYOR
14229768;;M;43;CHILENO;;X;VALPARAISO                    ;VALPARAISO;199990;1;1;0;0;0;1;1;199990;LED 43 43S5195 ROKU TV FHD;ELECTRONICA MAYOR
19663786;;M;24;CHILENO;;Z;QUILPUE                       ;VALPARAISO;552930;7;7;0;0;0;7;7;552930;LED 40 KEHD4020 SMART TV;ELECTRONICA MAYOR
17647708;;F;31;CHILENO;;Millenial;"";"";215970;3;2;0;0;0;3;2;215970;LED 50 KEUH50 SMART TV UHD;ELECTRONICA MAYOR
19956437;;F;24;CHILENO;;Z;PROVIDENCIA                   ;METROPOLITANA;647950;5;2;5;2;647950;0;0;0;LED 50 KEUH50 SMART TV UHD;ELECTRONICA MAYOR
19330334;;M;25;CHILENO;;Z;"";"";216980;2;1;2;1;216980;0;0;0;LED 55 KEUH5521 SMART TV UHD;ELECTRONICA MAYOR
17409934;;F;32;CHILENO;;Millenial;PAIGUANO                      ;COQUIMBO;875780;8;2;0;0;0;8;2;875780;LED SAMSUNG 55 4K UHD SMART TV UN55AU7090GXZS;ELECTRONICA MAYOR
10750648;;M;55;CHILENO;;Boomers;CANETE                        ;BIO BIO;284980;2;2;0;0;0;2;2;284980;LED 40 KEHD4020 SMART TV;ELECTRONICA MAYOR
4611991;;M;78;CHILENO;;Silencioso;CALAMA                        ;ANTOFAGASTA;586369;6;3;0;0;0;6;3;586369;LED 40 KEHD4020 SMART TV;ELECTRONICA MAYOR
19461230;;M;25;CHILENO;;Z;COIHAIQUE                     ;AYSEN;193590;2;1;0;0;0;2;1;193590;LED KIOTO 32 MI3228 SMART TV;ELECTRONICA MAYOR
10284081;Casado;F;54;CHILENO;;Boomers;TALCA                         ;MAULE;129990;1;1;0;0;0;1;1;129990;LED KIOTO 32 MI3228 SMART TV;ELECTRONICA MAYOR
17147032;;M;33;CHILENO;;Millenial;SAN JAVIER                    ;MAULE;179990;1;1;1;1;179990;0;0;0;LED 50 KEUH50 SMART TV UHD;ELECTRONICA MAYOR
19668570;;F;24;CHILENO;;Z;OVALLE                        ;COQUIMBO;61980;2;2;1;1;26990;1;1;34990;KARAOKE FUNKY DISCO;ELECTRONICA MAYOR
8286507;;F;65;CHILENO;;Boomers;CARAHUE                       ;ARAUCANIA;166980;2;1;0;0;0;2;1;166980;LED 42 KHFH4221 SMART TV;ELECTRONICA MAYOR
8394145;;F;68;CHILENO;;Boomers;TEMUCO                        ;ARAUCANIA;739520;7;7;0;0;0;7;7;739520;LED 50 50P615-50P ANDROID TV PASSION LINE UHD 4K;ELECTRONICA MAYOR
15748977;;F;38;CHILENO;;Millenial;N/D;N/D;278440;2;1;0;0;0;2;1;278440;LED 55 KEUH5521 SMART TV UHD;ELECTRONICA MAYOR
15835119;;F;37;CHILENO;;Millenial;TALCA                         ;MAULE;898930;7;3;0;0;0;7;3;898930;LED 55 55P615 UHD ANDROID TV 4K;ELECTRONICA MAYOR
6837735;;M;66;CHILENO;;Boomers;RENCA                         ;METROPOLITANA;429960;4;1;0;0;0;4;1;429960;LED 65 KEUH6521 SMART TV UHD;ELECTRONICA MAYOR
10577773;;M;51;CHILENO;;X;COIHAIQUE                     ;AYSEN;269990;1;1;0;0;0;1;1;269990;LED 50 KEUH50 SMART TV UHD;ELECTRONICA MAYOR
8040503;;M;61;CHILENO;;Boomers;"";"";914950;5;2;3;1;569970;2;1;344980;LED 50 UN50TU7090GXZS UHD SMART TV;ELECTRONICA MAYOR
19020074;;F;26;CHILENO;;Z;N/D;N/D;24980;2;2;0;0;0;2;2;24980;PARLANTE KARAOKE 8 MAXEIGHT;ELECTRONICA MAYOR
8722151;;M;60;CHILENO;;Boomers;COIHAIQUE                     ;AYSEN;354960;4;3;0;0;0;4;3;354960;LED 43 43LM6370 SMART TV FHD;ELECTRONICA MAYOR
19143859;;F;27;CHILENO;;Millenial;"";"";69990;1;1;0;0;0;1;1;69990;PARLANTE SENSEIGTH K3175;ELECTRONICA MAYOR
14571497;;M;42;CHILENO;;X;PUENTE ALTO                   ;METROPOLITANA;346960;4;2;0;0;0;4;2;346960;LED 50 50P615-50P ANDROID TV PASSION LINE UHD 4K;ELECTRONICA MAYOR
12379012;;F;49;CHILENO;;X;NIQUEN                        ;BIO BIO;308980;2;2;0;0;0;2;2;308980;LED 50 50P615-50P ANDROID TV PASSION LINE UHD 4K;ELECTRONICA MAYOR
7559722;;F;66;CHILENO;;Boomers;N/D;N/D;251130;3;2;0;0;0;3;2;251130;MINICOMPONENTE OL45;ELECTRONICA MAYOR
25461791;;M;24;PERUANO;;Extranjero;N/D;N/D;529970;3;2;0;0;0;3;2;529970;MINICOMPONENTE RN7;ELECTRONICA MAYOR
12258384;;M;50;CHILENO;;X;COLINA                        ;METROPOLITANA;663890;11;11;1;1;139990;10;10;523900;PARLANTE ULTRAMAGIC;ELECTRONICA MAYOR
10192379;;M;53;CHILENO;;Millenial;"";"";230970;3;2;0;0;0;3;2;230970;LED 32 32PHD6825 HD SMART TV;ELECTRONICA MAYOR
12059625;;M;55;CHILENO;;Boomers;MACUL                         ;METROPOLITANA;359990;1;1;0;0;0;1;1;359990;LED 55UP7500 UHD SMART;ELECTRONICA MAYOR
9058398;Soltero;F;63;CHILENO;;Boomers;PROVIDENCIA                   ;METROPOLITANA;153610;3;1;0;0;0;3;1;153610;LED KIOTO 32 MI3228 SMART TV;ELECTRONICA MAYOR
16119675;;F;37;CHILENO;;Millenial;PARRAL                        ;MAULE;527430;7;4;5;3;297450;2;1;229980;MINICOMPONENTE RN9;ELECTRONICA MAYOR
15254610;Casado;M;39;CHILENO;;X;RENCA                         ;METROPOLITANA;243930;2;1;0;0;0;2;1;243930;SOUNDBAR HW-A650/ZS;ELECTRONICA MAYOR
8821113;;M;66;CHILENO;;Boomers;PROVIDENCIA                   ;METROPOLITANA;289990;1;1;0;0;0;1;1;289990;LED 43 43UP7500 UHD SMART TV;ELECTRONICA MAYOR
15033724;;M;40;CHILENO;;Millenial;COPIAPO;ATACAMA;142980;2;1;0;0;0;2;1;142980;LED KIOTO 32 MI3228 SMART TV;ELECTRONICA MAYOR
13407834;;M;44;CHILENO;;X;CASTRO                        ;LOS LAGOS;1104970;3;2;0;0;0;3;2;1104970;LED 65 65PUD7625 4K UHD HDR;ELECTRONICA MAYOR
17162425;;F;33;CHILENO;;Millenial;N/D;N/D;179990;1;1;1;1;179990;0;0;0;LED 32LM637B HD SMART;ELECTRONICA MAYOR
7843829;;F;65;CHILENO;;Boomers;PENALOLEN                     ;METROPOLITANA;714540;6;3;0;0;0;6;3;714540;LED 50 UN50TU7090GXZS UHD SMART TV;ELECTRONICA MAYOR
13409123;;F;43;CHILENO;;X;CASTRO                        ;LOS LAGOS;348960;4;3;0;0;0;4;3;348960;LED 43 Full HD Smart TV 43PFD6825;ELECTRONICA MAYOR
12938123;;F;45;CHILENO;;X;RENCA                         ;METROPOLITANA;513980;2;1;2;1;513980;0;0;0;QLED 55 QN55Q60AAGXZS 4K UHD SMART TV;ELECTRONICA MAYOR
26297308;;M;42;NO INFORMA NACIONALIDAD;;Extranjero;VINA DEL MAR                  ;VALPARAISO;382970;3;3;0;0;0;3;3;382970;LED 65 KEUH6521 SMART TV UHD;ELECTRONICA MAYOR
10870034;;F;51;CHILENO;;X;TEMUCO                        ;ARAUCANIA;759700;7;3;0;0;0;7;3;759700;LED 40 KEHD4020 SMART TV;ELECTRONICA MAYOR
12029189;;M;43;CHILENO;;X;N/D;N/D;144980;2;2;0;0;0;2;2;144980;LED KIOTO 32 MI3228 SMART TV;ELECTRONICA MAYOR
13958073;;M;42;CHILENO;;X;CORONEL                       ;BIO BIO;189990;2;1;0;0;0;2;1;189990;LED 42 KHFH4221 SMART TV;ELECTRONICA MAYOR
6931746;;F;70;CHILENO;;Silencioso;ARICA                         ;ARICA Y PARINACOTA;210780;2;1;0;0;0;2;1;210780;LED 40 KEHD4020 SMART TV;ELECTRONICA MAYOR
14904921;;M;41;CHILENO;;X;N/D;N/D;498580;6;3;0;0;0;6;3;498580;MINICOMPONENTE RN7;ELECTRONICA MAYOR
9027089;;F;60;CHILENO;;Boomers;VINA DEL MAR;VALPARAISO;16093;1;1;1;1;16093;0;0;0;KARAOKE STREET SONG 4 MICÂ CABLEÂ BLACK 8900;ELECTRONICA MAYOR
12500821;;F;49;CHILENO;;X;PUENTE ALTO                   ;METROPOLITANA;26990;1;1;0;0;0;1;1;26990;KARAOKE FUNKY DISCO;ELECTRONICA MAYOR
14018005;;F;45;CHILENO;;X;TALCA                         ;MAULE;538962;4;4;0;0;0;4;4;538962;LED 55 KEUH5521 SMART TV UHD;ELECTRONICA MAYOR
8790336;;F;63;CHILENO;;Boomers;TOCOPILLA                     ;ANTOFAGASTA;659420;7;2;0;0;0;7;2;659420;LED 55 55P615 UHD ANDROID TV 4K;ELECTRONICA MAYOR
9055309;;M;59;CHILENO;;Boomers;LANCO                         ;LOS LAGOS;239990;1;1;0;0;0;1;1;239990;LED 43 43LM6370 SMART TV FHD;ELECTRONICA MAYOR
11812819;;M;50;CHILENO;;X;PROVIDENCIA                   ;METROPOLITANA;204980;2;1;0;0;0;2;1;204980;LED 42 KHFH4221 SMART TV;ELECTRONICA MAYOR
15629541;;M;38;CHILENO;;Millenial;LOS ANGELES                   ;BIO BIO;384970;3;3;0;0;0;3;3;384970;MINICOMPONENTE RN7;ELECTRONICA MAYOR
17320474;;F;32;CHILENO;;Millenial;PROVIDENCIA                   ;METROPOLITANA;99990;1;1;0;0;0;1;1;99990;KARAOKE 15 HEAVY BASS MIC INA CON ATRIL 8892;ELECTRONICA MAYOR
14360074;;M;41;CHILENO;;X;PROVIDENCIA                   ;METROPOLITANA;415940;6;5;0;0;0;6;5;415940;LED 42 KHFH4221 SMART TV;ELECTRONICA MAYOR
12330715;;F;49;CHILENO;;X;CANETE                        ;BIO BIO;524960;4;2;0;0;0;4;2;524960;LED 50 UN50TU7090GXZS UHD SMART TV;ELECTRONICA MAYOR
19275433;;F;25;CHILENO;;Z;MELIPILLA                     ;METROPOLITANA;447950;5;3;2;1;137980;3;2;309970;PARLANTE ULTRAMAGIC;ELECTRONICA MAYOR
13153201;;M;45;CHILENO;;X;SAN JOAQUIN                   ;METROPOLITANA;263970;3;1;0;0;0;3;1;263970;LED 43 Full HD Smart TV 43PFD6825;ELECTRONICA MAYOR
11596556;;M;52;CHILENO;;X;PURRANQUE                     ;LOS LAGOS;480950;6;5;0;0;0;6;5;480950;LED 42 KHFH4221 SMART TV;ELECTRONICA MAYOR
14246749;;M;47;CHILENO;;X;LAS CABRAS                    ;L.G.B.OÂ´HIGGINS;481960;4;3;0;0;0;4;3;481960;LED 40 UN40T5290AGXZS FHD SMART TV;ELECTRONICA MAYOR
11439186;;M;52;CHILENO;;X;INDEPENDENCIA                 ;METROPOLITANA;1112773;6;3;0;0;0;6;3;1112773;LED 65 KEUH6521 SMART TV UHD;ELECTRONICA MAYOR
24971707;;F;52;BOLIVIANO;;Extranjero;COPIAPO                       ;ATACAMA;674830;6;3;0;0;0;6;3;674830;PARLANTE ULTRAFORCE-I;ELECTRONICA MAYOR
8073965;;M;63;CHILENO;;Boomers;BUIN                          ;METROPOLITANA;349970;3;2;0;0;0;3;2;349970;LED 32 32S5305 HD HDR10/HLG;ELECTRONICA MAYOR
13173968;;M;45;CHILENO;;X;LA SERENA                     ;COQUIMBO;531950;5;3;0;0;0;5;3;531950;LED 55UP7500 UHD SMART;ELECTRONICA MAYOR
17649833;;F;31;CHILENO;;Millenial;QUELLON                       ;LOS LAGOS;418139;5;3;0;0;0;5;3;418139;LED 50 50PUD7625 SMART TV ULTRA HD 4K;ELECTRONICA MAYOR
9525844;;M;58;CHILENO;;Boomers;TIRUA                         ;BIO BIO;338960;4;2;0;0;0;4;2;338960;LED 55 KEUH5521 SMART TV UHD;ELECTRONICA MAYOR
26213222;;M;28;VENEZOLANO;;Extranjero;N/D;N/D;449990;2;1;2;1;449990;0;0;0;LED 60 UN60AU8000GXZS UHD SMART TV;ELECTRONICA MAYOR
11131039;;F;55;CHILENO;;Boomers;RENCA                         ;METROPOLITANA;159990;2;1;2;1;159990;0;0;0;LED 32 UN32T4300AGXZS HD SMART TV;ELECTRONICA MAYOR
12007451;;M;41;CHILENO;;X;PROVIDENCIA                   ;METROPOLITANA;24990;1;1;0;0;0;1;1;24990;KARAOKE STREET SONG 4 MICÂ CABLEÂ BLACK 8900;ELECTRONICA MAYOR
11132389;;M;55;CHILENO;;Boomers;N/D;N/D;344970;3;4;0;0;0;3;4;344970;LED 50 KEUH50 SMART TV UHD;ELECTRONICA MAYOR
15008408;;F;39;CHILENO;;X;ARICA                         ;TARAPACA;99990;1;1;0;0;0;1;1;99990;MINICOMPONENTE OL45;ELECTRONICA MAYOR
20156281;;M;22;CHILENO;;Z;"";"";360970;4;2;0;0;0;4;2;360970;LED 58 KEUH5821 SMART TV UHD;ELECTRONICA MAYOR
9097591;;F;61;CHILENO;;Boomers;RENCA                         ;METROPOLITANA;418950;7;2;0;0;0;7;2;418950;LED KIOTO 32 MI3228 SMART TV;ELECTRONICA MAYOR
12433708;;M;49;CHILENO;;X;PUERTO MONTT                  ;LOS LAGOS;479980;2;2;0;0;0;2;2;479980;LED 55UP7500 UHD SMART;ELECTRONICA MAYOR
12969036;;M;46;CHILENO;;X;CHILLAN                       ;BIO BIO;392159;4;2;0;0;0;4;2;392159;LED 58 KEUH5821 SMART TV UHD;ELECTRONICA MAYOR
6959232;;M;69;CHILENO;;Silencioso;COIHAIQUE                     ;AYSEN;235980;3;1;0;0;0;3;1;235980;LED 40 KEHD4020 SMART TV;ELECTRONICA MAYOR
19726143;;M;24;CHILENO;;Z;PROVIDENCIA                   ;METROPOLITANA;450960;4;1;0;0;0;4;1;450960;LED 55 UN55TU7090GXZS SMART TV UHD;ELECTRONICA MAYOR
17096217;;F;33;CHILENO;;Millenial;PICA                          ;TARAPACA;269980;2;2;0;0;0;2;2;269980;MINICOMPONENTE RN5;ELECTRONICA MAYOR
7263753;;M;64;CHILENO;;Boomers;TOCOPILLA                     ;ANTOFAGASTA;802650;4;2;0;0;0;4;2;802650;LED 60 UN60AU8000GXZS UHD SMART TV;ELECTRONICA MAYOR
14456983;;F;49;CHILENO;;X;N/D;N/D;369970;3;3;0;0;0;3;3;369970;LED 55 55P615 UHD ANDROID TV 4K;ELECTRONICA MAYOR
10552022;;F;55;CHILENO;;Boomers;N/D;N/D;421010;7;4;0;0;0;7;4;421010;LED 42 KHFH4221 SMART TV;ELECTRONICA MAYOR
9684535;;M;57;CHILENO;;Boomers;RENCA                         ;METROPOLITANA;139990;2;1;0;0;0;2;1;139990;LED KIOTO 32 MI3228 SMART TV;ELECTRONICA MAYOR
10405195;;M;56;CHILENO;;Boomers;RENCA                         ;METROPOLITANA;279990;1;1;0;0;0;1;1;279990;LED 50 KEUH50 SMART TV UHD;ELECTRONICA MAYOR
8850109;;F;57;CHILENO;;Boomers;COPIAPO                       ;ATACAMA;424950;5;1;0;0;0;5;1;424950;LED 50 UN50TU7090GXZS UHD SMART TV;ELECTRONICA MAYOR
18902485;;F;27;CHILENO;;Millenial;N/D;N/D;633950;6;3;0;0;0;6;3;633950;LED 42 KHFH4221 SMART TV;ELECTRONICA MAYOR
8058467;;F;61;CHILENO;;Boomers;PROVIDENCIA                   ;METROPOLITANA;93980;2;1;2;1;93980;0;0;0;PARLANTE ULTRAMEGA;ELECTRONICA MAYOR
16669915;;M;34;CHILENO;;Millenial;N/D;N/D;119990;1;1;0;0;0;1;1;119990;PARLANTE ULTRABUZZ;ELECTRONICA MAYOR
16828857;;F;34;CHILENO;;Millenial;PERALILLO                     ;L.G.B.OÂ´HIGGINS;204970;3;1;0;0;0;3;1;204970;PARLANTE ULTRAFORCE-I;ELECTRONICA MAYOR
10994391;;F;54;CHILENO;;Boomers;PADRE LAS CASAS               ;ARAUCANIA;211960;4;1;0;0;0;4;1;211960;LED 42 KHFH4221 SMART TV;ELECTRONICA MAYOR
10364268;;M;41;CHILENO;;X;PROVIDENCIA                   ;METROPOLITANA;159990;1;1;0;0;0;1;1;159990;LED 32 UN32T4300AGXZS HD SMART TV;ELECTRONICA MAYOR
18168274;;F;29;CHILENO;;Millenial;N/D;N/D;467970;3;1;0;0;0;3;1;467970;LED 50 50NANO75 NanoCell UHD SMART + MAGIC;ELECTRONICA MAYOR
10856327;;F;53;CHILENO;;X;PANGUIPULLI                   ;LOS RIOS;149990;1;1;0;0;0;1;1;149990;LED 32 32PHD6825 HD SMART TV;ELECTRONICA MAYOR
11835597;;M;51;CHILENO;;X;RENCA                         ;METROPOLITANA;139990;1;1;0;0;0;1;1;139990;LED 32 CS32S1 SMART TV HD NEGRO;ELECTRONICA MAYOR
6118181;;F;73;CHILENO;;Silencioso;BUIN                          ;METROPOLITANA;856950;5;2;0;0;0;5;2;856950;LED 65 KEUH6521 SMART TV UHD;ELECTRONICA MAYOR
9577554;;F;69;CHILENO;;Silencioso;MAIPU                         ;METROPOLITANA;765720;7;5;0;0;0;7;5;765720;LED 32 UN32T4300AGXZS HD SMART TV;ELECTRONICA MAYOR
4915592;;F;78;CHILENO;;Silencioso;RENCA                         ;METROPOLITANA;129990;1;1;0;0;0;1;1;129990;MINICOMPONENTE OL45;ELECTRONICA MAYOR
16937663;Soltero;F;34;CHILENO;INGENIERO EN CONTROL DE GESTION;Millenial;PROVIDENCIA                   ;METROPOLITANA;269990;2;1;2;1;269990;0;0;0;LED 50 UN50TU7090GXZS UHD SMART TV;ELECTRONICA MAYOR
15612336;;F;38;CHILENO;;X;PROVIDENCIA                   ;METROPOLITANA;169990;1;1;1;1;169990;0;0;0;LED 32 UN32T4300AGXZS HD SMART TV;ELECTRONICA MAYOR
8612332;;M;63;CHILENO;;Z;PROVIDENCIA                   ;METROPOLITANA;429960;4;2;0;0;0;4;2;429960;LED 32 UN32T4300AGXZS HD SMART TV;ELECTRONICA MAYOR
20210432;;F;22;CHILENO;;Z;PROVIDENCIA                   ;METROPOLITANA;289990;1;1;1;1;289990;0;0;0;LED 43 43UP7500 UHD SMART TV;ELECTRONICA MAYOR
11254785;;M;54;CHILENO;;X;PENALOLEN                     ;METROPOLITANA;139990;2;1;0;0;0;2;1;139990;LED KIOTO 32 MI3228 SMART TV;ELECTRONICA MAYOR
6904865;;M;68;CHILENO;;Silencioso;RENCA                         ;METROPOLITANA;29980;2;1;0;0;0;2;1;29980;PARLANTE KARAOKE 8 MAXEIGHT;ELECTRONICA MAYOR
19866462;;F;24;CHILENO;;Z;PROVIDENCIA                   ;METROPOLITANA;204980;2;1;2;1;204980;0;0;0;LED 43 Full HD Smart TV 43PFD6825;ELECTRONICA MAYOR
15770173;;F;37;CHILENO;;Millenial;N/D;N/D;154980;2;2;0;0;0;2;2;154980;PARLANTE BOLA DISCO CON MICROFONO INAL;ELECTRONICA MAYOR
13616519;Casado;F;50;CHILENO;;X;RENCA                         ;METROPOLITANA;140000;2;1;0;0;0;2;1;140000;LED KIOTO 32 MI3228 SMART TV;ELECTRONICA MAYOR
13949497;;M;42;CHILENO;;X;TALCA                         ;MAULE;599050;4;2;0;0;0;4;2;599050;PARLANTE MGULTRAEXTREME;ELECTRONICA MAYOR
26242599;Soltero;M;47;CHILENO;;Extranjero;PLACILLA                      ;L.G.B.OÂ´HIGGINS;207970;3;2;0;0;0;3;2;207970;PARLANTE MGULTRAEXTREME;ELECTRONICA MAYOR
14433860;;M;51;CHILENO;;X;LOS VILOS                     ;COQUIMBO;426960;4;2;1;1;179990;3;1;246970;PARLANTE ULTRAFORCE-I;ELECTRONICA MAYOR
9434229;;F;61;CHILENO;;Boomers;RENCA                         ;METROPOLITANA;140000;2;1;0;0;0;2;1;140000;PARLANTE ULTRAFORCE-I;ELECTRONICA MAYOR
12171734;;F;51;CHILENO;;X;VALLENAR;ATACAMA;437970;3;2;0;0;0;3;2;437970;LED 50 50P615-50P ANDROID TV PASSION LINE UHD 4K;ELECTRONICA MAYOR
19973290;;M;24;CHILENO;;Z;SAN ANTONIO                   ;VALPARAISO;416470;3;2;0;0;0;3;2;416470;LED 32 CS32S1 SMART TV HD NEGRO;ELECTRONICA MAYOR
6945024;;M;67;CHILENO;;Boomers;CURICO                        ;MAULE;443050;4;2;0;0;0;4;2;443050;LED 55UP7500 UHD SMART;ELECTRONICA MAYOR
8997279;;M;62;CHILENO;;Silencioso;PROVIDENCIA                   ;METROPOLITANA;236980;2;3;0;0;0;2;3;236980;LED 40 UN40T5290AGXZS FHD SMART TV;ELECTRONICA MAYOR
15603681;;M;38;CHILENO;;X;PROVIDENCIA                   ;METROPOLITANA;181980;2;1;0;0;0;2;1;181980;LED KIOTO 32 MI3228 SMART TV;ELECTRONICA MAYOR
17163084;;F;32;CHILENO;;Millenial;N/D;N/D;286980;2;1;0;0;0;2;1;286980;LED 43 UN43TU7090GXZS UHD SMART TV;ELECTRONICA MAYOR
19541833;;M;25;CHILENO;;Z;N/D;N/D;522970;3;2;0;0;0;3;2;522970;LED 50 UN50TU7090GXZS UHD SMART TV;ELECTRONICA MAYOR
6014272;Casado;F;74;CHILENO;;Silencioso;PROVIDENCIA                   ;METROPOLITANA;292990;3;1;0;0;0;3;1;292990;LED 50 50U6305 SMART TV ULTRA HD;ELECTRONICA MAYOR
12310742;;M;50;CHILENO;;X;COIHAIQUE                     ;AYSEN;661940;6;3;0;0;0;6;3;661940;LED 58 UN58AU7000GXZS UHD 4K SMART TV;ELECTRONICA MAYOR
16815843;;F;34;CHILENO;;Millenial;CHANCO                        ;MAULE;139990;1;1;0;0;0;1;1;139990;PARLANTE ULTRAFORCE-I;ELECTRONICA MAYOR
7884096;Casado;M;65;CHILENO;;Boomers;RENCA                         ;METROPOLITANA;139990;1;1;0;0;0;1;1;139990;LED KIOTO 32 MI3228 SMART TV;ELECTRONICA MAYOR
4161456;;F;80;CHILENO;;Silencioso;TALAGANTE                     ;METROPOLITANA;139990;1;1;0;0;0;1;1;139990;LED KIOTO 32 MI3228 SMART TV;ELECTRONICA MAYOR
13806665;;F;41;CHILENO;;X;ARAUCO                        ;BIO BIO;515960;4;2;0;0;0;4;2;515960;LED 50 UN50TU7090GXZS UHD SMART TV;ELECTRONICA MAYOR
11252624;Divorciado;M;53;CHILENO;;X;RENCA                         ;METROPOLITANA;302970;3;1;0;0;0;3;1;302970;LED 43 Full HD Smart TV 43PFD6825;ELECTRONICA MAYOR
12563321;;F;48;CHILENO;;X;ANGOL                         ;ARAUCANIA;44990;1;1;0;0;0;1;1;44990;PARLANTE SPBYF7 PORTATIL;ELECTRONICA MAYOR
9785935;;M;57;CHILENO;;Boomers;SAN BERNARDO                  ;METROPOLITANA;140970;3;1;0;0;0;3;1;140970;PARLANTE KARAOKE MGROKR NEGRO;ELECTRONICA MAYOR
7963867;;M;62;CHILENO;;Boomers;SAN ANTONIO                   ;VALPARAISO;54980;2;2;0;0;0;2;2;54980;PARLANTE KARAOKE 8 MAXEIGHT;ELECTRONICA MAYOR
14013894;;M;41;CHILENO;;X;SAN VICENTE                   ;L.G.B.OÂ´HIGGINS;599970;3;3;0;0;0;3;3;599970;LED 55UP7500 UHD SMART;ELECTRONICA MAYOR
10756606;;F;54;CHILENO;;X;ANCUD                         ;LOS LAGOS;277960;4;1;0;0;0;4;1;277960;LED 43 Full HD Smart TV 43PFD6825;ELECTRONICA MAYOR
15037437;;F;38;CHILENO;;Millenial;OVALLE                        ;COQUIMBO;1416960;4;2;0;0;0;4;2;1416960;LED 58 UN58AU7000GXZS UHD 4K SMART TV;ELECTRONICA MAYOR
9366614;;F;61;CHILENO;;Boomers;VILLA ALEMANA                 ;VALPARAISO;187980;2;1;0;0;0;2;1;187980;PARLANTE ULTRABUZZ;ELECTRONICA MAYOR
24143668;;M;32;BOLIVIANO;;Extranjero;QUINTA NORMAL                 ;METROPOLITANA;753220;10;6;10;6;753220;0;0;0;PARLANTE MGULTRAEXTREME;ELECTRONICA MAYOR
13274430;;M;45;CHILENO;;X;MAIPU;METROPOLITANA;193980;2;1;2;1;193980;0;0;0;LED 42 KHFH4221 SMART TV;ELECTRONICA MAYOR
6948755;;F;69;CHILENO;;Silencioso;VINA DEL MAR                  ;VALPARAISO;944070;12;5;0;0;0;12;5;944070;SOUNDBAR SK1;ELECTRONICA MAYOR
5618053;;F;72;CHILENO;;Silencioso;COQUIMBO                      ;COQUIMBO;199990;1;1;0;0;0;1;1;199990;LED 32LM637B HD SMART;ELECTRONICA MAYOR
26831511;;F;39;CHILENO;;Extranjero;"";"";144980;2;2;1;1;99990;1;1;44990;PARLANTE COBRA;ELECTRONICA MAYOR
9911252;;M;55;CHILENO;;Boomers;RENCA                         ;METROPOLITANA;179990;1;1;0;0;0;1;1;179990;LED 32 UN32T4300AGXZS HD SMART TV;ELECTRONICA MAYOR
10884032;;F;52;CHILENO;;X;VILLARICA                     ;ARAUCANIA;389980;2;2;0;0;0;2;2;389980;LED 43 Full HD Smart TV 43PFD6825;ELECTRONICA MAYOR
11698197;;F;51;CHILENO;;X;PUMANQUE                      ;L.G.B.OÂ´HIGGINS;337980;2;1;0;0;0;2;1;337980;LED 50 50U6305 SMART TV ULTRA HD;ELECTRONICA MAYOR
10812506;;F;55;CHILENO;;Boomers;CATEMU                        ;VALPARAISO;59990;1;1;0;0;0;1;1;59990;PARLANTE KARAOKE 12 FM/BT/USB;ELECTRONICA MAYOR
19411139;;F;26;CHILENO;;Silencioso;PROVIDENCIA                   ;METROPOLITANA;53980;2;1;2;1;53980;0;0;0;KARAOKE PORTATIL TWO-EIGHT 8860;ELECTRONICA MAYOR
12541631;;F;49;CHILENO;;X;RENCA                         ;METROPOLITANA;179980;2;1;0;0;0;2;1;179980;MONITOR 24 24TL520S SMART TV HD;ELECTRONICA MAYOR
19798908;;F;23;CHILENO;;Millenial;SAN CARLOS                    ;BIO BIO;414980;2;2;0;0;0;2;2;414980;LED 58 UN58AU7000GXZS UHD 4K SMART TV;ELECTRONICA MAYOR
17937807;;M;30;CHILENO;;Millenial;N/D;N/D;879610;5;2;5;2;879610;0;0;0;LED 60 UN60AU8000GXZS UHD SMART TV;ELECTRONICA MAYOR
11765796;Casado;M;51;CHILENO;;X;RENCA                         ;METROPOLITANA;44990;1;1;0;0;0;1;1;44990;PARLANTE SPBYF7 PORTATIL;ELECTRONICA MAYOR
16437160;;M;35;CHILENO;;Millenial;ANTOFAGASTA                   ;ANTOFAGASTA;279990;1;1;0;0;0;1;1;279990;LED 43 43UP7500 UHD SMART TV;ELECTRONICA MAYOR
10947921;;F;50;CHILENO;;Millenial;N/D;N/D;77980;2;1;0;0;0;2;1;77980;PARLANTE SENSEIGTH K3175;ELECTRONICA MAYOR
11449561;;M;52;CHILENO;;X;PROVIDENCIA                   ;METROPOLITANA;54990;1;1;0;0;0;1;1;54990;PARLANTE KARAOKE 12 FM/BT/USB;ELECTRONICA MAYOR
15327403;;M;42;CHILENO;;X;PUENTE ALTO                   ;METROPOLITANA;410960;4;2;0;0;0;4;2;410960;LED 43 43UP7500 UHD SMART TV;ELECTRONICA MAYOR
11993688;;M;49;CHILENO;;X;SAN BERNARDO                  ;METROPOLITANA;302980;2;2;0;0;0;2;2;302980;PARLANTE ULTRASENSATION;ELECTRONICA MAYOR
8077505;;F;63;CHILENO;;Boomers;PROVIDENCIA                   ;METROPOLITANA;169990;1;1;0;0;0;1;1;169990;LED 32 UN32T4300AGXZS HD SMART TV;ELECTRONICA MAYOR
9514045;;M;59;CHILENO;;Boomers;COIHAIQUE                     ;AYSEN;459980;2;1;0;0;0;2;1;459980;LED 50 UN50TU7090GXZS UHD SMART TV;ELECTRONICA MAYOR
9026610;;M;57;CHILENO;;Boomers;PUERTO MONTT                  ;LOS LAGOS;69990;1;1;0;0;0;1;1;69990;KARAOKE BLACK PHANTER II;ELECTRONICA MAYOR
13446994;;M;43;CHILENO;;X;PROVIDENCIA                   ;METROPOLITANA;184980;2;1;0;0;0;2;1;184980;PARLANTE ULTRAFUSION;ELECTRONICA MAYOR
20044318;;F;23;CHILENO;;Z;SAN BERNARDO                  ;METROPOLITANA;483960;5;2;5;2;483960;0;0;0;PARLANTE ULTRAMAGIC;ELECTRONICA MAYOR
16115301;;F;37;CHILENO;;Millenial;RENCA                         ;METROPOLITANA;1290550;4;3;0;0;0;4;3;1290550;LED 55 UN55TU7090GXZS SMART TV UHD;ELECTRONICA MAYOR
11560735;;M;54;CHILENO;;X;RENCA                         ;METROPOLITANA;44990;1;1;0;0;0;1;1;44990;PARLANTE COBRA;ELECTRONICA MAYOR
18360477;;F;28;CHILENO;;Millenial;TALCA                         ;MAULE;564970;4;2;0;0;0;4;2;564970;LED 42 42S6500 ANDROID TV FHD;ELECTRONICA MAYOR
7890495;;M;71;CHILENO;;Silencioso;PUDAHUEL                      ;METROPOLITANA;19990;1;1;0;0;0;1;1;19990;KARAOKE STREET SONG 4 MICÂ CABLEÂ BLACK 8900;ELECTRONICA MAYOR
17238088;;F;33;CHILENO;;Millenial;PROVIDENCIA                   ;METROPOLITANA;56980;2;2;0;0;0;2;2;56980;PARLANTE KARAOKE MGROCKET PLUS;ELECTRONICA MAYOR
10701269;;M;52;CHILENO;;X;ROMERAL                       ;MAULE;220948;5;2;0;0;0;5;2;220948;PARLANTE ULTRAMAGIC;ELECTRONICA MAYOR
11979474;;M;50;CHILENO;;X;BUIN                          ;METROPOLITANA;324970;3;2;0;0;0;3;2;324970;LED 50 50P615-50P ANDROID TV PASSION LINE UHD 4K;ELECTRONICA MAYOR
14340261;;F;44;CHILENO;;X;PUENTE ALTO                   ;METROPOLITANA;279990;1;3;0;0;0;1;3;279990;LED 43 43UP7500 UHD SMART TV;ELECTRONICA MAYOR
26356227;;F;34;VENEZOLANO;;Extranjero;N/D;N/D;193980;2;1;2;1;193980;0;0;0;LED 43 43S5305 SMART TV FULL HD;ELECTRONICA MAYOR
19029849;Soltero;M;27;CHILENO;;Z;PROVIDENCIA                   ;METROPOLITANA;139990;1;1;1;1;139990;0;0;0;LED 32 KHHD3221 SMART TV;ELECTRONICA MAYOR
11271699;;M;54;CHILENO;;X;ISLA DE MAIPO                 ;METROPOLITANA;269990;1;1;0;0;0;1;1;269990;LED 50 50U6305 SMART TV ULTRA HD;ELECTRONICA MAYOR
21754214;;M;54;PERUANO;;Extranjero;N/D;N/D;420970;3;1;0;0;0;3;1;420970;LED 50 UN50TU7090GXZS UHD SMART TV;ELECTRONICA MAYOR
9758568;;F;57;CHILENO;;Boomers;TALCA                         ;MAULE;591960;4;2;0;0;0;4;2;591960;LED 32 UN32T4300AGXZS HD SMART TV;ELECTRONICA MAYOR
13873940;;F;41;CHILENO;;X;COPIAPO                       ;ATACAMA;24990;1;1;0;0;0;1;1;24990;PARLANTE KARAOKE 8 MAXEIGHT;ELECTRONICA MAYOR
9682594;;M;57;CHILENO;;Boomers;ANTOFAGASTA                   ;ANTOFAGASTA;231980;2;1;0;0;0;2;1;231980;PARLANTE ULTRAFORCE-I;ELECTRONICA MAYOR
17825064;;F;30;CHILENO;;Millenial;TALCA;MAULE;365470;3;2;3;2;365470;0;0;0;LED 55UP7500 UHD SMART;ELECTRONICA MAYOR
14279865;;M;49;CHILENO;;X;HUALQUI                       ;BIO BIO;189990;1;1;0;0;0;1;1;189990;LED 40 KEHD4020 SMART TV;ELECTRONICA MAYOR
18901541;;F;27;CHILENO;;Millenial;NUEVA IMPERIAL                ;ARAUCANIA;222960;4;3;0;0;0;4;3;222960;PARLANTE KARAOKE MGROCKET PLUS;ELECTRONICA MAYOR
12772773;;F;47;CHILENO;;X;ANGOL                         ;ARAUCANIA;54990;1;1;0;0;0;1;1;54990;PARLANTE KARAOKE PINGUINO PORTATIL NEGRO;ELECTRONICA MAYOR
17515023;Casado;M;35;CHILENO;;Millenial;CORONEL                       ;BIO BIO;139990;1;1;0;0;0;1;1;139990;LED 32 KHHD3221 SMART TV;ELECTRONICA MAYOR
15823512;;M;41;CHILENO;;X;MAIPU                         ;METROPOLITANA;567970;3;1;0;0;0;3;1;567970;LED 43 UN43TU7090GXZS UHD SMART TV;ELECTRONICA MAYOR
21366696;;F;44;BOLIVIANO;;Extranjero;ARICA                         ;TARAPACA;940470;3;2;0;0;0;3;2;940470;OLED 55 A1 UHD SMART + MAGIC;ELECTRONICA MAYOR
15700833;Soltero;M;38;CHILENO;;X;PROVIDENCIA                   ;METROPOLITANA;389990;1;1;0;0;0;1;1;389990;LED 55UP7500 UHD SMART;ELECTRONICA MAYOR
16506551;;M;35;CHILENO;;Millenial;CALBUCO                       ;LOS LAGOS;139990;1;1;0;0;0;1;1;139990;LED KIOTO 32 MI3228 SMART TV;ELECTRONICA MAYOR
10743095;;F;52;CHILENO;;X;PROVIDENCIA                   ;METROPOLITANA;43980;2;1;2;1;43980;0;0;0;KARAOKE PORTATIL TWO-EIGHT 8860;ELECTRONICA MAYOR
18660507;;M;27;CHILENO;;Millenial;HIJUELAS                      ;VALPARAISO;69990;1;1;0;0;0;1;1;69990;PARLANTE SENSEIGTH K3175;ELECTRONICA MAYOR
17296337;;F;33;CHILENO;;Millenial;PUERTO MONTT;LOS LAGOS;74990;1;1;1;1;74990;0;0;0;PARLANTE MGVIPER;ELECTRONICA MAYOR
12544786;;F;48;CHILENO;;X;RETIRO                        ;MAULE;1177010;9;5;0;0;0;9;5;1177010;LED 55 UN55TU7090GXZS SMART TV UHD;ELECTRONICA MAYOR
16827753;;M;34;CHILENO;;Millenial;PARRAL                        ;MAULE;209990;1;1;0;0;0;1;1;209990;LED 40 UN40T5290AGXZS FHD SMART TV;ELECTRONICA MAYOR
5699757;;M;74;CHILENO;;Silencioso;LEBU                          ;BIO BIO;415970;3;1;0;0;0;3;1;415970;LED 50 50PUD7625 SMART TV ULTRA HD 4K;ELECTRONICA MAYOR
8970224;;M;60;CHILENO;;Boomers;LLAILLAY                      ;VALPARAISO;77980;2;1;0;0;0;2;1;77980;SOUNDBAR SK1;ELECTRONICA MAYOR
9152378;Viudo;M;60;CHILENO;;Boomers;VALPARAISO                    ;VALPARAISO;273980;2;1;0;0;0;2;1;273980;LED 40 UN40T5290AGXZS FHD SMART TV;ELECTRONICA MAYOR
16389469;;F;36;CHILENO;;Millenial;MAIPU                         ;METROPOLITANA;0;0;2;0;0;0;0;2;0;PARLANTE KARAOKE 12 FM/BT/USB;ELECTRONICA MAYOR
10744072;;F;57;CHILENO;;Boomers;"";"";69990;1;1;0;0;0;1;1;69990;PARLANTE SENSEIGTH K3175;ELECTRONICA MAYOR
26405345;;M;38;VENEZOLANO;;Extranjero;TALAGANTE                     ;METROPOLITANA;464970;3;2;1;1;399990;2;1;64980;LED 58 UN58AU7000GXZS UHD 4K SMART TV;ELECTRONICA MAYOR
19082115;;M;27;CHILENO;;Z;VILLA ALEMANA                 ;VALPARAISO;110970;3;2;0;0;0;3;2;110970;PARLANTE SENSEIGTH K3175;ELECTRONICA MAYOR
10446352;;M;57;CHILENO;;Boomers;ARAUCO                        ;BIO BIO;443970;3;2;2;1;343980;1;1;99990;PARLANTE ULTRAMAGIC;ELECTRONICA MAYOR
16810182;;M;34;CHILENO;;Millenial;N/D;N/D;519970;3;2;0;0;0;3;2;519970;LED 32 UN32T4300AGXZS HD SMART TV;ELECTRONICA MAYOR
19694774;;F;24;CHILENO;;Z;NATALES                       ;MAGALLANES;314990;1;1;0;0;0;1;1;314990;LED 50 UN50TU7090GXZS UHD SMART TV;ELECTRONICA MAYOR
19363879;;M;25;CHILENO;;Z;TALCA                         ;MAULE;249990;1;1;0;0;0;1;1;249990;LED 43 43LM6370 SMART TV FHD;ELECTRONICA MAYOR
26310118;;F;32;EXTRANJERO - NO INFORMA NACIONALIDAD;;Extranjero;QUILLOTA                      ;VALPARAISO;22990;1;1;0;0;0;1;1;22990;KARAOKE STREET SONG 4 MICÂ CABLEÂ BLACK 8900;ELECTRONICA MAYOR
7619913;;M;66;CHILENO;;Boomers;TALCAHUANO                    ;BIO BIO;579990;1;3;0;0;0;1;3;579990;LED 50 UN50TU7090GXZS UHD SMART TV;ELECTRONICA MAYOR
14335617;;F;44;CHILENO;;X;PELARCO                       ;MAULE;79980;2;1;2;1;79980;0;0;0;PARLANTE COBRA;ELECTRONICA MAYOR
5662411;;F;76;CHILENO;;Silencioso;MELIPILLA                     ;METROPOLITANA;205980;2;1;0;0;0;2;1;205980;LED KIOTO 32 MI3228 SMART TV;ELECTRONICA MAYOR
18475854;Soltero;M;28;CHILENO;MATRON;Millenial;PROVIDENCIA                   ;METROPOLITANA;139990;1;1;0;0;0;1;1;139990;LED KIOTO 32 MI3228 SMART TV;ELECTRONICA MAYOR
18695411;;F;28;CHILENO;;Millenial;PANGUIPULLI                   ;LOS RIOS;298969;3;1;0;0;0;3;1;298969;LED 50 KEUH50 SMART TV UHD;ELECTRONICA MAYOR
12072744;;F;54;CHILENO;;X;PUCHUNCAVI                    ;VALPARAISO;264970;3;2;2;1;234980;1;1;29990;KARAOKE DEPP BOUNCE 2 MIC ORANGE 8904;ELECTRONICA MAYOR
7234245;;M;68;CHILENO;;Silencioso;PENCAHUE                      ;MAULE;359980;2;1;0;0;0;2;1;359980;LED 50 50PUD7625 SMART TV ULTRA HD 4K;ELECTRONICA MAYOR
13108856;;F;46;CHILENO;;X;CORONEL                       ;BIO BIO;509980;2;2;0;0;0;2;2;509980;LED 55 UN55TU7090GXZS SMART TV UHD;ELECTRONICA MAYOR
18277124;Soltero;M;29;CHILENO;;Millenial;PROVIDENCIA                   ;METROPOLITANA;34990;1;1;0;0;0;1;1;34990;KARAOKE FUNKY DISCO;ELECTRONICA MAYOR
15289471;;F;40;CHILENO;;X;PROVIDENCIA                   ;METROPOLITANA;119990;1;1;0;0;0;1;1;119990;PARLANTE MEGALUX K2777;ELECTRONICA MAYOR
18487811;Soltero;M;29;CHILENO;;Millenial;PROVIDENCIA                   ;METROPOLITANA;303980;2;1;0;0;0;2;1;303980;LED 40 UN40T5290AGXZS FHD SMART TV;ELECTRONICA MAYOR
7544720;;F;67;CHILENO;;Boomers;SANTIAGO                      ;METROPOLITANA;881940;6;2;0;0;0;6;2;881940;LED 65 KEUH6521 SMART TV UHD;ELECTRONICA MAYOR
14371655;;M;50;CHILENO;;X;OVALLE                        ;COQUIMBO;179990;1;1;0;0;0;1;1;179990;LED 32 UN32T4300AGXZS HD SMART TV;ELECTRONICA MAYOR
15288896;;M;38;CHILENO;;Millenial;PROVIDENCIA                   ;METROPOLITANA;93980;2;1;0;0;0;2;1;93980;PARLANTE MGVIPER;ELECTRONICA MAYOR
8100086;;F;62;CHILENO;;Boomers;N/D;N/D;1048970;3;1;0;0;0;3;1;1048970;LED 75UP7500 UHD SMART;ELECTRONICA MAYOR
10200368;;F;57;CHILENO;;Boomers;VICTORIA                      ;ARAUCANIA;179990;1;1;0;0;0;1;1;179990;LED 40 KEHD4020 SMART TV;ELECTRONICA MAYOR
12297416;;M;49;CHILENO;;X;RENCA                         ;METROPOLITANA;39990;1;1;1;1;39990;0;0;0;PARLANTE COBRA;ELECTRONICA MAYOR
25684601;;F;32;HAITIANO;;Extranjero;PUENTE ALTO                   ;METROPOLITANA;256980;2;1;0;0;0;2;1;256980;LED 43 UN43TU7090GXZS UHD SMART TV;ELECTRONICA MAYOR
19762798;;M;24;CHILENO;;Z;TEMUCO                        ;ARAUCANIA;792930;6;2;4;1;566950;2;1;225980;PARLANTE ULTRAFORCE-I;ELECTRONICA MAYOR
11980423;;M;50;CHILENO;;X;ALHUE                         ;METROPOLITANA;353970;3;1;0;0;0;3;1;353970;LED 43 43UP7500 UHD SMART TV;ELECTRONICA MAYOR
19939124;;M;24;CHILENO;;Z;CAUQUENES                     ;MAULE;297980;2;1;0;0;0;2;1;297980;LED 50 50PUD7625 SMART TV ULTRA HD 4K;ELECTRONICA MAYOR
13811060;;F;43;CHILENO;;X;SAAVEDRA                      ;ARAUCANIA;545950;5;3;0;0;0;5;3;545950;LED 43 43S5305 SMART TV FULL HD;ELECTRONICA MAYOR
14752051;Casado;M;54;ECUATORIANO;;Extranjero;RECOLETA                      ;METROPOLITANA;199990;1;1;0;0;0;1;1;199990;LED 40 UN40T5290AGXZS FHD SMART TV;ELECTRONICA MAYOR
11063218;;F;56;CHILENO;;Boomers;VICTORIA                      ;ARAUCANIA;215470;2;1;0;0;0;2;1;215470;MINICOMPONENTE RN7;ELECTRONICA MAYOR
26071294;;M;27;VENEZOLANO;;Extranjero;SANTIAGO                      ;METROPOLITANA;349980;2;2;0;0;0;2;2;349980;LED 32 32S5295 SMART TV HD;ELECTRONICA MAYOR
9870668;;F;63;CHILENO;;Boomers;CALBUCO                       ;LOS LAGOS;24990;1;1;0;0;0;1;1;24990;KARAOKE EXTRA SAVAGE MICÂ CABLEÂ BLACK 8902;ELECTRONICA MAYOR
16824948;;F;33;CHILENO;;Millenial;LAUTARO                       ;ARAUCANIA;129990;1;1;0;0;0;1;1;129990;LED KIOTO 32 MI3228 SMART TV;ELECTRONICA MAYOR
11000455;;F;57;CHILENO;;Boomers;MELIPEUCO                     ;ARAUCANIA;309990;1;1;0;0;0;1;1;309990;LED 50 50UP7500 UHD SMART TV;ELECTRONICA MAYOR
18901148;;F;34;CHILENO;;Silencioso;PROVIDENCIA                   ;METROPOLITANA;484830;2;1;0;0;0;2;1;484830;LED 58 UN58AU7000GXZS UHD 4K SMART TV;ELECTRONICA MAYOR
11455807;Casado;M;53;CHILENO;;X;PROVIDENCIA                   ;METROPOLITANA;107370;2;1;0;0;0;2;1;107370;PARLANTE KARAOKE MGROKR NEGRO;ELECTRONICA MAYOR
10244552;;M;57;CHILENO;;Boomers;RENCA                         ;METROPOLITANA;221570;2;1;0;0;0;2;1;221570;LED 42 KHFH4221 SMART TV;ELECTRONICA MAYOR
19329788;;M;25;CHILENO;;Silencioso;PROVIDENCIA                   ;METROPOLITANA;213970;3;1;3;1;213970;0;0;0;LED 32 32PHD6825 HD SMART TV;ELECTRONICA MAYOR
8736098;;M;61;CHILENO;;Boomers;TALCA                         ;MAULE;374070;2;1;0;0;0;2;1;374070;LED 50 50UP7500 UHD SMART TV;ELECTRONICA MAYOR
19128201;;F;25;CHILENO;;Z;PROVIDENCIA                   ;METROPOLITANA;509980;2;2;2;2;509980;0;0;0;PARLANTE ULTRAFUSION;ELECTRONICA MAYOR
11845649;;F;51;CHILENO;;X;N/D;N/D;229990;2;1;2;1;229990;0;0;0;LED 43 43S5305 SMART TV FULL HD;ELECTRONICA MAYOR
16502465;;M;35;CHILENO;;Millenial;PROVIDENCIA                   ;METROPOLITANA;184980;2;1;2;1;184980;0;0;0;LED 42 KHFH4221 SMART TV;ELECTRONICA MAYOR
17444071;;M;32;CHILENO;;Millenial;MAULE                         ;MAULE;325480;2;1;2;1;325480;0;0;0;MINICOMPONENTE MX-T70/ZS ALL IN ONE;ELECTRONICA MAYOR
7091465;;F;67;CHILENO;;Boomers;LOS ANDES                     ;VALPARAISO;139990;1;1;0;0;0;1;1;139990;MINICOMPONENTE OL45;ELECTRONICA MAYOR
19472689;;M;25;CHILENO;;Z;EL MONTE;METROPOLITANA;149990;1;1;0;0;0;1;1;149990;LED 42 KHFH4221 SMART TV;ELECTRONICA MAYOR
5215244;;M;77;CHILENO;;Silencioso;CORONEL                       ;BIO BIO;289990;1;1;0;0;0;1;1;289990;LED 43 43UP7500 UHD SMART TV;ELECTRONICA MAYOR
6991909;;M;68;CHILENO;;Boomers;MAIPU                         ;METROPOLITANA;241570;2;1;0;0;0;2;1;241570;LED 32 KHHD3221 SMART TV;ELECTRONICA MAYOR
26724532;;M;29;EXTRANJERO - NO INFORMA NACIONALIDAD;;Extranjero;QUINTA NORMAL                 ;METROPOLITANA;292450;4;1;0;0;0;4;1;292450;LED 42 KHFH4221 SMART TV;ELECTRONICA MAYOR
26404141;;M;32;DOMINICANO;;Extranjero;N/D;N/D;1720660;5;4;2;1;905840;3;3;814820;LED 55UP7500 UHD SMART;ELECTRONICA MAYOR
25931833;;M;45;CHILENO;;Extranjero;N/D;N/D;214990;1;1;0;0;0;1;1;214990;LED 43 43S5305 SMART TV FULL HD;ELECTRONICA MAYOR
13631125;;F;44;CHILENO;;X;LUMACO                        ;ARAUCANIA;34990;1;1;0;0;0;1;1;34990;PARLANTE SPBYF7 PORTATIL;ELECTRONICA MAYOR
12345774;;M;53;CHILENO;;X;RENCA                         ;METROPOLITANA;469990;1;1;0;0;0;1;1;469990;LED 60 UN60AU8000GXZS UHD SMART TV;ELECTRONICA MAYOR
12412027;;F;49;CHILENO;;X;RENCA                         ;METROPOLITANA;97980;2;2;0;0;0;2;2;97980;PARLANTE KARAOKE MGROKR NEGRO;ELECTRONICA MAYOR
8194356;;F;60;CHILENO;;Boomers;PUERTO MONTT                  ;LOS LAGOS;327980;2;1;0;0;0;2;1;327980;LED 50 50P615-50P ANDROID TV PASSION LINE UHD 4K;ELECTRONICA MAYOR
15649003;;M;39;CHILENO;;X;"";"";253970;4;2;4;2;253970;0;0;0;LED 40 40S65A-40P ANDROID TV SMART LINE FHD;ELECTRONICA MAYOR
6155495;;M;73;CHILENO;;Silencioso;SAN FERNANDO                  ;L.G.B.OÂ´HIGGINS;803070;2;1;0;0;0;2;1;803070;LED 70 UN70AU7000GXZS UHD;ELECTRONICA MAYOR
12994848;;M;45;CHILENO;;X;N/D;N/D;84979;2;1;0;0;0;2;1;84979;PARLANTE MGVIPER;ELECTRONICA MAYOR
20116305;;F;23;CHILENO;;Silencioso;PROVIDENCIA                   ;METROPOLITANA;1452460;11;3;11;3;1452460;0;0;0;LED 70 UN70AU7000GXZS UHD;ELECTRONICA MAYOR
18152548;;F;30;CHILENO;;Millenial;HUECHURABA                    ;METROPOLITANA;315990;2;1;2;1;315990;0;0;0;LED 40 UN40T5290AGXZS FHD SMART TV;ELECTRONICA MAYOR
15425342;;M;39;CHILENO;;X;PROVIDENCIA                   ;METROPOLITANA;139980;2;1;0;0;0;2;1;139980;MINICOMPONENTE MHC-V02 ALL IN ONE;ELECTRONICA MAYOR
16538587;;F;35;CHILENO;;Extranjero;"";"";349990;1;1;1;1;349990;0;0;0;LED 58 58PUD7625 BORDES ULTRA DELGADOS 4K UHD;ELECTRONICA MAYOR
15619414;Casado;M;38;CHILENO;;X;PROVIDENCIA                   ;METROPOLITANA;309990;1;1;0;0;0;1;1;309990;LED 50 50UP7500 UHD SMART TV;ELECTRONICA MAYOR
26714580;;M;22;VENEZOLANO;;Extranjero;"";"";349990;1;1;0;0;0;1;1;349990;LED 55UP7500 UHD SMART;ELECTRONICA MAYOR
19215215;;F;26;CHILENO;;Z;ANTOFAGASTA                   ;ANTOFAGASTA;99990;1;1;0;0;0;1;1;99990;MINICOMPONENTE OL45;ELECTRONICA MAYOR
16582661;;M;34;CHILENO;;Millenial;PUENTE ALTO;METROPOLITANA;394980;2;2;0;0;0;2;2;394980;LED 55 UN55TU7090GXZS SMART TV UHD;ELECTRONICA MAYOR
16669896;;M;34;CHILENO;;Millenial;EL MONTE                      ;METROPOLITANA;249990;1;1;0;0;0;1;1;249990;LED 43 UN43TU7090GXZS UHD SMART TV;ELECTRONICA MAYOR
18347129;Soltero;F;29;CHILENO;;Extranjero;PROVIDENCIA                   ;METROPOLITANA;43980;2;1;2;1;43980;0;0;0;PARLANTE COBRA;ELECTRONICA MAYOR
12836763;;M;47;CHILENO;;X;N/D;N/D;487960;4;3;0;0;0;4;3;487960;LED 49 49UN7100 UHD SMART TV;ELECTRONICA MAYOR
14042982;;F;41;CHILENO;;X;N/D;N/D;233470;2;2;0;0;0;2;2;233470;MINICOMPONENTE RN7;ELECTRONICA MAYOR
11735912;;M;50;CHILENO;;X;VILLA ALEMANA                 ;VALPARAISO;22120;-1;2;0;0;0;-1;2;22120;LED 50 50U6305 SMART TV ULTRA HD;ELECTRONICA MAYOR
6988020;;F;68;CHILENO;;Boomers;LA CISTERNA                   ;METROPOLITANA;199990;1;1;0;0;0;1;1;199990;LED 43 43S5305 SMART TV FULL HD;ELECTRONICA MAYOR
18247761;;F;29;CHILENO;;Millenial;ANTOFAGASTA                   ;ANTOFAGASTA;242710;2;1;0;0;0;2;1;242710;MINICOMPONENTE RN7;ELECTRONICA MAYOR
19205556;Soltero;F;26;CHILENO;;Z;FREIRINA;ATACAMA;289990;1;1;0;0;0;1;1;289990;LED 50 50U6305 SMART TV ULTRA HD;ELECTRONICA MAYOR
15244347;;F;38;CHILENO;;Millenial;PROVIDENCIA                   ;METROPOLITANA;46980;2;1;2;1;46980;0;0;0;KARAOKE 8 CITY SET MIC WIRELESS ATRIL SILVER;ELECTRONICA MAYOR
19665302;;F;23;CHILENO;;Z;N/D;N/D;218670;2;1;0;0;0;2;1;218670;MINICOMPONENTE RN5;ELECTRONICA MAYOR
10317507;;F;53;CHILENO;;X;ARICA                         ;ARICA Y PARINACOTA;479990;1;1;0;0;0;1;1;479990;LED 60UP7750 UHD SMART + MAGIC;ELECTRONICA MAYOR
8207281;;M;65;CHILENO;;Boomers;COIHAIQUE                     ;AYSEN;453850;4;1;0;0;0;4;1;453850;LED 50 50PUD7625 SMART TV ULTRA HD 4K;ELECTRONICA MAYOR
13526418;;M;49;CHILENO;;X;CASTRO                        ;LOS LAGOS;164990;1;1;0;0;0;1;1;164990;SOUNDBAR TAB7305;ELECTRONICA MAYOR
17432402;;F;32;CHILENO;;Millenial;IQUIQUE                       ;TARAPACA;329990;1;1;1;1;329990;0;0;0;LED 50 UN50TU7090GXZS UHD SMART TV;ELECTRONICA MAYOR
20147208;;M;22;CHILENO;;Silencioso;PROVIDENCIA                   ;METROPOLITANA;299990;2;1;2;1;299990;0;0;0;LED 50 50PUD7625 SMART TV ULTRA HD 4K;ELECTRONICA MAYOR
19223268;;F;26;CHILENO;;Z;PUENTE ALTO                   ;METROPOLITANA;532500;4;2;0;0;0;4;2;532500;LED 55 55P615 UHD ANDROID TV 4K;ELECTRONICA MAYOR
27095975;;M;25;EXTRANJERO - NO INFORMA NACIONALIDAD;;Extranjero;"";"";397172;3;2;0;0;0;3;2;397172;LED 50 50UP7750 FHD SMART TV + MAGIC;ELECTRONICA MAYOR
4967670;;F;79;CHILENO;;Silencioso;REQUINOA                      ;L.G.B.OÂ´HIGGINS;228570;2;1;0;0;0;2;1;228570;LED 43 43S5305 SMART TV FULL HD;ELECTRONICA MAYOR
6539051;;M;67;CHILENO;;Boomers;SANTIAGO                      ;METROPOLITANA;155980;2;2;2;2;155980;0;0;0;LED 32 KHHD3221 SMART TV;ELECTRONICA MAYOR
15282645;;M;43;CHILENO;;Millenial;N/D;N/D;354970;3;2;0;0;0;3;2;354970;LED 42 KHFH4221 SMART TV;ELECTRONICA MAYOR
10476520;;F;58;CHILENO;;Boomers;SAN BERNARDO                  ;METROPOLITANA;195970;3;1;0;0;0;3;1;195970;MONITOR 24 24TL520S SMART TV HD;ELECTRONICA MAYOR
18855687;;F;27;CHILENO;;Z;PROVIDENCIA                   ;METROPOLITANA;185840;2;1;2;1;185840;0;0;0;LED 42 KHFH4221 SMART TV;ELECTRONICA MAYOR
16455175;;F;35;CHILENO;;Millenial;"";"";425480;2;1;2;1;425480;0;0;0;LED 50 50NANO75 NanoCell UHD SMART + MAGIC;ELECTRONICA MAYOR
17730568;;F;31;CHILENO;;Millenial;N/D;N/D;459970;4;2;4;2;459970;0;0;0;LED 43 UN43TU7090GXZS UHD SMART TV;ELECTRONICA MAYOR
12029758;;F;41;CHILENO;;X;RENCA                         ;METROPOLITANA;434980;2;1;2;1;434980;0;0;0;LED 58 UN58AU7000GXZS UHD 4K SMART TV;ELECTRONICA MAYOR
15653921;;F;38;CHILENO;;X;"";"";189990;1;1;1;1;189990;0;0;0;LED 42 KHFH4221 SMART TV;ELECTRONICA MAYOR
16852692;Soltero;M;33;CHILENO;;Millenial;PROVIDENCIA                   ;METROPOLITANA;209990;1;2;0;0;0;1;2;209990;LED 32LM637B HD SMART;ELECTRONICA MAYOR
10167333;;M;56;CHILENO;;Boomers;COQUIMBO                      ;COQUIMBO;307540;2;1;2;1;307540;0;0;0;LED 49 49UN7100 UHD SMART TV;ELECTRONICA MAYOR
20094844;;F;23;CHILENO;;Z;PERQUENCO                     ;ARAUCANIA;193570;2;3;0;0;0;2;3;193570;LED 32 CS32S1 SMART TV HD NEGRO;ELECTRONICA MAYOR
14315902;;M;46;CHILENO;;X;RENCA                         ;METROPOLITANA;319990;1;1;1;1;319990;0;0;0;LED 50 50UP7500 UHD SMART TV;ELECTRONICA MAYOR
25036207;;F;25;PERUANO;;Extranjero;N/D;N/D;229990;1;1;0;0;0;1;1;229990;LED 43 43S5305 SMART TV FULL HD;ELECTRONICA MAYOR
19683898;;F;25;CHILENO;;Z;N/D;N/D;327350;4;2;0;0;0;4;2;327350;MINICOMPONENTE RN5;ELECTRONICA MAYOR
16101578;;M;38;CHILENO;;Millenial;COIHAIQUE                     ;AYSEN;408980;2;1;0;0;0;2;1;408980;LED 55 UN55TU7090GXZS SMART TV UHD;ELECTRONICA MAYOR
7612511;;M;64;CHILENO;;Boomers;ANGOL                         ;ARAUCANIA;404980;2;1;2;1;404980;0;0;0;LED 55UP7500 UHD SMART;ELECTRONICA MAYOR
17585704;;M;31;CHILENO;;Millenial;PROVIDENCIA                   ;METROPOLITANA;189990;2;1;2;1;189990;0;0;0;LED 32LM637B HD SMART;ELECTRONICA MAYOR
11539487;;M;51;CHILENO;;X;CURANILAHUE                   ;BIO BIO;299990;1;1;0;0;0;1;1;299990;LED 50 50U6305 SMART TV ULTRA HD;ELECTRONICA MAYOR
13916109;;F;42;CHILENO;;X;ISLA DE MAIPO                 ;METROPOLITANA;307960;4;2;4;2;307960;0;0;0;LED 42 KHFH4221 SMART TV;ELECTRONICA MAYOR
15052262;;M;39;CHILENO;;X;LA SERENA                     ;COQUIMBO;375080;3;1;3;1;375080;0;0;0;MINICOMPONENTE MX-T50/ZS ALL IN ONE;ELECTRONICA MAYOR
12803520;;F;48;CHILENO;;X;N/D;N/D;69990;1;1;1;1;69990;0;0;0;SISTEMA DE SONIDO CM1560;ELECTRONICA MAYOR
13529795;;M;42;CHILENO;;X;"";"";319560;3;1;0;0;0;3;1;319560;LED 40 UN40T5290AGXZS FHD SMART TV;ELECTRONICA MAYOR
22617744;Soltero;M;45;ARGENTINO;;Extranjero;PROVIDENCIA                   ;METROPOLITANA;313980;2;1;2;1;313980;0;0;0;LED 43 43UP7500 UHD SMART TV;ELECTRONICA MAYOR
13979487;Casado;M;40;CHILENO;INGENIERO EN MAQUINARIA;X;RENCA                         ;METROPOLITANA;199990;1;1;0;0;0;1;1;199990;LED 32 UN32T4300AGXZS HD SMART TV;ELECTRONICA MAYOR
15330454;;M;40;CHILENO;;Silencioso;PROVIDENCIA                   ;METROPOLITANA;263980;2;1;2;1;263980;0;0;0;LED 40 UN40T5290AGXZS FHD SMART TV;ELECTRONICA MAYOR
16716710;;F;34;CHILENO;;Millenial;PELARCO                       ;MAULE;527550;4;1;0;0;0;4;1;527550;LED 55 55P615 UHD ANDROID TV 4K;ELECTRONICA MAYOR
9666526;;M;52;CHILENO;;X;PROVIDENCIA                   ;METROPOLITANA;399980;2;1;2;1;399980;0;0;0;LED 55 UN55TU7090GXZS SMART TV UHD;ELECTRONICA MAYOR
13332068;;F;43;CHILENO;;X;QUILLOTA                      ;VALPARAISO;277710;3;1;0;0;0;3;1;277710;LED 43 CS43F2 SMART TV FHD NEGRO;ELECTRONICA MAYOR
12958526;;M;45;CHILENO;;X;VILCUN                        ;ARAUCANIA;419990;1;1;0;0;0;1;1;419990;LED 55UP7500 UHD SMART;ELECTRONICA MAYOR
10530794;;F;57;CHILENO;;Boomers;QUEILEN                       ;LOS LAGOS;159990;1;1;0;0;0;1;1;159990;LED 32 KHHD3221 SMART TV;ELECTRONICA MAYOR
5337076;;M;73;CHILENO;;Silencioso;RENCA                         ;METROPOLITANA;211570;2;1;0;0;0;2;1;211570;LED 32 KHHD3221 SMART TV;ELECTRONICA MAYOR
6934536;;F;69;CHILENO;;Silencioso;VINA DEL MAR                  ;VALPARAISO;294560;3;1;0;0;0;3;1;294560;LED 43 Full HD Smart TV 43PFD6825;ELECTRONICA MAYOR
17738217;;F;31;CHILENO;;Millenial;N/D;N/D;124980;2;2;0;0;0;2;2;124980;PARLANTE ULTRAMEGA;ELECTRONICA MAYOR
19492539;;M;24;CHILENO;;Z;TEMUCO                        ;ARAUCANIA;190810;2;1;0;0;0;2;1;190810;LED 32 KHHD3221 SMART TV;ELECTRONICA MAYOR
13404440;;F;44;CHILENO;;X;PROVIDENCIA                   ;METROPOLITANA;199990;1;1;0;0;0;1;1;199990;LED 32 UN32T4300AGXZS HD SMART TV;ELECTRONICA MAYOR
9929640;;F;53;CHILENO;;X;VALLENAR;ATACAMA;299990;1;1;0;0;0;1;1;299990;LED 50 50U6305 SMART TV ULTRA HD;ELECTRONICA MAYOR
7331126;;F;68;CHILENO;;Boomers;RENCA                         ;METROPOLITANA;179980;2;1;0;0;0;2;1;179980;MINICOMPONENTE CJ45;ELECTRONICA MAYOR
7217003;;M;69;CHILENO;;Silencioso;PROVIDENCIA                   ;METROPOLITANA;220810;2;1;0;0;0;2;1;220810;LED 32 KHHD3221 SMART TV;ELECTRONICA MAYOR
12855356;;F;46;CHILENO;;X;"";"";29990;1;1;0;0;0;1;1;29990;KARAOKE STREET SONG 4 MICÂ CABLEÂ BLACK 8900;ELECTRONICA MAYOR
27205258;;M;36;VENEZOLANO;;Extranjero;N/D;N/D;453760;3;1;0;0;0;3;1;453760;LED 50 UN50TU7090GXZS UHD SMART TV;ELECTRONICA MAYOR
20320316;;F;22;CHILENO;;Silencioso;PROVIDENCIA                   ;METROPOLITANA;554970;3;2;3;2;554970;0;0;0;LED 50 UN50TU7090GXZS UHD SMART TV;ELECTRONICA MAYOR
19805272;;F;23;CHILENO;;Millenial;N/D;N/D;205760;3;1;0;0;0;3;1;205760;MINICOMPONENTE CJ45;ELECTRONICA MAYOR
11451881;;M;53;CHILENO;;X;TEMUCO                        ;ARAUCANIA;241570;2;1;0;0;0;2;1;241570;LED 32 UN32T4300AGXZS HD SMART TV;ELECTRONICA MAYOR
11767284;;M;50;CHILENO;;X;BUIN                          ;METROPOLITANA;159990;1;1;0;0;0;1;1;159990;MINICOMPONENTE RN5;ELECTRONICA MAYOR
26216120;;F;42;ECUATORIANO;;Extranjero;PUDAHUEL                      ;METROPOLITANA;549990;1;1;0;0;0;1;1;549990;LED 55 NanoCell 55NANO75 UHD SMART + MAGIC;ELECTRONICA MAYOR
9673428;;F;59;CHILENO;;Boomers;QUILICURA                     ;METROPOLITANA;154990;1;1;0;0;0;1;1;154990;MONITOR 24 24TL520S SMART TV HD;ELECTRONICA MAYOR
9337497;;F;61;CHILENO;;Boomers;COIHAIQUE                     ;AYSEN;189990;1;1;0;0;0;1;1;189990;LED 32 UN32T4300AGXZS HD SMART TV;ELECTRONICA MAYOR
6345440;Divorciado;F;74;CHILENO;PROFESOR;Silencioso;LA CISTERNA                   ;METROPOLITANA;199980;2;1;0;0;0;2;1;199980;LED 32 UN32T4300AGXZS HD SMART TV;ELECTRONICA MAYOR
13985144;;M;41;CHILENO;;X;LA CRUZ                       ;VALPARAISO;169990;1;1;0;0;0;1;1;169990;LED 32 KHHD3221 SMART TV;ELECTRONICA MAYOR
17374903;Soltero;M;32;CHILENO;;Millenial;PROVIDENCIA                   ;METROPOLITANA;183980;2;1;2;1;183980;0;0;0;LED 32 UN32T4300AGXZS HD SMART TV;ELECTRONICA MAYOR
9868630;;F;58;CHILENO;;Boomers;RENCA                         ;METROPOLITANA;152230;3;2;0;0;0;3;2;152230;MINICOMPONENTE MHC-V02 ALL IN ONE;ELECTRONICA MAYOR
5099760;;F;80;CHILENO;;Silencioso;CURANILAHUE                   ;BIO BIO;339990;1;1;0;0;0;1;1;339990;LED 50 50PUD7625 SMART TV ULTRA HD 4K;ELECTRONICA MAYOR
17578155;;F;31;CHILENO;;Millenial;PUDAHUEL                      ;METROPOLITANA;89990;1;1;0;0;0;1;1;89990;KARAOKE SP-101BT ALL IN ONE PORTATIL 60W;ELECTRONICA MAYOR
8147664;;M;61;CHILENO;;Boomers;MELIPILLA                     ;METROPOLITANA;-90870;-2;2;0;0;0;-2;2;-90870;LED 50 50PUD7625 SMART TV ULTRA HD 4K;ELECTRONICA MAYOR
18898272;;M;27;CHILENO;;Millenial;PUERTO MONTT                  ;LOS LAGOS;37670;2;1;0;0;0;2;1;37670;KARAOKE STREET SONG 4 MICÂ CABLEÂ BLACK 8900;ELECTRONICA MAYOR
7839786;;M;60;CHILENO;;Boomers;PEDRO AGUIRRE CERDA           ;METROPOLITANA;389990;1;1;0;0;0;1;1;389990;LED 55 UN55TU7090GXZS SMART TV UHD;ELECTRONICA MAYOR
11204272;;M;54;CHILENO;;Boomers;PROVIDENCIA                   ;METROPOLITANA;157970;2;1;0;0;0;2;1;157970;PARLANTE ULTRAMEGA;ELECTRONICA MAYOR
11444294;;M;53;CHILENO;;X;SAN CARLOS                    ;BIO BIO;187870;2;1;0;0;0;2;1;187870;LED 32 KHHD3221 SMART TV;ELECTRONICA MAYOR
8067556;;M;62;CHILENO;;Boomers;LAJA                          ;BIO BIO;44990;1;1;0;0;0;1;1;44990;KARAOKE RHYTHM CHARGER 12 MIC CABLE 8890;ELECTRONICA MAYOR
14106053;;F;41;CHILENO;;X;IQUIQUE                       ;TARAPACA;248670;2;1;0;0;0;2;1;248670;MINICOMPONENTE RN7;ELECTRONICA MAYOR
18175212;;F;30;CHILENO;;Millenial;N/D;N/D;405060;3;1;0;0;0;3;1;405060;MINICOMPONENTE RN7;ELECTRONICA MAYOR
11864310;;F;51;CHILENO;;X;PROVIDENCIA                   ;METROPOLITANA;133980;2;1;2;1;133980;0;0;0;LED 32 KHHD3221 SMART TV;ELECTRONICA MAYOR
20053227;;M;23;EXTRANJERO - NO INFORMA NACIONALIDAD;;Z;N/D;N/D;79990;1;1;0;0;0;1;1;79990;PARLANTE ULTRAMAGIC;ELECTRONICA MAYOR
8962528;;F;63;CHILENO;;Boomers;N/D;N/D;411870;2;1;0;0;0;2;1;411870;LED 49 49UN7100 UHD SMART TV;ELECTRONICA MAYOR
16950254;;F;33;CHILENO;;Millenial;PROVIDENCIA                   ;METROPOLITANA;39990;1;1;0;0;0;1;1;39990;PARLANTE SPBYF7 PORTATIL;ELECTRONICA MAYOR
7752175;;M;65;CHILENO;;Boomers;CASTRO                        ;LOS LAGOS;69990;1;1;0;0;0;1;1;69990;PARLANTE KARAOKE MGROKR NEGRO;ELECTRONICA MAYOR
14364514;;M;41;CHILENO;;X;N/D;N/D;-169990;-1;1;-1;1;-169990;0;0;0;LED 40 KEHD4020 SMART TV;ELECTRONICA MAYOR
15037112;;M;39;CHILENO;;X;PROVIDENCIA                   ;METROPOLITANA;89990;1;1;0;0;0;1;1;89990;PARLANTE ULTRAMAGIC;ELECTRONICA MAYOR
13857640;;F;42;CHILENO;;X;TALCA                         ;MAULE;364170;2;1;0;0;0;2;1;364170;LED 50 KHUH5021 SMART TV;ELECTRONICA MAYOR
8517567;;F;60;CHILENO;;Boomers;INDEPENDENCIA                 ;METROPOLITANA;213980;2;1;2;1;213980;0;0;0;LED 43 CS43F2 SMART TV FHD NEGRO;ELECTRONICA MAYOR
9258808;;M;59;CHILENO;;Boomers;PROVIDENCIA                   ;METROPOLITANA;222710;2;1;0;0;0;2;1;222710;MINICOMPONENTE RN7;ELECTRONICA MAYOR
19050616;;M;27;CHILENO;;Z;N/D;N/D;209990;1;1;1;1;209990;0;0;0;LED 32LM637B HD SMART;ELECTRONICA MAYOR
20123655;;F;24;CHILENO;;Z;PROVIDENCIA                   ;METROPOLITANA;0;0;0;0;0;0;0;0;0;LED 43 Full HD Smart TV 43PFD6825;ELECTRONICA MAYOR
11252881;;M;54;CHILENO;;X;N/D;N/D;0;0;0;0;0;0;0;0;0;MINICOMPONENTE MHC-V02 ALL IN ONE;ELECTRONICA MAYOR
7645953;Casado;M;66;CHILENO;;Boomers;TRAIGUEN                      ;ARAUCANIA;0;0;0;0;0;0;0;0;0;LED 43 43LM6370 SMART TV FHD;ELECTRONICA MAYOR
18619995;;F;28;CHILENO;;Millenial;TEMUCO                        ;ARAUCANIA;0;0;0;0;0;0;0;0;0;LED 40 UN40T5290AGXZS FHD SMART TV;ELECTRONICA MAYOR
26058975;;F;42;VENEZOLANO;;Extranjero;LA FLORIDA                    ;METROPOLITANA;0;0;0;0;0;0;0;0;0;LED 32 UN32T4300AGXZS HD SMART TV;ELECTRONICA MAYOR
8664040;;M;61;CHILENO;;Boomers;LA FLORIDA;METROPOLITANA;0;0;0;0;0;0;0;0;0;LED 32 32S5295 SMART TV HD;ELECTRONICA MAYOR
14247715;;F;47;CHILENO;;X;PUCHUNCAVI                    ;VALPARAISO;0;0;0;0;0;0;0;0;0;LED 50 50PUD6513/44 SMART TV UHD 4K;ELECTRONICA MAYOR
16227950;;F;36;CHILENO;;Millenial;SAN BERNARDO;METROPOLITANA;0;0;0;0;0;0;0;0;0;LED KIOTO 32 MI3228 SMART TV;ELECTRONICA MAYOR
18377982;;F;28;CHILENO;;Millenial;COINCO                        ;L.G.B.OÂ´HIGGINS;0;0;0;0;0;0;0;0;0;MINICOMPONENTE MHC-V02 ALL IN ONE;ELECTRONICA MAYOR
12745793;;F;46;CHILENO;;X;PROVIDENCIA                   ;METROPOLITANA;0;0;0;0;0;0;0;0;0;LED 50 50U6305 SMART TV ULTRA HD;ELECTRONICA MAYOR
10178942;;M;57;CHILENO;;Silencioso;PROVIDENCIA                   ;METROPOLITANA;0;0;0;0;0;0;0;0;0;LED 50 UN50TU7090GXZS UHD SMART TV;ELECTRONICA MAYOR
26405329;;M;41;VENEZOLANO;;Extranjero;CASTRO                        ;LOS LAGOS;0;0;0;0;0;0;0;0;0;LED 75UP7500 UHD SMART;ELECTRONICA MAYOR
17475426;Casado;F;32;CHILENO;;Millenial;PROVIDENCIA                   ;METROPOLITANA;0;0;0;0;0;0;0;0;0;LED 70 UN70AU7000GXZS UHD;ELECTRONICA MAYOR
16199855;;F;36;CHILENO;;Millenial;PUNTA ARENAS                  ;MAGALLANES;0;0;0;0;0;0;0;0;0;LED KIOTO 32 MI3228 SMART TV;ELECTRONICA MAYOR
12799931;;F;46;CHILENO;;X;MELIPILLA                     ;METROPOLITANA;0;0;0;0;0;0;0;0;0;LED 50 50U6305 SMART TV ULTRA HD;ELECTRONICA MAYOR
9263490;;F;59;CHILENO;;Boomers;PUENTE ALTO                   ;METROPOLITANA;0;0;0;0;0;0;0;0;0;LED KIOTO 32 MI3228 SMART TV;ELECTRONICA MAYOR
13595165;;F;43;CHILENO;;X;PROVIDENCIA                   ;METROPOLITANA;0;0;0;0;0;0;0;0;0;SISTEMA DE SONIDO CM1560;ELECTRONICA MAYOR
10635433;;M;51;CHILENO;;X;COIHAIQUE                     ;AYSEN;0;0;0;0;0;0;0;0;0;LED 40 UN40T5290AGXZS FHD SMART TV;ELECTRONICA MAYOR
10916250;;M;55;CHILENO;;Boomers;LONGAVI                       ;MAULE;0;0;0;0;0;0;0;0;0;LED 43 43UN7300 UHD SMART TV 4K;ELECTRONICA MAYOR
6536625;;F;67;CHILENO;;Boomers;VINA DEL MAR                  ;VALPARAISO;0;0;0;0;0;0;0;0;0;MINICOMPONENTE MHC-V02 ALL IN ONE;ELECTRONICA MAYOR
13916092;;F;42;CHILENO;;X;SAN JOAQUIN;METROPOLITANA;0;0;0;0;0;0;0;0;0;LED 50 50PUD7625 SMART TV ULTRA HD 4K;ELECTRONICA MAYOR
11852979;;F;51;CHILENO;;X;PENAFLOR                      ;METROPOLITANA;0;0;0;0;0;0;0;0;0;LED 50 50U6305 SMART TV ULTRA HD;ELECTRONICA MAYOR
4982336;;F;85;CHILENO;;Silencioso;COLINA                        ;METROPOLITANA;0;0;0;0;0;0;0;0;0;LED 43 CS43F2 SMART TV FHD NEGRO;ELECTRONICA MAYOR
13709492;Casado;F;43;CHILENO;;X;ISLA DE MAIPO                 ;METROPOLITANA;0;0;0;0;0;0;0;0;0;MINICOMPONENTE CM4360;ELECTRONICA MAYOR
18634366;;F;28;CHILENO;;Millenial;VALLENAR;ATACAMA;0;0;0;0;0;0;0;0;0;MINICOMPONENTE RN5;ELECTRONICA MAYOR
6789546;;F;72;CHILENO;;Silencioso;OSORNO                        ;LOS LAGOS;0;0;0;0;0;0;0;0;0;LED 40 KEHD4020 SMART TV;ELECTRONICA MAYOR
11170593;;F;55;CHILENO;;Boomers;ISLA DE MAIPO                 ;METROPOLITANA;0;0;0;0;0;0;0;0;0;MINICOMPONENTE MHC-V02 ALL IN ONE;ELECTRONICA MAYOR
16372135;;F;36;CHILENO;;Millenial;LAMPA                         ;METROPOLITANA;0;0;0;0;0;0;0;0;0;LED 49 49UN7100 UHD SMART TV;ELECTRONICA MAYOR
12438338;;F;50;CHILENO;;X;RENCA                         ;METROPOLITANA;0;0;0;0;0;0;0;0;0;LED 50 50U6305 SMART TV ULTRA HD;ELECTRONICA MAYOR
17363910;;M;32;CHILENO;;Millenial;RENCA                         ;METROPOLITANA;0;0;0;0;0;0;0;0;0;QLED 55 QN55Q60AAGXZS 4K UHD SMART TV;ELECTRONICA MAYOR
10666461;;F;56;CHILENO;;Boomers;TALAGANTE                     ;METROPOLITANA;0;0;0;0;0;0;0;0;0;LED 50 UN50TU7090GXZS UHD SMART TV;ELECTRONICA MAYOR
10034422;;F;54;CHILENO;;Boomers;PROVIDENCIA                   ;METROPOLITANA;0;0;0;0;0;0;0;0;0;LED 60UP7750 UHD SMART + MAGIC;ELECTRONICA MAYOR
17660644;;M;32;CHILENO;;Millenial;PROVIDENCIA                   ;METROPOLITANA;0;0;0;0;0;0;0;0;0;LED 50 KHUH5021 SMART TV;ELECTRONICA MAYOR
12387385;Viudo;F;49;CHILENO;;X;ERCILLA                       ;ARAUCANIA;0;0;0;0;0;0;0;0;0;LED 43 Full HD Smart TV 43PFD6825;ELECTRONICA MAYOR
15866753;;F;37;CHILENO;;Millenial;MELIPILLA                     ;METROPOLITANA;0;0;0;0;0;0;0;0;0;LED 42 42S6500 ANDROID TV FHD;ELECTRONICA MAYOR
10285967;;M;56;CHILENO;;Boomers;PROVIDENCIA                   ;METROPOLITANA;0;0;0;0;0;0;0;0;0;PARLANTE ULTRAMEGA;ELECTRONICA MAYOR
17822657;;M;31;CHILENO;;Millenial;TALCA                         ;MAULE;0;0;0;0;0;0;0;0;0;LED 55UP7500 UHD SMART;ELECTRONICA MAYOR
19558783;;M;25;CHILENO;;Silencioso;PROVIDENCIA                   ;METROPOLITANA;0;0;0;0;0;0;0;0;0;LED 50 UN50TU7090GXZS UHD SMART TV;ELECTRONICA MAYOR
18146043;;F;30;CHILENO;;Millenial;TEMUCO;ARAUCANIA;0;0;0;0;0;0;0;0;0;LED 42 42S6500 ANDROID TV FHD;ELECTRONICA MAYOR
10198030;;M;57;CHILENO;;Boomers;RENCA                         ;METROPOLITANA;0;0;0;0;0;0;0;0;0;LED KIOTO 32 MI3228 SMART TV;ELECTRONICA MAYOR
11807401;;M;51;CHILENO;;X;CASABLANCA                    ;VALPARAISO;0;0;0;0;0;0;0;0;0;LED 40 KEHD4020 SMART TV;ELECTRONICA MAYOR
13273220;;M;44;CHILENO;;Z;ESTACION CENTRAL              ;METROPOLITANA;0;0;0;0;0;0;0;0;0;LED KIOTO 32 MI3228 SMART TV;ELECTRONICA MAYOR
12233435;;F;50;CHILENO;;X;CHILLAN                       ;BIO BIO;0;0;0;0;0;0;0;0;0;SOUNDBAR HW-A550/ZS;ELECTRONICA MAYOR
26300880;;M;45;VENEZOLANO;;Extranjero;N/D;N/D;0;0;0;0;0;0;0;0;0;LED 40 KEHD4020 SMART TV;ELECTRONICA MAYOR
19234427;Soltero;M;26;CHILENO;;Silencioso;PROVIDENCIA                   ;METROPOLITANA;0;0;0;0;0;0;0;0;0;LED 50 50U6305 SMART TV ULTRA HD;ELECTRONICA MAYOR
19054563;;M;27;CHILENO;;Z;PROVIDENCIA                   ;METROPOLITANA;0;0;0;0;0;0;0;0;0;LED 43 UN43T5202AGXZS FHD SMART TV;ELECTRONICA MAYOR
8305862;;F;63;CHILENO;;Boomers;IQUIQUE                       ;TARAPACA;0;0;0;0;0;0;0;0;0;LED KIOTO 32 MI3228 SMART TV;ELECTRONICA MAYOR
17255440;Soltero;F;32;CHILENO;;Millenial;RENCA                         ;METROPOLITANA;0;0;0;0;0;0;0;0;0;LED 32 32PHD5813 SMART TV HD;ELECTRONICA MAYOR
14087766;;M;44;CHILENO;;X;ANCUD                         ;LOS LAGOS;0;0;0;0;0;0;0;0;0;PARLANTE BT T15 NEGRO + ATRIL;ELECTRONICA MAYOR
9801764;;F;58;CHILENO;;Boomers;VILLARICA                     ;ARAUCANIA;0;0;0;0;0;0;0;0;0;LED 32 32PHD5813 SMART TV HD;ELECTRONICA MAYOR
26314535;;M;36;VENEZOLANO;;Extranjero;TALCA                         ;MAULE;0;0;0;0;0;0;0;0;0;MINICOMPONENTE MX-T50/ZS ALL IN ONE;ELECTRONICA MAYOR
17818087;;M;31;CHILENO;;Millenial;CERRO NAVIA                   ;METROPOLITANA;0;0;0;0;0;0;0;0;0;LED 60 UN60AU8000GXZS UHD SMART TV;ELECTRONICA MAYOR
20461023;;M;22;CHILENO;;Millenial;PROVIDENCIA                   ;METROPOLITANA;0;0;0;0;0;0;0;0;0;LED 40 KEHD4020 SMART TV;ELECTRONICA MAYOR
19261460;;M;26;CHILENO;;Z;N/D;N/D;0;0;0;0;0;0;0;0;0;LED KIOTO 32 MI3228 SMART TV;ELECTRONICA MAYOR
8098263;;F;59;CHILENO;;Boomers;OSORNO                        ;LOS LAGOS;0;0;0;0;0;0;0;0;0;LED 50 UN50TU7090GXZS UHD SMART TV;ELECTRONICA MAYOR
9640351;;F;61;CHILENO;;Boomers;EL QUISCO                     ;VALPARAISO;0;0;0;0;0;0;0;0;0;LED 40 KEHD4020 SMART TV;ELECTRONICA MAYOR
19459995;;F;25;CHILENO;;Z;PROVIDENCIA                   ;METROPOLITANA;0;0;0;0;0;0;0;0;0;LED 50 UN50TU7090GXZS UHD SMART TV;ELECTRONICA MAYOR
12655023;;M;48;CHILENO;;Silencioso;PROVIDENCIA                   ;METROPOLITANA;0;0;0;0;0;0;0;0;0;LED 43 UN43T5202AGXZS FHD SMART TV;ELECTRONICA MAYOR
16534611;;F;35;CHILENO;;Millenial;PROVIDENCIA                   ;METROPOLITANA;0;0;0;0;0;0;0;0;0;LED 50 UN50TU7090GXZS UHD SMART TV;ELECTRONICA MAYOR
8032008;;F;64;CHILENO;;Boomers;CALAMA                        ;ANTOFAGASTA;0;0;0;0;0;0;0;0;0;KARAOKE RHYTHM CHARGER 12 MIC CABLE 8890;ELECTRONICA MAYOR
15736021;;F;38;CHILENO;;X;LA FLORIDA                    ;METROPOLITANA;0;0;0;0;0;0;0;0;0;PARLANTE ULTRASENSATION;ELECTRONICA MAYOR
7133730;;M;67;CHILENO;;Boomers;VALPARAISO                    ;VALPARAISO;0;0;0;0;0;0;0;0;0;LED 40 KEHD4020 SMART TV;ELECTRONICA MAYOR
12282792;;M;51;CHILENO;;X;EL BOSQUE                     ;METROPOLITANA;0;0;0;0;0;0;0;0;0;LED 32LM637B HD SMART;ELECTRONICA MAYOR
19500043;;F;25;CHILENO;;Z;LA SERENA                     ;COQUIMBO;0;0;0;0;0;0;0;0;0;LED KIOTO 32 MI3228 SMART TV;ELECTRONICA MAYOR
11233603;;M;53;CHILENO;;X;RENCA                         ;METROPOLITANA;0;0;0;0;0;0;0;0;0;PARLANTE ULTRASENSATION;ELECTRONICA MAYOR
14253620;;M;47;CHILENO;;X;PROVIDENCIA                   ;METROPOLITANA;0;0;0;0;0;0;0;0;0;LED 40 KEHD4020 SMART TV;ELECTRONICA MAYOR
14125981;;M;43;CHILENO;;X;EL BOSQUE                     ;METROPOLITANA;0;0;0;0;0;0;0;0;0;MINICOMPONENTE CJ45;ELECTRONICA MAYOR
10375041;;F;57;CHILENO;;Boomers;CHANCO                        ;MAULE;0;0;0;0;0;0;0;0;0;LED 40 KEHD4020 SMART TV;ELECTRONICA MAYOR
9147605;;M;61;CHILENO;;Boomers;LOLOL                         ;L.G.B.OÂ´HIGGINS;0;0;0;0;0;0;0;0;0;LED 50 50NANO75 NanoCell UHD SMART + MAGIC;ELECTRONICA MAYOR
13978302;;M;40;CHILENO;;X;SALAMANCA                     ;COQUIMBO;0;0;0;0;0;0;0;0;0;MINICOMPONENTE RN5;ELECTRONICA MAYOR
19463844;;F;26;CHILENO;;Z;VICTORIA                      ;ARAUCANIA;0;0;0;0;0;0;0;0;0;LED KIOTO 32 MI3228 SMART TV;ELECTRONICA MAYOR
12737144;Soltero;F;47;CHILENO;;X;RENCA                         ;METROPOLITANA;0;0;0;0;0;0;0;0;0;LED 43 43LM6370 SMART TV FHD;ELECTRONICA MAYOR
18968335;Soltero;M;27;CHILENO;;Millenial;PROVIDENCIA                   ;METROPOLITANA;0;0;0;0;0;0;0;0;0;PARLANTE ULTRAMEGA;ELECTRONICA MAYOR
15509680;;F;39;CHILENO;;X;SAN BERNARDO                  ;METROPOLITANA;0;0;0;0;0;0;0;0;0;LED KIOTO 32 MI3228 SMART TV;ELECTRONICA MAYOR
8831853;Soltero;M;61;CHILENO;;Boomers;LAUTARO                       ;ARAUCANIA;0;0;0;0;0;0;0;0;0;MINICOMPONENTE RN7;ELECTRONICA MAYOR
18314449;Soltero;M;29;CHILENO;;Millenial;PROVIDENCIA                   ;METROPOLITANA;0;0;0;0;0;0;0;0;0;LED 50 UN50TU7090GXZS UHD SMART TV;ELECTRONICA MAYOR
20142664;;F;22;CHILENO;;Z;PROVIDENCIA                   ;METROPOLITANA;0;0;0;0;0;0;0;0;0;PARLANTE ULTRAFORCE-I;ELECTRONICA MAYOR
9065272;;F;58;CHILENO;;Boomers;PUNTA ARENAS                  ;MAGALLANES;0;0;0;0;0;0;0;0;0;PARLANTE ULTRAFORCE-I;ELECTRONICA MAYOR
20412203;;M;22;CHILENO;;Z;N/D;N/D;0;0;0;0;0;0;0;0;0;LED KIOTO 32 MI3228 SMART TV;ELECTRONICA MAYOR
19590663;;F;25;CHILENO;;Z;TALCA                         ;MAULE;0;0;0;0;0;0;0;0;0;LED 32 32PHD6825 HD SMART TV;ELECTRONICA MAYOR
10960912;;M;51;CHILENO;;X;COLINA                        ;METROPOLITANA;0;0;0;0;0;0;0;0;0;PARLANTE COBRA;ELECTRONICA MAYOR
23089231;;M;44;PERUANO;;Extranjero;SANTIAGO                      ;METROPOLITANA;0;0;0;0;0;0;0;0;0;LED 50 UN50TU7090GXZS UHD SMART TV;ELECTRONICA MAYOR
6267486;;M;72;CHILENO;;Silencioso;N/D;N/D;0;0;0;0;0;0;0;0;0;LED 50 50U6305 SMART TV ULTRA HD;ELECTRONICA MAYOR
11262567;;F;54;CHILENO;;X;RENCA                         ;METROPOLITANA;0;0;0;0;0;0;0;0;0;SOUNDBAR SK1D;ELECTRONICA MAYOR
15939183;Soltero;M;37;CHILENO;INGENIERO DE EJECUCION EN INFORMATICA;Silencioso;PROVIDENCIA                   ;METROPOLITANA;0;0;0;0;0;0;0;0;0;LED 43 UN43TU7090GXZS UHD SMART TV;ELECTRONICA MAYOR
17638510;;F;32;CHILENO;;Silencioso;PROVIDENCIA                   ;METROPOLITANA;0;0;0;0;0;0;0;0;0;LED 32LM637B HD SMART;ELECTRONICA MAYOR
18674058;;M;29;CHILENO;;Millenial;N/D;N/D;0;0;0;0;0;0;0;0;0;MINICOMPONENTE RN9;ELECTRONICA MAYOR
17687796;;F;31;CHILENO;;Millenial;MALLOA                        ;L.G.B.OÂ´HIGGINS;0;0;0;0;0;0;0;0;0;LED KIOTO 32 MI3228 SMART TV;ELECTRONICA MAYOR
19346410;;F;26;CHILENO;;Z;PROVIDENCIA                   ;METROPOLITANA;0;0;0;0;0;0;0;0;0;PARLANTE BOLA DISCO CON MICROFONO INAL;ELECTRONICA MAYOR
13502563;;F;43;CHILENO;;X;MACHALI                       ;L.G.B.OÂ´HIGGINS;0;0;0;0;0;0;0;0;0;LED 43 UN43TU7090GXZS UHD SMART TV;ELECTRONICA MAYOR
6393170;Casado;M;68;CHILENO;;Boomers;RENCA                         ;METROPOLITANA;0;0;0;0;0;0;0;0;0;LED 60 UN60AU8000GXZS UHD SMART TV;ELECTRONICA MAYOR
18074397;;F;30;CHILENO;;Millenial;PROVIDENCIA                   ;METROPOLITANA;0;0;0;0;0;0;0;0;0;LED 50 UN50TU7090GXZS UHD SMART TV;ELECTRONICA MAYOR
6323795;;M;70;CHILENO;;Silencioso;SAGRADA FAMILIA               ;MAULE;0;0;0;0;0;0;0;0;0;LED KIOTO 32 MI3228 SMART TV;ELECTRONICA MAYOR
17350421;;F;33;CHILENO;;Millenial;"";"";0;0;0;0;0;0;0;0;0;LED 43 UN43T5202AGXZS FHD SMART TV;ELECTRONICA MAYOR
13354612;;F;43;CHILENO;;X;CONSTITUCION                  ;MAULE;0;0;0;0;0;0;0;0;0;LED KIOTO 32 MI3228 SMART TV;ELECTRONICA MAYOR
23321009;Soltero;M;36;PERUANO;;Extranjero;PROVIDENCIA                   ;METROPOLITANA;0;0;0;0;0;0;0;0;0;LED 40 KEHD4020 SMART TV;ELECTRONICA MAYOR
16409813;;F;35;CHILENO;;Millenial;LA PINTANA                    ;METROPOLITANA;0;0;0;0;0;0;0;0;0;LED KIOTO 32 MI3228 SMART TV;ELECTRONICA MAYOR
13302114;;F;44;CHILENO;;X;PROVIDENCIA                   ;METROPOLITANA;0;0;0;0;0;0;0;0;0;MONITOR 24 24TL520S SMART TV HD;ELECTRONICA MAYOR
6806511;;F;67;CHILENO;;Boomers;PROVIDENCIA                   ;METROPOLITANA;0;0;0;0;0;0;0;0;0;LED 49 49UN7100 UHD SMART TV;ELECTRONICA MAYOR
8729413;;M;62;CHILENO;;Boomers;N/D;N/D;0;0;0;0;0;0;0;0;0;PARLANTE KARAOKE MGLIGHTNING NEGRO;ELECTRONICA MAYOR
11345887;;F;53;CHILENO;;X;COPIAPO                       ;ATACAMA;0;0;0;0;0;0;0;0;0;LED 65 65UN7100 UHD SMART TV;ELECTRONICA MAYOR
18616920;;F;29;CHILENO;;Millenial;PROVIDENCIA                   ;METROPOLITANA;0;0;0;0;0;0;0;0;0;LED 32 32LM630BPSB SMART TV;ELECTRONICA MAYOR
13234033;Divorciado;M;44;CHILENO;INGENIERO;Silencioso;PROVIDENCIA                   ;METROPOLITANA;0;0;0;0;0;0;0;0;0;LED KIOTO 32 MI3228 SMART TV;ELECTRONICA MAYOR
18871244;;F;27;CHILENO;;Millenial;OSORNO                        ;LOS LAGOS;0;0;0;0;0;0;0;0;0;LED 40 KEHD4020 SMART TV;ELECTRONICA MAYOR
9721374;;F;60;CHILENO;;Boomers;RENCA                         ;METROPOLITANA;0;0;0;0;0;0;0;0;0;LED 43 43LM6300PSB SMART TV HD;ELECTRONICA MAYOR
17126397;;F;33;CHILENO;;Millenial;N/D;N/D;0;0;0;0;0;0;0;0;0;SOUNDBAR F-HQ700AS9500S;ELECTRONICA MAYOR
19651392;;M;24;CHILENO;;Z;CONSTITUCION                  ;MAULE;0;0;0;0;0;0;0;0;0;PARLANTE BT T15 NEGRO + ATRIL;ELECTRONICA MAYOR
12350172;;F;48;CHILENO;;X;COPIAPO                       ;ATACAMA;0;0;0;0;0;0;0;0;0;LED 40 KEHD4020 SMART TV;ELECTRONICA MAYOR
14596272;Casado;F;40;CHILENO;;Silencioso;PROVIDENCIA                   ;METROPOLITANA;0;0;0;0;0;0;0;0;0;LED 43 UN43T5202AGXZS FHD SMART TV;ELECTRONICA MAYOR
10843674;;M;53;CHILENO;;X;CONSTITUCION                  ;MAULE;0;0;0;0;0;0;0;0;0;LED KIOTO 32 MI3228 SMART TV;ELECTRONICA MAYOR
17508638;;M;32;CHILENO;;Millenial;MOLINA                        ;MAULE;0;0;0;0;0;0;0;0;0;LED 43 CS43S1USM UHD SMART TV NEGRO;ELECTRONICA MAYOR
16324786;;F;36;CHILENO;;Millenial;ARICA                         ;ARICA Y PARINACOTA;0;0;0;0;0;0;0;0;0;LED 50 UN50TU7090GXZS UHD SMART TV;ELECTRONICA MAYOR
16026915;Soltero;M;37;CHILENO;;Millenial;RENCA                         ;METROPOLITANA;0;0;0;0;0;0;0;0;0;MAGIC REMOTE MR20GA;ELECTRONICA MAYOR
16392557;;F;35;CHILENO;;Millenial;CERRO NAVIA                   ;METROPOLITANA;0;0;0;0;0;0;0;0;0;LED 50 50U6295 SMART TV UHD;ELECTRONICA MAYOR
16933824;;M;33;CHILENO;;Silencioso;PROVIDENCIA                   ;METROPOLITANA;0;0;0;0;0;0;0;0;0;LED KIOTO 32 MI3228 SMART TV;ELECTRONICA MAYOR
18535084;;F;28;CHILENO;;Millenial;MAIPU                         ;METROPOLITANA;0;0;0;0;0;0;0;0;0;LED 75 UN75AU7000GXZS UHD;ELECTRONICA MAYOR
19749706;;F;24;CHILENO;;Z;PROVIDENCIA                   ;METROPOLITANA;0;0;0;0;0;0;0;0;0;LED 43 43LM6370 SMART TV FHD;ELECTRONICA MAYOR
7767744;;M;64;CHILENO;;Boomers;N/D;N/D;0;0;0;0;0;0;0;0;0;LED 50 50P615-50P ANDROID TV PASSION LINE UHD 4K;ELECTRONICA MAYOR
11897086;;F;50;CHILENO;;X;N/D;N/D;0;0;0;0;0;0;0;0;0;LED KIOTO 32 MI3228 SMART TV;ELECTRONICA MAYOR
16186748;;M;37;CHILENO;;Silencioso;PROVIDENCIA                   ;METROPOLITANA;0;0;0;0;0;0;0;0;0;LED 43 43S5295 SMART TV FHD;ELECTRONICA MAYOR
17825529;Soltero;M;31;CHILENO;;Millenial;RENCA                         ;METROPOLITANA;0;0;0;0;0;0;0;0;0;LED 43 43S5295 SMART TV FHD;ELECTRONICA MAYOR
18918765;Soltero;M;27;CHILENO;;Millenial;PROVIDENCIA                   ;METROPOLITANA;0;0;0;0;0;0;0;0;0;LED 50 50NANO75 NanoCell UHD SMART + MAGIC;ELECTRONICA MAYOR
15569722;;F;39;CHILENO;;X;PROVIDENCIA                   ;METROPOLITANA;0;0;0;0;0;0;0;0;0;LED 40 KEHD4020 SMART TV;ELECTRONICA MAYOR
19504742;Soltero;F;25;CHILENO;;Silencioso;PROVIDENCIA                   ;METROPOLITANA;0;0;0;0;0;0;0;0;0;LED 50 UN50TU7090GXZS UHD SMART TV;ELECTRONICA MAYOR
14472212;Soltero;F;43;CHILENO;INGENIERO INFORMATICO;X;PROVIDENCIA                   ;METROPOLITANA;0;0;0;0;0;0;0;0;0;LED 43 43LM6300PSB SMART TV HD;ELECTRONICA MAYOR
15753433;;F;38;CHILENO;;Millenial;N/D;N/D;0;0;0;0;0;0;0;0;0;MINICOMPONENTE RN9;ELECTRONICA MAYOR
15779187;;F;37;CHILENO;;Millenial;N/D;N/D;0;0;0;0;0;0;0;0;0;PARLANTE ULTRAMAGIC;ELECTRONICA MAYOR
8015447;Casado;M;64;CHILENO;INGENIERO AGRICOLA;Boomers;RENCA                         ;METROPOLITANA;0;0;0;0;0;0;0;0;0;LED 50 KEUH50 SMART TV UHD;ELECTRONICA MAYOR
18236901;Soltero;M;29;CHILENO;;Millenial;QUILPUE                       ;VALPARAISO;0;0;0;0;0;0;0;0;0;LED KIOTO 32 MI3228 SMART TV;ELECTRONICA MAYOR
20469496;;M;22;CHILENO;;Silencioso;PROVIDENCIA                   ;METROPOLITANA;0;0;0;0;0;0;0;0;0;LED 50 UN50TU7090GXZS UHD SMART TV;ELECTRONICA MAYOR
18361764;;M;28;CHILENO;;Millenial;N/D;N/D;0;0;0;0;0;0;0;0;0;LED 32 UN32T4300AGXZS HD SMART TV;ELECTRONICA MAYOR
17289137;;M;23;CHILENO;;Z;PROVIDENCIA                   ;METROPOLITANA;0;0;0;0;0;0;0;0;0;LED KIOTO 32 MI3228 SMART TV;ELECTRONICA MAYOR
17101979;;F;33;CHILENO;;Silencioso;PROVIDENCIA                   ;METROPOLITANA;0;0;0;0;0;0;0;0;0;SOUNDBAR HW-A450/ZS;ELECTRONICA MAYOR
8913195;;M;61;CHILENO;;Boomers;RENCA                         ;METROPOLITANA;0;0;0;0;0;0;0;0;0;MONITOR 24 24TL520S SMART TV HD;ELECTRONICA MAYOR
19565146;;F;25;CHILENO;;Z;PROVIDENCIA                   ;METROPOLITANA;0;0;0;0;0;0;0;0;0;LED KIOTO 32 MI3228 SMART TV;ELECTRONICA MAYOR
18848815;Soltero;M;27;CHILENO;;Millenial;QUINTA NORMAL;METROPOLITANA;0;0;0;0;0;0;0;0;0;LED KIOTO 32 MI3228 SMART TV;ELECTRONICA MAYOR
26287945;;M;39;VENEZOLANO;;Extranjero;PROVIDENCIA                   ;METROPOLITANA;0;0;0;0;0;0;0;0;0;LED 55UP7500 UHD SMART;ELECTRONICA MAYOR
11947068;;F;50;CHILENO;;X;RENCA                         ;METROPOLITANA;0;0;0;0;0;0;0;0;0;LED 50 50PUD6513/44 SMART TV UHD 4K;ELECTRONICA MAYOR
19594801;Soltero;M;25;CHILENO;;Z;PROVIDENCIA                   ;METROPOLITANA;0;0;0;0;0;0;0;0;0;LED 32 32LM630BPSB SMART TV;ELECTRONICA MAYOR
15539883;;F;38;CHILENO;;X;PROVIDENCIA                   ;METROPOLITANA;0;0;0;0;0;0;0;0;0;LED 43 43S5295 SMART TV FHD;ELECTRONICA MAYOR
10145383;;M;57;CHILENO;;Boomers;N/D;N/D;0;0;0;0;0;0;0;0;0;LED 65 KUHK6520 UHD SMART TV;ELECTRONICA MAYOR
10301703;;M;45;CHILENO;;Silencioso;PROVIDENCIA                   ;METROPOLITANA;0;0;0;0;0;0;0;0;0;LED 32 32S5295 SMART TV HD;ELECTRONICA MAYOR
8249452;;F;65;CHILENO;;Boomers;SAN BERNARDO                  ;METROPOLITANA;0;0;0;0;0;0;0;0;0;LED 50 50U6295 SMART TV UHD;ELECTRONICA MAYOR
13694881;Casado;F;42;CHILENO;AGRONOMO;Silencioso;PROVIDENCIA                   ;METROPOLITANA;0;0;0;0;0;0;0;0;0;LED 50 UN50TU7090GXZS UHD SMART TV;ELECTRONICA MAYOR
10686953;;F;49;CHILENO;;X;PENAFLOR                      ;METROPOLITANA;0;0;0;0;0;0;0;0;0;LED 40 KEHD4020 SMART TV;ELECTRONICA MAYOR
7337874;Soltero;F;69;CHILENO;;Silencioso;FREIRE                        ;ARAUCANIA;0;0;0;0;0;0;0;0;0;LED KIOTO 32 MI3228 SMART TV;ELECTRONICA MAYOR
11367471;Soltero;M;53;CHILENO;;X;SAN FERNANDO                  ;L.G.B.OÂ´HIGGINS;0;0;0;0;0;0;0;0;0;PARLANTE COBRA;ELECTRONICA MAYOR
17904316;Soltero;M;31;CHILENO;;Millenial;PROVIDENCIA                   ;METROPOLITANA;0;0;0;0;0;0;0;0;0;LED 43 UN43TU7090GXZS UHD SMART TV;ELECTRONICA MAYOR
17608087;;M;31;CHILENO;;Millenial;PROVIDENCIA                   ;METROPOLITANA;0;0;0;0;0;0;0;0;0;LED 50 KEUH50 SMART TV UHD;ELECTRONICA MAYOR
17713939;;M;31;CHILENO;;Millenial;OVALLE                        ;COQUIMBO;0;0;0;0;0;0;0;0;0;LED 40 KEHD4020 SMART TV;ELECTRONICA MAYOR
19554323;;M;25;CHILENO;;Silencioso;PROVIDENCIA                   ;METROPOLITANA;0;0;0;0;0;0;0;0;0;LED 32 UN32T4300AGXZS HD SMART TV;ELECTRONICA MAYOR
19369621;Soltero;F;25;CHILENO;TECNICO DE NIVEL MEDIO EN ALIMENTACION;Z;PROVIDENCIA                   ;METROPOLITANA;0;0;0;0;0;0;0;0;0;LED KIOTO 32 MI3228 SMART TV;ELECTRONICA MAYOR
18734545;;F;28;CHILENO;;Millenial;PROVIDENCIA                   ;METROPOLITANA;0;0;0;0;0;0;0;0;0;LED 43 UN43TU7090GXZS UHD SMART TV;ELECTRONICA MAYOR
9406663;;F;61;CHILENO;;Boomers;PROVIDENCIA                   ;METROPOLITANA;0;0;0;0;0;0;0;0;0;LED 32 UN32T4300AGXZS HD SMART TV;ELECTRONICA MAYOR
19168611;Soltero;F;27;CHILENO;;Z;PROVIDENCIA                   ;METROPOLITANA;0;0;0;0;0;0;0;0;0;LED KIOTO 32 MI3228 SMART TV;ELECTRONICA MAYOR
9863082;;M;50;CHILENO;;X;RENCA                         ;METROPOLITANA;0;0;0;0;0;0;0;0;0;LED 32 32LM630BPSB SMART TV;ELECTRONICA MAYOR
17743970;;M;31;CHILENO;;Silencioso;PROVIDENCIA                   ;METROPOLITANA;0;0;0;0;0;0;0;0;0;LED 32 UN32T4300AGXZS HD SMART TV;ELECTRONICA MAYOR
7734419;;M;65;CHILENO;;Boomers;CURANILAHUE                   ;BIO BIO;0;0;0;0;0;0;0;0;0;LED KIOTO 32 MI3228 SMART TV;ELECTRONICA MAYOR
14186587;Soltero;M;40;CHILENO;;Silencioso;N/D;N/D;0;0;0;0;0;0;0;0;0;LED 40 KEHD4020 SMART TV;ELECTRONICA MAYOR
13454736;;M;44;CHILENO;;X;PROVIDENCIA                   ;METROPOLITANA;0;0;0;0;0;0;0;0;0;LED 50 UN50TU7090GXZS UHD SMART TV;ELECTRONICA MAYOR
11259959;;M;54;CHILENO;;X;QUILICURA                     ;METROPOLITANA;0;0;0;0;0;0;0;0;0;SOUNDBAR HW-T400/ZS;ELECTRONICA MAYOR
19762161;;F;24;CHILENO;;Millenial;PROVIDENCIA                   ;METROPOLITANA;0;0;0;0;0;0;0;0;0;LED 40 KEHD4020 SMART TV;ELECTRONICA MAYOR
17562477;Soltero;M;32;CHILENO;;Millenial;PROVIDENCIA                   ;METROPOLITANA;0;0;0;0;0;0;0;0;0;LED 50 UN50TU7090GXZS UHD SMART TV;ELECTRONICA MAYOR
15130276;;M;39;CHILENO;;X;CURICO                        ;MAULE;0;0;0;0;0;0;0;0;0;LED 43 CS43S1USM UHD SMART TV NEGRO;ELECTRONICA MAYOR
18269077;;M;30;CHILENO;;Millenial;AISEN                         ;AYSEN;0;0;0;0;0;0;0;0;0;LED 55 55UN7100 UHD SMART TV;ELECTRONICA MAYOR
16043111;;M;37;CHILENO;;Millenial;CERRILLOS                     ;METROPOLITANA;0;0;0;0;0;0;0;0;0;LED 50 KEUH50 SMART TV UHD;ELECTRONICA MAYOR
7145949;Casado;M;65;CHILENO;;Silencioso;PROVIDENCIA                   ;METROPOLITANA;0;0;0;0;0;0;0;0;0;LED KIOTO 32 MI3228 SMART TV;ELECTRONICA MAYOR
15747306;;F;38;CHILENO;;Millenial;RENCA                         ;METROPOLITANA;0;0;0;0;0;0;0;0;0;LED 49 49UN7100 UHD SMART TV;ELECTRONICA MAYOR
12166547;;M;44;CHILENO;;X;SAN ANTONIO                   ;VALPARAISO;0;0;0;0;0;0;0;0;0;PARLANTE ULTRAMEGA;ELECTRONICA MAYOR
12612700;;F;48;CHILENO;;X;PROVIDENCIA                   ;METROPOLITANA;0;0;0;0;0;0;0;0;0;HERVIDOR ELECTRICO RH-3001 3L + TOSTADOR RH-1400;ELECTRONICA MAYOR
16691620;Casado;M;35;CHILENO;MEDICO CIRUJANO;Silencioso;PROVIDENCIA                   ;METROPOLITANA;0;0;0;0;0;0;0;0;0;LED 32 32LM630BPSB SMART TV;ELECTRONICA MAYOR
18462344;;M;29;CHILENO;;Silencioso;PROVIDENCIA                   ;METROPOLITANA;0;0;0;0;0;0;0;0;0;LED 43 UN43T5202AGXZS FHD SMART TV;ELECTRONICA MAYOR
20401320;;M;22;CHILENO;;Z;SAN BERNARDO                  ;METROPOLITANA;0;0;0;0;0;0;0;0;0;LED 50 50P615-50P ANDROID TV PASSION LINE UHD 4K;ELECTRONICA MAYOR
14350991;;F;42;CHILENO;;X;LOS ANGELES                   ;BIO BIO;0;0;0;0;0;0;0;0;0;LED KIOTO 32 MI3228 SMART TV;ELECTRONICA MAYOR
3367863;;M;89;CHILENO;;Silencioso;TALCA                         ;MAULE;0;0;0;0;0;0;0;0;0;LED KIOTO 32 MI3228 SMART TV;ELECTRONICA MAYOR
7553573;Casado;F;67;CHILENO;;Boomers;QUILPUE                       ;VALPARAISO;0;0;0;0;0;0;0;0;0;PARLANTE ULTRABUZZ;ELECTRONICA MAYOR
14088556;;F;40;CHILENO;;X;PROVIDENCIA                   ;METROPOLITANA;0;0;0;0;0;0;0;0;0;HERVIDOR ELECTRICO RH-3001 3L + TOSTADOR RH-1400;ELECTRONICA MAYOR
8116758;;M;60;CHILENO;;Boomers;RENCA                         ;METROPOLITANA;0;0;0;0;0;0;0;0;0;LED 50 UN50TU7090GXZS UHD SMART TV;ELECTRONICA MAYOR
14168191;Casado;F;40;CHILENO;INGENIERO;Silencioso;PROVIDENCIA                   ;METROPOLITANA;0;0;0;0;0;0;0;0;0;LED 32 UN32T4300AGXZS HD SMART TV;ELECTRONICA MAYOR
18584777;;M;28;CHILENO;;Millenial;PROVIDENCIA                   ;METROPOLITANA;0;0;0;0;0;0;0;0;0;SISTEMA DE SONIDO CM1560;ELECTRONICA MAYOR
12695098;;F;48;CHILENO;;X;SAN VICENTE                   ;L.G.B.OÂ´HIGGINS;0;0;0;0;0;0;0;0;0;LED 50 KEUH50 SMART TV UHD;ELECTRONICA MAYOR
19710724;;F;24;CHILENO;;Silencioso;PROVIDENCIA                   ;METROPOLITANA;0;0;0;0;0;0;0;0;0;LED 43 43S5295 SMART TV FHD;ELECTRONICA MAYOR
7023233;;M;68;CHILENO;;Boomers;IQUIQUE                       ;TARAPACA;0;0;0;0;0;0;0;0;0;LED 40 KEHD4020 SMART TV;ELECTRONICA MAYOR
11789883;;M;50;CHILENO;;X;VALLENAR;ATACAMA;0;0;0;0;0;0;0;0;0;LED 40 KEHD4020 SMART TV;ELECTRONICA MAYOR
16479927;;F;35;CHILENO;;Millenial;RENCA                         ;METROPOLITANA;0;0;0;0;0;0;0;0;0;LED 50 UN50TU7090GXZS UHD SMART TV;ELECTRONICA MAYOR
18782537;Soltero;F;27;CHILENO;;Millenial;PROVIDENCIA                   ;METROPOLITANA;0;0;0;0;0;0;0;0;0;LED 32 UN32T4300AGXZS HD SMART TV;ELECTRONICA MAYOR
17270519;Soltero;M;32;CHILENO;INGENIERO COMERCIAL;Silencioso;PROVIDENCIA                   ;METROPOLITANA;0;0;0;0;0;0;0;0;0;LED 50 UN50TU7090GXZS UHD SMART TV;ELECTRONICA MAYOR
8164171;Casado;F;65;CHILENO;;Boomers;RENCA                         ;METROPOLITANA;0;0;0;0;0;0;0;0;0;LED 55 UN55TU7090GXZS SMART TV UHD;ELECTRONICA MAYOR
25444044;;M;34;HAITIANO;;Extranjero;N/D;N/D;0;0;0;0;0;0;0;0;0;MONITOR 24 24TL520S SMART TV HD;ELECTRONICA MAYOR
14157348;;M;41;CHILENO;;X;PROVIDENCIA                   ;METROPOLITANA;0;0;0;0;0;0;0;0;0;LED 65 KUHK6520 UHD SMART TV;ELECTRONICA MAYOR
14614452;;F;40;CHILENO;;X;"";"";0;0;0;0;0;0;0;0;0;LED 32 32LM630BPSB SMART TV;ELECTRONICA MAYOR
12497373;;M;49;CHILENO;;X;PROVIDENCIA                   ;METROPOLITANA;0;0;0;0;0;0;0;0;0;LED KIOTO 32 MI3228 SMART TV;ELECTRONICA MAYOR
8865671;Divorciado;M;61;CHILENO;;Silencioso;PROVIDENCIA                   ;METROPOLITANA;0;0;0;0;0;0;0;0;0;LED 50 KEUH50 SMART TV UHD;ELECTRONICA MAYOR
19145594;;M;26;CHILENO;;Z;VALLENAR;ATACAMA;0;0;0;0;0;0;0;0;0;LED 32 32S5295 SMART TV HD;ELECTRONICA MAYOR
19285734;Soltero;M;25;CHILENO;;Silencioso;PROVIDENCIA                   ;METROPOLITANA;0;0;0;0;0;0;0;0;0;LED KIOTO 32 MI3228 SMART TV;ELECTRONICA MAYOR
18712343;;F;28;CHILENO;;Millenial;PROVIDENCIA                   ;METROPOLITANA;0;0;0;0;0;0;0;0;0;LED 40 KEHD4020 SMART TV;ELECTRONICA MAYOR
19897575;;F;25;CHILENO;;Z;CALLE LARGA                   ;VALPARAISO;0;0;0;0;0;0;0;0;0;LED KIOTO 32 MI3228 SMART TV;ELECTRONICA MAYOR
15527544;;F;36;CHILENO;;Millenial;PROVIDENCIA                   ;METROPOLITANA;0;0;0;0;0;0;0;0;0;LED 43 43UN7300 UHD SMART TV 4K;ELECTRONICA MAYOR
20465873;;M;22;CHILENO;;Silencioso;PROVIDENCIA                   ;METROPOLITANA;0;0;0;0;0;0;0;0;0;LED 50 UN50TU7090GXZS UHD SMART TV;ELECTRONICA MAYOR
16128380;;F;36;CHILENO;;Silencioso;PROVIDENCIA                   ;METROPOLITANA;0;0;0;0;0;0;0;0;0;LED 50 UN50TU7090GXZS UHD SMART TV;ELECTRONICA MAYOR
19142955;Soltero;M;26;CHILENO;;Z;PROVIDENCIA                   ;METROPOLITANA;0;0;0;0;0;0;0;0;0;MINICOMPONENTE RN7;ELECTRONICA MAYOR
12842044;;F;47;CHILENO;;X;PROVIDENCIA                   ;METROPOLITANA;0;0;0;0;0;0;0;0;0;PARLANTE COBRA;ELECTRONICA MAYOR
8126955;;M;61;CHILENO;;Boomers;LO PRADO                      ;METROPOLITANA;0;0;0;0;0;0;0;0;0;LED KIOTO 32 MI3228 SMART TV;ELECTRONICA MAYOR
17734443;Soltero;M;31;CHILENO;;Silencioso;PROVIDENCIA                   ;METROPOLITANA;0;0;0;0;0;0;0;0;0;LED 50 UN50TU7090GXZS UHD SMART TV;ELECTRONICA MAYOR
26091689;;M;35;VENEZOLANO;;Extranjero;N/D;N/D;0;0;0;0;0;0;0;0;0;LED 55 55NANO79 NanoCell UHD SMART TV;ELECTRONICA MAYOR
18342711;;F;29;CHILENO;;Millenial;PROVIDENCIA                   ;METROPOLITANA;0;0;0;0;0;0;0;0;0;LED 55 UN55TU7090GXZS SMART TV UHD;ELECTRONICA MAYOR
10917951;Casado;F;55;CHILENO;ADMINISTRADOR TURISTICO;Silencioso;PROVIDENCIA                   ;METROPOLITANA;0;0;0;0;0;0;0;0;0;LED 55 55UN7100 UHD SMART TV;ELECTRONICA MAYOR
13125582;;F;46;CHILENO;;X;PROVIDENCIA                   ;METROPOLITANA;0;0;0;0;0;0;0;0;0;LED 32 UN32T4300AGXZS HD SMART TV;ELECTRONICA MAYOR
16241012;;F;36;CHILENO;;Millenial;NUEVA IMPERIAL                ;ARAUCANIA;0;0;0;0;0;0;0;0;0;LED 40 KEHD4020 SMART TV;ELECTRONICA MAYOR
17185750;;F;33;CHILENO;;Millenial;N/D;N/D;0;0;0;0;0;0;0;0;0;LED KIOTO 32 MI3228 SMART TV;ELECTRONICA MAYOR
19263243;Soltero;M;26;CHILENO;;Z;PROVIDENCIA                   ;METROPOLITANA;0;0;0;0;0;0;0;0;0;LED 43 43UN7300 UHD SMART TV 4K;ELECTRONICA MAYOR
16246528;;M;37;CHILENO;;Silencioso;PROVIDENCIA                   ;METROPOLITANA;0;0;0;0;0;0;0;0;0;SISTEMA DE SONIDO LK72B;ELECTRONICA MAYOR
27457178;;M;30;"";;Extranjero;PROVIDENCIA                   ;METROPOLITANA;0;0;0;0;0;0;0;0;0;LED 32 32S60-32P ANDROID TV SMART LINE HD;ELECTRONICA MAYOR
18784727;;M;27;CHILENO;;Z;PROVIDENCIA                   ;METROPOLITANA;0;0;0;0;0;0;0;0;0;LED 50 UN50TU7090GXZS UHD SMART TV;ELECTRONICA MAYOR
15375553;;M;39;CHILENO;;X;RENCA                         ;METROPOLITANA;0;0;0;0;0;0;0;0;0;LED 43 UN43T5202AGXZS FHD SMART TV;ELECTRONICA MAYOR
18761530;;M;27;CHILENO;;Z;"";"";0;0;0;0;0;0;0;0;0;LED 43 UN43TU7090GXZS UHD SMART TV;ELECTRONICA MAYOR
14305154;;M;47;CHILENO;;X;N/D;N/D;0;0;0;0;0;0;0;0;0;LED 50 UN50TU7090GXZS UHD SMART TV;ELECTRONICA MAYOR
16186545;;M;36;CHILENO;;Millenial;PROVIDENCIA                   ;METROPOLITANA;0;0;0;0;0;0;0;0;0;LED 50 50U6295 SMART TV UHD;ELECTRONICA MAYOR
6610446;;M;67;CHILENO;;Boomers;PIRQUE                        ;METROPOLITANA;0;0;0;0;0;0;0;0;0;LED 43 43UN7300 UHD SMART TV 4K;ELECTRONICA MAYOR
12310733;;F;50;CHILENO;;X;COIHAIQUE                     ;AYSEN;0;0;0;0;0;0;0;0;0;LED 43 UN43T5202AGXZS FHD SMART TV;ELECTRONICA MAYOR
12003228;;M;53;CHILENO;;X;MAIPU                         ;METROPOLITANA;0;0;0;0;0;0;0;0;0;LED 40 KEHD4020 SMART TV;ELECTRONICA MAYOR
13362482;;M;44;CHILENO;;X;SAN FELIPE                    ;VALPARAISO;0;0;0;0;0;0;0;0;0;LED 55 UN55TU7090GXZS SMART TV UHD;ELECTRONICA MAYOR
19663008;;F;23;CHILENO;;Silencioso;PROVIDENCIA                   ;METROPOLITANA;0;0;0;0;0;0;0;0;0;LED 32 32LM630BPSB SMART TV;ELECTRONICA MAYOR
26348793;;M;63;VENEZOLANO;;Extranjero;N/D;N/D;0;0;0;0;0;0;0;0;0;LED KIOTO 32 MI3228 SMART TV;ELECTRONICA MAYOR
16311998;;M;36;CHILENO;;Millenial;PUERTO MONTT                  ;LOS LAGOS;0;0;0;0;0;0;0;0;0;LED 40 KEHD4020 SMART TV;ELECTRONICA MAYOR
16562018;;F;35;CHILENO;;Millenial;PROVIDENCIA                   ;METROPOLITANA;0;0;0;0;0;0;0;0;0;MAGIC REMOTE MR20GA;ELECTRONICA MAYOR
16466086;;F;36;CHILENO;;Millenial;PROVIDENCIA                   ;METROPOLITANA;0;0;0;0;0;0;0;0;0;LED 43 UN43T5202AGXZS FHD SMART TV;ELECTRONICA MAYOR
16114928;;M;37;CHILENO;;Millenial;MAIPU                         ;METROPOLITANA;0;0;0;0;0;0;0;0;0;LED 58 KUHK5820 UHD SMART TV;ELECTRONICA MAYOR
12203771;;F;51;CHILENO;;X;CASTRO                        ;LOS LAGOS;0;0;0;0;0;0;0;0;0;LED 55 UN55TU8300GXZS UHD SMART TV CURVO;ELECTRONICA MAYOR
19317614;;F;26;CHILENO;;Z;N/D;N/D;0;0;0;0;0;0;0;0;0;MONITOR 24 24TL520S SMART TV HD;ELECTRONICA MAYOR
17625365;;M;31;CHILENO;;Millenial;SANTIAGO                      ;METROPOLITANA;0;0;0;0;0;0;0;0;0;LED KIOTO 32 MI3228 SMART TV;ELECTRONICA MAYOR
8733300;;M;61;CHILENO;;Boomers;SAN BERNARDO                  ;METROPOLITANA;0;0;0;0;0;0;0;0;0;LED 58 58PUD6513/44 SMART TV UHD;ELECTRONICA MAYOR
19874303;;F;23;CHILENO;;Z;N/D;N/D;0;0;0;0;0;0;0;0;0;LED 55 UN55TU7090GXZS SMART TV UHD;ELECTRONICA MAYOR
6395353;;M;72;CHILENO;;Silencioso;HIJUELAS                      ;VALPARAISO;0;0;0;0;0;0;0;0;0;LED 40 KEHD4020 SMART TV;ELECTRONICA MAYOR
13236133;;F;45;CHILENO;;X;N/D;N/D;0;0;0;0;0;0;0;0;0;LED 40 KEHD4020 SMART TV;ELECTRONICA MAYOR
18607768;;M;28;CHILENO;;Millenial;BUIN                          ;METROPOLITANA;0;0;0;0;0;0;0;0;0;LED KIOTO 32 MI3228 SMART TV;ELECTRONICA MAYOR
18318720;;M;29;CHILENO;;Millenial;CALERA DE TANGO               ;METROPOLITANA;0;0;0;0;0;0;0;0;0;LED KIOTO 32 MI3228 SMART TV;ELECTRONICA MAYOR
15529890;;F;38;CHILENO;;Silencioso;PROVIDENCIA                   ;METROPOLITANA;0;0;0;0;0;0;0;0;0;LED KIOTO 32 MI3228 SMART TV;ELECTRONICA MAYOR
10714939;Casado;F;52;CHILENO;PROFESOR;X;PROVIDENCIA                   ;METROPOLITANA;0;0;0;0;0;0;0;0;0;LED KIOTO 32 MI3228 SMART TV;ELECTRONICA MAYOR
12508499;;M;49;CHILENO;;X;PROVIDENCIA                   ;METROPOLITANA;0;0;0;0;0;0;0;0;0;LED 55 UN55TU7090GXZS SMART TV UHD;ELECTRONICA MAYOR
8610386;;F;61;CHILENO;;Boomers;RENCA                         ;METROPOLITANA;0;0;0;0;0;0;0;0;0;LED 50 KEUH50 SMART TV UHD;ELECTRONICA MAYOR
6179164;;F;77;CHILENO;;Silencioso;PROVIDENCIA                   ;METROPOLITANA;0;0;0;0;0;0;0;0;0;LED 55 55UN7100 UHD SMART TV;ELECTRONICA MAYOR
17790682;;F;31;CHILENO;;Millenial;VINA DEL MAR                  ;VALPARAISO;0;0;0;0;0;0;0;0;0;LED 50 50U6295 SMART TV UHD;ELECTRONICA MAYOR
6535461;;M;71;CHILENO;;Silencioso;SAN CARLOS                    ;BIO BIO;0;0;0;0;0;0;0;0;0;LED 55 55UN7100 UHD SMART TV;ELECTRONICA MAYOR
18287702;Soltero;F;28;CHILENO;NUTRICIONISTA;Millenial;PROVIDENCIA                   ;METROPOLITANA;0;0;0;0;0;0;0;0;0;MAGIC REMOTE MR20GA;ELECTRONICA MAYOR
9758818;;M;56;CHILENO;;Boomers;YUMBEL                        ;BIO BIO;0;0;0;0;0;0;0;0;0;LED 32 UN32T4300AGXZS HD SMART TV;ELECTRONICA MAYOR
20536181;;M;21;CHILENO;;Millenial;"";"";0;0;0;0;0;0;0;0;0;PARLANTE COBRA;ELECTRONICA MAYOR
15996212;;F;36;CHILENO;;Millenial;RANCAGUA                      ;L.G.B.OÂ´HIGGINS;0;0;0;0;0;0;0;0;0;SISTEMA DE SONIDO CM1560;ELECTRONICA MAYOR
5325704;;F;78;CHILENO;;Silencioso;RENCA                         ;METROPOLITANA;0;0;0;0;0;0;0;0;0;MINICOMPONENTE OL45;ELECTRONICA MAYOR
19808452;;M;23;CHILENO;;Z;TALCA                         ;MAULE;0;0;0;0;0;0;0;0;0;MINICOMPONENTE RN7;ELECTRONICA MAYOR
16429441;;F;35;CHILENO;;Silencioso;PROVIDENCIA                   ;METROPOLITANA;0;0;0;0;0;0;0;0;0;MINICOMPONENTE CJ45;ELECTRONICA MAYOR
18744062;;F;48;CHILENO;;X;LA PINTANA                    ;METROPOLITANA;0;0;0;0;0;0;0;0;0;SOUNDBAR HW-T450/ZS;ELECTRONICA MAYOR
6916542;;F;68;CHILENO;;Boomers;SAN VICENTE                   ;L.G.B.OÂ´HIGGINS;0;0;0;0;0;0;0;0;0;LED 40 KEHD4020 SMART TV;ELECTRONICA MAYOR
5055044;;M;73;CHILENO;;Silencioso;ILLAPEL                       ;COQUIMBO;0;0;0;0;0;0;0;0;0;LED 40 KEHD4020 SMART TV;ELECTRONICA MAYOR
9023526;;M;59;CHILENO;;Boomers;RENCA                         ;METROPOLITANA;0;0;0;0;0;0;0;0;0;SISTEMA DE SONIDO OK75;ELECTRONICA MAYOR
13648766;;F;43;CHILENO;;X;LA SERENA                     ;COQUIMBO;0;0;0;0;0;0;0;0;0;LED 50 UN50TU7090GXZS UHD SMART TV;ELECTRONICA MAYOR
17709110;Soltero;F;30;CHILENO;;Millenial;PROVIDENCIA                   ;METROPOLITANA;0;0;0;0;0;0;0;0;0;MONITOR 24 24TL520S SMART TV HD;ELECTRONICA MAYOR
20015355;;M;23;CHILENO;;Silencioso;PROVIDENCIA                   ;METROPOLITANA;0;0;0;0;0;0;0;0;0;LED 43 43UN7300 UHD SMART TV 4K;ELECTRONICA MAYOR
15167264;;M;40;CHILENO;;X;CABRERO                       ;BIO BIO;0;0;0;0;0;0;0;0;0;LED 50 50NANO79 NanoCell UHD SMART TV;ELECTRONICA MAYOR
16331810;;F;35;CHILENO;;Millenial;QUILPUE                       ;VALPARAISO;0;0;0;0;0;0;0;0;0;LED 43 43LM6300PSB SMART TV HD;ELECTRONICA MAYOR
10650771;;F;51;CHILENO;;X;RENCA                         ;METROPOLITANA;0;0;0;0;0;0;0;0;0;LED 32 UN32T4300AGXZS HD SMART TV;ELECTRONICA MAYOR
12589649;;F;48;CHILENO;;X;RENCA                         ;METROPOLITANA;0;0;0;0;0;0;0;0;0;LED 50 UN50TU7090GXZS UHD SMART TV;ELECTRONICA MAYOR
20667725;;M;21;CHILENO;;Z;GORBEA                        ;ARAUCANIA;0;0;0;0;0;0;0;0;0;LED 58 58PUD6513/44 SMART TV UHD;ELECTRONICA MAYOR
17736429;Soltero;M;31;CHILENO;INGENIERO COMERCIAL;Silencioso;PROVIDENCIA                   ;METROPOLITANA;0;0;0;0;0;0;0;0;0;LED 43 UN43T5202AGXZS FHD SMART TV;ELECTRONICA MAYOR
10372195;;F;53;CHILENO;;X;PROVIDENCIA                   ;METROPOLITANA;0;0;0;0;0;0;0;0;0;LED 43 UN43T5202AGXZS FHD SMART TV;ELECTRONICA MAYOR
14050278;;F;40;CHILENO;;X;RENCA                         ;METROPOLITANA;0;0;0;0;0;0;0;0;0;LED 32 UN32T4300AGXZS HD SMART TV;ELECTRONICA MAYOR
15483685;;M;40;CHILENO;;X;COIHAIQUE                     ;AYSEN;0;0;0;0;0;0;0;0;0;LED 65 UN65TU6900GXZS UHD SMART TV;ELECTRONICA MAYOR
8850464;Casado;M;61;CHILENO;;Boomers;COLINA                        ;METROPOLITANA;0;0;0;0;0;0;0;0;0;LED 40 KEHD4020 SMART TV;ELECTRONICA MAYOR
11271576;;F;54;CHILENO;;X;RENCA                         ;METROPOLITANA;0;0;0;0;0;0;0;0;0;PARLANTE SPBYF7 PORTATIL;ELECTRONICA MAYOR
10713733;;M;55;CHILENO;;Boomers;CORONEL                       ;BIO BIO;0;0;0;0;0;0;0;0;0;MINICOMPONENTE RN7;ELECTRONICA MAYOR
9164137;;F;61;CHILENO;;Boomers;RANCAGUA                      ;L.G.B.OÂ´HIGGINS;0;0;0;0;0;0;0;0;0;PARLANTE BOLA DISCO CON MICROFONO INAL;ELECTRONICA MAYOR
17378465;Soltero;M;32;CHILENO;INGENIERO ELECTRICO;Silencioso;PROVIDENCIA                   ;METROPOLITANA;0;0;0;0;0;0;0;0;0;LED 40 KEHD4020 SMART TV;ELECTRONICA MAYOR
14330986;;F;44;CHILENO;;X;LINARES                       ;MAULE;0;0;0;0;0;0;0;0;0;LED 40 KEHD4020 SMART TV;ELECTRONICA MAYOR
16100640;Casado;F;36;CHILENO;;Silencioso;PROVIDENCIA                   ;METROPOLITANA;0;0;0;0;0;0;0;0;0;LED 43 43LM6300PSB SMART TV HD;ELECTRONICA MAYOR
15352550;;M;39;CHILENO;;X;LA FLORIDA;METROPOLITANA;0;0;0;0;0;0;0;0;0;LED 32 32LM630BPSB SMART TV;ELECTRONICA MAYOR
13420618;;M;44;CHILENO;;X;RANCAGUA                      ;L.G.B.OÂ´HIGGINS;0;0;0;0;0;0;0;0;0;MINICOMPONENTE OL45;ELECTRONICA MAYOR
10635437;;F;55;CHILENO;;Boomers;CONCEPCION                    ;BIO BIO;0;0;0;0;0;0;0;0;0;LED 50 KEUH50 SMART TV UHD;ELECTRONICA MAYOR
5813540;;M;75;CHILENO;;Silencioso;RENCA                         ;METROPOLITANA;0;0;0;0;0;0;0;0;0;LED 40 KEHD4020 SMART TV;ELECTRONICA MAYOR
8933037;Casado;F;63;CHILENO;;Boomers;CORONEL                       ;BIO BIO;0;0;0;0;0;0;0;0;0;LED 65 UN65TU6900GXZS UHD SMART TV;ELECTRONICA MAYOR
9472170;;F;61;CHILENO;;Boomers;PROVIDENCIA                   ;METROPOLITANA;0;0;0;0;0;0;0;0;0;LED 43 43LM6300PSB SMART TV HD;ELECTRONICA MAYOR
17694547;Soltero;F;31;CHILENO;TECNICO EN ADMINISTRACION DE EMPRESAS;Millenial;PROVIDENCIA                   ;METROPOLITANA;0;0;0;0;0;0;0;0;0;LED 43 UN43T5202AGXZS FHD SMART TV;ELECTRONICA MAYOR
16071658;;M;37;CHILENO;;Millenial;N/D;N/D;0;0;0;0;0;0;0;0;0;LED 50 50U6295 SMART TV UHD;ELECTRONICA MAYOR
19457257;;F;30;CHILENO;;Millenial;CURICO                        ;MAULE;0;0;0;0;0;0;0;0;0;LED 50 50PUD6513/44 SMART TV UHD 4K;ELECTRONICA MAYOR
16072055;;F;36;CHILENO;;Millenial;N/D;N/D;0;0;0;0;0;0;0;0;0;MINICOMPONENTE RN9;ELECTRONICA MAYOR
10389165;;M;54;CHILENO;;Boomers;RENCA                         ;METROPOLITANA;0;0;0;0;0;0;0;0;0;LED 32 UN32T4300AGXZS HD SMART TV;ELECTRONICA MAYOR
10454243;;F;58;CHILENO;;Boomers;LOS ANGELES                   ;BIO BIO;0;0;0;0;0;0;0;0;0;LED 43 UN43T5202AGXZS FHD SMART TV;ELECTRONICA MAYOR
10964904;;F;54;CHILENO;;X;CALERA                        ;VALPARAISO;0;0;0;0;0;0;0;0;0;KARAOKE FUNKY DISCO;ELECTRONICA MAYOR
7201323;;F;65;CHILENO;;Boomers;ESTACION CENTRAL              ;METROPOLITANA;0;0;0;0;0;0;0;0;0;LED 50 KEUH50 SMART TV UHD;ELECTRONICA MAYOR
7331865;;M;69;CHILENO;;Silencioso;LA LIGUA                      ;VALPARAISO;0;0;0;0;0;0;0;0;0;LED 40 KEHD4020 SMART TV;ELECTRONICA MAYOR
16798683;Soltero;M;34;CHILENO;;Millenial;PROVIDENCIA                   ;METROPOLITANA;0;0;0;0;0;0;0;0;0;LED 50 KEUH50 SMART TV UHD;ELECTRONICA MAYOR
16808931;;M;34;CHILENO;;Millenial;RENCA                         ;METROPOLITANA;0;0;0;0;0;0;0;0;0;LED 32 UN32T4300AGXZS HD SMART TV;ELECTRONICA MAYOR
14270112;;M;50;CHILENO;;X;ARICA                         ;ARICA Y PARINACOTA;0;0;0;0;0;0;0;0;0;LED 58 KUHK5820 UHD SMART TV;ELECTRONICA MAYOR
17266443;Soltero;F;33;CHILENO;ABOGADO;Millenial;PROVIDENCIA                   ;METROPOLITANA;0;0;0;0;0;0;0;0;0;LED 43 UN43T5202AGXZS FHD SMART TV;ELECTRONICA MAYOR
13934988;;F;42;CHILENO;;X;PROVIDENCIA                   ;METROPOLITANA;0;0;0;0;0;0;0;0;0;LED 43 UN43T5202AGXZS FHD SMART TV;ELECTRONICA MAYOR
15883506;;M;38;CHILENO;;Extranjero;VALDIVIA                      ;LOS RIOS;0;0;0;0;0;0;0;0;0;LED 55 55UN7100 UHD SMART TV;ELECTRONICA MAYOR
10015563;;F;58;CHILENO;;Boomers;PUERTO MONTT                  ;LOS LAGOS;0;0;0;0;0;0;0;0;0;LED 50 UN50TU7090GXZS UHD SMART TV;ELECTRONICA MAYOR
18781465;Soltero;M;28;CHILENO;;Millenial;PROVIDENCIA                   ;METROPOLITANA;0;0;0;0;0;0;0;0;0;LED 32 UN32T4300AGXZS HD SMART TV;ELECTRONICA MAYOR
12583138;;M;47;CHILENO;;X;SALAMANCA                     ;COQUIMBO;0;0;0;0;0;0;0;0;0;LED 40 KEHD4020 SMART TV;ELECTRONICA MAYOR
13834396;Soltero;M;42;CHILENO;;X;PROVIDENCIA                   ;METROPOLITANA;0;0;0;0;0;0;0;0;0;LED 50 UN50TU7090GXZS UHD SMART TV;ELECTRONICA MAYOR
6113879;;F;73;CHILENO;;Silencioso;RENCA                         ;METROPOLITANA;0;0;0;0;0;0;0;0;0;LED 32 UN32T4300AGXZS HD SMART TV;ELECTRONICA MAYOR
14182385;;M;41;CHILENO;;X;RENCA                         ;METROPOLITANA;0;0;0;0;0;0;0;0;0;LED 43 CS43S1USM UHD SMART TV NEGRO;ELECTRONICA MAYOR
18607094;;M;28;CHILENO;;Millenial;PUENTE ALTO                   ;METROPOLITANA;0;0;0;0;0;0;0;0;0;LED 55 UN55TU8300GXZS UHD SMART TV CURVO;ELECTRONICA MAYOR
13472906;;F;46;CHILENO;;X;SAN BERNARDO                  ;METROPOLITANA;0;0;0;0;0;0;0;0;0;LED 58 KTUHD5820 4K SMART TV;ELECTRONICA MAYOR
18661102;;F;28;CHILENO;;Millenial;PROVIDENCIA                   ;METROPOLITANA;0;0;0;0;0;0;0;0;0;LED 50 50P715 ANDROID TV UHD 4K;ELECTRONICA MAYOR
13520114;;F;44;CHILENO;;X;RENCA                         ;METROPOLITANA;0;0;0;0;0;0;0;0;0;MONITOR 24 24TL520S SMART TV HD;ELECTRONICA MAYOR
10395171;;M;46;CHILENO;;X;PROVIDENCIA                   ;METROPOLITANA;0;0;0;0;0;0;0;0;0;SOUNDBAR HW-T650/ZS;ELECTRONICA MAYOR
14093323;;M;40;CHILENO;;X;SAN RAMON                     ;METROPOLITANA;0;0;0;0;0;0;0;0;0;LED 32 UN32T4300AGXZS HD SMART TV;ELECTRONICA MAYOR
25336783;;F;51;COLOMBIANO;;Extranjero;SANTIAGO                      ;METROPOLITANA;0;0;0;0;0;0;0;0;0;LED 50 UN50TU7090GXZS UHD SMART TV;ELECTRONICA MAYOR
10761402;;F;54;CHILENO;;Boomers;RANCAGUA                      ;L.G.B.OÂ´HIGGINS;0;0;0;0;0;0;0;0;0;LED 32 UN32T4300AGXZS HD SMART TV;ELECTRONICA MAYOR
26058668;;M;31;VENEZOLANO;;Extranjero;RANCAGUA                      ;L.G.B.OÂ´HIGGINS;0;0;0;0;0;0;0;0;0;LED 40 KEHD4020 SMART TV;ELECTRONICA MAYOR
4132993;;F;79;CHILENO;;Silencioso;RENCA                         ;METROPOLITANA;0;0;0;0;0;0;0;0;0;LED 32 UN32T4300AGXZS HD SMART TV;ELECTRONICA MAYOR
7978548;;M;65;CHILENO;;Boomers;N/D;N/D;0;0;0;0;0;0;0;0;0;LED 43 UN43T5202AGXZS FHD SMART TV;ELECTRONICA MAYOR
11374161;;F;53;CHILENO;;X;SAN JAVIER                    ;MAULE;0;0;0;0;0;0;0;0;0;LED 49 49UN7100 UHD SMART TV;ELECTRONICA MAYOR
16583128;;M;35;CHILENO;;Millenial;RENCA                         ;METROPOLITANA;0;0;0;0;0;0;0;0;0;MINICOMPONENTE CJ45;ELECTRONICA MAYOR
11626104;;F;52;CHILENO;;X;PROVIDENCIA                   ;METROPOLITANA;0;0;0;0;0;0;0;0;0;LED 32 UN32T4300AGXZS HD SMART TV;ELECTRONICA MAYOR
18997001;;M;27;CHILENO;;Silencioso;PROVIDENCIA                   ;METROPOLITANA;0;0;0;0;0;0;0;0;0;LED 43 CS43S1USM UHD SMART TV NEGRO;ELECTRONICA MAYOR
7947531;;M;63;CHILENO;;Extranjero;LEBU                          ;BIO BIO;0;0;0;0;0;0;0;0;0;LED 43 43LM6300PSB SMART TV HD;ELECTRONICA MAYOR
12632147;Casado;F;48;CHILENO;;X;PROVIDENCIA                   ;METROPOLITANA;0;0;0;0;0;0;0;0;0;LED 43 43LM6300PSB SMART TV HD;ELECTRONICA MAYOR
11562926;Casado;F;52;CHILENO;PROFESOR;X;SAN JAVIER                    ;MAULE;0;0;0;0;0;0;0;0;0;KARAOKE SP-101BT ALL IN ONE PORTATIL 60W;ELECTRONICA MAYOR
7412531;;F;64;CHILENO;;Boomers;SAN BERNARDO                  ;METROPOLITANA;0;0;0;0;0;0;0;0;0;LED 32 32S5295 SMART TV HD;ELECTRONICA MAYOR
12659580;;M;48;CHILENO;;X;PROVIDENCIA                   ;METROPOLITANA;0;0;0;0;0;0;0;0;0;LED 58 KTUHD5820 4K SMART TV;ELECTRONICA MAYOR
12549018;;M;48;CHILENO;;X;PROVIDENCIA                   ;METROPOLITANA;0;0;0;0;0;0;0;0;0;LED 55 UN55TU8300GXZS UHD SMART TV CURVO;ELECTRONICA MAYOR
12526262;;M;49;CHILENO;;X;PROVIDENCIA                   ;METROPOLITANA;0;0;0;0;0;0;0;0;0;LED 43 UN43T5202AGXZS FHD SMART TV;ELECTRONICA MAYOR
7875145;;F;63;CHILENO;;Boomers;PROVIDENCIA                   ;METROPOLITANA;0;0;0;0;0;0;0;0;0;KARAOKE RHYTHM CHARGER 12 MIC CABLE 8890;ELECTRONICA MAYOR
8896104;;M;56;CHILENO;;Boomers;PROVIDENCIA                   ;METROPOLITANA;0;0;0;0;0;0;0;0;0;LED 32 UN32T4300AGXZS HD SMART TV;ELECTRONICA MAYOR
11950564;;M;50;CHILENO;;X;RENGO                         ;L.G.B.OÂ´HIGGINS;0;0;0;0;0;0;0;0;0;LED 49 49LJ5100 FHD;ELECTRONICA MAYOR
25899898;;M;30;HAITIANO;;Extranjero;N/D;N/D;0;0;0;0;0;0;0;0;0;LED 50 UN50TU7090GXZS UHD SMART TV;ELECTRONICA MAYOR
16425877;;F;35;CHILENO;;Millenial;RENCA                         ;METROPOLITANA;0;0;0;0;0;0;0;0;0;PARLANTE ULTRAMEGA;ELECTRONICA MAYOR
16407706;;F;36;CHILENO;;Millenial;N/D;N/D;0;0;0;0;0;0;0;0;0;PARLANTE ULTRAFORCE-I;ELECTRONICA MAYOR
5825732;;F;75;CHILENO;;Silencioso;VALLENAR;ATACAMA;0;0;0;0;0;0;0;0;0;LED 32 32PHD5813 SMART TV HD;ELECTRONICA MAYOR
9223409;;M;58;CHILENO;;Boomers;PROVIDENCIA                   ;METROPOLITANA;0;0;0;0;0;0;0;0;0;PARLANTE ULTRASENSATION;ELECTRONICA MAYOR
18586257;Soltero;M;28;CHILENO;;Silencioso;PROVIDENCIA                   ;METROPOLITANA;0;0;0;0;0;0;0;0;0;LED 43 CS43S1USM UHD SMART TV NEGRO;ELECTRONICA MAYOR
10175003;;F;57;CHILENO;;Boomers;RENCA                         ;METROPOLITANA;0;0;0;0;0;0;0;0;0;LED 50 UN50TU7090GXZS UHD SMART TV;ELECTRONICA MAYOR
8948485;;M;62;CHILENO;;Boomers;PADRE HURTADO                 ;METROPOLITANA;0;0;0;0;0;0;0;0;0;LED 43 UN43T5202AGXZS FHD SMART TV;ELECTRONICA MAYOR
16560541;;M;34;CHILENO;;Millenial;N/D;N/D;0;0;0;0;0;0;0;0;0;LED 55 UN55TU8300GXZS UHD SMART TV CURVO;ELECTRONICA MAYOR
14185631;Soltero;F;41;CHILENO;;Silencioso;RENCA                         ;METROPOLITANA;0;0;0;0;0;0;0;0;0;MINICOMPONENTE CJ45;ELECTRONICA MAYOR
13155121;;M;44;CHILENO;;X;TEMUCO                        ;ARAUCANIA;0;0;0;0;0;0;0;0;0;LED 55 UN55NU7095GXZS SMART TV TV 4K;ELECTRONICA MAYOR
15304930;;F;40;CHILENO;;X;COIHAIQUE                     ;AYSEN;0;0;0;0;0;0;0;0;0;LED 43 43S5295 SMART TV FHD;ELECTRONICA MAYOR
18448511;;F;28;CHILENO;;Millenial;VINA DEL MAR                  ;VALPARAISO;0;0;0;0;0;0;0;0;0;LED KIOTO 32 MI3228 SMART TV;ELECTRONICA MAYOR
17180037;Soltero;F;33;CHILENO;;Millenial;PROVIDENCIA                   ;METROPOLITANA;0;0;0;0;0;0;0;0;0;LED 55 55NANO79 NanoCell UHD SMART TV;ELECTRONICA MAYOR
13580043;;F;43;CHILENO;;X;PROVIDENCIA                   ;METROPOLITANA;0;0;0;0;0;0;0;0;0;LED 32 32S5295 SMART TV HD;ELECTRONICA MAYOR
15116746;Soltero;F;39;CHILENO;;X;PROVIDENCIA                   ;METROPOLITANA;0;0;0;0;0;0;0;0;0;PARLANTE DJ VIBRANIUM;ELECTRONICA MAYOR
12934561;;F;46;CHILENO;;X;PUERTO MONTT                  ;LOS LAGOS;0;0;0;0;0;0;0;0;0;LED 50 UN50TU7090GXZS UHD SMART TV;ELECTRONICA MAYOR
12073338;;M;46;CHILENO;;X;SAN IGNACIO                   ;BIO BIO;0;0;0;0;0;0;0;0;0;MINICOMPONENTE MX-T40/ZS ALL IN ONE;ELECTRONICA MAYOR
11110722;;F;55;CHILENO;;Boomers;COLINA                        ;METROPOLITANA;0;0;0;0;0;0;0;0;0;EQUIPO SONIDO HCD-SHAKE X70;ELECTRONICA MAYOR
10440192;;M;56;CHILENO;;Boomers;PROVIDENCIA                   ;METROPOLITANA;0;0;0;0;0;0;0;0;0;MONITOR 24 24TL520S SMART TV HD;ELECTRONICA MAYOR
13348663;;M;44;CHILENO;;X;NUNOA                         ;METROPOLITANA;0;0;0;0;0;0;0;0;0;LED 32 32S5295 SMART TV HD;ELECTRONICA MAYOR
17263915;Soltero;M;32;CHILENO;;Millenial;PROVIDENCIA                   ;METROPOLITANA;0;0;0;0;0;0;0;0;0;PARLANTE KARAOKE RM1 8 PULGADAS;ELECTRONICA MAYOR
13749920;;M;43;CHILENO;;X;N/D;N/D;0;0;0;0;0;0;0;0;0;LED 43 UN43T5202AGXZS FHD SMART TV;ELECTRONICA MAYOR
16944204;;M;32;CHILENO;;Millenial;PALMILLA                      ;L.G.B.OÂ´HIGGINS;0;0;0;0;0;0;0;0;0;LED 32 32PHD5813 SMART TV HD;ELECTRONICA MAYOR
9811892;;M;59;CHILENO;;Extranjero;DALCAHUE                      ;LOS LAGOS;0;0;0;0;0;0;0;0;0;LED 32 32S60-32P ANDROID TV SMART LINE HD;ELECTRONICA MAYOR
12793906;;M;46;CHILENO;;X;N/D;N/D;0;0;0;0;0;0;0;0;0;LED 32 CS32S1 SMART TV HD NEGRO;ELECTRONICA MAYOR
17373040;;F;32;CHILENO;;Millenial;CERRO NAVIA                   ;METROPOLITANA;0;0;0;0;0;0;0;0;0;PARLANTE ULTRAFORCE-I;ELECTRONICA MAYOR
15753006;;M;38;CHILENO;;Millenial;PROVIDENCIA                   ;METROPOLITANA;0;0;0;0;0;0;0;0;0;SOUNDBAR HW-T450/ZS;ELECTRONICA MAYOR
17909233;;M;30;CHILENO;;Millenial;CATEMU;VALPARAISO;0;0;0;0;0;0;0;0;0;LED 50 UN50TU7090GXZS UHD SMART TV;ELECTRONICA MAYOR
8707544;;M;63;CHILENO;;Boomers;VALPARAISO                    ;VALPARAISO;0;0;0;0;0;0;0;0;0;LED 32 32S5295 SMART TV HD;ELECTRONICA MAYOR
11323183;;F;54;CHILENO;;Boomers;RENCA                         ;METROPOLITANA;0;0;0;0;0;0;0;0;0;KARAOKE RHYTHM CHARGER 12 MIC CABLE 8890;ELECTRONICA MAYOR
11228081;;M;54;CHILENO;;X;PROVIDENCIA                   ;METROPOLITANA;0;0;0;0;0;0;0;0;0;MINICOMPONENTE RN7;ELECTRONICA MAYOR
9298435;;M;59;CHILENO;;Boomers;RENCA                         ;METROPOLITANA;0;0;0;0;0;0;0;0;0;LED KIOTO 32 MI3228 SMART TV;ELECTRONICA MAYOR
13770977;Soltero;M;42;CHILENO;INGENIERO AGRICOLA;Silencioso;PROVIDENCIA                   ;METROPOLITANA;0;0;0;0;0;0;0;0;0;LED 49 49UJ6300 UHD SMART;ELECTRONICA MAYOR
16542373;;M;35;CHILENO;;Millenial;ANTOFAGASTA                   ;ANTOFAGASTA;0;0;0;0;0;0;0;0;0;LED 43 MI4328 SMART TV;ELECTRONICA MAYOR
17837760;;M;31;CHILENO;;Millenial;PROVIDENCIA                   ;METROPOLITANA;0;0;0;0;0;0;0;0;0;LED 32 UN32T4300AGXZS HD SMART TV;ELECTRONICA MAYOR
13379471;;M;44;CHILENO;;X;CHILLAN                       ;BIO BIO;0;0;0;0;0;0;0;0;0;LED 55 KD-55X725F SMART TV 4K;ELECTRONICA MAYOR
15131601;;F;40;CHILENO;;X;GRANEROS                      ;L.G.B.OÂ´HIGGINS;0;0;0;0;0;0;0;0;0;LED 32 CS32S1 SMART TV HD NEGRO;ELECTRONICA MAYOR
16032700;;M;37;CHILENO;;Millenial;RENCA                         ;METROPOLITANA;0;0;0;0;0;0;0;0;0;PARLANTE ULTRAFORCE-I;ELECTRONICA MAYOR
17777441;;M;31;CHILENO;;Millenial;N/D;N/D;0;0;0;0;0;0;0;0;0;LED 50 50PUD6513/44 SMART TV UHD 4K;ELECTRONICA MAYOR
9771435;;F;44;CHILENO;;X;PROVIDENCIA                   ;METROPOLITANA;0;0;0;0;0;0;0;0;0;MONITOR 24 24TL520S SMART TV HD;ELECTRONICA MAYOR
16618704;;M;34;CHILENO;;Millenial;CARTAGENA                     ;VALPARAISO;0;0;0;0;0;0;0;0;0;MINICOMPONENTE MX-T50/ZS ALL IN ONE;ELECTRONICA MAYOR
17494763;;M;32;CHILENO;;Millenial;PROVIDENCIA                   ;METROPOLITANA;0;0;0;0;0;0;0;0;0;LED 43 43LM6300PSB SMART TV HD;ELECTRONICA MAYOR
26616112;;M;35;VENEZOLANO;;Extranjero;"";"";0;0;0;0;0;0;0;0;0;LED KIOTO 32 MI3228 SMART TV;ELECTRONICA MAYOR
8136350;;F;63;CHILENO;;Boomers;RENCA                         ;METROPOLITANA;0;0;0;0;0;0;0;0;0;KARAOKE RHYTHM CHARGER 12 MIC CABLE 8890;ELECTRONICA MAYOR
10307668;;F;57;CHILENO;;Boomers;PROVIDENCIA                   ;METROPOLITANA;0;0;0;0;0;0;0;0;0;LED 50 UN50TU7090GXZS UHD SMART TV;ELECTRONICA MAYOR
18392246;;F;29;CHILENO;;Millenial;PROVIDENCIA                   ;METROPOLITANA;0;0;0;0;0;0;0;0;0;LED 40 40S65A-40P ANDROID TV SMART LINE FHD;ELECTRONICA MAYOR
15136553;;F;39;CHILENO;;X;TALCA                         ;MAULE;0;0;0;0;0;0;0;0;0;LED 49 49LJ5100 FHD;ELECTRONICA MAYOR
23479194;;M;39;PERUANO;;Extranjero;"";"";0;0;0;0;0;0;0;0;0;LED 55 55UN7100 UHD SMART TV;ELECTRONICA MAYOR
17554103;;F;30;CHILENO;;Millenial;PROVIDENCIA                   ;METROPOLITANA;0;0;0;0;0;0;0;0;0;PARLANTE ULTRAMAGIC;ELECTRONICA MAYOR
14687594;;F;49;PERUANO;;Extranjero;LA SERENA                     ;COQUIMBO;0;0;0;0;0;0;0;0;0;LED 43 43S5295 SMART TV FHD;ELECTRONICA MAYOR
13869093;;M;42;CHILENO;;X;RENCA                         ;METROPOLITANA;0;0;0;0;0;0;0;0;0;LED 55 UN55NU7095GXZS SMART TV TV 4K;ELECTRONICA MAYOR
19429545;;F;25;CHILENO;;Z;EL BOSQUE                     ;METROPOLITANA;0;0;0;0;0;0;0;0;0;LED 49 49LJ5100 FHD;ELECTRONICA MAYOR
16014566;;F;37;CHILENO;;Millenial;RANCAGUA                      ;L.G.B.OÂ´HIGGINS;0;0;0;0;0;0;0;0;0;LED 32 32PHD5813 SMART TV HD;ELECTRONICA MAYOR
15213673;;M;39;CHILENO;;X;N/D;N/D;0;0;0;0;0;0;0;0;0;MINICOMPONENTE MX-T50/ZS ALL IN ONE;ELECTRONICA MAYOR
19279543;;M;26;CHILENO;;Z;PROVIDENCIA                   ;METROPOLITANA;0;0;0;0;0;0;0;0;0;LED 43 UN43J5202AGXZS SMART TV FHD;ELECTRONICA MAYOR
16402050;;F;36;CHILENO;;Millenial;CATEMU                        ;VALPARAISO;0;0;0;0;0;0;0;0;0;PARLANTE ULTRAMAGIC;ELECTRONICA MAYOR
16756274;;F;34;CHILENO;;Millenial;HIJUELAS                      ;VALPARAISO;0;0;0;0;0;0;0;0;0;LED 43 43S5295 SMART TV FHD;ELECTRONICA MAYOR
10910252;;M;46;CHILENO;;X;COIHAIQUE                     ;AYSEN;0;0;0;0;0;0;0;0;0;LED 82 UN82RU8000GXZS SMART TV UHD;ELECTRONICA MAYOR
13571126;;F;42;CHILENO;;X;SANTA CRUZ                    ;L.G.B.OÂ´HIGGINS;0;0;0;0;0;0;0;0;0;LED 43 UN43J5202AGXZS SMART TV FHD;ELECTRONICA MAYOR
10810207;;M;54;CHILENO;;Boomers;RENCA                         ;METROPOLITANA;0;0;0;0;0;0;0;0;0;LED 32 32PHD5813 SMART TV HD;ELECTRONICA MAYOR
8473360;;F;65;CHILENO;;Boomers;SAN PEDRO DE LA PAZ           ;BIO BIO;0;0;0;0;0;0;0;0;0;PARLANTE ULTRAFORCE-I;ELECTRONICA MAYOR
14367530;;M;48;CHILENO;;X;N/D;N/D;0;0;0;0;0;0;0;0;0;LED 65 65UN7300 UHD SMART TV;ELECTRONICA MAYOR
16523589;;F;34;CHILENO;;Millenial;LIMACHE                       ;VALPARAISO;0;0;0;0;0;0;0;0;0;LED 55 UN55NU7095GXZS SMART TV TV 4K;ELECTRONICA MAYOR
26067984;;F;26;VENEZOLANO;;Extranjero;N/D;N/D;0;0;0;0;0;0;0;0;0;LED 65 UN65TU6900GXZS UHD SMART TV;ELECTRONICA MAYOR
6890328;;M;65;CHILENO;;Boomers;RANCAGUA                      ;L.G.B.OÂ´HIGGINS;0;0;0;0;0;0;0;0;0;LED 49 49UN7100 UHD SMART TV;ELECTRONICA MAYOR
8150689;Casado;F;65;CHILENO;PROFESOR;Boomers;RENCA                         ;METROPOLITANA;0;0;0;0;0;0;0;0;0;LED 32 32PHD5813 SMART TV HD;ELECTRONICA MAYOR
6485427;;M;69;CHILENO;;Silencioso;RETIRO                        ;MAULE;0;0;0;0;0;0;0;0;0;KARAOKE RHYTHM CHARGER 12 MIC CABLE 8890;ELECTRONICA MAYOR
8839544;;M;62;CHILENO;;Boomers;RENCA                         ;METROPOLITANA;0;0;0;0;0;0;0;0;0;LED 43 UN43J5202AGXZS SMART TV FHD;ELECTRONICA MAYOR
11201871;Soltero;F;55;CHILENO;;Boomers;RENCA                         ;METROPOLITANA;0;0;0;0;0;0;0;0;0;LED 43 UN43J5202AGXZS SMART TV FHD;ELECTRONICA MAYOR
11317617;Soltero;M;54;CHILENO;;X;RENCA                         ;METROPOLITANA;0;0;0;0;0;0;0;0;0;PARLANTE ULTRAMEGA;ELECTRONICA MAYOR
14488249;;M;47;CHILENO;;X;PROVIDENCIA                   ;METROPOLITANA;0;0;0;0;0;0;0;0;0;KARAOKE SP-101BT ALL IN ONE PORTATIL 60W;ELECTRONICA MAYOR
11315269;;M;54;CHILENO;;X;LAS CONDES                    ;METROPOLITANA;0;0;0;0;0;0;0;0;0;LED 55 55NANO79 NanoCell UHD SMART TV;ELECTRONICA MAYOR
10343458;;M;57;CHILENO;;Boomers;TALAGANTE                     ;METROPOLITANA;0;0;0;0;0;0;0;0;0;LED 32 32LM630BPSB SMART TV;ELECTRONICA MAYOR
10896522;;M;56;CHILENO;;Boomers;LINARES                       ;MAULE;0;0;0;0;0;0;0;0;0;LED 43 43PFD5813 SMART TV FULL HD;ELECTRONICA MAYOR
8827953;;F;63;CHILENO;;Boomers;QUILICURA                     ;METROPOLITANA;0;0;0;0;0;0;0;0;0;LED 32 32S5295 SMART TV HD;ELECTRONICA MAYOR
10577671;;M;51;CHILENO;;X;PROVIDENCIA                   ;METROPOLITANA;0;0;0;0;0;0;0;0;0;LED 50 50U6295 SMART TV UHD;ELECTRONICA MAYOR
16392598;;M;39;CHILENO;;X;PROVIDENCIA                   ;METROPOLITANA;0;0;0;0;0;0;0;0;0;LED 32 32LM630BPSB SMART TV;ELECTRONICA MAYOR
18574163;;F;28;CHILENO;;Millenial;CONSTITUCION                  ;MAULE;0;0;0;0;0;0;0;0;0;LED 49 49UN7100 UHD SMART TV;ELECTRONICA MAYOR
13638916;;F;42;CHILENO;;X;RENCA                         ;METROPOLITANA;0;0;0;0;0;0;0;0;0;LED 32 32LM630BPSB SMART TV;ELECTRONICA MAYOR
14408804;;M;48;CHILENO;;X;PANQUEHUE                     ;VALPARAISO;0;0;0;0;0;0;0;0;0;LED 43 43S5295 SMART TV FHD;ELECTRONICA MAYOR
9185800;;M;60;CHILENO;;Boomers;VALPARAISO                    ;VALPARAISO;0;0;0;0;0;0;0;0;0;LED 50 50PUD6513/44 SMART TV UHD 4K;ELECTRONICA MAYOR
14458076;;F;51;CHILENO;;X;SAN ANTONIO                   ;VALPARAISO;0;0;0;0;0;0;0;0;0;KARAOKE RHYTHM CHARGER 12 MIC CABLE 8890;ELECTRONICA MAYOR
16505822;;M;35;CHILENO;;Millenial;CONSTITUCION                  ;MAULE;0;0;0;0;0;0;0;0;0;LED 43 UN43J5202AGXZS SMART TV FHD;ELECTRONICA MAYOR
15773376;Soltero;M;38;CHILENO;;X;RENCA                         ;METROPOLITANA;0;0;0;0;0;0;0;0;0;MLAB KARAOKE 8 CITY SET MICROFONO INALAMBRICO AT;ELECTRONICA MAYOR
26512608;;F;29;VENEZOLANO;;Extranjero;INDEPENDENCIA                 ;METROPOLITANA;0;0;0;0;0;0;0;0;0;LED 50 UN50TU7090GXZS UHD SMART TV;ELECTRONICA MAYOR
11470917;;M;53;CHILENO;;X;SANTIAGO                      ;METROPOLITANA;0;0;0;0;0;0;0;0;0;LED 50 UN50TU7090GXZS UHD SMART TV;ELECTRONICA MAYOR
11385653;;F;53;CHILENO;;X;RENCA                         ;METROPOLITANA;0;0;0;0;0;0;0;0;0;MINICOMPONENTE MX-T50/ZS ALL IN ONE;ELECTRONICA MAYOR
26907596;;F;49;VENEZOLANO;;Extranjero;PUDAHUEL                      ;METROPOLITANA;0;0;0;0;0;0;0;0;0;LED 32 CS32S1 SMART TV HD NEGRO;ELECTRONICA MAYOR
11804999;;F;50;CHILENO;;X;PANGUIPULLI                   ;LOS LAGOS;0;0;0;0;0;0;0;0;0;MINICOMPONENTE CJ45;ELECTRONICA MAYOR
12659834;;F;48;CHILENO;;Silencioso;PROVIDENCIA                   ;METROPOLITANA;0;0;0;0;0;0;0;0;0;MLAB KARAOKE 8 CITY SET MICROFONO INALAMBRICO AT;ELECTRONICA MAYOR
16173311;;F;36;CHILENO;;Millenial;EL TABO;VALPARAISO;0;0;0;0;0;0;0;0;0;LED 50 UN50TU7090GXZS UHD SMART TV;ELECTRONICA MAYOR
15649074;Casado;F;39;CHILENO;;X;PROVIDENCIA                   ;METROPOLITANA;0;0;0;0;0;0;0;0;0;LED 55 SSM55291 SMART TV 4K;ELECTRONICA MAYOR
10267605;;M;57;CHILENO;;Extranjero;LIMACHE                       ;VALPARAISO;0;0;0;0;0;0;0;0;0;LED 58 58PUD6513/44 SMART TV UHD;ELECTRONICA MAYOR
7964901;;M;63;CHILENO;;Boomers;ANGOL                         ;ARAUCANIA;0;0;0;0;0;0;0;0;0;LED 43 MI4328 SMART TV;ELECTRONICA MAYOR
15742638;;F;38;CHILENO;;Millenial;PROVIDENCIA                   ;METROPOLITANA;0;0;0;0;0;0;0;0;0;LED KIOTO 32 MI3228 SMART TV;ELECTRONICA MAYOR
11308931;;M;54;CHILENO;;X;CASTRO                        ;LOS LAGOS;0;0;0;0;0;0;0;0;0;LED 32 32S5295 SMART TV HD;ELECTRONICA MAYOR
18033456;;F;30;CHILENO;;Millenial;VALPARAISO                    ;VALPARAISO;0;0;0;0;0;0;0;0;0;MINICOMPONENTE MHC-V02 ALL IN ONE;ELECTRONICA MAYOR
13622840;Casado;M;45;CHILENO;MANTENIMIENTO INDUSTRIAL;X;PROVIDENCIA                   ;METROPOLITANA;0;0;0;0;0;0;0;0;0;SOUNDBAR HW-Q60T/ZS;ELECTRONICA MAYOR
14236137;;F;50;CHILENO;;X;SAN CARLOS                    ;BIO BIO;0;0;0;0;0;0;0;0;0;LED 43 MI4328 SMART TV;ELECTRONICA MAYOR
18471471;;F;29;CHILENO;;Millenial;PROVIDENCIA                   ;METROPOLITANA;0;0;0;0;0;0;0;0;0;LED 32 UN32T4300AGXZS HD SMART TV;ELECTRONICA MAYOR
17620462;;M;31;CHILENO;;Millenial;PROVIDENCIA                   ;METROPOLITANA;0;0;0;0;0;0;0;0;0;LED 32 UN32T4300AGXZS HD SMART TV;ELECTRONICA MAYOR
12848707;;F;47;CHILENO;;X;PROVIDENCIA                   ;METROPOLITANA;0;0;0;0;0;0;0;0;0;LED 32 CS32S1 SMART TV HD NEGRO;ELECTRONICA MAYOR
18202469;;F;30;CHILENO;;Millenial;CAUQUENES                     ;MAULE;0;0;0;0;0;0;0;0;0;MINICOMPONENTE MHC-V02 ALL IN ONE;ELECTRONICA MAYOR
26067276;;M;30;VENEZOLANO;;Extranjero;N/D;N/D;0;0;0;0;0;0;0;0;0;SOUNDBAR HW-T450/ZS;ELECTRONICA MAYOR
25273845;;M;34;VENEZOLANO;;Extranjero;"";"";0;0;0;0;0;0;0;0;0;LED 43 43S5295 SMART TV FHD;ELECTRONICA MAYOR
26623437;;M;53;VENEZOLANO;;Extranjero;"";"";0;0;0;0;0;0;0;0;0;LED 43 43S6500 SMART TV TV FHD;ELECTRONICA MAYOR
13800136;Soltero;M;41;CHILENO;;X;PROVIDENCIA                   ;METROPOLITANA;0;0;0;0;0;0;0;0;0;LED 50 UN50TU7090GXZS UHD SMART TV;ELECTRONICA MAYOR
11077928;;F;56;CHILENO;;Boomers;PANGUIPULLI                   ;LOS LAGOS;0;0;0;0;0;0;0;0;0;PARLANTE CITY MIC WIRELESS GREEN 8710;ELECTRONICA MAYOR
15032326;Soltero;M;39;CHILENO;INGENIERIA EN PREVENCION DE RIESGOS CALIDAD Y AMBIENTE;X;PROVIDENCIA                   ;METROPOLITANA;0;0;0;0;0;0;0;0;0;LED 32 UN32T4300AGXZS HD SMART TV;ELECTRONICA MAYOR
13372184;;F;52;CHILENO;;X;RANCAGUA                      ;L.G.B.OÂ´HIGGINS;0;0;0;0;0;0;0;0;0;LED 49 49UN7100 UHD SMART TV;ELECTRONICA MAYOR
12415240;;M;48;CHILENO;;X;RENCA                         ;METROPOLITANA;0;0;0;0;0;0;0;0;0;LED 50 50U6295 SMART TV UHD;ELECTRONICA MAYOR
16316090;Soltero;M;36;CHILENO;;Millenial;RENCA                         ;METROPOLITANA;0;0;0;0;0;0;0;0;0;LED 58 58PUD6513/44 SMART TV UHD;ELECTRONICA MAYOR
18939153;;F;27;CHILENO;;Millenial;SAN JOAQUIN                   ;METROPOLITANA;0;0;0;0;0;0;0;0;0;LED 50 MI50291 SMART TV 4K;ELECTRONICA MAYOR
8094409;;F;67;CHILENO;;Boomers;CHILLAN VIEJO                 ;BIO BIO;0;0;0;0;0;0;0;0;0;LED 43 43UN7300 UHD SMART TV 4K;ELECTRONICA MAYOR
18318792;;M;29;CHILENO;;Millenial;COIHAIQUE                     ;AYSEN;0;0;0;0;0;0;0;0;0;KARAOKE BLACK PHANTER II;ELECTRONICA MAYOR
7914706;;M;64;CHILENO;;Boomers;PROVIDENCIA                   ;METROPOLITANA;0;0;0;0;0;0;0;0;0;LED 43 43LM6300PSB SMART TV HD;ELECTRONICA MAYOR
