CUSTOMER_ID;ESTADO_CIVIL;SEXO;EDAD;NACIONALIDAD;PROFESION;GENERACION_CLIENTE;COMUNA_CLIENTE;CIUDAD_CLIENTE;SUMA_INGRESOS_12;CANTIDAD_PRODUCTOS_12;SUMA_BOLETAS_12;CANTIDAD_UNIDADES_ECOMMERCE_12;SUMA_BOLETAS_ECOMMERCE_12;SUMA_INGRESOS_ECOMMERCE_12;CANTIDAD_UNIDADES_TIENDA_12;SUMA_BOLETAS_TIENDA_12;SUMA_INGRESOS_TIENDA_12;ULTIMO_PRODUCTO_COMPRADO;LINEA_ULTIMO_PRODUCTO_COMPRDO
11310062;;F;56;CHILENO;;Boomers;CALBUCO                       ;LOS LAGOS;695950;14;7;0;0;0;14;7;695950;Scooter con Vapor KeyRiders;OUTDOOR
18226499;Soltero;F;29;CHILENO;;Millenial;PROVIDENCIA                   ;METROPOLITANA;14990;1;1;0;0;0;1;1;14990;SPIN BALL;OUTDOOR
19691351;;F;26;CHILENO;;Z;N/D;N/D;104980;2;2;0;0;0;2;2;104980;CAMA ELASTICA (2,44M) CON MALLA GAMEPOWER AZUL;OUTDOOR
19616138;;F;25;CHILENO;;Millenial;"";"";92980;2;2;0;0;0;2;2;92980;Scooter Peluche Flamenco y Luces Led KeyRiders;OUTDOOR
16345626;;M;36;CHILENO;;Millenial;PROVIDENCIA                   ;METROPOLITANA;33970;3;1;3;1;33970;0;0;0;Scooter Peluche Unicornio y Luces Led KeyRiders;OUTDOOR
18850882;;F;27;CHILENO;;Millenial;"";"";102960;4;3;4;3;102960;0;0;0;Scooter Peluche Flamenco y Luces Led KeyRiders;OUTDOOR
19325945;Soltero;M;26;CHILENO;;Z;QUINTA NORMAL;METROPOLITANA;82980;2;1;2;1;82980;0;0;0;MOTO ELECTRICA NARANJA;OUTDOOR
18012609;;M;29;CHILENO;;Millenial;OVALLE;COQUIMBO;120000;2;1;0;0;0;2;1;120000;Mesa De Hockey 122X61X78 Cms;OUTDOOR
14145700;;F;41;CHILENO;;X;PROVIDENCIA                   ;METROPOLITANA;137980;2;1;2;1;137980;0;0;0;Auto Electrico 4x4 Descapotable Verde Militar;OUTDOOR
14337519;;M;44;CHILENO;;X;MALLOA                        ;L.G.B.OÂ´HIGGINS;121530;3;2;3;2;121530;0;0;0;Juego de Mesa Camcorro 10 en 1;OUTDOOR
6539082;;F;72;CHILENO;;Silencioso;VILLA ALEMANA                 ;VALPARAISO;72990;1;1;0;0;0;1;1;72990;MOTO ELECTRICA CELESTE;OUTDOOR
13394596;;M;44;CHILENO;;X;ERCILLA                       ;ARAUCANIA;25990;1;1;0;0;0;1;1;25990;Scooter con Burbujas KeyRiders;OUTDOOR
8464906;;F;56;CHILENO;;Boomers;"";"";189950;5;3;0;0;0;5;3;189950;Juego de Mesa Camcorro 10 en 1;OUTDOOR
19543887;;F;26;CHILENO;;Millenial;"";"";67970;3;2;0;0;0;3;2;67970;Scooter Lanza Agua hasta 5 mts KeyRiders;OUTDOOR
20028239;;F;23;CHILENO;;Z;PROVIDENCIA                   ;METROPOLITANA;15980;2;1;2;1;15980;0;0;0;Set De Ollas - Sarten Outback;OUTDOOR
16581375;;F;34;CHILENO;;Millenial;RENCA                         ;METROPOLITANA;111980;2;1;2;1;111980;0;0;0;GO-KART PEDALES NEGRO;OUTDOOR
13593116;;M;43;CHILENO;;X;ANCUD                         ;LOS LAGOS;350960;4;2;0;0;0;4;2;350960;CAMA ELASTICA (2,44M) CON MALLA GAMEPOWER AZUL;OUTDOOR
15830614;;F;37;CHILENO;;Millenial;PROVIDENCIA                   ;METROPOLITANA;62980;2;1;2;1;62980;0;0;0;Mesa AirHockey Carromco;OUTDOOR
17208506;Soltero;M;33;CHILENO;CONSTRUCTOR CIVIL;Millenial;PROVIDENCIA                   ;METROPOLITANA;17680;2;1;2;1;17680;0;0;0;V-QUITASOL BLANCO NAT GEO S17;OUTDOOR
10199297;Casado;F;54;CHILENO;;Boomers;PROVIDENCIA                   ;METROPOLITANA;15990;1;1;0;0;0;1;1;15990;COLCHON 2 PZA 203X152X22 CM;OUTDOOR
16112570;Soltero;F;36;CHILENO;PROFESOR;Millenial;PROVIDENCIA                   ;METROPOLITANA;67990;1;1;0;0;0;1;1;67990;GO-KART PEDALES ROJO;OUTDOOR
13448083;;F;44;CHILENO;;X;RENCA                         ;METROPOLITANA;15990;1;3;1;1;15990;0;2;0;COLCHON 2 PZA 203X152X22 CM;OUTDOOR
12749611;;M;46;CHILENO;;X;CONCHALI;METROPOLITANA;156970;3;2;2;1;103980;1;1;52990;CARPA NATIONAL GEOGRAPHIC COVE VI AZUL;OUTDOOR
16467616;;F;35;CHILENO;;Millenial;ARICA                         ;ARICA Y PARINACOTA;121540;2;1;2;1;121540;0;0;0;Auto Electrico 4x4 Descapotable Verde Militar;OUTDOOR
15942770;;M;37;CHILENO;;Millenial;LINARES                       ;MAULE;20990;1;1;0;0;0;1;1;20990;COLCHON 2 PZA 203X152X22 CM;OUTDOOR
12602187;;M;47;CHILENO;;X;PROVIDENCIA                   ;METROPOLITANA;19990;1;1;0;0;0;1;1;19990;COLCHON 2 PZA 203X152X22 CM;OUTDOOR
15901712;;F;37;CHILENO;;Millenial;N/D;N/D;39990;2;1;2;1;39990;0;0;0;CARPA INSTANT SUN TRAIL NATIONAL GEOGRAPHIC 2P;OUTDOOR
11236297;;M;54;CHILENO;;X;RENCA                         ;METROPOLITANA;56980;2;1;2;1;56980;0;0;0;V-CARPA 2 PERSONAS TORONTO NAT GEO S17;OUTDOOR
12376829;;F;49;CHILENO;;X;CHILLAN VIEJO                 ;BIO BIO;19990;1;1;0;0;0;1;1;19990;COLCHON 2 PZA 203X152X22 CM;OUTDOOR
17882596;;F;30;CHILENO;;Millenial;CURICO                        ;MAULE;27470;3;1;3;1;27470;0;0;0;V-PONCHO IMPERMEABLE NATIONAL GEOGRAPHIC VERDE;OUTDOOR
10159620;Casado;M;57;CHILENO;;Boomers;PROVIDENCIA                   ;METROPOLITANA;289980;2;1;2;1;289980;0;0;0;MESA DE POOL GAMEPOWER 03;OUTDOOR
15131781;;F;39;CHILENO;;X;PROVIDENCIA                   ;METROPOLITANA;29990;1;1;0;0;0;1;1;29990;Scooter con Burbujas KeyRiders;OUTDOOR
13020457;;F;46;CHILENO;;X;CALERA                        ;VALPARAISO;544940;6;5;6;5;544940;0;0;0;V-CARPA 4 PERSONAS ASPEN ROJO OUTBACK;OUTDOOR
9464378;;M;58;CHILENO;;Boomers;N/D;N/D;250940;6;4;0;0;0;6;4;250940;MALETA CORREPASILLO MOTO ROSADA;OUTDOOR
9372846;;M;61;CHILENO;;Boomers;ANGOL                         ;ARAUCANIA;21990;1;1;0;0;0;1;1;21990;COLCHON 2 PZA 203X152X22 CM;OUTDOOR
10114431;Casado;M;57;CHILENO;PAISAJISMO;Boomers;RENCA                         ;METROPOLITANA;135840;2;1;2;1;135840;0;0;0;Auto Electrico 4x4 Descapotable Verde Militar;OUTDOOR
11455594;;F;52;CHILENO;;X;TOME                          ;BIO BIO;29990;1;1;0;0;0;1;1;29990;Scooter Lanza Agua hasta 5 mts KeyRiders;OUTDOOR
19434639;;F;25;CHILENO;;Z;N/D;N/D;178660;3;2;0;0;0;3;2;178660;PISCINA CIRCULAR STEEL PRO 6473 L;OUTDOOR
6537386;;M;66;CHILENO;;Boomers;ANGOL                         ;ARAUCANIA;55980;2;1;0;0;0;2;1;55980;Set Aro Basketball Telescopico Dolu hasta 1.70 m;OUTDOOR
10026720;;F;53;CHILENO;;X;SAN PEDRO DE LA PAZ           ;BIO BIO;89990;1;1;0;0;0;1;1;89990;PISCINA STEEL PRO 300X201X66CM;OUTDOOR
16945948;;F;35;CHILENO;;Millenial;"";"";99990;1;1;0;0;0;1;1;99990;PISCINA STEEL PRO 300X201X66CM;OUTDOOR
14151673;;M;41;CHILENO;;X;N/D;N/D;119950;5;1;5;1;119950;0;0;0;V-BOLSO PORTA EQUIPAJE MEDIANO NAT GEO S17;OUTDOOR
17005292;;M;33;CHILENO;;Millenial;N/D;N/D;99990;1;1;0;0;0;1;1;99990;PISCINA STEEL PRO 300X201X66CM;OUTDOOR
17488807;;M;31;CHILENO;;Millenial;N/D;N/D;183950;5;1;0;0;0;5;1;183950;PISCINA STEEL PRO 300X201X66CM;OUTDOOR
19821025;;F;24;CHILENO;;Z;PROVIDENCIA                   ;METROPOLITANA;106980;2;1;2;1;106980;0;0;0;PISCINA STEEL PRO 300X201X66CM;OUTDOOR
18890492;;F;27;CHILENO;;Millenial;N/D;N/D;131970;3;2;0;0;0;3;2;131970;PISCINA STEEL PRO 300X201X66CM;OUTDOOR
12096856;;F;47;CHILENO;;X;"";"";509080;4;2;4;2;509080;0;0;0;PISCINA CIRCULAR STEEL PRO;OUTDOOR
10936439;;F;48;CHILENO;;X;PROVIDENCIA                   ;METROPOLITANA;118540;2;1;2;1;118540;0;0;0;PISCINA CIRCULAR STEEL PRO;OUTDOOR
12791484;;F;47;CHILENO;;X;LINARES                       ;MAULE;125480;2;1;2;1;125480;0;0;0;PISCINA CIRCULAR STEEL PRO 6473 L;OUTDOOR
19620038;;F;24;CHILENO;;Z;QUILPUE                       ;VALPARAISO;109990;1;1;0;0;0;1;1;109990;PISCINA CIRCULAR STEEL PRO;OUTDOOR
15699251;;F;38;CHILENO;;Millenial;PROVIDENCIA                   ;METROPOLITANA;116980;2;1;2;1;116980;0;0;0;PISCINA CIRCULAR STEEL PRO;OUTDOOR
10199984;;M;55;CHILENO;;Boomers;ILLAPEL                       ;COQUIMBO;174980;2;1;0;0;0;2;1;174980;PISCINA CIRCULAR STEEL PRO 6473 L;OUTDOOR
13987303;Soltero;M;40;CHILENO;;X;PROVIDENCIA                   ;METROPOLITANA;19990;1;1;0;0;0;1;1;19990;Scooter Peluche Flamenco y Luces Led KeyRiders;OUTDOOR
8335170;;M;61;CHILENO;;Boomers;N/D;N/D;72960;4;1;0;0;0;4;1;72960;SPIN BALL;OUTDOOR
12768165;;F;50;CHILENO;;X;LAJA                          ;BIO BIO;69990;1;1;0;0;0;1;1;69990;Cuatrimoto Electrica Force Negra/Verde;OUTDOOR
17853184;;F;31;CHILENO;;Millenial;CHIGUAYANTE                   ;BIO BIO;155840;2;1;2;1;155840;0;0;0;PISCINA CIRCULAR STEEL PRO 6473 L;OUTDOOR
19321943;;M;26;CHILENO;;Z;N/D;N/D;54990;1;1;0;0;0;1;1;54990;Scooter Burbujas Barbie;OUTDOOR
14340436;;F;45;CHILENO;;X;PROVIDENCIA                   ;METROPOLITANA;0;0;2;0;0;0;0;2;0;PISCINA STEEL PRO C/ESCALERA Y COBERTOR;OUTDOOR
19169909;Soltero;F;27;CHILENO;;Z;PROVIDENCIA                   ;METROPOLITANA;79980;2;1;2;1;79980;0;0;0;TACA TACA MADERA EVER GROUP;OUTDOOR
16261095;;F;36;CHILENO;;Millenial;LA CISTERNA                   ;METROPOLITANA;129990;1;1;0;0;0;1;1;129990;MESA DE PING PONG GAMEPOWER AZUL;OUTDOOR
13533025;;F;42;CHILENO;;X;N/D;N/D;99990;1;1;0;0;0;1;1;99990;PISCINA STEEL PRO 300X201X66CM;OUTDOOR
19988556;;F;23;CHILENO;;Z;N/D;N/D;138980;2;1;0;0;0;2;1;138980;PISCINA CIRCULAR STEEL PRO 6473 L;OUTDOOR
16799708;;M;34;CHILENO;;Millenial;RECOLETA;METROPOLITANA;123980;2;1;2;1;123980;0;0;0;PISCINA CIRCULAR STEEL PRO 6473 L;OUTDOOR
26481324;;F;26;VENEZOLANO;;Extranjero;PUERTO MONTT                  ;LOS LAGOS;64980;2;1;2;1;64980;0;0;0;Cuatrimoto Electrica Force Rosada;OUTDOOR
18126638;;M;30;CHILENO;;Millenial;"";"";23980;2;1;2;1;23980;0;0;0;Scooter Peluche Dotty Dalmata y Luces Led Keyrid;OUTDOOR
12349700;;M;49;CHILENO;;X;NUEVA IMPERIAL                ;ARAUCANIA;264939;6;5;2;2;49980;4;3;214959;V-PISCINA ESTRUCTURAL BESTWAY STEEL PRO 3.05M X;OUTDOOR
17199386;Soltero;F;33;CHILENO;FONOAUDIOLOGA;Millenial;CORONEL                       ;BIO BIO;76980;2;1;2;1;76980;0;0;0;PISCINA RECTANGULAR 150CM BESTWAY AZUL;OUTDOOR
10656559;;F;54;CHILENO;;Boomers;CHIGUAYANTE                   ;BIO BIO;99990;1;1;0;0;0;1;1;99990;PISCINA CIRCULAR STEEL PRO;OUTDOOR
6582579;;M;67;CHILENO;;Boomers;ALTO HOSPICIO;TARAPACA;89990;1;1;0;0;0;1;1;89990;AUTO ELECTRICO DESCAPOTABLE BLANCO COUP;OUTDOOR
19784506;;M;24;CHILENO;;Z;N/D;N/D;99990;1;1;0;0;0;1;1;99990;PISCINA STEEL PRO 300X201X66CM;OUTDOOR
9485331;;M;58;CHILENO;;Boomers;EL BOSQUE                     ;METROPOLITANA;174980;2;1;0;0;0;2;1;174980;V-PISCINA ESTRUCTURAL BESTWAY STEEL PRO 3.05M X;OUTDOOR
20263172;;F;22;CHILENO;;Z;PROVIDENCIA                   ;METROPOLITANA;99990;1;1;0;0;0;1;1;99990;PISCINA STEEL PRO 300X201X66CM;OUTDOOR
14347552;;F;43;CHILENO;;X;RENCA                         ;METROPOLITANA;24990;1;1;0;0;0;1;1;24990;Set Aro Basketball Telescopico Dolu hasta 1.70 m;OUTDOOR
17111062;;F;33;CHILENO;;Millenial;TEMUCO                        ;ARAUCANIA;19990;1;1;0;0;0;1;1;19990;Scooter Peluche Flamenco y Luces Led KeyRiders;OUTDOOR
6335336;Casado;M;72;CHILENO;;Silencioso;RENCA                         ;METROPOLITANA;254460;4;3;0;0;0;4;3;254460;GO-KART PEDALES ROJO;OUTDOOR
18505742;;F;28;CHILENO;;Millenial;PROVIDENCIA                   ;METROPOLITANA;99990;1;1;0;0;0;1;1;99990;PISCINA STEEL PRO 300X201X66CM;OUTDOOR
14224423;;M;41;CHILENO;;X;PANGUIPULLI                   ;LOS RIOS;262980;2;1;0;0;0;2;1;262980;SCOOTER ELECTRICO ASD BLANCO;OUTDOOR
15970134;Soltero;F;37;CHILENO;ASISTENTE SOCIAL;Millenial;PROVIDENCIA                   ;METROPOLITANA;23980;2;1;2;1;23980;0;0;0;Scooter Peluche Dinosaurio y Luces Led KeyRiders;OUTDOOR
9931989;;M;56;CHILENO;;Boomers;PROVIDENCIA                   ;METROPOLITANA;95840;2;1;2;1;95840;0;0;0;V-CARPA 6 PERSONAS TORONTO NAT GEO S17;OUTDOOR
13278879;;F;44;CHILENO;;Silencioso;PROVIDENCIA                   ;METROPOLITANA;99990;1;1;0;0;0;1;1;99990;V-PISCINA ESTRUCTURAL BESTWAY STEEL PRO 3.05M X;OUTDOOR
16670419;;M;34;CHILENO;;Millenial;ISLA DE MAIPO                 ;METROPOLITANA;619980;2;2;0;0;0;2;2;619980;PISCINA STEEL PRO 300X201X66CM;OUTDOOR
16589202;;F;35;CHILENO;;Millenial;PLACILLA                      ;L.G.B.OÂ´HIGGINS;172980;2;1;0;0;0;2;1;172980;PISCINA CIRCULAR STEEL PRO 6473 L;OUTDOOR
15415562;;M;40;CHILENO;;X;PROVIDENCIA                   ;METROPOLITANA;37970;3;1;3;1;37970;0;0;0;Scooter Peluche Unicornio y Luces Led KeyRiders;OUTDOOR
15736572;;F;40;CHILENO;;X;PROVIDENCIA                   ;METROPOLITANA;209980;2;2;0;0;0;2;2;209980;PISCINA CIRCULAR STEEL PRO;OUTDOOR
14314417;;F;45;CHILENO;;X;OVALLE                        ;COQUIMBO;119990;1;1;0;0;0;1;1;119990;PISCINA CIRCULAR STEEL PRO 6473 L;OUTDOOR
17263728;Soltero;F;32;CHILENO;;Millenial;TEMUCO                        ;ARAUCANIA;349990;1;1;1;1;349990;0;0;0;PISCINA STEEL PRO C/ESCALERA Y COBERTOR;OUTDOOR
19457254;;F;35;CHILENO;;Millenial;VICTORIA                      ;ARAUCANIA;99990;1;1;0;0;0;1;1;99990;PISCINA STEEL PRO 300X201X66CM;OUTDOOR
25872963;;M;32;CHILENO;;Extranjero;SANTIAGO                      ;METROPOLITANA;19990;1;1;0;0;0;1;1;19990;COLCHON 2 PZA 203X152X22 CM;OUTDOOR
16441421;;M;36;CHILENO;;Millenial;PROVIDENCIA                   ;METROPOLITANA;84980;2;1;2;1;84980;0;0;0;Mesa AirHockey Carromco;OUTDOOR
6301155;;M;73;CHILENO;;Silencioso;PUTAENDO                      ;VALPARAISO;119990;1;1;0;0;0;1;1;119990;PISCINA CIRCULAR STEEL PRO;OUTDOOR
8700498;Casado;M;61;CHILENO;;Boomers;RENCA                         ;METROPOLITANA;133970;3;1;3;1;133970;0;0;0;V-ARCO DE FUTBOL 300X205X120 GAME POWER;OUTDOOR
16536267;;F;34;CHILENO;;Millenial;PROVIDENCIA                   ;METROPOLITANA;15840;2;1;2;1;15840;0;0;0;Correpasillos Unicornio Rosado;OUTDOOR
15352528;Casado;M;39;CHILENO;;X;PROVIDENCIA                   ;METROPOLITANA;103980;2;1;2;1;103980;0;0;0;V-PISCINA ESTRUCTURAL BESTWAY STEEL PRO 3.05M X;OUTDOOR
13936139;Soltero;F;44;CHILENO;;X;EL BOSQUE                     ;METROPOLITANA;109980;2;1;0;0;0;2;1;109980;SCOOTER ELECTRICO CERO EKIDS NEGRO;OUTDOOR
11975912;;F;50;CHILENO;;X;PUNTA ARENAS                  ;MAGALLANES;69990;1;1;0;0;0;1;1;69990;TACA TACA MADERA EVER GROUP;OUTDOOR
16664571;;F;35;CHILENO;;Millenial;SAN BERNARDO                  ;METROPOLITANA;48970;3;2;2;1;23980;1;1;24990;Scooter Peluche Dotty Dalmata y Luces Led Keyrid;OUTDOOR
12547590;;F;47;CHILENO;;X;N/D;N/D;310810;5;3;5;3;310810;0;0;0;PISCINA CIRCULAR STEEL PRO;OUTDOOR
17782857;Casado;F;31;CHILENO;;Millenial;PROVIDENCIA                   ;METROPOLITANA;263980;2;1;2;1;263980;0;0;0;PISCINA STEEL PRO MAXÂ¿ 56709 BESTWAY DISENO RATT;OUTDOOR
18945356;;M;26;CHILENO;;Z;N/D;N/D;149980;2;1;0;0;0;2;1;149980;V-CARPA 3 PER. NEW CALGARY S17;OUTDOOR
19729439;;F;25;CHILENO;;Z;RETIRO                        ;MAULE;377960;4;3;0;0;0;4;3;377960;Mochila National Geographic Redwood 65lt;OUTDOOR
15515951;Soltero;M;39;CHILENO;;X;COIHAIQUE                     ;AYSEN;465640;5;2;0;0;0;5;2;465640;Cuatrimoto Electrica Force Negra/Verde;OUTDOOR
17682693;;F;31;CHILENO;;Millenial;PROVIDENCIA                   ;METROPOLITANA;263980;2;1;2;1;263980;0;0;0;PISCINA STEEL PRO MAXÂ¿ 56709 BESTWAY DISENO RATT;OUTDOOR
16794578;Soltero;M;34;CHILENO;PROFESOR;Millenial;PROVIDENCIA                   ;METROPOLITANA;30980;2;1;2;1;30980;0;0;0;V-CARPA 2 PERSONAS OTTAWA NAT GEO S17;OUTDOOR
23882098;;M;35;PERUANO;;Extranjero;"";"";69980;2;1;2;1;69980;0;0;0;TACA TACA MADERA EVER GROUP;OUTDOOR
15335208;;F;40;CHILENO;;X;N/D;N/D;38960;4;2;0;0;0;4;2;38960;Silla Plegable Outback Con Apoyo De Brazos Gris;OUTDOOR
15482512;;F;40;CHILENO;;X;N/D;N/D;63980;2;1;2;1;63980;0;0;0;PISCINA RECTANGULAR 150CM BESTWAY AZUL;OUTDOOR
17307475;Soltero;F;32;CHILENO;;Millenial;PROVIDENCIA                   ;METROPOLITANA;13980;2;1;2;1;13980;0;0;0;Correpasillos Rojo;OUTDOOR
15210965;;F;39;CHILENO;;X;PROVIDENCIA                   ;METROPOLITANA;0;0;0;0;0;0;0;0;0;COLCHON 2 PZA 203X152X22 CM;OUTDOOR
13350887;;M;44;CHILENO;;X;CURICO;MAULE;0;0;0;0;0;0;0;0;0;CERCA DE COLORES;OUTDOOR
18885187;;F;31;CHILENO;;Millenial;ZAPALLAR                      ;VALPARAISO;0;0;0;0;0;0;0;0;0;Cuatrimoto Electrica Force Rosada;OUTDOOR
13079763;;F;45;CHILENO;;X;"";"";0;0;0;0;0;0;0;0;0;Triciclo 360 Desmontable Bebesit;OUTDOOR
13869527;;F;42;CHILENO;;X;LA SERENA                     ;COQUIMBO;0;0;0;0;0;0;0;0;0;Triciclo 360 Desmontable Bebesit;OUTDOOR
16532663;;F;35;CHILENO;;Millenial;PROVIDENCIA                   ;METROPOLITANA;0;0;0;0;0;0;0;0;0;Cuatrimoto Electrica Force Negra/Verde;OUTDOOR
11484835;;M;52;CHILENO;;X;N/D;N/D;0;0;0;0;0;0;0;0;0;SCOOTER FISHER PRICE C/LUZ Y SONIDO;OUTDOOR
10530546;;M;52;CHILENO;;X;LA PINTANA                    ;METROPOLITANA;0;0;0;0;0;0;0;0;0;SCOOTER ELECTRICO CERO EKIDS NEGRO;OUTDOOR
20310871;;F;22;CHILENO;;Z;PROVIDENCIA                   ;METROPOLITANA;0;0;0;0;0;0;0;0;0;Cuatrimoto Electrica Force Rosada;OUTDOOR
16333274;;F;36;CHILENO;;Extranjero;SAN FELIPE                    ;VALPARAISO;0;0;0;0;0;0;0;0;0;CENTRO JUEGOS 3EN1 RESBALIN+COLUMPIO+AROBASQ;OUTDOOR
19462859;;M;25;CHILENO;;Z;PROVIDENCIA                   ;METROPOLITANA;0;0;0;0;0;0;0;0;0;COLCHON 2 PZA 203X152X22 CM;OUTDOOR
17965446;Soltero;F;30;CHILENO;;Millenial;PROVIDENCIA                   ;METROPOLITANA;0;0;0;0;0;0;0;0;0;CENTRO JUEGOS 3EN1 RESBALIN+COLUMPIO+AROBASQ;OUTDOOR
13381597;;F;43;CHILENO;;X;PROVIDENCIA                   ;METROPOLITANA;0;0;0;0;0;0;0;0;0;COLCHON 2 PZA 203X152X22 CM;OUTDOOR
18943515;Soltero;M;27;CHILENO;;Millenial;PROVIDENCIA                   ;METROPOLITANA;0;0;0;0;0;0;0;0;0;V-CARPA 2 PERSONAS MONTANA VERDE OUTBACK;OUTDOOR
6026240;;F;68;CHILENO;;Silencioso;PROVIDENCIA                   ;METROPOLITANA;0;0;0;0;0;0;0;0;0;Portarrollos Rimax Triple Blanco;OUTDOOR
15398443;;F;40;CHILENO;;X;LA FLORIDA                    ;METROPOLITANA;0;0;0;0;0;0;0;0;0;Silla Plegable Outback Con Apoyo De Brazos Azul;OUTDOOR
15912968;Soltero;F;37;CHILENO;SECRETARIA;Millenial;PROVIDENCIA                   ;METROPOLITANA;0;0;0;0;0;0;0;0;0;V-BODEGA NORTHWEST 189L COLOR GRIS;OUTDOOR
16827076;;F;34;CHILENO;;Millenial;PROVIDENCIA                   ;METROPOLITANA;0;0;0;0;0;0;0;0;0;Silla Plegable Outback Con Apoyo De Brazos Gris;OUTDOOR
16231720;;M;36;CHILENO;;Millenial;PROVIDENCIA                   ;METROPOLITANA;0;0;0;0;0;0;0;0;0;SCOOTER ELECTRICO ASD NEGRO;OUTDOOR
13909570;;F;42;CHILENO;;X;RECOLETA                      ;METROPOLITANA;0;0;0;0;0;0;0;0;0;SCOOTER ELECTRICO CERO EKIDS NEGRO;OUTDOOR
10962644;;M;51;CHILENO;;X;RENCA                         ;METROPOLITANA;0;0;0;0;0;0;0;0;0;PISCINA RECTANGULAR 150CM BESTWAY AZUL;OUTDOOR
15508250;;M;35;CHILENO;;Millenial;PROVIDENCIA                   ;METROPOLITANA;0;0;0;0;0;0;0;0;0;COLCHON 2 PZA 203X152X22 CM;OUTDOOR
19296194;;M;25;CHILENO;;Z;ILLAPEL                       ;COQUIMBO;0;0;0;0;0;0;0;0;0;COLCHON 2 PZA 203X152X22 CM;OUTDOOR
19758265;;F;24;CHILENO;;Z;PROVIDENCIA                   ;METROPOLITANA;0;0;0;0;0;0;0;0;0;COLCHON 2 PZA 203X152X22 CM;OUTDOOR
17794757;;F;31;CHILENO;;Millenial;CURICO                        ;MAULE;0;0;0;0;0;0;0;0;0;AUTO ELECTRICO DESCAPOTABLE BLANCO COUP;OUTDOOR
13021531;;M;45;CHILENO;;X;RENCA                         ;METROPOLITANA;0;0;0;0;0;0;0;0;0;PISCINA CIRCULAR STEEL PRO;OUTDOOR
17710545;Casado;M;30;CHILENO;INGENIERO EN PREVENCION DE RIESGOS;Millenial;PROVIDENCIA                   ;METROPOLITANA;0;0;0;0;0;0;0;0;0;CAMA ELASTICA (1,83M) CON MALLA GAMEPOWER AZUL;OUTDOOR
26795427;;F;27;COLOMBIANO;;Extranjero;N/D;N/D;0;0;0;0;0;0;0;0;0;CAMA ELASTICA (1,83M) CON MALLA GAMEPOWER AZUL;OUTDOOR
14526197;;F;46;CHILENO;;X;CASTRO                        ;LOS LAGOS;0;0;0;0;0;0;0;0;0;CAMA ELASTICA (1,83M) CON MALLA GAMEPOWER AZUL;OUTDOOR
6944781;;F;72;CHILENO;;Silencioso;PENALOLEN                     ;METROPOLITANA;0;0;0;0;0;0;0;0;0;PISCINA RECTANGULAR 150CM BESTWAY AZUL;OUTDOOR
18348363;;F;29;CHILENO;;Millenial;N/D;N/D;0;0;0;0;0;0;0;0;0;CAMIONETA ELECTRICA NINO 905 ZHE;OUTDOOR
16857151;;M;33;CHILENO;;Millenial;SANTIAGO                      ;METROPOLITANA;0;0;0;0;0;0;0;0;0;CAMA ELASTICA (2,44M) CON MALLA GAMEPOWER AZUL;OUTDOOR
15291166;;F;37;CHILENO;;Millenial;PUQUELDON                     ;LOS LAGOS;0;0;0;0;0;0;0;0;0;GO-KART PEDALES ROJO;OUTDOOR
17414791;;F;32;CHILENO;;Millenial;RENCA                         ;METROPOLITANA;0;0;0;0;0;0;0;0;0;PISCINA CIRCULAR STEEL PRO;OUTDOOR
17696074;;F;31;CHILENO;;Millenial;SAN CARLOS;BIO-BIO;0;0;0;0;0;0;0;0;0;SCOOTER ELECTRICO ASD NEGRO;OUTDOOR
15854608;;F;38;CHILENO;;Millenial;PROVIDENCIA                   ;METROPOLITANA;0;0;0;0;0;0;0;0;0;V-PISCINA INFLABLE LAGUNA AZUL 262x157x46CM;OUTDOOR
8051615;;F;66;CHILENO;;Boomers;RENCA                         ;METROPOLITANA;0;0;0;0;0;0;0;0;0;PISCINA STEEL PRO 300X201X66CM;OUTDOOR
25686342;;M;28;VENEZOLANO;;Extranjero;N/D;N/D;0;0;0;0;0;0;0;0;0;JUEGO DARDO C/BLUETOOTH 011 CAR;OUTDOOR
13436499;;F;44;CHILENO;;X;LA PINTANA                    ;METROPOLITANA;0;0;0;0;0;0;0;0;0;PISCINA RECTANGULAR 211CM BESTWAY AZUL;OUTDOOR
13987078;;M;40;CHILENO;;X;PROVIDENCIA                   ;METROPOLITANA;0;0;0;0;0;0;0;0;0;PISCINA STEEL PRO 300X201X66CM;OUTDOOR
18305536;;F;43;CHILENO;;X;PROVIDENCIA                   ;METROPOLITANA;0;0;0;0;0;0;0;0;0;PATINES EN LINEA T 32-34 ALPACA;OUTDOOR
13047154;;M;46;CHILENO;;X;PROVIDENCIA                   ;METROPOLITANA;0;0;0;0;0;0;0;0;0;CAMA ELASTICA (3,05M) CON MALLA GAMEPOWER AZUL;OUTDOOR
11672233;Casado;M;51;CHILENO;TECNICO MECANICO;X;RENCA                         ;METROPOLITANA;0;0;0;0;0;0;0;0;0;PISCINA STEEL PRO 300X201X66CM;OUTDOOR
13976860;Soltero;M;41;CHILENO;;X;RENCA                         ;METROPOLITANA;0;0;0;0;0;0;0;0;0;PISCINA STEEL PRO C/ESCALERA Y COBERTOR;OUTDOOR
9204992;;F;52;CHILENO;;X;PROVIDENCIA                   ;METROPOLITANA;0;0;0;0;0;0;0;0;0;PISCINA STEEL PRO C/ESCALERA Y COBERTOR;OUTDOOR
16882208;;M;34;CHILENO;;Millenial;PICHIDEGUA                    ;L.G.B.OÂ´HIGGINS;0;0;0;0;0;0;0;0;0;PISCINA STEEL PRO C/ESCALERA Y COBERTOR;OUTDOOR
15343734;;F;40;CHILENO;;X;RENCA                         ;METROPOLITANA;0;0;0;0;0;0;0;0;0;TACA TACA MADERA EVER GROUP;OUTDOOR
26531324;;M;43;VENEZOLANO;;Extranjero;N/D;N/D;0;0;0;0;0;0;0;0;0;JEEP ELECTRICO BLANCO;OUTDOOR
18063857;;F;30;CHILENO;;Millenial;MAIPU                         ;METROPOLITANA;0;0;0;0;0;0;0;0;0;PISCINA CIRCULAR STEEL PRO;OUTDOOR
11483023;;F;53;CHILENO;;X;SAN JAVIER                    ;MAULE;0;0;0;0;0;0;0;0;0;MESA PING PONG;OUTDOOR
11445811;;F;53;CHILENO;;X;PROVIDENCIA                   ;METROPOLITANA;0;0;0;0;0;0;0;0;0;AUTO ELECTRICO ROJO;OUTDOOR
18528124;;M;29;CHILENO;;Millenial;N/D;N/D;0;0;0;0;0;0;0;0;0;CAMA ELASTICA (1,83M) CON MALLA GAMEPOWER AZUL;OUTDOOR
17174941;;F;33;CHILENO;;Millenial;COQUIMBO                      ;COQUIMBO;0;0;0;0;0;0;0;0;0;COHETE C/LANZADOR;OUTDOOR
15454093;;M;40;CHILENO;;X;PROVIDENCIA                   ;METROPOLITANA;0;0;0;0;0;0;0;0;0;PISCINA ESTRUCTURAL STEEL PRO 5700LT;OUTDOOR
5002173;;F;76;CHILENO;;Silencioso;MAIPU                         ;METROPOLITANA;0;0;0;0;0;0;0;0;0;PISCINA RECTANGULAR 211CM BESTWAY AZUL;OUTDOOR
11668255;;F;51;CHILENO;;X;PROVIDENCIA                   ;METROPOLITANA;0;0;0;0;0;0;0;0;0;Piscina Redonda Steel Pro Max Pool Set 3.66x1.00;OUTDOOR
16175772;Soltero;M;36;CHILENO;;Millenial;PROVIDENCIA                   ;METROPOLITANA;0;0;0;0;0;0;0;0;0;PISCINA CIRCULAR STEEL PRO 6473 L;OUTDOOR
12660287;Soltero;M;48;CHILENO;;Silencioso;PROVIDENCIA                   ;METROPOLITANA;0;0;0;0;0;0;0;0;0;CASA DE PIEDRA AZUL;OUTDOOR
10588922;;M;57;CHILENO;;Boomers;VALDIVIA                      ;LOS LAGOS;0;0;0;0;0;0;0;0;0;PISCINA RECTANGULAR 150CM BESTWAY AZUL;OUTDOOR
17689048;Soltero;M;31;CHILENO;;Millenial;PROVIDENCIA                   ;METROPOLITANA;0;0;0;0;0;0;0;0;0;TRCICLO NINO COLOR A PPB TRA;OUTDOOR
13184392;;M;44;CHILENO;;X;SAN FELIPE                    ;VALPARAISO;0;0;0;0;0;0;0;0;0;TACA TACA MADERA EVER GROUP;OUTDOOR
25200437;;F;26;COLOMBIANO;;Extranjero;ANTOFAGASTA;ANTOFAGASTA;0;0;0;0;0;0;0;0;0;PATINES EN LINEA T 28-31 COMIC;OUTDOOR
15843292;;F;37;CHILENO;;Millenial;QUINTA NORMAL                 ;METROPOLITANA;0;0;0;0;0;0;0;0;0;MESA DE AIR HOCKEY 142X62X79CM;OUTDOOR
10331794;Casado;M;40;CHILENO;INGENIERO CIVIL INDUSTRIAL;X;PROVIDENCIA                   ;METROPOLITANA;0;0;0;0;0;0;0;0;0;CHALECO SALVAVIDAS INFLABLE FISHER PRICE;OUTDOOR
13863695;;F;42;CHILENO;;X;"";"";0;0;0;0;0;0;0;0;0;CASA DE PIEDRA MORADO;OUTDOOR
17938470;;M;30;CHILENO;;Millenial;PROVIDENCIA                   ;METROPOLITANA;0;0;0;0;0;0;0;0;0;CARPA DE JUEGO PAVILO;OUTDOOR
6985802;;F;70;CHILENO;;Silencioso;ARICA                         ;ARICA Y PARINACOTA;52990;1;1;0;0;0;1;1;52990;Asistencia Salud Integral Familia;GARANTIAS
6878006;;M;66;CHILENO;;Boomers;N/D;N/D;1097750;9;5;0;0;0;9;5;1097750;Asistencia Salud Integral Familia;GARANTIAS
5125507;;F;77;CHILENO;;Silencioso;LA PINTANA                    ;METROPOLITANA;305970;3;2;0;0;0;3;2;305970;Asistencia Salud Integral Familia;GARANTIAS
6164132;;F;77;CHILENO;;Silencioso;ARICA                         ;ARICA Y PARINACOTA;107650;3;2;0;0;0;3;2;107650;Asistencia Salud Integral Familia;GARANTIAS
8891627;;M;61;CHILENO;;Boomers;ANGOL                         ;ARAUCANIA;52990;1;1;0;0;0;1;1;52990;Asistencia Salud Integral Familia;GARANTIAS
17015727;;F;33;CHILENO;;Millenial;LA SERENA                     ;COQUIMBO;805960;4;3;0;0;0;4;3;805960;Asistencia Salud Integral Familia;GARANTIAS
8821658;;M;59;CHILENO;;Boomers;"";"";108070;2;2;0;0;0;2;2;108070;Asistencia Salud Integral Familia;GARANTIAS
11456057;;M;52;CHILENO;;X;CHIMBARONGO                   ;L.G.B.OÂ´HIGGINS;407660;5;2;0;0;0;5;2;407660;Asistencia Salud Integral Familia;GARANTIAS
10345684;;F;58;CHILENO;;Boomers;COIHAIQUE                     ;AYSEN;92980;2;2;0;0;0;2;2;92980;Asistencia Salud Integral Familia;GARANTIAS
11600922;;F;51;CHILENO;;X;LIMACHE                       ;VALPARAISO;52990;1;1;0;0;0;1;1;52990;Asistencia Salud Integral Familia;GARANTIAS
10821528;;M;56;CHILENO;;Boomers;SANTA CRUZ                    ;L.G.B.OÂ´HIGGINS;52990;1;1;0;0;0;1;1;52990;Asistencia Salud Integral Familia;GARANTIAS
9139505;;F;60;CHILENO;;Boomers;LINARES                       ;MAULE;286951;6;3;0;0;0;6;3;286951;Asistencia Programa Domiciliario;GARANTIAS
26200125;;M;30;VENEZOLANO;;Extranjero;LINARES                       ;MAULE;1871840;16;8;0;0;0;16;8;1871840;Asistencia Salud Integral Familia;GARANTIAS
10802337;;M;56;CHILENO;;Millenial;N/D;N/D;62980;2;2;0;0;0;2;2;62980;Asistencia Salud Integral Familia;GARANTIAS
13046083;;F;45;CHILENO;;X;LA GRANJA;METROPOLITANA;52990;1;1;0;0;0;1;1;52990;Asistencia Programa Domiciliario;GARANTIAS
11430021;;F;52;CHILENO;;X;CORONEL                       ;BIO BIO;391960;3;2;0;0;0;3;2;391960;Asistencia Salud Integral Familia;GARANTIAS
8058013;;F;64;CHILENO;;Boomers;CONCEPCION                    ;BIO BIO;105980;2;1;0;0;0;2;1;105980;Asistencia Salud Integral Familia;GARANTIAS
8506701;;M;63;CHILENO;;Boomers;LAGO RANCO                    ;LOS LAGOS;90980;2;2;0;0;0;2;2;90980;Asistencia Salud Integral Familia;GARANTIAS
10342414;;F;57;CHILENO;;Boomers;MELIPILLA                     ;METROPOLITANA;0;0;2;0;0;0;0;2;0;GM 1A X CTA SBI;GARANTIAS
25539686;Soltero;F;30;HAITIANO;;Extranjero;PROVIDENCIA                   ;METROPOLITANA;92980;2;2;1;1;39990;1;1;52990;Asistencia Salud Integral Familia;GARANTIAS
8340956;;M;63;CHILENO;;Boomers;NUNOA                         ;METROPOLITANA;52990;1;1;0;0;0;1;1;52990;ASIST. FULL HOGAR Y AUTO INGRAL;GARANTIAS
16164798;;F;37;CHILENO;;Millenial;SAN FERNANDO                  ;L.G.B.OÂ´HIGGINS;211960;4;4;0;0;0;4;4;211960;Asistencia Programa Domiciliario;GARANTIAS
8608675;;F;59;CHILENO;;Boomers;N/D;N/D;75520;6;3;0;0;0;6;3;75520;Asistencia Programa Domiciliario;GARANTIAS
17605142;;F;31;CHILENO;;Millenial;LOS LAGOS                     ;LOS LAGOS;52990;1;1;0;0;0;1;1;52990;Asistencia Salud Integral Familia;GARANTIAS
7875800;;F;65;CHILENO;;Boomers;N/D;N/D;671960;4;2;0;0;0;4;2;671960;Asistencia Salud Integral Familia;GARANTIAS
9563819;;M;58;CHILENO;;Boomers;CAUQUENES                     ;MAULE;415950;5;4;0;0;0;5;4;415950;Asistencia Salud Integral Familia;GARANTIAS
12873456;;F;47;CHILENO;;Millenial;"";"";52990;1;1;0;0;0;1;1;52990;ASIST. FULL HOGAR Y AUTO INGRAL;GARANTIAS
20101366;;M;23;CHILENO;;Z;N/D;N/D;94990;2;3;0;0;0;2;3;94990;Asistencia Salud Integral Familia;GARANTIAS
9710420;;F;60;CHILENO;;Boomers;N/D;N/D;52990;1;1;0;0;0;1;1;52990;Asistencia Salud Integral Familia;GARANTIAS
8309755;;M;66;CHILENO;;Boomers;CHILLAN VIEJO                 ;BIO BIO;672260;9;4;0;0;0;9;4;672260;Asistencia Salud Integral Familia;GARANTIAS
27486070;;M;32;CHILENO;;Extranjero;N/D;N/D;52990;1;1;0;0;0;1;1;52990;Asistencia Salud Integral Familia;GARANTIAS
5978734;;M;71;CHILENO;;Silencioso;FLORIDA                       ;BIO BIO;47880;1;5;0;0;0;1;5;47880;GM 1A X CTA SBI;GARANTIAS
8105284;;M;65;CHILENO;;Boomers;N/D;N/D;474950;5;3;0;0;0;5;3;474950;ASIST. FULL HOGAR Y AUTO INGRAL;GARANTIAS
12898982;;M;46;CHILENO;;X;CERRILLOS                     ;METROPOLITANA;400970;3;2;0;0;0;3;2;400970;Asistencia Programa Domiciliario;GARANTIAS
10544269;;F;47;CHILENO;;X;N/D;N/D;52990;1;1;0;0;0;1;1;52990;Asistencia Salud Integral Familia;GARANTIAS
5493329;;F;77;CHILENO;;Silencioso;VICUNA                        ;COQUIMBO;532370;6;3;0;0;0;6;3;532370;Asistencia Salud Integral Familia;GARANTIAS
10846422;;F;57;CHILENO;;Boomers;LA LIGUA                      ;VALPARAISO;766830;6;4;0;0;0;6;4;766830;Asistencia Programa Domiciliario;GARANTIAS
11673984;;M;52;CHILENO;;X;PUNITAQUI                     ;COQUIMBO;90980;2;1;0;0;0;2;1;90980;Asistencia Salud Integral Familia;GARANTIAS
19027992;;M;27;CHILENO;;Z;N/D;N/D;384510;5;3;2;1;78540;3;2;305970;Asistencia Programa Domiciliario;GARANTIAS
18856777;;F;27;CHILENO;;Z;N/D;N/D;582960;4;2;0;0;0;4;2;582960;Asistencia Salud Integral Familia;GARANTIAS
10608956;;M;53;CHILENO;;X;PROVIDENCIA                   ;METROPOLITANA;52990;1;1;0;0;0;1;1;52990;Asistencia Programa Domiciliario;GARANTIAS
5377632;;F;77;CHILENO;;Silencioso;CURANILAHUE                   ;BIO BIO;1288580;14;11;0;0;0;14;11;1288580;Asistencia Programa Domiciliario;GARANTIAS
12185393;;M;53;CHILENO;;X;PARRAL                        ;MAULE;52990;1;1;0;0;0;1;1;52990;Asistencia Salud Integral Familia;GARANTIAS
6304961;;F;70;CHILENO;;Silencioso;QUILLOTA                      ;VALPARAISO;61070;3;1;0;0;0;3;1;61070;GM 1A X CTA SBI;GARANTIAS
15688775;;F;38;CHILENO;;X;N/D;N/D;52990;1;1;0;0;0;1;1;52990;Asistencia Salud Integral Familia;GARANTIAS
6827239;;F;69;CHILENO;;Silencioso;LINARES                       ;MAULE;105980;2;4;0;0;0;2;4;105980;Asistencia de Mascotas;GARANTIAS
16537711;;M;35;CHILENO;;Millenial;N/D;N/D;443850;5;2;0;0;0;5;2;443850;Asistencia Salud Integral Familia;GARANTIAS
8070002;;F;66;CHILENO;;Boomers;MONTE PATRIA                  ;COQUIMBO;533930;7;5;0;0;0;7;5;533930;ASIST. FULL HOGAR Y AUTO INGRAL;GARANTIAS
20628490;;M;21;CHILENO;;Z;CHILLAN;BIO-BIO;87980;2;2;1;1;34990;1;1;52990;Asistencia Salud Integral Familia;GARANTIAS
9139855;;F;62;CHILENO;;Boomers;TALAGANTE                     ;METROPOLITANA;498450;4;2;0;0;0;4;2;498450;Asistencia Programa Domiciliario;GARANTIAS
11744607;;F;51;CHILENO;;X;N/D;N/D;953500;9;4;0;0;0;9;4;953500;Asistencia Salud Integral Familia;GARANTIAS
21938288;;F;66;PERUANO;;Extranjero;INDEPENDENCIA                 ;METROPOLITANA;52990;1;1;0;0;0;1;1;52990;Asistencia Salud Integral Familia;GARANTIAS
8817240;;M;62;CHILENO;;Boomers;SAN FERNANDO                  ;L.G.B.OÂ´HIGGINS;412980;2;2;0;0;0;2;2;412980;Asistencia Salud Integral Familia;GARANTIAS
12303423;;M;50;CHILENO;;X;PROVIDENCIA                   ;N/D;78582;2;2;0;0;0;2;2;78582;Asistencia Salud Integral Familia;GARANTIAS
7341309;;F;67;CHILENO;;Boomers;SAN BERNARDO                  ;METROPOLITANA;659780;9;6;0;0;0;9;6;659780;Asistencia Salud Integral Familia;GARANTIAS
17714323;;M;31;CHILENO;;Millenial;"";"";471930;7;4;0;0;0;7;4;471930;Asistencia Salud Integral Familia;GARANTIAS
8908149;;F;61;CHILENO;;Boomers;VALDIVIA                      ;LOS RIOS;133230;4;2;0;0;0;4;2;133230;Asistencia Salud Integral Familia;GARANTIAS
9264699;;F;60;CHILENO;;Boomers;COQUIMBO                      ;COQUIMBO;105980;2;1;0;0;0;2;1;105980;Asistencia Salud Integral Familia;GARANTIAS
8230719;;F;73;CHILENO;;Silencioso;RANCAGUA                      ;L.G.B.OÂ´HIGGINS;262970;3;3;0;0;0;3;3;262970;Asistencia Salud Integral Familia;GARANTIAS
25919202;;M;36;HAITIANO;;Extranjero;ESTACION CENTRAL              ;METROPOLITANA;15470;2;1;0;0;0;2;1;15470;GM 1A X CTA SBI;GARANTIAS
14464347;;F;44;CHILENO;;X;SAN PEDRO DE LA PAZ           ;BIO BIO;15470;2;1;0;0;0;2;1;15470;GM 1A X CTA SBI;GARANTIAS
12868748;;M;47;CHILENO;;X;N/D;N/D;52990;1;1;0;0;0;1;1;52990;Asistencia Salud Integral Familia;GARANTIAS
23145420;;F;39;NEPALÃS;;Extranjero;PROVIDENCIA                   ;METROPOLITANA;276970;3;2;2;1;223980;1;1;52990;Asistencia Salud Integral Familia;GARANTIAS
9576629;;F;60;CHILENO;;Boomers;CONSTITUCION                  ;MAULE;1046530;8;4;0;0;0;8;4;1046530;Asistencia Salud Integral Familia;GARANTIAS
13381580;;M;43;CHILENO;;X;N/D;N/D;422950;5;2;0;0;0;5;2;422950;Asistencia Salud Integral Familia;GARANTIAS
5294211;;M;77;CHILENO;;Silencioso;TALCA                         ;MAULE;1531100;17;10;0;0;0;17;10;1531100;Asistencia Salud Integral Familia;GARANTIAS
8059366;;M;60;CHILENO;;Boomers;SAN FELIPE                    ;VALPARAISO;167970;3;3;0;0;0;3;3;167970;Asistencia Salud Integral Familia;GARANTIAS
18626053;;F;28;CHILENO;;Millenial;"";"";52990;1;1;0;0;0;1;1;52990;Asistencia Programa Domiciliario;GARANTIAS
18046041;;F;32;CHILENO;;Millenial;LA FLORIDA                    ;METROPOLITANA;186970;3;2;2;1;133980;1;1;52990;ASIST. FULL HOGAR Y AUTO INGRAL;GARANTIAS
10983419;;M;54;CHILENO;;X;VINA DEL MAR                  ;VALPARAISO;52990;1;1;0;0;0;1;1;52990;Asistencia Salud Integral Familia;GARANTIAS
10799180;;M;51;CHILENO;;X;ARICA                         ;ARICA Y PARINACOTA;102980;2;2;0;0;0;2;2;102980;Asistencia Salud Integral Familia;GARANTIAS
7979847;;F;64;CHILENO;;Boomers;VALDIVIA                      ;LOS RIOS;52990;1;1;0;0;0;1;1;52990;Asistencia Salud Integral Familia;GARANTIAS
5910662;;F;73;CHILENO;;Silencioso;TALCA                         ;MAULE;237100;6;3;0;0;0;6;3;237100;Asistencia de Mascotas;GARANTIAS
15485281;;M;39;CHILENO;;X;RENCA                         ;METROPOLITANA;1522910;10;9;2;1;803980;8;8;718930;Asistencia Salud Integral Familia;GARANTIAS
11162576;;M;54;CHILENO;;Boomers;OVALLE                        ;COQUIMBO;52990;1;1;0;0;0;1;1;52990;ASIST. FULL HOGAR Y AUTO INGRAL;GARANTIAS
6489413;;M;70;CHILENO;;Silencioso;PUERTO MONTT                  ;LOS LAGOS;527660;7;3;0;0;0;7;3;527660;Asistencia Salud Integral Familia;GARANTIAS
4597855;;M;80;CHILENO;;Silencioso;RENCA                         ;METROPOLITANA;14670;3;1;0;0;0;3;1;14670;GM 1A X CTA SBI;GARANTIAS
7178509;;F;66;CHILENO;;Boomers;SANTA CRUZ                    ;L.G.B.OÂ´HIGGINS;52990;1;1;0;0;0;1;1;52990;Asistencia Salud Integral Familia;GARANTIAS
15544516;;M;39;CHILENO;;X;N/D;N/D;52990;1;1;0;0;0;1;1;52990;Asistencia Salud Integral Familia;GARANTIAS
10259207;;F;58;CHILENO;;Boomers;PROVIDENCIA                   ;METROPOLITANA;52990;1;1;0;0;0;1;1;52990;Asistencia Salud Integral Familia;GARANTIAS
20323769;;F;22;CHILENO;;Millenial;MULCHEN                       ;BIO BIO;26990;1;3;0;0;0;1;3;26990;GM 1A X CTA SBI;GARANTIAS
8222768;;F;64;CHILENO;;Boomers;TALCAHUANO                    ;BIO BIO;301960;4;4;0;0;0;4;4;301960;Asistencia Salud Integral Familia;GARANTIAS
7504470;;F;62;CHILENO;;Boomers;LOS ANGELES                   ;BIO BIO;355450;5;2;0;0;0;5;2;355450;Asistencia de Mascotas;GARANTIAS
8736593;;M;59;CHILENO;;Boomers;QUILPUE                       ;VALPARAISO;52990;1;1;0;0;0;1;1;52990;Asistencia Salud Integral Familia;GARANTIAS
9730394;;F;60;CHILENO;;Boomers;N/D;N/D;903710;9;6;0;0;0;9;6;903710;Asistencia Salud Integral Familia;GARANTIAS
11555677;;M;52;CHILENO;;X;CHIMBARONGO                   ;L.G.B.OÂ´HIGGINS;141250;4;3;0;0;0;4;3;141250;Asistencia Salud Integral Familia;GARANTIAS
13476432;;M;44;CHILENO;;Millenial;N/D;N/D;52990;1;1;0;0;0;1;1;52990;Asistencia Salud Integral Familia;GARANTIAS
24302281;;M;49;BOLIVIANO;;Extranjero;ANTOFAGASTA                   ;ANTOFAGASTA;978920;9;5;0;0;0;9;5;978920;Asistencia Programa Domiciliario;GARANTIAS
17282716;;M;32;CHILENO;;Millenial;LA GRANJA;METROPOLITANA;52990;1;1;0;0;0;1;1;52990;Asistencia Programa Domiciliario;GARANTIAS
10008750;;F;52;CHILENO;;X;LEBU                          ;BIO BIO;515980;10;8;0;0;0;10;8;515980;Asistencia Salud Integral Familia;GARANTIAS
14585892;;M;42;CHILENO;;Millenial;N/D;N/D;52990;1;1;0;0;0;1;1;52990;Asistencia Salud Integral Familia;GARANTIAS
12142992;;F;59;CHILENO;;Boomers;SANTA CRUZ                    ;L.G.B.OÂ´HIGGINS;645530;6;3;0;0;0;6;3;645530;Asistencia Salud Integral Familia;GARANTIAS
7859983;;M;67;CHILENO;;Boomers;SAN CLEMENTE                  ;MAULE;317940;6;3;0;0;0;6;3;317940;Asistencia Salud Integral Familia;GARANTIAS
16674998;;M;34;CHILENO;;Millenial;ANTOFAGASTA                   ;ANTOFAGASTA;105980;2;1;0;0;0;2;1;105980;Asistencia Salud Integral Familia;GARANTIAS
20197517;;F;22;CHILENO;;Z;SAN PEDRO DE LA PAZ           ;BIO BIO;353960;4;3;0;0;0;4;3;353960;Asistencia Programa Domiciliario;GARANTIAS
13203096;;M;44;CHILENO;;X;N/D;N/D;380970;3;2;0;0;0;3;2;380970;Asistencia Salud Integral Familia;GARANTIAS
4962303;;M;78;CHILENO;;Silencioso;ARICA                         ;ARICA Y PARINACOTA;242980;2;2;0;0;0;2;2;242980;Asistencia Salud Integral Familia;GARANTIAS
19563658;;M;25;CHILENO;;Z;N/D;N/D;52990;1;1;0;0;0;1;1;52990;Asistencia Programa Domiciliario;GARANTIAS
14331003;;F;44;CHILENO;;X;LINARES                       ;MAULE;132970;3;2;0;0;0;3;2;132970;ASIST. FULL HOGAR Y AUTO INGRAL;GARANTIAS
9106804;;F;59;CHILENO;;Boomers;CALLE LARGA                   ;VALPARAISO;52990;1;1;0;0;0;1;1;52990;Asistencia Salud Integral Familia;GARANTIAS
10244270;;F;53;CHILENO;;X;MARIA PINTO                   ;METROPOLITANA;256330;6;2;0;0;0;6;2;256330;ASIST. FULL HOGAR Y AUTO INGRAL;GARANTIAS
10443997;;F;55;CHILENO;;Boomers;N/D;N/D;52990;1;1;0;0;0;1;1;52990;ASIST. FULL HOGAR Y AUTO INGRAL;GARANTIAS
8674748;;M;62;CHILENO;;Boomers;QUILPUE                       ;VALPARAISO;52990;1;1;0;0;0;1;1;52990;Asistencia Salud Integral Familia;GARANTIAS
8606262;;F;60;CHILENO;;Boomers;PUTAENDO                      ;VALPARAISO;52990;1;1;0;0;0;1;1;52990;Asistencia Salud Integral Familia;GARANTIAS
13722481;;M;47;CHILENO;;X;SAN JAVIER                    ;MAULE;105980;2;1;0;0;0;2;1;105980;Asistencia Salud Integral Familia;GARANTIAS
5720660;;F;76;CHILENO;;Silencioso;ANCUD                         ;LOS LAGOS;72980;2;2;0;0;0;2;2;72980;Asistencia Programa Domiciliario;GARANTIAS
11880304;;F;52;CHILENO;;X;MELIPILLA                     ;METROPOLITANA;52990;1;1;0;0;0;1;1;52990;ASIST. FULL HOGAR Y AUTO INGRAL;GARANTIAS
15013482;;F;40;CHILENO;;X;PUNITAQUI                     ;COQUIMBO;373991;6;4;2;1;140980;4;3;233011;ASIST. FULL HOGAR Y AUTO INGRAL;GARANTIAS
10467885;;M;55;CHILENO;;Boomers;BUIN                          ;METROPOLITANA;52990;1;1;0;0;0;1;1;52990;Asistencia Salud Integral Familia;GARANTIAS
15903509;;M;37;CHILENO;;Millenial;PUERTO MONTT                  ;LOS LAGOS;52990;1;1;0;0;0;1;1;52990;Asistencia Programa Domiciliario;GARANTIAS
7093799;;M;68;CHILENO;;Silencioso;"";"";161060;3;3;0;0;0;3;3;161060;Asistencia Programa Domiciliario;GARANTIAS
6716933;;F;68;CHILENO;;Silencioso;CATEMU                        ;VALPARAISO;158970;3;3;0;0;0;3;3;158970;Asistencia Salud Integral Familia;GARANTIAS
14433698;;M;48;CHILENO;;X;LOS ANDES                     ;VALPARAISO;204980;2;2;1;1;151990;1;1;52990;Asistencia Salud Integral Familia;GARANTIAS
6597207;;F;72;CHILENO;;Silencioso;LA FLORIDA                    ;METROPOLITANA;182980;2;2;0;0;0;2;2;182980;Asistencia Salud Integral Familia;GARANTIAS
15587159;;F;39;CHILENO;;X;CERRO NAVIA                   ;METROPOLITANA;52990;1;1;0;0;0;1;1;52990;ASIST. FULL HOGAR Y AUTO INGRAL;GARANTIAS
7521270;;M;65;CHILENO;;Boomers;ANTOFAGASTA                   ;ANTOFAGASTA;191960;4;3;0;0;0;4;3;191960;Asistencia Programa Domiciliario;GARANTIAS
8679167;;M;63;CHILENO;;Boomers;PENAFLOR                      ;METROPOLITANA;105980;2;2;0;0;0;2;2;105980;Asistencia Programa Domiciliario;GARANTIAS
15140737;;F;40;CHILENO;;X;SAN CLEMENTE                  ;MAULE;105980;2;1;0;0;0;2;1;105980;Asistencia Salud Integral Familia;GARANTIAS
27015296;;F;44;CHILENO;;Extranjero;"";"";52990;1;1;0;0;0;1;1;52990;Asistencia Programa Domiciliario;GARANTIAS
8658433;;F;64;CHILENO;;Boomers;NOGALES                       ;VALPARAISO;222980;2;2;0;0;0;2;2;222980;Asistencia Salud Integral Familia;GARANTIAS
11455196;;M;54;CHILENO;;X;SANTA CRUZ                    ;L.G.B.OÂ´HIGGINS;308030;6;5;0;0;0;6;5;308030;Asistencia Salud Integral Familia;GARANTIAS
18951766;;M;27;CHILENO;;Z;N/D;N/D;211960;4;1;0;0;0;4;1;211960;Asistencia de Mascotas;GARANTIAS
9548593;;F;62;CHILENO;;Boomers;ANTOFAGASTA                   ;ANTOFAGASTA;147840;5;3;0;0;0;5;3;147840;Asistencia Programa Domiciliario;GARANTIAS
15039667;;F;40;CHILENO;;X;OVALLE                        ;COQUIMBO;52990;1;1;0;0;0;1;1;52990;Asistencia Salud Integral Familia;GARANTIAS
7646311;;M;67;CHILENO;;Boomers;"";"";52990;1;1;0;0;0;1;1;52990;Asistencia Salud Integral Familia;GARANTIAS
25811620;;M;50;HAITIANO;;Extranjero;CORONEL                       ;BIO BIO;510970;5;3;0;0;0;5;3;510970;ASIST. FULL HOGAR Y AUTO INGRAL;GARANTIAS
7794466;;M;61;CHILENO;;Boomers;MELIPILLA                     ;METROPOLITANA;52990;1;1;0;0;0;1;1;52990;ASIST. FULL HOGAR Y AUTO INGRAL;GARANTIAS
5488490;;M;73;CHILENO;;Silencioso;N/D;N/D;52990;1;1;0;0;0;1;1;52990;Asistencia Programa Domiciliario;GARANTIAS
6986296;;M;67;CHILENO;;Boomers;PUERTO MONTT                  ;LOS LAGOS;52990;1;1;0;0;0;1;1;52990;Asistencia Programa Domiciliario;GARANTIAS
25636677;;F;42;PERUANO;;Extranjero;INDEPENDENCIA                 ;METROPOLITANA;252980;2;2;0;0;0;2;2;252980;ASIST. FULL HOGAR Y AUTO INGRAL;GARANTIAS
19394473;;F;26;CHILENO;;Z;N/D;N/D;52990;1;1;0;0;0;1;1;52990;Asistencia Salud Integral Familia;GARANTIAS
24126523;;M;52;DOMINICANO;;Extranjero;INDEPENDENCIA                 ;METROPOLITANA;52990;1;1;0;0;0;1;1;52990;ASIST. FULL HOGAR Y AUTO INGRAL;GARANTIAS
24274522;;F;23;COLOMBIANO;;Extranjero;SANTIAGO;METROPOLITANA;52990;1;1;0;0;0;1;1;52990;Asistencia Programa Domiciliario;GARANTIAS
7288376;;M;68;CHILENO;;Silencioso;CORONEL                       ;BIO BIO;45041;1;1;0;0;0;1;1;45041;Asistencia Programa Domiciliario;GARANTIAS
6181900;;F;72;CHILENO;;Silencioso;EL BOSQUE                     ;METROPOLITANA;52990;1;1;0;0;0;1;1;52990;ASIST. FULL HOGAR Y AUTO INGRAL;GARANTIAS
10043495;;F;56;CHILENO;;Boomers;VINA DEL MAR                  ;VALPARAISO;139960;4;3;2;1;64980;2;2;74980;Asistencia Salud Integral Familia;GARANTIAS
8888149;;F;58;CHILENO;;Boomers;CALBUCO                       ;LOS LAGOS;212980;2;2;0;0;0;2;2;212980;Asistencia Salud Integral Familia;GARANTIAS
5612067;;F;75;CHILENO;;Silencioso;LOS ANGELES                   ;BIO BIO;243950;5;2;0;0;0;5;2;243950;Asistencia de Mascotas;GARANTIAS
14096976;;F;47;CHILENO;;X;TALCA                         ;MAULE;109970;3;2;0;0;0;3;2;109970;Asistencia Salud Integral Familia;GARANTIAS
12757108;;F;47;CHILENO;;X;PUERTO MONTT                  ;LOS LAGOS;749420;7;4;0;0;0;7;4;749420;Asistencia Salud Integral Familia;GARANTIAS
27203782;;M;50;CHILENO;;Extranjero;"";"";52990;1;1;0;0;0;1;1;52990;Asistencia Programa Domiciliario;GARANTIAS
14360953;;M;40;CHILENO;;X;ANGOL                         ;ARAUCANIA;52990;1;1;0;0;0;1;1;52990;Asistencia Salud Integral Familia;GARANTIAS
25039559;;F;29;PERUANO;;Extranjero;N/D;N/D;0;0;2;0;0;0;0;2;0;Asistencia Salud Integral Familia;GARANTIAS
25624772;;M;56;COLOMBIANO;;Extranjero;CERRILLOS                     ;METROPOLITANA;52990;1;1;0;0;0;1;1;52990;Asistencia Programa Domiciliario;GARANTIAS
25105475;;M;60;PERUANO;;Extranjero;N/D;N/D;52990;1;1;0;0;0;1;1;52990;ASIST. FULL HOGAR Y AUTO INGRAL;GARANTIAS
7137215;;F;68;CHILENO;;Silencioso;CURICO                        ;MAULE;211960;4;1;0;0;0;4;1;211960;Asistencia de Mascotas;GARANTIAS
18326138;;M;29;CHILENO;;Millenial;"";"";52990;1;1;0;0;0;1;1;52990;Asistencia Programa Domiciliario;GARANTIAS
6160443;;M;73;CHILENO;;Silencioso;TIRUA                         ;BIO BIO;52990;1;1;0;0;0;1;1;52990;Asistencia Salud Integral Familia;GARANTIAS
11715699;;M;51;CHILENO;;X;PUERTO MONTT                  ;LOS LAGOS;52990;1;1;0;0;0;1;1;52990;Asistencia Programa Domiciliario;GARANTIAS
12413463;;F;49;CHILENO;;X;SANTA CRUZ                    ;L.G.B.OÂ´HIGGINS;70980;2;2;0;0;0;2;2;70980;Asistencia Salud Integral Familia;GARANTIAS
13074578;;M;45;CHILENO;;Millenial;"";"";52990;1;1;0;0;0;1;1;52990;Asistencia Programa Domiciliario;GARANTIAS
6759779;;F;70;CHILENO;;Silencioso;PELARCO                       ;MAULE;106970;3;2;0;0;0;3;2;106970;Asistencia Salud Integral Familia;GARANTIAS
19003239;;F;27;CHILENO;;Z;PUENTE ALTO                   ;METROPOLITANA;542970;3;2;0;0;0;3;2;542970;Asistencia Salud Integral Familia;GARANTIAS
13001553;;F;46;CHILENO;;X;QUEMCHI                       ;LOS LAGOS;52990;1;1;0;0;0;1;1;52990;Asistencia Salud Integral Familia;GARANTIAS
17979207;;M;30;CHILENO;;Millenial;LA SERENA                     ;COQUIMBO;82980;2;2;0;0;0;2;2;82980;Asistencia Salud Integral Familia;GARANTIAS
18035102;;F;30;CHILENO;;Millenial;PROVIDENCIA                   ;METROPOLITANA;339960;4;2;0;0;0;4;2;339960;Asistencia Salud Integral Familia;GARANTIAS
11949816;;M;50;CHILENO;;X;LAS CABRAS                    ;L.G.B.OÂ´HIGGINS;52990;1;1;0;0;0;1;1;52990;Asistencia Salud Integral Familia;GARANTIAS
6632231;;F;71;CHILENO;;Silencioso;OVALLE                        ;COQUIMBO;97980;2;2;0;0;0;2;2;97980;Asistencia Programa Domiciliario;GARANTIAS
5893916;;M;69;CHILENO;;Silencioso;N/D;N/D;52990;1;1;0;0;0;1;1;52990;Asistencia Salud Integral Familia;GARANTIAS
8236563;;M;52;CHILENO;;X;CHILLAN                       ;BIO BIO;82974;3;3;0;0;0;3;3;82974;Asistencia Programa Domiciliario;GARANTIAS
24907717;;M;29;BOLIVIANO;;Extranjero;N/D;N/D;849140;9;4;0;0;0;9;4;849140;Asistencia Salud Integral Familia;GARANTIAS
22642403;;M;45;PERUANO;;Extranjero;PENALOLEN                     ;METROPOLITANA;52990;1;1;0;0;0;1;1;52990;Asistencia Salud Integral Familia;GARANTIAS
26932945;Soltero;F;36;CHILENO;;Extranjero;SANTIAGO                      ;METROPOLITANA;52990;1;1;0;0;0;1;1;52990;Asistencia Programa Domiciliario;GARANTIAS
14367682;;F;48;CHILENO;;X;PAINE                         ;METROPOLITANA;987040;6;3;0;0;0;6;3;987040;Asistencia Salud Integral Familia;GARANTIAS
18672976;;M;28;CHILENO;;Millenial;N/D;N/D;0;0;2;0;0;0;0;2;0;Asistencia Salud Integral Familia;GARANTIAS
12426767;;F;49;CHILENO;;X;OVALLE                        ;COQUIMBO;52990;1;1;0;0;0;1;1;52990;Asistencia Salud Integral Familia;GARANTIAS
5127109;;F;76;CHILENO;;Silencioso;EL BOSQUE                     ;METROPOLITANA;52990;1;1;0;0;0;1;1;52990;Asistencia Programa Domiciliario;GARANTIAS
16329828;;F;35;CHILENO;;Millenial;N/D;N/D;120970;3;3;0;0;0;3;3;120970;Asistencia Salud Integral Familia;GARANTIAS
8004197;;M;65;CHILENO;;Boomers;IQUIQUE                       ;TARAPACA;52990;1;1;0;0;0;1;1;52990;Asistencia Salud Integral Familia;GARANTIAS
15058498;;M;39;CHILENO;;X;CABILDO                       ;VALPARAISO;632970;3;2;0;0;0;3;2;632970;Asistencia Salud Integral Familia;GARANTIAS
16737203;;M;35;CHILENO;;Millenial;N/D;N/D;172980;2;2;0;0;0;2;2;172980;Asistencia Salud Integral Familia;GARANTIAS
7878453;;F;65;CHILENO;;Boomers;CORONEL                       ;BIO BIO;52990;1;1;0;0;0;1;1;52990;Asistencia Salud Integral Familia;GARANTIAS
6494332;;F;68;CHILENO;;Silencioso;QUILICURA                     ;METROPOLITANA;52990;1;1;0;0;0;1;1;52990;Asistencia Programa Domiciliario;GARANTIAS
15795427;;M;38;CHILENO;;Millenial;OSORNO                        ;LOS LAGOS;52990;1;1;0;0;0;1;1;52990;Asistencia Salud Integral Familia;GARANTIAS
12116728;;F;43;CHILENO;;X;ARICA                         ;ARICA Y PARINACOTA;52990;1;1;0;0;0;1;1;52990;Asistencia Salud Integral Familia;GARANTIAS
26299128;;F;39;EXTRANJERO - NO INFORMA NACIONALIDAD;;Extranjero;ESTACION CENTRAL              ;METROPOLITANA;52990;1;1;0;0;0;1;1;52990;Asistencia Programa Domiciliario;GARANTIAS
15778161;;F;38;CHILENO;;Millenial;LOTA                          ;BIO BIO;0;0;2;0;0;0;0;2;0;GPL 1A X CTA SBI;GARANTIAS
12681418;;F;48;CHILENO;;X;NUEVA IMPERIAL                ;ARAUCANIA;15980;2;1;0;0;0;2;1;15980;GM 1A X CTA SBI;GARANTIAS
7404829;;M;67;CHILENO;;Boomers;VILLARICA                     ;ARAUCANIA;52990;1;1;0;0;0;1;1;52990;Asistencia Salud Integral Familia;GARANTIAS
27292289;;F;36;EXTRANJERO - NO INFORMA NACIONALIDAD;;Extranjero;SANTIAGO                      ;METROPOLITANA;52990;1;1;0;0;0;1;1;52990;Asistencia Salud Integral Familia;GARANTIAS
8620323;;M;64;CHILENO;;Boomers;LLANQUIHUE                    ;LOS LAGOS;52990;1;1;0;0;0;1;1;52990;Asistencia Programa Domiciliario;GARANTIAS
12101744;;M;53;CHILENO;;X;"";"";52990;1;1;0;0;0;1;1;52990;Asistencia Salud Integral Familia;GARANTIAS
10730433;;F;58;CHILENO;;Boomers;ALTO HOSPICIO;TARAPACA;52990;1;1;0;0;0;1;1;52990;Asistencia Salud Integral Familia;GARANTIAS
6452883;;M;71;CHILENO;;Silencioso;N/D;N/D;52990;1;1;0;0;0;1;1;52990;Asistencia Salud Integral Familia;GARANTIAS
9116477;;M;60;CHILENO;;Boomers;PROVIDENCIA                   ;METROPOLITANA;52990;1;1;0;0;0;1;1;52990;ASIST. FULL HOGAR Y AUTO INGRAL;GARANTIAS
13006551;;F;46;CHILENO;;X;ARICA                         ;ARICA Y PARINACOTA;866340;5;2;0;0;0;5;2;866340;Asistencia Salud Integral Familia;GARANTIAS
8829926;;F;62;CHILENO;;Boomers;EL TABO                       ;VALPARAISO;52990;1;1;0;0;0;1;1;52990;Asistencia Salud Integral Familia;GARANTIAS
14065426;;F;41;CHILENO;;X;N/D;N/D;52990;1;1;0;0;0;1;1;52990;Asistencia Salud Integral Familia;GARANTIAS
10573308;;M;46;CHILENO;;X;VALDIVIA                      ;LOS LAGOS;102960;5;2;0;0;0;5;2;102960;GPL 1A X CTA SBI;GARANTIAS
13558148;;F;43;CHILENO;;X;N/D;N/D;52990;1;1;0;0;0;1;1;52990;Asistencia Programa Domiciliario;GARANTIAS
12918768;;M;46;CHILENO;;X;SAN PEDRO DE LA PAZ           ;BIO BIO;52990;1;1;0;0;0;1;1;52990;Asistencia Programa Domiciliario;GARANTIAS
18965417;;M;27;CHILENO;;Z;N/D;N/D;52990;1;1;0;0;0;1;1;52990;Asistencia Programa Domiciliario;GARANTIAS
7183367;;F;68;CHILENO;;Silencioso;LANCO                         ;LOS LAGOS;92980;2;4;0;0;0;2;4;92980;Asistencia Salud Integral Familia;GARANTIAS
6115779;;F;74;CHILENO;;Silencioso;VALDIVIA                      ;LOS RIOS;100870;2;2;0;0;0;2;2;100870;Asistencia Salud Integral Familia;GARANTIAS
16336671;;F;35;CHILENO;;Millenial;RANCAGUA;O HIGGINS;52990;1;1;0;0;0;1;1;52990;Asistencia Salud Integral Familia;GARANTIAS
9195581;;F;62;CHILENO;;Boomers;OVALLE                        ;COQUIMBO;46770;3;1;0;0;0;3;1;46770;GPL 1A X CTA SBI;GARANTIAS
8441908;;F;64;CHILENO;;Boomers;COIHAIQUE                     ;AYSEN;52990;1;1;0;0;0;1;1;52990;Asistencia Salud Integral Familia;GARANTIAS
5707015;;F;76;CHILENO;;Silencioso;ALTO HOSPICIO;TARAPACA;52990;1;1;0;0;0;1;1;52990;Asistencia Programa Domiciliario;GARANTIAS
14089807;;F;41;CHILENO;;X;N/D;N/D;52990;1;1;0;0;0;1;1;52990;Asistencia Programa Domiciliario;GARANTIAS
16778370;;M;33;CHILENO;;Millenial;CONCON                        ;VALPARAISO;52990;1;1;0;0;0;1;1;52990;Asistencia Programa Domiciliario;GARANTIAS
14482950;;F;46;CHILENO;;X;N/D;N/D;52990;1;1;0;0;0;1;1;52990;Asistencia Programa Domiciliario;GARANTIAS
26113830;;M;36;VENEZOLANO;;Extranjero;"";"";52990;1;1;0;0;0;1;1;52990;Asistencia Salud Integral Familia;GARANTIAS
14262279;;F;48;CHILENO;;X;PICHIDEGUA                    ;L.G.B.OÂ´HIGGINS;105980;2;1;0;0;0;2;1;105980;Asistencia Salud Integral Familia;GARANTIAS
6573343;;M;69;CHILENO;;Silencioso;ESTACION CENTRAL              ;METROPOLITANA;755250;4;2;0;0;0;4;2;755250;Asistencia Programa Domiciliario;GARANTIAS
6131554;;M;72;CHILENO;;Silencioso;CABILDO                       ;VALPARAISO;96070;2;2;0;0;0;2;2;96070;Asistencia Programa Domiciliario;GARANTIAS
9060268;;M;62;CHILENO;;Boomers;N/D;N/D;52990;1;1;0;0;0;1;1;52990;Asistencia Salud Integral Familia;GARANTIAS
13508642;;F;44;CHILENO;;X;SAN PEDRO DE LA PAZ           ;BIO BIO;169970;3;2;0;0;0;3;2;169970;Asistencia Programa Domiciliario;GARANTIAS
23711194;;F;34;PERUANO;;Extranjero;ANTOFAGASTA                   ;ANTOFAGASTA;158970;3;2;0;0;0;3;2;158970;Asistencia Salud Integral Familia;GARANTIAS
7402992;;M;67;CHILENO;;Boomers;ANTOFAGASTA                   ;ANTOFAGASTA;165240;3;2;0;0;0;3;2;165240;Asistencia Programa Domiciliario;GARANTIAS
3118958;;M;86;CHILENO;;Silencioso;SAN ANTONIO                   ;VALPARAISO;47880;1;1;0;0;0;1;1;47880;ASIS. SALUD X CTA ASSISTIME;GARANTIAS
25594739;;F;45;PERUANO;;Extranjero;RECOLETA                      ;METROPOLITANA;47880;1;1;0;0;0;1;1;47880;ASIS. SALUD X CTA ASSISTIME;GARANTIAS
13253946;;F;48;CHILENO;;X;PROVIDENCIA                   ;METROPOLITANA;47880;1;1;0;0;0;1;1;47880;ASIS. SALUD X CTA ASSISTIME;GARANTIAS
18431680;;F;28;CHILENO;;Millenial;N/D;N/D;47880;1;1;0;0;0;1;1;47880;ASIS. SALUD X CTA ASSISTIME;GARANTIAS
8133223;;M;64;CHILENO;;Boomers;MELIPILLA                     ;METROPOLITANA;47880;1;1;0;0;0;1;1;47880;ASIS. SALUD X CTA ASSISTIME;GARANTIAS
16679234;;M;35;CHILENO;;Millenial;N/D;N/D;43080;1;1;0;0;0;1;1;43080;ASIST. FULL HOGAR X CTA MOK;GARANTIAS
7150445;;F;70;CHILENO;;Silencioso;PERALILLO                     ;L.G.B.OÂ´HIGGINS;90960;2;1;0;0;0;2;1;90960;ASIS. SALUD X CTA ASSISTIME;GARANTIAS
17818410;;F;31;CHILENO;;Millenial;LOS ANDES                     ;VALPARAISO;47880;1;1;0;0;0;1;1;47880;ASIS. SALUD X CTA ASSISTIME;GARANTIAS
16859816;;M;34;CHILENO;;Millenial;CURICO                        ;MAULE;47880;1;1;0;0;0;1;1;47880;ASIS. SALUD X CTA ASSISTIME;GARANTIAS
18327368;;M;29;CHILENO;;Millenial;PUDAHUEL                      ;METROPOLITANA;47880;1;1;0;0;0;1;1;47880;ASIS. SALUD X CTA ASSISTIME;GARANTIAS
19167577;;F;27;CHILENO;;Z;VICUNA                        ;COQUIMBO;55080;1;1;0;0;0;1;1;55080;Asistencia Programa Domiciliario;GARANTIAS
10045569;;F;58;CHILENO;;Boomers;PUENTE ALTO                   ;METROPOLITANA;47880;1;1;0;0;0;1;1;47880;ASIS. SALUD X CTA ASSISTIME;GARANTIAS
10580691;;F;53;CHILENO;;X;TALCA                         ;MAULE;102960;2;1;0;0;0;2;1;102960;Asistencia Programa Domiciliario;GARANTIAS
24649863;;M;32;COLOMBIANO;;Extranjero;N/D;N/D;47880;1;1;0;0;0;1;1;47880;ASIS. SALUD X CTA ASSISTIME;GARANTIAS
10063072;;M;56;CHILENO;;Boomers;CURANILAHUE                   ;BIO BIO;47880;1;1;0;0;0;1;1;47880;ASIS. SALUD X CTA ASSISTIME;GARANTIAS
5629015;;F;75;CHILENO;;Silencioso;PUDAHUEL                      ;METROPOLITANA;47880;1;1;0;0;0;1;1;47880;ASIS. SALUD X CTA ASSISTIME;GARANTIAS
21104294;;F;24;CHILENO;;Z;COQUIMBO                      ;COQUIMBO;47880;1;1;0;0;0;1;1;47880;ASIS. SALUD X CTA ASSISTIME;GARANTIAS
10350573;;M;54;CHILENO;;Boomers;OVALLE                        ;COQUIMBO;47880;1;1;0;0;0;1;1;47880;ASIS. SALUD X CTA ASSISTIME;GARANTIAS
27053025;;F;32;VENEZOLANO;;Extranjero;N/D;N/D;0;0;2;0;0;0;0;2;0;ASIS. SALUD X CTA ASSISTIME;GARANTIAS
13983358;;M;41;CHILENO;;X;CALERA                        ;VALPARAISO;47880;1;1;0;0;0;1;1;47880;ASIS. SALUD X CTA ASSISTIME;GARANTIAS
19110615;;M;26;CHILENO;;Extranjero;TALCAHUANO                    ;BIO BIO;0;0;0;0;0;0;0;0;0;ASIS. SALUD X CTA ASSISTIME;GARANTIAS
12693417;;M;47;CHILENO;;X;RANCAGUA                      ;L.G.B.OÂ´HIGGINS;0;0;0;0;0;0;0;0;0;ASIS. SALUD X CTA ASSISTIME;GARANTIAS
8827469;;M;56;CHILENO;;Boomers;N/D;N/D;0;0;0;0;0;0;0;0;0;ASIS. SALUD X CTA ASSISTIME;GARANTIAS
27151478;;M;26;VENEZOLANO;;Extranjero;N/D;N/D;0;0;0;0;0;0;0;0;0;ASIS. SALUD X CTA ASSISTIME;GARANTIAS
26565906;;M;33;EXTRANJERO - NO INFORMA NACIONALIDAD;;Extranjero;N/D;N/D;0;0;0;0;0;0;0;0;0;ASIS. SALUD X CTA ASSISTIME;GARANTIAS
12067903;;F;52;CHILENO;;X;N/D;N/D;0;0;0;0;0;0;0;0;0;ASIS. SALUD X CTA ASSISTIME;GARANTIAS
7218868;;F;70;CHILENO;;Silencioso;PUCON                         ;ARAUCANIA;0;0;0;0;0;0;0;0;0;ASIS. SALUD X CTA ASSISTIME;GARANTIAS
24187205;;F;38;PERUANO;;Extranjero;CONCHALI                      ;METROPOLITANA;0;0;0;0;0;0;0;0;0;ASIS. SALUD X CTA ASSISTIME;GARANTIAS
8772070;;F;65;CHILENO;;Boomers;PUDAHUEL                      ;METROPOLITANA;0;0;0;0;0;0;0;0;0;ASIS. SALUD X CTA ASSISTIME;GARANTIAS
16111336;;F;37;CHILENO;;Millenial;N/D;N/D;0;0;0;0;0;0;0;0;0;ASIS. SALUD X CTA ASSISTIME;GARANTIAS
26341837;;M;32;EXTRANJERO - NO INFORMA NACIONALIDAD;;Extranjero;N/D;N/D;0;0;0;0;0;0;0;0;0;ASIS. SALUD X CTA ASSISTIME;GARANTIAS
25792011;;M;26;HAITIANO;;Extranjero;N/D;N/D;0;0;0;0;0;0;0;0;0;ASIS. SALUD X CTA ASSISTIME;GARANTIAS
4500222;;M;81;CHILENO;;Silencioso;QUILPUE                       ;VALPARAISO;0;0;0;0;0;0;0;0;0;ASIS. SALUD X CTA ASSISTIME;GARANTIAS
26188150;;M;32;HAITIANO;;Extranjero;OSORNO                        ;LOS LAGOS;0;0;0;0;0;0;0;0;0;ASIS. SALUD X CTA ASSISTIME;GARANTIAS
14336157;;F;44;CHILENO;;X;SAN VICENTE                   ;L.G.B.OÂ´HIGGINS;0;0;0;0;0;0;0;0;0;ASIS. SALUD X CTA ASSISTIME;GARANTIAS
26869276;;M;26;VENEZOLANO;;Extranjero;N/D;N/D;0;0;0;0;0;0;0;0;0;ASIS. SALUD X CTA ASSISTIME;GARANTIAS
8182705;;F;63;CHILENO;;Boomers;RENCA                         ;METROPOLITANA;0;0;0;0;0;0;0;0;0;GPL 1A X CTA SBI;GARANTIAS
14077858;;F;40;CHILENO;;X;N/D;N/D;0;0;0;0;0;0;0;0;0;GPL 1A X CTA SBI;GARANTIAS
12069370;;F;55;CHILENO;;Boomers;COQUIMBO                      ;COQUIMBO;0;0;0;0;0;0;0;0;0;ASIS. SALUD X CTA ASSISTIME;GARANTIAS
15634902;;M;38;CHILENO;;Millenial;PROVIDENCIA                   ;METROPOLITANA;0;0;0;0;0;0;0;0;0;GM 1A X CTA SBI;GARANTIAS
26034646;;F;28;VENEZOLANO;;Extranjero;QUILPUE                       ;VALPARAISO;0;0;0;0;0;0;0;0;0;ASIS. SALUD X CTA ASSISTIME;GARANTIAS
21897488;;M;42;PERUANO;;Extranjero;ANTOFAGASTA                   ;ANTOFAGASTA;0;0;0;0;0;0;0;0;0;TARIFA NORMAL;GARANTIAS
12510565;;F;49;CHILENO;;X;LA PINTANA                    ;METROPOLITANA;0;0;0;0;0;0;0;0;0;ASIS. SALUD X CTA ASSISTIME;GARANTIAS
5677001;;F;75;CHILENO;;Silencioso;OVALLE                        ;COQUIMBO;0;0;0;0;0;0;0;0;0;ASIS. SALUD X CTA ASSISTIME;GARANTIAS
9885005;;F;60;CHILENO;;Boomers;NANCAGUA                      ;L.G.B.OÂ´HIGGINS;0;0;0;0;0;0;0;0;0;ASIS. SALUD X CTA ASSISTIME;GARANTIAS
5337741;;M;75;CHILENO;;Silencioso;CURANILAHUE                   ;BIO BIO;0;0;0;0;0;0;0;0;0;ASIS. SALUD X CTA ASSISTIME;GARANTIAS
18729180;Soltero;M;28;CHILENO;;Silencioso;PROVIDENCIA                   ;METROPOLITANA;0;0;0;0;0;0;0;0;0;GM 1A X CTA SBI;GARANTIAS
7014011;;F;60;CHILENO;;Boomers;SAN ANTONIO                   ;VALPARAISO;0;0;0;0;0;0;0;0;0;ASIS. SALUD X CTA ASSISTIME;GARANTIAS
10017221;;F;58;CHILENO;;Boomers;CALBUCO                       ;LOS LAGOS;0;0;0;0;0;0;0;0;0;ASIS. SALUD X CTA ASSISTIME;GARANTIAS
6207590;;M;71;CHILENO;;Silencioso;COIHAIQUE                     ;AYSEN;0;0;0;0;0;0;0;0;0;ASIS. SALUD X CTA ASSISTIME;GARANTIAS
6438764;;M;71;CHILENO;;Silencioso;CABILDO                       ;VALPARAISO;0;0;0;0;0;0;0;0;0;ASIS. SALUD X CTA ASSISTIME;GARANTIAS
9528523;;M;59;CHILENO;;Boomers;SAN CLEMENTE                  ;MAULE;0;0;0;0;0;0;0;0;0;ASIS. SALUD X CTA ASSISTIME;GARANTIAS
10632097;;F;59;CHILENO;;Boomers;LA LIGUA                      ;VALPARAISO;0;0;0;0;0;0;0;0;0;ASIS. SALUD X CTA ASSISTIME;GARANTIAS
7946267;;M;62;CHILENO;;Boomers;VICUNA                        ;COQUIMBO;0;0;0;0;0;0;0;0;0;ASIS. SALUD X CTA ASSISTIME;GARANTIAS
9568212;;F;61;CHILENO;;Boomers;PUERTO MONTT                  ;LOS LAGOS;0;0;0;0;0;0;0;0;0;ASIS. SALUD X CTA ASSISTIME;GARANTIAS
13109520;;F;46;CHILENO;;X;N/D;N/D;0;0;0;0;0;0;0;0;0;ASIS. SALUD X CTA ASSISTIME;GARANTIAS
7598944;;F;68;CHILENO;;Silencioso;CONSTITUCION                  ;MAULE;0;0;0;0;0;0;0;0;0;ASIS. SALUD X CTA ASSISTIME;GARANTIAS
10301546;;F;55;CHILENO;;Boomers;CHILLAN                       ;BIO BIO;0;0;0;0;0;0;0;0;0;ASIS. SALUD X CTA ASSISTIME;GARANTIAS
11569187;;M;52;CHILENO;;X;COIHUECO                      ;BIO BIO;0;0;0;0;0;0;0;0;0;GPL 1A X CTA SBI;GARANTIAS
7507818;;M;66;CHILENO;;Boomers;CURICO                        ;MAULE;0;0;0;0;0;0;0;0;0;ASIS. SALUD X CTA ASSISTIME;GARANTIAS
4257513;;F;89;CHILENO;;Silencioso;SANTIAGO                      ;METROPOLITANA;0;0;0;0;0;0;0;0;0;ASIS. SALUD X CTA ASSISTIME;GARANTIAS
13161815;;M;44;CHILENO;;X;VALDIVIA                      ;LOS LAGOS;0;0;0;0;0;0;0;0;0;ASIS. SALUD X CTA ASSISTIME;GARANTIAS
24721275;;M;51;PERUANO;;Extranjero;ANTOFAGASTA                   ;ANTOFAGASTA;566590;8;3;0;0;0;8;3;566590;CELULAR GALAXY A03 4+128GB BLACK OPEN;TELEFONIA
9106236;;M;61;CHILENO;;Boomers;CANETE                        ;BIO BIO;936940;5;4;0;0;0;5;4;936940;CELULAR GALAXY A33 5G 6+128GB LIGHT BLUE OPEN;TELEFONIA
25033874;;F;36;BOLIVIANO;;Extranjero;CALAMA                        ;ANTOFAGASTA;669380;9;5;0;0;0;9;5;669380;CELULAR GALAXY A03 64GB BLACK DIRECTO MOVISTAR;TELEFONIA
21625559;;M;72;NO INFORMA NACIONALIDAD;;Extranjero;SANTIAGO                      ;METROPOLITANA;1555022;10;4;0;0;0;10;4;1555022;CELULAR MOTO G50 AZUL 128 GB OPEN;TELEFONIA
8799352;Divorciado;M;58;CHILENO;;Boomers;RENCA                         ;METROPOLITANA;149990;1;1;0;0;0;1;1;149990;CELULAR MOTO G22 64GB AZUL OPEN;TELEFONIA
12786457;;M;47;CHILENO;;X;PICHIDEGUA                    ;L.G.B.OÂ´HIGGINS;89990;2;1;0;0;0;2;1;89990;CELULAR MOTO G31 4/128 GB GRIS METEORITO OPEN;TELEFONIA
4839326;;M;78;CHILENO;;Silencioso;ARICA                         ;ARICA Y PARINACOTA;99980;2;2;0;0;0;2;2;99980;CELULAR BMOBILE SENIORPHONE C40 GRIS WOM;TELEFONIA
11188240;;M;55;CHILENO;;Boomers;LOS VILOS                     ;COQUIMBO;204698;3;1;0;0;0;3;1;204698;CELULAR GALAXY A22 5G 4+128GB GRAY;TELEFONIA
20210559;;F;21;CHILENO;;Z;PROVIDENCIA                   ;METROPOLITANA;99990;1;1;1;1;99990;0;0;0;CELULAR REDMI 10A US 32GB CHROME SILVER OPEN;TELEFONIA
10677592;;F;54;CHILENO;;Boomers;SAN VICENTE                   ;L.G.B.OÂ´HIGGINS;1032950;8;4;0;0;0;8;4;1032950;CELULAR REDMI 10C 128GB GRAPHITE GRAY CLARO;TELEFONIA
16321626;;M;36;CHILENO;;Millenial;MELIPILLA;METROPOLITANA;189990;1;1;0;0;0;1;1;189990;CELULAR GALAXY A22 5G 4+128GB MINT;TELEFONIA
14010201;;F;41;CHILENO;;X;RENCA                         ;METROPOLITANA;249660;3;1;0;0;0;3;1;249660;CELULAR REDMI 10C EU 4GB+128GB GRAPHITE GRAY OPE;TELEFONIA
17455222;Casado;M;32;CHILENO;;Millenial;PROVIDENCIA                   ;METROPOLITANA;109990;1;1;0;0;0;1;1;109990;CELULAR REDMI 9C 64GB SUNRISE ORANGE;TELEFONIA
15497186;;F;39;CHILENO;;X;PROVIDENCIA                   ;METROPOLITANA;225010;3;1;0;0;0;3;1;225010;CELULAR REDMI 10C EU 4GB+128GB GRAPHITE GRAY OPE;TELEFONIA
14353096;;M;43;CHILENO;;X;LA LIGUA                      ;VALPARAISO;406970;3;2;3;2;406970;0;0;0;CELULAR A52 128 GB BLACK OPEN;TELEFONIA
8998032;;F;63;CHILENO;;Boomers;N/D;N/D;2189460;22;8;0;0;0;22;8;2189460;CELULAR XIAOMI REDMI 9A 2/32GB GRANITE GRAY;TELEFONIA
15786937;;F;38;CHILENO;;Millenial;SAN RAMON                     ;METROPOLITANA;627190;8;4;4;2;293970;4;2;333220;CELULAR GALAXY A23 6+128GB LIGHT BLUE OPEN;TELEFONIA
10421351;;F;56;CHILENO;;Boomers;ARICA                         ;TARAPACA;1946810;19;16;0;0;0;19;16;1946810;CELULAR GALAXY A03 4+64GB BLACK OPEN;TELEFONIA
13742133;;F;43;CHILENO;;X;IQUIQUE                       ;TARAPACA;700120;6;3;0;0;0;6;3;700120;CELULAR GALAXY A73 5G 128GB WHITE OPEN;TELEFONIA
6471475;;F;69;CHILENO;;Silencioso;TOCOPILLA                     ;ANTOFAGASTA;3111100;15;10;0;0;0;15;10;3111100;CELULAR GALAXY A13 4+128GB BLACK;TELEFONIA
11456226;;M;53;CHILENO;;X;MOLINA                        ;MAULE;124290;2;1;0;0;0;2;1;124290;CELULAR XIAOMI REDMI 9A 2/32GB GRANITE GRAY;TELEFONIA
16887712;;M;34;CHILENO;;Millenial;N/D;N/D;179640;2;1;0;0;0;2;1;179640;CELULAR MOTOROLA G20 64GB BLUE CLARO;TELEFONIA
8982751;;M;61;CHILENO;;Boomers;VALPARAISO                    ;VALPARAISO;1003050;7;4;0;0;0;7;4;1003050;CELULAR GALAXY A03 4+64GB BLUE OPEN;TELEFONIA
16684471;;F;34;CHILENO;;Millenial;RENCA                         ;METROPOLITANA;239990;1;1;1;1;239990;0;0;0;CELULAR GALAXY A33 5G 6+128GB LIGHT BLUE OPEN;TELEFONIA
19971004;;M;23;CHILENO;;Z;PROVIDENCIA                   ;METROPOLITANA;569940;7;4;0;0;0;7;4;569940;CELULAR GALAXY A53 5G 6+128GB BLACK;TELEFONIA
18401055;;F;29;CHILENO;;Millenial;BUIN                          ;METROPOLITANA;774399;5;4;0;0;0;5;4;774399;CELULAR MOTO G51 5G 4/128 GB AZUL OPEN;TELEFONIA
14012086;;F;41;CHILENO;;X;RENCA                         ;METROPOLITANA;274970;4;2;0;0;0;4;2;274970;CELULAR GALAXY A03 4+64GB BLACK OPEN;TELEFONIA
18986942;;F;27;CHILENO;;Millenial;CURANILAHUE                   ;BIO BIO;837540;3;1;0;0;0;3;1;837540;CELULAR GALAXY A73 5G 256GB GRAY OPEN;TELEFONIA
12980603;;M;46;CHILENO;;X;LOS ANGELES                   ;BIO BIO;324990;1;1;0;0;0;1;1;324990;CELULAR MOTO G100 128GB VERDE BOREAL + HMDI OPEN;TELEFONIA
8149102;;F;64;CHILENO;;Boomers;IQUIQUE                       ;TARAPACA;179990;2;1;0;0;0;2;1;179990;CELULAR VIVO Y21S PEARL WHITE 128 GB OPEN;TELEFONIA
18993008;;F;27;CHILENO;;Z;ALTO HOSPICIO;TARAPACA;110140;2;1;0;0;0;2;1;110140;CELULAR REDMI NOTE 9 128G FOREST GREEN OPEN;TELEFONIA
13778129;;F;42;CHILENO;;X;"";"";99990;1;1;1;1;99990;0;0;0;CELULAR Moto G20 Blue WOM;TELEFONIA
17212192;;F;32;CHILENO;;Millenial;CONSTITUCION                  ;MAULE;514970;3;3;1;1;179990;2;2;334980;CELULAR MOTO E6I 32GB GRIS OPEN;TELEFONIA
17242238;;M;33;CHILENO;;Millenial;LA PINTANA                    ;METROPOLITANA;104276;3;1;0;0;0;3;1;104276;CELULAR VIVO Y15S WAVE GREEN OPEN;TELEFONIA
15887141;;M;38;CHILENO;;Millenial;ILLAPEL                       ;COQUIMBO;1403910;9;8;2;1;261980;7;7;1141930;CELULAR VIVO Y21S 128GB BLANCO WOM;TELEFONIA
17986496;;F;30;CHILENO;;Millenial;PROVIDENCIA                   ;METROPOLITANA;116800;3;1;0;0;0;3;1;116800;CELULAR GALAXY A03 4+128GB BLACK OPEN;TELEFONIA
12691848;;M;48;CHILENO;;X;MOSTAZAL                      ;L.G.B.OÂ´HIGGINS;434639;5;2;0;0;0;5;2;434639;CELULAR MOTOROLA G50 128GB AZUL CLARO;TELEFONIA
6631342;;M;65;CHILENO;;Boomers;RENCA                         ;METROPOLITANA;179990;1;1;1;1;179990;0;0;0;CELULAR GALAXY A23 6+128GB BLACK OPEN;TELEFONIA
11018562;Soltero;F;57;CHILENO;CONTADOR GENERAL;Boomers;RENCA                         ;METROPOLITANA;266551;3;1;0;0;0;3;1;266551;CELULAR VIVO V21 5G 128GB SUNSET DAZZLE OPEN;TELEFONIA
26725751;;M;29;VENEZOLANO;;Extranjero;ESTACION CENTRAL              ;METROPOLITANA;99990;1;1;0;0;0;1;1;99990;CELULAR XIAOMI REDMI 9A 2/32GB GRANITE GRAY;TELEFONIA
13978706;;M;40;CHILENO;;X;CANELA                        ;COQUIMBO;898550;9;5;0;0;0;9;5;898550;CELULAR A32 128 GB LIGHT VIOLET OPEN;TELEFONIA
9411256;;M;57;CHILENO;;Boomers;PROVIDENCIA                   ;METROPOLITANA;249660;3;2;0;0;0;3;2;249660;CELULAR GALAXY A03 4+64GB BLUE OPEN;TELEFONIA
19895035;;M;24;CHILENO;;Z;PROVIDENCIA                   ;METROPOLITANA;349970;3;2;3;2;349970;0;0;0;CELULAR VIVO Y53S FANTASTIC RAINBOW 128GB OPEN;TELEFONIA
13792074;;F;47;CHILENO;;X;CAUQUENES                     ;MAULE;649980;2;2;0;0;0;2;2;649980;CELULAR GALAXY A23 6+128GB BLACK OPEN;TELEFONIA
16510191;Soltero;F;35;CHILENO;;Millenial;PROVIDENCIA                   ;METROPOLITANA;456980;2;1;2;1;456980;0;0;0;CELULAR XIAOMI 11T PRO 8/256GB CELESTIAL BLUE OP;TELEFONIA
10014722;;F;56;CHILENO;;Boomers;ARAUCO                        ;BIO BIO;199990;2;1;0;0;0;2;1;199990;CELULAR A32 128 GB BLUE OPEN;TELEFONIA
10350771;;F;55;CHILENO;;Boomers;LA PINTANA                    ;METROPOLITANA;268620;4;2;0;0;0;4;2;268620;CELULAR VIVO Y21S 128GB BLANCO WOM;TELEFONIA
9991169;;F;57;CHILENO;;Boomers;CANETE                        ;BIO BIO;369990;1;1;0;0;0;1;1;369990;CELULAR GALAXY A53 5G 6+128GB ORANGE;TELEFONIA
15359129;Casado;F;39;CHILENO;PROFESOR;Silencioso;PROVIDENCIA                   ;METROPOLITANA;283970;3;1;3;1;283970;0;0;0;CELULAR MOTO G31 4/128 GB GRIS METEORITO OPEN;TELEFONIA
7229142;;M;64;CHILENO;;Boomers;ILLAPEL                       ;COQUIMBO;284640;5;3;0;0;0;5;3;284640;CELULAR SAMSUNG A03 64GB NEGRO WOM;TELEFONIA
10149338;;F;59;CHILENO;;Boomers;LA LIGUA                      ;VALPARAISO;190010;2;1;0;0;0;2;1;190010;CELULAR VIVO Y15S WAVE GREEN OPEN;TELEFONIA
4686509;;M;78;CHILENO;;Silencioso;LA LIGUA                      ;VALPARAISO;89990;1;1;0;0;0;1;1;89990;CELULAR REDMI 9A 32GB AURORA GREEN OPEN;TELEFONIA
4853409;;M;79;CHILENO;;Silencioso;RENCA                         ;METROPOLITANA;39990;1;1;0;0;0;1;1;39990;CELULAR BMOBILE W41 AZUL 32GB OPEN;TELEFONIA
16115298;Soltero;F;37;CHILENO;;Millenial;PROVIDENCIA                   ;METROPOLITANA;489950;6;2;2;1;280980;4;1;208970;CELULAR MOTO G60 128GB NEGRO MOVISTAR;TELEFONIA
10320931;;F;58;CHILENO;;Boomers;PUQUELDON                     ;LOS LAGOS;201472;3;2;0;0;0;3;2;201472;CELULAR VIVO Y01 AZUL ZAFIRO OPEN;TELEFONIA
24402499;Soltero;F;65;PERUANO;;Extranjero;PROVIDENCIA                   ;METROPOLITANA;329980;2;2;2;2;329980;0;0;0;CELULAR GALAXY A23 6+128GB BLACK OPEN;TELEFONIA
18971120;;F;27;CHILENO;;Millenial;SALAMANCA                     ;COQUIMBO;149640;2;1;0;0;0;2;1;149640;CELULAR VIVO Y01 AZUL ZAFIRO OPEN;TELEFONIA
19380510;;F;25;CHILENO;;Z;ANGOL                         ;ARAUCANIA;508970;3;2;0;0;0;3;2;508970;CELULAR GALAXY A53 5G 6+128GB WHITE;TELEFONIA
26401700;;M;31;VENEZOLANO;;Extranjero;"";"";183980;2;1;2;1;183980;0;0;0;CELULAR XIAOMI REDMI NOTE 10S BLANCO WOM;TELEFONIA
17968517;Soltero;F;29;CHILENO;;Millenial;PROVIDENCIA                   ;METROPOLITANA;169990;1;1;1;1;169990;0;0;0;CELULAR MOTOROLA G50 128GB AZUL CLARO;TELEFONIA
6801056;;M;70;CHILENO;;Silencioso;CALBUCO                       ;LOS LAGOS;841430;9;6;0;0;0;9;6;841430;CELULAR MOTO E7 32GB GRIS OPEN;TELEFONIA
19944028;;M;24;CHILENO;;Z;LOS ANGELES                   ;BIO BIO;179980;3;2;0;0;0;3;2;179980;CELULAR MOTO G22 128GB NEGRO WOM;TELEFONIA
5901509;;F;73;CHILENO;;Silencioso;HIJUELAS                      ;VALPARAISO;889620;14;8;0;0;0;14;8;889620;CELULAR BMOBILE AX1076 PRO BUNDLE;TELEFONIA
13330685;;M;44;CHILENO;;X;MONTE PATRIA                  ;COQUIMBO;129290;2;1;0;0;0;2;1;129290;CELULAR GALAXY A03 CORE 2GB 32GB BLUE OPEN;TELEFONIA
17037509;;F;35;CHILENO;;Millenial;CHIGUAYANTE;BIO-BIO;39990;2;1;0;0;0;2;1;39990;CELULAR Moto G20 Blue WOM;TELEFONIA
19767082;;F;24;CHILENO;;Z;CAUQUENES;MAULE;466970;3;2;3;2;466970;0;0;0;CELULAR A32 128 GB BLACK OPEN;TELEFONIA
18076661;;M;30;CHILENO;;Millenial;SAN MIGUEL                    ;METROPOLITANA;383970;5;2;5;2;383970;0;0;0;CELULAR GALAXY A33 5G 6+128GB BLACK OPEN;TELEFONIA
27119130;;M;25;VENEZOLANO;;Extranjero;N/D;N/D;169990;1;1;1;1;169990;0;0;0;CELULAR VIVO Y21S 128GB BLANCO WOM;TELEFONIA
17930620;Soltero;F;31;CHILENO;;Millenial;CHEPICA                       ;L.G.B.OÂ´HIGGINS;287950;5;4;4;3;286960;1;1;990;CELULAR SAMSUNG A03 CORE 32GB BLACK CLARO;TELEFONIA
14045242;;F;41;CHILENO;;X;CURICO                        ;MAULE;127979;2;1;0;0;0;2;1;127979;CELULAR XIAOMI REDMI 9A 2/32GB GRANITE GRAY;TELEFONIA
15253170;;F;39;CHILENO;;X;N/D;N/D;256670;9;6;0;0;0;9;6;256670;Celular 2.3 MOVISTAR DIRECTO CHARCOAL;TELEFONIA
12951046;;F;46;CHILENO;;X;NOGALES                       ;VALPARAISO;438970;3;4;0;0;0;3;4;438970;CELULAR A32 128 GB LIGHT VIOLET OPEN;TELEFONIA
12983177;;M;45;CHILENO;;X;CURANILAHUE                   ;BIO BIO;149990;1;1;1;1;149990;0;0;0;CELULAR GALAXY A23 6+128GB BLACK OPEN;TELEFONIA
16102318;;M;36;CHILENO;;Millenial;COIHAIQUE                     ;AYSEN;169980;2;1;0;0;0;2;1;169980;CELULAR REDMI 10A US 64GB GRAPHITE GRAY OPEN;TELEFONIA
18200535;Casado;F;29;CHILENO;PROFESOR;Millenial;COIHAIQUE                     ;AYSEN;464980;2;2;0;0;0;2;2;464980;CELULAR SAMSUNG A23 128GB BLACK CLARO;TELEFONIA
7324867;;F;67;CHILENO;;Boomers;CALERA DE TANGO               ;METROPOLITANA;770170;11;5;0;0;0;11;5;770170;CELULAR SAMSUNG A23 128GB BLACK CLARO;TELEFONIA
14308889;;M;46;CHILENO;;X;CALAMA                        ;ANTOFAGASTA;121980;3;2;0;0;0;3;2;121980;CELULAR VIVO Y01 AZUL ZAFIRO OPEN;TELEFONIA
11727507;;M;51;CHILENO;;X;COMBARBALA                    ;COQUIMBO;425210;5;3;0;0;0;5;3;425210;CELULAR GALAXY A13 4+128GB LIGHT BLUE OPEN;TELEFONIA
10450164;;M;54;CHILENO;;X;PUNTA ARENAS                  ;MAGALLANES;199990;1;1;0;0;0;1;1;199990;CELULAR MOTO G60 128GB NEGRO MOVISTAR;TELEFONIA
16044098;;F;37;CHILENO;;Millenial;COLINA;METROPOLITANA;473970;3;2;2;1;373980;1;1;99990;CELULAR Moto E7 Rosado WOM;TELEFONIA
17247284;;M;32;CHILENO;;Millenial;SAN BERNARDO                  ;METROPOLITANA;611930;6;4;0;0;0;6;4;611930;CELULAR SAMSUNG A52s 128GB BLACK CLARO;TELEFONIA
11410808;;F;53;CHILENO;;X;PROVIDENCIA                   ;METROPOLITANA;74990;2;1;0;0;0;2;1;74990;CELULAR XIAOMI REDMI 9A 2/32GB GRANITE GRAY;TELEFONIA
7237267;;F;68;CHILENO;;Silencioso;TALAGANTE                     ;METROPOLITANA;139970;3;2;0;0;0;3;2;139970;CELULAR GALAXY A03 CORE 2GB 32GB BLUE OPEN;TELEFONIA
10412952;;F;57;CHILENO;;Boomers;TOCOPILLA                     ;ANTOFAGASTA;496090;3;2;0;0;0;3;2;496090;CELULAR A52 128 GB BLACK OPEN;TELEFONIA
19000703;;F;27;CHILENO;;Millenial;PROVIDENCIA                   ;METROPOLITANA;246960;5;6;0;0;0;5;6;246960;CELULAR REDMI NOTE 11 4/128GB TWILIGHT BLUE OPEN;TELEFONIA
10636679;;F;57;CHILENO;;Boomers;QUILLOTA                      ;VALPARAISO;1301402;8;5;0;0;0;8;5;1301402;CELULAR VIVO Y53S FANTASTIC RAINBOW 128GB OPEN;TELEFONIA
13844365;;F;42;CHILENO;;X;"";"";980;2;1;0;0;0;2;1;980;CHIP OPEN ENTEL;TELEFONIA
20207836;;M;22;CHILENO;;Z;LA SERENA;COQUIMBO;378960;4;2;4;2;378960;0;0;0;CELULAR GALAXY A13 4+128GB LIGHT BLUE OPEN;TELEFONIA
18079224;;M;30;CHILENO;;Millenial;PROVIDENCIA                   ;METROPOLITANA;173980;2;1;2;1;173980;0;0;0;CELULAR HUAWEI Y9A BLACK OPEN;TELEFONIA
13150339;;F;45;CHILENO;;X;CANETE                        ;BIO BIO;89990;1;1;0;0;0;1;1;89990;CELULAR Moto E7 Rosado WOM;TELEFONIA
10372396;;F;57;CHILENO;;Boomers;RANCAGUA                      ;L.G.B.OÂ´HIGGINS;149990;2;1;0;0;0;2;1;149990;CELULAR GALAXY A22 5G 4+128GB GRAY;TELEFONIA
7561765;Soltero;M;67;CHILENO;AGRONOMO;Boomers;NUEVA IMPERIAL                ;ARAUCANIA;106220;3;1;0;0;0;3;1;106220;CELULAR SAMSUNG GALAXY A03 CORE AZUL WOM;TELEFONIA
12237886;;F;50;CHILENO;;X;NUNOA                         ;METROPOLITANA;589980;2;2;0;0;0;2;2;589980;CELULAR GALAXY A53 5G 6+128GB ORANGE;TELEFONIA
25406445;;F;33;BOLIVIANO;;Extranjero;N/D;N/D;652961;6;3;0;0;0;6;3;652961;CELULAR GALAXY A22 5G 4+128GB GRAY;TELEFONIA
14231331;;F;53;CHILENO;;X;LOTA                          ;BIO BIO;200640;6;2;0;0;0;6;2;200640;CELULAR VIVO Y21S 128GB BLANCO WOM;TELEFONIA
15757529;;F;38;CHILENO;;Millenial;DALCAHUE                      ;LOS LAGOS;129990;1;1;0;0;0;1;1;129990;CELULAR REDMI NOTE 11 4/128GB TWILIGHT BLUE OPEN;TELEFONIA
12494636;;F;48;CHILENO;;X;PROVIDENCIA                   ;METROPOLITANA;903980;2;1;2;1;903980;0;0;0;CELULAR GALAXY S22 ULTRA BURGUNDY 128GB;TELEFONIA
12865658;;M;47;CHILENO;;X;OVALLE                        ;COQUIMBO;149990;2;1;0;0;0;2;1;149990;CELULAR GALAXY A22 5G 4+128GB GRAY;TELEFONIA
10451143;;F;58;CHILENO;;Boomers;CHIMBARONGO                   ;L.G.B.OÂ´HIGGINS;646230;5;3;0;0;0;5;3;646230;CELULAR VIVO V21 5G 128GB SUNSET DAZZLE OPEN;TELEFONIA
16028906;;M;37;CHILENO;;Millenial;CERRILLOS;METROPOLITANA;99990;1;1;1;1;99990;0;0;0;CELULAR A16 PEARL BLUE 64GB;TELEFONIA
19985228;;F;23;CHILENO;;Z;PROVIDENCIA                   ;METROPOLITANA;299980;2;2;2;2;299980;0;0;0;CELULAR GALAXY A53 5G 6+128GB ORANGE;TELEFONIA
10481480;;M;55;CHILENO;;Boomers;CORONEL                       ;BIO BIO;954210;9;4;0;0;0;9;4;954210;CELULAR GALAXY A53 5G 6+128GB ORANGE;TELEFONIA
13811905;;F;43;CHILENO;;X;NUEVA IMPERIAL                ;ARAUCANIA;281386;7;5;0;0;0;7;5;281386;CELULAR VIVO Y15S WAVE GREEN OPEN;TELEFONIA
8929958;;F;64;CHILENO;;Boomers;BUIN                          ;METROPOLITANA;405840;5;3;0;0;0;5;3;405840;CELULAR GALAXY A13 4+128GB LIGHT BLUE OPEN;TELEFONIA
10674108;;F;53;CHILENO;;X;SAN PEDRO DE LA PAZ           ;BIO BIO;395980;2;1;2;1;395980;0;0;0;CELULAR XIAOMI 11T PRO 8/256GB CELESTIAL BLUE OP;TELEFONIA
7262393;;F;64;CHILENO;;Boomers;RETIRO                        ;MAULE;666950;5;3;5;3;666950;0;0;0;CELULAR SAMSUNG A03 64GB NEGRO WOM;TELEFONIA
19140008;Soltero;M;26;CHILENO;;Z;CONCEPCION                    ;BIO BIO;181970;3;1;3;1;181970;0;0;0;Celular Y8P ENTEL TRIANGULADO NEGRO;TELEFONIA
17867348;;M;31;CHILENO;;Millenial;PROVIDENCIA                   ;METROPOLITANA;119990;1;1;0;0;0;1;1;119990;CELULAR Moto G20 Rosado WOM;TELEFONIA
19369149;;F;25;CHILENO;;Z;PROVIDENCIA                   ;METROPOLITANA;203561;3;1;0;0;0;3;1;203561;CELULAR VIVO V21 5G 128GB SUNSET DAZZLE OPEN;TELEFONIA
9906111;Divorciado;M;58;CHILENO;;Boomers;PROVIDENCIA                   ;METROPOLITANA;443970;3;1;3;1;443970;0;0;0;CELULAR SAMSUNG A52s 128GB BLACK CLARO;TELEFONIA
23240548;;M;37;PERUANO;;Extranjero;ANTOFAGASTA                   ;ANTOFAGASTA;500620;3;2;0;0;0;3;2;500620;CELULAR MOTO G100 128GB VERDE BOREAL + HMDI OPEN;TELEFONIA
11959660;;F;49;CHILENO;;X;SAN BERNARDO                  ;METROPOLITANA;130140;2;1;0;0;0;2;1;130140;CELULAR MOTOROLA E30 GRIS CLARO;TELEFONIA
18853381;;F;27;CHILENO;;Millenial;CATEMU;VALPARAISO;137123;4;2;0;0;0;4;2;137123;CELULAR VIVO Y21S PEARL WHITE 128 GB OPEN;TELEFONIA
15526033;;F;39;CHILENO;;X;RENGO                         ;L.G.B.OÂ´HIGGINS;109990;1;1;0;0;0;1;1;109990;CELULAR VIVO Y01 AZUL ZAFIRO OPEN;TELEFONIA
5539263;Viudo;M;74;CHILENO;;Silencioso;ALTO HOSPICIO;TARAPACA;372201;7;4;0;0;0;7;4;372201;CELULAR REDMI 9C 64GB SUNRISE ORANGE;TELEFONIA
7729260;;M;63;CHILENO;;Boomers;RENGO                         ;L.G.B.OÂ´HIGGINS;472220;5;2;0;0;0;5;2;472220;IPHONE XR 64GB LIB OPEN NEGRO;TELEFONIA
7246975;;M;70;CHILENO;;Silencioso;NUEVA IMPERIAL                ;ARAUCANIA;429113;4;2;0;0;0;4;2;429113;CELULAR VIVO Y21S PEARL WHITE 128 GB OPEN;TELEFONIA
17016568;;F;33;CHILENO;;Millenial;"";"";1815137;53;33;0;0;0;53;33;1815137;CHIP OPEN ENTEL;TELEFONIA
14215654;;F;40;CHILENO;;Extranjero;PROVIDENCIA                   ;METROPOLITANA;663970;3;2;2;1;393980;1;1;269990;IPHONE 11 64GB BLACK CLARO;TELEFONIA
12777699;;M;55;CHILENO;;Boomers;N/D;N/D;673940;5;4;0;0;0;5;4;673940;CELULAR GALAXY A22 5G 4+128GB GRAY;TELEFONIA
18704434;;F;28;CHILENO;;Millenial;PROVIDENCIA                   ;METROPOLITANA;179990;1;1;1;1;179990;0;0;0;CELULAR REDMI 10C EU 4GB+128GB GRAPHITE GRAY OPE;TELEFONIA
10574251;;F;53;CHILENO;;X;EL MONTE                      ;METROPOLITANA;159250;2;1;0;0;0;2;1;159250;CELULAR REDMI 10A US 32GB CHROME SILVER OPEN;TELEFONIA
11451533;Casado;M;53;CHILENO;;X;PROVIDENCIA                   ;METROPOLITANA;349980;3;2;0;0;0;3;2;349980;CELULAR VIVO Y53S FANTASTIC RAINBOW 128GB OPEN;TELEFONIA
10858584;Casado;M;49;CHILENO;;X;RENCA                         ;METROPOLITANA;209990;2;1;0;0;0;2;1;209990;CELULAR REDMI NOTE 10 PRO 6+128GB GRADIENT BRONZ;TELEFONIA
12420533;Casado;M;49;CHILENO;;X;RENCA                         ;METROPOLITANA;128810;2;1;0;0;0;2;1;128810;CELULAR SAMSUNG A03 CORE 32GB BLACK CLARO;TELEFONIA
17980278;;M;30;CHILENO;;Millenial;COQUIMBO;COQUIMBO;980;2;1;0;0;0;2;1;980;CHIP OPEN ENTEL;TELEFONIA
17152422;;M;33;CHILENO;;Millenial;PUENTE ALTO;METROPOLITANA;457950;6;3;6;3;457950;0;0;0;CELULAR 11 LITE 5G NE 8/128GB PEACH PINK OPEN;TELEFONIA
11716031;Casado;M;51;CHILENO;;X;CALBUCO                       ;LOS LAGOS;129990;1;1;0;0;0;1;1;129990;CELULAR GALAXY A13 4+128GB BLACK;TELEFONIA
6340925;;F;73;CHILENO;;Silencioso;SAN VICENTE                   ;L.G.B.OÂ´HIGGINS;159980;3;2;0;0;0;3;2;159980;CELULAR REDMI 10C 128GB GRAPHITE GRAY CLARO;TELEFONIA
14400340;;F;43;CHILENO;;X;VICUNA                        ;COQUIMBO;598970;5;2;0;0;0;5;2;598970;CELULAR GALAXY A53 5G 6+128GB ORANGE;TELEFONIA
10579218;;F;55;CHILENO;;Boomers;PROVIDENCIA                   ;METROPOLITANA;59980;4;1;0;0;0;4;1;59980;CELULAR SAMSUNG A03 64GB NEGRO WOM;TELEFONIA
10132211;;M;58;CHILENO;;Boomers;SANTA CRUZ                    ;L.G.B.OÂ´HIGGINS;520820;6;4;0;0;0;6;4;520820;CELULAR SAMSUNG GALAXY A03 CORE 32GB NEGRO WOM;TELEFONIA
11490831;Casado;M;52;CHILENO;;X;PROVIDENCIA                   ;METROPOLITANA;557950;6;3;0;0;0;6;3;557950;CELULAR MOTO G30 128GB GRIS TORNASOL OPEN;TELEFONIA
26407940;Soltero;M;28;EXTRANJERO - NO INFORMA NACIONALIDAD;;Extranjero;N/D;N/D;996920;8;4;8;4;996920;0;0;0;CELULAR MOTO G60 4/128 GB NEGRO OPEN;TELEFONIA
18035310;;M;30;CHILENO;;Millenial;N/D;N/D;249990;1;1;1;1;249990;0;0;0;CELULAR GALAXY A33 5G 6+128GB BLACK OPEN;TELEFONIA
17555029;;M;30;CHILENO;;Millenial;N/D;N/D;1532410;9;4;0;0;0;9;4;1532410;CELULAR VIVO Y11S NEGRO WOM;TELEFONIA
20157553;;F;23;CHILENO;;Z;N/D;N/D;313120;4;2;0;0;0;4;2;313120;CELULAR REDMI NOTE 11S 128GB GRAPHITE GRAY;TELEFONIA
10870696;;F;54;CHILENO;;X;LA PINTANA                    ;METROPOLITANA;159990;1;1;0;0;0;1;1;159990;CELULAR GALAXY A13 4+128GB WHITE OPEN;TELEFONIA
10040089;;M;57;CHILENO;;Boomers;NACIMIENTO                    ;BIO BIO;156110;3;2;0;0;0;3;2;156110;CELULAR GALAXY A03 4+128GB BLACK OPEN;TELEFONIA
16675879;;M;34;CHILENO;;Silencioso;PROVIDENCIA                   ;METROPOLITANA;879820;4;2;4;2;879820;0;0;0;CELULAR GALAXY A73 5G 128GB GRAY OPEN;TELEFONIA
13901031;;M;41;CHILENO;;X;CAUQUENES                     ;MAULE;89990;1;1;0;0;0;1;1;89990;CELULAR REDMI 9C 64GB SUNRISE ORANGE;TELEFONIA
15780544;;M;38;CHILENO;;Millenial;RENCA                         ;METROPOLITANA;129990;1;1;0;0;0;1;1;129990;CELULAR GALAXY A13 4+128GB LIGHT BLUE OPEN;TELEFONIA
16579120;;F;35;CHILENO;;Millenial;VICTORIA                      ;ARAUCANIA;113536;3;1;0;0;0;3;1;113536;CELULAR VIVO Y15S WAVE GREEN OPEN;TELEFONIA
16124727;;M;37;CHILENO;;Millenial;PUTAENDO                      ;VALPARAISO;365950;4;2;2;1;146980;2;1;218970;CELULAR GALAXY A22 5G 4+128GB GRAY;TELEFONIA
13124408;Divorciado;F;47;CHILENO;;X;RENCA                         ;METROPOLITANA;89123;3;1;0;0;0;3;1;89123;CELULAR VIVO Y21S 128GB BLANCO WOM;TELEFONIA
14333613;;F;44;CHILENO;;X;ANGOL                         ;ARAUCANIA;667960;4;3;2;1;247980;2;2;419980;CELULAR GALAXY A53 5G 6+128GB BLUE;TELEFONIA
16032206;;M;37;CHILENO;;Millenial;"";"";64980;3;2;0;0;0;3;2;64980;CELULAR REDMI 9C 64GB SUNRISE ORANGE;TELEFONIA
7276592;Viudo;F;71;CHILENO;;Silencioso;TEMUCO                        ;ARAUCANIA;904073;10;5;0;0;0;10;5;904073;CELULAR VIVO Y21S 128GB BLANCO WOM;TELEFONIA
10290799;;F;57;CHILENO;;Boomers;CONCEPCION                    ;BIO BIO;484952;6;5;0;0;0;6;5;484952;CELULAR VIVO Y21S MIDNIGHT BLUE 128 GB OPEN;TELEFONIA
17835737;;M;31;CHILENO;;Millenial;PROVIDENCIA                   ;METROPOLITANA;308900;15;10;0;0;0;15;10;308900;CELULAR SAMSUNG GALAXY A03 CORE AZUL WOM;TELEFONIA
10323167;;F;55;CHILENO;;Boomers;ARICA                         ;ARICA Y PARINACOTA;139820;4;3;0;0;0;4;3;139820;CELULAR BMOBILE C40 CRIS OPEN;TELEFONIA
11847221;;M;50;CHILENO;;X;LA PINTANA                    ;METROPOLITANA;915570;10;5;0;0;0;10;5;915570;CELULAR GALAXY A53 5G 6+128GB BLACK;TELEFONIA
17346859;;M;32;CHILENO;;Millenial;CONCEPCION;BIO-BIO;757980;4;2;4;2;757980;0;0;0;CELULAR GALAXY S22+ WHITE 128GB;TELEFONIA
18516089;;M;28;CHILENO;;Millenial;NANCAGUA                      ;L.G.B.OÂ´HIGGINS;51840;2;1;0;0;0;2;1;51840;CELULAR BMOBILE C40 CRIS OPEN;TELEFONIA
18894599;;F;27;CHILENO;;Millenial;CONSTITUCION                  ;MAULE;439990;1;1;0;0;0;1;1;439990;CELULAR SAMSUNG S21 FE 128GB LIGHT GREEN OPEN;TELEFONIA
24831315;;F;58;BOLIVIANO;;Extranjero;RECOLETA                      ;METROPOLITANA;159250;2;1;0;0;0;2;1;159250;CELULAR Moto G20 Rosado WOM;TELEFONIA
14215857;;F;45;CHILENO;;X;TILTIL                        ;METROPOLITANA;204980;2;2;0;0;0;2;2;204980;CELULAR VIVO Y15S WAVE GREEN OPEN;TELEFONIA
10979439;;F;57;CHILENO;;Boomers;TALCA                         ;MAULE;708930;7;5;2;1;131980;5;4;576950;CELULAR GALAXY A53 5G 6+128GB BLACK;TELEFONIA
12332309;Soltero;F;48;CHILENO;;X;PROVIDENCIA                   ;METROPOLITANA;159250;2;1;0;0;0;2;1;159250;CELULAR SAMSUNG A03 128GB BLACK CLARO;TELEFONIA
7955861;;M;65;CHILENO;;Boomers;QUILPUE                       ;VALPARAISO;239960;4;3;0;0;0;4;3;239960;SMARTPHONE A03s 64 GB Red DS;TELEFONIA
14224256;;M;49;CHILENO;;X;TEMUCO                        ;ARAUCANIA;100760;2;1;0;0;0;2;1;100760;CELULAR Moto E7 Rosado WOM;TELEFONIA
16521983;;M;35;CHILENO;;Millenial;CHIMBARONGO                   ;L.G.B.OÂ´HIGGINS;196240;2;3;0;0;0;2;3;196240;CELULAR MOTOROLA G20 EDICION ESPECIAL VERDE CLAR;TELEFONIA
14107252;;M;41;CHILENO;;X;N/D;N/D;257550;3;2;0;0;0;3;2;257550;CELULAR POCO M4 PRO 128GB COOL BLUE OPEN;TELEFONIA
7112712;;F;67;CHILENO;;Boomers;CHILLAN                       ;BIO BIO;159990;1;1;0;0;0;1;1;159990;CELULAR GALAXY A13 4+128GB LIGHT BLUE OPEN;TELEFONIA
18270276;;M;29;CHILENO;;Millenial;VINA DEL MAR                  ;VALPARAISO;209990;1;1;0;0;0;1;1;209990;CELULAR GALAXY A23 6+128GB LIGHT BLUE OPEN;TELEFONIA
12384945;Casado;M;48;CHILENO;;X;RENCA                         ;METROPOLITANA;173750;3;2;0;0;0;3;2;173750;CELULAR REDMI 9C 64GB SUNRISE ORANGE;TELEFONIA
19156353;;F;24;CHILENO;;Z;PROVIDENCIA                   ;METROPOLITANA;179990;1;1;0;0;0;1;1;179990;CELULAR XIAOMI REDMI NOTE 10S BLANCO WOM;TELEFONIA
17400094;;F;31;CHILENO;;Millenial;LUMACO                        ;ARAUCANIA;158970;3;2;0;0;0;3;2;158970;CELULAR VIVO Y01 AZUL ZAFIRO OPEN;TELEFONIA
5954055;;M;74;CHILENO;;Silencioso;MEJILLONES                    ;ANTOFAGASTA;456200;7;4;0;0;0;7;4;456200;CELULAR GALAXY A03 4+64GB BLACK OPEN;TELEFONIA
10378656;;M;56;CHILENO;;Boomers;HUALQUI                       ;BIO BIO;1220790;11;5;0;0;0;11;5;1220790;CELULAR GALAXY A22 5G 4+128GB GRAY;TELEFONIA
8025798;;M;62;CHILENO;;Boomers;PROVIDENCIA                   ;METROPOLITANA;193980;2;1;2;1;193980;0;0;0;CELULAR A52 128 GB BLACK OPEN;TELEFONIA
14230060;;F;54;CHILENO;;X;CABILDO                       ;VALPARAISO;522230;4;2;0;0;0;4;2;522230;CELULAR REDMI 10A US 64GB GRAPHITE GRAY OPEN;TELEFONIA
8215348;;M;65;CHILENO;;Boomers;PROVIDENCIA                   ;N/D;127980;2;2;0;0;0;2;2;127980;CELULAR BMOBILE AX1076 PRO BUNDLE;TELEFONIA
20804516;;M;20;CHILENO;;Z;RENCA                         ;METROPOLITANA;169990;1;1;1;1;169990;0;0;0;CELULAR REDMI NOTE 10S 128GB ONIX BLACK;TELEFONIA
10594493;;M;56;CHILENO;;Boomers;TALCAHUANO                    ;BIO BIO;597020;7;3;0;0;0;7;3;597020;CELULAR GALAXY A13 4+128GB WHITE OPEN;TELEFONIA
7214525;;M;65;CHILENO;;Boomers;MELIPILLA                     ;METROPOLITANA;128810;3;1;0;0;0;3;1;128810;CELULAR XIAOMI REDMI 9A 2/32GB GRANITE GRAY;TELEFONIA
11811869;;M;51;CHILENO;;X;PENAFLOR                      ;METROPOLITANA;621930;7;4;6;3;431940;1;1;189990;CELULAR A32 128 GB BLACK OPEN;TELEFONIA
10836328;Soltero;M;56;CHILENO;;Boomers;TRAIGUEN                      ;ARAUCANIA;169250;3;1;0;0;0;3;1;169250;CELULAR GALAXY A13 4+128GB LIGHT BLUE OPEN;TELEFONIA
19545633;;F;25;CHILENO;;Z;"";"";73980;2;1;2;1;73980;0;0;0;CELULAR REDMI 9A 32GB SKY BLUE;TELEFONIA
12364921;;F;49;CHILENO;;X;PUENTE ALTO                   ;METROPOLITANA;683670;12;3;0;0;0;12;3;683670;CELULAR VIVO Y15S WAVE GREEN OPEN;TELEFONIA
9306760;;M;59;CHILENO;;Boomers;ARICA                         ;TARAPACA;712128;6;2;0;0;0;6;2;712128;CELULAR A52 128 GB BLACK OPEN;TELEFONIA
16304571;;M;36;CHILENO;;Millenial;ARAUCO                        ;BIO BIO;649970;3;3;0;0;0;3;3;649970;CELULAR GALAXY A03 4+128GB BLACK OPEN;TELEFONIA
5442778;;F;76;CHILENO;;Silencioso;LIMACHE                       ;VALPARAISO;269510;5;3;0;0;0;5;3;269510;CELULAR MOTOROLA G20 64GB BLUE CLARO;TELEFONIA
9947625;;M;54;CHILENO;;X;PROVIDENCIA                   ;METROPOLITANA;103980;2;1;2;1;103980;0;0;0;NOKIA G10 3/64 GB BLUE TRI WOM;TELEFONIA
13963979;;F;42;CHILENO;;X;TEMUCO                        ;ARAUCANIA;119990;2;1;0;0;0;2;1;119990;CELULAR MOTO G60 4/128 GB NEGRO OPEN;TELEFONIA
11940296;;M;50;CHILENO;;X;ILLAPEL                       ;COQUIMBO;149990;1;1;0;0;0;1;1;149990;CELULAR A32 128 GB BLACK OPEN;TELEFONIA
18677713;;F;28;CHILENO;;Millenial;CURANILAHUE                   ;BIO BIO;1231940;6;3;4;2;511960;2;1;719980;CELULAR SAMSUNG A52s 128GB BLACK CLARO;TELEFONIA
8542347;;F;64;CHILENO;;Boomers;TEMUCO                        ;ARAUCANIA;557580;6;3;0;0;0;6;3;557580;CELULAR GALAXY A13 4+128GB LIGHT BLUE OPEN;TELEFONIA
16580112;;M;35;CHILENO;;Millenial; COPIAPO;ATACAMA;229990;1;1;1;1;229990;0;0;0;CELULAR SAMSUNG A52s 128GB BLACK CLARO;TELEFONIA
15808289;;F;38;CHILENO;;Millenial;PROVIDENCIA                   ;METROPOLITANA;757970;3;1;3;1;757970;0;0;0;CELULAR XIAOMI 12 PRO 5G 8GB+256GB PURPLE BUNDLE;TELEFONIA
9090818;Casado;M;60;CHILENO;ANALISTA DE SISTEMAS;Boomers;PROVIDENCIA                   ;METROPOLITANA;163980;2;1;2;1;163980;0;0;0;CELULAR GALAXY A22 5G 4+128GB GRAY;TELEFONIA
13806551;;F;41;CHILENO;;X;CANETE                        ;BIO BIO;970560;13;8;0;0;0;13;8;970560;CELULAR SAMSUNG A52s 128GB BLACK CLARO;TELEFONIA
20614280;;F;21;CHILENO;;Z;PUENTE ALTO;METROPOLITANA;279990;1;1;1;1;279990;0;0;0;CELULAR GALAXY A53 5G 6+128GB ORANGE;TELEFONIA
7036949;Casado;M;67;CHILENO;;Boomers;RENCA                         ;METROPOLITANA;259990;1;1;1;1;259990;0;0;0;CELULAR GALAXY A53 5G 6+128GB ORANGE;TELEFONIA
18385094;;F;29;CHILENO;;Millenial;PROVIDENCIA                   ;METROPOLITANA;129990;1;1;0;0;0;1;1;129990;CELULAR VIVO Y01 AZUL ZAFIRO OPEN;TELEFONIA
8734531;;M;62;CHILENO;;Boomers;PICHIDEGUA                    ;L.G.B.OÂ´HIGGINS;325950;5;5;0;0;0;5;5;325950;CELULAR SAMSUNG A01 CORE BLACK WOM;TELEFONIA
15136832;;M;39;CHILENO;;X;PROVIDENCIA                   ;METROPOLITANA;957960;4;2;4;2;957960;0;0;0;CELULAR GALAXY S22 ULTRA WHITE 128GB;TELEFONIA
10255264;;M;56;CHILENO;;Boomers;RENCA                         ;METROPOLITANA;109990;2;1;0;0;0;2;1;109990;CELULAR VIVO Y01 AZUL ZAFIRO OPEN;TELEFONIA
16364591;;F;35;CHILENO;;Millenial;RENCA                         ;METROPOLITANA;343399;4;2;0;0;0;4;2;343399;CELULAR VIVO Y53S FANTASTIC RAINBOW 128GB OPEN;TELEFONIA
9686977;;M;42;CHILENO;;X;VALPARAISO                    ;VALPARAISO;188770;2;1;0;0;0;2;1;188770;CELULAR A32 128 GB LIGHT VIOLET OPEN;TELEFONIA
14901842;;M;43;CHILENO;;X;LA SERENA                     ;COQUIMBO;713488;5;3;0;0;0;5;3;713488;CELULAR REDMI NOTE 11S 128GB GRAPHITE GRAY;TELEFONIA
6145022;;F;75;CHILENO;;Silencioso;SAN JOAQUIN                   ;METROPOLITANA;119990;1;1;0;0;0;1;1;119990;CELULAR GALAXY A03 4+128GB BLUE OPEN;TELEFONIA
18889291;;F;26;CHILENO;;Z;VALDIVIA                      ;LOS RIOS;179990;2;1;0;0;0;2;1;179990;CELULAR REDMI NOTE 11 PRO 128GB GRAPHITE;TELEFONIA
16356589;Soltero;F;36;CHILENO;;Millenial;PROVIDENCIA                   ;METROPOLITANA;199990;1;1;0;0;0;1;1;199990;CELULAR GALAXY A23 6+128GB LIGHT BLUE OPEN;TELEFONIA
10155611;;F;49;CHILENO;;X;CABILDO                       ;VALPARAISO;301960;5;5;2;1;134980;3;4;166980;CELULAR VIVO Y01 AZUL ZAFIRO OPEN;TELEFONIA
14507583;;F;45;CHILENO;;X;OLIVAR                        ;L.G.B.OÂ´HIGGINS;876980;2;1;2;1;876980;0;0;0;CELULAR GALAXY S22 ULTRA BURGUNDY 128GB;TELEFONIA
9244744;;M;60;CHILENO;;Boomers;CONCEPCION                    ;BIO BIO;374980;2;2;0;0;0;2;2;374980;CELULAR REDMI 10C EU 4GB+128GB GRAPHITE GRAY OPE;TELEFONIA
7170358;;F;72;CHILENO;;Silencioso;AISEN                         ;AYSEN;481660;7;6;0;0;0;7;6;481660;CELULAR BMOBILE C40 CRIS OPEN;TELEFONIA
15575093;;M;29;CHILENO;;Millenial;OVALLE                        ;COQUIMBO;223980;2;2;0;0;0;2;2;223980;CELULAR REDMI NOTE 11 PRO 128GB GRAPHITE;TELEFONIA
8181258;;F;66;CHILENO;;Millenial;COPIAPO;ATACAMA;169980;2;2;0;0;0;2;2;169980;SMARTPHONE A22 VERDE 128GB;TELEFONIA
11392450;;F;52;CHILENO;;X;N/D;N/D;628940;6;4;4;2;381960;2;2;246980;CELULAR GALAXY A33 5G 6+128GB LIGHT BLUE OPEN;TELEFONIA
13153679;Casado;M;45;CHILENO;;X;PROVIDENCIA                   ;METROPOLITANA;70480;2;1;0;0;0;2;1;70480;CELULAR XIAOMI REDMI 9A 32GB BLACK DIRECTO CLARO;TELEFONIA
25993368;Soltero;M;29;NO INFORMA NACIONALIDAD;;Extranjero;PROVIDENCIA                   ;METROPOLITANA;173980;2;1;2;1;173980;0;0;0;CELULAR A52 128 GB LIGHT VIOLET OPEN;TELEFONIA
26655093;;M;41;VENEZOLANO;;Extranjero;RANCAGUA                      ;L.G.B.OÂ´HIGGINS;794510;5;5;5;5;794510;0;0;0;CELULAR GALAXY A03 4+64GB BLACK OPEN;TELEFONIA
20410257;;F;22;CHILENO;;Z;COPIAPO                       ;ATACAMA;154996;5;2;0;0;0;5;2;154996;CELULAR VIVO Y21S 128GB BLANCO WOM;TELEFONIA
8962230;;F;62;CHILENO;;Boomers;N/D;N/D;534940;6;4;0;0;0;6;4;534940;CELULAR SMARTPHONE A52S 5G BLACK 128GB;TELEFONIA
12462653;;M;49;CHILENO;;X;ANTOFAGASTA                   ;ANTOFAGASTA;79990;1;1;0;0;0;1;1;79990;CELULAR XIAOMI REDMI 9A 32GB GRANITE GRAY TRI WO;TELEFONIA
6019535;;M;72;CHILENO;;Silencioso;ARICA                         ;ARICA Y PARINACOTA;984800;4;3;0;0;0;4;3;984800;CELULAR SMARTPHONE A52S 5G BLACK 128GB;TELEFONIA
11580923;;F;52;CHILENO;;X;LEBU                          ;BIO BIO;260220;2;1;0;0;0;2;1;260220;CELULAR REDMI NOTE 10S 128GB OCEAN BLUE;TELEFONIA
12597981;;F;48;CHILENO;;X;ILLAPEL                       ;COQUIMBO;624280;7;4;0;0;0;7;4;624280;CELULAR Moto E7 Rosado WOM;TELEFONIA
15050608;;F;40;CHILENO;;X;LA SERENA                     ;COQUIMBO;169990;1;1;0;0;0;1;1;169990;CELULAR A32 128 GB BLACK OPEN;TELEFONIA
18599467;;M;28;CHILENO;;Millenial;TOCOPILLA                     ;ANTOFAGASTA;928930;7;4;0;0;0;7;4;928930;CELULAR GALAXY A53 5G 6+128GB WHITE;TELEFONIA
7501821;Soltero;M;68;CHILENO;;Boomers;ANGOL                         ;ARAUCANIA;57000;2;1;0;0;0;2;1;57000;CELULAR NOKIA QUEEN VALUE BLACK CLARO;TELEFONIA
17889419;;F;31;CHILENO;;Millenial;PROVIDENCIA                   ;METROPOLITANA;407980;2;1;2;1;407980;0;0;0;IPHONE 11 64GB BLACK CLARO;TELEFONIA
15474390;;F;39;CHILENO;;X;LINARES                       ;MAULE;169990;1;1;1;1;169990;0;0;0;CELULAR A52 128 GB LIGHT VIOLET OPEN;TELEFONIA
12282102;;M;50;CHILENO;;X;"";"";240610;5;3;0;0;0;5;3;240610;CELULAR GALAXY A03 4+64GB BLACK OPEN;TELEFONIA
17899931;Soltero;M;30;CHILENO;;Millenial;PROVIDENCIA                   ;METROPOLITANA;229990;1;1;0;0;0;1;1;229990;CELULAR SAMSUNG A52s 128GB BLACK CLARO;TELEFONIA
12073069;;M;44;CHILENO;;X;CONSTITUCION                  ;MAULE;199760;3;2;0;0;0;3;2;199760;CELULAR GALAXY A13 4+128GB LIGHT BLUE OPEN;TELEFONIA
16970842;;F;33;CHILENO;;Millenial;QUILPUE                       ;VALPARAISO;283210;4;1;0;0;0;4;1;283210;POCO X3 PRO US 128G METAL BRONZE;TELEFONIA
18612820;;M;28;CHILENO;;Millenial;LA LIGUA                      ;VALPARAISO;980;2;1;0;0;0;2;1;980;CHIP OPEN ENTEL;TELEFONIA
12578980;;M;48;CHILENO;;X;PROVIDENCIA                   ;METROPOLITANA;169990;1;1;1;1;169990;0;0;0;CELULAR A52 128 GB LIGHT VIOLET OPEN;TELEFONIA
9795102;Casado;M;59;CHILENO;;Boomers;RENCA                         ;METROPOLITANA;9990;2;1;0;0;0;2;1;9990;CELULAR XIAOMI REDMI 9A 2/32GB GRANITE GRAY;TELEFONIA
12921447;;M;47;CHILENO;;X;CHIGUAYANTE                   ;BIO BIO;106980;2;1;2;1;106980;0;0;0;CELULAR GALAXY A03 4+64GB BLACK OPEN;TELEFONIA
11998778;;F;50;CHILENO;;X;LINARES                       ;MAULE;348970;3;1;3;1;348970;0;0;0;CELULAR REDMI NOTE 10 PRO 6+128GB GRADIENT BRONZ;TELEFONIA
15980379;;M;42;CHILENO;;X;LOS ANGELES                   ;BIO BIO;74990;1;1;0;0;0;1;1;74990;CELULAR XIAOMI REDMI 9A 32GB VERDE CLARO;TELEFONIA
9084540;;M;61;CHILENO;;Boomers;TALAGANTE                     ;METROPOLITANA;397350;7;5;0;0;0;7;5;397350;CELULAR GALAXY A03 4+64GB BLUE OPEN;TELEFONIA
17977032;;M;31;CHILENO;;Millenial;CALERA                        ;VALPARAISO;549150;8;5;0;0;0;8;5;549150;SMARTPHONE A03S NEGRO 32GB;TELEFONIA
13745065;Soltero;M;48;CHILENO;;X;VALLENAR;ATACAMA;10000;3;1;0;0;0;3;1;10000;CELULAR SAMSUNG GALAXY A03 CORE 32GB NEGRO WOM;TELEFONIA
19537896;Soltero;M;25;CHILENO;;Z;PROVIDENCIA                   ;METROPOLITANA;299980;2;2;2;2;299980;0;0;0;CELULAR REDMI NOTE 11 PRO 128GB GRAPHITE;TELEFONIA
17296729;;M;32;CHILENO;;Millenial;N/D;N/D;199559;5;1;0;0;0;5;1;199559;CELULAR VIVO Y53S FANTASTIC RAINBOW 128GB OPEN;TELEFONIA
20050794;;F;23;CHILENO;;Z;MAIPU                         ;METROPOLITANA;130000;2;1;0;0;0;2;1;130000;CELULAR VIVO Y01 AZUL ZAFIRO OPEN;TELEFONIA
20398536;;F;21;CHILENO;;Z;PROVIDENCIA                   ;METROPOLITANA;193980;2;1;2;1;193980;0;0;0;CELULAR A52 128 GB BLACK OPEN;TELEFONIA
6070833;;M;70;CHILENO;;Silencioso;TALTAL                        ;ANTOFAGASTA;432970;3;1;0;0;0;3;1;432970;CELULAR GALAXY A22 5G 4+128GB GRAY;TELEFONIA
13147749;;F;44;CHILENO;;X;CANETE                        ;BIO BIO;2082910;10;6;2;1;116980;8;5;1965930;IPHONE 6S 64GB PLATA OPEN;TELEFONIA
26905014;Soltero;M;39;EXTRANJERO - NO INFORMA NACIONALIDAD;;Extranjero;PROVIDENCIA                   ;METROPOLITANA;14990;1;1;1;1;14990;0;0;0;CELULAR AZUMI L4G BLACK CLARO;TELEFONIA
11531236;;F;52;CHILENO;;X;VILLA ALEGRE                  ;MAULE;79990;2;1;0;0;0;2;1;79990;CELULAR VIVO Y15S WAVE GREEN OPEN;TELEFONIA
10292796;;M;54;CHILENO;;Boomers;RENCA                         ;METROPOLITANA;247050;5;2;0;0;0;5;2;247050;CELULAR GALAXY A03 CORE 2GB 32GB BLACK OPEN;TELEFONIA
5745874;;F;74;CHILENO;;Silencioso;LO ESPEJO                     ;METROPOLITANA;370830;7;4;0;0;0;7;4;370830;SMARTPHONE A03S NEGRO 32GB;TELEFONIA
13004152;;F;45;CHILENO;;X;NANCAGUA;O HIGGINS;366980;2;1;2;1;366980;0;0;0;CELULAR XIAOMI 11T 8/256GB CELESTIAL BLUE OPEN;TELEFONIA
16346548;;M;36;CHILENO;;Millenial;PUDAHUEL                      ;METROPOLITANA;119990;2;1;0;0;0;2;1;119990;CELULAR REDMI NOTE 10 5G 4/128GB GRAPHITE GRAY O;TELEFONIA
8508796;;M;63;CHILENO;;Boomers;PLACILLA                      ;L.G.B.OÂ´HIGGINS;222420;8;4;0;0;0;8;4;222420;CHIP OPEN ENTEL;TELEFONIA
13781040;;F;41;CHILENO;;X;SAN FERNANDO                  ;L.G.B.OÂ´HIGGINS;159990;1;1;1;1;159990;0;0;0;CELULAR REDMI NOTE 11 4/128GB GRAPHITE GRAY OPEN;TELEFONIA
12314522;;F;48;CHILENO;;X;N/D;N/D;503980;2;1;2;1;503980;0;0;0;IPHONE 11 128GB BLACK CLARO;TELEFONIA
26014449;Soltero;F;31;VENEZOLANO;;Extranjero;SAN MIGUEL;METROPOLITANA;134980;2;1;2;1;134980;0;0;0;CELULAR MOTO G20 EDICION ESPECIAL 4/128 GB AZUL;TELEFONIA
10020033;;F;55;CHILENO;;Boomers;PROVIDENCIA                   ;METROPOLITANA;189990;1;1;1;1;189990;0;0;0;CELULAR POCO M4 PRO 128GB COOL BLUE OPEN;TELEFONIA
19097715;Soltero;F;26;CHILENO;;Z;PROVIDENCIA                   ;METROPOLITANA;556960;4;3;4;3;556960;0;0;0;CELULAR SAMSUN A52 128GB NEGRO WOM;TELEFONIA
10765738;;F;55;CHILENO;;Boomers;MAIPU                         ;METROPOLITANA;163980;2;1;2;1;163980;0;0;0;CELULAR SAMSUN A52 128GB NEGRO WOM;TELEFONIA
15115178;;F;39;CHILENO;;X;SANTA CRUZ                    ;L.G.B.OÂ´HIGGINS;205540;2;1;0;0;0;2;1;205540;CELULAR A32 128 GB BLUE OPEN;TELEFONIA
7147155;;M;66;CHILENO;;Boomers;TALCA                         ;MAULE;369990;2;1;0;0;0;2;1;369990;CELULAR SAMSUNG S21 FE 128GB GRAY OPEN;TELEFONIA
15332671;Casado;F;39;CHILENO;PROFESOR;X;PROVIDENCIA                   ;METROPOLITANA;183980;2;1;2;1;183980;0;0;0;CELULAR XIAOMI REDMI NOTE 10 PRO 128GB GRIS WOM;TELEFONIA
19130381;;M;26;CHILENO;;Z;N/D;N/D;269980;2;2;1;1;129990;1;1;139990;CELULAR GALAXY A13 4+128GB LIGHT BLUE OPEN;TELEFONIA
24344590;Soltero;F;34;PERUANO;;Extranjero;PROVIDENCIA                   ;METROPOLITANA;259990;1;1;1;1;259990;0;0;0;CELULAR SMARTPHONE A52S 5G BLACK 128GB;TELEFONIA
10421035;Casado;M;54;CHILENO;;Boomers;PROVIDENCIA                   ;METROPOLITANA;33990;1;1;0;0;0;1;1;33990;Celular SA3 CLARO DIRECTO BLACK;TELEFONIA
10338924;;M;51;CHILENO;;X;PENALOLEN;METROPOLITANA;159990;1;1;1;1;159990;0;0;0;CELULAR GALAXY A22 5G 4+128GB MINT;TELEFONIA
9733690;;M;56;CHILENO;;Boomers;RENCA                         ;METROPOLITANA;11980;2;1;2;1;11980;0;0;0;REPETIDOR MI WIFI RANGE EXTENDER PRO XIAOMI;TELEFONIA
11279089;;M;54;CHILENO;;X;RENCA                         ;METROPOLITANA;24990;3;1;0;0;0;3;1;24990;CELULAR BMOBILE C40 CRIS OPEN;TELEFONIA
19824223;;F;24;CHILENO;;Z;SAN CARLOS                    ;BIO BIO;827810;8;4;2;1;128980;6;3;698830;CELULAR A52 128 GB BLUE OPEN;TELEFONIA
23234916;;M;40;BOLIVIANO;;Extranjero;TOCOPILLA                     ;ANTOFAGASTA;636270;6;3;0;0;0;6;3;636270;CELULAR A52 128 GB BLACK OPEN;TELEFONIA
15942746;;M;37;CHILENO;;Millenial;LINARES;MAULE;599990;1;1;1;1;599990;0;0;0;CELULAR XIAOMI 12 5G US 8GB+256GB GRAY BUNDLE;TELEFONIA
10508960;;M;54;CHILENO;;X;SANTA CRUZ                    ;L.G.B.OÂ´HIGGINS;294530;3;2;3;2;294530;0;0;0;CELULAR A32 128 GB BLUE OPEN;TELEFONIA
10998008;;M;41;CHILENO;;X;N/D;N/D;489950;6;3;0;0;0;6;3;489950;CELULAR GALAXY A03 4+64GB BLACK OPEN;TELEFONIA
7304727;;F;67;CHILENO;;Boomers;LEBU                          ;BIO BIO;839040;8;5;0;0;0;8;5;839040;CELULAR VIVO Y21S 128GB BLANCO WOM;TELEFONIA
24984444;;F;45;COLOMBIANO;;Extranjero;RECOLETA                      ;METROPOLITANA;174980;2;1;0;0;0;2;1;174980;CELULAR A32 128 GB BLACK OPEN;TELEFONIA
19082136;;F;27;CHILENO;;Silencioso;PROVIDENCIA                   ;METROPOLITANA;99990;1;1;1;1;99990;0;0;0;CELULAR GALAXY A03 4+64GB BLACK OPEN;TELEFONIA
16085257;;F;36;CHILENO;;Millenial;PROVIDENCIA                   ;METROPOLITANA;173980;2;1;2;1;173980;0;0;0;CELULAR A52 128 GB BLACK OPEN;TELEFONIA
26379663;;M;38;VENEZOLANO;;Extranjero;PROVIDENCIA                   ;METROPOLITANA;199990;1;1;1;1;199990;0;0;0;CELULAR REDMI NOTE 11 PRO 128GB GRAPHITE;TELEFONIA
26649293;Soltero;M;32;NO INFORMA NACIONALIDAD;;Extranjero;PROVIDENCIA                   ;METROPOLITANA;169990;1;1;1;1;169990;0;0;0;CELULAR REDMI NOTE 11 4/128GB GRAPHITE GRAY OPEN;TELEFONIA
9261652;;M;56;CHILENO;;Boomers;OVALLE                        ;COQUIMBO;384970;3;3;0;0;0;3;3;384970;CELULAR GALAXY A03 64GB BLACK DIRECTO MOVISTAR;TELEFONIA
16059960;;F;36;CHILENO;;Millenial;ILLAPEL                       ;COQUIMBO;181980;2;2;0;0;0;2;2;181980;CELULAR MOTOROLA G20 EDICION ESPECIAL VERDE CLAR;TELEFONIA
19109233;;F;26;CHILENO;;Z;PROVIDENCIA                   ;METROPOLITANA;175980;2;1;2;1;175980;0;0;0;CELULAR A52 128 GB LIGHT VIOLET OPEN;TELEFONIA
17119428;Soltero;M;33;CHILENO;INGENIERO COMERCIAL;Millenial;RENCA                         ;METROPOLITANA;39990;1;1;1;1;39990;0;0;0;CELULAR BMOBILE C40 CRIS OPEN;TELEFONIA
18101787;;M;30;CHILENO;;Millenial;N/D;N/D;861970;3;1;3;1;861970;0;0;0;CELULAR XIAOMI 12 PRO 5G 8GB+256GB PURPLE BUNDLE;TELEFONIA
14425583;;M;49;CHILENO;;X;N/D;N/D;613960;4;2;4;2;613960;0;0;0;CELULAR SMARTPHONE A52S 5G LIGHT GREEN 128GB;TELEFONIA
18291284;;F;29;CHILENO;;Millenial;CANETE                        ;BIO BIO;159390;5;2;0;0;0;5;2;159390;CELULAR REDMI 9A 32GB SKY BLUE;TELEFONIA
17916919;;M;30;CHILENO;;Millenial;PROVIDENCIA                   ;METROPOLITANA;34990;1;1;0;0;0;1;1;34990;CELULAR NOKIA 225 4G BLACK MOVISTAR DIRECTO;TELEFONIA
15199344;;F;39;CHILENO;;X;LEBU                          ;BIO BIO;299980;2;2;0;0;0;2;2;299980;CELULAR A52 128 GB LIGHT VIOLET OPEN;TELEFONIA
26280234;;M;35;VENEZOLANO;;Extranjero;N/D;N/D;178980;2;2;0;0;0;2;2;178980;CELULAR REDMI NOTE 10 5G 4/128GB GRAPHITE GRAY O;TELEFONIA
7969342;;F;67;CHILENO;;Boomers;RENCA                         ;METROPOLITANA;199990;1;1;0;0;0;1;1;199990;CELULAR A52 128 GB BLUE OPEN;TELEFONIA
19740998;;F;25;CHILENO;;Z;PROVIDENCIA                   ;METROPOLITANA;269980;2;1;2;1;269980;0;0;0;CELULAR GALAXY A53 5G 6+128GB ORANGE;TELEFONIA
8574716;;F;64;CHILENO;;Boomers;LOS ANDES                     ;VALPARAISO;149990;1;1;0;0;0;1;1;149990;CELULAR A12 128GB Negro OPEN;TELEFONIA
17972850;;F;31;CHILENO;;Millenial;VILLARICA                     ;ARAUCANIA;178120;2;1;0;0;0;2;1;178120;CELULAR MOTOROLA G20 64GB BLUE CLARO;TELEFONIA
18312841;;M;30;CHILENO;;Millenial;"";"";139990;1;1;1;1;139990;0;0;0;CELULAR REDMI NOTE 10 5G 4/128GB GRAPHITE GRAY O;TELEFONIA
14057612;;F;40;CHILENO;;X;CURANILAHUE                   ;BIO BIO;89990;1;1;0;0;0;1;1;89990;CELULAR SAMSUNG GALAXY A03 CORE 32GB NEGRO WOM;TELEFONIA
13206101;;F;45;CHILENO;;X;CAUQUENES                     ;MAULE;223280;2;1;0;0;0;2;1;223280;CELULAR A52 128 GB WHITE OPEN;TELEFONIA
6156416;;M;74;CHILENO;;Silencioso;CISNES                        ;AYSEN;50410;2;1;0;0;0;2;1;50410;CELULAR BMOBILE BS30 BLACK OPEN;TELEFONIA
13816998;;F;43;CHILENO;;X;PUENTE ALTO                   ;METROPOLITANA;206990;2;1;0;0;0;2;1;206990;CELULAR REDMI NOTE 10 5G 4/128GB GRAPHITE GRAY O;TELEFONIA
17595147;Soltero;F;31;CHILENO;;Millenial;PROVIDENCIA                   ;METROPOLITANA;192960;4;2;2;1;178980;2;1;13980;CELULAR A52 128 GB LIGHT VIOLET OPEN;TELEFONIA
11639376;;F;52;CHILENO;;X;RENCA                         ;METROPOLITANA;182980;2;2;2;2;182980;0;0;0;CELULAR REDMI NOTE 11 4/128GB TWILIGHT BLUE OPEN;TELEFONIA
17803465;Soltero;M;31;CHILENO;;Millenial;PROVIDENCIA                   ;METROPOLITANA;363980;2;1;2;1;363980;0;0;0;CELULAR XIAOMI 11T 8/256GB METEORITE GRAY OPEN;TELEFONIA
19797718;;F;24;CHILENO;;Z;PROVIDENCIA                   ;METROPOLITANA;134990;1;1;1;1;134990;0;0;0;CELULAR GALAXY A22 5G 4+128GB GRAY;TELEFONIA
12046975;;F;49;CHILENO;;X;"";"";499990;1;1;1;1;499990;0;0;0;IPHONE 11 128GB BLACK CLARO;TELEFONIA
14378211;;M;43;CHILENO;;X;CHONCHI                       ;LOS LAGOS;50410;2;1;0;0;0;2;1;50410;CELULAR BMOBILE BS30 BLACK OPEN;TELEFONIA
17262316;Soltero;M;32;CHILENO;INGENIERO ELECTRICO;Millenial;PROVIDENCIA                   ;METROPOLITANA;469990;1;1;1;1;469990;0;0;0;CELULAR XIAOMI 11T PRO 8/256GB METEORITE GRAY;TELEFONIA
18790819;;F;28;CHILENO;;Millenial;PROVIDENCIA                   ;METROPOLITANA;899990;3;1;3;1;899990;0;0;0;CELULAR GALAXY S22 ULTRA BURGUNDY 128GB;TELEFONIA
19673847;;M;25;CHILENO;;Z;PROVIDENCIA                   ;METROPOLITANA;345101;9;3;0;0;0;9;3;345101;CELULAR VIVO Y15S WAVE GREEN OPEN;TELEFONIA
17240575;;M;32;CHILENO;;Millenial;BUIN;METROPOLITANA;129990;1;1;0;0;0;1;1;129990;CELULAR GALAXY A03 4+128GB BLUE OPEN;TELEFONIA
19364514;;F;25;CHILENO;;Z;LEBU                          ;BIO BIO;789980;3;2;2;1;599990;1;1;189990;CELULAR GALAXY S22 BLACK 128GB;TELEFONIA
27434621;;M;35;CHILENO;;Extranjero;"";"";690020;8;3;0;0;0;8;3;690020;CELULAR MOTO G50 AZUL 128 GB OPEN;TELEFONIA
12715580;;M;48;CHILENO;;X;COIHAIQUE                     ;AYSEN;99990;1;1;0;0;0;1;1;99990;CELULAR VIVO Y11S NEGRO WOM;TELEFONIA
17694759;;F;32;CHILENO;;Millenial;PROVIDENCIA                   ;METROPOLITANA;198980;2;1;2;1;198980;0;0;0;CELULAR POCO M4 PRO 128GB POWER BLACK OPEN;TELEFONIA
13449792;;M;49;CHILENO;;X;PROVIDENCIA                   ;METROPOLITANA;269990;1;1;1;1;269990;0;0;0;CELULAR IPHONE SE 64GB DIRECTO CLARO;TELEFONIA
24269222;Casado;M;45;CHINO;;Extranjero;PROVIDENCIA                   ;METROPOLITANA;259990;1;1;1;1;259990;0;0;0;CELULAR GALAXY A53 5G 6+128GB WHITE;TELEFONIA
15869989;;F;37;CHILENO;;Millenial;TIERRA AMARILLA               ;ATACAMA;249990;1;1;0;0;0;1;1;249990;CELULAR SMARTPHONE A52S 5G LIGHT GREEN 128GB;TELEFONIA
12051669;Soltero;M;44;CHILENO;;X;RENCA                         ;METROPOLITANA;229990;1;1;0;0;0;1;1;229990;CELULAR A52 128 GB BLUE OPEN;TELEFONIA
7641836;;M;68;CHILENO;;Boomers;PROVIDENCIA                   ;METROPOLITANA;63100;3;1;0;0;0;3;1;63100;CELULAR NOKIA 225 4G BLACK MOVISTAR DIRECTO;TELEFONIA
12067288;;M;52;CHILENO;;X;SAN FELIPE                    ;VALPARAISO;249990;1;1;0;0;0;1;1;249990;CELULAR SMARTPHONE A52S 5G BLACK 128GB;TELEFONIA
26370853;Soltero;M;36;EXTRANJERO - NO INFORMA NACIONALIDAD;;Extranjero;SANTIAGO;METROPOLITANA;160990;2;1;2;1;160990;0;0;0;CELULAR A32 128 GB BLUE OPEN;TELEFONIA
18904205;Soltero;M;27;CHILENO;;Millenial;PROVIDENCIA                   ;METROPOLITANA;173980;2;1;2;1;173980;0;0;0;CELULAR A52 128 GB LIGHT VIOLET OPEN;TELEFONIA
16635405;;F;34;CHILENO;;Millenial;N/D;N/D;139990;2;1;2;1;139990;0;0;0;CELULAR A32 128 GB BLUE OPEN;TELEFONIA
19021658;;F;27;CHILENO;;Z;N/D;N/D;882920;9;5;5;3;645960;4;2;236960;CELULAR MOTO G60 4/128 GB SILVER OPEN;TELEFONIA
19965699;;M;23;CHILENO;;Z;CONSTITUCION                  ;MAULE;1431870;12;7;7;4;686430;5;3;745440;CELULAR GALAXY A22 5G 4+128GB MINT;TELEFONIA
17798663;Soltero;M;31;CHILENO;;Millenial;PROVIDENCIA                   ;METROPOLITANA;127400;2;1;0;0;0;2;1;127400;CELULAR XIAOMI REDMI 9A 32GB VERDE CLARO;TELEFONIA
17635313;;F;31;CHILENO;;Millenial;N/D;N/D;58970;3;2;0;0;0;3;2;58970;CELULAR BMOBILE SENIORPHONE C40 GRIS WOM;TELEFONIA
16002340;;F;37;CHILENO;;Millenial;PROVIDENCIA                   ;METROPOLITANA;169990;1;1;1;1;169990;0;0;0;CELULAR A52 128 GB LIGHT VIOLET OPEN;TELEFONIA
10372539;;F;57;CHILENO;;Boomers;PROVIDENCIA                   ;METROPOLITANA;149990;1;1;1;1;149990;0;0;0;CELULAR GALAXY A22 5G 4+128GB GRAY;TELEFONIA
20325206;;M;22;CHILENO;;Z;SAN ANTONIO                   ;VALPARAISO;289990;1;1;0;0;0;1;1;289990;CELULAR SMARTPHONE A52S 5G LIGHT GREEN 128GB;TELEFONIA
9119969;;M;61;CHILENO;;Boomers;RENCA                         ;METROPOLITANA;243430;4;1;0;0;0;4;1;243430;CELULAR A32 128 GB BLACK OPEN;TELEFONIA
19000371;;F;27;CHILENO;;Z;"";"";377960;4;3;3;2;360970;1;1;16990;CELULAR A52 128 GB LIGHT VIOLET OPEN;TELEFONIA
19565441;;F;25;CHILENO;;Z;PROVIDENCIA                   ;METROPOLITANA;193970;3;2;2;1;173980;1;1;19990;CELULAR REDMI NOTE 11 4/128GB GRAPHITE GRAY OPEN;TELEFONIA
20237894;;M;23;CHILENO;;Z;MELIPILLA                     ;METROPOLITANA;660970;5;5;0;0;0;5;5;660970;CELULAR MOTO G31 4/128 GB GRIS METEORITO OPEN;TELEFONIA
15475053;;F;39;CHILENO;;X;VALDIVIA                      ;LOS LAGOS;536970;4;3;0;0;0;4;3;536970;CELULAR GALAXY A22 5G 4+128GB GRAY;TELEFONIA
16224953;;F;38;CHILENO;;Millenial;MONTE PATRIA                  ;COQUIMBO;129990;2;1;0;0;0;2;1;129990;CELULAR A12 128GB Rojo OPEN;TELEFONIA
18702729;;M;28;CHILENO;;Millenial;SANTIAGO;METROPOLITANA;269980;2;2;2;2;269980;0;0;0;CELULAR XIAOMI REDMI 9A 2/32GB GRANITE GRAY;TELEFONIA
16759518;Soltero;F;34;CHILENO;;Millenial;PROVIDENCIA                   ;METROPOLITANA;149960;4;3;0;0;0;4;3;149960;CELULAR SAMSUNG GALAXY A03 CORE AZUL WOM;TELEFONIA
13360716;;M;43;CHILENO;;X;SALAMANCA                     ;COQUIMBO;169990;2;1;2;1;169990;0;0;0;CELULAR A52 128 GB WHITE OPEN;TELEFONIA
11361206;;F;52;CHILENO;;X;SAN JOSE DE MAIPO             ;METROPOLITANA;153870;3;2;0;0;0;3;2;153870;CELULAR SAMSUNG GALAXY A03 CORE 32GB NEGRO WOM;TELEFONIA
26435215;;F;35;COLOMBIANO;;Extranjero;N/D;N/D;192980;2;2;1;1;139990;1;1;52990;CELULAR REDMI NOTE 10 5G 4/128GB GRAPHITE GRAY O;TELEFONIA
19881288;;F;24;CHILENO;;Z;PROVIDENCIA                   ;METROPOLITANA;599990;1;1;1;1;599990;0;0;0;CELULAR GALAXY S22 WHITE 128GB;TELEFONIA
12787515;;M;46;CHILENO;;X;ESTACION CENTRAL              ;METROPOLITANA;29990;2;1;0;0;0;2;1;29990;CELULAR REDMI 9A 32GB SKY BLUE;TELEFONIA
19740446;;F;25;CHILENO;;Z;PROVIDENCIA                   ;METROPOLITANA;599990;2;1;2;1;599990;0;0;0;Galaxy Z Flip3 128GB CREAM;TELEFONIA
14402198;;F;46;CHILENO;;X;PANGUIPULLI                   ;LOS LAGOS;466780;6;3;0;0;0;6;3;466780;CELULAR VIVO Y11S 32GB NEBULA BLUE OPEN;TELEFONIA
9858362;;M;57;CHILENO;;Boomers;RENCA                         ;METROPOLITANA;99990;2;1;0;0;0;2;1;99990;CELULAR A16 PEARL BLUE 64GB;TELEFONIA
9399196;;M;59;CHILENO;;Boomers;PROVIDENCIA                   ;METROPOLITANA;105040;3;1;0;0;0;3;1;105040;CELULAR XIAOMI REDMI 9A SE 2/32GB GB PEACOCK GRE;TELEFONIA
23521560;;M;38;PERUANO;;Extranjero;IQUIQUE                       ;TARAPACA;86990;1;1;0;0;0;1;1;86990;Celular Y8P ENTEL TRIANGULADO NEGRO;TELEFONIA
8811023;;M;61;CHILENO;;Boomers;COLINA                        ;METROPOLITANA;374980;3;2;0;0;0;3;2;374980;CELULAR SAMSUNG A52s 128GB BLACK CLARO;TELEFONIA
18328339;;F;29;CHILENO;;Millenial;N/D;N/D;150240;2;2;0;0;0;2;2;150240;CELULAR VIVO Y15S WAVE GREEN OPEN;TELEFONIA
25101155;Casado;M;47;CHILENO;;Extranjero;PROVIDENCIA                   ;METROPOLITANA;143980;2;1;2;1;143980;0;0;0;CELULAR REDMI NOTE 10 5G 4/128GB GRAPHITE GRAY O;TELEFONIA
10806183;Divorciado;F;56;CHILENO;;Boomers;RENCA                         ;METROPOLITANA;99990;1;1;0;0;0;1;1;99990;CELULAR XIAOMI REDMI 9C 64GB GRAY WOM;TELEFONIA
7175862;;F;73;CHILENO;;Silencioso;BUIN                          ;METROPOLITANA;149990;2;1;0;0;0;2;1;149990;CELULAR REDMI NOTE 10 5G 4/128GB GRAPHITE GRAY O;TELEFONIA
19830514;;M;24;CHILENO;;Z;HUECHURABA;METROPOLITANA;143980;2;1;2;1;143980;0;0;0;CELULAR A32 128 GB BLACK OPEN;TELEFONIA
16991560;;M;33;CHILENO;;Millenial;LLAILLAY                      ;VALPARAISO;361960;4;2;4;2;361960;0;0;0;CELULAR A52 128 GB BLACK OPEN;TELEFONIA
19391760;;M;25;CHILENO;;Z;PAINE                         ;METROPOLITANA;307950;5;2;5;2;307950;0;0;0;CELULAR A52 128 GB WHITE OPEN;TELEFONIA
19090746;;M;26;CHILENO;;Z;LEBU                          ;BIO BIO;159990;1;1;0;0;0;1;1;159990;CELULAR A32 128 GB LIGHT VIOLET OPEN;TELEFONIA
13740009;;F;43;CHILENO;;X;COIHAIQUE                     ;AYSEN;899980;2;2;0;0;0;2;2;899980;CELULAR GALAXY A53 5G 6+128GB BLACK;TELEFONIA
9699283;;M;59;CHILENO;;Boomers;COMBARBALA                    ;COQUIMBO;349960;5;4;0;0;0;5;4;349960;CELULAR XIAOMI REDMI 9A SE 2/32GB GB PEACOCK GRE;TELEFONIA
15402175;;F;39;CHILENO;;X;PROVIDENCIA                   ;METROPOLITANA;139990;1;1;0;0;0;1;1;139990;CELULAR VIVO Y20S NEBULA 128 GB BLUE OPEN;TELEFONIA
19815124;;M;24;CHILENO;;Extranjero;CHIGUAYANTE                   ;BIO BIO;169990;2;1;2;1;169990;0;0;0;CELULAR A52 128 GB WHITE OPEN;TELEFONIA
5219359;;M;75;CHILENO;;Silencioso;LA LIGUA                      ;VALPARAISO;148120;2;1;0;0;0;2;1;148120;CELULAR SAMSUNG A03 64GB NEGRO WOM;TELEFONIA
11582834;;M;52;CHILENO;;X;ANGOL                         ;ARAUCANIA;39990;1;1;0;0;0;1;1;39990;CELULAR BMOBILE BS30 BLACK OPEN;TELEFONIA
19623815;;F;24;CHILENO;;Z;N/D;N/D;169990;1;1;1;1;169990;0;0;0;CELULAR A52 128 GB BLUE OPEN;TELEFONIA
19287566;Soltero;M;26;CHILENO;TECNICO EN TELECOMUNICACIONES;Z;PUENTE ALTO;METROPOLITANA;849990;1;1;1;1;849990;0;0;0;CELULAR Galaxy Z Fold3 256GB BLACK OPEN;TELEFONIA
12638833;;M;48;CHILENO;;X;N/D;N/D;123980;2;1;2;1;123980;0;0;0;IPHONE 6S 64GB PLATA OPEN;TELEFONIA
9261006;Casado;M;60;CHILENO;;Boomers;PROVIDENCIA                   ;METROPOLITANA;309980;2;1;2;1;309980;0;0;0;CELULAR GALAXY A53 5G 6+128GB BLACK;TELEFONIA
19131170;Casado;F;26;CHILENO;;Z;VILLARICA                     ;ARAUCANIA;219990;1;1;1;1;219990;0;0;0;CELULAR SMARTPHONE A52S 5G LIGHT VIOLET 128GB;TELEFONIA
10922902;;F;48;CHILENO;;X;RIO IBANEZ                    ;AYSEN;628940;6;5;0;0;0;6;5;628940;CELULAR VIVO Y01 AZUL ZAFIRO OPEN;TELEFONIA
8351520;;M;61;CHILENO;;Boomers;N/D;N/D;237390;3;2;0;0;0;3;2;237390;CELULAR SAMSUNG GALAXY A03 CORE AZUL WOM;TELEFONIA
17625524;;F;31;CHILENO;;Millenial;PROVIDENCIA                   ;METROPOLITANA;959980;2;1;2;1;959980;0;0;0;CELULAR IPHONE 13 PRO 256GB GRAFITO CLARO;TELEFONIA
17137456;;M;33;CHILENO;;Millenial;N/D;N/D;555980;2;1;2;1;555980;0;0;0;CELULAR IPHONE 12 64GB BLACK CLARO;TELEFONIA
15558532;Soltero;M;39;CHILENO;;X;RENCA                         ;METROPOLITANA;119980;2;2;0;0;0;2;2;119980;CELULAR BMOBILE SENIORPHONE C40 GRIS WOM;TELEFONIA
5956680;;F;76;CHILENO;;Silencioso;VILLA ALEMANA                 ;VALPARAISO;971930;8;5;0;0;0;8;5;971930;SMARTPHONE A03S 32 GB ROJO;TELEFONIA
9780131;;F;58;CHILENO;;Boomers;PROVIDENCIA                   ;METROPOLITANA;469980;2;2;2;2;469980;0;0;0;CELULAR GALAXY A53 5G 6+128GB BLUE;TELEFONIA
16871025;;F;34;CHILENO;;Millenial;N/D;N/D;822960;4;2;3;1;815970;1;1;6990;CELULAR XIAOMI 12 PRO 5G 8GB+256GB PURPLE BUNDLE;TELEFONIA
19118651;;F;26;CHILENO;;Z;PROVIDENCIA                   ;METROPOLITANA;69990;1;1;1;1;69990;0;0;0;CELULAR XIAOMI REDMI 9A 2/32GB GRANITE GRAY;TELEFONIA
11729916;;M;50;CHILENO;;X;SAN FELIPE                    ;VALPARAISO;69990;1;1;0;0;0;1;1;69990;CELULAR XIAOMI REDMI 9A 2/32GB GRANITE GRAY;TELEFONIA
7278260;;F;75;CHILENO;;Silencioso;LOS ALAMOS                    ;BIO BIO;150391;3;2;0;0;0;3;2;150391;CELULAR REDMI 9A 32GB SKY BLUE;TELEFONIA
19734060;;M;25;CHILENO;;Z;PROVIDENCIA                   ;METROPOLITANA;249990;3;1;3;1;249990;0;0;0;SMARTPHONE A52S 5G WHITE 128GB;TELEFONIA
14588354;Casado;F;41;CHILENO;ANALISTA DE SISTEMAS;X;RENCA                         ;METROPOLITANA;159970;3;2;2;1;153980;1;1;5990;CELULAR REDMI NOTE 10 5G 4/128GB GRAPHITE GRAY O;TELEFONIA
13393184;;F;49;CHILENO;;X;N/D;N/D;109500;3;1;0;0;0;3;1;109500;CELULAR GALAXY A03 CORE 2GB 32GB BLACK OPEN;TELEFONIA
13147450;Casado;M;45;CHILENO;PROFESOR;X;RENCA                         ;METROPOLITANA;99990;1;3;0;0;0;1;3;99990;CELULAR GALAXY A03 CORE 2GB 32GB BLACK OPEN;TELEFONIA
15442475;;M;40;CHILENO;;X;PIRQUE                        ;METROPOLITANA;865490;13;2;0;0;0;13;2;865490;CELULAR REDMI NOTE 10 PRO 6+128GB GRADIENT BRONZ;TELEFONIA
13186752;;M;44;CHILENO;;X;NOGALES                       ;VALPARAISO;387726;7;2;0;0;0;7;2;387726;CELULAR GALAXY A22 5G 4+128GB WHITE;TELEFONIA
12645124;Casado;F;48;CHILENO;;X;PROVIDENCIA                   ;METROPOLITANA;54230;2;1;0;0;0;2;1;54230;CELULAR BMOBILE C40 CRIS OPEN;TELEFONIA
18107364;Soltero;F;31;CHILENO;;Millenial;PROVIDENCIA                   ;METROPOLITANA;179990;1;1;1;1;179990;0;0;0;CELULAR GALAXY A22 5G 4+128GB MINT;TELEFONIA
7556540;;F;72;CHILENO;;Silencioso;QUILLOTA                      ;VALPARAISO;285471;6;4;0;0;0;6;4;285471;CELULAR SAMSUNG GALAXY A03 CORE AZUL WOM;TELEFONIA
10080548;;F;57;CHILENO;;Boomers;PROVIDENCIA                   ;METROPOLITANA;832200;7;6;0;0;0;7;6;832200;CELULAR GALAXY A22 5G 4+128GB MINT;TELEFONIA
11717489;;M;50;CHILENO;;X;CASTRO                        ;LOS LAGOS;149990;1;1;0;0;0;1;1;149990;CELULAR A12 128GB Azul OPEN;TELEFONIA
18562395;;F;28;CHILENO;;Millenial;PUTAENDO                      ;VALPARAISO;897960;4;2;4;2;897960;0;0;0;CELULAR XIAOMI 11T PRO 8/256GB MOON WHITE;TELEFONIA
12910256;;F;46;CHILENO;;X;PROVIDENCIA                   ;METROPOLITANA;303980;2;1;2;1;303980;0;0;0;CELULAR IPHONE SE 64GB DIRECTO CLARO;TELEFONIA
9944977;;F;57;CHILENO;;Boomers;TEMUCO                        ;ARAUCANIA;169990;1;3;0;0;0;1;3;169990;CELULAR GALAXY A22 5G 4+128GB MINT;TELEFONIA
14561086;;F;53;CHILENO;;X;VALDIVIA                      ;LOS LAGOS;119990;1;1;0;0;0;1;1;119990;CELULAR GALAXY A03 4+128GB BLUE OPEN;TELEFONIA
16535710;Soltero;F;35;CHILENO;;Millenial;PROVIDENCIA                   ;METROPOLITANA;147640;2;1;0;0;0;2;1;147640;Celular XIAOMI REDMI 9C 64 GB DIRECTO CLARO;TELEFONIA
13582367;;F;44;CHILENO;;X;VICTORIA                      ;ARAUCANIA;339980;2;2;0;0;0;2;2;339980;CELULAR SAMSUNG GALAXY A03 CORE AZUL WOM;TELEFONIA
17183857;;F;33;CHILENO;;Millenial;TALCA                         ;MAULE;699970;3;3;0;0;0;3;3;699970;CELULAR IPHONE 12 64GB BLACK CLARO;TELEFONIA
9543944;;F;57;CHILENO;;Boomers;SAN FELIPE                    ;VALPARAISO;801930;7;5;0;0;0;7;5;801930;CELULAR XIAOMI REDMI 9A 2/32GB GRANITE GRAY;TELEFONIA
11271772;;M;54;CHILENO;;X;TALAGANTE                     ;METROPOLITANA;89990;1;1;0;0;0;1;1;89990;CELULAR XIAOMI REDMI 9A 2/32GB GRANITE GRAY;TELEFONIA
8764770;;M;62;CHILENO;;Boomers;MARIA PINTO                   ;METROPOLITANA;187951;3;2;0;0;0;3;2;187951;CELULAR A54 OPPO AZUL 128GB;TELEFONIA
4647600;;F;78;CHILENO;;Silencioso;PUENTE ALTO                   ;METROPOLITANA;906930;7;4;0;0;0;7;4;906930;CELULAR SMARTPHONE A52S 5G LIGHT GREEN 128GB;TELEFONIA
8620473;;M;59;CHILENO;;Boomers;LEBU                          ;BIO BIO;948960;4;2;2;1;547980;2;1;400980;IPHONE 11 128GB BLACK CLARO;TELEFONIA
9946851;;F;55;CHILENO;;Boomers;OLMUE                         ;VALPARAISO;174980;2;1;2;1;174980;0;0;0;CELULAR A52 128 GB BLACK OPEN;TELEFONIA
16025288;;F;36;CHILENO;;Millenial;CURICO                        ;MAULE;756690;9;5;0;0;0;9;5;756690;CELULAR REDMI NOTE 10S 128GB ONIX BLACK;TELEFONIA
18519675;Soltero;F;29;CHILENO;NUTRICIONISTA;Millenial;PROVIDENCIA                   ;METROPOLITANA;188990;1;1;1;1;188990;0;0;0;CELULAR A52 128 GB BLUE OPEN;TELEFONIA
14536628;;M;48;CHILENO;;X;N/D;N/D;39991;2;1;0;0;0;2;1;39991;CELULAR BMOBILE C40 CRIS OPEN;TELEFONIA
7032560;Casado;M;69;CHILENO;TECNOLOGO MEDICO;Silencioso;RENCA                         ;METROPOLITANA;169990;1;1;1;1;169990;0;0;0;CELULAR REDMI NOTE 11 4/128GB TWILIGHT BLUE OPEN;TELEFONIA
19957303;;F;23;CHILENO;;Z;"";"";569990;1;1;1;1;569990;0;0;0;IPHONE 11 128GB BLACK CLARO;TELEFONIA
19594188;;M;24;CHILENO;;Z;PROVIDENCIA                   ;METROPOLITANA;232730;2;1;0;0;0;2;1;232730;CELULAR REDMI NOTE 11 4/128GB TWILIGHT BLUE OPEN;TELEFONIA
6673585;;M;67;CHILENO;;Boomers;COLLIPULLI                    ;ARAUCANIA;54231;3;1;0;0;0;3;1;54231;CELULAR BMOBILE C40 CRIS OPEN;TELEFONIA
14250021;;F;52;CHILENO;;X;RENGO                         ;L.G.B.OÂ´HIGGINS;139990;1;1;0;0;0;1;1;139990;CELULAR MOTO G20 EDICION ESPECIAL 4/128 GB VERDE;TELEFONIA
12528822;;F;49;CHILENO;;X;CONCEPCION                    ;BIO BIO;149990;1;1;0;0;0;1;1;149990;CELULAR MOTO G20 EDICION ESPECIAL 4/128 GB AZUL;TELEFONIA
12142949;;F;41;CHILENO;;X;RANCAGUA                      ;L.G.B.OÂ´HIGGINS;149990;2;1;0;0;0;2;1;149990;CELULAR VIVO Y21S PEARL WHITE 128 GB OPEN;TELEFONIA
12764716;;M;46;CHILENO;;X;RENCA                         ;METROPOLITANA;239980;2;1;0;0;0;2;1;239980;CELULAR VIVO Y20S NEBULA 128 GB BLUE OPEN;TELEFONIA
18777847;;M;28;CHILENO;;Millenial;MELIPILLA                     ;METROPOLITANA;2056230;4;1;0;0;0;4;1;2056230;CELULAR GALAXY S22 ULTRA BURGUNDY 128GB;TELEFONIA
11046556;;M;56;CHILENO;;Boomers;COPIAPO                       ;ATACAMA;198630;3;2;0;0;0;3;2;198630;CELULAR VIVO Y20S NEBULA 128 GB BLUE OPEN;TELEFONIA
7414879;Casado;M;59;CHILENO;PROFESOR;Boomers;PADRE LAS CASAS               ;ARAUCANIA;188990;1;1;1;1;188990;0;0;0;CELULAR A52 128 GB BLUE OPEN;TELEFONIA
20225647;;F;22;CHILENO;;Millenial;PROVIDENCIA                   ;METROPOLITANA;119990;1;1;0;0;0;1;1;119990;CELULAR XIAOMI REDMI 9C 64GB GRAY WOM;TELEFONIA
19706103;;M;24;CHILENO;;Z;PUENTE ALTO;METROPOLITANA;277823;5;3;1;1;13993;4;2;263830;CELULAR MOTOROLA E30 GRIS CLARO;TELEFONIA
11746569;;F;51;CHILENO;;X;LINARES                       ;MAULE;1918251;25;11;0;0;0;25;11;1918251;CELULAR GALAXY A03 64GB BLACK DIRECTO MOVISTAR;TELEFONIA
7832349;;F;62;CHILENO;;Boomers;ARICA                         ;ARICA Y PARINACOTA;193930;2;1;0;0;0;2;1;193930;CELULAR MOTOROLA G20 EDICION ESPECIAL VERDE CLAR;TELEFONIA
8849317;;M;61;CHILENO;;Boomers;SAN NICOLAS                   ;BIO BIO;109990;1;1;0;0;0;1;1;109990;CELULAR REDMI 9C 64GB MIDNIGHT GRAY MOVISTAR;TELEFONIA
18800460;;F;27;CHILENO;;Z;N/D;N/D;99990;1;1;0;0;0;1;1;99990;CELULAR VIVO Y11S PHANTOM BLACK OPEN;TELEFONIA
15776381;;M;38;CHILENO;;Millenial;LOS ANDES                     ;VALPARAISO;223980;2;1;2;1;223980;0;0;0;CELULAR SMARTPHONE A52S 5G LIGHT VIOLET 128GB;TELEFONIA
26205954;;M;23;EXTRANJERO - NO INFORMA NACIONALIDAD;;Extranjero;COLINA;METROPOLITANA;144990;2;1;0;0;0;2;1;144990;CELULAR A22 128GB NEGRO;TELEFONIA
10572475;;F;51;CHILENO;;X;LA LIGUA                      ;VALPARAISO;541162;6;2;0;0;0;6;2;541162;CELULAR A52 128 GB WHITE OPEN;TELEFONIA
4829045;;F;76;CHILENO;;Silencioso;VALLENAR;ATACAMA;403750;3;1;0;0;0;3;1;403750;CELULAR SMARTPHONE A52S 5G BLACK 128GB;TELEFONIA
15110908;;M;38;CHILENO;;X;RENCA                         ;METROPOLITANA;19990;1;1;0;0;0;1;1;19990;TELEFONO PP BINDU ENTEL;TELEFONIA
13037116;Casado;F;46;CHILENO;;X;RENCA                         ;METROPOLITANA;-45000;1;2;0;0;0;1;2;-45000;CELULAR GALAXY A03 CORE 2GB 32GB BLACK OPEN;TELEFONIA
8675847;;M;61;CHILENO;;Boomers;QUILICURA                     ;METROPOLITANA;54990;1;1;0;0;0;1;1;54990;CELULAR NOKIA C1 PLUS BLUE;TELEFONIA
4370318;;M;83;CHILENO;;Silencioso;LEBU                          ;BIO BIO;54230;2;1;0;0;0;2;1;54230;CELULAR BMOBILE C40 CRIS OPEN;TELEFONIA
22462125;;F;58;COLOMBIANO;;Extranjero;PUENTE ALTO                   ;METROPOLITANA;450930;7;3;0;0;0;7;3;450930;CELULAR VIVO Y20 BLACK 64GB MOVISTAR;TELEFONIA
26819810;;F;29;EXTRANJERO - NO INFORMA NACIONALIDAD;;Extranjero;PROVIDENCIA                   ;METROPOLITANA;183980;2;1;2;1;183980;0;0;0;CELULAR REDMI NOTE 11 GRAPHITE GRAY + REDMI BUDS;TELEFONIA
14521846;;M;46;CHILENO;;X;PROVIDENCIA                   ;METROPOLITANA;980;2;1;0;0;0;2;1;980;CHIP OPEN ENTEL;TELEFONIA
17783788;Soltero;F;31;CHILENO;;Millenial;PROVIDENCIA                   ;METROPOLITANA;39990;1;1;1;1;39990;0;0;0;CELULAR BMOBILE BS30 BLACK OPEN;TELEFONIA
9948573;;M;57;CHILENO;;Boomers;PUENTE ALTO                   ;METROPOLITANA;446830;8;3;0;0;0;8;3;446830;CELULAR VIVO Y11S PHANTOM BLACK OPEN;TELEFONIA
12997501;;M;45;CHILENO;;X;PUENTE ALTO                   ;METROPOLITANA;223160;4;1;0;0;0;4;1;223160;SMARTPHONE A03s 64 GB Red DS;TELEFONIA
16927877;;F;34;CHILENO;;Millenial;ILLAPEL                       ;COQUIMBO;600120;4;2;0;0;0;4;2;600120;SMARTPHONE A52S 5G WHITE 128GB;TELEFONIA
10714585;;M;56;CHILENO;;Boomers;VALLENAR;ATACAMA;1849950;5;4;0;0;0;5;4;1849950;CELULAR GALAXY S22 ULTRA GREEN 128GB;TELEFONIA
12947780;;M;46;CHILENO;;X;QUILLOTA                      ;VALPARAISO;279980;4;2;0;0;0;4;2;279980;CELULAR REDMI NOTE 11 4/128GB GRAPHITE GRAY OPEN;TELEFONIA
11960910;;M;50;CHILENO;;X;CURANILAHUE                   ;BIO BIO;109990;1;1;0;0;0;1;1;109990;CELULAR REDMI 9C 64GB MIDNIGHT GRAY MOVISTAR;TELEFONIA
12235458;;F;50;CHILENO;;X;PENAFLOR                      ;METROPOLITANA;129990;1;1;0;0;0;1;1;129990;SMARTPHONE A03S 64 GB NEGRO;TELEFONIA
19790687;;F;24;CHILENO;;Z;PUERTO VARAS                  ;LOS LAGOS;229990;2;1;0;0;0;2;1;229990;CELULAR VIVO Y53S FANTASTIC RAINBOW 128GB OPEN;TELEFONIA
9201925;Soltero;F;62;CHILENO;;Boomers;RENCA                         ;METROPOLITANA;32980;2;2;0;0;0;2;2;32980;CELULAR AZUMI L4G BLACK CLARO;TELEFONIA
23981278;;F;44;CHILENO;;Extranjero;CALAMA                        ;ANTOFAGASTA;864201;8;3;0;0;0;8;3;864201;CELULAR VIVO V21 5G 128GB SUNSET DAZZLE OPEN;TELEFONIA
17513518;;F;32;CHILENO;;Millenial;RENCA                         ;METROPOLITANA;119990;1;1;1;1;119990;0;0;0;CELULAR VIVO Y20S NEBULA 128 GB BLUE OPEN;TELEFONIA
16953482;;F;33;CHILENO;;Millenial;N/D;N/D;230630;3;1;0;0;0;3;1;230630;CELULAR MOTOROLA G20 EDICION ESPECIAL VERDE CLAR;TELEFONIA
15278900;;M;38;CHILENO;;X;N/D;N/D;139990;2;1;0;0;0;2;1;139990;CELULAR REDMI NOTE 11 4/128GB TWILIGHT BLUE OPEN;TELEFONIA
18580371;;F;28;CHILENO;;Millenial;PROVIDENCIA                   ;METROPOLITANA;129990;2;1;0;0;0;2;1;129990;CELULAR REDMI NOTE 10 5G 4/128GB GRAPHITE GRAY O;TELEFONIA
16827944;;F;34;CHILENO;;Millenial;MELIPILLA                     ;METROPOLITANA;387970;3;2;0;0;0;3;2;387970;CELULAR SMARTPHONE A52S 5G LIGHT VIOLET 128GB;TELEFONIA
18060544;Casado;M;30;CHILENO;;Millenial;PAREDONES                     ;L.G.B.OÂ´HIGGINS;469964;8;3;0;0;0;8;3;469964;CELULAR XIAOMI REDMI 9A 2/32GB GRANITE GRAY;TELEFONIA
8686472;;F;60;CHILENO;;Boomers;OVALLE                        ;COQUIMBO;557641;9;4;2;1;157540;7;3;400101;CELULAR REDMI NOTE 11 GRAPHITE GRAY + REDMI BUDS;TELEFONIA
11335731;;F;54;CHILENO;;X;LA FLORIDA                    ;METROPOLITANA;189990;1;1;0;0;0;1;1;189990;CELULAR A32 128 GB LIGHT VIOLET OPEN;TELEFONIA
5852791;;F;73;CHILENO;;Silencioso;CASTRO                        ;LOS LAGOS;1918770;7;3;0;0;0;7;3;1918770;CELULAR GALAXY S22+ BLACK 128GB;TELEFONIA
6072743;;M;70;CHILENO;;Silencioso;QUILLOTA                      ;VALPARAISO;136800;2;1;0;0;0;2;1;136800;CELULAR GALAXY A03 CORE 2GB 32GB BLUE OPEN;TELEFONIA
8081322;;F;65;CHILENO;;Boomers;SAN CARLOS                    ;BIO BIO;386440;8;5;0;0;0;8;5;386440;CELULAR XIAOMI REDMI 9A 32GB GRANITE GRAY TRI WO;TELEFONIA
13983412;;F;41;CHILENO;;X;CALERA                        ;VALPARAISO;97000;0;2;1;1;119990;-1;1;-22990;CELULAR VIVO Y20S NEBULA 128 GB BLUE OPEN;TELEFONIA
7942929;;M;63;CHILENO;;Boomers;ANTOFAGASTA                   ;ANTOFAGASTA;147640;2;1;0;0;0;2;1;147640;CELULAR VIVO Y11S PHANTON BLACK 32GB MOVISTAR;TELEFONIA
14392823;;F;43;CHILENO;;X;PROVIDENCIA                   ;METROPOLITANA;209990;1;1;1;1;209990;0;0;0;CELULAR A52 128 GB LIGHT VIOLET OPEN;TELEFONIA
15935605;;M;37;CHILENO;;Millenial;PROVIDENCIA                   ;METROPOLITANA;274981;4;2;0;0;0;4;2;274981;CELULAR XIAOMI 11 LITE 5G NE 6/128GB TRUFFLE BLA;TELEFONIA
18619728;Soltero;F;29;CHILENO;TECNICO DE NIVEL SUPERIOR EN ALIMENTACION Y NUTRICION;Millenial;PROVIDENCIA                   ;METROPOLITANA;466980;2;1;2;1;466980;0;0;0;CELULAR XIAOMI 11T PRO 8/256GB MOON WHITE;TELEFONIA
16287291;Casado;M;35;CHILENO;;Millenial;PROVIDENCIA                   ;METROPOLITANA;34990;1;1;0;0;0;1;1;34990;CELULAR NOKIA 225 4G BLACK MOVISTAR DIRECTO;TELEFONIA
9306802;;M;59;CHILENO;;Boomers;LAUTARO                       ;ARAUCANIA;310170;3;2;0;0;0;3;2;310170;CELULAR A52 128 GB BLUE OPEN;TELEFONIA
11613284;;F;52;CHILENO;;X;IQUIQUE                       ;TARAPACA;217061;6;1;0;0;0;6;1;217061;CELULAR REDMI NOTE 11 4/128GB TWILIGHT BLUE OPEN;TELEFONIA
18402508;;F;28;CHILENO;;Millenial;CURICO                        ;MAULE;105040;2;1;0;0;0;2;1;105040;CELULAR GALAXY A03 CORE 2GB 32GB BLACK OPEN;TELEFONIA
8558513;;F;62;CHILENO;;Boomers;VINA DEL MAR                  ;VALPARAISO;173271;5;2;0;0;0;5;2;173271;CELULAR XIAOMI REDMI 9A 32GB GRANITE GRAY TRI WO;TELEFONIA
20309444;;F;22;CHILENO;;Z;PROVIDENCIA                   ;METROPOLITANA;119990;1;1;1;1;119990;0;0;0;CELULAR A12 128GB Rojo OPEN;TELEFONIA
13859170;;M;42;CHILENO;;X;SAN CARLOS                    ;BIO BIO;399980;6;2;0;0;0;6;2;399980;CELULAR A52 128 GB BLUE OPEN;TELEFONIA
9140595;;F;59;CHILENO;;Boomers;PEDRO AGUIRRE CERDA           ;METROPOLITANA;667940;7;3;0;0;0;7;3;667940;CELULAR MOTO G20 EDICION ESPECIAL 4/128 GB AZUL;TELEFONIA
14043001;Soltero;M;41;CHILENO;;X;RENCA                         ;METROPOLITANA;40190;2;1;0;0;0;2;1;40190;CELULAR BMOBILE BS30 BLACK OPEN;TELEFONIA
5967221;;M;75;CHILENO;;Silencioso;PROVIDENCIA                   ;METROPOLITANA;39990;1;1;0;0;0;1;1;39990;CELULAR BMOBILE C40 CRIS OPEN;TELEFONIA
11595360;;M;51;CHILENO;;X;PROVIDENCIA                   ;METROPOLITANA;119500;2;1;0;0;0;2;1;119500;CELULAR XIAOMI REDMI 9A 2/32GB GRANITE GRAY;TELEFONIA
8003302;;M;49;CHILENO;;X;MAIPU                         ;METROPOLITANA;269990;1;1;0;0;0;1;1;269990;CELULAR SMARTPHONE A52S 5G LIGHT VIOLET 128GB;TELEFONIA
10892920;;F;50;CHILENO;;X;LEBU                          ;BIO BIO;219990;1;1;0;0;0;1;1;219990;CELULAR A52 128 GB BLUE OPEN;TELEFONIA
8293160;;F;67;CHILENO;;Boomers;VALLENAR;ATACAMA;581750;3;2;0;0;0;3;2;581750;CELULAR SMARTPHONE A52S 5G LIGHT GREEN 128GB;TELEFONIA
15516484;;M;39;CHILENO;;X;COIHAIQUE                     ;AYSEN;513670;2;3;0;0;0;2;3;513670;CELULAR MOTO G100 128GB VERDE BOREAL + HMDI OPEN;TELEFONIA
12350715;Divorciado;M;50;CHILENO;;X;OVALLE                        ;COQUIMBO;880;2;1;0;0;0;2;1;880;CHIP OPEN ENTEL;TELEFONIA
14535901;;M;48;CHILENO;;X;CASTRO                        ;LOS LAGOS;189990;1;1;1;1;189990;0;0;0;CELULAR REDMI NOTE 11 GRAPHITE GRAY + REDMI BUDS;TELEFONIA
11541988;Casado;F;52;CHILENO;;X;RENCA                         ;METROPOLITANA;129990;1;1;0;0;0;1;1;129990;SMARTPHONE A03s 64 GB Red DS;TELEFONIA
19347376;Soltero;F;26;CHILENO;;Z;PROVIDENCIA                   ;METROPOLITANA;119990;1;1;1;1;119990;0;0;0;CELULAR A12 128GB Azul OPEN;TELEFONIA
20620528;;F;20;CHILENO;;Millenial;"";"";282460;4;2;0;0;0;4;2;282460;CELULAR VIVO Y11S 32GB NEBULA BLUE OPEN;TELEFONIA
14020446;;F;41;CHILENO;;X;N/D;N/D;657330;6;3;0;0;0;6;3;657330;CELULAR VIVO Y11S PHANTON BLACK 32GB MOVISTAR;TELEFONIA
11987617;;M;49;CHILENO;;X;CANETE                        ;BIO BIO;324981;3;2;0;0;0;3;2;324981;CELULAR A32 128 GB BLACK OPEN;TELEFONIA
25650378;;M;44;COLOMBIANO;;Extranjero;"";"";149990;2;1;0;0;0;2;1;149990;CELULAR POCO X3 PRO 128G PHANTOM BLACK OPEN;TELEFONIA
19237987;;F;26;CHILENO;;Z;ARICA                         ;TARAPACA;494990;2;1;0;0;0;2;1;494990;IPHONE 11 128GB BLACK CLARO;TELEFONIA
13460414;;F;44;CHILENO;;X;LA PINTANA                    ;METROPOLITANA;177990;4;2;0;0;0;4;2;177990;CELULAR VIVO Y21S MIDNIGHT BLUE 128 GB OPEN;TELEFONIA
17862365;Soltero;F;31;CHILENO;;Millenial;CORONEL                       ;BIO BIO;136980;2;1;0;0;0;2;1;136980;CELULAR CLARO MOTOROLA E7 32GB GRIS;TELEFONIA
9140770;Casado;F;60;CHILENO;;Boomers;PROVIDENCIA                   ;METROPOLITANA;99990;2;1;0;0;0;2;1;99990;CELULAR A12 128GB Negro OPEN;TELEFONIA
15115291;;F;39;CHILENO;;X;PERALILLO                     ;L.G.B.OÂ´HIGGINS;204980;3;2;0;0;0;3;2;204980;CELULAR A32 128 GB BLACK OPEN;TELEFONIA
19864887;;M;24;CHILENO;;Z;N/D;N/D;29990;1;3;1;3;29990;0;0;0;Celular SA3 CLARO DIRECTO BLACK;TELEFONIA
9826780;;F;58;CHILENO;;Boomers;PUTAENDO                      ;VALPARAISO;2631790;10;4;0;0;0;10;4;2631790;CELULAR A12 128GB Azul OPEN;TELEFONIA
7333243;;F;68;CHILENO;;Silencioso;PROVIDENCIA                   ;METROPOLITANA;34990;1;1;0;0;0;1;1;34990;CELULAR NOKIA 225 4G BLACK MOVISTAR DIRECTO;TELEFONIA
18949334;;M;27;CHILENO;;Z;N/D;N/D;109990;2;1;0;0;0;2;1;109990;CELULAR MOTO G20 EDICION ESPECIAL 4/128 GB AZUL;TELEFONIA
6696185;;M;66;CHILENO;;Boomers;LA CISTERNA                   ;METROPOLITANA;190980;2;1;0;0;0;2;1;190980;CELULAR MOTOROLA G30 GRIS WOM 128 GB;TELEFONIA
14390821;;M;44;CHILENO;;X;N/D;N/D;297110;7;3;0;0;0;7;3;297110;CELULAR A52 128 GB BLUE OPEN;TELEFONIA
6030920;;F;79;CHILENO;;Silencioso;RENCA                         ;METROPOLITANA;53980;2;1;0;0;0;2;1;53980;CELULAR BMOBILE C40 CRIS OPEN;TELEFONIA
18192928;;F;29;CHILENO;;Millenial;PROVIDENCIA                   ;METROPOLITANA;199990;1;1;0;0;0;1;1;199990;CELULAR A32 128 GB BLACK OPEN;TELEFONIA
7583234;;F;70;CHILENO;;Silencioso;OSORNO                        ;LOS LAGOS;116980;3;1;0;0;0;3;1;116980;CELULAR VIVO Y20 NEBULA BLUE OPEN;TELEFONIA
12521056;;M;49;CHILENO;;X;PROVIDENCIA                   ;METROPOLITANA;349990;1;1;0;0;0;1;1;349990;CELULAR VIVO V21 5G DUSK BLUE 128GB OPEN;TELEFONIA
10804321;;F;56;CHILENO;;Boomers;RENCA                         ;METROPOLITANA;345980;2;1;0;0;0;2;1;345980;CELULAR SMARTPHONE A52S 5G LIGHT VIOLET 128GB;TELEFONIA
13758650;;M;42;CHILENO;;X;"";"";857910;10;6;4;2;277960;6;4;579950;CELULAR RENO5 LITE NEGRO 128GB;TELEFONIA
17013168;;F;34;CHILENO;;Millenial;ARICA                         ;TARAPACA;496950;5;3;0;0;0;5;3;496950;CELULAR A32 128 GB BLACK OPEN;TELEFONIA
19590166;;F;25;CHILENO;;Z;RANCAGUA                      ;L.G.B.OÂ´HIGGINS;619950;5;3;0;0;0;5;3;619950;CELULAR GALAXY S20FE 128GB ClOUD NAVY OPEN;TELEFONIA
13491800;;F;44;CHILENO;;X;CARAHUE                       ;ARAUCANIA;276532;4;2;0;0;0;4;2;276532;CELULAR XIAOMI REDMI 9A 32GB GRANITE GRAY TRI WO;TELEFONIA
10052989;;M;56;CHILENO;;Boomers;RENCA                         ;METROPOLITANA;109990;1;1;0;0;0;1;1;109990;CELULAR VIVO Y11S PHANTOM BLACK OPEN;TELEFONIA
11957809;;M;50;CHILENO;;X;PENCO                         ;BIO BIO;99990;1;1;1;1;99990;0;0;0;CELULAR MOTOROLA E30 GRIS CLARO;TELEFONIA
15622574;;F;39;CHILENO;;X;MELIPILLA                     ;METROPOLITANA;323960;4;1;0;0;0;4;1;323960;CELULAR MOTO G60 4/128 GB SILVER OPEN;TELEFONIA
17150892;;F;33;CHILENO;;Millenial;N/D;N/D;303980;2;1;0;0;0;2;1;303980;CELULAR SMARTPHONE A52S 5G BLACK 128GB;TELEFONIA
4347101;;M;82;"";;Silencioso;RENCA                         ;METROPOLITANA;0;0;2;0;0;0;0;2;0;CELULAR AZUMI L4G BLACK CLARO;TELEFONIA
9330039;;M;61;CHILENO;;Boomers;PAINE                         ;METROPOLITANA;90000;2;1;0;0;0;2;1;90000;CELULAR MOTO E7 32GB GRIS OPEN;TELEFONIA
9739033;Soltero;F;58;CHILENO;;Boomers;SAN CARLOS                    ;BIO BIO;59980;2;1;0;0;0;2;1;59980;Celular SA3 CLARO DIRECTO BLACK;TELEFONIA
18617484;;F;27;CHILENO;;Millenial;COIHAIQUE                     ;AYSEN;389980;2;2;1;1;219990;1;1;169990;CELULAR A52 128 GB BLACK OPEN;TELEFONIA
12354444;Casado;M;52;CHILENO;;X;PAINE                         ;METROPOLITANA;80000;2;1;0;0;0;2;1;80000;CELULAR XIAOMI REDMI 9A 32GB GRANITE GRAY TRI WO;TELEFONIA
22333146;;M;46;COLOMBIANO;;Extranjero;PROVIDENCIA                   ;METROPOLITANA;275980;2;1;2;1;275980;0;0;0;CELULAR REDMI NOTE 10 PRO 128GB AZUL WOM;TELEFONIA
25339007;;M;38;PERUANO;;Extranjero;CONCHALI                      ;METROPOLITANA;219990;1;1;0;0;0;1;1;219990;CELULAR A52 128 GB BLACK OPEN;TELEFONIA
9849277;;F;59;CHILENO;;Boomers;TIRUA                         ;BIO BIO;54990;2;1;0;0;0;2;1;54990;CELULAR VIVO Y11S PHANTOM BLACK OPEN;TELEFONIA
5249403;;F;83;CHILENO;;Silencioso;TALCAHUANO                    ;BIO BIO;39990;1;1;0;0;0;1;1;39990;CELULAR BMOBILE C40 CRIS OPEN;TELEFONIA
17813781;Soltero;M;31;CHILENO;;Millenial;PROVIDENCIA                   ;METROPOLITANA;89990;1;1;0;0;0;1;1;89990;CELULAR XIAOMI REDMI 9A 2/32GB GRANITE GRAY;TELEFONIA
19142414;Soltero;M;26;CHILENO;;Z;PROVIDENCIA                   ;METROPOLITANA;399990;1;1;1;1;399990;0;0;0;CELULAR XIAOMI 11T 8/256GB METEORITE GRAY OPEN;TELEFONIA
17748177;;M;32;CHILENO;;Millenial;COIHUECO                      ;BIO BIO;149990;1;1;0;0;0;1;1;149990;CELULAR VIVO Y20S NEBULA 128 GB BLUE OPEN;TELEFONIA
11477642;;M;52;CHILENO;;X;CERRILLOS                     ;METROPOLITANA;273970;5;2;5;2;273970;0;0;0;CELULAR A12 128GB Negro OPEN;TELEFONIA
20211243;;F;22;CHILENO;;Z;PROVIDENCIA                   ;METROPOLITANA;609940;5;2;5;2;609940;0;0;0;CELULAR A52 128 GB LIGHT VIOLET OPEN;TELEFONIA
11589506;;F;53;CHILENO;;X;RENCA                         ;METROPOLITANA;89990;2;1;0;0;0;2;1;89990;CELULAR VIVO Y11S PHANTOM BLACK OPEN;TELEFONIA
15462275;;M;39;CHILENO;;X;CONSTITUCION                  ;MAULE;98990;3;1;0;0;0;3;1;98990;Celular LG K22 MOVISTAR DIRECTO TITAN;TELEFONIA
24191451;;M;49;BOLIVIANO;;Extranjero;CALAMA                        ;ANTOFAGASTA;72981;3;2;0;0;0;3;2;72981;CELULAR BMOBILE C40 CRIS OPEN;TELEFONIA
25972976;;F;47;VENEZOLANO;;Extranjero;LA CISTERNA                   ;METROPOLITANA;194990;4;1;0;0;0;4;1;194990;CELULAR REDMI NOTE 10 5G 4/128GB GRAPHITE GRAY O;TELEFONIA
14376672;;F;45;CHILENO;;X;BUIN                          ;METROPOLITANA;1346940;6;3;0;0;0;6;3;1346940;CELULAR SAMSUNG S21 FE 128GB GRAY OPEN;TELEFONIA
14289212;;F;48;CHILENO;;X;COLBUN                        ;MAULE;127980;2;1;0;0;0;2;1;127980;CELULAR VIVO Y20 NEBULA BLUE OPEN;TELEFONIA
16074962;;F;36;CHILENO;;Millenial;"";"";1140;4;1;0;0;0;4;1;1140;CHIP RECARGA CLARO;TELEFONIA
25350738;;F;50;COLOMBIANO;;Extranjero;SANTIAGO                      ;METROPOLITANA;430970;3;2;0;0;0;3;2;430970;POCO X3 PRO 256 GB PHANTOM BLACK;TELEFONIA
16964087;;M;33;CHILENO;;Millenial;MARIA ELENA                   ;ANTOFAGASTA;149990;1;1;0;0;0;1;1;149990;CELULAR SAMSUNG A12 128GB BLACK CLARO;TELEFONIA
13316019;Casado;F;45;CHILENO;ENFERMERA;X;RENCA                         ;METROPOLITANA;17990;1;1;1;1;17990;0;0;0;CELULAR NOKIA 110 BLACK OPEN;TELEFONIA
10611789;;F;56;CHILENO;;Boomers;CHIMBARONGO                   ;L.G.B.OÂ´HIGGINS;341960;4;2;0;0;0;4;2;341960;CELULAR A52 128 GB LIGHT VIOLET OPEN;TELEFONIA
9884582;;F;54;CHILENO;;X;NATALES                       ;MAGALLANES;129990;1;1;0;0;0;1;1;129990;SMARTPHONE A03S 64 GB NEGRO;TELEFONIA
12809466;Soltero;F;47;CHILENO;KINESIOLOGO;X;RENCA                         ;METROPOLITANA;649970;3;2;2;1;449980;1;1;199990;CELULAR A32 128 GB BLACK OPEN;TELEFONIA
14424416;Divorciado;F;47;CHILENO;INGENIERO COMERCIAL;X;PROVIDENCIA                   ;METROPOLITANA;653980;2;1;2;1;653980;0;0;0;CELULAR IPHONE 12 64GB BLACK CLARO;TELEFONIA
9896188;;M;59;CHILENO;;Boomers;RENCA                         ;METROPOLITANA;99990;1;1;0;0;0;1;1;99990;CELULAR CLARO MOTOROLA E7 32GB GRIS;TELEFONIA
15744685;;M;38;CHILENO;;Millenial;"";"";129990;1;1;0;0;0;1;1;129990;CELULAR MOTOROLA G20 EDICION ESPECIAL VERDE CLAR;TELEFONIA
10350479;;M;54;CHILENO;;X;ARICA                         ;ARICA Y PARINACOTA;239990;1;1;0;0;0;1;1;239990;CELULAR A52 128 GB BLUE OPEN;TELEFONIA
17791956;Soltero;F;31;CHILENO;;Millenial;QUILLOTA                      ;VALPARAISO;79990;1;1;0;0;0;1;1;79990;CELULAR XIAOMI REDMI 9A SE 2/32GB GB PEACOCK GRE;TELEFONIA
16827567;;F;34;CHILENO;;Millenial;PARRAL                        ;MAULE;385972;4;3;0;0;0;4;3;385972;CELULAR A22 128GB NEGRO;TELEFONIA
18113588;;M;30;CHILENO;;Millenial;"";"";990;1;1;0;0;0;1;1;990;CHIP OPEN ENTEL;TELEFONIA
11221004;;F;54;CHILENO;;X;SALAMANCA                     ;COQUIMBO;238130;3;2;0;0;0;3;2;238130;CELULAR A52 128 GB LIGHT VIOLET OPEN;TELEFONIA
5961119;;F;75;CHILENO;;Silencioso;N/D;N/D;129990;1;3;0;0;0;1;3;129990;CELULAR A12 128GB Azul OPEN;TELEFONIA
11768135;;M;51;CHILENO;;X;RENCA                         ;METROPOLITANA;109990;1;1;0;0;0;1;1;109990;SMARTPHONE A03S 32 GB ROJO;TELEFONIA
5495492;;M;77;CHILENO;;Silencioso;ROMERAL                       ;MAULE;153970;3;2;0;0;0;3;2;153970;CELULAR GALAXY A03 CORE 2GB 32GB BLACK OPEN;TELEFONIA
10466469;;F;56;CHILENO;;Boomers;RENCA                         ;METROPOLITANA;71990;2;1;0;0;0;2;1;71990;CELULAR VIVO Y11S PHANTON BLACK 32GB MOVISTAR;TELEFONIA
25273486;;M;44;VENEZOLANO;;Extranjero;SANTIAGO                      ;METROPOLITANA;219990;1;1;0;0;0;1;1;219990;CELULAR A52 128 GB BLACK OPEN;TELEFONIA
22929530;;M;43;PERUANO;;Extranjero;ARICA                         ;ARICA Y PARINACOTA;269990;1;3;0;0;0;1;3;269990;CELULAR SMARTPHONE A52S 5G BLACK 128GB;TELEFONIA
8768246;Divorciado;M;63;CHILENO;;Boomers;RENCA                         ;METROPOLITANA;219992;3;1;0;0;0;3;1;219992;CELULAR MOTO G60S 6/128 GB AZUL;TELEFONIA
16774795;;F;35;CHILENO;;Millenial;VINA DEL MAR                  ;VALPARAISO;129480;2;1;0;0;0;2;1;129480;CELULAR VIVO Y11S PHANTOM BLACK OPEN;TELEFONIA
6670460;;F;65;CHILENO;;Boomers;IQUIQUE                       ;TARAPACA;199991;2;1;0;0;0;2;1;199991;CELULAR REDMI NOTE 11 4/128GB GRAPHITE GRAY OPEN;TELEFONIA
16215729;;F;37;CHILENO;;Millenial;N/D;N/D;296980;2;2;0;0;0;2;2;296980;CELULAR SMARTPHONE A52S 5G BLACK 128GB;TELEFONIA
5253229;;M;75;CHILENO;;Silencioso;LOS ANGELES                   ;BIO BIO;129990;1;1;0;0;0;1;1;129990;CELULAR A12 128GB Azul OPEN;TELEFONIA
15569049;;F;39;CHILENO;;X;N/D;N/D;139990;1;1;1;1;139990;0;0;0;CELULAR NOKIA G20 4/128 GB BLUE TRI WOM;TELEFONIA
7452127;;F;64;CHILENO;;Boomers;CHANARAL                      ;ATACAMA;213980;2;1;2;1;213980;0;0;0;CELULAR A32 128 GB BLACK OPEN;TELEFONIA
15033963;;M;39;CHILENO;;X;VALLENAR;ATACAMA;139990;1;1;0;0;0;1;1;139990;CELULAR A12 128GB Rojo OPEN;TELEFONIA
15047379;;F;38;CHILENO;;X;N/D;N/D;380960;4;2;2;1;225980;2;1;154980;CELULAR MOTO ONE FUSION 64GB VERDE 64GB OPEN;TELEFONIA
16577066;;F;33;CHILENO;;Millenial;MELIPILLA                     ;METROPOLITANA;683950;6;3;6;3;683950;0;0;0;CELULAR MOTOROLA G20 EDICION ESPECIAL VERDE CLAR;TELEFONIA
15178402;;F;39;CHILENO;;Silencioso;PROVIDENCIA                   ;METROPOLITANA;225980;2;1;2;1;225980;0;0;0;CELULAR A52 128 GB LIGHT VIOLET OPEN;TELEFONIA
10254132;;M;57;CHILENO;;Boomers;ARICA                         ;ARICA Y PARINACOTA;529970;3;3;0;0;0;3;3;529970;CELULAR VIVO Y53S FANTASTIC RAINBOW 128GB OPEN;TELEFONIA
18616889;;F;28;CHILENO;;Millenial;N/D;N/D;1345880;12;5;12;5;1345880;0;0;0;CELULAR A52 128 GB BLACK OPEN;TELEFONIA
19023762;;M;27;CHILENO;;Z;PUENTE ALTO                   ;METROPOLITANA;899990;2;1;2;1;899990;0;0;0;CELULAR GALAXY S22 ULTRA WHITE 256GB;TELEFONIA
13368748;;M;44;CHILENO;;X;MAIPU                         ;METROPOLITANA;183980;2;1;2;1;183980;0;0;0;CELULAR MOTO G50 AZUL 128 GB OPEN;TELEFONIA
16510404;;M;35;CHILENO;;Millenial;SAN ANTONIO                   ;VALPARAISO;169990;1;1;0;0;0;1;1;169990;CELULAR VIVO Y21S MIDNIGHT BLUE 128 GB OPEN;TELEFONIA
5582125;;M;74;CHILENO;;Silencioso;PROVIDENCIA                   ;METROPOLITANA;60980;3;1;0;0;0;3;1;60980;SMARTPHONE A03S AZUL 32GB;TELEFONIA
16400687;;M;35;CHILENO;;Millenial;"";"";280970;3;2;0;0;0;3;2;280970;CELULAR GALAXY A22 5G 4+128GB GRAY;TELEFONIA
15225874;;F;40;CHILENO;;X;LOS SAUCES                    ;ARAUCANIA;1069970;4;3;0;0;0;4;3;1069970;IPHONE 11 64GB BLACK CLARO;TELEFONIA
18987571;;M;26;CHILENO;;Z;CURANILAHUE                   ;BIO BIO;189980;2;1;0;0;0;2;1;189980;CELULAR A12 128GB Rojo OPEN;TELEFONIA
11685248;;F;51;CHILENO;;X;LOTA                          ;BIO BIO;179990;1;1;0;0;0;1;1;179990;CELULAR VIVO Y21S MIDNIGHT BLUE 128 GB OPEN;TELEFONIA
16837787;Soltero;F;34;CHILENO;TERAPEUTA OCUPACIONAL;Millenial;PROVIDENCIA                   ;METROPOLITANA;129960;4;2;4;2;129960;0;0;0;VIVO Y20 OBSIDIAN BLACK OPEN;TELEFONIA
10672904;Casado;M;55;CHILENO;;Z;TALCA                         ;MAULE;89990;1;1;0;0;0;1;1;89990;CELULAR XIAOMI REDMI 9 MORADO ENTEL;TELEFONIA
18242909;;F;30;CHILENO;;Millenial;PROVIDENCIA                   ;METROPOLITANA;293980;2;1;2;1;293980;0;0;0;CELULAR 11 LITE 5G NE 8/128GB PEACH PINK OPEN;TELEFONIA
14023719;;F;40;CHILENO;;X;PROVIDENCIA                   ;METROPOLITANA;166980;2;1;0;0;0;2;1;166980;CELULAR VIVO Y20 NEBULA BLUE OPEN;TELEFONIA
19179312;Soltero;M;26;CHILENO;;Z;PROVIDENCIA                   ;METROPOLITANA;431970;3;1;3;1;431970;0;0;0;CELULAR MOTO G100 128GB VERDE BOREAL + HMDI OPEN;TELEFONIA
10166876;;F;57;CHILENO;;Boomers;RENCA                         ;METROPOLITANA;265980;2;1;0;0;0;2;1;265980;CELULAR A32 128 GB BLACK OPEN;TELEFONIA
8496552;;F;61;CHILENO;;Boomers;PROVIDENCIA                   ;METROPOLITANA;172110;8;2;0;0;0;8;2;172110;CELULAR VIVO Y11S PHANTOM BLACK OPEN;TELEFONIA
12219402;;F;51;CHILENO;;X;LA SERENA                     ;COQUIMBO;308970;3;2;0;0;0;3;2;308970;SMARTPHONE A22 BLANCO 128GB;TELEFONIA
17535990;;F;34;CHILENO;;Millenial;MAIPU                         ;METROPOLITANA;0;0;2;0;0;0;0;2;0;PLAN MSM WOM 150 GB $13990 PORTA POST;TELEFONIA
20052335;;F;23;CHILENO;;Z;PROVIDENCIA                   ;METROPOLITANA;289990;1;1;1;1;289990;0;0;0;CELULAR 11 LITE 5G NE 8/128GB PEACH PINK OPEN;TELEFONIA
9927976;;F;58;CHILENO;;Boomers;ILLAPEL                       ;COQUIMBO;194970;3;2;0;0;0;3;2;194970;CELULAR A12 128GB Rojo OPEN;TELEFONIA
18687270;;M;27;CHILENO;;Z;PROVIDENCIA                   ;METROPOLITANA;164990;2;1;0;0;0;2;1;164990;POCO X3 PRO 256 GB PHANTOM BLACK;TELEFONIA
12008681;;F;48;CHILENO;;X;COLINA                        ;METROPOLITANA;108980;3;1;0;0;0;3;1;108980;CELULAR VIVO Y11S PHANTON BLACK 32GB MOVISTAR;TELEFONIA
17462539;;M;32;CHILENO;;Millenial;SAN BERNARDO                  ;METROPOLITANA;139990;1;1;0;0;0;1;1;139990;CELULAR A12 128GB Azul OPEN;TELEFONIA
13392087;;F;44;CHILENO;;X;RENCA                         ;METROPOLITANA;127980;2;1;0;0;0;2;1;127980;SMARTPHONE A03S AZUL 32GB;TELEFONIA
15033633;Soltero;M;40;CHILENO;;X;RENCA                         ;METROPOLITANA;99990;1;1;0;0;0;1;1;99990;CELULAR VIVO Y11S PHANTOM BLACK OPEN;TELEFONIA
17939168;Soltero;M;30;CHILENO;;Millenial;PROVIDENCIA                   ;METROPOLITANA;49990;2;1;0;0;0;2;1;49990;CELULAR VIVO Y11S PHANTOM BLACK OPEN;TELEFONIA
16830196;;F;33;CHILENO;;Millenial;PROVIDENCIA                   ;METROPOLITANA;99990;2;1;0;0;0;2;1;99990;CELULAR A12 128GB Negro OPEN;TELEFONIA
8948389;;M;61;CHILENO;;Boomers;COLINA                        ;METROPOLITANA;119990;1;1;0;0;0;1;1;119990;CELULAR MOTOROLA G20 64GB BLUE CLARO;TELEFONIA
9521643;;M;59;CHILENO;;Boomers;MELIPILLA                     ;METROPOLITANA;224970;3;2;0;0;0;3;2;224970;CELULAR A12 128GB Azul OPEN;TELEFONIA
7126302;;M;70;CHILENO;;Silencioso;CUNCO                         ;ARAUCANIA;119990;1;1;0;0;0;1;1;119990;SMARTPHONE A03S NEGRO 32GB;TELEFONIA
18011018;;F;30;CHILENO;;Millenial;OVALLE;COQUIMBO;119990;1;1;0;0;0;1;1;119990;CELULAR MOTOROLA G20 EDICION ESPECIAL VERDE CLAR;TELEFONIA
19722132;;F;25;CHILENO;;Z;N/D;N/D;1000;2;1;0;0;0;2;1;1000;CHIP PREPAGO 2000 WOM;TELEFONIA
26759762;;M;37;VENEZOLANO;;Extranjero;N/D;N/D;638882;9;4;0;0;0;9;4;638882;CELULAR A12 128GB Rojo OPEN;TELEFONIA
11287168;;F;54;CHILENO;;X;RENCA                         ;METROPOLITANA;25981;3;1;0;0;0;3;1;25981;CELULAR NOKIA 110 BLACK OPEN;TELEFONIA
17446952;;F;32;CHILENO;;Millenial;RENCA                         ;METROPOLITANA;309990;1;1;0;0;0;1;1;309990;SMARTPHONE A52S 5G WHITE 128GB;TELEFONIA
10279467;;F;55;CHILENO;;Boomers;ARAUCO                        ;BIO BIO;331970;3;4;0;0;0;3;4;331970;CELULAR NOKIA 225 4G BLACK MOVISTAR DIRECTO;TELEFONIA
18999466;Soltero;M;26;CHILENO;INGENIERO EN CONSTRUCCION;Z;PROVIDENCIA                   ;METROPOLITANA;158980;2;2;0;0;0;2;2;158980;CELULAR A12 128GB Azul OPEN;TELEFONIA
14298367;;M;47;CHILENO;;X;COLINA                        ;METROPOLITANA;159990;2;1;0;0;0;2;1;159990;CELULAR MOTO G30 128GB GRIS TORNASOL OPEN;TELEFONIA
14058457;;M;42;CHILENO;;X;N/D;N/D;400970;3;3;1;1;299990;2;2;100980;CELULAR IPHONE SE 64GB DIRECTO CLARO;TELEFONIA
12391244;;M;50;CHILENO;;X;QUELLON                       ;LOS LAGOS;372970;3;3;0;0;0;3;3;372970;CELULAR A12 128GB Negro OPEN;TELEFONIA
13328052;;M;44;CHILENO;;X;VALLENAR;ATACAMA;1742120;7;5;0;0;0;7;5;1742120;CELULAR MOTO G100 128GB VERDE BOREAL + HMDI OPEN;TELEFONIA
13441461;;F;44;CHILENO;;X;LA SERENA;COQUIMBO;990;1;1;0;0;0;1;1;990;CHIP OPEN ENTEL;TELEFONIA
15117735;;M;40;CHILENO;;X;SAN FERNANDO                  ;L.G.B.OÂ´HIGGINS;199980;2;2;0;0;0;2;2;199980;SMARTPHONE A03S 32 GB ROJO;TELEFONIA
10148031;;M;55;CHILENO;;Boomers;LAMPA                         ;METROPOLITANA;133980;2;1;2;1;133980;0;0;0;CELULAR A12 128GB Azul OPEN;TELEFONIA
18204085;;F;30;CHILENO;;Millenial;PROVIDENCIA                   ;METROPOLITANA;93980;2;1;2;1;93980;0;0;0;CELULAR MOTO E7 32GB GRIS OPEN;TELEFONIA
18543666;;M;28;CHILENO;;Millenial;ARAUCO                        ;BIO BIO;75990;1;1;0;0;0;1;1;75990;CELULAR MOTOROLA E6 PLAY AZUL TRI WOM;TELEFONIA
15792200;;F;37;CHILENO;;Millenial;N/D;N/D;34990;2;1;0;0;0;2;1;34990;CELULAR MOTO E7 32GB GRIS OPEN;TELEFONIA
9592622;;M;59;CHILENO;;Boomers;SAN CARLOS                    ;BIO BIO;220980;2;1;0;0;0;2;1;220980;POCO X3 PRO 256 GB PHANTOM BLACK;TELEFONIA
15817532;;M;38;CHILENO;;Millenial;"";"";249980;2;1;0;0;0;2;1;249980;CELULAR REDMI NOTE 10S 128GB PEBBLE WHITE;TELEFONIA
19676393;;F;31;CHILENO;;Millenial;N/D;N/D;301470;3;2;0;0;0;3;2;301470;CELULAR A32 128 GB BLACK OPEN;TELEFONIA
6984741;;M;68;CHILENO;;Silencioso;CHIMBARONGO                   ;L.G.B.OÂ´HIGGINS;67970;3;3;0;0;0;3;3;67970;CELULAR AZUMI L4G BLACK CLARO;TELEFONIA
10551765;;F;60;CHILENO;;Boomers;LAMPA                         ;METROPOLITANA;129990;1;1;0;0;0;1;1;129990;CELULAR A12 128GB Rojo OPEN;TELEFONIA
15755290;;M;38;CHILENO;;Millenial;PROVIDENCIA                   ;METROPOLITANA;143980;2;1;2;1;143980;0;0;0;CELULAR A12 128GB Negro OPEN;TELEFONIA
13648273;;M;43;CHILENO;;X;OVALLE                        ;COQUIMBO;74990;2;1;0;0;0;2;1;74990;CELULAR A12 128GB Negro OPEN;TELEFONIA
9619493;;M;56;CHILENO;;Boomers;MAIPU                         ;METROPOLITANA;169990;1;1;0;0;0;1;1;169990;CELULAR MOTOROLA G9 PLAY 64GB ELECTRIC BLUE OPEN;TELEFONIA
17912675;;F;30;CHILENO;;Millenial;CONCEPCION                    ;BIO BIO;1208930;7;2;0;0;0;7;2;1208930;CELULAR VIVO V21 5G 128GB SUNSET DAZZLE OPEN;TELEFONIA
7096797;;M;68;CHILENO;;Silencioso;PROVIDENCIA                   ;METROPOLITANA;139990;1;1;0;0;0;1;1;139990;CELULAR Moto G20 Blue WOM;TELEFONIA
18111112;Soltero;M;30;CHILENO;;Millenial;SAN PEDRO DE LA PAZ           ;BIO BIO;190000;2;1;0;0;0;2;1;190000;CELULAR MOTO G50 AZUL 128 GB OPEN;TELEFONIA
12806755;;M;46;CHILENO;;X;RENCA                         ;METROPOLITANA;61990;2;1;0;0;0;2;1;61990;CELULAR VIVO Y11S PHANTON BLACK 32GB MOVISTAR;TELEFONIA
18229875;;F;30;CHILENO;;Millenial;PROVIDENCIA                   ;METROPOLITANA;441971;4;3;0;0;0;4;3;441971;SMARTPHONE A22 BLANCO 128GB;TELEFONIA
20220041;;F;23;CHILENO;;Z;PROVIDENCIA                   ;METROPOLITANA;283980;2;1;2;1;283980;0;0;0;CELULAR SMARTPHONE A52S 5G BLACK 128GB;TELEFONIA
16855481;Casado;M;34;CHILENO;PROFESOR;Millenial;PROVIDENCIA                   ;METROPOLITANA;2103970;7;2;7;2;2103970;0;0;0;CELULAR GALAXY S22 ULTRA WHITE 128GB;TELEFONIA
16272020;Soltero;M;36;CHILENO;MANTENIMIENTO INDUSTRIAL;Millenial;PROVIDENCIA                   ;METROPOLITANA;248990;2;1;2;1;248990;0;0;0;CELULAR A52 128 GB BLACK OPEN;TELEFONIA
13448080;;F;44;CHILENO;;X;MAIPU                         ;METROPOLITANA;75140;3;1;0;0;0;3;1;75140;CELULAR A12 128GB Rojo OPEN;TELEFONIA
19876441;;F;23;CHILENO;;Millenial;"";"";74990;2;1;0;0;0;2;1;74990;CELULAR MOTOROLA G20 EDICION ESPECIAL VERDE CLAR;TELEFONIA
8034778;;F;68;CHILENO;;Boomers;N/D;N/D;243970;3;2;0;0;0;3;2;243970;SMARTPHONE A22 BLANCO 128GB;TELEFONIA
11527798;Soltero;F;52;CHILENO;;X;PROVIDENCIA                   ;METROPOLITANA;224970;3;3;0;0;0;3;3;224970;CELULAR A12 128GB Azul OPEN;TELEFONIA
10797965;;F;55;CHILENO;;Boomers;MELIPILLA                     ;METROPOLITANA;77980;3;1;0;0;0;3;1;77980;CELULAR VIVO Y11S 32GB NEBULA BLUE OPEN;TELEFONIA
5539605;;M;77;CHILENO;;Silencioso;SAN IGNACIO                   ;BIO BIO;1031980;2;1;0;0;0;2;1;1031980;CELULAR IPHONE 12 64GB BLACK CLARO;TELEFONIA
18238998;;F;29;CHILENO;;Millenial;"";"";416970;4;2;0;0;0;4;2;416970;POCO X3 PRO 256 GB PHANTOM BLACK;TELEFONIA
20035235;;F;23;CHILENO;;Z;CHEPICA;O HIGGINS;429990;1;1;0;0;0;1;1;429990;CELULAR A72 128 GB LIGHT VIOLET OPEN;TELEFONIA
17709271;Soltero;M;30;CHILENO;;Millenial;PROVIDENCIA                   ;METROPOLITANA;990;1;1;0;0;0;1;1;990;CHIP OPEN ENTEL;TELEFONIA
11220816;;F;53;CHILENO;;X;RENCA                         ;METROPOLITANA;259980;2;1;2;1;259980;0;0;0;CELULAR A52 128 GB LIGHT VIOLET OPEN;TELEFONIA
9262832;;F;66;CHILENO;;Boomers;TALCA                         ;MAULE;319990;1;1;0;0;0;1;1;319990;CELULAR XIAOMI 11 LITE 5G NE 8/128GB TRUFFLE BLA;TELEFONIA
11225817;;F;54;CHILENO;;X;TORTEL                        ;AYSEN;79990;1;1;0;0;0;1;1;79990;CELULAR REDMI 9A 32GB PEACOCK GREEN;TELEFONIA
25582663;Soltero;F;28;VENEZOLANO;;Extranjero;PROVIDENCIA                   ;METROPOLITANA;223980;2;1;2;1;223980;0;0;0;CELULAR RENO5 LITE VIOLETA 128GB;TELEFONIA
17720861;;M;28;CHILENO;;Millenial;PROVIDENCIA                   ;METROPOLITANA;529980;2;1;0;0;0;2;1;529980;CELULAR XIAOMI 11T 8/256GB MOONLIGHT WHITE OPEN;TELEFONIA
9545936;;F;58;CHILENO;;Boomers;CASTRO                        ;LOS LAGOS;624970;3;4;0;0;0;3;4;624970;CELULAR A12 128GB Negro OPEN;TELEFONIA
10795362;;F;56;CHILENO;;Boomers;PROVIDENCIA                   ;METROPOLITANA;282980;2;2;0;0;0;2;2;282980;CELULAR A52 128 GB BLACK OPEN;TELEFONIA
17264686;;F;33;CHILENO;;Millenial;MAIPU                         ;METROPOLITANA;239980;3;2;3;2;239980;0;0;0;SMARTHPHONE REDMI 10 US 64GB SEA BLUE;TELEFONIA
14264679;;F;51;CHILENO;;X;DALCAHUE                      ;LOS LAGOS;415970;3;2;2;1;295980;1;1;119990;CELULAR A12 128GB Rojo OPEN;TELEFONIA
15237859;Casado;F;39;CHILENO;;X;NUEVA IMPERIAL                ;ARAUCANIA;329960;5;2;0;0;0;5;2;329960;REDMI 10 US 128GB Carbon Gray;TELEFONIA
18044272;;M;29;CHILENO;;Millenial;N/D;N/D;299990;1;1;0;0;0;1;1;299990;CELULAR SMARTPHONE A52S 5G LIGHT GREEN 128GB;TELEFONIA
15977990;;M;36;CHILENO;;Millenial;SALAMANCA                     ;COQUIMBO;233940;6;3;0;0;0;6;3;233940;CELULAR MOTO E7 32GB GRIS OPEN;TELEFONIA
13731423;;F;43;CHILENO;;Millenial;"";"";99990;1;1;0;0;0;1;1;99990;CELULAR VIVO Y11S PHANTOM BLACK OPEN;TELEFONIA
5078852;Casado;F;75;CHILENO;ASISTENTE SOCIAL;Silencioso;RENCA                         ;METROPOLITANA;194980;2;1;2;1;194980;0;0;0;CELULAR MOTO G50 AZUL 128 GB OPEN;TELEFONIA
10762189;;M;56;CHILENO;;Boomers;SAN FELIPE                    ;VALPARAISO;129990;1;1;0;0;0;1;1;129990;CELULAR MOTO G20 EDICION ESPECIAL 4/128 GB AZUL;TELEFONIA
8302086;;M;71;CHILENO;;Silencioso;SAGRADA FAMILIA               ;MAULE;30990;3;1;0;0;0;3;1;30990;Celular SA3 CLARO DIRECTO BLACK;TELEFONIA
13564094;;F;43;CHILENO;;X;COLINA                        ;METROPOLITANA;298980;2;1;0;0;0;2;1;298980;CELULAR MOTO G60S 6/128 GB AZUL;TELEFONIA
21874714;;M;46;PERUANO;;Extranjero;N/D;N/D;1632050;6;4;0;0;0;6;4;1632050;CELULAR POCO X3 PRO 128G PHANTOM BLACK OPEN;TELEFONIA
12583924;;F;48;CHILENO;;X;RENCA                         ;METROPOLITANA;99990;1;1;1;1;99990;0;0;0;SMARTPHONE A03S 32 GB ROJO;TELEFONIA
6110859;;M;70;CHILENO;;Silencioso;ANTOFAGASTA                   ;ANTOFAGASTA;592980;2;2;0;0;0;2;2;592980;IPHONE 11 64GB BLACK CLARO;TELEFONIA
19448377;;F;25;CHILENO;;Z;SAN FELIPE                    ;VALPARAISO;219991;2;1;0;0;0;2;1;219991;POCO X3 PRO 256 GB PHANTOM BLACK;TELEFONIA
13572238;;M;43;CHILENO;;X;TENO                          ;MAULE;193971;5;2;0;0;0;5;2;193971;CELULAR BMOBILE C40 CRIS OPEN;TELEFONIA
12784342;;M;47;CHILENO;;X;ROMERAL                       ;MAULE;69990;2;1;0;0;0;2;1;69990;CELULAR REDMI 9A 32GB PEACOCK GREEN;TELEFONIA
18321420;;M;29;CHILENO;;Millenial;N/D;N/D;269990;1;1;1;1;269990;0;0;0;CELULAR REDMI NOTE 10 PRO 128GB AZUL WOM;TELEFONIA
17287826;;M;32;CHILENO;;Millenial;N/D;N/D;161990;2;1;0;0;0;2;1;161990;CELULAR XIAOMI POCO X3 PRO 128GB PANTHOM BLACK;TELEFONIA
12531071;;M;51;CHILENO;;X;RENCA                         ;METROPOLITANA;219990;1;1;0;0;0;1;1;219990;CELULAR MOTO G60S 6/128 GB AZUL;TELEFONIA
11849839;Casado;M;52;CHILENO;;X;SAN BERNARDO                  ;METROPOLITANA;104990;2;1;0;0;0;2;1;104990;CELULAR VIVO Y20S OBSIDIAN BLACK 128GB OPEN;TELEFONIA
20447861;;F;22;CHILENO;;Millenial;"";"";109990;1;1;0;0;0;1;1;109990;CELULAR VIVO Y11S PHANTOM BLACK OPEN;TELEFONIA
16206762;;M;36;CHILENO;;Millenial;ANCUD                         ;LOS LAGOS;1000;2;1;0;0;0;2;1;1000;CHIP OPEN ENTEL;TELEFONIA
10535939;Casado;M;56;CHILENO;INGENIERO CIVIL INDUSTRIAL;Boomers;RENCA                         ;METROPOLITANA;1019960;4;2;4;2;1019960;0;0;0;CELULAR SMARTPHONE A52S 5G BLACK 128GB;TELEFONIA
7320759;;F;67;CHILENO;;Boomers;SAN CLEMENTE                  ;MAULE;379960;4;2;0;0;0;4;2;379960;CELULAR XIAOMI REDMI 9A 32GB BLACK DIRECTO CLARO;TELEFONIA
7990108;;M;62;CHILENO;;Boomers;SAN FERNANDO                  ;L.G.B.OÂ´HIGGINS;80980;2;1;0;0;0;2;1;80980;CELULAR XIAOMI REDMI 9A 32GB GRANITE GRAY TRI WO;TELEFONIA
19288841;Soltero;M;26;CHILENO;;Millenial;N/D;N/D;703980;2;1;2;1;703980;0;0;0;CELULAR IPHONE 12 64GB BLACK CLARO;TELEFONIA
15190246;;M;40;CHILENO;;X;SANTA JUANA                   ;BIO BIO;325971;4;2;0;0;0;4;2;325971;CELULAR REDMI 9A 32GB PEACOCK GREEN;TELEFONIA
11048237;;F;55;CHILENO;;Boomers;"";"";634980;2;3;2;1;53980;0;2;581000;CELULAR HUAWEI NOVA 9 BLACK + FREEBUDS 4;TELEFONIA
20102301;;F;23;CHILENO;;Z;ERCILLA                       ;ARAUCANIA;229980;3;1;0;0;0;3;1;229980;CELULAR A32 128 GB BLUE OPEN;TELEFONIA
18349569;;M;29;CHILENO;;Millenial;PROVIDENCIA                   ;METROPOLITANA;459990;2;1;2;1;459990;0;0;0;CELULAR XIAOMI 11T 8/256GB MOONLIGHT WHITE KIT O;TELEFONIA
25829354;Soltero;F;28;EXTRANJERO - NO INFORMA NACIONALIDAD;;Extranjero;"";"";283980;2;1;2;1;283980;0;0;0;CELULAR SMARTPHONE A52S 5G BLACK 128GB;TELEFONIA
26882147;Soltero;F;64;EXTRANJERO - NO INFORMA NACIONALIDAD;;Extranjero;PROVIDENCIA                   ;METROPOLITANA;458971;4;3;0;0;0;4;3;458971;POCO X3 PRO 256 GB METAL BRONCE;TELEFONIA
10343362;;M;56;CHILENO;;Boomers;PENAFLOR                      ;METROPOLITANA;369980;2;2;0;0;0;2;2;369980;CELULAR SMARTPHONE A52S 5G BLACK 128GB;TELEFONIA
18010847;;F;30;CHILENO;;Millenial;N/D;N/D;110561;2;1;0;0;0;2;1;110561;CELULAR REDMI 9T 128 GB OCEAN GREEN;TELEFONIA
18818570;;M;28;CHILENO;;Millenial;COIHAIQUE                     ;AYSEN;439990;1;1;0;0;0;1;1;439990;CELULAR XIAOMI 11T 8/256GB MOONLIGHT WHITE KIT;TELEFONIA
13808018;;F;44;CHILENO;;X;ERCILLA                       ;ARAUCANIA;224970;3;2;0;0;0;3;2;224970;CELULAR A12 128GB Azul OPEN;TELEFONIA
16533079;;F;35;CHILENO;;Millenial;NUEVA IMPERIAL                ;ARAUCANIA;476950;6;3;0;0;0;6;3;476950;XIAOMI REDMI 9T GRIS WOM 128 GB;TELEFONIA
19650368;;F;25;CHILENO;;Z;CONSTITUCION                  ;MAULE;279980;2;4;1;1;49990;1;3;229990;CELULAR POCO X3 PRO 128G PHANTOM BLACK OPEN;TELEFONIA
16728295;;F;34;CHILENO;;Millenial;PROVIDENCIA                   ;METROPOLITANA;247960;4;3;0;0;0;4;3;247960;CELULAR XIAOMI REDMI 9A 32GB GRANITE GRAY TRI WO;TELEFONIA
8499140;;M;63;CHILENO;;Boomers;VILLARICA                     ;ARAUCANIA;279981;3;2;0;0;0;3;2;279981;CELULAR A12 128GB Rojo OPEN;TELEFONIA
13793457;;F;42;CHILENO;;X;SAN CARLOS                    ;BIO BIO;299990;1;1;0;0;0;1;1;299990;CELULAR SMARTPHONE A52S 5G LIGHT VIOLET 128GB;TELEFONIA
7032469;;M;69;CHILENO;;Silencioso;LONCOCHE                      ;ARAUCANIA;90980;2;1;0;0;0;2;1;90980;CELULAR XIAOMI REDMI 9A 32GB GRANITE GRAY TRI WO;TELEFONIA
27107779;Soltero;M;26;VENEZOLANO;;Extranjero;SANTIAGO                      ;METROPOLITANA;853980;2;1;2;1;853980;0;0;0;CELULAR IPHONE 12 PRO MAX 128GB AZUL CLARO;TELEFONIA
10613508;;F;54;CHILENO;;Boomers;ANCUD                         ;LOS LAGOS;41990;2;1;0;0;0;2;1;41990;CELULAR MOTO E7I POWER ORANGE 32GB MOVISTAR;TELEFONIA
9174150;;M;58;CHILENO;;Boomers;SAN CLEMENTE                  ;MAULE;129990;1;1;0;0;0;1;1;129990;CELULAR A12 128GB Rojo OPEN;TELEFONIA
19449622;;M;25;CHILENO;;Silencioso;PROVIDENCIA                   ;METROPOLITANA;299990;1;1;1;1;299990;0;0;0;CELULAR IPHONE SE 64GB DIRECTO CLARO;TELEFONIA
13992708;;F;41;CHILENO;;X;N/D;N/D;305970;3;2;0;0;0;3;2;305970;CELULAR A32 128 GB BLUE OPEN;TELEFONIA
5387541;;F;74;CHILENO;;Silencioso;CHILLAN VIEJO                 ;BIO BIO;313970;3;2;0;0;0;3;2;313970;CELULAR A32 128 GB BLACK OPEN;TELEFONIA
13630648;;M;43;CHILENO;;X;TENO                          ;MAULE;618920;8;4;0;0;0;8;4;618920;CELULAR A22 128GB NEGRO;TELEFONIA
19372627;;M;25;CHILENO;;Z;N/D;N/D;289990;2;1;0;0;0;2;1;289990;CELULAR SMARTPHONE A52S 5G BLACK 128GB;TELEFONIA
9656168;;F;56;CHILENO;;Boomers;RENCA                         ;METROPOLITANA;335980;2;1;0;0;0;2;1;335980;CELULAR SMARTPHONE A52S 5G BLACK 128GB;TELEFONIA
15256716;;M;40;CHILENO;;X;SAN PEDRO DE LA PAZ           ;BIO BIO;299990;2;1;0;0;0;2;1;299990;CELULAR IPHONE SE 64GB DIRECTO CLARO;TELEFONIA
9805479;Soltero;F;58;CHILENO;;Boomers;PROVIDENCIA                   ;METROPOLITANA;273980;2;1;2;1;273980;0;0;0;CELULAR SMARTPHONE A52S 5G BLACK 128GB;TELEFONIA
8523133;;F;64;CHILENO;;Boomers;PAINE                         ;METROPOLITANA;209960;5;3;0;0;0;5;3;209960;CELULAR VIVO Y11S 32 GB NEBULA BLUE WOM;TELEFONIA
10044483;;F;57;CHILENO;;Boomers;TEMUCO                        ;ARAUCANIA;359980;2;2;0;0;0;2;2;359980;CELULAR A22 128GB NEGRO;TELEFONIA
9819914;Casado;F;60;CHILENO;TECNICO DE NIVEL SUPERIOR EN ENFERMERIA;Boomers;RENCA                         ;METROPOLITANA;397962;6;1;0;0;0;6;1;397962;CELULAR HUAWEI Y9A BLACK OPEN;TELEFONIA
13157172;;M;45;CHILENO;;X;PROVIDENCIA                   ;METROPOLITANA;159990;1;1;1;1;159990;0;0;0;SMARTHPHONE REDMI 10 US 64GB SEA BLUE;TELEFONIA
17736417;;M;31;CHILENO;;Millenial;RENCA                         ;METROPOLITANA;679990;1;1;1;1;679990;0;0;0;Celular Galaxy S21 Plus Phantom Violet 128GB;TELEFONIA
24123669;;F;60;PERUANO;;Extranjero;SAN MIGUEL                    ;METROPOLITANA;638970;3;1;0;0;0;3;1;638970;CELULAR SMARTPHONE A52S 5G BLACK 128GB;TELEFONIA
11934750;;F;50;CHILENO;;X;RENCA                         ;METROPOLITANA;253980;2;1;0;0;0;2;1;253980;CELULAR VIVO Y21S PEARL WHITE 128 GB OPEN;TELEFONIA
5935404;;F;71;CHILENO;;Silencioso;PENAFLOR                      ;METROPOLITANA;232980;2;2;0;0;0;2;2;232980;CELULAR MOTOROLA G30 GRIS WOM 128 GB;TELEFONIA
15070157;;F;39;CHILENO;;X;VINA DEL MAR                  ;VALPARAISO;74990;2;1;0;0;0;2;1;74990;SMARTPHONE A03S NEGRO 32GB;TELEFONIA
19962530;;M;24;CHILENO;;Z;PROVIDENCIA                   ;METROPOLITANA;323980;2;1;2;1;323980;0;0;0;CELULAR IPHONE SE 64GB DIRECTO CLARO;TELEFONIA
8988329;;M;62;CHILENO;;Boomers;RANCAGUA                      ;L.G.B.OÂ´HIGGINS;241970;3;1;0;0;0;3;1;241970;CELULAR MOTOROLA G30 GRIS WOM 128 GB;TELEFONIA
8396065;;F;66;CHILENO;;Boomers;CALERA                        ;VALPARAISO;771222;7;4;0;0;0;7;4;771222;CELULAR A12 128GB Negro OPEN;TELEFONIA
19316242;Soltero;M;25;CHILENO;;Z;PROVIDENCIA                   ;METROPOLITANA;193980;2;1;2;1;193980;0;0;0;CELULAR A32 128 GB WHITE OPEN;TELEFONIA
20204332;;M;23;CHILENO;;Z;PROVIDENCIA                   ;METROPOLITANA;103980;4;1;0;0;0;4;1;103980;CELULAR VIVO Y11S PHANTON BLACK 32GB MOVISTAR;TELEFONIA
14197149;;F;41;CHILENO;;X;N/D;N/D;866930;7;3;7;3;866930;0;0;0;CELULAR XIAOMI 11T 8/256GB METEORITE GRAY OPEN;TELEFONIA
13816873;;F;49;CHILENO;;X;PROVIDENCIA                   ;METROPOLITANA;189991;2;1;0;0;0;2;1;189991;CELULAR REDMI NOTE 10S 128GB ONIX BLACK;TELEFONIA
13328405;;M;43;CHILENO;;X;"";"";299990;1;1;1;1;299990;0;0;0;CELULAR IPHONE SE 64GB DIRECTO CLARO;TELEFONIA
19929291;;F;24;CHILENO;;Z;N/D;N/D;799760;10;7;7;4;522790;3;3;276970;CELULAR POCO X3 PRO 256 GB FROST BLUE;TELEFONIA
19545993;;F;25;CHILENO;;Silencioso;PROVIDENCIA                   ;METROPOLITANA;319990;1;1;1;1;319990;0;0;0;CELULAR IPHONE SE 64GB DIRECTO CLARO;TELEFONIA
13780662;;F;41;CHILENO;;X;SAN FERNANDO                  ;L.G.B.OÂ´HIGGINS;394531;4;2;2;1;134540;2;1;259991;CELULAR MOTO G60S 6/128 GB AZUL;TELEFONIA
15670279;;F;38;CHILENO;;Millenial;RENCA                         ;METROPOLITANA;300140;2;3;0;0;0;2;3;300140;SMARTPHONE A52S 5G WHITE 128GB;TELEFONIA
25793628;;M;41;EXTRANJERO - NO INFORMA NACIONALIDAD;;Extranjero;N/D;N/D;283970;3;2;0;0;0;3;2;283970;CELULAR VIVO Y21S PEARL WHITE 128 GB OPEN;TELEFONIA
17547819;;M;32;CHILENO;;Millenial;PROVIDENCIA                   ;METROPOLITANA;189990;1;1;1;1;189990;0;0;0;CELULAR REDMI NOTE 10S 128GB ONIX BLACK;TELEFONIA
20087702;;F;23;CHILENO;;Z;CABRERO                       ;BIO BIO;166980;3;1;0;0;0;3;1;166980;CELULAR MOTO G30 128GB GRIS TORNASOL OPEN;TELEFONIA
9202688;;M;60;CHILENO;;Boomers;CARAHUE                       ;ARAUCANIA;348980;2;1;0;0;0;2;1;348980;MOTOROLA MOTO G50 AZUL 128 GB WOM;TELEFONIA
17474097;;M;32;CHILENO;;Millenial;PROVIDENCIA                   ;METROPOLITANA;804980;2;1;2;1;804980;0;0;0;CELULAR IPHONE 13 256GB MIDNIGHT CLARO;TELEFONIA
12725482;Soltero;M;47;CHILENO;;X;RENGO                         ;L.G.B.OÂ´HIGGINS;169980;4;2;0;0;0;4;2;169980;CELULAR MOTO G20 64GB ROSA FLAMINGO OPEN;TELEFONIA
17940604;;M;30;CHILENO;;Silencioso;PROVIDENCIA                   ;METROPOLITANA;97980;2;1;0;0;0;2;1;97980;CELULAR MOTO E7 32GB ROSA CORAL OPEN;TELEFONIA
9100277;;F;60;CHILENO;;Boomers;CURICO                        ;MAULE;44990;2;1;0;0;0;2;1;44990;Celular Y7P LIB OPEN NEGRO;TELEFONIA
16535547;;F;35;CHILENO;;Millenial;SAN CARLOS                    ;BIO BIO;39990;1;1;0;0;0;1;1;39990;CELULAR NOKIA QUEEN VALUE BLACK CLARO;TELEFONIA
18505797;;M;28;CHILENO;;Millenial;N/D;N/D;121990;2;1;0;0;0;2;1;121990;MOTO G20 AZUL CIELO 64GB MOVISTAR;TELEFONIA
12826458;;F;47;CHILENO;;X;SAN ANTONIO                   ;VALPARAISO;199990;1;1;0;0;0;1;1;199990;CELULAR VIVO Y21S PEARL WHITE 128 GB OPEN;TELEFONIA
20584024;;F;21;CHILENO;;Z;PROVIDENCIA                   ;METROPOLITANA;159991;2;1;0;0;0;2;1;159991;XIAOMI REDMI 9T GRIS WOM 128 GB;TELEFONIA
13311461;Soltero;M;45;CHILENO;;X;PROVIDENCIA                   ;METROPOLITANA;139991;2;1;0;0;0;2;1;139991;CELULAR MOTO G20 64GB AZUL OPEN;TELEFONIA
8747323;;M;63;CHILENO;;Boomers;RENCA                         ;METROPOLITANA;119990;1;1;0;0;0;1;1;119990;SMARTPHONE A03S 32 GB ROJO;TELEFONIA
15249851;;F;38;CHILENO;;Millenial;FREIRE                        ;ARAUCANIA;169980;2;2;0;0;0;2;2;169980;CELULAR A12 128GB Negro OPEN;TELEFONIA
10224906;;M;58;CHILENO;;Boomers;RENCA                         ;METROPOLITANA;31980;2;1;0;0;0;2;1;31980;CELULAR AZUMI L4G BLACK CLARO;TELEFONIA
11563772;;F;51;CHILENO;;X;PROVIDENCIA                   ;METROPOLITANA;129961;5;1;0;0;0;5;1;129961;CELULAR VIVO Y11S 32GB NEBULA BLUE OPEN;TELEFONIA
25625221;;M;27;COLOMBIANO;;Extranjero;CALDERA                       ;ATACAMA;214970;4;1;0;0;0;4;1;214970;CELULAR POCO X3 PRO 256 GB FROST BLUE;TELEFONIA
15216215;;M;40;CHILENO;;X;CHILLAN                       ;BIO BIO;119990;1;1;0;0;0;1;1;119990;CELULAR Moto G20 Blue WOM;TELEFONIA
4978807;;F;79;CHILENO;;Silencioso;VALLENAR;ATACAMA;54990;2;1;0;0;0;2;1;54990;CELULAR Redmi 9C 32GB Gray WOM;TELEFONIA
14496444;;F;46;CHILENO;;X;N/D;N/D;950820;4;2;2;1;655840;2;1;294980;IPHONE 11 128GB BLACK CLARO;TELEFONIA
11761229;;M;54;CHILENO;;X;LA LIGUA                      ;VALPARAISO;106501;3;2;0;0;0;3;2;106501;CELULAR MOTO G30 128GB GRIS TORNASOL OPEN;TELEFONIA
23333610;;F;39;PERUANO;;Extranjero;ARICA                         ;ARICA Y PARINACOTA;399990;1;1;0;0;0;1;1;399990;CELULAR GALAXY S20FE 128GB CLOUD LAVENDER OPEN;TELEFONIA
8623943;Casado;F;61;CHILENO;;Boomers;RENCA                         ;METROPOLITANA;180980;3;1;0;0;0;3;1;180980;CELULAR A32 128 GB LIGHT VIOLET OPEN;TELEFONIA
10813916;;M;55;CHILENO;;Boomers;LINARES                       ;MAULE;512090;9;3;0;0;0;9;3;512090;CELULAR VIVO Y11S 32GB NEBULA BLUE OPEN;TELEFONIA
18433236;;M;29;CHILENO;;Extranjero;N/D;N/D;115480;2;1;0;0;0;2;1;115480;CELULAR MOTO E7 32GB ROSA CORAL OPEN;TELEFONIA
20197378;;F;22;CHILENO;;Z;PROVIDENCIA                   ;METROPOLITANA;119990;1;1;0;0;0;1;1;119990;CELULAR VIVO Y20 BLACK 64GB MOVISTAR;TELEFONIA
8885112;;M;62;CHILENO;;Boomers;PADRE LAS CASAS               ;ARAUCANIA;304980;2;1;0;0;0;2;1;304980;CELULAR SMARTPHONE A52S 5G BLACK 128GB;TELEFONIA
5994421;;M;74;CHILENO;;Silencioso;VALLENAR;ATACAMA;39990;1;1;0;0;0;1;1;39990;CELULAR NOKIA QUEEN VALUE BLACK CLARO;TELEFONIA
7076140;;F;69;CHILENO;;Silencioso;SAN BERNARDO                  ;METROPOLITANA;109990;1;1;0;0;0;1;1;109990;CELULAR VIVO Y20 NEGRO DIRECTO ENTEL;TELEFONIA
13194727;;M;44;CHILENO;;X;PROVIDENCIA                   ;METROPOLITANA;79990;1;1;0;0;0;1;1;79990;CELULAR ZTE A5 2020 DIRECTO CLARO VERDE;TELEFONIA
11997725;;M;50;CHILENO;;X;RAUCO                         ;MAULE;117980;2;1;0;0;0;2;1;117980;CELULAR REDMI 9A 32GB PEACOCK GREEN;TELEFONIA
12576788;;M;48;CHILENO;;X;N/D;N/D;399980;2;1;0;0;0;2;1;399980;POCO X3 PRO US 128G METAL BRONZE;TELEFONIA
13876137;;F;41;CHILENO;;X;LA SERENA                     ;COQUIMBO;74990;1;1;0;0;0;1;1;74990;CELULAR VIVO Y11S 32GB NEBULA BLUE OPEN;TELEFONIA
7068706;;F;68;CHILENO;;Silencioso;PROVIDENCIA                   ;METROPOLITANA;906971;4;1;0;0;0;4;1;906971;Celular Galaxy S21 Phantom Grey 128GB;TELEFONIA
19126053;;M;26;CHILENO;;Z;PROVIDENCIA                   ;METROPOLITANA;189990;2;1;0;0;0;2;1;189990;CELULAR POCO X3 PRO 256 GB FROST BLUE;TELEFONIA
17995672;;F;30;CHILENO;;Millenial;MAIPU                         ;METROPOLITANA;149980;2;1;0;0;0;2;1;149980;CELULAR MOTOROLA G20 64GB BLUE CLARO;TELEFONIA
15157139;;F;40;CHILENO;;X;RETIRO                        ;MAULE;439956;5;2;0;0;0;5;2;439956;CELULAR A32 128 GB BLACK OPEN;TELEFONIA
14422299;;F;48;CHILENO;;X;MALLOA                        ;L.G.B.OÂ´HIGGINS;651860;3;2;0;0;0;3;2;651860;CELULAR A32 128 GB LIGHT VIOLET OPEN;TELEFONIA
9253052;Soltero;M;57;CHILENO;;Boomers;PROVIDENCIA                   ;METROPOLITANA;229990;1;1;1;1;229990;0;0;0;CELULAR POCO X3 PRO 256 GB FROST BLUE;TELEFONIA
18469874;Soltero;M;29;CHILENO;;Millenial;PROVIDENCIA                   ;METROPOLITANA;99990;1;1;1;1;99990;0;0;0;CELULAR NOKIA 5.3 CHARCOAL TRI ENTEL;TELEFONIA
18489077;;F;29;CHILENO;;Millenial;N/D;N/D;353985;2;3;0;2;163995;2;1;189990;CELULAR POCO X3 PRO 256 GB FROST BLUE;TELEFONIA
15381424;;F;39;CHILENO;;X;"";"";179990;1;1;1;1;179990;0;0;0;REDMI 10 US 128GB Carbon Gray;TELEFONIA
12886318;;F;47;CHILENO;;X;EL BOSQUE                     ;METROPOLITANA;322960;5;4;0;0;0;5;4;322960;CELULAR MOTO G30 128GB GRIS TORNASOL OPEN;TELEFONIA
17644588;Soltero;F;31;CHILENO;;Millenial;PROVIDENCIA                   ;METROPOLITANA;299982;4;1;0;0;0;4;1;299982;CELULAR A12 128GB Azul OPEN;TELEFONIA
7355579;Soltero;M;68;CHILENO;;Silencioso;PROVIDENCIA                   ;METROPOLITANA;79990;1;1;0;0;0;1;1;79990;CELULAR MOTO E7I POWER 32GB BLUE MOVISTAR;TELEFONIA
26329114;;M;39;VENEZOLANO;;Extranjero;PUERTO MONTT                  ;LOS LAGOS;234970;3;3;1;1;109990;2;2;124980;CELULAR VIVO Y20 BLACK 64GB MOVISTAR;TELEFONIA
19391866;;M;25;CHILENO;;Z;PAINE                         ;METROPOLITANA;149990;1;1;0;0;0;1;1;149990;CELULAR XIAOMI REDMI 9T 128GB BLACK CLARO;TELEFONIA
10858887;;F;56;CHILENO;;Boomers;PUERTO MONTT                  ;LOS LAGOS;119990;1;1;0;0;0;1;1;119990;Celular XIAOMI REDMI 9 64 GB DIRECTO CLARO NEGRO;TELEFONIA
10149219;;F;55;CHILENO;;Boomers;CONCEPCION                    ;BIO BIO;189990;1;1;0;0;0;1;1;189990;CELULAR A32 128 GB LIGHT VIOLET OPEN;TELEFONIA
9800572;;F;57;CHILENO;;Boomers;RENCA                         ;METROPOLITANA;119480;2;1;0;0;0;2;1;119480;CELULAR CLARO MOTOROLA E7 32GB GRIS;TELEFONIA
19712782;;M;23;CHILENO;;Z;VALLENAR;ATACAMA;319990;1;1;0;0;0;1;1;319990;CELULAR SMARTPHONE A52S 5G LIGHT VIOLET 128GB;TELEFONIA
12298809;;F;51;CHILENO;;X;TALCAHUANO                    ;BIO BIO;345980;2;1;0;0;0;2;1;345980;CELULAR REDMI NOTE 10 PRO 6+128GB ONYX GRAY;TELEFONIA
18562594;Soltero;M;28;CHILENO;;Millenial;SAN FELIPE                    ;VALPARAISO;119990;1;1;0;0;0;1;1;119990;CELULAR Redmi 9C 32GB Gray WOM;TELEFONIA
16519665;;M;35;CHILENO;;Millenial;RENCA                         ;METROPOLITANA;229980;2;2;0;0;0;2;2;229980;Celular XIAOMI REDMI 9 64 GB DIRECTO CLARO NEGRO;TELEFONIA
16811713;;M;40;CHILENO;;Extranjero;AISEN                         ;AYSEN;145980;2;1;0;0;0;2;1;145980;CELULAR VIVO Y11S 32GB NEBULA BLUE OPEN;TELEFONIA
15698911;;M;38;CHILENO;;Millenial;SAN FERNANDO                  ;L.G.B.OÂ´HIGGINS;89990;2;1;0;0;0;2;1;89990;CELULAR REDMI 9 64GB CARBON GREY;TELEFONIA
7855406;;F;57;CHILENO;;Boomers;ANCUD                         ;LOS LAGOS;36990;1;1;0;0;0;1;1;36990;CELULAR NOKIA 225 4G BLACK MOVISTAR DIRECTO;TELEFONIA
26342572;;M;28;EXTRANJERO - NO INFORMA NACIONALIDAD;;Extranjero;N/D;N/D;385230;4;2;2;1;359990;2;1;25240;IPHONE XS 64GB DORADO OPEN;TELEFONIA
24358304;;M;44;BOLIVIANO;;Extranjero;ANTOFAGASTA                   ;ANTOFAGASTA;105979;2;1;0;0;0;2;1;105979;SMARTPHONE A03S 32 GB ROJO;TELEFONIA
8800675;;M;63;CHILENO;;Boomers;RENCA                         ;METROPOLITANA;219990;1;1;0;0;0;1;1;219990;CELULAR REDMI NOTE 10S 128GB ONIX BLACK;TELEFONIA
6788926;;M;69;CHILENO;;Silencioso;PROVIDENCIA                   ;METROPOLITANA;319980;2;1;0;0;0;2;1;319980;XIAOMI REDMI 9T GRIS WOM 128 GB;TELEFONIA
6945698;;M;70;CHILENO;;Silencioso;LA LIGUA                      ;VALPARAISO;159990;1;1;0;0;0;1;1;159990;CELULAR SAMSUNG A12 128GB BLACK CLARO;TELEFONIA
19731179;;M;24;CHILENO;;Z;CARAHUE                       ;ARAUCANIA;119990;1;1;0;0;0;1;1;119990;SMARTPHONE A03S NEGRO 32GB;TELEFONIA
15046165;;F;39;CHILENO;;X;ILLAPEL                       ;COQUIMBO;139990;1;1;0;0;0;1;1;139990;SMARTPHONE A03S 64 GB NEGRO;TELEFONIA
4518845;;M;81;CHILENO;;Silencioso;LA PINTANA                    ;METROPOLITANA;129990;1;1;0;0;0;1;1;129990;SMARTPHONE A03S AZUL 32GB;TELEFONIA
9014738;;M;61;CHILENO;;Boomers;LA LIGUA                      ;VALPARAISO;380980;2;1;0;0;0;2;1;380980;CELULAR SMARTPHONE A52S 5G LIGHT VIOLET 128GB;TELEFONIA
11508878;;M;52;CHILENO;;X;N/D;N/D;489980;2;4;0;0;0;2;4;489980;CELULAR GALAXY S20FE 128GB CLOUD LAVENDER OPEN;TELEFONIA
15223159;;F;39;CHILENO;;X;N/D;N/D;130980;3;1;0;0;0;3;1;130980;CELULAR VIVO Y20S NEBULA 128 GB BLUE OPEN;TELEFONIA
17398682;Soltero;M;32;CHILENO;;Millenial;PROVIDENCIA                   ;METROPOLITANA;84990;1;1;0;0;0;1;1;84990;CELULAR VIVO Y11S 32GB NEBULA BLUE OPEN;TELEFONIA
19338152;;M;25;CHILENO;;Z;N/D;N/D;99990;1;1;0;0;0;1;1;99990;CELULAR VIVO Y11S PHANTOM BLACK OPEN;TELEFONIA
12736111;;F;47;CHILENO;;X;ERCILLA                       ;ARAUCANIA;99980;2;2;0;0;0;2;2;99980;Celular SAMSUNG A01 CORE BLACK CLARO;TELEFONIA
12057698;;M;55;CHILENO;;Boomers;N/D;N/D;440950;5;2;0;0;0;5;2;440950;CELULAR SAMSUNG A12 128GB BLACK CLARO;TELEFONIA
16309753;;F;35;CHILENO;;Millenial;CHONCHI                       ;LOS LAGOS;129990;1;1;0;0;0;1;1;129990;CELULAR Xiaomi Redmi 9 64 GB Morado WOM;TELEFONIA
16533439;;M;41;CHILENO;;X;NUNOA                         ;METROPOLITANA;191980;2;1;0;0;0;2;1;191980;CELULAR MOTO G20 64GB AZUL OPEN;TELEFONIA
17321522;Casado;F;32;CHILENO;;Millenial;PROVIDENCIA                   ;METROPOLITANA;149990;1;1;0;0;0;1;1;149990;CELULAR A12 128GB Rojo OPEN;TELEFONIA
20441380;;M;21;CHILENO;;Z;PROVIDENCIA                   ;METROPOLITANA;465650;6;3;5;2;305660;1;1;159990;CELULAR SAMSUNG A12 128GB BLACK CLARO;TELEFONIA
16687638;;M;34;CHILENO;;Millenial;LA SERENA                     ;COQUIMBO;124990;1;1;0;0;0;1;1;124990;CELULAR MOTO G30 128GB GRIS TORNASOL OPEN;TELEFONIA
5212637;;M;78;CHILENO;;Silencioso;QUILLOTA                      ;VALPARAISO;314950;5;3;2;1;34980;3;2;279970;POCO X3 PRO US 128G METAL BRONZE;TELEFONIA
8027037;;M;65;CHILENO;;Boomers;RANCAGUA                      ;L.G.B.OÂ´HIGGINS;89990;1;1;0;0;0;1;1;89990;CELULAR MOTO E7 GRIS MINERAL MOVISTAR;TELEFONIA
6949430;;F;68;CHILENO;;Silencioso;CHILLAN                       ;BIO BIO;139990;1;1;0;0;0;1;1;139990;SMARTPHONE A03S 64 GB S/SIM NEGRO;TELEFONIA
18350120;Soltero;F;29;CHILENO;;X;"";"";179980;2;2;2;2;179980;0;0;0;Celular NOKIA 4.2 ENTEL DIRECTO NEGRO;TELEFONIA
17488985;;F;31;CHILENO;;Millenial;PROVIDENCIA                   ;METROPOLITANA;305980;2;1;0;0;0;2;1;305980;POCO X3 PRO 256 GB METAL BRONCE;TELEFONIA
10795476;Divorciado;F;55;CHILENO;TECNICO EN TURISMO;Boomers;RENCA                         ;METROPOLITANA;161980;2;1;0;0;0;2;1;161980;CELULAR MOTOROLA G20 64GB BLUE CLARO;TELEFONIA
25879350;;M;67;VENEZOLANO;;Extranjero;SAN FELIPE                    ;VALPARAISO;443980;2;2;0;0;0;2;2;443980;SMARTPHONE A03S 64 GB NEGRO;TELEFONIA
19211482;Soltero;F;26;CHILENO;PROFESOR;Z;PROVIDENCIA                   ;METROPOLITANA;199990;1;1;0;0;0;1;1;199990;CELULAR A32 128 GB LIGHT VIOLET OPEN;TELEFONIA
14463930;;F;41;CHILENO;;X;TEMUCO                        ;ARAUCANIA;327980;2;1;0;0;0;2;1;327980;CELULAR SMARTPHONE A52S 5G BLACK 128GB;TELEFONIA
20461840;;F;22;CHILENO;;Z;PROVIDENCIA                   ;METROPOLITANA;59990;1;1;0;0;0;1;1;59990;CELULAR MOTO E6I 32GB GRIS OPEN;TELEFONIA
10888601;;M;62;CHILENO;;Boomers;PADRE HURTADO                 ;METROPOLITANA;346860;3;2;0;0;0;3;2;346860;CELULAR A32 128 GB LIGHT VIOLET OPEN;TELEFONIA
5040807;;M;75;CHILENO;;Silencioso;ARICA                         ;ARICA Y PARINACOTA;169990;1;1;0;0;0;1;1;169990;CELULAR A54 OPPO AZUL 128GB;TELEFONIA
7099974;;F;73;CHILENO;;Silencioso;LINARES                       ;MAULE;79480;3;1;0;0;0;3;1;79480;CELULAR VIVO Y11S 32GB NEBULA BLUE OPEN;TELEFONIA
16899521;Soltero;F;34;CHILENO;;Millenial;PROVIDENCIA                   ;METROPOLITANA;165470;4;2;2;1;125480;2;1;39990;CELULAR CLARO MOTOROLA E7 32GB GRIS;TELEFONIA
10726814;;M;54;CHILENO;;Boomers;RANCAGUA                      ;L.G.B.OÂ´HIGGINS;89990;1;1;0;0;0;1;1;89990;CELULAR MOTO E7 GRIS MINERAL MOVISTAR;TELEFONIA
8069976;;M;64;CHILENO;;Boomers;ESTACION CENTRAL              ;METROPOLITANA;283942;6;2;0;0;0;6;2;283942;CELULAR VIVO Y11S PHANTOM BLACK OPEN;TELEFONIA
16785013;Casado;M;35;CHILENO;;Millenial;PROVIDENCIA                   ;METROPOLITANA;149990;1;1;0;0;0;1;1;149990;SMARTPHONE A03S 64 GB NEGRO;TELEFONIA
12185857;;F;50;CHILENO;;X;PARRAL                        ;MAULE;239970;3;3;0;0;0;3;3;239970;CELULAR MOTO E6S 32GB ROSA OPEN;TELEFONIA
17279173;;F;32;CHILENO;;Millenial;PROVIDENCIA                   ;METROPOLITANA;19990;1;1;0;0;0;1;1;19990;CELULAR AZUMI L4G BLACK CLARO;TELEFONIA
14466594;;F;78;CHILENO;;Silencioso;LA PINTANA                    ;METROPOLITANA;146980;2;1;0;0;0;2;1;146980;CELULAR OPPO A15 BLACK 32GB CLARO;TELEFONIA
16563823;;M;35;CHILENO;;Millenial;VALDIVIA                      ;LOS RIOS;149990;1;1;0;0;0;1;1;149990;CELULAR VIVO Y20S NEBULA 128 GB BLUE OPEN;TELEFONIA
16900886;;F;34;CHILENO;;Millenial;PROVIDENCIA                   ;METROPOLITANA;139990;1;1;1;1;139990;0;0;0;SMARTPHONE A03S 64 GB S/SIM NEGRO;TELEFONIA
26784846;;M;35;VENEZOLANO;;Extranjero;N/D;N/D;209991;2;1;0;0;0;2;1;209991;CELULAR POCO X3 PRO 128G PHANTOM BLACK OPEN;TELEFONIA
19443745;;F;25;CHILENO;;Z;SANTA CRUZ                    ;L.G.B.OÂ´HIGGINS;185970;3;2;0;0;0;3;2;185970;CELULAR MOTO E7 32GB GRIS OPEN;TELEFONIA
10988469;;M;44;CHILENO;;X;SANTO DOMINGO                 ;VALPARAISO;89990;1;1;0;0;0;1;1;89990;CELULAR VIVO Y11S 32 GB NEBULA BLUE WOM;TELEFONIA
10573349;;F;56;CHILENO;;Boomers;N/D;N/D;414430;5;2;0;0;0;5;2;414430;CELULAR POCO X3 PRO 256 GB FROST BLUE;TELEFONIA
13526596;;F;45;CHILENO;;X;AISEN                         ;AYSEN;340940;6;2;0;0;0;6;2;340940;CELULAR A32 128 GB LIGHT VIOLET OPEN;TELEFONIA
17871850;;M;31;CHILENO;;Millenial;PAINE                         ;METROPOLITANA;277960;4;2;4;2;277960;0;0;0;SMARTHPHONE SAMSUNG GALAXY A03S 64GB NEGRO;TELEFONIA
13399314;;F;43;CHILENO;;X;RENCA                         ;METROPOLITANA;36990;1;1;0;0;0;1;1;36990;CELULAR NOKIA 225 4G BLACK MOVISTAR DIRECTO;TELEFONIA
19589570;;F;25;CHILENO;;Z;RENGO                         ;L.G.B.OÂ´HIGGINS;190970;4;2;0;0;0;4;2;190970;CELULAR MOTOROLA G20 64GB BLUE CLARO;TELEFONIA
7998701;;F;66;CHILENO;;Boomers;CHILLAN                       ;BIO BIO;89990;1;1;0;0;0;1;1;89990;CELULAR MOTO E7 GRIS MINERAL MOVISTAR;TELEFONIA
15922552;;F;37;CHILENO;;Millenial;RENCA                         ;METROPOLITANA;259980;3;2;0;0;0;3;2;259980;CELULAR MOTO G30 128GB GRIS TORNASOL OPEN;TELEFONIA
17760188;;F;30;CHILENO;;Millenial;LINARES                       ;MAULE;309980;2;2;0;0;0;2;2;309980;CELULAR SMARTPHONE A52S 5G BLACK 128GB;TELEFONIA
6592014;Divorciado;M;65;CHILENO;;Boomers;MAIPU                         ;METROPOLITANA;193980;2;1;2;1;193980;0;0;0;CELULAR A32 128 GB LIGHT VIOLET OPEN;TELEFONIA
19607488;;F;24;CHILENO;;Z;ANCUD                         ;LOS LAGOS;281180;8;4;2;1;59540;6;3;221640;CELULAR VIVO Y20 BLACK 64GB MOVISTAR;TELEFONIA
7490958;;M;68;CHILENO;;Boomers;SALAMANCA                     ;COQUIMBO;129990;1;1;0;0;0;1;1;129990;CELULAR A12 128GB NEGRO TRIANGULADO CLARO;TELEFONIA
20130139;;F;23;CHILENO;;Z;N/D;N/D;119990;1;1;0;0;0;1;1;119990;SMARTPHONE A03S NEGRO 32GB;TELEFONIA
17470217;;F;32;CHILENO;;Millenial;CONSTITUCION                  ;MAULE;491749;8;2;0;0;0;8;2;491749;MOTO G30 LILA PASTEL 128GB MOVISTAR;TELEFONIA
11397326;Casado;M;53;CHILENO;;X;RENCA                         ;METROPOLITANA;186980;2;1;0;0;0;2;1;186980;CELULAR MOTO G30 128GB LILA PASTEL OPEN;TELEFONIA
14550070;;M;46;CHILENO;;X;TEMUCO                        ;ARAUCANIA;249990;1;1;0;0;0;1;1;249990;CELULAR SMARTPHONE A52S 5G BLACK 128GB;TELEFONIA
17187895;;M;33;CHILENO;;Silencioso;PROVIDENCIA                   ;METROPOLITANA;229991;2;1;0;0;0;2;1;229991;CELULAR REDMI NOTE 10S 128GB PEBBLE WHITE;TELEFONIA
14497435;;M;45;CHILENO;;X;N/D;N/D;685960;4;3;0;0;0;4;3;685960;CELULAR VIVO V21 5G DUSK BLUE 128GB OPEN;TELEFONIA
6948370;Casado;F;69;CHILENO;;Silencioso;TALCA                         ;MAULE;169990;1;1;0;0;0;1;1;169990;CELULAR XIAOMI REDMI 9T TWILIGHT BLUE MOVISTAR;TELEFONIA
9071170;Soltero;M;48;CHILENO;TECNICO AGROPECUARIO;X;RENCA                         ;METROPOLITANA;149990;1;1;1;1;149990;0;0;0;CELULAR XIAOMI REDMI 9T TWILIGHT BLUE MOVISTAR;TELEFONIA
18580987;;M;28;CHILENO;;Millenial;ILLAPEL                       ;COQUIMBO;99990;1;1;0;0;0;1;1;99990;CELULAR REDMI 9 64GB CARBON GREY;TELEFONIA
11894371;;F;51;CHILENO;;X;RENCA                         ;METROPOLITANA;219990;1;1;0;0;0;1;1;219990;CELULAR POCO X3 PRO 128 GB FROST BLUE;TELEFONIA
8607074;Soltero;F;65;CHILENO;;Boomers;RENCA                         ;METROPOLITANA;189981;4;1;0;0;0;4;1;189981;CELULAR A12 128GB Rojo OPEN;TELEFONIA
16085972;;M;36;CHILENO;;Silencioso;PROVIDENCIA                   ;METROPOLITANA;39990;1;1;1;1;39990;0;0;0;CELULAR SMARTPHONE 1B ALCATEL PRIME BLACK;TELEFONIA
8919182;;F;61;CHILENO;;Boomers;PROVIDENCIA                   ;METROPOLITANA;169990;1;1;1;1;169990;0;0;0;CELULAR MOTOROLA G9 PLUS 128GB AZUL CLARO;TELEFONIA
5838082;;M;77;CHILENO;;Silencioso;CONCON                        ;VALPARAISO;24990;1;1;0;0;0;1;1;24990;Celular AL3 CLARO DIRECTO NEGRO;TELEFONIA
18379487;;F;28;CHILENO;;Millenial;RANCAGUA                      ;L.G.B.OÂ´HIGGINS;219991;2;1;0;0;0;2;1;219991;CELULAR A32 128 GB BLUE OPEN;TELEFONIA
14010533;;F;50;CHILENO;;X;MELIPILLA                     ;METROPOLITANA;349990;1;1;0;0;0;1;1;349990;CELULAR SMARTPHONE A52S 5G BLACK 128GB;TELEFONIA
8833905;;M;62;CHILENO;;Boomers;OVALLE                        ;COQUIMBO;229991;2;1;0;0;0;2;1;229991;CELULAR A32 128 GB WHITE OPEN;TELEFONIA
23885526;;F;35;BOLIVIANO;;Extranjero;IQUIQUE                       ;TARAPACA;453970;4;1;0;0;0;4;1;453970;CELULAR A72 128 GB BLACK OPEN;TELEFONIA
18586892;;M;28;CHILENO;;Millenial;PROVIDENCIA                   ;METROPOLITANA;119991;2;1;0;0;0;2;1;119991;CELULAR REDMI NOTE 8 2021 64 GB SPACE BLACK;TELEFONIA
10804145;Casado;F;56;CHILENO;;Boomers;RENCA                         ;METROPOLITANA;573980;2;1;2;1;573980;0;0;0;IPHONE 11 128GB BLACK CLARO;TELEFONIA
8034156;;M;61;CHILENO;;Boomers;SAN JAVIER                    ;MAULE;199990;1;1;0;0;0;1;1;199990;CELULAR A32 128 GB BLACK OPEN;TELEFONIA
16082538;;F;37;CHILENO;;Millenial;"";"";304970;3;1;0;0;0;3;1;304970;CELULAR A12 128GB Rojo OPEN;TELEFONIA
15888053;;F;38;CHILENO;;Millenial;TALAGANTE                     ;METROPOLITANA;223980;2;1;2;1;223980;0;0;0;CELULAR A32 128 GB LIGHT VIOLET OPEN;TELEFONIA
14074936;;M;41;CHILENO;;X;"";"";124990;1;1;0;0;0;1;1;124990;CELULAR MOTO ONE FUSION 128GB AZUL OPEN;TELEFONIA
14511856;;F;42;CHILENO;;X;CURICO                        ;MAULE;39990;1;1;0;0;0;1;1;39990;CELULAR NOKIA QUEEN VALUE BLACK CLARO;TELEFONIA
4205008;;F;80;CHILENO;;Silencioso;CERRO NAVIA                   ;METROPOLITANA;79990;1;1;0;0;0;1;1;79990;CELULAR MOTOROLA E7 IPOWER 32GB BLUE CLARO;TELEFONIA
9599537;;F;62;CHILENO;;Boomers;SAN ANTONIO                   ;VALPARAISO;209990;1;1;0;0;0;1;1;209990;CELULAR A32 128 GB LIGHT VIOLET OPEN;TELEFONIA
18281604;;M;29;CHILENO;;Millenial;PROVIDENCIA                   ;METROPOLITANA;328970;3;3;0;0;0;3;3;328970;CELULAR VIVO Y20S OBSIDIAN BLACK 128GB OPEN;TELEFONIA
19898249;;F;23;CHILENO;;Z;"";"";179960;4;3;0;0;0;4;3;179960;VIVO Y20 OBSIDIAN BLACK OPEN;TELEFONIA
16503499;;M;35;CHILENO;;Millenial;"";"";149990;1;1;0;0;0;1;1;149990;CELULAR A12 128GB Azul OPEN;TELEFONIA
14234897;;F;50;CHILENO;;X;TEMUCO                        ;ARAUCANIA;88770;2;1;0;0;0;2;1;88770;CELULAR MOTOROLA E6 PLAY AZUL TRI WOM;TELEFONIA
19391732;;M;25;CHILENO;;Z;SAN FERNANDO                  ;L.G.B.OÂ´HIGGINS;269990;1;1;0;0;0;1;1;269990;CELULAR MI 11 LITE US 128GB PEACH PINK OPEN;TELEFONIA
19129883;;F;27;CHILENO;;Z;PUTAENDO                      ;VALPARAISO;361970;3;2;2;1;324980;1;1;36990;POCO F3 EU Night Black 256GB;TELEFONIA
19411222;;M;26;CHILENO;;Z;MELIPILLA                     ;METROPOLITANA;609970;4;2;0;0;0;4;2;609970;CELULAR HUAWEI NOVA 8i BUNDLE;TELEFONIA
5480360;;M;75;CHILENO;;Silencioso;PEUMO                         ;L.G.B.OÂ´HIGGINS;134990;1;1;0;0;0;1;1;134990;SMARTHPHONE SAMSUNG GALAXY A03S 64GB NEGRO;TELEFONIA
7916700;;M;64;CHILENO;;Boomers;N/D;N/D;96480;2;1;0;0;0;2;1;96480;CELULAR MOTOROLA E7 IPOWER 32GB BLUE CLARO;TELEFONIA
13195491;Casado;M;44;CHILENO;INGENIERO CIVIL INDUSTRIAL;Silencioso;PROVIDENCIA                   ;METROPOLITANA;955480;2;1;2;1;955480;0;0;0;CELULAR IPHONE 12 PRO MAX 128GB AZUL CLARO;TELEFONIA
12196239;Soltero;M;50;CHILENO;INGENIERO AGRICOLA;X;RENCA                         ;METROPOLITANA;582970;3;2;0;0;0;3;2;582970;CELULAR POCO X3 PRO 128G PHANTOM BLACK OPEN;TELEFONIA
16313805;;M;35;CHILENO;;Millenial;CANELA                        ;COQUIMBO;49990;1;1;0;0;0;1;1;49990;CELULAR LG K22 TRIANGULADO WOM;TELEFONIA
12947220;;M;46;CHILENO;;X;LOS VILOS                     ;COQUIMBO;169990;1;1;0;0;0;1;1;169990;CELULAR A12 128GB Negro OPEN;TELEFONIA
19058432;Soltero;M;26;CHILENO;;Z;PROVIDENCIA                   ;METROPOLITANA;123980;2;1;2;1;123980;0;0;0;CELULAR A12 128GB Negro OPEN;TELEFONIA
15725074;;M;39;CHILENO;;X;N/D;N/D;589990;2;1;2;1;589990;0;0;0;CELULAR XIAOMI 11T PRO 8/256GB CELESTIAL BLUE KI;TELEFONIA
15529578;;M;38;CHILENO;;Millenial;PROVIDENCIA                   ;METROPOLITANA;119481;3;1;0;0;0;3;1;119481;CELULAR MOTO E7 32GB GRIS OPEN;TELEFONIA
16572761;;F;35;CHILENO;;Millenial;PROVIDENCIA                   ;METROPOLITANA;119990;1;1;1;1;119990;0;0;0;CELULAR REDMI 9 64GB CARBON GREY;TELEFONIA
16879307;;F;34;CHILENO;;Millenial;RANCAGUA                      ;L.G.B.OÂ´HIGGINS;169990;1;1;0;0;0;1;1;169990;CELULAR MOTO G30 128GB GRIS TORNASOL OPEN;TELEFONIA
13489615;;F;43;CHILENO;;X;MARIA PINTO                   ;METROPOLITANA;679070;4;1;0;0;0;4;1;679070;CELULAR GALAXY S20FE 128GB ClOUD NAVY OPEN;TELEFONIA
26269114;;M;28;VENEZOLANO;;Extranjero;N/D;N/D;469980;2;1;0;0;0;2;1;469980;CELULAR XIAOMI 11T 8/256GB CELESTIAL BLUE KIT;TELEFONIA
9836955;;M;59;CHILENO;;Boomers;SAGRADA FAMILIA               ;MAULE;189981;3;1;0;0;0;3;1;189981;CELULAR A12 128GB Azul OPEN;TELEFONIA
17116559;;M;32;CHILENO;;Millenial;VILLARICA                     ;ARAUCANIA;179990;1;1;0;0;0;1;1;179990;REDMI 10 US 128GB Carbon Gray;TELEFONIA
5282510;;F;75;CHILENO;;Silencioso;LOS ANDES                     ;VALPARAISO;34990;1;1;0;0;0;1;1;34990;CELULAR OWN 1026 AZUL ENTEL;TELEFONIA
6122042;;F;70;CHILENO;;Silencioso;QUILPUE                       ;VALPARAISO;198980;2;1;0;0;0;2;1;198980;CELULAR REDMI 9T 128 GB OCEAN GREEN;TELEFONIA
16241260;;M;37;CHILENO;;Millenial;PROVIDENCIA                   ;METROPOLITANA;119990;1;1;0;0;0;1;1;119990;SMARTPHONE A03S NEGRO 32GB;TELEFONIA
27050424;Soltero;F;29;VENEZOLANO;;Extranjero;ESTACION CENTRAL              ;METROPOLITANA;990;1;1;0;0;0;1;1;990;CHIP PREPAGO 2000 WOM;TELEFONIA
25768960;;M;54;VENEZOLANO;;Extranjero;N/D;N/D;607969;3;2;0;0;0;3;2;607969;CELULAR A54 OPPO NEGRO 128GB;TELEFONIA
13084881;;F;47;CHILENO;;X;PROVIDENCIA                   ;METROPOLITANA;383970;3;1;3;1;383970;0;0;0;CELULAR A32 128 GB LIGHT VIOLET OPEN;TELEFONIA
11813213;;F;51;CHILENO;;X;COQUIMBO                      ;COQUIMBO;1248080;6;1;0;0;0;6;1;1248080;CELULAR SAMSUNG NOTE 20 MYSTIC GRAY OPEN;TELEFONIA
14105561;;M;40;CHILENO;;X;ARICA                         ;ARICA Y PARINACOTA;164990;1;1;0;0;0;1;1;164990;CELULAR A22 128GB NEGRO;TELEFONIA
11608620;;F;51;CHILENO;;X;MELIPILLA                     ;METROPOLITANA;587980;2;2;0;0;0;2;2;587980;CELULAR XIAOMI 11T PRO 8/256GB CELESTIAL BLUE KI;TELEFONIA
13474897;;F;46;CHILENO;;X;PROVIDENCIA                   ;METROPOLITANA;269990;1;1;0;0;0;1;1;269990;CELULAR MI 11 LITE US 128GB PEACH PINK OPEN;TELEFONIA
20374903;;F;22;CHILENO;;Z;CHILLAN                       ;BIO BIO;309980;2;1;0;0;0;2;1;309980;Celular P40 LITE LIB OPEN GREEN;TELEFONIA
12229478;;M;50;CHILENO;;X;PROVIDENCIA                   ;METROPOLITANA;573980;2;1;2;1;573980;0;0;0;IPHONE 11 128GB BLACK CLARO;TELEFONIA
19001127;;F;26;CHILENO;;Z;ANGOL                         ;ARAUCANIA;1341960;4;2;4;2;1341960;0;0;0;CELULAR IPHONE 12 64GB BLACK CLARO;TELEFONIA
7673774;;M;63;CHILENO;;Boomers;PROVIDENCIA                   ;METROPOLITANA;129990;1;1;0;0;0;1;1;129990;CELULAR MOTOROLA G20 64GB BLUE CLARO;TELEFONIA
13536893;;M;42;CHILENO;;X;COMBARBALA                    ;COQUIMBO;129481;3;1;0;0;0;3;1;129481;CELULAR REDMI 9C 64GB SUNRISE ORANGE;TELEFONIA
6710627;;M;71;CHILENO;;Silencioso;DONIHUE                       ;L.G.B.OÂ´HIGGINS;69990;1;1;0;0;0;1;1;69990;CELULAR ZTE A5 2020 DIRECTO CLARO VERDE;TELEFONIA
14193583;;F;41;CHILENO;;X;LO ESPEJO                     ;METROPOLITANA;139990;1;1;0;0;0;1;1;139990;CELULAR A12 128GB Azul OPEN;TELEFONIA
12947229;Soltero;F;48;CHILENO;;X;RENCA                         ;METROPOLITANA;442971;4;2;0;0;0;4;2;442971;CELULAR SMARTPHONE A52S 5G BLACK 128GB;TELEFONIA
17823458;;M;30;CHILENO;;Millenial;PROVIDENCIA                   ;METROPOLITANA;375480;2;1;2;1;375480;0;0;0;CELULAR SMARTPHONE A52S 5G LIGHT VIOLET 128GB;TELEFONIA
19570327;;F;25;CHILENO;;Z;CURICO                        ;MAULE;149990;1;1;0;0;0;1;1;149990;CELULAR A12 128GB Rojo OPEN;TELEFONIA
18572644;;F;28;CHILENO;;Millenial;TALCA                         ;MAULE;86990;2;1;0;0;0;2;1;86990;CELULAR VIVO Y20 BLACK 64GB MOVISTAR;TELEFONIA
10998499;Soltero;F;41;CHILENO;ESTADISTICO;X;PROVIDENCIA                   ;METROPOLITANA;184980;2;1;2;1;184980;0;0;0;CELULAR MOTO G30 128GB GRIS TORNASOL OPEN;TELEFONIA
17696188;;F;31;CHILENO;;Millenial;SAN FABIAN                    ;BIO BIO;59480;3;1;0;0;0;3;1;59480;CELULAR Moto E7 Rosado WOM;TELEFONIA
9783789;Casado;F;59;CHILENO;;Boomers;RENCA                         ;METROPOLITANA;209990;1;1;0;0;0;1;1;209990;CELULAR A32 128 GB BLUE OPEN;TELEFONIA
18656216;;F;28;CHILENO;;Millenial;LINARES                       ;MAULE;359980;2;1;0;0;0;2;1;359980;CELULAR POCO X3 PRO 128G PHANTOM BLACK OPEN;TELEFONIA
9433451;;F;62;CHILENO;;Boomers;OSORNO                        ;LOS LAGOS;159990;1;1;0;0;0;1;1;159990;CELULAR VIVO Y20S OBSIDIAN BLACK 128GB OPEN;TELEFONIA
19745001;;F;25;CHILENO;;Z;N/D;N/D;89990;1;1;0;0;0;1;1;89990;CELULAR Redmi 9C 32GB Gray WOM;TELEFONIA
10994480;;M;49;CHILENO;;X;RENCA                         ;METROPOLITANA;144980;2;1;2;1;144980;0;0;0;CELULAR Moto One Fusion 128GB Blue WOM;TELEFONIA
10462469;;M;55;CHILENO;;Boomers;CONCEPCION                    ;BIO BIO;229990;1;1;0;0;0;1;1;229990;Celular P40 LITE LIB OPEN BLACK;TELEFONIA
17735756;;M;31;CHILENO;;Millenial;ANTOFAGASTA                   ;ANTOFAGASTA;199640;2;1;2;1;199640;0;0;0;CELULAR REDMI NOTE 10S 128GB OCEAN BLUE;TELEFONIA
22635969;;M;39;PERUANO;;Extranjero;"";"";69990;2;1;0;0;0;2;1;69990;CELULAR VIVO Y11S NEBULA BLUE 32GB OPEN;TELEFONIA
15637227;;M;38;CHILENO;;X;PROVIDENCIA                   ;METROPOLITANA;233980;2;1;2;1;233980;0;0;0;POCO X3 PRO 256 GB PHANTOM BLACK;TELEFONIA
12716133;;M;48;CHILENO;;X;PROVIDENCIA                   ;METROPOLITANA;129990;1;1;0;0;0;1;1;129990;CELULAR MOTOROLA G9 PLAY 64GB ELECTRIC BLUE OPEN;TELEFONIA
8947745;;M;64;CHILENO;;Boomers;PUREN                         ;ARAUCANIA;96480;2;1;0;0;0;2;1;96480;CELULAR ZTE A5 2020 DIRECTO CLARO VERDE;TELEFONIA
12692296;;F;48;CHILENO;;X;PROVIDENCIA                   ;METROPOLITANA;149990;1;1;0;0;0;1;1;149990;CELULAR A12 128GB Negro OPEN;TELEFONIA
15202026;;M;40;CHILENO;;X;PROVIDENCIA                   ;METROPOLITANA;329980;3;2;0;0;0;3;2;329980;CELULAR MOTO ONE FUSION 128GB AZUL OPEN;TELEFONIA
17510336;;F;32;CHILENO;;Millenial;N/D;N/D;140980;2;2;0;0;0;2;2;140980;CELULAR VIVO Y20S NEBULA 128 GB BLUE OPEN;TELEFONIA
20091760;;F;23;CHILENO;;Z;PROVIDENCIA                   ;METROPOLITANA;91990;2;1;0;0;0;2;1;91990;MOTO G20 AZUL CIELO 64GB MOVISTAR;TELEFONIA
12295011;;F;49;CHILENO;;X;PADRE HURTADO                 ;METROPOLITANA;229991;2;1;0;0;0;2;1;229991;CELULAR REDMI NOTE 10S 128GB PEBBLE WHITE;TELEFONIA
18144445;;F;30;CHILENO;;Millenial;"";"";215980;2;1;0;0;0;2;1;215980;VIVO Y53S DEEP SEA BLUE 128GB OPEN;TELEFONIA
11135033;;F;55;CHILENO;;Boomers;SAN IGNACIO                   ;BIO BIO;84990;2;1;0;0;0;2;1;84990;Celular VIVO Y11S ENTEL DIRECTO AZUL;TELEFONIA
4392421;;M;77;CHILENO;;Silencioso;CHILLAN                       ;BIO BIO;99990;1;1;0;0;0;1;1;99990;CELULAR MOTOROLA G20 64GB BLUE CLARO;TELEFONIA
10878882;;M;55;CHILENO;;Boomers;TALCA                         ;MAULE;129990;1;1;0;0;0;1;1;129990;CELULAR MOTO ONE FUSION 128GB AZUL OPEN;TELEFONIA
12734181;;F;47;CHILENO;;X;RENAICO                       ;ARAUCANIA;109991;2;1;0;0;0;2;1;109991;CELULAR REDMI 9C 32GB MIDNIGHT GRAY;TELEFONIA
19957698;;M;24;CHILENO;;Millenial;N/D;N/D;109480;2;1;0;0;0;2;1;109480;CELULAR CLARO MOTOROLA E7 32GB GRIS;TELEFONIA
17650730;;F;31;CHILENO;;Millenial;VILLA ALEMANA                 ;VALPARAISO;99990;1;1;1;1;99990;0;0;0;CELULAR XIAOMI REDMI 9 64GB DIRECTO CLARO MORADO;TELEFONIA
16290108;;M;36;CHILENO;;Millenial;CURICO;MAULE;830970;3;1;3;1;830970;0;0;0;Celular Galaxy S21 Plus Phantom Black 128GB;TELEFONIA
5053603;;M;77;CHILENO;;Silencioso;RENCA                         ;METROPOLITANA;1001510;5;4;5;4;1001510;0;0;0;CELULAR A12 128GB Rojo OPEN;TELEFONIA
12760209;Casado;F;47;CHILENO;;X;RENCA                         ;METROPOLITANA;59480;2;1;0;0;0;2;1;59480;CELULAR OWN 1026 AZUL ENTEL;TELEFONIA
18876210;;M;27;CHILENO;;Z;CARAHUE                       ;ARAUCANIA;129990;1;1;0;0;0;1;1;129990;CELULAR A12 128GB Azul OPEN;TELEFONIA
15953640;;M;37;CHILENO;;Millenial;LOS ANGELES                   ;BIO BIO;505840;2;1;2;1;505840;0;0;0;IPHONE 11 64GB BLACK CLARO;TELEFONIA
16535893;Soltero;M;34;CHILENO;INGENIERO EN PREVENCION DE RIESGOS;Millenial;RENCA                         ;METROPOLITANA;705840;2;1;2;1;705840;0;0;0;Celular Galaxy S21 Plus Phantom Black 128GB;TELEFONIA
18098321;;F;30;CHILENO;;Millenial;"";"";114980;2;1;0;0;0;2;1;114980;CELULAR MOTO E7I POWER 32GB BLUE MOVISTAR;TELEFONIA
19631129;;F;25;CHILENO;;Z;QUIRIHUE;BIO-BIO;269980;2;2;0;0;0;2;2;269980;SMARTPHONE A03S NEGRO 32GB;TELEFONIA
11137847;;M;55;CHILENO;;Boomers;LOS LAGOS                     ;LOS LAGOS;50980;2;2;0;0;0;2;2;50980;CELULAR ZTE A3 2020 GRIS DIRECTO CLARO;TELEFONIA
18510392;;F;29;CHILENO;;Millenial;HIJUELAS                      ;VALPARAISO;19990;1;1;0;0;0;1;1;19990;Celular AL3 CLARO DIRECTO NEGRO;TELEFONIA
13770660;;M;44;CHILENO;;X;LOS ALAMOS                    ;BIO BIO;169990;1;1;0;0;0;1;1;169990;CELULAR A21s 128 GB Rojo;TELEFONIA
7490129;Casado;M;68;CHILENO;;Boomers;ALTO HOSPICIO;TARAPACA;56982;2;1;0;0;0;2;1;56982;CELULAR MOTOROLA E6 PLAY AZUL TRI WOM;TELEFONIA
16371384;;M;34;CHILENO;;Silencioso;PROVIDENCIA                   ;METROPOLITANA;183980;2;1;2;1;183980;0;0;0;CELULAR POCO X3 PRO 128 GB FROST BLUE;TELEFONIA
26782411;;M;61;VENEZOLANO;;Extranjero;N/D;N/D;1752140;7;1;0;0;0;7;1;1752140;Celular Galaxy S21 Phantom Grey 128GB;TELEFONIA
20275805;;M;22;CHILENO;;Z;PROVIDENCIA                   ;METROPOLITANA;89990;2;1;0;0;0;2;1;89990;CELULAR MOTO ONE FUSION 128GB AZUL OPEN;TELEFONIA
17276155;Soltero;F;32;CHILENO;;Millenial;PROVIDENCIA                   ;METROPOLITANA;395080;3;1;3;1;395080;0;0;0;CELULAR VIVO Y51 TITANIUM SAPPHIRE OPEN;TELEFONIA
19653114;;M;24;CHILENO;;Silencioso;PROVIDENCIA                   ;METROPOLITANA;347960;3;1;3;1;347960;0;0;0;CELULAR POCO X3 PRO 128 GB FROST BLUE;TELEFONIA
8066753;;M;62;CHILENO;;Boomers;N/D;N/D;184540;2;1;2;1;184540;0;0;0;SMARTPHONE A22 VERDE 128GB;TELEFONIA
17229441;;M;32;CHILENO;;Silencioso;PROVIDENCIA                   ;METROPOLITANA;489640;2;1;2;1;489640;0;0;0;CELULAR SAMSUNG NOTE 20 MYSTIC GRAY OPEN;TELEFONIA
18775984;Soltero;F;27;CHILENO;;Silencioso;PROVIDENCIA                   ;METROPOLITANA;908540;2;1;2;1;908540;0;0;0;CELULAR IPHONE 12 PRO 128GB GRAFITO CLARO;TELEFONIA
26236187;;M;34;VENEZOLANO;;Extranjero;CHILLAN                       ;BIO BIO;863000;3;1;0;0;0;3;1;863000;CELULAR IPHONE SE 64GB DIRECTO CLARO;TELEFONIA
18260461;;F;29;CHILENO;;Millenial;LOS VILOS                     ;COQUIMBO;209990;1;1;1;1;209990;0;0;0;CELULAR POCO X3 PRO 128G PHANTOM BLACK OPEN;TELEFONIA
13412095;;F;44;CHILENO;;X;N/D;N/D;179990;1;1;0;0;0;1;1;179990;CELULAR POCO X3 PRO 128G PHANTOM BLACK OPEN;TELEFONIA
25932352;;F;44;VENEZOLANO;;Extranjero;HUECHURABA                    ;METROPOLITANA;113980;2;1;2;1;113980;0;0;0;CELULAR HUAWEI Y7P NEGRO ENTEL;TELEFONIA
17620009;;F;29;CHILENO;;Millenial;VINA DEL MAR                  ;VALPARAISO;200980;2;1;0;0;0;2;1;200980;SMARTPHONE A03S 64 GB NEGRO;TELEFONIA
6489986;Casado;M;66;CHILENO;;Boomers;RENCA                         ;METROPOLITANA;119990;1;1;1;1;119990;0;0;0;SMARTPHONE A03S NEGRO 32GB;TELEFONIA
13068231;;F;46;CHILENO;;X;PROVIDENCIA                   ;METROPOLITANA;193980;2;1;2;1;193980;0;0;0;Celular P40 LITE LIB OPEN GREEN;TELEFONIA
16142088;;F;37;CHILENO;;Millenial;"";"";604980;2;1;2;1;604980;0;0;0;CELULAR NOTE 20 ULTRA MYSTIC BLACK 256GB OPEN;TELEFONIA
14175497;;F;41;CHILENO;;X;N/D;N/D;1019980;2;1;0;0;0;2;1;1019980;Celular Galaxy S21 Phantom Grey 128GB;TELEFONIA
16288438;;M;36;CHILENO;;Millenial;RENCA                         ;METROPOLITANA;55980;2;1;0;0;0;2;1;55980;Celular A01 Core Azul Tri Entel;TELEFONIA
9045015;;F;55;CHILENO;;Boomers;IQUIQUE                       ;TARAPACA;474570;4;1;0;0;0;4;1;474570;CELULAR GALAXY S20FE 128GB ClOUD NAVY OPEN;TELEFONIA
9058044;;F;63;CHILENO;;Boomers;COIHAIQUE                     ;AYSEN;469990;2;1;0;0;0;2;1;469990;CELULAR GALAXY S20FE 128GB ClOUD NAVY OPEN;TELEFONIA
19942931;;F;23;CHILENO;;Z;ILLAPEL                       ;COQUIMBO;129990;1;1;0;0;0;1;1;129990;CELULAR XIAOMI REDMI 9T TWILIGHT BLUE MOVISTAR;TELEFONIA
12521769;;F;49;CHILENO;;X;TALCA                         ;MAULE;139990;1;1;0;0;0;1;1;139990;CELULAR A12 128GB Azul OPEN;TELEFONIA
17038607;;F;33;CHILENO;;Millenial;VALLENAR;ATACAMA;655950;5;4;0;0;0;5;4;655950;CELULAR POCO X3 PRO 256 GB FROST BLUE;TELEFONIA
21369252;;M;46;ARGENTINO;;Extranjero;CASTRO                        ;LOS LAGOS;219990;1;1;0;0;0;1;1;219990;CELULAR REDMI NOTE 10S 128GB PEBBLE WHITE;TELEFONIA
19295903;;F;26;CHILENO;;Z;ILLAPEL                       ;COQUIMBO;116870;2;1;0;0;0;2;1;116870;CELULAR MOTO E7I POWER 32GB BLUE MOVISTAR;TELEFONIA
16811294;;M;33;CHILENO;;Millenial;PROVIDENCIA                   ;METROPOLITANA;179990;1;1;0;0;0;1;1;179990;CELULAR MOTO G30 128GB GRIS TORNASOL OPEN;TELEFONIA
19648321;;M;25;CHILENO;;Silencioso;PROVIDENCIA                   ;METROPOLITANA;213980;2;1;2;1;213980;0;0;0;POCO X3 PRO 256 GB PHANTOM BLACK;TELEFONIA
19964993;;F;24;CHILENO;;Z;CALBUCO                       ;LOS LAGOS;119990;1;1;1;1;119990;0;0;0;CELULAR POCO M3 128GB POWER BLACK;TELEFONIA
14036915;;M;40;CHILENO;;X;N/D;N/D;109480;2;1;0;0;0;2;1;109480;CELULAR REDMI 9A 32GB PEACOCK GREEN;TELEFONIA
17098964;Soltero;F;33;CHILENO;ENFERMERA;Millenial;PROVIDENCIA                   ;METROPOLITANA;473980;3;1;3;1;473980;0;0;0;CELULAR GALAXY S20FE 128GB CLOUD LAVENDER OPEN;TELEFONIA
27006861;;M;33;VENEZOLANO;;Extranjero;N/D;N/D;179990;1;1;0;0;0;1;1;179990;MOTO G30 LILA PASTEL 128GB MOVISTAR;TELEFONIA
9884261;;F;58;CHILENO;;Boomers;CHILLAN                       ;BIO BIO;129990;1;1;0;0;0;1;1;129990;CELULAR REDMI 9T 128GB SUNRISE ORANGE MOVISTAR;TELEFONIA
19970645;;F;23;CHILENO;;Silencioso;PROVIDENCIA                   ;METROPOLITANA;497090;3;1;3;1;497090;0;0;0;CELULAR GALAXY S20FE 128GB CLOUD LAVENDER OPEN;TELEFONIA
10409562;Soltero;M;57;CHILENO;;Boomers;RENCA                         ;METROPOLITANA;99990;1;1;0;0;0;1;1;99990;CELULAR MOTO ONE FUSION 64GB VERDE 64GB OPEN;TELEFONIA
18699396;;F;26;CHILENO;;Z;QUINTA NORMAL                 ;METROPOLITANA;69990;1;1;0;0;0;1;1;69990;CELULAR MOTO E7i 32GB AZUL OPEN;TELEFONIA
16024155;;F;37;CHILENO;;Millenial;SAN BERNARDO                  ;METROPOLITANA;199990;1;1;0;0;0;1;1;199990;CELULAR POCO X3 PRO 128G PHANTOM BLACK OPEN;TELEFONIA
17240267;;F;32;CHILENO;;Millenial;PROVIDENCIA                   ;METROPOLITANA;473980;3;1;3;1;473980;0;0;0;CELULAR GALAXY S20FE 128GB ClOUD NAVY OPEN;TELEFONIA
18527197;Soltero;M;28;CHILENO;;Millenial;PROVIDENCIA                   ;METROPOLITANA;238540;2;1;2;1;238540;0;0;0;CELULAR REDMI NOTE 10 PRO 128GB GLACIER BLUE;TELEFONIA
14397060;Soltero;M;43;CHILENO;;X;PROVIDENCIA                   ;METROPOLITANA;353980;2;1;2;1;353980;0;0;0;CELULAR IPHONE SE 64GB DIRECTO CLARO;TELEFONIA
18488261;;F;28;CHILENO;;Millenial;N/D;N/D;344980;2;1;0;0;0;2;1;344980;CELULAR POCO X3 PRO 256 GB FROST BLUE;TELEFONIA
8509183;;M;63;CHILENO;;Boomers;RENCA                         ;METROPOLITANA;35990;1;1;0;0;0;1;1;35990;CELULAR NOKIA 225 4G BLACK MOVISTAR DIRECTO;TELEFONIA
9634873;;M;58;CHILENO;;Boomers;SAN ANTONIO                   ;VALPARAISO;79990;1;1;0;0;0;1;1;79990;MOTO E7i 2/32GB POWER NARANJA;TELEFONIA
13791479;;M;42;CHILENO;;X;CAUQUENES                     ;MAULE;109990;1;1;0;0;0;1;1;109990;CELULAR POCO M3 64GB POWER BLACK;TELEFONIA
12004527;Casado;F;40;CHILENO;;X;RENCA                         ;METROPOLITANA;487970;3;1;3;1;487970;0;0;0;CELULAR GALAXY S20FE 128GB CLOUD GREEN OPEN;TELEFONIA
8011010;;F;52;CHILENO;;Silencioso;PROVIDENCIA                   ;METROPOLITANA;-6000;0;2;0;0;0;0;2;-6000;CELULAR OWN 1026 AZUL ENTEL;TELEFONIA
7642011;Casado;M;65;CHILENO;;Silencioso;LEBU                          ;BIO BIO;169990;1;1;0;0;0;1;1;169990;CELULAR A21s 128 GB Rojo;TELEFONIA
14001533;;F;40;CHILENO;;X;VALPARAISO                    ;VALPARAISO;104980;2;1;2;1;104980;0;0;0;CELULAR MOTOROLA MOTO G20 64GB ROSA FLAMINGO;TELEFONIA
16022627;;F;36;CHILENO;;Millenial;TALAGANTE                     ;METROPOLITANA;369970;3;2;3;2;369970;0;0;0;POCO X3 PRO 256 GB PHANTOM BLACK;TELEFONIA
7285720;Soltero;M;69;CHILENO;;Silencioso;PROVIDENCIA                   ;METROPOLITANA;109990;1;1;0;0;0;1;1;109990;CELULAR REDMI NOTE 8 2021 64GB NEPTUNE BLUE;TELEFONIA
19138234;Soltero;F;27;CHILENO;TECNICO DE NIVEL SUPERIOR EN ENFERMERIA;Z;PROVIDENCIA                   ;METROPOLITANA;469990;1;1;1;1;469990;0;0;0;IPHONE 11 64GB BLACK CLARO;TELEFONIA
13702280;;F;43;CHILENO;;X;LA PINTANA                    ;METROPOLITANA;99990;1;1;1;1;99990;0;0;0;CELULAR REDMI NOTE 8 2021 64 GB SPACE BLACK;TELEFONIA
15040144;;F;40;CHILENO;;X;MONTE PATRIA                  ;COQUIMBO;335948;5;3;0;0;0;5;3;335948;CELULAR POCO M3 128GB POWER BLACK;TELEFONIA
18062800;;F;30;CHILENO;;Millenial;N/D;N/D;199990;1;1;1;1;199990;0;0;0;CELULAR POCO X3 PRO 256 GB FROST BLUE;TELEFONIA
17198157;;M;33;CHILENO;;Silencioso;PROVIDENCIA                   ;METROPOLITANA;189990;2;1;0;0;0;2;1;189990;CELULAR POCO X3 PRO 256 GB FROST BLUE;TELEFONIA
12058721;Soltero;M;41;CHILENO;TECNICO AGROPECUARIO;X;RENCA                         ;METROPOLITANA;243980;2;1;2;1;243980;0;0;0;CELULAR REDMI NOTE 10 PRO 128GB GLACIER BLUE;TELEFONIA
13826772;;F;42;CHILENO;;X;LA SERENA                     ;N/D;79990;2;1;0;0;0;2;1;79990;SMARTPHONE A03S AZUL 32GB;TELEFONIA
20368495;;M;22;CHILENO;;Z;PROVIDENCIA                   ;METROPOLITANA;584540;2;1;2;1;584540;0;0;0;CELULAR NOTE 20 ULTRA MYSTIC BRONZE 256 GB OPE;TELEFONIA
12728185;;M;47;CHILENO;;X;LINARES                       ;MAULE;154980;2;1;0;0;0;2;1;154980;CELULAR HUAWEI Y7P NEGRO ENTEL;TELEFONIA
4903201;;F;78;CHILENO;;Silencioso;ARICA                         ;ARICA Y PARINACOTA;144990;1;1;0;0;0;1;1;144990;CELULAR A21s 128 GB Negro;TELEFONIA
18904784;;F;27;CHILENO;;Millenial;PROVIDENCIA                   ;METROPOLITANA;209990;1;1;1;1;209990;0;0;0;POCO X3 PRO 256 GB PHANTOM BLACK;TELEFONIA
15254493;;F;39;CHILENO;;X;RENCA                         ;METROPOLITANA;990;1;1;0;0;0;1;1;990;CHIP OPEN ENTEL;TELEFONIA
13012556;;M;45;CHILENO;;X;ARICA                         ;TARAPACA;199990;1;1;0;0;0;1;1;199990;POCO X3 PRO 256 GB PHANTOM BLACK;TELEFONIA
26776060;;M;49;VENEZOLANO;;Extranjero;N/D;N/D;243980;2;1;2;1;243980;0;0;0;CELULAR REDMI NOTE 10 PRO 128GB GLACIER BLUE;TELEFONIA
5882904;;F;77;CHILENO;;Silencioso;CORONEL                       ;BIO BIO;129990;1;1;0;0;0;1;1;129990;CELULAR A12 128GB Rojo OPEN;TELEFONIA
18771736;;M;27;CHILENO;;Millenial;ARICA                         ;ARICA Y PARINACOTA;169990;1;1;0;0;0;1;1;169990;CELULAR MOTOROLA G9 PLUS 128GB AZUL CLARO;TELEFONIA
12202494;Casado;M;50;CHILENO;;X;RENCA                         ;METROPOLITANA;239990;2;1;0;0;0;2;1;239990;CELULAR REDMI NOTE 10 PRO 128GB GLACIER BLUE;TELEFONIA
17212102;;M;33;CHILENO;;Millenial;CONSTITUCION                  ;MAULE;159990;2;1;0;0;0;2;1;159990;CELULAR POCO X3 PRO 128G PHANTOM BLACK OPEN;TELEFONIA
14367165;;F;48;CHILENO;;X;PAINE                         ;METROPOLITANA;19990;1;1;0;0;0;1;1;19990;Celular AL3 CLARO DIRECTO NEGRO;TELEFONIA
9376002;;M;60;CHILENO;;Silencioso;PROVIDENCIA                   ;METROPOLITANA;101770;2;1;0;0;0;2;1;101770;CELULAR MOTOROLA E6 PLAY AZUL TRI WOM;TELEFONIA
7589413;;M;66;CHILENO;;Boomers;PUENTE ALTO                   ;METROPOLITANA;617080;3;1;0;0;0;3;1;617080;CELULAR GALAXY S20FE 128GB ClOUD NAVY OPEN;TELEFONIA
13826771;;M;42;CHILENO;;X;PROVIDENCIA                   ;METROPOLITANA;149990;1;1;0;0;0;1;1;149990;CELULAR A21s 128 GB Rojo;TELEFONIA
18428809;Casado;F;29;CHILENO;;Millenial;MARCHIHUE                     ;L.G.B.OÂ´HIGGINS;155970;3;1;0;0;0;3;1;155970;CELULAR MOTOROLA G9 PLAY 64GB BLUE DIRECTO CLAR;TELEFONIA
16494366;;M;35;CHILENO;;Millenial;RANCAGUA                      ;L.G.B.OÂ´HIGGINS;541570;3;1;0;0;0;3;1;541570;CELULAR GALAXY S20FE 128GB ClOUD NAVY OPEN;TELEFONIA
5151897;;M;74;CHILENO;;Silencioso;PROVIDENCIA                   ;METROPOLITANA;990;1;1;0;0;0;1;1;990;CHIP OPEN ENTEL;TELEFONIA
13559799;;F;42;CHILENO;;X;MELIPILLA                     ;METROPOLITANA;269990;1;1;0;0;0;1;1;269990;CELULAR REDMI NOTE 10 PRO 6+128GB GRADIENT BRONZ;TELEFONIA
8138188;;F;75;CHILENO;;Silencioso;ANGOL                         ;ARAUCANIA;174980;2;1;0;0;0;2;1;174980;CELULAR A21s 128 GB Rojo;TELEFONIA
8797244;;F;62;CHILENO;;Boomers;CHILLAN                       ;BIO BIO;139990;1;1;0;0;0;1;1;139990;CELULAR REDMI NOTE 9 DIRECTO CLARO BLUE;TELEFONIA
7588934;;M;66;CHILENO;;Boomers;YERBAS BUENAS                 ;MAULE;135480;2;1;0;0;0;2;1;135480;CELULAR HUAWEI Y8S NEGRO WOM;TELEFONIA
19718876;;F;25;CHILENO;;Z;PROVIDENCIA                   ;METROPOLITANA;114480;2;1;0;0;0;2;1;114480;CELULAR MOTOROLA E7 IPOWER 32GB BLUE CLARO;TELEFONIA
16991188;;M;33;CHILENO;;Millenial;SAN FELIPE                    ;VALPARAISO;79990;1;1;0;0;0;1;1;79990;CELULAR XIAOMI REDMI 9A 32GB BLACK DIRECTO CLARO;TELEFONIA
4786694;Soltero;M;75;CHILENO;;Silencioso;VINA DEL MAR                  ;VALPARAISO;139990;1;1;0;0;0;1;1;139990;CELULAR A21s 128 GB Negro;TELEFONIA
15426615;;F;39;CHILENO;;X;PROVIDENCIA                   ;METROPOLITANA;79990;1;1;0;0;0;1;1;79990;CELULAR REDMI 9A 32GB PEACOCO GREEN DIREC MOVIST;TELEFONIA
7643395;;M;65;CHILENO;;Extranjero;VICTORIA                      ;ARAUCANIA;114980;3;1;0;0;0;3;1;114980;CELULAR Xiaomi Redmi 9 64 GB Morado WOM;TELEFONIA
6061242;;F;70;CHILENO;;Silencioso;MAIPU                         ;METROPOLITANA;225120;4;3;0;0;0;4;3;225120;CELULAR SAMSUNG A12 128GB BLACK CLARO;TELEFONIA
18538363;;M;29;CHILENO;;Silencioso;PROVIDENCIA                   ;METROPOLITANA;233980;2;1;2;1;233980;0;0;0;POCO X3 PRO 256 GB PHANTOM BLACK;TELEFONIA
19873834;;F;24;CHILENO;;Z;PROVIDENCIA                   ;METROPOLITANA;543980;2;1;2;1;543980;0;0;0;IPHONE 11 64GB BLACK CLARO;TELEFONIA
5983302;;F;75;CHILENO;;Silencioso;PROVIDENCIA                   ;METROPOLITANA;99990;1;1;0;0;0;1;1;99990;Celular XIAOMI REDMI 9C 64 GB DIRECTO CLARO;TELEFONIA
15662226;;M;38;CHILENO;;X;PROVIDENCIA                   ;METROPOLITANA;139990;1;1;1;1;139990;0;0;0;CELULAR A21s 128 GB Rojo;TELEFONIA
11072413;;F;55;CHILENO;;Boomers;SAN JAVIER                    ;MAULE;189980;2;1;0;0;0;2;1;189980;CELULAR A21s 128 GB Rojo;TELEFONIA
18958981;;M;27;CHILENO;;Millenial;N/D;N/D;109990;1;1;1;1;109990;0;0;0;CELULAR REDMI NOTE 8 2021 64GB NEPTUNE BLUE;TELEFONIA
16591100;;F;35;CHILENO;;Millenial;N/D;N/D;96680;3;2;0;0;0;3;2;96680;CELULAR VIVO Y20S NEBULA 128 GB BLUE OPEN;TELEFONIA
18945008;;M;27;CHILENO;;Z;CABRERO                       ;BIO BIO;159990;2;1;0;0;0;2;1;159990;CELULAR A32 128 GB BLACK OPEN;TELEFONIA
10144873;;F;54;CHILENO;;Boomers;CHILLAN                       ;BIO BIO;139990;1;1;0;0;0;1;1;139990;CELULAR Galaxy A21s (128GB) Black WOM;TELEFONIA
19089650;;M;27;CHILENO;;Silencioso;PROVIDENCIA                   ;METROPOLITANA;139990;1;1;0;0;0;1;1;139990;CELULAR MOTO ONE FUSION 128GB AZUL OPEN;TELEFONIA
17127052;;M;38;CHILENO;;Millenial;PROVIDENCIA                   ;METROPOLITANA;149980;4;1;0;0;0;4;1;149980;CELULAR MOTO ONE FUSION 128GB AZUL OPEN;TELEFONIA
13969359;;M;44;CHILENO;;X;PROVIDENCIA                   ;METROPOLITANA;27960;4;2;0;0;0;4;2;27960;CELULAR NOKIA 110 BLACK OPEN;TELEFONIA
12924688;;M;47;CHILENO;;X;SAN PEDRO DE LA PAZ           ;BIO BIO;149990;1;1;0;0;0;1;1;149990;CELULAR SAMSUNG A12 128GB BLACK CLARO;TELEFONIA
10783254;;F;56;CHILENO;;Boomers;TALCAHUANO                    ;BIO BIO;189980;2;1;0;0;0;2;1;189980;CELULAR A21s 128 GB Negro;TELEFONIA
17524273;;M;30;CHILENO;;Millenial;QUINTA DE TILCOCO             ;L.G.B.OÂ´HIGGINS;230980;2;1;0;0;0;2;1;230980;CELULAR MOTOROLA G9 PLUS 128GB AZUL CLARO;TELEFONIA
12129529;;M;40;CHILENO;;X;N/D;N/D;229990;1;1;0;0;0;1;1;229990;POCO X3 PRO 256 GB PHANTOM BLACK;TELEFONIA
13774245;;M;42;CHILENO;;X;BUIN                          ;METROPOLITANA;139990;1;1;0;0;0;1;1;139990;CELULAR A21s 128 GB Negro;TELEFONIA
10089730;;F;54;CHILENO;;X;ALTO HOSPICIO;TARAPACA;19990;1;1;0;0;0;1;1;19990;Celular AL3 CLARO DIRECTO NEGRO;TELEFONIA
17745353;;M;31;CHILENO;;Millenial;N/D;N/D;288860;3;1;0;0;0;3;1;288860;POCO X3 PRO 256 GB PHANTOM BLACK;TELEFONIA
17549179;Casado;F;30;CHILENO;;Millenial;PROVIDENCIA                   ;METROPOLITANA;409980;2;2;2;2;409980;0;0;0;CELULAR POCO X3 PRO 256 GB FROST BLUE;TELEFONIA
12784647;Casado;M;46;CHILENO;CONTADOR AUDITOR;X;RENCA                         ;METROPOLITANA;49990;1;1;1;1;49990;0;0;0;CELULAR ZTE A3 2020 GRIS DIRECTO CLARO;TELEFONIA
11383356;;F;55;CHILENO;;Boomers;CALAMA                        ;ANTOFAGASTA;245980;2;1;0;0;0;2;1;245980;CELULAR A32 128 GB LIGHT VIOLET OPEN;TELEFONIA
25909170;;M;38;VENEZOLANO;;Extranjero;CONCEPCION                    ;BIO BIO;129990;1;1;0;0;0;1;1;129990;CELULAR POCO M3 128GB COOL BLUE;TELEFONIA
9885572;;M;56;CHILENO;;Boomers;PARRAL                        ;MAULE;129990;1;1;0;0;0;1;1;129990;CELULAR A12 128GB Azul OPEN;TELEFONIA
18414879;;M;29;CHILENO;;Millenial;ARAUCO                        ;BIO BIO;169990;1;1;0;0;0;1;1;169990;CELULAR MOTO G9 POWER 128GB MORADO SONICO OPEN;TELEFONIA
17277332;;F;32;CHILENO;;Millenial;LA SERENA                     ;COQUIMBO;99980;4;1;0;0;0;4;1;99980;CELULAR Moto E7 Rosado WOM;TELEFONIA
14359542;;F;44;CHILENO;;X;RENCA                         ;METROPOLITANA;459980;2;1;2;1;459980;0;0;0;CELULAR POCO X3 PRO 256 GB FROST BLUE;TELEFONIA
6513592;;M;69;CHILENO;;Silencioso;PUERTO OCTAY                  ;LOS LAGOS;119480;2;1;0;0;0;2;1;119480;CELULAR CLARO MOTOROLA E7 32GB GRIS;TELEFONIA
14542367;;M;46;CHILENO;;X;N/D;N/D;236970;3;2;0;0;0;3;2;236970;POCO X3 PRO 256 GB PHANTOM BLACK;TELEFONIA
7218319;Casado;M;69;CHILENO;;Silencioso;PADRE LAS CASAS               ;ARAUCANIA;79990;1;1;0;0;0;1;1;79990;CELULAR REDMI 9A 32GB PEACOCO GREEN DIREC MOVIST;TELEFONIA
11698200;;M;51;CHILENO;;X;N/D;N/D;139990;1;1;0;0;0;1;1;139990;CELULAR A21s 128 GB Negro;TELEFONIA
14458157;;M;48;CHILENO;;X;PROVIDENCIA                   ;METROPOLITANA;89990;1;1;1;1;89990;0;0;0;Celular XIAOMI REDMI 9C 64 GB DIRECTO CLARO;TELEFONIA
11752829;;F;50;CHILENO;;X;SAN FELIPE                    ;VALPARAISO;189980;2;1;0;0;0;2;1;189980;CELULAR A21s 128 GB AZUL;TELEFONIA
9118926;;M;58;CHILENO;;Boomers;RENCA                         ;METROPOLITANA;69990;1;1;0;0;0;1;1;69990;CELULAR MOTOROLA E6 PLAY AZUL TRI WOM;TELEFONIA
18979750;;F;26;CHILENO;;Z;PROVIDENCIA                   ;METROPOLITANA;133980;2;1;2;1;133980;0;0;0;CELULAR A12 128GB Negro OPEN;TELEFONIA
11270301;;F;54;CHILENO;;X;BUIN                          ;METROPOLITANA;148980;2;1;0;0;0;2;1;148980;CELULAR A12 128GB Negro OPEN;TELEFONIA
15271114;;F;39;CHILENO;;Millenial;OSORNO                        ;LOS LAGOS;149980;2;1;0;0;0;2;1;149980;CELULAR CLARO LG K42 GRIS;TELEFONIA
8649503;Casado;M;63;CHILENO;INGENIERO;Boomers;RENCA                         ;METROPOLITANA;129990;1;1;1;1;129990;0;0;0;CELULAR A12 128GB Rojo OPEN;TELEFONIA
12462027;;M;48;CHILENO;;X;PROVIDENCIA                   ;METROPOLITANA;99990;1;1;0;0;0;1;1;99990;CELULAR VIVO Y11S PHANTON BLACK 32GB MOVISTAR;TELEFONIA
8614137;;M;64;CHILENO;;Boomers;REQUINOA                      ;L.G.B.OÂ´HIGGINS;99990;1;1;0;0;0;1;1;99990;CELULAR VIVO Y11S PHANTON BLACK 32GB MOVISTAR;TELEFONIA
7903481;;F;64;CHILENO;;Boomers;LA LIGUA                      ;VALPARAISO;139990;1;1;0;0;0;1;1;139990;CELULAR A21s 128 GB Negro;TELEFONIA
19933907;;F;24;CHILENO;;Z;PROVIDENCIA                   ;METROPOLITANA;539990;1;1;1;1;539990;0;0;0;IPHONE 11 64GB BLACK CLARO;TELEFONIA
12100990;Divorciado;M;52;CHILENO;AGROINDUSTRIA;X;PROVIDENCIA                   ;METROPOLITANA;84990;1;1;0;0;0;1;1;84990;CELULAR MOTO E7i 32GB AZUL OPEN;TELEFONIA
19652827;;F;24;CHILENO;;Z;SAN CARLOS                    ;BIO BIO;117470;3;1;0;0;0;3;1;117470;CELULAR CLARO MOTOROLA E7 32GB GRIS;TELEFONIA
19809695;;F;25;CHILENO;;Silencioso;PROVIDENCIA                   ;METROPOLITANA;189990;1;1;1;1;189990;0;0;0;CELULAR MOTO G30 128GB LILA PASTEL OPEN;TELEFONIA
17967959;;F;30;CHILENO;;Millenial;PROVIDENCIA                   ;METROPOLITANA;194470;3;2;0;0;0;3;2;194470;CELULAR VIVO Y11S PHANTOM BLACK OPEN;TELEFONIA
14336569;;M;44;CHILENO;;X;QUINTA DE TILCOCO             ;L.G.B.OÂ´HIGGINS;65990;1;1;0;0;0;1;1;65990;CELULAR MOTOROLA E6 PLAY AZUL TRI WOM;TELEFONIA
13622540;;M;43;CHILENO;;X;CHIGUAYANTE                   ;BIO BIO;1314160;4;1;0;0;0;4;1;1314160;CELULAR GALAXY S20FE 128GB ClOUD NAVY OPEN;TELEFONIA
19683780;;M;25;CHILENO;;Z;N/D;N/D;0;0;0;0;0;0;0;0;0;CELULAR A21s 128 GB Negro;TELEFONIA
11981854;;F;50;CHILENO;;X;CHILLAN                       ;BIO BIO;0;0;0;0;0;0;0;0;0;CELULAR MOTO ONE FUSION 128GB AZUL OPEN;TELEFONIA
11055399;;F;55;CHILENO;;Silencioso;"";"";0;0;0;0;0;0;0;0;0;CELULAR A21s 128 GB Negro;TELEFONIA
19145473;Soltero;F;26;CHILENO;;Z;VALLENAR;ATACAMA;0;0;0;0;0;0;0;0;0;CELULAR REDMI NOTE 10 PRO 6+128GB GRADIENT BRONZ;TELEFONIA
9044575;;F;62;CHILENO;;Boomers;PETORCA                       ;VALPARAISO;0;0;0;0;0;0;0;0;0;CELULAR A32 128 GB BLUE OPEN;TELEFONIA
7831407;;F;62;CHILENO;;Boomers;RENCA                         ;METROPOLITANA;0;0;0;0;0;0;0;0;0;CELULAR A21s 128 GB Rojo;TELEFONIA
17380937;;F;32;CHILENO;;Millenial;COLINA                        ;METROPOLITANA;0;0;0;0;0;0;0;0;0;CELULAR A21s 128 GB AZUL;TELEFONIA
15607189;;F;38;CHILENO;;Silencioso;PROVIDENCIA                   ;METROPOLITANA;0;0;0;0;0;0;0;0;0;CELULAR A21s 128 GB AZUL;TELEFONIA
17468265;;F;32;CHILENO;;Millenial;LOS ANDES                     ;VALPARAISO;0;0;0;0;0;0;0;0;0;CELULAR A12 128GB AZUL OPEN;TELEFONIA
15566721;Soltero;F;38;CHILENO;;Millenial;SAN JAVIER                    ;MAULE;0;0;0;0;0;0;0;0;0;CELULAR A12 128GB AZUL OPEN;TELEFONIA
7328157;;F;71;CHILENO;;Silencioso;RANCAGUA                      ;L.G.B.OÂ´HIGGINS;0;0;0;0;0;0;0;0;0;CELULAR VIVO V20 MIDNIGHT JAZZ OPEN;TELEFONIA
12491638;;F;49;CHILENO;;X;PROVIDENCIA                   ;METROPOLITANA;0;0;0;0;0;0;0;0;0;CELULAR REDMI NOTE 8 2021 64GB MOONLIGHT WHITE;TELEFONIA
19668013;;F;24;CHILENO;;Silencioso;PROVIDENCIA                   ;METROPOLITANA;0;0;0;0;0;0;0;0;0;CELULAR A21s 128 GB Negro;TELEFONIA
10342415;;F;54;CHILENO;;Boomers;MAIPU                         ;METROPOLITANA;0;0;0;0;0;0;0;0;0;CELULAR IPHONE SE 64GB DIRECTO CLARO;TELEFONIA
19586398;;F;25;CHILENO;;Z;EL BOSQUE                     ;METROPOLITANA;0;0;0;0;0;0;0;0;0;CELULAR A32 128 GB BLACK OPEN;TELEFONIA
16650939;;M;34;CHILENO;;Millenial;"";"";0;0;0;0;0;0;0;0;0;CELULAR REDMI NOTE 10 PRO 6+128GB GRADIENT BRONZ;TELEFONIA
9794536;;F;58;CHILENO;;Boomers;LO PRADO                      ;METROPOLITANA;0;0;0;0;0;0;0;0;0;CELULAR REDMI 9T 128 GB OCEAN GREEN;TELEFONIA
13416923;;F;44;CHILENO;;X;N/D;N/D;0;0;0;0;0;0;0;0;0;CELULAR A21s 128 GB Rojo;TELEFONIA
15204916;;F;40;CHILENO;;X;RENCA                         ;METROPOLITANA;0;0;0;0;0;0;0;0;0;CELULAR MOTO G30 128GB LILA PASTEL OPEN;TELEFONIA
12738776;;M;55;CHILENO;;Boomers;PAINE                         ;METROPOLITANA;0;0;0;0;0;0;0;0;0;CELULAR A12 128GB NEGRO TRIANGULADO CLARO;TELEFONIA
19340326;;F;26;CHILENO;;Silencioso;"";"";0;0;0;0;0;0;0;0;0;CHIP OPEN ENTEL;TELEFONIA
15423536;;F;39;CHILENO;;X;PROVIDENCIA                   ;METROPOLITANA;0;0;0;0;0;0;0;0;0;IPHONE 7 LIB OPEN NEGRO;TELEFONIA
20338693;;F;22;CHILENO;;Z;RENCA                         ;METROPOLITANA;0;0;0;0;0;0;0;0;0;CELULAR A32 128 GB BLUE OPEN;TELEFONIA
10636574;;M;53;CHILENO;;X;CATEMU                        ;VALPARAISO;0;0;0;0;0;0;0;0;0;CELULAR A32 128 GB BLACK OPEN;TELEFONIA
19059923;;F;25;CHILENO;;Z;SANTIAGO                      ;METROPOLITANA;0;0;0;0;0;0;0;0;0;CELULAR MOTOROLA E6S ROSADO DIRECTO WOM;TELEFONIA
13376758;;M;43;CHILENO;;X;PANGUIPULLI                   ;LOS RIOS;0;0;0;0;0;0;0;0;0;CELULAR A21s 128 GB Negro;TELEFONIA
10689525;;F;57;CHILENO;;Boomers;CALAMA                        ;ANTOFAGASTA;0;0;0;0;0;0;0;0;0;CELULAR A21s 128 GB Negro;TELEFONIA
15786484;;F;38;CHILENO;;Millenial;SAN MIGUEL                    ;METROPOLITANA;0;0;0;0;0;0;0;0;0;IPHONE 11 64GB BLACK CLARO;TELEFONIA
8680524;;M;63;CHILENO;;Boomers;TALCAHUANO                    ;BIO BIO;0;0;0;0;0;0;0;0;0;CELULAR REDMI 9C 32GB TWILIGHT BLUE MOVISTAR;TELEFONIA
17220233;;M;33;CHILENO;;Millenial;PROVIDENCIA                   ;METROPOLITANA;0;0;0;0;0;0;0;0;0;CELULAR A12 128GB NEGRO OPEN;TELEFONIA
16875757;;F;34;CHILENO;;Millenial;PROVIDENCIA                   ;METROPOLITANA;0;0;0;0;0;0;0;0;0;Celular AL3 CLARO DIRECTO NEGRO;TELEFONIA
14373437;;F;48;CHILENO;;X;TALCAHUANO                    ;BIO BIO;0;0;0;0;0;0;0;0;0;CELULAR A52 128 GB BLACK OPEN;TELEFONIA
16230505;;F;37;CHILENO;;Millenial;PETORCA                       ;VALPARAISO;0;0;0;0;0;0;0;0;0;CELULAR A02 ROJO 32GB OPEN;TELEFONIA
18447153;;F;29;CHILENO;;Silencioso;PROVIDENCIA                   ;METROPOLITANA;0;0;0;0;0;0;0;0;0;CELULAR IPHONE SE 64GB DIRECTO CLARO;TELEFONIA
17460737;;F;32;CHILENO;;Millenial;COLLIPULLI                    ;ARAUCANIA;0;0;0;0;0;0;0;0;0;CELULAR A32 128 GB BLACK OPEN;TELEFONIA
16152801;;F;36;CHILENO;;Millenial;COIHUECO                      ;BIO BIO;0;0;0;0;0;0;0;0;0;CELULAR GALAXY S20FE 128GB CLOUD LAVENDER OPEN;TELEFONIA
12483657;;M;48;CHILENO;;X;N/D;N/D;0;0;0;0;0;0;0;0;0;CELULAR REDMI NOTE 10 EU 64GB ONIX GRAY OPEN;TELEFONIA
6036103;Soltero;F;71;CHILENO;;Silencioso;PROVIDENCIA                   ;METROPOLITANA;0;0;0;0;0;0;0;0;0;Celular AL3 CLARO DIRECTO NEGRO;TELEFONIA
6462242;;M;71;CHILENO;;Silencioso;LEBU                          ;BIO BIO;0;0;0;0;0;0;0;0;0;CELULAR A21s 128 GB Rojo;TELEFONIA
16549529;;F;35;CHILENO;;Millenial;ANTOFAGASTA                   ;ANTOFAGASTA;0;0;0;0;0;0;0;0;0;CELULAR A32 128 GB LIGHT VIOLET OPEN;TELEFONIA
15656398;;M;38;CHILENO;;Millenial;TEMUCO                        ;ARAUCANIA;0;0;0;0;0;0;0;0;0;CELULAR HUAWEI Y7P NEGRO ENTEL;TELEFONIA
15559325;;F;38;CHILENO;;X;PROVIDENCIA                   ;METROPOLITANA;0;0;0;0;0;0;0;0;0;CELULAR A32 128 GB WHITE OPEN;TELEFONIA
10784626;;M;55;CHILENO;;Boomers;LINARES                       ;MAULE;0;0;0;0;0;0;0;0;0;CELULAR A32 128 GB BLACK OPEN;TELEFONIA
11386395;;F;53;CHILENO;;X;NOGALES                       ;VALPARAISO;0;0;0;0;0;0;0;0;0;CELULAR A21s 128 GB Negro;TELEFONIA
9026789;;M;61;CHILENO;;Boomers;N/D;N/D;0;0;0;0;0;0;0;0;0;CELULAR REDMI NOTE 10 PRO 6+128GB GRADIENT BRONZ;TELEFONIA
14217805;;F;42;CHILENO;;X;PROVIDENCIA                   ;METROPOLITANA;0;0;0;0;0;0;0;0;0;CELULAR A32 128 GB BLACK OPEN;TELEFONIA
17373768;;M;32;CHILENO;;Millenial;"";"";0;0;0;0;0;0;0;0;0;CELULAR MOTO G9 POWER 128GB MORADO SONICO OPEN;TELEFONIA
10502354;;F;63;CHILENO;;Boomers;RIO IBANEZ                    ;AYSEN;0;0;0;0;0;0;0;0;0;CELULAR A21s 128 GB Rojo;TELEFONIA
19581052;;M;25;CHILENO;;Z;PROVIDENCIA                   ;METROPOLITANA;0;0;0;0;0;0;0;0;0;CELULAR A12 128GB AZUL OPEN;TELEFONIA
16641713;Soltero;F;35;CHILENO;;Millenial;ILLAPEL                       ;COQUIMBO;0;0;0;0;0;0;0;0;0;CELULAR MOTO E6I 32GB GRIS OPEN;TELEFONIA
13665796;;M;43;CHILENO;;X;TALAGANTE                     ;METROPOLITANA;0;0;0;0;0;0;0;0;0;CELULAR A21s 128 GB Rojo;TELEFONIA
18206350;;M;29;CHILENO;;Millenial;PROVIDENCIA                   ;METROPOLITANA;0;0;0;0;0;0;0;0;0;CELULAR NOKIA QUEEN VALUE BLACK CLARO;TELEFONIA
12129687;;M;40;CHILENO;;Silencioso;PROVIDENCIA                   ;METROPOLITANA;0;0;0;0;0;0;0;0;0;CELULAR GALAXY S20FE 128GB ClOUD NAVY OPEN;TELEFONIA
8061502;Casado;F;64;CHILENO;;Boomers;RENCA                         ;METROPOLITANA;0;0;0;0;0;0;0;0;0;CELULAR REDMI 9A 32GB PEACOCK GREEN;TELEFONIA
15102829;;F;40;CHILENO;;X;PROVIDENCIA                   ;METROPOLITANA;0;0;0;0;0;0;0;0;0;CELULAR A21s 128 GB AZUL;TELEFONIA
15768783;;M;38;CHILENO;;X;RANCAGUA                      ;L.G.B.OÂ´HIGGINS;0;0;0;0;0;0;0;0;0;CELULAR MOTO E7 32GB GRIS OPEN;TELEFONIA
11454011;;F;53;CHILENO;;Silencioso;PROVIDENCIA                   ;METROPOLITANA;0;0;0;0;0;0;0;0;0;CELULAR A32 128 GB LIGHT VIOLET OPEN;TELEFONIA
15501500;Soltero;M;39;CHILENO;;X;ANTOFAGASTA                   ;ANTOFAGASTA;0;0;0;0;0;0;0;0;0;CELULAR ZTE A5 2020 DIRECTO CLARO VERDE;TELEFONIA
9694134;;F;58;CHILENO;;Boomers;MULCHEN                       ;BIO BIO;0;0;0;0;0;0;0;0;0;Celular Y9 PRIME LIB OPEN VERDE;TELEFONIA
9852404;;M;57;CHILENO;;X;PROVIDENCIA                   ;METROPOLITANA;0;0;0;0;0;0;0;0;0;CELULAR ALCATEL P1 3080 BLACK MOVISTAR DIRECTO;TELEFONIA
20102414;;M;22;CHILENO;;Z;PROVIDENCIA                   ;METROPOLITANA;0;0;0;0;0;0;0;0;0;POCO X3 PRO 256 GB PHANTOM BLACK;TELEFONIA
6386421;;F;72;CHILENO;;Silencioso;LA FLORIDA                    ;METROPOLITANA;0;0;0;0;0;0;0;0;0;CELULAR OWN 1026 AZUL ENTEL;TELEFONIA
15842248;;F;37;CHILENO;;Millenial;PUENTE ALTO                   ;METROPOLITANA;0;0;0;0;0;0;0;0;0;CELULAR A32 128 GB LIGHT VIOLET OPEN;TELEFONIA
18284191;;F;29;CHILENO;;Millenial;PROVIDENCIA                   ;METROPOLITANA;0;0;0;0;0;0;0;0;0;CELULAR A32 128 GB BLUE OPEN;TELEFONIA
13397699;Soltero;F;44;CHILENO;;X;RENCA                         ;METROPOLITANA;0;0;0;0;0;0;0;0;0;Celular ZTE A3 2020 WOM DIRECTO NEGRO;TELEFONIA
15545200;;M;38;CHILENO;;Millenial;PROVIDENCIA                   ;METROPOLITANA;0;0;0;0;0;0;0;0;0;CELULAR A21s 128 GB Negro;TELEFONIA
10067192;;M;55;CHILENO;;Boomers;SAN BERNARDO                  ;METROPOLITANA;0;0;0;0;0;0;0;0;0;CELULAR VIVO Y20 BLACK 64GB MOVISTAR;TELEFONIA
8566038;;M;64;CHILENO;;Boomers;LINARES                       ;MAULE;0;0;0;0;0;0;0;0;0;CELULAR MOTOROLA E7 IPOWER 32GB BLUE CLARO;TELEFONIA
24451754;;M;34;ARGENTINO;;Extranjero;MONTE PATRIA                  ;COQUIMBO;0;0;0;0;0;0;0;0;0;CELULAR A32 128 GB LIGHT VIOLET OPEN;TELEFONIA
13583906;;F;47;CHILENO;;X;LO PRADO                      ;METROPOLITANA;0;0;0;0;0;0;0;0;0;CELULAR MOTOROLA E6 PLAY AZUL TRI WOM;TELEFONIA
4544525;;M;79;CHILENO;;Silencioso;ILLAPEL                       ;COQUIMBO;0;0;0;0;0;0;0;0;0;CELULAR A32 128 GB BLACK OPEN;TELEFONIA
19215623;;M;26;CHILENO;;Z;N/D;N/D;0;0;0;0;0;0;0;0;0;CELULAR POCO X3 PRO 256 GB FROST BLUE;TELEFONIA
16717319;;F;34;CHILENO;;Millenial;N/D;N/D;0;0;0;0;0;0;0;0;0;POCO X3 PRO 256 GB METAL BRONCE;TELEFONIA
9667576;;M;46;CHILENO;;Silencioso;PROVIDENCIA                   ;METROPOLITANA;0;0;0;0;0;0;0;0;0;CELULAR A32 128 GB LIGHT VIOLET OPEN;TELEFONIA
19922345;;F;24;CHILENO;;Z;"";"";0;0;0;0;0;0;0;0;0;CELULAR XIAOMI REDMI 9A 32GB BLACK DIRECTO CLARO;TELEFONIA
9921812;;F;58;CHILENO;;Boomers;RENCA                         ;METROPOLITANA;0;0;0;0;0;0;0;0;0;CELULAR A21s 128 GB AZUL;TELEFONIA
19472584;;F;25;CHILENO;;Z;TALCA                         ;MAULE;0;0;0;0;0;0;0;0;0;CELULAR A12 128GB AZUL OPEN;TELEFONIA
7556433;Casado;M;67;CHILENO;;Boomers;PROVIDENCIA                   ;METROPOLITANA;0;0;0;0;0;0;0;0;0;CELULAR VIVO Y20 BLACK 64GB MOVISTAR;TELEFONIA
19393974;Soltero;F;26;CHILENO;;Z;PROVIDENCIA                   ;METROPOLITANA;0;0;0;0;0;0;0;0;0;CELULAR A02 ROJO 32GB OPEN;TELEFONIA
11950212;;F;49;CHILENO;;X;RENGO                         ;L.G.B.OÂ´HIGGINS;0;0;0;0;0;0;0;0;0;CELULAR Xiaomi Redmi 9 64 GB Morado WOM;TELEFONIA
16761732;;F;34;CHILENO;;Millenial;N/D;N/D;0;0;0;0;0;0;0;0;0;CELULAR A21s 128 GB Rojo;TELEFONIA
15427096;Soltero;M;39;CHILENO;;X;PROVIDENCIA                   ;METROPOLITANA;0;0;0;0;0;0;0;0;0;POCO X3 PRO 256 GB METAL BRONCE;TELEFONIA
24400918;;F;32;BOLIVIANO;;Extranjero;N/D;N/D;0;0;0;0;0;0;0;0;0;CELULAR A21s 128 GB Rojo;TELEFONIA
19460491;;F;24;CHILENO;;Z;PROVIDENCIA                   ;METROPOLITANA;0;0;0;0;0;0;0;0;0;POCO X3 PRO 256 GB METAL BRONCE;TELEFONIA
19448080;;F;26;CHILENO;;Z;N/D;N/D;0;0;0;0;0;0;0;0;0;CELULAR A32 128 GB WHITE OPEN;TELEFONIA
10353921;Casado;M;53;CHILENO;;Silencioso;PROVIDENCIA                   ;METROPOLITANA;0;0;0;0;0;0;0;0;0;CELULAR VIVO Y11S PHANTOM BLACK OPEN;TELEFONIA
10396863;Soltero;F;56;CHILENO;PROFESOR;Boomers;RENCA                         ;METROPOLITANA;0;0;0;0;0;0;0;0;0;CELULAR GALAXY A01 32GB AZUL ENTEL;TELEFONIA
19672540;;F;24;CHILENO;;Z;N/D;N/D;0;0;0;0;0;0;0;0;0;POCO X3 PRO 256 GB PHANTOM BLACK;TELEFONIA
15881296;;M;42;CHILENO;;X;N/D;N/D;0;0;0;0;0;0;0;0;0;CELULAR A21s 128 GB Rojo;TELEFONIA
9015290;;M;62;CHILENO;;Boomers;PANGUIPULLI                   ;LOS RIOS;0;0;0;0;0;0;0;0;0;Celular A11 LIB OPEN WHITE;TELEFONIA
19985818;;M;23;CHILENO;;Silencioso;PROVIDENCIA                   ;METROPOLITANA;0;0;0;0;0;0;0;0;0;Celular Galaxy S21 Plus Phantom Black 128GB;TELEFONIA
18185953;;F;30;CHILENO;;Millenial;N/D;N/D;0;0;0;0;0;0;0;0;0;CELULAR A32 128 GB LIGHT VIOLET OPEN;TELEFONIA
17305072;;M;32;CHILENO;;Silencioso;PROVIDENCIA                   ;METROPOLITANA;0;0;0;0;0;0;0;0;0;CELULAR MOTO ONE FUSION 64GB VERDE 64GB OPEN;TELEFONIA
13109030;;M;45;CHILENO;;X;LOS ALAMOS                    ;BIO BIO;0;0;0;0;0;0;0;0;0;CELULAR REDMI 9T 128GB SUNRISE ORANGE MOVISTAR;TELEFONIA
11258908;;F;54;CHILENO;;X;N/D;N/D;0;0;0;0;0;0;0;0;0;CELULAR A21s 128 GB Negro;TELEFONIA
12354977;;M;49;CHILENO;;X;SAN BERNARDO                  ;METROPOLITANA;0;0;0;0;0;0;0;0;0;CELULAR A12 128GB AZUL OPEN;TELEFONIA
13324986;;M;45;CHILENO;;X;COIHAIQUE                     ;AYSEN;0;0;0;0;0;0;0;0;0;CELULAR A32 128 GB WHITE OPEN;TELEFONIA
17257846;Casado;M;32;CHILENO;INGENIERO EN ADMINISTRACION DE EMPRESAS;Millenial;PROVIDENCIA                   ;METROPOLITANA;0;0;0;0;0;0;0;0;0;CELULAR NOKIA 110 BLACK OPEN;TELEFONIA
11343120;;F;54;CHILENO;;X;RENCA                         ;METROPOLITANA;0;0;0;0;0;0;0;0;0;CELULAR ZTE A3 2020 GRIS DIRECTO CLARO;TELEFONIA
15382847;Casado;F;39;CHILENO;CIRUJANO DENTISTA;Silencioso;PROVIDENCIA                   ;METROPOLITANA;0;0;0;0;0;0;0;0;0;Celular A01 LIB OPEN AZUL;TELEFONIA
15135959;;F;39;CHILENO;;Silencioso;TALCA                         ;MAULE;0;0;0;0;0;0;0;0;0;CELULAR SAMSUNG NOTE 20 MYSTIC GRAY OPEN;TELEFONIA
14113034;;M;40;CHILENO;;Millenial;ANTOFAGASTA                   ;ANTOFAGASTA;0;0;0;0;0;0;0;0;0;CELULAR POCO X3 PRO 256 GB FROST BLUE;TELEFONIA
15733475;;M;38;CHILENO;;X;RENCA                         ;METROPOLITANA;0;0;0;0;0;0;0;0;0;CELULAR POCO M3 PRO 5G 128GB COOL BLUE;TELEFONIA
17813890;Soltero;F;31;CHILENO;PROFESOR;Silencioso;PROVIDENCIA                   ;METROPOLITANA;0;0;0;0;0;0;0;0;0;CELULAR REDMI 9C 32GB TWILIGHT BLUE MOVISTAR;TELEFONIA
16337873;;F;38;CHILENO;;Millenial;SAN PABLO                     ;LOS LAGOS;0;0;0;0;0;0;0;0;0;CELULAR VIVO Y11S PHANTOM BLACK OPEN;TELEFONIA
19990644;;F;23;CHILENO;;Z;PROVIDENCIA                   ;METROPOLITANA;0;0;0;0;0;0;0;0;0;Celular A11 LIB OPEN WHITE;TELEFONIA
14400525;;M;43;CHILENO;;X;RENCA                         ;METROPOLITANA;0;0;0;0;0;0;0;0;0;CELULAR REDMI NOTE 10 128GB ONIX GRAY OPEN;TELEFONIA
12556959;;F;48;CHILENO;;X;LOS ANGELES                   ;BIO BIO;0;0;0;0;0;0;0;0;0;CELULAR REDMI NOTE 9 128G FOREST GREEN OPEN;TELEFONIA
16359247;Soltero;M;35;CHILENO;CONTADOR AUDITOR;Millenial;PROVIDENCIA                   ;METROPOLITANA;0;0;0;0;0;0;0;0;0;CELULAR MOTO G9 POWER 128GB VERDE GRANITO OPEN;TELEFONIA
18813214;;M;28;CHILENO;;Millenial;SANTA JUANA                   ;BIO BIO;0;0;0;0;0;0;0;0;0;CELULAR POCO X3 PRO 128G PHANTOM BLACK OPEN;TELEFONIA
19149018;;M;26;CHILENO;;Z;PROVIDENCIA                   ;METROPOLITANA;0;0;0;0;0;0;0;0;0;CELULAR Xiaomi Redmi 9 64 GB Morado WOM;TELEFONIA
10259555;Soltero;M;56;CHILENO;;Boomers;ANGOL                         ;ARAUCANIA;0;0;0;0;0;0;0;0;0;CELULAR A32 128 GB LIGHT VIOLET OPEN;TELEFONIA
20587677;;F;21;CHILENO;;Z;PROVIDENCIA                   ;METROPOLITANA;0;0;0;0;0;0;0;0;0;CELULAR A32 128 GB WHITE OPEN;TELEFONIA
17150862;;M;33;CHILENO;;Millenial;N/D;N/D;0;0;0;0;0;0;0;0;0;CELULAR REDMI NOTE 10 EU 64GB ONIX GRAY OPEN;TELEFONIA
11548094;;M;51;CHILENO;;X;N/D;N/D;0;0;0;0;0;0;0;0;0;CELULAR A21s 128 GB AZUL;TELEFONIA
17973059;;F;30;CHILENO;;Millenial;PROVIDENCIA                   ;METROPOLITANA;0;0;0;0;0;0;0;0;0;CELULAR A21s 128 GB AZUL;TELEFONIA
11375103;;F;53;CHILENO;;X;LUMACO                        ;ARAUCANIA;0;0;0;0;0;0;0;0;0;CELULAR MOTOROLA G9 PLAY 64GB BLUE DIRECTO CLAR;TELEFONIA
12549411;;M;48;CHILENO;;X;CHILLAN                       ;BIO BIO;0;0;0;0;0;0;0;0;0;CELULAR REDMI NOTE 9 128 GB MIDNIGHT GREY OPEN;TELEFONIA
13767921;;F;42;CHILENO;;X;SANTO DOMINGO                 ;VALPARAISO;0;0;0;0;0;0;0;0;0;CELULAR A21s 128 GB Rojo;TELEFONIA
14625134;;F;45;CHILENO;;X;CHANCO                        ;MAULE;0;0;0;0;0;0;0;0;0;CELULAR A21s 128 GB AZUL;TELEFONIA
10404494;;M;55;CHILENO;;Silencioso;PADRE LAS CASAS               ;ARAUCANIA;0;0;0;0;0;0;0;0;0;CELULAR REDMI 9A 32GB PEACOCK GREEN;TELEFONIA
17870157;;F;31;CHILENO;;Millenial;LOS ANGELES                   ;BIO BIO;0;0;0;0;0;0;0;0;0;CELULAR MOTOROLA MOTO G20 64GB ROSA FLAMINGO;TELEFONIA
10472250;;M;55;CHILENO;;Boomers;SAN CARLOS                    ;BIO BIO;0;0;0;0;0;0;0;0;0;CELULAR REDMI 9A 32GB PEACOCK GREEN;TELEFONIA
18838424;;M;27;CHILENO;;Millenial;N/D;N/D;0;0;0;0;0;0;0;0;0;POCO X3 PRO 256 GB PHANTOM BLACK;TELEFONIA
14556870;Soltero;M;46;CHILENO;;X;LINARES                       ;MAULE;0;0;0;0;0;0;0;0;0;CELULAR A72 128 GB BLACK OPEN;TELEFONIA
19721472;;M;24;CHILENO;;Z;PROVIDENCIA                   ;METROPOLITANA;0;0;0;0;0;0;0;0;0;CELULAR A32 128 GB BLUE OPEN;TELEFONIA
16464718;;M;35;CHILENO;;Silencioso;PROVIDENCIA                   ;METROPOLITANA;0;0;0;0;0;0;0;0;0;CELULAR POCO M3 PRO 5G 128GB COOL BLUE;TELEFONIA
20345097;;M;22;CHILENO;;Z;N/D;N/D;0;0;0;0;0;0;0;0;0;CELULAR REDMI NOTE 10 128GB ONIX GRAY OPEN;TELEFONIA
8179275;;M;64;CHILENO;;Silencioso;PROVIDENCIA                   ;METROPOLITANA;0;0;0;0;0;0;0;0;0;CELULAR MOTO E6I 32GB GRIS OPEN;TELEFONIA
15287122;;F;38;CHILENO;;X;N/D;N/D;0;0;0;0;0;0;0;0;0;CELULAR HUAWEI P30 LITE PLUS PIEDRA DE LUNA OPEN;TELEFONIA
16901354;;F;34;CHILENO;;Millenial;LA PINTANA                    ;METROPOLITANA;0;0;0;0;0;0;0;0;0;CELULAR MOTOROLA E6 PLAY AZUL TRI WOM;TELEFONIA
12842387;;M;46;CHILENO;;X;RENCA                         ;METROPOLITANA;0;0;0;0;0;0;0;0;0;Celular A11 LIB OPEN WHITE;TELEFONIA
6057772;Soltero;M;72;CHILENO;;Silencioso;PROVIDENCIA                   ;METROPOLITANA;0;0;0;0;0;0;0;0;0;CELULAR A02 NEGRO 32GB OPEN;TELEFONIA
17307325;;F;32;CHILENO;;Millenial;SAN ANTONIO                   ;VALPARAISO;0;0;0;0;0;0;0;0;0;CELULAR NOKIA 110 BLACK OPEN;TELEFONIA
19987168;;F;23;CHILENO;;Z;MULCHEN                       ;BIO BIO;0;0;0;0;0;0;0;0;0;CELULAR POCO X3 PRO 128G PHANTOM BLACK OPEN;TELEFONIA
16728606;;F;35;CHILENO;;Millenial;PROVIDENCIA                   ;METROPOLITANA;0;0;0;0;0;0;0;0;0;POCO X3 PRO 256 GB PHANTOM BLACK;TELEFONIA
17417370;;M;32;CHILENO;;Silencioso;PROVIDENCIA                   ;METROPOLITANA;0;0;0;0;0;0;0;0;0;CELULAR A21s 128 GB Negro;TELEFONIA
10846922;;F;53;CHILENO;;X;ARICA                         ;ARICA Y PARINACOTA;0;0;0;0;0;0;0;0;0;POCO X3 PRO 256 GB PHANTOM BLACK;TELEFONIA
13747330;;F;41;CHILENO;;X;OVALLE                        ;COQUIMBO;0;0;0;0;0;0;0;0;0;CELULAR A21s 128 GB AZUL;TELEFONIA
13596689;Soltero;F;43;CHILENO;;X;SAN FERNANDO                  ;L.G.B.OÂ´HIGGINS;0;0;0;0;0;0;0;0;0;CELULAR MOTO G9 POWER PURPLE 128GB MOVISTAR;TELEFONIA
16066986;;F;38;CHILENO;;Millenial;PROVIDENCIA                   ;METROPOLITANA;0;0;0;0;0;0;0;0;0;Celular Galaxy S21 Plus Phantom Silver 128GB;TELEFONIA
14394351;;M;43;CHILENO;;X;QUIRIHUE                      ;BIO BIO;0;0;0;0;0;0;0;0;0;CELULAR A12 128GB ROJO OPEN;TELEFONIA
15156144;;F;38;CHILENO;;Millenial;CURICO                        ;MAULE;0;0;0;0;0;0;0;0;0;CELULAR A21s 128 GB Rojo;TELEFONIA
6259224;Casado;M;69;CHILENO;;Silencioso;RENCA                         ;METROPOLITANA;0;0;0;0;0;0;0;0;0;CELULAR HUAWEI Y8S CLARO DIRECTO BLACK;TELEFONIA
18318807;;F;29;CHILENO;;Millenial;"";"";0;0;0;0;0;0;0;0;0;CELULAR REDMI NOTE 8 2021 64 GB SPACE BLACK;TELEFONIA
12246052;;F;50;CHILENO;;X;N/D;N/D;0;0;0;0;0;0;0;0;0;CELULAR MI 11 LITE 128GB BOBA BLACK OPEN;TELEFONIA
18488905;Soltero;F;29;CHILENO;INGENIERO COMERCIAL;Millenial;PROVIDENCIA                   ;METROPOLITANA;0;0;0;0;0;0;0;0;0;Celular A01 LIB OPEN NEGRO;TELEFONIA
18135330;Soltero;F;30;CHILENO;PROFESOR;Millenial;PROVIDENCIA                   ;METROPOLITANA;0;0;0;0;0;0;0;0;0;CELULAR REDMI 9A 32GB PEACOCK GREEN;TELEFONIA
17669273;;F;30;CHILENO;;Millenial;PROVIDENCIA                   ;METROPOLITANA;0;0;0;0;0;0;0;0;0;CELULAR A21s 128 GB Rojo;TELEFONIA
17719410;;M;31;CHILENO;;Millenial;PUQUELDON                     ;LOS LAGOS;0;0;0;0;0;0;0;0;0;CELULAR A02s AZUL 32GB OPEN;TELEFONIA
17690541;;F;31;CHILENO;;Silencioso;PROVIDENCIA                   ;METROPOLITANA;0;0;0;0;0;0;0;0;0;CELULAR NOKIA 110 BLACK OPEN;TELEFONIA
10595518;;F;56;CHILENO;;Boomers;N/D;N/D;0;0;0;0;0;0;0;0;0;CELULAR MOTO E6I ROSA OPEN;TELEFONIA
12143872;;F;56;CHILENO;;Boomers;PUENTE ALTO                   ;METROPOLITANA;0;0;0;0;0;0;0;0;0;CELULAR A21s 128 GB AZUL;TELEFONIA
10080032;;F;58;CHILENO;;Boomers;COLLIPULLI                    ;ARAUCANIA;0;0;0;0;0;0;0;0;0;CELULAR Xiaomi Redmi 9 64 GB Morado WOM;TELEFONIA
11366992;Casado;M;53;CHILENO;;X;RENCA                         ;METROPOLITANA;0;0;0;0;0;0;0;0;0;Celular A01 Core Azul Tri Entel;TELEFONIA
13183129;;F;46;CHILENO;;X;N/D;N/D;0;0;0;0;0;0;0;0;0;CELULAR REDMI NOTE 9 128G FOREST GREEN OPEN;TELEFONIA
16842439;;M;33;CHILENO;;Silencioso;N/D;N/D;0;0;0;0;0;0;0;0;0;CELULAR MI 11 EU 256G MIDNIGHT GRAY;TELEFONIA
18981566;Soltero;M;27;CHILENO;;Millenial;PROVIDENCIA                   ;METROPOLITANA;0;0;0;0;0;0;0;0;0;CELULAR Xiaomi Redmi 9 64 GB Morado WOM;TELEFONIA
12532991;Casado;F;48;CHILENO;;X;PROVIDENCIA                   ;METROPOLITANA;0;0;0;0;0;0;0;0;0;CELULAR A12 128GB NEGRO OPEN;TELEFONIA
11628271;;F;52;CHILENO;;X;BUIN                          ;METROPOLITANA;0;0;0;0;0;0;0;0;0;CELULAR POCO X3 PRO 256 GB FROST BLUE;TELEFONIA
15705643;Soltero;M;38;CHILENO;CIRUJANO DENTISTA;Millenial;CAUQUENES                     ;MAULE;0;0;0;0;0;0;0;0;0;Celular P40 LITE LIB OPEN BLACK;TELEFONIA
20275036;;F;37;CHILENO;;Millenial;N/D;N/D;0;0;0;0;0;0;0;0;0;CELULAR A21s 128 GB Negro;TELEFONIA
25580701;;F;46;COLOMBIANO;;Extranjero;SAN ANTONIO                   ;VALPARAISO;0;0;0;0;0;0;0;0;0;POCO X3 PRO 256 GB PHANTOM BLACK;TELEFONIA
16238749;Casado;F;36;CHILENO;;Millenial;RENCA                         ;METROPOLITANA;0;0;0;0;0;0;0;0;0;CELULAR GALAXY A01 32GB AZUL ENTEL;TELEFONIA
15454838;;F;40;CHILENO;;X;CARAHUE                       ;ARAUCANIA;0;0;0;0;0;0;0;0;0;Celular S20 FE LIB OPEN Cloud Lavender;TELEFONIA
7569536;;F;68;CHILENO;;Boomers;N/D;N/D;0;0;0;0;0;0;0;0;0;CELULAR MOTOROLA G9 PLAY 64GB SPRING PINK OPEN;TELEFONIA
13507320;;M;46;CHILENO;;X;SAN PEDRO DE LA PAZ           ;BIO BIO;0;0;0;0;0;0;0;0;0;CELULAR A32 128 GB LIGHT VIOLET OPEN;TELEFONIA
18693879;;F;28;CHILENO;;Millenial;SAN BERNARDO                  ;METROPOLITANA;0;0;0;0;0;0;0;0;0;CELULAR POCO M3 PRO 5G 128GB COOL BLUE;TELEFONIA
5750980;;M;76;CHILENO;;Silencioso;QUILLOTA                      ;VALPARAISO;0;0;0;0;0;0;0;0;0;CELULAR A21s 128 GB Rojo;TELEFONIA
19694570;;M;24;CHILENO;;Silencioso;PROVIDENCIA                   ;METROPOLITANA;0;0;0;0;0;0;0;0;0;CELULAR NOKIA 110 BLACK OPEN;TELEFONIA
14397368;;F;44;CHILENO;;X;SAN PEDRO DE ATACAMA          ;ANTOFAGASTA;0;0;0;0;0;0;0;0;0;CELULAR NOKIA 225 4G BLACK MOVISTAR DIRECTO;TELEFONIA
6469402;;M;70;CHILENO;;Silencioso;PROVIDENCIA                   ;METROPOLITANA;0;0;0;0;0;0;0;0;0;CELULAR A21s 128 GB AZUL;TELEFONIA
12158882;;M;52;CHILENO;;X;RENCA                         ;METROPOLITANA;0;0;0;0;0;0;0;0;0;CELULAR POCO F3 128 GB DEEP OCEAN BLUE;TELEFONIA
26112234;;M;31;DOMINICANO;;Extranjero;N/D;N/D;0;0;0;0;0;0;0;0;0;CELULAR A21s 128 GB Rojo;TELEFONIA
7496241;;M;68;CHILENO;;Boomers;LA CISTERNA                   ;METROPOLITANA;0;0;0;0;0;0;0;0;0;CELULAR MOTO ONE FUSION 64GB VERDE 64GB OPEN;TELEFONIA
11718922;;M;51;CHILENO;;X;QUELLON                       ;LOS LAGOS;0;0;0;0;0;0;0;0;0;Celular NOKIA 6.2 MOVISTAR DIRECTO NEGRO;TELEFONIA
18907224;;M;27;CHILENO;;Silencioso;PROVIDENCIA                   ;METROPOLITANA;0;0;0;0;0;0;0;0;0;CELULAR A12 128GB ROJO OPEN;TELEFONIA
12151812;;F;57;CHILENO;;Boomers;SAN JAVIER                    ;MAULE;0;0;0;0;0;0;0;0;0;CELULAR A12 128GB AZUL OPEN;TELEFONIA
19730752;;M;25;CHILENO;;Silencioso;PROVIDENCIA                   ;METROPOLITANA;0;0;0;0;0;0;0;0;0;CELULAR A21s 128 GB AZUL;TELEFONIA
17741576;;M;31;CHILENO;;Millenial;N/D;N/D;0;0;0;0;0;0;0;0;0;CELULAR MOTO G30 128GB GRIS TORNASOL OPEN;TELEFONIA
5535757;;F;77;CHILENO;;Silencioso;PROVIDENCIA                   ;METROPOLITANA;0;0;0;0;0;0;0;0;0;CELULAR REDMI NOTE 9 128G ONYX BLACK OPEN;TELEFONIA
15472989;;M;40;CHILENO;;Silencioso;PROVIDENCIA                   ;METROPOLITANA;0;0;0;0;0;0;0;0;0;CELULAR GALAXY S20FE 128GB ClOUD NAVY OPEN;TELEFONIA
16818162;;F;34;CHILENO;;Millenial;N/D;N/D;0;0;0;0;0;0;0;0;0;Celular a11 azul samsung WOM;TELEFONIA
8238802;;M;64;CHILENO;;Boomers;RENCA                         ;METROPOLITANA;0;0;0;0;0;0;0;0;0;CELULAR MOTO E6S 32GB GRIS DIRECTO ENTEL;TELEFONIA
15754635;;F;37;CHILENO;;Millenial;PROVIDENCIA                   ;METROPOLITANA;0;0;0;0;0;0;0;0;0;CELULAR A52 128 GB BLACK OPEN;TELEFONIA
16859848;;M;33;CHILENO;;Millenial;CURICO                        ;MAULE;0;0;0;0;0;0;0;0;0;CELULAR MOTO ONE FUSION 64GB VERDE 64GB OPEN;TELEFONIA
12387821;;M;53;CHILENO;;X;PROVIDENCIA                   ;METROPOLITANA;0;0;0;0;0;0;0;0;0;CELULAR ZTE A5 2020 DIRECTO CLARO VERDE;TELEFONIA
14288254;;M;48;CHILENO;;X;LINARES                       ;MAULE;0;0;0;0;0;0;0;0;0;Celular LG K22 ENTEL DIRECTO TITAN;TELEFONIA
17912785;;F;31;CHILENO;;Millenial;PROVIDENCIA                   ;METROPOLITANA;0;0;0;0;0;0;0;0;0;CELULAR A72 128 GB BLACK OPEN;TELEFONIA
17974617;Soltero;M;30;CHILENO;PSICOLOGO;Millenial;PROVIDENCIA                   ;METROPOLITANA;0;0;0;0;0;0;0;0;0;CELULAR MOTO ONE FUSION 128GB AZUL OPEN;TELEFONIA
19936295;Casado;F;27;CHILENO;;Silencioso;PROVIDENCIA                   ;METROPOLITANA;0;0;0;0;0;0;0;0;0;CELULAR MOTO ONE FUSION 64GB VERDE 64GB OPEN;TELEFONIA
20045723;;M;23;CHILENO;;Z;N/D;N/D;0;0;0;0;0;0;0;0;0;CELULAR MOTOROLA G9 PLAY 64GB SPRING PINK OPEN;TELEFONIA
9051775;;F;61;CHILENO;;Boomers;TOME                          ;BIO BIO;0;0;0;0;0;0;0;0;0;Celular A11 LIB OPEN WHITE;TELEFONIA
15483771;;M;40;CHILENO;;X;RENCA                         ;METROPOLITANA;0;0;0;0;0;0;0;0;0;Celular A11 LIB OPEN BLACK;TELEFONIA
16650778;Soltero;M;34;CHILENO;;Millenial;PROVIDENCIA                   ;METROPOLITANA;0;0;0;0;0;0;0;0;0;CELULAR GALAXY S20FE 128GB ClOUD NAVY OPEN;TELEFONIA
17353957;;F;34;CHILENO;;Millenial;VILLA ALEMANA                 ;VALPARAISO;0;0;0;0;0;0;0;0;0;Celular A01 CLARO DIRECTO BLACK;TELEFONIA
16424697;Casado;F;35;CHILENO;TERAPEUTA OCUPACIONAL;Silencioso;PROVIDENCIA                   ;METROPOLITANA;0;0;0;0;0;0;0;0;0;CELULAR A21s 128 GB AZUL;TELEFONIA
15536950;Soltero;F;39;CHILENO;DISENADOR DE VESTUARIO;X;RENCA                         ;METROPOLITANA;0;0;0;0;0;0;0;0;0;Celular A11 LIB OPEN WHITE;TELEFONIA
16827841;;F;34;CHILENO;;Millenial;PARRAL                        ;MAULE;0;0;0;0;0;0;0;0;0;CELULAR A12 128GB NEGRO TRIANGULADO CLARO;TELEFONIA
16061054;;F;37;CHILENO;;Millenial;PROVIDENCIA                   ;METROPOLITANA;0;0;0;0;0;0;0;0;0;CELULAR OWN 1026 AZUL ENTEL;TELEFONIA
17225877;;F;32;CHILENO;;Millenial;TALAGANTE                     ;METROPOLITANA;0;0;0;0;0;0;0;0;0;CELULAR REDMI NOTE 10 EU 128G Lake Green BUNDLE;TELEFONIA
6485280;Casado;M;65;CHILENO;INGENIERO;Boomers;RENCA                         ;METROPOLITANA;0;0;0;0;0;0;0;0;0;CELULAR A32 128 GB BLACK OPEN;TELEFONIA
9266145;;F;46;CHILENO;;X;PROVIDENCIA                   ;METROPOLITANA;0;0;0;0;0;0;0;0;0;CELULAR A21s 128 GB AZUL;TELEFONIA
7452797;;M;63;CHILENO;;Boomers;RENCA                         ;METROPOLITANA;0;0;0;0;0;0;0;0;0;CELULAR OWN 1026 AZUL ENTEL;TELEFONIA
19273785;Soltero;M;26;CHILENO;;Silencioso;PLACILLA                      ;L.G.B.OÂ´HIGGINS;0;0;0;0;0;0;0;0;0;CELULAR A02 ROJO 32GB OPEN;TELEFONIA
17828072;;F;30;CHILENO;;Millenial;PROVIDENCIA                   ;METROPOLITANA;0;0;0;0;0;0;0;0;0;Celular A11 LIB OPEN WHITE;TELEFONIA
18319037;;F;29;CHILENO;;Millenial;ANGOL                         ;ARAUCANIA;0;0;0;0;0;0;0;0;0;CELULAR MOTO G9 POWER 128GB MORADO SONICO OPEN;TELEFONIA
15541349;;F;38;CHILENO;;Silencioso;PROVIDENCIA                   ;METROPOLITANA;0;0;0;0;0;0;0;0;0;IPHONE 8 64 GB LIB OPEN GRAY;TELEFONIA
13277103;Soltero;M;45;CHILENO;AGRONOMO;Silencioso;PROVIDENCIA                   ;METROPOLITANA;0;0;0;0;0;0;0;0;0;CELULAR A21s 128 GB AZUL;TELEFONIA
18189872;;F;29;CHILENO;;Millenial;PROVIDENCIA                   ;METROPOLITANA;0;0;0;0;0;0;0;0;0;IPHONE 8 64 GB LIB OPEN GRAY;TELEFONIA
20159811;;F;22;CHILENO;;Z;PROVIDENCIA                   ;METROPOLITANA;0;0;0;0;0;0;0;0;0;Celular G8 POWER LITE WOM DIRECTO TURQUESA;TELEFONIA
16368077;Soltero;M;35;CHILENO;;Silencioso;PROVIDENCIA                   ;METROPOLITANA;0;0;0;0;0;0;0;0;0;Celular Galaxy S21 Phantom Grey 128GB;TELEFONIA
8563868;;M;63;CHILENO;;Boomers;CHILLAN                       ;BIO BIO;0;0;0;0;0;0;0;0;0;CELULAR MOTOROLA G9 PLAY 64GB ELECTRIC BLUE OPEN;TELEFONIA
8566485;;M;61;CHILENO;;Boomers;COIHAIQUE                     ;AYSEN;0;0;0;0;0;0;0;0;0;CELULAR NOKIA 225 4G BLACK MOVISTAR DIRECTO;TELEFONIA
16425475;;F;35;CHILENO;;Millenial;N/D;N/D;0;0;0;0;0;0;0;0;0;CELULAR A32 128 GB BLUE OPEN;TELEFONIA
5991038;;F;76;CHILENO;;Silencioso;COPIAPO                       ;ATACAMA;0;0;0;0;0;0;0;0;0;Celular SA3 CLARO DIRECTO BLACK;TELEFONIA
9921686;;F;57;CHILENO;;Boomers;PROVIDENCIA                   ;METROPOLITANA;0;0;0;0;0;0;0;0;0;Celular A11 LIB OPEN BLACK;TELEFONIA
13241012;;F;45;CHILENO;;X;PROVIDENCIA                   ;METROPOLITANA;0;0;0;0;0;0;0;0;0;CELULAR XIAOMI POCO X3 64G SHADOW GRAY;TELEFONIA
16953030;;F;33;CHILENO;;Millenial;N/D;N/D;0;0;0;0;0;0;0;0;0;CELULAR GALAXY S20FE 128GB ClOUD NAVY OPEN;TELEFONIA
7454162;Casado;F;66;CHILENO;;Boomers;PROVIDENCIA                   ;METROPOLITANA;0;0;0;0;0;0;0;0;0;CELULAR A02s NEGRO 32GB OPEN;TELEFONIA
12871699;;M;46;CHILENO;;X;RENCA                         ;METROPOLITANA;0;0;0;0;0;0;0;0;0;CELULAR REDMI NOTE 10 128GB ONIX GRAY OPEN;TELEFONIA
19937952;;F;24;CHILENO;;Z;N/D;N/D;0;0;0;0;0;0;0;0;0;Celular A11 LIB OPEN BLACK;TELEFONIA
16087026;Soltero;F;36;CHILENO;;Millenial;RENCA                         ;METROPOLITANA;0;0;0;0;0;0;0;0;0;Celular NOKIA 1.3 NEGRO WOM;TELEFONIA
19591892;;M;25;CHILENO;;Silencioso;PROVIDENCIA                   ;METROPOLITANA;0;0;0;0;0;0;0;0;0;CELULAR POCO M3 64GB POWER BLACK;TELEFONIA
17732779;;M;31;CHILENO;;Millenial;RECOLETA                      ;METROPOLITANA;0;0;0;0;0;0;0;0;0;CELULAR REDMI NOTE 10 128GB ONIX GRAY OPEN;TELEFONIA
12357935;;M;48;CHILENO;;X;RENCA                         ;METROPOLITANA;0;0;0;0;0;0;0;0;0;CELULAR A32 128 GB WHITE OPEN;TELEFONIA
7499746;;F;68;CHILENO;;Silencioso;N/D;N/D;0;0;0;0;0;0;0;0;0;CELULAR ALCATEL P1 3080 BLACK MOVISTAR DIRECTO;TELEFONIA
16570296;;F;35;CHILENO;;Silencioso;PROVIDENCIA                   ;METROPOLITANA;0;0;0;0;0;0;0;0;0;Celular P40 LITE LIB OPEN GREEN;TELEFONIA
9507623;;M;58;CHILENO;;Boomers;RENCA                         ;METROPOLITANA;0;0;0;0;0;0;0;0;0;CELULAR POCO M3 64GB COOL BLUE;TELEFONIA
18615152;Soltero;F;28;CHILENO;;Millenial;PROVIDENCIA                   ;METROPOLITANA;0;0;0;0;0;0;0;0;0;Celular A11 LIB OPEN BLUE;TELEFONIA
15114234;Soltero;M;39;CHILENO;;X;PROVIDENCIA                   ;METROPOLITANA;0;0;0;0;0;0;0;0;0;CELULAR MOTOROLA G9 PLAY 64GB SPRING PINK OPEN;TELEFONIA
17519467;;F;32;CHILENO;;Millenial;PROVIDENCIA                   ;METROPOLITANA;0;0;0;0;0;0;0;0;0;Celular A11 LIB OPEN BLUE;TELEFONIA
7233508;;M;67;CHILENO;;Boomers;VALDIVIA                      ;LOS LAGOS;0;0;0;0;0;0;0;0;0;CELULAR A32 128 GB BLACK OPEN;TELEFONIA
8084676;Casado;M;62;CHILENO;;Boomers;PROVIDENCIA                   ;METROPOLITANA;0;0;0;0;0;0;0;0;0;Celular A11 LIB OPEN BLUE;TELEFONIA
21107652;;F;24;CHILENO;;Extranjero;PROVIDENCIA                   ;METROPOLITANA;0;0;0;0;0;0;0;0;0;CELULAR A32 128 GB LIGHT VIOLET OPEN;TELEFONIA
8852292;;M;63;CHILENO;;Boomers;N/D;N/D;0;0;0;0;0;0;0;0;0;CELULAR A32 128 GB BLUE OPEN;TELEFONIA
18508901;;M;28;CHILENO;;Silencioso;PROVIDENCIA                   ;METROPOLITANA;0;0;0;0;0;0;0;0;0;CELULAR MOTOROLA MOTO G20 64GB ROSA FLAMINGO;TELEFONIA
11476497;;M;52;CHILENO;;X;SAN ANTONIO                   ;VALPARAISO;0;0;0;0;0;0;0;0;0;CELULAR A72 128 GB BLUE OPEN;TELEFONIA
19055896;Soltero;F;27;CHILENO;NUTRICIONISTA;Silencioso;PROVIDENCIA                   ;METROPOLITANA;0;0;0;0;0;0;0;0;0;CELULAR GALAXY S20FE 128GB ClOUD NAVY OPEN;TELEFONIA
18796086;;F;28;CHILENO;;Millenial;SAN BERNARDO                  ;METROPOLITANA;0;0;0;0;0;0;0;0;0;CELULAR GALAXY S20FE 128GB CLOUD LAVENDER OPEN;TELEFONIA
17675840;Soltero;M;31;CHILENO;INGENIERO CIVIL INDUSTRIAL;Silencioso;PROVIDENCIA                   ;METROPOLITANA;0;0;0;0;0;0;0;0;0;CELULAR REDMI 9 32GB CARBON GREY OPEN;TELEFONIA
16365401;;F;35;CHILENO;;Millenial;PROVIDENCIA                   ;METROPOLITANA;0;0;0;0;0;0;0;0;0;CELULAR GALAXY S20FE 128GB CLOUD LAVENDER OPEN;TELEFONIA
15115214;;M;39;CHILENO;;X;CHEPICA;O HIGGINS;0;0;0;0;0;0;0;0;0;CELULAR ALCATEL P1 3080 BLACK MOVISTAR DIRECTO;TELEFONIA
17587436;;M;32;CHILENO;;Millenial;N/D;N/D;0;0;0;0;0;0;0;0;0;CELULAR MOTOROLA G9 PLAY 64GB BLUE DIRECTO CLAR;TELEFONIA
15493733;;M;39;CHILENO;;X;CABRERO                       ;BIO BIO;0;0;0;0;0;0;0;0;0;CELULAR REDMI NOTE 9 128G FOREST GREEN OPEN;TELEFONIA
13392312;;F;44;CHILENO;;X;PROVIDENCIA                   ;METROPOLITANA;0;0;0;0;0;0;0;0;0;CELULAR MOTOROLA E6 PLAY AZUL TRI WOM;TELEFONIA
5970508;;F;73;CHILENO;;Silencioso;CONTULMO                      ;BIO BIO;0;0;0;0;0;0;0;0;0;CELULAR MOTOROLA E6S ROSADO DIRECTO WOM;TELEFONIA
13579724;;F;43;CHILENO;;X;RENCA                         ;METROPOLITANA;0;0;0;0;0;0;0;0;0;Celular LG K22 MOVISTAR DIRECTO TITAN;TELEFONIA
15689026;;F;38;CHILENO;;X;PROVIDENCIA                   ;METROPOLITANA;0;0;0;0;0;0;0;0;0;CELULAR A32 128 GB WHITE OPEN;TELEFONIA
15500405;Casado;F;39;CHILENO;;X;RENCA                         ;METROPOLITANA;0;0;0;0;0;0;0;0;0;CELULAR A21s 128 GB Negro;TELEFONIA
8178362;;M;65;CHILENO;;Boomers;LA ESTRELLA                   ;L.G.B.OÂ´HIGGINS;0;0;0;0;0;0;0;0;0;CELULAR NOKIA 110 BLACK OPEN;TELEFONIA
15626751;;M;37;CHILENO;;Millenial;N/D;N/D;0;0;0;0;0;0;0;0;0;Celular A01 Core Azul Tri Entel;TELEFONIA
19465457;;F;25;CHILENO;;Z;PROVIDENCIA                   ;METROPOLITANA;0;0;0;0;0;0;0;0;0;CELULAR MOTO G9 POWER 128GB MORADO SONICO OPEN;TELEFONIA
19205791;;M;26;CHILENO;;Z;OVALLE                        ;COQUIMBO;0;0;0;0;0;0;0;0;0;CELULAR GALAXY S20FE 128GB ClOUD NAVY OPEN;TELEFONIA
12815457;;F;49;CHILENO;;X;PROVIDENCIA                   ;METROPOLITANA;0;0;0;0;0;0;0;0;0;CELULAR A02s AZUL 32GB OPEN;TELEFONIA
16315343;;M;36;CHILENO;;Millenial;TEMUCO                        ;ARAUCANIA;0;0;0;0;0;0;0;0;0;CELULAR HUAWEI Y8S BLACK TRI CLARO;TELEFONIA
19330602;;M;26;CHILENO;;Z;ANGOL                         ;ARAUCANIA;0;0;0;0;0;0;0;0;0;CELULAR A21s 128 GB AZUL;TELEFONIA
16498534;;M;36;CHILENO;;Millenial;CANETE                        ;BIO BIO;0;0;0;0;0;0;0;0;0;CELULAR POCO M3 64GB POWER BLACK;TELEFONIA
16998451;Soltero;M;33;CHILENO;MEDICO CIRUJANO;Silencioso;PROVIDENCIA                   ;METROPOLITANA;0;0;0;0;0;0;0;0;0;CELULAR MOTO ONE FUSION 128GB AZUL OPEN;TELEFONIA
12431804;;M;49;CHILENO;;X;CORRAL                        ;LOS LAGOS;0;0;0;0;0;0;0;0;0;CELULAR MOTOROLA G9 PLAY 64GB BLUE DIRECTO CLAR;TELEFONIA
18671410;Soltero;M;28;CHILENO;;Millenial;PROVIDENCIA                   ;METROPOLITANA;0;0;0;0;0;0;0;0;0;Celular SAMSUNG A01 CORE BLACK CLARO;TELEFONIA
12190664;;F;50;CHILENO;;X;COLLIPULLI                    ;ARAUCANIA;0;0;0;0;0;0;0;0;0;Celular A01 LIB OPEN NEGRO;TELEFONIA
17256765;Soltero;F;32;CHILENO;;Millenial;RENCA                         ;METROPOLITANA;0;0;0;0;0;0;0;0;0;CELULAR MOTOROLA G9 PLAY 64GB BLUE DIRECTO CLAR;TELEFONIA
19062086;Soltero;F;27;CHILENO;;Z;PROVIDENCIA                   ;METROPOLITANA;0;0;0;0;0;0;0;0;0;CELULAR A21s 128 GB Rojo;TELEFONIA
7225516;Casado;F;69;CHILENO;;Silencioso;PROVIDENCIA                   ;METROPOLITANA;0;0;0;0;0;0;0;0;0;CELULAR OWN 1026 AZUL ENTEL;TELEFONIA
18203142;;F;30;CHILENO;;Millenial;MOSTAZAL;O HIGGINS;0;0;0;0;0;0;0;0;0;CELULAR A21s 128 GB Rojo;TELEFONIA
16012948;;M;36;CHILENO;;Millenial;PROVIDENCIA                   ;METROPOLITANA;0;0;0;0;0;0;0;0;0;CELULAR MOTO G9 POWER 128GB VERDE GRANITO OPEN;TELEFONIA
7457420;;F;65;CHILENO;;Boomers;CAUQUENES                     ;MAULE;0;0;0;0;0;0;0;0;0;CELULAR A21s 128 GB Rojo;TELEFONIA
19942876;;F;24;CHILENO;;Z;PROVIDENCIA                   ;METROPOLITANA;0;0;0;0;0;0;0;0;0;Celular SAMSUNG A01 CORE BLACK CLARO;TELEFONIA
18243303;;M;30;CHILENO;;Millenial;PROVIDENCIA                   ;METROPOLITANA;0;0;0;0;0;0;0;0;0;Celular A51 128GB LIB OPEN AZUL;TELEFONIA
7852222;;F;65;CHILENO;;Boomers;"";"";0;0;0;0;0;0;0;0;0;CELULAR A72 128 GB BLACK OPEN;TELEFONIA
11531341;;M;52;CHILENO;;X;VILLA ALEGRE                  ;MAULE;0;0;0;0;0;0;0;0;0;Celular A01 CLARO DIRECTO BLACK;TELEFONIA
10050487;;M;57;CHILENO;;Boomers;RENCA                         ;METROPOLITANA;0;0;0;0;0;0;0;0;0;CELULAR MOTO E6I 32GB GRIS OPEN;TELEFONIA
12101076;;M;53;CHILENO;;X;CABILDO                       ;VALPARAISO;0;0;0;0;0;0;0;0;0;CELULAR A12 128GB NEGRO OPEN;TELEFONIA
13116725;Soltero;F;51;CHILENO;;Silencioso;PROVIDENCIA                   ;METROPOLITANA;0;0;0;0;0;0;0;0;0;CELULAR MOTOROLA E6 PLAY AZUL TRI WOM;TELEFONIA
19172371;;M;27;CHILENO;;Z;VALPARAISO                    ;VALPARAISO;0;0;0;0;0;0;0;0;0;Celular A51 128GB LIB OPEN BLACK;TELEFONIA
10363000;;F;55;CHILENO;;Boomers;PARRAL                        ;MAULE;0;0;0;0;0;0;0;0;0;Celular G8 POWER LITE MOVISTAR DIRECTO AZUL;TELEFONIA
19024551;;F;27;CHILENO;;Z;N/D;N/D;0;0;0;0;0;0;0;0;0;Celular A51 128GB LIB OPEN AZUL;TELEFONIA
20137564;;M;22;CHILENO;;Z;PROVIDENCIA                   ;METROPOLITANA;0;0;0;0;0;0;0;0;0;IPHONE 8 64 GB LIB OPEN NEGRO;TELEFONIA
10952379;;F;55;CHILENO;;Boomers;VINA DEL MAR                  ;VALPARAISO;0;0;0;0;0;0;0;0;0;CELULAR A12 128GB NEGRO OPEN;TELEFONIA
12189227;;M;49;CHILENO;;X;PROVIDENCIA                   ;METROPOLITANA;0;0;0;0;0;0;0;0;0;Celular A11 LIB OPEN BLUE;TELEFONIA
19945189;;M;24;CHILENO;;Silencioso;PROVIDENCIA                   ;METROPOLITANA;0;0;0;0;0;0;0;0;0;Celular A31 LIB OPEN ROJO;TELEFONIA
10844264;;M;52;CHILENO;;X;MARIQUINA                     ;LOS LAGOS;0;0;0;0;0;0;0;0;0;CELULAR A12 128GB NEGRO OPEN;TELEFONIA
24809108;;F;25;NO INFORMA NACIONALIDAD;;Extranjero;POZO ALMONTE                  ;TARAPACA;0;0;0;0;0;0;0;0;0;CELULAR A02s ROJO 32GB OPEN;TELEFONIA
20146880;;F;23;CHILENO;;Silencioso;PROVIDENCIA                   ;METROPOLITANA;0;0;0;0;0;0;0;0;0;Celular A51 128GB LIB OPEN AZUL;TELEFONIA
14286579;;F;47;CHILENO;;X;MOLINA                        ;MAULE;0;0;0;0;0;0;0;0;0;Celular Galaxy S21 Phantom Violet 128GB;TELEFONIA
10405489;;M;57;CHILENO;;Boomers;MAIPU                         ;METROPOLITANA;0;0;0;0;0;0;0;0;0;Celular A10S MOVISTAR DIRECTO BLACK;TELEFONIA
9039449;Casado;M;62;CHILENO;;Silencioso;PROVIDENCIA                   ;METROPOLITANA;0;0;0;0;0;0;0;0;0;CELULAR A02s AZUL 32GB OPEN;TELEFONIA
18533883;Soltero;M;28;CHILENO;;Silencioso;PROVIDENCIA                   ;METROPOLITANA;0;0;0;0;0;0;0;0;0;CELULAR A32 128 GB BLACK OPEN;TELEFONIA
13060485;Soltero;M;46;CHILENO;TECNICO MECANICO;Silencioso;PROVIDENCIA                   ;METROPOLITANA;0;0;0;0;0;0;0;0;0;CELULAR REDMI NOTE 10 128GB ONIX GRAY OPEN;TELEFONIA
19315654;Soltero;F;26;CHILENO;;Z;PROVIDENCIA                   ;METROPOLITANA;0;0;0;0;0;0;0;0;0;CELULAR REDMI 9 32GB CARBON GREY OPEN;TELEFONIA
12974920;;M;45;CHILENO;;X;HUALPEN;BIO BIO;0;0;0;0;0;0;0;0;0;CELULAR MOTO ONE FUSION 64GB VERDE 64GB OPEN;TELEFONIA
16731812;;F;34;CHILENO;;Millenial;TALCA                         ;MAULE;0;0;0;0;0;0;0;0;0;Celular NOKIA 4.2 ENTEL DIRECTO NEGRO;TELEFONIA
18141424;;F;29;CHILENO;;Millenial;N/D;N/D;0;0;0;0;0;0;0;0;0;CELULAR A21s 128 GB Rojo;TELEFONIA
19093225;;F;27;CHILENO;;Z;ISLA DE MAIPO                 ;METROPOLITANA;0;0;0;0;0;0;0;0;0;Celular A51 128GB LIB OPEN AZUL;TELEFONIA
18224600;Soltero;M;29;CHILENO;;Millenial;PROVIDENCIA                   ;METROPOLITANA;0;0;0;0;0;0;0;0;0;CELULAR A02s ROJO 32GB OPEN;TELEFONIA
15913664;Soltero;F;38;CHILENO;;Millenial;PROVIDENCIA                   ;METROPOLITANA;0;0;0;0;0;0;0;0;0;CELULAR SAMSUNG A02S 32GB NEGRO DIRECTO ENTEL;TELEFONIA
19503207;;M;25;CHILENO;;Z;PROVIDENCIA                   ;METROPOLITANA;0;0;0;0;0;0;0;0;0;CELULAR A21s 128 GB AZUL;TELEFONIA
18182318;;F;29;CHILENO;;Millenial;LAUTARO                       ;ARAUCANIA;0;0;0;0;0;0;0;0;0;CELULAR A02 ROJO 32GB OPEN;TELEFONIA
7308892;;M;65;CHILENO;;Boomers;COIHAIQUE                     ;AYSEN;0;0;0;0;0;0;0;0;0;CELULAR MOTO G9 POWER 128GB MORADO SONICO OPEN;TELEFONIA
20152680;;F;23;CHILENO;;Z;PROVIDENCIA                   ;METROPOLITANA;0;0;0;0;0;0;0;0;0;CELULAR A02 AZUL 32GB OPEN;TELEFONIA
14134119;Soltero;F;41;CHILENO;ARQUITECTO;X;PROVIDENCIA                   ;METROPOLITANA;0;0;0;0;0;0;0;0;0;CELULAR Xiaomi Redmi 9 64 GB Morado WOM;TELEFONIA
13001896;;M;46;CHILENO;;X;PROVIDENCIA                   ;METROPOLITANA;0;0;0;0;0;0;0;0;0;CELULAR A12 128GB NEGRO OPEN;TELEFONIA
12348612;;F;48;CHILENO;;X;PROVIDENCIA                   ;METROPOLITANA;0;0;0;0;0;0;0;0;0;Celular A51 128GB LIB OPEN AZUL;TELEFONIA
18516739;Soltero;F;29;CHILENO;;Millenial;PROVIDENCIA                   ;METROPOLITANA;0;0;0;0;0;0;0;0;0;Celular SAMSUNG A01 CORE BLACK CLARO;TELEFONIA
16498530;;M;36;CHILENO;;Millenial;PROVIDENCIA                   ;METROPOLITANA;0;0;0;0;0;0;0;0;0;CELULAR A32 128 GB BLACK OPEN;TELEFONIA
18105183;Soltero;M;29;CHILENO;;Millenial;PROVIDENCIA                   ;METROPOLITANA;0;0;0;0;0;0;0;0;0;CELULAR REDMI 9 32GB CARBON GREY OPEN;TELEFONIA
16497249;;M;35;CHILENO;;Millenial;CHILLAN                       ;NUBLE;0;0;0;0;0;0;0;0;0;CELULAR A21s 128 GB AZUL;TELEFONIA
19272331;Soltero;M;26;CHILENO;TECNICO DE NIVEL MEDIO EN ALIMENTACION;Z;PROVIDENCIA                   ;METROPOLITANA;0;0;0;0;0;0;0;0;0;CELULAR A02 NEGRO 32GB OPEN;TELEFONIA
8376211;;F;64;CHILENO;;Boomers;OVALLE                        ;COQUIMBO;0;0;0;0;0;0;0;0;0;Celular XIAOMI REDMI 9C 64 GB DIRECTO CLARO;TELEFONIA
18202585;;M;29;CHILENO;;Millenial;CAUQUENES                     ;MAULE;0;0;0;0;0;0;0;0;0;Celular ZTE A3 2020 ENTEL DIRECTO GRIS;TELEFONIA
11939973;;F;50;CHILENO;;X;ANTOFAGASTA                   ;ANTOFAGASTA;0;0;0;0;0;0;0;0;0;CELULAR A72 128 GB BLACK OPEN;TELEFONIA
19883177;;M;24;CHILENO;;Silencioso;"";"";0;0;0;0;0;0;0;0;0;CELULAR A52 128 GB BLACK OPEN;TELEFONIA
9639618;;F;57;CHILENO;;Boomers;TEMUCO                        ;ARAUCANIA;0;0;0;0;0;0;0;0;0;CELULAR REDMI NOTE 10 EU 64GB ONIX GRAY OPEN;TELEFONIA
20358272;;F;22;CHILENO;;Silencioso;PROVIDENCIA                   ;METROPOLITANA;0;0;0;0;0;0;0;0;0;CELULAR REDMI NOTE 10 EU 64GB ONIX GRAY OPEN;TELEFONIA
11033051;Casado;F;57;CHILENO;;Boomers;SAN CARLOS                    ;BIO BIO;0;0;0;0;0;0;0;0;0;Celular A01 CLARO DIRECTO BLACK;TELEFONIA
6627313;Soltero;M;69;CHILENO;;Silencioso;CALBUCO                       ;LOS LAGOS;0;0;0;0;0;0;0;0;0;CELULAR A12 128GB NEGRO OPEN;TELEFONIA
11440885;Soltero;F;53;CHILENO;;Silencioso;LINARES                       ;MAULE;0;0;0;0;0;0;0;0;0;Celular LG K22 ENTEL DIRECTO TITAN;TELEFONIA
9179621;;M;59;CHILENO;;Boomers;SANTA MARIA                   ;VALPARAISO;0;0;0;0;0;0;0;0;0;CELULAR A02s ROJO 32GB OPEN;TELEFONIA
17718080;;F;31;CHILENO;;Millenial;PROVIDENCIA                   ;METROPOLITANA;0;0;0;0;0;0;0;0;0;CELULAR A21s 128 GB Rojo;TELEFONIA
9691382;Soltero;M;58;CHILENO;;Boomers;PROVIDENCIA                   ;METROPOLITANA;0;0;0;0;0;0;0;0;0;CELULAR OWN 1026 AZUL ENTEL;TELEFONIA
17084156;Soltero;F;33;CHILENO;NUTRICIONISTA;Silencioso;PROVIDENCIA                   ;METROPOLITANA;0;0;0;0;0;0;0;0;0;Celular Galaxy S21 Phantom White 128GB;TELEFONIA
8846114;;M;55;CHILENO;;Boomers;PROVIDENCIA                   ;METROPOLITANA;0;0;0;0;0;0;0;0;0;Celular A51 128GB LIB OPEN BLACK;TELEFONIA
15450938;;F;40;CHILENO;;X;PEDRO AGUIRRE CERDA           ;METROPOLITANA;0;0;0;0;0;0;0;0;0;CELULAR A32 128 GB LIGHT VIOLET OPEN;TELEFONIA
13596148;;F;42;CHILENO;;X;PAINE                         ;METROPOLITANA;0;0;0;0;0;0;0;0;0;CELULAR A12 128GB ROJO OPEN;TELEFONIA
20332450;;M;22;CHILENO;;Silencioso;PROVIDENCIA                   ;METROPOLITANA;0;0;0;0;0;0;0;0;0;Celular A51 128GB LIB OPEN AZUL;TELEFONIA
20267828;;F;22;CHILENO;;Z;CHILLAN;BIO-BIO;0;0;0;0;0;0;0;0;0;CELULAR REDMI NOTE 10 128GB ONIX GRAY OPEN;TELEFONIA
7123909;Divorciado;M;72;CHILENO;;Silencioso;RANCAGUA                      ;L.G.B.OÂ´HIGGINS;0;0;0;0;0;0;0;0;0;CELULAR A32 128 GB BLACK OPEN;TELEFONIA
14159383;;F;41;CHILENO;;Silencioso;PROVIDENCIA                   ;METROPOLITANA;0;0;0;0;0;0;0;0;0;Celular A51 128GB LIB OPEN AZUL;TELEFONIA
12419928;Soltero;M;48;CHILENO;;X;RENCA                         ;METROPOLITANA;0;0;0;0;0;0;0;0;0;Celular A11 LIB OPEN BLACK;TELEFONIA
19683092;;F;25;CHILENO;;Z;N/D;N/D;0;0;0;0;0;0;0;0;0;IPHONE 11 64 GB ROJO ENTEL;TELEFONIA
8681232;;F;61;CHILENO;;Boomers;COIHAIQUE                     ;AYSEN;0;0;0;0;0;0;0;0;0;CELULAR A02s AZUL 32GB OPEN;TELEFONIA
9284958;;F;61;CHILENO;;Boomers;PROVIDENCIA                   ;METROPOLITANA;0;0;0;0;0;0;0;0;0;CELULAR REDMI 9 32GB CARBON GREY OPEN;TELEFONIA
12065966;;F;54;CHILENO;;X;SAN BERNARDO                  ;METROPOLITANA;0;0;0;0;0;0;0;0;0;CELULAR A12 128GB NEGRO OPEN;TELEFONIA
20099626;;F;23;CHILENO;;Z;"";"";0;0;0;0;0;0;0;0;0;CELULAR NOTE 20 ULTRA MYSTIC BRONZE 256 GB OPE;TELEFONIA
11769006;;F;51;CHILENO;;X;PARRAL                        ;MAULE;0;0;0;0;0;0;0;0;0;Celular G8 POWER LITE MOVISTAR DIRECTO AZUL;TELEFONIA
18519415;Soltero;M;28;CHILENO;;Silencioso;PROVIDENCIA                   ;METROPOLITANA;0;0;0;0;0;0;0;0;0;CELULAR REDMI NOTE 9 DIRECTO CLARO BLUE;TELEFONIA
15090026;Soltero;M;39;CHILENO;TECNICO EN CONSTRUCCION;X;PROVIDENCIA                   ;METROPOLITANA;0;0;0;0;0;0;0;0;0;CELULAR NOTE 20 ULTRA MYSTIC BLACK 256GB OPEN;TELEFONIA
11944806;;M;49;CHILENO;;X;LOS ANDES                     ;VALPARAISO;0;0;0;0;0;0;0;0;0;CELULAR LG K61 Gris OPEN;TELEFONIA
14498493;;F;48;CHILENO;;X;SAN PEDRO                     ;METROPOLITANA;0;0;0;0;0;0;0;0;0;CELULAR MOTO G9 POWER 128GB MORADO SONICO OPEN;TELEFONIA
15046150;;F;39;CHILENO;;X;ILLAPEL                       ;COQUIMBO;0;0;0;0;0;0;0;0;0;Celular A11 LIB OPEN BLACK;TELEFONIA
11143387;;M;54;CHILENO;;Boomers;PROVIDENCIA                   ;METROPOLITANA;0;0;0;0;0;0;0;0;0;CELULAR REDMI NOTE 10 EU 64GB ONIX GRAY OPEN;TELEFONIA
14327490;;F;45;CHILENO;;X;LAS CABRAS                    ;L.G.B.OÂ´HIGGINS;0;0;0;0;0;0;0;0;0;CELULAR MOTO G9 POWER 128GB MORADO SONICO OPEN;TELEFONIA
9172026;;F;55;CHILENO;;Boomers;RENCA                         ;METROPOLITANA;0;0;0;0;0;0;0;0;0;CELULAR NOKIA 110 BLACK OPEN;TELEFONIA
12665145;;F;48;CHILENO;;X;PROVIDENCIA                   ;METROPOLITANA;0;0;0;0;0;0;0;0;0;CELULAR MOTOROLA E6 PLAY AZUL TRI WOM;TELEFONIA
18571562;Soltero;M;29;CHILENO;;Silencioso;PROVIDENCIA                   ;METROPOLITANA;0;0;0;0;0;0;0;0;0;CELULAR POCO X3 PRO 128G PHANTOM BLACK OPEN;TELEFONIA
13220583;;F;44;CHILENO;;X;PROVIDENCIA                   ;METROPOLITANA;0;0;0;0;0;0;0;0;0;CELULAR MOTOROLA E6S GRIS 32GB DIRECTO WOM;TELEFONIA
17225540;;M;32;CHILENO;;Millenial;PENAFLOR                      ;METROPOLITANA;0;0;0;0;0;0;0;0;0;CELULAR A12 128GB NEGRO OPEN;TELEFONIA
19054521;Soltero;M;27;CHILENO;;Silencioso;PROVIDENCIA                   ;METROPOLITANA;0;0;0;0;0;0;0;0;0;CELULAR REDMI NOTE 10 EU 64GB ONIX GRAY OPEN;TELEFONIA
12375007;Casado;F;49;CHILENO;;X;PROVIDENCIA                   ;METROPOLITANA;0;0;0;0;0;0;0;0;0;CELULAR A21s 128 GB AZUL;TELEFONIA
7880886;;M;66;CHILENO;;Boomers;MAULE                         ;MAULE;0;0;0;0;0;0;0;0;0;CELULAR A32 128 GB BLACK OPEN;TELEFONIA
6409401;Soltero;M;73;CHILENO;;Silencioso;PROVIDENCIA                   ;METROPOLITANA;0;0;0;0;0;0;0;0;0;Celular SA3 CLARO DIRECTO BLACK;TELEFONIA
11187146;;M;54;CHILENO;;Boomers;PROVIDENCIA                   ;METROPOLITANA;0;0;0;0;0;0;0;0;0;CELULAR A02 ROJO 32GB OPEN;TELEFONIA
7809086;;F;65;CHILENO;;Boomers;PROVIDENCIA                   ;METROPOLITANA;0;0;0;0;0;0;0;0;0;Celular G8 POWER LITE WOM DIRECTO TURQUESA;TELEFONIA
10759357;;M;54;CHILENO;;Boomers;PUNITAQUI                     ;COQUIMBO;0;0;0;0;0;0;0;0;0;CELULAR SAMSUNG A01 NEGRO DIRECTO WOM;TELEFONIA
20274748;;F;22;CHILENO;;Silencioso;PROVIDENCIA                   ;METROPOLITANA;0;0;0;0;0;0;0;0;0;CELULAR XIAOMI POCO M3 128GB YELLOW OPEN;TELEFONIA
19014007;Soltero;F;26;CHILENO;TECNICO DE NIVEL SUPERIOR EN ENFERMERIA;Z;PROVIDENCIA                   ;METROPOLITANA;0;0;0;0;0;0;0;0;0;IPHONE 8 64 GB LIB OPEN DORADO;TELEFONIA
15294384;;F;40;CHILENO;;X;PROVIDENCIA                   ;METROPOLITANA;0;0;0;0;0;0;0;0;0;CELULAR NOKIA 110 BLACK OPEN;TELEFONIA
17153588;Soltero;F;33;CHILENO;;Millenial;RENCA                         ;METROPOLITANA;0;0;0;0;0;0;0;0;0;Celular A11 LIB OPEN WHITE;TELEFONIA
16848313;;F;34;CHILENO;;Millenial;OVALLE                        ;COQUIMBO;0;0;0;0;0;0;0;0;0;CELULAR A21s 128 GB Negro;TELEFONIA
17477559;Soltero;M;32;CHILENO;PUBLICISTA;Millenial;PROVIDENCIA                   ;METROPOLITANA;0;0;0;0;0;0;0;0;0;CELULAR GALAXY S20FE 128GB CLOUD GREEN OPEN;TELEFONIA
17310852;Soltero;F;32;CHILENO;NUTRICION Y DIETETICA;Silencioso;PROVIDENCIA                   ;METROPOLITANA;0;0;0;0;0;0;0;0;0;CELULAR NOKIA 110 BLACK OPEN;TELEFONIA
14176754;;M;41;CHILENO;;Silencioso;PROVIDENCIA                   ;METROPOLITANA;0;0;0;0;0;0;0;0;0;CELULAR A52 128 GB BLACK OPEN;TELEFONIA
10294668;;F;46;CHILENO;;X;PROVIDENCIA                   ;METROPOLITANA;0;0;0;0;0;0;0;0;0;CELULAR MOTOROLA G9 PLAY 64GB ELECTRIC BLUE OPEN;TELEFONIA
20000377;;M;24;CHILENO;;Z;PROVIDENCIA                   ;METROPOLITANA;0;0;0;0;0;0;0;0;0;CELULAR A52 128 GB BLACK OPEN;TELEFONIA
17599207;Soltero;F;31;CHILENO;FONOAUDIOLOGO;Silencioso;PROVIDENCIA                   ;METROPOLITANA;0;0;0;0;0;0;0;0;0;Celular A51 128GB LIB OPEN AZUL;TELEFONIA
16187292;Soltero;F;36;CHILENO;;Silencioso;PROVIDENCIA                   ;METROPOLITANA;0;0;0;0;0;0;0;0;0;Celular A11 LIB OPEN BLUE;TELEFONIA
16046799;;F;36;CHILENO;;Millenial;N/D;N/D;0;0;0;0;0;0;0;0;0;CELULAR A02 ROJO 32GB OPEN;TELEFONIA
17805828;;F;31;CHILENO;;Millenial;PROVIDENCIA                   ;METROPOLITANA;0;0;0;0;0;0;0;0;0;CELULAR REDMI NOTE 9 PRO 128GB GLACIER WHITE;TELEFONIA
18047688;;F;30;CHILENO;;Millenial;PROVIDENCIA                   ;METROPOLITANA;0;0;0;0;0;0;0;0;0;CELULAR A02 ROJO 32GB OPEN;TELEFONIA
10311425;;M;56;CHILENO;;Boomers;PUERTO MONTT                  ;LOS LAGOS;0;0;0;0;0;0;0;0;0;CELULAR XIAOMI POCO X3 64G SHADOW GRAY;TELEFONIA
4387914;;F;81;CHILENO;;Silencioso;NATALES                       ;MAGALLANES;0;0;0;0;0;0;0;0;0;Celular LG K22 MOVISTAR DIRECTO TITAN;TELEFONIA
12907681;;M;46;CHILENO;;X;RENCA                         ;METROPOLITANA;0;0;0;0;0;0;0;0;0;CELULAR NOTE 20 ULTRA MYSTIC BRONZE 256 GB OPE;TELEFONIA
11719734;Casado;F;51;CHILENO;PROFESOR;X;RENCA                         ;METROPOLITANA;0;0;0;0;0;0;0;0;0;Celular A10S MOVISTAR DIRECTO BLACK;TELEFONIA
19317564;;F;26;CHILENO;;Millenial;N/D;N/D;0;0;0;0;0;0;0;0;0;CELULAR OWN 1026 AZUL ENTEL;TELEFONIA
15094897;Casado;M;40;CHILENO;;Silencioso;PROVIDENCIA                   ;METROPOLITANA;0;0;0;0;0;0;0;0;0;IPHONE 8 256GB DORADO OPEN;TELEFONIA
18266062;;M;29;CHILENO;;Millenial;PROVIDENCIA                   ;METROPOLITANA;0;0;0;0;0;0;0;0;0;CELULAR A12 128GB AZUL OPEN;TELEFONIA
15342846;;M;38;CHILENO;;X;"";"";0;0;0;0;0;0;0;0;0;CELULAR REDMI NOTE 9 128 GB MIDNIGHT GREY OPEN;TELEFONIA
18151084;;M;30;CHILENO;;Millenial;HUECHURABA;METROPOLITANA;0;0;0;0;0;0;0;0;0;CELULAR MOTO E6I ROSA OPEN;TELEFONIA
6711656;Casado;M;68;CHILENO;;Silencioso;PROVIDENCIA                   ;METROPOLITANA;0;0;0;0;0;0;0;0;0;CELULAR A02s NEGRO 32GB OPEN;TELEFONIA
12931017;;M;46;CHILENO;;X;PROVIDENCIA                   ;METROPOLITANA;0;0;0;0;0;0;0;0;0;CELULAR NOKIA 110 BLACK OPEN;TELEFONIA
22604662;;F;48;CHILENO;;Extranjero;PROVIDENCIA                   ;METROPOLITANA;0;0;0;0;0;0;0;0;0;CELULAR A02s ROJO 32GB OPEN;TELEFONIA
11930816;;M;50;CHILENO;;X;RENCA                         ;METROPOLITANA;0;0;0;0;0;0;0;0;0;Celular A11 LIB OPEN BLACK;TELEFONIA
16649936;;M;35;CHILENO;;Millenial;SANTIAGO                      ;METROPOLITANA;0;0;0;0;0;0;0;0;0;Celular A71 LIB OPEN NEGRO;TELEFONIA
3933940;;M;85;CHILENO;;Silencioso;PROVIDENCIA                   ;METROPOLITANA;0;0;0;0;0;0;0;0;0;CELULAR MOTO G8 POWER LITE TURQUESA TRI ENTEL;TELEFONIA
17225950;Casado;F;40;CHILENO;INGENIERO EN CONTROL DE GESTION;X;PROVIDENCIA                   ;METROPOLITANA;0;0;0;0;0;0;0;0;0;CELULAR A21s 128 GB Rojo;TELEFONIA
16473140;;F;35;CHILENO;;Millenial;PROVIDENCIA                   ;METROPOLITANA;0;0;0;0;0;0;0;0;0;Celular SA3 CLARO DIRECTO BLACK;TELEFONIA
16439994;Casado;F;35;CHILENO;KINESIOLOGO;Millenial;ANGOL                         ;ARAUCANIA;0;0;0;0;0;0;0;0;0;CELULAR MOTO G9 POWER 128GB VERDE GRANITO OPEN;TELEFONIA
15815371;;F;38;CHILENO;;Millenial;PADRE LAS CASAS;ARAUCANIA;0;0;0;0;0;0;0;0;0;Celular AL3 CLARO DIRECTO NEGRO;TELEFONIA
5363407;;M;72;CHILENO;;Silencioso;RENCA                         ;METROPOLITANA;0;0;0;0;0;0;0;0;0;Celular K40S WOM DIRECTO NEGRO;TELEFONIA
8090926;;M;60;CHILENO;;Boomers;RENCA                         ;METROPOLITANA;0;0;0;0;0;0;0;0;0;CELULAR REDMI NOTE 9 PRO 128GB TROPICAL GREEN;TELEFONIA
9991010;;M;57;CHILENO;;Silencioso;PROVIDENCIA                   ;METROPOLITANA;0;0;0;0;0;0;0;0;0;IPHONE 8 64 GB LIB OPEN PLATEADO;TELEFONIA
11997821;;M;50;CHILENO;;X;LOS ANGELES                   ;BIO BIO;0;0;0;0;0;0;0;0;0;Celular A11 LIB OPEN BLUE;TELEFONIA
6823794;;M;66;CHILENO;;Boomers;CONTULMO                      ;BIO BIO;0;0;0;0;0;0;0;0;0;Celular A20S WOM TRIANGULADO AZUL;TELEFONIA
16747672;Soltero;F;34;CHILENO;ENFERMERA;Millenial;PROVIDENCIA                   ;METROPOLITANA;0;0;0;0;0;0;0;0;0;CELULAR A21s 128 GB Rojo;TELEFONIA
14674948;;F;52;PERUANO;;X;PROVIDENCIA                   ;METROPOLITANA;0;0;0;0;0;0;0;0;0;CELULAR REDMI 9 64GB CARBON GREY;TELEFONIA
18973001;;F;27;CHILENO;;Millenial;PROVIDENCIA                   ;METROPOLITANA;0;0;0;0;0;0;0;0;0;Celular 2.3 MOVISTAR DIRECTO CHARCOAL;TELEFONIA
26844855;;M;21;EXTRANJERO - NO INFORMA NACIONALIDAD ;;Extranjero;COPIAPO                       ;ATACAMA;0;0;0;0;0;0;0;0;0;Celular A71 LIB OPEN NEGRO;TELEFONIA
9691865;;M;59;CHILENO;;Boomers;QUEILEN                       ;LOS LAGOS;0;0;0;0;0;0;0;0;0;CELULAR A12 128GB NEGRO OPEN;TELEFONIA
19258825;;F;26;CHILENO;;Z;PROVIDENCIA                   ;METROPOLITANA;0;0;0;0;0;0;0;0;0;CELULAR REDMI 9 32GB CARBON GREY OPEN;TELEFONIA
14277518;Soltero;M;49;CHILENO;;X;PROVIDENCIA                   ;METROPOLITANA;0;0;0;0;0;0;0;0;0;Celular SAMSUNG A01 CORE BLACK CLARO;TELEFONIA
11414427;Soltero;M;53;CHILENO;;X;PROVIDENCIA                   ;METROPOLITANA;0;0;0;0;0;0;0;0;0;CELULAR OWN 1026 AZUL ENTEL;TELEFONIA
11623209;Soltero;F;52;CHILENO;;X;RENCA                         ;METROPOLITANA;0;0;0;0;0;0;0;0;0;Celular A10S MOVISTAR DIRECTO BLACK;TELEFONIA
4421960;;M;81;CHILENO;;Silencioso;CAUQUENES                     ;MAULE;0;0;0;0;0;0;0;0;0;Celular SAMSUNG A01 CORE BLACK CLARO;TELEFONIA
8528573;Casado;F;59;CHILENO;;Boomers;RENCA                         ;METROPOLITANA;0;0;0;0;0;0;0;0;0;Celular A51 128GB LIB OPEN AZUL;TELEFONIA
8734726;;M;62;CHILENO;;Boomers;CANETE                        ;BIO BIO;0;0;0;0;0;0;0;0;0;CELULAR MOTO G9 POWER 128GB MORADO SONICO OPEN;TELEFONIA
10217681;;F;57;CHILENO;;Boomers;RENCA                         ;METROPOLITANA;0;0;0;0;0;0;0;0;0;CELULAR A21s 128 GB AZUL;TELEFONIA
12438479;;M;49;CHILENO;;X;PROVIDENCIA                   ;METROPOLITANA;0;0;0;0;0;0;0;0;0;CELULAR A02s AZUL 32GB OPEN;TELEFONIA
9013964;Soltero;M;61;CHILENO;PROFESOR;Boomers;PROVIDENCIA                   ;METROPOLITANA;0;0;0;0;0;0;0;0;0;CELULAR Samsung Galaxy A02s 32GB Azul WOM;TELEFONIA
15867466;;M;37;CHILENO;;Millenial;ALHUE                         ;METROPOLITANA;0;0;0;0;0;0;0;0;0;Celular LG K22 ENTEL DIRECTO TITAN;TELEFONIA
6930528;Casado;F;67;CHILENO;;Silencioso;PROVIDENCIA                   ;METROPOLITANA;0;0;0;0;0;0;0;0;0;Celular SA3 CLARO DIRECTO BLACK;TELEFONIA
11347987;;F;53;CHILENO;;Silencioso;PROVIDENCIA                   ;METROPOLITANA;0;0;0;0;0;0;0;0;0;CELULAR XIAOMI MI 10T 128GB LUNAR SILVER OPEN;TELEFONIA
14013285;;F;41;CHILENO;;X;RENCA                         ;METROPOLITANA;0;0;0;0;0;0;0;0;0;Celular A51 128GB LIB OPEN BLACK;TELEFONIA
17972993;;M;30;CHILENO;;Millenial;N/D;N/D;0;0;0;0;0;0;0;0;0;CELULAR REDMI NOTE 9 PRO 128GB GLACIER WHITE;TELEFONIA
17050468;;F;33;CHILENO;;Millenial;LA GRANJA                     ;METROPOLITANA;0;0;0;0;0;0;0;0;0;Celular HUAWEI Y9 PRIME DIRECTO CLARO BLUE;TELEFONIA
15281627;;F;38;CHILENO;;Millenial;PUERTO MONTT                  ;LOS LAGOS;0;0;0;0;0;0;0;0;0;CELULAR VIVO Y20 NEGRO DIRECTO ENTEL;TELEFONIA
19296560;Soltero;F;26;CHILENO;;Silencioso;PROVIDENCIA                   ;METROPOLITANA;0;0;0;0;0;0;0;0;0;CELULAR REDMI NOTE 9 PRO 128GB INTERSTELLAR GREY;TELEFONIA
13123427;;F;46;CHILENO;;X;PUERTO MONTT                  ;LOS LAGOS;0;0;0;0;0;0;0;0;0;CELULAR MOTO G9 POWER 128GB MORADO SONICO OPEN;TELEFONIA
19049068;;M;26;CHILENO;;Z;QUILLOTA                      ;VALPARAISO;0;0;0;0;0;0;0;0;0;CELULAR NOKIA 110 BLACK OPEN;TELEFONIA
18362786;;M;29;CHILENO;;Millenial;PROVIDENCIA                   ;METROPOLITANA;0;0;0;0;0;0;0;0;0;CELULAR XIAOMI REDMI 9 64GB DIRECTO CLARO MORADO;TELEFONIA
9366279;Casado;M;59;CHILENO;;Boomers;PROVIDENCIA                   ;METROPOLITANA;0;0;0;0;0;0;0;0;0;Celular SAMSUNG A01 CORE BLACK CLARO;TELEFONIA
18946478;;F;27;CHILENO;;Millenial;PROVIDENCIA                   ;METROPOLITANA;0;0;0;0;0;0;0;0;0;CELULAR SAMSUNG A71 AZUL OPEN;TELEFONIA
14310619;;F;46;CHILENO;;X;PROVIDENCIA                   ;METROPOLITANA;0;0;0;0;0;0;0;0;0;Celular A51 128GB LIB OPEN AZUL;TELEFONIA
17715667;;M;31;CHILENO;;Millenial;CHEPICA                       ;L.G.B.OÂ´HIGGINS;0;0;0;0;0;0;0;0;0;CELULAR OWN 1026 AZUL ENTEL;TELEFONIA
16704073;;F;35;CHILENO;;Millenial;RENCA                         ;METROPOLITANA;0;0;0;0;0;0;0;0;0;CELULAR LG VELVET BLANCO OPEN;TELEFONIA
17618836;;M;30;CHILENO;;Millenial;COPIAPO                       ;ATACAMA;0;0;0;0;0;0;0;0;0;CELULAR SAMSUNG A71 AZUL OPEN;TELEFONIA
10162613;;F;56;CHILENO;;Boomers;MAIPU                         ;METROPOLITANA;0;0;0;0;0;0;0;0;0;Celular SA3 CLARO DIRECTO BLACK;TELEFONIA
6960054;;M;66;CHILENO;;Boomers;N/D;N/D;0;0;0;0;0;0;0;0;0;Celular A01 LIB OPEN AZUL;TELEFONIA
17369924;;F;32;CHILENO;;Millenial;ARICA                         ;ARICA Y PARINACOTA;0;0;0;0;0;0;0;0;0;Celular A51 128GB LIB OPEN BLACK;TELEFONIA
5949073;;M;74;CHILENO;;Silencioso;RENCA                         ;METROPOLITANA;0;0;0;0;0;0;0;0;0;CELULAR NOKIA 5.3 CHARCOAL TRI ENTEL;TELEFONIA
9117858;;M;61;CHILENO;;Boomers;MELIPILLA                     ;METROPOLITANA;0;0;0;0;0;0;0;0;0;CELULAR NOKIA 5.3 CHARCOAL TRI ENTEL;TELEFONIA
19623406;;M;25;CHILENO;;Z;PANGUIPULLI                   ;LOS LAGOS;0;0;0;0;0;0;0;0;0;CELULAR A12 128GB ROJO OPEN;TELEFONIA
12600340;Casado;M;47;CHILENO;;X;PROVIDENCIA                   ;METROPOLITANA;0;0;0;0;0;0;0;0;0;CELULAR SAMSUNG A02S 32GB NEGRO DIRECTO ENTEL;TELEFONIA
4287724;;M;84;CHILENO;;Silencioso;PROVIDENCIA                   ;METROPOLITANA;0;0;0;0;0;0;0;0;0;CELULAR OWN 1026 AZUL ENTEL;TELEFONIA
18321570;;F;29;CHILENO;;Millenial;CALBUCO                       ;LOS LAGOS;0;0;0;0;0;0;0;0;0;CELULAR A21s 128 GB Negro;TELEFONIA
15602525;;F;39;CHILENO;;X;CONCHALI                      ;METROPOLITANA;0;0;0;0;0;0;0;0;0;Celular A20S ENTEL TRIANGULADO NEGRO;TELEFONIA
19118538;;F;27;CHILENO;;Z;PEDRO AGUIRRE CERDA           ;METROPOLITANA;0;0;0;0;0;0;0;0;0;CELULAR A21s 128 GB Negro;TELEFONIA
18882663;;F;27;CHILENO;;Millenial;LA PINTANA                    ;METROPOLITANA;0;0;0;0;0;0;0;0;0;CELULAR LG K61 Gris OPEN;TELEFONIA
15796970;;F;38;CHILENO;;Millenial;N/D;N/D;0;0;0;0;0;0;0;0;0;Celular SAMSUNG A51 128GB BLACK CLARO;TELEFONIA
11243503;;M;53;CHILENO;;X;RENCA                         ;METROPOLITANA;0;0;0;0;0;0;0;0;0;Celular A01 Core Azul Tri Entel;TELEFONIA
4808823;;M;79;CHILENO;;Silencioso;LA LIGUA                      ;VALPARAISO;0;0;0;0;0;0;0;0;0;CELULAR MOTOROLA E6S ROSADO DIRECTO WOM;TELEFONIA
17339792;;M;32;CHILENO;;Silencioso;PROVIDENCIA                   ;METROPOLITANA;0;0;0;0;0;0;0;0;0;Celular A71 LIB OPEN NEGRO;TELEFONIA
11748539;;F;51;CHILENO;;X;OVALLE                        ;COQUIMBO;0;0;0;0;0;0;0;0;0;CELULAR XIAOMI REDMI 9C AZUL DIRECTO ENTEL;TELEFONIA
13578584;Casado;F;43;CHILENO;TECNICO UNIVERSITARIO EN ENFERMERIA;X;CURANILAHUE                   ;BIO BIO;0;0;0;0;0;0;0;0;0;CELULAR SAMSUNG A21S ROJO OPEN;TELEFONIA
10053670;;M;58;CHILENO;;Boomers;CALAMA                        ;ANTOFAGASTA;0;0;0;0;0;0;0;0;0;CHIP RECARGA CLARO;TELEFONIA
7721778;Casado;M;66;CHILENO;;Boomers;RENCA                         ;METROPOLITANA;0;0;0;0;0;0;0;0;0;CELULAR NOKIA 110 BLACK OPEN;TELEFONIA
9738793;;M;58;CHILENO;;Boomers;CASTRO                        ;LOS LAGOS;0;0;0;0;0;0;0;0;0;Celular S20 FE LIB OPEN Cloud Navy;TELEFONIA
20117044;;F;23;CHILENO;;Z;N/D;N/D;0;0;0;0;0;0;0;0;0;CELULAR A02 ROJO 32GB OPEN;TELEFONIA
19928536;;F;23;CHILENO;;Silencioso;IQUIQUE                       ;TARAPACA;0;0;0;0;0;0;0;0;0;Celular S20 FE LIB OPEN Cloud Lavender;TELEFONIA
13833492;;F;42;CHILENO;;X;RENCA                         ;METROPOLITANA;0;0;0;0;0;0;0;0;0;Celular R340 CLARO DIRECTO NEGRO;TELEFONIA
16027106;;F;37;CHILENO;;Millenial;SAN ESTEBAN                   ;VALPARAISO;0;0;0;0;0;0;0;0;0;CELULAR A21s 128 GB AZUL;TELEFONIA
7309462;;F;74;CHILENO;;Silencioso;SAN PABLO                     ;LOS LAGOS;0;0;0;0;0;0;0;0;0;Celular SAMSUNG A01 CORE AZUL ENTEL;TELEFONIA
11833867;Casado;M;50;CHILENO;AUTOMATIZACION Y CONTROL INDUSTRIAL;X;PROVIDENCIA                   ;METROPOLITANA;0;0;0;0;0;0;0;0;0;CELULAR MOTO G8 POWER LITE TURQUESA TRI ENTEL;TELEFONIA
27121479;;F;29;VENEZOLANO;;Extranjero;N/D;N/D;0;0;0;0;0;0;0;0;0;Celular A51 128GB LIB OPEN BLACK;TELEFONIA
17354274;;F;32;CHILENO;;Millenial;PROVIDENCIA                   ;METROPOLITANA;0;0;0;0;0;0;0;0;0;Celular R340 CLARO DIRECTO NEGRO;TELEFONIA
7216411;;F;62;CHILENO;;Boomers;PEDRO AGUIRRE CERDA           ;METROPOLITANA;0;0;0;0;0;0;0;0;0;Celular G8 POWER LITE MOVISTAR DIRECTO AZUL;TELEFONIA
18869980;;M;29;CHILENO;;Millenial;N/D;N/D;0;0;0;0;0;0;0;0;0;Celular A51 128GB LIB OPEN AZUL;TELEFONIA
7649023;;F;64;CHILENO;;Boomers;IQUIQUE                       ;TARAPACA;0;0;0;0;0;0;0;0;0;Celular a11 azul samsung WOM;TELEFONIA
5767349;Casado;F;70;CHILENO;;Silencioso;PROVIDENCIA                   ;METROPOLITANA;0;0;0;0;0;0;0;0;0;Celular A10S MOVISTAR DIRECTO BLACK;TELEFONIA
10113253;Casado;M;57;CHILENO;;Boomers;RENCA                         ;METROPOLITANA;0;0;0;0;0;0;0;0;0;CELULAR HUAWEI Y5P BLUE TRIANGULADO WOM;TELEFONIA
9583742;Casado;M;59;CHILENO;INGENIERO AGRICOLA;Boomers;RENCA                         ;METROPOLITANA;0;0;0;0;0;0;0;0;0;CELULAR NOKIA 110 BLACK OPEN;TELEFONIA
10407237;;M;42;CHILENO;;Silencioso;PROVIDENCIA                   ;METROPOLITANA;0;0;0;0;0;0;0;0;0;CELULAR IPHONE SE 64GB DIRECTO CLARO;TELEFONIA
16900791;Soltero;F;34;CHILENO;;Silencioso;PROVIDENCIA                   ;METROPOLITANA;0;0;0;0;0;0;0;0;0;Celular LG K22 MOVISTAR DIRECTO TITAN;TELEFONIA
10991583;;F;45;CHILENO;;X;RENCA                         ;METROPOLITANA;0;0;0;0;0;0;0;0;0;CELULAR A12 128GB ROJO OPEN;TELEFONIA
16103041;Soltero;F;37;CHILENO;ENFERMERA;Millenial;PROVIDENCIA                   ;METROPOLITANA;0;0;0;0;0;0;0;0;0;Celular Galaxy S21 Phantom Grey 128GB;TELEFONIA
17014112;;M;34;CHILENO;;Millenial;LAS CABRAS                    ;L.G.B.OÂ´HIGGINS;0;0;0;0;0;0;0;0;0;CELULAR XIAOMI REDMI 9C AZUL DIRECTO ENTEL;TELEFONIA
6913384;;M;68;CHILENO;;Silencioso;CASTRO                        ;LOS LAGOS;0;0;0;0;0;0;0;0;0;CELULAR MOTO G8 POWER LITE AZUL TRI ENTEL;TELEFONIA
10195392;;F;57;CHILENO;;Boomers;MONTE PATRIA                  ;COQUIMBO;0;0;0;0;0;0;0;0;0;CELULAR LG K41S TITAN DIRECTO MOVISTAR;TELEFONIA
6664403;;M;70;CHILENO;;Silencioso;SAN FELIPE                    ;VALPARAISO;0;0;0;0;0;0;0;0;0;CELULAR SAMSUNG A71 AZUL OPEN;TELEFONIA
18403182;Soltero;F;28;CHILENO;;Millenial;PROVIDENCIA                   ;METROPOLITANA;0;0;0;0;0;0;0;0;0;CELULAR SAMSUNG A01 NEGRO DIRECTO WOM;TELEFONIA
9873942;Soltero;F;41;CHILENO;PSICOPEDAGOGO;X;ARICA                         ;TARAPACA;0;0;0;0;0;0;0;0;0;CELULAR NOKIA 7.2 GREEN TRI WOM;TELEFONIA
13489493;;F;43;CHILENO;;Extranjero;PUENTE ALTO                   ;METROPOLITANA;0;0;0;0;0;0;0;0;0;CELULAR MOTOROLA E6S ROSADO DIRECTO WOM;TELEFONIA
15583633;Soltero;M;39;CHILENO;;X;RENCA;METROPOLITANA;0;0;0;0;0;0;0;0;0;Celular LG K22 ENTEL DIRECTO TITAN;TELEFONIA
26053979;;F;44;COLOMBIANO;;Extranjero;N/D;N/D;0;0;0;0;0;0;0;0;0;CELULAR REDMI NOTE 9 PRO 128GB INTERSTELLAR GREY;TELEFONIA
13869460;;M;42;CHILENO;;X;PROVIDENCIA                   ;METROPOLITANA;0;0;0;0;0;0;0;0;0;Celular SAMSUNG A01 CORE AZUL ENTEL;TELEFONIA
11953081;;F;50;CHILENO;;X;PROVIDENCIA                   ;METROPOLITANA;0;0;0;0;0;0;0;0;0;CELULAR MOTOROLA E6S GRIS 32GB DIRECTO WOM;TELEFONIA
15501228;;F;39;CHILENO;;X;ANTOFAGASTA                   ;ANTOFAGASTA;0;0;0;0;0;0;0;0;0;Celular W100 MOVISTAR DIRECTO BLACK;TELEFONIA
18371060;Soltero;F;28;CHILENO;;Millenial;PROVIDENCIA                   ;METROPOLITANA;0;0;0;0;0;0;0;0;0;Celular A51 128GB LIB OPEN AZUL;TELEFONIA
19779634;;M;23;CHILENO;;Millenial;N/D;N/D;0;0;0;0;0;0;0;0;0;CELULAR XIAOMI POCO X3 64G SHADOW GRAY;TELEFONIA
12946975;;F;46;CHILENO;;X;LOS VILOS                     ;COQUIMBO;0;0;0;0;0;0;0;0;0;Celular A20S WOM DIRECTO BLACK;TELEFONIA
14079311;;F;46;CHILENO;;X;VILLARICA                     ;ARAUCANIA;0;0;0;0;0;0;0;0;0;CELULAR HUAWEI Y9 PRIME BLUE OPEN;TELEFONIA
20124298;;M;23;CHILENO;;Z;PROVIDENCIA                   ;METROPOLITANA;0;0;0;0;0;0;0;0;0;CELULAR REDMI NOTE 8 64GB SPACE BLACK OPEN;TELEFONIA
9294050;Soltero;M;57;CHILENO;;Boomers;RENCA                         ;METROPOLITANA;0;0;0;0;0;0;0;0;0;CELULAR MOTOROLA G8 POWER LITE AZUL WOM;TELEFONIA
18617802;Soltero;F;27;CHILENO;;Silencioso;PROVIDENCIA                   ;METROPOLITANA;0;0;0;0;0;0;0;0;0;Celular NOKIA 1.3 NEGRO WOM;TELEFONIA
12360522;Casado;M;48;CHILENO;;X;RENCA                         ;METROPOLITANA;0;0;0;0;0;0;0;0;0;CELULAR A12 128GB NEGRO OPEN;TELEFONIA
11942778;;F;50;CHILENO;;X;RENCA                         ;METROPOLITANA;0;0;0;0;0;0;0;0;0;CELULAR REDMI NOTE 8 64GB SPACE BLACK OPEN;TELEFONIA
12984228;;F;45;CHILENO;;X;COLLIPULLI                    ;ARAUCANIA;0;0;0;0;0;0;0;0;0;CELULAR XIAOMI POCO X3 64G SHADOW GRAY;TELEFONIA
6816402;Casado;F;62;CHILENO;PROFESOR;Boomers;PROVIDENCIA                   ;METROPOLITANA;0;0;0;0;0;0;0;0;0;CELULAR SAMSUNG NOTE 20 MYSTIC GRAY OPEN;TELEFONIA
16849521;Soltero;F;34;CHILENO;;Millenial;PROVIDENCIA                   ;METROPOLITANA;0;0;0;0;0;0;0;0;0;Celular Galaxy S21 Plus Phantom Black 128GB;TELEFONIA
12311896;;F;49;CHILENO;;X;PROVIDENCIA                   ;METROPOLITANA;0;0;0;0;0;0;0;0;0;CELULAR NOKIA 110 BLACK OPEN;TELEFONIA
17866281;Soltero;M;30;CHILENO;TECNICO DE NIVEL SUPERIOR ASISTENTE;Millenial;PROVIDENCIA                   ;METROPOLITANA;0;0;0;0;0;0;0;0;0;CELULAR SAMSUNG A21S AZUL OPEN;TELEFONIA
6647492;;F;66;CHILENO;;Boomers;N/D;N/D;0;0;0;0;0;0;0;0;0;Celular A51 128GB LIB OPEN AZUL;TELEFONIA
13443745;;M;44;CHILENO;;X;RENCA                         ;METROPOLITANA;0;0;0;0;0;0;0;0;0;CELULAR SAMSUNG A71 AZUL OPEN;TELEFONIA
19938974;;F;24;CHILENO;;Z;PROVIDENCIA                   ;METROPOLITANA;0;0;0;0;0;0;0;0;0;CELULAR REDMI NOTE 9 PRO 128GB TROPICAL GREEN;TELEFONIA
19104442;Soltero;M;26;CHILENO;;Silencioso;PROVIDENCIA                   ;METROPOLITANA;0;0;0;0;0;0;0;0;0;CELULAR MOTOROLA G9 PLAY 64GB ELECTRIC BLUE OPEN;TELEFONIA
16664342;;F;34;CHILENO;;Millenial;PROVIDENCIA                   ;METROPOLITANA;0;0;0;0;0;0;0;0;0;CELULAR G8 POWER MOTO TRI ENTEL;TELEFONIA
10149104;;M;58;CHILENO;;Boomers;TEMUCO                        ;ARAUCANIA;0;0;0;0;0;0;0;0;0;Celular A11 LIB OPEN BLACK;TELEFONIA
11027750;;F;57;CHILENO;;Boomers;PROVIDENCIA                   ;METROPOLITANA;0;0;0;0;0;0;0;0;0;Celular A01 LIB OPEN AZUL;TELEFONIA
14393168;Soltero;M;43;CHILENO;;X;RENCA                         ;METROPOLITANA;0;0;0;0;0;0;0;0;0;Celular G8 POWER LITE MOVISTAR DIRECTO AZUL;TELEFONIA
25931303;;M;28;VENEZOLANO;;Extranjero;N/D;N/D;0;0;0;0;0;0;0;0;0;Celular A01 Core Azul Tri Entel;TELEFONIA
17049935;;F;33;CHILENO;;Millenial;PROVIDENCIA                   ;METROPOLITANA;0;0;0;0;0;0;0;0;0;CELULAR SAMSUNG A21S AZUL OPEN;TELEFONIA
9399822;;M;58;CHILENO;;Boomers;RENCA                         ;METROPOLITANA;0;0;0;0;0;0;0;0;0;Celular A01 CLARO DIRECTO BLACK;TELEFONIA
26247104;;M;41;VENEZOLANO;;Extranjero;N/D;N/D;0;0;0;0;0;0;0;0;0;Celular Galaxy S21 Phantom Grey 128GB;TELEFONIA
14351377;;F;42;CHILENO;;X;PENALOLEN                     ;METROPOLITANA;0;0;0;0;0;0;0;0;0;CELULAR NOKIA 110 BLACK OPEN;TELEFONIA
22903871;;F;41;HAITIANO;;Extranjero;QUILICURA                     ;METROPOLITANA;0;0;0;0;0;0;0;0;0;CELULAR REDMI NOTE 8 64GB SPACE BLACK OPEN;TELEFONIA
12603000;Casado;M;48;CHILENO;;X;"";"";0;0;0;0;0;0;0;0;0;Celular A01 LIB OPEN NEGRO;TELEFONIA
19268783;;M;25;CHILENO;;Z;"";"";0;0;0;0;0;0;0;0;0;Celular A51 128GB LIB OPEN BLACK;TELEFONIA
14047161;;F;41;CHILENO;;Silencioso;PROVIDENCIA                   ;METROPOLITANA;0;0;0;0;0;0;0;0;0;Celular A20S WOM TRIANGULADO AZUL;TELEFONIA
13521209;Soltero;F;43;CHILENO;;X;PROVIDENCIA                   ;METROPOLITANA;0;0;0;0;0;0;0;0;0;Celular Y9S LIB OPEN BREATHING CRYSTAL;TELEFONIA
4238949;;F;81;CHILENO;;Silencioso;COQUIMBO                      ;COQUIMBO;0;0;0;0;0;0;0;0;0;CELULAR OWN 1026 AZUL ENTEL;TELEFONIA
19250122;;F;26;CHILENO;;Z;N/D;N/D;0;0;0;0;0;0;0;0;0;Celular Y8P ENTEL TRIANGULADO PIEDRA DE LUNA;TELEFONIA
10237715;;M;53;CHILENO;;X;PROVIDENCIA                   ;METROPOLITANA;0;0;0;0;0;0;0;0;0;IPHONE 7 32GB LIB OPEN NEGRO;TELEFONIA
18951301;;M;27;CHILENO;;Millenial;NEGRETE                       ;BIO BIO;0;0;0;0;0;0;0;0;0;Celular R340 CLARO DIRECTO NEGRO;TELEFONIA
11273041;Casado;M;55;CHILENO;;Boomers;RENCA                         ;METROPOLITANA;0;0;0;0;0;0;0;0;0;CELULAR OWN 1026 AZUL ENTEL;TELEFONIA
16354828;Soltero;M;36;CHILENO;;Millenial;PROVIDENCIA                   ;METROPOLITANA;0;0;0;0;0;0;0;0;0;Celular A3 LITE ENTEL TRIANGULADO NEGRO;TELEFONIA
26442668;;F;23;EXTRANJERO - NO INFORMA NACIONALIDAD;;Extranjero;N/D;N/D;0;0;0;0;0;0;0;0;0;CELULAR SAMSUNG NOTE 20 MYSTIC BRONZE 256 GB OPE;TELEFONIA
11969293;;M;50;CHILENO;;X;N/D;N/D;0;0;0;0;0;0;0;0;0;CELULAR A02s NEGRO 32GB OPEN;TELEFONIA
8910487;;F;60;CHILENO;;Boomers;PROVIDENCIA                   ;METROPOLITANA;0;0;0;0;0;0;0;0;0;Celular A01 LIB OPEN AZUL;TELEFONIA
14208201;;F;41;CHILENO;;X;RENCA                         ;METROPOLITANA;0;0;0;0;0;0;0;0;0;Celular A01 LIB OPEN NEGRO;TELEFONIA
17876448;;F;31;CHILENO;;Millenial;PUDAHUEL                      ;METROPOLITANA;0;0;0;0;0;0;0;0;0;Celular A51 128GB LIB OPEN BLANCO;TELEFONIA
7637282;Soltero;M;65;CHILENO;;Boomers;QUEMCHI                       ;LOS LAGOS;0;0;0;0;0;0;0;0;0;Celular A11 LIB OPEN BLACK;TELEFONIA
13250991;;F;44;CHILENO;;X;"";"";0;0;0;0;0;0;0;0;0;CELULAR A12 128GB ROJO OPEN;TELEFONIA
17414056;Soltero;F;32;CHILENO;PROFESOR;Millenial;RENCA                         ;METROPOLITANA;0;0;0;0;0;0;0;0;0;CELULAR A12 128GB AZUL OPEN;TELEFONIA
9488232;;F;58;CHILENO;;Boomers;TEMUCO                        ;ARAUCANIA;0;0;0;0;0;0;0;0;0;Celular a11 azul samsung WOM;TELEFONIA
20452293;;M;22;CHILENO;;Z;EL MONTE                      ;METROPOLITANA;0;0;0;0;0;0;0;0;0;Celular A31 LIB OPEN BLACK;TELEFONIA
5595550;;M;72;CHILENO;;Silencioso;VILLA ALEGRE                  ;MAULE;0;0;0;0;0;0;0;0;0;CELULAR SAMSUNG A21S AZUL OPEN;TELEFONIA
19739020;;F;23;CHILENO;;Z;PROVIDENCIA                   ;METROPOLITANA;0;0;0;0;0;0;0;0;0;CELULAR A02s ROJO 32GB OPEN;TELEFONIA
6397341;;M;69;CHILENO;;Silencioso;SAN VICENTE                   ;L.G.B.OÂ´HIGGINS;0;0;0;0;0;0;0;0;0;Celular SAMSUNG A11 32GB ENTEL DIRECTO NEGRO;TELEFONIA
13804120;;M;42;CHILENO;;X;LOS ANGELES;BIO-BIO;0;0;0;0;0;0;0;0;0;CELULAR NOKIA 3310 CHARCOAL TRI WOM;TELEFONIA
9098741;Soltero;M;52;CHILENO;INGENIERO CIVIL INDUSTRIAL;X;RENCA                         ;METROPOLITANA;0;0;0;0;0;0;0;0;0;CELULAR NOKIA 110 BLACK OPEN;TELEFONIA
17484387;;M;32;CHILENO;;Millenial;PROVIDENCIA                   ;METROPOLITANA;0;0;0;0;0;0;0;0;0;Celular Galaxy S21 Phantom Grey 128GB;TELEFONIA
12517583;;F;48;CHILENO;;X;PROVIDENCIA                   ;METROPOLITANA;0;0;0;0;0;0;0;0;0;CELULAR NOKIA 225 4G BLACK TRI ENTEL;TELEFONIA
19721427;;M;24;CHILENO;;Z;BUIN                          ;METROPOLITANA;0;0;0;0;0;0;0;0;0;CELULAR REDMI NOTE 9 PRO 128GB GLACIER WHITE;TELEFONIA
9551437;;M;58;CHILENO;;Boomers;PAINE                         ;METROPOLITANA;0;0;0;0;0;0;0;0;0;Celular A71 LIB OPEN NEGRO;TELEFONIA
11382370;;F;53;CHILENO;;X;PROVIDENCIA                   ;METROPOLITANA;0;0;0;0;0;0;0;0;0;CELULAR LG K22 TRIANGULADO WOM;TELEFONIA
8717541;;F;64;CHILENO;;Boomers;LA FLORIDA                    ;METROPOLITANA;0;0;0;0;0;0;0;0;0;Celular A31 LIB OPEN ROJO;TELEFONIA
12701768;;F;48;CHILENO;;X;CONCEPCION                    ;BIO BIO;0;0;0;0;0;0;0;0;0;Celular A20S LIB OPEN NEGRO;TELEFONIA
6565593;Casado;M;67;CHILENO;;Boomers;PROVIDENCIA                   ;METROPOLITANA;0;0;0;0;0;0;0;0;0;Celular R340 CLARO DIRECTO NEGRO;TELEFONIA
13725689;;M;42;CHILENO;;X;HUALQUI                       ;BIO BIO;0;0;0;0;0;0;0;0;0;Celular A51 128GB LIB OPEN BLACK;TELEFONIA
6295807;;F;69;CHILENO;;Silencioso;CONCEPCION                    ;BIO BIO;0;0;0;0;0;0;0;0;0;CELULAR SAMSUNG A10S NEGRO WOM;TELEFONIA
20148646;;M;23;CHILENO;;Z;RANCAGUA                      ;L.G.B.OÂ´HIGGINS;0;0;0;0;0;0;0;0;0;Celular P30 LITE CLARO DIRECTO AZUL;TELEFONIA
18989775;;F;26;CHILENO;;Z;PROVIDENCIA                   ;METROPOLITANA;0;0;0;0;0;0;0;0;0;CELULAR OWN 1026 AZUL ENTEL;TELEFONIA
20414590;;F;21;CHILENO;;Z;PROVIDENCIA                   ;METROPOLITANA;0;0;0;0;0;0;0;0;0;CELULAR MOTO G8 POWER LITE BUNDLE + ARO DE LUZ;TELEFONIA
20033687;;M;23;CHILENO;;Silencioso;PROVIDENCIA                   ;METROPOLITANA;0;0;0;0;0;0;0;0;0;CELULAR G8 POWER MOTO TRI ENTEL;TELEFONIA
11849207;;F;51;CHILENO;;X;RENCA                         ;METROPOLITANA;0;0;0;0;0;0;0;0;0;CHIP OPEN ENTEL;TELEFONIA
11555366;;M;51;CHILENO;;X;RANCAGUA                      ;L.G.B.OÂ´HIGGINS;0;0;0;0;0;0;0;0;0;IPHONE 5S 16GB DORADO OPEN;TELEFONIA
19331420;Soltero;F;26;CHILENO;TECNICO DE NIVEL SUPERIOR EN LABORATORIO CLINICO Y BANCO DE SANGRE;Silencioso;PROVIDENCIA                   ;METROPOLITANA;0;0;0;0;0;0;0;0;0;CELULAR A21s 128 GB Negro;TELEFONIA
12104674;;F;50;CHILENO;;X;RENCA                         ;METROPOLITANA;0;0;0;0;0;0;0;0;0;CELULAR SAMSUNG A21S AZUL OPEN;TELEFONIA
18152365;;M;30;CHILENO;;Millenial;PROVIDENCIA                   ;METROPOLITANA;0;0;0;0;0;0;0;0;0;Celular NOKIA 1.3 NEGRO WOM;TELEFONIA
10321001;Casado;F;74;CHILENO;;Silencioso;CAUQUENES                     ;MAULE;0;0;0;0;0;0;0;0;0;CELULAR NOKIA 110 BLACK OPEN;TELEFONIA
7345363;;M;68;CHILENO;;Silencioso;PROVIDENCIA                   ;METROPOLITANA;0;0;0;0;0;0;0;0;0;Celular LG K22 ENTEL DIRECTO TITAN;TELEFONIA
13801398;;F;42;CHILENO;;X;RENCA                         ;METROPOLITANA;0;0;0;0;0;0;0;0;0;Celular Y6 2019 CLARO DIRECTO BLACK;TELEFONIA
19935182;Soltero;F;28;CHILENO;PROFESOR;Millenial;PROVIDENCIA                   ;METROPOLITANA;0;0;0;0;0;0;0;0;0;Celular AL3 CLARO DIRECTO NEGRO;TELEFONIA
11869904;;F;50;CHILENO;;X;N/D;N/D;0;0;0;0;0;0;0;0;0;CELULAR REDMI NOTE 9S 64 GB AURORA BLUE;TELEFONIA
23079478;;F;42;PERUANO;;Extranjero;PROVIDENCIA                   ;METROPOLITANA;0;0;0;0;0;0;0;0;0;Celular A10S LIB OPEN BLUE;TELEFONIA
17852165;;F;30;CHILENO;;Millenial;"";"";0;0;0;0;0;0;0;0;0;CELULAR LG K41S TITAN DIRECTO MOVISTAR;TELEFONIA
12815456;Soltero;M;49;CHILENO;;X;RENCA                         ;METROPOLITANA;0;0;0;0;0;0;0;0;0;CELULAR REDMI NOTE 8 64GB SPACE BLACK OPEN;TELEFONIA
16997766;;M;34;CHILENO;;Millenial;PROVIDENCIA                   ;METROPOLITANA;0;0;0;0;0;0;0;0;0;Celular S10+ LIB OPEN NEGRO;TELEFONIA
17335437;Soltero;M;32;CHILENO;;Millenial;PROVIDENCIA                   ;METROPOLITANA;0;0;0;0;0;0;0;0;0;CELULAR NOKIA 110 BLACK OPEN;TELEFONIA
9761328;Soltero;M;58;CHILENO;;Boomers;PROVIDENCIA                   ;METROPOLITANA;0;0;0;0;0;0;0;0;0;Celular SAMSUNG A01 CORE BLACK CLARO;TELEFONIA
11622189;;M;53;CHILENO;;X;PROVIDENCIA                   ;METROPOLITANA;0;0;0;0;0;0;0;0;0;CELULAR SAMSUNG A21S AZUL OPEN;TELEFONIA
17986904;;F;30;CHILENO;;Millenial;N/D;N/D;0;0;0;0;0;0;0;0;0;CELULAR G8 POWER MOTO TRI ENTEL;TELEFONIA
8876668;Soltero;F;63;CHILENO;TECNICO EN ADMINISTRACION DE EMPRESAS;Boomers;PROVIDENCIA                   ;METROPOLITANA;0;0;0;0;0;0;0;0;0;Celular A51 128GB LIB OPEN BLACK;TELEFONIA
11761384;;M;51;CHILENO;;X;CHIMBARONGO                   ;L.G.B.OÂ´HIGGINS;0;0;0;0;0;0;0;0;0;Celular P40 LITE LIB OPEN GREEN;TELEFONIA
7198699;;M;68;CHILENO;;Silencioso;LA CISTERNA                   ;METROPOLITANA;0;0;0;0;0;0;0;0;0;Celular A51 128GB LIB OPEN BLACK;TELEFONIA
10352893;;F;55;CHILENO;;Boomers;PROVIDENCIA                   ;METROPOLITANA;0;0;0;0;0;0;0;0;0;Celular TIGER V SENIOR CLARO DIRECTO NEGRO;TELEFONIA
16545349;;F;35;CHILENO;;Millenial;PROVIDENCIA                   ;METROPOLITANA;0;0;0;0;0;0;0;0;0;Celular SA3 CLARO DIRECTO BLACK;TELEFONIA
15856053;;F;37;CHILENO;;Millenial;PELLUHUE                      ;MAULE;0;0;0;0;0;0;0;0;0;Celular A01 LIB OPEN NEGRO;TELEFONIA
9860198;;M;58;CHILENO;;Boomers;SAN CARLOS                    ;BIO BIO;0;0;0;0;0;0;0;0;0;CELULAR SAMSUNG A01 NEGRO DIRECTO WOM;TELEFONIA
4403641;;F;80;CHILENO;;Silencioso;SANTA MARIA                   ;VALPARAISO;0;0;0;0;0;0;0;0;0;CELULAR HUAWEI Y9S BLACK DIRECTO CLARO;TELEFONIA
11171947;;M;55;CHILENO;;Boomers;RENCA                         ;METROPOLITANA;0;0;0;0;0;0;0;0;0;Celular 2.3 MOVISTAR DIRECTO CHARCOAL;TELEFONIA
24571576;;M;32;BOLIVIANO;;Extranjero;N/D;N/D;0;0;0;0;0;0;0;0;0;CELULAR XIAOMI REDMI 9A 32GB BLACK DIRECTO CLARO;TELEFONIA
9539291;;M;56;CHILENO;;Boomers;N/D;N/D;0;0;0;0;0;0;0;0;0;Celular A10S LIB OPEN BLUE;TELEFONIA
16651908;;M;35;CHILENO;;Millenial;RENCA                         ;METROPOLITANA;0;0;0;0;0;0;0;0;0;Celular SAMSUNG A11 32GB ENTEL DIRECTO NEGRO;TELEFONIA
7003354;;M;70;CHILENO;;Silencioso;QUILPUE                       ;VALPARAISO;0;0;0;0;0;0;0;0;0;Celular A10S MOVISTAR DIRECTO BLACK;TELEFONIA
15889971;;F;37;CHILENO;;Millenial;PADRE HURTADO                 ;METROPOLITANA;0;0;0;0;0;0;0;0;0;Celular P40 LITE LIB OPEN BLACK;TELEFONIA
9866909;;F;79;CHILENO;;Silencioso;PUENTE ALTO                   ;METROPOLITANA;0;0;0;0;0;0;0;0;0;Celular LG K22 ENTEL DIRECTO TITAN;TELEFONIA
9335751;;F;61;CHILENO;;Boomers;TALCA                         ;MAULE;0;0;0;0;0;0;0;0;0;Celular A11 LIB OPEN BLUE;TELEFONIA
13774658;Casado;M;41;CHILENO;;X;PROVIDENCIA                   ;METROPOLITANA;0;0;0;0;0;0;0;0;0;CELULAR REDMI NOTE 8 64GB NEPTUNE BLUE OPEN;TELEFONIA
16595427;;M;35;CHILENO;;Millenial;N/D;N/D;0;0;0;0;0;0;0;0;0;CELULAR MOTOROLA G9 PLUS CHAMPAGNE ROSE OPEN;TELEFONIA
6499086;;M;66;CHILENO;;Boomers;PROVIDENCIA                   ;METROPOLITANA;0;0;0;0;0;0;0;0;0;CELULAR A12 128GB NEGRO OPEN;TELEFONIA
14361235;;M;54;CHILENO;;X;LONGAVI                       ;MAULE;0;0;0;0;0;0;0;0;0;CELULAR SAMSUNG A21S NEGRO OPEN;TELEFONIA
19573817;;M;25;CHILENO;;Z;RENAICO                       ;ARAUCANIA;0;0;0;0;0;0;0;0;0;CELULAR G8 POWER MOTO TRI ENTEL;TELEFONIA
9430408;;M;57;CHILENO;;Boomers;HIJUELAS                      ;VALPARAISO;0;0;0;0;0;0;0;0;0;Celular A10S LIB OPEN NEGRO;TELEFONIA
12711241;;F;49;CHILENO;;X;FREIRE                        ;ARAUCANIA;0;0;0;0;0;0;0;0;0;Celular A10S LIB OPEN NEGRO;TELEFONIA
11888698;;M;50;CHILENO;;X;MACHALI                       ;L.G.B.OÂ´HIGGINS;0;0;0;0;0;0;0;0;0;CELULAR REDMI NOTE 9 PRO 128GB GLACIER WHITE;TELEFONIA
9493606;;M;44;CHILENO;;X;ARICA                         ;ARICA Y PARINACOTA;0;0;0;0;0;0;0;0;0;Celular A51 128GB LIB OPEN BLACK;TELEFONIA
20462407;;M;22;CHILENO;;Z;PROVIDENCIA                   ;METROPOLITANA;0;0;0;0;0;0;0;0;0;IPHONE 11 64GB BLACK CLARO;TELEFONIA
12128221;;M;50;CHILENO;;X;RENCA                         ;METROPOLITANA;0;0;0;0;0;0;0;0;0;CELULAR MOTO G8 POWER LITE AZUL TRI ENTEL;TELEFONIA
20270957;;F;22;CHILENO;;Z;PROVIDENCIA                   ;METROPOLITANA;0;0;0;0;0;0;0;0;0;Celular ZTE A3 2020 WOM DIRECTO NEGRO;TELEFONIA
14160818;;F;41;CHILENO;;X;PROVIDENCIA                   ;METROPOLITANA;0;0;0;0;0;0;0;0;0;CELULAR XIAOMI REDMI 9C 64GB MIDNIGHT GRAY;TELEFONIA
19010608;;M;27;CHILENO;;Z;ANDACOLLO                     ;COQUIMBO;0;0;0;0;0;0;0;0;0;CELULAR MOTOROLA G8 POWER LITE AZUL WOM;TELEFONIA
16482784;;F;35;CHILENO;;Millenial;PROVIDENCIA                   ;METROPOLITANA;0;0;0;0;0;0;0;0;0;IPHONE 7 32GB LIB OPEN DORADO;TELEFONIA
12794155;Soltero;M;47;CHILENO;;X;RENCA                         ;METROPOLITANA;0;0;0;0;0;0;0;0;0;Celular A31 LIB OPEN AZUL;TELEFONIA
13091916;;F;46;CHILENO;;X;PROVIDENCIA                   ;METROPOLITANA;0;0;0;0;0;0;0;0;0;Celular XIAOMI REDMI 9C 64 GB DIRECTO CLARO;TELEFONIA
13511467;;F;44;CHILENO;;X;RENGO                         ;L.G.B.OÂ´HIGGINS;0;0;0;0;0;0;0;0;0;Celular P30 LIB OPEN NEGRO;TELEFONIA
12096067;;M;53;CHILENO;;X;PROVIDENCIA                   ;METROPOLITANA;0;0;0;0;0;0;0;0;0;IPHONE 7 32GB LIB OPEN DORADO;TELEFONIA
12633082;;M;48;CHILENO;;X;PROVIDENCIA                   ;METROPOLITANA;0;0;0;0;0;0;0;0;0;CELULAR HUAWEI Y5 NEO NEGRO WOM;TELEFONIA
19666769;;M;25;CHILENO;;Z;OVALLE                        ;COQUIMBO;0;0;0;0;0;0;0;0;0;TELEFONO PP BINDU ENTEL;TELEFONIA
8183178;Casado;M;63;CHILENO;;Boomers;RENCA                         ;METROPOLITANA;0;0;0;0;0;0;0;0;0;Celular A01 CLARO DIRECTO BLACK;TELEFONIA
18517687;Soltero;F;29;CHILENO;;Millenial;PROVIDENCIA                   ;METROPOLITANA;0;0;0;0;0;0;0;0;0;CELULAR MOTOROLA G8 POWER LITE AZUL WOM;TELEFONIA
12186364;;F;49;CHILENO;;X;N/D;N/D;0;0;0;0;0;0;0;0;0;CELULAR REDMI NOTE 9S 64 GB GLACIER WHITE;TELEFONIA
18352900;;M;29;CHILENO;;Millenial;OVALLE;COQUIMBO;0;0;0;0;0;0;0;0;0;CELULAR MOTOROLA G9 PLUS CHAMPAGNE ROSE OPEN;TELEFONIA
17874801;Casado;F;31;CHILENO;;Millenial;PROVIDENCIA                   ;METROPOLITANA;0;0;0;0;0;0;0;0;0;CELULAR HUAWEI Y9S BLACK DIRECTO CLARO;TELEFONIA
13098141;;M;45;CHILENO;;X;PROVIDENCIA                   ;METROPOLITANA;0;0;0;0;0;0;0;0;0;CELULAR VIVO Y11s PHANTOM BLACK ENTEL DIRECTO;TELEFONIA
11647531;;F;52;CHILENO;;X;PROVIDENCIA                   ;METROPOLITANA;0;0;0;0;0;0;0;0;0;Celular A51 128GB LIB OPEN AZUL;TELEFONIA
17686447;Soltero;M;31;CHILENO;;Millenial;PROVIDENCIA                   ;METROPOLITANA;0;0;0;0;0;0;0;0;0;IPHONE 11 64 GB ROJO ENTEL;TELEFONIA
19167193;;F;26;CHILENO;;Z;N/D;N/D;0;0;0;0;0;0;0;0;0;CELULAR REDMI NOTE 8 64GB NEPTUNE BLUE OPEN;TELEFONIA
10065916;;F;54;CHILENO;;Extranjero;MALLOA                        ;L.G.B.OÂ´HIGGINS;0;0;0;0;0;0;0;0;0;Celular ZTE A3 2020 ENTEL DIRECTO GRIS;TELEFONIA
6814377;;F;68;CHILENO;;Silencioso;PROVIDENCIA                   ;METROPOLITANA;0;0;0;0;0;0;0;0;0;Celular A10S LIB OPEN BLUE;TELEFONIA
20661596;;F;21;CHILENO;;Z;RANCAGUA;O HIGGINS;0;0;0;0;0;0;0;0;0;CHIP RECARGA CLARO;TELEFONIA
15238488;Soltero;F;41;CHILENO;;X;RENCA                         ;METROPOLITANA;0;0;0;0;0;0;0;0;0;Celular A01 CORE MOVISTAR DIRECTO BLACK;TELEFONIA
18362528;;M;29;CHILENO;;Millenial;CALAMA                        ;ANTOFAGASTA;0;0;0;0;0;0;0;0;0;Celular A31 LIB OPEN ROJO;TELEFONIA
15842536;;M;37;CHILENO;;Millenial;LA PINTANA                    ;METROPOLITANA;0;0;0;0;0;0;0;0;0;Celular a11 azul samsung WOM;TELEFONIA
17709618;;F;30;CHILENO;;Extranjero;"";"";0;0;0;0;0;0;0;0;0;Celular Y9S LIB OPEN BREATHING CRYSTAL;TELEFONIA
10318468;;M;55;CHILENO;;Boomers;PROVIDENCIA                   ;METROPOLITANA;0;0;0;0;0;0;0;0;0;Celular A11 LIB OPEN BLUE;TELEFONIA
10147847;;M;58;CHILENO;;X;PROVIDENCIA                   ;METROPOLITANA;0;0;0;0;0;0;0;0;0;Celular SAMSUNG A11 32GB ENTEL DIRECTO NEGRO;TELEFONIA
9926622;Soltero;M;56;CHILENO;;Boomers;RENCA                         ;METROPOLITANA;0;0;0;0;0;0;0;0;0;Celular A20S LIB OPEN AZUL;TELEFONIA
14438278;;F;49;CHILENO;;X;PUENTE ALTO                   ;METROPOLITANA;0;0;0;0;0;0;0;0;0;CELULAR LG K22 TRIANGULADO WOM;TELEFONIA
13377917;;M;44;CHILENO;;X;SAN CARLOS                    ;BIO BIO;0;0;0;0;0;0;0;0;0;Celular G8 POWER LITE MOVISTAR DIRECTO AZUL;TELEFONIA
8672135;;F;62;CHILENO;;Boomers;SAN ANTONIO                   ;VALPARAISO;0;0;0;0;0;0;0;0;0;Celular A11 LIB OPEN BLUE;TELEFONIA
11382932;Casado;M;54;CHILENO;TECNICO ASISTENTE SOCIAL;X;RENCA                         ;METROPOLITANA;0;0;0;0;0;0;0;0;0;CELULAR LG K22 TRIANGULADO WOM;TELEFONIA
5818001;;M;72;CHILENO;;Silencioso;PROVIDENCIA                   ;METROPOLITANA;0;0;0;0;0;0;0;0;0;CELULAR SAMSUNG A21S NEGRO OPEN;TELEFONIA
13770742;;M;41;CHILENO;;Millenial;PROVIDENCIA                   ;METROPOLITANA;0;0;0;0;0;0;0;0;0;CELULAR XIAOMI REDMI 9C 64GB MIDNIGHT GRAY;TELEFONIA
12222372;;F;50;CHILENO;;X;PROVIDENCIA                   ;METROPOLITANA;0;0;0;0;0;0;0;0;0;IPHONE REAC 8 64GB ROJO OPEN;TELEFONIA
10095879;Soltero;M;61;CHILENO;;Boomers;RENCA                         ;METROPOLITANA;0;0;0;0;0;0;0;0;0;Celular A30S ENTEL TRIANGULADO NEGRO;TELEFONIA
18029788;Soltero;M;31;CHILENO;;Millenial;PROVIDENCIA                   ;METROPOLITANA;0;0;0;0;0;0;0;0;0;Celular A11 LIB OPEN BLUE;TELEFONIA
8644608;;M;64;CHILENO;;Boomers;N/D;N/D;0;0;0;0;0;0;0;0;0;CELULAR XIAOMI REDMI 9A 32GB GRANITE GRAY TRI WO;TELEFONIA
16977395;;F;33;CHILENO;;Millenial;QUILICURA;METROPOLITANA;0;0;0;0;0;0;0;0;0;Celular A01 LIB OPEN NEGRO;TELEFONIA
13854692;;M;41;CHILENO;;X;ANCUD                         ;LOS LAGOS;0;0;0;0;0;0;0;0;0;Celular S10 LITE LIB OPEN AZUL;TELEFONIA
7283477;Divorciado;F;64;CHILENO;;Boomers;OVALLE                        ;COQUIMBO;0;0;0;0;0;0;0;0;0;Celular A11 MOVISTAR DIRECTO BLACK;TELEFONIA
17889125;;F;31;CHILENO;;Millenial;PROVIDENCIA                   ;METROPOLITANA;0;0;0;0;0;0;0;0;0;Celular 2.3 MOVISTAR DIRECTO CHARCOAL;TELEFONIA
17906890;;F;30;CHILENO;;Millenial;"";"";0;0;0;0;0;0;0;0;0;Celular VIVO Y11S ENTEL DIRECTO AZUL;TELEFONIA
8119680;;M;62;CHILENO;;Boomers;HUALPEN;BIO BIO;0;0;0;0;0;0;0;0;0;CELULAR XIAOMI REDMI 9C 64GB MIDNIGHT GRAY;TELEFONIA
10805130;;F;55;CHILENO;;Boomers;ARICA                         ;ARICA Y PARINACOTA;0;0;0;0;0;0;0;0;0;Celular A10S LIB OPEN BLUE;TELEFONIA
9654019;;F;60;CHILENO;;Boomers;SAN PEDRO DE LA PAZ           ;BIO BIO;0;0;0;0;0;0;0;0;0;Celular G8 POWER LITE MOVISTAR DIRECTO AZUL;TELEFONIA
12725361;;M;47;CHILENO;;X;RENCA                         ;METROPOLITANA;0;0;0;0;0;0;0;0;0;Celular XIAOMI REDMI 9A 32 GB DIRECTO CLARO;TELEFONIA
19140313;;F;26;CHILENO;;Z;N/D;N/D;0;0;0;0;0;0;0;0;0;Celular A10S LIB OPEN RED;TELEFONIA
4575640;;M;81;CHILENO;;Silencioso;RENCA                         ;METROPOLITANA;0;0;0;0;0;0;0;0;0;Celular R340 CLARO DIRECTO NEGRO;TELEFONIA
9586741;;M;58;CHILENO;;Boomers;PROVIDENCIA                   ;METROPOLITANA;0;0;0;0;0;0;0;0;0;Celular Y6P WOM TRIANGULADO VERDE;TELEFONIA
15074376;;F;42;CHILENO;;X;RENCA                         ;METROPOLITANA;0;0;0;0;0;0;0;0;0;Celular A11 LIB OPEN WHITE;TELEFONIA
18490187;;F;29;CHILENO;;Millenial;PROVIDENCIA                   ;METROPOLITANA;0;0;0;0;0;0;0;0;0;CELULAR MOTOROLA G9 PLAY 64GB SPRING PINK OPEN;TELEFONIA
16460645;;F;35;CHILENO;;Millenial;RENCA                         ;METROPOLITANA;0;0;0;0;0;0;0;0;0;Celular A01 LIB OPEN ROJO;TELEFONIA
10183359;;M;57;CHILENO;;Boomers;PUENTE ALTO                   ;METROPOLITANA;0;0;0;0;0;0;0;0;0;Celular A10S LIB OPEN NEGRO;TELEFONIA
13846155;;F;48;CHILENO;;X;NUEVA IMPERIAL                ;ARAUCANIA;0;0;0;0;0;0;0;0;0;Celular Y8P ENTEL TRIANGULADO NEGRO;TELEFONIA
8644449;;F;65;CHILENO;;Boomers;TALCA                         ;MAULE;0;0;0;0;0;0;0;0;0;CELULAR Y8S MOVISTAR DIRECTO BLACK;TELEFONIA
13248824;;F;45;CHILENO;;X;PROVIDENCIA                   ;METROPOLITANA;0;0;0;0;0;0;0;0;0;CELULAR MOTOROLA G8 POWER LITE AZUL WOM;TELEFONIA
6526179;Casado;F;65;CHILENO;;Boomers;RENCA                         ;METROPOLITANA;0;0;0;0;0;0;0;0;0;Celular R340 CLARO DIRECTO NEGRO;TELEFONIA
10251885;;F;55;CHILENO;;Boomers;PROVIDENCIA                   ;METROPOLITANA;0;0;0;0;0;0;0;0;0;CELULAR XIAOMI REDMI 9C 64GB MIDNIGHT GRAY;TELEFONIA
15203341;;M;37;CHILENO;;Millenial;TIRUA                         ;BIO BIO;0;0;0;0;0;0;0;0;0;Celular A20S LIB OPEN AZUL;TELEFONIA
10457832;;M;56;CHILENO;;Boomers;PROVIDENCIA                   ;METROPOLITANA;0;0;0;0;0;0;0;0;0;Celular A10S LIB OPEN BLUE;TELEFONIA
10277114;;F;57;CHILENO;;Boomers;RENCA                         ;METROPOLITANA;0;0;0;0;0;0;0;0;0;Celular A10S LIB OPEN RED;TELEFONIA
10585739;;M;56;CHILENO;;Boomers;LAS CABRAS                    ;L.G.B.OÂ´HIGGINS;0;0;0;0;0;0;0;0;0;Celular A11 LIB OPEN BLACK;TELEFONIA
19578899;;F;25;CHILENO;;Z;CANETE                        ;BIO BIO;0;0;0;0;0;0;0;0;0;CELULAR LG K22 TRIANGULADO WOM;TELEFONIA
15120032;Soltero;F;38;CHILENO;INGENIERO;X;RENCA                         ;METROPOLITANA;0;0;0;0;0;0;0;0;0;Celular A01 LIB OPEN NEGRO;TELEFONIA
15402156;;F;39;CHILENO;;X;TALAGANTE                     ;METROPOLITANA;0;0;0;0;0;0;0;0;0;CELULAR HUAWEI Y9S BLACK DIRECTO CLARO;TELEFONIA
9139414;;M;61;CHILENO;;Boomers;PROVIDENCIA                   ;METROPOLITANA;0;0;0;0;0;0;0;0;0;CELULAR SAMSUNG A21S ROJO OPEN;TELEFONIA
10195661;;M;57;CHILENO;;Boomers;CURICO                        ;MAULE;0;0;0;0;0;0;0;0;0;Celular A31 LIB OPEN BLACK;TELEFONIA
11787193;;F;51;CHILENO;;X;MAULE                         ;MAULE;0;0;0;0;0;0;0;0;0;Celular A31 LIB OPEN AZUL;TELEFONIA
7052314;Casado;M;68;CHILENO;;Silencioso;PROVIDENCIA                   ;METROPOLITANA;0;0;0;0;0;0;0;0;0;Celular A10S ENTEL DIRECTO NEGRO;TELEFONIA
12732697;;F;46;CHILENO;;X;N/D;N/D;0;0;0;0;0;0;0;0;0;Celular SAMSUNG A21s CLARO DIRECTO BLACK;TELEFONIA
9402289;Casado;F;60;CHILENO;;Boomers;RENCA                         ;METROPOLITANA;0;0;0;0;0;0;0;0;0;CELULAR VIVO Y20 AZUL DIRECTO ENTEL;TELEFONIA
9846369;;M;55;CHILENO;;Boomers;RENCA                         ;METROPOLITANA;0;0;0;0;0;0;0;0;0;Celular A11 LIB OPEN BLUE;TELEFONIA
8805235;;M;64;CHILENO;;Boomers;NAVIDAD                       ;L.G.B.OÂ´HIGGINS;0;0;0;0;0;0;0;0;0;Celular A20S LIB OPEN ROJO;TELEFONIA
8136849;;M;63;CHILENO;;Boomers;RENCA                         ;METROPOLITANA;0;0;0;0;0;0;0;0;0;Celular A11 LIB OPEN BLACK;TELEFONIA
13077019;;F;45;CHILENO;;X;PROVIDENCIA                   ;METROPOLITANA;0;0;0;0;0;0;0;0;0;CELULAR XIAOMI REDMI 9C 64GB MIDNIGHT GRAY;TELEFONIA
13227846;;M;45;CHILENO;;X;VILLA ALEMANA                 ;VALPARAISO;0;0;0;0;0;0;0;0;0;CELULAR HUAWEI Y5 NEO NEGRO WOM;TELEFONIA
21543208;;M;30;"";;Extranjero;PROVIDENCIA                   ;METROPOLITANA;0;0;0;0;0;0;0;0;0;Celular A20S LIB OPEN ROJO;TELEFONIA
9394675;Casado;M;60;CHILENO;;Boomers;PROVIDENCIA                   ;METROPOLITANA;0;0;0;0;0;0;0;0;0;Celular NOKIA 1.3 NEGRO WOM;TELEFONIA
15021070;;M;40;CHILENO;;X;COQUIMBO                      ;COQUIMBO;0;0;0;0;0;0;0;0;0;CELULAR HUAWEI Y9S BLACK DIRECTO CLARO;TELEFONIA
15674246;;F;38;CHILENO;;Millenial;PROVIDENCIA                   ;METROPOLITANA;0;0;0;0;0;0;0;0;0;CELULAR HUAWEI Y8S CLARO DIRECTO BLACK;TELEFONIA
19420309;;F;24;CHILENO;;Z;PUERTO MONTT                  ;LOS LAGOS;0;0;0;0;0;0;0;0;0;Celular A10S LIB OPEN NEGRO;TELEFONIA
5345370;;M;77;CHILENO;;Silencioso;BUIN                          ;METROPOLITANA;0;0;0;0;0;0;0;0;0;CELULAR SAMSUNG A01 NEGRO DIRECTO WOM;TELEFONIA
8616461;Casado;M;63;CHILENO;;Boomers;PROVIDENCIA                   ;METROPOLITANA;0;0;0;0;0;0;0;0;0;Celular LG K22 MOVISTAR DIRECTO TITAN;TELEFONIA
12588216;;F;48;CHILENO;;X;MAULE                         ;MAULE;0;0;0;0;0;0;0;0;0;Celular NOKIA 1.3 NEGRO WOM;TELEFONIA
14175004;;M;41;CHILENO;;X;PROVIDENCIA                   ;METROPOLITANA;0;0;0;0;0;0;0;0;0;Celular HUAWEI Y9 PRIME DIRECTO CLARO BLUE;TELEFONIA
13319420;;M;45;CHILENO;;X;MARIQUINA                     ;LOS LAGOS;0;0;0;0;0;0;0;0;0;Celular A20S LIB OPEN NEGRO;TELEFONIA
12347246;;M;49;CHILENO;;X;ANTOFAGASTA;ANTOFAGASTA;0;0;0;0;0;0;0;0;0;Celular XIAOMI REDMI 9A 32 GB DIRECTO CLARO;TELEFONIA
11208724;Casado;M;55;CHILENO;;Boomers;PROVIDENCIA                   ;METROPOLITANA;0;0;0;0;0;0;0;0;0;CELULAR XIAOMI MIA1 GOLD 4/32 OPEN;TELEFONIA
25931985;;M;45;COLOMBIANO;;Extranjero;N/D;N/D;0;0;0;0;0;0;0;0;0;Celular Y9S LIB OPEN BREATHING CRYSTAL;TELEFONIA
14053586;;F;41;CHILENO;;X;CURICO                        ;MAULE;0;0;0;0;0;0;0;0;0;CELULAR MOTOROLA G9 PLUS DEEP DIVE OPEN;TELEFONIA
19587368;;F;24;CHILENO;;Z;"";"";0;0;0;0;0;0;0;0;0;CELULAR MOTOROLA G8 POWER LITE AZUL WOM;TELEFONIA
13638695;;F;43;CHILENO;;X;PROVIDENCIA                   ;METROPOLITANA;0;0;0;0;0;0;0;0;0;CELULAR LG K41S TITAN DIRECTO MOVISTAR;TELEFONIA
9741763;Casado;F;60;CHILENO;;Boomers;RENCA                         ;METROPOLITANA;0;0;0;0;0;0;0;0;0;Celular R340 CLARO DIRECTO NEGRO;TELEFONIA
18568348;;F;28;CHILENO;;Extranjero;QUILPUE                       ;VALPARAISO;0;0;0;0;0;0;0;0;0;CELULAR SAMSUNG A21S ROJO OPEN;TELEFONIA
10452369;;M;57;CHILENO;;Boomers;OSORNO                        ;LOS LAGOS;0;0;0;0;0;0;0;0;0;Celular A31 LIB OPEN AZUL;TELEFONIA
15892901;;F;37;CHILENO;;Millenial;N/D;N/D;0;0;0;0;0;0;0;0;0;Celular A31 LIB OPEN AZUL;TELEFONIA
13347334;Soltero;F;44;CHILENO;;X;RENCA                         ;METROPOLITANA;0;0;0;0;0;0;0;0;0;CELULAR MOTOROLA G8 POWER LITE AZUL WOM;TELEFONIA
8368467;Casado;M;64;CHILENO;;Boomers;PROVIDENCIA                   ;METROPOLITANA;0;0;0;0;0;0;0;0;0;Celular A31 LIB OPEN AZUL;TELEFONIA
15983865;;M;37;CHILENO;;Millenial;SAN CARLOS                    ;BIO BIO;0;0;0;0;0;0;0;0;0;CELULAR MOTOROLA G8 POWER LITE AZUL WOM;TELEFONIA
17108155;;F;33;CHILENO;;Millenial;RENCA                         ;METROPOLITANA;0;0;0;0;0;0;0;0;0;CELULAR G8 POWER MOTO TRI ENTEL;TELEFONIA
12573063;;M;48;CHILENO;;X;OVALLE                        ;COQUIMBO;0;0;0;0;0;0;0;0;0;CELULAR MOTOROLA G8 POWER LITE AZUL WOM;TELEFONIA
16887550;;F;34;CHILENO;;Millenial;VILLA ALEMANA                 ;VALPARAISO;0;0;0;0;0;0;0;0;0;Celular A01 LIB OPEN NEGRO;TELEFONIA
5973281;;F;72;CHILENO;;Silencioso;LA PINTANA                    ;METROPOLITANA;0;0;0;0;0;0;0;0;0;IPHONE XR 64GB LIB OPEN NEGRO;TELEFONIA
19754148;;F;24;CHILENO;;Z;PROVIDENCIA                   ;METROPOLITANA;0;0;0;0;0;0;0;0;0;CELULAR XIAOMI REDMI 9C 64GB MIDNIGHT GRAY;TELEFONIA
6799675;;M;67;CHILENO;;Boomers;VINA DEL MAR                  ;VALPARAISO;0;0;0;0;0;0;0;0;0;Celular NOKIA 2.3 WOM DIRECTO CHARCOAL;TELEFONIA
13841738;;M;42;CHILENO;;X;PARRAL                        ;MAULE;0;0;0;0;0;0;0;0;0;Celular G8 POWER LITE MOVISTAR DIRECTO AZUL;TELEFONIA
7797119;;M;67;CHILENO;;Boomers;PENCAHUE                      ;MAULE;0;0;0;0;0;0;0;0;0;CELULAR HUAWEI Y6P NEGRO ENTEL;TELEFONIA
13002238;;M;45;CHILENO;;X;RENCA                         ;METROPOLITANA;0;0;0;0;0;0;0;0;0;CELULAR SAMSUNG A21S ROJO OPEN;TELEFONIA
16425775;Casado;F;36;CHILENO;;Millenial;SAAVEDRA                      ;ARAUCANIA;0;0;0;0;0;0;0;0;0;Celular SAMSUNG A11 32GB ENTEL DIRECTO NEGRO;TELEFONIA
14678973;;M;55;PERUANO;;Extranjero;LA CISTERNA                   ;METROPOLITANA;0;0;0;0;0;0;0;0;0;Celular A71 LIB OPEN PLATEADO;TELEFONIA
9062658;;F;63;CHILENO;;Boomers;PUERTO MONTT                  ;LOS LAGOS;0;0;0;0;0;0;0;0;0;Celular R340 CLARO DIRECTO NEGRO;TELEFONIA
15065849;Soltero;F;40;CHILENO;ASISTENTE SOCIAL;X;SAN FELIPE                    ;VALPARAISO;0;0;0;0;0;0;0;0;0;Celular A10S LIB OPEN BLUE;TELEFONIA
18090050;Soltero;M;30;CHILENO;INGENIERO EN ADMINISTRACION DE EMPRESAS;Millenial;PROVIDENCIA                   ;METROPOLITANA;0;0;0;0;0;0;0;0;0;Celular A3 LITE ENTEL TRIANGULADO NEGRO;TELEFONIA
4070266;;M;84;CHILENO;;Silencioso;RANCAGUA                      ;L.G.B.OÂ´HIGGINS;0;0;0;0;0;0;0;0;0;CELULAR HUAWEI Y5 NEO NEGRO WOM;TELEFONIA
17646178;;M;31;CHILENO;;Millenial;"";"";0;0;0;0;0;0;0;0;0;Celular A51 128GB LIB OPEN BLACK;TELEFONIA
12642948;;F;47;CHILENO;;X;PROVIDENCIA                   ;METROPOLITANA;0;0;0;0;0;0;0;0;0;Celular NOKIA 4.2 ENTEL DIRECTO NEGRO;TELEFONIA
9988035;;M;58;CHILENO;;Boomers;VILLARICA                     ;ARAUCANIA;0;0;0;0;0;0;0;0;0;CELULAR HUAWEI Y5 NEO NEGRO WOM;TELEFONIA
20263065;;M;25;CHILENO;;Z;ARICA                         ;TARAPACA;0;0;0;0;0;0;0;0;0;Celular Y6P WOM TRIANGULADO VERDE;TELEFONIA
9140655;;M;62;CHILENO;;Boomers;PROVIDENCIA                   ;METROPOLITANA;0;0;0;0;0;0;0;0;0;Celular SA3 CLARO DIRECTO BLACK;TELEFONIA
10564334;;M;54;CHILENO;;Boomers;RENCA                         ;METROPOLITANA;0;0;0;0;0;0;0;0;0;CELULAR MOTO ONE FUSION 64GB VERDE 64GB OPEN;TELEFONIA
12738542;;F;48;CHILENO;;X;PROVIDENCIA                   ;METROPOLITANA;0;0;0;0;0;0;0;0;0;CELULAR SAMSUNG A21S AZUL OPEN;TELEFONIA
16676112;;F;34;CHILENO;;Millenial;"";"";0;0;0;0;0;0;0;0;0;Celular SAMSUNG A11 32GB ENTEL DIRECTO NEGRO;TELEFONIA
9853113;;M;59;CHILENO;;Boomers;N/D;N/D;0;0;0;0;0;0;0;0;0;Celular AL3 CLARO DIRECTO NEGRO;TELEFONIA
7110545;Casado;M;65;CHILENO;;Boomers;RENCA                         ;METROPOLITANA;0;0;0;0;0;0;0;0;0;Celular A01 LIB OPEN AZUL;TELEFONIA
18500973;;M;28;CHILENO;;Millenial;CORONEL                       ;BIO BIO;0;0;0;0;0;0;0;0;0;Celular P30 LITE PLUS LIB OPEN BLACK;TELEFONIA
12662870;Soltero;F;54;CHILENO;;X;PROVIDENCIA                   ;METROPOLITANA;0;0;0;0;0;0;0;0;0;Celular A20S WOM TRIANGULADO AZUL;TELEFONIA
15515198;;F;39;CHILENO;;X;SAN CARLOS                    ;BIO BIO;0;0;0;0;0;0;0;0;0;CELULAR HUAWEI Y8S NEGRO WOM;TELEFONIA
13925058;;F;52;CHILENO;;X;MAIPU                         ;METROPOLITANA;0;0;0;0;0;0;0;0;0;Celular Y9S LIB OPEN BREATHING CRYSTAL;TELEFONIA
17970224;;F;30;CHILENO;;Millenial;"";"";0;0;0;0;0;0;0;0;0;Celular A10S LIB OPEN RED;TELEFONIA
12055025;;F;51;CHILENO;;X;PROVIDENCIA                   ;METROPOLITANA;0;0;0;0;0;0;0;0;0;Celular SAMSUNG A11 32GB ENTEL DIRECTO NEGRO;TELEFONIA
10949287;Casado;M;54;CHILENO;;Boomers;RENCA                         ;METROPOLITANA;0;0;0;0;0;0;0;0;0;Celular A01 CLARO DIRECTO BLACK;TELEFONIA
20218102;;F;22;CHILENO;;Z;PROVIDENCIA                   ;METROPOLITANA;0;0;0;0;0;0;0;0;0;Celular A01 LIB OPEN AZUL;TELEFONIA
17128043;Casado;F;33;CHILENO;PROFESOR;Millenial;RENCA                         ;METROPOLITANA;0;0;0;0;0;0;0;0;0;CELULAR SAMSUNG A21S NEGRO OPEN;TELEFONIA
9003186;;F;59;CHILENO;;Boomers;MAIPU                         ;METROPOLITANA;0;0;0;0;0;0;0;0;0;Celular A20S LIB OPEN ROJO;TELEFONIA
17928752;;F;30;CHILENO;;Millenial;LA FLORIDA;METROPOLITANA;0;0;0;0;0;0;0;0;0;Celular Y8P ENTEL TRIANGULADO NEGRO;TELEFONIA
15918791;;M;37;CHILENO;;X;LA CISTERNA                   ;METROPOLITANA;0;0;0;0;0;0;0;0;0;Celular Y8P ENTEL TRIANGULADO PIEDRA DE LUNA;TELEFONIA
22267597;;M;37;PERUANO;;Extranjero;LA PINTANA                    ;METROPOLITANA;0;0;0;0;0;0;0;0;0;Celular A71 LIB OPEN PLATEADO;TELEFONIA
5235101;;M;76;CHILENO;;Silencioso;MACUL                         ;METROPOLITANA;0;0;0;0;0;0;0;0;0;Celular A11 LIB OPEN BLUE;TELEFONIA
14105839;;F;41;CHILENO;;X;IQUIQUE                       ;TARAPACA;0;0;0;0;0;0;0;0;0;CELULAR SAMSUNG A21S ROJO OPEN;TELEFONIA
9733155;;F;52;CHILENO;;X;QUILPUE;VALPARAISO;0;0;0;0;0;0;0;0;0;Celular S20 FE LIB OPEN Cloud Red;TELEFONIA
18997263;Casado;F;27;CHILENO;;Millenial;PROVIDENCIA                   ;METROPOLITANA;0;0;0;0;0;0;0;0;0;IPHONE 8 64 GB LIB OPEN DORADO;TELEFONIA
16557236;;M;35;CHILENO;;Millenial;CURICO                        ;MAULE;0;0;0;0;0;0;0;0;0;Celular LG K22 MOVISTAR DIRECTO TITAN;TELEFONIA
6730239;;M;69;CHILENO;;Silencioso;PROVIDENCIA                   ;METROPOLITANA;0;0;0;0;0;0;0;0;0;Celular SA3 CLARO DIRECTO BLACK;TELEFONIA
4828784;;M;79;CHILENO;;Silencioso;PROVIDENCIA                   ;METROPOLITANA;0;0;0;0;0;0;0;0;0;Celular A51 128GB LIB OPEN AZUL;TELEFONIA
17645465;;M;32;CHILENO;;Millenial;SAN FELIPE                    ;VALPARAISO;0;0;0;0;0;0;0;0;0;Celular Y9S LIB OPEN BREATHING CRYSTAL;TELEFONIA
27034914;;F;28;VENEZOLANO;;Extranjero;"";"";0;0;0;0;0;0;0;0;0;CELULAR MOTO ONE FUSION 64GB VERDE 64GB OPEN;TELEFONIA
15953852;Casado;F;37;CHILENO;;Millenial;PROVIDENCIA                   ;METROPOLITANA;0;0;0;0;0;0;0;0;0;CELULAR MOTO ONE FUSION 64GB VERDE 64GB OPEN;TELEFONIA
12377376;;M;49;CHILENO;;X;SAN CARLOS                    ;BIO BIO;0;0;0;0;0;0;0;0;0;Celular A11 LIB OPEN BLACK;TELEFONIA
13142892;;F;45;CHILENO;;X;LOS ANGELES                   ;BIO BIO;0;0;0;0;0;0;0;0;0;Celular A20S LIB OPEN ROJO;TELEFONIA
17848654;;M;31;CHILENO;;Millenial;PROVIDENCIA                   ;METROPOLITANA;0;0;0;0;0;0;0;0;0;Celular A01 LIB OPEN ROJO;TELEFONIA
12251367;;F;49;CHILENO;;X;PROVIDENCIA                   ;METROPOLITANA;0;0;0;0;0;0;0;0;0;CELULAR MOTO ONE FUSION 64GB VERDE 64GB OPEN;TELEFONIA
12132653;;M;51;CHILENO;;X;PAINE                         ;METROPOLITANA;0;0;0;0;0;0;0;0;0;Celular A11 MOVISTAR DIRECTO BLACK;TELEFONIA
12972492;;F;46;CHILENO;;X;SAN MIGUEL                    ;METROPOLITANA;0;0;0;0;0;0;0;0;0;Celular NOKIA 1.3 NEGRO WOM;TELEFONIA
12617524;;F;47;CHILENO;;X;COPIAPO;ATACAMA;0;0;0;0;0;0;0;0;0;Celular A31 LIB OPEN BLACK;TELEFONIA
11562090;;F;52;CHILENO;;X;SAN CLEMENTE                  ;MAULE;0;0;0;0;0;0;0;0;0;Celular LG K22 DIRECTO CLARO;TELEFONIA
6176697;Casado;M;73;CHILENO;;Silencioso;RENCA                         ;METROPOLITANA;0;0;0;0;0;0;0;0;0;Celular Y6 2019 WOM DIRECTO AZUL;TELEFONIA
8609654;;F;64;CHILENO;;Boomers;MALLOA                        ;L.G.B.OÂ´HIGGINS;0;0;0;0;0;0;0;0;0;Celular 2.3 MOVISTAR DIRECTO CHARCOAL;TELEFONIA
7612862;Casado;M;68;CHILENO;;Boomers;PAINE                         ;METROPOLITANA;0;0;0;0;0;0;0;0;0;Celular A01 LIB OPEN AZUL;TELEFONIA
8701658;;F;63;CHILENO;;Boomers;SAN FELIPE                    ;VALPARAISO;0;0;0;0;0;0;0;0;0;Celular Y5 NEO ENTEL DIRECTO BLACK;TELEFONIA
23963068;;M;41;CHILENO;;X;VALPARAISO                    ;VALPARAISO;0;0;0;0;0;0;0;0;0;Celular A31 LIB OPEN BLACK;TELEFONIA
14138070;;F;41;CHILENO;;X;SAN FERNANDO                  ;L.G.B.OÂ´HIGGINS;0;0;0;0;0;0;0;0;0;CELULAR HUAWEI Y5 NEO NEGRO WOM;TELEFONIA
16162418;;F;36;CHILENO;;Millenial;LOS VILOS                     ;COQUIMBO;0;0;0;0;0;0;0;0;0;Celular Y9S LIB OPEN BREATHING CRYSTAL;TELEFONIA
18179278;;F;29;CHILENO;;Millenial;N/D;N/D;0;0;0;0;0;0;0;0;0;Celular A10S LIB OPEN NEGRO;TELEFONIA
16340744;;M;36;CHILENO;;Millenial;PROVIDENCIA                   ;METROPOLITANA;0;0;0;0;0;0;0;0;0;Celular E6S MOVISTAR DIRECTO AZUL;TELEFONIA
6246559;;M;73;CHILENO;;Silencioso;LAS CONDES                    ;METROPOLITANA;0;0;0;0;0;0;0;0;0;CELULAR OWN 1026 AZUL ENTEL;TELEFONIA
15051396;;F;40;CHILENO;;X;PROVIDENCIA                   ;METROPOLITANA;0;0;0;0;0;0;0;0;0;CELULAR HUAWEI Y5 NEO NEGRO WOM;TELEFONIA
18694065;;F;28;CHILENO;;Millenial;PEDRO AGUIRRE CERDA;METROPOLITANA;0;0;0;0;0;0;0;0;0;Celular Y6 2019 WOM DIRECTO BLACK;TELEFONIA
24584545;;F;32;PERUANO;;Extranjero;PROVIDENCIA                   ;METROPOLITANA;0;0;0;0;0;0;0;0;0;Celular HUAWEI Y9 PRIME DIRECTO CLARO BLUE;TELEFONIA
16026610;;F;37;CHILENO;;Extranjero;"";"";0;0;0;0;0;0;0;0;0;Celular A11 LIB OPEN WHITE;TELEFONIA
18629209;;F;30;CHILENO;;Millenial;NUNOA                         ;METROPOLITANA;0;0;0;0;0;0;0;0;0;Celular A71 LIB OPEN PLATEADO;TELEFONIA
17557444;;F;31;CHILENO;;Millenial;PROVIDENCIA                   ;METROPOLITANA;0;0;0;0;0;0;0;0;0;Celular Y6 2019 WOM DIRECTO BLACK;TELEFONIA
17866955;;F;30;CHILENO;;Extranjero;"";"";0;0;0;0;0;0;0;0;0;CELULAR HUAWEI Y8S NEGRO WOM;TELEFONIA
18675659;;F;27;CHILENO;;Millenial;SAN JOSE DE MAIPO             ;METROPOLITANA;0;0;0;0;0;0;0;0;0;CELULAR SAMSUNG A21S AZUL OPEN;TELEFONIA
14245958;;M;48;CHILENO;;X;MELIPILLA                     ;METROPOLITANA;0;0;0;0;0;0;0;0;0;Celular A10S LIB OPEN NEGRO;TELEFONIA
16075331;Soltero;F;36;CHILENO;;Millenial;PEDRO AGUIRRE CERDA           ;METROPOLITANA;0;0;0;0;0;0;0;0;0;Celular A11 LIB OPEN BLACK;TELEFONIA
16679315;;M;35;CHILENO;;Millenial;CONSTITUCION                  ;MAULE;0;0;0;0;0;0;0;0;0;Celular A51 128GB LIB OPEN BLACK;TELEFONIA
7670077;;F;73;CHILENO;;Silencioso;PROVIDENCIA                   ;METROPOLITANA;0;0;0;0;0;0;0;0;0;Celular SAMSUNG A01 CORE AZUL ENTEL;TELEFONIA
7222333;;F;67;CHILENO;;Boomers;PROVIDENCIA                   ;METROPOLITANA;0;0;0;0;0;0;0;0;0;Celular A10S ENTEL DIRECTO NEGRO;TELEFONIA
18107135;;F;30;CHILENO;;Millenial;N/D;N/D;0;0;0;0;0;0;0;0;0;Celular A10S LIB OPEN RED;TELEFONIA
24532827;;F;48;PERUANO;;Extranjero;SANTIAGO                      ;METROPOLITANA;0;0;0;0;0;0;0;0;0;Celular A11 LIB OPEN BLUE;TELEFONIA
17254888;;F;32;CHILENO;;Millenial;TEMUCO                        ;ARAUCANIA;0;0;0;0;0;0;0;0;0;CELULAR SAMSUNG A21S AZUL OPEN;TELEFONIA
8094109;;M;65;CHILENO;;Boomers;SAGRADA FAMILIA               ;MAULE;0;0;0;0;0;0;0;0;0;Celular A11 LIB OPEN BLUE;TELEFONIA
9864855;Divorciado;F;59;CHILENO;;Boomers;PROVIDENCIA                   ;METROPOLITANA;0;0;0;0;0;0;0;0;0;Celular SAMSUNG A01 CORE BLACK CLARO;TELEFONIA
9267419;;M;52;CHILENO;;X;N/D;N/D;0;0;0;0;0;0;0;0;0;Celular S20+ LIB OPEN NEGRO;TELEFONIA
6155092;;F;73;CHILENO;;Silencioso;RENCA                         ;METROPOLITANA;0;0;0;0;0;0;0;0;0;Celular SA3 CLARO DIRECTO BLACK;TELEFONIA
11386430;;M;52;CHILENO;;X;NOGALES                       ;VALPARAISO;0;0;0;0;0;0;0;0;0;Celular A01 ENTEL TRIANGULADO NEGRO;TELEFONIA
8613822;Casado;M;63;CHILENO;;Boomers;PROVIDENCIA                   ;METROPOLITANA;0;0;0;0;0;0;0;0;0;Celular SA3 CLARO DIRECTO BLACK;TELEFONIA
13834984;;F;42;CHILENO;;X;N/D;N/D;0;0;0;0;0;0;0;0;0;CELULAR Y8S MOVISTAR DIRECTO BLACK;TELEFONIA
6934412;;F;71;CHILENO;;Silencioso;SAN ANTONIO                   ;VALPARAISO;0;0;0;0;0;0;0;0;0;Celular A20S LIB OPEN ROJO;TELEFONIA
16178347;;F;36;CHILENO;;Millenial;PUENTE ALTO                   ;METROPOLITANA;0;0;0;0;0;0;0;0;0;Celular A10S LIB OPEN RED;TELEFONIA
17188971;Soltero;F;33;CHILENO;ABOGADO;Millenial;PROVIDENCIA                   ;METROPOLITANA;0;0;0;0;0;0;0;0;0;Celular A3 LITE ENTEL TRIANGULADO NEGRO;TELEFONIA
18647928;;M;28;CHILENO;;Millenial;"";"";0;0;0;0;0;0;0;0;0;Celular Y9S LIB OPEN BLACK;TELEFONIA
7423315;;F;65;CHILENO;;Boomers;ARAUCO                        ;BIO BIO;0;0;0;0;0;0;0;0;0;Celular A20S LIB OPEN ROJO;TELEFONIA
4515436;;F;81;CHILENO;;Silencioso;NUEVA IMPERIAL                ;ARAUCANIA;0;0;0;0;0;0;0;0;0;CELULAR HUAWEI Y5 NEO NEGRO WOM;TELEFONIA
19615451;;M;23;CHILENO;;Millenial;"";"";0;0;0;0;0;0;0;0;0;CELULAR MOTO ONE FUSION 64GB VERDE 64GB OPEN;TELEFONIA
5827343;Casado;F;74;CHILENO;;Silencioso;PROVIDENCIA                   ;METROPOLITANA;0;0;0;0;0;0;0;0;0;Celular A01 LIB OPEN AZUL;TELEFONIA
6956795;;F;73;CHILENO;;Silencioso;LINARES                       ;MAULE;0;0;0;0;0;0;0;0;0;Celular SA3 CLARO DIRECTO BLACK;TELEFONIA
6727022;;F;67;CHILENO;;Boomers;QUINTA NORMAL                 ;METROPOLITANA;0;0;0;0;0;0;0;0;0;Celular A10S LIB OPEN RED;TELEFONIA
22813262;;M;62;PERUANO;;Extranjero;CALAMA                        ;ANTOFAGASTA;0;0;0;0;0;0;0;0;0;Celular A10S LIB OPEN NEGRO;TELEFONIA
15791029;;F;38;CHILENO;;Millenial;PROVIDENCIA                   ;METROPOLITANA;0;0;0;0;0;0;0;0;0;Celular A01 LIB OPEN AZUL;TELEFONIA
13120558;;F;46;CHILENO;;X;LINARES                       ;MAULE;0;0;0;0;0;0;0;0;0;Celular A10S LIB OPEN RED;TELEFONIA
18939056;;M;27;CHILENO;;Millenial;N/D;N/D;0;0;0;0;0;0;0;0;0;Celular A20S LIB OPEN ROJO;TELEFONIA
14234545;;F;52;CHILENO;;X;RENCA                         ;METROPOLITANA;0;0;0;0;0;0;0;0;0;Celular A5 CLARO DIRECTO BLACK;TELEFONIA
6581805;;M;64;CHILENO;;Boomers;CURICO                        ;MAULE;0;0;0;0;0;0;0;0;0;Celular A31 LIB OPEN BLACK;TELEFONIA
10144440;;M;53;CHILENO;;X;ANCUD                         ;LOS LAGOS;0;0;0;0;0;0;0;0;0;Celular A10S LIB OPEN BLUE;TELEFONIA
10440054;;F;58;CHILENO;;Boomers;PROVIDENCIA                   ;METROPOLITANA;0;0;0;0;0;0;0;0;0;Celular A3 LITE ENTEL TRIANGULADO NEGRO;TELEFONIA
5403318;;F;77;CHILENO;;Silencioso;RENCA                         ;METROPOLITANA;0;0;0;0;0;0;0;0;0;CELULAR HUAWEI Y5 NEO NEGRO WOM;TELEFONIA
14389444;;M;43;CHILENO;;X;LINARES                       ;MAULE;0;0;0;0;0;0;0;0;0;CELULAR SAMSUNG A21S ROJO OPEN;TELEFONIA
7677886;;M;65;CHILENO;;Boomers;RENCA                         ;METROPOLITANA;0;0;0;0;0;0;0;0;0;Celular A01 MOVISTAR DIRECTO BLACK;TELEFONIA
12609990;;F;47;CHILENO;;X;QUILLOTA                      ;VALPARAISO;0;0;0;0;0;0;0;0;0;CELULAR SAMSUNG A21S NEGRO OPEN;TELEFONIA
19565955;;M;25;CHILENO;;Z;PROVIDENCIA                   ;METROPOLITANA;0;0;0;0;0;0;0;0;0;Celular S20 LIB OPEN GRIS;TELEFONIA
5429953;Casado;M;75;CHILENO;;Silencioso;PROVIDENCIA                   ;METROPOLITANA;0;0;0;0;0;0;0;0;0;Celular A01 LIB OPEN ROJO;TELEFONIA
6732483;;M;69;CHILENO;;Silencioso;CALAMA                        ;ANTOFAGASTA;0;0;0;0;0;0;0;0;0;Celular A71 LIB OPEN PLATEADO;TELEFONIA
13959970;;F;41;CHILENO;;X;CALAMA                        ;ANTOFAGASTA;0;0;0;0;0;0;0;0;0;Celular A10S LIB OPEN RED;TELEFONIA
15287540;;F;40;CHILENO;;X;RENCA                         ;METROPOLITANA;0;0;0;0;0;0;0;0;0;Celular A20S LIB OPEN ROJO;TELEFONIA
11312436;;F;53;CHILENO;;X;CABRERO                       ;BIO BIO;0;0;0;0;0;0;0;0;0;Celular Y5 NEO ENTEL DIRECTO BLACK;TELEFONIA
18808145;Soltero;F;28;CHILENO;;Millenial;PROVIDENCIA                   ;METROPOLITANA;0;0;0;0;0;0;0;0;0;CELULAR MOTO ONE MACRO AZUL METAL WOM;TELEFONIA
26455453;;M;32;EXTRANJERO - NO INFORMA NACIONALIDAD;;Extranjero;LA CISTERNA                   ;METROPOLITANA;0;0;0;0;0;0;0;0;0;Celular SAMSUNG A31 BLACK CLARO;TELEFONIA
7853339;;F;69;CHILENO;;Silencioso;RENCA                         ;METROPOLITANA;0;0;0;0;0;0;0;0;0;Celular SA3 CLARO DIRECTO BLACK;TELEFONIA
16363521;;F;35;CHILENO;;Millenial;RENCA                         ;METROPOLITANA;0;0;0;0;0;0;0;0;0;Celular A11 LIB OPEN BLUE;TELEFONIA
11505040;;M;52;CHILENO;;X;PROVIDENCIA                   ;METROPOLITANA;0;0;0;0;0;0;0;0;0;Celular SA3 CLARO DIRECTO BLACK;TELEFONIA
6104831;;M;73;CHILENO;;Silencioso;HUASCO                        ;ATACAMA;0;0;0;0;0;0;0;0;0;Celular A31 LIB OPEN ROJO;TELEFONIA
6903267;Soltero;F;69;CHILENO;;Silencioso;PROVIDENCIA                   ;METROPOLITANA;0;0;0;0;0;0;0;0;0;Celular A10S LIB OPEN BLUE;TELEFONIA
17350556;Soltero;F;32;CHILENO;MEDICO CIRUJANO;Millenial;PROVIDENCIA                   ;METROPOLITANA;0;0;0;0;0;0;0;0;0;Celular S20 + LIB OPEN CELESTE;TELEFONIA
6705486;;F;70;CHILENO;;Silencioso;DALCAHUE                      ;LOS LAGOS;0;0;0;0;0;0;0;0;0;Celular SA3 CLARO DIRECTO BLACK;TELEFONIA
10495185;;M;58;CHILENO;;Boomers;PROVIDENCIA                   ;METROPOLITANA;0;0;0;0;0;0;0;0;0;Celular Y5 NEO ENTEL DIRECTO BLACK;TELEFONIA
9953011;;M;58;CHILENO;;Boomers;TALAGANTE                     ;METROPOLITANA;0;0;0;0;0;0;0;0;0;CELULAR MOTO ONE FUSION 64GB VERDE 64GB OPEN;TELEFONIA
19833994;;F;24;CHILENO;;Z;PROVIDENCIA                   ;METROPOLITANA;0;0;0;0;0;0;0;0;0;Celular A51 128GB CLARO TRIANGULADO BLACK;TELEFONIA
14498528;;M;45;CHILENO;;X;LOS ANGELES                   ;BIO BIO;0;0;0;0;0;0;0;0;0;Celular E6S ENTEL DIRECTO BLUE;TELEFONIA
9953010;;M;58;CHILENO;;Boomers;SAN ANTONIO                   ;VALPARAISO;0;0;0;0;0;0;0;0;0;CELULAR HUAWEI Y8S BLACK TRI CLARO;TELEFONIA
16971596;;F;33;CHILENO;;Millenial;PROVIDENCIA                   ;METROPOLITANA;0;0;0;0;0;0;0;0;0;Celular A10S LIB OPEN NEGRO;TELEFONIA
17420593;;F;32;CHILENO;;Millenial;RENCA                         ;METROPOLITANA;0;0;0;0;0;0;0;0;0;Celular A20S LIB OPEN AZUL;TELEFONIA
9262338;Casado;F;58;CHILENO;;Boomers;RENCA                         ;METROPOLITANA;0;0;0;0;0;0;0;0;0;CELULAR HUAWEI Y5P CLARO DIRECTO BLUE;TELEFONIA
20144450;;F;22;CHILENO;;Millenial;PROVIDENCIA                   ;METROPOLITANA;0;0;0;0;0;0;0;0;0;Celular P40 LITE LIB OPEN GREEN;TELEFONIA
7468577;Soltero;M;63;CHILENO;;Boomers;PROVIDENCIA                   ;METROPOLITANA;0;0;0;0;0;0;0;0;0;Celular Y6 2019 CLARO DIRECTO BLUE;TELEFONIA
17443047;;F;32;CHILENO;;Millenial;NATALES                       ;MAGALLANES;0;0;0;0;0;0;0;0;0;Celular E6S CLARO DIRECTO RED;TELEFONIA
10236702;;M;54;CHILENO;;X;SAN ANTONIO                   ;VALPARAISO;0;0;0;0;0;0;0;0;0;Celular A11 LIB OPEN BLUE;TELEFONIA
17644836;Soltero;F;31;CHILENO;TECNICO DE NIVEL SUPERIOR EN ENFERMERIA;Millenial;PROVIDENCIA                   ;METROPOLITANA;0;0;0;0;0;0;0;0;0;CELULAR HUAWEI Y8S BLACK TRI CLARO;TELEFONIA
16994005;;F;34;CHILENO;;Millenial;N/D;N/D;0;0;0;0;0;0;0;0;0;Celular G8 POWER LITE WOM DIRECTO TURQUESA;TELEFONIA
13938908;;M;42;CHILENO;;X;N/D;N/D;0;0;0;0;0;0;0;0;0;Celular A10S LIB OPEN NEGRO;TELEFONIA
13837434;;M;42;CHILENO;;X;PROVIDENCIA                   ;METROPOLITANA;0;0;0;0;0;0;0;0;0;IPHONE 8 64 GB LIB OPEN DORADO;TELEFONIA
9983349;Casado;M;58;CHILENO;;Boomers;PROVIDENCIA                   ;METROPOLITANA;0;0;0;0;0;0;0;0;0;Celular A01 LIB OPEN AZUL;TELEFONIA
26861071;;M;30;NO INFORMA NACIONALIDAD;;Extranjero;N/D;N/D;0;0;0;0;0;0;0;0;0;CELULAR MOTOROLA G9 PLAY 64GB ELECTRIC BLUE OPEN;TELEFONIA
16418441;;M;35;CHILENO;;Millenial;DALCAHUE                      ;LOS LAGOS;0;0;0;0;0;0;0;0;0;CELULAR A11 CLARO DIRECTO BLACK;TELEFONIA
18120232;;M;30;CHILENO;;Millenial;LA FLORIDA                    ;METROPOLITANA;0;0;0;0;0;0;0;0;0;Celular Y5 NEO CLARO DIRECTO BLACK;TELEFONIA
12749032;;M;46;CHILENO;;X;COIHAIQUE                     ;AYSEN;0;0;0;0;0;0;0;0;0;Celular Y5 NEO CLARO DIRECTO BLACK;TELEFONIA
17862854;;F;30;CHILENO;;Millenial;"";"";0;0;0;0;0;0;0;0;0;Celular SAMSUNG A31 BLACK CLARO;TELEFONIA
11866019;;M;51;CHILENO;;X;PROVIDENCIA                   ;METROPOLITANA;0;0;0;0;0;0;0;0;0;Celular A51 128GB LIB OPEN AZUL;TELEFONIA
20093150;;M;23;CHILENO;;Z;N/D;N/D;0;0;0;0;0;0;0;0;0;Celular a11 azul samsung WOM;TELEFONIA
16341254;;M;35;CHILENO;;Millenial;"";"";0;0;0;0;0;0;0;0;0;Celular A20S LIB OPEN AZUL;TELEFONIA
6994439;;M;69;CHILENO;;Silencioso;VALDIVIA                      ;LOS LAGOS;0;0;0;0;0;0;0;0;0;Celular Y6P WOM TRIANGULADO VERDE;TELEFONIA
17214546;;F;33;CHILENO;;Millenial;N/D;N/D;0;0;0;0;0;0;0;0;0;CELULAR MOTOROLA E6S AZUL WOM;TELEFONIA
19380216;Soltero;M;25;CHILENO;;Z;PROVIDENCIA                   ;METROPOLITANA;0;0;0;0;0;0;0;0;0;Celular Y7P LIB OPEN NEGRO;TELEFONIA
9824019;;M;58;CHILENO;;Boomers;PROVIDENCIA                   ;METROPOLITANA;0;0;0;0;0;0;0;0;0;Celular SAMSUNG A01 CORE AZUL ENTEL;TELEFONIA
19648052;;M;25;CHILENO;;Z;PROVIDENCIA                   ;METROPOLITANA;0;0;0;0;0;0;0;0;0;CELULAR SAMSUNG A80 BLACK OPEN;TELEFONIA
12396816;;F;49;CHILENO;;X;CABILDO                       ;VALPARAISO;0;0;0;0;0;0;0;0;0;Celular Y9S LIB OPEN BLACK;TELEFONIA
11729290;;M;51;CHILENO;;X;RENCA                         ;METROPOLITANA;0;0;0;0;0;0;0;0;0;Celular A01 LIB OPEN ROJO;TELEFONIA
11733563;;M;51;CHILENO;;X;PROVIDENCIA                   ;METROPOLITANA;0;0;0;0;0;0;0;0;0;CELULAR MOTO ONE FUSION 64GB VERDE 64GB OPEN;TELEFONIA
18362140;;F;26;CHILENO;;Z;N/D;N/D;0;0;0;0;0;0;0;0;0;Celular A01 LIB OPEN NEGRO;TELEFONIA
9465944;;F;58;CHILENO;;Boomers;SAN CARLOS                    ;BIO BIO;0;0;0;0;0;0;0;0;0;Celular A01 LIB OPEN AZUL;TELEFONIA
4912764;;M;76;CHILENO;;Silencioso;RENCA                         ;METROPOLITANA;0;0;0;0;0;0;0;0;0;Celular A01 CLARO DIRECTO BLACK;TELEFONIA
9439494;;M;59;CHILENO;;Boomers;CAUQUENES                     ;MAULE;0;0;0;0;0;0;0;0;0;Celular A10S MOVISTAR DIRECTO NEGRO;TELEFONIA
6161659;;F;71;CHILENO;;Silencioso;OLMUE                         ;VALPARAISO;0;0;0;0;0;0;0;0;0;Celular A10S MOVISTAR DIRECTO NEGRO;TELEFONIA
6654975;;M;67;CHILENO;;Boomers;RENCA                         ;METROPOLITANA;0;0;0;0;0;0;0;0;0;Celular A3 LITE ENTEL TRIANGULADO NEGRO;TELEFONIA
15571199;;M;39;CHILENO;;X;PROVIDENCIA                   ;METROPOLITANA;0;0;0;0;0;0;0;0;0;Celular A51 128GB LIB OPEN AZUL;TELEFONIA
6325123;;F;73;CHILENO;;Silencioso;VILLARICA                     ;ARAUCANIA;0;0;0;0;0;0;0;0;0;Celular Y5 NEO CLARO DIRECTO BLACK;TELEFONIA
7353507;Soltero;M;68;CHILENO;AGRONOMO;Silencioso;PROVIDENCIA                   ;METROPOLITANA;0;0;0;0;0;0;0;0;0;Celular A01 LIB OPEN NEGRO;TELEFONIA
16165203;;F;36;CHILENO;;Millenial;N/D;N/D;0;0;0;0;0;0;0;0;0;CELULAR HUAWEI Y5P CLARO DIRECTO BLUE;TELEFONIA
11543992;;M;52;CHILENO;;X;CALBUCO                       ;LOS LAGOS;0;0;0;0;0;0;0;0;0;Celular J2 CORE CLARO DIRECTO NEGRO;TELEFONIA
5932979;;F;75;CHILENO;;Silencioso;COIHAIQUE                     ;AYSEN;0;0;0;0;0;0;0;0;0;Celular A01 LIB OPEN AZUL;TELEFONIA
19347050;;F;25;CHILENO;;Z;LINARES                       ;MAULE;0;0;0;0;0;0;0;0;0;Celular Y6 2019 MOVISTAR DIRECTO BLUE;TELEFONIA
12469729;Soltero;F;49;CHILENO;;X;PROVIDENCIA                   ;METROPOLITANA;0;0;0;0;0;0;0;0;0;Celular Y9 PRIME LIB OPEN VERDE;TELEFONIA
6495705;;F;70;CHILENO;;Silencioso;PROVIDENCIA                   ;METROPOLITANA;0;0;0;0;0;0;0;0;0;Celular A10S LIB OPEN RED;TELEFONIA
11433383;;F;53;CHILENO;;X;CATEMU                        ;VALPARAISO;0;0;0;0;0;0;0;0;0;Celular A01 LIB OPEN NEGRO;TELEFONIA
10704287;;F;55;CHILENO;;Boomers;MACHALI                       ;L.G.B.OÂ´HIGGINS;0;0;0;0;0;0;0;0;0;Celular A20S LIB OPEN NEGRO;TELEFONIA
20136498;;M;23;CHILENO;;Z;PROVIDENCIA                   ;METROPOLITANA;0;0;0;0;0;0;0;0;0;CELULAR SAMSUNG A21S AZUL OPEN;TELEFONIA
20412013;;M;22;CHILENO;;Extranjero;N/D;N/D;0;0;0;0;0;0;0;0;0;CELULAR HUAWEI Y6P NEGRO ENTEL;TELEFONIA
10814096;Casado;M;50;CHILENO;;X;RENCA                         ;METROPOLITANA;0;0;0;0;0;0;0;0;0;Celular A3 LITE ENTEL TRIANGULADO NEGRO;TELEFONIA
18228988;;M;30;CHILENO;;Millenial;PROVIDENCIA                   ;METROPOLITANA;0;0;0;0;0;0;0;0;0;Celular Y6 2019 CLARO DIRECTO BLACK;TELEFONIA
18958937;;F;27;CHILENO;;Millenial;PROVIDENCIA                   ;METROPOLITANA;21700;2;1;0;0;0;2;1;21700;TRAVEL ADAPTER 15W - FAST CHARGER (TYPE-C CABLE);ACCESORIOS
17956917;;F;31;CHILENO;;Millenial;N/D;N/D;5990;1;1;0;0;0;1;1;5990;Mouse 530 Wireless (PlatinumGrey);ACCESORIOS
15601324;Divorciado;M;39;CHILENO;;X;RENCA                         ;METROPOLITANA;6990;1;1;0;0;0;1;1;6990;SOPORTE TV 26-56 KTA02 KIOTO FIJO;ACCESORIOS
20125897;;M;22;CHILENO;;Z;PROVIDENCIA                   ;METROPOLITANA;7990;1;1;1;1;7990;0;0;0;TYPE C TO TYPE C CABLE 3A (MAX 60W);ACCESORIOS
19581119;Soltero;M;25;CHILENO;;Z;SAN ESTEBAN;VALPARAISO;6990;1;1;0;0;0;1;1;6990;SOPORTE TV 26-56 KTA02 KIOTO FIJO;ACCESORIOS
6686065;;F;71;CHILENO;;Silencioso;CALAMA                        ;ANTOFAGASTA;1815930;7;4;0;0;0;7;4;1815930;Escritorio Gamer Pro RGB;ACCESORIOS
8618327;;M;62;CHILENO;;Boomers;PROVIDENCIA                   ;METROPOLITANA;963500;24;11;0;0;0;24;11;963500;Audifonos Gamer Expert MF6;ACCESORIOS
9735618;;M;58;CHILENO;;Boomers;BUIN                          ;METROPOLITANA;366280;6;3;0;0;0;6;3;366280;SOPORTE TVKTM - 01S;ACCESORIOS
10195561;;M;56;CHILENO;;Boomers;PARRAL                        ;MAULE;69972;3;2;0;0;0;3;2;69972;AUDIFONO ON HF100 PANASONIC AZUL;ACCESORIOS
11898436;;F;51;CHILENO;;X;RENCA                         ;METROPOLITANA;1356500;17;4;0;0;0;17;4;1356500;SOPORTE TV 26-56 KTAT02 KIOTO MOVIL;ACCESORIOS
19758616;;F;24;CHILENO;;Z;ALGARROBO;VALPARAISO;98980;2;3;2;3;98980;0;0;0;Silla Gaming PCH-102BK Negra;ACCESORIOS
16742767;;F;34;CHILENO;;Millenial;PROVIDENCIA                   ;METROPOLITANA;99990;1;1;1;1;99990;0;0;0;GALAXY WATCH ACTIVE4 40 MM GOLD;ACCESORIOS
19572070;;M;25;CHILENO;;Z;PROVIDENCIA                   ;METROPOLITANA;113980;2;1;2;1;113980;0;0;0;Galaxy Watch Active4 40 mm Black;ACCESORIOS
8978008;;M;61;CHILENO;;Boomers;RENCA                         ;METROPOLITANA;69980;2;1;0;0;0;2;1;69980;AUDIFONOS IN-EAR TRULY WIRELESS JBL W100 TWS BLA;ACCESORIOS
12358005;;F;48;CHILENO;;X;ISLA DE MAIPO                 ;METROPOLITANA;12990;1;1;0;0;0;1;1;12990;SAMSUNG TYPE-C EARPHONES WHITE;ACCESORIOS
20279351;;F;22;CHILENO;;Z;PROVIDENCIA                   ;METROPOLITANA;30960;4;2;4;2;30960;0;0;0;KIT GAMER 3 EN 1 LVLUP TECLADO CON LUCES, MOUSE;ACCESORIOS
19499143;;M;25;CHILENO;;Z;SANTA CRUZ;O HIGGINS;219980;2;1;0;0;0;2;1;219980;AUDIFONOS GALAXY BUDS PRO SILVER;ACCESORIOS
16558319;;M;34;CHILENO;;Millenial;SANTIAGO;METROPOLITANA;19990;1;1;1;1;19990;0;0;0;Teclado + Mouse 510 Wireless Combo - LA Spanish;ACCESORIOS
16153873;;M;36;CHILENO;;Millenial;ESTACION CENTRAL;METROPOLITANA;0;0;4;0;4;0;0;0;0;TWS EARPHONE WITH CHARGING CASE BLANCO FIDDLER;ACCESORIOS
12217817;;M;50;CHILENO;;X;COPIAPO                       ;ATACAMA;55241;1;1;0;0;0;1;1;55241;Disco Externo Elements Portable SE 2TB;ACCESORIOS
17494673;;M;32;CHILENO;;Millenial;TALCA;MAULE;24990;1;1;1;1;24990;0;0;0;MI Smart Band 6 Negra XIAOMI;ACCESORIOS
16819114;;F;34;CHILENO;;Millenial;QUILLOTA                      ;VALPARAISO;5000;1;1;0;0;0;1;1;5000;PARLANTE ZUKABASS + MICROFONO MLAB BT;ACCESORIOS
19805879;;M;24;CHILENO;;Z;N/D;N/D;39990;1;1;0;0;0;1;1;39990;MI Smart Band 6 Negra XIAOMI;ACCESORIOS
8125249;;F;59;CHILENO;;Boomers;PROVIDENCIA                   ;METROPOLITANA;19990;2;1;0;0;0;2;1;19990;PARLANTES GAMER DHS-2101;ACCESORIOS
10698611;;F;52;CHILENO;;X;RENCA                         ;METROPOLITANA;109990;1;1;1;1;109990;0;0;0;GALAXY WATCH ACTIVE4 40 MM GOLD;ACCESORIOS
10016694;;M;55;CHILENO;;Boomers;VILLARICA                     ;ARAUCANIA;419970;3;3;0;0;0;3;3;419970;SOPORTE TV 14-42 KTAM02 KIOTO C/ BRAZO MOVIL;ACCESORIOS
17800729;;M;30;CHILENO;;Millenial;ALTO HOSPICIO;TARAPACA;81980;2;2;1;1;64990;1;1;16990;SAMSUNG TYPE-C EARPHONES BLACK;ACCESORIOS
13291279;;F;45;CHILENO;;X;RENCA                         ;METROPOLITANA;12240;2;1;0;0;0;2;1;12240;AUDIFONO MANOS LIBRES MOTOROLA SQUADS 200 AZUL;ACCESORIOS
15941975;;M;37;CHILENO;;Millenial;N/D;N/D;74364;4;2;2;1;15980;2;1;58384;Porta audifonos M650;ACCESORIOS
13119803;Casado;M;45;CHILENO;;X;PROVIDENCIA                   ;METROPOLITANA;130980;2;2;2;2;130980;0;0;0;ITFIT Tripode Selfie Stick;ACCESORIOS
18897479;;M;27;CHILENO;;Millenial;COPIAPO;ATACAMA;24990;1;1;0;0;0;1;1;24990;Redmi Buds 3 Lite Black;ACCESORIOS
18119794;;M;30;CHILENO;;Millenial;"";"";89990;1;1;0;0;0;1;1;89990;PARLANTE FLIP ESSENTIAL BLUETOOTH;ACCESORIOS
10740356;;F;54;CHILENO;;Boomers;PROVIDENCIA;METROPOLITANA;179970;3;2;2;1;169980;1;1;9990;Mouse 200 Silver Wireless;ACCESORIOS
14255680;;M;48;CHILENO;;X;MAIPU;METROPOLITANA;53980;2;1;2;1;53980;0;0;0;Disco Externo Elements Portable SE 1TB;ACCESORIOS
9015864;;M;61;CHILENO;;Boomers;PROVIDENCIA                   ;METROPOLITANA;22990;1;1;0;0;0;1;1;22990;AUDIFONOS ON-EAR JBL TUNE 500 AZUL;ACCESORIOS
20541271;;F;21;CHILENO;;Z;SAN FELIPE;VALPARAISO;109980;2;2;2;2;109980;0;0;0;Parlante Bluetooth Blik Rockwood;ACCESORIOS
19060134;;F;25;CHILENO;;Z;PROVIDENCIA                   ;METROPOLITANA;2990;1;1;0;0;0;1;1;2990;CABLE MGCAMIC;ACCESORIOS
13204953;;M;44;CHILENO;;X;RENCA                         ;METROPOLITANA;89990;1;1;1;1;89990;0;0;0;Smartwatch GT 2 BLACK;ACCESORIOS
15793300;;M;37;CHILENO;;Millenial;MAIPU                         ;METROPOLITANA;49990;1;1;0;0;0;1;1;49990;JBL AUDIFONOS ON-EAR BLUETOOTH TUNE 510BT NEGRO;ACCESORIOS
12188829;;F;50;CHILENO;;X;N/D;N/D;219980;2;2;0;0;0;2;2;219980;Parlante Bluetooth Blik Booster 1;ACCESORIOS
14311907;;M;46;CHILENO;;X;N/D;N/D;482160;7;3;5;2;233960;2;1;248200;Parlante Karaoke Blik Screamer 1;ACCESORIOS
19751996;;F;25;CHILENO;;Z;N/D;N/D;9990;1;1;0;0;0;1;1;9990;Mouse Inalambrico M280 Negro;ACCESORIOS
15773564;;M;37;CHILENO;;Millenial;COQUIMBO                      ;COQUIMBO;9093;1;1;0;0;0;1;1;9093;SAMSUNG TYPE-C EARPHONES BLACK;ACCESORIOS
27415924;;M;50;CHILENO;;Extranjero;"";"";111940;5;2;5;2;111940;0;0;0;JBL AUDIFONOS ON-EAR BLUETOOTH TUNE 510BT NEGRO;ACCESORIOS
11185792;;M;54;CHILENO;;Boomers;PROVIDENCIA                   ;METROPOLITANA;14990;1;1;0;0;0;1;1;14990;SAMSUNG TYPE-C EARPHONES WHITE;ACCESORIOS
7641080;;M;61;CHILENO;;Boomers;LOTA                          ;BIO BIO;273850;4;2;0;0;0;4;2;273850;SOPORTE TV 26-56 KTA02 KIOTO FIJO;ACCESORIOS
12014719;;M;41;CHILENO;;Millenial;N/D;N/D;11990;1;1;1;1;11990;0;0;0;Porta audifonos M650;ACCESORIOS
12261558;;F;50;CHILENO;;X;SANTIAGO;METROPOLITANA;48980;2;1;2;1;48980;0;0;0;365 Familia 6 usuarios Anual;ACCESORIOS
14711880;;M;44;CHILENO;;X;PROVIDENCIA                   ;METROPOLITANA;5990;1;1;0;0;0;1;1;5990;Mouse 530 Wireless (PlatinumGrey);ACCESORIOS
17784201;;F;31;CHILENO;;Millenial;NINHUE                        ;BIO BIO;119990;1;1;0;0;0;1;1;119990;Silla Gamer Balderi negra celeste;ACCESORIOS
17930080;Soltero;M;31;CHILENO;;Millenial;PROVIDENCIA                   ;METROPOLITANA;69990;1;1;0;0;0;1;1;69990;DISCO DURO CANVIO 2TB BASICS BLACK TOSHIBA;ACCESORIOS
10112099;;M;55;CHILENO;;Boomers;SAN CLEMENTE                  ;MAULE;24970;3;2;0;0;0;3;2;24970;SOPORTE TV 26-56 KTA02 KIOTO FIJO;ACCESORIOS
19019352;;F;26;CHILENO;;Millenial;RANCAGUA                      ;L.G.B.OÂ´HIGGINS;321980;3;11;1;1;199990;2;10;121990;AUDIFONO MLAB TWS FREE IN-AIR TOUCH BLACK 8534;ACCESORIOS
5939006;;M;73;CHILENO;;Silencioso;NATALES                       ;MAGALLANES;114990;1;1;0;0;0;1;1;114990;Silla Gamer Tyrus Blanco rosadosa;ACCESORIOS
14329543;;M;45;CHILENO;;X;N/D;N/D;320480;4;2;2;1;305480;2;1;15000;AUDIFONO MLAB TWS FREE IN-AIR TOUCH BLACK 8534;ACCESORIOS
6675704;;M;68;CHILENO;;Boomers;EL BOSQUE                     ;METROPOLITANA;326930;7;4;0;0;0;7;4;326930;SOPORTE TV 14-63 CON BRAZO KT-FM 3L;ACCESORIOS
17876606;;M;31;CHILENO;;Millenial;PROVIDENCIA                   ;METROPOLITANA;29990;1;1;1;1;29990;0;0;0;365 Personal Suscripcion Anual;ACCESORIOS
20375702;;M;21;CHILENO;;Z;N/D;N/D;40000;2;1;0;0;0;2;1;40000;FREEBUDS 4i BLACK HUAWEI;ACCESORIOS
9127632;;F;58;CHILENO;;Boomers;PROVIDENCIA                   ;METROPOLITANA;6990;1;1;0;0;0;1;1;6990;SOPORTE TV 26-56 KTA02 KIOTO FIJO;ACCESORIOS
19550265;Soltero;F;25;CHILENO;;Z;PROVIDENCIA                   ;METROPOLITANA;11990;1;1;0;0;0;1;1;11990;SAMSUNG TYPE-C EARPHONES BLACK;ACCESORIOS
19847598;;M;24;CHILENO;;Z;"";"";290970;4;2;2;1;120980;2;1;169990;Escritorio Gamer RGB;ACCESORIOS
20638045;;M;21;CHILENO;;Z;"";"";15000;2;1;0;0;0;2;1;15000;ALTEC LANSING AUDIFONO HEADBAND BLUETOOTH COMFOR;ACCESORIOS
18947834;;F;27;CHILENO;;Millenial;PANGUIPULLI                   ;LOS RIOS;21980;2;1;0;0;0;2;1;21980;TRAVEL ADAPTER 15W - FAST CHARGER (TYPE-C CABLE);ACCESORIOS
19747006;;M;28;CHILENO;;Millenial;NUNOA                         ;METROPOLITANA;44990;3;2;0;0;0;3;2;44990;AUDIFONOS ON-EAR JBL TUNE 500 NEGRO;ACCESORIOS
12020675;;M;45;CHILENO;;Silencioso;PROVIDENCIA                   ;METROPOLITANA;119960;4;1;4;1;119960;0;0;0;365 Familia 6 usuarios Anual;ACCESORIOS
13232583;;F;45;CHILENO;;X;PROVIDENCIA;METROPOLITANA;14990;1;1;0;0;0;1;1;14990;SAMSUNG TYPE-C EARPHONES BLACK;ACCESORIOS
26582474;;M;31;VENEZOLANO;;Extranjero;N/D;N/D;1831810;18;10;17;9;1801820;1;1;29990;AUDIFONO GALAXY BUDS2 VIOLET;ACCESORIOS
26014622;;F;21;EXTRANJERO - NO INFORMA NACIONALIDAD ;;Extranjero;"";"";15000;2;1;0;0;0;2;1;15000;SAMSUNG TYPE-C EARPHONES WHITE;ACCESORIOS
24975127;;M;28;PERUANO;;Extranjero;N/D;N/D;1027400;9;5;2;1;23980;7;4;1003420;SAMSUNG TYPE-C EARPHONES BLACK;ACCESORIOS
18183969;;M;29;CHILENO;;Millenial;CALAMA                        ;ANTOFAGASTA;99990;1;1;0;0;0;1;1;99990;AUDIFONO GALAXY BUDS LIVE NEGRO;ACCESORIOS
18871254;Soltero;M;27;CHILENO;;Millenial;PROVIDENCIA                   ;METROPOLITANA;196980;2;2;1;1;189990;1;1;6990;SOPORTE TV 26-56 KTA02 KIOTO FIJO;ACCESORIOS
6256883;;F;76;CHILENO;;Silencioso;RENGO                         ;L.G.B.OÂ´HIGGINS;189970;3;2;0;0;0;3;2;189970;Escritorio Gamer Pro RGB;ACCESORIOS
18778050;Soltero;M;27;CHILENO;;Millenial;PROVIDENCIA                   ;METROPOLITANA;80970;3;2;2;1;73980;1;1;6990;SOPORTE TV 26-56 KTA02 KIOTO FIJO;ACCESORIOS
19514154;;F;25;CHILENO;;Silencioso;PROVIDENCIA                   ;METROPOLITANA;64990;1;1;0;0;0;1;1;64990;REDMI BUDS 3 PRO (GRAPHITE BLACK);ACCESORIOS
17837562;;F;31;CHILENO;;Millenial;PROVIDENCIA                   ;METROPOLITANA;182970;3;2;2;1;175980;1;1;6990;SOPORTE TV 26-56 KTA02 KIOTO FIJO;ACCESORIOS
6996808;;F;69;CHILENO;;Extranjero;COIHAIQUE                     ;AYSEN;21990;1;1;0;0;0;1;1;21990;SMARTWATCH HUAWEI BAND 4E ACTIVE MINERAL RED;ACCESORIOS
15697400;;M;38;CHILENO;;Silencioso;PROVIDENCIA                   ;METROPOLITANA;42980;2;2;0;0;0;2;2;42980;SOPORTE TV 26-56 KTAT02 KIOTO MOVIL;ACCESORIOS
18895321;;F;27;CHILENO;;Z;"";"";106200;6;7;1;1;119990;5;6;-13790;WebCam 300 FHD;ACCESORIOS
20323569;;M;22;CHILENO;;Z;PROVIDENCIA                   ;METROPOLITANA;349980;2;2;2;2;349980;0;0;0;AUDIFONO GALAXY BUDS2 BLACK;ACCESORIOS
19215468;Soltero;M;26;CHILENO;;Z;PUCON                         ;ARAUCANIA;31000;2;1;0;0;0;2;1;31000;AUDIFONO INALAMBRICO ANC 21 FIDDLER;ACCESORIOS
26383384;;M;30;VENEZOLANO;;Extranjero;SANTIAGO;METROPOLITANA;89990;1;1;0;0;0;1;1;89990;AUDIFONO GALAXY BUDS LIVE NEGRO;ACCESORIOS
9862389;;F;58;CHILENO;;Boomers;COLINA                        ;METROPOLITANA;315970;3;2;0;0;0;3;2;315970;HUAWEI WATCH FIT NEW SAKURA PINK;ACCESORIOS
8900176;;M;62;CHILENO;;Boomers;SAN ANTONIO                   ;VALPARAISO;1454368;10;4;0;0;0;10;4;1454368;Silla Gamer Ymer RGB Negra;ACCESORIOS
17225020;Soltero;M;33;CHILENO;;Millenial;PROVIDENCIA                   ;METROPOLITANA;83980;2;1;2;1;83980;0;0;0;Silla Gamer Tyrus Negra;ACCESORIOS
17240625;;M;32;CHILENO;;Millenial;"";"";3000;2;1;0;0;0;2;1;3000;CABLE MGCATC;ACCESORIOS
18928509;;M;27;CHILENO;;Millenial;PROVIDENCIA                   ;METROPOLITANA;119980;2;1;0;0;0;2;1;119980;MI WATCH NEGRO XIAOMI;ACCESORIOS
20386405;;F;21;CHILENO;;Z;PROVIDENCIA                   ;METROPOLITANA;239981;4;2;0;0;0;4;2;239981;DISCO DURO CANVIO 2TB BASICS BLACK TOSHIBA;ACCESORIOS
18796320;Soltero;F;27;CHILENO;TECNICO SUPERIOR DE ENFERMERIA;Z;LA PINTANA                    ;METROPOLITANA;16980;2;1;2;1;16980;0;0;0;SAMSUNG TYPE-C EARPHONES BLACK;ACCESORIOS
15161215;;M;40;CHILENO;;X;SAN CARLOS                    ;BIO BIO;189960;5;3;0;0;0;5;3;189960;SOPORTE TV 26-56 KTA02 KIOTO FIJO;ACCESORIOS
9887287;Casado;F;58;CHILENO;;Boomers;RENCA                         ;METROPOLITANA;11990;1;1;0;0;0;1;1;11990;SAMSUNG TYPE-C EARPHONES BLACK;ACCESORIOS
13266846;;F;45;CHILENO;;X;PROVIDENCIA                   ;METROPOLITANA;53970;3;1;3;1;53970;0;0;0;CAMARA SMART FIJA NEXXT 1080P;ACCESORIOS
7921160;;M;64;CHILENO;;Boomers;ANTOFAGASTA                   ;ANTOFAGASTA;18990;1;1;0;0;0;1;1;18990;AUDIFONO INALAMBRICO N68 FIDDLER;ACCESORIOS
18585191;Soltero;F;28;CHILENO;;Millenial;PROVIDENCIA                   ;METROPOLITANA;44980;2;1;2;1;44980;0;0;0;HUAWEI FREEBUDS 4i SILVER FROST;ACCESORIOS
7857648;;F;66;CHILENO;;Boomers;N/D;N/D;891960;4;3;1;1;149990;3;2;741970;GALAXY WATCH4 42 MM BLACK;ACCESORIOS
14502299;;M;47;CHILENO;;X;LAJA                          ;BIO BIO;25990;1;1;0;0;0;1;1;25990;PARLANTE KARAOKE MGROCKET NEGRO;ACCESORIOS
16585091;;M;34;CHILENO;;Millenial;SAN PABLO                     ;LOS LAGOS;22990;1;1;1;1;22990;0;0;0;AUDIFONO XIAOMI EARPHONES MI TRUE WIRELESS 2 BAS;ACCESORIOS
15326997;;F;41;CHILENO;;X;N/D;N/D;9990;1;1;0;0;0;1;1;9990;MINI PARLANTE BT GO2;ACCESORIOS
9918553;;F;59;CHILENO;;Boomers;PROVIDENCIA                   ;METROPOLITANA;23980;2;1;2;1;23980;0;0;0;Reloj Smartwatch Casual P9 Negro;ACCESORIOS
17009295;;M;33;CHILENO;;Millenial;N/D;N/D;328950;5;2;3;1;273970;2;1;54980;Galaxy Watch Active4 40 mm Black;ACCESORIOS
16128919;Casado;M;36;CHILENO;;Millenial;PROVIDENCIA                   ;METROPOLITANA;19980;2;1;0;0;0;2;1;19980;TRAVEL ADAPTER 15W - FAST CHARGER (TYPE-C CABLE);ACCESORIOS
8956864;Casado;M;44;CHILENO;DISENADOR GRAFICO;X;RECOLETA                      ;METROPOLITANA;9990;1;1;0;0;0;1;1;9990;TRAVEL ADAPTER 15W - FAST CHARGER (TYPE-C CABLE);ACCESORIOS
20363238;;M;29;CHILENO;;Millenial;SAN CARLOS                    ;BIO BIO;7990;1;1;0;0;0;1;1;7990;Funda Con Cierre 14;ACCESORIOS
16078872;;F;38;CHILENO;;Millenial;N/D;N/D;12990;1;1;0;0;0;1;1;12990;SAMSUNG TYPE-C EARPHONES WHITE;ACCESORIOS
19771449;;M;24;CHILENO;;Z;"";"";13000;2;1;0;0;0;2;1;13000;SAMSUNG TYPE-C EARPHONES BLACK;ACCESORIOS
19882706;;F;24;CHILENO;;Millenial;N/D;N/D;10000;2;1;0;0;0;2;1;10000;AUDIFONO MLAB TWS FULLY WIRELESSÂ  WHITE 8721;ACCESORIOS
19527596;Soltero;M;25;CHILENO;;Millenial;"";"";11000;2;1;0;0;0;2;1;11000;AUDIFONO TEEN FROZEN 2 ELSA+ANNA ALAMBRICO;ACCESORIOS
25170081;;F;36;VENEZOLANO;;Extranjero;SANTIAGO;METROPOLITANA;192970;3;3;2;1;62980;1;2;129990;AUDIFONOS GALAXY BUDS PRO SILVER;ACCESORIOS
13216877;;F;46;CHILENO;;X;RENCA                         ;METROPOLITANA;6993;1;1;0;0;0;1;1;6993;TRAVEL ADAPTER 15W - FAST CHARGER (TYPE-C CABLE);ACCESORIOS
14198592;;F;40;CHILENO;;X;RENCA                         ;METROPOLITANA;12990;1;1;1;1;12990;0;0;0;SAMSUNG TYPE-C EARPHONES BLACK;ACCESORIOS
8172130;;F;64;CHILENO;;Boomers;N/D;N/D;63550;4;2;0;0;0;4;2;63550;SOPORTE TV 14-63 CON BRAZO KT-FM 3L;ACCESORIOS
7922679;;F;63;CHILENO;;Boomers;PENAFLOR                      ;METROPOLITANA;258970;3;5;1;1;169990;2;4;88980;GALAXY WATCH ACTIVE4 40 MM GOLD;ACCESORIOS
17019879;;M;33;CHILENO;;Millenial;ANTOFAGASTA                   ;ANTOFAGASTA;19990;1;1;0;0;0;1;1;19990;20000mAh REDMI 18W FAST CHARGE POWER BANK BLACK;ACCESORIOS
12234427;Casado;F;51;CHILENO;PERIODISTA;X;PROVIDENCIA                   ;METROPOLITANA;205970;3;1;3;1;205970;0;0;0;AUDIFONOS Airpods (MV7N2BE/A);ACCESORIOS
17906172;Soltero;F;31;CHILENO;TECNICO EN TRABAJO SOCIAL;Millenial;INDEPENDENCIA                 ;METROPOLITANA;2990;1;1;0;0;0;1;1;2990;CABLE MGCALIG;ACCESORIOS
11670931;;F;52;CHILENO;;X;RANCAGUA                      ;L.G.B.OÂ´HIGGINS;12990;1;1;0;0;0;1;1;12990;SOPORTE TV 14-42 KTAM02 KIOTO C/ BRAZO MOVIL;ACCESORIOS
9894611;Casado;M;53;CHILENO;;X;RENCA                         ;METROPOLITANA;9992;1;2;0;0;0;1;2;9992;PARLANTE ZUKABASS + MICROFONO MLAB BT;ACCESORIOS
14484627;;F;46;CHILENO;;X;PROVIDENCIA                   ;METROPOLITANA;45980;2;1;0;0;0;2;1;45980;Redmi Buds 3 Lite White;ACCESORIOS
18893703;Soltero;F;27;CHILENO;TECNICO EN ENFERMERIA DE NIVEL SUPERIOR;Millenial;PROVIDENCIA                   ;METROPOLITANA;15980;2;1;0;0;0;2;1;15980;TRAVEL ADAPTER 15W - FAST CHARGER (TYPE-C CABLE);ACCESORIOS
19898268;;F;23;CHILENO;;Z;N/D;N/D;360120;4;4;0;0;0;4;4;360120;20000mAh REDMI 18W FAST CHARGE POWER BANK BLACK;ACCESORIOS
18281245;;F;29;CHILENO;;Millenial;ANCUD                         ;LOS LAGOS;7990;1;1;0;0;0;1;1;7990;SOPORTE TV 26-56 KTAT02 KIOTO MOVIL;ACCESORIOS
6671199;;F;68;CHILENO;;Boomers;N/D;N/D;385952;6;4;0;0;0;6;4;385952;AUDIFONO MOTO BUDBS 100 TRUE WIRELESS WHITE;ACCESORIOS
17469368;;F;31;CHILENO;;Millenial;CALLE LARGA;VALPARAISO;19980;2;1;0;0;0;2;1;19980;AUDIFONO TEEN H AVENGERS IRON MAN ALAMBRICO;ACCESORIOS
13725881;;M;43;CHILENO;;X;COIHAIQUE                     ;AYSEN;299970;3;2;0;0;0;3;2;299970;AUDIFONOS ON-EAR JBL TUNE 500 BLANCO;ACCESORIOS
15918299;;F;37;CHILENO;;Millenial;N/D;N/D;30000;2;1;0;0;0;2;1;30000;ALTEC LANSING AUDIFONO HEADBAND BLUETOOTH COMFOR;ACCESORIOS
19342740;;F;26;CHILENO;;Z;COLINA                        ;METROPOLITANA;26980;2;2;0;0;0;2;2;26980;SOPORTE TV 32-65 KTA03 KIOTO FIJO;ACCESORIOS
20315117;;M;22;CHILENO;;Z;PROVIDENCIA                   ;METROPOLITANA;14990;1;1;1;1;14990;0;0;0;Cooler Pad M2072;ACCESORIOS
16687800;;F;34;CHILENO;;Millenial;PROVIDENCIA                   ;METROPOLITANA;219980;2;1;0;0;0;2;1;219980;AUDIFONOS GALAXY BUDS PRO SILVER;ACCESORIOS
8251794;;F;65;CHILENO;;Boomers;LA LIGUA                      ;VALPARAISO;12990;1;1;0;0;0;1;1;12990;AUDIFONO ON ZX310AP NEGRO;ACCESORIOS
8205666;;F;61;CHILENO;;Boomers;PROVIDENCIA                   ;METROPOLITANA;25980;2;2;0;0;0;2;2;25980;ALTEC LANSING AUDIFONO HEADBAND BLUETOOTH COMFOR;ACCESORIOS
17164868;;M;32;CHILENO;;Millenial;LOS ANDES;VALPARAISO;39990;1;1;0;0;0;1;1;39990;BAND 6 BLACK HUAWEI;ACCESORIOS
19356719;Soltero;M;25;CHILENO;;Z;PROVIDENCIA                   ;METROPOLITANA;22990;1;1;1;1;22990;0;0;0;AUDIFONO XIAOMI EARPHONES MI TRUE WIRELESS 2 BAS;ACCESORIOS
12224123;;F;49;CHILENO;;X;VILLA ALEMANA                 ;VALPARAISO;10990;1;1;0;0;0;1;1;10990;AUDIFONO TEEN FROZEN 2 ELSA+ANNA ALAMBRICO;ACCESORIOS
16212458;Soltero;M;35;CHILENO;;Millenial;PROVIDENCIA                   ;METROPOLITANA;7990;1;5;0;0;0;1;5;7990;AUDIFONO MOTOROLA EARBUDS M. LIBRES METAL NEGRO;ACCESORIOS
12695307;;F;47;CHILENO;;X;SAN FERNANDO                  ;L.G.B.OÂ´HIGGINS;58980;2;2;0;0;0;2;2;58980;DISCO DURO CANVIO 1TB BASICS BLACK TOSHIBA;ACCESORIOS
17188297;Soltero;M;33;CHILENO;ADMINISTRADOR GASTRONOMICO;Millenial;LO BARNECHEA                  ;METROPOLITANA;0;0;2;0;0;0;0;2;0;Kit 4 en 1 Gamer M501;ACCESORIOS
19801443;;M;24;CHILENO;;Millenial;N/D;N/D;3000;2;1;0;0;0;2;1;3000;CABLE MGCALIG;ACCESORIOS
19725015;;M;24;CHILENO;;Z;VILLARICA                     ;ARAUCANIA;24990;1;1;1;1;24990;0;0;0;ALTEC LANSING AUDIFONO Nanobuds TWS 2.0 GRAY BLA;ACCESORIOS
11779002;;F;51;CHILENO;;X;RENCA                         ;METROPOLITANA;154980;2;2;0;0;0;2;2;154980;SAMSUNG TYPE-C EARPHONES BLACK;ACCESORIOS
8100672;;M;63;CHILENO;;Boomers;SAN PEDRO DE LA PAZ           ;BIO BIO;129960;4;2;0;0;0;4;2;129960;Parlante Bluetooth Blik Rockwood;ACCESORIOS
13148669;Casado;M;44;CHILENO;TECNICO DE NIVEL SUPERIOR EN ENFERMERIA;X;SANTA BARBARA                 ;BIO BIO;12990;1;1;0;0;0;1;1;12990;SAMSUNG TYPE-C EARPHONES BLACK;ACCESORIOS
11069177;;F;55;CHILENO;;Boomers;SANTA CRUZ                    ;L.G.B.OÂ´HIGGINS;12990;1;1;0;0;0;1;1;12990;SOPORTE TV 26-56 KTAT02 KIOTO MOVIL;ACCESORIOS
14216811;;F;41;CHILENO;;X;RENCA                         ;METROPOLITANA;24990;1;1;0;0;0;1;1;24990;PARLANTE BLUETOOTH TAS2505B;ACCESORIOS
7880167;;M;64;CHILENO;;Boomers;PROVIDENCIA                   ;METROPOLITANA;6990;1;1;0;0;0;1;1;6990;SOPORTE TV 26-56 KTA02 KIOTO FIJO;ACCESORIOS
26645884;;M;31;VENEZOLANO;;Extranjero;"";"";14990;1;1;0;0;0;1;1;14990;Travel Adapter SFC 25W Type C (w/o Cable);ACCESORIOS
16742975;Soltero;F;34;CHILENO;;Millenial;PROVIDENCIA                   ;METROPOLITANA;7990;1;1;0;0;0;1;1;7990;Mouse Inalambrico M280 Negro;ACCESORIOS
20412774;;M;21;CHILENO;;Z;"";"";402960;4;3;0;0;0;4;3;402960;PARLANTE KARAOKE MGGLADIATOR NEGRO;ACCESORIOS
17242661;Soltero;F;33;CHILENO;;Millenial;"";"";22980;2;1;0;0;0;2;1;22980;CARGADOR CP404;ACCESORIOS
26341806;;M;34;VENEZOLANO;;Extranjero;RANCAGUA                      ;L.G.B.OÂ´HIGGINS;59980;2;1;0;0;0;2;1;59980;BAND 4 BLACK;ACCESORIOS
11156063;;F;54;CHILENO;;Boomers;N/D;N/D;6990;1;1;0;0;0;1;1;6990;AUDIFONO SONY MDRXB550APGCLA VERDE;ACCESORIOS
10614557;;M;51;CHILENO;;X;PROVIDENCIA                   ;METROPOLITANA;22990;1;1;0;0;0;1;1;22990;AUDIFONO XIAOMI EARPHONES MI TRUE WIRELESS 2 BAS;ACCESORIOS
18522226;;M;29;CHILENO;;Millenial;MARIQUINA                     ;LOS LAGOS;14990;1;1;0;0;0;1;1;14990;SAMSUNG TYPE-C EARPHONES WHITE;ACCESORIOS
14022034;;M;40;CHILENO;;X;PARRAL                        ;MAULE;96980;2;2;2;2;96980;0;0;0;SOPORTE TV 26-56 KTAT02 KIOTO MOVIL;ACCESORIOS
15173457;;M;39;CHILENO;;X;TALCAHUANO                    ;BIO BIO;27980;2;2;0;0;0;2;2;27980;ALTEC LANSING AUDIFONO HEADBAND BLUETOOTH COMFOR;ACCESORIOS
14167562;;F;41;CHILENO;;X;PAPUDO                        ;VALPARAISO;213970;3;2;2;1;189980;1;1;23990;KARAOKE MLAB TOWER OUTDOOR MIC BT BK 8568;ACCESORIOS
25189572;;F;51;BOLIVIANO;;Extranjero;N/D;N/D;129980;3;2;0;0;0;3;2;129980;KIT PREPAGO HD DIRECTV;ACCESORIOS
13251820;;M;44;CHILENO;;X;PROVIDENCIA                   ;METROPOLITANA;-90010;1;2;0;0;0;1;2;-90010;SOPORTE TV 14-42 KTAM02 KIOTO C/ BRAZO MOVIL;ACCESORIOS
10859939;;M;55;CHILENO;;Boomers;LA SERENA                     ;COQUIMBO;39990;1;6;0;0;0;1;6;39990;BAND 6 PINK HUAWEI;ACCESORIOS
20400565;;F;22;CHILENO;;Z;CHEPICA;O HIGGINS;203130;3;4;1;1;179990;2;3;23140;AUDIFONO MOTO BUDBS 100 TRUE WIRELESS BLACK;ACCESORIOS
26512620;;M;35;EXTRANJERO - NO INFORMA NACIONALIDAD;;Extranjero;"";"";14990;1;1;0;0;0;1;1;14990;PARLANTE 6986 MLAB VERTICAL STICKERS BT;ACCESORIOS
19009956;Soltero;M;27;CHILENO;;Z;N/D;N/D;97970;3;3;0;0;0;3;3;97970;SOPORTE TV 32-65 KTA03 KIOTO FIJO;ACCESORIOS
16487398;;F;35;CHILENO;;Millenial;N/D;N/D;7990;3;1;0;0;0;3;1;7990;MOUSE GAMER RGB M160;ACCESORIOS
17355445;;M;32;CHILENO;;Silencioso;PROVIDENCIA                   ;METROPOLITANA;12990;1;1;0;0;0;1;1;12990;CARGADOR CP404;ACCESORIOS
6156184;;F;74;CHILENO;;Silencioso;SANTA JUANA                   ;BIO BIO;188300;4;2;0;0;0;4;2;188300;ALTEC LANSING AUDIFONO HEADBAND BLUETOOTH COMFOR;ACCESORIOS
20122479;;M;23;CHILENO;;Z;PROVIDENCIA                   ;METROPOLITANA;0;0;2;0;0;0;0;2;0;ALTEC LANSING AUDIFONO Nano Pods TWS PURPLE 8996;ACCESORIOS
16292698;;M;36;CHILENO;;Millenial;N/D;N/D;8000;2;1;0;0;0;2;1;8000;AUDIFONO MOTOROLA EARBUDS M. LIBRES METAL NEGRO;ACCESORIOS
19332576;;M;26;CHILENO;;Silencioso;PROVIDENCIA                   ;METROPOLITANA;53980;2;1;2;1;53980;0;0;0;HONOR EARBUDS 2 LITE WHITE;ACCESORIOS
15207950;;F;39;CHILENO;;X;PROVIDENCIA                   ;METROPOLITANA;189990;1;1;0;0;0;1;1;189990;GALAXY WATCH4 42 MM SILVER;ACCESORIOS
19092530;;M;27;CHILENO;;Z;PROVIDENCIA                   ;METROPOLITANA;59990;1;1;0;0;0;1;1;59990;New GAMEPAD - GLAP;ACCESORIOS
26706623;Soltero;M;47;EXTRANJERO - NO INFORMA NACIONALIDAD;;Extranjero;"";"";59990;1;1;0;0;0;1;1;59990;MI WATCH LITE NEGRO XIAOMI;ACCESORIOS
14165857;;F;41;CHILENO;;Silencioso;PROVIDENCIA                   ;METROPOLITANA;37960;4;2;4;2;37960;0;0;0;Galaxy SmartTag Basic Pack 1 Black;ACCESORIOS
16315004;;F;40;CHILENO;;X;TEMUCO;ARAUCANIA;144980;2;2;1;1;109990;1;1;34990;AUDIFONO GALAXY BUDS LIVE COBRE;ACCESORIOS
5844784;;M;71;CHILENO;;Silencioso;NATALES                       ;MAGALLANES;92980;2;2;0;0;0;2;2;92980;SOPORTE TV 32-65 KTA03 KIOTO FIJO;ACCESORIOS
17473091;;F;32;CHILENO;;Millenial;PROVIDENCIA                   ;METROPOLITANA;9990;1;1;0;0;0;1;1;9990;SOPORTE TV 32-65 KTA03 KIOTO FIJO;ACCESORIOS
20602442;;M;21;CHILENO;;Z;PROVIDENCIA                   ;METROPOLITANA;24980;2;2;1;1;14990;1;1;9990;SAMSUNG TYPE-C EARPHONES BLACK;ACCESORIOS
18577553;;F;28;CHILENO;;Millenial;"";"";12990;1;1;0;0;0;1;1;12990;PARLANTE ZUKABASS + MICROFONO MLAB BT;ACCESORIOS
19110983;;F;26;CHILENO;;Z;"";"";12140;3;1;0;0;0;3;1;12140;AUDIFONO TEEN SPIDERMAN ALAMBRICO;ACCESORIOS
14109374;Soltero;F;40;CHILENO;CHEF;X;PROVIDENCIA                   ;METROPOLITANA;26970;3;2;0;0;0;3;2;26970;SAMSUNG TYPE-C EARPHONES BLACK;ACCESORIOS
17234908;Soltero;F;33;CHILENO;PROFESOR;Millenial;PROVIDENCIA                   ;METROPOLITANA;2990;1;1;0;0;0;1;1;2990;CABLE MGCATC;ACCESORIOS
17030300;;F;33;CHILENO;;Millenial;CONSTITUCION                  ;MAULE;20990;1;1;0;0;0;1;1;20990;PARLANTE 8247 MLAB SOUNDLAB BLACK;ACCESORIOS
12363472;;F;52;CHILENO;;X;PROVIDENCIA                   ;METROPOLITANA;7990;1;1;0;0;0;1;1;7990;AUDIFONO MOTOROLA EARBUDS M. LIBRES METAL NEGRO;ACCESORIOS
14415405;;F;52;CHILENO;;X;RENCA                         ;METROPOLITANA;9990;1;1;0;0;0;1;1;9990;SOPORTE TV 32-65 KTA03 KIOTO FIJO;ACCESORIOS
13768563;;M;42;CHILENO;;X;"";"";22990;1;1;0;0;0;1;1;22990;PARLANTE KARAOKE MGGLADIATOR NEGRO;ACCESORIOS
20412790;;M;21;CHILENO;;Z;PROVIDENCIA                   ;METROPOLITANA;7990;1;1;1;1;7990;0;0;0;PARLANTE BLUETOOTH BABYBOOM XL;ACCESORIOS
19538354;;M;25;CHILENO;;Z;CALAMA                        ;ANTOFAGASTA;16990;1;1;0;0;0;1;1;16990;MLAB KARAOKE OUTDOOR FUN GREEN 8564;ACCESORIOS
17072980;;F;33;CHILENO;;Millenial;COLINA                        ;METROPOLITANA;11990;1;1;0;0;0;1;1;11990;AUDIFONO MANOS LIBRES MOTOROLA SQUADS 200 ROSADO;ACCESORIOS
13957654;;M;42;CHILENO;;X;PROVIDENCIA                   ;METROPOLITANA;14990;1;1;0;0;0;1;1;14990;Travel Adapter SFC 25W Type C (w/o Cable);ACCESORIOS
26383566;;F;29;EXTRANJERO - NO INFORMA NACIONALIDAD;;Extranjero;"";"";8990;1;1;0;0;0;1;1;8990;MEMORIA MICROSD CLASE 10 64GB SANDISK;ACCESORIOS
8866482;;M;60;CHILENO;;Boomers;MAIPU                         ;METROPOLITANA;2990;1;1;0;0;0;1;1;2990;CABLE MGCAMIC;ACCESORIOS
18135512;;F;30;CHILENO;;Millenial;N/D;N/D;426562;4;3;0;0;0;4;3;426562;PARLANTE KARAOKE MGROCKET NEGRO;ACCESORIOS
16042587;;F;37;CHILENO;;Millenial;N/D;N/D;5990;1;1;0;0;0;1;1;5990;Funda Reversible Fucsia/Negro 15;ACCESORIOS
13397640;Soltero;M;47;CHILENO;;Silencioso;PROVIDENCIA                   ;METROPOLITANA;6990;1;1;0;0;0;1;1;6990;SOPORTE TV 26-56 KTAT02 KIOTO MOVIL;ACCESORIOS
15046562;;F;40;CHILENO;;X;SALAMANCA                     ;COQUIMBO;306960;4;3;1;1;8990;3;2;297970;GALAXY WATCH4 42 MM BLACK;ACCESORIOS
16569945;;F;35;CHILENO;;Millenial;PROVIDENCIA                   ;METROPOLITANA;23970;3;1;3;1;23970;0;0;0;PARLANTE BLUETOOTH BABYBOOM XL;ACCESORIOS
19363660;;F;25;CHILENO;;Millenial;PROVIDENCIA                   ;METROPOLITANA;21990;1;1;0;0;0;1;1;21990;AUDIFONO INALAMBRICO N68 FIDDLER;ACCESORIOS
12801168;;M;47;CHILENO;;X;PROVIDENCIA                   ;METROPOLITANA;22990;1;1;1;1;22990;0;0;0;AUDIFONO MOTOROLA BLUETOOTH ESCAPE 220 BLANCO;ACCESORIOS
18182807;;F;30;CHILENO;;Millenial;N/D;N/D;14990;1;1;0;0;0;1;1;14990;AUDIFONO BLUETOOTH SPIDERMAN;ACCESORIOS
15351420;;F;39;CHILENO;;X;"";"";51980;2;1;0;0;0;2;1;51980;PARLANTE PL2 XBOOM GO BLUETHOOH 2020;ACCESORIOS
16520634;;M;35;CHILENO;;Millenial;PROVIDENCIA                   ;METROPOLITANA;19980;2;1;0;0;0;2;1;19980;SOPORTE TV 14-42 KTAM02 KIOTO C/ BRAZO MOVIL;ACCESORIOS
17390344;;M;32;CHILENO;;Millenial;PUDAHUEL;METROPOLITANA;73980;2;1;2;1;73980;0;0;0;DISCO DURO CANVIO 2TB ADVANCE NEGRO;ACCESORIOS
12675010;;M;48;CHILENO;;X;SAN RAMON;METROPOLITANA;169990;1;1;1;1;169990;0;0;0;GALAXY WATCH4 42 MM SILVER;ACCESORIOS
17305715;;F;32;CHILENO;;Millenial;PROVIDENCIA                   ;METROPOLITANA;219980;3;2;3;2;219980;0;0;0;Galaxy Watch4 46 mm Black;ACCESORIOS
18146940;;F;30;CHILENO;;Millenial;SAN PEDRO DE LA PAZ           ;BIO BIO;8140;2;1;0;0;0;2;1;8140;AUDIFONO KIDS FROZEN 2 ANNA ALAMBRICO;ACCESORIOS
19306518;;M;26;CHILENO;;Z;SANTIAGO                      ;METROPOLITANA;164924;8;4;6;3;124940;2;1;39984;Cooler Pad M2072;ACCESORIOS
18717339;;F;28;CHILENO;;Millenial;BUIN                          ;METROPOLITANA;88960;4;3;0;0;0;4;3;88960;ALTEC LANSING AUDIFONO HEADBAND BLUETOOTH COMFOR;ACCESORIOS
17291092;;M;33;CHILENO;;Millenial;RENCA                         ;METROPOLITANA;0;0;2;1;1;14990;-1;1;-14990;AUDIFONO SAMSUNG WIRELESS A08C;ACCESORIOS
9679404;;M;59;CHILENO;;Boomers;SAN BERNARDO;METROPOLITANA;94990;1;1;0;0;0;1;1;94990;Silla Gamer Python Roja;ACCESORIOS
12477475;;F;48;CHILENO;;X;RENCA                         ;METROPOLITANA;189990;1;1;1;1;189990;0;0;0;GALAXY WATCH ACTIVE4 40 MM SILVER;ACCESORIOS
19346102;;F;26;CHILENO;;Z;N/D;N/D;9990;1;1;0;0;0;1;1;9990;AUDIFONO TEEN FROZEN 2 ELSA+ANNA ALAMBRICO;ACCESORIOS
11465503;;F;53;CHILENO;;X;CALAMA                        ;ANTOFAGASTA;19990;1;1;0;0;0;1;1;19990;KARAOKE MLAB TOWER OUTDOOR MIC BT BK 8568;ACCESORIOS
10218474;;M;55;CHILENO;;Boomers;ILLAPEL                       ;COQUIMBO;399980;2;1;0;0;0;2;1;399980;GALAXY WATCH4 42 MM SILVER;ACCESORIOS
17134458;;F;33;CHILENO;;Millenial;PROVIDENCIA;METROPOLITANA;7990;1;1;0;0;0;1;1;7990;Funda Con Cierre 14;ACCESORIOS
11231455;;M;53;CHILENO;;X;RENCA                         ;METROPOLITANA;189990;1;1;0;0;0;1;1;189990;GALAXY WATCH ACTIVE4 40 MM GOLD;ACCESORIOS
16008420;;F;39;CHILENO;;X;NATALES                       ;MAGALLANES;327980;2;2;0;0;0;2;2;327980;SOPORTE TV 26-56 KTAT02 KIOTO MOVIL;ACCESORIOS
18318747;;F;30;CHILENO;;Millenial;ANGOL;ARAUCANIA;269960;4;4;4;4;269960;0;0;0;BAND 6 BLACK HUAWEI;ACCESORIOS
9264375;;F;60;CHILENO;;Boomers;CALAMA                        ;ANTOFAGASTA;203970;3;1;0;0;0;3;1;203970;GALAXY WATCH ACTIVE4 40 MM SILVER;ACCESORIOS
16260886;;F;36;CHILENO;;Millenial;PROVIDENCIA                   ;METROPOLITANA;109990;1;1;0;0;0;1;1;109990;SILLA GAMER LEGI LBLU;ACCESORIOS
14019343;;F;40;CHILENO;;Extranjero;"";"";8990;1;1;0;0;0;1;1;8990;PARLANTE 7284 MLAB ZUKABASS NARAN/VERDE BT;ACCESORIOS
15964538;;F;38;CHILENO;;Millenial;LA PINTANA                    ;METROPOLITANA;23980;2;1;2;1;23980;0;0;0;Mouse Gaming G203 Blanco;ACCESORIOS
5132114;;F;76;CHILENO;;Silencioso;ALTO HOSPICIO;TARAPACA;529370;4;2;0;0;0;4;2;529370;PARLANTE KARAOKE MGROCKET NEGRO;ACCESORIOS
16461357;;F;35;CHILENO;;Millenial;PROVIDENCIA                   ;METROPOLITANA;19990;1;1;0;0;0;1;1;19990;AUDIFONO XIAOMI EARBUDS MI TRUE WIRELESS BASIC 2;ACCESORIOS
19830194;;F;24;CHILENO;;Z;PROVIDENCIA                   ;METROPOLITANA;200500;5;2;5;2;200500;0;0;0;Funda Con Cierre 14;ACCESORIOS
16525748;;M;36;CHILENO;;Millenial;SAN BERNARDO                  ;METROPOLITANA;16990;1;1;0;0;0;1;1;16990;SOPORTE TV 14-42 KTAM02 KIOTO C/ BRAZO MOVIL;ACCESORIOS
19653199;Soltero;F;33;CHILENO;;Millenial;CHILLAN                       ;BIO BIO;109990;1;1;0;0;0;1;1;109990;SILLA GAMER LEGI LBLU;ACCESORIOS
15187198;;F;40;CHILENO;;X;PROVIDENCIA                   ;METROPOLITANA;13990;1;1;0;0;0;1;1;13990;AUDIFONO SAMSUNG WIRELESS 103B;ACCESORIOS
13904746;;F;42;CHILENO;;Millenial;"";"";14990;1;1;0;0;0;1;1;14990;AUDIFONO TEEN SPIDERMAN ALAMBRICO;ACCESORIOS
16004660;;M;36;CHILENO;;Millenial;BUIN                          ;METROPOLITANA;182980;2;2;0;0;0;2;2;182980;AUDIFONO MOTO BUDBS 100 TRUE WIRELESS WHITE;ACCESORIOS
19839477;;M;24;CHILENO;;Z;PROVIDENCIA                   ;METROPOLITANA;19990;1;1;0;0;0;1;1;19990;Mouse G203 LIGHTSYNC Gaming - BLACK;ACCESORIOS
20232189;;M;22;CHILENO;;Z;PROVIDENCIA                   ;METROPOLITANA;31980;2;2;2;2;31980;0;0;0;AUDIFONO XIAOMI EARBUDS MI TRUE WIRELESS BASIC 2;ACCESORIOS
17416110;;M;32;CHILENO;;Millenial;N/D;N/D;7990;1;1;0;0;0;1;1;7990;SOPORTE TV 26-56 KTA02 KIOTO FIJO;ACCESORIOS
19534708;;M;24;CHILENO;;Z;PENCO                         ;BIO BIO;85840;2;1;2;1;85840;0;0;0;AUDIFONO GALAXY BUDS LIVE NEGRO;ACCESORIOS
15541621;;F;38;CHILENO;;X;MAIPU                         ;METROPOLITANA;4990;1;1;0;0;0;1;1;4990;AUDIFONO MOTO EARBUDS 2 MANOS LIBRES NEGRO;ACCESORIOS
18339333;;F;29;CHILENO;;Millenial;EL BOSQUE;METROPOLITANA;21990;1;1;0;0;0;1;1;21990;AUDIFONO INALAMBRICO N68 FIDDLER;ACCESORIOS
16125884;;M;36;CHILENO;;Millenial;MAIPU                         ;METROPOLITANA;24990;1;1;0;0;0;1;1;24990;BANDA GALAXY FIT E NEGRO;ACCESORIOS
10672633;;F;57;CHILENO;;Boomers;CALBUCO                       ;LOS LAGOS;14990;1;1;0;0;0;1;1;14990;SOPORTE TV 14-42 KTAM02 KIOTO C/ BRAZO MOVIL;ACCESORIOS
12315289;;M;49;CHILENO;;X;RENGO                         ;L.G.B.OÂ´HIGGINS;8990;1;1;0;0;0;1;1;8990;Mouse Gamer BTS;ACCESORIOS
20462671;;M;22;CHILENO;;Z;PROVIDENCIA                   ;METROPOLITANA;6990;1;1;0;0;0;1;1;6990;Audifonos Orejas De Gato Rosado;ACCESORIOS
11812023;;F;51;CHILENO;;X;PENAFLOR                      ;METROPOLITANA;189990;1;1;0;0;0;1;1;189990;Galaxy Watch Active4 40 mm Black;ACCESORIOS
10426742;Casado;M;57;CHILENO;;Boomers;PROVIDENCIA                   ;METROPOLITANA;49990;1;1;0;0;0;1;1;49990;DISCO DURO CANVIO 1TB BASICS BLACK TOSHIBA;ACCESORIOS
8934264;;M;57;CHILENO;;Boomers;ANTOFAGASTA                   ;ANTOFAGASTA;579980;2;1;0;0;0;2;1;579980;GALAXY WATCH4 42 MM BLACK;ACCESORIOS
12052501;;M;43;CHILENO;;X;N/D;N/D;8990;1;1;0;0;0;1;1;8990;PARLANTE 7284 MLAB ZUKABASS NARAN/VERDE BT;ACCESORIOS
11406351;;F;53;CHILENO;;X;ARAUCO                        ;BIO BIO;138980;2;2;1;1;129990;1;1;8990;SOPORTE TV 26-56 KTA02 KIOTO FIJO;ACCESORIOS
16206091;;F;37;CHILENO;;Millenial;ANCUD                         ;LOS LAGOS;227970;3;3;2;2;208980;1;1;18990;AUDIFONO XIAOMI EARBUDS MI TRUE WIRELESS BASIC 2;ACCESORIOS
16135496;;M;36;CHILENO;;Millenial;N/D;N/D;839930;7;2;0;0;0;7;2;839930;SOPORTE TV 26-56 KTAT02 KIOTO MOVIL;ACCESORIOS
16720996;Casado;M;35;CHILENO;;Millenial;PROVIDENCIA                   ;METROPOLITANA;35980;2;2;0;0;0;2;2;35980;PARLANTE KARAOKE MGPANTERA NEGRO;ACCESORIOS
6535839;;M;68;CHILENO;;Boomers;TOCOPILLA                     ;ANTOFAGASTA;16980;2;2;0;0;0;2;2;16980;SOPORTE TV 32-65 KTA03 KIOTO FIJO;ACCESORIOS
9710886;;F;61;CHILENO;;Boomers;ILLAPEL                       ;COQUIMBO;403970;3;3;0;0;0;3;3;403970;SOPORTE TV 14-63 CON BRAZO KT-FM 3L;ACCESORIOS
15352477;;M;39;CHILENO;;X;PROVIDENCIA                   ;METROPOLITANA;29990;1;1;1;1;29990;0;0;0;TECLADO GAMER MECANICO RGB GK100;ACCESORIOS
17282513;Soltero;M;32;CHILENO;;Millenial;PROVIDENCIA                   ;METROPOLITANA;14990;1;1;0;0;0;1;1;14990;Travel Adapter SFC 25W Type C (w/o Cable);ACCESORIOS
10885491;;M;53;CHILENO;;X;LAS CABRAS                    ;L.G.B.OÂ´HIGGINS;12990;1;1;0;0;0;1;1;12990;MINI PARLANTE BT GO2;ACCESORIOS
16291870;;F;36;CHILENO;;Millenial;MELIPILLA                     ;METROPOLITANA;7990;1;1;0;0;0;1;1;7990;SOPORTE TV 26-56 KTA02 KIOTO FIJO;ACCESORIOS
25319263;;F;54;PERUANO;;Extranjero;SANTIAGO                      ;METROPOLITANA;17990;1;1;0;0;0;1;1;17990;SMARTWATCH HUAWEI BAND 4E ACTIVE MINERAL RED;ACCESORIOS
17470796;;F;32;CHILENO;;Millenial;SAN FERNANDO                  ;L.G.B.OÂ´HIGGINS;189990;1;1;0;0;0;1;1;189990;Galaxy Watch Active4 40 mm Black;ACCESORIOS
7408589;;M;65;CHILENO;;Boomers;ARICA                         ;ARICA Y PARINACOTA;454180;3;2;0;0;0;3;2;454180;PARLANTE 7284 MLAB ZUKABASS NARAN/VERDE BT;ACCESORIOS
13354501;Casado;M;43;CHILENO;;X;RENCA                         ;METROPOLITANA;139980;2;1;2;1;139980;0;0;0;Disco Externo Elements Portable SE 2TB;ACCESORIOS
20318432;;M;22;CHILENO;;Z;PROVIDENCIA                   ;METROPOLITANA;18990;1;1;0;0;0;1;1;18990;AUDIFONO XIAOMI EARBUDS MI TRUE WIRELESS BASIC 2;ACCESORIOS
17300563;;F;32;CHILENO;;Millenial;SAN FELIPE                    ;VALPARAISO;17990;1;1;0;0;0;1;1;17990;SOPORTE TV 14-63 CON BRAZO KT-FM 3L;ACCESORIOS
25888057;;M;32;COLOMBIANO;;Extranjero;"";"";8990;1;1;0;0;0;1;1;8990;AUDIFONO IN EX15LP SONY NEG;ACCESORIOS
12762080;Soltero;F;47;CHILENO;TECNICO DE NIVEL SUPERIOR EN ENFERMERIA;X;PROVIDENCIA                   ;METROPOLITANA;5990;1;1;0;0;0;1;1;5990;AUDIFONO IN SAM HS1303C/ MIC AZUL;ACCESORIOS
9199808;;F;58;CHILENO;;Boomers;CORONEL                       ;BIO BIO;33990;1;1;0;0;0;1;1;33990;Repetidor Wifi AC1200 2 antenas Externas;ACCESORIOS
13413929;;F;43;CHILENO;;X;N/D;N/D;75970;3;3;0;0;0;3;3;75970;BAND 4 AMBER SUNRISE;ACCESORIOS
18958086;;F;27;CHILENO;;Z;VALDIVIA                      ;LOS LAGOS;109990;1;1;0;0;0;1;1;109990;Smartwatch GT 2 BLACK;ACCESORIOS
14508353;;F;45;CHILENO;;X;SAN CLEMENTE                  ;MAULE;13990;1;1;0;0;0;1;1;13990;AUDIFONO SAMSUNG WIRELESS A08C;ACCESORIOS
26358746;;F;37;COLOMBIANO;;Extranjero;HUALPEN;BIO BIO;44990;1;1;0;0;0;1;1;44990;FREEBUDS 4i BLACK HUAWEI;ACCESORIOS
8860873;Casado;M;61;CHILENO;;Boomers;PROVIDENCIA                   ;METROPOLITANA;153980;2;1;2;1;153980;0;0;0;AUDIFONOS GALAXY BUDS PRO VIOLET;ACCESORIOS
17556858;;F;31;CHILENO;;Millenial;ARICA                         ;ARICA Y PARINACOTA;4990;1;1;0;0;0;1;1;4990;MOUSE 100 WIRED;ACCESORIOS
9692013;;M;55;CHILENO;;Boomers;RENCA                         ;METROPOLITANA;11990;1;1;0;0;0;1;1;11990;SOPORTE INCLINABLE 37-70 PULGADAS + CABLE;ACCESORIOS
17408768;Soltero;F;31;CHILENO;INGENIERO COMERCIAL;Millenial;PROVIDENCIA                   ;METROPOLITANA;203980;2;1;2;1;203980;0;0;0;Galaxy Watch Active4 44 mm Black;ACCESORIOS
26069984;;M;35;VENEZOLANO;;Extranjero;QUINTA NORMAL;METROPOLITANA;6990;1;1;0;0;0;1;1;6990;SOPORTE TV 26-56 KTAT02 KIOTO MOVIL;ACCESORIOS
12001529;;F;58;CHILENO;;Boomers;SAN CLEMENTE                  ;MAULE;6990;1;1;0;0;0;1;1;6990;SOPORTE TV 26-56 KTAT02 KIOTO MOVIL;ACCESORIOS
19945622;;F;23;CHILENO;;Z;PROVIDENCIA                   ;METROPOLITANA;15980;2;3;2;1;15980;0;2;0;AUDIFONO HEADBAND BT NEGRO;ACCESORIOS
13754933;;M;41;CHILENO;;X;PROVIDENCIA                   ;METROPOLITANA;30000;2;1;0;0;0;2;1;30000;SOPORTE TV 14-42 KTAM02 KIOTO C/ BRAZO MOVIL;ACCESORIOS
18679284;Soltero;F;27;CHILENO;;Millenial;PROVIDENCIA                   ;METROPOLITANA;7990;1;1;0;0;0;1;1;7990;MINI PODS TOUCH FIDDLER;ACCESORIOS
9149808;;F;52;CHILENO;;X;VALDIVIA                      ;LOS RIOS;13990;1;1;0;0;0;1;1;13990;ITFIT Tripode Selfie Stick;ACCESORIOS
18423696;;F;29;CHILENO;;Millenial;HUECHURABA                    ;METROPOLITANA;93980;2;1;2;1;93980;0;0;0;SILLA GAMER LEG PURPL;ACCESORIOS
17087809;;M;33;CHILENO;;Silencioso;PROVIDENCIA                   ;METROPOLITANA;18980;2;1;2;1;18980;0;0;0;BATERY PACK TIPO C 10.000 MAH SAMSUNG;ACCESORIOS
12632896;;M;48;CHILENO;;X;SAN JOAQUIN                   ;METROPOLITANA;178960;4;2;4;2;178960;0;0;0;MI Bluetooth Speaker (16W) BLUE;ACCESORIOS
19406498;;F;26;CHILENO;;Z;PROVIDENCIA                   ;METROPOLITANA;267970;3;1;3;1;267970;0;0;0;GALAXY WATCH ACTIVE4 40 MM GOLD;ACCESORIOS
26846760;;F;50;VENEZOLANO;;Extranjero;N/D;N/D;12990;1;1;0;0;0;1;1;12990;AUDIFONO SAMSUNG WIRELESS 103B;ACCESORIOS
18560807;;F;28;CHILENO;;Millenial;TENO                          ;MAULE;22980;2;2;0;0;0;2;2;22980;TWS EARPHONE WITH CHARGING CASE NEGRO FIDDLER;ACCESORIOS
20130329;;M;23;CHILENO;;Z;HUECHURABA                    ;METROPOLITANA;18980;2;1;2;1;18980;0;0;0;Kit gamer 3 en 1;ACCESORIOS
16396752;;F;35;CHILENO;;Millenial;PROVIDENCIA                   ;METROPOLITANA;59990;1;1;1;1;59990;0;0;0;PARLANTE PL5 XBOOM GO BLUETHOOH 2020;ACCESORIOS
11891382;;M;50;CHILENO;;X;PEUMO                         ;L.G.B.OÂ´HIGGINS;67990;1;1;0;0;0;1;1;67990;PARLANTE FLIP ESSENTIAL BLUETOOTH;ACCESORIOS
19072445;;F;26;CHILENO;;Z;"";"";1990;1;1;0;0;0;1;1;1990;AUDIFONO PANASONIC IN RP-HV096E-K NEGRO;ACCESORIOS
18055402;;M;29;CHILENO;;Millenial;EL BOSQUE                     ;METROPOLITANA;22990;1;1;0;0;0;1;1;22990;PARLANTE 8247 MLAB SOUNDLAB BLACK;ACCESORIOS
16820373;;M;34;CHILENO;;Millenial;PROVIDENCIA                   ;METROPOLITANA;14990;1;1;1;1;14990;0;0;0;BATERY PACK TIPO C 10.000 MAH SAMSUNG;ACCESORIOS
19984071;;F;24;CHILENO;;Z;PROVIDENCIA                   ;METROPOLITANA;9990;1;1;0;0;0;1;1;9990;AUDIFONO IN PANASONIC RP-TCM130PPW BLANCO;ACCESORIOS
16684923;Soltero;M;35;CHILENO;;Millenial;SAN ANTONIO                   ;VALPARAISO;14990;1;1;0;0;0;1;1;14990;Travel Adapter SFC 25W Type C (w/o Cable);ACCESORIOS
19278851;Soltero;F;26;CHILENO;;Z;PROVIDENCIA                   ;METROPOLITANA;6990;1;1;0;0;0;1;1;6990;Funda Reversible Fucsia/Negro 14;ACCESORIOS
25062734;;M;34;PERUANO;;Extranjero;LAS CONDES;METROPOLITANA;507960;4;2;4;2;507960;0;0;0;HONOR WATCH GS PRO BLACK;ACCESORIOS
14042929;;M;41;CHILENO;;X;COIHAIQUE                     ;AYSEN;12990;1;1;0;0;0;1;1;12990;SOPORTE TV 32-65 KTA03 KIOTO FIJO;ACCESORIOS
16261111;;M;36;CHILENO;;Millenial;SANTA CRUZ;O HIGGINS;94540;2;1;2;1;94540;0;0;0;PARLANTE PL7 XBOOM GO BLUETHOOH 2020;ACCESORIOS
8217969;;M;62;CHILENO;;Boomers;CALAMA                        ;ANTOFAGASTA;29990;1;1;0;0;0;1;1;29990;PARLANTE PL2 XBOOM GO BLUETHOOH 2020;ACCESORIOS
12105032;;M;52;CHILENO;;X;N/D;N/D;147950;5;5;0;0;0;5;5;147950;AUDIFONO IN EX15AP SONY NEGRO;ACCESORIOS
20031489;;F;23;CHILENO;;Z;N/D;N/D;9990;1;1;0;0;0;1;1;9990;TRAVEL ADAPTER 15W - FAST CHARGER (TYPE-C CABLE);ACCESORIOS
12916887;Casado;M;47;CHILENO;TECNICO JURIDICO;Silencioso;PROVIDENCIA                   ;METROPOLITANA;20980;2;1;2;1;20980;0;0;0;Teclado + Mouse Gamer Negro Retroiluminado;ACCESORIOS
17773842;Soltero;M;31;CHILENO;;Millenial;PROVIDENCIA                   ;METROPOLITANA;287290;3;1;3;1;287290;0;0;0;Galaxy Watch Active4 44 mm Black;ACCESORIOS
9229386;;M;61;CHILENO;;Boomers;SAN BERNARDO                  ;METROPOLITANA;168860;3;1;0;0;0;3;1;168860;Silla Gamer Guardian Roja;ACCESORIOS
15250484;;M;44;CHILENO;;X;GORBEA                        ;ARAUCANIA;18392;1;1;0;0;0;1;1;18392;PARLANTE KARAOKE MGROCKET NEGRO;ACCESORIOS
24263873;;M;33;BOLIVIANO;;Extranjero;ARICA                         ;ARICA Y PARINACOTA;954960;3;4;0;0;0;3;4;954960;TRAVEL ADAPTER 15W - FAST CHARGER (TYPE-C CABLE);ACCESORIOS
16069435;;F;37;CHILENO;;Millenial;N/D;N/D;490;1;1;0;0;0;1;1;490;AUDIFONO MLAB IN ISPORT HOOK M.LIBRES RED 7738;ACCESORIOS
12021507;;M;55;CHILENO;;Boomers;RENCA                         ;METROPOLITANA;29990;1;1;0;0;0;1;1;29990;AUDIFONO IN SONY BT WI-C200 WHITE;ACCESORIOS
9427307;;M;59;CHILENO;;Silencioso;PROVIDENCIA                   ;METROPOLITANA;17990;1;1;0;0;0;1;1;17990;SOPORTE TV 14-63 CON BRAZO KT-FM 3L;ACCESORIOS
15821435;;M;38;CHILENO;;Silencioso;PROVIDENCIA                   ;METROPOLITANA;277970;3;1;3;1;277970;0;0;0;Galaxy Watch Active4 44 mm Black;ACCESORIOS
20155925;;M;22;CHILENO;;Z;"";"";69990;1;1;0;0;0;1;1;69990;XIAOMI MI TRUE WIRELESS EARPHONES 2S;ACCESORIOS
12734349;;M;47;CHILENO;;X;CANETE                        ;BIO BIO;159990;1;1;0;0;0;1;1;159990;SILLA GAMER RACING PRO - NEGRO;ACCESORIOS
19601428;;M;24;CHILENO;;Z;PROVIDENCIA                   ;METROPOLITANA;1690;1;1;0;0;0;1;1;1690;AUDIFONO PANASONIC IN RP-HV096E-K NEGRO;ACCESORIOS
14439947;;M;58;CHILENO;;Boomers;PAILLACO                      ;LOS RIOS;1690;1;1;0;0;0;1;1;1690;AUDIFONO PANASONIC IN RP-HV096E-K NEGRO;ACCESORIOS
15752220;;F;38;CHILENO;;Millenial;VALPARAISO                    ;VALPARAISO;99990;1;1;0;0;0;1;1;99990;Silla Gamer Python Roja;ACCESORIOS
13593230;;M;43;CHILENO;;X;N/D;N/D;21990;1;1;0;0;0;1;1;21990;KIT PREPAGO HD DIRECTV;ACCESORIOS
14384154;;F;42;CHILENO;;X;PROVIDENCIA                   ;METROPOLITANA;19990;1;1;0;0;0;1;1;19990;SOPORTE ARTICULADO FULL MOTION 32-55 PULGADAS;ACCESORIOS
12337322;;F;49;CHILENO;;X;"";"";16990;1;1;0;0;0;1;1;16990;SOPORTE TV 14-42 KTAM02 KIOTO C/ BRAZO MOVIL;ACCESORIOS
16580065;;M;34;CHILENO;;Millenial;SAN RAMON                     ;METROPOLITANA;83980;2;1;2;1;83980;0;0;0;PARLANTE PL7 XBOOM GO BLUETHOOH 2020;ACCESORIOS
17986703;;F;30;CHILENO;;Millenial;MELIPILLA                     ;METROPOLITANA;7990;1;1;0;0;0;1;1;7990;SOPORTE TV 26-56 KTA02 KIOTO FIJO;ACCESORIOS
12032748;;F;54;CHILENO;;X;HIJUELAS                      ;VALPARAISO;14990;1;1;0;0;0;1;1;14990;SOPORTE TV 14-42 KTAM02 KIOTO C/ BRAZO MOVIL;ACCESORIOS
13610666;;M;43;CHILENO;;X;AISEN                         ;AYSEN;9990;1;1;0;0;0;1;1;9990;TRAVEL ADAPTER 15W - FAST CHARGER (TYPE-C CABLE);ACCESORIOS
20028531;;F;23;CHILENO;;Z;"";"";39540;2;1;2;1;39540;0;0;0;EXPRESS MOD 3930 PURPLE;ACCESORIOS
10460134;;F;53;CHILENO;;X;PROVIDENCIA                   ;METROPOLITANA;14990;1;1;0;0;0;1;1;14990;SOPORTE TV 14-42 KTAM02 KIOTO C/ BRAZO MOVIL;ACCESORIOS
19462612;Casado;F;25;CHILENO;;Millenial;N/D;N/D;19990;1;1;0;0;0;1;1;19990;SOPORTE ARTICULADO FULL MOTION 32-55 PULGADAS;ACCESORIOS
13944863;;F;41;CHILENO;;X;N/D;N/D;0;0;0;0;0;0;0;0;0;PARLANTE 8531 MLAB MAX BASS BT;ACCESORIOS
17063886;;M;33;CHILENO;;Silencioso;PROVIDENCIA                   ;METROPOLITANA;0;0;0;0;0;0;0;0;0;SOPORTE TV 14-63 CON BRAZO KT-FM 3L;ACCESORIOS
21862648;;M;33;PERUANO;;Extranjero;N/D;N/D;0;0;0;0;0;0;0;0;0;BATERY PACK TIPO C 10.000 MAH SAMSUNG;ACCESORIOS
19561754;;F;24;CHILENO;;Z;RANCAGUA                      ;L.G.B.OÂ´HIGGINS;0;0;0;0;0;0;0;0;0;AUDIFONOS IN HUAWEI METALICO;ACCESORIOS
15276862;;F;36;CHILENO;;Millenial;N/D;N/D;0;0;0;0;0;0;0;0;0;Funda Con Cierre 15;ACCESORIOS
20144837;;M;23;CHILENO;;Z;PROVIDENCIA                   ;METROPOLITANA;0;0;0;0;0;0;0;0;0;AUDIFONO GALAXY BUDS PLUS NEGRO;ACCESORIOS
19059246;;F;26;CHILENO;;Z;PROVIDENCIA                   ;METROPOLITANA;0;0;0;0;0;0;0;0;0;Mi True Wireless Earphones 2 Basic XIAOMI;ACCESORIOS
18432581;;F;28;CHILENO;;Millenial;PROVIDENCIA                   ;METROPOLITANA;0;0;0;0;0;0;0;0;0;AUDIFONO IN EX15AP SONY NEGRO;ACCESORIOS
6767326;;F;67;CHILENO;;Boomers;PROVIDENCIA                   ;METROPOLITANA;0;0;0;0;0;0;0;0;0;SOPORTE TV 14-42 KTAM02 KIOTO C/ BRAZO MOVIL;ACCESORIOS
17067416;;F;33;CHILENO;;Millenial;N/D;N/D;0;0;0;0;0;0;0;0;0;AUDIFONO TWS FULLY WIRELESS 8873;ACCESORIOS
10499426;;F;59;CHILENO;;Boomers;LOS ANDES                     ;VALPARAISO;0;0;0;0;0;0;0;0;0;PARLANTE KARAOKE MGPANTERA NEGRO;ACCESORIOS
13330721;;F;44;CHILENO;;X;OVALLE                        ;COQUIMBO;0;0;0;0;0;0;0;0;0;Audifonos Orejas De Gato Rosado;ACCESORIOS
26545966;;M;37;VENEZOLANO;;Extranjero;COIHAIQUE                     ;AYSEN;0;0;0;0;0;0;0;0;0;AUDIFONOS Airpods Pro (MWP22AM/A);ACCESORIOS
13212957;;F;44;CHILENO;;X;IQUIQUE                       ;TARAPACA;0;0;0;0;0;0;0;0;0;SILLA GAMER RACING PRO - ROSADO;ACCESORIOS
15803302;;M;37;CHILENO;;Millenial;SAN FERNANDO                  ;L.G.B.OÂ´HIGGINS;0;0;0;0;0;0;0;0;0;SOPORTE TV 26-56 KTA02 KIOTO FIJO;ACCESORIOS
7804079;;F;66;CHILENO;;Boomers;VALLENAR;ATACAMA;0;0;0;0;0;0;0;0;0;RADIO RETRO MINI WOOGIE 8751;ACCESORIOS
16181534;;M;36;CHILENO;;Millenial;PROVIDENCIA                   ;METROPOLITANA;0;0;0;0;0;0;0;0;0;MOUSE WIRELESS M280 NEGRO;ACCESORIOS
17510555;;F;31;CHILENO;;Millenial;PENCO                         ;BIO BIO;0;0;0;0;0;0;0;0;0;CABLE DE DATOS USB TIPO C HUAWEI SUPER CHARGER A;ACCESORIOS
17134097;;M;33;CHILENO;;Millenial;PROVIDENCIA                   ;METROPOLITANA;0;0;0;0;0;0;0;0;0;PARLANTES SRS-XB12/BC LA;ACCESORIOS
15874454;;M;37;CHILENO;;Millenial;ANCUD                         ;LOS LAGOS;0;0;0;0;0;0;0;0;0;AUDIFONO ON SONY ZX110 BLANCO;ACCESORIOS
7583245;;F;69;CHILENO;;Silencioso;OVALLE                        ;COQUIMBO;0;0;0;0;0;0;0;0;0;AUDIFONO XIAOMI EARBUDS MI TRUE WIRELESS BASIC 2;ACCESORIOS
10468573;Casado;M;55;CHILENO;AGROINDUSTRIA;Boomers;PROVIDENCIA                   ;METROPOLITANA;0;0;0;0;0;0;0;0;0;SOPORTE TV 26-56 KTA02 KIOTO FIJO;ACCESORIOS
12633558;;F;48;CHILENO;;X;SAN CARLOS                    ;BIO BIO;0;0;0;0;0;0;0;0;0;PARLANTE 8247 MLAB SOUNDLAB BLACK;ACCESORIOS
19903513;;F;24;CHILENO;;Silencioso;PROVIDENCIA                   ;METROPOLITANA;0;0;0;0;0;0;0;0;0;AUDIFONO IN SAM FIT EG920 BLANCO;ACCESORIOS
6618267;;F;72;CHILENO;;Silencioso;EL BOSQUE                     ;METROPOLITANA;0;0;0;0;0;0;0;0;0;APPLE PENCIL 2ND GEN- (MU8F2AM/A);ACCESORIOS
20198270;;F;23;CHILENO;;Z;N/D;N/D;0;0;0;0;0;0;0;0;0;HUAWEI AUDIFONOS MANOS LIBRES AM116;ACCESORIOS
14420694;;M;40;CHILENO;;X;PROVIDENCIA                   ;METROPOLITANA;0;0;0;0;0;0;0;0;0;AUDIFONO IN E9LP SONY BZ NEGRO;ACCESORIOS
15156750;Soltero;F;30;CHILENO;EDUCADOR DE PARVULOS;Millenial;PROVIDENCIA                   ;METROPOLITANA;0;0;0;0;0;0;0;0;0;PARLANTE ZUKABASS + MICROFONO MLAB BT;ACCESORIOS
10699816;;F;56;CHILENO;;Boomers;SAN JAVIER                    ;MAULE;0;0;0;0;0;0;0;0;0;DISCO DURO CANVIO 4TB BASICS BLACK;ACCESORIOS
18269474;;F;29;CHILENO;;Millenial;VALPARAISO                    ;VALPARAISO;0;0;0;0;0;0;0;0;0;AUDIFONO PANASONIC IN RP-HV096E-K NEGRO;ACCESORIOS
6962325;;F;69;CHILENO;;Silencioso;PARRAL                        ;MAULE;0;0;0;0;0;0;0;0;0;RADIO RETRO MINI WOOGIE 8751;ACCESORIOS
17116052;;F;38;CHILENO;;Millenial;PROVIDENCIA                   ;METROPOLITANA;0;0;0;0;0;0;0;0;0;SMARTWATCH HUAWEI BAND 4E ACTIVE BLACK;ACCESORIOS
17757713;Soltero;M;31;CHILENO;;Millenial;PROVIDENCIA                   ;METROPOLITANA;0;0;0;0;0;0;0;0;0;HUAWEI Sport Bluetooth Headphones Lite Black AM6;ACCESORIOS
12382779;;M;49;CHILENO;;X;MONTE PATRIA                  ;COQUIMBO;0;0;0;0;0;0;0;0;0;AUDIFONO HEADBAND BT BLANCO FIDDLER;ACCESORIOS
19831317;;F;24;CHILENO;;Z;N/D;N/D;0;0;0;0;0;0;0;0;0;Smartwatch ACTIVE 2 BLACK;ACCESORIOS
8707647;;M;61;CHILENO;;Boomers;SAN FELIPE                    ;VALPARAISO;0;0;0;0;0;0;0;0;0;AUDIFONO XIAOMI EARBUDS MI TRUE WIRELESS BASIC 2;ACCESORIOS
20452397;;M;22;CHILENO;;Z;PROVIDENCIA                   ;METROPOLITANA;0;0;0;0;0;0;0;0;0;Ducky One 2 SF RGB Black - Brown;ACCESORIOS
17654950;;F;31;CHILENO;;Silencioso;PROVIDENCIA                   ;METROPOLITANA;0;0;0;0;0;0;0;0;0;SMARTWATCH GALAXY WATCH 3 45MM MYSTIC BLACK;ACCESORIOS
9521405;;F;60;CHILENO;;Boomers;PROVIDENCIA                   ;METROPOLITANA;0;0;0;0;0;0;0;0;0;SOPORTE TV 26-56 KTA02 KIOTO FIJO;ACCESORIOS
25737843;;M;26;BOLIVIANO;;Extranjero;PROVIDENCIA                   ;METROPOLITANA;0;0;0;0;0;0;0;0;0;AUDIFONO ON ZX110 SONY NEGRO;ACCESORIOS
18064725;;M;30;CHILENO;;Millenial;LO PRADO                      ;METROPOLITANA;0;0;0;0;0;0;0;0;0;HUAWEI Freelace Orange;ACCESORIOS
10191490;;F;57;CHILENO;;Boomers;RENCA                         ;METROPOLITANA;0;0;0;0;0;0;0;0;0;PARLANTE ZUKABASS + MICROFONO MLAB BT ROJO;ACCESORIOS
12609278;;F;48;CHILENO;;X;ARICA                         ;ARICA Y PARINACOTA;0;0;0;0;0;0;0;0;0;365 Personal Suscripcion Anual QQ2-0008TP;ACCESORIOS
14429534;;M;48;CHILENO;;X;PROVIDENCIA                   ;METROPOLITANA;0;0;0;0;0;0;0;0;0;PARLANTE GBASS MICRO;ACCESORIOS
15812225;;M;38;CHILENO;;Millenial;COQUIMBO                      ;COQUIMBO;0;0;0;0;0;0;0;0;0;Headset Pav Gam 400 Grn CAN/ENG;ACCESORIOS
17247629;;F;32;CHILENO;;Millenial;PROVIDENCIA                   ;METROPOLITANA;0;0;0;0;0;0;0;0;0;CARGADOR Flat TA EP-TA20EWSUGCH;ACCESORIOS
17907853;;F;33;CHILENO;;Millenial;EL BOSQUE                     ;METROPOLITANA;0;0;0;0;0;0;0;0;0;PARLANTE KARAOKE MGGLADIATOR NEGRO;ACCESORIOS
25227814;;F;29;VENEZOLANO;;Extranjero;PUERTO MONTT                  ;LOS LAGOS;0;0;0;0;0;0;0;0;0;MOUSE MICROSOFT Wireless Mbl 1850 Purple;ACCESORIOS
19479321;;M;25;CHILENO;;Silencioso;PROVIDENCIA                   ;METROPOLITANA;0;0;0;0;0;0;0;0;0;AUDIFONO Bluetooth BE7 Azul;ACCESORIOS
15988429;;F;36;CHILENO;;Millenial;PROVIDENCIA                   ;METROPOLITANA;0;0;0;0;0;0;0;0;0;PARLANTE KARAOKE MGPANTERA NEGRO;ACCESORIOS
19484031;;F;25;CHILENO;;Z;N/D;N/D;0;0;0;0;0;0;0;0;0;AUDIFONO SONY MDRZX310APLZUC;ACCESORIOS
17879221;;M;30;CHILENO;;Millenial;N/D;N/D;0;0;0;0;0;0;0;0;0;MEMORIA MICROSD CLASE 10 32GB SANDISK;ACCESORIOS
18494362;;F;29;CHILENO;;Millenial;LA SERENA                     ;COQUIMBO;0;0;0;0;0;0;0;0;0;MEMORIA MICROSD CLASE 10 16GB SANDISK;ACCESORIOS
16604041;;F;35;CHILENO;;Millenial;LA FLORIDA                    ;METROPOLITANA;0;0;0;0;0;0;0;0;0;KARAOKE MLAB SUITCASE OUTDOOR MIC BT BK 8566;ACCESORIOS
16903974;;F;33;CHILENO;;Millenial;PROVIDENCIA                   ;METROPOLITANA;0;0;0;0;0;0;0;0;0;PARLANTE 8531 MLAB MAX BASS BT;ACCESORIOS
18460702;;M;29;CHILENO;;Millenial;N/D;N/D;0;0;0;0;0;0;0;0;0;Audifonos LG Tone Free FN6 Blanco;ACCESORIOS
13445584;;M;44;CHILENO;;Silencioso;PROVIDENCIA                   ;METROPOLITANA;0;0;0;0;0;0;0;0;0;AUDIFONO TAT1235 PHILIPS NEGRO;ACCESORIOS
6411394;;F;69;CHILENO;;Silencioso;RENCA                         ;METROPOLITANA;0;0;0;0;0;0;0;0;0;SOPORTE TV 14-42 KTAM02 KIOTO C/ BRAZO MOVIL;ACCESORIOS
15977267;;F;37;CHILENO;;Millenial;N/D;N/D;0;0;0;0;0;0;0;0;0;AUDIFONO ON ZX310AP NEGRO;ACCESORIOS
19013871;;F;26;CHILENO;;Z;N/D;N/D;0;0;0;0;0;0;0;0;0;AUDIFONO ON ZX310AP ROJO;ACCESORIOS
18777431;;F;28;CHILENO;;Millenial;PROVIDENCIA                   ;METROPOLITANA;0;0;0;0;0;0;0;0;0;SMARTWATCH GT 2 LATONA BROWN;ACCESORIOS
16021665;;F;33;CHILENO;;Millenial;ARAUCO                        ;BIO BIO;0;0;0;0;0;0;0;0;0;SOPORTE TV 32-65 KTA03 KIOTO FIJO;ACCESORIOS
19903476;;F;24;CHILENO;;Z;MAIPU                         ;METROPOLITANA;0;0;0;0;0;0;0;0;0;BAND 4 BLACK;ACCESORIOS
15300779;;F;39;CHILENO;;Millenial;N/D;N/D;0;0;0;0;0;0;0;0;0;Headset Pav Gam 400 Grn CAN/ENG;ACCESORIOS
10903541;;M;50;CHILENO;;X;N/D;N/D;0;0;0;0;0;0;0;0;0;Mouse 200 Silver Wireless;ACCESORIOS
16942666;Soltero;F;33;CHILENO;;Silencioso;PROVIDENCIA                   ;METROPOLITANA;0;0;0;0;0;0;0;0;0;MI WATCH LITE NEGRO XIAOMI;ACCESORIOS
10833042;Viudo;F;49;CHILENO;;X;MARIA PINTO                   ;METROPOLITANA;0;0;0;0;0;0;0;0;0;PARLANTE ZUKABASS + MICROFONO MLAB BT;ACCESORIOS
18154422;;M;37;CHILENO;;Millenial;CHILLAN                       ;BIO BIO;0;0;0;0;0;0;0;0;0;Mouse 200 Blue Wireless;ACCESORIOS
19679581;;F;25;CHILENO;;Silencioso;PROVIDENCIA                   ;METROPOLITANA;0;0;0;0;0;0;0;0;0;AUDIFONOS Airpods Pro (MWP22AM/A);ACCESORIOS
19173714;Soltero;F;26;CHILENO;COSMETOLOGA;Silencioso;PROVIDENCIA                   ;METROPOLITANA;0;0;0;0;0;0;0;0;0;TRAVEL ADAPTER 15W - FAST CHARGER (TYPE-C CABLE);ACCESORIOS
10956541;;M;53;CHILENO;;X;ALTO HOSPICIO;TARAPACA;0;0;0;0;0;0;0;0;0;AUDIFONO Bluetooth BE7 Azul;ACCESORIOS
17989292;Soltero;F;30;CHILENO;;Millenial;PROVIDENCIA                   ;METROPOLITANA;0;0;0;0;0;0;0;0;0;PARLANTE PL5 XBOOM GO BLUETHOOH 2020;ACCESORIOS
18819081;Soltero;M;27;CHILENO;;Millenial;PROVIDENCIA                   ;METROPOLITANA;0;0;0;0;0;0;0;0;0;BATERY PACK TIPO C 10.000 MAH SAMSUNG;ACCESORIOS
16644353;Soltero;F;35;CHILENO;;Millenial;PROVIDENCIA                   ;METROPOLITANA;0;0;0;0;0;0;0;0;0;AUDIFONO GALAXY BUDS LIVE COBRE;ACCESORIOS
19258659;Soltero;F;26;CHILENO;;Silencioso;PROVIDENCIA                   ;METROPOLITANA;0;0;0;0;0;0;0;0;0;AUDIFONO ON ZX110 SONY ROSA;ACCESORIOS
16811057;;F;34;CHILENO;;Millenial;"";"";0;0;0;0;0;0;0;0;0;SILLA GAMER RAYZEN NEGRO - BLANCO;ACCESORIOS
18401212;;M;29;CHILENO;;Millenial;BUIN                          ;METROPOLITANA;0;0;0;0;0;0;0;0;0;MI WATCH NEGRO XIAOMI;ACCESORIOS
14142289;;M;40;CHILENO;;X;PROVIDENCIA                   ;METROPOLITANA;0;0;0;0;0;0;0;0;0;AUDIFONO ON ZX110 SONY NEGRO;ACCESORIOS
20327689;;F;22;CHILENO;;Z;COLINA                        ;METROPOLITANA;0;0;0;0;0;0;0;0;0;PARLANTE FLIP ESSENTIAL BLUETOOTH;ACCESORIOS
18191546;Soltero;F;29;CHILENO;;Millenial;PROVIDENCIA                   ;METROPOLITANA;0;0;0;0;0;0;0;0;0;PARLANTE 8531 MLAB MAX BASS BT;ACCESORIOS
17782535;Soltero;M;31;CHILENO;;Millenial;PROVIDENCIA                   ;METROPOLITANA;0;0;0;0;0;0;0;0;0;AUDIFONO IN SAM C/ MIC EG920 BLACK;ACCESORIOS
20182499;;F;23;CHILENO;;Silencioso;PROVIDENCIA                   ;METROPOLITANA;0;0;0;0;0;0;0;0;0;MEMORIA MICROSD CLASE 10 16GB SANDISK;ACCESORIOS
12559201;;F;47;CHILENO;;X;PROVIDENCIA                   ;METROPOLITANA;0;0;0;0;0;0;0;0;0;HUAWEI FREEBUDS 3I BLANCOS;ACCESORIOS
18608558;;M;28;CHILENO;;Silencioso;PROVIDENCIA                   ;METROPOLITANA;0;0;0;0;0;0;0;0;0;HUAWEI Sport Bluetooth Headphones Lite Black AM6;ACCESORIOS
13110755;;M;45;CHILENO;;Silencioso;PROVIDENCIA                   ;METROPOLITANA;0;0;0;0;0;0;0;0;0;DISCO DURO CANVIO 1TB BASICS BLACK TOSHIBA;ACCESORIOS
10227184;;M;55;CHILENO;;Boomers;PROVIDENCIA                   ;METROPOLITANA;0;0;0;0;0;0;0;0;0;TRAVEL ADAPTER 15W - FAST CHARGER (TYPE-C CABLE);ACCESORIOS
16405779;;M;35;CHILENO;;Silencioso;PROVIDENCIA                   ;METROPOLITANA;0;0;0;0;0;0;0;0;0;AUDIFONO XIAOMI EARBUDS MI TRUE WIRELESS BASIC 2;ACCESORIOS
20387675;;F;22;CHILENO;;Z;PROVIDENCIA                   ;METROPOLITANA;0;0;0;0;0;0;0;0;0;Mouse Gaming G203 Blanco;ACCESORIOS
19348353;Soltero;F;26;CHILENO;TECNICO DE NIVEL MEDIO EN ALIMENTACION;Z;PROVIDENCIA                   ;METROPOLITANA;0;0;0;0;0;0;0;0;0;BAND 4 BLACK;ACCESORIOS
17774200;;F;30;CHILENO;;Silencioso;PROVIDENCIA                   ;METROPOLITANA;0;0;0;0;0;0;0;0;0;PARLANTE 8531 MLAB MAX BASS BT;ACCESORIOS
20029070;;M;23;CHILENO;;Z;PROVIDENCIA                   ;METROPOLITANA;0;0;0;0;0;0;0;0;0;AUDIFONO IN E9LP SONY GRIS;ACCESORIOS
13148117;;F;45;CHILENO;;X;LOS ALAMOS                    ;BIO BIO;0;0;0;0;0;0;0;0;0;AUDIFONO ON ZX110 SONY ROSA;ACCESORIOS
13213533;;F;44;CHILENO;;X;PROVIDENCIA                   ;METROPOLITANA;0;0;0;0;0;0;0;0;0;Mouse 200 Blue Wireless;ACCESORIOS
10628633;;F;51;CHILENO;;X;PROVIDENCIA                   ;METROPOLITANA;0;0;0;0;0;0;0;0;0;SMARTBAND SAMSUNG GALAXY FIT 2 ROJO;ACCESORIOS
5631034;Casado;F;74;CHILENO;;Silencioso;PROVIDENCIA                   ;METROPOLITANA;0;0;0;0;0;0;0;0;0;Kit gamer 3 en 1;ACCESORIOS
21759609;;M;22;CHILENO;;Extranjero;PROVIDENCIA                   ;METROPOLITANA;0;0;0;0;0;0;0;0;0;Mouse Arc Touch MS Negro;ACCESORIOS
15513255;;F;38;CHILENO;;X;PROVIDENCIA                   ;METROPOLITANA;0;0;0;0;0;0;0;0;0;AUDIFONO IN SAM FIT EG920 BLANCO;ACCESORIOS
19111797;Soltero;M;27;CHILENO;;Z;PROVIDENCIA                   ;METROPOLITANA;0;0;0;0;0;0;0;0;0;SOPORTE TV 14-42 KTAM02 KIOTO C/ BRAZO MOVIL;ACCESORIOS
20094954;;F;22;CHILENO;;Z;PROVIDENCIA                   ;METROPOLITANA;0;0;0;0;0;0;0;0;0;BATERY PACK TIPO C 10.000 MAH SAMSUNG;ACCESORIOS
18145207;Soltero;F;30;CHILENO;;Silencioso;PROVIDENCIA                   ;METROPOLITANA;0;0;0;0;0;0;0;0;0;AUDIFONO XIAOMI EARBUDS MI TRUE WIRELESS BASIC 2;ACCESORIOS
6714192;Casado;M;70;CHILENO;PROFESOR;Silencioso;RENCA                         ;METROPOLITANA;0;0;0;0;0;0;0;0;0;SOPORTE TV 26-56 KTA02 KIOTO FIJO;ACCESORIOS
13847839;;M;41;CHILENO;;X;LA LIGUA                      ;VALPARAISO;0;0;0;0;0;0;0;0;0;AUDIFONO SONY MDRZX310APLZUC;ACCESORIOS
20090736;;M;23;CHILENO;;Silencioso;PROVIDENCIA                   ;METROPOLITANA;0;0;0;0;0;0;0;0;0;Mouse G203 LIGHTSYNC Gaming - BLACK;ACCESORIOS
17794879;;F;31;CHILENO;;Millenial;SANTIAGO                      ;METROPOLITANA;0;0;0;0;0;0;0;0;0;Smartwatch ACTIVE 1 NEGRO;ACCESORIOS
7235756;;M;69;CHILENO;;Silencioso;CONCEPCION                    ;BIO BIO;0;0;0;0;0;0;0;0;0;SOPORTE TV 14-42 KTAM02 KIOTO C/ BRAZO MOVIL;ACCESORIOS
19597563;;M;25;CHILENO;;Z;PROVIDENCIA                   ;METROPOLITANA;0;0;0;0;0;0;0;0;0;AUDIFONO IN SAM C/ MIC EG920 BLACK;ACCESORIOS
18482209;;M;29;CHILENO;;Millenial;PROVIDENCIA                   ;METROPOLITANA;0;0;0;0;0;0;0;0;0;SMARTWATCH GALAXY WATCH 3 45MM MYSTIC BLACK;ACCESORIOS
12023166;;F;47;CHILENO;;X;PROVIDENCIA                   ;METROPOLITANA;0;0;0;0;0;0;0;0;0;AUDIFONO IN SAM C/ MIC EG920 BLACK;ACCESORIOS
25931823;;F;31;COLOMBIANO;;Extranjero;LA FLORIDA                    ;METROPOLITANA;0;0;0;0;0;0;0;0;0;APPLE WATCH SERIE 3 42MM SILVER;ACCESORIOS
26380007;;F;35;EXTRANJERO - NO INFORMA NACIONALIDAD;;Extranjero;"";"";0;0;0;0;0;0;0;0;0;AUDIFONO Bluetooth BE7 Azul;ACCESORIOS
17476852;;F;32;CHILENO;;Millenial;RANCAGUA                      ;L.G.B.OÂ´HIGGINS;0;0;0;0;0;0;0;0;0;APPLE WATCH SERIE 3 38MM SILVER;ACCESORIOS
17590962;;F;32;CHILENO;;Millenial;LOS ANGELES                   ;BIO BIO;0;0;0;0;0;0;0;0;0;MOCHILA CAPRI 20 QUILT GR;ACCESORIOS
14073728;;M;41;CHILENO;;X;PROVIDENCIA                   ;METROPOLITANA;0;0;0;0;0;0;0;0;0;Smartwatch GT 2E BLACK;ACCESORIOS
16915076;;F;33;CHILENO;;Millenial;RENCA                         ;METROPOLITANA;0;0;0;0;0;0;0;0;0;CABLE DE DATOS USB TIPO C HUAWEI SUPER CHARGER A;ACCESORIOS
8905804;Soltero;M;62;CHILENO;CONTADOR AUDITOR;Boomers;RENCA                         ;METROPOLITANA;0;0;0;0;0;0;0;0;0;SOPORTE TV 14-63 CON BRAZO KT-FM 3L;ACCESORIOS
13486386;;F;44;CHILENO;;X;N/D;N/D;0;0;0;0;0;0;0;0;0;MOCHILA Mix 1 2021 SPIDER;ACCESORIOS
10564192;;M;57;CHILENO;;Boomers;RENCA                         ;METROPOLITANA;0;0;0;0;0;0;0;0;0;SOPORTE TV 26-56 KTA02 KIOTO FIJO;ACCESORIOS
10672071;;F;48;CHILENO;;X;PUNTA ARENAS                  ;MAGALLANES;0;0;0;0;0;0;0;0;0;SOPORTE TV 14-63 CON BRAZO KT-FM 3L;ACCESORIOS
17546919;Soltero;F;31;CHILENO;PSICOLOGA;Silencioso;PROVIDENCIA                   ;METROPOLITANA;0;0;0;0;0;0;0;0;0;HUAWEI AUDIFONOS MANOS LIBRES AM115;ACCESORIOS
23505359;;F;31;BOLIVIANO;;Extranjero;ALTO HOSPICIO;TARAPACA;0;0;0;0;0;0;0;0;0;AUDIFONO ON ZX310AP ROJO;ACCESORIOS
15789440;Soltero;F;38;CHILENO;TECNICO EN ADMINISTRACION DE EMPRESAS;Millenial;RENCA                         ;METROPOLITANA;0;0;0;0;0;0;0;0;0;Smartwatch ACTIVE 1 VERDE;ACCESORIOS
19668162;;F;24;CHILENO;;Z;PROVIDENCIA                   ;METROPOLITANA;0;0;0;0;0;0;0;0;0;AUDIFONO SAMSUNG WIRELESS 103B;ACCESORIOS
19684325;;M;25;CHILENO;;Millenial;N/D;N/D;0;0;0;0;0;0;0;0;0;CABLE DE DATOS USB TIPO C HUAWEI SUPER CHARGER A;ACCESORIOS
17453446;;F;32;CHILENO;;Millenial;LA SERENA                     ;COQUIMBO;0;0;0;0;0;0;0;0;0;AUDIFONO PANASONIC IN RP-HV096E-K NEGRO;ACCESORIOS
18012540;;F;30;CHILENO;;Millenial;OVALLE                        ;COQUIMBO;0;0;0;0;0;0;0;0;0;MEMORIA MICROSD CLASE 10 64GB SANDISK;ACCESORIOS
9890623;;M;57;CHILENO;;Boomers;PROVIDENCIA                   ;METROPOLITANA;0;0;0;0;0;0;0;0;0;TRAVEL ADAPTER 15W - FAST CHARGER (TYPE-C CABLE);ACCESORIOS
20104787;;M;23;CHILENO;;Millenial;N/D;N/D;0;0;0;0;0;0;0;0;0;Smartwatch GT 2 WHITE;ACCESORIOS
13099710;Casado;F;46;CHILENO;;Silencioso;PROVIDENCIA                   ;METROPOLITANA;0;0;0;0;0;0;0;0;0;SOPORTE TV 26-56 KTA02 KIOTO FIJO;ACCESORIOS
17150662;;F;33;CHILENO;;Millenial;QUINTA NORMAL                 ;METROPOLITANA;0;0;0;0;0;0;0;0;0;SOPORTE TV 14-42 KTAM02 KIOTO C/ BRAZO MOVIL;ACCESORIOS
25274099;;F;34;PERUANO;;Extranjero;SANTIAGO                      ;METROPOLITANA;0;0;0;0;0;0;0;0;0;MOCHILA Mix 1 2021 SPACE;ACCESORIOS
17192323;Soltero;M;33;CHILENO;;Millenial;PROVIDENCIA                   ;METROPOLITANA;0;0;0;0;0;0;0;0;0;True Wireless Philips TAT1215 6+12 Hrs Negro;ACCESORIOS
16027411;;F;37;CHILENO;;Millenial;PROVIDENCIA                   ;METROPOLITANA;0;0;0;0;0;0;0;0;0;SOPORTE TV 14-63 CON BRAZO KT-FM 3L;ACCESORIOS
18219438;;M;29;CHILENO;;Silencioso;PROVIDENCIA                   ;METROPOLITANA;0;0;0;0;0;0;0;0;0;AUDIFONO MLAB TWS IN-AIR WHITE 8533;ACCESORIOS
17576029;;F;32;CHILENO;;Millenial;PROVIDENCIA                   ;METROPOLITANA;0;0;0;0;0;0;0;0;0;BAND 4 PRO BLACK;ACCESORIOS
23815289;;F;60;CHILENO;;Extranjero;SAN ANTONIO                   ;VALPARAISO;0;0;0;0;0;0;0;0;0;MOUSE INAL M187 LOG NEGRO;ACCESORIOS
16867910;Soltero;F;34;CHILENO;TECNICO DE NIVEL SUPERIOR EN ENFERMERIA;Millenial;PROVIDENCIA                   ;METROPOLITANA;0;0;0;0;0;0;0;0;0;AUDIFONO MLAB TWS IN-AIR WHITE 8533;ACCESORIOS
10774788;Casado;M;54;CHILENO;INGENIERO;Boomers;RENCA                         ;METROPOLITANA;0;0;0;0;0;0;0;0;0;RADIO RETRO MINI WOOGIE 8751;ACCESORIOS
13883476;;F;43;CHILENO;;X;RENCA                         ;METROPOLITANA;0;0;0;0;0;0;0;0;0;AUDIFONO PHIL BASS+ ON-EAR SHL3075WT/00 BLANCO;ACCESORIOS
17080469;;F;33;CHILENO;;Millenial;N/D;N/D;0;0;0;0;0;0;0;0;0;AUDIFONO IN SONY BT WI-C200 BLACK;ACCESORIOS
11630949;Casado;M;52;CHILENO;ABOGADO;X;PROVIDENCIA                   ;METROPOLITANA;0;0;0;0;0;0;0;0;0;KIT PREPAGO HD DIRECTV;ACCESORIOS
12791391;;F;46;CHILENO;;X;RENCA                         ;METROPOLITANA;0;0;0;0;0;0;0;0;0;AUDIFONO IN SPORT HS34PC PNS AZUL;ACCESORIOS
9803384;;M;58;CHILENO;;Silencioso;PROVIDENCIA                   ;METROPOLITANA;0;0;0;0;0;0;0;0;0;365 Familia 6 usuarios Anual;ACCESORIOS
18705344;Soltero;F;28;CHILENO;PROFESOR;Millenial;PROVIDENCIA                   ;METROPOLITANA;0;0;0;0;0;0;0;0;0;AUDIFONO IN SAM HS1303C/ MIC BLANCO;ACCESORIOS
19650265;;F;23;CHILENO;;Z;PROVIDENCIA                   ;METROPOLITANA;0;0;0;0;0;0;0;0;0;PARLANTE ZUKABASS 4 BT USB/SD/FM CALACAS;ACCESORIOS
16930983;Soltero;M;34;CHILENO;;Millenial;RENCA                         ;METROPOLITANA;0;0;0;0;0;0;0;0;0;MOCHILA NTBK 15,6 DENVER MELANGE Negro/Gris;ACCESORIOS
19045056;Soltero;M;26;CHILENO;;Z;PROVIDENCIA                   ;METROPOLITANA;0;0;0;0;0;0;0;0;0;TRAVEL ADAPTER 15W - FAST CHARGER (TYPE-C CABLE);ACCESORIOS
18185185;;M;30;CHILENO;;Millenial;LOS ANGELES                   ;BIO BIO;0;0;0;0;0;0;0;0;0;True Wireless Philips TAT3215 6+18 Hrs Negro;ACCESORIOS
19915375;;F;24;CHILENO;;Silencioso;PROVIDENCIA                   ;METROPOLITANA;0;0;0;0;0;0;0;0;0;BAND 4 PRO BLACK;ACCESORIOS
6546568;;M;68;CHILENO;;Silencioso;RENCA                         ;METROPOLITANA;0;0;0;0;0;0;0;0;0;MOUSE HP Z3700 Black WIRELESS;ACCESORIOS
13939265;;M;42;CHILENO;;X;PROVIDENCIA                   ;METROPOLITANA;0;0;0;0;0;0;0;0;0;DISCO DURO CANVIO 2TB BASICS BLACK TOSHIBA;ACCESORIOS
16535014;;F;35;CHILENO;;Millenial;PROVIDENCIA                   ;METROPOLITANA;0;0;0;0;0;0;0;0;0;Smartwatch ACTIVE 1 DORADO;ACCESORIOS
17230552;;F;33;CHILENO;;Millenial;RENCA                         ;METROPOLITANA;0;0;0;0;0;0;0;0;0;Smartwatch ACTIVE 2 GOLD;ACCESORIOS
14447882;Divorciado;M;49;CHILENO;INGENIERO;X;PROVIDENCIA                   ;METROPOLITANA;0;0;0;0;0;0;0;0;0;MOUSE MICROSOFT Bluetooth Mobile 3600 Dark Red;ACCESORIOS
15622731;;M;39;CHILENO;;X;PROVIDENCIA                   ;METROPOLITANA;0;0;0;0;0;0;0;0;0;AUDIFONO PANASONIC BT ON RP-HF410BPUK NEGRO;ACCESORIOS
8697666;Casado;F;61;CHILENO;;Boomers;RENCA                         ;METROPOLITANA;0;0;0;0;0;0;0;0;0;SOPORTE TV EE-F01 14-42 ENCORE;ACCESORIOS
14347641;Soltero;M;43;CHILENO;;X;RENCA                         ;METROPOLITANA;0;0;0;0;0;0;0;0;0;PARLANTE KARAOKE FD-PKBT82 8 LUCES MIC/FM/BT/USB;ACCESORIOS
17507904;Soltero;M;31;CHILENO;MANTENIMIENTO INDUSTRIAL;Millenial;PROVIDENCIA                   ;METROPOLITANA;0;0;0;0;0;0;0;0;0;KIT DIRECTV GO BOX;ACCESORIOS
19798156;;F;24;CHILENO;;Z;CHILLAN                       ;BIO BIO;0;0;0;0;0;0;0;0;0;AUDIFONO MLAB TWS FULLY WIRELESSÂ  WHITE 8721;ACCESORIOS
4920271;;M;79;CHILENO;;Silencioso;RENCA                         ;METROPOLITANA;0;0;0;0;0;0;0;0;0;SOPORTE TV 32-65 KTA03 KIOTO FIJO;ACCESORIOS
15218877;;M;39;CHILENO;;Millenial;"";"";0;0;0;0;0;0;0;0;0;PARLANTE ZUKABASS + MICROFONO MLAB BT;ACCESORIOS
11812846;;F;50;CHILENO;;X;COIHAIQUE                     ;AYSEN;0;0;0;0;0;0;0;0;0;Smartwatch ACTIVE 1 NEGRO;ACCESORIOS
12092346;;F;52;CHILENO;;X;LA CISTERNA                   ;METROPOLITANA;0;0;0;0;0;0;0;0;0;AUDIFONO BLUETOOTH RP-HF410BPUA BT 24HRS AZUL;ACCESORIOS
12862010;;F;47;CHILENO;;X;RENCA                         ;METROPOLITANA;0;0;0;0;0;0;0;0;0;SMARTWATCH HUAWEI WATCH FIT BLACK;ACCESORIOS
18837548;Soltero;M;27;CHILENO;;Millenial;PROVIDENCIA                   ;METROPOLITANA;0;0;0;0;0;0;0;0;0;RADIO RETRO ANTIQUE 8732;ACCESORIOS
12426303;;M;50;CHILENO;;X;OVALLE                        ;COQUIMBO;0;0;0;0;0;0;0;0;0;PARLANTE 7279 MLAB ZUKABASS NEGRO BT;ACCESORIOS
17576414;Soltero;F;32;CHILENO;;Millenial;PROVIDENCIA                   ;METROPOLITANA;0;0;0;0;0;0;0;0;0;DISCO DURO CANVIO 2TB BASICS BLACK TOSHIBA;ACCESORIOS
16531026;;F;34;CHILENO;;Millenial;PENAFLOR                      ;METROPOLITANA;0;0;0;0;0;0;0;0;0;AUDIFONO BLUETOOTH RP-HF410BPUA BT 24HRS AZUL;ACCESORIOS
11271369;;F;54;CHILENO;;Boomers;TALAGANTE                     ;METROPOLITANA;0;0;0;0;0;0;0;0;0;AUDIFONO MLAB TWS FREE IN-AIR TOUCH BLACK 8534;ACCESORIOS
14686408;;M;59;PERUANO;;Extranjero;INDEPENDENCIA                 ;METROPOLITANA;0;0;0;0;0;0;0;0;0;Smartwatch ACTIVE 2 BLACK;ACCESORIOS
17925295;;F;30;CHILENO;;Millenial;N/D;N/D;0;0;0;0;0;0;0;0;0;AUDIFONO BLUETOOTH RP-HF410BPUA BT 24HRS AZUL;ACCESORIOS
13263754;;M;49;CHILENO;;X;PROVIDENCIA                   ;METROPOLITANA;0;0;0;0;0;0;0;0;0;AUDIFONO BLUETOOTH PANASONIC RP-HJE120B NEGRO;ACCESORIOS
13217892;Divorciado;M;45;CHILENO;INGENIERO CIVIL INDUSTRIAL;X;LAS CONDES;METROPOLITANA;0;0;0;0;0;0;0;0;0;HUAWEI Sport Bluetooth Headphones Lite Black AM6;ACCESORIOS
7524437;;M;63;CHILENO;;Boomers;HUALPEN;BIO BIO;0;0;0;0;0;0;0;0;0;Smartwatch GT 2E RED;ACCESORIOS
10994886;Casado;M;51;CHILENO;;X;PROVIDENCIA                   ;METROPOLITANA;0;0;0;0;0;0;0;0;0;Smartwatch GT 2E BLACK;ACCESORIOS
10006636;;M;50;CHILENO;;X;LA SERENA                     ;COQUIMBO;0;0;0;0;0;0;0;0;0;Smartwatch ACTIVE 1 NEGRO;ACCESORIOS
18512735;;M;29;CHILENO;;Millenial;N/D;N/D;0;0;0;0;0;0;0;0;0;True Wireless Philips TAT1215 6+12 Hrs Negro;ACCESORIOS
13106566;;F;46;CHILENO;;X;CONCEPCION                    ;BIO BIO;0;0;0;0;0;0;0;0;0;PARLANTE 8531 MLAB MAX BASS BT;ACCESORIOS
10292860;Casado;M;53;CHILENO;;X;RENCA                         ;METROPOLITANA;0;0;0;0;0;0;0;0;0;DISCO DURO CANVIO 1TB BASICS BLACK TOSHIBA;ACCESORIOS
13708826;;F;43;CHILENO;;X;N/D;N/D;0;0;0;0;0;0;0;0;0;AUDIFONO IN SAM FIT EG920 BLANCO;ACCESORIOS
20269776;;F;22;CHILENO;;Z;PROVIDENCIA                   ;METROPOLITANA;0;0;0;0;0;0;0;0;0;AUDIFONO IN T110 JBL NEGRO;ACCESORIOS
17805024;;F;31;CHILENO;;Millenial;PROVIDENCIA                   ;METROPOLITANA;0;0;0;0;0;0;0;0;0;BAND 4 AMBER SUNRISE;ACCESORIOS
16690087;;M;34;CHILENO;;Millenial;PROVIDENCIA                   ;METROPOLITANA;0;0;0;0;0;0;0;0;0;365 Familia 6 usuarios Anual;ACCESORIOS
19898991;;F;24;CHILENO;;Z;PROVIDENCIA                   ;METROPOLITANA;0;0;0;0;0;0;0;0;0;SOPORTE TV 26-56 KTAT02 KIOTO MOVIL;ACCESORIOS
17978519;Soltero;M;30;CHILENO;;Millenial;PROVIDENCIA                   ;METROPOLITANA;0;0;0;0;0;0;0;0;0;SOPORTE TV 26-56 KTAT02 KIOTO MOVIL;ACCESORIOS
18132500;;F;30;CHILENO;;Millenial;VALDIVIA                      ;LOS RIOS;0;0;0;0;0;0;0;0;0;SMARTWATCH HUAWEI WATCH FIT PINK;ACCESORIOS
16533436;;F;36;CHILENO;;Millenial;NUEVA IMPERIAL                ;ARAUCANIA;0;0;0;0;0;0;0;0;0;AUDIFONO MLAB ON STYLE BLACK BT 8240;ACCESORIOS
16836331;;F;34;CHILENO;;Millenial;PROVIDENCIA                   ;METROPOLITANA;0;0;0;0;0;0;0;0;0;AUDIFONO ON RPHF300E-W BLANCO PNS;ACCESORIOS
18212377;;M;30;CHILENO;;Millenial;PROVIDENCIA                   ;METROPOLITANA;0;0;0;0;0;0;0;0;0;TECLADO + MOUSE MICROSOFT WIRELESS DESKTOP 2000;ACCESORIOS
15726095;Soltero;M;38;CHILENO;ARQUITECTO;X;PROVIDENCIA                   ;METROPOLITANA;0;0;0;0;0;0;0;0;0;Smartwatch GT 2E RED;ACCESORIOS
12577457;;M;48;CHILENO;;X;MONTE PATRIA                  ;COQUIMBO;0;0;0;0;0;0;0;0;0;AUDIFONO ON RPHF300E-W BLANCO PNS;ACCESORIOS
17202409;;F;33;CHILENO;;Millenial;QUILPUE                       ;VALPARAISO;0;0;0;0;0;0;0;0;0;MEMORIA MICROSD CLASE 10 32GB SANDISK;ACCESORIOS
11575102;;M;52;CHILENO;;X;N/D;N/D;0;0;0;0;0;0;0;0;0;KIT PREPAGO HD DIRECTV;ACCESORIOS
13183192;;M;45;CHILENO;;X;RENCA                         ;METROPOLITANA;0;0;0;0;0;0;0;0;0;Smartwatch GT 2E RED;ACCESORIOS
6810644;Casado;F;72;CHILENO;;Silencioso;RENCA                         ;METROPOLITANA;0;0;0;0;0;0;0;0;0;AUDIFONO IN PANASONIC RP-TCM130PPA AZUL;ACCESORIOS
19489354;;M;25;CHILENO;;Z;PROVIDENCIA                   ;METROPOLITANA;0;0;0;0;0;0;0;0;0;Smartwatch GT 2E RED;ACCESORIOS
16821246;;F;33;CHILENO;;Millenial;PROVIDENCIA                   ;METROPOLITANA;0;0;0;0;0;0;0;0;0;PENDRIVE CRUZERBLADE Z50 SANDISK 32GB;ACCESORIOS
18294997;Soltero;M;29;CHILENO;;Millenial;PROVIDENCIA                   ;METROPOLITANA;0;0;0;0;0;0;0;0;0;AUDIFONOS Airpods (MV7N2BE/A);ACCESORIOS
17807515;;M;31;CHILENO;;Millenial;VALPARAISO                    ;VALPARAISO;0;0;0;0;0;0;0;0;0;AUDIFONO MLAB TWS IN-AIR WHITE 8533;ACCESORIOS
26331569;;M;37;VENEZOLANO;;Extranjero;SANTIAGO                      ;METROPOLITANA;0;0;0;0;0;0;0;0;0;Smartwatch GT 2E RED;ACCESORIOS
16991496;;M;33;CHILENO;;Millenial;SAN FELIPE                    ;VALPARAISO;0;0;0;0;0;0;0;0;0;SOPORTE TV 14-63 CON BRAZO KT-FM 3L;ACCESORIOS
17758680;;F;31;CHILENO;;Millenial;PROVIDENCIA                   ;METROPOLITANA;0;0;0;0;0;0;0;0;0;Smartwatch GALAXY WATCH GOLD;ACCESORIOS
16822714;;F;33;CHILENO;;Millenial;MAIPU                         ;METROPOLITANA;0;0;0;0;0;0;0;0;0;MEMORIA MICROSD CLASE 10 32GB SANDISK;ACCESORIOS
12253222;;F;50;CHILENO;;X;PROVIDENCIA                   ;METROPOLITANA;0;0;0;0;0;0;0;0;0;PARLANTE 8531 MLAB MAX BASS BT;ACCESORIOS
15400207;;F;39;CHILENO;;X;MAIPU                         ;METROPOLITANA;0;0;0;0;0;0;0;0;0;SOPORTE TV 14-63 CON BRAZO KT-FM 3L;ACCESORIOS
16734203;Soltero;M;35;CHILENO;PROFESOR;Millenial;PROVIDENCIA                   ;METROPOLITANA;0;0;0;0;0;0;0;0;0;Smartwatch GT 2 WHITE;ACCESORIOS
19551907;;F;25;CHILENO;;Z;PROVIDENCIA                   ;METROPOLITANA;0;0;0;0;0;0;0;0;0;MEMORIA MICROSD CLASE 10 32GB SANDISK;ACCESORIOS
19404766;;M;25;CHILENO;;Z;PROVIDENCIA                   ;METROPOLITANA;0;0;0;0;0;0;0;0;0;MOCHILA NTBK 15,6 DENVER MELANGE Negro/Gris;ACCESORIOS
5039741;;M;76;CHILENO;;Silencioso;PROVIDENCIA                   ;METROPOLITANA;0;0;0;0;0;0;0;0;0;CARGADOR Flat TA EP-TA20EWSUGCH;ACCESORIOS
8399640;;F;52;CHILENO;;X;PROVIDENCIA                   ;METROPOLITANA;0;0;0;0;0;0;0;0;0;CARGADOR Flat TA EP-TA20EWSUGCH;ACCESORIOS
17249988;;F;33;CHILENO;;Millenial;PROVIDENCIA                   ;METROPOLITANA;0;0;0;0;0;0;0;0;0;DISCO DURO CANVIO 1TB BASICS BLACK TOSHIBA;ACCESORIOS
18891008;;F;28;CHILENO;;Millenial;"";"";0;0;0;0;0;0;0;0;0;CABLE HUAWEI DATA BLANCO;ACCESORIOS
14418117;;M;43;CHILENO;;X;RENCA                         ;METROPOLITANA;0;0;0;0;0;0;0;0;0;Smartwatch GT 2E BLACK;ACCESORIOS
14330917;;M;44;CHILENO;;X;RENCA                         ;METROPOLITANA;0;0;0;0;0;0;0;0;0;DISCO DURO CANVIO 1TB BASICS BLACK TOSHIBA;ACCESORIOS
13949677;;F;42;CHILENO;;X;PROVIDENCIA                   ;METROPOLITANA;0;0;0;0;0;0;0;0;0;Smartwatch GT 2E BLACK;ACCESORIOS
26452773;;M;24;EXTRANJERO - NO INFORMA NACIONALIDAD;;Extranjero;PROVIDENCIA                   ;METROPOLITANA;0;0;0;0;0;0;0;0;0;AUDIFONO EVO Bluetooth Negro;ACCESORIOS
18151259;;M;30;CHILENO;;Millenial;PROVIDENCIA                   ;METROPOLITANA;0;0;0;0;0;0;0;0;0;Smartwatch ACTIVE 2 GOLD;ACCESORIOS
21777600;Casado;F;43;CHILENO;;Extranjero;PROVIDENCIA                   ;METROPOLITANA;0;0;0;0;0;0;0;0;0;MOUSE HP Z3700 Black WIRELESS;ACCESORIOS
8391039;;F;63;CHILENO;;Boomers;VALLENAR;ATACAMA;0;0;0;0;0;0;0;0;0;SOPORTE TV 14-63 CON BRAZO KT-FM 3L;ACCESORIOS
13631799;;F;45;CHILENO;;X;RENCA                         ;METROPOLITANA;0;0;0;0;0;0;0;0;0;DISCO DURO CANVIO 1TB BASICS BLACK TOSHIBA;ACCESORIOS
17747139;;F;31;CHILENO;;Millenial;CHIMBARONGO;O HIGGINS;64980;2;1;2;1;64980;0;0;0;BICICLETA DISNEY FROZEN BALANCE ARO 12;BICICLETAS
17965845;;M;30;CHILENO;;Millenial;N/D;N/D;429980;2;2;1;1;189990;1;1;239990;BICI VIGORPLUS NEGRA 27,5 V-BRAKE;BICICLETAS
19304502;Soltero;M;26;CHILENO;;Silencioso;PROVIDENCIA                   ;METROPOLITANA;404970;4;3;3;1;404970;1;2;0;BC XTS MTB ALU STRIKERPLUS 29 24VEL DISCOHID AZU;BICICLETAS
17086903;;F;33;CHILENO;;Millenial;PROVIDENCIA                   ;METROPOLITANA;179980;2;1;2;1;179980;0;0;0;BICI ALLEYCAT NEGRA/TURQUESA 28 FITZER;BICICLETAS
19514747;;M;25;CHILENO;;Silencioso;PEDRO AGUIRRE CERDA;METROPOLITANA;139980;2;1;2;1;139980;0;0;0;BICI ALLEYCAT NEGRA 28 FITZER;BICICLETAS
17259388;Casado;F;32;CHILENO;CIRUJANO DENTISTA;Millenial;PROVIDENCIA                   ;METROPOLITANA;134980;2;1;2;1;134980;0;0;0;BICI RETROPLUS CELESTE ARO 26;BICICLETAS
10293857;;F;55;CHILENO;;Boomers;CASTRO                        ;LOS LAGOS;169990;1;1;0;0;0;1;1;169990;BICI VIGOR NEGRA 24 V-BRAKE;BICICLETAS
19364286;;M;25;CHILENO;;Z;LEBU                          ;BIO BIO;229990;2;3;0;0;0;2;3;229990;BICI VIGORPLUS VERDE 27,5 V-BRAKE;BICICLETAS
15880844;;F;37;CHILENO;;Millenial;NUEVA IMPERIAL                ;ARAUCANIA;267950;5;5;0;0;0;5;5;267950;BICI RETROPLUS VERDE 26 V-BRAKE;BICICLETAS
9816048;;F;58;CHILENO;;Boomers;"";"";229990;1;1;1;1;229990;0;0;0;BC XTS MTB ALU STRIKER 29 21VEL DISCO NEGRO;BICICLETAS
13947538;;M;42;CHILENO;;X;RENCA                         ;METROPOLITANA;119980;2;1;2;1;119980;0;0;0;BICI ALLEYCAT NEGRA/TURQUESA 28 FITZER;BICICLETAS
12915503;;F;47;CHILENO;;X;N/D;N/D;229990;1;1;0;0;0;1;1;229990;BICICLETA MONKEL 29 ALUMINIO GRIS;BICICLETAS
15872176;Soltero;F;37;CHILENO;;Millenial;SAN ANTONIO                   ;VALPARAISO;279990;1;1;0;0;0;1;1;279990;MODELO SUNPEED ZERO ARO 29 ROJA M;BICICLETAS
14224923;;M;44;CHILENO;;X;LANCO                         ;LOS RIOS;433150;4;2;0;0;0;4;2;433150;MODELO SUNPEED ZERO ARO 29 GRAFITO M;BICICLETAS
26316544;;M;42;CHILENO;;Extranjero;N/D;N/D;179970;3;4;2;1;84980;1;3;94990;MOTOBIKE NARANJA ARO 16;BICICLETAS
10106489;;F;56;CHILENO;;Boomers;SAN FERNANDO                  ;L.G.B.OÂ´HIGGINS;155980;2;1;0;0;0;2;1;155980;BICICLETA INFANTIL ARO 20 AMARILLA;BICICLETAS
17966052;;F;30;CHILENO;;Millenial;N/D;N/D;150770;5;2;3;1;120530;2;1;30240;BICICLETA INFANTIL ARO 20 AMARILLA;BICICLETAS
11896700;;M;50;CHILENO;;X;N/D;N/D;198980;2;1;2;1;198980;0;0;0;BICI RETROPLUS VERDE 26 V-BRAKE;BICICLETAS
10697332;;F;53;CHILENO;;X;N/D;N/D;191980;2;1;2;1;191980;0;0;0;BICI RETROPLUS CELESTE ARO 26;BICICLETAS
13813975;;M;42;CHILENO;;X;VILLARICA                     ;ARAUCANIA;147980;2;2;0;0;0;2;2;147980;BICICLETA INFANTIL ARO 12 ROSADA;BICICLETAS
15107344;;F;39;CHILENO;;Millenial;N/D;N/D;84540;2;1;2;1;84540;0;0;0;BICICLETA INFANTIL ARO 12 ROSADA;BICICLETAS
9951590;;F;55;CHILENO;;Boomers;N/D;N/D;109980;2;1;0;0;0;2;1;109980;BICICLETA INFANTIL ARO 20 NEGRA;BICICLETAS
16275014;Soltero;M;36;CHILENO;;Millenial;PROVIDENCIA                   ;METROPOLITANA;196980;2;1;2;1;196980;0;0;0;BICI RETROPLUS ROSADA 26 V-BRAKE;BICICLETAS
13959838;;M;41;CHILENO;;Boomers;PROVIDENCIA                   ;METROPOLITANA;260840;2;1;2;1;260840;0;0;0;MODELO SUNPEED STELLA ARO 27.5 CELESTE S;BICICLETAS
7622829;;F;63;CHILENO;;Boomers;N/D;N/D;268970;3;2;2;1;259980;1;1;8990;BICI VIGORPLUS VERDE 27,5 V-BRAKE;BICICLETAS
5096198;;F;74;CHILENO;;Silencioso;ILLAPEL                       ;COQUIMBO;243520;4;2;4;2;243520;0;0;0;BC XTS MTB ACE MUJ SHINE 27 18VEL DISCO TURQ;BICICLETAS
6902034;;M;67;CHILENO;;Boomers;TALCA                         ;MAULE;299970;3;1;0;0;0;3;1;299970;BICICLETA INFANTIL ARO 20 AMARILLA;BICICLETAS
17299987;;M;33;CHILENO;;Millenial;"";"";309980;2;1;0;0;0;2;1;309980;BICICLETA MONKEL 29 ALUMINIO AZUL;BICICLETAS
15903117;Casado;F;38;CHILENO;TECNICO DE NIVEL SUPERIOR EN ENFERMERIA;Millenial;PROVIDENCIA                   ;METROPOLITANA;101480;2;1;2;1;101480;0;0;0;BICICLETA INFANTIL ARO 16 ROSADA;BICICLETAS
13859731;;F;42;CHILENO;;X;TEMUCO                        ;ARAUCANIA;96980;2;1;2;1;96980;0;0;0;V-MTB ARO 16 MINNIE ROSADO;BICICLETAS
8477828;;F;69;CHILENO;;Silencioso;SAN CARLOS                    ;BIO BIO;89990;1;1;0;0;0;1;1;89990;BICICLETA INFANTIL ARO 16 ROSADA;BICICLETAS
16835646;;F;34;CHILENO;;Millenial;LONGAVI                       ;MAULE;135480;2;1;2;1;135480;0;0;0;V-MTB ARO 16 CAPITAN AMERICA AZUL;BICICLETAS
14272794;;M;47;CHILENO;;X;TALCAHUANO                    ;BIO BIO;339990;1;1;0;0;0;1;1;339990;BICICLETA MTB XT-27.5 ARO 27 VERDE;BICICLETAS
14184733;;M;41;CHILENO;;Silencioso;PROVIDENCIA                   ;METROPOLITANA;123980;2;1;2;1;123980;0;0;0;BICICLETA INFANTIL VENOM ARO 16 NEGRO;BICICLETAS
19119406;;F;27;CHILENO;;Z;SAN FELIPE                    ;VALPARAISO;144980;2;1;2;1;144980;0;0;0;BICICLETA INFANTIL VENOM ARO 16 NEGRO;BICICLETAS
4480107;;F;82;CHILENO;;Silencioso;ZAPALLAR                      ;VALPARAISO;436440;5;3;0;0;0;5;3;436440;BICICLETA MONKEL 29 ALUMINIO GRIS;BICICLETAS
16514973;;F;35;CHILENO;;Silencioso;PROVIDENCIA                   ;METROPOLITANA;0;0;0;0;0;0;0;0;0;BARBIE 16 BLANCO;BICICLETAS
16728240;;M;34;CHILENO;;Millenial;RENCA                         ;METROPOLITANA;0;0;0;0;0;0;0;0;0;BIANCHI ADVANTAGE 27,5 SX GRIS OSCURO SEMI MATTE;BICICLETAS
16196998;;F;35;CHILENO;;Millenial;PROVIDENCIA                   ;METROPOLITANA;0;0;0;0;0;0;0;0;0;BICICLETA VISION KRYPTON ALUMINIO (NEGRO / VERDE;BICICLETAS
12939845;Soltero;M;46;CHILENO;;X;RENCA                         ;METROPOLITANA;0;0;0;0;0;0;0;0;0;BICICLETA VISION KRYPTON ALUMINIO (NEGRO / NARAN;BICICLETAS
13944951;Casado;M;41;CHILENO;;Silencioso;PROVIDENCIA                   ;METROPOLITANA;0;0;0;0;0;0;0;0;0;BICICLETA INFANTIL ARO 12 ROJA;BICICLETAS
6461108;;M;67;CHILENO;;Boomers;MAIPU                         ;METROPOLITANA;0;0;0;0;0;0;0;0;0;BICI BMX JUMP PRO ARO 20 PLATEADA;BICICLETAS
19080277;Soltero;F;27;CHILENO;;Silencioso;PROVIDENCIA                   ;METROPOLITANA;0;0;0;0;0;0;0;0;0;MODELO SUNPEED STELLA ARO 27.5 CELESTE S;BICICLETAS
16983626;;F;33;CHILENO;;Millenial;PROVIDENCIA                   ;METROPOLITANA;0;0;0;0;0;0;0;0;0;BARBIE 12 CELESTE;BICICLETAS
14398541;;F;44;CHILENO;;X;TALCA                         ;MAULE;0;0;0;0;0;0;0;0;0;BICI VIGOR GRIS 24 V-BRAKE;BICICLETAS
12532277;;F;48;CHILENO;;Silencioso;PROVIDENCIA                   ;METROPOLITANA;0;0;0;0;0;0;0;0;0;BICI VIGOR GRIS 24 V-BRAKE;BICICLETAS
17172424;;M;33;CHILENO;;Millenial;PROVIDENCIA                   ;METROPOLITANA;0;0;0;0;0;0;0;0;0;BICI STRIKER AMARILLA 29 V-BRAKE;BICICLETAS
8062572;Viudo;F;64;CHILENO;;Boomers;PROVIDENCIA                   ;METROPOLITANA;0;0;0;0;0;0;0;0;0;BICI CITYPETITE ROJA 24 V-BRAKE;BICICLETAS
18041445;;F;30;CHILENO;;Millenial;PROVIDENCIA                   ;METROPOLITANA;0;0;0;0;0;0;0;0;0;FREESTYLE PRO ARO 20 NEGRA/AZUL;BICICLETAS
8879574;;F;61;CHILENO;;Boomers;EL QUISCO;VALPARAISO;0;0;0;0;0;0;0;0;0;BICICLETA BARBIE ARO12 ROSADO/LILA;BICICLETAS
13280807;Casado;M;44;CHILENO;DOCTOR;X;PROVIDENCIA                   ;METROPOLITANA;0;0;0;0;0;0;0;0;0;BICI BMX JUMP PRO ARO 20 PLATEADA;BICICLETAS
18077447;Soltero;F;30;CHILENO;TECNICO EN ENFERMERIA DE NIVEL SUPERIOR;Millenial;PROVIDENCIA                   ;METROPOLITANA;0;0;0;0;0;0;0;0;0;FREESTYLE PRO ARO 20 NEGRA/AZUL;BICICLETAS
10999057;;M;53;CHILENO;;X;PROVIDENCIA                   ;METROPOLITANA;0;0;0;0;0;0;0;0;0;BICI SHINEPLUS BLANCA 27,5 FRENO DISCO;BICICLETAS
16652867;Soltero;M;35;CHILENO;INGENIERO EN PREVENCION DE RIESGOS;Millenial;PROVIDENCIA                   ;METROPOLITANA;0;0;0;0;0;0;0;0;0;BICICLETA INFANTIL ARO 16 ROSADA;BICICLETAS
5089267;;M;73;CHILENO;;Silencioso;N/D;N/D;0;0;0;0;0;0;0;0;0;BICI STRIKER NEGRA 29 FRENO DISCO;BICICLETAS
17091597;;M;33;CHILENO;;Millenial;PROVIDENCIA                   ;METROPOLITANA;0;0;0;0;0;0;0;0;0;BICICLETA INFANTIL ARO 20 AMARILLA;BICICLETAS
13620819;;M;43;CHILENO;;X;RENCA                         ;METROPOLITANA;0;0;0;0;0;0;0;0;0;BICICLETA INFANTIL ARO 20 NEGRA;BICICLETAS
15528458;;M;40;CHILENO;;X;CHAITEN                       ;LOS LAGOS;0;0;0;0;0;0;0;0;0;BICICLETA INFANTIL ARO 20 BLANCA;BICICLETAS
11767931;;M;51;CHILENO;;X;N/D;N/D;0;0;0;0;0;0;0;0;0;BICI VIGORPLUS NEGRA 27,5 V-BRAKE;BICICLETAS
11180958;Casado;F;54;CHILENO;;Boomers;HIJUELAS                      ;VALPARAISO;0;0;0;0;0;0;0;0;0;BICI VIGORPLUS VERDE 27,5 V-BRAKE;BICICLETAS
16577669;Soltero;M;33;CHILENO;;Millenial;RENCA                         ;METROPOLITANA;0;0;0;0;0;0;0;0;0;BICI BMX FREESTYLE ARO 20 AZUL;BICICLETAS
4726490;;M;80;CHILENO;;Silencioso;VALLENAR;ATACAMA;0;0;0;0;0;0;0;0;0;BICI SHINEPLUS BLANCA 27,5 FRENO DISCO;BICICLETAS
15164948;;M;42;CHILENO;;X;PROVIDENCIA                   ;METROPOLITANA;0;0;0;0;0;0;0;0;0;BICICLETA INFANTIL ARO 16 AZUL;BICICLETAS
6322711;Soltero;F;69;CHILENO;PROFESOR;Silencioso;RENCA                         ;METROPOLITANA;0;0;0;0;0;0;0;0;0;BICICLETA INFANTIL ARO 20 AMARILLA;BICICLETAS
19094750;;F;27;CHILENO;;Z;PROVIDENCIA                   ;METROPOLITANA;0;0;0;0;0;0;0;0;0;BICICLETA INFANTIL ARO 20 AMARILLA;BICICLETAS
17331303;;F;32;CHILENO;;Millenial;COPIAPO                       ;ATACAMA;0;0;0;0;0;0;0;0;0;BICICLETA INFANTIL ARO 16 CELESTE;BICICLETAS
6225286;Casado;F;72;CHILENO;ASISTENTE SOCIAL;Silencioso;PROVIDENCIA                   ;METROPOLITANA;0;0;0;0;0;0;0;0;0;BICICLETA INFANTIL ARO 20 AMARILLA;BICICLETAS
18793212;Soltero;M;27;CHILENO;;Millenial;PROVIDENCIA                   ;METROPOLITANA;0;0;0;0;0;0;0;0;0;BICICLETA INFANTIL ARO 20 AMARILLA;BICICLETAS
17827163;;M;31;CHILENO;;Millenial;PROVIDENCIA                   ;METROPOLITANA;0;0;0;0;0;0;0;0;0;BICICLETA INFANTIL ARO 16 NEGRA;BICICLETAS
7773449;;F;63;CHILENO;;Boomers;RENCA                         ;METROPOLITANA;0;0;0;0;0;0;0;0;0;BICI STRIKER AMARILLA 29 V-BRAKE;BICICLETAS
7720079;;F;70;CHILENO;;Silencioso;IQUIQUE                       ;TARAPACA;0;0;0;0;0;0;0;0;0;BICI BMX FREESTYLE ARO 20 AZUL;BICICLETAS
14353105;;F;43;CHILENO;;X;PROVIDENCIA                   ;METROPOLITANA;0;0;0;0;0;0;0;0;0;BICICLETA INFANTIL ARO 16 NEGRA;BICICLETAS
13274606;;M;45;CHILENO;;X;SAN CLEMENTE                  ;MAULE;0;0;0;0;0;0;0;0;0;BICI SHINEPLUS GRIS 27,5 FRENO DISCO;BICICLETAS
16571241;;M;35;CHILENO;;Millenial;RENCA                         ;METROPOLITANA;0;0;0;0;0;0;0;0;0;BICI CITYPETITE VERDE 24 V-BRAKE;BICICLETAS
17665493;;F;31;CHILENO;;Millenial;TALAGANTE;METROPOLITANA;0;0;0;0;0;0;0;0;0;BICICLETA INFANTIL ARO 20 AMARILLA;BICICLETAS
17142093;Casado;F;33;CHILENO;;Millenial;N/D;N/D;0;0;0;0;0;0;0;0;0;BICICLETA INFANTIL ARO 20 ROSADA;BICICLETAS
10234556;;F;57;CHILENO;;Boomers;RENCA                         ;METROPOLITANA;0;0;0;0;0;0;0;0;0;BICICLETA INFANTIL ARO 20 ROSADA;BICICLETAS
12068993;;M;52;CHILENO;;X;PROVIDENCIA                   ;METROPOLITANA;0;0;0;0;0;0;0;0;0;V-MTB ARO 16 HOMBRE AVENGERS GRIS;BICICLETAS
18228877;;F;30;CHILENO;;Millenial;CHIMBARONGO                   ;L.G.B.OÂ´HIGGINS;0;0;0;0;0;0;0;0;0;BICI VIGORPLUS VERDE 27,5 V-BRAKE;BICICLETAS
14605117;Casado;F;40;CHILENO;;X;PROVIDENCIA                   ;METROPOLITANA;0;0;0;0;0;0;0;0;0;BICICLETA INFANTIL ARO 12 CELESTE;BICICLETAS
10420787;;M;56;CHILENO;;Boomers;CHILLAN                       ;BIO BIO;0;0;0;0;0;0;0;0;0;BIANCHI KITTY 16 ROSADO / BLANCO;BICICLETAS
7982896;Soltero;F;63;CHILENO;CONTADOR GENERAL;Boomers;PROVIDENCIA                   ;METROPOLITANA;0;0;0;0;0;0;0;0;0;BICICLETA INFANTIL ARO 12 CELESTE;BICICLETAS
12589955;;M;47;CHILENO;;X;RENCA                         ;METROPOLITANA;0;0;0;0;0;0;0;0;0;BICI BMX FREESTYLE ARO 20 AZUL;BICICLETAS
14281373;;M;48;CHILENO;;X;PROVIDENCIA                   ;METROPOLITANA;0;0;0;0;0;0;0;0;0;SET DE PROTECCIONES BIA;BICICLETAS
17075837;;F;33;CHILENO;;Millenial;CORONEL                       ;BIO BIO;0;0;0;0;0;0;0;0;0;BIANCHI 20 CLASSIC GIRL VERDE CLARO;BICICLETAS
8710372;Casado;F;63;CHILENO;;Boomers;PROVIDENCIA                   ;METROPOLITANA;0;0;0;0;0;0;0;0;0;V-BICICLETA PASEO PROVENZA ARO 26;BICICLETAS
18829860;;M;28;CHILENO;;Millenial;PROVIDENCIA                   ;METROPOLITANA;0;0;0;0;0;0;0;0;0;BICI CITYCOMMUTER AZUL ARO 26;BICICLETAS
9543721;Divorciado;M;58;CHILENO;;Boomers;RENCA                         ;METROPOLITANA;0;0;0;0;0;0;0;0;0;MOTOBIKE INFANTIL ROJA ARO 12;BICICLETAS
13797670;;M;42;CHILENO;;X;N/D;N/D;1553870;13;4;0;0;0;13;4;1553870;CAMA EUROPEA NEW MEGA + SET IBIZA 2 PLAZAS BD;DORMITORIO
12107096;;F;45;CHILENO;;X;PROVIDENCIA                   ;METROPOLITANA;343970;3;2;0;0;0;3;2;343970;COLCHON THERAPEDIC 2P;DORMITORIO
8901924;;M;62;CHILENO;;Boomers;N/D;N/D;-27700;1;3;0;0;0;1;3;-27700;CE EVOLUTION BLACK 1,5P BN RESP+VEL;DORMITORIO
10051332;;F;50;CHILENO;;X;PROVIDENCIA                   ;METROPOLITANA;129990;1;1;1;1;129990;0;0;0;COLCHON 1PZA NEW VERSATILE BY ABCDIN;DORMITORIO
9053193;;F;56;CHILENO;;Boomers;RENCA                         ;METROPOLITANA;19980;2;1;0;0;0;2;1;19980;Almohadas Isidora Soft 50x70 cm;DORMITORIO
14106351;;M;41;CHILENO;;X;IQUIQUE;TARAPACA;231980;2;1;2;1;231980;0;0;0;CE EVOLUTION BLACK 1,5P BN RESP+VEL;DORMITORIO
5733561;;F;76;CHILENO;;Millenial;N/D;N/D;183970;3;1;0;0;0;3;1;183970;COLCHON BAMBOO 1,5P FIBRAS BAMBOO;DORMITORIO
12296040;;F;50;CHILENO;;X;TALCA                         ;MAULE;932560;12;6;0;0;0;12;6;932560;COLCHON ERGO T 1,5P;DORMITORIO
7603085;;F;67;CHILENO;;Boomers;LOS ALAMOS                    ;BIO BIO;1731500;16;8;0;0;0;16;8;1731500;BOX BAMBOO + Respaldo + 2 Veladores ALICANTE;DORMITORIO
6919939;;M;69;CHILENO;;Silencioso;PUERTO MONTT                  ;LOS LAGOS;189980;2;1;0;0;0;2;1;189980;COLCHON ERGO T 2P;DORMITORIO
17168618;;F;33;CHILENO;;Millenial;SAN BERNARDO                  ;METROPOLITANA;783900;9;4;9;4;783900;0;0;0;COLCHON ERGO T 1P;DORMITORIO
10055652;;M;56;CHILENO;;Boomers;LA SERENA                     ;COQUIMBO;452647;9;6;0;0;0;9;6;452647;CE EVOLUTION BLACK 1,5P + RESPALDO CASTILLA;DORMITORIO
7175534;;F;67;CHILENO;;Boomers;TALCA                         ;MAULE;216280;3;1;0;0;0;3;1;216280;COLCHON THERAPEDIC 2P;DORMITORIO
14320364;;F;47;CHILENO;;X;SAN CARLOS                    ;BIO BIO;580980;2;1;0;0;0;2;1;580980;CAMA ERGO T 1.50X2.00 BD ROBIN C;DORMITORIO
10623900;;F;54;CHILENO;;X;PROVIDENCIA                   ;METROPOLITANA;211980;2;1;0;0;0;2;1;211980;COLCHON NEW STYLE 2 2P;DORMITORIO
7459359;;F;71;CHILENO;;Silencioso;LOS ANGELES                   ;BIO BIO;107840;3;2;0;0;0;3;2;107840;PACK 2 ALMOHADAS C+L;DORMITORIO
15102319;;F;39;CHILENO;;X;QUILPUE                       ;VALPARAISO;513920;4;1;0;0;0;4;1;513920;CE ERGO T 2P 2MT BD;DORMITORIO
19011589;;F;21;CHILENO;;Millenial;"";"";23980;2;2;0;0;0;2;2;23980;ALMOHADA FLEX-D VISCOLASTICA 60 x 40;DORMITORIO
13001293;;F;53;CHILENO;;X;ANCUD                         ;LOS LAGOS;382950;5;3;2;1;174980;3;2;207970;CE EVOLUTION BLACK 1P BN DUAL SIDE;DORMITORIO
6612996;;F;71;CHILENO;;Silencioso;PROVIDENCIA                   ;METROPOLITANA;939830;15;8;6;2;595920;9;6;343910;CAMA EUROPEA CASALINDA CDM 2PL BD;DORMITORIO
12120741;;M;52;CHILENO;;X;CONSTITUCION                  ;MAULE;577811;4;3;0;0;0;4;3;577811;COLCHON EVOLUTION BLACK 1,5P DUAL SIDE;DORMITORIO
8757747;;F;73;CHILENO;;Silencioso;RETIRO                        ;MAULE;707900;10;6;0;0;0;10;6;707900;CLOSET ESPANA 6P+4C;DORMITORIO
14440431;;M;48;CHILENO;;X;PROVIDENCIA                   ;METROPOLITANA;219990;1;1;0;0;0;1;1;219990;BOX AMERICANO MIRAGE 2PBN;DORMITORIO
10940522;;F;55;CHILENO;;Boomers;PUENTE ALTO                   ;METROPOLITANA;17990;1;1;0;0;0;1;1;17990;ALMOHADA COOL GEL TECH SERIES 60X40 CM;DORMITORIO
11601785;;M;51;CHILENO;;X;N/D;N/D;643949;5;5;0;0;0;5;5;643949;SET 2 ALMOHADAS VISCO MEDIUM 60X40 CM;DORMITORIO
15885667;;F;37;CHILENO;;Millenial;VALLENAR;ATACAMA;1194940;6;3;0;0;0;6;3;1194940;BOX AMERICANO MIRAGE 2PBN;DORMITORIO
15996919;;F;37;CHILENO;;Millenial;PUERTO MONTT                  ;LOS LAGOS;6990;1;1;0;0;0;1;1;6990;Almohadas Isidora Soft 50x70 cm;DORMITORIO
12999158;;F;50;CHILENO;;X;FRESIA                        ;LOS LAGOS;297960;4;2;0;0;0;4;2;297960;COLCHON EVOLUTION BLACK 1,5P DUAL SIDE;DORMITORIO
6092156;Casado;M;69;CHILENO;;Silencioso;PROVIDENCIA                   ;METROPOLITANA;189980;2;1;2;1;189980;0;0;0;CE EVOLUTION BLACK 1,5P + RESPALDO CASTILLA;DORMITORIO
6991246;;F;70;CHILENO;;Silencioso;CHILLAN                       ;BIO BIO;19980;2;2;0;0;0;2;2;19980;PACK 2 ALMOHADAS C+L;DORMITORIO
11182687;;F;55;CHILENO;;Boomers;PROVIDENCIA                   ;METROPOLITANA;4990;1;1;0;0;0;1;1;4990;PACK 2 ALMOHADAS C+L;DORMITORIO
11413864;;F;55;CHILENO;;Boomers;N/D;N/D;307280;4;2;2;1;184980;2;1;122300;CLOSET M-701 6 PUERTAS 2 CAJONES ALTO 1,82 COLOR;DORMITORIO
16670613;;F;34;CHILENO;;Millenial;PROVIDENCIA                   ;METROPOLITANA;226310;0;3;2;1;241980;-2;2;-15670;C.EURO EXCELLENCE PLUS 1P+RESP+1VEL NEW GALES;DORMITORIO
7167636;;F;68;CHILENO;;Boomers;LOS ANGELES                   ;BIO BIO;562950;5;4;0;0;0;5;4;562950;PACK 2 ALMOHADAS C+L;DORMITORIO
12912537;;F;47;CHILENO;;X;PROVIDENCIA                   ;METROPOLITANA;109980;2;1;2;1;109980;0;0;0;COMODA CIPRES MODELO CP10D, COLOR DEMOLICION, 1;DORMITORIO
19580898;;M;24;CHILENO;;Z;PROVIDENCIA                   ;METROPOLITANA;192960;2;3;0;0;0;2;3;192960;CAMA AMERICANA BEAT 1.05X1.90 TABORï¿½Â ;DORMITORIO
16686069;;M;35;CHILENO;;Millenial;COQUIMBO;COQUIMBO;182980;2;1;2;1;182980;0;0;0;CLOSET 2P 3C MOD G584 - BICOLOR 46 pulgadas;DORMITORIO
13318610;;M;45;CHILENO;;X;PROVIDENCIA                   ;METROPOLITANA;156980;2;2;0;0;0;2;2;156980;COLCHON BAMBOO 1,5P FIBRAS BAMBOO;DORMITORIO
5752736;;M;73;CHILENO;;Silencioso;N/D;N/D;34980;2;2;0;0;0;2;2;34980;ALMOHADA VISCO ELASTICA CANNABIS 60X40CM;DORMITORIO
18346062;;F;29;CHILENO;;Millenial;N/D;N/D;1842930;7;2;3;1;367970;4;1;1474960;BOX AM NEW ENTREE 1.5 PL;DORMITORIO
20734315;;M;21;CHILENO;;Z;"";"";19960;4;1;4;1;19960;0;0;0;PACK 2 ALMOHADAS C+L;DORMITORIO
6291998;;F;74;CHILENO;;Silencioso;TEMUCO                        ;ARAUCANIA;384980;2;1;0;0;0;2;1;384980;Cama Europea Terapeutic 2PBD;DORMITORIO
19522346;;F;25;CHILENO;;Millenial;"";"";4990;1;1;1;1;4990;0;0;0;PACK 2 ALMOHADAS C+L;DORMITORIO
20468909;;M;22;CHILENO;;Z;PROVIDENCIA                   ;METROPOLITANA;14970;3;1;3;1;14970;0;0;0;PACK 2 ALMOHADAS C+L;DORMITORIO
18436967;;F;29;CHILENO;;Millenial;PROVIDENCIA                   ;METROPOLITANA;128980;2;1;2;1;128980;0;0;0;CE EVOLUTION BLACK 1P BN DUAL SIDE;DORMITORIO
10531565;;F;55;CHILENO;;Boomers;OSORNO                        ;LOS LAGOS;227440;4;2;0;0;0;4;2;227440;CE EVOLUTION BLACK 1,5P BN RESP+VEL;DORMITORIO
11614767;;F;52;CHILENO;;X;ANTOFAGASTA                   ;ANTOFAGASTA;328552;6;3;0;0;0;6;3;328552;ALMOHADA VISCO ELASTICA CANNABIS 60X40CM;DORMITORIO
14605826;;F;44;CHILENO;;X;PROVIDENCIA                   ;METROPOLITANA;169980;2;1;2;1;169980;0;0;0;CE EVOLUTION BLACK 1,5P + RESPALDO CASTILLA;DORMITORIO
13614878;;M;43;CHILENO;;X;N/D;N/D;463950;5;3;4;2;353960;1;1;109990;Closet BAKER TV 43 2PT 4CJ CHOCOLATE;DORMITORIO
10042075;;M;57;CHILENO;;Boomers;PUERTO MONTT                  ;LOS LAGOS;121900;3;1;0;0;0;3;1;121900;RACK MURILLO CHOCOLATE;DORMITORIO
8142651;;F;67;CHILENO;;Boomers;QUILLOTA                      ;VALPARAISO;516660;4;2;0;0;0;4;2;516660;COLCHON TERAPEUTIC 2P PILLOW TOP;DORMITORIO
16263002;;M;36;CHILENO;;Millenial;RENCA                         ;METROPOLITANA;311980;2;1;2;1;311980;0;0;0;DIVAN NEW ORTOPEDIC 1,5P BLACK;DORMITORIO
20546257;;M;22;CHILENO;;Millenial;"";"";188980;2;1;2;1;188980;0;0;0;CE EVOLUTION BLACK 1,5P + RESPALDO CASTILLA;DORMITORIO
9631466;;F;61;CHILENO;;Boomers;OSORNO                        ;LOS LAGOS;9980;2;1;0;0;0;2;1;9980;PACK 2 ALMOHADAS C+L;DORMITORIO
12840235;;F;46;CHILENO;;X;ANTOFAGASTA                   ;ANTOFAGASTA;545440;6;4;2;1;105480;4;3;439960;COLCHON BAMBOO 2P FIBRAS BAMBOO;DORMITORIO
19722906;;M;24;CHILENO;;Z;PROVIDENCIA                   ;METROPOLITANA;474970;3;1;3;1;474970;0;0;0;CE EVOLUTION BLACK 2P BD+RESP+2 VEL;DORMITORIO
15963190;;F;37;CHILENO;;Millenial;PROVIDENCIA                   ;METROPOLITANA;219990;1;1;0;0;0;1;1;219990;COLCHON BAMBOO 2P FIBRAS BAMBOO;DORMITORIO
18990241;Soltero;M;27;CHILENO;;Millenial;PENALOLEN;METROPOLITANA;159980;2;1;2;1;159980;0;0;0;CE EVOLUTION BLACK 1,5P + RESPALDO CASTILLA;DORMITORIO
17120099;;F;33;CHILENO;;Millenial;VALPARAISO                    ;VALPARAISO;176980;2;1;2;1;176980;0;0;0;CLOSET MANILA Z-120 5P - DUNA /BLANCO;DORMITORIO
8059784;;F;61;CHILENO;;Boomers;RANCAGUA                      ;L.G.B.OÂ´HIGGINS;506930;6;2;3;1;208960;3;1;297970;CLOSET 4P 2C MOD S444 - CAFE CLARO;DORMITORIO
6751004;;F;73;CHILENO;;Silencioso;NUEVA IMPERIAL                ;ARAUCANIA;1362100;7;5;0;0;0;7;5;1362100;CE EVEREST 2P 2MTS BD DUAL SIDE;DORMITORIO
18057909;;M;30;CHILENO;;Silencioso;PROVIDENCIA                   ;METROPOLITANA;169980;2;1;2;1;169980;0;0;0;COLCHON NEW STYLE 2 2P;DORMITORIO
16836473;;M;35;CHILENO;;Millenial;PROVIDENCIA                   ;METROPOLITANA;271520;2;1;0;0;0;2;1;271520;COLCHON BAMBOO 2P FIBRAS BAMBOO;DORMITORIO
12294875;;M;49;CHILENO;;X;N/D;N/D;761950;5;3;2;1;143980;3;2;617970;COLCHON WAVE 0.90X1.90;DORMITORIO
19072365;Soltero;F;27;CHILENO;;Z;VALDIVIA                      ;LOS LAGOS;306980;2;1;2;1;306980;0;0;0;CE ERGO T 2P 2MT BD;DORMITORIO
14340799;;F;44;CHILENO;;X;CALERA DE TANGO               ;METROPOLITANA;143960;4;2;4;2;143960;0;0;0;CLOSET CIPRES MODELO CMS24D, COLOR DEMOLICION, 2;DORMITORIO
16719760;;F;34;CHILENO;;Millenial;NUNOA                         ;METROPOLITANA;911960;4;2;4;2;911960;0;0;0;CAMA MULTI RETRACTIL 1.5P;DORMITORIO
12983110;;M;45;CHILENO;;X;RENCA                         ;METROPOLITANA;4990;1;1;0;0;0;1;1;4990;PACK 2 ALMOHADAS C+L;DORMITORIO
6236857;;F;74;CHILENO;;Silencioso;ARICA                         ;TARAPACA;457970;3;1;0;0;0;3;1;457970;COLCHON BAMBOO 2P FIBRAS BAMBOO;DORMITORIO
13756523;Casado;M;42;CHILENO;PSICOLOGO;X;RENCA                         ;METROPOLITANA;131980;2;1;2;1;131980;0;0;0;CAMA BOMBERO 1P;DORMITORIO
16842891;;F;32;CHILENO;;Millenial;PROVIDENCIA                   ;METROPOLITANA;468960;3;1;3;1;468960;0;0;0;CE CURVE BALANCE KING;DORMITORIO
19274157;;F;26;CHILENO;;Z;NANCAGUA                      ;L.G.B.OÂ´HIGGINS;9980;2;1;0;0;0;2;1;9980;PACK 2 ALMOHADAS C+L;DORMITORIO
16083834;Soltero;F;37;CHILENO;;Millenial;PROVIDENCIA                   ;METROPOLITANA;119980;2;1;2;1;119980;0;0;0;COLCHON EXCELLENCE 1,5P;DORMITORIO
20292646;;F;22;CHILENO;;Z;PUERTO MONTT;LOS LAGOS;9990;3;1;0;0;0;3;1;9990;PACK 2 ALMOHADAS C+L;DORMITORIO
14112578;;F;40;CHILENO;;X;"";"";579970;3;2;0;0;0;3;2;579970;BOX SPRING NEOSENSE FULL BLACK;DORMITORIO
21748223;Casado;F;46;EXTRANJERO - NO INFORMA NACIONALIDAD;;Extranjero;RECOLETA;METROPOLITANA;579980;2;1;2;1;579980;0;0;0;CE TEMPO 1.50X2.00 2P BD RESP ISSEY GRAF ];DORMITORIO
26353544;;M;27;ECUATORIANO;;Extranjero;N/D;N/D;318980;2;1;0;0;0;2;1;318980;DIVAN CAMA ERGO T 1,5P 2 MTS;DORMITORIO
19024648;;F;27;CHILENO;;Z;PEDRO AGUIRRE CERDA;METROPOLITANA;287880;2;1;2;1;287880;0;0;0;BS ORTOPEDIC ADVANCE B5 BLACK 2PBN;DORMITORIO
6353769;;F;73;CHILENO;;Silencioso;N/D;N/D;1162770;9;3;0;0;0;9;3;1162770;CAMA EUROPEA IBIZA 2 PL BD;DORMITORIO
17761060;;F;32;CHILENO;;Millenial;PROVIDENCIA                   ;METROPOLITANA;963980;11;3;11;3;963980;0;0;0;DIVAN CAMA ERGO T 1,5P 2MTS+RESP+1 VEL TABOR;DORMITORIO
14656178;;F;31;CHILENO;;Millenial;ARICA;TARAPACA;320980;2;1;2;1;320980;0;0;0;CE ERGO T 2P 2MT BD;DORMITORIO
18120806;;M;30;CHILENO;;Millenial;PUENTE ALTO;METROPOLITANA;8483;2;1;0;0;0;2;1;8483;PACK 2 ALMOHADAS C+L;DORMITORIO
12097756;;F;53;CHILENO;;X;"";"";239980;2;1;2;1;239980;0;0;0;CE EVOLUTION BLACK 2P BD DUAL SIDE;DORMITORIO
10332703;;F;55;CHILENO;;Boomers;SAN ANTONIO                   ;VALPARAISO;36950;5;3;0;0;0;5;3;36950;Almohada Imperial Soft 50x70 cm;DORMITORIO
11252462;;M;53;CHILENO;;X;ANCUD                         ;LOS LAGOS;224980;2;1;2;1;224980;0;0;0;CAMA AMERICANA BEAT 2 PLAZAS 150 X 190 CM;DORMITORIO
19451076;;M;25;CHILENO;;Z;COPIAPO;ATACAMA;397980;2;1;2;1;397980;0;0;0;C.EURO NEW ORTOPEDIC 2PBN +RESP+2VEL ESPRESSO;DORMITORIO
16547363;;F;35;CHILENO;;Millenial;MAIPU;METROPOLITANA;199980;2;1;2;1;199980;0;0;0;C.EUROPEA EXCELLENCE PLUS 1.5P +RESP+VEL OLMO;DORMITORIO
18139634;Soltero;F;29;CHILENO;PROFESOR;Millenial;PROVIDENCIA                   ;METROPOLITANA;29990;1;1;0;0;0;1;1;29990;ALMOHADA VISCO ELASTICA CANNABIS 60X40CM;DORMITORIO
6317902;;F;75;CHILENO;;Silencioso;NATALES                       ;MAGALLANES;599970;3;2;0;0;0;3;2;599970;BOX AMERICANO EXCELLENCE 2P BASE NORMAL+2ALM;DORMITORIO
18453099;Casado;F;28;CHILENO;;Millenial;PROVIDENCIA                   ;METROPOLITANA;138980;2;1;2;1;138980;0;0;0;RESPALDO TIGRIS 2 PLAZAS;DORMITORIO
7124003;;F;67;CHILENO;;Boomers;TALCAHUANO                    ;BIO BIO;278980;3;1;0;0;0;3;1;278980;CE ERGO T 2P 2MT BD;DORMITORIO
12411927;;F;49;CHILENO;;X;MELIPILLA                     ;METROPOLITANA;35990;1;1;0;0;0;1;1;35990;Almohada ViscoGel Cobre 70x40x13 cm;DORMITORIO
8905383;;F;52;CHILENO;;X;RENCA                         ;METROPOLITANA;380960;4;2;4;2;380960;0;0;0;BOX AMERICANO BEAT 1,5 PLAZAS 105 X 190 CM;DORMITORIO
16439788;Soltero;F;33;CHILENO;;Millenial;PROVIDENCIA                   ;METROPOLITANA;4990;1;1;0;0;0;1;1;4990;PACK 2 ALMOHADAS C+L;DORMITORIO
14138503;;F;41;CHILENO;;X;VICTORIA                      ;ARAUCANIA;4990;1;1;0;0;0;1;1;4990;PACK 2 ALMOHADAS C+L;DORMITORIO
11783147;;F;51;CHILENO;;X;N/D;N/D;419980;2;1;2;1;419980;0;0;0;CAMA ERGO T 2PBN + RESP + 2 VEL FERRARA;DORMITORIO
15725471;Casado;M;39;CHILENO;;X;PROVIDENCIA                   ;METROPOLITANA;291980;2;1;2;1;291980;0;0;0;DIVAN CAMA ERGO T 1,5P 2 MTS;DORMITORIO
14513873;;F;48;CHILENO;;X;PROVIDENCIA                   ;METROPOLITANA;596940;6;1;0;0;0;6;1;596940;BOX AMERICANO MIRAGE 2PBN;DORMITORIO
20571161;;M;21;CHILENO;;Z;ANCUD;LOS LAGOS;85970;3;2;2;1;73980;1;1;11990;ESCRITORIO FAVATEX YATES CASTANO;DORMITORIO
16123698;;F;37;CHILENO;;Millenial;LO PRADO                      ;METROPOLITANA;189980;2;1;0;0;0;2;1;189980;CE EVOLUTION BLACK 1,5P BN RESP+VEL;DORMITORIO
26194095;;F;61;VENEZOLANO;;Extranjero;PUERTO MONTT                  ;LOS LAGOS;1135920;8;1;0;0;0;8;1;1135920;CE EVEREST 2P 2MTS BD DUAL SIDE;DORMITORIO
5701313;;F;77;CHILENO;;Silencioso;TALCAHUANO                    ;BIO BIO;90000;2;1;0;0;0;2;1;90000;RESP ITALIA CEDRO 2P CAFE;DORMITORIO
15339734;;M;39;CHILENO;;X;N/D;N/D;754940;6;3;5;2;634950;1;1;119990;CAMA EUROPEA THERAPEDIC MAS KING;DORMITORIO
4829182;;M;75;CHILENO;;Silencioso;RANCAGUA                      ;L.G.B.OÂ´HIGGINS;382970;3;1;0;0;0;3;1;382970;COLCHON BALANCE 2P;DORMITORIO
8244992;;M;63;CHILENO;;Boomers;CHIMBARONGO                   ;L.G.B.OÂ´HIGGINS;385150;4;2;0;0;0;4;2;385150;COLCHON TERAPEUTIC 2P PILLOW TOP;DORMITORIO
6315360;;F;70;CHILENO;;Silencioso;MELIPILLA                     ;METROPOLITANA;650930;5;1;0;0;0;5;1;650930;Cama Europea Active 1,5P;DORMITORIO
6276929;;F;70;CHILENO;;X;CALAMA                        ;ANTOFAGASTA;323960;4;1;0;0;0;4;1;323960;CE ERGO T 2P 2MT BD;DORMITORIO
5675645;;M;72;CHILENO;;Silencioso;MARIA PINTO                   ;METROPOLITANA;260980;2;1;0;0;0;2;1;260980;BOX AMERICANO EXCELLENCE 2P BN +2ALM+PLU;DORMITORIO
18747844;;M;28;CHILENO;;Millenial;N/D;N/D;875870;9;2;9;2;875870;0;0;0;CE SUPER PREMIUM 2PBD +RESP+2VEL NEW TOR CHOC;DORMITORIO
9248412;Divorciado;F;54;CHILENO;PROFESOR;X;RENCA                         ;METROPOLITANA;19980;2;2;2;2;19980;0;0;0;ALMOHADA DA SOFT SLEEP 50 X 70;DORMITORIO
19086917;Soltero;F;26;CHILENO;;Z;TALCA;MAULE;171980;2;1;2;1;171980;0;0;0;CE EVOLUTION BLACK 1,5P + RESPALDO CASTILLA;DORMITORIO
13144537;;F;45;CHILENO;;X;LOS ANGELES                   ;BIO BIO;461840;5;3;0;0;0;5;3;461840;Almohadas Isidora Soft 50x90 cm;DORMITORIO
9977675;;F;57;CHILENO;;Boomers;LO ESPEJO                     ;METROPOLITANA;109980;2;1;2;1;109980;0;0;0;CLOSET CIPRES MODELO CMS24D, COLOR DEMOLICION, 2;DORMITORIO
13754919;;F;42;CHILENO;;X;TILTIL;METROPOLITANA;129980;2;1;2;1;129980;0;0;0;COLCHON SPRING III 2P;DORMITORIO
12760480;;F;47;CHILENO;;X;CASTRO                        ;LOS LAGOS;-127020;2;3;0;0;0;2;3;-127020;PACK 2 ALMOHADAS C+L;DORMITORIO
20102326;;M;23;CHILENO;;Z;PROVIDENCIA                   ;METROPOLITANA;218980;2;1;2;1;218980;0;0;0;CAMA EUROPEA SPRING VI FULL;DORMITORIO
13285305;;M;45;CHILENO;;X;LA PINTANA                    ;METROPOLITANA;773930;7;3;0;0;0;7;3;773930;COLCHON EVOLUTION BLACK 1,5P DUAL SIDE;DORMITORIO
12171614;;M;49;CHILENO;;X;N/D;N/D;1811830;16;2;0;0;0;16;2;1811830;CE EVOLUTION BLACK 1,5P + RESPALDO CASTILLA;DORMITORIO
26357853;;M;42;VENEZOLANO;;Extranjero;PROVIDENCIA                   ;METROPOLITANA;409980;2;1;2;1;409980;0;0;0;CAMA SPACE BOX ORTOPEDIC ADVANCE 2P;DORMITORIO
9762675;;F;56;CHILENO;;Boomers;RENCA                         ;METROPOLITANA;9980;2;1;0;0;0;2;1;9980;PACK 2 ALMOHADAS C+L;DORMITORIO
9840267;;M;58;CHILENO;;Boomers;LA PINTANA                    ;METROPOLITANA;219990;1;1;0;0;0;1;1;219990;COLCHON BAMBOO 2P FIBRAS BAMBOO;DORMITORIO
12096292;;M;40;CHILENO;;X;N/D;N/D;209980;2;1;2;1;209980;0;0;0;COLCHON NEW STYLE 2 1,5P 105X200;DORMITORIO
26038656;;M;34;HAITIANO;;Extranjero;PROVIDENCIA                   ;METROPOLITANA;186980;2;1;0;0;0;2;1;186980;COLCHON 1PZA NEW VERSATILE BY ABCDIN;DORMITORIO
6046494;Soltero;F;69;CHILENO;;Silencioso;PROVIDENCIA                   ;METROPOLITANA;252980;3;1;0;0;0;3;1;252980;CE EVOLUTION BLACK 1,5P + RESPALDO CASTILLA;DORMITORIO
26264614;;F;44;COLOMBIANO;;Extranjero;COIHAIQUE                     ;AYSEN;308140;5;4;0;0;0;5;4;308140;PACK 2 ALMOHADAS C+L;DORMITORIO
24490047;;F;43;PERUANO;;Extranjero;SALAMANCA                     ;COQUIMBO;295970;3;2;2;1;165980;1;1;129990;CLOSET M-801 6P+2C ALTO 1,82 BLANCO NATURAL;DORMITORIO
5380818;Viudo;F;75;CHILENO;;Silencioso;LINARES                       ;MAULE;189980;2;1;0;0;0;2;1;189980;COLCHON BAMBOO 1,5P FIBRAS BAMBOO;DORMITORIO
9632463;;F;59;CHILENO;;Boomers;BUIN                          ;METROPOLITANA;307960;5;2;0;0;0;5;2;307960;COLCHON BAMBOO 2P FIBRAS BAMBOO;DORMITORIO
8596197;;F;65;CHILENO;;Boomers;TALCA                         ;MAULE;4990;1;1;0;0;0;1;1;4990;PACK 2 ALMOHADAS C+L;DORMITORIO
25049457;;F;39;VENEZOLANO;;Extranjero;PROVIDENCIA                   ;METROPOLITANA;425940;5;1;0;0;0;5;1;425940;COLCHON NEW ORTOPEDIC 2P;DORMITORIO
19161202;;M;27;CHILENO;;Z;N/D;N/D;267960;4;2;4;2;267960;0;0;0;CE EVOLUTION BLACK 1,5P BN RESP+VEL;DORMITORIO
10157887;;F;55;CHILENO;;Boomers;ARICA                         ;ARICA Y PARINACOTA;194970;3;2;0;0;0;3;2;194970;COLCHON NEW ORTOPEDIC 1,5P;DORMITORIO
8449916;;F;69;CHILENO;;Silencioso;PROVIDENCIA                   ;METROPOLITANA;279980;2;1;2;1;279980;0;0;0;BOX AMERICANO EXCELLENCE PLUS 2P BD +AL+PLU;DORMITORIO
18320323;;M;29;CHILENO;;Millenial;VICTORIA                      ;ARAUCANIA;355980;2;1;2;1;355980;0;0;0;CAMA AMERICANA SPRING VI 2.0 PL + ASTURIAS;DORMITORIO
8432161;Casado;M;55;CHILENO;;Boomers;PROVIDENCIA                   ;METROPOLITANA;310980;2;1;2;1;310980;0;0;0;CE NEW STYLE 2 2P 2MT BD;DORMITORIO
12504243;;M;48;CHILENO;;X;PROVIDENCIA                   ;METROPOLITANA;109980;2;1;2;1;109980;0;0;0;COLCHON EXCELLENCE 1,5P;DORMITORIO
10847902;;F;55;CHILENO;;Boomers;RENCA                         ;METROPOLITANA;129980;2;1;2;1;129980;0;0;0;COLCHON CASALINDA CDM 1.5PL X200;DORMITORIO
15887059;;F;38;CHILENO;;Millenial;LA PINTANA;METROPOLITANA;294970;3;2;0;0;0;3;2;294970;COLCHON IBIZA 2P;DORMITORIO
14507685;;M;42;CHILENO;;X;CALAMA                        ;ANTOFAGASTA;219620;4;2;4;2;219620;0;0;0;COLCHON ERGO T 2P;DORMITORIO
13744008;;F;42;CHILENO;;X;VALLENAR;ATACAMA;7990;1;1;0;0;0;1;1;7990;Pack Imperial Soft 45x65 cm.;DORMITORIO
5950976;;F;76;CHILENO;;Silencioso;ANCUD                         ;LOS LAGOS;1543340;8;3;0;0;0;8;3;1543340;COLCHON BAMBOO 2P FIBRAS BAMBOO;DORMITORIO
11915163;;F;50;CHILENO;;X;LOS ALAMOS                    ;BIO BIO;44950;5;1;0;0;0;5;1;44950;ALMOHADA SOFT MICROGEL;DORMITORIO
8907234;;F;59;CHILENO;;Boomers;LOLOL                         ;L.G.B.OÂ´HIGGINS;231980;3;1;0;0;0;3;1;231980;CE EVOLUTION BLACK 1,5P BN DUAL SIDE;DORMITORIO
10745165;;M;51;CHILENO;;X;MAULE                         ;MAULE;307970;3;2;0;0;0;3;2;307970;COLCHON IBIZA 2P;DORMITORIO
15312734;Casado;M;39;CHILENO;INGENIERO CIVIL INDUSTRIAL;X;PROVIDENCIA                   ;METROPOLITANA;11680;2;1;2;1;11680;0;0;0;ALMOHADA LIGHT 50X90;DORMITORIO
15957809;Soltero;M;37;CHILENO;;Millenial;PROVIDENCIA                   ;METROPOLITANA;159980;2;1;2;1;159980;0;0;0;COLCHON CASALINDA CDM 1.5PL X190;DORMITORIO
26091361;Soltero;M;27;VENEZOLANO;;Extranjero;N/D;N/D;259980;2;1;2;1;259980;0;0;0;CE EVOLUTION BLACK 2P BD DUAL SIDE;DORMITORIO
24992746;;M;37;COLOMBIANO;;Extranjero;ANTOFAGASTA;ANTOFAGASTA;219990;1;1;0;0;0;1;1;219990;COLCHON BAMBOO 2P FIBRAS BAMBOO;DORMITORIO
8437799;;F;65;CHILENO;;Boomers;VINA DEL MAR                  ;VALPARAISO;445970;4;1;0;0;0;4;1;445970;CE ERGO T 2P 2MT BD;DORMITORIO
16242007;;F;36;CHILENO;;Millenial;N/D;N/D;329970;3;2;2;1;209980;1;1;119990;CAMA EUROPEA SPRING VI FULL;DORMITORIO
26740540;;M;42;VENEZOLANO;;Extranjero;"";"";4990;1;1;0;0;0;1;1;4990;PACK 2 ALMOHADAS C+L;DORMITORIO
27461826;;M;53;VENEZOLANO;;Extranjero;COQUIMBO;COQUIMBO;8990;1;1;0;0;0;1;1;8990;ALMOHADA SOFT MICROGEL;DORMITORIO
20684288;;M;21;CHILENO;;Z;PROVIDENCIA                   ;METROPOLITANA;309980;2;1;2;1;309980;0;0;0;BOXET ERGO T 1,5 P;DORMITORIO
10380403;;F;55;CHILENO;;Boomers;PROVIDENCIA                   ;METROPOLITANA;216980;2;1;0;0;0;2;1;216980;CE EVOLUTION BLACK 1,5P + RESPALDO CASTILLA;DORMITORIO
9758381;;F;56;CHILENO;;Boomers;N/D;N/D;267220;3;1;3;1;267220;0;0;0;BOX AMERICANO EXCELLENCE FULL PLAZA +2ALM+PLU;DORMITORIO
13381687;;F;43;CHILENO;;X;CHILLAN                       ;BIO BIO;252980;2;1;2;1;252980;0;0;0;CLOSET MAULE 4 PTA CORREDERA 8 CJ CEREZO;DORMITORIO
13764371;;F;41;CHILENO;;X;QUILLOTA                      ;VALPARAISO;1316910;9;4;7;3;1184930;2;1;131980;COLCHON SUPER PREMIUM 2P X 2 MTS;DORMITORIO
6734540;;M;72;CHILENO;;Silencioso;DALCAHUE                      ;LOS LAGOS;706850;4;3;0;0;0;4;3;706850;COLCHON THERAPEDIC 2P;DORMITORIO
6300601;;F;72;CHILENO;;Silencioso;QUINTA NORMAL                 ;METROPOLITANA;409970;3;2;0;0;0;3;2;409970;BOX AMERICANO EXCELLENCE PLUS 2P BN +AL+PLU;DORMITORIO
10530664;;M;53;CHILENO;;X;ISLA DE MAIPO                 ;METROPOLITANA;971930;8;2;2;1;503980;6;1;467950;BA BEAT 2P 2MTS BN;DORMITORIO
17193751;Soltero;F;33;CHILENO;;Millenial;PROVIDENCIA                   ;METROPOLITANA;195980;2;1;2;1;195980;0;0;0;COLCHON NEW STYLE 2 2P;DORMITORIO
15416760;;F;39;CHILENO;;X;PROVIDENCIA                   ;METROPOLITANA;263980;2;1;2;1;263980;0;0;0;CE EVOLUTION BLACK 2P BD DUAL SIDE;DORMITORIO
11311418;;F;54;CHILENO;;X;PROVIDENCIA                   ;METROPOLITANA;268970;3;1;0;0;0;3;1;268970;COLCHON BAMBOO 2P FIBRAS BAMBOO;DORMITORIO
17966251;;F;30;CHILENO;;Millenial;MARCHIHUE                     ;L.G.B.OÂ´HIGGINS;343520;4;2;4;2;343520;0;0;0;COLCHON NEW STYLE 2 2P;DORMITORIO
14289548;;F;48;CHILENO;;X;VILLA ALEMANA                 ;VALPARAISO;378960;4;2;0;0;0;4;2;378960;COLCHON BAMBOO 2P FIBRAS BAMBOO;DORMITORIO
10009173;;F;57;CHILENO;;Boomers;RENCA                         ;METROPOLITANA;755840;5;2;0;0;0;5;2;755840;COLCHON BAMBOO 2P FIBRAS BAMBOO;DORMITORIO
20401296;;F;22;CHILENO;;Z;PROVIDENCIA                   ;METROPOLITANA;189980;2;1;2;1;189980;0;0;0;COLCHON CASALINDA CDM 2PL X190;DORMITORIO
16724208;;M;34;CHILENO;;X;PROVIDENCIA                   ;METROPOLITANA;169980;2;1;2;1;169980;0;0;0;CE EVOLUTION BLACK 1,5P BN DUAL SIDE;DORMITORIO
20128746;;F;23;CHILENO;;Z;PROVIDENCIA                   ;METROPOLITANA;249980;2;1;2;1;249980;0;0;0;Cama Europea Danubio 2P BN Comprimido;DORMITORIO
19973220;;M;23;CHILENO;;Z;AISEN                         ;AYSEN;739960;4;2;0;0;0;4;2;739960;COLCHON Balance King X2M;DORMITORIO
25932850;;M;45;CHILENO;;Extranjero;CARTAGENA                     ;VALPARAISO;380200;6;2;0;0;0;6;2;380200;COLCHON TERAPEUTIC 2P PILLOW TOP;DORMITORIO
26276232;;M;57;EXTRANJERO - NO INFORMA NACIONALIDAD;;Extranjero;CERRO NAVIA                   ;METROPOLITANA;519980;2;1;0;0;0;2;1;519980;COLCHON EVEREST KING 180X200;DORMITORIO
12024564;Soltero;F;45;CHILENO;INGENIERO;X;RENCA                         ;METROPOLITANA;233970;3;1;3;1;233970;0;0;0;COLCHON NEW ORTOPEDIC 1P;DORMITORIO
11060470;;M;56;CHILENO;;Boomers;TENO                          ;MAULE;9980;2;1;0;0;0;2;1;9980;PACK 2 ALMOHADAS C+L;DORMITORIO
14047267;;F;40;CHILENO;;X;EL MONTE                      ;METROPOLITANA;13980;2;1;0;0;0;2;1;13980;Almohadas Isidora Soft 50x70 cm;DORMITORIO
15111963;;F;38;CHILENO;;Millenial;PROVIDENCIA                   ;METROPOLITANA;202970;3;3;0;0;0;3;3;202970;COLCHON BAMBOO 1,5P FIBRAS BAMBOO;DORMITORIO
14164797;;F;40;CHILENO;;X;EL BOSQUE                     ;METROPOLITANA;567950;5;2;5;2;567950;0;0;0;BS NEW ORTOPEDIC B5 BLACK 2PBD;DORMITORIO
19132344;;F;26;CHILENO;;Z;PROVIDENCIA                   ;METROPOLITANA;4990;1;1;0;0;0;1;1;4990;PACK 2 ALMOHADAS C+L;DORMITORIO
15265272;;F;39;CHILENO;;X;ROMERAL                       ;MAULE;49990;1;1;0;0;0;1;1;49990;SET 2 ALMOHADAS VISCO MEDIUM 60X40 CM;DORMITORIO
5843889;;F;73;CHILENO;;Silencioso;PENAFLOR                      ;METROPOLITANA;187470;2;1;0;0;0;2;1;187470;COLCHON BAMBOO 1,5P FIBRAS BAMBOO;DORMITORIO
12815799;Soltero;M;47;CHILENO;;X;RENCA                         ;METROPOLITANA;4990;1;1;0;0;0;1;1;4990;PACK 2 ALMOHADAS C+L;DORMITORIO
12268157;Casado;F;50;CHILENO;;X;ANTOFAGASTA                   ;ANTOFAGASTA;354980;2;1;0;0;0;2;1;354980;DUPLEX CAMA EUROPEA EXCELLENCE PLUS 1 PLAZA;DORMITORIO
10859205;;M;55;CHILENO;;Boomers;RENCA                         ;METROPOLITANA;279990;1;1;0;0;0;1;1;279990;COLCHON TERAPEUTIC 2P PILLOW TOP;DORMITORIO
9674520;;M;48;CHILENO;;X;VALDIVIA                      ;LOS RIOS;314530;3;1;3;1;314530;0;0;0;CE EVOLUTION BLACK 2P BD DUAL SIDE;DORMITORIO
9598226;;F;62;CHILENO;;Boomers;MELIPEUCO                     ;ARAUCANIA;426490;6;2;6;2;426490;0;0;0;DIVAN CAMA ERGO T 1,5P 2 MTS;DORMITORIO
13862262;;M;42;CHILENO;;Extranjero;N/D;N/D;391530;3;1;3;1;391530;0;0;0;CLOSETAMATISTA 6P/2CINTERIORES;DORMITORIO
10506419;;F;57;CHILENO;;Boomers;COLBUN                        ;MAULE;30970;3;2;0;0;0;3;2;30970;ALMOHADA SOFT MICROGEL;DORMITORIO
15197572;;F;40;CHILENO;;X;PROVIDENCIA                   ;METROPOLITANA;39990;1;1;0;0;0;1;1;39990;SET 2 ALMOHADAS VISCO MEDIUM 60X40 CM;DORMITORIO
16833030;;M;34;CHILENO;;Millenial;PROVIDENCIA                   ;METROPOLITANA;193640;2;1;2;1;193640;0;0;0;BOX AMERICANO EXCELLENCE 2P BASE NORMAL+2ALM;DORMITORIO
16108498;;F;38;CHILENO;;Millenial;RENCA                         ;METROPOLITANA;273980;2;1;2;1;273980;0;0;0;DIVAN CAMA ERGO T 1,5P 2 MTS;DORMITORIO
11278732;;F;54;CHILENO;;X;PROVIDENCIA                   ;METROPOLITANA;104540;2;1;2;1;104540;0;0;0;CLOSET MARITTIMA 6P+2C;DORMITORIO
15063454;;M;40;CHILENO;;Millenial;LIMACHE                       ;VALPARAISO;189980;2;1;2;1;189980;0;0;0;BOX AMERICANO EXCELLENCE 2P BASE NORMAL+2ALM;DORMITORIO
17605577;;F;32;CHILENO;;Millenial;PROVIDENCIA                   ;METROPOLITANA;173980;2;1;2;1;173980;0;0;0;COLCHON NEW ORTOPEDIC 2P;DORMITORIO
19021066;;F;26;CHILENO;;Z;N/D;N/D;297960;4;2;4;2;297960;0;0;0;COLCHON NEW ORTOPEDIC 1,5P;DORMITORIO
18687103;;F;27;CHILENO;;Millenial;PROVIDENCIA                   ;METROPOLITANA;57970;3;2;0;0;0;3;2;57970;ALMOHADA SOFT MICROGEL;DORMITORIO
20111367;;F;23;CHILENO;;Z;PROVIDENCIA                   ;METROPOLITANA;233980;2;1;2;1;233980;0;0;0;BOX AMERICANO MIRAGE 2PBN;DORMITORIO
20077157;;M;23;CHILENO;;Z;"";"";4990;1;1;0;0;0;1;1;4990;PACK 2 ALMOHADAS C+L;DORMITORIO
15208849;;F;39;CHILENO;;X;TALCA                         ;MAULE;85480;2;1;2;1;85480;0;0;0;CLOSET CROACIA BLANCO 4P;DORMITORIO
14316505;;F;45;CHILENO;;X;TEMUCO                        ;ARAUCANIA;9980;2;1;0;0;0;2;1;9980;PACK 2 ALMOHADAS C+L;DORMITORIO
7268160;Casado;M;68;CHILENO;;Silencioso;TEMUCO                        ;ARAUCANIA;247980;2;1;0;0;0;2;1;247980;CE EVOLUTION BLACK 1,5P BN RESP+VEL;DORMITORIO
16011712;;F;37;CHILENO;;Millenial;CHIGUAYANTE                   ;BIO BIO;71920;8;1;0;0;0;8;1;71920;ALMOHADA SOFT MICROGEL;DORMITORIO
18918672;;F;29;CHILENO;;Millenial;ANTOFAGASTA                   ;ANTOFAGASTA;312970;3;1;0;0;0;3;1;312970;COLCHON NEW ORTOPEDIC 1P;DORMITORIO
10642276;;F;57;CHILENO;;Boomers;N/D;N/D;373530;3;1;3;1;373530;0;0;0;CE ERGO T 2P 2MT BD;DORMITORIO
12758414;Casado;M;51;CHILENO;;X;RENCA                         ;METROPOLITANA;155980;2;1;2;1;155980;0;0;0;COLCHON 2PZA NEW VERSATILE BY ABCDIN;DORMITORIO
18650092;Casado;F;27;CHILENO;;Millenial;PROVIDENCIA                   ;METROPOLITANA;199990;2;1;2;1;199990;0;0;0;CE EVOLUTION BLACK 2P BD DUAL SIDE;DORMITORIO
18016236;Casado;F;30;CHILENO;;Millenial;CUNCO;ARAUCANIA;355520;4;2;4;2;355520;0;0;0;COLCHON BAMBOO 2P FIBRAS BAMBOO;DORMITORIO
8172763;;F;64;CHILENO;;Boomers;MALLOA                        ;L.G.B.OÂ´HIGGINS;238980;2;1;2;1;238980;0;0;0;COLCHON NEW STYLE 4 2P;DORMITORIO
19269567;;M;26;CHILENO;;Z;N/D;N/D;255980;2;1;2;1;255980;0;0;0;CE ERGO T 2P 2MT BD;DORMITORIO
16731744;Soltero;M;34;CHILENO;CONTADOR AUDITOR;Millenial;PROVIDENCIA                   ;METROPOLITANA;209980;2;1;2;1;209980;0;0;0;CAMA EUROPEA THERAPEDIC MAS 1,5P;DORMITORIO
12921462;Casado;F;47;CHILENO;TECNICO UNIVERSITARIO EN ENFERMERIA;X;RENCA                         ;METROPOLITANA;143980;2;1;2;1;143980;0;0;0;CE EVOLUTION BLACK 1,5P + RESPALDO CASTILLA;DORMITORIO
8097899;Casado;F;63;CHILENO;;Boomers;PROVIDENCIA                   ;METROPOLITANA;169980;2;1;2;1;169980;0;0;0;COLCHON NEW ORTOPEDIC 2P;DORMITORIO
16944772;;M;34;CHILENO;;Millenial;N/D;N/D;714970;3;1;3;1;714970;0;0;0;DUPLEX CE EVOLUTION BLACK 1P + 2 RESP + VEL ASTU;DORMITORIO
18995991;;F;27;CHILENO;;Millenial;PROVIDENCIA                   ;METROPOLITANA;139980;2;1;2;1;139980;0;0;0;CE EVOLUTION BLACK 1,5P + RESPALDO CASTILLA;DORMITORIO
18552769;;M;29;CHILENO;;Millenial;PROVIDENCIA                   ;METROPOLITANA;286240;5;2;5;2;286240;0;0;0;CE EVOLUTION BLACK 1,5P + RESPALDO CASTILLA;DORMITORIO
16034532;;F;37;CHILENO;;Millenial;VILLA ALEMANA                 ;VALPARAISO;154980;2;1;2;1;154980;0;0;0;CLOSET CABURGUA 2 PT CORREDERA CEREZO;DORMITORIO
6770802;;F;78;CHILENO;;Silencioso;N/D;N/D;389250;3;2;0;0;0;3;2;389250;PACK 2 ALMOHADAS C+L;DORMITORIO
16857112;;F;34;CHILENO;;Millenial;N/D;N/D;253680;4;2;2;1;251980;2;1;1700;CE EVOLUTION BLACK 2P BN+RESP+2 VEL;DORMITORIO
19503027;;F;25;CHILENO;;Z;TALAGANTE;METROPOLITANA;7980;2;1;0;0;0;2;1;7980;PACK 2 ALMOHADAS C+L;DORMITORIO
6137145;;M;69;CHILENO;;Silencioso;EL BOSQUE                     ;METROPOLITANA;294000;7;2;0;0;0;7;2;294000;COLCHON ERGO T 0.90X2.00;DORMITORIO
6639051;Casado;M;65;CHILENO;;Boomers;CALAMA                        ;ANTOFAGASTA;187870;2;1;0;0;0;2;1;187870;COLCHON BAMBOO 1,5P FIBRAS BAMBOO;DORMITORIO
11771551;;F;50;CHILENO;;X;NIQUEN                        ;BIO BIO;126630;6;2;0;0;0;6;2;126630;PACK 2 ALMOHADAS C+L;DORMITORIO
13573218;Soltero;F;42;CHILENO;INGENIERO CIVIL INDUSTRIAL;X;PROVIDENCIA                   ;METROPOLITANA;421980;2;1;2;1;421980;0;0;0;Cama Ergo T 2PBD + Resp +2 Vel Tabor;DORMITORIO
18979957;;F;28;CHILENO;;Millenial;PROVIDENCIA                   ;METROPOLITANA;224980;2;1;2;1;224980;0;0;0;BA BEAT 2P 2MTS BN;DORMITORIO
17015454;Soltero;F;33;CHILENO;;Millenial;PROVIDENCIA                   ;METROPOLITANA;139980;2;1;2;1;139980;0;0;0;CE EVOLUTION BLACK 1,5P + RESPALDO CASTILLA;DORMITORIO
8126458;;F;58;CHILENO;;Boomers;RENCA                         ;METROPOLITANA;419980;2;1;2;1;419980;0;0;0;CE NEW STYLE 6 2P 2MT BD;DORMITORIO
5388378;;F;64;CHILENO;;Boomers;N/D;N/D;270960;4;2;0;0;0;4;2;270960;Almohada Bamboo Classic 70x40;DORMITORIO
16028614;;F;37;CHILENO;;Millenial;N/D;N/D;469940;6;1;0;0;0;6;1;469940;COLCHON NEW ORTOPEDIC 1,5P;DORMITORIO
13854343;;F;42;CHILENO;;X;CHONCHI;LOS LAGOS;351950;5;2;5;2;351950;0;0;0;CE EVOLUTION BLACK 1,5P BN RESP+VEL;DORMITORIO
16914377;Soltero;M;33;CHILENO;;Millenial;PROVIDENCIA                   ;METROPOLITANA;7980;2;1;0;0;0;2;1;7980;PACK 2 ALMOHADAS C+L;DORMITORIO
11489924;;M;52;CHILENO;;X;NUNOA                         ;METROPOLITANA;103920;8;2;8;2;103920;0;0;0;ALMOHADA VISCO SLEEP TECH SERIES 65X45 CM;DORMITORIO
13082905;Casado;F;46;CHILENO;;X;RENCA                         ;METROPOLITANA;97970;3;2;1;1;89990;2;1;7980;PACK 2 ALMOHADAS C+L;DORMITORIO
18473257;;F;29;CHILENO;;Millenial;N/D;N/D;205980;2;1;2;1;205980;0;0;0;CE EVOLUTION BLACK 2P BD DUAL SIDE;DORMITORIO
20082660;Soltero;F;26;CHILENO;PSICOLOGA;Z;PROVIDENCIA                   ;METROPOLITANA;226980;2;1;2;1;226980;0;0;0;BOX AMERICANO EXCELLENCE FULL +RESP+2VEL OLMO;DORMITORIO
11090005;;F;55;CHILENO;;Boomers;TEODORO SCHMIDT               ;ARAUCANIA;7980;2;1;0;0;0;2;1;7980;PACK 2 ALMOHADAS C+L;DORMITORIO
15975601;;M;37;CHILENO;;Silencioso;PROVIDENCIA                   ;METROPOLITANA;169980;2;1;2;1;169980;0;0;0;COLCHON NEW ORTOPEDIC 1P;DORMITORIO
16301878;Casado;F;36;CHILENO;ABOGADO;Millenial;PROVIDENCIA                   ;METROPOLITANA;419980;2;1;2;1;419980;0;0;0;CE NEW STYLE 6 2P 2MT BD;DORMITORIO
9636174;;F;56;CHILENO;;Boomers;CORONEL                       ;BIO BIO;12990;1;1;0;0;0;1;1;12990;Almohada Bamboo Classic 70x40;DORMITORIO
7988373;;F;63;CHILENO;;Boomers;CHANARAL                      ;ATACAMA;511950;5;2;3;1;251970;2;1;259980;CE EVOLUTION BLACK 1,5P BN DUAL SIDE;DORMITORIO
12025524;;F;55;CHILENO;;Millenial;VALPARAISO                    ;VALPARAISO;179980;2;1;2;1;179980;0;0;0;CE EVOLUTION BLACK 1,5P + RESPALDO ASTURIAS;DORMITORIO
17874561;;F;31;CHILENO;;Millenial;SAN VICENTE                   ;L.G.B.OÂ´HIGGINS;259990;1;1;0;0;0;1;1;259990;COLCHON TERAPEUTIC 2P PILLOW TOP;DORMITORIO
14031164;;M;41;CHILENO;;Millenial;SAN PEDRO DE LA PAZ           ;BIO BIO;243980;2;1;2;1;243980;0;0;0;Cama Europea Cannabis 1.5 plazas + Sabanas Imper;DORMITORIO
5262891;;F;75;CHILENO;;Silencioso;RENCA                         ;METROPOLITANA;8490;1;1;0;0;0;1;1;8490;ALMOHADA ROSEN SOFT PLUS AMERICANA;DORMITORIO
17331622;;F;32;CHILENO;;Silencioso;PROVIDENCIA                   ;METROPOLITANA;203980;2;1;2;1;203980;0;0;0;BOX AMERICANO BEAT 1,5 PLAZAS 105 X 190 CM;DORMITORIO
17137707;Soltero;F;33;CHILENO;;Millenial;RENCA                         ;METROPOLITANA;289980;2;1;2;1;289980;0;0;0;COLCHON ROSEN SWAG 2P 2 MT 1.50X2.00;DORMITORIO
13846322;;M;57;CHILENO;;Boomers;PROVIDENCIA                   ;METROPOLITANA;139990;1;1;0;0;0;1;1;139990;COLCHON BAMBOO 1,5P FIBRAS BAMBOO;DORMITORIO
18835032;Soltero;F;28;CHILENO;;Millenial;PROVIDENCIA                   ;METROPOLITANA;3990;1;1;0;0;0;1;1;3990;PACK 2 ALMOHADAS C+L;DORMITORIO
16678714;Soltero;F;35;CHILENO;INGENIERO EN PREVENCION DE RIESGOS;Millenial;PROVIDENCIA                   ;METROPOLITANA;408980;2;1;2;1;408980;0;0;0;CAMA ERGO T 2PBD + RESP + 2 VEL FERRARA;DORMITORIO
13092520;;F;46;CHILENO;;Silencioso;PROVIDENCIA                   ;METROPOLITANA;309980;2;1;2;1;309980;0;0;0;BOXET ERGO T 1,5 P;DORMITORIO
7995888;;M;66;CHILENO;;Silencioso;PROVIDENCIA                   ;METROPOLITANA;-129990;-1;1;-1;1;-129990;0;0;0;COLCHON BEAT 1P;DORMITORIO
19408275;;F;26;CHILENO;;Millenial;PROVIDENCIA                   ;METROPOLITANA;179980;2;1;2;1;179980;0;0;0;CE EVOLUTION BLACK 1,5P + RESPALDO ASTURIAS;DORMITORIO
8205025;Divorciado;F;64;CHILENO;;Boomers;PUTAENDO                      ;VALPARAISO;3990;1;1;0;0;0;1;1;3990;PACK 2 ALMOHADAS C+L;DORMITORIO
18438882;;F;28;CHILENO;;Millenial;PUERTO MONTT;LOS LAGOS;20980;2;1;0;0;0;2;1;20980;ALMOHADA ROSEN SOFT PLUS KING;DORMITORIO
15219367;Soltero;F;38;CHILENO;;X;RENCA                         ;METROPOLITANA;14970;3;2;0;0;0;3;2;14970;PACK 2 ALMOHADAS C+L;DORMITORIO
15232862;Soltero;F;38;CHILENO;;X;CURACAUTIN                    ;ARAUCANIA;4000;2;1;0;0;0;2;1;4000;PACK 2 ALMOHADAS C+L;DORMITORIO
17291919;;F;32;CHILENO;;Millenial;ARAUCO                        ;BIO BIO;206980;2;1;0;0;0;2;1;206980;BOX AMERICANO EXCELLENCE 2P BASE NORMAL+2ALM;DORMITORIO
8174625;;F;57;CHILENO;;Boomers;CALLE LARGA                   ;VALPARAISO;7990;1;1;0;0;0;1;1;7990;Pack Imperial Soft 45x65 cm.;DORMITORIO
17580189;Soltero;F;31;CHILENO;;Millenial;PROVIDENCIA                   ;METROPOLITANA;3990;1;1;0;0;0;1;1;3990;PACK 2 ALMOHADAS C+L;DORMITORIO
10510453;;M;55;CHILENO;;Boomers;VALLENAR;ATACAMA;0;0;0;0;0;0;0;0;0;BOX AMERICANO MIRAGE 2PBN;DORMITORIO
17374110;;M;32;CHILENO;;Millenial;PROVIDENCIA                   ;METROPOLITANA;0;0;0;0;0;0;0;0;0;CAMA EUROPEA EXCELLENCE PLUS 2 PLAZAS BD;DORMITORIO
19712473;;M;23;CHILENO;;Z;N/D;N/D;0;0;0;0;0;0;0;0;0;COLCHON THERAPEDIC 2P;DORMITORIO
26970684;;F;50;VENEZOLANO;;Extranjero;N/D;N/D;0;0;0;0;0;0;0;0;0;PACK 2 ALMOHADAS C+L;DORMITORIO
17846989;;F;31;CHILENO;;Millenial;LA HIGUERA                    ;COQUIMBO;0;0;0;0;0;0;0;0;0;CAMA EUROPEA EXCELLENCE PLUS 2 PLAZAS BD;DORMITORIO
20570981;;F;21;CHILENO;;Z;PROVIDENCIA                   ;METROPOLITANA;0;0;0;0;0;0;0;0;0;CAMA AMERICANA BEAT 1.50X1.90 TABOR;DORMITORIO
10936791;;F;54;CHILENO;;Boomers;SAN JAVIER                    ;MAULE;0;0;0;0;0;0;0;0;0;CE ERGO T 2P 2MT BD;DORMITORIO
6682727;;F;72;CHILENO;;Silencioso;RENCA                         ;METROPOLITANA;0;0;0;0;0;0;0;0;0;PACK 2 ALMOHADAS C+L;DORMITORIO
12589432;;F;48;CHILENO;;X;RENCA                         ;METROPOLITANA;0;0;0;0;0;0;0;0;0;COLCHON SPRING III 1P;DORMITORIO
19580650;;F;25;CHILENO;;Z;N/D;N/D;0;0;0;0;0;0;0;0;0;CE CAMA ERGO T 1.50X2.00 BD + RESP FERRARA;DORMITORIO
10650458;;F;63;CHILENO;;Boomers;CASTRO                        ;LOS LAGOS;0;0;0;0;0;0;0;0;0;PACK 2 ALMOHADAS C+L;DORMITORIO
5964032;;F;74;CHILENO;;Silencioso;RENCA                         ;METROPOLITANA;0;0;0;0;0;0;0;0;0;ALMOHADA SOFT MICROGEL;DORMITORIO
15221401;;M;40;CHILENO;;X;N/D;N/D;0;0;0;0;0;0;0;0;0;Almohada Bamboo Classic 70x40;DORMITORIO
16732189;;M;34;CHILENO;;Millenial;TALCA                         ;MAULE;0;0;0;0;0;0;0;0;0;COLCHON ERGO T 2P;DORMITORIO
17910216;Soltero;F;29;CHILENO;;Millenial;PROVIDENCIA                   ;METROPOLITANA;0;0;0;0;0;0;0;0;0;CE ERGO T 2P 2MT BD;DORMITORIO
17296491;Soltero;F;32;CHILENO;;Millenial;PROVIDENCIA                   ;METROPOLITANA;0;0;0;0;0;0;0;0;0;CLOSET CROACIA CHOCOLATE 4P;DORMITORIO
14631195;;F;47;CHILENO;;Millenial;N/D;N/D;0;0;0;0;0;0;0;0;0;C.EUR EXCELLENCE PLUS 1P+RESP+1VEL NEW MUNICH;DORMITORIO
14010518;;M;40;CHILENO;;X;SAN PEDRO                     ;METROPOLITANA;0;0;0;0;0;0;0;0;0;COLCHON ORTOPEDIC ADVANCE 2P;DORMITORIO
4219698;;F;84;CHILENO;;Silencioso;VILLA ALEMANA                 ;VALPARAISO;0;0;0;0;0;0;0;0;0;COLCHON SPRING III 1P;DORMITORIO
14183409;;F;41;CHILENO;;X;RENCA                         ;METROPOLITANA;0;0;0;0;0;0;0;0;0;SET 2 ALMOHADAS VISCO MEDIUM 60X40 CM;DORMITORIO
19835636;;F;24;CHILENO;;Silencioso;PROVIDENCIA                   ;METROPOLITANA;0;0;0;0;0;0;0;0;0;ALMOHADA MEMORY MAX BASIC AMERICANA;DORMITORIO
8935256;;F;59;CHILENO;;Boomers;PROVIDENCIA                   ;METROPOLITANA;0;0;0;0;0;0;0;0;0;ALMOHADA SOFT MICROGEL;DORMITORIO
13341838;;F;44;CHILENO;;X;BUIN                          ;METROPOLITANA;0;0;0;0;0;0;0;0;0;COLCHON ART 4 2P;DORMITORIO
26461355;;M;32;EXTRANJERO - NO INFORMA NACIONALIDAD;;Extranjero;N/D;N/D;0;0;0;0;0;0;0;0;0;SET 2 ALMOHADAS VISCO MEDIUM 60X40 CM;DORMITORIO
17377684;;F;32;CHILENO;;Millenial;MARIQUINA                     ;LOS LAGOS;0;0;0;0;0;0;0;0;0;HOME TV FAVATEX IGUAZU 55 AVELLANA;DORMITORIO
16635287;;F;34;CHILENO;;Millenial;TEMUCO                        ;ARAUCANIA;0;0;0;0;0;0;0;0;0;DIVAN NEW ORTOPEDIC 1,5P BLACK;DORMITORIO
8972970;Casado;M;61;CHILENO;;Silencioso;PROVIDENCIA                   ;METROPOLITANA;0;0;0;0;0;0;0;0;0;ALMOHADA ROSEN SOFT PLUS KING;DORMITORIO
11544966;;F;52;CHILENO;;X;PUERTO MONTT                  ;LOS LAGOS;0;0;0;0;0;0;0;0;0;COMODA CIPRES MODELO CP25D, COLOR DEMOLICION, 2;DORMITORIO
18962198;;F;27;CHILENO;;Z;PROVIDENCIA                   ;METROPOLITANA;0;0;0;0;0;0;0;0;0;SET SABANA MICROFIBRA ROUGE 2P;DORMITORIO
10713926;;F;56;CHILENO;;Boomers;SAN PEDRO DE LA PAZ           ;BIO BIO;0;0;0;0;0;0;0;0;0;ALMOHADA COOL GEL TECH SERIES 60X40 CM;DORMITORIO
4723771;;F;75;CHILENO;;Silencioso;ARICA                         ;ARICA Y PARINACOTA;0;0;0;0;0;0;0;0;0;COLCHON NEW ORTOPEDIC 1P;DORMITORIO
7701597;;F;65;CHILENO;;Boomers;CALAMA                        ;ANTOFAGASTA;0;0;0;0;0;0;0;0;0;CAMA EUROPEA THERAPEDIC MAS 1,5P;DORMITORIO
18911180;Soltero;M;36;CHILENO;PROFESOR;Silencioso;PROVIDENCIA                   ;METROPOLITANA;0;0;0;0;0;0;0;0;0;Cama Tempo King + Resp + 2 Vel Grafito;DORMITORIO
19731422;;F;25;CHILENO;;Z;N/D;N/D;0;0;0;0;0;0;0;0;0;COLCHON THERAPEDIC 2P;DORMITORIO
19575221;;F;25;CHILENO;;Z;LINARES                       ;MAULE;0;0;0;0;0;0;0;0;0;SET SABANA MICROFIBRA ROUGE 1,5P;DORMITORIO
13906209;Soltero;M;41;CHILENO;INGENIERO DE EJECUCION EN INFORMATICA;Silencioso;PROVIDENCIA                   ;METROPOLITANA;0;0;0;0;0;0;0;0;0;COLCHON SPRING III 1P;DORMITORIO
9232675;;M;58;CHILENO;;Boomers;CUREPTO                       ;MAULE;0;0;0;0;0;0;0;0;0;COLCHON EXCELLENCE PLUS 1,5P;DORMITORIO
8201630;;M;65;CHILENO;;Boomers;RENCA                         ;METROPOLITANA;0;0;0;0;0;0;0;0;0;COLCHON ART 4 2P;DORMITORIO
16851119;;F;34;CHILENO;;Millenial;CALLE LARGA                   ;VALPARAISO;0;0;0;0;0;0;0;0;0;SET 2 ALMOHADAS VISCO MEDIUM 60X40 CM;DORMITORIO
16740123;;M;34;CHILENO;;Millenial;LONQUIMAY;ARAUCANIA;0;0;0;0;0;0;0;0;0;BA EXCEL PLUS 2P BN +RESP+2VEL NEW VILLARRICA;DORMITORIO
19240197;;M;26;CHILENO;;Z;QUILICURA                     ;METROPOLITANA;0;0;0;0;0;0;0;0;0;SET RESPALDO BENITO 1,5 PLAZAS + 1 VELADOR;DORMITORIO
18773565;;M;27;CHILENO;;Z;CHILLAN;BIO-BIO;0;0;0;0;0;0;0;0;0;ALMOHADA SOFT MICROGEL;DORMITORIO
19460075;;F;25;CHILENO;;Silencioso;PROVIDENCIA                   ;METROPOLITANA;0;0;0;0;0;0;0;0;0;COLCHON BAMBOO 1,5P FIBRAS BAMBOO;DORMITORIO
18032462;;M;30;CHILENO;;Millenial;N/D;N/D;0;0;0;0;0;0;0;0;0;COLCHON SPRING III 1P;DORMITORIO
20159386;;F;22;CHILENO;;Z;PROVIDENCIA                   ;METROPOLITANA;0;0;0;0;0;0;0;0;0;BOX 1 1/2 P + RESP +1 VEL;DORMITORIO
9720382;;F;60;CHILENO;;Boomers;PROVIDENCIA                   ;METROPOLITANA;0;0;0;0;0;0;0;0;0;ALMOHADA SOFT MICROGEL;DORMITORIO
7952729;;F;64;CHILENO;;Boomers;LOS ALAMOS                    ;BIO BIO;0;0;0;0;0;0;0;0;0;ALMOHADA MEMORY MAX BASIC AMERICANA;DORMITORIO
20292928;;F;22;CHILENO;;Millenial;"";"";0;0;0;0;0;0;0;0;0;BOX AMERICANO EXCELLENCE 1.5 PLAZAS;DORMITORIO
19044336;;F;26;CHILENO;;Z;PROVIDENCIA                   ;METROPOLITANA;0;0;0;0;0;0;0;0;0;COMODA CIPRES MODELO CP010D, COLOR DEMIOLICION,;DORMITORIO
6160762;Viudo;F;74;CHILENO;;Silencioso;RENCA                         ;METROPOLITANA;0;0;0;0;0;0;0;0;0;Almohada Bamboo Classic 70x40;DORMITORIO
20023274;;F;23;CHILENO;;Z;PROVIDENCIA                   ;METROPOLITANA;0;0;0;0;0;0;0;0;0;Pack Imperial Soft 50x70 cm;DORMITORIO
14170467;;F;41;CHILENO;;X;PROVIDENCIA                   ;METROPOLITANA;0;0;0;0;0;0;0;0;0;COLCHON SWAG 2P 150 X 190;DORMITORIO
16571913;;F;34;CHILENO;;Millenial;LO ESPEJO                     ;METROPOLITANA;0;0;0;0;0;0;0;0;0;CLOSET NEWCAPRI M-330 AVELLANA/CARVALHO4P3C+ESPE;DORMITORIO
6323882;;M;66;CHILENO;;Boomers;PROVIDENCIA                   ;METROPOLITANA;0;0;0;0;0;0;0;0;0;CLOSET M-701 6 PUERTAS 2 CAJONES ALTO 1,82 COLOR;DORMITORIO
19224487;Soltero;F;26;CHILENO;PSICOLOGA;Z;PROVIDENCIA                   ;METROPOLITANA;0;0;0;0;0;0;0;0;0;BOX AMERICANO EXCELLENCE 1.5 PLAZA + ALM;DORMITORIO
10516256;;M;54;CHILENO;;X;RENCA                         ;METROPOLITANA;0;0;0;0;0;0;0;0;0;BOX 1 1/2 P + RESP +1 VEL;DORMITORIO
17155110;Soltero;M;33;CHILENO;MEDICO CIRUJANO;Silencioso;PROVIDENCIA                   ;METROPOLITANA;0;0;0;0;0;0;0;0;0;CAMA NEW STYLE 2 1.50X2.00BD + RESPALDO FERRARA;DORMITORIO
17266803;;M;33;CHILENO;;Silencioso;PROVIDENCIA                   ;METROPOLITANA;0;0;0;0;0;0;0;0;0;COLCHON NEW ORTOPEDIC 1,5 105X200;DORMITORIO
5960634;Soltero;M;74;CHILENO;;Silencioso;LA SERENA                     ;COQUIMBO;0;0;0;0;0;0;0;0;0;PACK 2 ALMOHADAS C+L;DORMITORIO
13426366;;F;44;CHILENO;;X;VINA DEL MAR                  ;VALPARAISO;0;0;0;0;0;0;0;0;0;SET SABANA MICROFIBRA MUSTARD 2P;DORMITORIO
10682410;Soltero;F;52;CHILENO;DISENADOR DE VESTUARIO;Silencioso;PROVIDENCIA                   ;METROPOLITANA;0;0;0;0;0;0;0;0;0;COLCHON ART 4 2P;DORMITORIO
20144616;;F;23;CHILENO;;Z;PROVIDENCIA                   ;METROPOLITANA;0;0;0;0;0;0;0;0;0;COLCHON ORTOPEDIC ADVANCE KING 180X200;DORMITORIO
10091433;;F;58;CHILENO;;Boomers;LA CISTERNA                   ;METROPOLITANA;0;0;0;0;0;0;0;0;0;Almohada Viscoelastica Bamboo Pack 60x40 cm;DORMITORIO
17746672;;F;31;CHILENO;;Millenial;PROVIDENCIA                   ;METROPOLITANA;0;0;0;0;0;0;0;0;0;SET SABANA MICROFIBRA SAND 2P;DORMITORIO
11683577;Casado;F;51;CHILENO;;X;PROVIDENCIA                   ;METROPOLITANA;0;0;0;0;0;0;0;0;0;COLCHON NEW ORTOPEDIC 1P;DORMITORIO
12826980;;M;46;CHILENO;;X;RENCA                         ;METROPOLITANA;0;0;0;0;0;0;0;0;0;CE EVOLUTION BLACK 1,5P + RESPALDO CASTILLA;DORMITORIO
19987754;;F;24;CHILENO;;Z;MACHALI                       ;L.G.B.OÂ´HIGGINS;0;0;0;0;0;0;0;0;0;SET SABANA MICROFIBRA SAND 2P;DORMITORIO
9507187;;F;60;CHILENO;;Boomers;N/D;N/D;0;0;0;0;0;0;0;0;0;PACK 2 ALMOHADAS C+L;DORMITORIO
11518867;;F;52;CHILENO;;X;SANTA MARIA                   ;VALPARAISO;0;0;0;0;0;0;0;0;0;PACK 2 ALMOHADAS C+L;DORMITORIO
11567694;;F;52;CHILENO;;X;RENCA                         ;METROPOLITANA;0;0;0;0;0;0;0;0;0;COLCHON EVOLUTION BLACK 2P DUAL SIDE;DORMITORIO
26399687;;F;52;VENEZOLANO;;Extranjero;LOS ANDES                     ;VALPARAISO;0;0;0;0;0;0;0;0;0;CE BAMBOO 2PBD BAMBOO+RES+2V ALICANTE;DORMITORIO
15053535;Casado;M;39;CHILENO;ARQUITECTO;Silencioso;PROVIDENCIA                   ;METROPOLITANA;0;0;0;0;0;0;0;0;0;COLCHON NEW STYLE 6 2P 150X200;DORMITORIO
9085384;Casado;M;63;CHILENO;AGRONOMO;Silencioso;PROVIDENCIA                   ;METROPOLITANA;0;0;0;0;0;0;0;0;0;COLCHON TERAPEUTIC 2P PILLOW TOP;DORMITORIO
11702417;;F;51;CHILENO;;X;N/D;N/D;0;0;0;0;0;0;0;0;0;CE ERGO T 2P 2MT BD;DORMITORIO
19816842;;M;24;CHILENO;;Z;PROVIDENCIA                   ;METROPOLITANA;0;0;0;0;0;0;0;0;0;CE EVOLUTION BLACK 1,5P + RESPALDO CASTILLA;DORMITORIO
19718008;;F;24;CHILENO;;Z;PROVIDENCIA                   ;METROPOLITANA;0;0;0;0;0;0;0;0;0;CLOSET ESPANA 6P+4C;DORMITORIO
10883929;;F;56;CHILENO;;Boomers;PUERTO MONTT                  ;LOS LAGOS;0;0;0;0;0;0;0;0;0;COLCHON EVEREST 2P HILOS DE COBRE;DORMITORIO
17457243;;M;32;CHILENO;;Millenial;PROVIDENCIA                   ;METROPOLITANA;0;0;0;0;0;0;0;0;0;CE ORTOPEDIC ADVANCE KING +RESPALDO TIGRIS;DORMITORIO
9219660;;M;60;CHILENO;;Boomers;PICHIDEGUA                    ;L.G.B.OÂ´HIGGINS;0;0;0;0;0;0;0;0;0;CE EVOLUTION BLACK 2P BD DUAL SIDE;DORMITORIO
18082162;Soltero;F;29;CHILENO;;Millenial;PROVIDENCIA                   ;METROPOLITANA;0;0;0;0;0;0;0;0;0;CE ERGO T 2P 2MT BD;DORMITORIO
17519121;;F;32;CHILENO;;Millenial;N/D;N/D;0;0;0;0;0;0;0;0;0;COLCHON NEW STYLE 4 2P;DORMITORIO
18120166;Soltero;F;30;CHILENO;;Silencioso;PROVIDENCIA                   ;METROPOLITANA;0;0;0;0;0;0;0;0;0;RACK FAVATEX CAHUIL BLANCO;DORMITORIO
19073049;;F;27;CHILENO;;Z;PROVIDENCIA                   ;METROPOLITANA;0;0;0;0;0;0;0;0;0;CE EVOLUTION BLACK 1,5P + RESPALDO CASTILLA;DORMITORIO
18526766;Soltero;M;29;CHILENO;PROFESOR;Silencioso;PROVIDENCIA                   ;METROPOLITANA;0;0;0;0;0;0;0;0;0;COLCHON EVOLUTION BLACK 1,5P DUAL SIDE;DORMITORIO
12570926;;M;47;CHILENO;;X;PROVIDENCIA                   ;METROPOLITANA;0;0;0;0;0;0;0;0;0;TOCADOR FAVATEX EIBAR 5C 2P;DORMITORIO
8223011;;F;65;CHILENO;;Boomers;N/D;N/D;0;0;0;0;0;0;0;0;0;COLCHON TERAPEUTIC 2P PILLOW TOP;DORMITORIO
17722983;;F;31;CHILENO;;Millenial;"";"";0;0;0;0;0;0;0;0;0;PACK 2 ALMOHADAS C+L;DORMITORIO
19337579;;F;26;CHILENO;;Z;QUINTERO                      ;VALPARAISO;0;0;0;0;0;0;0;0;0;CLOSET NIZA 6P+2C;DORMITORIO
9299307;;M;59;CHILENO;;Boomers;VINA DEL MAR                  ;VALPARAISO;0;0;0;0;0;0;0;0;0;COLCHON IBIZA 2P;DORMITORIO
20102506;;M;22;CHILENO;;Z;PROVIDENCIA                   ;METROPOLITANA;0;0;0;0;0;0;0;0;0;ESCRITORIO ZENGA;DORMITORIO
5473168;;F;75;CHILENO;;Silencioso;RENCA                         ;METROPOLITANA;0;0;0;0;0;0;0;0;0;COLCHON EXCELLENCE 2 PLAZA + 2 ALM;DORMITORIO
11735766;;F;50;CHILENO;;X;QUILPUE                       ;VALPARAISO;0;0;0;0;0;0;0;0;0;CLOSET CROACIA BLANCO 4P;DORMITORIO
17447889;;F;32;CHILENO;;Millenial;LINARES                       ;MAULE;0;0;0;0;0;0;0;0;0;COLCHON TERAPEUTIC 2P PILLOW TOP;DORMITORIO
6714013;;F;74;CHILENO;;Silencioso;PROVIDENCIA                   ;METROPOLITANA;0;0;0;0;0;0;0;0;0;COLCHON ART 4 2P;DORMITORIO
13467684;Soltero;F;44;CHILENO;INGENIERIA CIVIL EN MECANICA;Silencioso;PROVIDENCIA                   ;METROPOLITANA;0;0;0;0;0;0;0;0;0;CE EVOLUTION BLACK 1,5P + RESPALDO ASTURIAS;DORMITORIO
19733700;;F;24;CHILENO;;Z;PROVIDENCIA                   ;METROPOLITANA;0;0;0;0;0;0;0;0;0;ALMOHADA MEMORY MAX BASIC AMERICANA;DORMITORIO
8708197;;F;62;CHILENO;;Boomers;PROVIDENCIA                   ;METROPOLITANA;0;0;0;0;0;0;0;0;0;ALMOHADA FLEX-D ROYAL KING 50X90;DORMITORIO
5944421;Casado;M;72;CHILENO;INGENIERO AGRICOLA;Silencioso;PROVIDENCIA                   ;METROPOLITANA;0;0;0;0;0;0;0;0;0;CE NEW ORTOPEDIC 2PBN +RESP+2VEL NEW VILLARRI;DORMITORIO
11126491;;F;54;CHILENO;;Boomers;TRAIGUEN                      ;ARAUCANIA;0;0;0;0;0;0;0;0;0;CAMA EUROPEA IBIZA 2 PL BD;DORMITORIO
13764627;;F;41;CHILENO;;X;QUILLOTA                      ;VALPARAISO;0;0;0;0;0;0;0;0;0;CAMA EUROPEA CANNABIS 2PBD + RESP + VEL CASTILLA;DORMITORIO
17075705;;F;33;CHILENO;;Millenial;RENCA                         ;METROPOLITANA;0;0;0;0;0;0;0;0;0;TOCADOR FAVATEX EIBAR 5C 2P;DORMITORIO
6712381;;F;69;CHILENO;;Silencioso;ISLA DE MAIPO                 ;METROPOLITANA;0;0;0;0;0;0;0;0;0;SET 2 ALMOHADAS VISCO MEDIUM 60X40 CM;DORMITORIO
7970198;Soltero;M;62;CHILENO;;Boomers;PROVIDENCIA                   ;METROPOLITANA;0;0;0;0;0;0;0;0;0;COLCHON ACTIVE 1,5P DUAL SIDE;DORMITORIO
3389911;;F;85;CHILENO;;Silencioso;OVALLE                        ;COQUIMBO;0;0;0;0;0;0;0;0;0;CE ERGO T 2P 2MT BD;DORMITORIO
19139897;;M;26;CHILENO;;Millenial;LOTA                          ;BIO BIO;0;0;0;0;0;0;0;0;0;ALMOHADA ROSEN SOFT PLUS AMERICANA;DORMITORIO
9053438;;F;61;CHILENO;;Boomers;PROVIDENCIA                   ;METROPOLITANA;0;0;0;0;0;0;0;0;0;COLCHON NEW ORTOPEDIC 2P 150X190 + CUBREC;DORMITORIO
18590186;Soltero;M;28;CHILENO;KINESIOLOGO;Millenial;PROVIDENCIA                   ;METROPOLITANA;0;0;0;0;0;0;0;0;0;SET SABANA MICROFIBRA MUSTARD 2P;DORMITORIO
15015800;;F;39;CHILENO;;X;PROVIDENCIA                   ;METROPOLITANA;0;0;0;0;0;0;0;0;0;PACK 2 ALMOHADAS C+L;DORMITORIO
10310675;;F;53;CHILENO;;X;RENCA                         ;METROPOLITANA;0;0;0;0;0;0;0;0;0;BS ORTOPEDIC ADVANCE B5 BLACK 2PBN;DORMITORIO
11852086;;F;50;CHILENO;;X;ESTACION CENTRAL              ;METROPOLITANA;0;0;0;0;0;0;0;0;0;COLCHON EXCELLENCE 1.5 PLAZA + CUBRECOLCHON;DORMITORIO
17655185;;F;31;CHILENO;;Millenial;PROVIDENCIA                   ;METROPOLITANA;0;0;0;0;0;0;0;0;0;CAMAROTE TRIPLE CORINA CAFE OSCURO;DORMITORIO
15958691;;F;37;CHILENO;;Millenial;PROVIDENCIA                   ;METROPOLITANA;0;0;0;0;0;0;0;0;0;COLCHON SUPER PREMIUM 2P X 2 MTS;DORMITORIO
16285632;;F;35;CHILENO;INGENIERO INFORMATICO;Silencioso;PROVIDENCIA                   ;METROPOLITANA;0;0;0;0;0;0;0;0;0;COLCHON NEW STYLE 6 2P 150X200;DORMITORIO
17401143;;M;32;CHILENO;;Silencioso;PROVIDENCIA                   ;METROPOLITANA;0;0;0;0;0;0;0;0;0;COLCHON EXCELLENCE PLUS 1,5P;DORMITORIO
10681029;;F;52;CHILENO;;X;CHIMBARONGO                   ;L.G.B.OÂ´HIGGINS;0;0;0;0;0;0;0;0;0;CE EVOLUTION BLACK 1,5P BN RESP+VEL;DORMITORIO
18776770;Soltero;F;26;CHILENO;;Z;PROVIDENCIA                   ;METROPOLITANA;0;0;0;0;0;0;0;0;0;BS NEW ORTOPEDIC B5 BLACK 1.5P+RESP+VEL LEGNO;DORMITORIO
10143424;Casado;M;56;CHILENO;;Boomers;RENCA                         ;METROPOLITANA;0;0;0;0;0;0;0;0;0;CLOSET ESPANA 6P+4C;DORMITORIO
7178899;Casado;F;69;CHILENO;AUXILIAR DE ENFERMERIA;Silencioso;MELIPILLA                     ;METROPOLITANA;0;0;0;0;0;0;0;0;0;COLCHON EVEREST 1,5P HILOS DE COBRE;DORMITORIO
19541465;;F;25;CHILENO;;Silencioso;PROVIDENCIA                   ;METROPOLITANA;0;0;0;0;0;0;0;0;0;BOX 1 1/2 P + RESP +1 VEL;DORMITORIO
12855401;;M;46;CHILENO;;X;LA FLORIDA                    ;METROPOLITANA;0;0;0;0;0;0;0;0;0;CE ERGO T 2P 2MT BD;DORMITORIO
9131726;;M;60;CHILENO;;Boomers;BUIN                          ;METROPOLITANA;0;0;0;0;0;0;0;0;0;CE EVOLUTION BLACK 1P + RESPALDO CASTILLA;DORMITORIO
6034587;;F;74;CHILENO;;Silencioso;PUERTO MONTT                  ;LOS LAGOS;0;0;0;0;0;0;0;0;0;CE EVOLUTION BLACK 1,5P BN RESP+VEL;DORMITORIO
19312345;Casado;F;26;CHILENO;;Z;PROVIDENCIA                   ;METROPOLITANA;0;0;0;0;0;0;0;0;0;COLCHON NEW STYLE 6 2P;DORMITORIO
17189269;Soltero;F;33;CHILENO;PSICOLOGA;Silencioso;PROVIDENCIA                   ;METROPOLITANA;0;0;0;0;0;0;0;0;0;Velador Multi Funcional Z-54 - WENGUE;DORMITORIO
19100724;Soltero;F;27;CHILENO;;Z;PROVIDENCIA                   ;METROPOLITANA;0;0;0;0;0;0;0;0;0;CLOSET CROACIA BLANCO 4P;DORMITORIO
19481942;;F;26;CHILENO;;Z;N/D;N/D;0;0;0;0;0;0;0;0;0;RACK BELLINI 50;DORMITORIO
4785501;;F;79;CHILENO;;Silencioso;RENCA                         ;METROPOLITANA;0;0;0;0;0;0;0;0;0;COLCHON BEAT 1,5P;DORMITORIO
11943611;Soltero;M;49;CHILENO;;X;RENCA                         ;METROPOLITANA;0;0;0;0;0;0;0;0;0;COLCHON EXCELLENCE 1P;DORMITORIO
18137129;;F;30;CHILENO;;Millenial;CONCEPCION                    ;BIO BIO;0;0;0;0;0;0;0;0;0;COLCHON NEW STYLE 4 2P;DORMITORIO
18952495;;F;27;CHILENO;;Z;PROVIDENCIA                   ;METROPOLITANA;0;0;0;0;0;0;0;0;0;ALMOHADA SOFT MICROGEL;DORMITORIO
18555511;Soltero;M;28;CHILENO;;Silencioso;PROVIDENCIA                   ;METROPOLITANA;0;0;0;0;0;0;0;0;0;PACK 2 ALMOHADAS-D VISCO 60 x 40;DORMITORIO
12113970;;F;51;CHILENO;;X;MARCHIHUE                     ;L.G.B.OÂ´HIGGINS;0;0;0;0;0;0;0;0;0;ALMOHADA SOFT MICROGEL;DORMITORIO
14367692;;F;47;CHILENO;;X;PAINE                         ;METROPOLITANA;0;0;0;0;0;0;0;0;0;ALMOHADA SOFT MICROGEL;DORMITORIO
10048153;;F;58;CHILENO;;Boomers;PROVIDENCIA                   ;METROPOLITANA;0;0;0;0;0;0;0;0;0;CE BAMBOO 2P BD FIBRAS BAMBOO DUAL SIDE;DORMITORIO
12367675;Casado;M;49;CHILENO;;X;RENCA                         ;METROPOLITANA;0;0;0;0;0;0;0;0;0;CE EVOLUTION BLACK 1,5P BN RESP+VEL;DORMITORIO
15415712;;F;39;CHILENO;;X;PROVIDENCIA                   ;METROPOLITANA;0;0;0;0;0;0;0;0;0;DIVAN NEW ORTOPEDIC BLACK ALM+PL;DORMITORIO
9819654;;M;57;CHILENO;;Boomers;VALLENAR;ATACAMA;0;0;0;0;0;0;0;0;0;CE ORTO ADVANCE 2PBD +RESP+2VEL NEW DUB CHOC;DORMITORIO
19564917;;M;25;CHILENO;;Millenial;PROVIDENCIA                   ;METROPOLITANA;0;0;0;0;0;0;0;0;0;COLCHON EXCELLENCE 2 PLAZA + 2 ALM;DORMITORIO
11397136;;F;52;CHILENO;;X;PROVIDENCIA                   ;METROPOLITANA;0;0;0;0;0;0;0;0;0;SET 2 ALMOHADAS VISCO MEDIUM 60X40 CM;DORMITORIO
18343008;;F;29;CHILENO;;Millenial;N/D;N/D;0;0;0;0;0;0;0;0;0;CE EVOLUTION BLACK 1,5P BN RESP+VEL;DORMITORIO
13954557;;F;42;CHILENO;;X;SAN PEDRO DE LA PAZ           ;BIO BIO;0;0;0;0;0;0;0;0;0;COLCHON NEW ORTOPEDIC 2P 150X190 + CUBREC;DORMITORIO
19787993;;F;24;CHILENO;;Silencioso;PROVIDENCIA                   ;METROPOLITANA;0;0;0;0;0;0;0;0;0;ALMOHADA ROSEN SOFT PLUS AMERICANA;DORMITORIO
17343054;;F;33;CHILENO;;Millenial;PROVIDENCIA                   ;METROPOLITANA;0;0;0;0;0;0;0;0;0;CAMA EUROPEA EXCELLENCE 2 PLAZAS BASE NORMAL;DORMITORIO
15914622;;F;38;CHILENO;;Millenial;LEBU                          ;BIO BIO;0;0;0;0;0;0;0;0;0;Closet MAIPO 6PT 3CJ 180 CM CEREZO;DORMITORIO
19750092;;F;24;CHILENO;;Z;PROVIDENCIA                   ;METROPOLITANA;0;0;0;0;0;0;0;0;0;ESCRITORIO REPISAS CHOCOLATE;DORMITORIO
8832604;;F;57;CHILENO;;Boomers;PROVIDENCIA                   ;METROPOLITANA;0;0;0;0;0;0;0;0;0;COLCHON TERAPEUTIC 2P PILLOW TOP;DORMITORIO
13078562;;M;45;CHILENO;;X;BUIN                          ;METROPOLITANA;0;0;0;0;0;0;0;0;0;COLCHON SUPER PREMIUM 1,5P;DORMITORIO
17997667;Soltero;F;30;CHILENO;CIRUJANO DENTISTA;Millenial;PROVIDENCIA                   ;METROPOLITANA;0;0;0;0;0;0;0;0;0;CLOSET M-803 3P 2C ALTO 1,82 BLANCO NATURAL;DORMITORIO
13930735;;M;42;CHILENO;;X;N/D;N/D;0;0;0;0;0;0;0;0;0;TOCADOR BARBARA;DORMITORIO
16865073;;M;34;CHILENO;;Millenial;PROVIDENCIA                   ;METROPOLITANA;0;0;0;0;0;0;0;0;0;Cama Tempo King + Resp + 2 Vel Grafito;DORMITORIO
16783290;Soltero;F;34;CHILENO;;Millenial;PROVIDENCIA                   ;METROPOLITANA;0;0;0;0;0;0;0;0;0;COLCHON NEW STYLE 6 2P;DORMITORIO
18655961;;F;28;CHILENO;;Millenial;PROVIDENCIA                   ;METROPOLITANA;0;0;0;0;0;0;0;0;0;ESCRITORIO JACK CAFE;DORMITORIO
7561485;;F;71;CHILENO;;Silencioso;PETORCA                       ;VALPARAISO;0;0;0;0;0;0;0;0;0;COLCHON EXCELLENCE 1,5P;DORMITORIO
15435458;;F;40;CHILENO;;X;SAN JOSE DE MAIPO             ;METROPOLITANA;0;0;0;0;0;0;0;0;0;CLOSET CAJONERA NEW BELGICA M-398-NW;DORMITORIO
20342149;;F;32;CHILENO;;Millenial;FREIRE;ARAUCANIA;0;0;0;0;0;0;0;0;0;CLOSET M-803 3P 2C ALTO 1,82 BLANCO NATURAL;DORMITORIO
10638537;;M;52;CHILENO;;Silencioso;PROVIDENCIA                   ;METROPOLITANA;0;0;0;0;0;0;0;0;0;ALMOHADA SOFT MICROGEL;DORMITORIO
7829167;;F;65;CHILENO;;Boomers;CALERA                        ;VALPARAISO;0;0;0;0;0;0;0;0;0;COLCHON IBIZA 2P;DORMITORIO
11580745;Casado;M;52;CHILENO;;X;LOS ALAMOS                    ;BIO BIO;0;0;0;0;0;0;0;0;0;COLCHON TERAPEUTIC 2P PILLOW TOP;DORMITORIO
13959137;;F;42;CHILENO;;X;CORONEL                       ;BIO BIO;0;0;0;0;0;0;0;0;0;CLOSET CAJONERA NEW BELGICA M-398-NW;DORMITORIO
8739000;;M;56;CHILENO;;Boomers;LEBU                          ;BIO BIO;0;0;0;0;0;0;0;0;0;CE EVEREST 2P 2MTS BD DUAL SIDE;DORMITORIO
13216270;Soltero;M;45;CHILENO;;X;RENCA                         ;METROPOLITANA;0;0;0;0;0;0;0;0;0;CAMA EURO GRIS NEW ENTREE-D 2PBD;DORMITORIO
18013811;;F;30;CHILENO;;Millenial;PROVIDENCIA                   ;METROPOLITANA;0;0;0;0;0;0;0;0;0;RACK FAVATEX CAHUIL BLANCO;DORMITORIO
8965063;;F;61;CHILENO;;Boomers;PROVIDENCIA                   ;METROPOLITANA;0;0;0;0;0;0;0;0;0;COLCHON NEW ENTREE 2P;DORMITORIO
11168361;;F;55;CHILENO;;Boomers;EL TABO                       ;VALPARAISO;0;0;0;0;0;0;0;0;0;COLCHON TERAPEUTIC 2P PILLOW TOP;DORMITORIO
12241960;;M;50;CHILENO;;X;QUILPUE                       ;VALPARAISO;0;0;0;0;0;0;0;0;0;COLCHON TERAPEUTIC 2P PILLOW TOP;DORMITORIO
13309253;;F;45;CHILENO;;Millenial;"";"";0;0;0;0;0;0;0;0;0;CLOSET M-803 3P 2C ALTO 1,82 BLANCO NATURAL;DORMITORIO
16946227;;F;34;CHILENO;;Millenial;PROVIDENCIA                   ;METROPOLITANA;0;0;0;0;0;0;0;0;0;CLOSET NIZA 6P+2C;DORMITORIO
10006371;;F;59;CHILENO;;Boomers;CALBUCO                       ;LOS LAGOS;0;0;0;0;0;0;0;0;0;COLCHON MONT BLANC 2P DUAL SIDE;DORMITORIO
6582338;;F;74;CHILENO;;Silencioso;ISLA DE MAIPO                 ;METROPOLITANA;0;0;0;0;0;0;0;0;0;CLOSET NEW SLIM M-900 CASTANO;DORMITORIO
17021757;;F;34;CHILENO;;Millenial;N/D;N/D;0;0;0;0;0;0;0;0;0;Cama Tempo 2PBD + Resp + 2 Vel Grafito;DORMITORIO
13003080;;M;46;CHILENO;;X;PROVIDENCIA                   ;METROPOLITANA;0;0;0;0;0;0;0;0;0;PACK 2 ALMOHADAS C+L;DORMITORIO
18137957;;F;29;CHILENO;;Millenial;CORONEL                       ;BIO BIO;0;0;0;0;0;0;0;0;0;DUPLEX CE EVOLUTION BLACK 1P + 2 RESP + VEL ASTU;DORMITORIO
18931696;Soltero;F;27;CHILENO;TECNICO DE NIVEL SUPERIOR EN ENFERMERIA E INSTRUMENTACION QUIRURGICA;Z;PROVIDENCIA                   ;METROPOLITANA;0;0;0;0;0;0;0;0;0;PANEL DILETO;DORMITORIO
14353709;;M;43;CHILENO;;X;TALCAHUANO;BIO-BIO;0;0;0;0;0;0;0;0;0;COLCHON NEW STYLE 6 2P 150X200;DORMITORIO
18133220;;F;31;CHILENO;;Millenial;PROVIDENCIA                   ;METROPOLITANA;0;0;0;0;0;0;0;0;0;COLCHON SMART KING;DORMITORIO
13032688;;F;45;CHILENO;;X;RENCA                         ;METROPOLITANA;0;0;0;0;0;0;0;0;0;CLOSET NEWCAPRI M-330 AVELLANA/CARVALHO4P3C+ESPE;DORMITORIO
9057892;;M;59;CHILENO;;Boomers;PROVIDENCIA                   ;METROPOLITANA;0;0;0;0;0;0;0;0;0;COLCHON TERAPEUTIC 2P PILLOW TOP;DORMITORIO
15044231;;F;40;CHILENO;;X;"";"";0;0;0;0;0;0;0;0;0;PACK 2 ALMOHADAS C+L;DORMITORIO
6214058;;M;71;CHILENO;;Silencioso;SAN ANTONIO                   ;VALPARAISO;0;0;0;0;0;0;0;0;0;CE ERGO T 2P 2MT BD;DORMITORIO
15033892;Casado;F;39;CHILENO;KINESIOLOGO;X;RENCA                         ;METROPOLITANA;0;0;0;0;0;0;0;0;0;PACK 2 ALMOHADAS 100% PLUMA 50 X 70 CM;DORMITORIO
17149890;;M;33;CHILENO;;Millenial;PROVIDENCIA                   ;METROPOLITANA;0;0;0;0;0;0;0;0;0;DIVAN CAMA ERGO T 1,5P 2MTS+RESP+1 VEL TABOR;DORMITORIO
18074943;;F;30;CHILENO;;Millenial;RENCA                         ;METROPOLITANA;0;0;0;0;0;0;0;0;0;COLCHON TERAPEUTIC 2P PILLOW TOP;DORMITORIO
9968948;;F;57;CHILENO;;Boomers;RENCA                         ;METROPOLITANA;0;0;0;0;0;0;0;0;0;ALMOHADA ROSEN SOFT PLUS KING;DORMITORIO
19151196;;M;27;CHILENO;;Z;QUILPUE                       ;VALPARAISO;0;0;0;0;0;0;0;0;0;CE EVOLUTION BLACK 1,5P + RESPALDO CASTILLA;DORMITORIO
14553922;Casado;M;42;CHILENO;;X;RENCA                         ;METROPOLITANA;0;0;0;0;0;0;0;0;0;ALMOHADA VISCO SLEEP TECH SERIES 65X45 CM;DORMITORIO
9805666;;F;59;CHILENO;;Boomers;EL BOSQUE                     ;METROPOLITANA;0;0;0;0;0;0;0;0;0;COLCHON TERAPEUTIC 2P PILLOW TOP;DORMITORIO
12768671;;M;46;CHILENO;;X;LOS ANGELES                   ;BIO BIO;0;0;0;0;0;0;0;0;0;COLCHON SUPER PREMIUM 2P X 2 MTS;DORMITORIO
15864602;;M;37;CHILENO;;Millenial;VILLARICA                     ;ARAUCANIA;0;0;0;0;0;0;0;0;0;COLCHON EXCELLENCE 1,5P;DORMITORIO
18488244;;M;28;CHILENO;;Millenial;MELIPILLA                     ;METROPOLITANA;0;0;0;0;0;0;0;0;0;BOX AMERICANO EXCELLENCE 2P BASE NORMAL+2ALM;DORMITORIO
10809513;;M;41;CHILENO;;X;RENCA                         ;METROPOLITANA;0;0;0;0;0;0;0;0;0;CAMA ELOISA 1.5P + CAMA NIDO 1P;DORMITORIO
10039661;;F;58;CHILENO;;Boomers;PROVIDENCIA                   ;METROPOLITANA;0;0;0;0;0;0;0;0;0;RESPALDO ALICANTE FELPA ROJO 2P;DORMITORIO
8068055;;M;63;CHILENO;;Boomers;PROVIDENCIA                   ;METROPOLITANA;0;0;0;0;0;0;0;0;0;ALMOHADA SOFT MICROGEL;DORMITORIO
16252814;;F;36;CHILENO;;Millenial;N/D;N/D;0;0;0;0;0;0;0;0;0;ALMOHADA COOL GEL TECH SERIES 60X40 CM;DORMITORIO
23435804;;M;65;COLOMBIANO;;Extranjero;ANTOFAGASTA                   ;ANTOFAGASTA;0;0;0;0;0;0;0;0;0;CE EVOLUTION BLACK 2P BD DUAL SIDE;DORMITORIO
14043194;;F;40;CHILENO;;X;COIHAIQUE                     ;AYSEN;0;0;0;0;0;0;0;0;0;COLCHON NEW ORTOPEDIC 1P;DORMITORIO
10605693;;F;53;CHILENO;;X;N/D;N/D;0;0;0;0;0;0;0;0;0;Duplex Spring III 1P + Resp + 1 Vel Arezzo;DORMITORIO
13587920;;M;44;CHILENO;;X;LA SERENA                     ;COQUIMBO;0;0;0;0;0;0;0;0;0;Almohada Viscoelastica Bamboo Pack 73x43 cm;DORMITORIO
17400565;;F;32;CHILENO;;Millenial;PROVIDENCIA                   ;METROPOLITANA;0;0;0;0;0;0;0;0;0;CE BAMBOO 2P BD FIBRAS BAMBOO DUAL SIDE;DORMITORIO
19579499;;F;25;CHILENO;;Z;CANETE                        ;BIO BIO;0;0;0;0;0;0;0;0;0;BOX AMERICANO EXCELLENCE 1.5 PLAZAS;DORMITORIO
7480250;Casado;M;57;CHILENO;INGENIERO CIVIL;Boomers;PROVIDENCIA                   ;METROPOLITANA;0;0;0;0;0;0;0;0;0;CE ERGO T 2P 2MT BD;DORMITORIO
19504738;;M;25;CHILENO;;Z;CHANARAL                      ;ATACAMA;0;0;0;0;0;0;0;0;0;Closet MAIPO 6PT 6CJ 180 CM CHOCOLATE;DORMITORIO
17358942;;M;33;CHILENO;;Millenial;VALDIVIA                      ;LOS RIOS;0;0;0;0;0;0;0;0;0;CE EVOLUTION BLACK 1P BN DUAL SIDE;DORMITORIO
12659671;Casado;F;48;CHILENO;;X;PROVIDENCIA                   ;METROPOLITANA;0;0;0;0;0;0;0;0;0;COLCHON MAXIMO COBRE 1,5P 2MTS;DORMITORIO
19922684;;F;22;CHILENO;;Millenial;PROVIDENCIA                   ;METROPOLITANA;0;0;0;0;0;0;0;0;0;CLOSET ESPANA 6P+4C;DORMITORIO
10316840;;F;53;CHILENO;;X;CHILLAN                       ;BIO BIO;0;0;0;0;0;0;0;0;0;CLOSET NIZA 6P+2C;DORMITORIO
11206156;;F;55;CHILENO;;Boomers;PROVIDENCIA                   ;METROPOLITANA;0;0;0;0;0;0;0;0;0;CE BLACK EVOLUTION FULL;DORMITORIO
10550461;;F;55;CHILENO;;Boomers;PROVIDENCIA                   ;METROPOLITANA;0;0;0;0;0;0;0;0;0;COMODA 5C KANSAS;DORMITORIO
10217463;;M;50;CHILENO;;X;PROVIDENCIA                   ;METROPOLITANA;0;0;0;0;0;0;0;0;0;PACK 2 ALMOHADAS C+L;DORMITORIO
10244164;;M;54;CHILENO;;X;N/D;N/D;0;0;0;0;0;0;0;0;0;COLCHON NEW ORTOPEDIC 2P;DORMITORIO
10929211;;F;51;CHILENO;;X;SAN VICENTE                   ;L.G.B.OÂ´HIGGINS;0;0;0;0;0;0;0;0;0;CAMA EURO MORADO NEW ENTREE-D 1.5 PL;DORMITORIO
6064921;;M;60;CHILENO;;Boomers;PROVIDENCIA                   ;METROPOLITANA;0;0;0;0;0;0;0;0;0;COLCHON EXCELLENCE 1P;DORMITORIO
13168530;;F;45;CHILENO;;X;ANCUD                         ;LOS LAGOS;0;0;0;0;0;0;0;0;0;CE ERGO T KING 2MT BD;DORMITORIO
19154474;;F;26;CHILENO;;Z;PROVIDENCIA                   ;METROPOLITANA;0;0;0;0;0;0;0;0;0;COLCHON NEW STYLE 4 2P;DORMITORIO
9887855;;F;58;CHILENO;;Boomers;PROVIDENCIA                   ;METROPOLITANA;0;0;0;0;0;0;0;0;0;COLCHON ERGO T 2P;DORMITORIO
15611817;;F;38;CHILENO;;Millenial;RENCA                         ;METROPOLITANA;0;0;0;0;0;0;0;0;0;COLCHON NEW STYLE 4 2P;DORMITORIO
11891512;;M;51;CHILENO;;X;SAN VICENTE                   ;L.G.B.OÂ´HIGGINS;0;0;0;0;0;0;0;0;0;COLCHON BAMBOO 1,5P FIBRAS BAMBOO;DORMITORIO
14419445;;F;48;CHILENO;;X;CHILLAN                       ;BIO BIO;0;0;0;0;0;0;0;0;0;CE ERGO T 2P 2MT BD;DORMITORIO
19448862;;M;25;CHILENO;;Z;PROVIDENCIA                   ;METROPOLITANA;0;0;0;0;0;0;0;0;0;DIVAN CAMA ERGO T 1,5P 2MTS+RESP+1 VEL TABOR;DORMITORIO
11840441;;F;51;CHILENO;;X;N/D;N/D;0;0;0;0;0;0;0;0;0;DIVAN CAMA ERGO T 1,5P 2 MTS;DORMITORIO
15361064;;F;38;CHILENO;;Millenial;INDEPENDENCIA                 ;METROPOLITANA;0;0;0;0;0;0;0;0;0;CE NEW STYLE 6 2P 2MT BD+RESP+2VEL FERRARA;DORMITORIO
21448876;;M;36;CHILENO;;Millenial;PROVIDENCIA                   ;METROPOLITANA;0;0;0;0;0;0;0;0;0;COLCHON NEW STYLE 4 2P 150X200;DORMITORIO
26078258;;M;37;HAITIANO;;Extranjero;PARRAL                        ;MAULE;0;0;0;0;0;0;0;0;0;PACK 2 ALMOHADAS C+L;DORMITORIO
13692158;;F;43;CHILENO;;X;MAIPU                         ;METROPOLITANA;0;0;0;0;0;0;0;0;0;COLCHON ERGO T 2P;DORMITORIO
12706439;Casado;M;50;CHILENO;;X;PROVIDENCIA                   ;METROPOLITANA;0;0;0;0;0;0;0;0;0;COLCHON BAMBOO 2P FIBRAS BAMBOO;DORMITORIO
17693655;;F;31;CHILENO;;Millenial;VALDIVIA                      ;LOS RIOS;0;0;0;0;0;0;0;0;0;CLOSET CROACIA CHOCOLATE 4P;DORMITORIO
17606270;Soltero;F;31;CHILENO;TECNICO EN PREVENCION DE RIESGOS;Millenial;PROVIDENCIA                   ;METROPOLITANA;0;0;0;0;0;0;0;0;0;CAMA NIDO EVOLUTION BLACK 1,5P;DORMITORIO
18428697;Soltero;M;29;CHILENO;;Millenial;PROVIDENCIA                   ;METROPOLITANA;0;0;0;0;0;0;0;0;0;COLCHON EXCELLENCE FULL;DORMITORIO
10564789;;F;57;CHILENO;;Boomers;RENCA                         ;METROPOLITANA;0;0;0;0;0;0;0;0;0;CE EVOLUTION BLACK 1P BN DUAL SIDE;DORMITORIO
9871871;;M;58;CHILENO;;Boomers;RENCA                         ;METROPOLITANA;0;0;0;0;0;0;0;0;0;ALMOHADA ROSEN SOFT PLUS AMERICANA;DORMITORIO
18947166;;F;27;CHILENO;;Millenial;CONCHALI                      ;METROPOLITANA;0;0;0;0;0;0;0;0;0;PACK 2 ALMOHADAS C+L;DORMITORIO
17635545;;M;31;CHILENO;;Millenial;PROVIDENCIA                   ;METROPOLITANA;0;0;0;0;0;0;0;0;0;Almohada Visco Aloe Vera Classic 60x40 cm;DORMITORIO
17444219;Soltero;F;32;CHILENO;;Millenial;PROVIDENCIA                   ;METROPOLITANA;0;0;0;0;0;0;0;0;0;CE EVOLUTION BLACK 1P + RESPALDO ASTURIAS;DORMITORIO
15956747;;F;37;CHILENO;;Millenial;N/D;N/D;0;0;0;0;0;0;0;0;0;Closet PASCO 3 PUERTAS CHOCOLATE;DORMITORIO
15375968;;M;43;CHILENO;;X;PROVIDENCIA                   ;METROPOLITANA;0;0;0;0;0;0;0;0;0;CE ERGO T 2P 2MT BD;DORMITORIO
6388941;;F;70;CHILENO;;Silencioso;ANTOFAGASTA                   ;ANTOFAGASTA;0;0;0;0;0;0;0;0;0;COMODA ALTAIR WALNUT;DORMITORIO
19041293;Soltero;F;27;CHILENO;;Z;PROVIDENCIA                   ;METROPOLITANA;0;0;0;0;0;0;0;0;0;CAMA EUROPEA IBIZA 2 PL BD + MADERAS CASTELL;DORMITORIO
6587442;Casado;F;74;CHILENO;;Silencioso;RENCA                         ;METROPOLITANA;0;0;0;0;0;0;0;0;0;PACK 2 ALMOHADAS C+L;DORMITORIO
16602317;;F;34;CHILENO;;Millenial;ILLAPEL                       ;COQUIMBO;0;0;0;0;0;0;0;0;0;PACK 2 ALMOHADAS C+L;DORMITORIO
15762958;;M;38;CHILENO;;Millenial;PROVIDENCIA                   ;METROPOLITANA;0;0;0;0;0;0;0;0;0;CE EVOLUTION BLACK 2P BN+RESP+2 VEL;DORMITORIO
11198367;Soltero;F;54;CHILENO;;Boomers;PROVIDENCIA                   ;METROPOLITANA;0;0;0;0;0;0;0;0;0;CLOSET TOKIO M-460 AVELLANA / CASTANO 6P1C1Z;DORMITORIO
13405552;;F;44;CHILENO;;X;PUENTE ALTO                   ;METROPOLITANA;0;0;0;0;0;0;0;0;0;BS NEW ORTOPEDIC B5 BLACK 2PBN;DORMITORIO
14429898;;F;53;CHILENO;;X;PROVIDENCIA                   ;METROPOLITANA;0;0;0;0;0;0;0;0;0;DUPLEX CE EVOLUTION BLACK 1P + 2 RESP + VEL ASTU;DORMITORIO
18126115;Soltero;M;30;CHILENO;PROFESOR;Millenial;PROVIDENCIA                   ;METROPOLITANA;0;0;0;0;0;0;0;0;0;Cama Europea Danubio 2P BD Comprimido;DORMITORIO
17525408;;M;30;CHILENO;;Millenial;NANCAGUA                      ;L.G.B.OÂ´HIGGINS;0;0;0;0;0;0;0;0;0;CE NEW ORTOPEDIC 2PBD;DORMITORIO
12435818;;M;49;CHILENO;;X;ARICA                         ;ARICA Y PARINACOTA;0;0;0;0;0;0;0;0;0;Closet PASCO 3 PUERTAS CEREZO;DORMITORIO
10067960;;M;58;CHILENO;;Boomers;N/D;N/D;0;0;0;0;0;0;0;0;0;BA EXCELLENCE PLUS 2P BD +RESP+VEL OLMO;DORMITORIO
5996302;;M;76;CHILENO;;Silencioso;NUEVA IMPERIAL                ;ARAUCANIA;0;0;0;0;0;0;0;0;0;BOX AMERICANO MIRAGE 2PBN;DORMITORIO
13687269;Casado;M;43;CHILENO;MEDICO VETERINARIO;X;PROVIDENCIA                   ;METROPOLITANA;0;0;0;0;0;0;0;0;0;COLCHON DANUBIO 2P COMPRIMIDO;DORMITORIO
16350087;;F;36;CHILENO;;Millenial;PROVIDENCIA                   ;METROPOLITANA;0;0;0;0;0;0;0;0;0;CAMA EUROPEA THERAPEDIC MAS 1,5P;DORMITORIO
16455380;;M;36;CHILENO;;Millenial;QUILLOTA                      ;VALPARAISO;0;0;0;0;0;0;0;0;0;CLOSET ARICA TV 32 M302 TEXTURADO;DORMITORIO
18149633;;F;30;CHILENO;;Millenial;N/D;N/D;0;0;0;0;0;0;0;0;0;ALMOHADA BAMBOO TECH SERIES 65X45 CM;DORMITORIO
16653411;;F;34;CHILENO;;Millenial;ILLAPEL                       ;COQUIMBO;0;0;0;0;0;0;0;0;0;BS NEW ORTOPEDIC B5 BLACK 2P BD ALM+PL;DORMITORIO
12285285;;M;51;CHILENO;;X;RENCA                         ;METROPOLITANA;0;0;0;0;0;0;0;0;0;CE EVOLUTION BLACK 1,5P + RESPALDO CASTILLA;DORMITORIO
17934181;;M;31;CHILENO;;Millenial;PROVIDENCIA                   ;METROPOLITANA;0;0;0;0;0;0;0;0;0;CE ERGO T 2P 2MT BD;DORMITORIO
13655254;Divorciado;F;43;CHILENO;;X;RENCA                         ;METROPOLITANA;0;0;0;0;0;0;0;0;0;CAMA EUROPEA IBIZA 2 PL BD;DORMITORIO
24622541;;F;58;PERUANO;;Extranjero;PROVIDENCIA                   ;METROPOLITANA;1968010;13;9;0;0;0;13;9;1968010;NTBK Aspire 5 R3/4GB/128SSD/15P FHD W+T Ingles;COMPUTACION
21460746;;M;24;ARGENTINO;;Extranjero;N/D;N/D;886950;5;3;4;2;861960;1;1;24990;Multifuncional EcoTank L4260 Wifi y Duplex;COMPUTACION
16867495;;F;34;CHILENO;;Extranjero;PAIGUANO                      ;COQUIMBO;139990;1;1;0;0;0;1;1;139990;Tab M10 Plus FHD 4GB 64GB 10.3P platinum grey;COMPUTACION
17715195;;F;31;CHILENO;;Millenial;PUNTA ARENAS                  ;MAGALLANES;346970;5;2;1;1;129990;4;1;216980;NTBK D330 Celeron N4020/4GB/64GB/10P+OfficeHS;COMPUTACION
13171605;;F;44;CHILENO;;X;N/D;N/D;167130;4;2;0;0;0;4;2;167130;TAB 7 PLAY AND LEARN PLUS BLUE 8868;COMPUTACION
26210016;;M;36;VENEZOLANO;;Extranjero;N/D;N/D;223980;2;1;2;1;223980;0;0;0;NTBK Inspiron 3505 Athlon 3050U/12GB/256 SSD/15P;COMPUTACION
18465081;;M;28;CHILENO;;Millenial;PROVIDENCIA                   ;METROPOLITANA;50960;4;2;4;2;50960;0;0;0;TABLET MLAB 7 MB4 PLUS 1+16GB RED;COMPUTACION
13643289;;F;43;CHILENO;;X;N/D;N/D;817830;6;6;0;0;0;6;6;817830;Monitor Nitro XFA240Q 23,6P 165Hz Full HD;COMPUTACION
9438444;Casado;M;60;CHILENO;;Boomers;RENCA                         ;METROPOLITANA;159990;1;1;0;0;0;1;1;159990;Multifuncional DCPT520W Wifi;COMPUTACION
17222626;Soltero;M;33;CHILENO;;Millenial;TALCAHUANO                    ;BIO BIO;455970;3;2;3;2;455970;0;0;0;NTBK IP3 Ryzen 3-5300U/8GB/256GB SSD/14P FHD;COMPUTACION
8503708;;M;50;CHILENO;;X;PROVIDENCIA                   ;METROPOLITANA;385980;2;1;2;1;385980;0;0;0;NBTK IP3 Core i5-10210U/8GB/512GB SSD/15P;COMPUTACION
8382991;;F;60;CHILENO;;Boomers;HIJUELAS                      ;VALPARAISO;139990;1;1;0;0;0;1;1;139990;Multifuncional EcoTank L3210;COMPUTACION
13012654;;F;46;CHILENO;;X;ANTOFAGASTA;ANTOFAGASTA;160480;2;1;2;1;160480;0;0;0;NTBK Inspiron 3502 Celeron/4GB/128GB SSD/+O365;COMPUTACION
12502765;;F;49;CHILENO;;X;RENCA                         ;METROPOLITANA;383980;2;1;2;1;383980;0;0;0;NBTK IP3 Core i5-10210U/8GB/512GB SSD/15P;COMPUTACION
10136315;;F;58;CHILENO;;Boomers;N/D;N/D;750630;5;2;0;0;0;5;2;750630;NTBK 240 G8 Core i3-1005G1/8GB/256GB SSD/14P;COMPUTACION
23796827;;M;30;BOLIVIANO;;Extranjero;ANTOFAGASTA                   ;ANTOFAGASTA;801420;6;2;0;0;0;6;2;801420;NTBK 15-ef1015la Ryzen 3-4300U/4GB/256GBSSD/15P;COMPUTACION
14040454;;M;48;CHILENO;;X;HUALAIHUE                     ;LOS LAGOS;275960;4;1;0;0;0;4;1;275960;Multifuncional EcoTank L4260 Wifi y Duplex;COMPUTACION
7223646;;F;60;CHILENO;;Boomers;VINA DEL MAR                  ;VALPARAISO;69990;1;1;0;0;0;1;1;69990;Smart Tab M8 2G-32GB 8 IPS HD WiFi + Docking iro;COMPUTACION
4069930;;F;82;CHILENO;;Silencioso;COPIAPO                       ;ATACAMA;479940;8;6;0;0;0;8;6;479940;Multifuncional EcoTank L3250 Wifi;COMPUTACION
7490641;;F;64;CHILENO;;Boomers;EL MONTE                      ;METROPOLITANA;299990;1;1;0;0;0;1;1;299990;NTBK 348 G7 Core i5-10210U/4GB/1TB/14P;COMPUTACION
9372022;;M;57;CHILENO;;Boomers;COIHAIQUE                     ;AYSEN;509980;2;2;0;0;0;2;2;509980;TABLET TCL TAB 10NEO BLACK+ KEYBOARD;COMPUTACION
15513975;;F;39;CHILENO;;X;VALLENAR;ATACAMA;209290;2;1;0;0;0;2;1;209290;Multifuncional DCPT520W Wifi;COMPUTACION
10373377;;M;55;CHILENO;;Boomers;PROVIDENCIA                   ;N/D;139990;1;1;0;0;0;1;1;139990;TAB Galaxy A7 Lite (8.7, 32GB, WIFI + 4G);COMPUTACION
12789187;;F;46;CHILENO;;X;AISEN                         ;AYSEN;1235950;7;5;0;0;0;7;5;1235950;NTBK IP5 Ryzen 7-4700U/16GB/256GB SSD/15P FHD;COMPUTACION
9731033;;F;60;CHILENO;;Boomers;"";"";882940;6;4;5;3;742950;1;1;139990;Impresora Laser HL-1202 Monocromatica;COMPUTACION
6511539;;M;71;CHILENO;;Silencioso;PROVIDENCIA                   ;METROPOLITANA;3204330;28;10;0;0;0;28;10;3204330;NTBK 240 G8 Celeron N4020/4GB/500GB/14P;COMPUTACION
14286302;;F;48;CHILENO;;X;PROVIDENCIA                   ;METROPOLITANA;240980;2;1;0;0;0;2;1;240980;AIO/Athlon 3050U/4GB/1TB + 256GB/UMA/White;COMPUTACION
17504268;;F;32;CHILENO;;Millenial;SAN FERNANDO;O HIGGINS;145980;2;1;2;1;145980;0;0;0;Multifuncional EcoTank L3210;COMPUTACION
12255516;;M;50;CHILENO;;X;RECOLETA                      ;METROPOLITANA;955739;7;2;0;0;0;7;2;955739;NTBK 15-ef1015la Ryzen 3-4300U/4GB/256GBSSD/15P;COMPUTACION
16829973;;F;33;CHILENO;;Millenial;"";"";251960;4;4;0;0;0;4;4;251960;Multifuncional EcoTank L3250 Wifi;COMPUTACION
18518543;;M;28;CHILENO;;Millenial;TOCOPILLA                     ;ANTOFAGASTA;42980;2;1;2;1;42980;0;0;0;Router Huawei AX3 WIFI Quad core;COMPUTACION
23991347;Soltero;M;39;ARGENTINO;;Extranjero;PROVIDENCIA                   ;METROPOLITANA;582940;6;3;6;3;582940;0;0;0;Multifuncional DCPT520W Wifi;COMPUTACION
17241268;;M;37;CHILENO;;Millenial;N/D;N/D;319980;3;2;1;1;139990;2;1;179990;NTBK 240 G8 Celeron N4020/4GB/500GB/14P;COMPUTACION
19129047;Soltero;F;26;CHILENO;;Z;LA LIGUA                      ;VALPARAISO;60770;4;3;0;0;0;4;3;60770;TAB MLAB MBX 8 QUAD CORE 1G+16G 8716;COMPUTACION
10859312;;F;54;CHILENO;;X;COLINA                        ;METROPOLITANA;366960;4;2;4;2;366960;0;0;0;Galaxy Tab S6 Lite + Book Cover (10.4,128GB,Blue;COMPUTACION
6656838;;F;69;CHILENO;;Silencioso;N/D;N/D;1297450;8;5;2;1;304980;6;4;992470;NTBK D14 Ci5-10210U/8GB/512SSD/14 FHD/ office365;COMPUTACION
15528412;;F;39;CHILENO;;X;"";"";1240950;5;2;5;2;1240950;0;0;0;NTBK L5i Ci7-10750H/16GB/128SSD+1TB/RTX2060 6GB;COMPUTACION
17901731;;F;30;CHILENO;;Millenial;PROVIDENCIA                   ;METROPOLITANA;179990;1;1;0;0;0;1;1;179990;Multifuncional EcoTank L3250 Wifi;COMPUTACION
12365510;;M;48;CHILENO;;X;RENCA                         ;METROPOLITANA;699980;2;1;0;0;0;2;1;699980;NTBK 15-eh0006la Ryzen 5-4500U/8GB/512GB/15P;COMPUTACION
13047234;;M;47;CHILENO;;X;RENCA                         ;METROPOLITANA;303980;2;1;2;1;303980;0;0;0;TAB P11 6G-128GB Case + KB + Pen + Wifi +Â  Slate;COMPUTACION
7661698;;M;66;CHILENO;;Boomers;CHILLAN                       ;BIO BIO;104990;1;1;0;0;0;1;1;104990;Multifuncional DCPT220;COMPUTACION
25877533;;F;37;VENEZOLANO;;Extranjero;N/D;N/D;143980;2;1;2;1;143980;0;0;0;NTBK D330 Celeron N4020/4GB/64GB/10P+OfficeHS;COMPUTACION
19095149;;M;26;CHILENO;;Millenial;PUDAHUEL;METROPOLITANA;73980;2;1;2;1;73980;0;0;0;Smart Tab M8 2G-32GB 8 IPS HD WiFi + Docking iro;COMPUTACION
22457468;;M;30;CHILENO;;Millenial;SANTIAGO                      ;METROPOLITANA;569990;1;1;1;1;569990;0;0;0;NTBK IP5 Ryzen 7-4700U/16GB/256GB SSD/15P FHD;COMPUTACION
18892753;;M;27;CHILENO;;Extranjero;TALCA                         ;MAULE;217960;4;3;0;0;0;4;3;217960;NTBK 240 G8 Celeron N4020/4GB/500GB/14P;COMPUTACION
13128883;;M;45;CHILENO;;X;CHILLAN VIEJO                 ;BIO BIO;555810;5;4;2;1;185840;3;3;369970;TABLET XIAOMI MI PAD 5 6/126GB;COMPUTACION
6996943;;F;66;CHILENO;;Boomers;PUENTE ALTO                   ;METROPOLITANA;1824920;17;11;0;0;0;17;11;1824920;NTBK 15-ef1015la Ryzen 3-4300U/4GB/256GBSSD/15P;COMPUTACION
16633693;Soltero;F;34;CHILENO;;Millenial;TEMUCO                        ;ARAUCANIA;159990;1;1;1;1;159990;0;0;0;NTBK 240 G8 Celeron N4020/4GB/500GB/14P;COMPUTACION
8083856;;M;62;CHILENO;;Boomers;N/D;N/D;197990;1;2;0;0;0;1;2;197990;NTBK XH02 Celeron 4GB/64GB eMMC/11P/T+W ingles;COMPUTACION
17759865;;F;31;CHILENO;;Millenial;LINARES                       ;MAULE;642960;4;3;0;0;0;4;3;642960;NTBK D330 Celeron N4020/4GB/64GB/10P+OfficeHS;COMPUTACION
13682839;Soltero;F;43;CHILENO;ADMINISTRADOR PUBLICO;X;QUILICURA                     ;METROPOLITANA;497230;2;1;0;0;0;2;1;497230;NBTK IP3 Core i5-10210U/8GB/512GB SSD/15P;COMPUTACION
15641923;;M;38;CHILENO;;Extranjero;PROVIDENCIA                   ;N/D;53980;2;1;2;1;53980;0;0;0;Impresora Monocromatica Xerox B210-NDI;COMPUTACION
19227649;Soltero;F;26;CHILENO;FONOAUDIOLOGA;Millenial;"";"";195940;6;2;5;1;187950;1;1;7990;T544 DYE BLACK INK BOTTLE (65ml);COMPUTACION
13606492;;M;42;CHILENO;;X;ARAUCO                        ;BIO BIO;134990;1;1;0;0;0;1;1;134990;Tab M10 Plus FHD 4GB 64GB 10.3P platinum grey;COMPUTACION
13650144;;M;42;CHILENO;;X;"";"";1284400;12;3;0;0;0;12;3;1284400;AIO IC A340 Core i3/4GB/1TB/24P Full HD;COMPUTACION
16465933;;M;36;CHILENO;;Millenial;ARICA                         ;ARICA Y PARINACOTA;839970;3;3;3;3;839970;0;0;0;Multifuncional EcoTank L3210;COMPUTACION
21702763;;F;26;PERUANO;;Extranjero;PROVIDENCIA                   ;METROPOLITANA;174930;6;2;6;2;174930;0;0;0;Multifuncional XP-2101 wifi;COMPUTACION
18332916;;F;29;CHILENO;;Millenial;CARAHUE                       ;ARAUCANIA;169990;1;1;0;0;0;1;1;169990;Multifuncional EcoTank L3210;COMPUTACION
10638097;;M;50;CHILENO;;X;PROVIDENCIA                   ;METROPOLITANA;249990;1;1;1;1;249990;0;0;0;TAB S6 Lite (610) 4GB 64GB 10.4P PINK;COMPUTACION
11944100;;F;53;CHILENO;;X;COPIAPO                       ;ATACAMA;199990;1;1;0;0;0;1;1;199990;Galaxy Tab A8 (10.5, 64GB, WIFI) Pink Gold;COMPUTACION
13010748;;F;46;CHILENO;;X;CALAMA                        ;ANTOFAGASTA;75480;2;2;0;0;0;2;2;75480;TAB M7 3ra Gen MT8766 2+32GB 7 Wifi Iron grey;COMPUTACION
12053474;;F;54;CHILENO;;Boomers;AISEN                         ;AYSEN;352980;2;1;0;0;0;2;1;352980;NTBK 255 G8 Ryzen 5-5500U/8GB/256GB SSD/15P;COMPUTACION
18239381;;M;30;CHILENO;;Millenial;N/D;N/D;49990;1;1;0;0;0;1;1;49990;Multifuncional DeskJet Ink Advantage 2752 Wifi;COMPUTACION
18137387;;F;30;CHILENO;;Millenial;CORONEL                       ;BIO BIO;566040;8;6;2;1;115840;6;5;450200;TAB Galaxy A7 Lite (8.7, 32GB, WIFI);COMPUTACION
16331794;;F;35;CHILENO;;Millenial;"";"";171980;2;1;2;1;171980;0;0;0;Monitor 27MK400H-B.AWH 27P Full HD FreeSync;COMPUTACION
11110205;;M;55;CHILENO;;Boomers;PROVIDENCIA                   ;METROPOLITANA;1096090;5;2;0;0;0;5;2;1096090;NTBK FX506 Ci5-10300H/8GB/512GB SSD/GTX1650 4GB;COMPUTACION
7687858;;F;61;CHILENO;;Boomers;PROVIDENCIA                   ;METROPOLITANA;439690;9;3;0;0;0;9;3;439690;NTBK Inspiron 3501 Ci3-1115G4/4GB/1TB/14P;COMPUTACION
7104682;;F;66;CHILENO;;Boomers;VALPARAISO                    ;VALPARAISO;499990;1;1;0;0;0;1;1;499990;AIO IC A340 Core i5/4GB/256GB SSD+1TB/23.8P FHD;COMPUTACION
19984164;;F;24;CHILENO;;Z;PROVIDENCIA                   ;METROPOLITANA;253980;2;1;2;1;253980;0;0;0;TAB S6 Lite (610) 4GB 64GB 10.4P PINK;COMPUTACION
17502457;Soltero;M;32;CHILENO;;Millenial;PROVIDENCIA                   ;METROPOLITANA;36980;2;1;2;1;36980;0;0;0;TABLET MLAB 7 MB4 PLUS 1+16GB RED;COMPUTACION
18583041;;F;26;CHILENO;;Z;PROVIDENCIA                   ;METROPOLITANA;368970;2;1;0;0;0;2;1;368970;NTBK X415 Core i3-10110U/4GB/256GB SSD/14P FHD;COMPUTACION
14121653;;M;40;CHILENO;;X;RENCA                         ;METROPOLITANA;349990;1;1;1;1;349990;0;0;0;NTBK IP3 Ryzen 3-5300U/8GB/256GB SSD/14P FHD;COMPUTACION
7902946;Casado;F;65;CHILENO;;Boomers;QUILLOTA                      ;VALPARAISO;831900;10;8;1;1;139990;9;7;691910;NTBK 240 G8 Celeron N4020/4GB/500GB/14P;COMPUTACION
26734966;Soltero;F;32;VENEZOLANO;;Extranjero;PROVIDENCIA                   ;N/D;323980;2;1;2;1;323980;0;0;0;NTBK IP3 Ryzen 3-5300U/8GB/256GB SSD/14P FHD;COMPUTACION
16124181;;M;37;CHILENO;;Silencioso;PROVIDENCIA                   ;METROPOLITANA;917960;4;2;4;2;917960;0;0;0;NTBK L5i Ci7-10750H/16GB/128SSD+1TB/RTX2060 6GB;COMPUTACION
25927007;;M;33;ECUATORIANO;;Extranjero;N/D;N/D;270290;3;2;0;0;0;3;2;270290;NTBK 240 G8 Celeron N4020/4GB/500GB/14P;COMPUTACION
26276414;;M;34;VENEZOLANO;;Extranjero;"";"";156830;4;1;0;0;0;4;1;156830;TAB Galaxy A7 Lite (8.7, 32GB, WIFI);COMPUTACION
15078838;;F;39;CHILENO;;X;N/D;N/D;323960;4;2;4;2;323960;0;0;0;Impresora Laser HL-1202 Monocromatica;COMPUTACION
16295223;;F;36;CHILENO;;Millenial;CANETE                        ;BIO BIO;579970;3;2;3;2;579970;0;0;0;NTBK 14-dq2025la Ci3-1115G4/4GB/256GB+16GB/14P;COMPUTACION
16831241;;F;34;CHILENO;;Millenial;PROVIDENCIA                   ;METROPOLITANA;360980;2;1;2;1;360980;0;0;0;NTBK IP3 Ryzen 3-5300U/8GB/256GB SSD/14P FHD;COMPUTACION
20152902;;M;22;CHILENO;;Z;PROVIDENCIA                   ;METROPOLITANA;259990;1;1;1;1;259990;0;0;0;NTBK 15-ef1015la Ryzen 3-4300U/4GB/256GBSSD/15P;COMPUTACION
19118784;;F;26;CHILENO;;Z;RENCA                         ;METROPOLITANA;377550;3;1;0;0;0;3;1;377550;NTBK Vivobook Ci3/4GB/128GB SSD/15P W+T Ingl;COMPUTACION
23039959;;F;37;CHILENO;;Extranjero;PROVIDENCIA                   ;METROPOLITANA;141760;3;2;0;0;0;3;2;141760;Multifuncional XP-2101 wifi;COMPUTACION
9298338;;M;60;CHILENO;;Boomers;NANCAGUA                      ;L.G.B.OÂ´HIGGINS;149990;1;1;0;0;0;1;1;149990;Multifuncional DCPT220;COMPUTACION
15718275;Soltero;M;38;CHILENO;ADMINISTRADOR PUBLICO;X;PROVIDENCIA                   ;METROPOLITANA;139990;1;1;1;1;139990;0;0;0;Tab M10 Plus FHD 4GB 64GB 10.3P platinum grey;COMPUTACION
13346547;Soltero;M;44;CHILENO;;X;PROVIDENCIA                   ;METROPOLITANA;139990;1;1;1;1;139990;0;0;0;Multifuncional EcoTank L3210;COMPUTACION
10644079;;M;53;CHILENO;;X;PUERTO MONTT                  ;LOS LAGOS;247000;3;2;0;0;0;3;2;247000;Galaxy Tab A8 (10.5, 32GB, WIFI) Gray;COMPUTACION
4748077;;M;81;CHILENO;;Silencioso;OSORNO                        ;LOS LAGOS;547980;3;1;0;0;0;3;1;547980;NTBK Yoga Slim7 Ryzen 5-4500U/8GB/256GB/14P FHD;COMPUTACION
13379578;;M;44;CHILENO;;X;RENCA                         ;METROPOLITANA;1403950;5;1;5;1;1403950;0;0;0;NTBK IP3 Ryzen 3-5300U/8GB/256GB SSD/14P FHD;COMPUTACION
17616640;;F;30;CHILENO;;Millenial;PROVIDENCIA                   ;METROPOLITANA;306980;2;1;2;1;306980;0;0;0;NTBK 14-dq2025la Ci3-1115G4/4GB/256GB+16GB/14P;COMPUTACION
16725194;;M;34;CHILENO;;Millenial;PUDAHUEL;METROPOLITANA;253980;2;1;2;1;253980;0;0;0;NTBK Vivobook Ci3/4GB/128GB SSD/15P W+T Ingl;COMPUTACION
14439211;;F;45;CHILENO;;X;PROVIDENCIA                   ;METROPOLITANA;363970;3;2;3;2;363970;0;0;0;Multifuncional DeskJet Ink Advantage 2775 Wifi;COMPUTACION
20955683;;F;24;CHILENO;;Z;OSORNO;LOS LAGOS;267510;5;5;5;5;267510;0;0;0;Multifuncional Pixma TR4522 Wifi;COMPUTACION
18829316;;M;28;CHILENO;;Millenial;N/D;N/D;132990;3;2;0;0;0;3;2;132990;TAB M8 QC 2GB 32GB 8P Gris;COMPUTACION
5824095;;F;69;CHILENO;;Silencioso;RENCA                         ;METROPOLITANA;136980;2;1;0;0;0;2;1;136980;Tablet Matepad 10.4;COMPUTACION
7174953;;M;68;CHILENO;;Silencioso;PUERTO MONTT                  ;LOS LAGOS;499070;4;2;0;0;0;4;2;499070;NTBK BR11 Celeron N4500/4GB/64GB eMMC/11P;COMPUTACION
20364793;;M;25;CHILENO;;Z;TIRUA                         ;BIO BIO;319981;3;2;1;1;179990;2;1;139991;NTBK IP3i Celeron N4020/4G/500GB/14P/Rojo;COMPUTACION
12050419;;F;46;CHILENO;;X;PALMILLA                      ;L.G.B.OÂ´HIGGINS;420940;6;3;2;1;31980;4;2;388960;TAB 7 MB4 Plus 4Core 1GB 16GB 7 Plata;COMPUTACION
16396845;;F;35;CHILENO;;Millenial;LOS ANGELES                   ;BIO BIO;269990;1;1;0;0;0;1;1;269990;NTBK 15-ef1015la Ryzen 3-4300U/4GB/256GBSSD/15P;COMPUTACION
26268607;;M;25;EXTRANJERO - NO INFORMA NACIONALIDAD;;Extranjero;N/D;N/D;266550;4;2;0;0;0;4;2;266550;TABLET 7 WIFI 1+16;COMPUTACION
19017512;;M;27;CHILENO;;Z;RANCAGUA                      ;L.G.B.OÂ´HIGGINS;649980;2;2;0;0;0;2;2;649980;NTBK D15 Core i3-10110U/8GB/256GB SSD/15P FHD;COMPUTACION
15679299;Soltero;M;38;CHILENO;INGENIERO INFORMATICO;Millenial;LOS ANDES                     ;VALPARAISO;159990;1;1;0;0;0;1;1;159990;Galaxy Tab A8 (10.5, 32GB, WIFI) Gray;COMPUTACION
17578081;;F;31;CHILENO;;Millenial;PROVIDENCIA                   ;METROPOLITANA;53980;2;1;2;1;53980;0;0;0;TAB GAMER 7 QUAD CORE 2G+16G 8715;COMPUTACION
16284972;Casado;M;35;CHILENO;;Silencioso;PROVIDENCIA                   ;METROPOLITANA;893970;3;2;2;1;143980;1;1;749990;NTBK FX506 Ci5-10300H/8GB/512GB SSD/GTX1650 4GB;COMPUTACION
10680757;;M;56;CHILENO;;Boomers;VINA DEL MAR                  ;VALPARAISO;329970;3;2;3;2;329970;0;0;0;Multifuncional DeskJet Ink Advantage 2775 Wifi;COMPUTACION
16275512;Soltero;M;35;CHILENO;ENFERMERO;Millenial;PROVIDENCIA                   ;METROPOLITANA;49990;1;1;1;1;49990;0;0;0;Multifuncional Pixma TR4522 Wifi;COMPUTACION
19589487;;F;25;CHILENO;;Z;N/D;N/D;368990;4;3;1;1;129990;3;2;239000;Tab M10 FHD Plus LTE 10.3IN 2GB 32GB;COMPUTACION
20119535;;M;23;CHILENO;;Millenial;N/D;N/D;713950;6;4;6;4;713950;0;0;0;Monitor Mi 23.8P Full HD;COMPUTACION
17790567;Casado;F;31;CHILENO;INGENIERO CIVIL EN BIOQUIMICA;Millenial;PROVIDENCIA                   ;METROPOLITANA;304980;2;1;2;1;304980;0;0;0;TAB P11 6G-128GB Case + KB + Pen + Wifi +Â  Slate;COMPUTACION
17044863;;M;33;CHILENO;;Millenial;PROVIDENCIA                   ;METROPOLITANA;863970;5;2;5;2;863970;0;0;0;NTBK FX506 Ci5-10300H/8GB/512GB SSD/GTX1650 4GB;COMPUTACION
18819569;Soltero;F;26;CHILENO;;Z;COIHAIQUE                     ;AYSEN;345360;6;2;0;0;0;6;2;345360;NTBK BR11 Celeron N4500/4GB/64GB eMMC/11P;COMPUTACION
20336995;;F;21;CHILENO;;Z;N/D;N/D;180250;3;2;0;0;0;3;2;180250;NTBK D330 Celeron N4020/4GB/64GB/10P+OfficeHS;COMPUTACION
17214764;Soltero;M;32;CHILENO;INGENIERO EN PREVENCION DE RIESGOS;Millenial;PROVIDENCIA                   ;METROPOLITANA;305980;2;1;2;1;305980;0;0;0;NTBK 15-ef1015la Ryzen 3-4300U/4GB/256GBSSD/15P;COMPUTACION
17656513;;M;31;CHILENO;;Millenial;PROVIDENCIA                   ;METROPOLITANA;259990;1;1;1;1;259990;0;0;0;NTBK 15-ef1015la Ryzen 3-4300U/4GB/256GBSSD/15P;COMPUTACION
15278611;;F;39;CHILENO;;X;N/D;N/D;300960;4;2;4;2;300960;0;0;0;NTBK DATACHABLE IDEAPAD D330 N4020 4G 128G W10PR;COMPUTACION
19516215;;F;25;CHILENO;;Z;N/D;N/D;351960;4;3;2;1;153980;2;2;197980;Multifuncional DCPT520W Wifi;COMPUTACION
18650008;;F;27;CHILENO;;Extranjero;RANCAGUA                      ;L.G.B.OÂ´HIGGINS;539990;1;1;0;0;0;1;1;539990;NTBK 15-eh0006la Ryzen 5-4500U/8GB/512GB/15P;COMPUTACION
13556854;;M;45;CHILENO;;X;SAN BERNARDO                  ;METROPOLITANA;193980;2;1;2;1;193980;0;0;0;NTBK S13A Celeron/6GB/128SSD/13P FHD/Tec-Ingles;COMPUTACION
11384373;;M;52;CHILENO;;X;ILLAPEL                       ;COQUIMBO;119990;1;1;0;0;0;1;1;119990;TAB Galaxy A7 Lite (8.7, 32GB, WIFI);COMPUTACION
8787615;Casado;M;59;CHILENO;;Boomers;RENCA                         ;METROPOLITANA;576970;3;2;3;2;576970;0;0;0;Galaxy Tab A8 (10.5, 32GB, WIFI) Silver;COMPUTACION
15738290;;F;38;CHILENO;;X;RENCA                         ;METROPOLITANA;59990;1;1;1;1;59990;0;0;0;Multifuncional Pixma TR4522 Wifi;COMPUTACION
25664396;;M;49;BOLIVIANO;;Extranjero;ANTOFAGASTA                   ;ANTOFAGASTA;139990;1;1;0;0;0;1;1;139990;TAB Galaxy A7 Lite (8.7, 32GB, WIFI + 4G);COMPUTACION
14167807;;M;41;CHILENO;;X;PROVIDENCIA                   ;METROPOLITANA;488960;5;3;3;2;363970;2;1;124990;Multifuncional DCPT520W Wifi;COMPUTACION
18816006;;M;27;CHILENO;;Millenial;PROVIDENCIA                   ;METROPOLITANA;685980;2;1;2;1;685980;0;0;0;NTBK FX506 Ci5-10300H/8GB/512GB SSD/GTX1650 4GB;COMPUTACION
9446704;;M;60;CHILENO;;Boomers;PUENTE ALTO                   ;METROPOLITANA;178980;2;1;0;0;0;2;1;178980;Multifuncional EcoTank L3250 Wifi;COMPUTACION
22887800;;M;22;CHILENO;;Extranjero;PROVIDENCIA                   ;METROPOLITANA;446980;2;1;2;1;446980;0;0;0;TAB Galaxy S7 FE (12.4, 64GB WIFI) BLACK;COMPUTACION
5720947;;M;72;CHILENO;;Silencioso;COQUIMBO                      ;COQUIMBO;459990;2;1;0;0;0;2;1;459990;AIO IC A340 Core i3/4GB/1TB/24P Full HD;COMPUTACION
13582630;;M;44;CHILENO;;X;SAAVEDRA                      ;ARAUCANIA;590980;2;1;0;0;0;2;1;590980;NTBK 2en1 Flex5 R5-4500U/8GB/256SSD/14P FHD+Pen;COMPUTACION
19405144;;F;25;CHILENO;;Extranjero;PROVIDENCIA                   ;METROPOLITANA;103980;2;1;2;1;103980;0;0;0;NTBK DATACHABLE IDEAPAD D330 N4020 4G 128G W10PR;COMPUTACION
17077228;;F;32;CHILENO;;Millenial;PROVIDENCIA                   ;METROPOLITANA;588980;2;1;2;1;588980;0;0;0;NTBK 2en1 Flex5 R5-4500U/8GB/256SSD/14P FHD+Pen;COMPUTACION
11391398;;F;53;CHILENO;;X;PUENTE ALTO                   ;METROPOLITANA;514420;7;2;0;0;0;7;2;514420;NTBK Aspire 3 Athlon 3020e/8GB/256GB SSD/14P;COMPUTACION
15300134;;F;39;CHILENO;;X;PUERTO MONTT                  ;LOS LAGOS;124990;1;2;1;1;39990;0;1;85000;Multifuncional EcoTank L3210;COMPUTACION
11795865;;F;50;CHILENO;;X;PROVIDENCIA                   ;METROPOLITANA;166980;2;1;2;1;166980;0;0;0;Multifuncional EcoTank L3210;COMPUTACION
20450269;;M;21;CHILENO;;Z;PROVIDENCIA                   ;METROPOLITANA;160970;3;2;2;1;156980;1;1;3990;Multifuncional DCPT520W Wifi;COMPUTACION
15605406;;F;38;CHILENO;;X;PROVIDENCIA                   ;METROPOLITANA;102960;4;2;4;2;102960;0;0;0;Multifuncional DeskJet Ink Advantage 2775 Wifi;COMPUTACION
14234994;;F;52;CHILENO;;X;TEODORO SCHMIDT               ;ARAUCANIA;162150;2;1;0;0;0;2;1;162150;NTBK BR11 Celeron N4500/4GB/64GB eMMC/11P;COMPUTACION
16441646;;M;35;CHILENO;;Millenial;N/D;N/D;149990;1;1;0;0;0;1;1;149990;Multifuncional DCPT520W Wifi;COMPUTACION
8226868;;F;64;CHILENO;;Boomers;YERBAS BUENAS                 ;MAULE;625340;8;4;0;0;0;8;4;625340;Galaxy Tab A8 (10.5, 32GB, WIFI) Pink Gold;COMPUTACION
17760299;;F;30;CHILENO;;Millenial;"";"";265470;3;2;2;1;115480;1;1;149990;NTBK XH02 Celeron 4GB/64GB eMMC/11P/T+W ingles;COMPUTACION
14607428;;F;45;CHILENO;;X;TUCAPEL                       ;BIO BIO;2266200;16;10;0;0;0;16;10;2266200;NTBK FX506 Ci5-10300H/8GB/512GB SSD/GTX1650 4GB;COMPUTACION
13181019;;F;45;CHILENO;;X;ILLAPEL                       ;COQUIMBO;409476;10;5;0;0;0;10;5;409476;Multifuncional XP-2101 wifi;COMPUTACION
10913408;;F;50;CHILENO;;X;PICHILEMU                     ;L.G.B.OÂ´HIGGINS;177970;3;1;0;0;0;3;1;177970;Multifuncional EcoTank L3210;COMPUTACION
10112933;Casado;M;53;CHILENO;;X;ARICA                         ;TARAPACA;528470;3;2;0;0;0;3;2;528470;Galaxy Tab A8 (10.5, 64GB, WIFI) Pink Gold;COMPUTACION
18788617;;M;28;CHILENO;;Millenial;SAN CARLOS                    ;BIO BIO;556400;8;3;0;0;0;8;3;556400;NTBK DATACHABLE IDEAPAD D330 N4020 4G 128G W10PR;COMPUTACION
19967857;;F;23;CHILENO;;Z;PROVIDENCIA                   ;METROPOLITANA;279990;1;1;0;0;0;1;1;279990;NTBK 15-ef1015la Ryzen 3-4300U/4GB/256GBSSD/15P;COMPUTACION
16887542;;F;34;CHILENO;;Millenial;VINA DEL MAR                  ;VALPARAISO;99980;2;1;2;1;99980;0;0;0;NTBK DATACHABLE IDEAPAD D330 N4020 4G 128G W10PR;COMPUTACION
18495640;;F;28;CHILENO;;Millenial;PROVIDENCIA                   ;METROPOLITANA;0;0;2;0;2;0;0;0;0;TAB MLAB MBX 8 QUAD CORE 1G+16G 8716;COMPUTACION
18158359;;M;33;CHILENO;;Silencioso;PROVIDENCIA                   ;METROPOLITANA;484980;2;2;2;2;484980;0;0;0;Multifuncional EcoTank L3250 Wifi;COMPUTACION
17066110;;F;33;CHILENO;;Millenial;"";"";299980;2;1;0;0;0;2;1;299980;Multifuncional EcoTank L3250 Wifi;COMPUTACION
14002609;;M;40;CHILENO;;X;RENCA                         ;METROPOLITANA;103980;2;1;2;1;103980;0;0;0;NTBK DATACHABLE IDEAPAD D330 N4020 4G 128G W10PR;COMPUTACION
20088257;;F;23;CHILENO;;Z;N/D;N/D;814740;9;4;0;0;0;9;4;814740;Multifuncional EcoTank L3210;COMPUTACION
16183424;;F;37;CHILENO;;Millenial;VALLENAR;ATACAMA;115040;2;1;0;0;0;2;1;115040;TAB M7 3ra Gen MT8766 2+32GB 7 Wifi Iron grey;COMPUTACION
12671817;;F;47;CHILENO;;X;PUENTE ALTO                   ;METROPOLITANA;399990;1;1;0;0;0;1;1;399990;NTBK 14-dq2025la Ci3-1115G4/4GB/256GB+16GB/14P;COMPUTACION
13774095;Casado;M;42;CHILENO;;X;RENCA                         ;METROPOLITANA;263980;2;1;2;1;263980;0;0;0;NTBK 15-ef1015la Ryzen 3-4300U/4GB/256GBSSD/15P;COMPUTACION
7159097;;M;69;CHILENO;;Silencioso;CORONEL                       ;BIO BIO;266000;3;1;0;0;0;3;1;266000;NTBK 240 G7 Core i3-1005G1 4GB 1TB 14P;COMPUTACION
11938363;;F;49;CHILENO;;X;OVALLE                        ;COQUIMBO;246980;2;2;0;0;0;2;2;246980;Galaxy Tab A8 (10.5, 64GB, WIFI) Silver;COMPUTACION
19930842;;M;24;CHILENO;;Z;PROVIDENCIA                   ;METROPOLITANA;579990;2;1;2;1;579990;0;0;0;NTBK 2en1 Flex5 R5-4500U/8GB/256SSD/14P FHD+Pen;COMPUTACION
16078229;;F;36;CHILENO;;Millenial;SAN FELIPE                    ;VALPARAISO;696950;5;4;2;1;136980;3;3;559970;Monitor HP V22 FHD;COMPUTACION
13698397;;F;43;CHILENO;;X;PROVIDENCIA                   ;METROPOLITANA;99990;1;1;0;0;0;1;1;99990;TAB Galaxy A7 Lite (8.7, 32GB, WIFI);COMPUTACION
4902156;;F;79;CHILENO;;Silencioso;ANGOL                         ;ARAUCANIA;199980;2;2;0;0;0;2;2;199980;Multifuncional EcoTank L3210;COMPUTACION
20465003;;F;22;CHILENO;;Z;TALCA                         ;MAULE;488950;7;3;0;0;0;7;3;488950;NTBK IP3i Celeron N4020/4G/500GB/14P/Rojo;COMPUTACION
18828440;;M;27;CHILENO;;Silencioso;PROVIDENCIA                   ;METROPOLITANA;453820;4;2;4;2;453820;0;0;0;TAB Yoga 13IN Qualcomm 870 G;COMPUTACION
19377838;Soltero;F;25;CHILENO;;Silencioso;PROVIDENCIA                   ;METROPOLITANA;410120;4;1;0;0;0;4;1;410120;NTBK 15-ef1015la Ryzen 3-4300U/4GB/256GBSSD/15P;COMPUTACION
7756426;;F;64;CHILENO;;Boomers;NOGALES                       ;VALPARAISO;99990;1;1;0;0;0;1;1;99990;Multifuncional Pixma TR4522 Wifi;COMPUTACION
4003484;;M;83;CHILENO;;Silencioso;ANGOL                         ;ARAUCANIA;279970;3;2;2;1;214980;1;1;64990;Multifuncional DeskJet Ink Advantage 2775 Wifi;COMPUTACION
13966701;;F;46;CHILENO;;X;"";"";2392010;12;3;0;0;0;12;3;2392010;NTBK M3500 Ryzen 5 -5600H/8GB/512GB SSD/15P FHD;COMPUTACION
11693761;;F;51;CHILENO;;X;RENCA                         ;METROPOLITANA;289990;1;1;0;0;0;1;1;289990;NTBK 15-ef1015la Ryzen 3-4300U/4GB/256GBSSD/15P;COMPUTACION
19062720;;F;27;CHILENO;;Millenial;LA FLORIDA;METROPOLITANA;1127960;4;2;4;2;1127960;0;0;0;NTBK 15-dw1080la Celeron N4020/4GB/1TB/15P;COMPUTACION
24027076;;F;38;BOLIVIANO;;Extranjero;ANTOFAGASTA                   ;ANTOFAGASTA;102483;2;2;0;0;0;2;2;102483;TAB Galaxy A7 Lite (8.7, 32GB, WIFI);COMPUTACION
16793131;;M;34;CHILENO;;Millenial;N/D;N/D;174990;1;1;0;0;0;1;1;174990;Multifuncional EcoTank L3250 Wifi;COMPUTACION
17594776;;M;31;CHILENO;;Millenial;N/D;N/D;832930;7;4;0;0;0;7;4;832930;NTBK D330 Celeron N4020/4GB/64GB/10P+OfficeHS;COMPUTACION
18153142;;F;29;CHILENO;;Millenial;PROVIDENCIA                   ;METROPOLITANA;289990;2;1;2;1;289990;0;0;0;NTBK 15-ef1015la Ryzen 3-4300U/4GB/256GBSSD/15P;COMPUTACION
17757778;;F;31;CHILENO;;Millenial;LINARES                       ;MAULE;1028700;5;3;0;0;0;5;3;1028700;Multifuncional Ink Tank 415 Wifi;COMPUTACION
17759500;;M;31;CHILENO;;Millenial;LA SERENA                     ;COQUIMBO;129990;1;1;0;0;0;1;1;129990;Multifuncional Ink Tank 315;COMPUTACION
13722957;;M;42;CHILENO;;X;TALCA                         ;MAULE;499990;1;1;0;0;0;1;1;499990;NTBK 15-eh0006la Ryzen 5-4500U/8GB/512GB/15P;COMPUTACION
15444354;;M;39;CHILENO;;X;"";"";184990;1;1;0;0;0;1;1;184990;NTBK IP1 AMD 3020e/4GB/64GB eMMC/14P;COMPUTACION
18704624;;F;28;CHILENO;;Millenial;LA CRUZ                       ;VALPARAISO;150000;2;1;0;0;0;2;1;150000;Multifuncional EcoTank L3210;COMPUTACION
19651219;;M;24;CHILENO;;Z;PROVIDENCIA                   ;METROPOLITANA;399990;1;1;1;1;399990;0;0;0;NTBK IP3 Ryzen 3-5300U/8GB/256GB SSD/14P FHD;COMPUTACION
25362899;;M;41;COLOMBIANO;;Extranjero;IQUIQUE                       ;TARAPACA;239990;1;3;1;1;239990;0;2;0;TAB 7 MB4 Plus 4Core 1GB 16GB 7 Negra;COMPUTACION
14434933;;F;59;CHILENO;;Boomers;ANGOL                         ;ARAUCANIA;279990;1;1;0;0;0;1;1;279990;NTBK 15-ef1015la Ryzen 3-4300U/4GB/256GBSSD/15P;COMPUTACION
15299320;Soltero;M;40;CHILENO;;X;PROVIDENCIA                   ;METROPOLITANA;349990;1;1;1;1;349990;0;0;0;NTBK IP3 Core i3-1115G4/4GB/512GB SSD/14P FHD;COMPUTACION
15157826;;M;40;CHILENO;;X;PARRAL                        ;MAULE;459980;2;2;0;0;0;2;2;459980;Multifuncional EcoTank L3210;COMPUTACION
19904730;;M;24;CHILENO;;Silencioso;EL QUISCO                     ;VALPARAISO;354960;4;3;2;1;184980;2;2;169980;Tab M10 FHD Plus LTE 10.3IN 2GB 32GB;COMPUTACION
13287815;Casado;F;45;CHILENO;;X;PROVIDENCIA                   ;METROPOLITANA;163980;2;1;2;1;163980;0;0;0;Multifuncional DCPT520W Wifi;COMPUTACION
17800913;;F;30;CHILENO;;Millenial;"";"";242980;2;1;0;0;0;2;1;242980;NTBK D330 Celeron N4020/4GB/64GB/10P+OfficeHS;COMPUTACION
18555968;;F;29;CHILENO;;Millenial;ARICA                         ;ARICA Y PARINACOTA;214980;2;2;1;1;149990;1;1;64990;Multifuncional EcoTank L3210;COMPUTACION
8618985;;F;59;CHILENO;;Boomers;QUILLOTA                      ;VALPARAISO;479990;2;1;0;0;0;2;1;479990;NTBK IP3 Ryzen 3-3250U/8GB/1TB/15P;COMPUTACION
6728132;;F;70;CHILENO;;Silencioso;LOS VILOS                     ;COQUIMBO;807960;4;4;0;0;0;4;4;807960;NTBK Aspire 5 R5-3500U/12GB/256SSD GB/15P FHD;COMPUTACION
14008921;Divorciado;F;41;CHILENO;;X;BUIN                          ;METROPOLITANA;219980;2;2;0;0;0;2;2;219980;TAB Galaxy A7 Lite (8.7, 32GB, WIFI);COMPUTACION
17588579;;M;30;CHILENO;;Millenial;PROVIDENCIA                   ;METROPOLITANA;291980;2;2;0;0;0;2;2;291980;NTBK 240 G8 Celeron N4020/4GB/500GB/14P;COMPUTACION
25281398;;M;34;PERUANO;;Extranjero;HIJUELAS                      ;VALPARAISO;374961;5;3;0;0;0;5;3;374961;TAB Galaxy A7 Lite (8.7, 32GB, WIFI);COMPUTACION
18291487;;F;29;CHILENO;;Millenial;ARAUCO                        ;BIO BIO;119990;1;1;0;0;0;1;1;119990;TAB Galaxy A7 Lite (8.7, 32GB, WIFI + 4G);COMPUTACION
26697658;;F;52;NO INFORMA NACIONALIDAD;;Extranjero;COLINA                        ;METROPOLITANA;233230;5;2;0;0;0;5;2;233230;NTBK 15-dw1080la Celeron N4020/4GB/1TB/15P;COMPUTACION
10991391;;M;46;CHILENO;;X;RENCA                         ;METROPOLITANA;433980;2;1;2;1;433980;0;0;0;TAB Galaxy S7 FE (12.4, 128GB WIFI) SILVER;COMPUTACION
7851488;;M;63;CHILENO;;Boomers;ILLAPEL                       ;COQUIMBO;789530;5;6;0;0;0;5;6;789530;NTBK 14-dy0501laCi3-1125G4/8GB/256SSD/FHD/Pen;COMPUTACION
18877772;;F;27;CHILENO;;Millenial;"";"";159990;1;1;0;0;0;1;1;159990;Multifuncional EcoTank L3210;COMPUTACION
10967500;;F;52;CHILENO;;X;LOS ALAMOS                    ;BIO BIO;159990;1;1;0;0;0;1;1;159990;Multifuncional EcoTank L3210;COMPUTACION
16204438;;M;36;CHILENO;;Millenial;LOS ANGELES                   ;BIO BIO;731320;4;2;4;2;731320;0;0;0;TAB Galaxy A7 Lite (8.7, 32GB, WIFI);COMPUTACION
26203590;;M;26;HAITIANO;;Extranjero;SAN FERNANDO                  ;L.G.B.OÂ´HIGGINS;370960;4;3;0;0;0;4;3;370960;NTBK 15-dw1080la Celeron N4020/4GB/1TB/15P;COMPUTACION
19630754;;F;25;CHILENO;;Extranjero;SAN BERNARDO                  ;METROPOLITANA;303980;2;1;2;1;303980;0;0;0;NTBK X415 Core i3-10110U/4GB/256GB SSD/14P FHD;COMPUTACION
27146497;;F;48;EXTRANJERO - NO INFORMA NACIONALIDAD ;;Extranjero;N/D;N/D;180980;2;1;0;0;0;2;1;180980;Multifuncional DCPT220;COMPUTACION
26396332;;F;27;EXTRANJERO - NO INFORMA NACIONALIDAD;;Extranjero;SANTIAGO;METROPOLITANA;522950;7;4;0;0;0;7;4;522950;Multifuncional EcoTank L3250 Wifi;COMPUTACION
7956717;;F;66;CHILENO;;Boomers;LOS ANGELES                   ;BIO BIO;149990;1;1;0;0;0;1;1;149990;Multifuncional EcoTank L3210;COMPUTACION
11539797;;F;52;CHILENO;;X;VICTORIA                      ;ARAUCANIA;373540;7;4;0;0;0;7;4;373540;Multifuncional EcoTank L3210;COMPUTACION
11236461;;F;53;CHILENO;;X;N/D;N/D;149980;2;2;0;0;0;2;2;149980;TAB Galaxy A7 Lite (8.7, 32GB, WIFI + 4G);COMPUTACION
12123495;;F;46;CHILENO;;X;"";"";323970;3;2;3;2;323970;0;0;0;NTBK 15-dw1080la Celeron N4020/4GB/1TB/15P;COMPUTACION
14262152;;F;48;CHILENO;;X;SANTA CRUZ                    ;L.G.B.OÂ´HIGGINS;464980;2;2;0;0;0;2;2;464980;TAB M7 7 1GB RAM 8 GB ROM Platinum Grey;COMPUTACION
25473630;;M;36;PERUANO;;Extranjero;NUNOA                         ;METROPOLITANA;183980;2;1;2;1;183980;0;0;0;NTBK 15-dw1080la Celeron N4020/4GB/1TB/15P;COMPUTACION
9168868;;M;62;CHILENO;;Boomers;COLINA                        ;METROPOLITANA;514350;4;2;0;0;0;4;2;514350;NTBK 15-dw1080la Celeron N4020/4GB/1TB/15P;COMPUTACION
24696378;;M;27;PERUANO;;Extranjero;N/D;N/D;413980;2;1;2;1;413980;0;0;0;NTBK D15 Core i3-10110U/8GB/256GB SSD/15P FHD;COMPUTACION
13385206;;F;44;CHILENO;;X;PROVIDENCIA                   ;METROPOLITANA;50980;2;1;2;1;50980;0;0;0;TAB MLAB MBX 8 QUAD CORE 1G+16G 8716;COMPUTACION
15977180;;F;37;CHILENO;;Millenial;PROVIDENCIA                   ;METROPOLITANA;159990;1;1;0;0;0;1;1;159990;Multifuncional EcoTank L3210;COMPUTACION
8424462;;M;64;CHILENO;;Boomers;COLTAUCO                      ;L.G.B.OÂ´HIGGINS;522460;3;2;0;0;0;3;2;522460;NTBK IP3 Athlon 3050U/8GB/1TB/14P;COMPUTACION
11529846;;F;51;CHILENO;;X;PICHIDEGUA                    ;L.G.B.OÂ´HIGGINS;655980;2;1;0;0;0;2;1;655980;NTBK D14 Ci5-10210U/8GB/512SSD/14 FHD/ office365;COMPUTACION
19286427;;F;25;CHILENO;;Z;LONCOCHE                      ;ARAUCANIA;69980;2;2;0;0;0;2;2;69980;TAB MLAB MBX 8 QUAD CORE 1G+16G 8716;COMPUTACION
21893735;Soltero;F;42;PERUANO;;Extranjero;PROVIDENCIA                   ;METROPOLITANA;423980;2;1;2;1;423980;0;0;0;TAB Galaxy S7 FE (12.4, 128GB WIFI) LIGHT PINK;COMPUTACION
26100155;;F;37;NO INFORMA NACIONALIDAD;;Extranjero;LA FLORIDA;METROPOLITANA;183980;2;1;2;1;183980;0;0;0;Multifuncional EcoTank L3250 Wifi;COMPUTACION
8943717;Soltero;F;62;CHILENO;CONTADOR GENERAL;Boomers;RENCA                         ;METROPOLITANA;55480;2;1;2;1;55480;0;0;0;Impresora Laser HL-1202 Monocromatica;COMPUTACION
9216285;;F;60;CHILENO;;Boomers;RENCA                         ;METROPOLITANA;109990;1;1;0;0;0;1;1;109990;TAB Galaxy A7 Lite (8.7, 32GB, WIFI + 4G);COMPUTACION
11672057;;F;51;CHILENO;;X;RANCAGUA                      ;L.G.B.OÂ´HIGGINS;542950;5;5;1;1;299990;4;4;242960;TAB GAMER 7 QUAD CORE 2G+16G 8715;COMPUTACION
13623370;;F;43;CHILENO;;X;ANGOL                         ;ARAUCANIA;514960;4;2;4;2;514960;0;0;0;AIO 200 G4 Pentium J5040/4GB/1TB/21.5P Full HD;COMPUTACION
19550059;;F;24;CHILENO;;Millenial;CABILDO;VALPARAISO;34990;1;1;0;0;0;1;1;34990;TAB 7 MB4 Plus 4Core 1GB 16GB 7 Plata;COMPUTACION
10381694;;M;57;CHILENO;;Boomers;RENCA                         ;METROPOLITANA;159990;1;1;0;0;0;1;1;159990;Multifuncional EcoTank L3210;COMPUTACION
10083622;;F;55;CHILENO;;Boomers;RENCA                         ;METROPOLITANA;251980;2;1;0;0;0;2;1;251980;NTBK 240 G8 Celeron N4020/4GB/500GB/14P;COMPUTACION
18429501;Soltero;F;29;CHILENO;PROFESOR;Millenial;PROVIDENCIA                   ;METROPOLITANA;159990;1;1;0;0;0;1;1;159990;Multifuncional EcoTank L3210;COMPUTACION
13420959;;M;43;CHILENO;;X;PROVIDENCIA                   ;METROPOLITANA;449980;2;1;0;0;0;2;1;449980;NTBK 255 G8 Ryzen 5-5500U/8GB/256GB SSD/15P;COMPUTACION
19695799;;M;25;CHILENO;;Z;CHANCO                        ;MAULE;180150;4;2;0;0;0;4;2;180150;TAB M8 QC 2GB 32GB 8P Gris;COMPUTACION
9973663;;M;57;CHILENO;;Boomers;PUENTE ALTO                   ;METROPOLITANA;713980;2;1;0;0;0;2;1;713980;NTBK Aspire 5 Ci3-10110U/12GB/512GB SSD/15P FHD;COMPUTACION
17502653;Soltero;F;32;CHILENO;;Millenial;PROVIDENCIA                   ;METROPOLITANA;879990;1;1;1;1;879990;0;0;0;NTBK GAMER N5 Ci5-10300H/16GB/512SSD/GTX1650 4GB;COMPUTACION
20427077;;M;22;CHILENO;;Z;"";"";340370;2;1;0;0;0;2;1;340370;NTBK 240 G8 Celeron N4020/4GB/500GB/14P;COMPUTACION
13782060;;F;42;CHILENO;;X;PROVIDENCIA                   ;METROPOLITANA;62990;1;1;0;0;0;1;1;62990;IMPRESORA LASER PASHER 3020;COMPUTACION
8752533;;F;63;CHILENO;;Boomers;TALCA                         ;MAULE;369990;1;3;0;0;0;1;3;369990;NTBK IP3 Athlon 3050U/8GB/1TB/14P;COMPUTACION
15281344;;F;39;CHILENO;;X;FRESIA                        ;LOS LAGOS;1085720;6;2;0;0;0;6;2;1085720;NTBK IP3 Athlon 3050U/8GB/1TB/14P;COMPUTACION
6905190;;F;67;CHILENO;;Boomers;VALLENAR;ATACAMA;119990;1;1;0;0;0;1;1;119990;Multifuncional Pixma TR4522 Wifi;COMPUTACION
19084676;Soltero;F;27;CHILENO;;Millenial;VALDIVIA;LOS LAGOS;89990;1;1;0;0;0;1;1;89990;TAB M8 QC 2GB 32GB 8P Gris;COMPUTACION
9943369;;F;54;CHILENO;;X;ARICA                         ;TARAPACA;530980;2;1;0;0;0;2;1;530980;NTBK 14-dy0501laCi3-1125G4/8GB/256SSD/FHD/Pen;COMPUTACION
8684353;;F;63;CHILENO;;Boomers;RENCA                         ;METROPOLITANA;69990;1;1;0;0;0;1;1;69990;Multifuncional DeskJet Ink Advantage 3775 Wifi;COMPUTACION
20384548;;M;22;CHILENO;;Z;PROVIDENCIA                   ;METROPOLITANA;155840;2;1;2;1;155840;0;0;0;Multifuncional EcoTank L3210;COMPUTACION
25599263;Soltero;M;39;HAITIANO;;Extranjero;PROVIDENCIA                   ;METROPOLITANA;59980;2;1;0;0;0;2;1;59980;TAB MLAB MBX 8 QUAD CORE 1G+16G 8716;COMPUTACION
18127814;Soltero;M;29;CHILENO;;Millenial;PROVIDENCIA                   ;METROPOLITANA;223980;2;1;2;1;223980;0;0;0;NTBK IP3i Celeron N4020/4G/500GB/14P/Rojo;COMPUTACION
27101244;;M;37;EXTRANJERO - NO INFORMA NACIONALIDAD;;Extranjero;N/D;N/D;134980;2;1;0;0;0;2;1;134980;TAB M8 QC 2GB 32GB 8P Gris;COMPUTACION
19531220;;F;25;CHILENO;;Z;PROVIDENCIA                   ;METROPOLITANA;539990;1;1;1;1;539990;0;0;0;NTBK 255 G8 Ryzen 5-5500U/8GB/256GB SSD/15P;COMPUTACION
13001858;Casado;F;46;CHILENO;;X;PROVIDENCIA                   ;METROPOLITANA;99990;1;1;0;0;0;1;1;99990;TAB M8 QC 2GB 32GB 8P Gris;COMPUTACION
13759818;;F;42;CHILENO;;X;PROVIDENCIA                   ;METROPOLITANA;248540;2;1;2;1;248540;0;0;0;NTBK 14-cf2097la Pentium Gold 6405U/8GB/256GB/14;COMPUTACION
5589440;;F;78;CHILENO;;Silencioso;SAN JAVIER                    ;MAULE;563350;4;2;0;0;0;4;2;563350;NTBK 14-ck2091la i3-10110U 4GB 128GB 14 HD;COMPUTACION
19408362;Soltero;F;26;CHILENO;;Z;LA FLORIDA;METROPOLITANA;164980;2;1;0;0;0;2;1;164980;TAB Galaxy A7 Lite (8.7, 32GB, WIFI);COMPUTACION
16742129;;M;34;CHILENO;;Millenial;N/D;N/D;271980;3;1;0;0;0;3;1;271980;Tab M10 FHD Plus LTE 10.3IN 2GB 32GB;COMPUTACION
15479227;;M;39;CHILENO;;X;LOS ANGELES                   ;BIO BIO;181670;2;1;0;0;0;2;1;181670;Multifuncional DCPT220;COMPUTACION
19168077;;M;26;CHILENO;;Z;NATALES                       ;MAGALLANES;34990;1;1;0;0;0;1;1;34990;TAB 7 MB4 Plus 4Core 1GB 16GB 7 Plata;COMPUTACION
14309647;;F;46;CHILENO;;X;N/D;N/D;584960;4;2;0;0;0;4;2;584960;NTBK 14-ck2091la i3-10110U 4GB 128GB 14 HD;COMPUTACION
17967946;;F;30;CHILENO;;Millenial;N/D;N/D;374960;5;2;0;0;0;5;2;374960;NTBK IP3i Celeron N4020/4G/500GB/14P/Rojo;COMPUTACION
15175298;;M;40;CHILENO;;X;PROVIDENCIA                   ;METROPOLITANA;562220;4;1;0;0;0;4;1;562220;NTBK M!4 Core i3-10110U/8GB/256GB SSD/14P FHD;COMPUTACION
11169146;;F;54;CHILENO;;Boomers;LO ESPEJO                     ;METROPOLITANA;203980;2;1;2;1;203980;0;0;0;Monitor Emerald 27P 165Hz Full HD;COMPUTACION
8186517;;M;49;CHILENO;;X;PROVIDENCIA                   ;METROPOLITANA;204980;2;1;2;1;204980;0;0;0;BUNDLE TAB P11 6GB 128SSD Slate Grey;COMPUTACION
8053385;;M;66;CHILENO;;Boomers;CHILLAN                       ;BIO BIO;199990;1;1;0;0;0;1;1;199990;NTBK IP3i Celeron N4020/4G/500GB/14P/Rojo;COMPUTACION
17593429;Casado;F;31;CHILENO;;Millenial;PROVIDENCIA                   ;METROPOLITANA;84990;1;1;0;0;0;1;1;84990;TAB M8 QC 2GB 32GB 8P Gris;COMPUTACION
15294530;;M;39;CHILENO;;X;ARICA                         ;ARICA Y PARINACOTA;859990;1;1;0;0;0;1;1;859990;NTBK GAMER N5 Ci5-10300H/16GB/512SSD/GTX1650 4GB;COMPUTACION
24398526;;M;38;MEXICANO;;Extranjero;N/D;N/D;390060;3;2;0;0;0;3;2;390060;NTBK 240G7 CelN4020 14 4GB/500 PC;COMPUTACION
14060532;;M;41;CHILENO;;X;CONCEPCION                    ;BIO BIO;49990;1;1;1;1;49990;0;0;0;TAB MLAB MBX 8 QUAD CORE 1G+16G 8716;COMPUTACION
7161463;;M;69;CHILENO;;Silencioso;N/D;N/D;633980;2;1;0;0;0;2;1;633980;NTBK IP3 Ryzen 3-5300U/8GB/256GB SSD/14P FHD;COMPUTACION
17626874;;M;31;CHILENO;;Millenial;LA SERENA                     ;COQUIMBO;229990;1;1;0;0;0;1;1;229990;NTBK 240 G8 Celeron N4020/4GB/500GB/14P;COMPUTACION
14210624;;M;41;CHILENO;;X;HUALAIHUE;LOS LAGOS;309990;1;1;1;1;309990;0;0;0;TAB S6 Lite (610) 4GB 64GB 10.4P DARK GREY;COMPUTACION
14144798;;F;41;CHILENO;;X;"";"";164970;3;2;0;0;0;3;2;164970;TAB M8 QC 2GB 32GB 8P Gris;COMPUTACION
19836587;;F;23;CHILENO;;Z;PROVIDENCIA                   ;METROPOLITANA;34990;1;1;1;1;34990;0;0;0;TAB 7 MB4 Plus 4Core 1GB 16GB 7 Negra;COMPUTACION
17706050;;F;31;CHILENO;;Millenial;PROVIDENCIA                   ;METROPOLITANA;38980;2;1;2;1;38980;0;0;0;TAB 7 MB4 Plus 4Core 1GB 16GB 7 Plata;COMPUTACION
15673754;;M;38;CHILENO;;X;"";"";232980;2;1;0;0;0;2;1;232980;NTBK HT14 Celeron N4020 4GB/128GB SSD/14P;COMPUTACION
7824315;Casado;F;66;CHILENO;;Boomers;RENCA                         ;METROPOLITANA;377980;2;1;0;0;0;2;1;377980;TAB S6 Lite (610) 4GB 64GB 10.4P DARK GREY;COMPUTACION
18021964;Soltero;F;30;CHILENO;;Millenial;PROVIDENCIA                   ;METROPOLITANA;703980;2;1;2;1;703980;0;0;0;NTBK Zenbook Ryzen 5-5500U/8GB/512GB SSD/13P FHD;COMPUTACION
10121096;;F;56;CHILENO;;Boomers;RENCA                         ;METROPOLITANA;299980;2;1;2;1;299980;0;0;0;TAB S6 Lite (610) 4GB 64GB 10.4P PINK;COMPUTACION
16084627;;F;36;CHILENO;;Millenial;N/D;N/D;154970;3;2;0;0;0;3;2;154970;Tab M10 HD 2G-32GB 10.1 Iron grey WiFi;COMPUTACION
6458319;;M;69;CHILENO;;Silencioso;ANTOFAGASTA                   ;ANTOFAGASTA;1235980;2;1;0;0;0;2;1;1235980;MBA 13.3 SPG/8C CPU/8C GPU/8GB/512GB-BES;COMPUTACION
16860786;;F;48;CHILENO;;X;SAN FERNANDO                  ;L.G.B.OÂ´HIGGINS;421970;3;1;0;0;0;3;1;421970;Tab Yoga Smart;COMPUTACION
19713586;;F;24;CHILENO;;Z;PROVIDENCIA                   ;METROPOLITANA;262960;4;2;4;2;262960;0;0;0;NTBK 14-cf2097la Pentium Gold 6405U/8GB/256GB/14;COMPUTACION
16132911;;M;37;CHILENO;;Millenial;N/D;N/D;551620;4;2;2;1;279640;2;1;271980;NTBK IP3i Celeron N4020/4G/500GB/14P/Rojo;COMPUTACION
18330940;;M;30;CHILENO;;Millenial;QUILICURA                     ;METROPOLITANA;45990;1;1;0;0;0;1;1;45990;TAB MLAB MBX 8 QUAD CORE 1G+16G 8716;COMPUTACION
19560466;;M;25;CHILENO;;Z;PROVIDENCIA                   ;METROPOLITANA;233980;2;1;2;1;233980;0;0;0;NTBK 14-cf2097la Pentium Gold 6405U/8GB/256GB/14;COMPUTACION
6669721;;F;71;CHILENO;;Silencioso;QUELLON                       ;LOS LAGOS;397982;2;2;0;0;0;2;2;397982;NTBK IP3i Celeron N4020/4G/500GB/14P/Rojo;COMPUTACION
17058546;;F;31;CHILENO;;Millenial;SAN FABIAN                    ;BIO BIO;443452;5;3;0;0;0;5;3;443452;TAB-X306X 10-INCH 4G+64G HD WIFI+4G LTE;COMPUTACION
17210875;;F;32;CHILENO;;Millenial;CALERA                        ;VALPARAISO;199990;1;3;0;0;0;1;3;199990;NTBK 240 G8 Celeron N4020/4GB/500GB/14P;COMPUTACION
16584569;;F;35;CHILENO;;Millenial;N/D;N/D;199990;1;1;1;1;199990;0;0;0;NTBK IP3i Celeron N4020/4G/500GB/14P/Rojo;COMPUTACION
17031197;;F;33;CHILENO;;Extranjero;PUENTE ALTO                   ;METROPOLITANA;763970;3;1;3;1;763970;0;0;0;NTBK Aspire 3 Athlon 3020e/8GB/256GB SSD/14P;COMPUTACION
13760060;;M;41;CHILENO;;X;N/D;N/D;303640;2;1;2;1;303640;0;0;0;TAB S6 Lite (610) 4GB 64GB 10.4P PINK;COMPUTACION
17290709;;M;32;CHILENO;;Millenial;AISEN                         ;AYSEN;39140;2;1;0;0;0;2;1;39140;TAB 7 MB4 Plus 4Core 1GB 16GB 7 Plata;COMPUTACION
17814424;;F;31;CHILENO;;Millenial;SAN ANTONIO                   ;VALPARAISO;129990;1;1;0;0;0;1;1;129990;Tab M10 FHD Plus LTE 10.3IN 2GB 32GB;COMPUTACION
13381484;;F;44;CHILENO;;X;BULNES                        ;BIO BIO;721520;6;4;0;0;0;6;4;721520;NTBK Aspire 5 Ci3-10110U/12GB/512GB SSD/15P FHD;COMPUTACION
12045156;;F;71;CHILENO;;Silencioso;AISEN                         ;AYSEN;439990;1;1;0;0;0;1;1;439990;NTBK IP3 Ryzen 3-5300U/8GB/256GB SSD/14P FHD;COMPUTACION
15043475;;F;32;CHILENO;;Millenial;TIERRA AMARILLA;ATACAMA;91980;2;1;0;0;0;2;1;91980;TAB MLAB MBX 8 QUAD CORE 1G+16G 8716;COMPUTACION
9709471;Soltero;M;55;CHILENO;INGENIERO;Boomers;PROVIDENCIA                   ;METROPOLITANA;503980;2;1;2;1;503980;0;0;0;NTBK M14 Ryzen 5-5500U 8GB/256GB SSD/14P FHD;COMPUTACION
14078580;;F;41;CHILENO;;X;N/D;N/D;54990;1;1;0;0;0;1;1;54990;TAB MLAB MBX 8 QUAD CORE 1G+16G 8716;COMPUTACION
8774067;;F;62;CHILENO;;Boomers;RENCA                         ;METROPOLITANA;149990;2;1;2;1;149990;0;0;0;Galaxy Tab A7 (10.4 ,32GB, WIFI) Gold;COMPUTACION
13702508;;M;43;CHILENO;;X;LA PINTANA                    ;METROPOLITANA;677960;4;2;4;2;677960;0;0;0;NTBK M14 Ryzen 5-5500U 8GB/256GB SSD/14P FHD;COMPUTACION
9523658;;F;60;CHILENO;;Boomers;PUNITAQUI;COQUIMBO;295080;4;2;4;2;295080;0;0;0;NTBK 240 G8 Celeron N4020/4GB/500GB/14P;COMPUTACION
24443588;;M;21;CHILENO;;Extranjero;PROVIDENCIA                   ;METROPOLITANA;173980;2;1;2;1;173980;0;0;0;MONITOR LC27F390FHLXZS 1920X1080 CURVO;COMPUTACION
19695764;;F;33;CHILENO;;Millenial;TALCA                         ;MAULE;833360;6;3;0;0;0;6;3;833360;Tab M10 HD 2G-32GB 10.1 Iron grey WiFi;COMPUTACION
9250725;;M;60;CHILENO;;Boomers;PROVIDENCIA                   ;METROPOLITANA;178570;2;1;0;0;0;2;1;178570;TAB-X306X 10-INCH 4G+64G HD WIFI+4G LTE;COMPUTACION
18677369;;M;27;CHILENO;;Z;PANQUEHUE                     ;VALPARAISO;1071650;4;1;0;0;0;4;1;1071650;NTBK 15-dk0007la Core i7 16GB 1TB+128 1660ti 6GB;COMPUTACION
21233585;;M;59;BOLIVIANO;;Extranjero;ANTOFAGASTA                   ;ANTOFAGASTA;519990;1;1;0;0;0;1;1;519990;NTBK M!4 Core i3-10110U/8GB/256GB SSD/14P FHD;COMPUTACION
8199864;;M;60;CHILENO;;Boomers;RANCAGUA                      ;L.G.B.OÂ´HIGGINS;284990;1;1;0;0;0;1;1;284990;NTBK Y11 11.6 Intel Celeron 8GB RAM + 256GB SDD;COMPUTACION
10825781;;M;53;CHILENO;;X;SAN FERNANDO                  ;L.G.B.OÂ´HIGGINS;49990;1;1;0;0;0;1;1;49990;Impresora Monofuncional Laser 107w;COMPUTACION
10861997;Casado;F;47;CHILENO;;X;RENCA                         ;METROPOLITANA;364980;2;1;2;1;364980;0;0;0;TAB S6 Lite (610) 4GB 64GB 10.4P PINK;COMPUTACION
16814666;;F;33;CHILENO;;Millenial;IQUIQUE                       ;TARAPACA;124990;1;1;0;0;0;1;1;124990;TAB Galaxy A 8 + S Pen (8, 32GB, WIFI);COMPUTACION
20360464;;M;22;CHILENO;;Z;PROVIDENCIA                   ;METROPOLITANA;139990;1;1;1;1;139990;0;0;0;TAB-X306X 10-INCH 4G+64G HD WIFI+4G LTE;COMPUTACION
17548260;;F;30;CHILENO;;Millenial;CURANILAHUE                   ;BIO BIO;149990;1;1;0;0;0;1;1;149990;TAB Galaxy A7 Lite (8.7, 32GB, WIFI);COMPUTACION
15057503;;M;38;CHILENO;;X;PROVIDENCIA                   ;METROPOLITANA;126990;1;1;0;0;0;1;1;126990;Multifuncional DCPT220;COMPUTACION
17642940;Soltero;M;31;CHILENO;;Millenial;PROVIDENCIA                   ;METROPOLITANA;349990;1;1;0;0;0;1;1;349990;NTBK GemiBook Celeron/12GB/256GB/2K/Tec-Ingles;COMPUTACION
17236600;;F;33;CHILENO;;Millenial;CHILLAN VIEJO                 ;BIO BIO;245461;6;1;0;0;0;6;1;245461;IMPRESORA MONOCR B215V-DNI;COMPUTACION
12694468;;F;47;CHILENO;;X;LA SERENA                     ;COQUIMBO;229990;1;3;0;0;0;1;3;229990;NTBK IP Chromebook Octacore/4GB/128GB/10P FHD;COMPUTACION
9533904;;F;57;CHILENO;;Boomers;N/D;N/D;145840;2;1;2;1;145840;0;0;0;TABLET TCL TAB 10NEO CREAM MINT + KEYBOARD;COMPUTACION
9784388;;F;58;CHILENO;;Boomers;EL BOSQUE                     ;METROPOLITANA;692850;4;1;0;0;0;4;1;692850;NTBK 240 G8 Core i3-1005G1/4GB/1TB/14P;COMPUTACION
16562510;;M;35;CHILENO;;Millenial;N/D;N/D;807950;4;1;4;1;807950;0;0;0;Monitor Gamer Optix G32C4 31.5;COMPUTACION
15921154;;M;37;CHILENO;;Millenial;PROVIDENCIA                   ;METROPOLITANA;1005480;2;1;2;1;1005480;0;0;0;NTBK G14 R7-4800HS/16GB/512SSD/1650 4G/14P 120Hz;COMPUTACION
9741110;;F;60;CHILENO;;Boomers;LO PRADO                      ;METROPOLITANA;753530;7;4;0;0;0;7;4;753530;NTBK IP3 Athlon 3050U/8GB/1TB/14P;COMPUTACION
10367025;;M;54;CHILENO;;Boomers;TEMUCO                        ;ARAUCANIA;395870;2;1;0;0;0;2;1;395870;NTBK Tecra Cel 5205U/4GB/128SSD/14FHD/T+W Ingles;COMPUTACION
11941782;;M;51;CHILENO;;X;LOS VILOS                     ;COQUIMBO;124980;2;1;0;0;0;2;1;124980;TAB Galaxy A7 Lite (8.7, 32GB, WIFI);COMPUTACION
7957372;;F;91;CHILENO;;Silencioso;VILLA ALEMANA                 ;VALPARAISO;304980;2;1;2;1;304980;0;0;0;NTBK IP3i Celeron N4020/4G/500GB/14P/Rojo;COMPUTACION
25792835;;M;37;COLOMBIANO;;Extranjero;SANTIAGO                      ;METROPOLITANA;112470;2;1;0;0;0;2;1;112470;TAB M8 QC 2GB 32GB 8P Gris;COMPUTACION
19495348;;F;24;CHILENO;;Silencioso;PROVIDENCIA                   ;METROPOLITANA;44990;2;1;2;1;44990;0;0;0;TABLET 7 WIFI 1+16;COMPUTACION
14340404;;F;44;CHILENO;;X;EL BOSQUE;METROPOLITANA;119990;1;1;0;0;0;1;1;119990;Galaxy Tab A7 (10.4 ,32GB, WIFI) Dark Gray;COMPUTACION
18374239;;F;29;CHILENO;;Silencioso;PROVIDENCIA                   ;METROPOLITANA;154540;2;1;2;1;154540;0;0;0;Galaxy Tab A7 (10.4 ,32GB, WIFI + 4G) Dark Gray;COMPUTACION
13132804;;F;44;CHILENO;;X;TOME                          ;BIO BIO;155840;2;1;2;1;155840;0;0;0;Multifuncional DCPT720DW Wifi, Duplex y ADF;COMPUTACION
17183158;;F;32;CHILENO;;Millenial;TOME                          ;BIO BIO;1247550;2;1;0;0;0;2;1;1247550;NTBK GAMER GF66 Ci5-11400H/8GB/512GB/GTX1650 4GB;COMPUTACION
6565008;;M;67;CHILENO;;Boomers;ARICA                         ;ARICA Y PARINACOTA;249980;2;2;0;0;0;2;2;249980;Tab M10 HD 2G-32GB 10.1 Iron grey WiFi;COMPUTACION
15474145;;F;40;CHILENO;;X;RENCA                         ;METROPOLITANA;59990;1;1;0;0;0;1;1;59990;TAB 7 MB4 PLUS 3G 1+16GB BLACK 8761;COMPUTACION
18538837;;F;29;CHILENO;;Millenial;N/D;N/D;276000;1;1;1;1;276000;0;0;0;NTBK Herobook Celeron N4020/8GB/256SSD/14P FHD;COMPUTACION
17651378;;M;31;CHILENO;;Silencioso;PROVIDENCIA                   ;METROPOLITANA;284540;2;1;2;1;284540;0;0;0;NTBK Herobook Celeron N4020/8GB/256SSD/14P FHD;COMPUTACION
15432541;;M;40;CHILENO;;X;PUENTE ALTO                   ;METROPOLITANA;84990;2;1;2;1;84990;0;0;0;Tab M10 HD 2G-32GB 10.1 Iron grey WiFi;COMPUTACION
15652248;;M;39;CHILENO;;X;PROVIDENCIA                   ;METROPOLITANA;636980;2;1;2;1;636980;0;0;0;NTBK Gaming 3 Ryzen 5 4600H 8GB 512SSD G1650 4GB;COMPUTACION
13791593;;M;42;CHILENO;;X;CAUQUENES                     ;MAULE;269980;2;2;0;0;0;2;2;269980;Galaxy Tab A7 (10.4 ,32GB, WIFI) Dark Gray;COMPUTACION
20406309;;M;22;CHILENO;;Silencioso;PROVIDENCIA                   ;METROPOLITANA;57540;2;1;2;1;57540;0;0;0;Router Huawei AX3 WIFI Quad core;COMPUTACION
12912452;;M;47;CHILENO;;X;N/D;N/D;834540;2;1;2;1;834540;0;0;0;NTBK GAMER L5i Ci5-10300H/8GB/512SSD/GTX1650 4GB;COMPUTACION
15912502;;F;37;CHILENO;;Millenial;PROVIDENCIA                   ;METROPOLITANA;371540;2;1;2;1;371540;0;0;0;TAB S6 Lite (610) 4GB 64GB 10.4P PINK;COMPUTACION
20247680;;M;23;CHILENO;;Silencioso;PROVIDENCIA                   ;METROPOLITANA;455480;2;1;2;1;455480;0;0;0;NTBK M!4 Core i3-10110U/8GB/256GB SSD/14P FHD;COMPUTACION
19721787;;M;24;CHILENO;;Z;PROVIDENCIA                   ;METROPOLITANA;119990;1;1;1;1;119990;0;0;0;Galaxy Tab A7 (10.4 ,32GB, WIFI) Dark Gray;COMPUTACION
12179887;;F;49;CHILENO;;X;SAN BERNARDO                  ;METROPOLITANA;442860;3;2;0;0;0;3;2;442860;AIO 200 G4 Pentium J5040/4GB/1TB/21.5P Full HD;COMPUTACION
20315902;;M;21;CHILENO;;Silencioso;PROVIDENCIA                   ;METROPOLITANA;118540;2;1;2;1;118540;0;0;0;Monitor L24e-30 (C20238FL0) 23.8inch-HDMI;COMPUTACION
13682183;;M;43;CHILENO;;X;SAN BERNARDO                  ;METROPOLITANA;99990;1;1;0;0;0;1;1;99990;Tab M10 HD 2G-32GB 10.1 Iron grey WiFi;COMPUTACION
12098789;;F;52;CHILENO;;Millenial;N/D;N/D;79990;1;1;1;1;79990;0;0;0;Tab M10 HD 2G-32GB 10.1 Iron grey WiFi;COMPUTACION
18685144;;F;28;CHILENO;;Millenial;PROVIDENCIA                   ;METROPOLITANA;145840;2;1;2;1;145840;0;0;0;Multifuncional DCPT520W Wifi;COMPUTACION
10603766;;M;52;CHILENO;;X;CABILDO                       ;VALPARAISO;485060;3;1;0;0;0;3;1;485060;NTBK 14-ck2091la i3-10110U 4GB 128GB 14 HD;COMPUTACION
25609248;;M;29;HAITIANO;;Extranjero;TALCA                         ;MAULE;154400;2;1;0;0;0;2;1;154400;Tab M10 HD 2G-32GB 10.1 Iron grey WiFi;COMPUTACION
13688543;;M;42;CHILENO;;Silencioso;PROVIDENCIA                   ;METROPOLITANA;499990;2;1;2;1;499990;0;0;0;NBTK IP3 Core i5-10210U/8GB/512GB SSD/15P;COMPUTACION
19913930;;F;24;CHILENO;;Silencioso;PROVIDENCIA                   ;METROPOLITANA;329990;1;1;0;0;0;1;1;329990;NTBK IP3 Athlon 3050U/8GB/1TB/14P;COMPUTACION
12554937;;F;47;CHILENO;;X;PROVIDENCIA                   ;METROPOLITANA;407870;2;1;0;0;0;2;1;407870;NTBK IP3 Athlon 3050U/8GB/1TB/14P;COMPUTACION
14536907;;F;44;CHILENO;;X;TOLTEN                        ;ARAUCANIA;476980;2;1;2;1;476980;0;0;0;TAB Galaxy S7 FE (12.4, 64GB WIFI) BLACK;COMPUTACION
12945434;;M;46;CHILENO;;X;ALTO HOSPICIO;TARAPACA;294980;2;1;0;0;0;2;1;294980;NTBK IP1 AMD 3020e/4GB/64GB eMMC/14P;COMPUTACION
19941585;;M;24;CHILENO;;Z;PROVIDENCIA                   ;METROPOLITANA;232570;2;1;0;0;0;2;1;232570;TAB Galaxy Tab A 10.1 8Core 2GB 32GB 10 Negra;COMPUTACION
17482892;Soltero;F;32;CHILENO;TECNICO DEPORTIVO;Millenial;PROVIDENCIA                   ;METROPOLITANA;419990;2;1;2;1;419990;0;0;0;NTBK 14 3400 i3-1115G4 8GB 1TB Intel UHD Graphic;COMPUTACION
9041670;;M;61;CHILENO;;Boomers;COLINA                        ;METROPOLITANA;669990;1;3;0;0;0;1;3;669990;NTBK IP S540 Core i5/16GB/512SSD/13.3P QHD;COMPUTACION
5096458;;F;78;CHILENO;;Silencioso;SAN PEDRO DE LA PAZ           ;BIO BIO;209990;1;1;0;0;0;1;1;209990;TAB M5 Lite Octa Core 32GB 10P FHD;COMPUTACION
16553476;;M;35;CHILENO;;Millenial;PUENTE ALTO                   ;METROPOLITANA;403980;2;1;2;1;403980;0;0;0;NTBK Y13 Pro 13.3 8GB RAM +256GB SDD;COMPUTACION
12292228;;F;50;CHILENO;;X;RENCA                         ;METROPOLITANA;634980;2;1;2;1;634980;0;0;0;NTBK Gaming 3 Ryzen 5 4600H 8GB 512SSD G1650 4GB;COMPUTACION
9562250;Casado;M;58;CHILENO;;Boomers;RENCA                         ;METROPOLITANA;190370;2;1;0;0;0;2;1;190370;Galaxy Tab A7 (10.4 ,32GB, WIFI) Dark Gray;COMPUTACION
19879043;;F;24;CHILENO;;Silencioso;N/D;N/D;458540;2;1;2;1;458540;0;0;0;NTBK CoreBook X i5-8259U/ 8GB/ 512GB SSD/ 14/ W1;COMPUTACION
13971423;;M;41;CHILENO;;X;N/D;N/D;269990;1;1;0;0;0;1;1;269990;NTBK 240G7 CelN4020 14 4GB/500 PC;COMPUTACION
18205459;;F;29;CHILENO;;Silencioso;PROVIDENCIA                   ;METROPOLITANA;129990;1;1;1;1;129990;0;0;0;Galaxy Tab A7 (10.4 ,32GB, WIFI) Dark Gray;COMPUTACION
26135509;;M;32;VENEZOLANO;;Extranjero;SANTIAGO                      ;METROPOLITANA;203980;2;1;2;1;203980;0;0;0;Monitor Emerald 27P 165Hz Full HD;COMPUTACION
15288408;;M;39;CHILENO;;X;ANCUD                         ;LOS LAGOS;549990;1;1;1;1;549990;0;0;0;NTBK M14 Ryzen 5-5500U 8GB/256GB SSD/14P FHD;COMPUTACION
17583081;;M;32;CHILENO;;Silencioso;PROVIDENCIA                   ;METROPOLITANA;103980;2;1;2;1;103980;0;0;0;Tab M10 HD 2G-32GB 10.1 Iron grey WiFi;COMPUTACION
8548878;;F;60;CHILENO;;Boomers;PROVIDENCIA                   ;METROPOLITANA;169990;1;1;0;0;0;1;1;169990;Galaxy Tab A7 (10.4 ,32GB, WIFI) Dark Gray;COMPUTACION
8952411;;M;61;CHILENO;;Boomers;PROVIDENCIA                   ;METROPOLITANA;347870;2;1;0;0;0;2;1;347870;NTBK 240G7 CelN4020 14 4GB/500 PC;COMPUTACION
15910998;Soltero;F;37;CHILENO;;Millenial;PROVIDENCIA                   ;METROPOLITANA;279990;1;1;1;1;279990;0;0;0;NTBK 240G7 CelN4020 14 4GB/500 PC;COMPUTACION
16941787;;F;33;CHILENO;;Millenial;N/D;N/D;476980;2;1;2;1;476980;0;0;0;IPAD WI-FI 128GB SILVER-CHL (MYLE2CI/A);COMPUTACION
18910816;;F;29;CHILENO;;Millenial;N/D;N/D;103980;2;1;2;1;103980;0;0;0;Tab M10 HD 2G-32GB 10.1 Iron grey WiFi;COMPUTACION
16973415;;F;33;CHILENO;;Millenial;COIHAIQUE                     ;AYSEN;359990;1;1;1;1;359990;0;0;0;NTBK 240 G8 Core i3-1005G1/4GB/1TB/14P;COMPUTACION
14196152;;M;41;CHILENO;;X;"";"";427070;3;1;0;0;0;3;1;427070;NTBK Herobook Celeron N4020/8GB/256SSD/14P FHD;COMPUTACION
17255748;;F;32;CHILENO;;Millenial;PROVIDENCIA                   ;METROPOLITANA;353980;2;1;2;1;353980;0;0;0;NTBK GemiBook Celeron/12GB/256GB/2K/Tec-Ingles;COMPUTACION
7264470;;M;64;CHILENO;;Boomers;PROVIDENCIA                   ;METROPOLITANA;53980;2;1;2;1;53980;0;0;0;Impresora Monofuncional Laser 107w;COMPUTACION
3796678;;F;87;CHILENO;;Silencioso;SAN FELIPE                    ;VALPARAISO;988940;4;1;0;0;0;4;1;988940;NTBK 15-dk1043la i5-10300H 8GB512SSD4V W10H;COMPUTACION
18924640;;M;27;CHILENO;;Millenial;CASABLANCA                    ;VALPARAISO;279990;1;1;1;1;279990;0;0;0;NTBK IP Chromebook Octacore/4GB/128GB/10P FHD;COMPUTACION
19104706;;F;27;CHILENO;;Z;N/D;N/D;679990;1;1;0;0;0;1;1;679990;NTBK M14 Ryzen 5-5500U 8GB/256GB SSD/14P FHD;COMPUTACION
12090402;;F;52;CHILENO;;Millenial;PROVIDENCIA                   ;METROPOLITANA;703980;2;1;2;1;703980;0;0;0;NTBK Gaming 3 Ryzen 5 4600H 8GB 512SSD G1650 4GB;COMPUTACION
12700537;;M;48;CHILENO;;X;TALCAHUANO                    ;BIO BIO;11970;3;1;0;0;0;3;1;11970;TINTA HP BOTELLA MAGENTA GT52;COMPUTACION
9686223;;M;59;CHILENO;;Boomers;PROVIDENCIA                   ;METROPOLITANA;409990;1;1;0;0;0;1;1;409990;NTBK S145-14IIL I3 10/4G 128SSD/14HD;COMPUTACION
11796618;;F;54;CHILENO;;Z;PROVIDENCIA                   ;METROPOLITANA;99990;1;1;0;0;0;1;1;99990;Tab M10 HD 2G-32GB 10.1 Iron grey WiFi;COMPUTACION
14373532;;M;47;CHILENO;;X;CORONEL                       ;BIO BIO;385840;2;1;2;1;385840;0;0;0;NTBK 348G7 i3-10110U 14 4GB/1T PC WHOME;COMPUTACION
14534905;;M;41;CHILENO;;X;ISLA DE MAIPO                 ;METROPOLITANA;0;0;0;0;0;0;0;0;0;NTBK 348G7 i3-10110U 14 4GB/1T PC WHOME;COMPUTACION
15071327;;M;38;CHILENO;;Silencioso;PROVIDENCIA                   ;METROPOLITANA;0;0;0;0;0;0;0;0;0;TAB MLAB MBX 8 QUAD CORE 1G+16G 8716;COMPUTACION
15233243;;F;37;CHILENO;;Millenial;TEMUCO                        ;ARAUCANIA;0;0;0;0;0;0;0;0;0;MULTIFUNCIONAL ECOTANK L3150 Wifi;COMPUTACION
9338129;;M;59;CHILENO;;Boomers;N/D;N/D;0;0;0;0;0;0;0;0;0;IPAD WI-FI 128GB SILVER-CHL (MYLE2CI/A);COMPUTACION
25989807;;F;53;CHILENO;;Extranjero;N/D;N/D;0;0;0;0;0;0;0;0;0;NTBK 15-dk1028la Ci5-10300H/8GB/256SSD/1050 3GB;COMPUTACION
11768106;;F;51;CHILENO;;X;PROVIDENCIA                   ;METROPOLITANA;0;0;0;0;0;0;0;0;0;Multifuncional Smart Tank 515 Wifi;COMPUTACION
15882916;;M;37;CHILENO;;Millenial;"";"";0;0;0;0;0;0;0;0;0;NTBK IP1 AMD 3020e/4GB/64GB eMMC/14P;COMPUTACION
14541797;;M;47;CHILENO;;Silencioso;PROVIDENCIA                   ;METROPOLITANA;0;0;0;0;0;0;0;0;0;Multifuncional Ink Tank 315;COMPUTACION
16540328;;M;35;CHILENO;;Millenial;N/D;N/D;0;0;0;0;0;0;0;0;0;NTBK 240 G8 Core i3-1005G1/4GB/1TB/14P;COMPUTACION
8253684;Casado;F;57;CHILENO;COMERCIO EXTERIOR;Boomers;RENCA                         ;METROPOLITANA;0;0;0;0;0;0;0;0;0;NTBK 14-ck2091la i3-10110U 4GB 128GB 14 HD;COMPUTACION
18335848;;M;29;CHILENO;;Silencioso;PROVIDENCIA                   ;METROPOLITANA;0;0;0;0;0;0;0;0;0;IMPRESORA LASER PASHER 3020;COMPUTACION
19399328;;F;26;CHILENO;;Z;CASTRO                        ;LOS LAGOS;0;0;0;0;0;0;0;0;0;T544 DYE MAGENTA INK BOTTLE (65ml);COMPUTACION
17365123;;M;33;CHILENO;;Silencioso;PROVIDENCIA                   ;METROPOLITANA;0;0;0;0;0;0;0;0;0;MULTIFUNCIONAL ECOTANK L3150 Wifi;COMPUTACION
27417236;;M;30;CHILENO;;Extranjero;N/D;N/D;0;0;0;0;0;0;0;0;0;NTBK 240 G8 Core i3-1005G1/4GB/1TB/14P;COMPUTACION
17967558;;F;30;CHILENO;;Millenial;N/D;N/D;0;0;0;0;0;0;0;0;0;MULTIFUNCIONAL G2110 TINTA CONT;COMPUTACION
16259896;;M;36;CHILENO;;Millenial;CALAMA                        ;ANTOFAGASTA;0;0;0;0;0;0;0;0;0;Multifuncional DCPT720DW Wifi, Duplex y ADF;COMPUTACION
12150227;;F;51;CHILENO;;X;OVALLE                        ;COQUIMBO;0;0;0;0;0;0;0;0;0;T544 DYE MAGENTA INK BOTTLE (65ml);COMPUTACION
16236912;;M;36;CHILENO;;Millenial;PROVIDENCIA                   ;METROPOLITANA;0;0;0;0;0;0;0;0;0;Tab M10 HD 2G-32GB 10.1 Iron grey WiFi;COMPUTACION
5968840;;F;79;CHILENO;;Silencioso;TALCAHUANO                    ;BIO BIO;0;0;0;0;0;0;0;0;0;Galaxy Tab A7 (10.4 ,32GB, WIFI) Dark Gray;COMPUTACION
16751994;Soltero;F;34;CHILENO;;Millenial;PROVIDENCIA                   ;METROPOLITANA;0;0;0;0;0;0;0;0;0;NTBK G7 240 Intel Celeron 4GB 500GB 14;COMPUTACION
5845573;;F;77;CHILENO;;Silencioso;PROVIDENCIA                   ;METROPOLITANA;0;0;0;0;0;0;0;0;0;TAB Matepad T8 Wifi 2GB 32GB 8P;COMPUTACION
7489697;;F;64;CHILENO;;Boomers;ANTOFAGASTA                   ;ANTOFAGASTA;0;0;0;0;0;0;0;0;0;TAB 7 PLAY AND LEARN PLUS PURPLE 8867;COMPUTACION
17685328;;M;31;CHILENO;;Extranjero;TALCA                         ;MAULE;0;0;0;0;0;0;0;0;0;Impresora Monofuncional Laser 107w;COMPUTACION
14389138;;M;44;CHILENO;;X;N/D;N/D;0;0;0;0;0;0;0;0;0;Multifuncional DCPT520W Wifi;COMPUTACION
11600131;;M;51;CHILENO;;X;ARICA                         ;ARICA Y PARINACOTA;0;0;0;0;0;0;0;0;0;NTBK 15 FHD Core i5 16/1T+128 + 1650;COMPUTACION
22228073;;M;27;CHILENO;;Z;ARICA                         ;ARICA Y PARINACOTA;0;0;0;0;0;0;0;0;0;NTBK 240 G8 Core i3-1005G1/4GB/1TB/14P;COMPUTACION
10260050;;M;53;CHILENO;;X;SAN FELIPE                    ;VALPARAISO;0;0;0;0;0;0;0;0;0;Multifuncional DCPT720DW Wifi, Duplex y ADF;COMPUTACION
13589276;;M;43;CHILENO;;X;ARICA                         ;ARICA Y PARINACOTA;0;0;0;0;0;0;0;0;0;TAB 7 MB4 Plus 4Core 1GB 16GB 7 Plata;COMPUTACION
11928888;;M;50;CHILENO;;X;QUEMCHI                       ;LOS LAGOS;0;0;0;0;0;0;0;0;0;MULTIFUNCIONAL ECOTANK L3110;COMPUTACION
19697369;;F;24;CHILENO;;Z;TALCA                         ;MAULE;0;0;0;0;0;0;0;0;0;NTBK 240 G8 Core i3-1005G1/4GB/1TB/14P;COMPUTACION
15028605;;M;37;CHILENO;;Millenial;RENCA                         ;METROPOLITANA;0;0;0;0;0;0;0;0;0;NTBK 240 G8 Core i3-1005G1/4GB/1TB/14P;COMPUTACION
16037128;;F;37;CHILENO;;Silencioso;PROVIDENCIA                   ;METROPOLITANA;0;0;0;0;0;0;0;0;0;TAB Galaxy Tab A 8 4G 4Core 2GB 32GB 8 Gris;COMPUTACION
15374504;Casado;F;39;CHILENO;PROFESOR;Silencioso;PROVIDENCIA                   ;METROPOLITANA;0;0;0;0;0;0;0;0;0;TAB Galaxy Tab A 8 4G 4Core 2GB 32GB 8 Gris;COMPUTACION
18466272;;F;28;CHILENO;;Millenial;PROVIDENCIA                   ;METROPOLITANA;0;0;0;0;0;0;0;0;0;MULTIFUNCIONAL ECOTANK L4160 Wifi;COMPUTACION
13211877;;F;46;CHILENO;;X;CALAMA                        ;ANTOFAGASTA;0;0;0;0;0;0;0;0;0;NTBK 14-cf2051la i3-10110U 4GB 256GB+16GB 14 HD;COMPUTACION
15350143;;M;40;CHILENO;;X;PROVIDENCIA                   ;METROPOLITANA;0;0;0;0;0;0;0;0;0;NTBK IP S145 AMD 3020E/4GB/500GB/14P;COMPUTACION
5245272;;F;73;CHILENO;;Silencioso;TALCA                         ;MAULE;0;0;0;0;0;0;0;0;0;NTBK 240 G8 Core i3-1005G1/4GB/1TB/14P;COMPUTACION
12038017;;M;54;CHILENO;;X;RENCA                         ;METROPOLITANA;0;0;0;0;0;0;0;0;0;MULTIFUNCIONAL ECOTANK L3110;COMPUTACION
14129587;;F;40;CHILENO;;X;PROVIDENCIA                   ;METROPOLITANA;0;0;0;0;0;0;0;0;0;Tablet Matepad 10.4;COMPUTACION
16270922;;F;36;CHILENO;;Millenial;TALCA                         ;MAULE;0;0;0;0;0;0;0;0;0;MULTIFUNCIONAL ECOTANK L3150 Wifi;COMPUTACION
18522008;;M;28;CHILENO;;Millenial;PROVIDENCIA                   ;METROPOLITANA;0;0;0;0;0;0;0;0;0;TAB 7 MB4 Plus 4Core 1GB 16GB 7 Negra;COMPUTACION
19440434;Soltero;M;26;CHILENO;;Z;PROVIDENCIA                   ;METROPOLITANA;0;0;0;0;0;0;0;0;0;TAB Galaxy S6 Lite +Book Cover (10.4,64GB,WIFI+4;COMPUTACION
14252639;Soltero;M;48;CHILENO;TECNICO EN ELECTRICIDAD;X;"";"";0;0;0;0;0;0;0;0;0;NTBK 15-dk1043la i5-10300H 8GB512SSD4V W10H;COMPUTACION
7426085;;F;70;CHILENO;;Silencioso;SAN BERNARDO                  ;METROPOLITANA;0;0;0;0;0;0;0;0;0;NTBK 15-dk1028la Ci5-10300H/8GB/256SSD/1050 3GB;COMPUTACION
16160930;;F;36;CHILENO;;Millenial;PROVIDENCIA                   ;METROPOLITANA;0;0;0;0;0;0;0;0;0;NTBK Aspire 5 Ci3-10110U/12GB/512GB SSD/15P FHD;COMPUTACION
10803675;;M;55;CHILENO;;Boomers;NEGRETE                       ;BIO BIO;0;0;0;0;0;0;0;0;0;TAB Galaxy A7 Lite (8.7, 32GB, WIFI + 4G);COMPUTACION
16988194;Soltero;M;33;CHILENO;INGENIERO EN ADMINISTRACION DE EMPRESAS;Silencioso;PROVIDENCIA                   ;METROPOLITANA;0;0;0;0;0;0;0;0;0;Tab M10 HD 2G-32GB 10.1 Iron grey WiFi;COMPUTACION
12437682;;F;49;CHILENO;;X;N/D;N/D;0;0;0;0;0;0;0;0;0;NTBK 14-ck2091la i3-10110U 4GB 128GB 14 HD;COMPUTACION
5147240;;M;77;CHILENO;;Silencioso;RENCA                         ;METROPOLITANA;0;0;0;0;0;0;0;0;0;TAB Galaxy A7 Lite (8.7, 32GB, WIFI + 4G);COMPUTACION
11224309;Casado;F;54;CHILENO;;X;PROVIDENCIA                   ;METROPOLITANA;0;0;0;0;0;0;0;0;0;NTBK 15-dk1043la i5-10300H 8GB512SSD4V W10H;COMPUTACION
19279305;Soltero;F;26;CHILENO;TECNICO DE NIVEL MEDIO EN ALIMENTACION;Z;SAN BERNARDO                  ;METROPOLITANA;0;0;0;0;0;0;0;0;0;TAB M8 QC 2GB 32GB 8P Gris;COMPUTACION
9441210;;M;59;CHILENO;;Boomers;N/D;N/D;0;0;0;0;0;0;0;0;0;NTBK 14-ck2091la i3-10110U 4GB 128GB 14 HD;COMPUTACION
13127917;;M;45;CHILENO;;X;N/D;N/D;0;0;0;0;0;0;0;0;0;Tab Yoga Smart;COMPUTACION
7640479;;M;64;CHILENO;;Boomers;PUENTE ALTO                   ;METROPOLITANA;0;0;0;0;0;0;0;0;0;NTBK 15-dk1043la i5-10300H 8GB512SSD4V W10H;COMPUTACION
18083077;;F;29;CHILENO;;Millenial;MELIPILLA                     ;METROPOLITANA;0;0;0;0;0;0;0;0;0;TAB Galaxy Tab A 8 4Core 2GB 32GB 8 Negra;COMPUTACION
19754491;;M;24;CHILENO;;Z;PROVIDENCIA                   ;METROPOLITANA;0;0;0;0;0;0;0;0;0;NTBK 15-dk1028la Ci5-10300H/8GB/256SSD/1050 3GB;COMPUTACION
19731531;;F;24;CHILENO;;Z;N/D;N/D;0;0;0;0;0;0;0;0;0;NTBK 14-ck2091la i3-10110U 4GB 128GB 14 HD;COMPUTACION
7872369;;M;65;CHILENO;;Boomers;RENCA                         ;METROPOLITANA;0;0;0;0;0;0;0;0;0;Tab M10 HD 2G-32GB 10.1 Iron grey WiFi;COMPUTACION
18640586;;F;28;CHILENO;;Silencioso;PROVIDENCIA                   ;METROPOLITANA;0;0;0;0;0;0;0;0;0;NTBK 15-dk1028la Ci5-10300H/8GB/256SSD/1050 3GB;COMPUTACION
20098429;;M;23;CHILENO;;Z;PROVIDENCIA                   ;METROPOLITANA;0;0;0;0;0;0;0;0;0;TAB Galaxy Tab A 8 4Core 2GB 32GB 8 Gris;COMPUTACION
18070687;Soltero;F;29;CHILENO;;Millenial;PROVIDENCIA                   ;METROPOLITANA;0;0;0;0;0;0;0;0;0;TAB 7 MB4 Plus 4Core 1GB 16GB 7 Plata;COMPUTACION
13200677;;M;45;CHILENO;;Silencioso;PROVIDENCIA                   ;METROPOLITANA;0;0;0;0;0;0;0;0;0;TAB Galaxy Tab A+SPen 8Core 3GB 32GB 8 Gris;COMPUTACION
12329355;;F;48;CHILENO;;X;PROVIDENCIA                   ;METROPOLITANA;0;0;0;0;0;0;0;0;0;Galaxy Tab A7 (10.4 ,32GB, WIFI + 4G) Dark Gray;COMPUTACION
10213102;;F;54;CHILENO;;Silencioso;PROVIDENCIA                   ;METROPOLITANA;0;0;0;0;0;0;0;0;0;TAB S6 Lite (610) 4GB 64GB 10.4P BLUE;COMPUTACION
19084347;;M;26;CHILENO;;Silencioso;PROVIDENCIA                   ;METROPOLITANA;0;0;0;0;0;0;0;0;0;MONITOR 22x 21.5-inch Display;COMPUTACION
10075840;;M;51;CHILENO;;Silencioso;PROVIDENCIA                   ;METROPOLITANA;0;0;0;0;0;0;0;0;0;NTBK 15-dk1043la i5-10300H 8GB512SSD4V W10H;COMPUTACION
17469805;;F;34;CHILENO;;Millenial;PROVIDENCIA                   ;METROPOLITANA;0;0;0;0;0;0;0;0;0;TABLET 7 KIDS + KID CASE 1+16;COMPUTACION
11235105;;F;54;CHILENO;;X;N/D;N/D;0;0;0;0;0;0;0;0;0;NTBK 14-ck2091la i3-10110U 4GB 128GB 14 HD;COMPUTACION
16977174;;M;33;CHILENO;;Millenial;QUILICURA                     ;METROPOLITANA;0;0;0;0;0;0;0;0;0;Matepad T10S WIFI 2+32 GB;COMPUTACION
20500303;;M;22;CHILENO;;Z;PROVIDENCIA                   ;METROPOLITANA;0;0;0;0;0;0;0;0;0;MULTIFUNCIONAL ECOTANK L3110;COMPUTACION
19873738;;M;24;CHILENO;;Z;N/D;N/D;0;0;0;0;0;0;0;0;0;NTBK 240 G8 Core i3-1005G1/4GB/1TB/14P;COMPUTACION
15229416;;F;39;CHILENO;;X;RENCA                         ;METROPOLITANA;0;0;0;0;0;0;0;0;0;TABLET 7 KIDS + KID CASE 1+16;COMPUTACION
13122064;;F;46;CHILENO;;X;RENCA                         ;METROPOLITANA;0;0;0;0;0;0;0;0;0;NTBK IP S145 AMD 3020E/4GB/500GB/14P;COMPUTACION
18327942;Soltero;F;29;CHILENO;;Silencioso;PROVIDENCIA                   ;METROPOLITANA;0;0;0;0;0;0;0;0;0;NTBK 15-dk1043la i5-10300H 8GB512SSD4V W10H;COMPUTACION
13363928;;M;44;CHILENO;;X;"";"";0;0;0;0;0;0;0;0;0;MULTIFUNCIONAL ECOTANK L5190 Wifi/ Fax;COMPUTACION
25410716;;M;28;HAITIANO;;Extranjero;SAN BERNARDO                  ;METROPOLITANA;0;0;0;0;0;0;0;0;0;TAB 7 MB4 PLUS 3G 1+16GB BLACK 8761;COMPUTACION
7733460;Casado;M;67;CHILENO;AGROINDUSTRIA;Boomers;LONGAVI                       ;MAULE;0;0;0;0;0;0;0;0;0;NTBK 240 G8 Core i3-1005G1/4GB/1TB/14P;COMPUTACION
18691059;Soltero;F;27;CHILENO;;Millenial;PROVIDENCIA                   ;METROPOLITANA;0;0;0;0;0;0;0;0;0;NTBK 14-ck2096la CeleronN4020 4GB500GB W10H;COMPUTACION
18317370;Soltero;M;29;CHILENO;INGENIERO AGRICOLA;Silencioso;PROVIDENCIA                   ;METROPOLITANA;0;0;0;0;0;0;0;0;0;NTBK 15-dk1043la i5-10300H 8GB512SSD4V W10H;COMPUTACION
17723539;Soltero;F;31;CHILENO;CIRUJANO DENTISTA;Millenial;PROVIDENCIA                   ;METROPOLITANA;0;0;0;0;0;0;0;0;0;Impresora Laser HL-1202 Monocromatica;COMPUTACION
14264799;;F;51;CHILENO;;X;RENCA                         ;METROPOLITANA;0;0;0;0;0;0;0;0;0;Galaxy Tab A7 (10.4 ,64GB, WIFI) Dark Gray;COMPUTACION
16562511;;M;35;CHILENO;;Silencioso;PROVIDENCIA                   ;METROPOLITANA;0;0;0;0;0;0;0;0;0;MULTIFUNCIONAL ECOTANK L3150 Wifi;COMPUTACION
18877521;;M;27;CHILENO;;Millenial;PARRAL                        ;MAULE;0;0;0;0;0;0;0;0;0;MULTIFUNCIONAL ECOTANK L3150 Wifi;COMPUTACION
19058726;;F;27;CHILENO;;Z;LLANQUIHUE;LOS LAGOS;0;0;0;0;0;0;0;0;0;TAB Galaxy Tab A 8 4Core 2GB 32GB 8 Gris;COMPUTACION
15132345;;F;38;CHILENO;;Millenial;RENCA                         ;METROPOLITANA;0;0;0;0;0;0;0;0;0;MULTIFUNCIONAL ECOTANK L3150 Wifi;COMPUTACION
7452319;Soltero;F;64;CHILENO;;Boomers;RENCA                         ;METROPOLITANA;0;0;0;0;0;0;0;0;0;NTBK 14-ck2091la i3-10110U 4GB 128GB 14 HD;COMPUTACION
20249316;;F;22;CHILENO;;Z;IQUIQUE                       ;TARAPACA;0;0;0;0;0;0;0;0;0;MULTIFUNCIONAL ECOTANK L3150 Wifi;COMPUTACION
17846721;;F;31;CHILENO;;Silencioso;PROVIDENCIA                   ;METROPOLITANA;0;0;0;0;0;0;0;0;0;Multifuncional Ink Tank 415 Wifi;COMPUTACION
25785318;;M;30;VENEZOLANO;;Extranjero;SANTIAGO                      ;METROPOLITANA;0;0;0;0;0;0;0;0;0;Galaxy Tab A7 (10.4 ,32GB, WIFI) Silver;COMPUTACION
15497287;;M;38;CHILENO;;X;MARCHIHUE                     ;L.G.B.OÂ´HIGGINS;0;0;0;0;0;0;0;0;0;NTBK 14-cf2051la i3-10110U 4GB 256GB+16GB 14 HD;COMPUTACION
20199268;;F;23;CHILENO;;Silencioso;PROVIDENCIA                   ;METROPOLITANA;0;0;0;0;0;0;0;0;0;NTBK INSPIRON 15 3505 AMD ATHLON SILVER 8GB 256G;COMPUTACION
10056779;;M;58;CHILENO;;Boomers;CABILDO                       ;VALPARAISO;0;0;0;0;0;0;0;0;0;NTBK GAMER N5 Ci5-10300H/16GB/512SSD/GTX1650 4GB;COMPUTACION
18626134;;F;28;CHILENO;;Millenial;COLINA                        ;METROPOLITANA;0;0;0;0;0;0;0;0;0;NTBK 14-ck2091la i3-10110U 4GB 128GB 14 HD;COMPUTACION
15778934;;M;37;CHILENO;;Millenial;TALAGANTE;METROPOLITANA;0;0;0;0;0;0;0;0;0;Galaxy Tab A7 (10.4 ,32GB, WIFI + 4G) Dark Gray;COMPUTACION
16946902;;M;34;CHILENO;;Millenial;PROVIDENCIA                   ;METROPOLITANA;0;0;0;0;0;0;0;0;0;NTBK 15-dy2051la i3-1115G4 8GB 256GB+16GB 15IN S;COMPUTACION
19916713;;F;23;CHILENO;;Silencioso;PROVIDENCIA                   ;METROPOLITANA;0;0;0;0;0;0;0;0;0;NTBK 14-dq1004la Core i5-1035G1 8GB 256SSD 14P;COMPUTACION
13886995;;F;42;CHILENO;;X;N/D;N/D;0;0;0;0;0;0;0;0;0;MULTIFUNCIONAL HP INK ADVANTAGE 3785/3775;COMPUTACION
18257433;Soltero;F;29;CHILENO;ASISTENTE SOCIAL;Millenial;PROVIDENCIA                   ;METROPOLITANA;0;0;0;0;0;0;0;0;0;MULTIFUNCIONAL ECOTANK L3150 Wifi;COMPUTACION
26414966;;M;25;VENEZOLANO;;Extranjero;N/D;N/D;0;0;0;0;0;0;0;0;0;Galaxy Tab A7 (10.4 ,32GB, WIFI) Gold;COMPUTACION
15198683;;F;40;CHILENO;;Silencioso;PROVIDENCIA                   ;METROPOLITANA;0;0;0;0;0;0;0;0;0;TAB M8 QC 2GB 32GB 8P Gris;COMPUTACION
5555006;;F;71;CHILENO;;Silencioso;N/D;N/D;0;0;0;0;0;0;0;0;0;MULTIFUNCIONAL ECOTANK L3150 Wifi;COMPUTACION
9275900;;M;59;CHILENO;;Boomers;ARAUCO                        ;BIO BIO;0;0;0;0;0;0;0;0;0;TAB Galaxy Tab A 8 4Core 2GB 32GB 8 Gris;COMPUTACION
19045610;Soltero;F;27;CHILENO;;Millenial;PROVIDENCIA                   ;METROPOLITANA;0;0;0;0;0;0;0;0;0;TAB Galaxy Tab A 8 4Core 2GB 32GB 8 Negra;COMPUTACION
19475629;Soltero;M;26;CHILENO;;Silencioso;PROVIDENCIA                   ;METROPOLITANA;0;0;0;0;0;0;0;0;0;NTBK 15-dk1043la i5-10300H 8GB512SSD4V W10H;COMPUTACION
14190522;;F;41;CHILENO;;X;PROVIDENCIA                   ;METROPOLITANA;0;0;0;0;0;0;0;0;0;TAB Galaxy Tab A 8 4Core 2GB 32GB 8 Gris;COMPUTACION
16904953;;F;34;CHILENO;;Millenial;CAUQUENES                     ;MAULE;0;0;0;0;0;0;0;0;0;AIO 21-b0021la Pentium J5040 8GB 1TB;COMPUTACION
18160689;;M;31;CHILENO;;Millenial;VINA DEL MAR                  ;VALPARAISO;0;0;0;0;0;0;0;0;0;NTBK 14-ck2096la CeleronN4020 4GB500GB W10H;COMPUTACION
15089306;;F;39;CHILENO;;X;PROVIDENCIA                   ;METROPOLITANA;0;0;0;0;0;0;0;0;0;Multifuncional DCPT220;COMPUTACION
14495106;;M;41;CHILENO;;X;RENGO;O HIGGINS;0;0;0;0;0;0;0;0;0;TAB Galaxy Tab A 8 4Core 2GB 32GB 8 Negra;COMPUTACION
18457714;Soltero;F;28;CHILENO;;Silencioso;PROVIDENCIA                   ;METROPOLITANA;0;0;0;0;0;0;0;0;0;TAB S6 Lite (610) 4GB 64GB 10.4P BLUE;COMPUTACION
18640886;Soltero;F;28;CHILENO;;Silencioso;PROVIDENCIA                   ;METROPOLITANA;0;0;0;0;0;0;0;0;0;TAB S6 Lite (610) 4GB 64GB 10.4P BLUE;COMPUTACION
16988162;;F;33;CHILENO;;Millenial;SANTA BARBARA                 ;BIO BIO;0;0;0;0;0;0;0;0;0;Multifuncional Smart tank 530 WiFi ADF;COMPUTACION
18329847;;F;29;CHILENO;;Millenial;CHIMBARONGO                   ;L.G.B.OÂ´HIGGINS;0;0;0;0;0;0;0;0;0;NTBK 14-cf2051la i3-10110U 4GB 256GB+16GB 14 HD;COMPUTACION
19413698;Soltero;F;25;CHILENO;;Z;PROVIDENCIA                   ;METROPOLITANA;0;0;0;0;0;0;0;0;0;TINTA 664 TRI COLOR;COMPUTACION
11704042;;M;51;CHILENO;;X;RENCA                         ;METROPOLITANA;0;0;0;0;0;0;0;0;0;NTBK 14-dq1004la Core i5-1035G1 8GB 256SSD 14P;COMPUTACION
18387718;Soltero;M;29;CHILENO;;Silencioso;PROVIDENCIA                   ;METROPOLITANA;0;0;0;0;0;0;0;0;0;NTBK 245 G7 AMD Ryzen 5 3500U 8GB 1TB 14P;COMPUTACION
15340211;Soltero;M;39;CHILENO;ABOGADO;Silencioso;PROVIDENCIA                   ;METROPOLITANA;0;0;0;0;0;0;0;0;0;TAB Galaxy Tab A 8 4Core 2GB 32GB 8 Negra;COMPUTACION
16323326;;F;35;CHILENO;;Millenial;PROVIDENCIA                   ;METROPOLITANA;0;0;0;0;0;0;0;0;0;AIO 21-b0021la Pentium J5040 8GB 1TB;COMPUTACION
13851685;;F;42;CHILENO;;Silencioso;PROVIDENCIA                   ;METROPOLITANA;0;0;0;0;0;0;0;0;0;NTBK 15-dy2051la i3-1115G4 8GB 256GB+16GB 15IN S;COMPUTACION
17442663;;F;32;CHILENO;;Millenial;PROVIDENCIA                   ;METROPOLITANA;0;0;0;0;0;0;0;0;0;TAB Galaxy Tab A 8 4Core 2GB 32GB 8 Negra;COMPUTACION
9755987;;M;56;CHILENO;;Boomers;PROVIDENCIA                   ;METROPOLITANA;0;0;0;0;0;0;0;0;0;Multifuncional Smart Tank 515 Wifi;COMPUTACION
15556819;;M;39;CHILENO;;X;VINA DEL MAR                  ;VALPARAISO;0;0;0;0;0;0;0;0;0;NTBK G7 240 Intel Celeron 4GB 500GB 14;COMPUTACION
5869501;;M;71;CHILENO;;Silencioso;PROVIDENCIA                   ;METROPOLITANA;0;0;0;0;0;0;0;0;0;NTBK 245 G7 AMD Ryzen 5 3500U 8GB 1TB 14P;COMPUTACION
18809350;Soltero;M;27;CHILENO;;Silencioso;PROVIDENCIA                   ;METROPOLITANA;0;0;0;0;0;0;0;0;0;NTBK INSPIRON 5505 AMD R5 4500U 8GB 512SSD;COMPUTACION
18206941;;F;29;CHILENO;;Millenial;CALLE LARGA                   ;VALPARAISO;0;0;0;0;0;0;0;0;0;Impresora Laser HL-1202 Monocromatica;COMPUTACION
18179037;;F;29;CHILENO;;Millenial;PROVIDENCIA                   ;METROPOLITANA;0;0;0;0;0;0;0;0;0;Multifuncional DeskJet Ink Advantage 3775 Wifi;COMPUTACION
9820443;Casado;M;50;CHILENO;PERIODISTA;X;PROVIDENCIA                   ;METROPOLITANA;0;0;0;0;0;0;0;0;0;TAB S6 Lite (610) 4GB 64GB 10.4P BLUE;COMPUTACION
15823323;;M;37;CHILENO;;Millenial;PUTAENDO;VALPARAISO;0;0;0;0;0;0;0;0;0;NTBK 245 G7 AMD Ryzen 5 3500U 8GB 1TB 14P;COMPUTACION
12475081;;F;48;CHILENO;;X;PROVIDENCIA                   ;METROPOLITANA;0;0;0;0;0;0;0;0;0;NTBK 245 G7 AMD Ryzen 5 3500U 8GB 1TB 14P;COMPUTACION
19862254;;M;24;CHILENO;;Silencioso;PROVIDENCIA                   ;METROPOLITANA;0;0;0;0;0;0;0;0;0;Impresora Laser HL-1202 Monocromatica;COMPUTACION
7061769;;F;67;CHILENO;;Boomers;PEDRO AGUIRRE CERDA           ;METROPOLITANA;0;0;0;0;0;0;0;0;0;Multifuncional DeskJet Ink Advantage 3775 Wifi;COMPUTACION
20307510;;M;22;CHILENO;;Z;PROVIDENCIA                   ;METROPOLITANA;0;0;0;0;0;0;0;0;0;IPAD WI-FI 32GB SILVER (MYLA2CI/A);COMPUTACION
15183164;Soltero;M;40;CHILENO;;Silencioso;PROVIDENCIA                   ;METROPOLITANA;0;0;0;0;0;0;0;0;0;NTBK 14-cf2051la i3-10110U 4GB 256GB+16GB 14 HD;COMPUTACION
17019954;;F;33;CHILENO;;Millenial;PROVIDENCIA                   ;METROPOLITANA;0;0;0;0;0;0;0;0;0;Multifuncional DeskJet Ink Advantage 3775 Wifi;COMPUTACION
19321883;Soltero;M;26;CHILENO;;Z;PROVIDENCIA                   ;METROPOLITANA;0;0;0;0;0;0;0;0;0;TAB MLAB MBX 8 QUAD CORE 1G+16G 8716;COMPUTACION
12639491;;F;48;CHILENO;;X;PROVIDENCIA                   ;METROPOLITANA;0;0;0;0;0;0;0;0;0;MULTIFUNCIONAL HP INK ADVANTAGE 3785/3775;COMPUTACION
13230181;Casado;F;44;CHILENO;;X;PEUMO                         ;L.G.B.OÂ´HIGGINS;0;0;0;0;0;0;0;0;0;NTBK 14-ck2091la i3-10110U 4GB 128GB 14 HD;COMPUTACION
14066926;;M;40;CHILENO;;Silencioso;PROVIDENCIA                   ;METROPOLITANA;0;0;0;0;0;0;0;0;0;NTBK 15-ek0008la Core i7 32+32GB 512SSD 2070 8GB;COMPUTACION
16695244;;F;34;CHILENO;;Millenial;N/D;N/D;0;0;0;0;0;0;0;0;0;TINTA 664 NEGRA;COMPUTACION
19139105;;M;27;CHILENO;;Millenial;LAS CONDES                    ;METROPOLITANA;0;0;0;0;0;0;0;0;0;TAB Galaxy Tab A 8 4Core 2GB 32GB 8 Negra;COMPUTACION
18785715;;M;27;CHILENO;;Millenial;PROVIDENCIA                   ;METROPOLITANA;0;0;0;0;0;0;0;0;0;MULTIFUNCIONAL ECOTANK L3150 Wifi;COMPUTACION
19832837;;M;24;CHILENO;;Z;PROVIDENCIA                   ;METROPOLITANA;0;0;0;0;0;0;0;0;0;TAB M8 4G QC 2GB 16GB 8P Gris;COMPUTACION
20198184;;M;23;CHILENO;;Z;N/D;N/D;0;0;0;0;0;0;0;0;0;NTBK 15-cw1006la Ryzen 7-3700U 8GB 512SSD 15P;COMPUTACION
18360527;Soltero;M;29;CHILENO;;Millenial;PROVIDENCIA                   ;METROPOLITANA;0;0;0;0;0;0;0;0;0;Multifuncional DCPT520W Wifi;COMPUTACION
18812163;;F;27;CHILENO;;Z;PROVIDENCIA                   ;METROPOLITANA;0;0;0;0;0;0;0;0;0;Multifuncional Smart Tank 515 Wifi;COMPUTACION
19351962;Soltero;F;26;CHILENO;;Z;PROVIDENCIA                   ;METROPOLITANA;0;0;0;0;0;0;0;0;0;TAB Galaxy Tab A 8 4Core 2GB 32GB 8 Negra;COMPUTACION
25656092;;M;39;VENEZOLANO;;Extranjero;SANTIAGO                      ;METROPOLITANA;0;0;0;0;0;0;0;0;0;TAB 7 MB4 Plus 4Core 1GB 16GB 7 Plata;COMPUTACION
10993381;;F;51;CHILENO;;X;RENCA                         ;METROPOLITANA;0;0;0;0;0;0;0;0;0;MULTIFUNCIONAL ECOTANK L3110;COMPUTACION
13065592;;M;46;CHILENO;;X;RENCA                         ;METROPOLITANA;0;0;0;0;0;0;0;0;0;Multifuncional DCPT220;COMPUTACION
19352310;Soltero;M;26;CHILENO;;Silencioso;PROVIDENCIA                   ;METROPOLITANA;0;0;0;0;0;0;0;0;0;NTBK 240 G7 Core i3-1005G1 4GB 1TB 14P;COMPUTACION
12549487;;M;48;CHILENO;;X;CHILLAN VIEJO                 ;BIO BIO;0;0;0;0;0;0;0;0;0;NTBK 14-dq1004la Core i5-1035G1 8GB 256SSD 14P;COMPUTACION
6971735;;F;68;CHILENO;;Boomers;TALCA                         ;MAULE;0;0;0;0;0;0;0;0;0;NTBK 14-dq1004la Core i5-1035G1 8GB 256SSD 14P;COMPUTACION
5511926;;F;77;CHILENO;;Silencioso;N/D;N/D;0;0;0;0;0;0;0;0;0;NTBK 240 G7 Core i3-1005G1 4GB 1TB 14P;COMPUTACION
4277087;;F;84;CHILENO;;Silencioso;CASTRO                        ;LOS LAGOS;0;0;0;0;0;0;0;0;0;AIO IC Athlon 3050U 4GB 1TB 21.5P;COMPUTACION
18835325;;F;28;CHILENO;;Millenial;PROVIDENCIA                   ;METROPOLITANA;0;0;0;0;0;0;0;0;0;MULTIFUNCIONAL ECOTANK L3150 Wifi;COMPUTACION
11732925;Soltero;M;50;CHILENO;;X;CATEMU                        ;VALPARAISO;0;0;0;0;0;0;0;0;0;TAB Galaxy Tab A+SPen 8Core 3GB 32GB 8 Gris;COMPUTACION
6914179;;M;69;CHILENO;;Silencioso;CASTRO                        ;LOS LAGOS;0;0;0;0;0;0;0;0;0;NTBK G7 240 Intel Celeron 4GB 500GB 14;COMPUTACION
16074030;;F;36;CHILENO;;Silencioso;PROVIDENCIA                   ;METROPOLITANA;0;0;0;0;0;0;0;0;0;MULTIFUNCIONAL ECOTANK L3110;COMPUTACION
16036199;;F;37;CHILENO;;Millenial;PROVIDENCIA                   ;METROPOLITANA;0;0;0;0;0;0;0;0;0;TAB GAMER 7 QUAD CORE 2G+16G 8715;COMPUTACION
14212866;;M;41;CHILENO;;X;CORONEL                       ;BIO BIO;0;0;0;0;0;0;0;0;0;Tab M10 Plus FHD 4GB 64GB 10.3P platinum grey;COMPUTACION
18710232;Soltero;M;28;CHILENO;TRABAJADOR SOCIAL;Millenial;PROVIDENCIA                   ;METROPOLITANA;0;0;0;0;0;0;0;0;0;Multifuncional Laser DCP-1602 Monocromatica;COMPUTACION
17024765;Soltero;M;33;CHILENO;;Silencioso;PROVIDENCIA                   ;METROPOLITANA;0;0;0;0;0;0;0;0;0;NTBK 14-CF3028LA OPP i51035G1 4GB 1TB 14 HDÂ W10;COMPUTACION
9517634;;F;62;CHILENO;;Boomers;N/D;N/D;0;0;0;0;0;0;0;0;0;NTBK G7 240 Intel Celeron 4GB 500GB 14;COMPUTACION
17774443;;F;30;CHILENO;;Millenial;COPIAPO                       ;ATACAMA;0;0;0;0;0;0;0;0;0;NTBK Ideapad 5i Core i5 11va 8GB 512GB 15P FHD;COMPUTACION
19228898;;F;26;CHILENO;;Z;PROVIDENCIA                   ;METROPOLITANA;0;0;0;0;0;0;0;0;0;MULTIFUNCIONAL ECOTANK L3110;COMPUTACION
18319926;;M;28;CHILENO;;Millenial;ANGOL                         ;ARAUCANIA;0;0;0;0;0;0;0;0;0;NTBK 14-dw0005la Core i7-1065G7 8GB 512SSD 14P;COMPUTACION
20168482;;F;22;CHILENO;;Z;PUNITAQUI                     ;COQUIMBO;0;0;0;0;0;0;0;0;0;NTBK S150 AMD A4-9120e 4GB 64GB eMMc 14P;COMPUTACION
17332036;;F;33;CHILENO;;Millenial;PARRAL                        ;MAULE;0;0;0;0;0;0;0;0;0;TAB Galaxy Tab A 8 4Core 2GB 32GB 8 Gris;COMPUTACION
18510446;Soltero;F;29;CHILENO;;Millenial;PROVIDENCIA                   ;METROPOLITANA;0;0;0;0;0;0;0;0;0;TAB Galaxy Tab A 8 4Core 2GB 32GB 8 Gris;COMPUTACION
16583464;;F;34;CHILENO;;Millenial;CAUQUENES                     ;MAULE;0;0;0;0;0;0;0;0;0;NTBK 14-dq1004la Core i5-1035G1 8GB 256SSD 14P;COMPUTACION
16677942;;M;34;CHILENO;;Millenial;"";"";0;0;0;0;0;0;0;0;0;Tablet HMS Matepad T10;COMPUTACION
19855346;;F;23;CHILENO;;Z;PROVIDENCIA                   ;METROPOLITANA;0;0;0;0;0;0;0;0;0;NTBK 14-CF3028LA OPP i51035G1 4GB 1TB 14 HDÂ W10;COMPUTACION
17637397;Soltero;M;31;CHILENO;TECNICO EN AUTOMATIZACION Y CONTROL INDUSTRIAL;Millenial;PROVIDENCIA                   ;METROPOLITANA;0;0;0;0;0;0;0;0;0;NTBK Ideapad S145 Celeron 4GB 500GB 14P;COMPUTACION
13087602;;F;46;CHILENO;;X;RENCA                         ;METROPOLITANA;0;0;0;0;0;0;0;0;0;NTBK 240 G7 Core i3-1005G1 4GB 1TB 14P;COMPUTACION
16511901;;F;35;CHILENO;;Millenial;ANGOL                         ;ARAUCANIA;0;0;0;0;0;0;0;0;0;TAB Matepad T8 wifi 2GB 16GB;COMPUTACION
12727204;;F;47;CHILENO;;X;CONSTITUCION                  ;MAULE;0;0;0;0;0;0;0;0;0;TAB Matepad 10.4;COMPUTACION
11964176;;F;50;CHILENO;;X;ARAUCO                        ;BIO BIO;0;0;0;0;0;0;0;0;0;TAB Galaxy Tab A 8 4Core 2GB 32GB 8 Gris;COMPUTACION
13350102;;M;44;CHILENO;;X;TENO                          ;MAULE;0;0;0;0;0;0;0;0;0;MULTIFUNCIONAL ECOTANK L3110;COMPUTACION
16927793;;M;34;CHILENO;;Millenial;ILLAPEL                       ;COQUIMBO;0;0;0;0;0;0;0;0;0;TAB Galaxy Tab A 8 4Core 2GB 32GB 8 Negra;COMPUTACION
15381103;;F;39;CHILENO;;X;PROVIDENCIA                   ;METROPOLITANA;0;0;0;0;0;0;0;0;0;NTBK Ideapad S145 Celeron 4GB 500GB 14P;COMPUTACION
9736197;;F;57;CHILENO;;Boomers;VILLA ALEGRE                  ;MAULE;0;0;0;0;0;0;0;0;0;MULTIFUNCIONAL ECOTANK L3150 Wifi;COMPUTACION
12198302;;M;50;CHILENO;;X;HUALPEN;BIO BIO;0;0;0;0;0;0;0;0;0;NTBK 240 G7 Core i3-1005G1 4GB 1TB 14P;COMPUTACION
10569450;;M;56;CHILENO;;Boomers;PROVIDENCIA                   ;METROPOLITANA;0;0;0;0;0;0;0;0;0;NTBK 15-cw1021la Ryzen 3-3300U 12GB 256SSD 15P;COMPUTACION
8883809;;M;60;CHILENO;;Boomers;COLINA                        ;METROPOLITANA;0;0;0;0;0;0;0;0;0;NTBK Ideapad S145 Celeron 4GB 500GB 14P;COMPUTACION
17190240;;M;32;CHILENO;;Millenial;PROVIDENCIA                   ;METROPOLITANA;0;0;0;0;0;0;0;0;0;TAB MBXR 8717 4Core 2GB 16GB 10 Negra;COMPUTACION
18988814;Soltero;F;27;CHILENO;;Z;RENCA                         ;METROPOLITANA;0;0;0;0;0;0;0;0;0;MULTIFUNCIONAL ECOTANK L3110;COMPUTACION
19113180;;M;26;CHILENO;;Z;MAIPU                         ;METROPOLITANA;0;0;0;0;0;0;0;0;0;NTBK GF63 10SCSR Core i5 8GB 512SSD 1650Ti 4GB;COMPUTACION
10242577;;M;56;CHILENO;;Boomers;DALCAHUE                      ;LOS LAGOS;0;0;0;0;0;0;0;0;0;MULTIFUNCIONAL ECOTANK L3110;COMPUTACION
11497925;;F;53;CHILENO;;X;PROVIDENCIA                   ;METROPOLITANA;0;0;0;0;0;0;0;0;0;NTBK 15-cw1021la Ryzen 3-3300U 12GB 256SSD 15P;COMPUTACION
19437482;;M;25;CHILENO;;Z;PUERTO MONTT                  ;LOS LAGOS;0;0;0;0;0;0;0;0;0;TAB MLAB 7 MB4 PLUS 3G 1+16GB WHITE 8762;COMPUTACION
12175084;;F;50;CHILENO;;Millenial;PROVIDENCIA                   ;METROPOLITANA;0;0;0;0;0;0;0;0;0;NTBK 15-cw1021la Ryzen 3-3300U 12GB 256SSD 15P;COMPUTACION
20299338;;F;22;CHILENO;;Z;PROVIDENCIA                   ;METROPOLITANA;0;0;0;0;0;0;0;0;0;TINTA EPSON T504 NG BOTELLA C13T03N12A;COMPUTACION
13373841;;F;43;CHILENO;;X;CAUQUENES                     ;MAULE;0;0;0;0;0;0;0;0;0;NTBK IP3 Ryzen 3-3250U/8GB/1TB/15P;COMPUTACION
7792440;;F;69;CHILENO;;Silencioso;MELIPILLA                     ;METROPOLITANA;0;0;0;0;0;0;0;0;0;NTBK S150 AMD A4-9120e 4GB 64GB eMMc 14P;COMPUTACION
8761319;;M;62;CHILENO;;Boomers;CALAMA                        ;ANTOFAGASTA;0;0;0;0;0;0;0;0;0;TAB GAMER 7 QUAD CORE 2G+16G 8715;COMPUTACION
15231195;Soltero;M;39;CHILENO;;X;PROVIDENCIA                   ;METROPOLITANA;0;0;0;0;0;0;0;0;0;TAB MBXR 8717 4Core 2GB 16GB 10 Negra;COMPUTACION
15850222;Soltero;F;37;CHILENO;;Millenial;PROVIDENCIA                   ;METROPOLITANA;0;0;0;0;0;0;0;0;0;TAB Galaxy Tab A 8 4Core 2GB 32GB 8 Negra;COMPUTACION
17747095;Soltero;M;31;CHILENO;;Millenial;PROVIDENCIA                   ;METROPOLITANA;0;0;0;0;0;0;0;0;0;TAB M7 QC 1GB 8GB 7P Gris;COMPUTACION
8037641;Casado;M;65;CHILENO;CONSTRUCTOR CIVIL;Boomers;PANGUIPULLI                   ;LOS RIOS;0;0;0;0;0;0;0;0;0;NTBK 15-cw1021la Ryzen 3-3300U 12GB 256SSD 15P;COMPUTACION
17650147;;M;32;CHILENO;;Millenial;QUILPUE                       ;VALPARAISO;0;0;0;0;0;0;0;0;0;NTBK 15-dk0007la Core i7 16GB 1TB+128 1660ti 6GB;COMPUTACION
16600277;;M;34;CHILENO;;Millenial;PROVIDENCIA                   ;METROPOLITANA;0;0;0;0;0;0;0;0;0;NTBK Matebook D14 AMD Ryzen 5 8GB 512SSD 14P;COMPUTACION
13956922;;M;41;CHILENO;;X;N/D;N/D;0;0;0;0;0;0;0;0;0;TAB Galaxy Tab A 8 4Core 2GB 32GB 8 Gris;COMPUTACION
17847851;;F;30;CHILENO;;Silencioso;N/D;N/D;0;0;0;0;0;0;0;0;0;NTBK S150 AMD A4-9120e 4GB 64GB eMMc 14P;COMPUTACION
10377547;;M;57;CHILENO;;Boomers;COLTAUCO                      ;L.G.B.OÂ´HIGGINS;0;0;0;0;0;0;0;0;0;TAB Galaxy Tab A 8 4Core 2GB 32GB 8 Negra;COMPUTACION
17653830;Soltero;F;31;CHILENO;;Millenial;PROVIDENCIA                   ;METROPOLITANA;0;0;0;0;0;0;0;0;0;TAB Matepad T10S 3GB 64GB 10P;COMPUTACION
10074791;;F;55;CHILENO;;Boomers;RENCA                         ;METROPOLITANA;0;0;0;0;0;0;0;0;0;TAB M8 QC 2GB 32GB 8P Gris;COMPUTACION
13953592;;M;41;CHILENO;;X;GRANEROS                      ;L.G.B.OÂ´HIGGINS;0;0;0;0;0;0;0;0;0;MULTIFUNCIONAL ECOTANK L3110;COMPUTACION
10346142;;M;57;CHILENO;;Boomers;RANCAGUA                      ;L.G.B.OÂ´HIGGINS;0;0;0;0;0;0;0;0;0;MULTIFUNCIONAL ECOTANK L3110;COMPUTACION
24494118;;F;45;HAITIANO;;Extranjero;QUILICURA                     ;METROPOLITANA;0;0;0;0;0;0;0;0;0;TAB 7 MB4 Plus 4Core 1GB 16GB 7 Negra;COMPUTACION
19728997;;F;24;CHILENO;;Z;LIMACHE                       ;VALPARAISO;0;0;0;0;0;0;0;0;0;NTBK 15-cw1021la Ryzen 3-3300U 12GB 256SSD 15P;COMPUTACION
15886679;;F;38;CHILENO;;Millenial;"";"";0;0;0;0;0;0;0;0;0;TAB Matepad T8 Wifi 2GB 32GB 8P;COMPUTACION
12248387;;F;50;CHILENO;;Silencioso;PROVIDENCIA                   ;METROPOLITANA;0;0;0;0;0;0;0;0;0;IMPRESORA EPSON L120;COMPUTACION
12660031;;M;48;CHILENO;;X;MELIPILLA                     ;METROPOLITANA;0;0;0;0;0;0;0;0;0;TAB Galaxy Tab A 8 4Core 2GB 32GB 8 Gris;COMPUTACION
8033801;;M;63;CHILENO;;Boomers;PROVIDENCIA                   ;METROPOLITANA;0;0;0;0;0;0;0;0;0;NTBK IP3 Athlon 3050U/4GB/500GB/15P;COMPUTACION
9143467;;M;57;CHILENO;;Boomers;RENCA                         ;METROPOLITANA;0;0;0;0;0;0;0;0;0;NTBK A315-42-R0W1-1 Ryzen 7-3700U 8GB 256SSD 15P;COMPUTACION
13725544;;M;42;CHILENO;;X;PROVIDENCIA                   ;METROPOLITANA;0;0;0;0;0;0;0;0;0;NTBK IP3 Ryzen 3-3250U/8GB/1TB/15P;COMPUTACION
13831578;;M;41;CHILENO;;X;RENCA                         ;METROPOLITANA;0;0;0;0;0;0;0;0;0;NTBK A315-42-R0W1-1 Ryzen 7-3700U 8GB 256SSD 15P;COMPUTACION
26345983;;M;30;"";;Extranjero;PROVIDENCIA                   ;METROPOLITANA;0;0;0;0;0;0;0;0;0;TABLET 7 4G LTE 8930;COMPUTACION
16819007;;M;34;CHILENO;;Millenial;QUILLOTA                      ;VALPARAISO;0;0;0;0;0;0;0;0;0;NTBK Gaming 3 Ryzen 5 4600H 8GB 512SSD G1650 4GB;COMPUTACION
14504496;;F;46;CHILENO;;X;RENCA                         ;METROPOLITANA;0;0;0;0;0;0;0;0;0;TAB Matepad T8 Wifi 2GB 32GB 8P;COMPUTACION
6570446;;F;74;CHILENO;;Silencioso;SALAMANCA                     ;COQUIMBO;0;0;0;0;0;0;0;0;0;NTBK 15-ek0010la Core i5 8+32 512SSD 2060 6GB;COMPUTACION
5353083;;M;76;CHILENO;;Silencioso;SANTA MARIA                   ;VALPARAISO;0;0;0;0;0;0;0;0;0;Galaxy Tab A7 (10.4 ,32GB, WIFI) Silver;COMPUTACION
15740265;;M;39;CHILENO;;X;PROVIDENCIA                   ;METROPOLITANA;0;0;0;0;0;0;0;0;0;TAB Galaxy Tab A 8 4Core 2GB 32GB 8 Gris;COMPUTACION
12121666;;F;42;CHILENO;;X;PROVIDENCIA                   ;METROPOLITANA;0;0;0;0;0;0;0;0;0;TAB Galaxy Tab A+SPen 8Core 3GB 32GB 8 Gris;COMPUTACION
12736797;;M;46;CHILENO;;X;VICTORIA                      ;ARAUCANIA;0;0;0;0;0;0;0;0;0;TAB MBXR 8717 4Core 2GB 16GB 10 Negra;COMPUTACION
15771068;;M;38;CHILENO;;Millenial;PROVIDENCIA                   ;METROPOLITANA;0;0;0;0;0;0;0;0;0;TAB M5 Lite Octa Core 32GB 10P FHD;COMPUTACION
18781136;;F;27;CHILENO;;Millenial;SANTIAGO                      ;METROPOLITANA;0;0;0;0;0;0;0;0;0;NTBK A315-42-R0W1-1 Ryzen 7-3700U 8GB 256SSD 15P;COMPUTACION
14437664;;M;50;CHILENO;;Silencioso;BUIN                          ;METROPOLITANA;0;0;0;0;0;0;0;0;0;NTBK IP3 Ryzen 3-3250U/8GB/1TB/15P;COMPUTACION
12704341;Casado;F;48;CHILENO;;X;RENCA                         ;METROPOLITANA;0;0;0;0;0;0;0;0;0;Tablet HMS Matepad T10;COMPUTACION
20140664;;F;23;CHILENO;;Z;PROVIDENCIA                   ;METROPOLITANA;0;0;0;0;0;0;0;0;0;TABLET MLAB 7 MB4 PLUS 1+16GB RED;COMPUTACION
9276174;;F;55;CHILENO;;Boomers;RENCA                         ;METROPOLITANA;0;0;0;0;0;0;0;0;0;TAB MBXR 8717 4Core 2GB 16GB 10 Negra;COMPUTACION
9088295;;M;59;CHILENO;;Boomers;SAN PEDRO DE LA PAZ           ;BIO BIO;0;0;0;0;0;0;0;0;0;TAB MLAB MBX 8 QUAD CORE 1G+16G 8716;COMPUTACION
11635706;;M;51;CHILENO;;X;RENCA                         ;METROPOLITANA;0;0;0;0;0;0;0;0;0;MULTIFUNCIONAL MFC-T910 Wifi/ ADF / DUPLEX;COMPUTACION
14012450;;F;41;CHILENO;;X;RENCA                         ;METROPOLITANA;0;0;0;0;0;0;0;0;0;TAB M7 QC 1GB 8GB 7P Gris;COMPUTACION
12030336;;F;50;CHILENO;;X;RENCA                         ;METROPOLITANA;0;0;0;0;0;0;0;0;0;NTBK IP3 Ryzen 3-3250U/8GB/1TB/15P;COMPUTACION
15227205;;F;40;CHILENO;;X;PROVIDENCIA                   ;METROPOLITANA;0;0;0;0;0;0;0;0;0;TAB Galaxy Tab A+SPen 8Core 3GB 32GB 8 Gris;COMPUTACION
16149799;;M;37;CHILENO;;Millenial;MAIPU                         ;METROPOLITANA;0;0;0;0;0;0;0;0;0;NTBK IP3 Athlon 3050U/4GB/500GB/15P;COMPUTACION
7413230;;M;64;CHILENO;;Boomers;LA REINA                      ;METROPOLITANA;0;0;0;0;0;0;0;0;0;TABLET MLAB 7 MB4 PLUS 1+16GB RED;COMPUTACION
14602454;;F;40;CHILENO;;X;PROVIDENCIA                   ;METROPOLITANA;0;0;0;0;0;0;0;0;0;MULTIFUNCIONAL ECOTANK L3150 Wifi;COMPUTACION
19555857;;M;25;CHILENO;;Z;VILLARICA                     ;ARAUCANIA;0;0;0;0;0;0;0;0;0;TAB MediaPad T5 10 3GB 32GB 10.1P Azul;COMPUTACION
18499922;;M;28;CHILENO;;Millenial;SANTIAGO                      ;METROPOLITANA;0;0;0;0;0;0;0;0;0;TAB Galaxy Tab A 8 4Core 2GB 32GB 8 Negra;COMPUTACION
25298614;;M;35;VENEZOLANO;;Extranjero;QUINTA NORMAL                 ;METROPOLITANA;0;0;0;0;0;0;0;0;0;Tab M10 Plus FHD 4GB 64GB 10.3P platinum grey;COMPUTACION
17131531;;M;33;CHILENO;;Millenial;PROVIDENCIA                   ;METROPOLITANA;0;0;0;0;0;0;0;0;0;TAB 7 MB4 Plus 4Core 1GB 16GB 7 Plata;COMPUTACION
10779165;;M;59;CHILENO;;Boomers;PROVIDENCIA                   ;METROPOLITANA;0;0;0;0;0;0;0;0;0;TAB 7 MB4 PLUS 3G 1+16GB BLACK 8761;COMPUTACION
11661995;;M;52;CHILENO;;X;PROVIDENCIA                   ;METROPOLITANA;0;0;0;0;0;0;0;0;0;TAB M8 QC 2GB 32GB 8P Gris;COMPUTACION
17336468;Soltero;M;33;CHILENO;;Millenial;PROVIDENCIA                   ;METROPOLITANA;0;0;0;0;0;0;0;0;0;NTBK IP3 Athlon 3050U/4GB/500GB/15P;COMPUTACION
15239533;;M;40;CHILENO;;X;PROVIDENCIA                   ;METROPOLITANA;0;0;0;0;0;0;0;0;0;MULTIFUNCIONAL DCP-T510 Wifi;COMPUTACION
16206317;;F;36;CHILENO;;Millenial;CASTRO                        ;LOS LAGOS;0;0;0;0;0;0;0;0;0;TAB M8 4G QC 2GB 16GB 8P Gris;COMPUTACION
9662011;;F;60;CHILENO;;Boomers;CORONEL                       ;BIO BIO;0;0;0;0;0;0;0;0;0;NTBK 14-dw0005la Core i7-1065G7 8GB 512SSD 14P;COMPUTACION
11899081;;F;51;CHILENO;;X;CONCEPCION                    ;BIO BIO;0;0;0;0;0;0;0;0;0;MULTIFUNCIONAL ECOTANK L4160 Wifi;COMPUTACION
18393832;Soltero;M;29;CHILENO;;Millenial;PROVIDENCIA                   ;METROPOLITANA;0;0;0;0;0;0;0;0;0;TAB Galaxy Tab A 10.1 8Core 2GB 32GB 10 Negra;COMPUTACION
12712214;;F;52;CHILENO;;X;N/D;N/D;0;0;0;0;0;0;0;0;0;NTBK IP3 Athlon 3050U/4GB/500GB/15P;COMPUTACION
12654681;;M;48;CHILENO;;X;PROVIDENCIA                   ;METROPOLITANA;0;0;0;0;0;0;0;0;0;TAB Matepad T8 wifi 2GB 16GB;COMPUTACION
16368769;Soltero;F;35;CHILENO;;Millenial;PROVIDENCIA                   ;METROPOLITANA;0;0;0;0;0;0;0;0;0;TAB M8 QC 2GB 32GB 8P Gris;COMPUTACION
8552375;;M;64;CHILENO;;Boomers;MONTE PATRIA                  ;COQUIMBO;0;0;0;0;0;0;0;0;0;MULTIFUNCIONAL DCP-T710W Wifi/ ADF;COMPUTACION
14353429;;M;43;CHILENO;;X;TALCAHUANO                    ;BIO BIO;0;0;0;0;0;0;0;0;0;TAB 7 MB4 Plus 4Core 1GB 16GB 7 Plata;COMPUTACION
12764250;;M;46;CHILENO;;X;N/D;N/D;0;0;0;0;0;0;0;0;0;MULTIFUNCIONAL DCP-T510 Wifi;COMPUTACION
18898225;;M;27;CHILENO;;Millenial;ALTO HOSPICIO;TARAPACA;0;0;0;0;0;0;0;0;0;TAB MediaPad T5 10 3GB 32GB 10.1P Azul;COMPUTACION
13225077;;M;45;CHILENO;;X;SAN ANTONIO                   ;VALPARAISO;0;0;0;0;0;0;0;0;0;NTBK 15-cw1020la Ryzen 5-3500U 8GB 256GB 15P;COMPUTACION
13478423;Casado;M;44;CHILENO;;X;PROVIDENCIA                   ;METROPOLITANA;0;0;0;0;0;0;0;0;0;TAB M8 QC 2GB 32GB 8P Gris;COMPUTACION
5782430;;F;70;CHILENO;;Silencioso;PROVIDENCIA                   ;METROPOLITANA;0;0;0;0;0;0;0;0;0;NTBK HP 15-da0082la Pentium 4GB 500GB 15P;COMPUTACION
15713358;;M;38;CHILENO;;Millenial;PROVIDENCIA                   ;METROPOLITANA;0;0;0;0;0;0;0;0;0;NTBK 15-dw1051la Core i5-10210U 8GB 256SSD 15P;COMPUTACION
16094226;;F;36;CHILENO;;Millenial;PROVIDENCIA                   ;METROPOLITANA;0;0;0;0;0;0;0;0;0;TAB Matepad 10.4;COMPUTACION
17165249;;F;33;CHILENO;;Millenial;QUILPUE                       ;VALPARAISO;0;0;0;0;0;0;0;0;0;TAB 7 MB4 Plus 4Core 1GB 16GB 7 Plata;COMPUTACION
18872328;;M;28;CHILENO;;Millenial;PADRE LAS CASAS               ;ARAUCANIA;0;0;0;0;0;0;0;0;0;NTBK IP3 Athlon 3050U/4GB/500GB/15P;COMPUTACION
16469017;;F;35;CHILENO;;Millenial;ARICA                         ;TARAPACA;0;0;0;0;0;0;0;0;0;NTBK IP S340 Core I5-1035G4 4GB 256GB SSD 14P;COMPUTACION
13217856;;M;45;CHILENO;;X;RENCA                         ;METROPOLITANA;0;0;0;0;0;0;0;0;0;TAB Galaxy Tab A 8 4Core 2GB 32GB 8 Gris;COMPUTACION
17853411;;F;31;CHILENO;;Millenial;N/D;N/D;0;0;0;0;0;0;0;0;0;NTBK IP S145 AMD A4-9125/4GB/500GB/14P;COMPUTACION
13343324;;M;44;CHILENO;;X;PROVIDENCIA                   ;METROPOLITANA;0;0;0;0;0;0;0;0;0;MULTIFUNCIONAL ECOTANK L3110;COMPUTACION
10636901;;F;57;CHILENO;;Boomers;QUINTA DE TILCOCO             ;L.G.B.OÂ´HIGGINS;0;0;0;0;0;0;0;0;0;TAB 7 MB4 Plus 4Core 1GB 16GB 7 Plata;COMPUTACION
19287582;Soltero;F;27;CHILENO;MATRONA;Z;PROVIDENCIA                   ;METROPOLITANA;0;0;0;0;0;0;0;0;0;TAB M5 Lite Octa Core 32GB 10P FHD;COMPUTACION
17751681;;M;31;CHILENO;;Millenial;VILLA ALEMANA                 ;VALPARAISO;0;0;0;0;0;0;0;0;0;TAB Galaxy Tab A 8 4Core 2GB 32GB 8 Negra;COMPUTACION
4826003;;F;77;CHILENO;;Silencioso;PUENTE ALTO                   ;METROPOLITANA;0;0;0;0;0;0;0;0;0;IMPRESORA LASER 107a;COMPUTACION
16786625;;F;34;CHILENO;;Millenial;N/D;N/D;0;0;0;0;0;0;0;0;0;TAB 7 MB4 Plus 4Core 1GB 16GB 7 Negra;COMPUTACION
26306013;;M;27;HAITIANO;;Extranjero;SAN FELIPE                    ;VALPARAISO;0;0;0;0;0;0;0;0;0;NTBK G7 240 Intel Celeron 4GB 500GB 14;COMPUTACION
10652298;;M;55;CHILENO;;Boomers;PROVIDENCIA                   ;METROPOLITANA;0;0;0;0;0;0;0;0;0;MULTIFUNCIONAL ECOTANK L3150 Wifi;COMPUTACION
15898327;;F;38;CHILENO;;Millenial;PROVIDENCIA                   ;METROPOLITANA;0;0;0;0;0;0;0;0;0;Multifuncional Ink Tank 315;COMPUTACION
15145322;;F;40;CHILENO;;X;PROVIDENCIA                   ;METROPOLITANA;0;0;0;0;0;0;0;0;0;NTBK G7 240 Intel Celeron 4GB 500GB 14;COMPUTACION
12550411;;F;48;CHILENO;;X;CHILLAN                       ;BIO BIO;0;0;0;0;0;0;0;0;0;NTBK IP3 Ryzen 3-3250U/8GB/1TB/15P;COMPUTACION
13731032;;F;43;CHILENO;;X;PROVIDENCIA                   ;METROPOLITANA;0;0;0;0;0;0;0;0;0;TAB Galaxy Tab A+SPen 8Core 3GB 32GB 8 Gris;COMPUTACION
7253556;Casado;M;61;CHILENO;;Boomers;COPIAPO                       ;ATACAMA;0;0;0;0;0;0;0;0;0;MULTIFUNCIONAL ECOTANK L3160 Wifi;COMPUTACION
16779156;;M;34;CHILENO;;Millenial;ANCUD                         ;LOS LAGOS;0;0;0;0;0;0;0;0;0;TAB M7 QC 1GB 8GB 7P Gris;COMPUTACION
18808055;Soltero;M;28;CHILENO;;Millenial;PROVIDENCIA                   ;METROPOLITANA;0;0;0;0;0;0;0;0;0;NTBK 15-ek0010la Core i5 8+32 512SSD 2060 6GB;COMPUTACION
15906628;;M;38;CHILENO;;Millenial;TALCA                         ;MAULE;0;0;0;0;0;0;0;0;0;NTBK 14-DQ1001 Core i3-1005G1 4+16 256SSD 14;COMPUTACION
13688345;Soltero;F;42;CHILENO;;X;SANTIAGO                      ;METROPOLITANA;0;0;0;0;0;0;0;0;0;TAB 7 MB4 Plus 4Core 1GB 16GB 7 Plata;COMPUTACION
16000081;Casado;F;37;CHILENO;DISENADOR GRAFICO;Millenial;PROVIDENCIA                   ;METROPOLITANA;0;0;0;0;0;0;0;0;0;MULTIFUNCIONAL ECOTANK L3110;COMPUTACION
8957049;;M;53;CHILENO;;X;SANTIAGO                      ;METROPOLITANA;0;0;0;0;0;0;0;0;0;MULTIFUNCIONAL ECOTANK L3150 Wifi;COMPUTACION
8471729;;F;64;CHILENO;;Boomers;CALERA                        ;VALPARAISO;0;0;0;0;0;0;0;0;0;NTBK 14-DQ1001 Core i3-1005G1 4+16 256SSD 14;COMPUTACION
6824895;Soltero;F;63;CHILENO;;Boomers;PROVIDENCIA                   ;METROPOLITANA;0;0;0;0;0;0;0;0;0;MULTIFUNCIONAL ECOTANK L3150 Wifi;COMPUTACION
6427407;;F;66;CHILENO;;Boomers;CURICO                        ;MAULE;0;0;0;0;0;0;0;0;0;NTBK 240 G7 Core i3-1005G1 4GB 1TB 14P;COMPUTACION
19370081;Soltero;F;26;CHILENO;;Z;PROVIDENCIA                   ;METROPOLITANA;0;0;0;0;0;0;0;0;0;MULTIFUNCIONAL ECOTANK L3110;COMPUTACION
10327446;;F;49;CHILENO;;X;"";"";0;0;0;0;0;0;0;0;0;TAB 7 MB4 Plus 4Core 1GB 16GB 7 Plata;COMPUTACION
7261996;;F;65;CHILENO;;Boomers;VICTORIA                      ;ARAUCANIA;0;0;0;0;0;0;0;0;0;TAB Galaxy Tab A 10.1 8Core 2GB 32GB 10 Negra;COMPUTACION
5892072;;F;72;CHILENO;;Silencioso;TEMUCO                        ;ARAUCANIA;0;0;0;0;0;0;0;0;0;AIO 20-c421la CeleroN 4 GB 1TB Windows;COMPUTACION
18765198;;F;27;CHILENO;;Z;PROVIDENCIA                   ;METROPOLITANA;0;0;0;0;0;0;0;0;0;NTBK 14-ds002la AMD A4 4GB 64GB eMMC 14P;COMPUTACION
17216038;;F;33;CHILENO;;Millenial;"";"";0;0;0;0;0;0;0;0;0;MULTIFUNCIONAL ECOTANK L3110;COMPUTACION
14338888;Soltero;F;45;CHILENO;;X;RENCA                         ;METROPOLITANA;0;0;0;0;0;0;0;0;0;TAB Galaxy Tab A 8 4Core 2GB 32GB 8 Gris;COMPUTACION
14462028;;M;44;CHILENO;;X;ARICA                         ;TARAPACA;0;0;0;0;0;0;0;0;0;NTBK 15-gw0016la AMD Athlon 8GB 256GBSSD 15P;COMPUTACION
15654880;Divorciado;M;38;CHILENO;INGENIERO COMERCIAL;Millenial;PROVIDENCIA                   ;METROPOLITANA;0;0;0;0;0;0;0;0;0;MULTIFUNCIONAL ECOTANK L3150 Wifi;COMPUTACION
23900471;;F;52;COLOMBIANO;;Extranjero;INDEPENDENCIA                 ;METROPOLITANA;0;0;0;0;0;0;0;0;0;TAB Galaxy Tab A 8 4Core 2GB 32GB 8 Gris;COMPUTACION
11133916;;M;55;CHILENO;;Boomers;RENCA                         ;METROPOLITANA;0;0;0;0;0;0;0;0;0;MULTIFUNCIONAL ECOTANK L3150 Wifi;COMPUTACION
16479174;;M;35;CHILENO;;Millenial;MAIPU                         ;METROPOLITANA;0;0;0;0;0;0;0;0;0;NTBK HP 14-cf0011la Ci3-8130U 4GB 128SSD 14P;COMPUTACION
6141935;;M;69;CHILENO;;Silencioso;HUALAIHUE                     ;LOS LAGOS;0;0;0;0;0;0;0;0;0;NTBK 15-gw0016la AMD Athlon 8GB 256GBSSD 15P;COMPUTACION
17082087;;F;36;CHILENO;;Millenial;MELIPILLA                     ;METROPOLITANA;0;0;0;0;0;0;0;0;0;TAB Galaxy Tab A 10.1 4G 8Core 2GB 32GB 10 Gold;COMPUTACION
8323917;;M;63;CHILENO;;Boomers;RENCA                         ;METROPOLITANA;0;0;0;0;0;0;0;0;0;NTBK G7 240 Intel Celeron 4GB 500GB 14;COMPUTACION
16869786;;F;34;CHILENO;;Millenial;ALTO HOSPICIO;TARAPACA;0;0;0;0;0;0;0;0;0;T544 DYE BLACK INK BOTTLE (65ml);COMPUTACION
16863442;;M;34;CHILENO;;Millenial;PROVIDENCIA                   ;METROPOLITANA;0;0;0;0;0;0;0;0;0;NTBK 240 G7 Core i3-1005G1 4GB 1TB 14P;COMPUTACION
15433560;;M;40;CHILENO;;X;MAIPU                         ;METROPOLITANA;0;0;0;0;0;0;0;0;0;TAB Matepad T8 wifi 2GB 16GB;COMPUTACION
16864870;;M;34;CHILENO;;Millenial;PROVIDENCIA                   ;METROPOLITANA;0;0;0;0;0;0;0;0;0;NTBK 245 A4-9125 4GB 500GB 14;COMPUTACION
16150194;;F;36;CHILENO;;Millenial;PROVIDENCIA                   ;METROPOLITANA;0;0;0;0;0;0;0;0;0;TAB MediaPad T5 10 3GB 32GB 10.1P Azul;COMPUTACION
15932111;;M;36;CHILENO;;Millenial;PROVIDENCIA                   ;METROPOLITANA;0;0;0;0;0;0;0;0;0;NTBK HP 14-cf0011la Ci3-8130U 4GB 128SSD 14P;COMPUTACION
15537497;Soltero;F;39;CHILENO;CONTADOR AUDITOR;X;PROVIDENCIA                   ;METROPOLITANA;0;0;0;0;0;0;0;0;0;NTBK 14-dq1004la Core i5-1035G1 8GB 256SSD 14P;COMPUTACION
18640319;Soltero;F;28;CHILENO;;Millenial;PROVIDENCIA                   ;METROPOLITANA;0;0;0;0;0;0;0;0;0;TAB S6 Lite (610) 4GB 64GB 10.4P PINK;COMPUTACION
18400373;;F;29;CHILENO;;Millenial;CALAMA;ANTOFAGASTA;124980;2;1;2;1;124980;0;0;0;MUEBLE DE COCINA KITCHEN 90 - BLANCO / WENGUE;MERCADO ABC
26462686;;M;30;VENEZOLANO;;Extranjero;N/D;N/D;138980;2;3;2;3;138980;0;0;0;Parrilla Boston 3Quemadores+Quem. Lateral;MERCADO ABC
12665927;;M;48;CHILENO;;X;"";"";99920;8;3;8;3;99920;0;0;0;Set destornilladores 6pzas TOTAL;MERCADO ABC
18288478;;F;29;CHILENO;;Millenial;PUERTO MONTT;LOS LAGOS;64980;2;1;2;1;64980;0;0;0;MESA DE CENTRO RM01 RETRO NICHOS;MERCADO ABC
18961812;;M;27;CHILENO;;Millenial;VILLA ALEMANA                 ;VALPARAISO;125960;3;1;3;1;125960;0;0;0;OPTIMIZADOR BATH 161 - BLANCO OLB 4281;MERCADO ABC
25938399;Soltero;M;47;EXTRANJERO - NO INFORMA NACIONALIDAD;;Extranjero;PROVIDENCIA                   ;METROPOLITANA;53980;2;1;2;1;53980;0;0;0;OPTIMIZADOR LAVAMANOS BATH 47-A - BLANCO MLB 106;MERCADO ABC
16942062;;F;33;CHILENO;;Millenial;PROVIDENCIA                   ;METROPOLITANA;279980;2;1;2;1;279980;0;0;0;BUFFET IRON MOSAICO;MERCADO ABC
7465975;;F;63;CHILENO;;Boomers;CONCEPCION                    ;BIO BIO;116980;2;1;0;0;0;2;1;116980;Coche Travel Sienna Gris;MERCADO ABC
16032717;;F;37;CHILENO;;Millenial;"";"";598950;5;3;4;2;545960;1;1;52990;SECCIONAL INTERCAMBIABLE DONATO PU ENVEJECIDO;MERCADO ABC
15099889;;F;40;CHILENO;;X;HUALPEN;BIO-BIO;65970;3;1;3;1;65970;0;0;0;MESA DE CENTRO LUZ PEROLA - CARAMELO FVTX;MERCADO ABC
24295981;Soltero;M;34;COLOMBIANO;;Extranjero;PROVIDENCIA                   ;METROPOLITANA;515960;4;3;3;2;508970;1;1;6990;Comedor Campo 4 sillas Madera Maciza Canela 100x;MERCADO ABC
17243570;Soltero;F;33;CHILENO;;Millenial;VALDIVIA                      ;LOS LAGOS;237460;4;2;4;2;237460;0;0;0;Alfombra Frise Manhattan 3D 160x230 Farum;MERCADO ABC
27130921;;M;30;VENEZOLANO;;Extranjero;PROVIDENCIA                   ;METROPOLITANA;1804270;13;5;4;2;1351970;9;3;452300;Coche Travel System Modesck SOMERD;MERCADO ABC
18200693;;F;29;CHILENO;;Millenial;PADRE HURTADO                 ;METROPOLITANA;98980;2;1;2;1;98980;0;0;0;Taladro Inalambrico 2 Velocidades 18v Li-Ion;MERCADO ABC
16904547;;M;34;CHILENO;;Millenial;CAUQUENES                     ;MAULE;46980;2;1;2;1;46980;0;0;0;CASA PARA PERRO PEQUENA TECHO VERDE RIMAX;MERCADO ABC
14117589;;F;42;CHILENO;;X;LA SERENA                     ;COQUIMBO;126980;2;1;2;1;126980;0;0;0;MESA COMEDOR TORINO 2 - HABANO MLH 3805;MERCADO ABC
26285972;;M;54;VENEZOLANO;;Extranjero;CURICO                        ;MAULE;339490;13;3;10;2;174400;3;1;165090;Sabana Polar Est. 1.5 P Parati;MERCADO ABC
18982721;Soltero;M;27;CHILENO;ABOGADO;Z;PROVIDENCIA                   ;METROPOLITANA;69940;6;3;5;2;59950;1;1;9990;OLLA PRESION AVANT ALUMN 6 LTS. ALUMN;MERCADO ABC
13445490;;M;44;CHILENO;;X;PROVIDENCIA                   ;METROPOLITANA;31980;2;1;2;1;31980;0;0;0;CORREPASILLO ROJO CON TOLDO Y LUCES;MERCADO ABC
17879312;;F;30;CHILENO;;Millenial;PROVIDENCIA                   ;METROPOLITANA;33980;2;1;2;1;33980;0;0;0;MUEBLE MICROONDAS ESTRELLA BLANCO FVTX;MERCADO ABC
14197582;;F;40;CHILENO;;Silencioso;PROVIDENCIA                   ;METROPOLITANA;265960;3;1;3;1;265960;0;0;0;SOFA 3 CUERPOS AMAPOLA GRIS OSCURO;MERCADO ABC
17861148;;M;31;CHILENO;;Millenial;ANTOFAGASTA                   ;ANTOFAGASTA;125980;2;1;2;1;125980;0;0;0;RACK PARA TV BELLAGIO CON PUERTAS;MERCADO ABC
19021692;;F;27;CHILENO;;Z;N/D;N/D;69960;3;3;3;3;69960;0;0;0;UKELELE FD-XU23;MERCADO ABC
18032689;;F;30;CHILENO;;Millenial;N/D;N/D;123980;2;1;2;1;123980;0;0;0;S AUTO REVOII HB28 NEGRA;MERCADO ABC
18095783;;F;30;CHILENO;;Millenial;SANTIAGO                      ;METROPOLITANA;11980;2;1;2;1;11980;0;0;0;Pelota Pilates Yoga 75 cm Gris + Inflador;MERCADO ABC
9743689;;M;59;CHILENO;;Boomers;QUILICURA                     ;METROPOLITANA;423960;4;2;4;2;423960;0;0;0;Trotadora Electrica Baldini 1,5HP;MERCADO ABC
7844224;;F;63;CHILENO;;Boomers;LA FLORIDA                    ;METROPOLITANA;162940;6;3;6;3;162940;0;0;0;Coche Twister Azul5224SX;MERCADO ABC
11896730;Casado;M;50;CHILENO;;X;PROVIDENCIA                   ;METROPOLITANA;99980;2;1;2;1;99980;0;0;0;ESCRITORIO HOME VIBES SAN FRANCISCO GRIS;MERCADO ABC
18838521;Soltero;F;27;CHILENO;;Millenial;PUDAHUEL;METROPOLITANA;133940;5;2;5;2;133940;0;0;0;MESA LANNES (1C) MIEL MLM 3009;MERCADO ABC
13834774;;F;42;CHILENO;;X;PUENTE ALTO                   ;METROPOLITANA;95970;3;1;3;1;95970;0;0;0;Cortina Roller Garden Blanca 200x250cm;MERCADO ABC
26104285;;F;36;VENEZOLANO;;Extranjero;ESTACION CENTRAL              ;METROPOLITANA;63950;4;1;4;1;63950;0;0;0;Plumon Imperial Standard Tomy;MERCADO ABC
16862352;;M;34;CHILENO;;Millenial;PROVIDENCIA                   ;METROPOLITANA;36980;2;1;2;1;36980;0;0;0;COLCHON CON ALMOHADA MASCOTA T/M;MERCADO ABC
22668196;;M;47;PERUANO;;Extranjero;LO PRADO                      ;METROPOLITANA;93980;2;1;2;1;93980;0;0;0;KIT COCINA 140 EREN MALTE-BLANCO FVTX;MERCADO ABC
16148223;;F;36;CHILENO;;Millenial;RECOLETA;METROPOLITANA;217960;4;2;4;2;217960;0;0;0;Camara Bala Exterior Full HDCAMEXTE624H;MERCADO ABC
17937191;;F;31;CHILENO;;Millenial;"";"";88480;2;1;2;1;88480;0;0;0;MUEBLE DE ASEO NALA (1C) BLANCO MLB 2602;MERCADO ABC
12225774;;F;50;CHILENO;;X;PROVIDENCIA                   ;METROPOLITANA;151980;2;1;2;1;151980;0;0;0;Trotadora Plegable K-FIT Bekele;MERCADO ABC
19182660;Soltero;F;27;CHILENO;;Z;PROVIDENCIA                   ;METROPOLITANA;43980;2;1;2;1;43980;0;0;0;Maquina Abdominales Six Pack K-FIT;MERCADO ABC
15292599;;M;40;CHILENO;;X;VALDIVIA;LOS LAGOS;265980;2;1;2;1;265980;0;0;0;Maquina Remadora Bogadora de Agua Boron;MERCADO ABC
9252155;;F;54;CHILENO;;X;TALAGANTE                     ;METROPOLITANA;383980;2;1;2;1;383980;0;0;0;BERGERE VALENCIA CAFE;MERCADO ABC
12924287;;F;46;CHILENO;;X;PROVIDENCIA;METROPOLITANA;96960;4;2;4;2;96960;0;0;0;Alfombra Frise 1.6k Venecia 150x200 Ravena;MERCADO ABC
13879815;;F;42;CHILENO;;X;CASABLANCA                    ;VALPARAISO;124970;3;1;3;1;124970;0;0;0;Silla Poltrona Eames Patchwork Calgary;MERCADO ABC
16089568;;M;36;CHILENO;;Millenial;RENCA                         ;METROPOLITANA;38980;2;1;2;1;38980;0;0;0;Set Mancuernas Con Barra Ajustable 30Kg K-FIT;MERCADO ABC
10897030;;M;52;CHILENO;;X;N/D;N/D;91980;2;1;2;1;91980;0;0;0;BARRA AUXILIAR DE COCINA FENDI - CEMENTO / BLANC;MERCADO ABC
16901454;Casado;F;34;CHILENO;TECNICO JURIDICO;Silencioso;PROVIDENCIA                   ;METROPOLITANA;4990;1;1;0;0;0;1;1;4990;DOMINO ANIMAL;MERCADO ABC
16672951;;F;34;CHILENO;;Millenial;ANTOFAGASTA;ANTOFAGASTA;118640;2;1;2;1;118640;0;0;0;RACK TV70 CINCINATTI Z-180 1P - CONAC RLC 5072;MERCADO ABC
17281108;;F;32;CHILENO;;Millenial;PROVIDENCIA                   ;METROPOLITANA;143980;2;1;2;1;143980;0;0;0;Bicicleta De Spinning Boonen K-FIT;MERCADO ABC
10382045;;F;69;CHILENO;;Silencioso;QUINTERO                      ;VALPARAISO;678940;6;2;0;0;0;6;2;678940;Bicicleta Estatica Magnetica BES 500 MGNTC Negro;MERCADO ABC
20901823;;F;30;CHILENO;;Millenial;N/D;N/D;58540;2;1;2;1;58540;0;0;0;Mesa Plegable Tipo Maleta + 4 Pisos 120Cms;MERCADO ABC
13965752;;F;41;CHILENO;;X;FREIRE                        ;ARAUCANIA;26990;1;1;0;0;0;1;1;26990;AVENTURA SKYLAB;MERCADO ABC
17658298;Soltero;M;31;CHILENO;AGRONOMO;Silencioso;PROVIDENCIA                   ;METROPOLITANA;58540;2;1;2;1;58540;0;0;0;Set Mancuernas Con Barra Ajustable 30Kg K-FIT;MERCADO ABC
19553014;;M;25;CHILENO;;Z;TOLTEN                        ;ARAUCANIA;731960;4;2;4;2;731960;0;0;0;SOFA MANET 3 CPO TELA COLOR INDIGOÂ ;MERCADO ABC
15152568;;M;40;CHILENO;;X;HUALPEN;BIO BIO;145840;2;1;2;1;145840;0;0;0;Plataforma Vibratoria FullFit 3000 Naranjo;MERCADO ABC
19848083;;M;24;CHILENO;;Z;ISLA DE MAIPO                 ;METROPOLITANA;38980;2;1;2;1;38980;0;0;0;BICICLETA ARO 12 APRENDIZAJE AMARILLA;MERCADO ABC
19107605;;F;35;CHILENO;;Millenial;N/D;N/D;121830;3;2;2;1;31840;1;1;89990;CORREPASILLO ROJO CON TOLDO Y LUCES;MERCADO ABC
19213582;;M;25;CHILENO;;Z;PUENTE ALTO;METROPOLITANA;77960;4;2;4;2;77960;0;0;0;GUITARRA CLASICA 39 FD-GC08;MERCADO ABC
16380010;;M;36;CHILENO;;Millenial;PROVIDENCIA                   ;METROPOLITANA;193980;2;1;2;1;193980;0;0;0;Bicicleta De Spinning Boonen K-FIT;MERCADO ABC
10374999;;F;55;CHILENO;;Boomers;CASTRO                        ;LOS LAGOS;30992;1;1;0;0;0;1;1;30992;GUITARRA CLASICA MS139 39 NATURAL;MERCADO ABC
5916394;;M;70;CHILENO;;Silencioso;PUERTO MONTT                  ;LOS LAGOS;8990;1;1;0;0;0;1;1;8990;TIJERA MULTIUSO COCINANEW LINE;MERCADO ABC
18433385;Soltero;M;29;CHILENO;;Millenial;PROVIDENCIA                   ;METROPOLITANA;60840;2;1;2;1;60840;0;0;0;Cortina Roller Duo Lino Blanco Grain 200x240cm;MERCADO ABC
18566265;;M;28;CHILENO;;Silencioso;PROVIDENCIA                   ;METROPOLITANA;689980;2;1;2;1;689980;0;0;0;Trotadora RUNNER PRF 550 con APP ZWIFT Negro;MERCADO ABC
15395420;;M;40;CHILENO;;X;N/D;N/D;310960;3;1;3;1;310960;0;0;0;Bicicleta De Spinning Strong Pro-Fit K-FIT;MERCADO ABC
15673024;;M;39;CHILENO;;X;LA SERENA                     ;COQUIMBO;24540;2;1;2;1;24540;0;0;0;Andador Moby 7106 Amari;MERCADO ABC
18803344;;F;28;CHILENO;;Millenial;"";"";105840;2;1;2;1;105840;0;0;0;Maquina De Remo Bogadora Murray K-FIT;MERCADO ABC
17740492;Soltero;F;31;CHILENO;;Millenial;PROVIDENCIA                   ;METROPOLITANA;83980;2;1;2;1;83980;0;0;0;POLTRONA LUCIA GRIS PLATA;MERCADO ABC
19460345;;M;24;CHILENO;;Z;PROVIDENCIA                   ;METROPOLITANA;29840;2;1;2;1;29840;0;0;0;Set Mancuernas Con Barra Ajustable 10Kg K-FIT;MERCADO ABC
18688650;Soltero;F;28;CHILENO;;Millenial;PROVIDENCIA                   ;METROPOLITANA;307540;2;1;2;1;307540;0;0;0;Trotadora Electrica Baldini 1,5HP;MERCADO ABC
8582074;;F;52;CHILENO;;X;PROVIDENCIA                   ;METROPOLITANA;158980;2;1;2;1;158980;0;0;0;Gym Multifuncional K-FIT;MERCADO ABC
19203503;Casado;F;42;CHILENO;CIRUJANO DENTISTA;X;RENCA                         ;METROPOLITANA;0;0;0;0;0;0;0;0;0;COMBO KIDS GUITARRA + AMPLIFICADOR FD-CKG07;MERCADO ABC
16628610;;F;34;CHILENO;;Millenial;MAIPU                         ;METROPOLITANA;0;0;0;0;0;0;0;0;0;TECLADO MINI SA-47AH2;MERCADO ABC
17462649;;F;32;CHILENO;;Millenial;PROVIDENCIA                   ;METROPOLITANA;0;0;0;0;0;0;0;0;0;rack modelo avellano tv hasta 65 color nero/rust;MERCADO ABC
13851129;;F;42;CHILENO;;X;PROVIDENCIA                   ;METROPOLITANA;0;0;0;0;0;0;0;0;0;TECLADO MONOFONICO NINO;MERCADO ABC
15150473;Casado;M;38;CHILENO;;X;RENCA                         ;METROPOLITANA;0;0;0;0;0;0;0;0;0;MESA OVALADA 3 NIVELES NEGRO;MERCADO ABC
15975218;;F;37;CHILENO;;Millenial;ANTOFAGASTA                   ;ANTOFAGASTA;0;0;0;0;0;0;0;0;0;LAT HACKIN PACKIN ALPACA;MERCADO ABC
13270577;Casado;F;45;CHILENO;;Silencioso;PROVIDENCIA                   ;METROPOLITANA;0;0;0;0;0;0;0;0;0;COLCHON MASCOTA PLUS T/M;MERCADO ABC
13755839;;F;42;CHILENO;;X;PROVIDENCIA                   ;METROPOLITANA;0;0;0;0;0;0;0;0;0;Casa Para Perro Medium Con Ventilacion Coolpets;MERCADO ABC
19332721;;F;26;CHILENO;;Z;N/D;N/D;0;0;0;0;0;0;0;0;0;Contenedor De Alimento Para Mascota Con Pala Y R;MERCADO ABC
15483434;;F;40;CHILENO;;X;PUENTE ALTO                   ;METROPOLITANA;0;0;0;0;0;0;0;0;0;MICROFONO CON PEDESTAL;MERCADO ABC
17954845;;F;30;CHILENO;;Millenial;LIMACHE                       ;VALPARAISO;0;0;0;0;0;0;0;0;0;CAJA ORGANIZADORA RIMAX PEQUENA 3 CAJONES;MERCADO ABC
20214539;;F;22;CHILENO;;Silencioso;PROVIDENCIA                   ;METROPOLITANA;0;0;0;0;0;0;0;0;0;Caja de Herramientas Rimax 12 Vanity Ii;MERCADO ABC
8898623;Casado;F;60;CHILENO;AUXILIAR DE ENFERMERIA;Silencioso;PROVIDENCIA                   ;METROPOLITANA;0;0;0;0;0;0;0;0;0;TECLADO CTK-240H2 ESTANDAR C/TRANSF;MERCADO ABC
11806604;;M;51;CHILENO;;X;OVALLE                        ;COQUIMBO;0;0;0;0;0;0;0;0;0;MESA CENTRO SONETTO CANYON;MERCADO ABC
13132660;;F;45;CHILENO;;X;PENCO                         ;BIO BIO;0;0;0;0;0;0;0;0;0;TECLADO CTK-240H2 ESTANDAR C/TRANSF;MERCADO ABC
9870301;;F;58;CHILENO;;Boomers;N/D;N/D;0;0;0;0;0;0;0;0;0;Colchoneta Outback Eva Aluminizada;MERCADO ABC
16505312;;F;35;CHILENO;;Millenial;PROVIDENCIA                   ;METROPOLITANA;0;0;0;0;0;0;0;0;0;GUITARRA ELECTROACUSTICA AUDITORIUM OSCAR SHMIDT;MERCADO ABC
13672743;Soltero;M;42;CHILENO;TECNICO INFORMATICO;X;PROVIDENCIA                   ;METROPOLITANA;0;0;0;0;0;0;0;0;0;Bianchi Magnetic Plegable Mp-500;MERCADO ABC
19012672;;F;27;CHILENO;;Z;N/D;N/D;0;0;0;0;0;0;0;0;0;SET DE JUEGO ASCENSOR FRESH METAL;MERCADO ABC
15118748;Casado;F;39;CHILENO;;X;PROVIDENCIA                   ;METROPOLITANA;0;0;0;0;0;0;0;0;0;SILLA METALICA ACERO;MERCADO ABC
16721506;Soltero;M;35;CHILENO;;Millenial;PROVIDENCIA                   ;METROPOLITANA;0;0;0;0;0;0;0;0;0;QUITASOL LATERAL D293CMxH265CM;MERCADO ABC
17112165;;F;33;CHILENO;;Millenial;PROVIDENCIA                   ;METROPOLITANA;0;0;0;0;0;0;0;0;0;ENCAJE CLASIFICADOR DE FORMAS;MERCADO ABC
16829163;;F;37;CHILENO;;Millenial;ARICA                         ;ARICA Y PARINACOTA;0;0;0;0;0;0;0;0;0;SILLA METALICA NEGRO;MERCADO ABC
5521537;;F;76;CHILENO;;Silencioso;IQUIQUE                       ;TARAPACA;0;0;0;0;0;0;0;0;0;PACK SABANAS 2P OCRE LINEAS;MERCADO ABC
10375285;;F;56;CHILENO;;Boomers;ANTOFAGASTA                   ;ANTOFAGASTA;0;0;0;0;0;0;0;0;0;SET CARRO SUPERMERCADO C/ACCESORIOS;MERCADO ABC
10211704;;M;56;CHILENO;;Boomers;SANTIAGO                      ;METROPOLITANA;0;0;0;0;0;0;0;0;0;HOT WHEELS SURTIDO DELUXE CITY;MERCADO ABC
10314554;;F;57;CHILENO;;Boomers;RENCA                         ;METROPOLITANA;0;0;0;0;0;0;0;0;0;PISTA CITY TRACK SERIE;MERCADO ABC
15684421;;M;39;CHILENO;;X;PROVIDENCIA                   ;METROPOLITANA;0;0;0;0;0;0;0;0;0;CAMIONETA FRICCION MONSTER AMARILLA;MERCADO ABC
11913152;;F;52;CHILENO;;X;N/D;N/D;0;0;0;0;0;0;0;0;0;SET TERRAZA 2 SILLAS+MESA VERDE144 PLI;MERCADO ABC
22080830;;F;48;PERUANO;;Extranjero;IQUIQUE                       ;TARAPACA;0;0;0;0;0;0;0;0;0;QUILT REVERSIBLE ONDAS C/ FLECOS 2P;MERCADO ABC
16856254;;M;34;CHILENO;;Millenial;N/D;N/D;0;0;0;0;0;0;0;0;0;COLUMPIO TERRAZA C/QUITASOL VERDE 469 PLI;MERCADO ABC
12188861;;F;50;CHILENO;;X;PROVIDENCIA                   ;METROPOLITANA;0;0;0;0;0;0;0;0;0;PERGOLA 300x300x250CM;MERCADO ABC
17330900;Soltero;M;32;CHILENO;;Millenial;PROVIDENCIA                   ;METROPOLITANA;0;0;0;0;0;0;0;0;0;SET DE ARCO CON FLECHAS Y DARDOS;MERCADO ABC
16438953;;F;35;CHILENO;;Millenial;PROVIDENCIA                   ;METROPOLITANA;0;0;0;0;0;0;0;0;0;JUEGO LIVING MODULAR TERRAZA GRIS;MERCADO ABC
12543034;;F;48;CHILENO;;X;RENCA                         ;METROPOLITANA;0;0;0;0;0;0;0;0;0;PLUMON MICROFIBRA BLUE 1,5P;MERCADO ABC
11988307;;M;50;CHILENO;;X;PROVIDENCIA                   ;METROPOLITANA;0;0;0;0;0;0;0;0;0;PACK SABANAS 2P OCRE LINEAS;MERCADO ABC
5480349;;F;75;CHILENO;;Silencioso;PENAFLOR                      ;METROPOLITANA;0;0;0;0;0;0;0;0;0;CUCHILLERIA 24P ACERO AUSTRIA;MERCADO ABC
10308339;;F;58;CHILENO;;Boomers;CONSTITUCION                  ;MAULE;0;0;0;0;0;0;0;0;0;PLUMON MICROFIBRA BLUE 2P;MERCADO ABC
17953744;;F;30;CHILENO;;Millenial;N/D;N/D;0;0;0;0;0;0;0;0;0;PUF GRECO METALICO GRIS;MERCADO ABC
11208804;;M;55;CHILENO;;Boomers;PROVIDENCIA                   ;METROPOLITANA;0;0;0;0;0;0;0;0;0;COLUMPIO TERRAZA C/QUITASOL VERDE 469 PLI;MERCADO ABC
13851969;Casado;M;41;CHILENO;ARQUITECTO;X;PROVIDENCIA                   ;METROPOLITANA;0;0;0;0;0;0;0;0;0;DINOSAURIO CON 30 BLOQUES Y SONIDOS;MERCADO ABC
18346274;;F;29;CHILENO;;Millenial;N/D;N/D;0;0;0;0;0;0;0;0;0;TECLADO CT-S200WE 61 TECLAS CON TRANSFORMADOR;MERCADO ABC
6091250;Soltero;M;72;CHILENO;;Silencioso;QUILPUE                       ;VALPARAISO;230030;6;3;0;0;0;6;3;230030;Bolsa Papel Grande Abcdin;PROMOCIONES
10053992;;F;57;CHILENO;;Boomers;COQUIMBO                      ;COQUIMBO;53140;2;2;0;0;0;2;2;53140;Bolsa Papel Abcdin;PROMOCIONES
26706930;;F;31;NO INFORMA NACIONALIDAD;;Extranjero;N/D;N/D;330370;5;3;4;2;330120;1;1;250;Bolsa Papel Grande Abcdin;PROMOCIONES
12702998;;F;48;CHILENO;;X;PROVIDENCIA                   ;METROPOLITANA;150;1;1;0;0;0;1;1;150;Bolsa Papel Abcdin;PROMOCIONES
19271101;;M;25;CHILENO;;Z;N/D;N/D;150;1;1;0;0;0;1;1;150;Bolsa Papel Abcdin;PROMOCIONES
18146060;;F;29;CHILENO;;Millenial;CORONEL                       ;BIO BIO;900;4;4;0;0;0;4;4;900;Bolsa Papel Abcdin;PROMOCIONES
19821474;;M;24;CHILENO;;Z;N/D;N/D;166090;3;2;2;1;165840;1;1;250;Bolsa Papel Grande Abcdin;PROMOCIONES
18896044;;M;27;CHILENO;;Millenial;N/D;N/D;0;0;0;0;0;0;0;0;0;KEY FINDER ASD-ATL1003-1;PROMOCIONES
8641621;;M;62;CHILENO;;Boomers;"";"";0;0;0;0;0;0;0;0;0;Bolsa Papel Grande Abcdin;PROMOCIONES
18526445;Soltero;M;27;CHILENO;INGENIERIA EN MAQUINARIA VEHICULOS AUTOMOTRICES Y SISTEMAS ELECTRONICOS;Millenial;PROVIDENCIA                   ;METROPOLITANA;0;0;0;0;0;0;0;0;0;Bolsa Papel Abcdin;PROMOCIONES
18308711;Soltero;M;34;CHILENO;INGENIERO ELECTRONICO;Millenial;RENCA                         ;METROPOLITANA;219990;2;1;0;0;0;2;1;219990;Cocina CMC20AXX-1 4P Inox;LINEA BLANCA
8820928;Casado;F;65;CHILENO;PROFESOR;Boomers;RENCA                         ;METROPOLITANA;845050;7;2;0;0;0;7;2;845050;Refrigerador 322Lts No Frost BF DB60S;LINEA BLANCA
17685207;;F;31;CHILENO;;Millenial;CONSTITUCION                  ;MAULE;256980;4;1;4;1;256980;0;0;0;Cocina CH-7400 4P;LINEA BLANCA
5706883;;F;79;CHILENO;;Silencioso;QUILLOTA                      ;VALPARAISO;543060;5;2;0;0;0;5;2;543060;Lavadora Premium Care 20SZ 20Kg Silver;LINEA BLANCA
15484401;;F;40;CHILENO;;X;"";"";558270;7;3;0;0;0;7;3;558270;Lavadora Semiautomatica Twister 5300 4Kg;LINEA BLANCA
19293836;Casado;F;31;CHILENO;;Millenial;PROVIDENCIA                   ;METROPOLITANA;499980;3;2;0;0;0;3;2;499980;Lavadora Efficace SZG 17,5Kg Silver;LINEA BLANCA
14377902;;F;43;CHILENO;;X;N/D;N/D;1176890;11;8;0;0;0;11;8;1176890;Lavadora WA80H4200SW1ZS 8Kg Blanca;LINEA BLANCA
15513989;;F;39;CHILENO;;X;PROVIDENCIA                   ;METROPOLITANA;603940;6;4;6;4;603940;0;0;0;CALEFON KOMFORTEK UT C10-D GL;LINEA BLANCA
8572845;;F;51;CHILENO;;X;LA SERENA                     ;COQUIMBO;1148170;8;3;0;0;0;8;3;1148170;Refrigerador 527Lts Side by Side MRSBS5300G689WE;LINEA BLANCA
9049966;;M;61;CHILENO;;Boomers;PROVIDENCIA                   ;METROPOLITANA;661260;7;2;0;0;0;7;2;661260;Lavadora Efficace SZG 17,5Kg Silver;LINEA BLANCA
19261557;;F;26;CHILENO;;Z;N/D;N/D;783970;3;1;0;0;0;3;1;783970;Refrigerador LB33MPP 306Lts Bottom No Frost;LINEA BLANCA
14050564;Soltero;F;54;CHILENO;;X;RENCA                         ;METROPOLITANA;211980;2;1;2;1;211980;0;0;0;Cocina MV 220 T 4P Silver;LINEA BLANCA
17639695;;M;32;CHILENO;;Millenial;PROVIDENCIA                   ;METROPOLITANA;137630;3;2;0;0;0;3;2;137630;Calefont 5Lts GL Essenetial ECO;LINEA BLANCA
18105085;Casado;M;29;CHILENO;ANALISTA DE SISTEMAS;Millenial;PROVIDENCIA                   ;METROPOLITANA;173980;2;1;2;1;173980;0;0;0;Lavadora MLS-090GE04N 9Kg Gris;LINEA BLANCA
12133406;;F;51;CHILENO;;X;RENCA                         ;METROPOLITANA;280980;2;1;2;1;280980;0;0;0;Lavadora WA13T5260BW/ZS 13Kg Blanca;LINEA BLANCA
20832497;;F;20;CHILENO;;Z;N/D;N/D;382450;4;2;0;0;0;4;2;382450;Secadora 7Kg 7D BZG Ventilacion Blanca;LINEA BLANCA
7121375;;M;63;CHILENO;;Boomers;N/D;N/D;847940;6;3;0;0;0;6;3;847940;Lavadora MLS-190GC03N 19Kg Gris;LINEA BLANCA
16595401;;M;36;CHILENO;;Millenial;OVALLE                        ;COQUIMBO;269990;1;1;0;0;0;1;1;269990;Lavadora Efficace SZG 17,5Kg Silver;LINEA BLANCA
16257225;;M;36;CHILENO;;Millenial;PEDRO AGUIRRE CERDA           ;METROPOLITANA;159980;2;1;2;1;159980;0;0;0;Freezer 145 Lts FDHM150BY0 Horizontal;LINEA BLANCA
9126748;;F;61;CHILENO;;Boomers;ARAUCO                        ;BIO BIO;667952;7;4;2;1;198980;5;3;468972;Lavadora 9,5Kg BZG Blanca;LINEA BLANCA
8555321;Soltero;M;63;CHILENO;;Boomers;RENCA                         ;METROPOLITANA;232130;3;1;0;0;0;3;1;232130;Lavadora 9,5Kg BZG Blanca;LINEA BLANCA
14318712;;F;46;CHILENO;;X;TALCAHUANO                    ;BIO BIO;262620;4;2;0;0;0;4;2;262620;Centrifuga Primma 5B 5,5Kilos;LINEA BLANCA
7703168;Casado;F;63;CHILENO;;Boomers;N/D;N/D;915333;8;7;0;0;0;8;7;915333;Lavadora WT13WSBP 13Kg Blanca;LINEA BLANCA
17458940;;M;32;CHILENO;;Millenial;N/D;N/D;553030;13;4;0;0;0;13;4;553030;Cocina F 2608 T 4P Reflex Silver;LINEA BLANCA
15570129;;F;38;CHILENO;;X;LINARES                       ;MAULE;232140;2;1;0;0;0;2;1;232140;Secadora Electrica SEM101BDBY Blanca 10 KG;LINEA BLANCA
8003284;;F;64;CHILENO;;Boomers;EL BOSQUE                     ;METROPOLITANA;169990;1;1;0;0;0;1;1;169990;Lavadora MLS-090GE04N 9Kg Gris;LINEA BLANCA
15548017;;F;39;CHILENO;;X;VALDIVIA                      ;LOS RIOS;294950;7;2;0;0;0;7;2;294950;Lavadora MLS-090GE04N 9Kg Gris;LINEA BLANCA
9938262;;F;55;CHILENO;;Boomers;CALAMA                        ;ANTOFAGASTA;384500;6;4;2;1;147540;4;3;236960;Calefon ionizado 7 litros GL AS0;LINEA BLANCA
6264537;;M;68;CHILENO;;Boomers;RENCA                         ;METROPOLITANA;240490;3;1;0;0;0;3;1;240490;Calefon 13Lts GL ATMD;LINEA BLANCA
8385303;;F;63;CHILENO;;Boomers;CALERA                        ;VALPARAISO;216980;2;1;0;0;0;2;1;216980;Freezer 200 Lts FDHM200BY0 Horizontal;LINEA BLANCA
19417034;;F;25;CHILENO;;Z;CHILLAN                       ;BIO BIO;442980;7;3;0;0;0;7;3;442980;Lavadora Efficace SZG 17,5Kg Silver;LINEA BLANCA
26723906;;M;39;EXTRANJERO - NO INFORMA NACIONALIDAD;;Extranjero;N/D;N/D;582550;8;3;0;0;0;8;3;582550;Cocina CMC20AXX-1 4P Inox;LINEA BLANCA
12532959;;F;49;CHILENO;;X;PADRE LAS CASAS               ;ARAUCANIA;351980;2;1;0;0;0;2;1;351980;Lavadora MLS-190GC03N 19Kg Gris;LINEA BLANCA
16826116;;M;34;CHILENO;;Millenial;LUMACO                        ;ARAUCANIA;462130;4;3;0;0;0;4;3;462130;Secadora 7Kg 7D BZG Ventilacion Blanca;LINEA BLANCA
11869330;;M;51;CHILENO;;X;PROVIDENCIA                   ;N/D;409620;6;2;0;0;0;6;2;409620;Refrigerador 303Lts BF Frio Directo Nordik 480;LINEA BLANCA
10560692;;M;55;CHILENO;;Boomers;RENCA                         ;METROPOLITANA;350980;2;2;0;0;0;2;2;350980;Cocina F 2608 T 4P Reflex Silver;LINEA BLANCA
3841147;;M;85;CHILENO;;Silencioso;VALDIVIA                      ;LOS RIOS;348780;3;1;0;0;0;3;1;348780;Refrigerador 252Lts No Frost MRFS-2700G333FW;LINEA BLANCA
10121346;;F;56;CHILENO;;Boomers;N/D;N/D;452780;4;4;0;0;0;4;4;452780;Lavadora WT16DSBP 16Kg Silver;LINEA BLANCA
15850891;;F;37;CHILENO;;Millenial;COIHAIQUE                     ;AYSEN;813750;6;3;0;0;0;6;3;813750;REFRIGERADOR TOP MOUNT GT29BPPK NO FROST 254 Lt;LINEA BLANCA
10102652;;M;56;CHILENO;;Boomers;QUEILEN                       ;LOS LAGOS;1614880;16;5;0;0;0;16;5;1614880;Cocina CH-7400 4P;LINEA BLANCA
19031643;Soltero;F;29;CHILENO;;Millenial;PROVIDENCIA                   ;METROPOLITANA;349990;1;3;0;0;0;1;3;349990;Cocina MCG-5QI30NS 5P;LINEA BLANCA
11170953;Casado;F;55;CHILENO;;Boomers;RENCA                         ;METROPOLITANA;439990;1;1;0;0;0;1;1;439990;Cocina M 920 T 5P Silver;LINEA BLANCA
10975441;;F;45;CHILENO;;X;CONCHALI                      ;METROPOLITANA;1851710;23;9;0;0;0;23;9;1851710;Cocina CH-9955NG 5P;LINEA BLANCA
6650806;;F;68;CHILENO;;Boomers;MELIPILLA                     ;METROPOLITANA;770950;5;2;0;0;0;5;2;770950;Cocina F 5500 T 5P Reflex Silver;LINEA BLANCA
9955781;;M;57;CHILENO;;Boomers;N/D;N/D;806919;8;5;0;0;0;8;5;806919;Cocina MCG-5QI30NS 5P;LINEA BLANCA
8706706;;F;67;CHILENO;;Boomers;COIHAIQUE                     ;AYSEN;269990;1;1;0;0;0;1;1;269990;Lavadora WA13T5260BW/ZS 13Kg Blanca;LINEA BLANCA
7120117;;M;63;CHILENO;;Boomers;SAN FERNANDO                  ;L.G.B.OÂ´HIGGINS;852740;6;2;0;0;0;6;2;852740;Cocina F 5500 T 5P Reflex Silver;LINEA BLANCA
13407497;;M;49;CHILENO;;X;DALCAHUE                      ;LOS LAGOS;606451;7;4;0;0;0;7;4;606451;Lavadora MLS-160BSC03T 16Kg Blanca;LINEA BLANCA
9093463;;M;59;CHILENO;;Z;PROVIDENCIA                   ;METROPOLITANA;259980;2;1;2;1;259980;0;0;0;Lavadora Efficace SZG 17,5Kg Silver;LINEA BLANCA
14029953;;F;41;CHILENO;;X;TALCAHUANO                    ;BIO BIO;397980;2;1;2;1;397980;0;0;0;KIT - TRIO HE KURZ-BREIT4P-REIN60;LINEA BLANCA
10715277;;F;56;CHILENO;;Boomers;LAMPA                         ;METROPOLITANA;9990;1;1;0;0;0;1;1;9990;CANASTO TEXTURA RATAN TAPA ABATIBLE;LINEA BLANCA
8603776;;M;63;CHILENO;;Boomers;ALHUE                         ;METROPOLITANA;468849;6;2;0;0;0;6;2;468849;Cocina F 2608 T 4P Reflex Silver;LINEA BLANCA
6763388;;F;75;CHILENO;;Silencioso;ALTO HOSPICIO;TARAPACA;775930;7;6;0;0;0;7;6;775930;Lavadora WT19DSBP 19Kg Silver;LINEA BLANCA
5628083;;M;73;CHILENO;;Silencioso;VINA DEL MAR                  ;VALPARAISO;297971;3;2;0;0;0;3;2;297971;Lavadora WA90H4400SW1ZS 9Kg Blanca;LINEA BLANCA
20353524;;M;22;CHILENO;;Z;TEMUCO;ARAUCANIA;708400;7;3;4;2;389960;3;1;318440;Secadora 7Kg 7D BZG Ventilacion Blanca;LINEA BLANCA
11271494;;F;54;CHILENO;;X;"";"";266980;2;1;0;0;0;2;1;266980;Lavadora MLS-160BSC03T 16Kg Blanca;LINEA BLANCA
8095442;;F;64;CHILENO;;Boomers;LUMACO                        ;ARAUCANIA;217150;2;1;0;0;0;2;1;217150;Lavadora MLS-090GE04N 9Kg Gris;LINEA BLANCA
16913630;;M;33;CHILENO;;Millenial;PEDRO AGUIRRE CERDA           ;METROPOLITANA;1515890;11;6;4;2;696960;7;4;818930;Lavadora Efficace SZG 19,5Kg Silver;LINEA BLANCA
10788861;;M;56;CHILENO;;Boomers;MELIPILLA                     ;METROPOLITANA;309980;2;2;0;0;0;2;2;309980;Centrifuga Primma 5B 5,5Kilos;LINEA BLANCA
10970571;;M;52;CHILENO;;X;ARAUCO                        ;BIO BIO;345360;4;2;0;0;0;4;2;345360;Lavadora Efficace SZG 17,5Kg Silver;LINEA BLANCA
6097538;;F;73;CHILENO;;Silencioso;ERCILLA                       ;ARAUCANIA;961380;10;2;0;0;0;10;2;961380;Freezer Horizontal M 150 142Lts;LINEA BLANCA
13062404;;M;45;CHILENO;;X;PROVIDENCIA                   ;METROPOLITANA;149990;1;1;0;0;0;1;1;149990;Calefon 11Lts GL Master;LINEA BLANCA
7453019;;F;65;CHILENO;;Boomers;COIHAIQUE                     ;AYSEN;503210;3;2;0;0;0;3;2;503210;Cocina MCG-5QI30NS 5P;LINEA BLANCA
6874295;;F;74;CHILENO;;Silencioso;RENCA                         ;METROPOLITANA;328980;2;1;0;0;0;2;1;328980;Lavadora Efficace SZG 19,5Kg Silver;LINEA BLANCA
11284927;;M;53;CHILENO;;X;CONSTITUCION                  ;MAULE;377971;3;3;0;0;0;3;3;377971;Secadora 7Kg 7D BZG Ventilacion Blanca;LINEA BLANCA
12148519;;F;53;CHILENO;;X;LINARES                       ;MAULE;496958;7;3;0;0;0;7;3;496958;Lavadora Efficace SZG 17,5Kg Silver;LINEA BLANCA
6754098;;F;70;CHILENO;;Silencioso;RENCA                         ;METROPOLITANA;219990;1;1;0;0;0;1;1;219990;Cocina CH-7400 4P;LINEA BLANCA
13380517;;M;44;CHILENO;;X;N/D;N/D;1274920;9;5;0;0;0;9;5;1274920;Lavadora Efficace BZG 11,5Kg Blanca;LINEA BLANCA
9006694;;M;60;CHILENO;;Boomers;TALAGANTE                     ;METROPOLITANA;1518960;14;7;0;0;0;14;7;1518960;Lavadora Premium Care 20SZ 20Kg Silver;LINEA BLANCA
16515929;;F;34;CHILENO;;Millenial;CANETE                        ;BIO BIO;969950;7;7;0;0;0;7;7;969950;Calefon ionizado 7 litros GL AS0;LINEA BLANCA
11522755;;F;51;CHILENO;;X;SAN ANTONIO                   ;VALPARAISO;581960;4;1;4;1;581960;0;0;0;KIT - TRIO HE KURZ-BREIT4P-REIN60;LINEA BLANCA
26323498;;F;27;VENEZOLANO;;Extranjero;N/D;N/D;980890;8;4;0;0;0;8;4;980890;Lavadora Efficace SZG 17,5Kg Silver;LINEA BLANCA
7068212;;F;66;CHILENO;;Boomers;ALTO HOSPICIO;TARAPACA;352980;2;1;0;0;0;2;1;352980;Refrigerador 250 Lts No Frost RMA250PHUG1;LINEA BLANCA
10147918;;F;56;CHILENO;;Boomers;PROVIDENCIA                   ;METROPOLITANA;207122;3;2;0;0;0;3;2;207122;Centrifuga Primma 5B 5,5Kilos;LINEA BLANCA
8392605;;F;62;CHILENO;;Boomers;ANGOL                         ;ARAUCANIA;359970;4;3;0;0;0;4;3;359970;Secadora 7Kg 7D BZG Ventilacion Blanca;LINEA BLANCA
19411225;;M;26;CHILENO;;Z;MELIPILLA;METROPOLITANA;289980;2;1;2;1;289980;0;0;0;Refrigerador 241Lts BF Frio Directo Nordik 415;LINEA BLANCA
13570558;;M;42;CHILENO;;X;SAN FERNANDO                  ;L.G.B.OÂ´HIGGINS;945960;4;2;4;2;945960;0;0;0;ENCIMERA UT PRIME GLT-5 GL;LINEA BLANCA
8988484;;M;62;CHILENO;;Boomers;N/D;N/D;465960;4;1;0;0;0;4;1;465960;Refrigerador 260Lts BF Frio Direc MRFI2660SR346W;LINEA BLANCA
8329319;;F;65;CHILENO;;Boomers;LLAILLAY                      ;VALPARAISO;793760;7;3;0;0;0;7;3;793760;Lavadora Efficace SZG 17,5Kg Silver;LINEA BLANCA
7595903;;F;74;CHILENO;;Silencioso;OVALLE                        ;COQUIMBO;293950;2;1;0;0;0;2;1;293950;Lavadora MLS-160BSC03T 16Kg Blanca;LINEA BLANCA
14264076;;F;51;CHILENO;;X;CALAMA                        ;ANTOFAGASTA;849950;5;4;2;1;459980;3;3;389970;Lavadora Efficace SZG 17,5Kg Silver;LINEA BLANCA
17568585;;M;31;CHILENO;;Millenial;PROVIDENCIA                   ;METROPOLITANA;444960;4;2;0;0;0;4;2;444960;Refrigerador 303Lts BF Frio Directo Nordik 480;LINEA BLANCA
4546447;;F;80;CHILENO;;Silencioso;NUEVA IMPERIAL                ;ARAUCANIA;209990;1;1;0;0;0;1;1;209990;Lavadora WA80H4200SW1ZS 8Kg Blanca;LINEA BLANCA
11265198;;F;53;CHILENO;;X;CABILDO                       ;VALPARAISO;249990;1;1;0;0;0;1;1;249990;Lavadora Efficace SZG 17,5Kg Silver;LINEA BLANCA
12598921;;M;51;CHILENO;;X;LA LIGUA                      ;VALPARAISO;563940;3;2;0;0;0;3;2;563940;Lavadora MLS-160BSC03T 16Kg Blanca;LINEA BLANCA
15907656;;F;37;CHILENO;;Millenial;EL BOSQUE                     ;METROPOLITANA;239173;3;2;0;0;0;3;2;239173;Secadora 7Kg 7D BZG Ventilacion Blanca;LINEA BLANCA
8264965;;F;65;CHILENO;;Boomers;PROVIDENCIA                   ;METROPOLITANA;491970;3;1;3;1;491970;0;0;0;Refrigerador MDRB424FGE46 302 Lts No Frost;LINEA BLANCA
9260554;;F;58;CHILENO;;Boomers;TEMUCO                        ;ARAUCANIA;473930;4;3;0;0;0;4;3;473930;Lavadora MLS-160BSC03T 16Kg Blanca;LINEA BLANCA
7193809;;M;67;CHILENO;;Boomers;PUDAHUEL                      ;METROPOLITANA;419720;6;2;0;0;0;6;2;419720;Secadora Ropa MD100A90/W 9Kg Ventilacion Blanca;LINEA BLANCA
18916067;Soltero;M;27;CHILENO;ADMINISTRADOR GASTRONOMICO;Extranjero;PROVIDENCIA                   ;METROPOLITANA;176980;2;1;2;1;176980;0;0;0;Refrigerador 167Lts Frio Directo 1700-S;LINEA BLANCA
12792344;;F;47;CHILENO;;X;CAUQUENES                     ;MAULE;1576860;14;7;0;0;0;14;7;1576860;Secadora Ropa MD100A90/W 9Kg Ventilacion Blanca;LINEA BLANCA
9179937;;F;60;CHILENO;;Boomers;PUENTE ALTO                   ;METROPOLITANA;359990;1;1;0;0;0;1;1;359990;Lavadora MLS-190GC03N 19Kg Gris;LINEA BLANCA
11394140;;F;53;CHILENO;;X;MELIPILLA                     ;METROPOLITANA;2399030;17;8;4;2;457960;13;6;1941070;Freezer 162 Lts SFV-205 SI Vertical;LINEA BLANCA
6178635;;F;70;CHILENO;;Silencioso;NATALES                       ;MAGALLANES;430180;4;1;0;0;0;4;1;430180;Lavadora WA90H4400SW1ZS 9Kg Blanca;LINEA BLANCA
6669469;;M;69;CHILENO;;Silencioso;LAS CABRAS                    ;L.G.B.OÂ´HIGGINS;253812;3;2;0;0;0;3;2;253812;Calefon 13Lts GL ATMD;LINEA BLANCA
19059784;Soltero;M;25;CHILENO;;Z;PROVIDENCIA                   ;METROPOLITANA;569980;2;1;0;0;0;2;1;569980;Lavadora Efficace SZG 19,5Kg Silver;LINEA BLANCA
15537823;;M;39;CHILENO;;X;PROVIDENCIA                   ;METROPOLITANA;259980;2;1;2;1;259980;0;0;0;Refrigerador MDRB424FGE46 302 Lts No Frost;LINEA BLANCA
20041885;;M;23;CHILENO;;Z;PROVIDENCIA                   ;METROPOLITANA;279980;2;1;2;1;279980;0;0;0;Refrigerador MDRB424FGE46 302 Lts No Frost;LINEA BLANCA
4447534;;M;76;CHILENO;;Silencioso;LEBU                          ;BIO BIO;728330;6;3;0;0;0;6;3;728330;Lavadora WT19DSBP 19Kg Silver;LINEA BLANCA
11950397;;M;49;CHILENO;;X;PROVIDENCIA                   ;METROPOLITANA;479980;3;3;0;0;0;3;3;479980;Secadora 9 Kg 9D BZG Ventilacion Blanca;LINEA BLANCA
15624947;;F;38;CHILENO;;Millenial;N/D;N/D;376980;2;1;0;0;0;2;1;376980;Lavadora WA15T5260BW/ZS 15Kg Blanca;LINEA BLANCA
16235272;;M;36;CHILENO;;Millenial;N/D;N/D;1392930;7;5;6;4;1362940;1;1;29990;Lavadora C Frontal 12K WM12WVC4S6 Inverter Dire;LINEA BLANCA
17242532;;F;33;CHILENO;;Millenial;LAMPA;METROPOLITANA;409980;2;1;2;1;409980;0;0;0;Lavadora Secadora MLSF-13510SC01I 13,5Kg/10Kg Gr;LINEA BLANCA
7402307;;M;66;CHILENO;;Boomers;PUNITAQUI                     ;COQUIMBO;1515880;14;9;0;0;0;14;9;1515880;Campana Cocina FXU6190 90Cms;LINEA BLANCA
10795479;;M;55;CHILENO;;Boomers;ISLA DE MAIPO                 ;METROPOLITANA;2451490;16;8;0;0;0;16;8;2451490;Calefont 10Lts GL Essenetial ECO;LINEA BLANCA
10240407;;F;56;CHILENO;;Boomers;SAN VICENTE                   ;L.G.B.OÂ´HIGGINS;524841;8;4;0;0;0;8;4;524841;Calefont 8Lts GL Essenetial ECO;LINEA BLANCA
10450129;;M;57;CHILENO;;Boomers;RENCA                         ;METROPOLITANA;119990;1;1;0;0;0;1;1;119990;Centrifuga Primma 5B 5,5Kilos;LINEA BLANCA
6707491;;F;69;CHILENO;;Silencioso;PUNITAQUI                     ;COQUIMBO;460950;5;3;0;0;0;5;3;460950;Cocina CH-7400 4P;LINEA BLANCA
12491546;;F;49;CHILENO;;X;"";"";409980;2;1;2;1;409980;0;0;0;Lavadora Secadora MLSF-13510SC01I 13,5Kg/10Kg Gr;LINEA BLANCA
7582191;;F;67;CHILENO;;Boomers;LOS ANGELES                   ;BIO BIO;293950;2;1;0;0;0;2;1;293950;Lavadora Efficace SZG 17,5Kg Silver;LINEA BLANCA
9635308;;F;68;CHILENO;;Boomers;PROVIDENCIA                   ;METROPOLITANA;99880;4;2;0;0;0;4;2;99880;Campana Slim CA-606NG;LINEA BLANCA
20347027;;M;22;CHILENO;;Z;N/D;N/D;280962;4;3;1;1;249990;3;2;30972;Lavadora Efficace SZG 17,5Kg Silver;LINEA BLANCA
8514664;;F;62;CHILENO;;Millenial;N/D;N/D;159980;2;1;0;0;0;2;1;159980;Refrigerador 167Lts Frio Directo 1700-S;LINEA BLANCA
19263450;Soltero;F;26;CHILENO;;Z;PROVIDENCIA                   ;METROPOLITANA;261980;2;1;2;1;261980;0;0;0;Refrigerador 241Lts BF Frio Directo Nordik 415;LINEA BLANCA
10805709;;M;54;CHILENO;;X;TALAGANTE                     ;METROPOLITANA;597060;3;2;0;0;0;3;2;597060;Calefon ionizado 7 litros GL AS0;LINEA BLANCA
5333671;;F;78;CHILENO;;Silencioso;VILLA ALEMANA                 ;VALPARAISO;978060;9;4;0;0;0;9;4;978060;Calefont 10Lts GL Essenetial ECO;LINEA BLANCA
7101351;;F;70;CHILENO;;Silencioso;PALMILLA                      ;L.G.B.OÂ´HIGGINS;298970;3;2;0;0;0;3;2;298970;Lavadora MLS-140GSC03T 14Kg Gris;LINEA BLANCA
18314363;;F;29;CHILENO;;Millenial;ARICA                         ;ARICA Y PARINACOTA;313950;2;1;0;0;0;2;1;313950;Lavadora MLS-160BSC03T 16Kg Blanca;LINEA BLANCA
11626899;;F;52;CHILENO;;X;TALAGANTE                     ;METROPOLITANA;435500;5;6;0;0;0;5;6;435500;Lavadora MLS-160BSC03T 16Kg Blanca;LINEA BLANCA
25859832;;M;33;HAITIANO;;Extranjero;INDEPENDENCIA                 ;METROPOLITANA;299980;2;1;0;0;0;2;1;299980;Lavadora Efficace SZG 19,5Kg Silver;LINEA BLANCA
9083446;;M;58;CHILENO;;Boomers;SAN ANTONIO                   ;VALPARAISO;1036210;5;3;0;0;0;5;3;1036210;Cocina Doble Horno 76DXT 5P Silver;LINEA BLANCA
6658125;;F;69;CHILENO;;Silencioso;CATEMU                        ;VALPARAISO;344980;2;1;0;0;0;2;1;344980;Lavadora Premium Care 20SZ 20Kg Silver;LINEA BLANCA
17906808;;M;30;CHILENO;;Millenial;EL BOSQUE                     ;METROPOLITANA;209980;2;1;2;1;209980;0;0;0;Secadora Ropa MD100A90/T 9Kg Ventilacion Gris;LINEA BLANCA
10519337;;F;54;CHILENO;;X;N/D;N/D;1145050;6;3;6;3;1145050;0;0;0;Lavadora Efficace SZG 17,5Kg Silver;LINEA BLANCA
17912221;;F;31;CHILENO;;Millenial;N/D;N/D;1042350;7;4;4;2;529820;3;2;512530;Lavadora Efficace SZG 15,5Kg Silver;LINEA BLANCA
5721054;;F;76;CHILENO;;Silencioso;LINARES                       ;MAULE;956420;5;2;2;1;655480;3;1;300940;Lavadora Efficace SZG 17,5Kg Silver;LINEA BLANCA
7681141;Casado;F;68;CHILENO;;Silencioso;VINA DEL MAR                  ;VALPARAISO;296980;2;1;2;1;296980;0;0;0;Cocina PRO 425 4P Inox - Serie 2 HSG14I21SE;LINEA BLANCA
17258973;;F;32;CHILENO;;Millenial;PROVIDENCIA                   ;METROPOLITANA;73980;2;1;2;1;73980;0;0;0;SECADORA SR-10 8KG GRIS SINDELEN;LINEA BLANCA
20471932;;M;21;CHILENO;;Millenial;"";"";65980;2;1;2;1;65980;0;0;0;SECADORA SR-10 8KG GRIS SINDELEN;LINEA BLANCA
8425423;;M;62;CHILENO;;Boomers;NATALES                       ;MAGALLANES;323950;2;1;0;0;0;2;1;323950;Lavadora Efficace SZG 15,5Kg Silver;LINEA BLANCA
12204091;;M;50;CHILENO;;X;NATALES                       ;MAGALLANES;394950;5;2;0;0;0;5;2;394950;Freezer 99Lts MFH-1000B131CN Horizontal;LINEA BLANCA
9364318;;F;60;CHILENO;;Boomers;REQUINOA                      ;L.G.B.OÂ´HIGGINS;591960;4;4;0;0;0;4;4;591960;Cocina MCG-5QI30NS 5P;LINEA BLANCA
25555614;;M;29;COLOMBIANO;;Extranjero;N/D;N/D;191430;2;1;0;0;0;2;1;191430;Secadora Ropa MSV-90 9K Blanca Ventilacion;LINEA BLANCA
20648402;;M;21;CHILENO;;Z;PROVIDENCIA                   ;METROPOLITANA;209980;2;1;2;1;209980;0;0;0;Refrigerador 166 Lts Frio Directo BF MED165;LINEA BLANCA
8365072;;M;64;CHILENO;;Boomers;LOS ANGELES                   ;BIO BIO;241980;2;1;2;1;241980;0;0;0;Lavadora 9 Kg Carga Superior Blanca;LINEA BLANCA
11288646;;F;54;CHILENO;;X;RETIRO                        ;MAULE;350940;6;3;0;0;0;6;3;350940;Calefon 7Lts GL Master;LINEA BLANCA
16689299;;F;34;CHILENO;;Millenial;COQUIMBO                      ;COQUIMBO;1024690;8;4;0;0;0;8;4;1024690;Refrigerador 300Lts No Frost RT29K500JS8/ZS;LINEA BLANCA
9529026;;F;62;CHILENO;;Boomers;ANCUD                         ;LOS LAGOS;727050;9;4;0;0;0;9;4;727050;Lavadora LMA0920WGCL0 9,5Kg Gris;LINEA BLANCA
7131892;;M;63;CHILENO;;Boomers;PAINE                         ;METROPOLITANA;367960;4;2;4;2;367960;0;0;0;Secadora 9 Kg 9D SZG Silver;LINEA BLANCA
7605272;;F;66;CHILENO;;Boomers;TALCA                         ;MAULE;256980;2;1;0;0;0;2;1;256980;Lavadora Efficace BZG 11,5Kg Blanca;LINEA BLANCA
7653498;;M;63;CHILENO;;Boomers;COIHAIQUE                     ;AYSEN;189990;1;1;0;0;0;1;1;189990;Freezer Horizontal M 150 142Lts;LINEA BLANCA
7964896;;M;66;CHILENO;;Boomers;PELLUHUE                      ;MAULE;1073760;9;4;0;0;0;9;4;1073760;Lavadora Efficace SZG 17,5Kg Silver;LINEA BLANCA
12922228;;M;46;CHILENO;;X;CONCEPCION                    ;BIO BIO;369990;3;1;0;0;0;3;1;369990;REFRIGERADOR TOP MOUNT GT29BPPK NO FROST 254 Lt;LINEA BLANCA
15822746;;F;37;CHILENO;;Millenial;QUILICURA;METROPOLITANA;233980;2;1;2;1;233980;0;0;0;Secadora 9 Kg 9D SZG Silver;LINEA BLANCA
6871774;;F;66;CHILENO;;Boomers;EL BOSQUE                     ;METROPOLITANA;1541180;12;6;6;3;743940;6;3;797240;Cocina CH-9905SI 5P;LINEA BLANCA
12742856;Divorciado;F;47;CHILENO;ANESTESIOLOGIA Y REANIMACION;Silencioso;PROVIDENCIA                   ;METROPOLITANA;239980;2;1;2;1;239980;0;0;0;Lavadora Efficace BZG 11,5Kg Blanca;LINEA BLANCA
26167332;;M;34;VENEZOLANO;;Extranjero;PROVIDENCIA                   ;METROPOLITANA;173980;2;1;2;1;173980;0;0;0;Cocina CMC20AXX-1 4P Inox;LINEA BLANCA
8183010;;F;64;CHILENO;;Boomers;SAN FELIPE                    ;VALPARAISO;109990;1;1;0;0;0;1;1;109990;Calefont 5Lts GL Essenetial ECO;LINEA BLANCA
15561073;;F;39;CHILENO;;X;VINA DEL MAR;VALPARAISO;686960;4;3;4;3;686960;0;0;0;Lavadora Secadora MLSF-13510SC01I 13,5Kg/10Kg Gr;LINEA BLANCA
18287041;;M;29;CHILENO;;Millenial;N/D;N/D;456970;3;3;0;0;0;3;3;456970;Refrigerador 260Lts BF Frio Direc MRFI2660SR346W;LINEA BLANCA
6404361;;F;71;CHILENO;;Silencioso;PAINE                         ;METROPOLITANA;416960;5;3;0;0;0;5;3;416960;Lavadora Efficace SZG 19,5Kg Silver;LINEA BLANCA
6463554;;M;72;CHILENO;;Silencioso;PUNTA ARENAS                  ;MAGALLANES;316412;4;4;0;0;0;4;4;316412;Cocina CH-9400 4P SILVER;LINEA BLANCA
14142117;;M;40;CHILENO;;X;"";"";289970;3;3;0;0;0;3;3;289970;Lavadora Premium Care Pro 16Kg Silver;LINEA BLANCA
6995633;;F;63;CHILENO;;Boomers;COQUIMBO                      ;COQUIMBO;618940;5;2;0;0;0;5;2;618940;Cocina CH-7400 4P;LINEA BLANCA
17314854;;F;32;CHILENO;;Millenial;PUENTE ALTO;METROPOLITANA;148960;4;2;4;2;148960;0;0;0;Secadora Ropa MSV-90 9K Blanca Ventilacion;LINEA BLANCA
12765561;Casado;F;47;CHILENO;;X;CABRERO                       ;BIO BIO;220980;2;1;0;0;0;2;1;220980;Refrigerador 166 Lts Frio Directo BF MED165;LINEA BLANCA
16189773;;F;35;CHILENO;;Millenial;COLTAUCO                      ;L.G.B.OÂ´HIGGINS;252400;5;1;0;0;0;5;1;252400;Secadora Ropa MSV-90 9K Blanca Ventilacion;LINEA BLANCA
7557506;;F;67;CHILENO;;Boomers;CHILLAN                       ;BIO BIO;321970;3;2;0;0;0;3;2;321970;Lavadora Efficace SZG 17,5Kg Silver;LINEA BLANCA
10824136;;F;52;CHILENO;;X;N/D;N/D;129990;1;1;0;0;0;1;1;129990;Centrifuga Primma 5B 5,5Kilos;LINEA BLANCA
16687817;;F;34;CHILENO;;Millenial;RENCA                         ;METROPOLITANA;701980;2;1;2;1;701980;0;0;0;Refrigerador 626Lt Side by Side GS65MPP1 APZPECL;LINEA BLANCA
9808649;;F;58;CHILENO;;Boomers;PROVIDENCIA                   ;METROPOLITANA;143980;2;1;2;1;143980;0;0;0;Calefont 10Lts GL Essenetial ECO;LINEA BLANCA
7247179;;M;67;CHILENO;;Boomers;EL MONTE                      ;METROPOLITANA;1190550;15;8;0;0;0;15;8;1190550;Cocina Andes60TX4 4P Inox;LINEA BLANCA
15667576;;M;38;CHILENO;;Millenial;"";"";169980;2;1;2;1;169980;0;0;0;Lavadora MLS-090GE04N 9Kg Gris;LINEA BLANCA
19623415;;F;25;CHILENO;;Z;PANGUIPULLI                   ;LOS LAGOS;877700;5;4;1;1;259990;4;3;617710;Secadora 7Kg 7D BZG Ventilacion Blanca;LINEA BLANCA
7552118;;M;66;CHILENO;;Boomers;RENCA                         ;METROPOLITANA;529980;2;2;0;0;0;2;2;529980;Refrigerador 527Lts Side by Side MRSBS5300G689WE;LINEA BLANCA
8401600;;F;64;CHILENO;;Boomers;QUINTA NORMAL                 ;METROPOLITANA;442790;5;2;0;0;0;5;2;442790;Secadora Ropa MD100A90/W 9Kg Ventilacion Blanca;LINEA BLANCA
14435479;;F;49;CHILENO;;X;DALCAHUE                      ;LOS LAGOS;1428130;12;7;0;0;0;12;7;1428130;Refrigerador 317 Lts No frost IF32;LINEA BLANCA
16117494;;F;36;CHILENO;;Millenial;N/D;N/D;387950;5;2;2;1;176980;3;1;210970;Lavadora MLS-080BE04N 8Kg Blanca;LINEA BLANCA
8741287;;M;62;CHILENO;;Boomers;CORONEL;BIO-BIO;168980;2;1;2;1;168980;0;0;0;Lavadora MLS-090GE04N 9Kg Gris;LINEA BLANCA
13048656;;F;46;CHILENO;;X;PROVIDENCIA                   ;METROPOLITANA;279980;2;1;2;1;279980;0;0;0;Refrigerador RB27N4020S8/ZS BF 257Lts;LINEA BLANCA
12613096;;F;48;CHILENO;;X;N/D;N/D;2370650;15;6;0;0;0;15;6;2370650;Secadora 7Kg 7D BZG Ventilacion Blanca;LINEA BLANCA
12424359;;M;49;CHILENO;;X;LA SERENA                     ;COQUIMBO;358650;4;2;0;0;0;4;2;358650;Centrifuga Primma 5B 5,5Kilos;LINEA BLANCA
11345098;;F;53;CHILENO;;X;ANTOFAGASTA                   ;ANTOFAGASTA;391970;3;1;3;1;391970;0;0;0;Refrigerador LRT-200DFI 168Lts Frio Directo;LINEA BLANCA
19464189;;F;25;CHILENO;;Z;PROVIDENCIA                   ;METROPOLITANA;221430;2;1;0;0;0;2;1;221430;Secadora Ropa MD100A90/W 9Kg Ventilacion Blanca;LINEA BLANCA
16490740;;M;37;CHILENO;;Millenial;PAINE                         ;METROPOLITANA;310980;3;1;0;0;0;3;1;310980;Lavadora Premium Care Pro 16Kg Silver;LINEA BLANCA
15474621;;F;39;CHILENO;;X;RENCA                         ;METROPOLITANA;171980;2;1;2;1;171980;0;0;0;Refrigerador 167Lts MRFI-1700R234RN F.Direc Rojo;LINEA BLANCA
11999709;;M;50;CHILENO;;X;PROVIDENCIA                   ;METROPOLITANA;371960;3;1;0;0;0;3;1;371960;Cocina M 775 ST 4P Silver;LINEA BLANCA
7462780;;M;67;CHILENO;;Boomers;PROVIDENCIA                   ;METROPOLITANA;419990;2;1;2;1;419990;0;0;0;Lavadora Secadora MLSF-13510SC01I 13,5Kg/10Kg Gr;LINEA BLANCA
7664919;;M;63;CHILENO;;Boomers;SAN FELIPE                    ;VALPARAISO;276970;4;1;0;0;0;4;1;276970;Lavadora Efficace SZG 15,5Kg Silver;LINEA BLANCA
18651769;;F;23;CHILENO;;Z;PROVIDENCIA                   ;METROPOLITANA;314980;2;1;2;1;314980;0;0;0;Lavadora Premium Care 20SZ 20Kg Silver;LINEA BLANCA
7138345;;M;60;CHILENO;;Boomers;ARICA                         ;TARAPACA;209990;1;1;0;0;0;1;1;209990;Lavadora WA90H4400SW1ZS 9Kg Blanca;LINEA BLANCA
16087440;;M;36;CHILENO;;X;PROVIDENCIA                   ;METROPOLITANA;199980;2;1;2;1;199980;0;0;0;Lavadora WA90H4400SW1ZS 9Kg Blanca;LINEA BLANCA
25800549;;M;34;HAITIANO;;Extranjero;SAN BERNARDO                  ;METROPOLITANA;362970;3;1;0;0;0;3;1;362970;Cocina MCG-4QI24NS 4P;LINEA BLANCA
13400221;;F;44;CHILENO;;X;VILLARICA                     ;ARAUCANIA;764680;7;4;0;0;0;7;4;764680;Refrigerador 303Lts BF Frio Directo Nordik 480;LINEA BLANCA
19271829;Soltero;F;25;CHILENO;;Z;CATEMU                        ;VALPARAISO;314980;2;1;0;0;0;2;1;314980;Lavadora WA13T5260BW/ZS 13Kg Blanca;LINEA BLANCA
11647198;;F;51;CHILENO;;X;COPIAPO                       ;ATACAMA;109990;1;1;0;0;0;1;1;109990;Calefont 5Lts GL Essenetial ECO;LINEA BLANCA
18087943;;M;29;CHILENO;;Millenial;BUIN;METROPOLITANA;217970;3;2;0;0;0;3;2;217970;Secadora Ropa MD100A90/W 9Kg Ventilacion Blanca;LINEA BLANCA
13848711;Casado;M;42;CHILENO;INTERPRETE L DE SS;X;RIO NEGRO                     ;LOS LAGOS;468970;3;1;0;0;0;3;1;468970;Cocina F 2608 T 4P Reflex Silver;LINEA BLANCA
26777754;;M;41;VENEZOLANO;;Extranjero;N/D;N/D;501970;3;2;2;1;201980;1;1;299990;Lavadora LMA0920WGCL0 9,5Kg Gris;LINEA BLANCA
19062089;;F;27;CHILENO;;Z;PROVIDENCIA                   ;METROPOLITANA;279980;2;1;2;1;279980;0;0;0;Lavadora LMA8120WGCL0 18Kg Gris;LINEA BLANCA
7493400;;M;66;CHILENO;;Boomers;COELEMU                       ;BIO BIO;319990;1;1;0;0;0;1;1;319990;Cocina MCG-5QI30NS 5P;LINEA BLANCA
15403961;;M;40;CHILENO;;X;CERRILLOS                     ;METROPOLITANA;419980;2;2;0;0;0;2;2;419980;Lavadora MLS-160BSC03T 16Kg Blanca;LINEA BLANCA
12583046;;M;48;CHILENO;;X;SALAMANCA                     ;COQUIMBO;461950;5;3;5;3;461950;0;0;0;ENCIMERA A GAS 4 PLATOS CEG-4600 INOX;LINEA BLANCA
9262382;;M;61;CHILENO;;Boomers;ROMERAL                       ;MAULE;332980;2;1;0;0;0;2;1;332980;Refrigerador 260Lts BF Frio Direc MRFI2660SR346W;LINEA BLANCA
22270348;;M;43;PERUANO;;Extranjero;N/D;N/D;1078930;8;5;0;0;0;8;5;1078930;Refrigerador 252Lts No Frost MRFS-2700G333FW;LINEA BLANCA
15499380;;F;45;CHILENO;;X;PROVIDENCIA                   ;METROPOLITANA;176980;2;1;2;1;176980;0;0;0;Lavadora MLS-090GE04N 9Kg Gris;LINEA BLANCA
15157623;;M;40;CHILENO;;X;RENCA                         ;METROPOLITANA;386980;2;1;0;0;0;2;1;386980;Refrigerador 300Lts No Frost RT29K500JS8/ZS;LINEA BLANCA
4981942;;M;69;CHILENO;;Silencioso;CAUQUENES                     ;MAULE;465650;4;2;0;0;0;4;2;465650;Secadora 9 Kg Premium Care Pro 9D;LINEA BLANCA
16418647;;M;36;CHILENO;;Millenial;YUMBEL                        ;BIO BIO;229990;1;1;1;1;229990;0;0;0;Refrigerador 244Lts Frio Directo Progress 3100;LINEA BLANCA
13509188;;F;44;CHILENO;;X;CONCEPCION                    ;BIO BIO;339980;2;2;0;0;0;2;2;339980;Cocina CH-7400 4P;LINEA BLANCA
14459943;;F;46;CHILENO;;X;CONTULMO                      ;BIO BIO;138980;2;1;2;1;138980;0;0;0;Centrifuga Primma 5B 5,5Kilos;LINEA BLANCA
13850141;Soltero;M;42;CHILENO;INGENIERO EN MANTENIMIENTO INDUSTRIAL;X;RENCA                         ;METROPOLITANA;159990;1;1;1;1;159990;0;0;0;Lavadora WA80H4200SW1ZS 8Kg Blanca;LINEA BLANCA
7177914;;F;71;CHILENO;;Silencioso;CANETE                        ;BIO BIO;800470;3;2;0;0;0;3;2;800470;Calefon ionizado 7 litros GL AS0;LINEA BLANCA
9624405;;F;60;CHILENO;;Boomers;RENCA                         ;METROPOLITANA;145980;2;1;0;0;0;2;1;145980;Lavadora Semiautomatica LS-6100 6Kg Gris;LINEA BLANCA
15599334;;M;38;CHILENO;;Millenial;TALCA                         ;MAULE;320455;5;4;0;0;0;5;4;320455;COCINA CH-6700IN 4P;LINEA BLANCA
9521470;;F;58;CHILENO;;Boomers;COIHAIQUE                     ;AYSEN;705960;4;3;0;0;0;4;3;705960;Lavadora WT16DSBP 16Kg Silver;LINEA BLANCA
18898318;;F;27;CHILENO;;Millenial;ALTO HOSPICIO;TARAPACA;200910;2;1;0;0;0;2;1;200910;Lavadora WA80H4200SW1ZS 8Kg Blanca;LINEA BLANCA
8595065;;F;60;CHILENO;;Boomers;CERRO NAVIA                   ;METROPOLITANA;509960;4;2;4;2;509960;0;0;0;Lavadora Premium Care Pro 16Kg Silver;LINEA BLANCA
18761358;;F;27;CHILENO;;Z;PROVIDENCIA                   ;METROPOLITANA;388980;2;1;2;1;388980;0;0;0;KIT - TRIO HE KURZ-BREIT4P-REIN60;LINEA BLANCA
12759958;;M;47;CHILENO;;X;PUENTE ALTO                   ;METROPOLITANA;138980;2;1;0;0;0;2;1;138980;Calefont 10Lts GL Essenetial ECO;LINEA BLANCA
17839708;;M;30;CHILENO;;Millenial;PROVIDENCIA                   ;METROPOLITANA;163980;2;1;2;1;163980;0;0;0;Lavadora Semiautomatica Twister 5300 4Kg;LINEA BLANCA
11256499;;F;54;CHILENO;;X;PROVIDENCIA                   ;METROPOLITANA;179990;1;1;1;1;179990;0;0;0;Cocina CMC20AXX 4P Inox;LINEA BLANCA
11653031;;F;52;CHILENO;;X;N/D;N/D;389920;6;2;6;2;389920;0;0;0;Lavadora Efficace BZG 11,5Kg Blanca;LINEA BLANCA
13352476;;M;43;CHILENO;;X;LA FLORIDA;METROPOLITANA;211980;4;2;0;0;0;4;2;211980;Refrigerador 167Lts MRFI-1700R234RN F.Direc Rojo;LINEA BLANCA
9365429;;F;61;CHILENO;;Boomers;PUERTO VARAS                  ;LOS LAGOS;899340;4;1;0;0;0;4;1;899340;Refrigerador 425Lts No Frost Altus 1430W;LINEA BLANCA
20202063;;F;22;CHILENO;;Z;PROVIDENCIA                   ;METROPOLITANA;159980;2;1;2;1;159980;0;0;0;Lavadora WA80H4200SW1ZS 8Kg Blanca;LINEA BLANCA
15566235;;M;38;CHILENO;;Silencioso;PROVIDENCIA                   ;METROPOLITANA;133980;2;1;2;1;133980;0;0;0;Centrifuga Primma 5B 5,5Kilos;LINEA BLANCA
7904796;;F;66;CHILENO;;Boomers;CHIMBARONGO                   ;L.G.B.OÂ´HIGGINS;866960;4;2;0;0;0;4;2;866960;Cocina MCG-5QI30NS 5P;LINEA BLANCA
13895991;Casado;M;42;CHILENO;INGENIERO EN MAQUINARIA;X;RENCA                         ;METROPOLITANA;169990;1;1;1;1;169990;0;0;0;Secadora 7Kg 7D BZG Ventilacion Blanca;LINEA BLANCA
15203920;;M;39;CHILENO;;X;CANETE                        ;BIO BIO;298070;3;2;0;0;0;3;2;298070;Secadora Electrica SEM101BDBY Blanca 10 KG;LINEA BLANCA
10650361;;F;55;CHILENO;;Boomers;RENCA                         ;METROPOLITANA;220910;2;1;0;0;0;2;1;220910;Secadora Ropa MD100A90/W 9Kg Ventilacion Blanca;LINEA BLANCA
7553425;;M;67;CHILENO;;Boomers;TALCA                         ;MAULE;269990;1;1;0;0;0;1;1;269990;Lavadora MLS-160BSC03T 16Kg Blanca;LINEA BLANCA
13599131;;M;43;CHILENO;;X;LONGAVI                       ;MAULE;517170;4;4;0;0;0;4;4;517170;Refrigerador 322Lts No Frost BF DB60S;LINEA BLANCA
26019680;;F;24;PERUANO;;Extranjero;"";"";474960;4;2;0;0;0;4;2;474960;Secadora 9 Kg Premium Care Pro 9D;LINEA BLANCA
5752950;;F;75;CHILENO;;Silencioso;TEMUCO                        ;ARAUCANIA;242260;5;1;0;0;0;5;1;242260;Cocina CMC20AXX-1 4P Inox;LINEA BLANCA
5872667;Casado;F;70;CHILENO;;Silencioso;COLINA                        ;METROPOLITANA;472070;6;2;0;0;0;6;2;472070;Refrigerador 255Lts No Frost RT25FARADS8/ZS;LINEA BLANCA
22190529;;F;37;PERUANO;;Extranjero;PROVIDENCIA                   ;METROPOLITANA;229980;2;1;2;1;229980;0;0;0;Lavadora Frontal MLF-085BE08N 8,5Kg Blanca;LINEA BLANCA
16835231;;F;34;CHILENO;;Millenial;"";"";327971;4;2;1;1;199990;3;1;127981;Refrigerador 241Lts BF Frio Directo Nordik 415;LINEA BLANCA
19284728;;F;25;CHILENO;;Z;BUIN                          ;METROPOLITANA;350190;2;1;0;0;0;2;1;350190;Lavadora Efficace SZG 17,5Kg Silver;LINEA BLANCA
11983618;;M;50;CHILENO;;X;CONSTITUCION                  ;MAULE;629980;2;2;1;1;169990;1;1;459990;Secadora 7Kg 7D BZG Ventilacion Blanca;LINEA BLANCA
10968548;;F;50;CHILENO;;X;PROVIDENCIA                   ;METROPOLITANA;369990;1;1;0;0;0;1;1;369990;Cocina MCG-5QI30NS 5P;LINEA BLANCA
12038022;;M;44;CHILENO;;X;N/D;N/D;474960;4;3;0;0;0;4;3;474960;Lavadora MLS-090GE04N 9Kg Gris;LINEA BLANCA
9674499;;F;58;CHILENO;;Boomers;COIHAIQUE                     ;AYSEN;323980;2;1;2;1;323980;0;0;0;Lavadora Premium Care Pro 16Kg Silver;LINEA BLANCA
10011009;;F;57;CHILENO;;Boomers;RENCA                         ;METROPOLITANA;251970;3;2;3;2;251970;0;0;0;Refrigerador 166 Lts Frio Directo BF MED165;LINEA BLANCA
14489570;;F;48;CHILENO;;X;TEODORO SCHMIDT               ;ARAUCANIA;290330;3;1;0;0;0;3;1;290330;Secadora Ropa MD100A90/W 9Kg Ventilacion Blanca;LINEA BLANCA
18804430;;M;27;CHILENO;;Millenial;"";"";969940;6;3;6;3;969940;0;0;0;Refrigerador 260Lts BF Frio Direc MRFI2660SR346W;LINEA BLANCA
12322900;;M;52;CHILENO;;X;N/D;N/D;569980;3;2;0;0;0;3;2;569980;Lavadora Efficace SZG 17,5Kg Silver;LINEA BLANCA
6941953;Soltero;M;72;CHILENO;AGROINDUSTRIA;Silencioso;NUEVA IMPERIAL                ;ARAUCANIA;516240;4;2;0;0;0;4;2;516240;Lavadora Semiautomatica LC-6550 6,5Kg;LINEA BLANCA
14358936;;M;44;CHILENO;;X;CHILLAN                       ;BIO BIO;533990;5;2;0;0;0;5;2;533990;Secadora Ropa MD100A90/W 9Kg Ventilacion Blanca;LINEA BLANCA
8413794;;F;62;CHILENO;;Boomers;COIHAIQUE                     ;AYSEN;464980;2;2;0;0;0;2;2;464980;Refrigerador 244Lts Frio Directo Progress 3100;LINEA BLANCA
16875786;;F;34;CHILENO;;Millenial;SAN BERNARDO;METROPOLITANA;654520;10;3;0;0;0;10;3;654520;Lavadora Efficace SZG 17,5Kg Silver;LINEA BLANCA
7691844;;M;64;CHILENO;;Boomers;PEDRO AGUIRRE CERDA           ;METROPOLITANA;199990;1;1;0;0;0;1;1;199990;Secadora Ropa MD100A90/W 9Kg Ventilacion Blanca;LINEA BLANCA
7591804;;M;68;CHILENO;;Boomers;TALAGANTE                     ;METROPOLITANA;408430;3;1;0;0;0;3;1;408430;Lavadora Premium Care Pro 16Kg Silver;LINEA BLANCA
4878514;;F;78;CHILENO;;Silencioso;LA CRUZ                       ;VALPARAISO;1176250;14;5;1;1;169990;13;4;1006260;Lavadora WA90H4400SW1ZS 9Kg Blanca;LINEA BLANCA
5849707;;M;70;CHILENO;;Silencioso;RENCA                         ;METROPOLITANA;88980;2;1;0;0;0;2;1;88980;Campana Cocina FXU6190 90Cms;LINEA BLANCA
12005723;;M;49;CHILENO;;Extranjero;LA LIGUA                      ;VALPARAISO;189990;1;1;1;1;189990;0;0;0;Cocina CMC20AXX 4P Inox;LINEA BLANCA
7659410;;F;66;CHILENO;;Boomers;COPIAPO                       ;ATACAMA;552530;6;4;0;0;0;6;4;552530;Lavadora MLS-160BSC03T 16Kg Blanca;LINEA BLANCA
8024486;;M;63;CHILENO;;Boomers;ARICA                         ;ARICA Y PARINACOTA;1298960;4;4;0;0;0;4;4;1298960;Lavadora WT19DSBP 19Kg Silver;LINEA BLANCA
17866699;;F;31;CHILENO;;Millenial;VILLA ALEMANA                 ;VALPARAISO;171980;2;1;2;1;171980;0;0;0;Lavadora MLS-080BE04N 8Kg Blanca;LINEA BLANCA
9959256;;M;59;CHILENO;;Boomers;N/D;N/D;551790;7;3;0;0;0;7;3;551790;Freezer FDHM150BY1 150Lts Horizontal;LINEA BLANCA
16583235;;M;35;CHILENO;;Millenial;CAUQUENES                     ;MAULE;339960;4;2;2;1;204980;2;1;134980;Secadora Ropa MD100A90/W 9Kg Ventilacion Blanca;LINEA BLANCA
8371999;;F;62;CHILENO;;Boomers;EL MONTE                      ;METROPOLITANA;829950;5;3;5;3;829950;0;0;0;Cocina CH-9400 4P SILVER;LINEA BLANCA
14317691;;F;46;CHILENO;;X;PROVIDENCIA                   ;METROPOLITANA;459930;7;4;0;0;0;7;4;459930;Secadora 7Kg 7D BZG Ventilacion Blanca;LINEA BLANCA
5252407;;M;79;CHILENO;;Silencioso;RANCAGUA                      ;L.G.B.OÂ´HIGGINS;211980;2;1;0;0;0;2;1;211980;Freezer Horizontal M 150 142Lts;LINEA BLANCA
22726594;;F;44;COLOMBIANO;;Extranjero;CASTRO                        ;LOS LAGOS;626010;4;2;0;0;0;4;2;626010;Lavadora MLS-160BSC03T 16Kg Blanca;LINEA BLANCA
19772626;;F;24;CHILENO;;Silencioso;PROVIDENCIA                   ;METROPOLITANA;389980;2;1;2;1;389980;0;0;0;Lavadora Secadora Perfect Care 8Kg/5Kg Blanca;LINEA BLANCA
9064835;;F;60;CHILENO;;Boomers;RENCA                         ;METROPOLITANA;379960;4;2;4;2;379960;0;0;0;Lavadora Efficace SZG 19,5Kg Silver;LINEA BLANCA
10256308;;F;57;CHILENO;;Boomers;SAN FERNANDO                  ;L.G.B.OÂ´HIGGINS;239990;1;1;0;0;0;1;1;239990;Lavadora LMA0920WGCL0 9,5Kg Gris;LINEA BLANCA
18854160;Soltero;F;27;CHILENO;ENFERMERA;Z;PROVIDENCIA                   ;METROPOLITANA;249990;2;1;2;1;249990;0;0;0;Cocina M 775 ST 4P Silver;LINEA BLANCA
15334763;Casado;F;38;CHILENO;PROFESOR;X;PROVIDENCIA                   ;METROPOLITANA;262980;2;1;2;1;262980;0;0;0;Lavadora Efficace SZG 15,5Kg Silver;LINEA BLANCA
18543842;;M;29;CHILENO;;Millenial;SAN BERNARDO                  ;METROPOLITANA;2404299;11;4;0;0;0;11;4;2404299;Refrigerador 527Lts Side by Side MRSBS5300G689WE;LINEA BLANCA
12393642;;M;48;CHILENO;;X;RENCA                         ;METROPOLITANA;370970;3;1;0;0;0;3;1;370970;COCINA CH-6700IN 4P;LINEA BLANCA
18007523;;F;29;CHILENO;;Millenial;N/D;N/D;574660;4;3;0;0;0;4;3;574660;Refrigerador 250 Lts No Frost RMA250PHUG1;LINEA BLANCA
5297809;;M;76;CHILENO;;Silencioso;IQUIQUE                       ;TARAPACA;231530;2;1;0;0;0;2;1;231530;Cocina CH-7400 4P;LINEA BLANCA
17991361;;F;30;CHILENO;;Millenial;VICTORIA;ARAUCANIA;1024930;7;5;2;1;237980;5;4;786950;Cocina CH-8700IN 5P;LINEA BLANCA
10129116;;F;58;CHILENO;;Boomers;VILLARICA                     ;ARAUCANIA;541590;4;2;0;0;0;4;2;541590;Lavadora Semiautomatica LC-6550 6,5Kg;LINEA BLANCA
17511409;;M;32;CHILENO;;Millenial;GORBEA                        ;ARAUCANIA;428980;4;2;0;0;0;4;2;428980;Secadora 7Kg 7D BZG Ventilacion Blanca;LINEA BLANCA
9856335;;F;58;CHILENO;;Boomers;PROVIDENCIA                   ;METROPOLITANA;93980;2;1;2;1;93980;0;0;0;ENCIMERA ELECTRICA MEE-2E MADEMSA;LINEA BLANCA
16356765;Casado;M;36;CHILENO;;Silencioso;PROVIDENCIA                   ;METROPOLITANA;239980;2;1;2;1;239980;0;0;0;Beer Cooler MBC-960N125SEN 96Lts;LINEA BLANCA
8323569;;F;63;CHILENO;;Boomers;LITUECHE                      ;L.G.B.OÂ´HIGGINS;672240;3;2;0;0;0;3;2;672240;Lavadora MLS-160BSC03T 16Kg Blanca;LINEA BLANCA
11091196;;F;56;CHILENO;;Boomers;N/D;N/D;176356;5;2;2;1;141980;3;1;34376;Centrifuga Primma 5B 5,5Kilos;LINEA BLANCA
8731120;;M;61;CHILENO;;Boomers;CORONEL                       ;BIO BIO;261750;3;1;0;0;0;3;1;261750;Secadora Ropa MD100A90/W 9Kg Ventilacion Blanca;LINEA BLANCA
7389892;Casado;M;68;CHILENO;PROFESOR;Boomers;PAINE                         ;METROPOLITANA;133980;2;1;2;1;133980;0;0;0;Centrifuga Primma 5B 5,5Kilos;LINEA BLANCA
14367166;;F;48;CHILENO;;X;BUIN                          ;METROPOLITANA;103980;2;1;0;0;0;2;1;103980;Calefont 5Lts GL Essenetial ECO;LINEA BLANCA
6554546;;F;71;CHILENO;;Silencioso;SAN BERNARDO                  ;METROPOLITANA;200520;2;1;0;0;0;2;1;200520;Lavadora Semiautomatica Twister 5300 4Kg;LINEA BLANCA
5260139;;M;79;CHILENO;;Silencioso;ROMERAL                       ;MAULE;439680;2;1;0;0;0;2;1;439680;Refrigerador 322Lts No Frost BF DB60S;LINEA BLANCA
16828492;;F;34;CHILENO;;Millenial;PROVIDENCIA                   ;METROPOLITANA;659980;2;2;0;0;0;2;2;659980;KIT INSTAL COC. LENA ALCAZAR;LINEA BLANCA
10035368;;F;57;CHILENO;;Boomers;CHIMBARONGO                   ;L.G.B.OÂ´HIGGINS;287980;2;2;0;0;0;2;2;287980;Lavadora Efficace SZG 15,5Kg Silver;LINEA BLANCA
9750797;;F;56;CHILENO;;Boomers;SAN VICENTE                   ;L.G.B.OÂ´HIGGINS;873650;5;3;0;0;0;5;3;873650;Cocina Lena Angelina Blanca;LINEA BLANCA
14302688;Casado;F;47;CHILENO;;X;RENCA                         ;METROPOLITANA;561980;2;1;0;0;0;2;1;561980;Refrigerador 341Lts BF No Frost GB37MPD;LINEA BLANCA
9722834;;F;56;CHILENO;;Boomers;VALLENAR;ATACAMA;735930;9;2;0;0;0;9;2;735930;Lavadora Efficace SZG 19,5Kg Silver;LINEA BLANCA
19802343;;F;24;CHILENO;;Z;PROVIDENCIA                   ;METROPOLITANA;354970;3;3;1;1;24990;2;2;329980;Refrigerador 260Lts BF Frio Direc MRFI2660SR346W;LINEA BLANCA
7467516;;F;68;CHILENO;;Boomers;N/D;N/D;201980;2;1;2;1;201980;0;0;0;Lavadora WA80H4200SW1ZS 8Kg Blanca;LINEA BLANCA
10781829;;M;55;CHILENO;;Boomers;MARIA PINTO                   ;METROPOLITANA;1414390;7;4;0;0;0;7;4;1414390;Cocina MCG-5QI30NS 5P;LINEA BLANCA
5790289;;M;75;CHILENO;;Silencioso;PARRAL                        ;MAULE;924630;6;2;0;0;0;6;2;924630;Lavadora Secadora Perfect Care 8Kg/5Kg Blanca;LINEA BLANCA
6115061;;M;76;CHILENO;;Silencioso;EMPEDRADO                     ;MAULE;407940;9;4;0;0;0;9;4;407940;Refrigerador 167Lts Frio Directo 1700-S;LINEA BLANCA
5615025;;F;72;CHILENO;;Silencioso;ARICA                         ;TARAPACA;752970;3;1;0;0;0;3;1;752970;Refrigerador 525Lts Side by Side SFX500;LINEA BLANCA
13599784;;M;43;CHILENO;;X;RENCA                         ;METROPOLITANA;333980;2;1;2;1;333980;0;0;0;Lavadora WT16DSBP 16Kg Silver;LINEA BLANCA
7190091;;F;69;CHILENO;;Silencioso;PUENTE ALTO                   ;METROPOLITANA;826950;5;2;0;0;0;5;2;826950;Lavadora WT19DSBP 19Kg Silver;LINEA BLANCA
7507484;Casado;F;70;CHILENO;;Silencioso;LAJA                          ;BIO BIO;602970;3;1;0;0;0;3;1;602970;Refrigerador Side by side Multidoor DM64S;LINEA BLANCA
19197613;;F;26;CHILENO;;Z;TEMUCO                        ;ARAUCANIA;314980;2;1;0;0;0;2;1;314980;Lavadora Secadora MLSF-1108BN05N 11Kg/8Kg Blanca;LINEA BLANCA
6973695;;M;69;CHILENO;;Silencioso;COLINA                        ;METROPOLITANA;702920;8;5;0;0;0;8;5;702920;Lavadora Efficace SZG 19,5Kg Silver;LINEA BLANCA
16894867;;F;34;CHILENO;;Millenial;PUERTO MONTT                  ;LOS LAGOS;244970;3;1;0;0;0;3;1;244970;Secadora Ropa MD100A90/W 9Kg Ventilacion Blanca;LINEA BLANCA
17379197;;F;32;CHILENO;;Millenial;PROVIDENCIA                   ;METROPOLITANA;209980;2;1;2;1;209980;0;0;0;Secadora Electrica SEM101BDBY Blanca 10 KG;LINEA BLANCA
13123565;;M;46;CHILENO;;X;N/D;N/D;-67010;1;2;2;1;192980;-1;1;-259990;Lavadora Secadora MLSF-1108BN05N 11Kg/8Kg Blanca;LINEA BLANCA
11119277;;M;54;CHILENO;;Boomers;PUERTO MONTT                  ;LOS LAGOS;463960;4;1;0;0;0;4;1;463960;Cocina CMC20AXX 4P Inox;LINEA BLANCA
5827404;;F;76;CHILENO;;Silencioso;CHILLAN                       ;BIO BIO;1030430;7;2;0;0;0;7;2;1030430;Lavadora Efficace SZG 17,5Kg Silver;LINEA BLANCA
14048705;Soltero;M;41;CHILENO;;X;SAN FERNANDO                  ;L.G.B.OÂ´HIGGINS;391970;3;1;0;0;0;3;1;391970;Lavadora MLS-190GC03N 19Kg Gris;LINEA BLANCA
10514714;;F;56;CHILENO;;Boomers;ANGOL                         ;ARAUCANIA;424980;2;2;0;0;0;2;2;424980;Lavadora MLS-160BSC03T 16Kg Blanca;LINEA BLANCA
11703369;;F;52;CHILENO;;X;VALDIVIA                      ;LOS RIOS;418960;4;2;4;2;418960;0;0;0;Campana Slim CA-635PNG;LINEA BLANCA
7454013;Soltero;M;64;CHILENO;;Silencioso;PROVIDENCIA                   ;METROPOLITANA;203980;2;1;0;0;0;2;1;203980;Lavadora WA80H4200SW1ZS 8Kg Blanca;LINEA BLANCA
6866439;;F;69;CHILENO;;Silencioso;LA LIGUA                      ;VALPARAISO;1702480;11;4;0;0;0;11;4;1702480;Freezer 196Lts M200 Horizontal;LINEA BLANCA
17797824;;F;31;CHILENO;;Millenial;PROVIDENCIA                   ;METROPOLITANA;742140;4;2;0;0;0;4;2;742140;Refrigerador 300Lts No Frost RT29K500JS8/ZS;LINEA BLANCA
18830543;;F;28;CHILENO;;Millenial;VILLA ALEGRE                  ;MAULE;199990;1;1;0;0;0;1;1;199990;Lavadora WA90H4400SW1ZS 9Kg Blanca;LINEA BLANCA
18885874;;M;27;CHILENO;;Z;PANGUIPULLI                   ;LOS RIOS;1423870;15;11;1;1;49990;14;10;1373880;Calefont 10Lts GL Essenetial ECO;LINEA BLANCA
14081384;;F;41;CHILENO;;X;PROVIDENCIA                   ;METROPOLITANA;366980;2;1;2;1;366980;0;0;0;Lavadora Secadora MF100D110B/T 11Kg/8KG Gris;LINEA BLANCA
13629111;;M;43;CHILENO;;X;CANETE                        ;BIO BIO;301980;2;1;0;0;0;2;1;301980;Refrigerador 260Lts BF Frio Direc MRFI2660SR346W;LINEA BLANCA
10762533;;M;56;CHILENO;;Boomers;RENCA                         ;METROPOLITANA;354980;2;1;0;0;0;2;1;354980;Lavadora WT13WSBP 13Kg Blanca;LINEA BLANCA
15299001;;M;40;CHILENO;;X;PROVIDENCIA                   ;METROPOLITANA;709940;6;2;0;0;0;6;2;709940;Lavadora Efficace SZG 15,5Kg Silver;LINEA BLANCA
4429490;;F;78;CHILENO;;Silencioso;VALPARAISO                    ;VALPARAISO;339980;2;1;0;0;0;2;1;339980;Cocina Andes60TX4 4P Inox;LINEA BLANCA
16961808;;F;34;CHILENO;;Millenial;PAINE                         ;METROPOLITANA;183980;2;1;2;1;183980;0;0;0;Secadora Ropa MD100A90/W 9Kg Ventilacion Blanca;LINEA BLANCA
7328278;;F;70;CHILENO;;Silencioso;PROVIDENCIA                   ;METROPOLITANA;341970;3;2;0;0;0;3;2;341970;Freezer 196Lts M200 Horizontal;LINEA BLANCA
8280120;;M;63;CHILENO;;Boomers;ANTOFAGASTA                   ;ANTOFAGASTA;590550;4;2;0;0;0;4;2;590550;Lavadora MLS-160BSC03T 16Kg Blanca;LINEA BLANCA
6462284;;F;67;CHILENO;;Boomers;CALAMA                        ;ANTOFAGASTA;342980;2;1;0;0;0;2;1;342980;Refrigerador 252Lts No Frost MRFS-2700G333FW;LINEA BLANCA
8568696;;M;65;CHILENO;;Boomers;RENCA                         ;METROPOLITANA;103170;2;1;0;0;0;2;1;103170;Calefont 5Lts GL Essenetial ECO;LINEA BLANCA
16568446;;M;34;CHILENO;;Millenial;PROVIDENCIA                   ;METROPOLITANA;159990;1;1;0;0;0;1;1;159990;Lavadora Semiautomatica LC-6550 6,5Kg;LINEA BLANCA
20077220;;F;23;CHILENO;;Z;CHILLAN                       ;BIO BIO;277470;5;2;2;1;197480;3;1;79990;Secadora Ropa MD100A90/W 9Kg Ventilacion Blanca;LINEA BLANCA
6544292;;M;68;CHILENO;;Silencioso;HUASCO                        ;ATACAMA;403980;2;1;0;0;0;2;1;403980;Lavadora Premium Care 20SZ 20Kg Silver;LINEA BLANCA
18332309;;F;28;CHILENO;;Millenial;"";"";467960;4;2;4;2;467960;0;0;0;Encimera a Gas F GC75V A 5P;LINEA BLANCA
10057576;;F;55;CHILENO;;Boomers;PLACILLA                      ;L.G.B.OÂ´HIGGINS;297970;3;2;0;0;0;3;2;297970;Freezer 162 Lts SFV-205 SI Vertical;LINEA BLANCA
13154469;;M;48;CHILENO;;X;CARAHUE                       ;ARAUCANIA;329990;1;1;0;0;0;1;1;329990;Lavadora WA17T6260BW/ZS 17Kg Blanca;LINEA BLANCA
9555618;;M;60;CHILENO;;Boomers;RECOLETA                      ;METROPOLITANA;565970;3;1;0;0;0;3;1;565970;Refrigerador 527Lts Side by Side MRSBS5300G689WE;LINEA BLANCA
17928403;;M;30;CHILENO;;Millenial;LA PINTANA                    ;METROPOLITANA;463950;5;3;0;0;0;5;3;463950;Lavadora WA17T6260BW/ZS 17Kg Blanca;LINEA BLANCA
8865945;;M;62;CHILENO;;Boomers;EL BOSQUE                     ;METROPOLITANA;253560;3;1;0;0;0;3;1;253560;COCINA CH-6700IN 4P;LINEA BLANCA
7650756;Soltero;M;66;CHILENO;;Boomers;PUTAENDO                      ;VALPARAISO;435980;2;1;0;0;0;2;1;435980;Refrigerador 303Lts BF Frio Directo Nordik 480;LINEA BLANCA
10294922;;F;54;CHILENO;;X;RENCA                         ;METROPOLITANA;189990;1;1;0;0;0;1;1;189990;Secadora Ropa MD100A90/W 9Kg Ventilacion Blanca;LINEA BLANCA
9114299;;M;59;CHILENO;;Boomers;MALLOA                        ;L.G.B.OÂ´HIGGINS;688960;4;1;0;0;0;4;1;688960;Refrigerador 251Lts No Frost Altus 1250;LINEA BLANCA
6729548;;F;69;CHILENO;;Silencioso;PROVIDENCIA                   ;METROPOLITANA;199990;1;1;0;0;0;1;1;199990;Cocina CH-7400 4P;LINEA BLANCA
9538061;;F;61;CHILENO;;Boomers;ARICA                         ;TARAPACA;298960;4;1;0;0;0;4;1;298960;Refrigerador 167Lts MRFI-1700R234RN F.Direc Rojo;LINEA BLANCA
26749736;;M;34;EXTRANJERO - NO INFORMA NACIONALIDAD;;Extranjero;PROVIDENCIA                   ;METROPOLITANA;669950;5;1;0;0;0;5;1;669950;Refrigerador RB27N4020S8/ZS BF 257Lts;LINEA BLANCA
16197046;Soltero;M;37;CHILENO;;Millenial;ESTACION CENTRAL              ;METROPOLITANA;679970;3;1;3;1;679970;0;0;0;REFRIGERADOR 234Lt TMF RT22FARADS8/ZS;LINEA BLANCA
12926388;;F;47;CHILENO;;X;LINARES                       ;MAULE;354980;2;2;0;0;0;2;2;354980;Lavadora Semiautomatica LC-6550 6,5Kg;LINEA BLANCA
14211498;;M;40;CHILENO;;X;COIHAIQUE                     ;AYSEN;563950;4;1;4;1;563950;0;0;0;Refrigerador 210Lts Rojo Frio Dir MRFS2100R273FN;LINEA BLANCA
12991893;;F;46;CHILENO;;X;CHONCHI                       ;LOS LAGOS;1149900;10;4;0;0;0;10;4;1149900;Cocina M 795 T 4P Silver;LINEA BLANCA
6952032;;F;68;CHILENO;;Silencioso;RENGO                         ;L.G.B.OÂ´HIGGINS;858970;3;1;0;0;0;3;1;858970;Refrigerador RL4363SBABS/ZS 432Lts No Frost;LINEA BLANCA
10618594;;F;41;CHILENO;;X;PUCON                         ;ARAUCANIA;186980;2;1;2;1;186980;0;0;0;Secadora Ropa MD100A90/W 9Kg Ventilacion Blanca;LINEA BLANCA
13582985;;F;44;CHILENO;;X;NUEVA IMPERIAL                ;ARAUCANIA;226920;8;3;2;1;186980;6;2;39940;Refrigerador 167Lts Frio Directo 1700-S;LINEA BLANCA
12571929;;F;48;CHILENO;;X;OVALLE                        ;COQUIMBO;315980;2;1;0;0;0;2;1;315980;Lavadora Efficace SZG 19,5Kg Silver;LINEA BLANCA
9672937;;F;59;CHILENO;;Boomers;CALERA DE TANGO               ;METROPOLITANA;294970;3;2;0;0;0;3;2;294970;Lavadora Efficace SZG 17,5Kg Silver;LINEA BLANCA
8495555;;M;56;CHILENO;;Boomers;COIHAIQUE                     ;AYSEN;1001960;4;3;0;0;0;4;3;1001960;Refrigerador 535Lts Side by Side RS54N3003SL/ZS;LINEA BLANCA
12415512;;M;49;CHILENO;;X;CURICO                        ;MAULE;321980;2;1;0;0;0;2;1;321980;Lavadora Efficace SZG 17,5Kg Silver;LINEA BLANCA
13462688;;F;51;CHILENO;;X;RECOLETA                      ;METROPOLITANA;369980;2;1;0;0;0;2;1;369980;Cocina MCG-5QI30NS 5P;LINEA BLANCA
10476793;;M;62;CHILENO;;Boomers;PROVIDENCIA                   ;METROPOLITANA;336070;2;1;0;0;0;2;1;336070;Freezer 200 Lts FDHM200BY0 Horizontal;LINEA BLANCA
15038673;;F;35;CHILENO;;Millenial;COQUIMBO                      ;COQUIMBO;309990;1;1;1;1;309990;0;0;0;Lavadora WA17T6260BW/ZS 17Kg Blanca;LINEA BLANCA
17296497;;F;32;CHILENO;;Millenial;PUERTO VARAS                  ;LOS LAGOS;294980;2;1;2;1;294980;0;0;0;Lavadora Efficace SZG 17,5Kg Blanca;LINEA BLANCA
9988761;Casado;M;57;CHILENO;ESTADISTICO;Boomers;RENCA                         ;METROPOLITANA;184980;2;1;2;1;184980;0;0;0;Lavadora WA80H4200SW1ZS 8Kg Blanca;LINEA BLANCA
8978524;;M;56;CHILENO;;Boomers;SAN FERNANDO                  ;L.G.B.OÂ´HIGGINS;312980;3;1;0;0;0;3;1;312980;Refrigerador 252Lts No Frost MRFS-2700G333FW;LINEA BLANCA
17519860;;M;31;CHILENO;;Millenial;N/D;N/D;279990;1;1;0;0;0;1;1;279990;Lavadora Efficace SZG 17,5Kg Blanca;LINEA BLANCA
14530763;;M;48;CHILENO;;X;"";"";207980;2;4;0;0;0;2;4;207980;Lavadora Efficace BZG 9,5Kg Blanca;LINEA BLANCA
9613093;;F;60;CHILENO;;Boomers;BUIN                          ;METROPOLITANA;529970;3;2;0;0;0;3;2;529970;Lavadora Efficace SZG 15,5Kg Silver;LINEA BLANCA
12373132;;M;49;CHILENO;;X;TALCA                         ;MAULE;459980;2;1;0;0;0;2;1;459980;Refrigerador 260Lts BF Frio Direc MRFI2660SR346W;LINEA BLANCA
9410206;;F;58;CHILENO;;Boomers;OVALLE                        ;COQUIMBO;161980;2;1;2;1;161980;0;0;0;Lavadora Semiautomatica Twister 5100 4Kg;LINEA BLANCA
12958325;;M;45;CHILENO;;X;SAN ANTONIO                   ;VALPARAISO;359980;2;1;0;0;0;2;1;359980;Cocina Andes76HG0 6P Inox;LINEA BLANCA
16683578;;F;34;CHILENO;;Millenial;CHILE CHICO                   ;AYSEN;199990;1;1;0;0;0;1;1;199990;Cocina CH-7400 4P;LINEA BLANCA
16918476;;F;34;CHILENO;;Millenial;PROVIDENCIA                   ;METROPOLITANA;209980;2;1;2;1;209980;0;0;0;Lavadora 9 Kg Carga Superior Blanca;LINEA BLANCA
7021563;;F;61;CHILENO;;Boomers;VICTORIA                      ;ARAUCANIA;344980;2;1;0;0;0;2;1;344980;Lavadora WT16DSBP 16Kg Silver;LINEA BLANCA
8943699;;F;58;CHILENO;;Boomers;MAFIL                         ;LOS LAGOS;327990;3;1;0;0;0;3;1;327990;Lavadora WA17T6260BW/ZS 17Kg Blanca;LINEA BLANCA
9332417;;M;59;CHILENO;;Boomers;SAN CARLOS                    ;BIO BIO;508950;5;1;0;0;0;5;1;508950;Refrigerador 244Lts Frio Directo Progress 3100;LINEA BLANCA
9613167;;F;61;CHILENO;;Boomers;N/D;N/D;439920;7;3;6;2;422930;1;1;16990;Cocina CH-9050SI 4P;LINEA BLANCA
11408183;;F;55;CHILENO;;Boomers;MAIPU                         ;METROPOLITANA;199980;2;1;2;1;199980;0;0;0;COCINA CH-5490NI 4P;LINEA BLANCA
10966456;;M;50;CHILENO;;Silencioso;PROVIDENCIA                   ;METROPOLITANA;1459820;4;2;4;2;1459820;0;0;0;Refrigerador SBS LS64SXP Instaview 592L;LINEA BLANCA
8771796;;M;63;CHILENO;;Boomers;PUERTO MONTT                  ;LOS LAGOS;400930;7;3;0;0;0;7;3;400930;Cocina 775X 4P;LINEA BLANCA
9589182;;F;58;CHILENO;;Boomers;PROVIDENCIA                   ;METROPOLITANA;349990;1;1;0;0;0;1;1;349990;Lavadora WA17T6260BW/ZS 17Kg Blanca;LINEA BLANCA
13328331;;F;43;CHILENO;;X;VALLENAR;ATACAMA;321980;2;1;0;0;0;2;1;321980;Refrigerador 303Lts BF Frio Directo Nordik 480;LINEA BLANCA
11025513;;F;57;CHILENO;;Boomers;CERRO NAVIA                   ;METROPOLITANA;415970;3;1;0;0;0;3;1;415970;Lavadora WT16DSBP 16Kg Silver;LINEA BLANCA
3687829;;F;83;CHILENO;;Silencioso;SAN ESTEBAN                   ;VALPARAISO;209980;2;1;0;0;0;2;1;209980;Refrigerador 210Lts Rojo Frio Dir MRFS2100R273FN;LINEA BLANCA
5970102;;F;77;CHILENO;;Silencioso;SAN ANTONIO                   ;VALPARAISO;259980;2;1;0;0;0;2;1;259980;Lavadora MLS-140GSC03T 14Kg Gris;LINEA BLANCA
19083485;;F;27;CHILENO;;Z;SAN VICENTE                   ;L.G.B.OÂ´HIGGINS;1256940;6;3;6;3;1256940;0;0;0;Cocina F-2525 4P;LINEA BLANCA
19579047;;M;25;CHILENO;;Z;PROVIDENCIA                   ;METROPOLITANA;576940;6;4;4;2;489960;2;2;86980;Refrigerador 260Lts BF Frio Direc MRFI2660SR346W;LINEA BLANCA
5937393;Casado;M;75;CHILENO;;Silencioso;RENCA                         ;METROPOLITANA;259990;1;1;0;0;0;1;1;259990;Freezer 200 Lts FDHM200BY0 Horizontal;LINEA BLANCA
16291998;;M;36;CHILENO;;Millenial;PROVIDENCIA                   ;METROPOLITANA;329980;2;1;2;1;329980;0;0;0;Lavadora Secadora Perfect Care 11/7Kg Blanca;LINEA BLANCA
11728776;;M;50;CHILENO;;X;LA LIGUA                      ;VALPARAISO;430970;3;1;0;0;0;3;1;430970;Refrigerador 290Lts BF No Frost RB30N4020S8;LINEA BLANCA
20048998;;M;23;CHILENO;;Z;"";"";307960;4;2;4;2;307960;0;0;0;Cocina Andes60TX4 4P Inox;LINEA BLANCA
18082013;;F;30;CHILENO;;Millenial;N/D;N/D;610950;5;2;0;0;0;5;2;610950;Refrigerador 260Lts BF Frio Direc MRFI2660SR346W;LINEA BLANCA
8249405;;M;63;CHILENO;;Boomers;CONCHALI                      ;METROPOLITANA;572960;4;2;0;0;0;4;2;572960;Refrigerador DW44S 400Lts Dispen No Frost;LINEA BLANCA
18482473;Soltero;F;29;CHILENO;;Silencioso;PROVIDENCIA                   ;METROPOLITANA;319980;2;1;2;1;319980;0;0;0;Lavadora Efficace SZG 19,5Kg Silver;LINEA BLANCA
6043154;;M;72;CHILENO;;Silencioso;VALDIVIA                      ;LOS RIOS;416562;4;2;0;0;0;4;2;416562;Lavadora WA17T6260BW/ZS 17Kg Blanca;LINEA BLANCA
17695495;;F;28;CHILENO;;Millenial;VILLARICA                     ;ARAUCANIA;748970;3;2;0;0;0;3;2;748970;Refrigerador 527Lts Side by Side MRSBS5300G689WE;LINEA BLANCA
16524871;;M;35;CHILENO;;Millenial;TOME                          ;BIO BIO;313990;3;1;0;0;0;3;1;313990;Lavadora WT16DSBP 16Kg Silver;LINEA BLANCA
12164617;Soltero;F;53;CHILENO;;X;PROVIDENCIA                   ;METROPOLITANA;179990;1;1;0;0;0;1;1;179990;Freezer 142Lts EFC14A5MNW Horizontal;LINEA BLANCA
9039692;;M;62;CHILENO;;Boomers;RENCA                         ;METROPOLITANA;159990;1;1;0;0;0;1;1;159990;Lavadora Semiautomatica LC-6550 6,5Kg;LINEA BLANCA
20303167;;F;22;CHILENO;;Z;"";"";528620;4;3;2;1;138640;2;2;389980;Lavadora WA17T6260BW/ZS 17Kg Blanca;LINEA BLANCA
7700557;Casado;F;67;CHILENO;;Silencioso;PROVIDENCIA                   ;METROPOLITANA;347980;2;1;0;0;0;2;1;347980;Cocina F-2808 4P;LINEA BLANCA
25801751;;M;31;EXTRANJERO - NO INFORMA NACIONALIDAD;;Extranjero;"";"";159990;1;1;0;0;0;1;1;159990;Lavadora Semiautomatica LC-6550 6,5Kg;LINEA BLANCA
16292344;;M;36;CHILENO;;Millenial;N/D;N/D;189980;2;1;0;0;0;2;1;189980;Freezer 142Lts EFC14A5MNW Horizontal;LINEA BLANCA
17713844;;F;31;CHILENO;;Millenial;N/D;N/D;531510;6;2;2;1;177540;4;1;353970;Refrigerador 252Lts No Frost MRFS-2700G333FW;LINEA BLANCA
7542664;Casado;F;66;CHILENO;CIRUJANO DENTISTA;Boomers;CAUQUENES                     ;MAULE;450000;2;1;0;0;0;2;1;450000;Refrigerador 400 Lts No Frost RMP400FHUG1;LINEA BLANCA
12076183;;F;53;CHILENO;;X;CARAHUE                       ;ARAUCANIA;361970;3;2;0;0;0;3;2;361970;Lavadora Semiautomatica Twister 5300 4Kg;LINEA BLANCA
14040098;;M;53;CHILENO;;X;OSORNO                        ;LOS LAGOS;215980;2;1;0;0;0;2;1;215980;Lavadora WA90H4400SW1ZS 9Kg Blanca;LINEA BLANCA
8587868;;F;63;CHILENO;;Boomers;NATALES                       ;MAGALLANES;329980;2;1;0;0;0;2;1;329980;Lavadora Efficace SZG 19,5Kg Silver;LINEA BLANCA
18862863;;F;27;CHILENO;;Z;SAGRADA FAMILIA               ;MAULE;165980;2;1;2;1;165980;0;0;0;Lavadora Semiautomatica LC-6550 6,5Kg;LINEA BLANCA
5062933;;F;82;CHILENO;;Silencioso;ARICA                         ;ARICA Y PARINACOTA;235980;2;1;0;0;0;2;1;235980;Refrigerador 167Lts MRFI-1700R234RN F.Direc Rojo;LINEA BLANCA
13260536;Casado;F;45;CHILENO;;X;RENCA                         ;METROPOLITANA;299980;3;2;0;0;0;3;2;299980;Cocina CMC20AXX 4P Inox;LINEA BLANCA
7859774;Casado;M;66;CHILENO;;Boomers;VILLA ALEGRE                  ;MAULE;219980;2;1;0;0;0;2;1;219980;Lavadora LMA0920WGCL0 9,5Kg Gris;LINEA BLANCA
9246752;;M;60;CHILENO;;Boomers;LA UNION                      ;LOS RIOS;179990;1;1;0;0;0;1;1;179990;Cocina CH-7400 4P;LINEA BLANCA
11189102;;F;55;CHILENO;;Boomers;QUINTERO                      ;VALPARAISO;655970;3;1;0;0;0;3;1;655970;Cocina 76DXR Doble Horno;LINEA BLANCA
11369352;;F;52;CHILENO;;X;MOLINA                        ;MAULE;305480;2;1;2;1;305480;0;0;0;Lavadora Efficace SZG 19,5Kg Silver;LINEA BLANCA
20493104;;F;21;CHILENO;;Z;"";"";265970;3;2;2;1;195980;1;1;69990;Refrigerador 167Lts MRFI-1700R234RN F.Direc Rojo;LINEA BLANCA
16109948;;M;37;CHILENO;;Millenial;COQUIMBO                      ;COQUIMBO;359980;2;2;0;0;0;2;2;359980;Cocina Andes60TX4 4P Inox;LINEA BLANCA
19496994;;F;24;CHILENO;;Z;N/D;N/D;741840;11;6;0;0;0;11;6;741840;Refrigerador 260Lts BF Frio Direc MRFI2660SR346W;LINEA BLANCA
14437268;;F;50;CHILENO;;X;TALCA                         ;MAULE;169990;1;1;0;0;0;1;1;169990;Freezer 142Lts MFH-1430B186C Horizontal;LINEA BLANCA
13019149;;M;46;CHILENO;;X;RENCA                         ;METROPOLITANA;1057960;4;2;0;0;0;4;2;1057960;Lavadora Secadora WD95T4046CE/ZS 9,5Kg/6Kg Blanc;LINEA BLANCA
24142578;;M;37;PERUANO;;Extranjero;N/D;N/D;976940;5;1;0;0;0;5;1;976940;Refrigerador French Door LM22SGPK 533 Lt;LINEA BLANCA
12137429;;F;53;CHILENO;;X;N/D;N/D;674930;7;3;7;3;674930;0;0;0;Cocina F-2808 4P;LINEA BLANCA
10148504;;M;58;CHILENO;;Boomers;N/D;N/D;389970;3;2;0;0;0;3;2;389970;Cocina CMC20AXX 4P Inox;LINEA BLANCA
9166740;;F;61;CHILENO;;Boomers;ILLAPEL                       ;COQUIMBO;229990;1;1;0;0;0;1;1;229990;Freezer 196Lts M200 Horizontal;LINEA BLANCA
17493615;;F;32;CHILENO;;Millenial;N/D;N/D;418960;4;4;0;0;0;4;4;418960;Calefont 5Lts GL Essenetial ECO;LINEA BLANCA
15502715;;F;39;CHILENO;;X;PROVIDENCIA                   ;METROPOLITANA;207470;3;1;0;0;0;3;1;207470;Secadora Ropa MSV-90 9K Blanca Ventilacion;LINEA BLANCA
16983845;Soltero;M;33;CHILENO;INGENIERO CIVIL;Millenial;PROVIDENCIA                   ;METROPOLITANA;283980;2;1;2;1;283980;0;0;0;Freezer 162 Lts SFV-205 SI Vertical;LINEA BLANCA
7713081;;F;65;CHILENO;;Boomers;ARICA                         ;ARICA Y PARINACOTA;299990;1;1;0;0;0;1;1;299990;Cocina F-2808 4P;LINEA BLANCA
9687971;;M;59;CHILENO;;Boomers;LINARES                       ;MAULE;645950;5;1;0;0;0;5;1;645950;Refrigerador 255Lts No Frost RT25FARADS8/ZS;LINEA BLANCA
15734697;;F;38;CHILENO;;X;PUERTO MONTT                  ;LOS LAGOS;513060;6;3;6;3;513060;0;0;0;Secadora Ropa MSV-90 9K Blanca Ventilacion;LINEA BLANCA
17393148;;F;32;CHILENO;;Millenial;CALAMA                        ;ANTOFAGASTA;853800;11;5;0;0;0;11;5;853800;Lavadora WT16DSBP 16Kg Silver;LINEA BLANCA
4370004;;F;80;CHILENO;;Silencioso;ANGOL                         ;ARAUCANIA;712930;7;5;0;0;0;7;5;712930;Cocina Andes60TX4 4P Inox;LINEA BLANCA
14006939;;F;41;CHILENO;;X;MELIPILLA                     ;METROPOLITANA;306980;2;1;0;0;0;2;1;306980;Cocina MCG-4QI24AME4 4P Inox;LINEA BLANCA
7038759;;M;66;CHILENO;;Boomers;VILCUN                        ;ARAUCANIA;219980;2;1;0;0;0;2;1;219980;Refrigerador 167Lts MRFI-1700R234RN F.Direc Rojo;LINEA BLANCA
16640296;Soltero;F;35;CHILENO;CONTADOR AUDITOR;Millenial;RENCA                         ;METROPOLITANA;146980;2;1;2;1;146980;0;0;0;Lavadora Semiautomatica Twister 5100 4Kg;LINEA BLANCA
19722817;;M;24;CHILENO;;Z;N/D;N/D;403970;3;2;0;0;0;3;2;403970;Cocina Andes76HG0 6P Inox;LINEA BLANCA
11007600;;F;57;CHILENO;;Boomers;VALLENAR;ATACAMA;335970;3;1;0;0;0;3;1;335970;Lavadora Efficace SZG 17,5Kg Silver;LINEA BLANCA
16975664;;F;34;CHILENO;;Millenial;COIHAIQUE                     ;AYSEN;227950;5;2;0;0;0;5;2;227950;Freezer 142Lts MFH-1430B186C Horizontal;LINEA BLANCA
15921592;;F;37;CHILENO;;Silencioso;PROVIDENCIA                   ;METROPOLITANA;128540;2;1;2;1;128540;0;0;0;FRIGOBAR 93 LTS MFB-930S121LN;LINEA BLANCA
5907565;;M;73;CHILENO;;Silencioso;CANETE                        ;BIO BIO;455040;5;2;0;0;0;5;2;455040;Cocina CH-7400 4P;LINEA BLANCA
11215384;;F;54;CHILENO;;Boomers;TEODORO SCHMIDT               ;ARAUCANIA;1108810;8;5;0;0;0;8;5;1108810;Cocina CMC20AXX 4P Inox;LINEA BLANCA
8695089;;F;66;CHILENO;;Boomers;PAINE                         ;METROPOLITANA;299970;3;1;0;0;0;3;1;299970;Freezer 196Lts M200 Horizontal;LINEA BLANCA
14301736;;F;46;CHILENO;;X;OSORNO                        ;LOS LAGOS;169990;1;1;0;0;0;1;1;169990;Cocina CH-9050SI 4P;LINEA BLANCA
12916057;;F;46;CHILENO;;X;SAN VICENTE                   ;L.G.B.OÂ´HIGGINS;349990;1;1;0;0;0;1;1;349990;Cocina F-5500 Premium 5P;LINEA BLANCA
10308578;;F;54;CHILENO;;X;PUERTO MONTT                  ;LOS LAGOS;311980;2;1;0;0;0;2;1;311980;Refrigerador 252Lts No Frost MRFS-2700G333FW;LINEA BLANCA
8188378;;F;65;CHILENO;;Boomers;TALCAHUANO                    ;BIO BIO;387540;5;3;0;0;0;5;3;387540;Lavadora Efficace SZG 17,5Kg Silver;LINEA BLANCA
12684675;;F;48;CHILENO;;X;EL BOSQUE                     ;METROPOLITANA;1371730;4;2;0;0;0;4;2;1371730;Cocina F-2808 4P;LINEA BLANCA
15695536;;F;38;CHILENO;;Millenial;"";"";341120;4;2;0;0;0;4;2;341120;Lavadora 9 Kg Carga Superior Blanca;LINEA BLANCA
8079830;Soltero;M;66;CHILENO;;Boomers;PUNTA ARENAS                  ;MAGALLANES;219970;3;1;0;0;0;3;1;219970;Lavadora Semiautomatica LC-6550 6,5Kg;LINEA BLANCA
18267105;Soltero;M;29;CHILENO;;Millenial;PROVIDENCIA                   ;METROPOLITANA;295980;2;1;0;0;0;2;1;295980;Refrigerador 260Lts BF Frio Direc MRFI2660SR346W;LINEA BLANCA
15002849;;M;40;CHILENO;;X;PROVIDENCIA                   ;METROPOLITANA;385980;2;1;2;1;385980;0;0;0;Lavadora Secadora WD95T4046CE/ZS 9,5Kg/6Kg Blanc;LINEA BLANCA
9347451;;M;60;CHILENO;;Boomers;PROVIDENCIA                   ;METROPOLITANA;388650;4;2;0;0;0;4;2;388650;Cocina F-5500 Premium 5P;LINEA BLANCA
24355370;Soltero;F;33;BOLIVIANO;;Extranjero;PROVIDENCIA                   ;METROPOLITANA;163630;3;2;2;1;138640;1;1;24990;Freezer 99Lts MFH-1000B131CN Horizontal;LINEA BLANCA
26303007;;M;45;VENEZOLANO;;Extranjero;"";"";139980;2;1;2;1;139980;0;0;0;Freezer 99Lts MFH-1000B131CN Horizontal;LINEA BLANCA
12807474;;F;46;CHILENO;;X;MONTE PATRIA                  ;COQUIMBO;841060;6;3;6;3;841060;0;0;0;Lavadora Semiautomatica Twister 5100 4Kg;LINEA BLANCA
15067052;;F;38;CHILENO;;X;PROVIDENCIA                   ;METROPOLITANA;489980;2;1;2;1;489980;0;0;0;Refrigerador 340 Lts BF No Frost GB37MPP;LINEA BLANCA
5645528;;F;76;CHILENO;;Silencioso;RENCA                         ;METROPOLITANA;261980;2;1;0;0;0;2;1;261980;Refrigerador 260Lts BF Frio Direc MRFI2660SR346W;LINEA BLANCA
19655815;;F;34;CHILENO;;Millenial;PROVIDENCIA                   ;METROPOLITANA;305980;2;1;2;1;305980;0;0;0;Lavadora WA15T5260BW/ZS 15Kg Blanca;LINEA BLANCA
14299204;;M;47;CHILENO;;X;RANCAGUA                      ;L.G.B.OÂ´HIGGINS;405970;3;2;0;0;0;3;2;405970;Cocina F-5500 Premium 5P;LINEA BLANCA
11633820;;M;52;CHILENO;;X;SANTIAGO;METROPOLITANA;329980;2;1;2;1;329980;0;0;0;Lavadora Secadora MLSF-1108BN05N 11Kg/8Kg Blanca;LINEA BLANCA
11533708;;F;51;CHILENO;;X;COIHUECO                      ;BIO BIO;570930;7;2;0;0;0;7;2;570930;Lavadora MLS-080BE04N 8Kg Blanca;LINEA BLANCA
9275365;;F;69;CHILENO;;Silencioso;PENCAHUE                      ;MAULE;1042000;9;3;0;0;0;9;3;1042000;Lavadora MLS-140GSC03T 14Kg Gris;LINEA BLANCA
18161767;;M;30;CHILENO;;Millenial;SAN ANTONIO                   ;VALPARAISO;404960;4;2;0;0;0;4;2;404960;Lavadora MLS-160BSC03T 16Kg Blanca;LINEA BLANCA
8294311;;F;63;CHILENO;;Boomers;LA GRANJA                     ;METROPOLITANA;199980;2;1;0;0;0;2;1;199980;Cocina CH-7400 4P;LINEA BLANCA
23183241;Casado;F;45;CHILENO;;Extranjero;PROVIDENCIA                   ;METROPOLITANA;93980;2;1;2;1;93980;0;0;0;Campana Cocina CAR-610 Retractil 60Cms Inox;LINEA BLANCA
9605581;;F;57;CHILENO;;Boomers;VILLARICA                     ;ARAUCANIA;692420;6;1;0;0;0;6;1;692420;Lavadora MLS-190GC03N 19Kg Gris;LINEA BLANCA
25235735;Soltero;M;32;BOLIVIANO;;Extranjero;COPIAPO                       ;ATACAMA;1111970;5;3;0;0;0;5;3;1111970;Cocina F-5500 Premium 5P;LINEA BLANCA
9544041;;M;59;CHILENO;;Boomers;SAN ANTONIO                   ;VALPARAISO;182980;2;1;0;0;0;2;1;182980;Calefon 10Lts GL ATMD;LINEA BLANCA
7147710;;F;67;CHILENO;;Boomers;PUTAENDO                      ;VALPARAISO;347980;2;1;0;0;0;2;1;347980;Lavadora WT16DSBP 16Kg Silver;LINEA BLANCA
11183770;;F;55;CHILENO;;Boomers;SAN ANTONIO                   ;VALPARAISO;385980;2;1;0;0;0;2;1;385980;Cocina Andes60TX4 4P Inox;LINEA BLANCA
15507960;;M;36;CHILENO;;Millenial;SANTIAGO                      ;METROPOLITANA;173980;2;1;2;1;173980;0;0;0;Lavadora LMA0920WGCL0 9,5Kg Gris;LINEA BLANCA
8210920;;F;66;CHILENO;;Boomers;LOS ANGELES                   ;BIO BIO;475310;7;3;0;0;0;7;3;475310;Lavadora MLS-140GSC03T 14Kg Gris;LINEA BLANCA
16193997;Soltero;F;35;CHILENO;;Millenial;RENCA                         ;METROPOLITANA;279980;2;1;2;1;279980;0;0;0;Cocina Andes60TX4 4P Inox;LINEA BLANCA
16019915;;M;36;CHILENO;;Millenial;NUNOA;METROPOLITANA;363980;2;1;2;1;363980;0;0;0;Lavavajillas FS FDV Element 10C;LINEA BLANCA
26006489;;F;35;VENEZOLANO;;Extranjero;N/D;N/D;229890;2;1;2;1;229890;0;0;0;Refrigerador 252Lts No Frost MRFS-2700G333FW;LINEA BLANCA
6994771;Casado;M;68;CHILENO;MEDICO CIRUJANO;Boomers;VINA DEL MAR                  ;VALPARAISO;270980;2;1;0;0;0;2;1;270980;Secadora Electrica SEM101BDBY Blanca 10 KG;LINEA BLANCA
9429781;;M;60;CHILENO;;Boomers;LA SERENA                     ;COQUIMBO;558920;8;3;0;0;0;8;3;558920;Freezer 196Lts M200 Horizontal;LINEA BLANCA
6376585;;F;69;CHILENO;;Silencioso;PROVIDENCIA                   ;METROPOLITANA;83980;2;1;2;1;83980;0;0;0;CAMPANA COCINA UT VF 60 BLANCA 1M;LINEA BLANCA
12723426;;F;49;CHILENO;;X;N/D;N/D;159990;1;1;0;0;0;1;1;159990;Freezer 142Lts MFH-1430B186C Horizontal;LINEA BLANCA
9631561;;M;59;CHILENO;;Boomers;ROMERAL                       ;MAULE;222960;4;4;0;0;0;4;4;222960;Cocina CH-7400 4P;LINEA BLANCA
18016621;;M;30;CHILENO;;Millenial;SANTIAGO                      ;METROPOLITANA;300000;2;1;0;0;0;2;1;300000;Refrigerador 252Lts No Frost MRFS-2700G333FW;LINEA BLANCA
9185307;;F;66;CHILENO;;Boomers;CALAMA                        ;ANTOFAGASTA;285980;2;1;0;0;0;2;1;285980;Lavadora MLS-160BSC03T 16Kg Blanca;LINEA BLANCA
6884609;;F;73;CHILENO;;Silencioso;SAN BERNARDO                  ;METROPOLITANA;662970;3;1;0;0;0;3;1;662970;Cocina 76DXR Doble Horno;LINEA BLANCA
20403982;;M;22;CHILENO;;Z;"";"";266980;2;1;0;0;0;2;1;266980;Refrigerador 260Lts BF Frio Direc MRFI2660SR346W;LINEA BLANCA
19650370;;M;25;CHILENO;;Z;CONSTITUCION                  ;MAULE;229990;1;1;0;0;0;1;1;229990;Lavadora MLS-140GSC03T 14Kg Gris;LINEA BLANCA
15259111;Soltero;F;47;CHILENO;;X;RENCA                         ;METROPOLITANA;209980;2;1;0;0;0;2;1;209980;Cocina CMC20AXX 4P Inox;LINEA BLANCA
16404212;;F;36;CHILENO;;Millenial;SAN ANTONIO                   ;VALPARAISO;344970;3;2;2;1;184980;1;1;159990;Freezer 142Lts MFH-1430B186C Horizontal;LINEA BLANCA
8902046;;M;61;CHILENO;;Boomers;ARICA                         ;ARICA Y PARINACOTA;256980;2;1;0;0;0;2;1;256980;Freezer 145 Lts FDHM150BY0 Horizontal;LINEA BLANCA
9639221;;F;59;CHILENO;;Boomers;ANTOFAGASTA                   ;ANTOFAGASTA;674960;4;2;0;0;0;4;2;674960;Refrigerador RT35K5730SL/ZS 361Lta No Frost;LINEA BLANCA
5386743;;F;83;CHILENO;;Silencioso;TALAGANTE                     ;METROPOLITANA;395970;3;1;0;0;0;3;1;395970;Cocina Andes76HG0 6P Inox;LINEA BLANCA
15925488;Casado;M;37;CHILENO;;Millenial;RENCA                         ;METROPOLITANA;773960;4;2;4;2;773960;0;0;0;Lavadora WT13WSBP 13Kg Blanca;LINEA BLANCA
15604825;;F;38;CHILENO;;X;PROVIDENCIA                   ;METROPOLITANA;509980;2;1;2;1;509980;0;0;0;Refrigerador 527Lts Side by Side MRSBS5300G689WE;LINEA BLANCA
12014539;;M;51;CHILENO;;X;PANGUIPULLI                   ;LOS RIOS;346980;2;1;0;0;0;2;1;346980;Refrigerador 252Lts No Frost MRFS-2700G333FW;LINEA BLANCA
17972876;;F;31;CHILENO;;Millenial;VILLARICA                     ;ARAUCANIA;169990;1;1;1;1;169990;0;0;0;Cocina CMC20AXX 4P Inox;LINEA BLANCA
4023733;;F;84;CHILENO;;Silencioso;TALCA                         ;MAULE;353980;2;1;0;0;0;2;1;353980;Lavadora Efficace SZG 19,5Kg Silver;LINEA BLANCA
8568433;;M;51;CHILENO;;X;N/D;N/D;559970;3;2;0;0;0;3;2;559970;Cocina CMC20AXX 4P Inox;LINEA BLANCA
21529700;;M;48;CHILENO;;Extranjero;CALAMA                        ;ANTOFAGASTA;249990;1;1;0;0;0;1;1;249990;Refrigerador 252Lts No Frost MRFS-2700G333FW;LINEA BLANCA
13371389;;F;43;CHILENO;;X;N/D;N/D;394980;2;1;2;1;394980;0;0;0;Refrigerador LB33MPP 306Lts Bottom No Frost;LINEA BLANCA
18222644;Soltero;F;29;CHILENO;;Millenial;N/D;N/D;169990;1;1;0;0;0;1;1;169990;Freezer horizontal 142Lts lfh-151 blanco;LINEA BLANCA
5684499;Casado;F;75;CHILENO;;Silencioso;PROVIDENCIA                   ;METROPOLITANA;339990;1;1;0;0;0;1;1;339990;Cocina Andes60TX4 4P Inox;LINEA BLANCA
24009262;;M;48;BOLIVIANO;;Extranjero;TOCOPILLA                     ;ANTOFAGASTA;1177910;9;3;0;0;0;9;3;1177910;Refrigerador 322Lts No Frost BF DB60S;LINEA BLANCA
8898848;;F;62;CHILENO;;Boomers;VALLENAR;ATACAMA;238640;2;1;2;1;238640;0;0;0;Lavadora MLS-160BSC03T 16Kg Blanca;LINEA BLANCA
14080910;;F;43;CHILENO;;X;"";"";444980;2;1;2;1;444980;0;0;0;Refrigerador Side by side Multidoor DM64S;LINEA BLANCA
15101128;Soltero;M;39;CHILENO;;X;QUILPUE                       ;VALPARAISO;351980;2;1;0;0;0;2;1;351980;Refrigerador 249Lts No Frost RMA250PHUG;LINEA BLANCA
11275842;;F;54;CHILENO;;X;LAS CABRAS                    ;L.G.B.OÂ´HIGGINS;586250;4;3;0;0;0;4;3;586250;Refrigerador 254Lts No Frost GT29WPPDC;LINEA BLANCA
7966394;;F;66;CHILENO;;Boomers;CARAHUE                       ;ARAUCANIA;189990;1;1;0;0;0;1;1;189990;Lavadora WA90H4400SW/ZS 9Kg Blanca;LINEA BLANCA
13172348;;M;45;CHILENO;;X;ARICA                         ;ARICA Y PARINACOTA;316470;3;1;0;0;0;3;1;316470;Cocina 785FX 4P;LINEA BLANCA
14183330;;M;41;CHILENO;;X;N/D;N/D;354960;4;1;0;0;0;4;1;354960;Freezer 200 Lts FDHM200BY0 Horizontal;LINEA BLANCA
11060822;;F;58;CHILENO;;Boomers;CAUQUENES                     ;MAULE;197370;2;1;0;0;0;2;1;197370;Freezer 142Lts MFH-1430B186C Horizontal;LINEA BLANCA
10979999;;F;43;CHILENO;;X;NATALES                       ;MAGALLANES;109990;1;1;0;0;0;1;1;109990;Calefon 7Lts GL Master;LINEA BLANCA
8203043;;F;60;CHILENO;;Boomers;VILLA ALEMANA                 ;VALPARAISO;439980;2;1;2;1;439980;0;0;0;Refrigerador Side by side Multidoor DM64S;LINEA BLANCA
6605471;;F;73;CHILENO;;Silencioso;CHILLAN                       ;BIO BIO;226480;3;1;0;0;0;3;1;226480;Cocina CH-7400 4P;LINEA BLANCA
19860770;;F;24;CHILENO;;Z;"";"";143980;2;1;2;1;143980;0;0;0;Lavadora MLS-090GE04N 9Kg Gris;LINEA BLANCA
7120358;;F;68;CHILENO;;Boomers;PROVIDENCIA                   ;METROPOLITANA;221980;2;1;0;0;0;2;1;221980;Cocina MV 220 4P;LINEA BLANCA
18729215;;F;28;CHILENO;;Millenial;PADRE LAS CASAS               ;ARAUCANIA;580950;5;1;0;0;0;5;1;580950;Refrigerador 252Lts No Frost MRFS-2700G333FW;LINEA BLANCA
12537236;;F;48;CHILENO;;X;TEMUCO                        ;ARAUCANIA;269990;1;1;0;0;0;1;1;269990;Refrigerador 252Lts No Frost MRFS-2700G333FW;LINEA BLANCA
19146358;;F;26;CHILENO;;Z;CHONCHI                       ;LOS LAGOS;371980;2;1;0;0;0;2;1;371980;Refrigerador 300Lts No Frost RT29K500JS8/ZS;LINEA BLANCA
7114743;;M;64;CHILENO;;Boomers;VALPARAISO                    ;VALPARAISO;509980;2;1;2;1;509980;0;0;0;Refrigerador 425Lts No Frost Altus 1430W;LINEA BLANCA
7825091;;M;66;CHILENO;;Boomers;PROVIDENCIA                   ;METROPOLITANA;81540;2;1;2;1;81540;0;0;0;Encimera CE2-435I 2P Inox;LINEA BLANCA
24467430;;F;35;COLOMBIANO;;Extranjero;N/D;N/D;279370;2;1;0;0;0;2;1;279370;Refrigerador 252Lts No Frost MRFS-2700G333FW;LINEA BLANCA
20070319;;F;23;CHILENO;;Z;N/D;N/D;125480;2;1;2;1;125480;0;0;0;ENCIMERA A GAS CMG6044SD-0CL 4Q MABE;LINEA BLANCA
6735402;;F;71;CHILENO;;Silencioso;RENCA                         ;METROPOLITANA;263980;2;1;2;1;263980;0;0;0;Freezer Vertical M165V 165Lts;LINEA BLANCA
16233122;;F;36;CHILENO;;Millenial;VINA DEL MAR                  ;VALPARAISO;334980;2;1;2;1;334980;0;0;0;KIT-138 HORNO HE-7200IN+CEG-4600IN+CA-610EIN;LINEA BLANCA
6339631;Viudo;F;75;CHILENO;;Silencioso;BUIN                          ;METROPOLITANA;339980;2;1;0;0;0;2;1;339980;Freezer 162 Lts SFV-205 SI Vertical;LINEA BLANCA
8309174;;M;64;CHILENO;;Boomers;N/D;N/D;332560;3;1;0;0;0;3;1;332560;Lavadora Efficace SZG 17,5Kg Silver;LINEA BLANCA
15695722;;F;38;CHILENO;;Millenial;IQUIQUE                       ;TARAPACA;337860;3;1;0;0;0;3;1;337860;REFRIGERADOR TOP MOUNT GT29BPPK NO FROST 254 Lt;LINEA BLANCA
17500318;;F;32;CHILENO;;Millenial;NANCAGUA                      ;L.G.B.OÂ´HIGGINS;169990;1;1;0;0;0;1;1;169990;Freezer 145 Lts FDHM150BY0 Horizontal;LINEA BLANCA
6891910;;F;65;CHILENO;;Boomers;RENCA                         ;METROPOLITANA;202770;2;1;0;0;0;2;1;202770;Lavadora Semiautomatica Twister 5300 4Kg;LINEA BLANCA
10272216;;M;56;CHILENO;;Boomers;"";"";509980;2;1;2;1;509980;0;0;0;Refrigerador Side by side Multidoor DM64S;LINEA BLANCA
13946243;Casado;M;44;CHILENO;;X;SAN VICENTE                   ;L.G.B.OÂ´HIGGINS;331980;2;1;0;0;0;2;1;331980;Lavadora WA15T5260BW/ZS 15Kg Blanca;LINEA BLANCA
7505138;;F;67;CHILENO;;Boomers;CAUQUENES                     ;MAULE;269970;3;2;0;0;0;3;2;269970;Lavadora LMA0920WGCL0 9,5Kg Gris;LINEA BLANCA
14172364;;F;41;CHILENO;;X;SAN ANTONIO                   ;VALPARAISO;685440;5;2;0;0;0;5;2;685440;Cocina F-2808 4P;LINEA BLANCA
15396984;;M;38;CHILENO;;X;CAUQUENES                     ;MAULE;714970;3;1;0;0;0;3;1;714970;Lavadora WT16DSBP 16Kg Silver;LINEA BLANCA
19370470;;F;26;CHILENO;;Extranjero;LOS ANGELES                   ;BIO BIO;145840;2;1;2;1;145840;0;0;0;Lavadora WA80H4200SW/ZS 8Kg Blanca;LINEA BLANCA
6690043;;F;69;CHILENO;;Silencioso;RENCA                         ;METROPOLITANA;230980;2;1;0;0;0;2;1;230980;Freezaer Vertical MFV 545B 165Lts;LINEA BLANCA
15329188;;M;39;CHILENO;;Silencioso;PROVIDENCIA                   ;METROPOLITANA;173980;2;1;2;1;173980;0;0;0;Cocina MV 120 4 Platos;LINEA BLANCA
11199457;;F;54;CHILENO;;Boomers;BUIN                          ;METROPOLITANA;299980;2;1;0;0;0;2;1;299980;Cocina 795XF 4P;LINEA BLANCA
19331933;;M;26;CHILENO;;Z;PROVIDENCIA                   ;METROPOLITANA;165840;2;1;2;1;165840;0;0;0;Secadora Ropa MSV-90 9K Blanca Ventilacion;LINEA BLANCA
9775627;Soltero;M;56;CHILENO;MEDICO VETERINARIO;Boomers;RENCA                         ;METROPOLITANA;279980;2;1;2;1;279980;0;0;0;Refrigerador 244Lts Frio Directo Progress 3100;LINEA BLANCA
12303492;;M;50;CHILENO;;X;N/D;N/D;135840;2;1;2;1;135840;0;0;0;ENCIMERA A GAS 4 PLATOS CEG-4650 INOX;LINEA BLANCA
16380166;;M;36;CHILENO;;Silencioso;PROVIDENCIA                   ;METROPOLITANA;229980;2;1;2;1;229980;0;0;0;Freezaer Vertical MFV 545B 165Lts;LINEA BLANCA
13785294;;F;41;CHILENO;;X;PROVIDENCIA                   ;METROPOLITANA;199990;1;1;0;0;0;1;1;199990;Cocina CH-7400 4P;LINEA BLANCA
13627789;;M;42;CHILENO;;X;LOS ALAMOS                    ;BIO BIO;263980;2;1;2;1;263980;0;0;0;Refrigerador 244Lts Frio Directo Progress 3100;LINEA BLANCA
24587264;;M;34;BOLIVIANO;;Extranjero;ALTO HOSPICIO;TARAPACA;432840;4;2;0;0;0;4;2;432840;Freezer 145 Lts FDHM150BY0 Horizontal;LINEA BLANCA
9850081;;F;61;CHILENO;;Boomers;PROVIDENCIA                   ;METROPOLITANA;303980;2;1;0;0;0;2;1;303980;Freezer 200 Lts FDHM200BY0 Horizontal;LINEA BLANCA
15742254;;F;52;CHILENO;;X;NOGALES                       ;VALPARAISO;227370;2;1;0;0;0;2;1;227370;Cocina CH-7400 4P;LINEA BLANCA
19047185;;M;27;CHILENO;;Z;PROVIDENCIA                   ;METROPOLITANA;339970;3;2;3;2;339970;0;0;0;Lavadora WT13WSBP 13Kg Blanca;LINEA BLANCA
15912010;;M;37;CHILENO;;Silencioso;PROVIDENCIA                   ;METROPOLITANA;266980;2;1;2;1;266980;0;0;0;Refrigerador 249Lts No Frost RMA250PHUG;LINEA BLANCA
18967126;;M;27;CHILENO;;Z;MOLINA                        ;MAULE;281980;2;1;2;1;281980;0;0;0;Lavadora Efficace SZG 17,5Kg Silver;LINEA BLANCA
7451992;;F;64;CHILENO;;Boomers;CABILDO                       ;VALPARAISO;162980;2;1;0;0;0;2;1;162980;Cocina CMC20AXX 4P Inox;LINEA BLANCA
7659853;;M;62;CHILENO;;Boomers;PUNTA ARENAS                  ;MAGALLANES;349990;1;1;0;0;0;1;1;349990;Refrigerador 254Lts No Frost GT29WPPDC;LINEA BLANCA
18957120;;F;27;CHILENO;;Millenial;"";"";143980;2;1;2;1;143980;0;0;0;Lavadora WA80H4200SW/ZS 8Kg Blanca;LINEA BLANCA
8447277;;F;66;CHILENO;;Boomers;SAN ANTONIO                   ;VALPARAISO;177370;2;1;0;0;0;2;1;177370;Calefon 11Lts GL Master;LINEA BLANCA
10373232;;F;59;CHILENO;;Boomers;MAFIL                         ;LOS RIOS;232980;2;1;0;0;0;2;1;232980;Refrigerador 210Lts Rojo Frio Dir MRFS2100R273FN;LINEA BLANCA
16520472;;F;35;CHILENO;;Millenial;PROVIDENCIA                   ;METROPOLITANA;139980;2;1;2;1;139980;0;0;0;Freezer 99Lts MFH-1000B131CN Horizontal;LINEA BLANCA
16342051;Soltero;M;36;CHILENO;QUIMICO FARMACEUTICO;Millenial;PROVIDENCIA                   ;METROPOLITANA;513970;3;2;2;1;509980;1;1;3990;Lavadora Secadora Frontal 12 / 7Kg Inox Titan;LINEA BLANCA
18030188;;F;30;CHILENO;;Millenial;ISLA DE MAIPO                 ;METROPOLITANA;259370;2;1;0;0;0;2;1;259370;Lavadora LMA0920WGCL0 9,5Kg Gris;LINEA BLANCA
18894609;Soltero;F;27;CHILENO;NUTRICIONISTA;Millenial;PROVIDENCIA                   ;METROPOLITANA;711970;3;2;3;2;711970;0;0;0;Refrigerador 241Lts BF Frio Directo Nordik 415;LINEA BLANCA
13514432;;F;43;CHILENO;;X;RENCA                         ;METROPOLITANA;188980;2;1;0;0;0;2;1;188980;Lavadora WA80H4200SW/ZS 8Kg Blanca;LINEA BLANCA
8279808;;M;62;CHILENO;;Silencioso;PENAFLOR                      ;METROPOLITANA;349980;2;1;0;0;0;2;1;349980;REFRIGERADOR 234Lt TMF RT22FARADS8/ZS;LINEA BLANCA
18201262;;F;30;CHILENO;;Silencioso;PROVIDENCIA                   ;METROPOLITANA;249980;2;1;2;1;249980;0;0;0;Refrigerador 241Lts BF Frio Directo Nordik 415;LINEA BLANCA
7337620;;M;66;CHILENO;;Boomers;PUENTE ALTO                   ;METROPOLITANA;279990;1;1;0;0;0;1;1;279990;Lavadora Efficace SZG 17,5Kg Silver;LINEA BLANCA
19143367;;F;26;CHILENO;;Z;SAN ANTONIO                   ;VALPARAISO;299980;2;1;2;1;299980;0;0;0;Lavadora Efficace SZG 15,5Kg Silver;LINEA BLANCA
17997280;;M;30;CHILENO;;Silencioso;PROVIDENCIA                   ;METROPOLITANA;325970;3;1;3;1;325970;0;0;0;Secadora Ropa MSV-90 9K Blanca Ventilacion;LINEA BLANCA
13769755;;M;43;CHILENO;;X;PROVIDENCIA                   ;METROPOLITANA;169980;2;1;2;1;169980;0;0;0;Freezer Horizontal MFH-1990B258CN 198Lts;LINEA BLANCA
13758462;;M;42;CHILENO;;X;PENAFLOR                      ;METROPOLITANA;839980;2;1;2;1;839980;0;0;0;Refrigerador French Door LM22SGPK 533 Lt;LINEA BLANCA
5189583;;M;78;CHILENO;;Silencioso;LA CRUZ                       ;VALPARAISO;368460;3;1;0;0;0;3;1;368460;Lavadora Efficace SZG 17,5Kg Silver;LINEA BLANCA
26585786;;M;46;VENEZOLANO;;Extranjero;N/D;N/D;604860;3;1;0;0;0;3;1;604860;Refrigerador 400Lts No Frost RMP400FZUC Dispen;LINEA BLANCA
5643858;;F;70;CHILENO;;Silencioso;SAN ANTONIO                   ;VALPARAISO;392760;3;1;0;0;0;3;1;392760;Lavadora WT16DSBP 16Kg Silver;LINEA BLANCA
15756818;;M;38;CHILENO;;Silencioso;PROVIDENCIA                   ;METROPOLITANA;509980;2;1;2;1;509980;0;0;0;Lavadora Secadora Frontal 12 / 7Kg Inox Titan;LINEA BLANCA
15812958;;F;38;CHILENO;;Millenial;ANTOFAGASTA                   ;ANTOFAGASTA;234260;4;1;4;1;234260;0;0;0;Secadora Ropa MSV-90 9K Blanca Ventilacion;LINEA BLANCA
5380613;;M;76;CHILENO;;Silencioso;HIJUELAS                      ;VALPARAISO;378460;3;1;0;0;0;3;1;378460;Lavadora MLS-190GC03N 19Kg Gris;LINEA BLANCA
7146321;Casado;M;66;CHILENO;;Boomers;ILLAPEL                       ;COQUIMBO;251480;2;1;0;0;0;2;1;251480;Refrigerador 2100-S 207Lts Frio Directo;LINEA BLANCA
16884788;;M;33;CHILENO;;Millenial;N/D;N/D;179980;2;1;0;0;0;2;1;179980;Freezer 142Lts MFH-1430B186C Horizontal;LINEA BLANCA
9441547;;F;59;CHILENO;;Boomers;CHIMBARONGO                   ;L.G.B.OÂ´HIGGINS;110662;3;2;0;0;0;3;2;110662;Calefon 5Lts GL Master;LINEA BLANCA
7391338;;M;67;CHILENO;;Boomers;RENCA                         ;METROPOLITANA;333570;2;1;0;0;0;2;1;333570;Refrigerador 252Lts No Frost MRFS-2700G333FW;LINEA BLANCA
9766524;;M;56;CHILENO;;Boomers;SANTIAGO                      ;METROPOLITANA;301970;3;1;0;0;0;3;1;301970;Cocina CH-9950NG-1 6P Negro;LINEA BLANCA
4960223;;F;77;CHILENO;;Silencioso;YERBAS BUENAS                 ;MAULE;253360;3;1;0;0;0;3;1;253360;Lavadora Efficace BZG 9,5Kg Blanca;LINEA BLANCA
15226073;Soltero;M;39;CHILENO;PROFESOR;X;PROVIDENCIA                   ;METROPOLITANA;284980;2;1;2;1;284980;0;0;0;Lavadora Brilliant SG 15Kg Silver;LINEA BLANCA
7210406;Soltero;M;66;CHILENO;AGROINDUSTRIA;Boomers;LOS ANDES                     ;VALPARAISO;486060;3;1;0;0;0;3;1;486060;Refrigerador 300Lts No Frost RT29K500JS8/ZS;LINEA BLANCA
17476611;;F;31;CHILENO;;Silencioso;PROVIDENCIA                   ;METROPOLITANA;339980;2;1;2;1;339980;0;0;0;KIT-138 HORNO HE-7200IN+CEG-4600IN+CA-610EIN;LINEA BLANCA
11783918;;F;51;CHILENO;;X;ILLAPEL                       ;COQUIMBO;139990;1;1;0;0;0;1;1;139990;Lavadora Semiautomatica Twister 5100 4Kg;LINEA BLANCA
26685541;;F;30;VENEZOLANO;;Extranjero;N/D;N/D;279990;1;1;0;0;0;1;1;279990;Cocina Andes60TX4 4P Inox;LINEA BLANCA
7167189;Soltero;F;70;CHILENO;;Silencioso;CHILLAN                       ;BIO BIO;254860;3;1;0;0;0;3;1;254860;Lavadora Efficace BZG 9,5Kg Blanca;LINEA BLANCA
19486184;;F;25;CHILENO;;Z;N/D;N/D;269980;2;1;2;1;269980;0;0;0;COCINA CH-6700IN 4P;LINEA BLANCA
20688730;;F;21;CHILENO;;Z;QUILPUE;VALPARAISO;374960;3;1;3;1;374960;0;0;0;Lavadora MLS-090GE04N 9Kg Gris;LINEA BLANCA
6978519;Casado;M;64;CHILENO;;Silencioso;PROVIDENCIA                   ;METROPOLITANA;679980;2;1;2;1;679980;0;0;0;Refrigerador BMF con Dispensador 442 Lts LB45SGP;LINEA BLANCA
12899343;;F;46;CHILENO;;X;LA PINTANA                    ;METROPOLITANA;402760;3;1;0;0;0;3;1;402760;KIT-138 HORNO HE-7200IN+CEG-4600IN+CA-610EIN;LINEA BLANCA
11986356;;M;49;CHILENO;;X;RENCA                         ;METROPOLITANA;273980;2;1;2;1;273980;0;0;0;TERMO ELECTRICO 150 LITROS (SPLENDID);LINEA BLANCA
16766592;;M;34;CHILENO;;Millenial;CORONEL                       ;BIO BIO;362869;2;1;0;0;0;2;1;362869;Lavadora Efficace SZG 17,5Kg Silver;LINEA BLANCA
12041943;;F;46;CHILENO;;X;N/D;N/D;300650;4;1;0;0;0;4;1;300650;Refrigerador 241Lts BF Frio Directo Nordik 415;LINEA BLANCA
8188200;;M;66;CHILENO;;Boomers;CURANILAHUE                   ;BIO BIO;289990;1;1;0;0;0;1;1;289990;Cocina F-2808 4P;LINEA BLANCA
13930096;;M;42;CHILENO;;X;PROVIDENCIA                   ;METROPOLITANA;419980;2;1;2;1;419980;0;0;0;Refrigerador No Frost con Dispensador 312 Lts GT;LINEA BLANCA
8793812;Soltero;F;63;CHILENO;;Boomers;CANETE                        ;BIO BIO;340480;2;1;0;0;0;2;1;340480;Refrigerador 244Lts Frio Directo Progress 3100;LINEA BLANCA
9477826;;M;60;CHILENO;;Millenial;SAN BERNARDO                  ;METROPOLITANA;230560;3;1;0;0;0;3;1;230560;Freezer Horizontal M100 99Lts;LINEA BLANCA
5606530;;F;74;CHILENO;;Silencioso;RENCA                         ;METROPOLITANA;309990;1;1;0;0;0;1;1;309990;Lavadora Efficace SZG 15,5Kg Silver;LINEA BLANCA
8891154;;F;62;CHILENO;;Boomers;SAN VICENTE                   ;L.G.B.OÂ´HIGGINS;108270;2;1;0;0;0;2;1;108270;Calefon 7Lts GL ATMD;LINEA BLANCA
11406728;;F;52;CHILENO;;X;CONCEPCION                    ;BIO BIO;953950;4;1;0;0;0;4;1;953950;Secadora Ropa MSC-90 9K Blanca Condensacion;LINEA BLANCA
19211564;;F;26;CHILENO;;Z;N/D;N/D;253980;2;1;2;1;253980;0;0;0;Lavadora MLS-140BSC03T 14Kg Blanca;LINEA BLANCA
11354892;;M;54;CHILENO;;Boomers;TEMUCO                        ;ARAUCANIA;159470;2;1;0;0;0;2;1;159470;Lavadora Semiautomatica Twister 5300 4Kg;LINEA BLANCA
19411957;Soltero;M;25;CHILENO;;Z;MELIPILLA                     ;METROPOLITANA;409980;2;1;0;0;0;2;1;409980;Lavadora WT19DSBP 19Kg Silver;LINEA BLANCA
12401584;;F;49;CHILENO;;X;NOGALES                       ;VALPARAISO;372960;5;2;0;0;0;5;2;372960;Freezer Horizontal M100 99Lts;LINEA BLANCA
16741748;;M;35;CHILENO;;Silencioso;PROVIDENCIA                   ;METROPOLITANA;399980;2;1;2;1;399980;0;0;0;Refrigerador LB33MPP 306Lts Bottom No Frost;LINEA BLANCA
6304100;;M;72;CHILENO;;Silencioso;TALAGANTE                     ;METROPOLITANA;218370;2;1;0;0;0;2;1;218370;Freezer FDHM150BY1 150Lts Horizontal;LINEA BLANCA
11892999;;F;51;CHILENO;;X;SANTIAGO                      ;METROPOLITANA;265560;3;1;0;0;0;3;1;265560;Lavadora Efficace BZG 9,5Kg Blanca;LINEA BLANCA
12336750;;F;50;CHILENO;;X;ALGARROBO                     ;VALPARAISO;216970;3;2;0;0;0;3;2;216970;Secadora Ropa MSV-90 9K Blanca Ventilacion;LINEA BLANCA
19387510;;F;26;CHILENO;;Z;N/D;N/D;0;0;0;0;0;0;0;0;0;Lavadora Premium Care 20SZ 20Kg Silver;LINEA BLANCA
12483632;;F;48;CHILENO;;X;RENCA                         ;METROPOLITANA;0;0;0;0;0;0;0;0;0;Lavadora 9 Kg Carga Superior Blanca;LINEA BLANCA
4859859;;F;79;CHILENO;;Silencioso;MALLOA                        ;L.G.B.OÂ´HIGGINS;0;0;0;0;0;0;0;0;0;Cocina CH-7400 4P;LINEA BLANCA
11800353;;M;52;CHILENO;;Silencioso;PROVIDENCIA                   ;METROPOLITANA;0;0;0;0;0;0;0;0;0;Cocina CMC20AXX 4P Inox;LINEA BLANCA
17092182;;M;33;CHILENO;;Millenial;ANTOFAGASTA                   ;ANTOFAGASTA;0;0;0;0;0;0;0;0;0;Lavadora WA17T6260BW/ZS 17Kg Blanca;LINEA BLANCA
11059677;;M;56;CHILENO;;Boomers;PEUMO                         ;L.G.B.OÂ´HIGGINS;0;0;0;0;0;0;0;0;0;Lavadora Premium Care Pro 16Kg Silver;LINEA BLANCA
25177945;;F;27;PERUANO;;Extranjero;IQUIQUE                       ;TARAPACA;0;0;0;0;0;0;0;0;0;Refrigerador 290LTS No Frost RMB302PXLRS0;LINEA BLANCA
15404887;Soltero;F;40;CHILENO;;X;PROVIDENCIA                   ;METROPOLITANA;0;0;0;0;0;0;0;0;0;Lavadora Premium Care 20SZ 20Kg Silver;LINEA BLANCA
7666847;;M;65;CHILENO;;Boomers;MELIPILLA                     ;METROPOLITANA;0;0;0;0;0;0;0;0;0;Cocina MV 110 4 Platos;LINEA BLANCA
7251691;;M;66;CHILENO;;Boomers;LA GRANJA                     ;METROPOLITANA;0;0;0;0;0;0;0;0;0;Cocina F-5500 Premium 5P;LINEA BLANCA
24086570;;M;47;HAITIANO;;Extranjero;QUILPUE                       ;VALPARAISO;0;0;0;0;0;0;0;0;0;Cocina Andes7650FX 5P Inox;LINEA BLANCA
9297021;;M;61;CHILENO;;Boomers;SAN PEDRO                     ;METROPOLITANA;0;0;0;0;0;0;0;0;0;Freezer Horizontal MFH-1990B258CN 198Lts;LINEA BLANCA
9915083;;F;54;CHILENO;;Boomers;N/D;N/D;0;0;0;0;0;0;0;0;0;Refrigerador 254Lts No Frost GT29WPPDC;LINEA BLANCA
15954234;;F;37;CHILENO;;Millenial;N/D;N/D;0;0;0;0;0;0;0;0;0;Lavadora Efficace SZG 15,5Kg Silver;LINEA BLANCA
13240960;Casado;M;45;CHILENO;INGENIERO CIVIL INDUSTRIAL;Silencioso;PROVIDENCIA                   ;METROPOLITANA;0;0;0;0;0;0;0;0;0;CALEFON CALEFON RHEEM TN 14L GL;LINEA BLANCA
5670854;;M;74;CHILENO;;Silencioso;CORONEL                       ;BIO BIO;0;0;0;0;0;0;0;0;0;Refrigerador 252Lts No Frost MRFS-2700G333FW;LINEA BLANCA
6377324;;M;66;CHILENO;;Boomers;PROVIDENCIA                   ;METROPOLITANA;0;0;0;0;0;0;0;0;0;Centrifuga Primma 5B 5,5Kilos;LINEA BLANCA
10116773;;M;57;CHILENO;;Boomers;ANCUD                         ;LOS LAGOS;0;0;0;0;0;0;0;0;0;Lavadora LMA0920WGCL0 9,5Kg Gris;LINEA BLANCA
12547232;;F;47;CHILENO;;X;PROVIDENCIA                   ;METROPOLITANA;0;0;0;0;0;0;0;0;0;CENTRIFUGA C-752;LINEA BLANCA
12134919;;M;41;CHILENO;;X;N/D;N/D;0;0;0;0;0;0;0;0;0;Refrigerador 290LTS No Frost RMB302PXLRS0;LINEA BLANCA
10622170;Casado;F;55;CHILENO;;Boomers;RENCA                         ;METROPOLITANA;0;0;0;0;0;0;0;0;0;Refrigerador 290Lts BF No Frost RB30N4020S8;LINEA BLANCA
20151282;;M;23;CHILENO;;Silencioso;PROVIDENCIA                   ;METROPOLITANA;0;0;0;0;0;0;0;0;0;Cocina CH-9950NG-1 6P Negro;LINEA BLANCA
16259814;;M;36;CHILENO;;Millenial;N/D;N/D;0;0;0;0;0;0;0;0;0;Refrigerador 525Lts Side by Side SFX500;LINEA BLANCA
14907172;;F;41;CHILENO;;Millenial;TALCAHUANO                    ;BIO BIO;0;0;0;0;0;0;0;0;0;Secadora Electrica SEM101BDBY Blanca 10 KG;LINEA BLANCA
26118378;Soltero;M;30;COLOMBIANO;MEDICO CIRUJANO;Extranjero;PROVIDENCIA                   ;METROPOLITANA;0;0;0;0;0;0;0;0;0;Lavadora Secadora Frontal 12 / 7Kg Inox Titan;LINEA BLANCA
14280513;;F;48;CHILENO;;X;VALDIVIA                      ;LOS RIOS;0;0;0;0;0;0;0;0;0;Cocina CH-7400 4P;LINEA BLANCA
10177079;;M;51;CHILENO;;X;TIERRA AMARILLA               ;ATACAMA;0;0;0;0;0;0;0;0;0;Lavadora WA90H4400SW/ZS 9Kg Blanca;LINEA BLANCA
20204785;;M;23;CHILENO;;Z;PENALOLEN                     ;METROPOLITANA;0;0;0;0;0;0;0;0;0;Refrigerador Bottom No Frost con Dispensador 336;LINEA BLANCA
5533988;;M;76;CHILENO;;Silencioso;OSORNO                        ;LOS LAGOS;0;0;0;0;0;0;0;0;0;Cocina CMC20AXX 4P Inox;LINEA BLANCA
12133855;;F;52;CHILENO;;X;N/D;N/D;0;0;0;0;0;0;0;0;0;Lavadora WT19DSBP 19Kg Silver;LINEA BLANCA
18113593;;F;30;CHILENO;;Millenial;SAN ESTEBAN                   ;VALPARAISO;0;0;0;0;0;0;0;0;0;Lavadora MLS-090GE04N 9Kg Gris;LINEA BLANCA
7383161;;M;66;CHILENO;;Boomers;PENAFLOR                      ;METROPOLITANA;0;0;0;0;0;0;0;0;0;Lavadora Premium Care 20SZ 20Kg Silver;LINEA BLANCA
11509834;;M;52;CHILENO;;X;LA SERENA                     ;COQUIMBO;0;0;0;0;0;0;0;0;0;Lavadora MLS-090GE04N 9Kg Gris;LINEA BLANCA
17786598;;F;31;CHILENO;;Millenial;PROVIDENCIA                   ;METROPOLITANA;0;0;0;0;0;0;0;0;0;Lavadora superior MLS-110GE04N 11Kg;LINEA BLANCA
11250873;;F;54;CHILENO;;X;FRUTILLAR                     ;LOS LAGOS;0;0;0;0;0;0;0;0;0;Lavadora MLS-090GE04N 9Kg Gris;LINEA BLANCA
19124083;Soltero;M;26;CHILENO;;Z;PROVIDENCIA                   ;METROPOLITANA;0;0;0;0;0;0;0;0;0;Refrigerador 255Lts No Frost RT25FARADS8/ZS;LINEA BLANCA
6516265;;F;78;CHILENO;;Silencioso;PROVIDENCIA                   ;METROPOLITANA;0;0;0;0;0;0;0;0;0;Lavadora MLS-090GE04N 9Kg Gris;LINEA BLANCA
9330115;;M;58;CHILENO;;Boomers;ARICA                         ;ARICA Y PARINACOTA;0;0;0;0;0;0;0;0;0;Lavadora WA17T6260BW/ZS 17Kg Blanca;LINEA BLANCA
14150555;;F;41;CHILENO;;X;N/D;N/D;0;0;0;0;0;0;0;0;0;Refrigerador 2260-S 222Lts Frio Directo;LINEA BLANCA
19511168;;M;25;CHILENO;;Millenial;N/D;N/D;0;0;0;0;0;0;0;0;0;Lavadora WT13WSBP 13Kg Blanca;LINEA BLANCA
17330664;Soltero;F;32;CHILENO;;Millenial;VALLENAR;ATACAMA;0;0;0;0;0;0;0;0;0;Cocina CH-7400 4P;LINEA BLANCA
13304340;;F;44;CHILENO;;X;CHIMBARONGO                   ;L.G.B.OÂ´HIGGINS;0;0;0;0;0;0;0;0;0;Calefon 7Lts GL Master;LINEA BLANCA
6532448;Soltero;F;67;CHILENO;;Boomers;QUILLOTA                      ;VALPARAISO;0;0;0;0;0;0;0;0;0;Cocina 775X 4P;LINEA BLANCA
10072987;;F;58;CHILENO;;Boomers;N/D;N/D;0;0;0;0;0;0;0;0;0;Cocina F-2608 4P Inox;LINEA BLANCA
11940435;;M;50;CHILENO;;X;N/D;N/D;0;0;0;0;0;0;0;0;0;Calefon 11Lts GL Master;LINEA BLANCA
10581847;;F;58;CHILENO;;Boomers;PROVIDENCIA                   ;METROPOLITANA;0;0;0;0;0;0;0;0;0;Freezer Horizontal M100 99Lts;LINEA BLANCA
19268040;;M;26;CHILENO;;Z;"";"";0;0;0;0;0;0;0;0;0;Cocina CH-7400 4P;LINEA BLANCA
19763521;;M;24;CHILENO;;Silencioso;PROVIDENCIA                   ;METROPOLITANA;0;0;0;0;0;0;0;0;0;Cocina CH-9900SI 6P Silver;LINEA BLANCA
6264698;;F;68;CHILENO;;Silencioso;LAS CABRAS                    ;L.G.B.OÂ´HIGGINS;0;0;0;0;0;0;0;0;0;Refrigerador 249Lts No Frost RMA250PHUG;LINEA BLANCA
18698637;Soltero;F;28;CHILENO;TECNICO DE NIVEL SUPERIOR EN ENFERMERIA;Millenial;PROVIDENCIA                   ;METROPOLITANA;0;0;0;0;0;0;0;0;0;Lavadora Premium Care Pro 16Kg Silver;LINEA BLANCA
17584318;;M;31;CHILENO;;Millenial;N/D;N/D;0;0;0;0;0;0;0;0;0;Cocina MV 110 4 Platos;LINEA BLANCA
19751772;;F;25;CHILENO;;Z;HUECHURABA                    ;METROPOLITANA;0;0;0;0;0;0;0;0;0;Cocina CH-9900SI 6P Silver;LINEA BLANCA
6193700;;F;71;CHILENO;;Silencioso;PROVIDENCIA                   ;METROPOLITANA;0;0;0;0;0;0;0;0;0;Lavadora Efficace SZG 17,5Kg Silver;LINEA BLANCA
7291783;;M;66;CHILENO;;Boomers;OVALLE                        ;COQUIMBO;0;0;0;0;0;0;0;0;0;Refrigerador 241Lts BF Frio Directo Nordik 415;LINEA BLANCA
12571541;;M;48;CHILENO;;X;PROVIDENCIA                   ;METROPOLITANA;0;0;0;0;0;0;0;0;0;Encimera CE2-435I 2P Inox;LINEA BLANCA
13896986;;F;42;CHILENO;;Silencioso;PROVIDENCIA                   ;METROPOLITANA;0;0;0;0;0;0;0;0;0;Cocina F-5500 Premium 5P;LINEA BLANCA
17948543;;F;36;CHILENO;;Millenial;PROVIDENCIA                   ;METROPOLITANA;0;0;0;0;0;0;0;0;0;Refrigerador 254Lts No Frost GT29WPPDC;LINEA BLANCA
18279629;;M;34;CHILENO;;Millenial;N/D;N/D;0;0;0;0;0;0;0;0;0;Lavadora Efficace SZG 15,5Kg Silver;LINEA BLANCA
20266122;;F;22;CHILENO;;Silencioso;PROVIDENCIA                   ;METROPOLITANA;0;0;0;0;0;0;0;0;0;Secadora Ropa MSV-90 9K Blanca Ventilacion;LINEA BLANCA
7503616;Casado;F;67;CHILENO;;Boomers;SAN JOAQUIN                   ;METROPOLITANA;0;0;0;0;0;0;0;0;0;Cocina MV 110 4 Platos;LINEA BLANCA
6973558;;F;69;CHILENO;;Silencioso;CORONEL                       ;BIO BIO;0;0;0;0;0;0;0;0;0;Calefont 10Lts GL Essenetial ECO;LINEA BLANCA
5136064;;F;78;CHILENO;;Silencioso;PROVIDENCIA                   ;METROPOLITANA;0;0;0;0;0;0;0;0;0;Refrigerador 210Lts Rojo Frio Dir MRFS2100R273FN;LINEA BLANCA
5836019;;F;72;CHILENO;;Silencioso;ALTO HOSPICIO;TARAPACA;0;0;0;0;0;0;0;0;0;Lavadora WA90H4400SW/ZS 9Kg Blanca;LINEA BLANCA
14624013;;M;42;CHILENO;;X;PROVIDENCIA                   ;METROPOLITANA;0;0;0;0;0;0;0;0;0;Lavadora Efficace BZG 9,5Kg Blanca;LINEA BLANCA
8180387;Soltero;F;67;CHILENO;;Silencioso;PROVIDENCIA                   ;METROPOLITANA;0;0;0;0;0;0;0;0;0;Cocina MV 110 4 Platos;LINEA BLANCA
14199277;;M;40;CHILENO;;X;PROVIDENCIA                   ;METROPOLITANA;0;0;0;0;0;0;0;0;0;Lavadora WA90H4400SW/ZS 9Kg Blanca;LINEA BLANCA
16639489;;M;35;CHILENO;;Millenial;PROVIDENCIA                   ;METROPOLITANA;0;0;0;0;0;0;0;0;0;Lavadora WA90H4400SW/ZS 9Kg Blanca;LINEA BLANCA
12258410;;F;50;CHILENO;;X;MOLINA                        ;MAULE;0;0;0;0;0;0;0;0;0;Lavadora MLS-160BSC03T 16Kg Blanca;LINEA BLANCA
11581116;;F;52;CHILENO;;X;LOS ANGELES                   ;BIO BIO;0;0;0;0;0;0;0;0;0;Cocina 76DXR Doble Horno;LINEA BLANCA
9378155;;M;59;CHILENO;;Boomers;RENCA                         ;METROPOLITANA;0;0;0;0;0;0;0;0;0;Cocina CH-9900SI 6P Silver;LINEA BLANCA
16742806;;F;34;CHILENO;;Millenial;PROVIDENCIA                   ;METROPOLITANA;0;0;0;0;0;0;0;0;0;Horno Empotrado FHE 1190 T Negro 50 Lts;LINEA BLANCA
13415125;;F;44;CHILENO;;X;RENCA                         ;METROPOLITANA;0;0;0;0;0;0;0;0;0;Refrigerador 260Lts BF Frio Direc MRFI2660SR346W;LINEA BLANCA
26119623;;M;30;VENEZOLANO;;Extranjero;N/D;N/D;0;0;0;0;0;0;0;0;0;Lavadora Secadora Frontal 10.5 / 6Kg Inox Titan;LINEA BLANCA
11673179;;F;52;CHILENO;;X;SAN VICENTE                   ;L.G.B.OÂ´HIGGINS;0;0;0;0;0;0;0;0;0;Lavadora WT19DSBP 19Kg Silver;LINEA BLANCA
19664808;;M;23;CHILENO;;Silencioso;VILLA ALEMANA                 ;VALPARAISO;0;0;0;0;0;0;0;0;0;REFRIGERADOR 234Lt TMF RT22FARADS8/ZS;LINEA BLANCA
15528972;;M;39;CHILENO;;X;CORONEL                       ;BIO BIO;0;0;0;0;0;0;0;0;0;Cocina 775X 4P;LINEA BLANCA
19874425;;M;24;CHILENO;;Z;NANCAGUA                      ;L.G.B.OÂ´HIGGINS;0;0;0;0;0;0;0;0;0;Lavadora MLS-160BSC03T 16Kg Blanca;LINEA BLANCA
15453043;Casado;F;41;CHILENO;;X;RENCA                         ;METROPOLITANA;0;0;0;0;0;0;0;0;0;Refrigerador 167Lts Frio Directo 1700-S;LINEA BLANCA
8056910;;F;64;CHILENO;;Boomers;TENO                          ;MAULE;0;0;0;0;0;0;0;0;0;Cocina 785FX 4P;LINEA BLANCA
12810744;;M;47;CHILENO;;X;IQUIQUE                       ;TARAPACA;0;0;0;0;0;0;0;0;0;Refrigerador 252Lts No Frost MRFS-2700G333FW;LINEA BLANCA
15757907;;M;38;CHILENO;;Millenial;AISEN                         ;AYSEN;0;0;0;0;0;0;0;0;0;Cocina CH-6900IN 4P;LINEA BLANCA
13667043;Soltero;F;42;CHILENO;PROFESOR;X;PROVIDENCIA                   ;METROPOLITANA;0;0;0;0;0;0;0;0;0;Lavadora WA13T5260BW/ZS 13Kg Blanca;LINEA BLANCA
15000235;;F;40;CHILENO;;Silencioso;PROVIDENCIA                   ;METROPOLITANA;0;0;0;0;0;0;0;0;0;Lavadora WA13T5260BW/ZS 13Kg Blanca;LINEA BLANCA
17076478;;F;33;CHILENO;;Silencioso;PROVIDENCIA                   ;METROPOLITANA;0;0;0;0;0;0;0;0;0;Cocina Diva 820 6P;LINEA BLANCA
16413079;;M;35;CHILENO;;Millenial;PROVIDENCIA                   ;METROPOLITANA;0;0;0;0;0;0;0;0;0;Refrigerador 244Lts Frio Directo Progress 3100;LINEA BLANCA
18649190;;F;27;CHILENO;;Millenial;RANCAGUA                      ;L.G.B.OÂ´HIGGINS;0;0;0;0;0;0;0;0;0;Lavadora WA80H4200SW/ZS 8Kg Blanca;LINEA BLANCA
8903270;;F;62;CHILENO;;Silencioso;PROVIDENCIA                   ;METROPOLITANA;0;0;0;0;0;0;0;0;0;Refrigerador 241Lts BF Frio Directo Nordik 415;LINEA BLANCA
18046018;;F;30;CHILENO;;Millenial;PROVIDENCIA                   ;METROPOLITANA;0;0;0;0;0;0;0;0;0;Lavadora MLS-160BSC03T 16Kg Blanca;LINEA BLANCA
12529254;;F;55;CHILENO;;Boomers;PROVIDENCIA                   ;METROPOLITANA;0;0;0;0;0;0;0;0;0;Refrigerador 255Lts No Frost RT25FARADS8/ZS;LINEA BLANCA
16070971;;F;36;CHILENO;;Millenial;PROVIDENCIA                   ;METROPOLITANA;0;0;0;0;0;0;0;0;0;Lavadora MLS-160BSC03T 16Kg Blanca;LINEA BLANCA
15545716;;F;38;CHILENO;;Millenial;PROVIDENCIA                   ;METROPOLITANA;0;0;0;0;0;0;0;0;0;Lavadora Secadora WD12N64FR2X/ZS 12/7Kg Silver;LINEA BLANCA
17062083;;F;33;CHILENO;;Millenial;"";"";0;0;0;0;0;0;0;0;0;Lavadora Efficace SZG 15,5Kg Silver;LINEA BLANCA
11745108;;M;50;CHILENO;;X;LINARES                       ;MAULE;0;0;0;0;0;0;0;0;0;Refrigerador 290LTS No Frost RMB302PXLRS0;LINEA BLANCA
16243250;;M;37;CHILENO;;Millenial;N/D;N/D;0;0;0;0;0;0;0;0;0;Cocina MV 110 4 Platos;LINEA BLANCA
19506734;;F;25;CHILENO;;Z;N/D;N/D;0;0;0;0;0;0;0;0;0;Cocina MV 110 4 Platos;LINEA BLANCA
13656825;;F;47;CHILENO;;X;LAMPA;METROPOLITANA;0;0;0;0;0;0;0;0;0;HORNO EMPOTRABLE HE-7200 INOX 2250W 57L SINDELEN;LINEA BLANCA
11425727;;F;53;CHILENO;;X;VALDIVIA                      ;LOS RIOS;0;0;0;0;0;0;0;0;0;Secadora Ropa MSV-90 9K Blanca Ventilacion;LINEA BLANCA
15885086;;F;38;CHILENO;;Millenial;VALLENAR;ATACAMA;0;0;0;0;0;0;0;0;0;Refrigerador 252Lts No Frost MRFS-2700G333FW;LINEA BLANCA
8025347;Casado;F;61;CHILENO;INGENIERO CIVIL;Boomers;RENCA                         ;METROPOLITANA;0;0;0;0;0;0;0;0;0;Refrigerador 241Lts BF Frio Directo Nordik 415;LINEA BLANCA
4973629;;F;77;CHILENO;;Silencioso;CALAMA                        ;ANTOFAGASTA;0;0;0;0;0;0;0;0;0;Lavadora Semiautomatica LC-6550 6,5Kg;LINEA BLANCA
9762277;;F;56;CHILENO;;Boomers;PROVIDENCIA                   ;METROPOLITANA;0;0;0;0;0;0;0;0;0;Cocina Lena Angelina Blanca;LINEA BLANCA
10044791;;M;56;CHILENO;;Boomers;VILLARICA                     ;ARAUCANIA;0;0;0;0;0;0;0;0;0;Lavadora Efficace SZG 15,5Kg Silver;LINEA BLANCA
5375427;Soltero;F;73;CHILENO;;Silencioso;PROVIDENCIA                   ;METROPOLITANA;0;0;0;0;0;0;0;0;0;Lavadora Efficace SZG 17,5Kg Silver;LINEA BLANCA
17942702;;F;30;CHILENO;;Silencioso;PROVIDENCIA                   ;METROPOLITANA;0;0;0;0;0;0;0;0;0;Secadora Electrica SEM101BDBY Blanca 10 KG;LINEA BLANCA
19483518;;F;27;CHILENO;;Z;N/D;N/D;0;0;0;0;0;0;0;0;0;Lavadora Efficace SZG 17,5Kg Blanca;LINEA BLANCA
18765748;;F;28;CHILENO;;Millenial;N/D;N/D;0;0;0;0;0;0;0;0;0;Cocina MCG-4QI24AME4 4P Inox;LINEA BLANCA
20122705;;M;23;CHILENO;;Silencioso;PROVIDENCIA                   ;METROPOLITANA;0;0;0;0;0;0;0;0;0;Lavadora Efficace SZG 17,5Kg Blanca;LINEA BLANCA
14222864;Divorciado;M;40;CHILENO;;X;RENCA                         ;METROPOLITANA;0;0;0;0;0;0;0;0;0;CAMPANA CURVEX 900 ISLA INOX ALBIN TROTTER;LINEA BLANCA
7379172;;M;63;CHILENO;;Boomers;OVALLE                        ;COQUIMBO;0;0;0;0;0;0;0;0;0;Calefon 5Lts GL Master;LINEA BLANCA
17671585;;M;31;CHILENO;;Silencioso;PROVIDENCIA                   ;METROPOLITANA;0;0;0;0;0;0;0;0;0;Refrigerador 244Lts Frio Directo Progress 3100;LINEA BLANCA
16791995;Soltero;M;33;CHILENO;PSICOLOGO;Silencioso;PROVIDENCIA                   ;METROPOLITANA;0;0;0;0;0;0;0;0;0;Lavadora WT13WSBP 13Kg Blanca;LINEA BLANCA
8095500;;M;62;CHILENO;;Boomers;BUIN                          ;METROPOLITANA;0;0;0;0;0;0;0;0;0;Refrigerador MRFI1800S234RN 180Lts BF Frio Direc;LINEA BLANCA
19481673;Soltero;F;26;CHILENO;;Silencioso;PROVIDENCIA                   ;METROPOLITANA;0;0;0;0;0;0;0;0;0;Secadora Ropa Solare 7100 7K Ventilacion;LINEA BLANCA
16039090;;M;36;CHILENO;;Millenial;TALCAHUANO                    ;BIO BIO;0;0;0;0;0;0;0;0;0;Cocina Andes60TX4 4P Inox;LINEA BLANCA
16252877;;F;36;CHILENO;;Millenial;DONIHUE                       ;L.G.B.OÂ´HIGGINS;0;0;0;0;0;0;0;0;0;Refrigerador 167Lts Frio Directo 1700-S;LINEA BLANCA
10126666;;F;56;CHILENO;;Boomers;N/D;N/D;0;0;0;0;0;0;0;0;0;Lavadora Efficace SZG 19,5Kg Silver;LINEA BLANCA
9738993;;F;59;CHILENO;;Boomers;MELIPILLA                     ;METROPOLITANA;0;0;0;0;0;0;0;0;0;Lavadora Efficace SZG 15,5Kg Silver;LINEA BLANCA
10954085;;M;54;CHILENO;;Boomers;NUNOA                         ;METROPOLITANA;0;0;0;0;0;0;0;0;0;Refrigerador RMN222PXLRS0 222LTS No Frost;LINEA BLANCA
13788629;Casado;F;42;CHILENO;;X;PROVIDENCIA                   ;METROPOLITANA;0;0;0;0;0;0;0;0;0;Secadora Ropa MSV-90 9K Blanca Ventilacion;LINEA BLANCA
14513946;Casado;M;46;CHILENO;;X;PROVIDENCIA                   ;METROPOLITANA;0;0;0;0;0;0;0;0;0;Secadora Ropa Reverplus 6470 7Kg Gris Ventilacio;LINEA BLANCA
20467878;;F;22;CHILENO;;Z;PROVIDENCIA                   ;METROPOLITANA;0;0;0;0;0;0;0;0;0;Secadora Ropa Solare 9100 9K Ventilacion;LINEA BLANCA
5562010;;M;75;CHILENO;;Silencioso;PROVIDENCIA                   ;METROPOLITANA;0;0;0;0;0;0;0;0;0;Refrigerador 249Lts No Frost RMA250PHUG;LINEA BLANCA
20223968;;M;23;CHILENO;;Z;PROVIDENCIA                   ;METROPOLITANA;0;0;0;0;0;0;0;0;0;Secadora LG DF9WPN por condensacion 9K con Smart;LINEA BLANCA
6321303;;F;76;CHILENO;;Silencioso;BUIN                          ;METROPOLITANA;0;0;0;0;0;0;0;0;0;Lavadora Premium Care Pro 16Kg Silver;LINEA BLANCA
14208977;;F;42;CHILENO;;X;LAUTARO                       ;ARAUCANIA;0;0;0;0;0;0;0;0;0;Cocina CH-9600RJ 4P;LINEA BLANCA
10436705;Casado;M;57;CHILENO;ADMINISTRACION GASTRONOMICA INTERNACIONAL;Boomers;RENCA                         ;METROPOLITANA;0;0;0;0;0;0;0;0;0;Secadora Ropa Solare 9100 9K Ventilacion;LINEA BLANCA
7759495;;F;67;CHILENO;;Boomers;RENCA                         ;METROPOLITANA;0;0;0;0;0;0;0;0;0;Lavadora Brilliant SG 11,5Kg Silver;LINEA BLANCA
12890795;;F;47;CHILENO;;X;PROVIDENCIA                   ;METROPOLITANA;0;0;0;0;0;0;0;0;0;Refrigerador 254Lts No Frost GT29WPPDC;LINEA BLANCA
16284445;;M;35;CHILENO;;Millenial;PROVIDENCIA                   ;METROPOLITANA;0;0;0;0;0;0;0;0;0;FREEZER SFH-150 14OL BLANCO SINDELEN;LINEA BLANCA
4927608;;M;78;CHILENO;;Silencioso;SAN ANTONIO                   ;VALPARAISO;0;0;0;0;0;0;0;0;0;Cocina CMC5515GCH-1 4P;LINEA BLANCA
13626137;;F;43;CHILENO;;X;RENCA                         ;METROPOLITANA;0;0;0;0;0;0;0;0;0;Cocina 775X 4P;LINEA BLANCA
16757469;Casado;F;35;CHILENO;;Millenial;PROVIDENCIA                   ;METROPOLITANA;0;0;0;0;0;0;0;0;0;Lavadora MLS-090GE04N 9Kg Gris;LINEA BLANCA
15180864;;M;40;CHILENO;;X;LOS ANDES                     ;VALPARAISO;0;0;0;0;0;0;0;0;0;Freezer 142Lts MFH-1430B186C Horizontal;LINEA BLANCA
17927648;;M;30;CHILENO;;Millenial;PROVIDENCIA                   ;METROPOLITANA;0;0;0;0;0;0;0;0;0;SECADORA SR-10 8KG GRIS SINDELEN;LINEA BLANCA
18589026;;F;28;CHILENO;;Millenial;N/D;N/D;0;0;0;0;0;0;0;0;0;Secadora Ropa Reverplus 6470 7Kg Gris Ventilacio;LINEA BLANCA
10199847;;F;51;CHILENO;;X;PUERTO MONTT                  ;LOS LAGOS;0;0;0;0;0;0;0;0;0;Secadora Ropa Solare 7100 7K Ventilacion;LINEA BLANCA
10731156;;F;41;CHILENO;;X;VICTORIA                      ;ARAUCANIA;0;0;0;0;0;0;0;0;0;Freezer Horizontal 248 Lts Blanco FF-255;LINEA BLANCA
9748435;;F;57;CHILENO;;Boomers;PROVIDENCIA                   ;METROPOLITANA;0;0;0;0;0;0;0;0;0;Secadora Ropa Solare 7100 7K Ventilacion;LINEA BLANCA
17164323;;F;33;CHILENO;;Millenial;LOS ANDES                     ;VALPARAISO;0;0;0;0;0;0;0;0;0;Secadora Ropa Reverplus 6470 7Kg Gris Ventilacio;LINEA BLANCA
10611308;;F;56;CHILENO;;Boomers;VALLENAR;ATACAMA;0;0;0;0;0;0;0;0;0;Refrigerador RMN222PXLRS0 222LTS No Frost;LINEA BLANCA
26484669;;M;42;VENEZOLANO;;Extranjero;N/D;N/D;0;0;0;0;0;0;0;0;0;Cocina CMC20AXX 4P Inox;LINEA BLANCA
8286696;Viudo;F;67;CHILENO;;Silencioso;PROVIDENCIA                   ;METROPOLITANA;0;0;0;0;0;0;0;0;0;Lavadora WT13WSBP 13Kg Blanca;LINEA BLANCA
12189137;;M;49;CHILENO;;X;NACIMIENTO                    ;BIO BIO;0;0;0;0;0;0;0;0;0;Lavadora MLS-160BSC03T 16Kg Blanca;LINEA BLANCA
11631359;;M;51;CHILENO;;X;PROVIDENCIA                   ;METROPOLITANA;0;0;0;0;0;0;0;0;0;ENCIMERA A GAS CMG6044SD-0CL 4Q MABE;LINEA BLANCA
15619796;Soltero;F;38;CHILENO;;X;PROVIDENCIA                   ;METROPOLITANA;0;0;0;0;0;0;0;0;0;Cocina CH-9600RJ 4P;LINEA BLANCA
16344512;;F;35;CHILENO;;Millenial;OSORNO                        ;LOS LAGOS;0;0;0;0;0;0;0;0;0;Refrigerador 303Lts BF Frio Directo Nordik 480;LINEA BLANCA
25102259;;F;24;CHILENO;;Extranjero;PROVIDENCIA                   ;METROPOLITANA;0;0;0;0;0;0;0;0;0;Cocina CMC20AXX 4P Inox;LINEA BLANCA
18447605;Soltero;F;29;CHILENO;;Millenial;PROVIDENCIA                   ;METROPOLITANA;0;0;0;0;0;0;0;0;0;Secadora 9Kg Solare 9200 Ventilacion;LINEA BLANCA
8923561;;F;59;CHILENO;;Boomers;RENCA                         ;METROPOLITANA;0;0;0;0;0;0;0;0;0;Cocina 775X 4P;LINEA BLANCA
13369255;Casado;M;43;CHILENO;INGENIERO EN PREVENCION DE RIESGOS;X;SAN ANTONIO                   ;VALPARAISO;0;0;0;0;0;0;0;0;0;Cocina MCG-5QI30AME5 5P Inox;LINEA BLANCA
9965081;;M;60;CHILENO;;Silencioso;PROVIDENCIA                   ;METROPOLITANA;0;0;0;0;0;0;0;0;0;Lavadora WT16DSBP 16Kg Silver;LINEA BLANCA
9620329;;M;56;CHILENO;;Boomers;RENCA                         ;METROPOLITANA;0;0;0;0;0;0;0;0;0;Cocina PRO 549 Inox Serie4 5P;LINEA BLANCA
18266230;;F;29;CHILENO;;Millenial;PROVIDENCIA                   ;METROPOLITANA;0;0;0;0;0;0;0;0;0;Refrigerador 167Lts Frio Directo 1700-S;LINEA BLANCA
10066679;;F;56;CHILENO;;Boomers;N/D;N/D;0;0;0;0;0;0;0;0;0;Lavadora Secadora WD10WVC4S6 10,5/6Kg Blanca;LINEA BLANCA
8847550;;M;62;CHILENO;;Boomers;TUCAPEL                       ;BIO BIO;0;0;0;0;0;0;0;0;0;Refrigerador 525Lts Side by Side SFX500;LINEA BLANCA
11891248;;F;51;CHILENO;;X;PICHIDEGUA                    ;L.G.B.OÂ´HIGGINS;0;0;0;0;0;0;0;0;0;Secadora Electrica SEM101BDBY Blanca 10 KG;LINEA BLANCA
7975898;;M;65;CHILENO;;Boomers;NIQUEN                        ;BIO BIO;0;0;0;0;0;0;0;0;0;Refrigerador 255Lts No Frost RT25FARADS8/ZS;LINEA BLANCA
8758826;;F;62;CHILENO;;Boomers;RENCA                         ;METROPOLITANA;0;0;0;0;0;0;0;0;0;Lavadora WA90H4400SW/ZS 9Kg Blanca;LINEA BLANCA
13060187;;M;46;CHILENO;;Silencioso;PROVIDENCIA                   ;METROPOLITANA;0;0;0;0;0;0;0;0;0;Lavadora MLS-160BSC03T 16Kg Blanca;LINEA BLANCA
9770875;;M;56;CHILENO;;Boomers;PROVIDENCIA                   ;METROPOLITANA;0;0;0;0;0;0;0;0;0;Lavadora Efficace SZG 9,5Kg Silver;LINEA BLANCA
8306318;;M;60;CHILENO;;Boomers;PROVIDENCIA                   ;METROPOLITANA;0;0;0;0;0;0;0;0;0;Cocina F-5500 Premium 5P;LINEA BLANCA
11230755;Casado;F;54;CHILENO;;X;MELIPILLA                     ;METROPOLITANA;0;0;0;0;0;0;0;0;0;Lavadora Efficace BZG 9,5Kg Blanca;LINEA BLANCA
15996398;;F;37;CHILENO;;Millenial;PUERTO MONTT                  ;LOS LAGOS;0;0;0;0;0;0;0;0;0;Cocina CH-9400 4P SILVER;LINEA BLANCA
10455403;;M;53;CHILENO;;X;LLAILLAY                      ;VALPARAISO;0;0;0;0;0;0;0;0;0;Lavadora WT19DSBP 19Kg Silver;LINEA BLANCA
7867754;Casado;M;64;CHILENO;;Silencioso;PROVIDENCIA                   ;METROPOLITANA;0;0;0;0;0;0;0;0;0;Centrifuga Primma 5B 5,5Kilos;LINEA BLANCA
13699949;Soltero;F;43;CHILENO;TECNICO DE NIVEL SUPERIOR LABORATORISTA DENTAL;X;RENCA                         ;METROPOLITANA;0;0;0;0;0;0;0;0;0;Lavadora 9 Kg Carga Superior Blanca;LINEA BLANCA
7227870;;F;69;CHILENO;;Silencioso;LOS ANDES                     ;VALPARAISO;0;0;0;0;0;0;0;0;0;Cocina CH-7400 4P;LINEA BLANCA
6082864;;M;70;CHILENO;;Silencioso;PROVIDENCIA                   ;METROPOLITANA;0;0;0;0;0;0;0;0;0;Lavadora Efficace SZG 17,5Kg Silver;LINEA BLANCA
17914861;;F;31;CHILENO;;Millenial;CHILLAN                       ;NUBLE;0;0;0;0;0;0;0;0;0;Secadora Ropa MSV-90 9K Blanca Ventilacion;LINEA BLANCA
15371607;Soltero;M;39;CHILENO;DISENADOR MULTIMEDIA;Silencioso;PROVIDENCIA                   ;METROPOLITANA;0;0;0;0;0;0;0;0;0;Lavadora MLS-090GE04N 9Kg Gris;LINEA BLANCA
10270854;;F;56;CHILENO;;Boomers;ILLAPEL                       ;COQUIMBO;0;0;0;0;0;0;0;0;0;Lavadora WT16DSBP 16Kg Silver;LINEA BLANCA
7323225;Viudo;F;67;CHILENO;;Boomers;PROVIDENCIA                   ;METROPOLITANA;0;0;0;0;0;0;0;0;0;Calefont 8Lts GL Essenetial ECO;LINEA BLANCA
20307984;;F;22;CHILENO;;Z;PROVIDENCIA                   ;METROPOLITANA;0;0;0;0;0;0;0;0;0;Lavadora Premium Care 20SZ 20Kg Silver;LINEA BLANCA
17455894;;F;32;CHILENO;;Millenial;N/D;N/D;0;0;0;0;0;0;0;0;0;Cocina CMC20AXX 4P Inox;LINEA BLANCA
9641826;Divorciado;M;57;CHILENO;;Boomers;COLINA                        ;METROPOLITANA;0;0;0;0;0;0;0;0;0;Calefont 5Lts GL Essenetial ECO;LINEA BLANCA
16508744;Soltero;F;36;CHILENO;PROFESOR;Millenial;CARAHUE                       ;ARAUCANIA;0;0;0;0;0;0;0;0;0;CALEFON 10 LITROS MASTER GL (SPLENDID);LINEA BLANCA
11536198;;M;51;CHILENO;;X;RENCA                         ;METROPOLITANA;0;0;0;0;0;0;0;0;0;Lavadora Brilliant SG 11,5Kg Silver;LINEA BLANCA
17345640;;M;32;CHILENO;;Millenial;PENCO                         ;BIO BIO;0;0;0;0;0;0;0;0;0;Secadora Ropa Solare 7100 7K Ventilacion;LINEA BLANCA
6659586;;M;68;CHILENO;;Boomers;N/D;N/D;0;0;0;0;0;0;0;0;0;ENCIMERA EXCLUSIVE 60 GN 4P ALBIN TROTTER;LINEA BLANCA
18228310;Soltero;F;29;CHILENO;ENFERMERA;Millenial;PROVIDENCIA                   ;METROPOLITANA;0;0;0;0;0;0;0;0;0;Refrigerador No Frost TMF 197 Lts FRT-220;LINEA BLANCA
16935161;;F;33;CHILENO;;Millenial;PROVIDENCIA                   ;METROPOLITANA;0;0;0;0;0;0;0;0;0;Lavadora Efficace BZG 15,5Kg Blanca;LINEA BLANCA
15079837;;F;39;CHILENO;;X;PROVIDENCIA                   ;METROPOLITANA;0;0;0;0;0;0;0;0;0;REFRIGERADOR 234Lt TMF RT22FARADS8/ZS;LINEA BLANCA
15195559;;M;39;CHILENO;;Silencioso;"";"";0;0;0;0;0;0;0;0;0;CALEFON CALEFON RHEEM TN 14L GL;LINEA BLANCA
13811370;Viudo;F;42;CHILENO;;X;PROVIDENCIA                   ;METROPOLITANA;0;0;0;0;0;0;0;0;0;Cocina 785FX 4P;LINEA BLANCA
10615106;;M;56;CHILENO;;Boomers;LAS CABRAS                    ;L.G.B.OÂ´HIGGINS;0;0;0;0;0;0;0;0;0;Refrigerador No Frost TMF 197 Lts FRT-220;LINEA BLANCA
11736232;;F;51;CHILENO;;X;PROVIDENCIA                   ;METROPOLITANA;0;0;0;0;0;0;0;0;0;CAMPANA ESSENTIAL 602 INOX 2M ALBIN TROTTER;LINEA BLANCA
19260404;;F;25;CHILENO;;Z;PROVIDENCIA                   ;METROPOLITANA;0;0;0;0;0;0;0;0;0;COCINA CH-5700SI 4P;LINEA BLANCA
9325711;;M;60;CHILENO;;Boomers;MOSTAZAL                      ;L.G.B.OÂ´HIGGINS;0;0;0;0;0;0;0;0;0;Refrigerador 2100-S 207Lts Frio Directo;LINEA BLANCA
7462773;;M;64;CHILENO;;Boomers;VINA DEL MAR                  ;VALPARAISO;0;0;0;0;0;0;0;0;0;Lavadora Semiautomatica LC-6550 6,5Kg;LINEA BLANCA
16239537;;M;36;CHILENO;;Millenial;COIHUECO                      ;BIO BIO;0;0;0;0;0;0;0;0;0;HORNO EMPOTRABLE 2250W 57LTS HE-7220R NEGRO;LINEA BLANCA
14452350;Casado;F;51;CHILENO;;X;RENCA                         ;METROPOLITANA;0;0;0;0;0;0;0;0;0;Secadora Ropa Reverplus 6470 7Kg Gris Ventilacio;LINEA BLANCA
9070792;;M;61;CHILENO;;Boomers;PROVIDENCIA                   ;METROPOLITANA;0;0;0;0;0;0;0;0;0;Refrigerador 3560-S 337Lts No Frost;LINEA BLANCA
18959980;;F;27;CHILENO;;Millenial;N/D;N/D;0;0;0;0;0;0;0;0;0;Cocina CH-9400 4P SILVER;LINEA BLANCA
10754256;;F;56;CHILENO;;Boomers;OVALLE                        ;COQUIMBO;0;0;0;0;0;0;0;0;0;Refrigerador 241Lts BF Frio Directo Nordik 415;LINEA BLANCA
10623573;;M;53;CHILENO;;X;CASTRO                        ;LOS LAGOS;0;0;0;0;0;0;0;0;0;Refrigerador Advantage 5300 320Lts No Frost;LINEA BLANCA
4712997;;M;78;CHILENO;;Silencioso;COPIAPO                       ;ATACAMA;0;0;0;0;0;0;0;0;0;Refrigerador 300Lts No Frost RT29K500JS8/ZS;LINEA BLANCA
3782093;;M;84;CHILENO;;Silencioso;PROVIDENCIA                   ;METROPOLITANA;0;0;0;0;0;0;0;0;0;Cocina CH-7400 4P;LINEA BLANCA
17091235;;F;33;CHILENO;;Millenial;"";"";0;0;0;0;0;0;0;0;0;FREEZER M300 HORIZONTAL MADEMSA;LINEA BLANCA
11201010;;F;55;CHILENO;;Boomers;SAN CARLOS                    ;BIO BIO;0;0;0;0;0;0;0;0;0;Calefont Essential 7 ECO GL;LINEA BLANCA
9453305;Casado;M;60;CHILENO;TECNICO;Silencioso;PROVIDENCIA                   ;METROPOLITANA;0;0;0;0;0;0;0;0;0;Cocina CMC20AXX 4P Inox;LINEA BLANCA
14581707;;M;44;CHILENO;;X;VICTORIA                      ;ARAUCANIA;0;0;0;0;0;0;0;0;0;Refrigerador 260Lts BF Frio Direc MRFI2660SR346W;LINEA BLANCA
16664237;;F;34;CHILENO;;Millenial;LOS ANGELES                   ;BIO BIO;0;0;0;0;0;0;0;0;0;Cocina CMC20AXX 4P Inox;LINEA BLANCA
10031383;;F;58;CHILENO;;Boomers;N/D;N/D;0;0;0;0;0;0;0;0;0;Refrigerador 244Lts Frio Directo Progress 3100;LINEA BLANCA
7716420;;M;62;CHILENO;;Silencioso;PROVIDENCIA                   ;METROPOLITANA;0;0;0;0;0;0;0;0;0;Lavadora Impressive 16SZ 16Kg Silver;LINEA BLANCA
15184581;Soltero;F;39;CHILENO;ABOGADO;Silencioso;PROVIDENCIA                   ;METROPOLITANA;0;0;0;0;0;0;0;0;0;TERMO ELECTRICO TERMO E RH 125L 220V P;LINEA BLANCA
14506650;;M;46;CHILENO;;X;YUMBEL                        ;BIO BIO;0;0;0;0;0;0;0;0;0;Lavadora Efficace BZG 15,5Kg Blanca;LINEA BLANCA
16348792;;F;35;CHILENO;;Millenial;PROVIDENCIA                   ;METROPOLITANA;0;0;0;0;0;0;0;0;0;Cocina CH-9950NG-1 6P Negro;LINEA BLANCA
20036353;;M;23;CHILENO;;Z;N/D;N/D;0;0;0;0;0;0;0;0;0;Lavadora Semiautomatica Twister 5100 4Kg;LINEA BLANCA
18813708;;M;28;CHILENO;;Millenial;PROVIDENCIA                   ;METROPOLITANA;0;0;0;0;0;0;0;0;0;Lavadora superior MLS-110GE04N 11Kg;LINEA BLANCA
19500299;;M;25;CHILENO;;Z;MAIPU                         ;METROPOLITANA;0;0;0;0;0;0;0;0;0;CONGELADOR LFH-300 TAPA DURA 300L;LINEA BLANCA
18153143;;M;29;CHILENO;;Silencioso;PROVIDENCIA                   ;METROPOLITANA;0;0;0;0;0;0;0;0;0;Cocina 76DXR Doble Horno;LINEA BLANCA
10023114;;M;50;CHILENO;;X;RANCAGUA                      ;L.G.B.OÂ´HIGGINS;0;0;0;0;0;0;0;0;0;Cocina 795XF 4P;LINEA BLANCA
7927583;;M;66;CHILENO;;Boomers;CORONEL                       ;BIO BIO;0;0;0;0;0;0;0;0;0;Lavadora WA13T5260BW/ZS 13Kg Blanca;LINEA BLANCA
15396608;;F;53;CHILENO;;X;SAN BERNARDO                  ;METROPOLITANA;0;0;0;0;0;0;0;0;0;Refrigerador 260Lts BF Frio Direc MRFI2660SR346W;LINEA BLANCA
17192884;;F;32;CHILENO;;Millenial;"";"";0;0;0;0;0;0;0;0;0;Cocina 76DXR Doble Horno;LINEA BLANCA
8459681;;F;52;CHILENO;;X;RENCA                         ;METROPOLITANA;0;0;0;0;0;0;0;0;0;Refrigerador 254Lts No Frost GT29WPPDC;LINEA BLANCA
12211298;;F;49;CHILENO;;X;CONCEPCION                    ;BIO BIO;0;0;0;0;0;0;0;0;0;Freezer FDHM150BY1 150Lts Horizontal;LINEA BLANCA
8657358;;M;62;CHILENO;;Boomers;PROVIDENCIA                   ;METROPOLITANA;0;0;0;0;0;0;0;0;0;Lavadora Semiautomatica Twister 5300 4Kg;LINEA BLANCA
19357571;;M;25;CHILENO;;Z;PROVIDENCIA                   ;METROPOLITANA;0;0;0;0;0;0;0;0;0;Refrigerador 260Lts BF Frio Direc MRFI2660SR346W;LINEA BLANCA
16571278;;F;35;CHILENO;;Millenial;SAN BERNARDO                  ;METROPOLITANA;0;0;0;0;0;0;0;0;0;Lavadora Efficace SZG 15,5Kg Silver;LINEA BLANCA
13180791;;M;54;CHILENO;;X;RENCA                         ;METROPOLITANA;0;0;0;0;0;0;0;0;0;Lavadora MLS-160BSC03T 16Kg Blanca;LINEA BLANCA
16219161;;M;36;CHILENO;;Millenial;PORTEZUELO                    ;BIO BIO;0;0;0;0;0;0;0;0;0;Cocina 795XF 4P;LINEA BLANCA
15068263;Casado;F;40;CHILENO;;X;PROVIDENCIA                   ;METROPOLITANA;0;0;0;0;0;0;0;0;0;Lavadora Impressive 14SZ 14Kg Silver;LINEA BLANCA
13555806;Soltero;M;42;CHILENO;;Silencioso;PROVIDENCIA                   ;METROPOLITANA;0;0;0;0;0;0;0;0;0;Campana Cocina CA-610EBL 60Cms Blanca;LINEA BLANCA
16193913;;M;35;CHILENO;;Millenial;PROVIDENCIA                   ;METROPOLITANA;0;0;0;0;0;0;0;0;0;Cocina MV 120 4 Platos;LINEA BLANCA
9804024;;F;59;CHILENO;;Boomers;HIJUELAS                      ;VALPARAISO;0;0;0;0;0;0;0;0;0;Lavadora Efficace SZG 17,5Kg Silver;LINEA BLANCA
17469032;;M;32;CHILENO;;Millenial;PROVIDENCIA                   ;METROPOLITANA;0;0;0;0;0;0;0;0;0;Lavadora WT19DSBP 19Kg Silver;LINEA BLANCA
12532693;Soltero;F;49;CHILENO;;X;TRAIGUEN                      ;ARAUCANIA;0;0;0;0;0;0;0;0;0;Refrigerador 400Lts No Frost RMP400FHUG;LINEA BLANCA
16784612;;M;34;CHILENO;;Millenial;PUNTA ARENAS                  ;MAGALLANES;0;0;0;0;0;0;0;0;0;Refrigerador 527Lts Side by Side MRSBS5300G689WE;LINEA BLANCA
18250913;;F;29;CHILENO;;Millenial;PROVIDENCIA                   ;METROPOLITANA;0;0;0;0;0;0;0;0;0;Refrigerador LB37MPGK 341Lts No Frost;LINEA BLANCA
6748521;Soltero;F;71;CHILENO;;Silencioso;PROVIDENCIA                   ;METROPOLITANA;0;0;0;0;0;0;0;0;0;Refrigerador 300Lts No Frost RT29K500JS8/ZS;LINEA BLANCA
18096778;Soltero;F;30;CHILENO;;Millenial;PROVIDENCIA                   ;METROPOLITANA;0;0;0;0;0;0;0;0;0;Refrigerador LT39WPP 393Lts No Frost;LINEA BLANCA
12100803;;M;47;CHILENO;;X;PROVIDENCIA                   ;METROPOLITANA;0;0;0;0;0;0;0;0;0;Lavadora Secadora WD12N64FR2X/ZS 12/7Kg Silver;LINEA BLANCA
27143270;;M;30;"";;Extranjero;"";"";0;0;0;0;0;0;0;0;0;Lavadora/Centrifuga LC4550 4,5Kg Blanca;LINEA BLANCA
7388911;;M;67;CHILENO;;Boomers;PROVIDENCIA                   ;METROPOLITANA;0;0;0;0;0;0;0;0;0;Calefont 10Lts GL Essenetial ECO;LINEA BLANCA
6577814;;M;69;CHILENO;;Silencioso;PEDRO AGUIRRE CERDA           ;METROPOLITANA;0;0;0;0;0;0;0;0;0;Refrigerador 241Lts BF Frio Directo Nordik 415;LINEA BLANCA
8402255;;F;49;CHILENO;;X;COLINA                        ;METROPOLITANA;0;0;0;0;0;0;0;0;0;Refrigerador 400Lts No Frost RMP400FHUG;LINEA BLANCA
5670326;;F;73;CHILENO;;Silencioso;OVALLE                        ;COQUIMBO;0;0;0;0;0;0;0;0;0;Lavadora MLS-090GE04N 9Kg Gris;LINEA BLANCA
14503653;Casado;F;46;CHILENO;;X;RENCA                         ;METROPOLITANA;0;0;0;0;0;0;0;0;0;Freezer Horizontal M100 99Lts;LINEA BLANCA
13248005;;F;44;CHILENO;;Silencioso;PROVIDENCIA                   ;METROPOLITANA;0;0;0;0;0;0;0;0;0;Refrigerador LT44AGP 424Lts Dispensador No Frost;LINEA BLANCA
5986614;;M;75;CHILENO;;Silencioso;GRANEROS                      ;L.G.B.OÂ´HIGGINS;0;0;0;0;0;0;0;0;0;Secadora Ropa MSV-90 9K Blanca Ventilacion;LINEA BLANCA
7540132;;F;69;CHILENO;;Silencioso;VILLARICA                     ;ARAUCANIA;0;0;0;0;0;0;0;0;0;Cocina CH-9950NG-1 6P Negro;LINEA BLANCA
6847046;;F;83;CHILENO;;Silencioso;OVALLE                        ;COQUIMBO;0;0;0;0;0;0;0;0;0;Refrigerador 252Lts No Frost MRFS-2700G333FW;LINEA BLANCA
10053715;;M;57;CHILENO;;Boomers;RENCA                         ;METROPOLITANA;0;0;0;0;0;0;0;0;0;Lavadora MLS-160BSC03T 16Kg Blanca;LINEA BLANCA
20376365;;M;22;CHILENO;;Silencioso;PROVIDENCIA                   ;METROPOLITANA;0;0;0;0;0;0;0;0;0;Lavadora/Centrifuga LC4550 4,5Kg Blanca;LINEA BLANCA
19164907;;M;26;CHILENO;;Z;PROVIDENCIA                   ;METROPOLITANA;0;0;0;0;0;0;0;0;0;Lavadora WA13T5260BW/ZS 13Kg Blanca;LINEA BLANCA
18546749;;F;28;CHILENO;;Millenial;PROVIDENCIA                   ;METROPOLITANA;0;0;0;0;0;0;0;0;0;Cocina MCG-5QI30AME5 5P Inox;LINEA BLANCA
8331871;Casado;M;63;CHILENO;;Boomers;SANTIAGO                      ;METROPOLITANA;0;0;0;0;0;0;0;0;0;Refrigerador 535Lts Side by Side RS54N3003SL/ZS;LINEA BLANCA
13316320;;F;45;CHILENO;;X;PROVIDENCIA                   ;METROPOLITANA;0;0;0;0;0;0;0;0;0;Freezer Horizontal M100 99Lts;LINEA BLANCA
12480655;;F;49;CHILENO;;X;SAN VICENTE                   ;L.G.B.OÂ´HIGGINS;0;0;0;0;0;0;0;0;0;ENCIMERA A GAS 4 PLATOS CEG-4600 INOX;LINEA BLANCA
6342252;;F;72;CHILENO;;Silencioso;LAGO RANCO                    ;LOS LAGOS;0;0;0;0;0;0;0;0;0;Refrigerador 252Lts No Frost MRFS-2700G333FW;LINEA BLANCA
16950997;Soltero;M;34;CHILENO;;Silencioso;PROVIDENCIA                   ;METROPOLITANA;0;0;0;0;0;0;0;0;0;Refrigerador 322Lts No Frost BF DB60S;LINEA BLANCA
6788892;;F;73;CHILENO;;Silencioso;CURICO                        ;MAULE;0;0;0;0;0;0;0;0;0;Lavadora WA17T6260BW/ZS 17Kg Blanca;LINEA BLANCA
9873237;;M;59;CHILENO;;Boomers;PROVIDENCIA                   ;METROPOLITANA;0;0;0;0;0;0;0;0;0;Secadora Ropa MSV-90 9K Blanca Ventilacion;LINEA BLANCA
18578126;Soltero;F;28;CHILENO;PSICOLOGO;Silencioso;PROVIDENCIA                   ;METROPOLITANA;0;0;0;0;0;0;0;0;0;Lavadora Secadora Perfect Care 8Kg/5Kg Blanca;LINEA BLANCA
13825124;;F;43;CHILENO;;X;RENCA                         ;METROPOLITANA;0;0;0;0;0;0;0;0;0;Refrigerador 260Lts BF Frio Direc MRFI2660SR346W;LINEA BLANCA
10469873;;M;56;CHILENO;;Boomers;PROVIDENCIA                   ;METROPOLITANA;0;0;0;0;0;0;0;0;0;Refrigerador 260Lts BF Frio Direc MRFI2660SR346W;LINEA BLANCA
10500419;;F;55;CHILENO;;Boomers;N/D;N/D;0;0;0;0;0;0;0;0;0;Refrigerador 400Lts No Frost RMP400FHUG;LINEA BLANCA
16514744;;M;35;CHILENO;;Millenial;PENCO                         ;BIO BIO;0;0;0;0;0;0;0;0;0;Refrigerador 260Lts BF Frio Direc MRFI2660SR346W;LINEA BLANCA
15170035;;M;40;CHILENO;;X;PROVIDENCIA                   ;METROPOLITANA;0;0;0;0;0;0;0;0;0;Cocina 76DXR Doble Horno;LINEA BLANCA
9312742;;M;59;CHILENO;;Boomers;CURICO                        ;MAULE;0;0;0;0;0;0;0;0;0;Freezer Horizontal M100 99Lts;LINEA BLANCA
6836813;;F;68;CHILENO;;Silencioso;RENCA                         ;METROPOLITANA;0;0;0;0;0;0;0;0;0;Freezer Horizontal M100 99Lts;LINEA BLANCA
11741317;;M;50;CHILENO;;Silencioso;PROVIDENCIA                   ;METROPOLITANA;0;0;0;0;0;0;0;0;0;Freezer FDHM200BY1 200Lts Horizontal;LINEA BLANCA
15144716;;M;39;CHILENO;;X;TALCA                         ;MAULE;0;0;0;0;0;0;0;0;0;Lavadora MLS-090GE04N 9Kg Gris;LINEA BLANCA
17650215;Soltero;M;32;CHILENO;INGENIERO EN PREVENCION DE RIESGOS;Millenial;PROVIDENCIA                   ;METROPOLITANA;0;0;0;0;0;0;0;0;0;Cocina CH-7400 4P;LINEA BLANCA
13954861;;F;42;CHILENO;;X;PROVIDENCIA                   ;METROPOLITANA;0;0;0;0;0;0;0;0;0;Lavadora MLS-090GE04N 9Kg Gris;LINEA BLANCA
13915110;;F;44;CHILENO;;X;NUNOA                         ;METROPOLITANA;0;0;0;0;0;0;0;0;0;Lavadora LMA0920WGCL0 9,5Kg Gris;LINEA BLANCA
17610335;;M;31;CHILENO;;Millenial;N/D;N/D;0;0;0;0;0;0;0;0;0;Lavadora Efficace SZG 17,5Kg Silver;LINEA BLANCA
8497389;Soltero;F;63;CHILENO;;Boomers;COIHAIQUE                     ;AYSEN;0;0;0;0;0;0;0;0;0;Refrigerador 244Lts Frio Directo Progress 3100;LINEA BLANCA
12922368;;M;46;CHILENO;;X;PROVIDENCIA                   ;METROPOLITANA;0;0;0;0;0;0;0;0;0;Lavadora MLS-160BSC03T 16Kg Blanca;LINEA BLANCA
6496353;Divorciado;M;69;CHILENO;;Silencioso;PROVIDENCIA                   ;METROPOLITANA;0;0;0;0;0;0;0;0;0;Cocina 775X 4P;LINEA BLANCA
14479142;Soltero;M;46;CHILENO;INGENIERO EN CONSTRUCCION;Silencioso;PROVIDENCIA                   ;METROPOLITANA;0;0;0;0;0;0;0;0;0;FREEZERSFV-200 SILVER 183L SINDELEN;LINEA BLANCA
9569304;;F;57;CHILENO;;Boomers;CONCON                        ;VALPARAISO;0;0;0;0;0;0;0;0;0;Freezer FDHM150BY1 150Lts Horizontal;LINEA BLANCA
19117832;;M;26;CHILENO;;Z;N/D;N/D;0;0;0;0;0;0;0;0;0;Lavadora MLS-160BSC03T 16Kg Blanca;LINEA BLANCA
5933462;;F;77;CHILENO;;Silencioso;SAN CLEMENTE                  ;MAULE;0;0;0;0;0;0;0;0;0;Refrigerador 252Lts No Frost MRFS-2700G333FW;LINEA BLANCA
11417071;;M;55;CHILENO;;Boomers;LOS ANGELES                   ;BIO BIO;0;0;0;0;0;0;0;0;0;Cocina MCG-5QI30AME5 5P Inox;LINEA BLANCA
10087636;;M;65;CHILENO;;Boomers;SAN FERNANDO                  ;L.G.B.OÂ´HIGGINS;0;0;0;0;0;0;0;0;0;Lavadora MLS-160BSC03T 16Kg Blanca;LINEA BLANCA
12420580;;F;49;CHILENO;;X;RENCA                         ;METROPOLITANA;0;0;0;0;0;0;0;0;0;Calefon 7Lts GL Master;LINEA BLANCA
5779632;;M;74;CHILENO;;Silencioso;EL BOSQUE                     ;METROPOLITANA;0;0;0;0;0;0;0;0;0;Cocina CMC5515GCH-1 4P;LINEA BLANCA
15046154;;F;39;CHILENO;;X;ILLAPEL                       ;COQUIMBO;0;0;0;0;0;0;0;0;0;Lavadora superior MLS-110GE04N 11Kg;LINEA BLANCA
18154279;Soltero;M;33;CHILENO;;Millenial;SAN IGNACIO                   ;BIO BIO;0;0;0;0;0;0;0;0;0;Lavadora WA17T6260BW/ZS 17Kg Blanca;LINEA BLANCA
5808132;;F;59;CHILENO;;Boomers;OSORNO                        ;LOS LAGOS;0;0;0;0;0;0;0;0;0;Lavadora MLS-090GE04N 9Kg Gris;LINEA BLANCA
4997863;;M;77;CHILENO;;Silencioso;RENCA                         ;METROPOLITANA;0;0;0;0;0;0;0;0;0;Calefon 7Lts GL Master;LINEA BLANCA
11602103;;M;52;CHILENO;;X;MELIPILLA                     ;METROPOLITANA;0;0;0;0;0;0;0;0;0;Freezer FDHM150BY1 150Lts Horizontal;LINEA BLANCA
18557529;Soltero;M;29;CHILENO;;Millenial;PROVIDENCIA                   ;METROPOLITANA;0;0;0;0;0;0;0;0;0;Refrigerador 241Lts BF Frio Directo Nordik 415;LINEA BLANCA
19035957;Soltero;M;27;CHILENO;;Silencioso;PROVIDENCIA                   ;METROPOLITANA;0;0;0;0;0;0;0;0;0;Cocina CH-9900SI 6P Silver;LINEA BLANCA
6302127;;M;71;CHILENO;;Silencioso;SAN ANTONIO                   ;VALPARAISO;0;0;0;0;0;0;0;0;0;Cocina MCG-5QI30AME5 5P Inox;LINEA BLANCA
18388080;;M;29;CHILENO;;Millenial;RENCA                         ;METROPOLITANA;0;0;0;0;0;0;0;0;0;Refrigerador Altus 1350W 342Lts No Frost;LINEA BLANCA
12499106;;M;49;CHILENO;;X;PUENTE ALTO                   ;METROPOLITANA;0;0;0;0;0;0;0;0;0;Calefon 5Lts GL Master;LINEA BLANCA
11808878;;M;51;CHILENO;;X;CHILLAN                       ;BIO BIO;0;0;0;0;0;0;0;0;0;Lavadora Efficace SZG 19,5Kg Silver;LINEA BLANCA
8448062;Casado;F;58;CHILENO;;Boomers;PROVIDENCIA                   ;METROPOLITANA;0;0;0;0;0;0;0;0;0;Lavadora Secadora WD10WVC4S6 10,5/6Kg Blanca;LINEA BLANCA
8811414;;M;63;CHILENO;;Boomers;RENCA                         ;METROPOLITANA;0;0;0;0;0;0;0;0;0;Lavadora Brilliant SG 15Kg Silver;LINEA BLANCA
13112261;;F;49;CHILENO;;X;PUENTE ALTO                   ;METROPOLITANA;0;0;0;0;0;0;0;0;0;Refrigerador 244Lts Frio Directo Progress 3100;LINEA BLANCA
17542220;Soltero;F;31;CHILENO;ADMINISTRADOR HOTELERO;Silencioso;PROVIDENCIA                   ;METROPOLITANA;0;0;0;0;0;0;0;0;0;Cocina 76DXR Doble Horno;LINEA BLANCA
15130452;Casado;F;39;CHILENO;CONTADOR AUDITOR;X;RENCA                         ;METROPOLITANA;0;0;0;0;0;0;0;0;0;Refrigerador 322Lts No Frost BF DB60S;LINEA BLANCA
15460594;;M;39;CHILENO;;X;PROVIDENCIA                   ;METROPOLITANA;0;0;0;0;0;0;0;0;0;Freezer FDHM150BY1 150Lts Horizontal;LINEA BLANCA
6579552;;M;69;CHILENO;;Silencioso;RANCAGUA                      ;L.G.B.OÂ´HIGGINS;0;0;0;0;0;0;0;0;0;Lavadora Efficace SZG 17,5Kg Silver;LINEA BLANCA
8420034;;M;63;CHILENO;;Boomers;COLINA                        ;METROPOLITANA;0;0;0;0;0;0;0;0;0;Freezer FDHM150BY1 150Lts Horizontal;LINEA BLANCA
18664228;;F;28;CHILENO;;Silencioso;PROVIDENCIA                   ;METROPOLITANA;0;0;0;0;0;0;0;0;0;Lavadora MLS-140BSC03T 14Kg Blanca;LINEA BLANCA
17238271;;M;32;CHILENO;;Millenial;PROVIDENCIA                   ;METROPOLITANA;0;0;0;0;0;0;0;0;0;Refrigerador 525Lts Side by Side SFX500;LINEA BLANCA
20280237;;M;22;CHILENO;;Z;PROVIDENCIA                   ;METROPOLITANA;0;0;0;0;0;0;0;0;0;Refrigerador 322Lts No Frost BF DB60S;LINEA BLANCA
8444651;;M;65;CHILENO;;Boomers;SAN PEDRO DE LA PAZ           ;BIO BIO;0;0;0;0;0;0;0;0;0;Refrigerador 249Lts No Frost RMA250PHUG;LINEA BLANCA
17044510;Casado;F;33;CHILENO;;Millenial;SANTA JUANA                   ;BIO BIO;0;0;0;0;0;0;0;0;0;Refrigerador 527Lts Side by Side MRSBS5300G689WE;LINEA BLANCA
6342089;;F;77;CHILENO;;Silencioso;PROVIDENCIA                   ;METROPOLITANA;0;0;0;0;0;0;0;0;0;Centrifuga Primma 5B 5,5Kilos;LINEA BLANCA
17591633;Soltero;M;32;CHILENO;;Millenial;PROVIDENCIA                   ;METROPOLITANA;0;0;0;0;0;0;0;0;0;Lavadora Semiautomatica Twister 5300 4Kg;LINEA BLANCA
18793014;;F;27;CHILENO;;Millenial;ANTOFAGASTA                   ;ANTOFAGASTA;0;0;0;0;0;0;0;0;0;Lavadora superior MLS-110GE04N 11Kg;LINEA BLANCA
11200616;;M;55;CHILENO;;Boomers;NUNOA                         ;METROPOLITANA;0;0;0;0;0;0;0;0;0;Cocina F-2808 4P;LINEA BLANCA
14473584;;F;46;CHILENO;;X;PROVIDENCIA                   ;METROPOLITANA;0;0;0;0;0;0;0;0;0;Lavadora WA17T6260BW/ZS 17Kg Blanca;LINEA BLANCA
8797832;;F;63;CHILENO;;Boomers;MACHALI                       ;L.G.B.OÂ´HIGGINS;0;0;0;0;0;0;0;0;0;Lavadora MLS-090GE04N 9Kg Gris;LINEA BLANCA
10906700;;M;51;CHILENO;;X;LAJA                          ;BIO BIO;0;0;0;0;0;0;0;0;0;Refrigerador Altus 1350W 342Lts No Frost;LINEA BLANCA
26697660;;F;45;CHILENO;;Extranjero;N/D;N/D;0;0;0;0;0;0;0;0;0;Cocina CMC5515GCH-1 4P;LINEA BLANCA
6889770;;F;67;CHILENO;;Boomers;SAAVEDRA                      ;ARAUCANIA;0;0;0;0;0;0;0;0;0;Cocina CH-7400 4P;LINEA BLANCA
13811770;;M;42;CHILENO;;X;RENCA                         ;METROPOLITANA;0;0;0;0;0;0;0;0;0;Refrigerador 241Lts BF Frio Directo Nordik 415;LINEA BLANCA
7443617;;M;65;CHILENO;;Boomers;ANDACOLLO                     ;COQUIMBO;0;0;0;0;0;0;0;0;0;Cocina Andes7650FX 5P Inox;LINEA BLANCA
6578805;;M;71;CHILENO;;Silencioso;PROVIDENCIA                   ;METROPOLITANA;0;0;0;0;0;0;0;0;0;Refrigerador 527Lts Side by Side MRSBS5300G689WE;LINEA BLANCA
16540196;;F;35;CHILENO;;Millenial;HIJUELAS                      ;VALPARAISO;0;0;0;0;0;0;0;0;0;Refrigerador 241Lts BF Frio Directo Nordik 415;LINEA BLANCA
5118234;;M;76;CHILENO;;Silencioso;RENCA                         ;METROPOLITANA;0;0;0;0;0;0;0;0;0;Refrigerador Altus 1350W 342Lts No Frost;LINEA BLANCA
12916463;;M;51;CHILENO;;X;TALCA                         ;MAULE;0;0;0;0;0;0;0;0;0;Freezer Horizontal MFH-1990B258CN 198Lts;LINEA BLANCA
13827249;;F;42;CHILENO;;X;N/D;N/D;0;0;0;0;0;0;0;0;0;Freezer 142Lts EFC14A5MNW Horizontal;LINEA BLANCA
12890399;;F;47;CHILENO;;X;PROVIDENCIA                   ;METROPOLITANA;0;0;0;0;0;0;0;0;0;Lavadora Efficace SZG 15,5Kg Silver;LINEA BLANCA
10810278;Casado;M;44;CHILENO;;X;COIHAIQUE                     ;AYSEN;0;0;0;0;0;0;0;0;0;Cocina F-2525 4P;LINEA BLANCA
9303880;Casado;M;59;CHILENO;;Boomers;PROVIDENCIA                   ;METROPOLITANA;0;0;0;0;0;0;0;0;0;Lavadora Impressive 20SZ 20Kg Silver;LINEA BLANCA
6437345;;M;68;CHILENO;;Boomers;TEMUCO                        ;ARAUCANIA;0;0;0;0;0;0;0;0;0;Refrigerador 252Lts No Frost MRFS-2700G333FW;LINEA BLANCA
13840591;;M;41;CHILENO;;X;PROVIDENCIA                   ;METROPOLITANA;0;0;0;0;0;0;0;0;0;Freezer 99Lts MFH-1000B131CN Horizontal;LINEA BLANCA
9138485;;F;59;CHILENO;;Boomers;IQUIQUE                       ;TARAPACA;0;0;0;0;0;0;0;0;0;Refrigerador 400Lts No Frost RMP400FHUG;LINEA BLANCA
7604882;;F;68;CHILENO;;Boomers;QUILPUE                       ;VALPARAISO;0;0;0;0;0;0;0;0;0;Lavadora MLS-090GE04N 9Kg Gris;LINEA BLANCA
17142659;;F;33;CHILENO;;Millenial;VALPARAISO                    ;VALPARAISO;0;0;0;0;0;0;0;0;0;Refrigerador 260Lts BF Frio Direc MRFI2660SR346W;LINEA BLANCA
18212425;;F;30;CHILENO;;Millenial;"";"";0;0;0;0;0;0;0;0;0;Cocina Andes76HG0 6P Inox;LINEA BLANCA
13145944;;M;45;CHILENO;;X;LOS ANGELES                   ;BIO BIO;0;0;0;0;0;0;0;0;0;Refrigerador 303Lts BF Frio Directo Nordik 480;LINEA BLANCA
5870937;;M;74;CHILENO;;Silencioso;PROVIDENCIA                   ;METROPOLITANA;0;0;0;0;0;0;0;0;0;Lavadora WA90H4400SW/ZS 9Kg Blanca;LINEA BLANCA
18719526;;M;28;CHILENO;;Millenial;ANCUD                         ;LOS LAGOS;0;0;0;0;0;0;0;0;0;Lavadora Secadora WD12WVC4S6 12/7Kg Blanca;LINEA BLANCA
8456330;;M;65;CHILENO;;Boomers;ARICA                         ;TARAPACA;0;0;0;0;0;0;0;0;0;Freezer 99Lts MFH-1000B131CN Horizontal;LINEA BLANCA
7501981;Casado;M;65;CHILENO;;Boomers;RENCA                         ;METROPOLITANA;0;0;0;0;0;0;0;0;0;Refrigerador 249Lts No Frost RMA250PHUG;LINEA BLANCA
8935447;;F;62;CHILENO;;Boomers;PUENTE ALTO                   ;METROPOLITANA;0;0;0;0;0;0;0;0;0;Freezer FDHM150BY1 150Lts Horizontal;LINEA BLANCA
16146929;;M;36;CHILENO;;Millenial;PUDAHUEL;METROPOLITANA;0;0;0;0;0;0;0;0;0;Refrigerador 303Lts BF Frio Directo Nordik 480;LINEA BLANCA
15496136;;F;42;CHILENO;;X;OSORNO                        ;LOS LAGOS;0;0;0;0;0;0;0;0;0;Lavadora Efficace SZG 19,5Kg Silver;LINEA BLANCA
9413336;Divorciado;M;58;CHILENO;;Boomers;PROVIDENCIA                   ;METROPOLITANA;0;0;0;0;0;0;0;0;0;Lavadora WT16DSBP 16Kg Silver;LINEA BLANCA
11238253;;F;53;CHILENO;;X;PENCO                         ;BIO BIO;0;0;0;0;0;0;0;0;0;Cocina CH-9400 4P SILVER;LINEA BLANCA
26098985;;F;32;VENEZOLANO;;Extranjero;NUNOA                         ;METROPOLITANA;0;0;0;0;0;0;0;0;0;Lavadora MLS-090GE04N 9Kg Gris;LINEA BLANCA
9941010;Casado;M;58;CHILENO;;Boomers;TENO                          ;MAULE;0;0;0;0;0;0;0;0;0;Lavadora MLS-090GE04N 9Kg Gris;LINEA BLANCA
8473372;;F;64;CHILENO;;Boomers;VALLENAR;ATACAMA;0;0;0;0;0;0;0;0;0;Refrigerador 249Lts No Frost RMA250PHUG;LINEA BLANCA
9719606;;F;55;CHILENO;;Boomers;BUIN                          ;METROPOLITANA;0;0;0;0;0;0;0;0;0;Refrigerador MBF60X 322Lts BF No Frost;LINEA BLANCA
15153916;;F;39;CHILENO;;X;MACHALI                       ;L.G.B.OÂ´HIGGINS;0;0;0;0;0;0;0;0;0;Lavadora WA17F7L6DD 17Kg Blanca;LINEA BLANCA
5366579;Casado;F;70;CHILENO;;Silencioso;PROVIDENCIA                   ;METROPOLITANA;0;0;0;0;0;0;0;0;0;Cocina F-2808 4P;LINEA BLANCA
19691046;;M;25;CHILENO;;Z;N/D;N/D;0;0;0;0;0;0;0;0;0;Cocina Diva 920 5P;LINEA BLANCA
9983433;;M;59;CHILENO;;Boomers;LINARES                       ;MAULE;0;0;0;0;0;0;0;0;0;Cocina Andes60TX4 4P Inox;LINEA BLANCA
19751067;;F;24;CHILENO;;Z;SAN VICENTE                   ;L.G.B.OÂ´HIGGINS;0;0;0;0;0;0;0;0;0;Refrigerador 244Lts Frio Directo Progress 3100;LINEA BLANCA
15333608;;F;38;CHILENO;;Millenial;"";"";0;0;0;0;0;0;0;0;0;Lavadora WT13WSBP 13Kg Blanca;LINEA BLANCA
12792175;Soltero;M;47;CHILENO;;X;CAUQUENES                     ;MAULE;0;0;0;0;0;0;0;0;0;Freezer 142Lts MFH-1430B186C Horizontal;LINEA BLANCA
14450253;Casado;M;48;CHILENO;;X;RENCA                         ;METROPOLITANA;0;0;0;0;0;0;0;0;0;Cocina Diva 920 5P;LINEA BLANCA
13367141;;M;44;CHILENO;;X;TEMUCO                        ;ARAUCANIA;0;0;0;0;0;0;0;0;0;Cocina Diva 920 5P;LINEA BLANCA
18030279;;F;30;CHILENO;;Millenial;PROVIDENCIA                   ;METROPOLITANA;0;0;0;0;0;0;0;0;0;Cocina MV 110 4 Platos;LINEA BLANCA
8246080;Casado;F;50;CHILENO;INGENIERO;X;PROVIDENCIA                   ;METROPOLITANA;0;0;0;0;0;0;0;0;0;Refrigerador Side by Side RF62HESL/ZS 441Lts;LINEA BLANCA
14523857;;M;48;CHILENO;;X;RENCA                         ;METROPOLITANA;0;0;0;0;0;0;0;0;0;Cocina Lena Angelina Blanca;LINEA BLANCA
13972702;;F;45;CHILENO;;X;RENCA                         ;METROPOLITANA;0;0;0;0;0;0;0;0;0;Lavadora WT13WSBP 13Kg Blanca;LINEA BLANCA
9533709;;F;60;CHILENO;;Boomers;LA GRANJA                     ;METROPOLITANA;0;0;0;0;0;0;0;0;0;Freezer 99Lts MFH-1000B131CN Horizontal;LINEA BLANCA
9429370;;M;60;CHILENO;;Boomers;CALAMA                        ;ANTOFAGASTA;0;0;0;0;0;0;0;0;0;Campana Cocina CM6031ZI 60Cms Inox;LINEA BLANCA
8634865;Casado;F;63;CHILENO;;Boomers;PROVIDENCIA                   ;METROPOLITANA;0;0;0;0;0;0;0;0;0;Lavadora MLS-160BSC03T 16Kg Blanca;LINEA BLANCA
16054812;;M;37;CHILENO;;Millenial;IQUIQUE                       ;TARAPACA;0;0;0;0;0;0;0;0;0;Lavadora Efficace SZG 17,5Kg Silver;LINEA BLANCA
18348259;;M;29;CHILENO;;Millenial;PROVIDENCIA                   ;METROPOLITANA;0;0;0;0;0;0;0;0;0;Lavadora Efficace SZG 15,5Kg Silver;LINEA BLANCA
10226859;;M;55;CHILENO;;Boomers;SAN CARLOS                    ;BIO BIO;0;0;0;0;0;0;0;0;0;Lavadora Efficace SZG 19,5Kg Silver;LINEA BLANCA
13953695;;M;41;CHILENO;;X;TOME                          ;BIO BIO;0;0;0;0;0;0;0;0;0;Lavadora Efficace BZG 9,5Kg Blanca;LINEA BLANCA
8067942;;F;63;CHILENO;;Boomers;MONTE PATRIA                  ;COQUIMBO;0;0;0;0;0;0;0;0;0;Freezer 99Lts MFH-1000B131CN Horizontal;LINEA BLANCA
11423241;;F;53;CHILENO;;X;SANTA MARIA                   ;VALPARAISO;0;0;0;0;0;0;0;0;0;Refrigerador 244Lts Frio Directo Progress 3100;LINEA BLANCA
6643996;;M;71;CHILENO;;Silencioso;SAN FELIPE                    ;VALPARAISO;0;0;0;0;0;0;0;0;0;Calefon 5Lts GL Master;LINEA BLANCA
17842125;;M;31;CHILENO;;Millenial;LOS ANGELES                   ;BIO BIO;0;0;0;0;0;0;0;0;0;Cocina Andes7650FX 5P Inox;LINEA BLANCA
23887229;;F;29;COLOMBIANO;;Extranjero;SANTIAGO                      ;METROPOLITANA;0;0;0;0;0;0;0;0;0;Lavadora Superior WW10J6410CW1ZS 10Kg;LINEA BLANCA
13009201;;M;45;CHILENO;;X;IQUIQUE                       ;TARAPACA;0;0;0;0;0;0;0;0;0;Freezer 99Lts MFH-1000B131CN Horizontal;LINEA BLANCA
19252300;;F;25;CHILENO;;Z;N/D;N/D;0;0;0;0;0;0;0;0;0;Cocina Nova CH9850NG 6P;LINEA BLANCA
5446313;;F;75;CHILENO;;Silencioso;SAN FELIPE                    ;VALPARAISO;0;0;0;0;0;0;0;0;0;Refrigerador 252Lts No Frost MRFS-2700G333FW;LINEA BLANCA
11475713;;F;52;CHILENO;;X;CERRILLOS                     ;METROPOLITANA;0;0;0;0;0;0;0;0;0;Cocina F-2808 4P;LINEA BLANCA
6608289;;F;73;CHILENO;;Silencioso;ANTOFAGASTA                   ;ANTOFAGASTA;0;0;0;0;0;0;0;0;0;Refrigerador 252Lts No Frost MRFS-2700G333FW;LINEA BLANCA
19780362;;F;23;CHILENO;;Z;CURICO                        ;MAULE;0;0;0;0;0;0;0;0;0;Lavadora Efficace SZG 15,5Kg Silver;LINEA BLANCA
13264627;;M;45;CHILENO;;X;PROVIDENCIA                   ;METROPOLITANA;0;0;0;0;0;0;0;0;0;Cocina CH-9050SI 4P;LINEA BLANCA
15404987;;M;40;CHILENO;;X;PROVIDENCIA                   ;METROPOLITANA;0;0;0;0;0;0;0;0;0;Lavadora WT19DSBP 19Kg Silver;LINEA BLANCA
11811979;;F;51;CHILENO;;X;PENAFLOR                      ;METROPOLITANA;0;0;0;0;0;0;0;0;0;Lavadora WA13R5260BW/ZS 13Kg Blanca;LINEA BLANCA
18654045;;F;28;CHILENO;;Millenial;CHIMBARONGO                   ;L.G.B.OÂ´HIGGINS;0;0;0;0;0;0;0;0;0;Lavadora MLS-090GE04N 9Kg Gris;LINEA BLANCA
15439594;Soltero;M;40;CHILENO;;X;PROVIDENCIA                   ;METROPOLITANA;0;0;0;0;0;0;0;0;0;Freezer 142Lts MFH-1430B186C Horizontal;LINEA BLANCA
7658147;;M;67;CHILENO;;Boomers;N/D;N/D;0;0;0;0;0;0;0;0;0;Lavadora Frontal Premium Care 11W 11Kg Blanca;LINEA BLANCA
8653398;;M;61;CHILENO;;Boomers;PUENTE ALTO                   ;METROPOLITANA;0;0;0;0;0;0;0;0;0;Freezer MFH-2950B384CN 295 lts blanco;LINEA BLANCA
9403876;Casado;F;58;CHILENO;;Boomers;PROVIDENCIA                   ;METROPOLITANA;0;0;0;0;0;0;0;0;0;ENCIMERA A GAS CMG6044SD-0CL 4Q MABE;LINEA BLANCA
16917516;;M;34;CHILENO;;Millenial;PROVIDENCIA                   ;METROPOLITANA;0;0;0;0;0;0;0;0;0;Freezer 142Lts EFC14A5MNW Horizontal;LINEA BLANCA
18082396;;M;29;CHILENO;;Millenial;QUILICURA                     ;METROPOLITANA;0;0;0;0;0;0;0;0;0;Lavadora LMA0920WGCL0 9,5Kg Gris;LINEA BLANCA
6898894;;M;69;CHILENO;;Silencioso;RENCA                         ;METROPOLITANA;0;0;0;0;0;0;0;0;0;Refrigerador 241Lts BF Frio Directo Nordik 415;LINEA BLANCA
11732747;;M;51;CHILENO;;X;PROVIDENCIA                   ;METROPOLITANA;0;0;0;0;0;0;0;0;0;Cocina CH-7400 4P;LINEA BLANCA
15511823;;M;39;CHILENO;;X;ANGOL                         ;ARAUCANIA;0;0;0;0;0;0;0;0;0;Campana Cocina CA-610EBL 60Cms Blanca;LINEA BLANCA
26807887;;M;29;VENEZOLANO;;Extranjero;N/D;N/D;0;0;0;0;0;0;0;0;0;Refrigerador 249Lts No Frost RMA250PHUG;LINEA BLANCA
5705991;;F;76;CHILENO;;Silencioso;MELIPILLA                     ;METROPOLITANA;0;0;0;0;0;0;0;0;0;Refrigerador 290Lts BF No Frost RB30N4020S8;LINEA BLANCA
27164284;Soltero;M;40;EXTRANJERO - NO INFORMA NACIONALIDAD;;Extranjero;N/D;N/D;1429990;2;1;0;0;0;2;1;1429990;SCOOTER TAKASAKI SY150T-28 COLOR NEGRO;MOTOCICLETAS
15786945;;F;38;CHILENO;;Millenial;"";"";131970;5;7;1;3;17990;4;4;113980;ACC CONTROL PS4 DUALSHOCK;VIDEO JUEGOS
19185569;Soltero;M;26;CHILENO;;Silencioso;PROVIDENCIA                   ;METROPOLITANA;33980;2;1;2;1;33980;0;0;0;JUEGO SPIDER-MAN MILES MORALES - LATAM PS4;VIDEO JUEGOS
19307881;Soltero;M;26;CHILENO;;Silencioso;PROVIDENCIA                   ;METROPOLITANA;56980;2;2;1;1;39990;1;1;16990;CONTROL NINTENDO SWITCH PRO CONTROLLER;VIDEO JUEGOS
11989719;;F;52;CHILENO;;X;"";"";538270;2;1;0;0;0;2;1;538270;Consola PlayStation 4 500GB;VIDEO JUEGOS
25015081;;M;30;BOLIVIANO;;Extranjero;RECOLETA                      ;METROPOLITANA;479980;2;2;0;0;0;2;2;479980;Consola PlayStation 4 500GB;VIDEO JUEGOS
27357647;;M;23;CHILENO;;Z;N/D;N/D;409990;3;2;0;0;0;3;2;409990;Consola PlayStation 4 500GB;VIDEO JUEGOS
18873192;;M;27;CHILENO;;Silencioso;PROVIDENCIA                   ;METROPOLITANA;41990;1;1;0;0;0;1;1;41990;Juego SWITCH MARIO PARTY SUPERSTARS;VIDEO JUEGOS
11869325;;F;50;CHILENO;;X;N/D;N/D;683980;2;1;0;0;0;2;1;683980;Consola PlayStation 5 con Disco (Internacional);VIDEO JUEGOS
17584585;;M;31;CHILENO;;Millenial;TEMUCO                        ;ARAUCANIA;64990;1;1;0;0;0;1;1;64990;ACC CONTROL PS4 DUALSHOCK;VIDEO JUEGOS
12507480;;M;50;CHILENO;;X;SAN MIGUEL                    ;METROPOLITANA;772980;5;2;0;0;0;5;2;772980;Consola PlayStation 4 500GB;VIDEO JUEGOS
17514102;Soltero;M;31;CHILENO;;Millenial;PROVIDENCIA                   ;METROPOLITANA;29980;2;1;2;1;29980;0;0;0;JUEGO PRO EVOLUTION 2021 - LATAM PS4;VIDEO JUEGOS
13517954;;M;43;CHILENO;;X;CHILLAN                       ;BIO BIO;596790;7;7;7;4;770290;0;3;-173500;Estuche protector Switch Pikachu;VIDEO JUEGOS
19643638;;M;25;CHILENO;;Z;RECOLETA                      ;METROPOLITANA;650000;3;1;0;0;0;3;1;650000;Consola PlayStation 5 con Disco (Internacional);VIDEO JUEGOS
13674991;;F;43;CHILENO;;X;CONCHALI;METROPOLITANA;124940;5;2;4;1;69950;1;1;54990;Audifonos Xbox Wired;VIDEO JUEGOS
5801440;;F;83;CHILENO;;Silencioso;CASTRO                        ;LOS LAGOS;660660;4;2;0;0;0;4;2;660660;Consola PlayStation 4 500GB;VIDEO JUEGOS
10797459;Casado;M;50;CHILENO;PERIODISTA;X;PROVIDENCIA                   ;METROPOLITANA;713980;2;1;2;1;713980;0;0;0;Consola PlayStation 5 con Disco;VIDEO JUEGOS
11706587;;M;51;CHILENO;;X;N/D;N/D;586980;2;1;0;0;0;2;1;586980;Consola PlayStation 4 500GB;VIDEO JUEGOS
18235652;Soltero;M;29;CHILENO;;Millenial;PROVIDENCIA                   ;METROPOLITANA;64980;2;1;2;1;64980;0;0;0;CONTROL XBOX SHOCK BLUE;VIDEO JUEGOS
17081291;;M;34;CHILENO;;Millenial;RENCA                         ;METROPOLITANA;473980;2;1;2;1;473980;0;0;0;PS4 HW 1TB MEGA 18 - R C, GOT, GOW BNDL;VIDEO JUEGOS
13023888;;F;46;CHILENO;;X;LA REINA;METROPOLITANA;473980;2;1;2;1;473980;0;0;0;PS4 HW 1TB MEGA 18 - R C, GOT, GOW BNDL;VIDEO JUEGOS
19193246;;F;26;CHILENO;;Z;QUILPUE;VALPARAISO;117970;3;1;3;1;117970;0;0;0;ACC SWITCH JOY CON L R BLUE NEON YELLOW;VIDEO JUEGOS
13979777;;M;41;CHILENO;;X;N/D;N/D;989990;1;1;1;1;989990;0;0;0;Consola PlayStation 5 con Disco (Internacional);VIDEO JUEGOS
18391945;Soltero;F;29;CHILENO;;Millenial;PROVIDENCIA                   ;METROPOLITANA;44980;2;1;2;1;44980;0;0;0;JUEGO SW SWITCH LUIGIS MANSION 3;VIDEO JUEGOS
11716234;;M;50;CHILENO;;X;CALBUCO                       ;LOS LAGOS;199990;1;1;0;0;0;1;1;199990;CONSOLA SWITCH LITE TURQUOISE;VIDEO JUEGOS
8595847;;F;64;CHILENO;;Boomers;RENCA                         ;METROPOLITANA;369990;1;1;0;0;0;1;1;369990;CONSOLA SWITCH LT2 NEON;VIDEO JUEGOS
14000586;;F;40;CHILENO;;X;VILLA ALEMANA                 ;VALPARAISO;45980;2;1;2;1;45980;0;0;0;JUEGO SWITCH Mario Kart 8 Deluxe;VIDEO JUEGOS
20419149;;F;22;CHILENO;;Z;N/D;N/D;849990;2;1;0;0;0;2;1;849990;Consola PlayStation 5 con Disco (Internacional);VIDEO JUEGOS
17675628;;F;31;CHILENO;;Millenial;"";"";41980;2;1;2;1;41980;0;0;0;JUEGO SWITCH Mario Kart 8 Deluxe;VIDEO JUEGOS
18861836;;F;27;CHILENO;;Boomers;PROVIDENCIA                   ;METROPOLITANA;1206964;4;2;0;0;0;4;2;1206964;Consola PlayStation 5 con Disco;VIDEO JUEGOS
16778144;;M;34;CHILENO;;Millenial;PROVIDENCIA                   ;METROPOLITANA;1604970;3;1;3;1;1604970;0;0;0;Consola PlayStation 5 con Disco;VIDEO JUEGOS
15299750;;M;39;CHILENO;;X;RENCA                         ;METROPOLITANA;68540;2;1;2;1;68540;0;0;0;JUEGO SWITCH SUPER MARIO 3D ALL STARS;VIDEO JUEGOS
17150070;;F;33;CHILENO;;Millenial;N/D;N/D;44980;2;1;2;1;44980;0;0;0;JUEGO SW SWITCH LUIGIS MANSION 3;VIDEO JUEGOS
19393590;Soltero;M;26;CHILENO;;Z;PROVIDENCIA                   ;METROPOLITANA;44980;2;1;2;1;44980;0;0;0;JUEGO SWITCH Zelda: Breath of the Wild;VIDEO JUEGOS
14146370;;M;41;CHILENO;;X;PROVIDENCIA                   ;METROPOLITANA;89960;4;2;4;2;89960;0;0;0;JUEGO SWITCH SUPER MARIO 3D ALL STARS;VIDEO JUEGOS
18325593;;M;29;CHILENO;;Silencioso;PROVIDENCIA                   ;METROPOLITANA;223980;2;1;2;1;223980;0;0;0;CONSOLA SWITCH LITE + JUEGO ZELDA Link s Awakeni;VIDEO JUEGOS
19915005;;M;24;CHILENO;;Z;PROVIDENCIA                   ;METROPOLITANA;17980;2;1;2;1;17980;0;0;0;GRAND THEFT AUTO V PREMIUM EDITION - LATAM PS4;VIDEO JUEGOS
17831764;;M;31;CHILENO;;Millenial;N/D;N/D;399990;1;3;0;0;0;1;3;399990;CONSOLA SWITCH LT2 NEON;VIDEO JUEGOS
13710594;;M;43;CHILENO;;X;LO ESPEJO                     ;METROPOLITANA;0;0;0;0;0;0;0;0;0;JUEGO SWITCH Super Smash Bros Ultimate;VIDEO JUEGOS
16207837;Soltero;M;36;CHILENO;INGENIERO CIVIL INDUSTRIAL;Millenial;PROVIDENCIA                   ;METROPOLITANA;0;0;0;0;0;0;0;0;0;ACC ENWIRED CONTROLLER MARIO VINTAGE;VIDEO JUEGOS
17622940;;M;31;CHILENO;;Millenial;PROVIDENCIA                   ;METROPOLITANA;0;0;0;0;0;0;0;0;0;Consola PlayStation 5 con Disco;VIDEO JUEGOS
18293216;Soltero;M;29;CHILENO;;Silencioso;PROVIDENCIA                   ;METROPOLITANA;0;0;0;0;0;0;0;0;0;Juego Switch Ring Fit Adventure;VIDEO JUEGOS
17006920;;M;33;CHILENO;;Millenial;PROVIDENCIA                   ;METROPOLITANA;0;0;0;0;0;0;0;0;0;PS5 DUALSENSE;VIDEO JUEGOS
16268452;;F;36;CHILENO;;Silencioso;"";"";0;0;0;0;0;0;0;0;0;JUEGO THE LAST OF US 2 - LATAM PS4;VIDEO JUEGOS
13907762;;F;42;CHILENO;;X;N/D;N/D;0;0;0;0;0;0;0;0;0;ACC CONTROL PS4 DUALSHOCK;VIDEO JUEGOS
13060571;;F;46;CHILENO;;X;N/D;N/D;0;0;0;0;0;0;0;0;0;PS4 HW 1TB MEGA 15 - SPDMN GOTY, R C, HZDCE BNDL;VIDEO JUEGOS
17672588;Soltero;M;31;CHILENO;TECNICO EN AUTOMATIZACION Y CONTROL INDUSTRIAL;Silencioso;PROVIDENCIA                   ;METROPOLITANA;0;0;0;0;0;0;0;0;0;JUEGO SWITCH Super Smash Bros Ultimate;VIDEO JUEGOS
18537597;Soltero;M;29;CHILENO;;Millenial;PROVIDENCIA                   ;METROPOLITANA;0;0;0;0;0;0;0;0;0;JUEGO SWITCH Zelda: Breath of the Wild;VIDEO JUEGOS
10746363;;M;41;CHILENO;;X;PROVIDENCIA                   ;METROPOLITANA;0;0;0;0;0;0;0;0;0;Consola PlayStation 5 con Disco;VIDEO JUEGOS
18506584;;M;29;CHILENO;;Millenial;PROVIDENCIA                   ;METROPOLITANA;0;0;0;0;0;0;0;0;0;Consola PS4 Slim 500gb FIFA 21 Bundle;VIDEO JUEGOS
15477141;;F;39;CHILENO;;X;PROVIDENCIA                   ;METROPOLITANA;0;0;0;0;0;0;0;0;0;CONSOLA SWITCH LITE YELLOW;VIDEO JUEGOS
13901789;Casado;M;42;CHILENO;MEDICO CIRUJANO;X;PROVIDENCIA                   ;METROPOLITANA;0;0;0;0;0;0;0;0;0;CONSOLA SWITCH LITE YELLOW;VIDEO JUEGOS
17051148;;M;33;CHILENO;;Millenial;PROVIDENCIA                   ;METROPOLITANA;0;0;0;0;0;0;0;0;0;CONSOLA ONE S XBOX BLANCA;VIDEO JUEGOS
18499506;;M;28;CHILENO;;Millenial;N/D;N/D;0;0;0;0;0;0;0;0;0;Control inalambrico + cable USB-C Negro;VIDEO JUEGOS
17138251;;M;33;CHILENO;;Millenial;N/D;N/D;0;0;0;0;0;0;0;0;0;CONSOLA SWITCH LT2 NEON;VIDEO JUEGOS
20311362;;F;22;CHILENO;;Z;PROVIDENCIA                   ;METROPOLITANA;0;0;0;0;0;0;0;0;0;ACC CONTROL PS4 DUALSHOCK;VIDEO JUEGOS
17107859;Soltero;F;33;CHILENO;INGENIERA CIVIL QUIMICA;Millenial;PROVIDENCIA                   ;METROPOLITANA;0;0;0;0;0;0;0;0;0;JUEGO TONY HAWK - LATAM XBONE;VIDEO JUEGOS
5892984;;F;73;CHILENO;;Silencioso;CAUQUENES                     ;MAULE;0;0;0;0;0;0;0;0;0;PS4 SLIM 1TB MEGAPACK HIT 13;VIDEO JUEGOS
12882535;;M;47;CHILENO;;X;PROVIDENCIA                   ;METROPOLITANA;0;0;0;0;0;0;0;0;0;PS4 SLIM 1TB MEGAPACK HIT 13;VIDEO JUEGOS
19223797;;M;26;CHILENO;;Z;PROVIDENCIA                   ;METROPOLITANA;0;0;0;0;0;0;0;0;0;ACC CONTROL PS4 DUALSHOCK;VIDEO JUEGOS
17118096;;M;33;CHILENO;;Millenial;PROVIDENCIA                   ;METROPOLITANA;0;0;0;0;0;0;0;0;0;Consola Xbox Series S 512GB;VIDEO JUEGOS
13262902;Casado;M;44;CHILENO;PSICOLOGO;X;PROVIDENCIA                   ;METROPOLITANA;0;0;0;0;0;0;0;0;0;JUEGO THE LAST OF US 2 - LATAM PS4;VIDEO JUEGOS
14107784;;M;40;CHILENO;;X;PROVIDENCIA                   ;METROPOLITANA;0;0;0;0;0;0;0;0;0;Consola Xbox Series S 512GB;VIDEO JUEGOS
14167358;;F;41;CHILENO;;X;PENALOLEN                     ;METROPOLITANA;0;0;0;0;0;0;0;0;0;CONSOLA PS4 1TB MEGA 6 3 Juegos 3M PS Plus;VIDEO JUEGOS
16210292;Casado;M;36;CHILENO;CINEASTA;Millenial;PROVIDENCIA                   ;METROPOLITANA;0;0;0;0;0;0;0;0;0;CONTROL Inalambrico Camo;VIDEO JUEGOS
12258364;Divorciado;F;50;CHILENO;;X;N/D;N/D;0;0;0;0;0;0;0;0;0;ACC JOY CON L R NEON PURPLE NEON ORANGE;VIDEO JUEGOS
17627225;;M;31;CHILENO;;Millenial;"";"";0;0;0;0;0;0;0;0;0;DUALSHOCK 4 (CUH-ZCT2U) - MAGMA RED - LATAM PS4;VIDEO JUEGOS
18143680;;F;30;CHILENO;;Millenial;ANGOL                         ;ARAUCANIA;8990;1;1;1;1;8990;0;0;0;ESTUFA CUARZO KIOTO 800W KTE-011A;CLIMATIZACION
17266316;;F;33;CHILENO;;Millenial;PROVIDENCIA                   ;METROPOLITANA;88980;2;2;0;0;0;2;2;88980;ESTUFA ELEC. FIBRA DE CARBONO NSB120K5 SILVER;CLIMATIZACION
11596211;;M;51;CHILENO;;X;OSORNO                        ;LOS LAGOS;0;0;2;0;0;0;0;2;0;ESTUFA CUARZO KIOTO 800W KTE-011A;CLIMATIZACION
19820967;;M;24;CHILENO;;Z;PROVIDENCIA                   ;METROPOLITANA;24990;1;1;1;1;24990;0;0;0;MINI OLEOELECTRICA KIOTO 500W NEGRO KTE-1081N;CLIMATIZACION
8279242;;F;63;CHILENO;;Boomers;PUENTE ALTO                   ;METROPOLITANA;12980;2;1;0;0;0;2;1;12980;ESTUFA CUARZO KIOTO 800W KTE-011A;CLIMATIZACION
14377227;;F;45;CHILENO;;X;N/D;N/D;964290;10;5;0;0;0;10;5;964290;ESTUFA A GAS CALMA 15 KG HELIUS;CLIMATIZACION
17853593;;M;30;CHILENO;;Millenial;CHILLAN                       ;BIO BIO;9990;1;1;1;1;9990;0;0;0;ESTUFA CUARZO KIOTO 800W KTE-011A;CLIMATIZACION
10274798;;F;60;CHILENO;;Boomers;RENCA                         ;METROPOLITANA;21990;1;1;0;0;0;1;1;21990;TERMOVENTILADOR NICROM VFH500 BL 2000W;CLIMATIZACION
13344810;;M;44;CHILENO;;X;QUINTA DE TILCOCO             ;L.G.B.OÂ´HIGGINS;1157371;19;8;0;0;0;19;8;1157371;CHIMENEA ELECTRICA KIOTO 2000W KTE-1101;CLIMATIZACION
8510238;;M;62;CHILENO;;Boomers;PUENTE ALTO;METROPOLITANA;1382616;13;9;0;0;0;13;9;1382616;CALIENTACAMA KIOTO DIGITAL 1 PLAZA KTC-1005;CLIMATIZACION
13371992;;M;43;CHILENO;;X;SAN JAVIER                    ;MAULE;54980;2;2;0;0;0;2;2;54980;ESTUFA CUARZO KIOTO 800W KTE-011A;CLIMATIZACION
12239714;;M;50;CHILENO;;Millenial;"";"";5592;1;1;0;0;0;1;1;5592;ESTUFA CUARZO KIOTO 800W KTE-011A;CLIMATIZACION
11862410;;F;51;CHILENO;;X;RENCA                         ;METROPOLITANA;0;0;2;0;2;0;0;0;0;ESTUFA CUARZO KIOTO 800W KTE-011A;CLIMATIZACION
8963248;;F;62;CHILENO;;Boomers;LA SERENA                     ;COQUIMBO;37720;4;3;0;0;0;4;3;37720;ESTUFA CUARZO KIOTO 800W KTE-011A;CLIMATIZACION
12470973;;M;49;CHILENO;;X;RENCA                         ;METROPOLITANA;6490;1;1;0;0;0;1;1;6490;ESTUFA CUARZO KIOTO 800W KTE-011A;CLIMATIZACION
9621296;;F;61;CHILENO;;Boomers;PROVIDENCIA                   ;METROPOLITANA;18560;2;1;0;0;0;2;1;18560;ESTUFA CUARZO KIOTO 800W KTE-011A;CLIMATIZACION
13541136;;M;42;CHILENO;;X;LAJA                          ;BIO BIO;27990;1;1;0;0;0;1;1;27990;TERMOVENTILADOR TH-FH30 BLANCO 1000W-2000W;CLIMATIZACION
20088872;;F;23;CHILENO;;Z;PUTAENDO                      ;VALPARAISO;39970;3;2;1;1;26990;2;1;12980;CALIENTACAMA KIOTO DIGITAL 2 PLAZAS KTC-1006;CLIMATIZACION
26082391;;F;30;VENEZOLANO;;Extranjero;PROVIDENCIA                   ;METROPOLITANA;53980;2;1;2;1;53980;0;0;0;CONVECTOR ELECT. UT HMC-2000;CLIMATIZACION
15267675;Soltero;M;40;CHILENO;;X;RENCA                         ;METROPOLITANA;25990;1;1;1;1;25990;0;0;0;CALIENTACAMA KIOTO DIGITAL 2 PLAZAS KTC-1006;CLIMATIZACION
19926490;;F;24;CHILENO;;Z;CODEGUA;O HIGGINS;0;0;2;0;2;0;0;0;0;TERMOVENTILADOR KIOTO BLANCO 2000W KTE-1028B;CLIMATIZACION
13602992;;F;42;CHILENO;;X;N/D;N/D;587010;11;9;9;5;542770;2;4;44240;CALIENTACAMAS ANALOGO BASICO 2 PL;CLIMATIZACION
5514280;Casado;F;73;CHILENO;;Silencioso;RENCA                         ;METROPOLITANA;33980;2;1;0;0;0;2;1;33980;CALIENTACAMA KIOTO ANALOGO 1 PLAZA KTC-1004;CLIMATIZACION
17018655;;F;33;CHILENO;;Millenial;ANTOFAGASTA;ANTOFAGASTA;51960;4;2;4;2;51960;0;0;0;TERMOVENTILADOR KIOTO BLANCO 2000W KTE-1028B;CLIMATIZACION
20276810;;F;22;CHILENO;;Z;N/D;N/D;563940;7;4;0;0;0;7;4;563940;TERMOVENTILADOR KIOTO NEGRO 2000W KTE-1028N;CLIMATIZACION
8759271;Soltero;F;62;CHILENO;SECRETARIA;Boomers;RENCA                         ;METROPOLITANA;49990;1;1;0;0;0;1;1;49990;CHIMENEA ELECTRICA KIOTO 2000W KTE-1101;CLIMATIZACION
6374766;;F;70;CHILENO;;Silencioso;PROVIDENCIA                   ;METROPOLITANA;45980;2;1;2;1;45980;0;0;0;TERMOVENTILADOR TH-FH31 BLANCO 1000W-2000W;CLIMATIZACION
17251208;;M;33;CHILENO;;Millenial;PROVIDENCIA                   ;METROPOLITANA;16980;2;1;2;1;16980;0;0;0;CALIENTACAMA KIOTO ANALOGO 1 PLAZA KTC-1004;CLIMATIZACION
15145701;;M;39;CHILENO;;X;ANTOFAGASTA                   ;ANTOFAGASTA;9990;1;1;0;0;0;1;1;9990;TERMOVENTILADOR KIOTO BLANCO 2000W KTE-1028B;CLIMATIZACION
26979789;Soltero;F;26;VENEZOLANO;;Extranjero;SANTIAGO;METROPOLITANA;11980;2;1;2;1;11980;0;0;0;TERMOVENTILADOR KIOTO BLANCO 2000W KTE-1028B;CLIMATIZACION
13940927;;F;41;CHILENO;;X;SAN JOAQUIN;METROPOLITANA;11980;2;1;2;1;11980;0;0;0;ESTUFA CUARZO KIOTO 800W KTE-011A;CLIMATIZACION
17835577;;F;31;CHILENO;;Millenial;PROVIDENCIA                   ;METROPOLITANA;24980;2;2;1;1;15990;1;1;8990;CALIENTACAMA KIOTO DIGITAL 1 PLAZA KTC-1005;CLIMATIZACION
4888914;;F;78;CHILENO;;Silencioso;PROVIDENCIA                   ;METROPOLITANA;9990;1;1;0;0;0;1;1;9990;TERMOVENTILADOR KIOTO BLANCO 2000W KTE-1028B;CLIMATIZACION
9447189;Casado;M;59;CHILENO;CONTADOR GENERAL;Boomers;RENCA                         ;METROPOLITANA;494970;3;2;2;1;469980;1;1;24990;CALIENTACAMA KIOTO DIGITAL 1 PLAZA KTC-1005;CLIMATIZACION
9231587;;M;57;CHILENO;;Boomers;NATALES                       ;MAGALLANES;159450;7;5;0;0;0;7;5;159450;TERMOVENTILADOR KIOTO BLANCO 2000W KTE-1028B;CLIMATIZACION
7438444;Casado;F;67;CHILENO;TECNICO EN ADMINISTRACION DE EMPRESAS;Boomers;PROVIDENCIA                   ;METROPOLITANA;31980;2;1;0;0;0;2;1;31980;ESTUFA ELECTRICA CUARZO KIOTO 1200W KTE 1033;CLIMATIZACION
9895804;;F;59;CHILENO;;Boomers;PROVIDENCIA                   ;METROPOLITANA;15990;1;1;0;0;0;1;1;15990;ESTUFA ELECTRICA CUARZO KIOTO 1200W KTE 1033;CLIMATIZACION
26444269;Soltero;F;28;VENEZOLANO;;Extranjero;"";"";9990;1;1;0;0;0;1;1;9990;TERMOVENTILADOR KIOTO BLANCO 2000W KTE-1028B;CLIMATIZACION
13210193;;F;45;CHILENO;;Millenial;"";"";32382;2;1;0;0;0;2;1;32382;CALIENTACAMA KIOTO DIGITAL 1 PLAZA KTC-1005;CLIMATIZACION
17066545;;F;34;CHILENO;;Millenial;PROVIDENCIA                   ;METROPOLITANA;15980;2;1;2;1;15980;0;0;0;TERMOVENTILADOR KIOTO BLANCO 2000W KTE-1028B;CLIMATIZACION
7485479;Soltero;M;65;CHILENO;;Boomers;LOS ANDES                     ;VALPARAISO;32982;2;2;0;0;0;2;2;32982;TERMOVENTILADOR KIOTO BLANCO 2000W KTE-1028B;CLIMATIZACION
19297436;;F;26;CHILENO;;Z;PROVIDENCIA                   ;METROPOLITANA;24980;2;1;2;1;24980;0;0;0;ESTUFA ELECTRICA CUARZO KIOTO 1200W KTE 1033;CLIMATIZACION
14312311;;M;46;CHILENO;;X;MELIPILLA                     ;METROPOLITANA;6990;1;1;0;0;0;1;1;6990;ESTUFA CUARZO KIOTO 800W KTE-011A;CLIMATIZACION
18491734;;F;28;CHILENO;;Millenial;OSORNO;LOS LAGOS;99980;2;1;2;1;99980;0;0;0;CHIMENEA ELECTRICA KIOTO 2000W KTE-1101;CLIMATIZACION
6763262;;F;71;CHILENO;;Silencioso;CALAMA                        ;ANTOFAGASTA;292430;6;4;0;0;0;6;4;292430;TERMOVENTILADOR KIOTO BLANCO 2000W KTE-1028B;CLIMATIZACION
26042097;Soltero;M;33;HAITIANO;;Extranjero;PROVIDENCIA                   ;METROPOLITANA;11980;2;1;2;1;11980;0;0;0;TERMOVENTILADOR KIOTO BLANCO 2000W KTE-1028B;CLIMATIZACION
11653736;Soltero;F;51;CHILENO;;X;RENCA                         ;METROPOLITANA;9990;1;1;0;0;0;1;1;9990;TERMOVENTILADOR KIOTO NEGRO 2000W KTE-1028N;CLIMATIZACION
18828526;;M;27;CHILENO;;Millenial;TALCAHUANO;BIO-BIO;237980;2;2;2;2;237980;0;0;0;ESTUFA CUARZO KIOTO 800W KTE-011A;CLIMATIZACION
11934061;;F;50;CHILENO;;X;RENCA                         ;METROPOLITANA;692950;5;4;4;3;681960;1;1;10990;TERMOVENTILADOR KIOTO BLANCO 2000W KTE-1028B;CLIMATIZACION
6889306;;M;68;CHILENO;;Boomers;N/D;N/D;6990;1;1;0;0;0;1;1;6990;ESTUFA CUARZO KIOTO 800W KTE-011A;CLIMATIZACION
26607226;;F;26;EXTRANJERO - NO INFORMA NACIONALIDAD;;Extranjero;PROVIDENCIA                   ;METROPOLITANA;7990;2;1;2;1;7990;0;0;0;TERMOVENTILADOR KIOTO BLANCO 2000W KTE-1028B;CLIMATIZACION
12830312;Casado;F;48;CHILENO;;X;RENCA                         ;METROPOLITANA;7990;1;1;1;1;7990;0;0;0;ESTUFA CUARZO KIOTO 800W KTE-011A;CLIMATIZACION
26590572;;F;47;VENEZOLANO;;Extranjero;PENCO                         ;BIO BIO;29990;1;1;0;0;0;1;1;29990;CALIENTACAMA KIOTO DIGITAL 2 PLAZAS KTC-1006;CLIMATIZACION
16824100;;F;34;CHILENO;;X;NUEVA IMPERIAL                ;ARAUCANIA;820241;12;12;0;0;0;12;12;820241;ESTUFA CUARZO KIOTO 800W KTE-011A;CLIMATIZACION
4573136;;F;82;CHILENO;;Silencioso;CANETE                        ;BIO BIO;207980;2;2;0;0;0;2;2;207980;MINI OLEOELECTRICA KIOTO 500W BLANCO KTE-1081B;CLIMATIZACION
19726666;;F;25;CHILENO;;Z;PROVIDENCIA                   ;METROPOLITANA;60980;2;2;0;0;0;2;2;60980;TERMOVENTILADOR KIOTO BLANCO 2000W KTE-1028B;CLIMATIZACION
15998935;;M;37;CHILENO;;Millenial;CANETE                        ;BIO BIO;45980;2;2;0;0;0;2;2;45980;TERMOVENTILADOR KIOTO BLANCO 2000W KTE-1028B;CLIMATIZACION
12719660;;F;46;CHILENO;;X;RENCA                         ;METROPOLITANA;49990;1;1;0;0;0;1;1;49990;CHIMENEA ELECTRICA KIOTO 2000W KTE-1101;CLIMATIZACION
11550747;;F;52;CHILENO;;X;N/D;N/D;54970;3;3;0;0;0;3;3;54970;ESTUFA CUARZO KIOTO 800W KTE-011A;CLIMATIZACION
8497656;;M;62;CHILENO;;Boomers;QUILLOTA                      ;VALPARAISO;367982;7;4;0;0;0;7;4;367982;ESTUFA CUARZO KIOTO 800W KTE-011A;CLIMATIZACION
15560730;;M;39;CHILENO;;X;N/D;N/D;644960;4;2;0;0;0;4;2;644960;CALEFACTOR CARBONO EEC-6000NW;CLIMATIZACION
9970720;;F;56;CHILENO;;Boomers;RENCA                         ;METROPOLITANA;57940;6;2;6;2;57940;0;0;0;CALIENTACAMA KIOTO ANALOGO 1 PLAZA KTC-1004;CLIMATIZACION
16292488;;F;35;CHILENO;;Millenial;MELIPILLA                     ;METROPOLITANA;177959;4;2;0;0;0;4;2;177959;CHIMENEA ELECTRICA KIOTO 2000W KTE-1101;CLIMATIZACION
13005736;;F;46;CHILENO;;X;LA FLORIDA;METROPOLITANA;49990;1;1;1;1;49990;0;0;0;CHIMENEA ELECTRICA KIOTO 2000W KTE-1101;CLIMATIZACION
17165433;;F;33;CHILENO;;Millenial;SAN PEDRO DE LA PAZ           ;BIO BIO;100980;2;3;0;2;0;2;1;100980;ESTUFA ELECTRICA CUARZO KIOTO 1200W KTE 1033;CLIMATIZACION
18347546;;F;29;CHILENO;;Millenial;N/D;N/D;214980;2;2;0;0;0;2;2;214980;CALIENTACAMA KIOTO ANALOGO 1 PLAZA KTC-1004;CLIMATIZACION
5857978;;M;76;CHILENO;;Silencioso;CONCEPCION                    ;BIO BIO;561240;8;3;0;0;0;8;3;561240;ESTUFA CUARZO KIOTO 800W KTE-011A;CLIMATIZACION
12948688;;F;46;CHILENO;;X;COPIAPO                       ;ATACAMA;113890;3;2;0;0;0;3;2;113890;CHIMENEA ELECTRICA KIOTO 2000W KTE-1101;CLIMATIZACION
18370280;Soltero;F;28;CHILENO;;Millenial;PROVIDENCIA                   ;METROPOLITANA;10990;1;1;0;0;0;1;1;10990;TERMOVENTILADOR KIOTO NEGRO 2000W KTE-1028N;CLIMATIZACION
18174692;;F;30;CHILENO;;Millenial;SAN CLEMENTE                  ;MAULE;115981;3;2;0;0;0;3;2;115981;ESTUFA ELECTRICA CUARZO KIOTO 1200W KTE 1033;CLIMATIZACION
6708831;;F;68;CHILENO;;Boomers;TALAGANTE                     ;METROPOLITANA;42982;3;1;0;0;0;3;1;42982;CALIENTACAMA KIOTO DIGITAL 1 PLAZA KTC-1005;CLIMATIZACION
15568040;;M;35;CHILENO;;Millenial;SAN JAVIER                    ;MAULE;10993;1;1;0;0;0;1;1;10993;MINI OLEOELECTRICA KIOTO 500W NEGRO KTE-1081N;CLIMATIZACION
20288056;;F;23;CHILENO;;Z;PROVIDENCIA                   ;METROPOLITANA;33970;3;2;3;2;33970;0;0;0;TERMOVENTILADOR KIOTO BLANCO 2000W KTE-1028B;CLIMATIZACION
14312638;;F;46;CHILENO;;X;MELIPILLA                     ;METROPOLITANA;375950;5;6;0;2;0;5;4;375950;ESTUFA ELECTRICA CUARZO KIOTO 1200W KTE 1033;CLIMATIZACION
16306663;;F;35;CHILENO;;Millenial;LOS ANDES                     ;VALPARAISO;10990;1;1;1;1;10990;0;0;0;CALIENTACAMA KIOTO ANALOGO 1 PLAZA KTC-1004;CLIMATIZACION
13772134;;F;42;CHILENO;;X;MELIPILLA                     ;METROPOLITANA;39992;1;1;0;0;0;1;1;39992;CHIMENEA ELECTRICA KIOTO 2000W KTE-1101;CLIMATIZACION
15093657;;F;40;CHILENO;;X;PROVIDENCIA                   ;METROPOLITANA;90150;2;1;0;0;0;2;1;90150;CHIMENEA ELECTRICA KIOTO 2000W KTE-1101;CLIMATIZACION
15692168;;F;38;CHILENO;;X;N/D;N/D;9990;1;1;0;0;0;1;1;9990;ESTUFA CUARZO KIOTO 800W KTE-011A;CLIMATIZACION
16748095;;F;34;CHILENO;;Silencioso;PROVIDENCIA                   ;METROPOLITANA;23980;2;1;2;1;23980;0;0;0;CALIENTACAMA KIOTO ANALOGO 1 PLAZA KTC-1004;CLIMATIZACION
17314898;Soltero;M;32;CHILENO;;Silencioso;PROVIDENCIA                   ;METROPOLITANA;14980;2;1;2;1;14980;0;0;0;CALIENTACAMA KIOTO ANALOGO 1 PLAZA KTC-1004;CLIMATIZACION
9773158;;F;56;CHILENO;;Boomers;RENCA                         ;METROPOLITANA;999960;4;3;3;2;799970;1;1;199990;ESTUFA INFRAROJA TH-IR60;CLIMATIZACION
16990296;;F;34;CHILENO;;Millenial;CABILDO                       ;VALPARAISO;150193;7;4;0;0;0;7;4;150193;CHIMENEA ELECTRICA KIOTO 2000W KTE-1101;CLIMATIZACION
11870448;;M;50;CHILENO;;X;VILLARRICA;ARAUCANIA;543940;6;3;2;1;216980;4;2;326960;CALIENTACAMA KIOTO ANALOGO 1 PLAZA KTC-1004;CLIMATIZACION
18469177;Soltero;M;29;CHILENO;;Millenial;PROVIDENCIA                   ;METROPOLITANA;7990;1;1;1;1;7990;0;0;0;ESTUFA CUARZO KIOTO 800W KTE-011A;CLIMATIZACION
17821584;;M;36;CHILENO;;Millenial;"";"";285970;3;2;0;0;0;3;2;285970;ESTUFA A GAS UT GRX-4200 15 KILOS;CLIMATIZACION
8931656;Soltero;F;57;CHILENO;;Boomers;RENCA                         ;METROPOLITANA;15990;1;1;1;1;15990;0;0;0;CALIENTACAMA KIOTO DIGITAL 1 PLAZA KTC-1005;CLIMATIZACION
8723570;;F;63;CHILENO;;Millenial;NATALES                       ;MAGALLANES;177001;5;5;0;0;0;5;5;177001;CALIENTACAMA KIOTO DIGITAL 2 PLAZAS KTC-1006;CLIMATIZACION
17379234;;F;32;CHILENO;;Millenial;LA PINTANA                    ;METROPOLITANA;13980;2;1;0;0;0;2;1;13980;ESTUFA CUARZO KIOTO 800W KTE-011A;CLIMATIZACION
18823199;;F;31;CHILENO;;Millenial;N/D;N/D;62960;4;4;3;3;52970;1;1;9990;ESTUFA CUARZO KIOTO 800W KTE-011A;CLIMATIZACION
17918447;;F;30;CHILENO;;Millenial;TEMUCO                        ;ARAUCANIA;695940;6;4;2;1;254980;4;3;440960;ESTUFA CUARZO KIOTO 800W KTE-011A;CLIMATIZACION
19726843;;M;25;CHILENO;;Z;NOGALES;VALPARAISO;9990;1;1;0;0;0;1;1;9990;TERMOVENTILADOR KIOTO NEGRO 2000W KTE-1028N;CLIMATIZACION
19490591;;F;25;CHILENO;;Z;PROVIDENCIA                   ;METROPOLITANA;0;0;2;1;1;11990;-1;1;-11990;TERMOVENTILADOR KIOTO NEGRO 2000W KTE-1028N;CLIMATIZACION
17664715;;F;31;CHILENO;;Millenial;PROVIDENCIA                   ;METROPOLITANA;7990;1;1;1;1;7990;0;0;0;ESTUFA CUARZO KIOTO 800W KTE-011A;CLIMATIZACION
9724217;;F;58;CHILENO;;Boomers;PROVIDENCIA                   ;METROPOLITANA;9990;1;1;0;0;0;1;1;9990;TERMOVENTILADOR KIOTO BLANCO 2000W KTE-1028B;CLIMATIZACION
26749923;Soltero;M;36;VENEZOLANO;;Extranjero;"";"";143800;19;3;19;3;143800;0;0;0;TERMOVENTILADOR KIOTO BLANCO 2000W KTE-1028B;CLIMATIZACION
5091911;;F;79;CHILENO;;Silencioso;VICTORIA                      ;ARAUCANIA;86980;2;2;0;0;0;2;2;86980;CALIENTACAMA KIOTO ANALOGO 1 PLAZA KTC-1004;CLIMATIZACION
13948374;;M;41;CHILENO;;X;SAN VICENTE                   ;L.G.B.OÂ´HIGGINS;29990;1;1;0;0;0;1;1;29990;CALIENTACAMA KIOTO DIGITAL 2 PLAZAS KTC-1006;CLIMATIZACION
19145683;Soltero;F;26;CHILENO;;Z;PROVIDENCIA                   ;METROPOLITANA;352970;3;3;3;3;352970;0;0;0;CALIENTACAMA KIOTO DIGITAL 1 PLAZA KTC-1005;CLIMATIZACION
16253059;;F;36;CHILENO;;Millenial;RENCA                         ;METROPOLITANA;25990;1;1;1;1;25990;0;0;0;CALIENTACAMA KIOTO DIGITAL 2 PLAZAS KTC-1006;CLIMATIZACION
8033345;;M;63;CHILENO;;Boomers;LA SERENA                     ;COQUIMBO;361970;3;3;0;0;0;3;3;361970;ESTUFA GAS EH2500 5K NEGRO;CLIMATIZACION
13560643;;F;43;CHILENO;;X;PAINE                         ;METROPOLITANA;41960;4;3;0;0;0;4;3;41960;ESTUFA CUARZO KIOTO 800W KTE-011A;CLIMATIZACION
20033944;;F;23;CHILENO;;Z;COLINA;METROPOLITANA;115840;8;4;0;0;0;8;4;115840;CHIMENEA ELECTRICA KIOTO 2000W KTE-1101;CLIMATIZACION
15635448;;M;38;CHILENO;;Millenial;PROVIDENCIA                   ;METROPOLITANA;7990;1;1;1;1;7990;0;0;0;ESTUFA CUARZO KIOTO 800W KTE-011A;CLIMATIZACION
11767650;Divorciado;M;51;CHILENO;;X;RENCA                         ;METROPOLITANA;33802;6;3;0;0;0;6;3;33802;ESTUFA CUARZO KIOTO 800W KTE-011A;CLIMATIZACION
9266589;;F;53;CHILENO;;X;"";"";652540;5;4;0;0;0;5;4;652540;TERMOVENTILADOR KIOTO NEGRO 2000W KTE-1028N;CLIMATIZACION
19972101;;F;23;CHILENO;;Z;LOS ANGELES;BIO-BIO;546930;7;6;7;6;546930;0;0;0;CALIENTACAMA KIOTO DIGITAL 2 PLAZAS KTC-1006;CLIMATIZACION
8555258;;M;63;CHILENO;;Boomers;PROVIDENCIA                   ;METROPOLITANA;29990;1;1;0;0;0;1;1;29990;CALIENTACAMA KIOTO DIGITAL 2 PLAZAS KTC-1006;CLIMATIZACION
10257167;;F;57;CHILENO;;Boomers;PROVIDENCIA                   ;METROPOLITANA;15980;2;1;2;1;15980;0;0;0;TERMOVENTILADOR KIOTO BLANCO 2000W KTE-1028B;CLIMATIZACION
7569691;;F;62;CHILENO;;Boomers;ANTOFAGASTA                   ;ANTOFAGASTA;149990;1;3;0;0;0;1;3;149990;VITTALE 8;CLIMATIZACION
19056638;;F;27;CHILENO;;Z;PROVIDENCIA                   ;METROPOLITANA;109980;2;2;0;0;0;2;2;109980;CHIMENEA ELECTRICA KIOTO 2000W KTE-1101;CLIMATIZACION
11424050;Casado;F;53;CHILENO;;X;PROVIDENCIA                   ;METROPOLITANA;56980;2;2;0;0;0;2;2;56980;CALIENTACAMA KIOTO DIGITAL 2 PLAZAS KTC-1006;CLIMATIZACION
14467431;;M;46;CHILENO;;X;PROVIDENCIA                   ;METROPOLITANA;11990;1;1;0;0;0;1;1;11990;CALIENTACAMA KIOTO ANALOGO 1 PLAZA KTC-1004;CLIMATIZACION
18193261;;F;29;CHILENO;;Silencioso;PROVIDENCIA                   ;METROPOLITANA;11980;2;1;2;1;11980;0;0;0;TERMOVENTILADOR KIOTO BLANCO 2000W KTE-1028B;CLIMATIZACION
18834013;;F;27;CHILENO;;Millenial;"";"";244970;4;3;0;0;0;4;3;244970;ESTUFA CUARZO KIOTO 800W KTE-011A;CLIMATIZACION
16451702;;F;36;CHILENO;;Millenial;PUENTE ALTO;METROPOLITANA;17990;1;1;1;1;17990;0;0;0;ESTUFA ELECTRICA CUARZO KIOTO 1200W KTE 1033;CLIMATIZACION
17386641;;F;33;CHILENO;;Millenial;QUEMCHI                       ;LOS LAGOS;33000;2;1;0;0;0;2;1;33000;CALIENTACAMA KIOTO DIGITAL 2 PLAZAS KTC-1006;CLIMATIZACION
14178521;;F;41;CHILENO;;X;CHILLAN                       ;BIO BIO;247430;5;4;0;0;0;5;4;247430;CALIENTACAMA KIOTO ANALOGO 1 PLAZA KTC-1004;CLIMATIZACION
17270669;;F;32;CHILENO;;Millenial;PROVIDENCIA                   ;METROPOLITANA;0;0;2;0;2;0;0;0;0;CALIENTACAMAS ANALOGO BASICO 2 PL;CLIMATIZACION
17455056;;M;32;CHILENO;;Millenial;SAN ANTONIO;VALPARAISO;9240;2;1;0;0;0;2;1;9240;TERMOVENTILADOR KIOTO NEGRO 2000W KTE-1028N;CLIMATIZACION
17018246;;M;33;CHILENO;;Millenial;ANTOFAGASTA                   ;ANTOFAGASTA;19990;1;1;0;0;0;1;1;19990;ESTUFA ELECTRICA CUARZO KIOTO 1200W KTE 1033;CLIMATIZACION
18929868;;F;27;CHILENO;;Extranjero;VILLARICA                     ;ARAUCANIA;49980;2;2;0;0;0;2;2;49980;TERMOVENTILADOR KIOTO NEGRO 2000W KTE-1028N;CLIMATIZACION
14225318;;M;41;CHILENO;;X;N/D;N/D;18230;3;1;0;0;0;3;1;18230;TERMOVENTILADOR KIOTO BLANCO 2000W KTE-1028B;CLIMATIZACION
8572106;;F;66;CHILENO;;Boomers;COPIAPO                       ;ATACAMA;125000;2;1;0;0;0;2;1;125000;ESTUFA GAS KG5 5K NEGRO EUROPEA;CLIMATIZACION
13447066;;F;43;CHILENO;;X;RENCA                         ;METROPOLITANA;8990;1;1;0;0;0;1;1;8990;TERMOVENTILADOR KIOTO BLANCO 2000W KTE-1028B;CLIMATIZACION
8042329;;M;60;CHILENO;;Boomers;N/D;N/D;82620;5;2;0;0;0;5;2;82620;TERMOVENTILADOR KIOTO BLANCO 2000W KTE-1028B;CLIMATIZACION
18847621;Soltero;F;28;CHILENO;TECNICO DE NIVEL SUPERIOR EN ENFERMERIA;Millenial;CERRO NAVIA                   ;METROPOLITANA;11980;2;1;2;1;11980;0;0;0;TERMOVENTILADOR KIOTO BLANCO 2000W KTE-1028B;CLIMATIZACION
14002672;;M;41;CHILENO;;X;SAN ANTONIO                   ;VALPARAISO;111880;4;2;0;0;0;4;2;111880;CHIMENEA ELECTRICA KIOTO 2000W KTE-1101;CLIMATIZACION
8954015;Casado;M;61;CHILENO;;Boomers;RENCA                         ;METROPOLITANA;11990;1;1;0;0;0;1;1;11990;CALIENTACAMA KIOTO ANALOGO 1 PLAZA KTC-1004;CLIMATIZACION
11701885;;F;50;CHILENO;;X;RENAICO                       ;ARAUCANIA;8990;1;1;0;0;0;1;1;8990;TERMOVENTILADOR KIOTO BLANCO 2000W KTE-1028B;CLIMATIZACION
6354350;;F;78;CHILENO;;Silencioso;RANCAGUA                      ;L.G.B.OÂ´HIGGINS;216520;6;4;0;0;0;6;4;216520;CALEFACTOR CUARZO VERTICAL 800 W HQ 80 AIROLITE;CLIMATIZACION
26091982;;M;33;VENEZOLANO;;Extranjero;PROVIDENCIA                   ;METROPOLITANA;131850;15;3;15;3;131850;0;0;0;ESTUFA ELECTRICA CUARZO KIOTO 1200W KTE 1033;CLIMATIZACION
8817277;Soltero;F;59;CHILENO;;Boomers;PICHILEMU                     ;L.G.B.OÂ´HIGGINS;24990;1;1;0;0;0;1;1;24990;TERMOVENTILADOR TH-FH30 BLANCO 1000W-2000W;CLIMATIZACION
15845340;;M;37;CHILENO;;Millenial;PROVIDENCIA                   ;METROPOLITANA;11980;2;1;2;1;11980;0;0;0;TERMOVENTILADOR KIOTO BLANCO 2000W KTE-1028B;CLIMATIZACION
18904608;;F;28;CHILENO;;Millenial;RENCA;METROPOLITANA;641950;5;3;4;2;613960;1;1;27990;CALIENTACAMA KIOTO DIGITAL 2 PLAZAS KTC-1006;CLIMATIZACION
25614980;;F;33;VENEZOLANO;;Extranjero;SANTIAGO                      ;METROPOLITANA;8990;1;1;1;1;8990;0;0;0;ESTUFA CUARZO KIOTO 800W KTE-011A;CLIMATIZACION
18962731;;F;28;CHILENO;;Millenial;N/D;N/D;101960;4;2;4;2;101960;0;0;0;CALIENTACAMA KIOTO ANALOGO 1 PLAZA KTC-1004;CLIMATIZACION
18388629;;F;28;CHILENO;;Millenial;TALCAHUANO;BIO-BIO;12593;1;1;1;1;12593;0;0;0;ESTUFA ELECTRICA CUARZO KIOTO 1200W KTE 1033;CLIMATIZACION
10189579;;M;57;CHILENO;;Boomers;ISLA DE MAIPO                 ;METROPOLITANA;217960;4;3;0;0;0;4;3;217960;ESTUFA CUARZO KIOTO 800W KTE-011A;CLIMATIZACION
20280865;;F;22;CHILENO;;Z;"";"";8990;1;1;0;0;0;1;1;8990;TERMOVENTILADOR KIOTO NEGRO 2000W KTE-1028N;CLIMATIZACION
14503125;;F;48;CHILENO;;X;OSORNO                        ;LOS LAGOS;8990;1;1;0;0;0;1;1;8990;ESTUFA CUARZO KIOTO 800W KTE-011A;CLIMATIZACION
19236063;Casado;F;26;CHILENO;TECNICO DE NIVEL MEDIO EN ALIMENTACION;Silencioso;PROVIDENCIA                   ;METROPOLITANA;11980;2;1;2;1;11980;0;0;0;TERMOVENTILADOR KIOTO BLANCO 2000W KTE-1028B;CLIMATIZACION
16076446;;M;36;CHILENO;;Millenial;PROVIDENCIA                   ;METROPOLITANA;15980;2;1;2;1;15980;0;0;0;TERMOVENTILADOR KIOTO BLANCO 2000W KTE-1028B;CLIMATIZACION
15118632;;M;39;CHILENO;;X;PROVIDENCIA                   ;METROPOLITANA;8990;1;1;0;0;0;1;1;8990;TERMOVENTILADOR KIOTO NEGRO 2000W KTE-1028N;CLIMATIZACION
26405186;;M;39;VENEZOLANO;;Extranjero;LA SERENA                     ;COQUIMBO;59990;1;1;0;0;0;1;1;59990;ESTUFA ELECTRICA CUARZO KC 220 ROJA;CLIMATIZACION
18552686;;M;29;CHILENO;;Millenial;QUILPUE                       ;VALPARAISO;155970;3;2;0;0;0;3;2;155970;CALIENTACAMA KIOTO DIGITAL 2 PLAZAS KTC-1006;CLIMATIZACION
26495787;;M;39;HAITIANO;;Extranjero;VALDIVIA                      ;LOS RIOS;119990;1;1;0;0;0;1;1;119990;ESTUFA FIAMMA PRO;CLIMATIZACION
17026165;Soltero;F;33;CHILENO;PSICOLOGA;Millenial;PROVIDENCIA                   ;METROPOLITANA;19970;3;1;3;1;19970;0;0;0;TERMOVENTILADOR KIOTO BLANCO 2000W KTE-1028B;CLIMATIZACION
10790331;;M;55;CHILENO;;Boomers;PUENTE ALTO                   ;METROPOLITANA;234980;2;2;0;0;0;2;2;234980;CHIMENEA ELECTRICA KIOTO 2000W KTE-1101;CLIMATIZACION
6860436;;M;68;CHILENO;;Boomers;LA PINTANA                    ;METROPOLITANA;18370;2;1;0;0;0;2;1;18370;ESTUFA CUARZO KIOTO 800W KTE-011A;CLIMATIZACION
11521530;;M;51;CHILENO;;X;VINA DEL MAR                  ;VALPARAISO;59990;1;1;0;0;0;1;1;59990;CALIENTACAMAS ANALOGO BASICO 2 PL;CLIMATIZACION
18872394;;F;28;CHILENO;;Millenial;TEMUCO                        ;ARAUCANIA;39970;3;4;3;4;39970;0;0;0;CALIENTACAMA KIOTO ANALOGO 1 PLAZA KTC-1004;CLIMATIZACION
23762965;;F;50;PERUANO;;Extranjero;N/D;N/D;275068;5;2;0;0;0;5;2;275068;CHIMENEA ELECTRICA KIOTO 2000W KTE-1101;CLIMATIZACION
16256242;;F;35;CHILENO;;Millenial;"";"";42980;2;2;0;0;0;2;2;42980;CALIENTACAMA KIOTO DIGITAL 2 PLAZAS KTC-1006;CLIMATIZACION
20229171;;F;23;CHILENO;;Z;PROVIDENCIA                   ;METROPOLITANA;163470;3;2;3;2;163470;0;0;0;CALIENTACAMA KIOTO DIGITAL 2 PLAZAS KTC-1006;CLIMATIZACION
15552656;;M;36;CHILENO;;Millenial;LONCOCHE                      ;ARAUCANIA;118970;3;2;0;0;0;3;2;118970;TERMOVENTILADOR KIOTO NEGRO 2000W KTE-1028N;CLIMATIZACION
9853380;Viudo;F;67;CHILENO;;Boomers;RENCA                         ;METROPOLITANA;27990;1;1;0;0;0;1;1;27990;CALIENTACAMA KIOTO DIGITAL 2 PLAZAS KTC-1006;CLIMATIZACION
17707386;;F;31;CHILENO;;Millenial;RENCA                         ;METROPOLITANA;32920;4;1;0;0;0;4;1;32920;TERMOVENTILADOR KIOTO NEGRO 2000W KTE-1028N;CLIMATIZACION
20240399;;M;23;CHILENO;;Z;ESTACION CENTRAL;METROPOLITANA;61980;4;2;2;1;31980;2;1;30000;CALIENTACAMA KIOTO DIGITAL 2 PLAZAS KTC-1006;CLIMATIZACION
16475986;;F;35;CHILENO;;Millenial;LIMACHE;VALPARAISO;59990;1;1;0;0;0;1;1;59990;CHIMENEA ELECTRICA KIOTO 2000W KTE-1101;CLIMATIZACION
14368582;;F;48;CHILENO;;X;CHILLAN                       ;BIO BIO;35980;2;1;0;0;0;2;1;35980;ESTUFA ELECTRICA CUARZO KIOTO 1200W KTE 1033;CLIMATIZACION
25281619;;F;37;HAITIANO;;Extranjero;PUENTE ALTO                   ;METROPOLITANA;46350;4;2;0;0;0;4;2;46350;TERMOVENTILADOR KIOTO BLANCO 2000W KTE-1028B;CLIMATIZACION
9470552;;F;59;CHILENO;;Boomers;COIHAIQUE                     ;AYSEN;953950;5;3;2;1;418980;3;2;534970;ESTUFA PARAFINA KPL-36;CLIMATIZACION
8689591;Soltero;M;63;CHILENO;;Boomers;SAN FELIPE                    ;VALPARAISO;14990;1;1;0;0;0;1;1;14990;CALIENTACAMA KIOTO ANALOGO 1 PLAZA KTC-1004;CLIMATIZACION
19331440;;F;26;CHILENO;;Z;CONCEPCION;BIO-BIO;99910;3;1;0;0;0;3;1;99910;ESTUFA INFRARROJA ELECTRICA KIOTO 1500W KTE-1045;CLIMATIZACION
25787993;Soltero;M;31;NO INFORMA NACIONALIDAD;;Extranjero;PROVIDENCIA                   ;METROPOLITANA;7990;1;1;1;1;7990;0;0;0;TERMOVENTILADOR KIOTO BLANCO 2000W KTE-1028B;CLIMATIZACION
6777749;;M;64;CHILENO;;Boomers;COIHAIQUE                     ;AYSEN;132960;4;1;0;0;0;4;1;132960;CALIENTACAMAS DIGITAL TIMER SG-5351 2PL;CLIMATIZACION
18133100;;F;30;CHILENO;;Millenial;TEMUCO;ARAUCANIA;203960;4;2;2;1;166980;2;1;36980;ESTUFA ELECTRICA CUARZO KIOTO 1200W KTE 1033;CLIMATIZACION
18967475;;F;28;CHILENO;;Millenial;PROVIDENCIA                   ;METROPOLITANA;23970;3;2;0;0;0;3;2;23970;TERMOVENTILADOR KIOTO NEGRO 2000W KTE-1028N;CLIMATIZACION
9902699;;F;54;CHILENO;;X;RENCA                         ;METROPOLITANA;9990;1;1;1;1;9990;0;0;0;TERMOVENTILADOR KIOTO BLANCO 2000W KTE-1028B;CLIMATIZACION
18876073;;F;27;CHILENO;;Z;CONTULMO                      ;BIO BIO;72980;2;2;0;0;0;2;2;72980;CALIENTACAMA KIOTO ANALOGO 1 PLAZA KTC-1004;CLIMATIZACION
19038656;;F;26;CHILENO;;Z;PUDAHUEL;METROPOLITANA;8990;1;1;0;0;0;1;1;8990;TERMOVENTILADOR KIOTO NEGRO 2000W KTE-1028N;CLIMATIZACION
11214702;;F;54;CHILENO;;Boomers;PROVIDENCIA                   ;METROPOLITANA;19990;1;1;0;0;0;1;1;19990;ESTUFA ELECTRICA CUARZO KIOTO 1200W KTE 1033;CLIMATIZACION
13625729;;M;45;CHILENO;;X;PROVIDENCIA                   ;METROPOLITANA;45980;2;1;0;0;0;2;1;45980;CALIENTACAMA KIOTO DIGITAL 2 PLAZAS KTC-1006;CLIMATIZACION
10109642;;F;51;CHILENO;;X;OVALLE                        ;COQUIMBO;1856470;14;9;0;0;0;14;9;1856470;ESTUFA ELECTRICA CUARZO KIOTO 1200W KTE 1033;CLIMATIZACION
14144674;Casado;M;41;CHILENO;AGRONOMO;X;SAN VICENTE                   ;L.G.B.OÂ´HIGGINS;9990;1;1;0;0;0;1;1;9990;TERMOVENTILADOR KIOTO BLANCO 2000W KTE-1028B;CLIMATIZACION
17643049;;M;37;CHILENO;;Extranjero;PROVIDENCIA                   ;METROPOLITANA;544651;9;4;0;0;0;9;4;544651;ESTUFA ELECTRICA CUARZO KIOTO 1200W KTE 1033;CLIMATIZACION
14013287;;F;41;CHILENO;;X;PEUMO                         ;L.G.B.OÂ´HIGGINS;1008940;6;4;0;0;0;6;4;1008940;TERMOVENTILADOR KIOTO BLANCO 2000W KTE-1028B;CLIMATIZACION
15492373;;F;39;CHILENO;;X;PROVIDENCIA                   ;METROPOLITANA;17990;1;1;1;1;17990;0;0;0;ESTUFA ELECTRICA CUARZO KIOTO 1200W KTE 1033;CLIMATIZACION
18619131;;M;26;CHILENO;;Z;VILLA ALEMANA                 ;VALPARAISO;27990;1;1;1;1;27990;0;0;0;CALIENTACAMA KIOTO DIGITAL 2 PLAZAS KTC-1006;CLIMATIZACION
11658194;;M;52;CHILENO;;X;EL BOSQUE                     ;METROPOLITANA;74990;1;1;0;0;0;1;1;74990;TERMOVENTILADOR CERAMICO DIGITAL 2000 W HTC-2022;CLIMATIZACION
12675506;;F;50;CHILENO;;X;LA PINTANA                    ;METROPOLITANA;1039020;7;3;7;3;1039020;0;0;0;CHIMENEA ELECTRICA KIOTO 2000W KTE-1101;CLIMATIZACION
9578559;;F;61;CHILENO;;Boomers;"";"";0;0;2;0;2;0;0;0;0;ESTUFA ELEC. FIBRA DE CARBONO NSB120K5 ROJA;CLIMATIZACION
8084548;;F;63;CHILENO;;Boomers;N/D;N/D;22460;2;1;0;0;0;2;1;22460;CALIENTACAMA KIOTO ANALOGO 1 PLAZA KTC-1004;CLIMATIZACION
9535048;;M;58;CHILENO;;Boomers;PUENTE ALTO                   ;METROPOLITANA;346390;11;4;0;0;0;11;4;346390;TERMOVENTILADOR KIOTO BLANCO 2000W KTE-1028B;CLIMATIZACION
19411449;Soltero;F;26;CHILENO;;Z;PROVIDENCIA                   ;METROPOLITANA;146940;6;2;6;2;146940;0;0;0;TERMOVENTILADOR KIOTO BLANCO 2000W KTE-1028B;CLIMATIZACION
9169768;;F;61;CHILENO;;Boomers;ARICA                         ;TARAPACA;28460;2;1;0;0;0;2;1;28460;ESTUFA ELECTRICA CUARZO KIOTO 1200W KTE 1033;CLIMATIZACION
9967971;;F;58;CHILENO;;Boomers;PROVIDENCIA                   ;METROPOLITANA;7990;1;1;1;1;7990;0;0;0;TERMOVENTILADOR KIOTO BLANCO 2000W KTE-1028B;CLIMATIZACION
9776492;;F;59;CHILENO;;Boomers;LINARES                       ;MAULE;319980;3;2;0;0;0;3;2;319980;ESTUFA A GAS UT GRX-6200 ET ROJA 15 KILOS;CLIMATIZACION
11580584;Casado;M;51;CHILENO;AGROINDUSTRIA;X;RENCA                         ;METROPOLITANA;30460;2;1;0;0;0;2;1;30460;ESTUFA ELECTRICA CUARZO KIOTO 1200W KTE 1033;CLIMATIZACION
4964916;;F;76;CHILENO;;Silencioso;CHILLAN                       ;BIO BIO;399990;1;1;0;0;0;1;1;399990;ESTUFA PARAFINA KPL-36;CLIMATIZACION
19963596;;F;23;CHILENO;;Z;PROVIDENCIA                   ;METROPOLITANA;8990;1;1;0;0;0;1;1;8990;ESTUFA CUARZO KIOTO 800W KTE-011A;CLIMATIZACION
11328006;;F;53;CHILENO;;X;RENCA                         ;METROPOLITANA;26970;3;1;3;1;26970;0;0;0;TERMOVENTILADOR KIOTO BLANCO 2000W KTE-1028B;CLIMATIZACION
6092567;Soltero;F;72;CHILENO;;Silencioso;PROVIDENCIA                   ;METROPOLITANA;104890;3;1;0;0;0;3;1;104890;CHIMENEA ELECTRICA KIOTO 2000W KTE-1101;CLIMATIZACION
15616412;;M;38;CHILENO;;Millenial;RENCA                         ;METROPOLITANA;35960;4;1;4;1;35960;0;0;0;ESTUFA CUARZO KIOTO 800W KTE-011A;CLIMATIZACION
18400417;Soltero;M;29;CHILENO;INGENIERO METALURGICO;Millenial;CALAMA;ANTOFAGASTA;15990;1;3;1;1;15990;0;2;0;ESTUFA ELECTRICA CUARZO KIOTO 1200W KTE 1033;CLIMATIZACION
18084376;;F;30;CHILENO;;Millenial;PROVIDENCIA                   ;METROPOLITANA;8990;1;1;1;1;8990;0;0;0;TERMOVENTILADOR KIOTO NEGRO 2000W KTE-1028N;CLIMATIZACION
19975868;;M;24;CHILENO;;Silencioso;PROVIDENCIA                   ;METROPOLITANA;13980;2;1;2;1;13980;0;0;0;ESTUFA ELECTRICA CUARZO KIOTO 1200W KTE 1033;CLIMATIZACION
18743367;Soltero;M;56;CHILENO;;Boomers;RENCA                         ;METROPOLITANA;29990;1;1;1;1;29990;0;0;0;CALIENTACAMA KIOTO DIGITAL 2 PLAZAS KTC-1006;CLIMATIZACION
12133476;;F;46;CHILENO;;X;SAN JAVIER                    ;MAULE;88980;2;1;2;1;88980;0;0;0;ESTUFA GAS EH2500 5K NEGRO;CLIMATIZACION
25596754;Soltero;M;34;VENEZOLANO;QUIMICO FARMACEUTICO;Extranjero;PROVIDENCIA                   ;METROPOLITANA;23970;3;1;3;1;23970;0;0;0;ESTUFA ELECTRICA CUARZO KIOTO 1200W KTE 1033;CLIMATIZACION
9783180;;F;58;CHILENO;;Boomers;RENCA                         ;METROPOLITANA;28460;2;1;0;0;0;2;1;28460;ESTUFA ELECTRICA CUARZO KIOTO 1200W KTE 1033;CLIMATIZACION
18050750;;F;30;CHILENO;;Millenial;PROVIDENCIA                   ;METROPOLITANA;8990;1;1;1;1;8990;0;0;0;ESTUFA CUARZO KIOTO 800W KTE-011A;CLIMATIZACION
6244619;;M;69;CHILENO;;Silencioso;SAN FERNANDO                  ;L.G.B.OÂ´HIGGINS;32970;3;2;0;0;0;3;2;32970;TERMOVENTILADOR KIOTO BLANCO 2000W KTE-1028B;CLIMATIZACION
26145945;;F;35;VENEZOLANO;;Extranjero;PROVIDENCIA                   ;METROPOLITANA;11980;2;1;2;1;11980;0;0;0;TERMOVENTILADOR KIOTO NEGRO 2000W KTE-1028N;CLIMATIZACION
14449064;;F;48;CHILENO;;X;ISLA DE MAIPO                 ;METROPOLITANA;173970;3;2;2;1;160980;1;1;12990;CALIENTACAMA KIOTO ANALOGO 1 PLAZA KTC-1004;CLIMATIZACION
15729426;;F;38;CHILENO;;X;HIJUELAS                      ;VALPARAISO;132980;2;2;2;2;132980;0;0;0;CALIENTACAMA KIOTO ANALOGO 1 PLAZA KTC-1004;CLIMATIZACION
15226349;Soltero;M;38;CHILENO;;X;LITUECHE                      ;L.G.B.OÂ´HIGGINS;259980;2;1;0;0;0;2;1;259980;Estufa a gas Kaly 11;CLIMATIZACION
9435992;Casado;F;58;CHILENO;;Boomers;PROVIDENCIA                   ;METROPOLITANA;17980;2;1;0;0;0;2;1;17980;TERMOVENTILADOR KIOTO BLANCO 2000W KTE-1028B;CLIMATIZACION
18288592;;F;29;CHILENO;;Millenial;N/D;N/D;113970;3;2;2;1;58980;1;1;54990;CHIMENEA ELECTRICA KIOTO 2000W KTE-1101;CLIMATIZACION
12472926;;M;49;CHILENO;;X;PUENTE ALTO                   ;METROPOLITANA;25980;2;1;2;1;25980;0;0;0;CALIENTACAMA KIOTO ANALOGO 1 PLAZA KTC-1004;CLIMATIZACION
11414331;;F;52;CHILENO;;X;CHONCHI                       ;LOS LAGOS;12990;1;1;0;0;0;1;1;12990;CALIENTACAMA KIOTO ANALOGO 1 PLAZA KTC-1004;CLIMATIZACION
18369777;;F;28;CHILENO;;Millenial;CURANILAHUE                   ;BIO BIO;9990;1;1;0;0;0;1;1;9990;TERMOVENTILADOR KIOTO BLANCO 2000W KTE-1028B;CLIMATIZACION
18979393;;F;27;CHILENO;;Millenial;"";"";46980;2;1;2;1;46980;0;0;0;ESTUFA FIBRA DE CARBONO KFB 90;CLIMATIZACION
10563223;;M;54;CHILENO;;Boomers;RENCA                         ;METROPOLITANA;54990;1;1;1;1;54990;0;0;0;CHIMENEA ELECTRICA KIOTO 2000W KTE-1101;CLIMATIZACION
10487317;;F;56;CHILENO;;Boomers;CONCHALI                      ;METROPOLITANA;398970;3;2;0;0;0;3;2;398970;TERMOVENTILADOR KIOTO BLANCO 2000W KTE-1028B;CLIMATIZACION
12502139;;F;49;CHILENO;;X;SAN BERNARDO;METROPOLITANA;47980;2;2;0;0;0;2;2;47980;CALIENTACAMA KIOTO DIGITAL 2 PLAZAS KTC-1006;CLIMATIZACION
11251890;;M;55;CHILENO;;Boomers;NATALES                       ;MAGALLANES;169980;2;2;0;0;0;2;2;169980;ESTUFA ELECTRICA CUARZO KIOTO 1200W KTE 1033;CLIMATIZACION
10139112;;F;56;CHILENO;;Boomers;DONIHUE                       ;L.G.B.OÂ´HIGGINS;169970;3;2;0;0;0;3;2;169970;CALIENTACAMAS ANALOGO BASICO 1PL;CLIMATIZACION
8982254;;F;59;CHILENO;;Boomers;RENCA                         ;METROPOLITANA;19980;2;1;0;0;0;2;1;19980;TERMOVENTILADOR KIOTO BLANCO 2000W KTE-1028B;CLIMATIZACION
19143296;;F;26;CHILENO;;Z;SAN ANTONIO                   ;VALPARAISO;484140;8;2;0;0;0;8;2;484140;CALEFACTOR CARBONO EEC-6000NW;CLIMATIZACION
16679308;;F;35;CHILENO;;Millenial;CONSTITUCION                  ;MAULE;27990;1;1;0;0;0;1;1;27990;CALIENTACAMA KIOTO DIGITAL 2 PLAZAS KTC-1006;CLIMATIZACION
14303851;;M;47;CHILENO;;X;N/D;N/D;76960;4;6;0;0;0;4;6;76960;TERMOVENTILADOR CALMA PTC DIGITAL T3000;CLIMATIZACION
11177639;;F;54;CHILENO;;Boomers;RENCA                         ;METROPOLITANA;18220;2;1;0;0;0;2;1;18220;TERMOVENTILADOR KIOTO BLANCO 2000W KTE-1028B;CLIMATIZACION
17696124;;F;31;CHILENO;;Millenial;SAN NICOLAS                   ;BIO BIO;357960;5;2;2;1;121980;3;1;235980;ESTUFA ELEC. CHIMENEA TH-FP70 NG 1000W-2000W;CLIMATIZACION
18761679;;F;27;CHILENO;;Z;VINA DEL MAR                  ;VALPARAISO;12990;1;1;1;1;12990;0;0;0;CALIENTACAMA KIOTO ANALOGO 1 PLAZA KTC-1004;CLIMATIZACION
7499458;;F;71;CHILENO;;Silencioso;PUENTE ALTO                   ;METROPOLITANA;252250;4;2;0;0;0;4;2;252250;ESTUFA FIAMMA PRO;CLIMATIZACION
14308841;;F;46;CHILENO;;X;PROVIDENCIA                   ;METROPOLITANA;9990;1;1;0;0;0;1;1;9990;TERMOVENTILADOR KIOTO NEGRO 2000W KTE-1028N;CLIMATIZACION
27370851;;M;40;NO INFORMA NACIONALIDAD;;Extranjero;PROVIDENCIA                   ;METROPOLITANA;19980;2;2;1;1;9990;1;1;9990;ESTUFA ELECTRICA CUARZO KIOTO 1200W KTE 1033;CLIMATIZACION
6489220;;F;70;CHILENO;;Silencioso;PUENTE ALTO                   ;METROPOLITANA;473930;7;3;0;0;0;7;3;473930;ESTUFA FOGUITA PRO;CLIMATIZACION
10387061;;F;53;CHILENO;;X;CORONEL;BIO-BIO;168980;2;1;2;1;168980;0;0;0;ESTUFA VITTALE-40 15K;CLIMATIZACION
8945562;Soltero;M;62;CHILENO;;Boomers;RENCA                         ;METROPOLITANA;389770;2;1;0;0;0;2;1;389770;CALEFACTOR LENA ECO350 CHARCOAL;CLIMATIZACION
16198069;;F;36;CHILENO;;Millenial;N/D;N/D;165960;4;2;4;2;165960;0;0;0;ESTUFA INFRAROJA TH-IR60;CLIMATIZACION
18577300;;M;28;CHILENO;;Millenial;SAN FERNANDO                  ;L.G.B.OÂ´HIGGINS;27990;1;1;1;1;27990;0;0;0;CALIENTACAMA KIOTO DIGITAL 2 PLAZAS KTC-1006;CLIMATIZACION
13391458;;F;44;CHILENO;;X;RANCAGUA                      ;L.G.B.OÂ´HIGGINS;719960;4;3;0;0;0;4;3;719960;CALIENTACAMA KIOTO ANALOGO 1 PLAZA KTC-1004;CLIMATIZACION
15743322;;F;38;CHILENO;;X;RENCA                         ;METROPOLITANA;16980;2;1;2;1;16980;0;0;0;TERMOVENTILADOR KIOTO NEGRO 2000W KTE-1028N;CLIMATIZACION
9221157;;F;52;CHILENO;;X;PROVIDENCIA                   ;METROPOLITANA;145960;4;1;0;0;0;4;1;145960;CHIMENEA ELECTRICA KIOTO 2000W KTE-1101;CLIMATIZACION
7022454;;F;67;CHILENO;;Boomers;TOCOPILLA                     ;ANTOFAGASTA;25491;1;1;0;0;0;1;1;25491;CALIENTACAMA KIOTO DIGITAL 2 PLAZAS KTC-1006;CLIMATIZACION
15866813;;M;37;CHILENO;;Millenial;MELIPILLA                     ;METROPOLITANA;42980;2;1;0;0;0;2;1;42980;CALIENTACAMA KIOTO DIGITAL 2 PLAZAS KTC-1006;CLIMATIZACION
17475506;;F;32;CHILENO;;Millenial;"";"";17980;2;1;2;1;17980;0;0;0;ESTUFA CUARZO KIOTO 800W KTE-011A;CLIMATIZACION
6993711;;F;72;CHILENO;;Silencioso;CHILLAN                       ;BIO BIO;176940;2;1;0;0;0;2;1;176940;ESTUFA A GAS UT GRX-4200 15 KILOS;CLIMATIZACION
18476354;Soltero;F;28;CHILENO;;Millenial;PROVIDENCIA                   ;METROPOLITANA;19990;1;1;0;0;0;1;1;19990;TURBO CALEFACTOR VERT. TC-2100V BLANCO;CLIMATIZACION
15146891;;F;38;CHILENO;;X;PELLUHUE                      ;MAULE;224960;4;4;0;0;0;4;4;224960;CHIMENEA ELECTRICA KIOTO 2000W KTE-1101;CLIMATIZACION
17754264;;F;31;CHILENO;;Millenial;QUILPUE;VALPARAISO;50304;3;2;3;1;49970;0;1;334;CALIENTACAMA KIOTO DIGITAL 1 PLAZA KTC-1005;CLIMATIZACION
16005940;;M;37;CHILENO;;Millenial;PROVIDENCIA                   ;METROPOLITANA;374180;4;2;0;0;0;4;2;374180;ESTUFA KEROSENE 720+;CLIMATIZACION
7529457;;F;65;CHILENO;;Boomers;MOLINA                        ;MAULE;149990;1;1;0;0;0;1;1;149990;ESTUFA A GAS CALMA 5 KG COMPAK;CLIMATIZACION
25778580;;F;25;CHILENO;;Extranjero;LOS LAGOS                     ;LOS LAGOS;175950;5;3;0;0;0;5;3;175950;CALIENTACAMA KIOTO DIGITAL 2 PLAZAS KTC-1006;CLIMATIZACION
25678755;;M;31;HAITIANO;;Extranjero;BUIN                          ;METROPOLITANA;23980;2;2;0;0;0;2;2;23980;TERMOVENTILADOR KIOTO BLANCO 2000W KTE-1028B;CLIMATIZACION
19424107;Soltero;M;25;CHILENO;;Z;PUNTA ARENAS;MAGALLANES;19990;1;1;0;0;0;1;1;19990;ESTUFA ELECTRICA CUARZO KIOTO 1200W KTE 1033;CLIMATIZACION
12485368;;M;49;CHILENO;;X;"";"";9990;1;1;0;0;0;1;1;9990;TERMOVENTILADOR KIOTO BLANCO 2000W KTE-1028B;CLIMATIZACION
14324523;Casado;M;45;CHILENO;;X;RENCA                         ;METROPOLITANA;268980;2;1;2;1;268980;0;0;0;ESTUFA ELEC. CHIMENEA TH-FP100 CAFE 1000W-2000W;CLIMATIZACION
27089648;;M;1043;EXTRANJERO - NO INFORMA NACIONALIDAD ;;Extranjero;ILLAPEL                       ;COQUIMBO;706940;6;4;0;0;0;6;4;706940;CALIENTACAMA KIOTO DIGITAL 2 PLAZAS KTC-1006;CLIMATIZACION
19437266;;F;25;CHILENO;;Silencioso;PROVIDENCIA                   ;METROPOLITANA;10240;2;2;0;0;0;2;2;10240;ESTUFA CUARZO KIOTO 800W KTE-011A;CLIMATIZACION
19274713;;F;26;CHILENO;;Z;SAN FERNANDO                  ;L.G.B.OÂ´HIGGINS;14990;1;1;0;0;0;1;1;14990;CALIENTACAMA KIOTO ANALOGO 1 PLAZA KTC-1004;CLIMATIZACION
12326807;;M;49;CHILENO;;X;PROVIDENCIA                   ;METROPOLITANA;20990;1;1;0;0;0;1;1;20990;ESTUFA ELECTRICA CUARZO KIOTO 1200W KTE 1033;CLIMATIZACION
8709205;;F;63;CHILENO;;Boomers;LINARES                       ;MAULE;298471;5;3;0;0;0;5;3;298471;CALIENTACAMA KIOTO DIGITAL 1 PLAZA KTC-1005;CLIMATIZACION
19807771;;M;24;CHILENO;;Extranjero;SAN CLEMENTE                  ;MAULE;8990;1;1;0;0;0;1;1;8990;TERMOVENTILADOR KIOTO BLANCO 2000W KTE-1028B;CLIMATIZACION
16694317;;F;34;CHILENO;;Millenial;PROVIDENCIA                   ;METROPOLITANA;44970;3;2;3;2;44970;0;0;0;ESTUFA ELECTRICA CUARZO KIOTO 1200W KTE 1033;CLIMATIZACION
16217654;;F;36;CHILENO;;Millenial;NIQUEN                        ;BIO BIO;134452;5;5;0;0;0;5;5;134452;CALIENTACAMA KIOTO DIGITAL 2 PLAZAS KTC-1006;CLIMATIZACION
18510423;Soltero;M;29;CHILENO;;Millenial;PROVIDENCIA                   ;METROPOLITANA;21990;1;1;0;0;0;1;1;21990;TERMOVENTILADOR OSCILANTE FH-120S BL;CLIMATIZACION
8081529;;F;65;CHILENO;;Boomers;TALCA                         ;MAULE;601513;6;2;0;0;0;6;2;601513;ESTUFA FIAMMA PRO;CLIMATIZACION
10531116;;F;52;CHILENO;;X;N/D;N/D;9240;2;1;0;0;0;2;1;9240;ESTUFA CUARZO KIOTO 800W KTE-011A;CLIMATIZACION
12275378;;F;50;CHILENO;;X;LA FLORIDA                    ;METROPOLITANA;9990;1;1;0;0;0;1;1;9990;TERMOVENTILADOR KIOTO NEGRO 2000W KTE-1028N;CLIMATIZACION
11256404;;F;54;CHILENO;;X;RENCA                         ;METROPOLITANA;19990;1;1;1;1;19990;0;0;0;ESTUFA ELECTRICA CUARZO KIOTO 1200W KTE 1033;CLIMATIZACION
18921029;;F;27;CHILENO;;Millenial;PROVIDENCIA                   ;METROPOLITANA;12980;2;1;2;1;12980;0;0;0;ESTUFA CUARZO KIOTO 800W KTE-011A;CLIMATIZACION
26420320;;M;42;VENEZOLANO;;Extranjero;N/D;N/D;40960;4;2;0;0;0;4;2;40960;TERMOVENTILADOR TH-FH30 BLANCO 1000W-2000W;CLIMATIZACION
24386526;;F;32;PERUANO;;Extranjero;LA PINTANA                    ;METROPOLITANA;245960;5;3;5;3;245960;0;0;0;ESTUFA ELECTRICA PORTATIL EEP-2200BLBLANCA;CLIMATIZACION
16156898;;F;36;CHILENO;;Millenial;PROVIDENCIA                   ;METROPOLITANA;108980;2;2;0;0;0;2;2;108980;TERMOVENTILADOR KIOTO BLANCO 2000W KTE-1028B;CLIMATIZACION
18272253;;F;29;CHILENO;;Millenial;"";"";19980;2;1;0;0;0;2;1;19980;TERMOVENTILADOR KIOTO NEGRO 2000W KTE-1028N;CLIMATIZACION
5490140;;F;78;CHILENO;;Silencioso;SANTIAGO                      ;METROPOLITANA;250940;6;2;0;0;0;6;2;250940;ESTUFA GAS EH2500 5K NEGRO;CLIMATIZACION
13989111;;F;40;CHILENO;;X;PROVIDENCIA                   ;METROPOLITANA;8990;1;1;1;1;8990;0;0;0;TERMOVENTILADOR KIOTO NEGRO 2000W KTE-1028N;CLIMATIZACION
27171142;;F;53;EXTRANJERO - NO INFORMA NACIONALIDAD;;Extranjero;"";"";1358950;6;3;0;0;0;6;3;1358950;CALIENTACAMA KIOTO DIGITAL 2 PLAZAS KTC-1006;CLIMATIZACION
9161480;;F;63;CHILENO;;Boomers;EL CARMEN                     ;BIO BIO;761740;5;1;0;0;0;5;1;761740;CALEFACTOR LENA CLASSIC400 BURDEO;CLIMATIZACION
7123815;;F;67;CHILENO;;Boomers;N/D;N/D;217970;3;3;0;0;0;3;3;217970;ESTUFA KEROSENE 720+;CLIMATIZACION
7180602;;F;70;CHILENO;;Silencioso;ARICA                         ;ARICA Y PARINACOTA;164970;3;3;0;0;0;3;3;164970;CALEFACTOR CARBONO 800W EEC-3000 NEGRO;CLIMATIZACION
18260121;;M;29;CHILENO;;Millenial;RETIRO                        ;MAULE;867420;8;5;4;2;552460;4;3;314960;CALIENTACAMA KIOTO DIGITAL 2 PLAZAS KTC-1006;CLIMATIZACION
13921311;Soltero;F;42;CHILENO;INGENIERO;X;CERRILLOS;METROPOLITANA;277970;4;2;4;2;277970;0;0;0;TERMOVENTILADOR KIOTO BLANCO 2000W KTE-1028B;CLIMATIZACION
27002683;;F;28;VENEZOLANO;;Extranjero;LINARES                       ;MAULE;8990;1;1;0;0;0;1;1;8990;TERMOVENTILADOR KIOTO BLANCO 2000W KTE-1028B;CLIMATIZACION
15133611;;F;39;CHILENO;;X;LA FLORIDA                    ;METROPOLITANA;40970;3;2;0;0;0;3;2;40970;CALIENTACAMA KIOTO ANALOGO 1 PLAZA KTC-1004;CLIMATIZACION
7674137;;F;67;CHILENO;;Boomers;LA SERENA                     ;COQUIMBO;155900;3;1;0;0;0;3;1;155900;CHIMENEA ELECTRICA KIOTO 2000W KTE-1101;CLIMATIZACION
16942362;;M;33;CHILENO;;Millenial;SAN FERNANDO                  ;L.G.B.OÂ´HIGGINS;34970;3;1;0;0;0;3;1;34970;CALIENTACAMA KIOTO ANALOGO 1 PLAZA KTC-1004;CLIMATIZACION
18748706;Soltero;F;28;CHILENO;BIOQUIMICO;Millenial;PROVIDENCIA                   ;METROPOLITANA;8990;1;1;0;0;0;1;1;8990;TERMOVENTILADOR KIOTO NEGRO 2000W KTE-1028N;CLIMATIZACION
8368219;;F;65;CHILENO;;Z;PROVIDENCIA                   ;METROPOLITANA;179990;1;1;0;0;0;1;1;179990;ESTUFA POTENZA;CLIMATIZACION
8370061;;F;66;CHILENO;;Boomers;SAN FERNANDO                  ;L.G.B.OÂ´HIGGINS;315970;3;4;2;1;175980;1;3;139990;ESTUFA FOGUITA PRO;CLIMATIZACION
20330504;;F;22;CHILENO;;Z;N/D;N/D;147950;5;4;0;0;0;5;4;147950;ESTUFA CUARZO KIOTO 800W KTE-011A;CLIMATIZACION
15634146;;M;39;CHILENO;;X;N/D;N/D;360960;4;2;4;2;360960;0;0;0;ESTUFA FOGUITA PRO;CLIMATIZACION
16063876;Soltero;F;36;CHILENO;;Millenial;PROVIDENCIA                   ;METROPOLITANA;48980;2;1;0;0;0;2;1;48980;CALIENTACAMAS ANALOGO BASICO 1PL;CLIMATIZACION
11397664;Casado;F;52;CHILENO;;X;SAN FERNANDO                  ;L.G.B.OÂ´HIGGINS;21990;1;1;0;0;0;1;1;21990;Termoventilador Ht 2014 R;CLIMATIZACION
9393505;;F;57;CHILENO;;Boomers;RENCA                         ;METROPOLITANA;41980;2;1;0;0;0;2;1;41980;Calefactor Halogeno Ha-10T 1000W;CLIMATIZACION
12455530;Soltero;F;48;CHILENO;MECANICO AUTOMOTRIZ EN SISTEMAS ELECTRONICOS;X;RENCA                         ;METROPOLITANA;14990;1;1;1;1;14990;0;0;0;TURBO CALEFACTOR VERT. TC-2070V BLANCO;CLIMATIZACION
23579213;Soltero;M;36;COLOMBIANO;;Extranjero;PROVIDENCIA                   ;METROPOLITANA;0;0;2;0;2;0;0;0;0;VENTILADOR PEDESTAL KTP-1015;CLIMATIZACION
18626147;Soltero;F;28;CHILENO;TECNICO DE NIVEL SUPERIOR EN ENFERMERIA;Millenial;"";"";167980;2;1;2;1;167980;0;0;0;ESTUFA FIAMMA PRO;CLIMATIZACION
15879588;;F;48;CHILENO;;Silencioso;CHILLAN                       ;BIO BIO;380970;3;2;2;1;367980;1;1;12990;CALEFACTOR LENA NORDIC360 GRIS CHARCOAL;CLIMATIZACION
19428003;Soltero;F;26;CHILENO;TECNICO DE NIVEL MEDIO EN ALIMENTACION;Z;PROVIDENCIA                   ;METROPOLITANA;29990;1;1;1;1;29990;0;0;0;CALIENTACAMA KIOTO DIGITAL 2 PLAZAS KTC-1006;CLIMATIZACION
6665419;;M;71;CHILENO;;Silencioso;OVALLE                        ;COQUIMBO;401760;4;2;0;0;0;4;2;401760;ESTUFA A GAS UT GRX-6200 ET ROJA 15 KILOS;CLIMATIZACION
14397737;;M;44;CHILENO;;X;PROVIDENCIA                   ;METROPOLITANA;16990;1;1;0;0;0;1;1;16990;CALIENTACAMA KIOTO DIGITAL 1 PLAZA KTC-1005;CLIMATIZACION
12588729;;F;48;CHILENO;;X;N/D;N/D;15990;1;1;0;0;0;1;1;15990;TURBO CALEFACTOR VERT. TC-2070V BLANCO;CLIMATIZACION
6882423;;M;70;CHILENO;;Silencioso;EL QUISCO                     ;VALPARAISO;165690;2;1;0;0;0;2;1;165690;ESTUFA HIBRIDA SR-6300NG;CLIMATIZACION
8222505;;M;66;CHILENO;;Boomers;CONCEPCION                    ;BIO BIO;221094;6;4;0;0;0;6;4;221094;ESTUFA GAS KGQ15N 15K NEGRO EUROPEA;CLIMATIZACION
14440774;;M;42;CHILENO;;X;RANQUIL                       ;BIO BIO;899200;9;3;0;0;0;9;3;899200;CALEFACTOR LENA NORDIC360 GRIS CHARCOAL;CLIMATIZACION
17300966;;F;32;CHILENO;;Millenial;PUTAENDO                      ;VALPARAISO;18990;1;1;0;0;0;1;1;18990;CALEFACTOR HALOGENO 1200W EEH-1210 GRIS;CLIMATIZACION
17789578;;F;31;CHILENO;;Millenial;PROVIDENCIA                   ;METROPOLITANA;125980;2;1;2;1;125980;0;0;0;KIT INSTALACION VERTICAL 6X4MTS ACERO;CLIMATIZACION
5481816;;M;77;CHILENO;;Silencioso;LA GRANJA                     ;METROPOLITANA;226960;4;3;0;0;0;4;3;226960;ESTUFA KEROSENE F 1120+;CLIMATIZACION
13662940;Casado;F;42;CHILENO;GEOGRAFO;X;PROVIDENCIA                   ;METROPOLITANA;21990;1;1;0;0;0;1;1;21990;V-VENTILADOR SOBREMESA 12 AIROLITE;CLIMATIZACION
18560076;;M;28;CHILENO;;Millenial;PARRAL                        ;MAULE;24990;1;1;0;0;0;1;1;24990;VENTILADOR PEDESTAL KTP-1015;CLIMATIZACION
15771682;;F;37;CHILENO;;Millenial;MAIPU                         ;METROPOLITANA;43980;2;1;0;0;0;2;1;43980;VENTILADOR PEDESTAL 16 PLASTIC KFX-16P;CLIMATIZACION
12207196;Soltero;M;52;CHILENO;;X;RENCA                         ;METROPOLITANA;24990;1;1;0;0;0;1;1;24990;VENTILADOR PEDESTAL KTP-1015;CLIMATIZACION
5411334;;F;78;CHILENO;;Silencioso;SAN ANTONIO                   ;VALPARAISO;437950;5;5;0;0;0;5;5;437950;VENTILADOR PEDESTAL 16 PLASTIC KFX-16P;CLIMATIZACION
15587137;Casado;M;38;CHILENO;;X;PROVIDENCIA                   ;METROPOLITANA;39990;1;1;0;0;0;1;1;39990;V-VENTILADOR PEDESTAL 16 AIROLITE;CLIMATIZACION
4766344;;M;74;CHILENO;;Silencioso;LOS ANDES                     ;VALPARAISO;359990;1;1;0;0;0;1;1;359990;A/C FRIO/CALOR PORTATIL 12000BTU;CLIMATIZACION
16708676;;F;35;CHILENO;;Millenial;N/D;N/D;649970;3;2;0;0;0;3;2;649970;ENFRIADOR DE AIRE CE IONIZER;CLIMATIZACION
8743038;Casado;M;63;CHILENO;;Boomers;MELIPILLA                     ;METROPOLITANA;109980;2;1;0;0;0;2;1;109980;VENTILADOR 18 PLG CP 18 GUN METAL C/ SOPORTE;CLIMATIZACION
15790282;Soltero;M;38;CHILENO;INGENIERO INFORMATICO;Millenial;PROVIDENCIA                   ;METROPOLITANA;59990;1;1;0;0;0;1;1;59990;VENTILADOR PEDESTAL16 PLG MODELO CPE 160 3 EN 1;CLIMATIZACION
7432006;;F;67;CHILENO;;Boomers;QUILLOTA                      ;VALPARAISO;19990;1;1;0;0;0;1;1;19990;VENTILADOR THOMAS TH-08NM;CLIMATIZACION
8556594;Casado;M;64;CHILENO;INGENIERO AGRICOLA;Boomers;RENCA                         ;METROPOLITANA;32990;1;1;0;0;0;1;1;32990;VENTILADOR PEDESTAL KTP-1015;CLIMATIZACION
13968330;;M;42;CHILENO;;X;PROVIDENCIA                   ;METROPOLITANA;39990;1;1;0;0;0;1;1;39990;V-VENTILADOR 360 TURBO 8 AIROLITE;CLIMATIZACION
10264708;;F;48;CHILENO;;X;RENCA                         ;METROPOLITANA;64980;2;2;0;0;0;2;2;64980;VENTILADOR INDUSTRIAL KTI-1013;CLIMATIZACION
17461009;;M;44;CHILENO;;X;ANGOL                         ;ARAUCANIA;24990;1;1;0;0;0;1;1;24990;VENTILADOR PEDESTAL KTP-1015;CLIMATIZACION
13518579;;F;44;CHILENO;;X;N/D;N/D;55980;2;1;0;0;0;2;1;55980;Ventilador BOX 20 Metalico FE-45 20Â¿;CLIMATIZACION
18256927;Soltero;F;29;CHILENO;NUTRICIONISTA;Millenial;PROVIDENCIA                   ;METROPOLITANA;34990;1;1;1;1;34990;0;0;0;VENTILADOR PEDESTAL KTP-1016;CLIMATIZACION
18942398;Soltero;F;26;CHILENO;;Z;PROVIDENCIA                   ;METROPOLITANA;33980;2;1;2;1;33980;0;0;0;V-VENTILADOR PISO/MESA 12 C/CONTROL Y TIMER;CLIMATIZACION
13861556;;M;41;CHILENO;;X;PROVIDENCIA                   ;METROPOLITANA;49990;1;3;0;0;0;1;3;49990;VENTILADOR INDUSTRIAL KTI-1013;CLIMATIZACION
13815102;;F;43;CHILENO;;X;RENCA                         ;METROPOLITANA;63980;2;1;0;0;0;2;1;63980;VENTILADOR PEDESTAL16 PLG MODELO CPE 160 3 EN 1;CLIMATIZACION
19973657;;F;23;CHILENO;;Z;PROVIDENCIA                   ;METROPOLITANA;19990;1;1;1;1;19990;0;0;0;VENTILADOR PEDESTAL KF-16P;CLIMATIZACION
6919039;;F;74;CHILENO;;Silencioso;SAN VICENTE                   ;L.G.B.OÂ´HIGGINS;34990;1;1;0;0;0;1;1;34990;VENTILADOR INDUSTRIAL KTI-1013;CLIMATIZACION
14224750;;M;41;CHILENO;;X;SANTIAGO                      ;METROPOLITANA;47990;2;1;0;0;0;2;1;47990;VENTILADOR WIND BREEZE (160S);CLIMATIZACION
20519630;;M;22;CHILENO;;Z;N/D;N/D;56970;3;2;0;0;0;3;2;56970;VENTILADOR PEDESTAL KF-16P;CLIMATIZACION
17792510;;F;31;CHILENO;;Millenial;N/D;N/D;47980;2;1;0;0;0;2;1;47980;VENTILADOR PEDESTAL KTP-1015;CLIMATIZACION
17423850;;F;33;CHILENO;;Millenial;VALDIVIA                      ;LOS RIOS;299990;1;1;0;0;0;1;1;299990;AIRE AC. PORTATIL 12000 BTU TCL-12CHPA;CLIMATIZACION
13127331;;F;46;CHILENO;;X;NIQUEN                        ;BIO BIO;316950;5;5;0;0;0;5;5;316950;VENTILADOR PEDESTAL KTP-1015;CLIMATIZACION
13548852;;F;43;CHILENO;;X;RENCA                         ;METROPOLITANA;299990;2;1;2;1;299990;0;0;0;A/C FRIO/CALOR PORTATI 9000BTU;CLIMATIZACION
17493035;Soltero;F;33;CHILENO;;Millenial;RENCA                         ;METROPOLITANA;19990;1;1;1;1;19990;0;0;0;VENTILADOR PEDESTAL KF-16P;CLIMATIZACION
12465422;;F;50;CHILENO;;X;HUECHURABA                    ;METROPOLITANA;319990;2;1;2;1;319990;0;0;0;A/C FRIO/CALOR PORTATIL 12000BTU;CLIMATIZACION
7416353;;M;65;CHILENO;;Boomers;PROVIDENCIA                   ;METROPOLITANA;34990;1;1;0;0;0;1;1;34990;VENTILADOR PEDESTAL KTP-1015;CLIMATIZACION
17532503;;F;32;CHILENO;;Millenial;PROVIDENCIA                   ;METROPOLITANA;39990;1;1;0;0;0;1;1;39990;V-VENTILADOR PEDESTAL 16 AIROLITE;CLIMATIZACION
16840298;;F;34;CHILENO;;Millenial;CAUQUENES                     ;MAULE;29990;1;1;0;0;0;1;1;29990;VENTILADOR INDUSTRIAL KTI-1013;CLIMATIZACION
6001870;;F;74;CHILENO;;Silencioso;LO ESPEJO                     ;METROPOLITANA;31673;2;1;0;0;0;2;1;31673;VENTILADOR INDUSTRIAL KTI-1013;CLIMATIZACION
10636762;Viudo;F;56;CHILENO;;Boomers;RENCA                         ;METROPOLITANA;173150;4;2;0;0;0;4;2;173150;VENTILADOR THOMAS TH-16CP Pedestal 16;CLIMATIZACION
15305741;;F;40;CHILENO;;X;COIHAIQUE                     ;AYSEN;27990;1;1;0;0;0;1;1;27990;VENTILADOR BOX NVB1210 12P;CLIMATIZACION
7817191;;M;61;CHILENO;;Boomers;LAMPA                         ;METROPOLITANA;92660;3;1;0;0;0;3;1;92660;VENTILADOR SOBREMESA 1696 COLOR NEGRO Y CROMADO;CLIMATIZACION
16990198;;M;34;CHILENO;;Millenial;SAN ESTEBAN                   ;VALPARAISO;97260;3;1;3;1;97260;0;0;0;CONVECTOR INFRAROJO EEC-1550NG;CLIMATIZACION
12298653;;M;49;CHILENO;;X;TALCA                         ;MAULE;311980;2;1;2;1;311980;0;0;0;CALEFACTOR LENA SCANTEK360 GRIS CHARCOAL;CLIMATIZACION
16237681;;M;36;CHILENO;;Millenial;N/D;N/D;367080;4;2;4;2;367080;0;0;0;KIT INSTALACION VERTICAL 6X4MTS ACERO;CLIMATIZACION
18821920;;F;27;CHILENO;;Z;PROVIDENCIA                   ;METROPOLITANA;258540;2;1;2;1;258540;0;0;0;CALEFACTOR LENA ECO350 CHARCOAL;CLIMATIZACION
16136297;;F;37;CHILENO;;Millenial;PROVIDENCIA                   ;METROPOLITANA;78540;2;1;2;1;78540;0;0;0;CONVECTOR INFRAROJO EEC-1550NG;CLIMATIZACION
17498629;;F;31;CHILENO;;Millenial;SAN JAVIER                    ;MAULE;311980;2;1;2;1;311980;0;0;0;CALEFACTOR LENA SCANTEK360 GRIS CHARCOAL;CLIMATIZACION
9066691;;F;59;CHILENO;;Boomers;N/D;N/D;188980;2;1;2;1;188980;0;0;0;A/C FRIO/CALOR PORTATI 9000BTU;CLIMATIZACION
18832207;;M;28;CHILENO;;Silencioso;PROVIDENCIA                   ;METROPOLITANA;0;0;0;0;0;0;0;0;0;CALIENTACAMAS DIGITAL SUBLIME MAXI 1.5PL;CLIMATIZACION
19467238;;F;24;CHILENO;;Z;PROVIDENCIA                   ;METROPOLITANA;0;0;0;0;0;0;0;0;0;TERMOVENTILADOR KIOTO BLANCO 2000W KTE-1028B;CLIMATIZACION
7065212;;F;65;CHILENO;;Silencioso;PROVIDENCIA                   ;METROPOLITANA;0;0;0;0;0;0;0;0;0;ESTUFA ELECTRICA CUARZO KIOTO 1200W KTE 1033;CLIMATIZACION
7402598;;M;62;CHILENO;;Boomers;PROVIDENCIA                   ;METROPOLITANA;0;0;0;0;0;0;0;0;0;ESTUFA ELECTRICA CUARZO KIOTO 1200W KTE 1033;CLIMATIZACION
8396228;Casado;M;51;CHILENO;;X;RENCA                         ;METROPOLITANA;0;0;0;0;0;0;0;0;0;TERMOVENTILADOR VINTAGE HT RETRO 2000B;CLIMATIZACION
11715806;Soltero;M;51;CHILENO;;X;RENCA                         ;METROPOLITANA;0;0;0;0;0;0;0;0;0;CHIMENEA ELECTRICA ROBLE NEGRA;CLIMATIZACION
9107587;;M;59;CHILENO;;Boomers;PROVIDENCIA                   ;METROPOLITANA;0;0;0;0;0;0;0;0;0;CONVECTOR INFRAROJO EEC-1550NG;CLIMATIZACION
19095693;Soltero;F;26;CHILENO;ENFERMERA;Silencioso;PROVIDENCIA                   ;METROPOLITANA;0;0;0;0;0;0;0;0;0;TERMOVENTILADOR TH-FH30 BLANCO 1000W-2000W;CLIMATIZACION
17861924;;F;31;CHILENO;;Millenial;CORONEL                       ;BIO BIO;0;0;0;0;0;0;0;0;0;CALEFACTOR LENA ITALY6100 ROJO;CLIMATIZACION
19399441;Soltero;F;26;CHILENO;;Z;QUEILEN                       ;LOS LAGOS;0;0;0;0;0;0;0;0;0;CALIENTACAMA KIOTO DIGITAL 2 PLAZAS KTC-1006;CLIMATIZACION
13047792;Casado;M;46;CHILENO;INGENIERO CIVIL;X;PROVIDENCIA                   ;METROPOLITANA;0;0;0;0;0;0;0;0;0;V-AIRE PORTATIL MIDEA MPPD-12KHRN1;CLIMATIZACION
17153355;Soltero;M;33;CHILENO;ENFERMERO;Millenial;CALBUCO;LOS LAGOS;0;0;0;0;0;0;0;0;0;CHIMENEA ELECTRICA KIOTO 2000W KTE-1101;CLIMATIZACION
13376642;;F;43;CHILENO;;Extranjero;SAN PEDRO DE LA PAZ           ;BIO BIO;0;0;0;0;0;0;0;0;0;ESTUFA CUARZO KIOTO 800W KTE-011A;CLIMATIZACION
16853243;;F;34;CHILENO;;Millenial;PROVIDENCIA                   ;METROPOLITANA;0;0;0;0;0;0;0;0;0;CALEFACTOR LENA ECO350 CHARCOAL;CLIMATIZACION
7862252;;F;65;CHILENO;;Silencioso;PROVIDENCIA                   ;METROPOLITANA;0;0;0;0;0;0;0;0;0;ESTUFA A GAS UT GRX-6200 ET ROJA 15 KILOS;CLIMATIZACION
14097277;;F;41;CHILENO;;X;PROVIDENCIA                   ;METROPOLITANA;0;0;0;0;0;0;0;0;0;TERMOVENTILADOR KIOTO NEGRO 2000W KTE-1028N;CLIMATIZACION
10105421;;M;50;CHILENO;;X;CHILLAN                       ;BIO BIO;0;0;0;0;0;0;0;0;0;CALIENTACAMA KIOTO ANALOGO 1 PLAZA KTC-1004;CLIMATIZACION
19428416;;F;26;CHILENO;;Z;PROVIDENCIA                   ;METROPOLITANA;0;0;0;0;0;0;0;0;0;CALIENTACAMAS DIGITAL TIMER SG-5350 1PL;CLIMATIZACION
8747943;;F;63;CHILENO;;Boomers;PALMILLA                      ;L.G.B.OÂ´HIGGINS;0;0;0;0;0;0;0;0;0;ESTUFA FIBRA DE CARBONO KFB 90;CLIMATIZACION
18759169;Soltero;F;27;CHILENO;;Silencioso;PROVIDENCIA                   ;METROPOLITANA;0;0;0;0;0;0;0;0;0;ESTUFA CUARZO KIOTO 800W KTE-011A;CLIMATIZACION
5907073;;M;75;CHILENO;;Silencioso;CAUQUENES                     ;MAULE;0;0;0;0;0;0;0;0;0;CALIENTACAMA KIOTO DIGITAL 2 PLAZAS KTC-1006;CLIMATIZACION
19263115;;F;26;CHILENO;;Z;PROVIDENCIA                   ;METROPOLITANA;0;0;0;0;0;0;0;0;0;TERMOVENTILADOR KIOTO BLANCO 2000W KTE-1028B;CLIMATIZACION
12775384;;F;54;CHILENO;;X;RENCA                         ;METROPOLITANA;0;0;0;0;0;0;0;0;0;ESTUFA ELEC. INFRAROJO 4 EN 1 WIFI NG;CLIMATIZACION
6881296;;F;69;CHILENO;;Silencioso;SANTA CRUZ                    ;L.G.B.OÂ´HIGGINS;0;0;0;0;0;0;0;0;0;CALIENTACAMA KIOTO DIGITAL 2 PLAZAS KTC-1006;CLIMATIZACION
8953413;Soltero;F;59;CHILENO;CONTADOR AUDITOR;Boomers;PROVIDENCIA                   ;METROPOLITANA;0;0;0;0;0;0;0;0;0;TERMOVENTILADOR KIOTO BLANCO 2000W KTE-1028B;CLIMATIZACION
10151484;;F;58;CHILENO;;Boomers;RENCA                         ;METROPOLITANA;0;0;0;0;0;0;0;0;0;TERMOVENTILADOR KIOTO BLANCO 2000W KTE-1028B;CLIMATIZACION
18726643;;F;28;CHILENO;;Millenial;LO BARNECHEA                  ;METROPOLITANA;0;0;0;0;0;0;0;0;0;ESTUFA CUARZO KIOTO 800W KTE-011A;CLIMATIZACION
6549224;;F;73;CHILENO;;Silencioso;CALERA                        ;VALPARAISO;0;0;0;0;0;0;0;0;0;ESTUFA CUARZO KIOTO 800W KTE-011A;CLIMATIZACION
18007371;;F;29;CHILENO;;Millenial;PICA                          ;TARAPACA;0;0;0;0;0;0;0;0;0;TERMOVENTILADOR KIOTO BLANCO 2000W KTE-1028B;CLIMATIZACION
15538807;Casado;F;39;CHILENO;;X;PROVIDENCIA                   ;METROPOLITANA;0;0;0;0;0;0;0;0;0;CALIENTACAMA KIOTO DIGITAL 2 PLAZAS KTC-1006;CLIMATIZACION
7873194;;F;62;CHILENO;;Boomers;RENCA                         ;METROPOLITANA;0;0;0;0;0;0;0;0;0;CALIENTACAMAS ANALOGO 2 PL;CLIMATIZACION
12650768;;F;47;CHILENO;;X;CONCHALI                      ;METROPOLITANA;0;0;0;0;0;0;0;0;0;ESTUFA ELECTRICA CUARZO KIOTO 1200W KTE 1033;CLIMATIZACION
6524565;Viudo;F;71;CHILENO;PROFESOR;Silencioso;LONGAVI                       ;MAULE;0;0;0;0;0;0;0;0;0;CALIENTACAMA KIOTO ANALOGO 1 PLAZA KTC-1004;CLIMATIZACION
12082324;;F;54;CHILENO;;X;OSORNO                        ;LOS LAGOS;0;0;0;0;0;0;0;0;0;TERMOVENTILADOR KIOTO BLANCO 2000W KTE-1028B;CLIMATIZACION
9825268;;M;58;CHILENO;;Silencioso;PROVIDENCIA                   ;METROPOLITANA;0;0;0;0;0;0;0;0;0;TERMOVENTILADOR CERAMICO TH-CH41 NG 1000W-2000W;CLIMATIZACION
16779411;;F;34;CHILENO;;Millenial;ANCUD                         ;LOS LAGOS;0;0;0;0;0;0;0;0;0;TERMOVENTILADOR NICROM VFH300 BL 1800W;CLIMATIZACION
14093327;;M;40;CHILENO;;Silencioso;PROVIDENCIA                   ;METROPOLITANA;0;0;0;0;0;0;0;0;0;CHIMENEA ELECTRICA KIOTO 2000W KTE-1101;CLIMATIZACION
10823897;;F;55;CHILENO;;Boomers;TALCAHUANO                    ;BIO BIO;0;0;0;0;0;0;0;0;0;CHIMENEA ELECTRICA KIOTO 2000W KTE-1101;CLIMATIZACION
17686124;;F;31;CHILENO;;Millenial;PROVIDENCIA                   ;METROPOLITANA;0;0;0;0;0;0;0;0;0;CALEFACTOR CARBONO 800W EEC-3000 NEGRO;CLIMATIZACION
12865804;;M;47;CHILENO;;Silencioso;PROVIDENCIA                   ;METROPOLITANA;0;0;0;0;0;0;0;0;0;CALIENTACAMAS DIGITAL SUBLIME MAXI 1.5PL;CLIMATIZACION
13123707;;M;45;CHILENO;;X;COIHAIQUE                     ;AYSEN;0;0;0;0;0;0;0;0;0;TERMOVENTILADOR KIOTO BLANCO 2000W KTE-1028B;CLIMATIZACION
14137894;;F;41;CHILENO;;Silencioso;PROVIDENCIA                   ;METROPOLITANA;0;0;0;0;0;0;0;0;0;ESTUFA ELECTRICA CUARZO KIOTO 1200W KTE 1033;CLIMATIZACION
19130759;Soltero;F;26;CHILENO;;Z;PROVIDENCIA                   ;METROPOLITANA;0;0;0;0;0;0;0;0;0;CALIENTACAMA KIOTO DIGITAL 2 PLAZAS KTC-1006;CLIMATIZACION
10550188;;M;56;CHILENO;;Boomers;RENCA                         ;METROPOLITANA;0;0;0;0;0;0;0;0;0;CONVECTOR TH-CV51 BL 750W - 1250W - 2000W;CLIMATIZACION
8347403;;F;63;CHILENO;;Boomers;PENAFLOR                      ;METROPOLITANA;0;0;0;0;0;0;0;0;0;CALIENTACAMA KIOTO DIGITAL 1 PLAZA KTC-1005;CLIMATIZACION
11925640;;F;50;CHILENO;;X;PUERTO MONTT                  ;LOS LAGOS;0;0;0;0;0;0;0;0;0;CONVECTOR ELECT. UT HMC-2000;CLIMATIZACION
8160532;;F;65;CHILENO;;Boomers;CONCEPCION                    ;BIO BIO;0;0;0;0;0;0;0;0;0;CALIENTACAMA KIOTO DIGITAL 2 PLAZAS KTC-1006;CLIMATIZACION
12271089;;F;50;CHILENO;;X;QUINTA NORMAL                 ;METROPOLITANA;0;0;0;0;0;0;0;0;0;ESTUFA A GAS UT GRX-6200 ET ROJA 15 KILOS;CLIMATIZACION
20404235;;F;22;CHILENO;;Silencioso;PROVIDENCIA                   ;METROPOLITANA;0;0;0;0;0;0;0;0;0;CALIENTACAMA KIOTO ANALOGO 1 PLAZA KTC-1004;CLIMATIZACION
17914621;Soltero;F;31;CHILENO;KINESIOLOGA;Millenial;TEMUCO                        ;ARAUCANIA;0;0;0;0;0;0;0;0;0;TERMOVENTILADOR KIOTO NEGRO 2000W KTE-1028N;CLIMATIZACION
18527796;;F;29;CHILENO;;Millenial;SANTA CRUZ                    ;L.G.B.OÂ´HIGGINS;0;0;0;0;0;0;0;0;0;TERMOVENTILADOR VERTICAL SUN05 PURP.;CLIMATIZACION
7921551;;F;63;CHILENO;;Boomers;TALAGANTE                     ;METROPOLITANA;0;0;0;0;0;0;0;0;0;CALIENTACAMA KIOTO DIGITAL 1 PLAZA KTC-1005;CLIMATIZACION
16872302;;M;33;CHILENO;;Millenial;N/D;N/D;0;0;0;0;0;0;0;0;0;ESTUFA INFRARROJA ELECTRICA KIOTO 1500W KTE-1045;CLIMATIZACION
15966090;;F;37;CHILENO;;Millenial;N/D;N/D;0;0;0;0;0;0;0;0;0;TERMOVENTILADOR KIOTO NEGRO 2000W KTE-1028N;CLIMATIZACION
13807711;;F;42;CHILENO;;X;RENCA                         ;METROPOLITANA;0;0;0;0;0;0;0;0;0;CALIENTACAMA KIOTO ANALOGO 1 PLAZA KTC-1004;CLIMATIZACION
19716212;;F;24;CHILENO;;Z;PROVIDENCIA                   ;METROPOLITANA;0;0;0;0;0;0;0;0;0;TERMOVENTILADOR KIOTO BLANCO 2000W KTE-1028B;CLIMATIZACION
19802806;;M;24;CHILENO;;Z;PROVIDENCIA                   ;METROPOLITANA;0;0;0;0;0;0;0;0;0;ESTUFA ELEC. FIBRA DE CARBONO NSB120K5 ROJA;CLIMATIZACION
17027141;Casado;F;33;CHILENO;;Millenial;PROVIDENCIA                   ;METROPOLITANA;0;0;0;0;0;0;0;0;0;Estufa a gas Kaly 11;CLIMATIZACION
5313858;;M;71;CHILENO;;Silencioso;N/D;N/D;0;0;0;0;0;0;0;0;0;CALIENTACAMAS DIGITAL TIMER SG-5151 2PL;CLIMATIZACION
5990122;Casado;M;75;CHILENO;;Silencioso;PROVIDENCIA                   ;METROPOLITANA;0;0;0;0;0;0;0;0;0;ESTUFA VALORY MINI BLACK Incl REG Y MANG;CLIMATIZACION
16352567;;M;36;CHILENO;;Millenial;RENCA                         ;METROPOLITANA;0;0;0;0;0;0;0;0;0;CALIENTACAMA KIOTO DIGITAL 2 PLAZAS KTC-1006;CLIMATIZACION
17820376;;M;30;CHILENO;;Millenial;PROVIDENCIA                   ;METROPOLITANA;0;0;0;0;0;0;0;0;0;CONVECTOR TH-CV51 BL 750W - 1250W - 2000W;CLIMATIZACION
13060086;;F;46;CHILENO;;X;N/D;N/D;0;0;0;0;0;0;0;0;0;CALIENTACAMA KIOTO DIGITAL 2 PLAZAS KTC-1006;CLIMATIZACION
5647012;;F;81;CHILENO;;Silencioso;PROVIDENCIA                   ;METROPOLITANA;0;0;0;0;0;0;0;0;0;CONVECTOR TURBO KCH 2000 BL;CLIMATIZACION
13169149;;F;45;CHILENO;;Silencioso;PROVIDENCIA                   ;METROPOLITANA;0;0;0;0;0;0;0;0;0;ESTUFA INFRARROJA ELECTRICA KIOTO 1500W KTE-1045;CLIMATIZACION
12753184;;M;47;CHILENO;;X;RENCA                         ;METROPOLITANA;0;0;0;0;0;0;0;0;0;ESTUFA ELECTRICA CUARZO KIOTO 1200W KTE 1033;CLIMATIZACION
18071102;Soltero;F;30;CHILENO;;Silencioso;PROVIDENCIA                   ;METROPOLITANA;0;0;0;0;0;0;0;0;0;CONVECTOR ELECTRICO KIOTO 2000W KTE-1105;CLIMATIZACION
16194424;;M;37;CHILENO;;Millenial;PUERTO MONTT                  ;LOS LAGOS;0;0;0;0;0;0;0;0;0;ESTUFA ELEC. FIBRA DE CARBONO NSB120K5 ROJA;CLIMATIZACION
17479807;;M;32;CHILENO;;Millenial;VINA DEL MAR                  ;VALPARAISO;0;0;0;0;0;0;0;0;0;CONVECTOR ELECTRICO KIOTO 2000W KTE-1105;CLIMATIZACION
8585962;;F;64;CHILENO;;Boomers;PROVIDENCIA                   ;METROPOLITANA;0;0;0;0;0;0;0;0;0;ESTUFA ELECTRICA PORTATIL EEP-2200BLBLANCA;CLIMATIZACION
11471296;;M;52;CHILENO;;Silencioso;LA SERENA                     ;COQUIMBO;0;0;0;0;0;0;0;0;0;TERMOVENTILADOR KIOTO BLANCO 2000W KTE-1028B;CLIMATIZACION
6718936;Soltero;F;68;CHILENO;;Boomers;LINARES                       ;MAULE;0;0;0;0;0;0;0;0;0;CALEFACTOR LENA ECO350 CHARCOAL;CLIMATIZACION
16386698;;F;35;CHILENO;;Millenial;N/D;N/D;0;0;0;0;0;0;0;0;0;TERMOVENTILADOR PTC VILN18 BL 2000W;CLIMATIZACION
18748970;Soltero;M;28;CHILENO;;Silencioso;PROVIDENCIA                   ;METROPOLITANA;0;0;0;0;0;0;0;0;0;TERMOVENTILADOR NICROM VFH300 BL 1800W;CLIMATIZACION
17225660;;F;32;CHILENO;;Millenial;N/D;N/D;0;0;0;0;0;0;0;0;0;CHIMENEA ELECTRICA KIOTO 2000W KTE-1101;CLIMATIZACION
13044077;;M;46;CHILENO;;Silencioso;PROVIDENCIA                   ;METROPOLITANA;0;0;0;0;0;0;0;0;0;ESTUFA GAS SR-6250NG;CLIMATIZACION
12662978;Divorciado;M;51;CHILENO;;X;RENCA                         ;METROPOLITANA;0;0;0;0;0;0;0;0;0;Estufa a gas Kaly 15;CLIMATIZACION
9953338;;M;59;CHILENO;;Millenial;PROVIDENCIA                   ;METROPOLITANA;0;0;0;0;0;0;0;0;0;TERMOVENTILADOR KIOTO NEGRO 2000W KTE-1028N;CLIMATIZACION
14378400;Casado;F;42;CHILENO;;X;RENCA                         ;METROPOLITANA;0;0;0;0;0;0;0;0;0;TERMOVENTILADOR OSCILANTE FH-120S BL;CLIMATIZACION
10521345;Casado;M;52;CHILENO;;X;RENCA                         ;METROPOLITANA;0;0;0;0;0;0;0;0;0;TERMOVENTILADOR KIOTO BLANCO 2000W KTE-1028B;CLIMATIZACION
19285927;;M;26;CHILENO;;Z;COCHRANE                      ;AYSEN;0;0;0;0;0;0;0;0;0;ESTUFA ELECTRICA CUARZO KIOTO 1200W KTE 1033;CLIMATIZACION
16343091;Soltero;F;35;CHILENO;PROFESOR;Silencioso;PROVIDENCIA                   ;METROPOLITANA;0;0;0;0;0;0;0;0;0;TERMOVENTILADOR KIOTO BLANCO 2000W KTE-1028B;CLIMATIZACION
19924016;;F;24;CHILENO;;Z;MELIPILLA                     ;METROPOLITANA;0;0;0;0;0;0;0;0;0;CALIENTACAMA KIOTO DIGITAL 2 PLAZAS KTC-1006;CLIMATIZACION
6818711;;F;68;CHILENO;;Boomers;PARRAL                        ;MAULE;0;0;0;0;0;0;0;0;0;ESTUFA ELECTRICA CUARZO KIOTO 1200W KTE 1033;CLIMATIZACION
15228953;;F;40;CHILENO;;X;PROVIDENCIA                   ;METROPOLITANA;0;0;0;0;0;0;0;0;0;CALEFACTOR LENA SCANTEK380 GRIS CHARCOAL;CLIMATIZACION
2721225;;F;90;CHILENO;;Silencioso;SAN FELIPE                    ;VALPARAISO;0;0;0;0;0;0;0;0;0;TERMOVENTILADOR KIOTO BLANCO 2000W KTE-1028B;CLIMATIZACION
19912605;;F;24;CHILENO;;Z;PROVIDENCIA                   ;METROPOLITANA;0;0;0;0;0;0;0;0;0;ESTUFA POTENZA;CLIMATIZACION
11959384;Soltero;F;49;CHILENO;PROFESOR;X;RENCA                         ;METROPOLITANA;0;0;0;0;0;0;0;0;0;CALIENTACAMA KIOTO ANALOGO 1 PLAZA KTC-1004;CLIMATIZACION
18239583;;F;30;CHILENO;;Millenial;N/D;N/D;0;0;0;0;0;0;0;0;0;ESTUFA GAS SR-6250NG;CLIMATIZACION
10821204;;M;48;CHILENO;;X;LAS CONDES                    ;METROPOLITANA;0;0;0;0;0;0;0;0;0;CALEFACTOR CONVECTOR EEP-2100BL;CLIMATIZACION
19967932;;F;23;CHILENO;;Z;ANTOFAGASTA                   ;ANTOFAGASTA;0;0;0;0;0;0;0;0;0;TERMOVENTILADOR KIOTO BLANCO 2000W KTE-1028B;CLIMATIZACION
14456422;;F;50;CHILENO;;X;PROVIDENCIA                   ;METROPOLITANA;0;0;0;0;0;0;0;0;0;CALIENTACAMAS UFESA INDIVIDUAL CIE;CLIMATIZACION
18826105;;F;27;CHILENO;;Millenial;PROVIDENCIA                   ;METROPOLITANA;0;0;0;0;0;0;0;0;0;CALIENTACAMAS MANUAL 2N SG-5121D4 2PL;CLIMATIZACION
18876390;;M;27;CHILENO;;Z;LOS ALAMOS                    ;BIO BIO;0;0;0;0;0;0;0;0;0;ESTUFA INFRARROJA ELECTRICA KIOTO 1500W KTE-1045;CLIMATIZACION
12391796;Casado;M;49;CHILENO;TECNICO DE NIVEL SUPERIOR EN ENFERMERIA;X;RENCA                         ;METROPOLITANA;0;0;0;0;0;0;0;0;0;CALEFACTOR CONVECTOR EEP-2100BL;CLIMATIZACION
15957560;;M;37;CHILENO;;Millenial;BUIN;METROPOLITANA;0;0;0;0;0;0;0;0;0;Estufa a gas Kaly 11;CLIMATIZACION
16907376;;M;34;CHILENO;;Millenial;N/D;N/D;0;0;0;0;0;0;0;0;0;ESTUFA ELEC. CHIMENEA TH-FP70 NG 1000W-2000W;CLIMATIZACION
5784059;;F;70;CHILENO;;Silencioso;LA GRANJA                     ;METROPOLITANA;0;0;0;0;0;0;0;0;0;ESTUFA ELECTRICA CUARZO KIOTO 1200W KTE 1033;CLIMATIZACION
11422367;;M;53;CHILENO;;X;N/D;N/D;0;0;0;0;0;0;0;0;0;TERMOVENTILADOR KIOTO NEGRO 2000W KTE-1028N;CLIMATIZACION
17985524;;F;31;CHILENO;;Millenial;PROVIDENCIA                   ;METROPOLITANA;0;0;0;0;0;0;0;0;0;CHIMENEA ELECTRICA ROBLE NEGRA;CLIMATIZACION
14486236;;M;45;CHILENO;;X;EMPEDRADO                     ;MAULE;0;0;0;0;0;0;0;0;0;TERMOVENTILADOR KIOTO BLANCO 2000W KTE-1028B;CLIMATIZACION
8045480;;F;53;CHILENO;;X;PROVIDENCIA                   ;METROPOLITANA;0;0;0;0;0;0;0;0;0;CHIMENEA ELECTRICA KIOTO 2000W KTE-1101;CLIMATIZACION
9452566;;M;60;CHILENO;;Boomers;CURICO                        ;MAULE;0;0;0;0;0;0;0;0;0;TERMOVENTILADOR KIOTO NEGRO 2000W KTE-1028N;CLIMATIZACION
13317889;;M;44;CHILENO;;X;TEMUCO                        ;ARAUCANIA;0;0;0;0;0;0;0;0;0;ESTUFA GAS KG5 5K NEGRO EUROPEA;CLIMATIZACION
11298347;;F;53;CHILENO;;X;RENCA                         ;METROPOLITANA;0;0;0;0;0;0;0;0;0;CHIMENEA ELECTRICA KIOTO 2000W KTE-1101;CLIMATIZACION
12627331;;F;47;CHILENO;;X;PROVIDENCIA                   ;METROPOLITANA;0;0;0;0;0;0;0;0;0;TERMOVENTILADOR KIOTO NEGRO 2000W KTE-1028N;CLIMATIZACION
6682255;Casado;F;66;CHILENO;;Boomers;PROVIDENCIA                   ;METROPOLITANA;0;0;0;0;0;0;0;0;0;Estufa a gas Kaly 11;CLIMATIZACION
13313363;;F;44;CHILENO;;X;PROVIDENCIA                   ;METROPOLITANA;0;0;0;0;0;0;0;0;0;TERMOVENTILADOR KIOTO BLANCO 2000W KTE-1028B;CLIMATIZACION
17066164;;M;33;CHILENO;;Millenial;N/D;N/D;0;0;0;0;0;0;0;0;0;CHIMENEA ELECTRICA KIOTO 2000W KTE-1101;CLIMATIZACION
17642762;;M;31;CHILENO;;Millenial;ILLAPEL                       ;COQUIMBO;0;0;0;0;0;0;0;0;0;CALEFACTOR LENA ECO380 CHARCOAL;CLIMATIZACION
18960377;;M;27;CHILENO;;Millenial;MAIPU                         ;METROPOLITANA;0;0;0;0;0;0;0;0;0;TERMOVENTILADOR NICROM VFH1000 BL 2000W;CLIMATIZACION
13724230;;F;46;CHILENO;;X;CONCEPCION                    ;BIO BIO;0;0;0;0;0;0;0;0;0;CHIMENEA ELECTRICA KIOTO 2000W KTE-1101;CLIMATIZACION
8874703;;F;61;CHILENO;;Boomers;SAN CARLOS                    ;BIO BIO;0;0;0;0;0;0;0;0;0;ESTUFA CUARZO KIOTO 800W KTE-011A;CLIMATIZACION
14619991;Soltero;F;42;CHILENO;;X;PROVIDENCIA                   ;METROPOLITANA;0;0;0;0;0;0;0;0;0;CALIENTACAMAS DIGITAL TIMER SG-5151 2PL;CLIMATIZACION
13034763;;M;46;CHILENO;;X;PROVIDENCIA                   ;METROPOLITANA;0;0;0;0;0;0;0;0;0;ESTUFA ELECTRICA CUARZO KIOTO 1200W KTE 1033;CLIMATIZACION
16090664;;F;36;CHILENO;;Millenial;CONSTITUCION                  ;MAULE;0;0;0;0;0;0;0;0;0;CHIMENEA ELECTRICA KIOTO 2000W KTE-1101;CLIMATIZACION
19558348;;F;25;CHILENO;;Z;PROVIDENCIA                   ;METROPOLITANA;0;0;0;0;0;0;0;0;0;TERMOVENTILADOR NICROM VFH1000 BL 2000W;CLIMATIZACION
18920841;;F;28;CHILENO;;Millenial;PROVIDENCIA                   ;METROPOLITANA;0;0;0;0;0;0;0;0;0;TERMOVENTILADOR KIOTO NEGRO 2000W KTE-1028N;CLIMATIZACION
14317126;;M;45;CHILENO;;X;PROVIDENCIA                   ;METROPOLITANA;0;0;0;0;0;0;0;0;0;TERMOVENTILADOR KIOTO NEGRO 2000W KTE-1028N;CLIMATIZACION
18554789;Soltero;F;28;CHILENO;REFRIGERACION;Millenial;NATALES                       ;MAGALLANES;0;0;0;0;0;0;0;0;0;TERMOVENTILADOR NICROM VFH300 BL 1800W;CLIMATIZACION
15430443;;F;40;CHILENO;;X;PUENTE ALTO                   ;METROPOLITANA;0;0;0;0;0;0;0;0;0;ESTUFA VITTALE-40 15K;CLIMATIZACION
19906625;;M;24;CHILENO;;Z;SAN PEDRO DE LA PAZ           ;BIO BIO;0;0;0;0;0;0;0;0;0;TERMOVENTILADOR KIOTO NEGRO 2000W KTE-1028N;CLIMATIZACION
17839399;;F;30;CHILENO;;Millenial;PROVIDENCIA                   ;METROPOLITANA;0;0;0;0;0;0;0;0;0;CALIENTACAMAS MANUAL 2N SG-5120D4 1PL;CLIMATIZACION
16882302;;F;34;CHILENO;;Millenial;N/D;N/D;0;0;0;0;0;0;0;0;0;ESTUFA PARAFINA KPM-23;CLIMATIZACION
19499148;;M;25;CHILENO;;Z;PROVIDENCIA                   ;METROPOLITANA;0;0;0;0;0;0;0;0;0;VITTALE 8;CLIMATIZACION
8101573;Casado;F;66;CHILENO;;Boomers;PROVIDENCIA                   ;METROPOLITANA;0;0;0;0;0;0;0;0;0;ESTUFA FOGUITA PRO;CLIMATIZACION
26204009;;F;29;VENEZOLANO;;Extranjero;PROVIDENCIA                   ;METROPOLITANA;0;0;0;0;0;0;0;0;0;TERMOVENTILADOR KIOTO BLANCO 2000W KTE-1028B;CLIMATIZACION
17084936;;M;33;CHILENO;;Silencioso;PROVIDENCIA                   ;METROPOLITANA;0;0;0;0;0;0;0;0;0;CONVECTOR TH-CV51 BL 750W - 1250W - 2000W;CLIMATIZACION
10804823;;F;53;CHILENO;;X;HUALPEN;BIO BIO;0;0;0;0;0;0;0;0;0;Estufa a gas Kaly 11;CLIMATIZACION
7281009;Viudo;F;70;CHILENO;;Silencioso;CHILLAN                       ;BIO BIO;0;0;0;0;0;0;0;0;0;TERMOVENTILADOR NICROM VFH500 BL 2000W;CLIMATIZACION
8231977;;M;64;CHILENO;;Boomers;ANCUD                         ;LOS LAGOS;0;0;0;0;0;0;0;0;0;TERMOVENTILADOR TH-FH31 BLANCO 1000W-2000W;CLIMATIZACION
11272857;;M;53;CHILENO;;Silencioso;PROVIDENCIA                   ;METROPOLITANA;0;0;0;0;0;0;0;0;0;TERMOVENTILADOR KIOTO NEGRO 2000W KTE-1028N;CLIMATIZACION
19832896;;M;24;CHILENO;;Z;PENAFLOR;METROPOLITANA;0;0;0;0;0;0;0;0;0;CHIMENEA ELECTRICA KIOTO 2000W KTE-1101;CLIMATIZACION
7823806;Casado;M;66;CHILENO;;Boomers;RENCA                         ;METROPOLITANA;0;0;0;0;0;0;0;0;0;TERMOVENTILADOR CURVE TOWER;CLIMATIZACION
13774180;;F;42;CHILENO;;X;BUIN                          ;METROPOLITANA;0;0;0;0;0;0;0;0;0;Estufa a gas Kaly 15;CLIMATIZACION
10739481;;M;53;CHILENO;;X;PROVIDENCIA                   ;METROPOLITANA;0;0;0;0;0;0;0;0;0;ESTUFA ELECTRICA PORTATIL EEP-2200BLBLANCA;CLIMATIZACION
5418619;;F;74;CHILENO;;Silencioso;CURANILAHUE                   ;BIO BIO;0;0;0;0;0;0;0;0;0;ESTUFA ELECTRICA CUARZO KIOTO 1200W KTE 1033;CLIMATIZACION
26211620;;M;36;VENEZOLANO;;Extranjero;QUINTA NORMAL                 ;METROPOLITANA;0;0;0;0;0;0;0;0;0;TERMOVENTILADOR KIOTO BLANCO 2000W KTE-1028B;CLIMATIZACION
14463473;Casado;F;48;CHILENO;;X;RENCA                         ;METROPOLITANA;0;0;0;0;0;0;0;0;0;ESTUFA PARAFINA KPM-23;CLIMATIZACION
16196171;;F;37;CHILENO;;Millenial;"";"";0;0;0;0;0;0;0;0;0;CALIENTACAMAS ANALOGO BASICO 2 PL;CLIMATIZACION
15206134;;F;40;CHILENO;;X;LOS ANGELES                   ;BIO BIO;0;0;0;0;0;0;0;0;0;ESTUFA VITTALE-40 15K;CLIMATIZACION
7952551;Soltero;F;63;CHILENO;;Boomers;RENCA                         ;METROPOLITANA;0;0;0;0;0;0;0;0;0;TERMOVENTILADOR KFH-18 BL 2000W;CLIMATIZACION
20426920;;F;22;CHILENO;;Z;PROVIDENCIA                   ;METROPOLITANA;0;0;0;0;0;0;0;0;0;TERMOVENTILADOR KIOTO NEGRO 2000W KTE-1028N;CLIMATIZACION
18022889;Soltero;M;30;CHILENO;PSICOLOGO;Silencioso;PROVIDENCIA                   ;METROPOLITANA;0;0;0;0;0;0;0;0;0;ESTUFA ELECTRICA PORTATIL EEP-2200BLBLANCA;CLIMATIZACION
18569676;Soltero;F;28;CHILENO;;Millenial;PROVIDENCIA                   ;METROPOLITANA;0;0;0;0;0;0;0;0;0;ESTUFA ELEC. FIBRA DE CARBONO NSB120K5 ROJA;CLIMATIZACION
17666365;;F;31;CHILENO;;Millenial;PROVIDENCIA                   ;METROPOLITANA;0;0;0;0;0;0;0;0;0;TERMOVENTILADOR KIOTO NEGRO 2000W KTE-1028N;CLIMATIZACION
18384719;;F;29;CHILENO;;Millenial;LOS ANDES                     ;VALPARAISO;0;0;0;0;0;0;0;0;0;TERMOVENTILADOR NICROM VFH1000 BL 2000W;CLIMATIZACION
12549908;Soltero;F;48;CHILENO;PROFESOR;X;PROVIDENCIA                   ;METROPOLITANA;0;0;0;0;0;0;0;0;0;ESTUFA GAS SUNNY SR-6200 15K;CLIMATIZACION
18805728;;F;27;CHILENO;;Millenial;N/D;N/D;0;0;0;0;0;0;0;0;0;TERMOVENTILADOR KFH-18 BL 2000W;CLIMATIZACION
18154948;;F;30;CHILENO;;Millenial;CHILLAN                       ;BIO BIO;0;0;0;0;0;0;0;0;0;CONVECTOR UT N10;CLIMATIZACION
13299816;;M;48;CHILENO;;X;N/D;N/D;0;0;0;0;0;0;0;0;0;ESTUFA GAS KG5 5K NEGRO EUROPEA;CLIMATIZACION
6217177;Casado;M;71;CHILENO;;Silencioso;PROVIDENCIA                   ;METROPOLITANA;0;0;0;0;0;0;0;0;0;ESTUFA ELECTRICA CUARZO KIOTO 1200W KTE 1033;CLIMATIZACION
15204082;;F;38;CHILENO;;X;PUENTE ALTO                   ;METROPOLITANA;0;0;0;0;0;0;0;0;0;ESTUFA CUARZO KIOTO 800W KTE-011A;CLIMATIZACION
12399801;;F;49;CHILENO;;X;RENCA                         ;METROPOLITANA;0;0;0;0;0;0;0;0;0;TERMOVENTILADOR KIOTO NEGRO 2000W KTE-1028N;CLIMATIZACION
12100490;;M;53;CHILENO;;X;N/D;N/D;0;0;0;0;0;0;0;0;0;ESTUFA GAS KGQ15N 15K NEGRO EUROPEA;CLIMATIZACION
5003796;;M;74;CHILENO;;Silencioso;PROVIDENCIA                   ;METROPOLITANA;0;0;0;0;0;0;0;0;0;ESTUFA GAS EH2500 5K NEGRO;CLIMATIZACION
18370984;;M;28;CHILENO;;Millenial;N/D;N/D;0;0;0;0;0;0;0;0;0;ESTUFA FEL-1408 5K;CLIMATIZACION
11263377;Casado;F;54;CHILENO;;Silencioso;PROVIDENCIA                   ;METROPOLITANA;0;0;0;0;0;0;0;0;0;CALIENTACAMAS ANALOGO BASICO 1PL;CLIMATIZACION
19986187;;F;23;CHILENO;;Silencioso;PROVIDENCIA                   ;METROPOLITANA;0;0;0;0;0;0;0;0;0;ESTUFA ELECTRICA CUARZO KIOTO 1200W KTE 1033;CLIMATIZACION
16554931;Soltero;F;35;CHILENO;KINESIOLOGO;Millenial;PROVIDENCIA                   ;METROPOLITANA;0;0;0;0;0;0;0;0;0;ESTUFA A GAS UT GRX-4200 15 KILOS;CLIMATIZACION
16126772;;F;36;CHILENO;;Millenial;PROVIDENCIA                   ;METROPOLITANA;0;0;0;0;0;0;0;0;0;CHIMENEA ELECTRICA KIOTO 2000W KTE-1101;CLIMATIZACION
15398292;;F;40;CHILENO;;X;SAN BERNARDO                  ;METROPOLITANA;0;0;0;0;0;0;0;0;0;ESTUFA VITTALE-40 15K;CLIMATIZACION
9222027;;F;53;CHILENO;;X;TEMUCO                        ;ARAUCANIA;0;0;0;0;0;0;0;0;0;CALEFACTOR CONVECTOR EEP-2100BL;CLIMATIZACION
11401209;Casado;M;53;CHILENO;;X;RENCA                         ;METROPOLITANA;0;0;0;0;0;0;0;0;0;CALEFACTOR INFRAROJO GR2800 R NEGRO;CLIMATIZACION
16666570;;F;35;CHILENO;;Millenial;BUIN                          ;METROPOLITANA;0;0;0;0;0;0;0;0;0;TERMOVENTILADOR CERAMICO TH-CH40;CLIMATIZACION
6767297;;M;71;CHILENO;;Silencioso;RENCA                         ;METROPOLITANA;0;0;0;0;0;0;0;0;0;TERMOVENTILADOR TH-FH31 BLANCO 1000W-2000W;CLIMATIZACION
15773021;;F;38;CHILENO;;Millenial;N/D;N/D;0;0;0;0;0;0;0;0;0;CALEFACTOR LENA LIMIT350 CHARCOAL;CLIMATIZACION
14200605;;M;41;CHILENO;;X;N/D;N/D;0;0;0;0;0;0;0;0;0;ESTUFA VITTALE-40 15K;CLIMATIZACION
13485823;;F;44;CHILENO;;X;PUENTE ALTO                   ;METROPOLITANA;0;0;0;0;0;0;0;0;0;ESTUFA VITTALE-40 15K;CLIMATIZACION
14180161;;F;41;CHILENO;;X;PROVIDENCIA                   ;METROPOLITANA;0;0;0;0;0;0;0;0;0;VENTILADOR PEDESTAL KTP-1015;CLIMATIZACION
13165185;;F;46;CHILENO;;X;PROVIDENCIA                   ;METROPOLITANA;0;0;0;0;0;0;0;0;0;CALIENTACAMA KIOTO DIGITAL 2 PLAZAS KTC-1006;CLIMATIZACION
17048449;Soltero;M;33;CHILENO;;Silencioso;PROVIDENCIA                   ;METROPOLITANA;0;0;0;0;0;0;0;0;0;A/C FRIO/CALOR PORTATI 9000BTU;CLIMATIZACION
12375202;Casado;M;48;CHILENO;;X;RENCA                         ;METROPOLITANA;0;0;0;0;0;0;0;0;0;KIT INSTALACION VERTICAL 6X4MTS ACERO;CLIMATIZACION
8597224;;F;63;CHILENO;;Boomers;RENCA                         ;METROPOLITANA;0;0;0;0;0;0;0;0;0;TERMOVENTILADOR NICROM VFH300 BL 1800W;CLIMATIZACION
11373128;;M;53;CHILENO;;X;PORVENIR                      ;MAGALLANES;0;0;0;0;0;0;0;0;0;CALEFACTOR LENA LIMIT380 CHARCOAL;CLIMATIZACION
13067452;;F;46;CHILENO;;X;N/D;N/D;0;0;0;0;0;0;0;0;0;CALEFACTOR INFRAROJO GR2800 R NEGRO;CLIMATIZACION
11816764;;F;51;CHILENO;;X;IQUIQUE                       ;TARAPACA;0;0;0;0;0;0;0;0;0;VENTILADOR INDUSTRIAL KTI-1013;CLIMATIZACION
12378250;;F;48;CHILENO;;X;PUENTE ALTO                   ;METROPOLITANA;0;0;0;0;0;0;0;0;0;Ventilador BOX 12 Plastico KF-12B3;CLIMATIZACION
5917036;;F;78;CHILENO;;Silencioso;RENCA                         ;METROPOLITANA;0;0;0;0;0;0;0;0;0;Ventilador Sobremesa Plastico KF 9D;CLIMATIZACION
14086968;;F;40;CHILENO;;X;PROVIDENCIA                   ;METROPOLITANA;0;0;0;0;0;0;0;0;0;VENTILADOR WIND BREEZE PRO 2 EN 1;CLIMATIZACION
7275006;;M;65;CHILENO;;Boomers;"";"";0;0;0;0;0;0;0;0;0;Enfriador KSH-16R;CLIMATIZACION
13126674;;F;45;CHILENO;;X;SAN CARLOS                    ;BIO BIO;0;0;0;0;0;0;0;0;0;VENTILADOR PEDESTAL KTP-1015;CLIMATIZACION
18414502;;F;29;CHILENO;;Millenial;ARAUCO                        ;BIO BIO;0;0;0;0;0;0;0;0;0;VENTILADOR PEDESTAL 15569;CLIMATIZACION
15774357;;F;37;CHILENO;;Millenial;PROVIDENCIA                   ;METROPOLITANA;0;0;0;0;0;0;0;0;0;VENTILADOR WIND BREEZE (160S);CLIMATIZACION
15354587;;M;39;CHILENO;;Silencioso;PROVIDENCIA                   ;METROPOLITANA;0;0;0;0;0;0;0;0;0;VENTILADOR PEDESTAL KTP-1016;CLIMATIZACION
6053574;Casado;M;71;CHILENO;;Silencioso;RENCA                         ;METROPOLITANA;0;0;0;0;0;0;0;0;0;VENTILADOR VALORY VSF 9 SOBREMESA 9Â¿ 35W;CLIMATIZACION
13943631;Soltero;F;41;CHILENO;;X;PROVIDENCIA                   ;METROPOLITANA;0;0;0;0;0;0;0;0;0;V-AIRE PORTATIL MIDEA MPPD-12KHRN1;CLIMATIZACION
10465502;;F;59;CHILENO;;Boomers;N/D;N/D;0;0;0;0;0;0;0;0;0;VENTILADOR PEDESTAL KTP-1015;CLIMATIZACION
8988688;;M;62;CHILENO;;Boomers;SANTIAGO                      ;METROPOLITANA;0;0;0;0;0;0;0;0;0;ENFRIADOR Y HUMIFICADOR THOMAS Blanco/Negro;CLIMATIZACION
19636372;;F;25;CHILENO;;Z;PROVIDENCIA                   ;METROPOLITANA;0;0;0;0;0;0;0;0;0;ENFRIADOR Y HUMIFICADOR THOMAS Blanco/Negro;CLIMATIZACION
10042430;;F;56;CHILENO;;Boomers;RENCA                         ;METROPOLITANA;0;0;0;0;0;0;0;0;0;Ventilador Sobremesa Plastico KF 12D;CLIMATIZACION
7313700;;F;69;CHILENO;;Silencioso;SAN BERNARDO                  ;METROPOLITANA;0;0;0;0;0;0;0;0;0;VENTILADOR TURBO NVB802EA 8P;CLIMATIZACION
16104061;;M;37;CHILENO;;Millenial;QUILLOTA                      ;VALPARAISO;0;0;0;0;0;0;0;0;0;VENTILADOR PEDESTAL KTP-1015;CLIMATIZACION
9860938;;M;58;CHILENO;;Boomers;RENCA                         ;METROPOLITANA;0;0;0;0;0;0;0;0;0;VENTILADOR PEDESTAL KTP-1015;CLIMATIZACION
17656157;Soltero;M;31;CHILENO;;Millenial;PROVIDENCIA                   ;METROPOLITANA;0;0;0;0;0;0;0;0;0;VENTILADOR BOX 20 NEGRO 120W;CLIMATIZACION
7815288;Casado;F;63;CHILENO;;Boomers;PROVIDENCIA                   ;METROPOLITANA;0;0;0;0;0;0;0;0;0;VENTILADOR PEDESTAL KTP-1015;CLIMATIZACION
9047512;;F;56;CHILENO;;Boomers;SAN JAVIER                    ;MAULE;0;0;0;0;0;0;0;0;0;VENTILADOR VBF016 BOX 16 NEGRO;CLIMATIZACION
17136610;;M;33;CHILENO;;Millenial;MARCHIHUE                     ;L.G.B.OÂ´HIGGINS;0;0;0;0;0;0;0;0;0;VENTILADOR PEDESTAL KF-16P;CLIMATIZACION
6251684;;M;70;CHILENO;;Silencioso;PROVIDENCIA                   ;METROPOLITANA;0;0;0;0;0;0;0;0;0;VENTILADOR PEDESTAL KF-16P;CLIMATIZACION
14519104;;M;47;CHILENO;;Extranjero;CHIMBARONGO                   ;L.G.B.OÂ´HIGGINS;0;0;0;0;0;0;0;0;0;VENTILADOR THOMAS TH-12CM Sobre Mesa 12;CLIMATIZACION
12547970;Casado;M;47;CHILENO;;X;PROVIDENCIA                   ;METROPOLITANA;0;0;0;0;0;0;0;0;0;VENTILADOR PEDESTAL KTP-1015;CLIMATIZACION
11767780;;F;51;CHILENO;;X;PROVIDENCIA                   ;METROPOLITANA;0;0;0;0;0;0;0;0;0;VENTILADOR INDUSTRIAL KTI-1013;CLIMATIZACION
14007934;;M;41;CHILENO;;X;RENCA                         ;METROPOLITANA;0;0;0;0;0;0;0;0;0;VENTILADOR PEDESTAL KTP-1015;CLIMATIZACION
5493505;;F;81;CHILENO;;Silencioso;CURANILAHUE                   ;BIO BIO;0;0;0;0;0;0;0;0;0;CALIENTACAMA KIOTO DIGITAL 2 PLAZAS KTC-1006;CLIMATIZACION
10827455;;M;54;CHILENO;;Boomers;VINA DEL MAR                  ;VALPARAISO;0;0;0;0;0;0;0;0;0;VENTILADOR THOMAS TH-16CP Pedestal 16;CLIMATIZACION
10645447;;F;53;CHILENO;;X;PROVIDENCIA                   ;METROPOLITANA;0;0;0;0;0;0;0;0;0;VENTILADOR INDUSTRIAL KTI-1013;CLIMATIZACION
14410786;;F;56;CHILENO;;Boomers;NEGRETE                       ;BIO BIO;0;0;0;0;0;0;0;0;0;ESTUFA VITTALE-40 15K;CLIMATIZACION
15308390;;M;39;CHILENO;;X;PROVIDENCIA                   ;METROPOLITANA;0;0;0;0;0;0;0;0;0;CALIENTACAMA KIOTO DIGITAL 1 PLAZA KTC-1005;CLIMATIZACION
18224738;Soltero;M;29;CHILENO;;Millenial;PROVIDENCIA                   ;METROPOLITANA;0;0;0;0;0;0;0;0;0;ESTUFA CUARZO KIOTO 800W KTE-011A;CLIMATIZACION
10877234;;F;58;CHILENO;;Boomers;OSORNO                        ;LOS LAGOS;0;0;0;0;0;0;0;0;0;ESTUFA GAS KG5 5K NEGRO EUROPEA;CLIMATIZACION
17487156;;F;32;CHILENO;;Millenial;INDEPENDENCIA                 ;METROPOLITANA;0;0;0;0;0;0;0;0;0;VENTILADOR WIND BREEZE (160S);CLIMATIZACION
11536126;Casado;F;51;CHILENO;PSICOLOGO;X;PROVIDENCIA                   ;METROPOLITANA;0;0;0;0;0;0;0;0;0;CALIENTACAMAS ANALOGO BASICO 1PL;CLIMATIZACION
27450886;;M;34;VENEZOLANO;;Millenial;CASTRO;LOS LAGOS;61980;2;2;0;0;0;2;2;61980;AFEITADORA GAMA GSH986 SPORT;PERSONAL CARE
13074245;;M;46;CHILENO;;Millenial;PROVIDENCIA                   ;METROPOLITANA;296970;5;3;0;0;0;5;3;296970;ONDULADOR DE PELO SG-2420 33MM;PERSONAL CARE
17987716;;F;30;CHILENO;;Millenial;CAUQUENES                     ;MAULE;102960;4;4;1;1;34990;3;3;67970;ONDULADOR SIEGEN SG-2352;PERSONAL CARE
15165914;Soltero;F;40;CHILENO;;X;RENCA                         ;METROPOLITANA;24990;1;1;1;1;24990;0;0;0;ALISADOR DE PELO S6300 GRIS;PERSONAL CARE
19976350;;F;24;CHILENO;;Millenial;N/D;N/D;306220;7;3;0;0;0;7;3;306220;SECADOR DE PELO SG-3012 NEGRO;PERSONAL CARE
11760260;Divorciado;F;50;CHILENO;;X;RENCA                         ;METROPOLITANA;17990;1;1;0;0;0;1;1;17990;SECADOR DIAMOND STD;PERSONAL CARE
19364086;;M;25;CHILENO;;Z;LEBU                          ;BIO BIO;56060;2;1;0;0;0;2;1;56060;ALISADOR DE PELO S12A(220) Shine Therapy PALTA M;PERSONAL CARE
14489564;Soltero;M;48;CHILENO;;X;PROVIDENCIA                   ;METROPOLITANA;24990;1;1;0;0;0;1;1;24990;CORTA PELO SG-8410;PERSONAL CARE
16083037;Soltero;F;37;CHILENO;;Millenial;CALBUCO                       ;LOS LAGOS;53960;4;2;0;0;0;4;2;53960;CORTA PELO HC3505;PERSONAL CARE
19189310;;M;26;CHILENO;;Z;N/D;N/D;11990;1;1;0;0;0;1;1;11990;ONDULADOR SIEGEN SG-2352;PERSONAL CARE
16457097;;F;35;CHILENO;;Millenial;N/D;N/D;493960;4;3;0;0;0;4;3;493960;AFEITADORA GAMA SH 1527 WD;PERSONAL CARE
11144483;;M;54;CHILENO;;Boomers;NANCAGUA                      ;L.G.B.OÂ´HIGGINS;154960;4;3;0;0;0;4;3;154960;CORTA PELO GC-615;PERSONAL CARE
18225735;;F;30;CHILENO;;Millenial;N/D;N/D;19990;1;1;0;0;0;1;1;19990;SECADOR DE PELO SIEGEN SG-3035;PERSONAL CARE
7358065;;M;67;CHILENO;;Boomers;ANGOL                         ;ARAUCANIA;217980;2;2;0;0;0;2;2;217980;ALISADOR DE PELO SG-3512D1 ROSA;PERSONAL CARE
7147691;Soltero;M;66;CHILENO;;Boomers;CONCEPCION                    ;BIO BIO;230161;6;4;0;0;0;6;4;230161;CORTADOR DE PELO SIEGEN SG-8590;PERSONAL CARE
8974429;;F;63;CHILENO;;Boomers;COIHAIQUE                     ;AYSEN;548980;2;2;0;0;0;2;2;548980;ONDULADOR SIEGEN SG-2352;PERSONAL CARE
19128078;;F;25;CHILENO;;Z;PARRAL                        ;MAULE;158960;4;4;0;0;0;4;4;158960;ALISADOR DE PELO SG-4651 ROJO;PERSONAL CARE
10504058;;M;56;CHILENO;;Boomers;RENCA                         ;METROPOLITANA;219680;4;2;0;0;0;4;2;219680;CORTA PELO SG-8200;PERSONAL CARE
16275206;;F;36;CHILENO;;Millenial;N/D;N/D;39990;1;1;0;0;0;1;1;39990;ALISADOR DE PELO I X-WIDE ST TITAN KERATIN GRIS;PERSONAL CARE
13393384;;M;44;CHILENO;;X;CANETE                        ;BIO BIO;355433;7;5;0;0;0;7;5;355433;ALISADOR DE PELO S12A(220) Shine Therapy PALTA M;PERSONAL CARE
18031407;;F;30;CHILENO;;Millenial;EL MONTE                      ;METROPOLITANA;483940;6;5;5;4;464950;1;1;18990;SECADOR GAMA BRILLIAN AQUA;PERSONAL CARE
17980625;;F;30;CHILENO;;Millenial;CURICO;MAULE;81970;3;1;3;1;81970;0;0;0;ALISADOR DE PELO S12A(220) Shine Therapy PALTA M;PERSONAL CARE
13791322;;F;42;CHILENO;;X;CAUQUENES                     ;MAULE;23990;1;1;0;0;0;1;1;23990;ALISADOR SG-3510C12 BLANCO;PERSONAL CARE
25101116;;F;34;CHILENO;;Extranjero;SAN PEDRO DE LA PAZ;BIO-BIO;39990;1;1;1;1;39990;0;0;0;ALISADOR DE PELO S12A(220) Shine Therapy PALTA M;PERSONAL CARE
11797247;;F;51;CHILENO;;X;COLLIPULLI                    ;ARAUCANIA;38783;2;2;0;0;0;2;2;38783;ALISADOR DE PELO SG-3540 MORADO MORADO;PERSONAL CARE
22337594;;F;38;PERUANO;;Extranjero;ALTO HOSPICIO;TARAPACA;78500;5;2;0;0;0;5;2;78500;SECADOR DE PELO SG-3051;PERSONAL CARE
17722670;;F;31;CHILENO;;Millenial;"";"";22980;2;1;2;1;22980;0;0;0;SECADOR DE PELO SG-3012C23 VERDE;PERSONAL CARE
11244893;;F;54;CHILENO;;X;LEBU                          ;BIO BIO;128970;3;3;0;0;0;3;3;128970;Secador de Pelo 3000 Series Philips BHD340/10;PERSONAL CARE
9598867;Casado;M;57;CHILENO;TECNICO;Boomers;PROVIDENCIA                   ;METROPOLITANA;21990;1;1;0;0;0;1;1;21990;SECADOR DE PELO SG-3043 DC CAFE 2200 WATTS;PERSONAL CARE
13955034;;F;42;CHILENO;;X;CONCEPCION                    ;BIO BIO;316960;4;3;0;0;0;4;3;316960;DEPILADORA OASIS NEXT BVT;PERSONAL CARE
6639976;;M;70;CHILENO;;Silencioso;N/D;N/D;64980;2;2;0;0;0;2;2;64980;CORTA PELO GC-615;PERSONAL CARE
15679227;;F;38;CHILENO;;X;ANTOFAGASTA                   ;ANTOFAGASTA;154980;2;2;0;0;0;2;2;154980;CEPILLO MODELADOR SG-2803C02 NEGRO;PERSONAL CARE
19335855;;M;25;CHILENO;;Z;SAN ANTONIO                   ;VALPARAISO;206970;3;2;2;1;184980;1;1;21990;SECADOR GAMA BORA KERATION;PERSONAL CARE
27156866;;M;29;EXTRANJERO - NO INFORMA NACIONALIDAD;;Extranjero;N/D;N/D;368500;8;4;3;2;148530;5;2;219970;ALISADOR DE PELO S12A(220) Shine Therapy PALTA M;PERSONAL CARE
10810431;;M;53;CHILENO;;X;RENCA                         ;METROPOLITANA;11990;1;1;0;0;0;1;1;11990;CORTAPELO GAMA MG 566;PERSONAL CARE
8577840;;F;64;CHILENO;;Millenial;"";"";49180;4;1;0;0;0;4;1;49180;CORTAPELO GAMA MG 566;PERSONAL CARE
18987182;Soltero;F;27;CHILENO;;Z;PROVIDENCIA                   ;METROPOLITANA;14990;1;1;0;0;0;1;1;14990;SECADOR GAMA EOLIC MINI TRAVEL;PERSONAL CARE
7603257;;M;63;CHILENO;;Boomers;PROVIDENCIA                   ;METROPOLITANA;77220;3;2;0;0;0;3;2;77220;CORTA PELO SPORT GCX 623 BVT;PERSONAL CARE
20530009;;F;21;CHILENO;;Z;"";"";144123;3;2;0;0;0;3;2;144123;ALISADOR DE PELO SG-3510 FUCSIA;PERSONAL CARE
14329081;;F;49;CHILENO;;X;RENCA                         ;METROPOLITANA;21990;1;1;0;0;0;1;1;21990;SECADOR GAMA BORA KERATION;PERSONAL CARE
13620463;Casado;F;49;CHILENO;;X;RENCA                         ;METROPOLITANA;13990;1;1;0;0;0;1;1;13990;SECADOR DE PELO SG-3012 NEGRO;PERSONAL CARE
19030994;;F;27;CHILENO;;Z;PROVIDENCIA                   ;METROPOLITANA;44990;1;1;0;0;0;1;1;44990;ALISADOR X-WIDE DIGITAL KERATION;PERSONAL CARE
19029676;Soltero;M;26;CHILENO;;Z;"";"";29990;1;1;0;0;0;1;1;29990;CORTA PELO SPORT GCX 623 BVT;PERSONAL CARE
24354022;;M;40;BOLIVIANO;;Extranjero;TOCOPILLA                     ;ANTOFAGASTA;114210;6;2;0;0;0;6;2;114210;TRICOMBO SECADOR+ALISADOR+ONDULAD;PERSONAL CARE
18487577;;F;29;CHILENO;;Millenial;N/D;N/D;40980;2;1;0;0;0;2;1;40980;SECADOR DE PELO SG-3043 DC CAFE 2200 WATTS;PERSONAL CARE
7458369;Casado;F;71;CHILENO;;Silencioso;PROVIDENCIA                   ;METROPOLITANA;132950;5;5;0;0;0;5;5;132950;SECADOR DE PELO DIVA NEGRO;PERSONAL CARE
7448780;;F;68;CHILENO;;Boomers;CARAHUE                       ;ARAUCANIA;324840;5;2;0;0;0;5;2;324840;SECADOR DE PELO SG-3012C29 MORADO;PERSONAL CARE
15244794;;M;50;CHILENO;;X;"";"";35130;3;2;0;0;0;3;2;35130;AFEITADORA SG-7210 NEGRO;PERSONAL CARE
10300927;;F;59;CHILENO;;Boomers;CONCEPCION                    ;BIO BIO;167930;10;7;0;0;0;10;7;167930;CORTA PELO SG-8200;PERSONAL CARE
5767883;;F;71;CHILENO;;Silencioso;N/D;N/D;1692650;12;7;0;0;0;12;7;1692650;SECADOR DE PELO SE-3049C01 FUCSIA;PERSONAL CARE
26050130;Soltero;M;29;EXTRANJERO - NO INFORMA NACIONALIDAD;;Extranjero;PROVIDENCIA                   ;METROPOLITANA;112960;4;2;4;2;112960;0;0;0;ALISADOR REMIG. WET2 S27A (BV) R;PERSONAL CARE
16037321;;M;37;CHILENO;;Millenial;SAN MIGUEL;METROPOLITANA;33970;3;2;2;1;23980;1;1;9990;SECADOR DE PELO SIEGEN SG-3035;PERSONAL CARE
8658605;;M;59;CHILENO;;Boomers;PROVIDENCIA                   ;METROPOLITANA;26990;1;1;0;0;0;1;1;26990;SECADOR DE PELO SG-3049 NEGRO;PERSONAL CARE
16185834;;F;36;CHILENO;;Millenial;BULNES                        ;BIO BIO;193364;6;3;0;0;0;6;3;193364;SECADOR DE PELO SG-3049 NEGRO;PERSONAL CARE
13794075;;F;48;CHILENO;;X;"";"";100230;3;2;0;0;0;3;2;100230;SECADOR DE PELO SIEGEN SG-3035;PERSONAL CARE
19210297;;M;26;CHILENO;;Z;MALLOA                        ;L.G.B.OÂ´HIGGINS;105230;3;2;1;1;89990;2;1;15240;SECADOR DE PELO MISTRAL STD;PERSONAL CARE
14063590;;F;40;CHILENO;;X;N/D;N/D;19990;1;1;0;0;0;1;1;19990;ALISADOR MATCHA;PERSONAL CARE
18653675;;F;28;CHILENO;;Millenial;SAN BERNARDO                  ;METROPOLITANA;60230;3;2;0;0;0;3;2;60230;SECADOR DE PELO SIEGEN SG-3035;PERSONAL CARE
26334781;;M;26;VENEZOLANO;;Extranjero;N/D;N/D;59980;2;2;0;0;0;2;2;59980;SECADOR DE PELO SE-3049C01 FUCSIA;PERSONAL CARE
8753718;;F;63;CHILENO;;Boomers;VALPARAISO                    ;VALPARAISO;62710;3;1;0;0;0;3;1;62710;CORTA PELO SPORT GCX 623 BVT;PERSONAL CARE
13853810;;M;42;CHILENO;;X;LEBU                          ;BIO BIO;231352;4;2;0;0;0;4;2;231352;AFEITADORA GAMA SH 1527 WD;PERSONAL CARE
11247636;;F;55;CHILENO;;Boomers;VILLARICA                     ;ARAUCANIA;27990;1;1;0;0;0;1;1;27990;ALISADOR MATCHA;PERSONAL CARE
10969618;;F;53;CHILENO;;X;RENCA                         ;METROPOLITANA;29990;1;1;0;0;0;1;1;29990;SECADOR DE PELO SG-3051;PERSONAL CARE
13989279;;M;40;CHILENO;;X;COIHAIQUE                     ;AYSEN;17493;1;1;0;0;0;1;1;17493;SECADOR GAMA BORA KERATION;PERSONAL CARE
20023688;;F;23;CHILENO;;Z;LANCO                         ;LOS RIOS;199980;2;2;1;1;169990;1;1;29990;SECADOR DE PELO SG-3051;PERSONAL CARE
17074631;;F;33;CHILENO;;Millenial;CHEPICA                       ;L.G.B.OÂ´HIGGINS;227330;4;2;0;0;0;4;2;227330;SECADOR DE PELO SG-3012 NEGRO;PERSONAL CARE
18338288;;F;29;CHILENO;;Millenial;MAIPU                         ;METROPOLITANA;43980;2;1;0;0;0;2;1;43980;ALISADOR DE PELO SG-3510 FUCSIA;PERSONAL CARE
4097801;;M;80;CHILENO;;Silencioso;RENCA                         ;METROPOLITANA;60970;3;1;0;0;0;3;1;60970;AFEITADORA S1223/41 ELECTRICA;PERSONAL CARE
11904440;;M;51;CHILENO;;X;LOTA                          ;BIO BIO;78980;2;2;0;0;0;2;2;78980;SECADOR DE PELO SG-3049 NEGRO;PERSONAL CARE
19306850;Soltero;M;26;CHILENO;;Silencioso;PROVIDENCIA                   ;METROPOLITANA;188960;4;2;4;2;188960;0;0;0;MULTIGROOM MG5730 SERIE 5000;PERSONAL CARE
10367916;;M;54;CHILENO;;X;N/D;N/D;0;0;2;0;0;0;0;2;0;SECADOR GAMA EOLIC MINI TRAVEL;PERSONAL CARE
16144164;;F;37;CHILENO;;Millenial;N/D;N/D;313790;5;4;0;0;0;5;4;313790;AFEITADORA SH 887 WD BAT;PERSONAL CARE
15515608;;F;39;CHILENO;;X;CERRO NAVIA                   ;METROPOLITANA;237950;5;3;5;3;237950;0;0;0;SECADOR DE PELO SE-3049C01 FUCSIA;PERSONAL CARE
16809707;;F;34;CHILENO;;Millenial;PUENTE ALTO;METROPOLITANA;33980;2;1;2;1;33980;0;0;0;AFEITADORA SPORT SH 886 BAT;PERSONAL CARE
14337072;;F;45;CHILENO;;X;PICHIDEGUA                    ;L.G.B.OÂ´HIGGINS;98044;4;2;0;0;0;4;2;98044;AFEITADORA S1223/41 ELECTRICA;PERSONAL CARE
15090786;;F;40;CHILENO;;X;SAN FELIPE                    ;VALPARAISO;34990;1;1;0;0;0;1;1;34990;AFEITADORA SH 887 WD BAT;PERSONAL CARE
7316350;;M;68;CHILENO;;Silencioso;SAN BERNARDO                  ;METROPOLITANA;25000;2;1;0;0;0;2;1;25000;SECADOR DE PELO SE-3049C01 FUCSIA;PERSONAL CARE
18410196;;F;29;CHILENO;;Millenial;CORONEL                       ;BIO BIO;54990;1;1;0;0;0;1;1;54990;ALISADOR DE PELO SG-4651 ROJO;PERSONAL CARE
11856758;;M;51;CHILENO;;X;N/D;N/D;102483;2;2;0;0;0;2;2;102483;CORTA PELO SG-8520;PERSONAL CARE
11277589;;F;54;CHILENO;;X;"";"";130960;4;4;0;0;0;4;4;130960;SECADOR DE PELO SG-3012 NEGRO;PERSONAL CARE
7141323;;M;68;CHILENO;;Boomers;ANTOFAGASTA                   ;ANTOFAGASTA;71970;3;3;0;0;0;3;3;71970;SECADOR DE PELO SG-3051;PERSONAL CARE
10309761;;F;54;CHILENO;;Boomers;COPIAPO                       ;ATACAMA;14990;1;1;0;0;0;1;1;14990;Secador de Pelo 3000 Series Philips BHD302/00;PERSONAL CARE
19534008;;F;25;CHILENO;;Z;N/D;N/D;73980;2;2;0;0;0;2;2;73980;CORTA PELO SG-8520;PERSONAL CARE
16294502;;F;36;CHILENO;;Millenial;N/D;N/D;227940;6;4;0;0;0;6;4;227940;SPA PARA PIES SG-1560;PERSONAL CARE
5429085;;M;76;CHILENO;;Silencioso;TRAIGUEN                      ;ARAUCANIA;23710;3;1;0;0;0;3;1;23710;CORTABARBA BT3206;PERSONAL CARE
12370284;Casado;F;49;CHILENO;;X;RENCA                         ;METROPOLITANA;44990;1;1;0;0;0;1;1;44990;CORTA PELO HC-5850;PERSONAL CARE
18431579;Soltero;M;28;CHILENO;TECNICO DE NIVEL SUPERIOR EN LABORATORIO CLINICO Y BANCO DE SANGRE;Millenial;PROVIDENCIA                   ;METROPOLITANA;30240;2;1;0;0;0;2;1;30240;ALISADOR +SECADOR PELO;PERSONAL CARE
16975595;;F;33;CHILENO;;Millenial;N/D;N/D;273011;4;3;0;0;0;4;3;273011;SECADOR DE PELO SG-3051;PERSONAL CARE
19761468;;F;24;CHILENO;;Z;"";"";25000;2;1;0;0;0;2;1;25000;AFEITADORA SG-7250 NEGRO;PERSONAL CARE
12335050;;F;49;CHILENO;;X;VILLARICA                     ;ARAUCANIA;234902;5;3;0;0;0;5;3;234902;SECADOR DE PELO SG-3049 NEGRO;PERSONAL CARE
17757729;;M;31;CHILENO;;Millenial;LINARES                       ;MAULE;34990;1;1;0;0;0;1;1;34990;COMBO SIEGEN AFEITADORA + MULTISTYLER SG-8440;PERSONAL CARE
25851237;;F;35;VENEZOLANO;;Extranjero;SANTIAGO                      ;METROPOLITANA;12990;1;1;0;0;0;1;1;12990;SECADOR DE PELO SG-3012 NEGRO;PERSONAL CARE
7537022;;F;66;CHILENO;;Boomers;PADRE HURTADO                 ;METROPOLITANA;12990;1;1;0;0;0;1;1;12990;CORTAPELO GAMA MG 566;PERSONAL CARE
19496452;;M;25;CHILENO;;Z;TOCOPILLA                     ;ANTOFAGASTA;388980;2;2;1;1;359990;1;1;28990;SECADOR DE PELO SG-3049 NEGRO;PERSONAL CARE
16202284;;M;36;CHILENO;;Millenial;VILLARICA                     ;ARAUCANIA;24990;1;1;0;0;0;1;1;24990;CORTA PELO SG-8520;PERSONAL CARE
15372418;Soltero;M;40;CHILENO;;X;PROVIDENCIA                   ;METROPOLITANA;21980;2;1;2;1;21980;0;0;0;CORTAPELO Y BARBA TELEFUNKEN TF HC250;PERSONAL CARE
14680428;;F;46;PERUANO;;Extranjero;RECOLETA                      ;METROPOLITANA;26990;1;1;0;0;0;1;1;26990;SECADOR DE PELO SG-3049 NEGRO;PERSONAL CARE
19255973;;F;25;CHILENO;;Z;CONSTITUCION                  ;MAULE;31990;1;1;0;0;0;1;1;31990;CORTA PELO SG-8520;PERSONAL CARE
7798600;;F;63;CHILENO;;Boomers;QUILPUE                       ;VALPARAISO;368701;7;4;0;0;0;7;4;368701;SECADOR DE VIAJE REMINGTON D2400;PERSONAL CARE
10175230;;M;56;CHILENO;;Boomers;LOS ANGELES                   ;BIO BIO;30130;3;2;0;0;0;3;2;30130;SECADOR DE PELO SG-3012 NEGRO;PERSONAL CARE
23891460;;F;53;VENEZOLANO;;Extranjero;"";"";49410;2;1;0;0;0;2;1;49410;COMBO GAMA SECADOR+ALISADOR+CEPILLO;PERSONAL CARE
15311780;;M;40;CHILENO;;Millenial;SAN JOAQUIN;METROPOLITANA;24990;1;1;0;0;0;1;1;24990;ALISADOR GAMA BELLA SHINE;PERSONAL CARE
18624905;Soltero;F;28;CHILENO;;Millenial;TALAGANTE                     ;METROPOLITANA;674980;2;2;0;0;0;2;2;674980;SPA PARA PIES SG-1560;PERSONAL CARE
18400340;;F;29;CHILENO;;Millenial;N/D;N/D;39990;1;1;0;0;0;1;1;39990;CORTA PELO HC-5850;PERSONAL CARE
20424625;;M;22;CHILENO;;Z;PROVIDENCIA                   ;METROPOLITANA;119970;3;2;2;1;34980;1;1;84990;ALISADOR AQUA THERAPY LED;PERSONAL CARE
13450330;;F;44;CHILENO;;X;N/D;N/D;266950;6;4;0;0;0;6;4;266950;SECADOR PHILIPS BHC010;PERSONAL CARE
18040516;;F;30;CHILENO;;Millenial;"";"";354980;2;2;0;0;0;2;2;354980;ALISADOR DE PELO SG-3540 MORADO MORADO;PERSONAL CARE
17653553;;M;31;CHILENO;;Millenial;PROVIDENCIA                   ;METROPOLITANA;18990;1;1;0;0;0;1;1;18990;CORTAPELO GAMA MG 566;PERSONAL CARE
8947570;Casado;M;61;CHILENO;;Boomers;RENCA                         ;METROPOLITANA;36990;1;1;0;0;0;1;1;36990;AFEITADORA SG-7250 NEGRO;PERSONAL CARE
16918821;;M;34;CHILENO;;Millenial;PROVIDENCIA                   ;METROPOLITANA;64960;4;2;0;0;0;4;2;64960;ALISADOR DE PELO S12A(220) Shine Therapy PALTA M;PERSONAL CARE
8924065;;M;55;CHILENO;;Boomers;CONCEPCION                    ;BIO BIO;40150;3;1;0;0;0;3;1;40150;COMBO SIEGEN AFEITADORA + MULTISTYLER SG-8440;PERSONAL CARE
17625565;;F;31;CHILENO;;Millenial;PROVIDENCIA                   ;METROPOLITANA;34980;2;1;0;0;0;2;1;34980;SECADOR DE PELO SIEGEN SG-3035;PERSONAL CARE
12056494;;F;46;CHILENO;;X;HUALPEN;BIO-BIO;70970;3;3;3;1;70970;0;2;0;ALISADOR DE PELO SG-3540 MORADO MORADO;PERSONAL CARE
10481732;;F;56;CHILENO;;Boomers;DALCAHUE                      ;LOS LAGOS;96980;2;2;0;0;0;2;2;96980;SPA PARA PIES SG-1560;PERSONAL CARE
9715081;;F;48;CHILENO;;X;PROVIDENCIA                   ;METROPOLITANA;19990;1;1;0;0;0;1;1;19990;SECADOR DE PELO SIEGEN SG-3035;PERSONAL CARE
18031007;Soltero;F;30;CHILENO;;Millenial;PROVIDENCIA                   ;METROPOLITANA;44990;1;1;0;0;0;1;1;44990;COMBO SIEGEN AFEITADORA + MULTISTYLER SG-8440;PERSONAL CARE
11561259;;M;52;CHILENO;;X;CONSTITUCION                  ;MAULE;131970;3;2;0;0;0;3;2;131970;DEPILADORA BRE285/00 CONVENCIONAL;PERSONAL CARE
19696967;;M;24;CHILENO;;Z;PROVIDENCIA                   ;METROPOLITANA;44990;1;1;1;1;44990;0;0;0;ALISADOR DE PELO SG-4651 ROJO;PERSONAL CARE
15201811;;M;40;CHILENO;;X;CANETE                        ;BIO BIO;32990;1;1;0;0;0;1;1;32990;SECADOR DE PELO SG-3051;PERSONAL CARE
18281807;;M;29;CHILENO;;Millenial;ANCUD                         ;LOS LAGOS;95980;2;2;0;0;0;2;2;95980;CORTA PELO HC3505;PERSONAL CARE
18614370;;F;28;CHILENO;;Millenial;N/D;N/D;25500;4;2;0;0;0;4;2;25500;SECADOR DE PELO SG-3049 NEGRO;PERSONAL CARE
10904042;;M;52;CHILENO;;X;LLAILLAY                      ;VALPARAISO;26990;1;1;0;0;0;1;1;26990;SECADOR DE PELO SG-3049 NEGRO;PERSONAL CARE
12180296;;F;50;CHILENO;;X;CONCEPCION;BIO-BIO;35000;2;1;0;0;0;2;1;35000;Pack Depiladora BRE255/00 + Recortador HP6389/00;PERSONAL CARE
18620208;;M;28;CHILENO;;Millenial;TEMUCO;ARAUCANIA;335960;4;4;0;0;0;4;4;335960;SECADOR DE PELO SG-3049 NEGRO;PERSONAL CARE
17188039;;M;33;CHILENO;;Millenial;N/D;N/D;13990;1;1;0;0;0;1;1;13990;CORTA PELO SG-8200;PERSONAL CARE
14080045;;F;42;CHILENO;;X;LONCOCHE                      ;ARAUCANIA;24990;1;1;0;0;0;1;1;24990;SECADOR DE PELO SG-3051;PERSONAL CARE
18818846;;F;27;CHILENO;;Millenial;COIHAIQUE                     ;AYSEN;285970;3;3;0;0;0;3;3;285970;SECADOR DE PELO SG-3012C23 VERDE;PERSONAL CARE
15778981;;M;37;CHILENO;;Millenial;PROVIDENCIA                   ;METROPOLITANA;43980;2;2;0;0;0;2;2;43980;CORTA PELO SG-8410;PERSONAL CARE
11273103;;M;54;CHILENO;;X;ALHUE                         ;METROPOLITANA;74980;2;1;0;0;0;2;1;74980;ALISADOR X-WIDE DIGITAL KERATION;PERSONAL CARE
11983307;;M;50;CHILENO;;X;CONSTITUCION                  ;MAULE;417160;4;2;0;0;0;4;2;417160;ALISADOR REMIG. WET2 S27A (BV) R;PERSONAL CARE
12320995;Casado;F;48;CHILENO;;Silencioso;PROVIDENCIA                   ;METROPOLITANA;21990;1;1;0;0;0;1;1;21990;SECADOR GAMA BRILLIAN AQUA;PERSONAL CARE
13381976;;F;44;CHILENO;;X;LA CISTERNA                   ;METROPOLITANA;19990;1;1;0;0;0;1;1;19990;SECADOR DE PELO SG-3043 DC CAFE 2200 WATTS;PERSONAL CARE
19410180;;M;25;CHILENO;;Z;TIERRA AMARILLA               ;ATACAMA;39990;1;1;1;1;39990;0;0;0;COMBO SIEGEN AFEITADORA + MULTISTYLER SG-8440;PERSONAL CARE
16744694;Soltero;F;34;CHILENO;PROFESOR;Millenial;PROVIDENCIA                   ;METROPOLITANA;64990;1;1;0;0;0;1;1;64990;ALISADOR SIEGEN SG-4716;PERSONAL CARE
13898510;Soltero;F;42;CHILENO;PERIODISTA;X;PROVIDENCIA                   ;METROPOLITANA;99990;2;1;2;1;99990;0;0;0;DEPILADORA IPL Allevia;PERSONAL CARE
8847503;;F;61;CHILENO;;Extranjero;AISEN                         ;AYSEN;10990;1;1;0;0;0;1;1;10990;SECADOR DE PELO STD TITAN KERATIN PLATA;PERSONAL CARE
13647927;;F;42;CHILENO;;X;N/D;N/D;54990;1;1;0;0;0;1;1;54990;DEPILADORA BRE700/00 MID-END CLOSED BOX;PERSONAL CARE
19942435;;F;23;CHILENO;;Z;PROVIDENCIA                   ;METROPOLITANA;16990;1;1;0;0;0;1;1;16990;SECADOR DE VIAJE REMINGTON D2400;PERSONAL CARE
15825363;;M;38;CHILENO;;Millenial;N/D;N/D;220970;3;2;3;2;220970;0;0;0;DEPILADORA BRE700/00 MID-END CLOSED BOX;PERSONAL CARE
10751905;;M;52;CHILENO;;X;CORONEL                       ;BIO BIO;9990;1;1;0;0;0;1;1;9990;SECADOR DE PELO SG-3012 NEGRO;PERSONAL CARE
18554096;;M;28;CHILENO;;Millenial;QUILPUE                       ;VALPARAISO;34990;1;1;0;0;0;1;1;34990;ALISADOR DE PELO SG-4651 ROJO;PERSONAL CARE
27065147;;M;49;EXTRANJERO - NO INFORMA NACIONALIDAD;;Extranjero;"";"";910430;10;5;6;2;748180;4;3;162250;CORTA PELO SPORT GCX 623 BVT;PERSONAL CARE
19724193;;F;24;CHILENO;;Z;"";"";43990;3;1;0;0;0;3;1;43990;ALISADOR DE PELO SG-3512D1 ROSA;PERSONAL CARE
18064861;;F;30;CHILENO;;Millenial;SAN JAVIER;MAULE;20283;2;1;2;1;20283;0;0;0;ALISADOR PELO FINA CP1;PERSONAL CARE
6839019;;M;69;CHILENO;;Silencioso;PROVIDENCIA                   ;METROPOLITANA;21990;1;1;0;0;0;1;1;21990;SECADOR DE PELO SG-3043 DC CAFE 2200 WATTS;PERSONAL CARE
14243620;;F;52;CHILENO;;X;N/D;N/D;74980;2;2;0;0;0;2;2;74980;AFEITADORA SPORT;PERSONAL CARE
26569726;;M;36;EXTRANJERO - NO INFORMA NACIONALIDAD;;Extranjero;N/D;N/D;113390;5;2;0;0;0;5;2;113390;CORTA PELO GC-615;PERSONAL CARE
18737784;;F;28;CHILENO;;Millenial;"";"";34240;4;2;0;0;0;4;2;34240;SECADOR DE PELO SE-3049C01 FUCSIA;PERSONAL CARE
20253135;;F;22;CHILENO;;Z;N/D;N/D;26980;2;1;0;0;0;2;1;26980;ALISADOR DE PELO SG-3510 FUCSIA;PERSONAL CARE
25641886;;F;29;CHILENO;;Extranjero;SANTIAGO                      ;METROPOLITANA;69980;2;2;2;2;69980;0;0;0;ALISADOR DE PELO S12A(220) Shine Therapy PALTA M;PERSONAL CARE
14313846;;M;46;CHILENO;;X;OVALLE                        ;COQUIMBO;194980;2;2;0;0;0;2;2;194980;AFEITADORA SPORT SH 886 BAT;PERSONAL CARE
12778883;;F;48;CHILENO;;X;LITUECHE                      ;L.G.B.OÂ´HIGGINS;136970;3;2;0;0;0;3;2;136970;SECADOR TEMPO TITAN KERATIN;PERSONAL CARE
18873146;;F;28;CHILENO;;Millenial;N/D;N/D;34990;1;1;0;0;0;1;1;34990;TRICOMBO SECADOR+ALISADOR+ONDULADOR;PERSONAL CARE
11353695;;F;53;CHILENO;;X;HUALPEN;BIO BIO;82220;4;4;0;0;0;4;4;82220;Pack depiladoras HP6306/00 + BRE225/00;PERSONAL CARE
14345249;;F;44;CHILENO;;X;SAN JAVIER                    ;MAULE;234550;4;3;0;0;0;4;3;234550;AFEITADORA SG-7210 NEGRO;PERSONAL CARE
9686221;Casado;M;59;CHILENO;;Boomers;PROVIDENCIA                   ;METROPOLITANA;19990;1;1;0;0;0;1;1;19990;SECADOR DE PELO SG-3043 DC CAFE 2200 WATTS;PERSONAL CARE
9849370;;F;58;CHILENO;;Boomers;LINARES                       ;MAULE;12990;1;1;0;0;0;1;1;12990;SECADOR DE PELO SG-3012C29 MORADO;PERSONAL CARE
16267204;Soltero;M;36;CHILENO;;Millenial;PROVIDENCIA                   ;METROPOLITANA;41980;2;1;0;0;0;2;1;41980;ALISADOR +SECADOR PELO;PERSONAL CARE
18342567;;F;29;CHILENO;;Millenial;PROVIDENCIA                   ;METROPOLITANA;38980;2;1;2;1;38980;0;0;0;COMBO GAMA SECADOR+ALISADOR+CEPILLO;PERSONAL CARE
11588618;Soltero;F;51;CHILENO;;X;RENCA                         ;METROPOLITANA;38980;2;2;0;0;0;2;2;38980;SECADOR DE PELO SG-3051;PERSONAL CARE
8059382;;F;63;CHILENO;;Boomers;VALLENAR;ATACAMA;45980;2;2;0;0;0;2;2;45980;CORTA PELO SG-8520;PERSONAL CARE
18833878;;M;27;CHILENO;;Millenial;RANCAGUA                      ;L.G.B.OÂ´HIGGINS;29990;1;1;0;0;0;1;1;29990;AFEITADORA SPORT SH 886 BAT;PERSONAL CARE
14547713;;M;43;CHILENO;;X;PROVIDENCIA                   ;METROPOLITANA;44980;2;1;2;1;44980;0;0;0;CORTA PELO HC-5850;PERSONAL CARE
17632211;;M;31;CHILENO;;Millenial;CASTRO                        ;LOS LAGOS;65970;3;2;0;0;0;3;2;65970;ALISADOR DE PELO SG-3510 FUCSIA;PERSONAL CARE
13813955;;F;42;CHILENO;;X;VILLARICA                     ;ARAUCANIA;25990;1;1;0;0;0;1;1;25990;SECADOR GAMA BORA KERATION;PERSONAL CARE
6740604;Casado;M;71;CHILENO;;Silencioso;PROVIDENCIA                   ;METROPOLITANA;34990;1;1;0;0;0;1;1;34990;AFEITADORA SG-7250 NEGRO;PERSONAL CARE
11151970;;M;55;CHILENO;;Boomers;PROVIDENCIA                   ;METROPOLITANA;45960;4;2;0;0;0;4;2;45960;SECADOR DE PELO SG-3043 DC CAFE 2200 WATTS;PERSONAL CARE
8414445;;F;50;CHILENO;;X;CASTRO                        ;LOS LAGOS;340960;4;4;0;0;0;4;4;340960;SECADOR DE VIAJE REMINGTON D2400;PERSONAL CARE
7166304;;M;69;CHILENO;;Silencioso;TEMUCO                        ;ARAUCANIA;263950;5;3;0;0;0;5;3;263950;AFEITADORA SG-7250 NEGRO;PERSONAL CARE
18260943;;M;31;CHILENO;;Millenial;PROVIDENCIA                   ;METROPOLITANA;14990;1;1;0;0;0;1;1;14990;SECADOR DE VIAJE REMINGTON D2400;PERSONAL CARE
11316766;;F;54;CHILENO;;X;MAIPU                         ;METROPOLITANA;23240;2;1;0;0;0;2;1;23240;SECADOR GAMA BORA KERATION;PERSONAL CARE
16082086;;M;37;CHILENO;;Millenial;RENCA                         ;METROPOLITANA;16990;1;1;1;1;16990;0;0;0;CORTA PELO SPORT GCX 623 BVT;PERSONAL CARE
12669529;;M;47;CHILENO;;X;PENALOLEN;METROPOLITANA;34990;1;1;1;1;34990;0;0;0;CORTA PELO MGK3220 BLACK BOX MN;PERSONAL CARE
16638416;Soltero;F;35;CHILENO;;Millenial;EL QUISCO                     ;VALPARAISO;1060960;4;4;0;0;0;4;4;1060960;DEPILADORA SG-9004EX;PERSONAL CARE
12846845;;F;46;CHILENO;;X;VALPARAISO                    ;VALPARAISO;44980;2;1;0;0;0;2;1;44980;SECADOR DE PELO SE-3049C01 FUCSIA;PERSONAL CARE
9295642;Casado;F;60;CHILENO;;Boomers;RENCA                         ;METROPOLITANA;21990;1;1;0;0;0;1;1;21990;AFEITADORA SPORT;PERSONAL CARE
12873573;;F;47;CHILENO;;X;N/D;N/D;19990;1;1;0;0;0;1;1;19990;SECADOR DE PELO SIEGEN SG-3035;PERSONAL CARE
16918052;;F;33;CHILENO;;Millenial;CATEMU                        ;VALPARAISO;19990;1;1;0;0;0;1;1;19990;SECADOR DE PELO SIEGEN SG-3035;PERSONAL CARE
12796590;;M;46;CHILENO;;X;CAUQUENES                     ;MAULE;36990;1;1;0;0;0;1;1;36990;AFEITADORA SG-7250 NEGRO;PERSONAL CARE
10958301;;F;48;CHILENO;;X;ILLAPEL                       ;COQUIMBO;44980;2;2;1;1;14990;1;1;29990;ALISADOR DE PELO SG-3540 MORADO MORADO;PERSONAL CARE
16827885;;F;34;CHILENO;;Millenial;RETIRO                        ;MAULE;34990;1;1;0;0;0;1;1;34990;TRICOMBO SECADOR+ALISADOR+ONDULADOR;PERSONAL CARE
10956984;;F;58;CHILENO;;Boomers;TALCA                         ;MAULE;40980;2;2;0;0;0;2;2;40980;SECADOR GAMA EOLIC MINI TRAVEL;PERSONAL CARE
8434557;;M;49;CHILENO;;X;RENCA                         ;METROPOLITANA;29990;1;1;0;0;0;1;1;29990;SECADOR DE PELO SG-3051;PERSONAL CARE
14191782;;F;41;CHILENO;;X;SAN BERNARDO                  ;METROPOLITANA;621920;8;5;0;0;0;8;5;621920;DEPILADORA SG-9004;PERSONAL CARE
6216034;;F;74;CHILENO;;Silencioso;CASTRO                        ;LOS LAGOS;77325;8;3;0;0;0;8;3;77325;SECADOR DE PELO SG-3012 NEGRO;PERSONAL CARE
8016145;;F;55;CHILENO;;Boomers;"";"";26990;1;1;0;0;0;1;1;26990;CORTA PELO SPORT GCX 623 BVT;PERSONAL CARE
20208737;;F;23;CHILENO;;Z;PROVIDENCIA                   ;METROPOLITANA;326970;3;2;2;1;296980;1;1;29990;ALISADOR DE PELO SG-3540 MORADO MORADO;PERSONAL CARE
14407472;;F;53;CHILENO;;X;CONSTITUCION                  ;MAULE;72970;3;3;0;0;0;3;3;72970;Secador de Pelo 3000 Series Philips BHD302/00;PERSONAL CARE
20515664;;F;21;CHILENO;;Z;PROVIDENCIA                   ;METROPOLITANA;49980;2;2;0;0;0;2;2;49980;ALISADOR +SECADOR PELO;PERSONAL CARE
15666455;Soltero;M;38;CHILENO;PERIODISTA;Millenial;RENCA                         ;METROPOLITANA;12990;1;1;0;0;0;1;1;12990;SECADOR DE PELO SG-3012 NEGRO;PERSONAL CARE
17851445;Soltero;F;31;CHILENO;PROFESOR;Millenial;PROVIDENCIA                   ;METROPOLITANA;29990;1;1;0;0;0;1;1;29990;DEPILADORA OASIS LOOK BVT;PERSONAL CARE
10526938;;M;56;CHILENO;;Boomers;EL MONTE                      ;METROPOLITANA;12990;1;1;0;0;0;1;1;12990;SECADOR DE PELO SG-3012 NEGRO;PERSONAL CARE
17345396;;M;32;CHILENO;;Millenial;PROVIDENCIA                   ;METROPOLITANA;12990;1;1;0;0;0;1;1;12990;CORTA PELO SG-8200;PERSONAL CARE
17729795;;M;31;CHILENO;;Millenial;TALCA                         ;MAULE;29990;1;1;0;0;0;1;1;29990;CORTA PELO SG-8520;PERSONAL CARE
16403739;;F;36;CHILENO;;Millenial;PROVIDENCIA                   ;METROPOLITANA;66990;1;1;0;0;0;1;1;66990;DEPILADORA SES 5/500 PINK BOX MN;PERSONAL CARE
16448473;;M;36;CHILENO;;Millenial;CHONCHI                       ;LOS LAGOS;361970;3;4;0;0;0;3;4;361970;CORTA PELO SG-8520;PERSONAL CARE
13575863;;F;42;CHILENO;;X;SAN FERNANDO                  ;L.G.B.OÂ´HIGGINS;49990;1;1;0;0;0;1;1;49990;DEPILADORA BRE285/00 CONVENCIONAL;PERSONAL CARE
13299809;Casado;F;48;CHILENO;;X;MELIPILLA                     ;METROPOLITANA;23990;1;1;0;0;0;1;1;23990;DEPILADORA GAMA ESSENCIAL;PERSONAL CARE
7158929;;F;69;CHILENO;;Silencioso;BUIN                          ;METROPOLITANA;24990;1;1;0;0;0;1;1;24990;SECADOR DE PELO SE-3049C01 FUCSIA;PERSONAL CARE
13543933;;M;42;CHILENO;;X;RENCA                         ;METROPOLITANA;24990;1;1;0;0;0;1;1;24990;SECADOR DE PELO DIVA NEGRO;PERSONAL CARE
15698190;;F;38;CHILENO;;X;CHIMBARONGO                   ;L.G.B.OÂ´HIGGINS;44990;1;1;0;0;0;1;1;44990;ALISADOR DE PELO S12A(220) Shine Therapy PALTA M;PERSONAL CARE
19371273;;F;25;CHILENO;;Z;N/D;N/D;1431680;7;4;2;1;275840;5;3;1155840;CORTAPELOS GM 596;PERSONAL CARE
11066066;;M;56;CHILENO;;Extranjero;CASABLANCA                    ;VALPARAISO;24990;1;1;0;0;0;1;1;24990;SECADOR DE PELO SE-3049C01 FUCSIA;PERSONAL CARE
6123677;Casado;F;75;CHILENO;;Silencioso;RENCA                         ;METROPOLITANA;29990;1;1;0;0;0;1;1;29990;AFEITADORA SG-7250 NEGRO;PERSONAL CARE
14375471;;M;47;CHILENO;;X;N/D;N/D;145970;3;4;0;0;0;3;4;145970;CORTA PELO HC3505;PERSONAL CARE
17526269;;F;30;CHILENO;;Millenial;PEUMO                         ;L.G.B.OÂ´HIGGINS;86970;3;1;0;0;0;3;1;86970;ALISADOR DE PELO S12A(220) Shine Therapy PALTA M;PERSONAL CARE
15289402;Soltero;M;31;CHILENO;;Millenial;PROVIDENCIA                   ;METROPOLITANA;328970;3;2;0;0;0;3;2;328970;AFEITADORA S1121/41 ELECTRICA;PERSONAL CARE
17657439;;F;31;CHILENO;;Millenial;LA LIGUA                      ;VALPARAISO;262960;4;2;3;1;244970;1;1;17990;SECADOR GAMA BRILLIAN AQUA;PERSONAL CARE
12770767;;F;47;CHILENO;;X;OVALLE                        ;COQUIMBO;10000;2;1;0;0;0;2;1;10000;SECADOR DE PELO SG-3025 SILVER;PERSONAL CARE
18039486;;F;30;CHILENO;;Millenial;RENCA                         ;METROPOLITANA;34990;1;1;0;0;0;1;1;34990;CORTA PELO MGK3220 BLACK BOX MN;PERSONAL CARE
13361325;;M;44;CHILENO;;X;RENCA                         ;METROPOLITANA;26990;1;1;0;0;0;1;1;26990;ALISADOR +SECADOR PELO;PERSONAL CARE
12150625;;F;52;CHILENO;;X;NUNOA                         ;METROPOLITANA;25980;2;1;2;1;25980;0;0;0;CEPILLO ALISADOR SIEGEN SG-2805;PERSONAL CARE
17689856;;F;31;CHILENO;;Millenial;PROVIDENCIA                   ;METROPOLITANA;29990;1;1;0;0;0;1;1;29990;DEPILADORA BRE255/00;PERSONAL CARE
11060003;;F;55;CHILENO;;Silencioso;PROVIDENCIA                   ;METROPOLITANA;40980;2;2;0;0;0;2;2;40980;ALISADOR PHILIPS BHS376;PERSONAL CARE
13632111;;F;46;CHILENO;;X;RENCA                         ;METROPOLITANA;16990;1;1;0;0;0;1;1;16990;SECADOR DE VIAJE REMINGTON D2400;PERSONAL CARE
19248559;;M;26;CHILENO;;Z;LA UNION                      ;LOS RIOS;264970;3;2;0;0;0;3;2;264970;AFEITADORA SPORT;PERSONAL CARE
7249851;;F;68;CHILENO;;Silencioso;CHEPICA                       ;L.G.B.OÂ´HIGGINS;0;0;2;0;0;0;0;2;0;CORTAPELOS GM 596;PERSONAL CARE
18443648;;F;28;CHILENO;;Millenial;PROVIDENCIA                   ;METROPOLITANA;32990;1;1;0;0;0;1;1;32990;ALISADOR AQUA THERAPY LED;PERSONAL CARE
15615204;;F;38;CHILENO;;Millenial;CORONEL                       ;BIO BIO;36990;1;1;0;0;0;1;1;36990;TRICOMBO SECADOR+ALISADOR+ONDULADOR;PERSONAL CARE
17410556;;M;32;CHILENO;;Millenial;PROVIDENCIA                   ;METROPOLITANA;13990;1;1;0;0;0;1;1;13990;SECADOR DE PELO SG-3012 NEGRO;PERSONAL CARE
16466493;;F;36;CHILENO;;Millenial;ARICA                         ;TARAPACA;64980;2;1;0;0;0;2;1;64980;ALISADOR DE PELO S12A(220) Shine Therapy PALTA M;PERSONAL CARE
17359848;;M;32;CHILENO;;Millenial;N/D;N/D;84980;2;2;0;0;0;2;2;84980;CORTAPELOS GM 596;PERSONAL CARE
25084222;;F;59;COLOMBIANO;;Extranjero;VALDIVIA                      ;LOS LAGOS;26990;1;1;0;0;0;1;1;26990;SECADOR DE PELO SE-3049C01 FUCSIA;PERSONAL CARE
18965799;;M;27;CHILENO;;Z;CHANCO                        ;MAULE;19990;1;1;0;0;0;1;1;19990;KIT CORTABARBA MG3711;PERSONAL CARE
15058834;;M;38;CHILENO;;X;CABILDO                       ;VALPARAISO;26990;1;1;0;0;0;1;1;26990;CORTA PELO SPORT GCX 623 BVT;PERSONAL CARE
25212593;;F;33;PERUANO;;Extranjero;N/D;N/D;685020;6;2;0;0;0;6;2;685020;CORTA PELO SG-8410;PERSONAL CARE
10550682;;M;57;CHILENO;;Boomers;PROVIDENCIA                   ;METROPOLITANA;12990;1;1;0;0;0;1;1;12990;CORTA PELO SG-8200;PERSONAL CARE
14033588;;F;41;CHILENO;;X;PROVIDENCIA                   ;METROPOLITANA;18990;1;1;0;0;0;1;1;18990;SECADOR DE PELO D3019 PRO TITANIO;PERSONAL CARE
18414749;;F;29;CHILENO;;Millenial;N/D;N/D;47990;1;1;0;0;0;1;1;47990;DEPILADORA OASIS SENSATION;PERSONAL CARE
16371738;;F;36;CHILENO;;Millenial;N/D;N/D;43980;2;1;2;1;43980;0;0;0;ALISADOR DE PELO S12A(220) Shine Therapy PALTA M;PERSONAL CARE
18499838;Soltero;F;28;CHILENO;;Millenial;PROVIDENCIA                   ;METROPOLITANA;34990;1;1;1;1;34990;0;0;0;DEPILADORA OASIS NEXT BVT;PERSONAL CARE
14459104;;F;48;CHILENO;;X;VALLENAR;ATACAMA;38990;1;1;0;0;0;1;1;38990;AFEITADORA SH 887 WD BAT;PERSONAL CARE
8353512;;F;65;CHILENO;;Boomers;PROVIDENCIA                   ;METROPOLITANA;36990;1;1;0;0;0;1;1;36990;AFEITADORA SH 887 WD BAT;PERSONAL CARE
19477180;;F;25;CHILENO;;Z;TEMUCO                        ;ARAUCANIA;97540;5;3;0;0;0;5;3;97540;CORTADOR DE PELO SIEGEN SG-8590;PERSONAL CARE
13394814;;M;44;CHILENO;;X;PROVIDENCIA                   ;METROPOLITANA;88980;2;1;0;0;0;2;1;88980;DEPILADORA IPL MAGNA PK;PERSONAL CARE
18433034;;M;29;CHILENO;;Millenial;"";"";54990;1;1;0;0;0;1;1;54990;ALISADOR DE PELO SG-4651 ROJO;PERSONAL CARE
18952837;;M;26;CHILENO;;Z;ILLAPEL                       ;COQUIMBO;25240;2;1;0;0;0;2;1;25240;ALISADOR +SECADOR PELO;PERSONAL CARE
15017128;;M;40;CHILENO;;X;CALAMA                        ;ANTOFAGASTA;24990;1;1;0;0;0;1;1;24990;AFEITADORA S1121/41 ELECTRICA;PERSONAL CARE
17222862;;M;33;CHILENO;;Millenial;N/D;N/D;395920;5;4;3;1;361680;2;3;34240;DEPILADORA GAMA ESSENCIAL;PERSONAL CARE
18580876;Soltero;M;28;CHILENO;;Millenial;PROVIDENCIA                   ;METROPOLITANA;25980;2;1;0;0;0;2;1;25980;CORTAPELO GAMA TITANIUM T827;PERSONAL CARE
12830897;Casado;F;46;CHILENO;;X;PROVIDENCIA                   ;METROPOLITANA;23990;1;1;0;0;0;1;1;23990;DEPILADORA GAMA ESSENCIAL;PERSONAL CARE
17331746;;F;33;CHILENO;;Millenial;PROVIDENCIA                   ;METROPOLITANA;317970;3;2;0;0;0;3;2;317970;AFEITADORA 3000BT NEGRA;PERSONAL CARE
9024653;;M;60;CHILENO;;Boomers;AISEN                         ;AYSEN;16990;1;1;0;0;0;1;1;16990;CORTA PELO HC3505;PERSONAL CARE
10663174;;M;53;CHILENO;;X;OVALLE                        ;COQUIMBO;654980;2;2;1;1;629990;1;1;24990;ALISADOR DE PELO SG-3512D1 ROSA;PERSONAL CARE
16793597;;M;34;CHILENO;;Millenial;SAN JAVIER                    ;MAULE;29990;1;1;0;0;0;1;1;29990;AFEITADORA S1223/41 ELECTRICA;PERSONAL CARE
15191338;;M;36;CHILENO;;Millenial;PROVIDENCIA                   ;METROPOLITANA;38990;1;1;0;0;0;1;1;38990;COMBO GAMA SECADOR+ALISADOR+CEPILLO;PERSONAL CARE
16958479;;F;32;CHILENO;;Millenial;PROVIDENCIA                   ;METROPOLITANA;26990;1;1;0;0;0;1;1;26990;DEPILADORA SG-9004;PERSONAL CARE
16162054;;F;36;CHILENO;;Millenial;RENCA                         ;METROPOLITANA;26990;1;1;0;0;0;1;1;26990;SECADOR DE PELO SE-3049C01 FUCSIA;PERSONAL CARE
12713734;;F;49;CHILENO;;X;PROVIDENCIA                   ;METROPOLITANA;23990;1;1;0;0;0;1;1;23990;DEPILADORA GAMA ESSENCIAL;PERSONAL CARE
9593969;;F;61;CHILENO;;Boomers;N/D;N/D;176970;3;2;0;0;0;3;2;176970;ALISADOR DE PELO SG-3512D1 ROSA;PERSONAL CARE
16295002;;F;36;CHILENO;;Millenial;CANETE                        ;BIO BIO;57980;2;2;0;0;0;2;2;57980;COMBO GAMA SECADOR+ALISADOR+CEPILLO;PERSONAL CARE
10880791;;F;54;CHILENO;;Boomers;PROVIDENCIA                   ;METROPOLITANA;126980;3;2;0;0;0;3;2;126980;ALISADOR DE PELO SG-3540 MORADO MORADO;PERSONAL CARE
11275101;Casado;F;53;CHILENO;;X;RENCA                         ;METROPOLITANA;19990;1;1;0;0;0;1;1;19990;DEPILADORA SG-9003;PERSONAL CARE
10013791;;M;55;CHILENO;;Boomers;N/D;N/D;20990;1;1;0;0;0;1;1;20990;CORTA PELO SG-8410;PERSONAL CARE
10296213;;F;53;CHILENO;;X;PUERTO MONTT                  ;LOS LAGOS;42980;2;2;0;0;0;2;2;42980;SECADOR DE PELO SG-3012 NEGRO;PERSONAL CARE
16364675;;F;35;CHILENO;;Millenial;COIHAIQUE                     ;AYSEN;32990;1;1;0;0;0;1;1;32990;ALISADOR AQUA THERAPY LED;PERSONAL CARE
16732718;;F;34;CHILENO;;Millenial;VALLENAR;ATACAMA;29990;1;1;0;0;0;1;1;29990;DEPILADORA BRE255/00;PERSONAL CARE
18574175;;M;28;CHILENO;;Millenial;CONSTITUCION                  ;MAULE;54980;2;3;0;0;0;2;3;54980;ALISADOR DE PELO I X-WIDE ST TITAN KERATIN GRIS;PERSONAL CARE
8703767;;F;58;CHILENO;;Boomers;RENCA                         ;METROPOLITANA;34990;1;1;0;0;0;1;1;34990;ALISADOR DE PELO SG-3540 MORADO MORADO;PERSONAL CARE
10795028;;M;55;CHILENO;;Boomers;SALAMANCA                     ;COQUIMBO;407460;3;2;0;0;0;3;2;407460;AFEITADORA SPORT SH 886 BAT;PERSONAL CARE
18426040;;F;28;CHILENO;;Millenial;"";"";19990;1;1;1;1;19990;0;0;0;DEPILADORA BRE225/00;PERSONAL CARE
17214187;;M;31;CHILENO;;Millenial;PROVIDENCIA                   ;METROPOLITANA;24990;1;1;0;0;0;1;1;24990;CORTAPELOS GM 596;PERSONAL CARE
11120717;;F;55;CHILENO;;Boomers;VINA DEL MAR                  ;VALPARAISO;41980;2;1;0;0;0;2;1;41980;COMBO GAMA SECADOR+ALISADOR+CEPILLO;PERSONAL CARE
17414690;Soltero;M;32;CHILENO;INGENIERO ELECTRICO;Silencioso;PROVIDENCIA                   ;METROPOLITANA;193980;2;1;2;1;193980;0;0;0;DEPILADORA BRI920/00 IPL LUMEA ADVANCE;PERSONAL CARE
18188566;;F;30;CHILENO;;Millenial;LA GRANJA;METROPOLITANA;403910;8;3;8;3;403910;0;0;0;Xiaomi Mi Body Composition Scale 2 - 21907;PERSONAL CARE
7210552;;M;68;CHILENO;;Silencioso;LEBU                          ;BIO BIO;20990;1;1;0;0;0;1;1;20990;KIT CORTABARBA MG3711;PERSONAL CARE
14225860;Casado;F;40;CHILENO;;X;PROVIDENCIA                   ;METROPOLITANA;52980;2;2;0;0;0;2;2;52980;AFEITADORA SG-7210 NEGRO;PERSONAL CARE
16850771;;F;33;CHILENO;;Millenial;CASTRO                        ;LOS LAGOS;15990;1;1;0;0;0;1;1;15990;CORTAPELO GAMA MG 566;PERSONAL CARE
9158442;;F;61;CHILENO;;Boomers;CANETE                        ;BIO BIO;57980;2;2;0;0;0;2;2;57980;SECADOR DE PELO SG-3051;PERSONAL CARE
11362813;;F;52;CHILENO;;X;TALAGANTE                     ;METROPOLITANA;26990;1;1;0;0;0;1;1;26990;DEPILADORA SG-9004;PERSONAL CARE
20327329;;M;22;CHILENO;;Z;COLINA;METROPOLITANA;101970;3;2;0;0;0;3;2;101970;CORTA PELO SG-8520;PERSONAL CARE
9392208;;F;62;CHILENO;;Boomers;PROVIDENCIA                   ;METROPOLITANA;393250;4;2;0;0;0;4;2;393250;COMBO GAMA SECADOR+ALISADOR+CEPILLO;PERSONAL CARE
17234261;;F;32;CHILENO;;Millenial;COIHAIQUE                     ;AYSEN;38990;1;1;0;0;0;1;1;38990;AFEITADORA SH 887 WD BAT;PERSONAL CARE
11732906;;M;50;CHILENO;;X;N/D;N/D;89990;1;1;0;0;0;1;1;89990;DEPILADORA IPL MAGNA PK;PERSONAL CARE
19575618;;F;25;CHILENO;;Z;PROVIDENCIA                   ;METROPOLITANA;34990;1;1;1;1;34990;0;0;0;Pack depiladoras HP6306/00 + BRE225/00;PERSONAL CARE
12808812;;M;47;CHILENO;;X;LO PRADO                      ;METROPOLITANA;34990;1;1;0;0;0;1;1;34990;CORTADOR DE PELO SIEGEN SG-8590;PERSONAL CARE
16842309;;M;34;CHILENO;;Millenial;CASTRO                        ;LOS LAGOS;17592;1;1;0;0;0;1;1;17592;AFEITADORA GAMA SH 860;PERSONAL CARE
19020147;;F;26;CHILENO;;Z;RENGO                         ;L.G.B.OÂ´HIGGINS;39990;1;1;0;0;0;1;1;39990;ALISADOR DE PELO S12A(220) Shine Therapy PALTA M;PERSONAL CARE
17080099;;F;33;CHILENO;;Millenial;PROVIDENCIA                   ;METROPOLITANA;54990;1;1;0;0;0;1;1;54990;ALISADOR DE PELO SG-4651 ROJO;PERSONAL CARE
16718049;;F;34;CHILENO;;Millenial;N/D;N/D;39990;1;1;1;1;39990;0;0;0;ALISADOR DE PELO S12A(220) Shine Therapy PALTA M;PERSONAL CARE
15323878;;F;41;CHILENO;;X;N/D;N/D;64980;2;1;0;0;0;2;1;64980;DEPILADORA BRE700/00 MID-END CLOSED BOX;PERSONAL CARE
19915867;;F;24;CHILENO;;Z;EL BOSQUE                     ;METROPOLITANA;24990;1;1;0;0;0;1;1;24990;ALISADOR +SECADOR PELO;PERSONAL CARE
7684848;;F;60;CHILENO;;Boomers;SANTIAGO                      ;METROPOLITANA;13990;1;1;0;0;0;1;1;13990;CORTAPELO GAMA TITANIUM T827;PERSONAL CARE
18785456;;F;28;CHILENO;;Millenial;N/D;N/D;49990;1;1;0;0;0;1;1;49990;ALISADOR DE PELO SG-4651 ROJO;PERSONAL CARE
12420992;;F;48;CHILENO;;X;COLINA                        ;METROPOLITANA;34980;2;2;0;0;0;2;2;34980;ONDULADOR DE PELO SG-2411 25MM;PERSONAL CARE
12734076;Divorciado;M;46;CHILENO;;X;PROVIDENCIA                   ;METROPOLITANA;21990;1;1;0;0;0;1;1;21990;SECADOR DE PELO SG-3051;PERSONAL CARE
24722664;;F;39;BOLIVIANO;;Extranjero;N/D;N/D;44960;4;1;0;0;0;4;1;44960;COMBO GAMA SECADOR+ALISADOR+CEPILLO;PERSONAL CARE
19826432;;F;24;CHILENO;;Z;PROVIDENCIA                   ;METROPOLITANA;33670;2;1;0;0;0;2;1;33670;SECADOR GAMA BORA KERATION;PERSONAL CARE
18759923;Casado;F;28;CHILENO;PSICOLOGA;Millenial;PROVIDENCIA                   ;METROPOLITANA;24990;1;1;0;0;0;1;1;24990;AFEITADORA QP2521/50 ONE BLADE GRAFITO;PERSONAL CARE
19198101;;M;26;CHILENO;;Z;ANGOL                         ;ARAUCANIA;39992;1;1;0;0;0;1;1;39992;ALISADOR DE PELO SG-4651 ROJO;PERSONAL CARE
19148967;;F;26;CHILENO;;Z;N/D;N/D;32990;1;1;0;0;0;1;1;32990;ALISADOR ELEGANCE LED KER;PERSONAL CARE
14022526;;F;40;CHILENO;;X;CONCEPCION                    ;BIO BIO;27060;3;1;0;0;0;3;1;27060;SECADOR GAMA EOLIC MINI TRAVEL;PERSONAL CARE
7296659;;F;67;CHILENO;;Boomers;LEBU                          ;BIO BIO;37670;2;1;0;0;0;2;1;37670;SECADOR DE PELO SE-3049C01 FUCSIA;PERSONAL CARE
19071099;;F;26;CHILENO;;Z;CABILDO                       ;VALPARAISO;41990;1;3;0;0;0;1;3;41990;DEPILADORA OASIS SENSATION;PERSONAL CARE
11445985;;F;53;CHILENO;;X;TOME                          ;BIO BIO;39990;1;1;0;0;0;1;1;39990;DEPILADORA OASIS SENSATION;PERSONAL CARE
15929601;;F;36;CHILENO;;Millenial;PUENTE ALTO;METROPOLITANA;29990;1;1;1;1;29990;0;0;0;DEPILADORA OASIS NEXT BVT;PERSONAL CARE
19095568;;F;27;CHILENO;;Z;PUDAHUEL                      ;METROPOLITANA;30240;2;1;0;0;0;2;1;30240;COMBO GAMA SECADOR+ALISADOR+CEPILLO;PERSONAL CARE
13020506;;F;46;CHILENO;;X;PROVIDENCIA                   ;METROPOLITANA;20990;1;1;0;0;0;1;1;20990;AFEITADORA SG-7210 NEGRO;PERSONAL CARE
19724329;;F;24;CHILENO;;Millenial;LLANQUIHUE                    ;LOS LAGOS;39990;1;1;0;0;0;1;1;39990;CORTADOR DE PELO PACL GC 542 Sport Bat GT 527;PERSONAL CARE
17879284;Soltero;F;30;CHILENO;;Millenial;PROVIDENCIA                   ;METROPOLITANA;40670;2;1;0;0;0;2;1;40670;COMBO GAMA SECADOR+ALISADOR+CEPILLO;PERSONAL CARE
19501461;;M;24;CHILENO;;Millenial;"";"";24990;1;1;0;0;0;1;1;24990;AFEITADORA QP2521/50 ONE BLADE GRAFITO;PERSONAL CARE
26791418;;M;33;EXTRANJERO - NO INFORMA NACIONALIDAD;;Extranjero;PENCO                         ;BIO BIO;99340;4;1;0;0;0;4;1;99340;ALISADOR SIEGEN SG-4716;PERSONAL CARE
11767035;Casado;F;51;CHILENO;;X;RENCA                         ;METROPOLITANA;29990;1;1;0;0;0;1;1;29990;DEPILADORA BRE255/00;PERSONAL CARE
14498299;;M;46;CHILENO;;X;RENCA                         ;METROPOLITANA;86960;4;4;0;0;0;4;4;86960;ALISADOR +SECADOR PELO;PERSONAL CARE
16956156;;F;33;CHILENO;;Millenial;ISLA DE MAIPO;METROPOLITANA;24990;1;1;0;0;0;1;1;24990;AFEITADORA QP2521/50 ONE BLADE GRAFITO;PERSONAL CARE
17095663;;F;33;CHILENO;;Millenial;ALTO HOSPICIO;TARAPACA;201540;2;1;2;1;201540;0;0;0;DEPILADORA BRI920/00 IPL LUMEA ADVANCE;PERSONAL CARE
18291161;;M;29;CHILENO;;Millenial;TIRUA                         ;BIO BIO;16990;1;1;0;0;0;1;1;16990;SECADOR DIAMOND STD;PERSONAL CARE
12164949;;F;50;CHILENO;;X;OVALLE                        ;COQUIMBO;19990;1;1;0;0;0;1;1;19990;ALISADOR DE PELO SG-3512D1 ROSA;PERSONAL CARE
15438141;;F;40;CHILENO;;X;PIRQUE                        ;METROPOLITANA;103980;2;1;2;1;103980;0;0;0;DEPILADORA LASER SIEGEN SG-9303;PERSONAL CARE
25278354;;M;55;PERUANO;;Extranjero;SAN JOAQUIN                   ;METROPOLITANA;24990;1;1;0;0;0;1;1;24990;SECADOR DE PELO DIVA NEGRO;PERSONAL CARE
8245083;;F;63;CHILENO;;Boomers;PANGUIPULLI                   ;LOS RIOS;21990;1;1;0;0;0;1;1;21990;SECADOR DE PELO SE-3049C01 FUCSIA;PERSONAL CARE
17515922;;M;32;CHILENO;;Millenial;EL BOSQUE                     ;METROPOLITANA;61980;2;1;0;0;0;2;1;61980;ALISADOR DE PELO S12A(220) Shine Therapy PALTA M;PERSONAL CARE
17862048;;F;31;CHILENO;;Millenial;CORONEL;BIO-BIO;152650;4;3;0;0;0;4;3;152650;DEPILADORA OASIS SENSATION;PERSONAL CARE
8235473;;F;65;CHILENO;;Boomers;PUERTO MONTT                  ;LOS LAGOS;49980;2;1;0;0;0;2;1;49980;AFEITADORA S1121/41 ELECTRICA;PERSONAL CARE
17370967;;M;32;CHILENO;;Millenial;CANETE                        ;BIO BIO;21990;1;1;0;0;0;1;1;21990;CORTA PELO SG-8520;PERSONAL CARE
16564410;;F;38;CHILENO;;Millenial;PROVIDENCIA                   ;METROPOLITANA;34990;1;1;0;0;0;1;1;34990;AFEITADORA SH 887 WD BAT;PERSONAL CARE
18976088;;M;27;CHILENO;;Millenial;PROVIDENCIA                   ;METROPOLITANA;24990;1;1;0;0;0;1;1;24990;CORTA PELO SG-8520;PERSONAL CARE
15914111;Soltero;M;36;CHILENO;;Millenial;LA LIGUA                      ;VALPARAISO;29990;1;1;0;0;0;1;1;29990;CORTAPELOS GM 596;PERSONAL CARE
18861151;;F;27;CHILENO;;Millenial;"";"";32990;1;1;0;0;0;1;1;32990;TRICOMBO SECADOR+ALISADOR+ONDULADOR;PERSONAL CARE
13093473;;F;45;CHILENO;;X;SAN RAMON                     ;METROPOLITANA;42230;3;1;0;0;0;3;1;42230;SECADOR DE PELO DIVA NEGRO;PERSONAL CARE
13846865;;F;42;CHILENO;;X;PROVIDENCIA                   ;METROPOLITANA;39990;1;1;0;0;0;1;1;39990;DEPILADORA OASIS SENSATION;PERSONAL CARE
27429382;;F;51;COLOMBIANO;;Extranjero;N/D;N/D;34990;1;1;0;0;0;1;1;34990;ALISADOR DE PELO SG-3540 MORADO MORADO;PERSONAL CARE
15623820;;M;38;CHILENO;;X;MELIPILLA                     ;METROPOLITANA;39990;1;1;0;0;0;1;1;39990;ALISADOR REMIG. WET2 S27A (BV) R;PERSONAL CARE
15131481;;F;40;CHILENO;;X;MAIPU                         ;METROPOLITANA;18990;1;1;0;0;0;1;1;18990;DEPILADORA BRE225/00;PERSONAL CARE
13837268;;M;42;CHILENO;;X;PROVIDENCIA                   ;METROPOLITANA;13990;1;1;0;0;0;1;1;13990;SECADOR DIAMOND STD;PERSONAL CARE
9271463;;F;56;CHILENO;;Boomers;PROVIDENCIA                   ;METROPOLITANA;19990;1;1;0;0;0;1;1;19990;CORTA PELO SG-8410;PERSONAL CARE
19782142;;F;24;CHILENO;;Z;PROVIDENCIA                   ;METROPOLITANA;75970;3;2;0;0;0;3;2;75970;TRICOMBO SECADOR+ALISADOR+ONDULADOR;PERSONAL CARE
17164178;;F;33;CHILENO;;Silencioso;PROVIDENCIA                   ;METROPOLITANA;49990;1;1;0;0;0;1;1;49990;DEPILADORA BRE285/00 CONVENCIONAL;PERSONAL CARE
4730757;;M;78;CHILENO;;Silencioso;TALCAHUANO                    ;BIO BIO;26990;1;1;0;0;0;1;1;26990;SECADOR DE PELO SG-3051;PERSONAL CARE
16587193;;F;34;CHILENO;;Millenial;"";"";44980;2;2;0;0;0;2;2;44980;SECADOR DE PELO SG-3051;PERSONAL CARE
19786863;;F;24;CHILENO;;Z;PROVIDENCIA                   ;METROPOLITANA;35670;2;1;0;0;0;2;1;35670;ALISADOR +SECADOR PELO;PERSONAL CARE
20244604;;M;22;CHILENO;;Silencioso;PROVIDENCIA                   ;METROPOLITANA;28990;1;1;0;0;0;1;1;28990;CORTA PELO SPORT GCX 623 BVT;PERSONAL CARE
15919843;;F;37;CHILENO;;X;PROVIDENCIA                   ;METROPOLITANA;54990;1;1;0;0;0;1;1;54990;ALISADOR DE PELO SG-4651 ROJO;PERSONAL CARE
6128515;;F;77;CHILENO;;Silencioso;RENCA                         ;METROPOLITANA;36670;2;1;0;0;0;2;1;36670;SECADOR DE PELO SE-3049C01 FUCSIA;PERSONAL CARE
18494082;;F;29;CHILENO;;Millenial;PROVIDENCIA                   ;METROPOLITANA;38980;2;1;0;0;0;2;1;38980;DEPILADORA SG-9004;PERSONAL CARE
15808628;;M;38;CHILENO;;Millenial;TALCAHUANO                    ;BIO BIO;20990;1;1;0;0;0;1;1;20990;ALISADOR DE PELO SG-3510 FUCSIA;PERSONAL CARE
11986889;;F;49;CHILENO;;X;RENCA                         ;METROPOLITANA;14990;1;1;0;0;0;1;1;14990;SECADOR DE PELO MISTRAL STD;PERSONAL CARE
20519324;;F;22;CHILENO;;Z;LINARES                       ;MAULE;6990;1;1;0;0;0;1;1;6990;ALISADOR DE PELO S1520 CERAMIC COLORS-AZUL;PERSONAL CARE
10895205;;F;59;CHILENO;;Boomers;PROVIDENCIA                   ;METROPOLITANA;66980;2;1;0;0;0;2;1;66980;CORTADOR DE PELO SIEGEN SG-8590;PERSONAL CARE
16059615;;F;37;CHILENO;;Millenial;VINA DEL MAR                  ;VALPARAISO;13990;1;1;0;0;0;1;1;13990;SECADOR DE PELO MISTRAL STD;PERSONAL CARE
11432822;;F;53;CHILENO;;X;PUNTA ARENAS                  ;MAGALLANES;15990;1;1;0;0;0;1;1;15990;SECADOR DIAMOND STD;PERSONAL CARE
14105001;;F;40;CHILENO;;X;ARICA                         ;ARICA Y PARINACOTA;154980;2;2;0;0;0;2;2;154980;SECADOR DIAMOND STD;PERSONAL CARE
18289458;;F;31;CHILENO;;Millenial;VALDIVIA                      ;LOS RIOS;24990;1;1;0;0;0;1;1;24990;ALISADORA SIEGEN SG-3512D2;PERSONAL CARE
15849477;;F;38;CHILENO;;Millenial;PANGUIPULLI                   ;LOS RIOS;88650;4;3;0;0;0;4;3;88650;ALISADOR REMIG. WET2 S27A (BV) R;PERSONAL CARE
19108055;;F;27;CHILENO;;Silencioso;PROVIDENCIA                   ;METROPOLITANA;10990;1;1;0;0;0;1;1;10990;SECADOR GAMA EOLIC MINI TRAVEL;PERSONAL CARE
14246780;;F;47;CHILENO;;X;TALAGANTE                     ;METROPOLITANA;14990;1;1;0;0;0;1;1;14990;CORTA PELO GM 562;PERSONAL CARE
15240902;;F;42;CHILENO;;X;PROVIDENCIA                   ;METROPOLITANA;40670;2;1;0;0;0;2;1;40670;DEPILADORA BRE255/00;PERSONAL CARE
19520874;;F;25;CHILENO;;Z;PROVIDENCIA                   ;METROPOLITANA;25990;1;1;0;0;0;1;1;25990;SECADOR DE PELO SIEGEN SG-3049C02;PERSONAL CARE
15909477;;F;37;CHILENO;;Silencioso;PROVIDENCIA                   ;METROPOLITANA;16990;1;1;0;0;0;1;1;16990;SECADOR DE PELO STD TITAN KERATIN PLATA;PERSONAL CARE
15842579;;F;37;CHILENO;;Millenial;PROVIDENCIA                   ;METROPOLITANA;28570;2;1;0;0;0;2;1;28570;DEPILADORA GAMA ESSENCIAL;PERSONAL CARE
8927818;;M;60;CHILENO;;Boomers;COIHUECO                      ;BIO BIO;24990;1;1;0;0;0;1;1;24990;CORTA PELO SG-8410;PERSONAL CARE
16120423;;M;36;CHILENO;;Millenial;PROVIDENCIA                   ;METROPOLITANA;25990;1;1;0;0;0;1;1;25990;SECADOR DE PELO SE-3049C01 FUCSIA;PERSONAL CARE
14611507;;F;42;CHILENO;;X;N/D;N/D;16990;1;1;0;0;0;1;1;16990;SECADOR DE PELO SG-3043 DC CAFE 2200 WATTS;PERSONAL CARE
16503407;Casado;F;35;CHILENO;TECNICO DE NIVEL SUPERIOR EN ENFERMERIA;Millenial;PROVIDENCIA                   ;METROPOLITANA;34990;1;1;1;1;34990;0;0;0;PACK AFEITADORA S1223/41+CORTA PELO HC3505/15;PERSONAL CARE
16434399;;F;35;CHILENO;;Millenial;RENCA                         ;METROPOLITANA;21990;1;1;0;0;0;1;1;21990;CORTA PELO HC3520;PERSONAL CARE
4519895;;M;82;CHILENO;;Silencioso;PUERTO MONTT                  ;LOS LAGOS;14990;1;3;0;0;0;1;3;14990;CORTA PELO SPORT GCX 623 BVT;PERSONAL CARE
17004498;;M;33;CHILENO;;Silencioso;PROVIDENCIA                   ;METROPOLITANA;0;0;0;0;0;0;0;0;0;CORTA PELO HC3505;PERSONAL CARE
18821944;;F;29;CHILENO;;Millenial;PROVIDENCIA                   ;METROPOLITANA;0;0;0;0;0;0;0;0;0;TRICOMBO SECADOR+ALISADOR+ONDULADOR;PERSONAL CARE
19766993;;F;24;CHILENO;;Z;CAUQUENES                     ;MAULE;0;0;0;0;0;0;0;0;0;ALISADOR DE PELO SG-3540 MORADO MORADO;PERSONAL CARE
10610193;Casado;M;56;CHILENO;;Boomers;RENCA                         ;METROPOLITANA;0;0;0;0;0;0;0;0;0;CORTA PELO PG6025 KIT RECORTE;PERSONAL CARE
26214495;;M;34;VENEZOLANO;;Extranjero;MAIPU                         ;METROPOLITANA;0;0;0;0;0;0;0;0;0;SECADOR DE PELO SG-3049 NEGRO;PERSONAL CARE
15977514;;F;37;CHILENO;;Millenial;SALAMANCA                     ;COQUIMBO;0;0;0;0;0;0;0;0;0;SECADOR DE PELO SG-3051;PERSONAL CARE
20134938;;F;23;CHILENO;;Z;N/D;N/D;0;0;0;0;0;0;0;0;0;AFEITADORA SH 887 WD BAT;PERSONAL CARE
15483208;;F;40;CHILENO;;X;RENCA                         ;METROPOLITANA;0;0;0;0;0;0;0;0;0;DEPILADORA SG-9003;PERSONAL CARE
17061279;;F;34;CHILENO;;Millenial;PROVIDENCIA                   ;METROPOLITANA;0;0;0;0;0;0;0;0;0;ALISADORA SG-4751;PERSONAL CARE
19934012;;F;24;CHILENO;;Z;PROVIDENCIA                   ;METROPOLITANA;0;0;0;0;0;0;0;0;0;TRICOMBO SECADOR+ALISADOR+ONDULADOR;PERSONAL CARE
19024428;;M;27;CHILENO;;Z;PROVIDENCIA                   ;METROPOLITANA;0;0;0;0;0;0;0;0;0;ALISADOR DE PELO SG-3540 MORADO MORADO;PERSONAL CARE
13444257;;F;44;CHILENO;;X;COLINA                        ;METROPOLITANA;0;0;0;0;0;0;0;0;0;SECADOR DIAMOND STD;PERSONAL CARE
16717702;;F;34;CHILENO;;Millenial;PROVIDENCIA                   ;METROPOLITANA;0;0;0;0;0;0;0;0;0;DEPILADORA BRE225/00;PERSONAL CARE
20066087;;M;23;CHILENO;;Silencioso;PROVIDENCIA                   ;METROPOLITANA;0;0;0;0;0;0;0;0;0;SECADOR PELO SG-3012C19;PERSONAL CARE
10171686;;F;55;CHILENO;;Boomers;ANTOFAGASTA                   ;ANTOFAGASTA;0;0;0;0;0;0;0;0;0;DEPILADORA BRAUN SE830 FACE MN SR WH BOX CHI;PERSONAL CARE
19912719;;F;24;CHILENO;;Z;PROVIDENCIA                   ;METROPOLITANA;0;0;0;0;0;0;0;0;0;Depiladora E SkinPro Go Bvt;PERSONAL CARE
14302211;;M;47;CHILENO;;X;N/D;N/D;0;0;0;0;0;0;0;0;0;CORTA PELO SPORT GCX 623 BVT;PERSONAL CARE
16646563;;F;34;CHILENO;;Millenial;LO BARNECHEA                  ;METROPOLITANA;0;0;0;0;0;0;0;0;0;ALISADOR ELEGANCE LED BLOOM VT;PERSONAL CARE
8928570;;M;58;CHILENO;;Boomers;CURANILAHUE                   ;BIO BIO;0;0;0;0;0;0;0;0;0;AFEITADORA S1323/41 ELECTRICA;PERSONAL CARE
17795236;;F;31;CHILENO;;Millenial;PROVIDENCIA                   ;METROPOLITANA;0;0;0;0;0;0;0;0;0;ALISADOR DE PELO SG-4651 ROJO;PERSONAL CARE
12177198;Casado;F;50;CHILENO;;X;PROVIDENCIA                   ;METROPOLITANA;0;0;0;0;0;0;0;0;0;SECADOR PELO SG-3012C19;PERSONAL CARE
20246762;;F;23;CHILENO;;Z;PROVIDENCIA                   ;METROPOLITANA;0;0;0;0;0;0;0;0;0;ALISADOR DE PELO SG-3540 MORADO MORADO;PERSONAL CARE
12202534;;M;50;CHILENO;;X;PROVIDENCIA                   ;METROPOLITANA;0;0;0;0;0;0;0;0;0;ALISADOR SG3510C09 MORADO PLACAS DE CERAMICA 21;PERSONAL CARE
20208310;;F;22;CHILENO;;Silencioso;PROVIDENCIA                   ;METROPOLITANA;0;0;0;0;0;0;0;0;0;SECADOR DE PELO SIEGEN SG-3035;PERSONAL CARE
13698262;;F;43;CHILENO;;X;N/D;N/D;0;0;0;0;0;0;0;0;0;CORTA PELO SG-8520;PERSONAL CARE
15460890;;F;39;CHILENO;;X;PROVIDENCIA                   ;METROPOLITANA;0;0;0;0;0;0;0;0;0;SECADOR DE PELO SIEGEN SG-3035;PERSONAL CARE
10968519;;M;50;CHILENO;;X;N/D;N/D;0;0;0;0;0;0;0;0;0;SECADOR DE PELO D3019 PRO TITANIO;PERSONAL CARE
11837646;;F;51;CHILENO;;X;SAN JAVIER                    ;MAULE;0;0;0;0;0;0;0;0;0;ALISADOR DE PELO SG-4651 ROJO;PERSONAL CARE
16756650;;M;35;CHILENO;;Millenial;N/D;N/D;0;0;0;0;0;0;0;0;0;CORTA PELO SG-8520;PERSONAL CARE
9863466;;F;54;CHILENO;;Boomers;LLANQUIHUE                    ;LOS LAGOS;0;0;0;0;0;0;0;0;0;CORTA PELO GM 562;PERSONAL CARE
10014633;;M;54;CHILENO;;X;PROVIDENCIA                   ;METROPOLITANA;0;0;0;0;0;0;0;0;0;PACK AFEITADORA S1223/41+CORTA PELO HC3505/15;PERSONAL CARE
11156411;;F;55;CHILENO;;Boomers;CERRILLOS                     ;METROPOLITANA;0;0;0;0;0;0;0;0;0;SECADOR DE PELO SG-3051;PERSONAL CARE
17225827;;F;32;CHILENO;;Millenial;ISLA DE MAIPO                 ;METROPOLITANA;0;0;0;0;0;0;0;0;0;SECADOR DE PELO SG-3012 NEGRO;PERSONAL CARE
13400476;;F;44;CHILENO;;X;RENCA                         ;METROPOLITANA;0;0;0;0;0;0;0;0;0;SECADOR DIAMOND STD;PERSONAL CARE
18563605;Soltero;F;28;CHILENO;;Millenial;PROVIDENCIA                   ;METROPOLITANA;0;0;0;0;0;0;0;0;0;SECADOR DE PELO MISTRAL STD;PERSONAL CARE
13679461;;F;43;CHILENO;;X;PROVIDENCIA                   ;METROPOLITANA;0;0;0;0;0;0;0;0;0;CORTA PELO SG-8200;PERSONAL CARE
19978594;;F;23;CHILENO;;Z;OVALLE                        ;COQUIMBO;0;0;0;0;0;0;0;0;0;ALISADOR DE PELO ERGOSTYLER ION DUO ROJO;PERSONAL CARE
19372448;;M;25;CHILENO;;Z;QUILACO                       ;BIO BIO;0;0;0;0;0;0;0;0;0;AFEITADORA SH 887 WD BAT;PERSONAL CARE
10016159;Divorciado;F;63;CHILENO;;Boomers;RENCA                         ;METROPOLITANA;0;0;0;0;0;0;0;0;0;SECADOR DE VIAJE REMINGTON D2400;PERSONAL CARE
15716762;;F;38;CHILENO;;Millenial;LOS ANDES                     ;VALPARAISO;0;0;0;0;0;0;0;0;0;DEPILADORA BRE225/00;PERSONAL CARE
19807001;;F;24;CHILENO;;Z;TALCA                         ;MAULE;0;0;0;0;0;0;0;0;0;SECADOR DE PELO SG-3051;PERSONAL CARE
17811200;;F;30;CHILENO;;Millenial;N/D;N/D;0;0;0;0;0;0;0;0;0;ALISADOR SIEGEN SG-4716;PERSONAL CARE
15403820;;F;40;CHILENO;;X;RENCA                         ;METROPOLITANA;0;0;0;0;0;0;0;0;0;DEPILADORA BRI920/00 IPL LUMEA ADVANCE;PERSONAL CARE
12205538;;F;49;CHILENO;;X;RENCA                         ;METROPOLITANA;0;0;0;0;0;0;0;0;0;SECADOR DIAMOND STD;PERSONAL CARE
18786667;Soltero;F;27;CHILENO;PSICOPEDAGOGO;Z;PROVIDENCIA                   ;METROPOLITANA;0;0;0;0;0;0;0;0;0;ONDULADOR SIEGEN SG-2352;PERSONAL CARE
11515458;Casado;F;52;CHILENO;;X;PROVIDENCIA                   ;METROPOLITANA;0;0;0;0;0;0;0;0;0;ALISADOR DE PELO SG-3540 MORADO MORADO;PERSONAL CARE
16637105;;F;35;CHILENO;;Millenial;COLINA                        ;METROPOLITANA;0;0;0;0;0;0;0;0;0;PACK AFEITADORA S1223/41+CORTA PELO HC3505/15;PERSONAL CARE
16524151;;F;35;CHILENO;;Millenial;PROVIDENCIA                   ;METROPOLITANA;0;0;0;0;0;0;0;0;0;Pack Secador de pelo BHD004/10 + Alisador HP8321;PERSONAL CARE
17532964;Soltero;M;32;CHILENO;;Millenial;PROVIDENCIA                   ;METROPOLITANA;0;0;0;0;0;0;0;0;0;CORTA PELO PG6025 KIT RECORTE;PERSONAL CARE
19676420;;M;24;CHILENO;;Extranjero;MARCHIHUE                     ;L.G.B.OÂ´HIGGINS;0;0;0;0;0;0;0;0;0;CORTA PELO GM 562;PERSONAL CARE
14211267;;F;40;CHILENO;;X;PADRE LAS CASAS               ;ARAUCANIA;0;0;0;0;0;0;0;0;0;SECADOR DE PELO MISTRAL STD;PERSONAL CARE
9820828;Divorciado;M;59;CHILENO;;Boomers;PROVIDENCIA                   ;METROPOLITANA;0;0;0;0;0;0;0;0;0;SECADOR DE PELO SG-3012 NEGRO;PERSONAL CARE
10334207;;F;56;CHILENO;;Boomers;CABILDO                       ;VALPARAISO;0;0;0;0;0;0;0;0;0;DEPILADORA BRE255/00;PERSONAL CARE
16461140;;M;35;CHILENO;;Millenial;ANCUD                         ;LOS LAGOS;0;0;0;0;0;0;0;0;0;ALISADOR DE PELO SG-4651 ROJO;PERSONAL CARE
18655522;Soltero;F;28;CHILENO;;Millenial;PROVIDENCIA                   ;METROPOLITANA;0;0;0;0;0;0;0;0;0;SECADOR DE PELO SG-3012 NEGRO;PERSONAL CARE
6923887;;F;66;CHILENO;;Boomers;PAINE                         ;METROPOLITANA;0;0;0;0;0;0;0;0;0;AFEITADORA SG-7250 NEGRO;PERSONAL CARE
12096189;;F;52;CHILENO;;X;BUIN                          ;METROPOLITANA;0;0;0;0;0;0;0;0;0;CORTA PELO SG-8200;PERSONAL CARE
11994059;;F;51;CHILENO;;X;PROVIDENCIA                   ;METROPOLITANA;0;0;0;0;0;0;0;0;0;Pack Secador de pelo BHD004/10 + Alisador HP8321;PERSONAL CARE
15656192;Soltero;F;38;CHILENO;;Silencioso;PROVIDENCIA                   ;METROPOLITANA;0;0;0;0;0;0;0;0;0;ALISADOR DE PELO SG-3540 MORADO MORADO;PERSONAL CARE
5311540;Casado;M;73;CHILENO;;Silencioso;PROVIDENCIA                   ;METROPOLITANA;0;0;0;0;0;0;0;0;0;AFEITADORA S1121/41 ELECTRICA;PERSONAL CARE
14148144;Soltero;F;40;CHILENO;INTERPRETE DE IDIOMAS;Silencioso;PROVIDENCIA                   ;METROPOLITANA;0;0;0;0;0;0;0;0;0;CORTA PELO SG-8520;PERSONAL CARE
10810044;;F;54;CHILENO;;Boomers;PROVIDENCIA                   ;METROPOLITANA;0;0;0;0;0;0;0;0;0;COMBO BALANZA NEGRA+SECADOR DIAMOND ST NEGRO;PERSONAL CARE
20148376;;M;22;CHILENO;;Silencioso;PROVIDENCIA                   ;METROPOLITANA;0;0;0;0;0;0;0;0;0;AFEITADORA SPORT;PERSONAL CARE
12310316;;F;50;CHILENO;;X;PROVIDENCIA                   ;METROPOLITANA;0;0;0;0;0;0;0;0;0;SECADOR DE PELO SE-3049C01 FUCSIA;PERSONAL CARE
18178563;;F;30;CHILENO;;Millenial;LA SERENA                     ;COQUIMBO;0;0;0;0;0;0;0;0;0;SECADOR DE PELO SG-3116;PERSONAL CARE
14358836;;F;45;CHILENO;;X;CHILLAN                       ;BIO BIO;0;0;0;0;0;0;0;0;0;AFEITADORA SG-7250 NEGRO;PERSONAL CARE
19007514;Soltero;F;27;CHILENO;;Z;PROVIDENCIA                   ;METROPOLITANA;0;0;0;0;0;0;0;0;0;SECADOR DE PELO TEMPO MORADO;PERSONAL CARE
20805260;;M;20;CHILENO;;X;PROVIDENCIA                   ;METROPOLITANA;0;0;0;0;0;0;0;0;0;AFEITADORA SG-7250 NEGRO;PERSONAL CARE
19885603;;F;23;CHILENO;;Z;PROVIDENCIA                   ;METROPOLITANA;0;0;0;0;0;0;0;0;0;CORTA PELO SG-8200;PERSONAL CARE
15801431;;F;38;CHILENO;;Millenial;PROVIDENCIA                   ;METROPOLITANA;0;0;0;0;0;0;0;0;0;CORTA PELO HC3505;PERSONAL CARE
16362243;Casado;F;35;CHILENO;;Millenial;VILLARICA                     ;ARAUCANIA;0;0;0;0;0;0;0;0;0;CORTADOR DE PELO PACL GC 542 Sport Bat GT 527;PERSONAL CARE
5613975;;M;75;CHILENO;;Silencioso;PUNTA ARENAS                  ;MAGALLANES;0;0;0;0;0;0;0;0;0;COMBO SIEGEN AFEITADORA + MULTISTYLER SG-8440;PERSONAL CARE
19671554;;F;25;CHILENO;;Z;PROVIDENCIA                   ;METROPOLITANA;0;0;0;0;0;0;0;0;0;CORTA PELO GC-625;PERSONAL CARE
20447293;;F;22;CHILENO;;Silencioso;PROVIDENCIA                   ;METROPOLITANA;0;0;0;0;0;0;0;0;0;ALISADOR ELEGANCE LED KER;PERSONAL CARE
15883436;;M;38;CHILENO;;Millenial;VALDIVIA                      ;LOS RIOS;0;0;0;0;0;0;0;0;0;ALISADOR GAMA BELLA SHINE;PERSONAL CARE
12367968;;M;49;CHILENO;;Silencioso;N/D;N/D;0;0;0;0;0;0;0;0;0;DEPILADORA BRE285/00 CONVENCIONAL;PERSONAL CARE
15824273;;M;39;CHILENO;;X;PUENTE ALTO                   ;METROPOLITANA;0;0;0;0;0;0;0;0;0;SECADOR DE PELO DIAMOND ST BLOOM VT 220;PERSONAL CARE
17955992;;F;30;CHILENO;;Millenial;N/D;N/D;0;0;0;0;0;0;0;0;0;TRICOMBO SECADOR+ALISADOR+ONDULADOR;PERSONAL CARE
20167659;;F;23;CHILENO;;Z;PROVIDENCIA                   ;METROPOLITANA;0;0;0;0;0;0;0;0;0;DEPILADORA GAMA ESSENCIAL;PERSONAL CARE
7946001;;M;66;CHILENO;;Boomers;QUILPUE                       ;VALPARAISO;0;0;0;0;0;0;0;0;0;RECORTADOR DE VELLO NT3160/15 PHILIPS;PERSONAL CARE
19718412;;M;24;CHILENO;;Silencioso;PROVIDENCIA                   ;METROPOLITANA;0;0;0;0;0;0;0;0;0;CORTA PELO GC-625;PERSONAL CARE
18973045;Soltero;F;27;CHILENO;TECNICO DE NIVEL SUPERIOR EN ENFERMERIA;Millenial;N/D;N/D;0;0;0;0;0;0;0;0;0;SPA PARA PIES SG-1560;PERSONAL CARE
10693085;;M;44;CHILENO;;X;N/D;N/D;0;0;0;0;0;0;0;0;0;CORTA PELO GC-625;PERSONAL CARE
18103334;;F;57;CHILENO;;Boomers;PROVIDENCIA                   ;METROPOLITANA;0;0;0;0;0;0;0;0;0;SECADOR DE PELO DIAMOND ST BLOOM VT 220;PERSONAL CARE
11819583;;F;51;CHILENO;;X;PROVIDENCIA                   ;METROPOLITANA;0;0;0;0;0;0;0;0;0;SECADOR DE PELO SIEGEN SG-3035;PERSONAL CARE
16699648;;M;34;CHILENO;;Millenial;PROVIDENCIA                   ;METROPOLITANA;0;0;0;0;0;0;0;0;0;CORTAPELOS GM 596;PERSONAL CARE
17222205;;M;33;CHILENO;;Millenial;PROVIDENCIA                   ;METROPOLITANA;0;0;0;0;0;0;0;0;0;Afeitadora Corporal Serie 3000 Philips BG105/11;PERSONAL CARE
16849354;;M;34;CHILENO;;Millenial;OVALLE                        ;COQUIMBO;0;0;0;0;0;0;0;0;0;SECADOR DE PELO DIAMOND ST BLOOM VT 220;PERSONAL CARE
24378400;;M;29;BOLIVIANO;;Extranjero;RECOLETA                      ;METROPOLITANA;0;0;0;0;0;0;0;0;0;ALISADOR SIEGEN SG-4716;PERSONAL CARE
19167883;;F;26;CHILENO;;Z;VALDIVIA                      ;LOS LAGOS;0;0;0;0;0;0;0;0;0;SECADOR DE PELO D13A-220-R PLATA;PERSONAL CARE
9822355;Casado;F;58;CHILENO;;Boomers;RENCA                         ;METROPOLITANA;0;0;0;0;0;0;0;0;0;CORTA PELO HC3505;PERSONAL CARE
27236962;;M;30;CHILENO;;Extranjero;N/D;N/D;0;0;0;0;0;0;0;0;0;ALISADOR DE PELO S8607 DE COCO VERDE;PERSONAL CARE
13670531;;F;43;CHILENO;;X;N/D;N/D;0;0;0;0;0;0;0;0;0;COMBO SIEGEN AFEITADORA + MULTISTYLER SG-8440;PERSONAL CARE
8590342;;F;63;CHILENO;;Boomers;PROVIDENCIA                   ;METROPOLITANA;0;0;0;0;0;0;0;0;0;ONDULADOR SIEGEN SG-2352;PERSONAL CARE
19415429;;F;25;CHILENO;;Z;PROVIDENCIA                   ;METROPOLITANA;0;0;0;0;0;0;0;0;0;SECADOR DE PELO SE-3049C01 FUCSIA;PERSONAL CARE
19211364;Soltero;F;25;CHILENO;;Z;PROVIDENCIA                   ;METROPOLITANA;0;0;0;0;0;0;0;0;0;SECADOR GAMA EOLIC MINI TRAVEL;PERSONAL CARE
19210844;;F;26;CHILENO;;Z;LAS CABRAS                    ;L.G.B.OÂ´HIGGINS;0;0;0;0;0;0;0;0;0;ALISADOR DE PELO SG-3540 MORADO MORADO;PERSONAL CARE
20459328;;M;31;CHILENO;;Silencioso;PROVIDENCIA                   ;METROPOLITANA;0;0;0;0;0;0;0;0;0;ALISADOR DE PELO ERGOSTYLER ION DUO ROJO;PERSONAL CARE
8070190;;M;64;CHILENO;;Boomers;PADRE HURTADO                 ;METROPOLITANA;0;0;0;0;0;0;0;0;0;AFEITADORA SG-7210 NEGRO;PERSONAL CARE
26792193;;M;34;VENEZOLANO;;Extranjero;PUERTO MONTT                  ;LOS LAGOS;0;0;0;0;0;0;0;0;0;CORTA PELO SG-8200;PERSONAL CARE
11832515;;F;50;CHILENO;;X;ARICA                         ;ARICA Y PARINACOTA;0;0;0;0;0;0;0;0;0;SECADOR DE PELO SIEGEN SG-3035;PERSONAL CARE
12240191;;F;50;CHILENO;;X;PROVIDENCIA                   ;METROPOLITANA;0;0;0;0;0;0;0;0;0;AFEITADORA SG-7210 NEGRO;PERSONAL CARE
8546987;Casado;M;49;CHILENO;;X;RENCA                         ;METROPOLITANA;0;0;0;0;0;0;0;0;0;CORTA PELO HC3520;PERSONAL CARE
13740381;;M;42;CHILENO;;X;COIHAIQUE                     ;AYSEN;0;0;0;0;0;0;0;0;0;CORTA PELO SG-8200;PERSONAL CARE
19860008;;F;24;CHILENO;;Silencioso;PROVIDENCIA                   ;METROPOLITANA;0;0;0;0;0;0;0;0;0;DEPILADORA IPL Allevia;PERSONAL CARE
18559481;;F;28;CHILENO;;Millenial;PROVIDENCIA                   ;METROPOLITANA;0;0;0;0;0;0;0;0;0;AFEITADORA SPORT;PERSONAL CARE
18385324;Soltero;M;29;CHILENO;;Millenial;PROVIDENCIA                   ;METROPOLITANA;0;0;0;0;0;0;0;0;0;AFEITADORA SPORT SH 886 BAT;PERSONAL CARE
12329343;;M;48;CHILENO;;X;PROVIDENCIA                   ;METROPOLITANA;0;0;0;0;0;0;0;0;0;CORTA PELO SPORT GCX 623 BVT;PERSONAL CARE
18218942;Soltero;F;29;CHILENO;ASISTENTE SOCIAL;Millenial;PROVIDENCIA                   ;METROPOLITANA;0;0;0;0;0;0;0;0;0;ALISADOR ATTIVA STD;PERSONAL CARE
7975455;;M;63;CHILENO;;Boomers;PROVIDENCIA                   ;METROPOLITANA;0;0;0;0;0;0;0;0;0;AFEITADORA XR1430 NEGRO;PERSONAL CARE
9640151;Casado;F;60;CHILENO;;Boomers;RENCA                         ;METROPOLITANA;0;0;0;0;0;0;0;0;0;SECADOR DE PELO SG-3025 SILVER;PERSONAL CARE
18842473;;M;27;CHILENO;;Millenial;VILLA ALEMANA                 ;VALPARAISO;0;0;0;0;0;0;0;0;0;SECADOR DIAMOND STD;PERSONAL CARE
17901670;Soltero;M;30;CHILENO;;Millenial;PROVIDENCIA                   ;METROPOLITANA;0;0;0;0;0;0;0;0;0;DEPILADORA GAMA ESSENCIAL;PERSONAL CARE
18979203;;F;26;CHILENO;;Z;TOME                          ;BIO BIO;0;0;0;0;0;0;0;0;0;ALISADOR URBAN SKY 220V;PERSONAL CARE
15207621;;F;39;CHILENO;;X;LOS ANGELES                   ;BIO BIO;0;0;0;0;0;0;0;0;0;DEPILADORA SG-9004;PERSONAL CARE
9391285;Casado;M;57;CHILENO;TECNICO MECANICO;Boomers;PROVIDENCIA                   ;METROPOLITANA;0;0;0;0;0;0;0;0;0;SECADOR DE PELO MISTRAL STD;PERSONAL CARE
9547154;;F;61;CHILENO;;Boomers;PUDAHUEL                      ;METROPOLITANA;0;0;0;0;0;0;0;0;0;SECADOR DIAMOND STD;PERSONAL CARE
26096679;;F;27;HAITIANO;;Extranjero;CALERA DE TANGO               ;METROPOLITANA;0;0;0;0;0;0;0;0;0;DEPILADORA OASIS SENSATION;PERSONAL CARE
18092392;;M;30;CHILENO;;Millenial;QUILICURA                     ;METROPOLITANA;0;0;0;0;0;0;0;0;0;CORTA PELO SG-8520;PERSONAL CARE
9954914;;M;57;CHILENO;;Boomers;LEBU                          ;BIO BIO;0;0;0;0;0;0;0;0;0;CORTA PELO SG-8520;PERSONAL CARE
20161435;;M;22;CHILENO;;Z;LOS ANGELES                   ;BIO BIO;0;0;0;0;0;0;0;0;0;ALISADOR DE PELO SG-3510 FUCSIA;PERSONAL CARE
16945474;Soltero;F;33;CHILENO;INGENIERO COMERCIAL;Millenial;PROVIDENCIA                   ;METROPOLITANA;0;0;0;0;0;0;0;0;0;DEPILADORA GAMA ESSENCIAL;PERSONAL CARE
8097408;;F;62;CHILENO;;Boomers;PROVIDENCIA                   ;METROPOLITANA;0;0;0;0;0;0;0;0;0;ALISADOR DE PELO SG-3510 FUCSIA;PERSONAL CARE
16820243;;F;34;CHILENO;;Millenial;QUILLOTA                      ;VALPARAISO;0;0;0;0;0;0;0;0;0;ALISADOR GAMA BELLA SHINE;PERSONAL CARE
9409635;;M;59;CHILENO;;Boomers;SAN CARLOS                    ;BIO BIO;0;0;0;0;0;0;0;0;0;SECADOR DE PELO HP8204/10 THERMOPROTECT 2100W FR;PERSONAL CARE
15948364;;F;35;CHILENO;;Millenial;VALPARAISO                    ;VALPARAISO;0;0;0;0;0;0;0;0;0;DEPILADORA BRE700/00 MID-END CLOSED BOX;PERSONAL CARE
11512751;;F;52;CHILENO;;X;RENCA                         ;METROPOLITANA;0;0;0;0;0;0;0;0;0;ALISADOR DE PELO SG-3540 MORADO MORADO;PERSONAL CARE
14527823;;F;42;CHILENO;;X;PROVIDENCIA                   ;METROPOLITANA;0;0;0;0;0;0;0;0;0;CORTA PELO SPORT GC 542 BVT;PERSONAL CARE
9674082;;M;56;CHILENO;;Boomers;PROVIDENCIA                   ;METROPOLITANA;0;0;0;0;0;0;0;0;0;CORTA PELO SPORT GC 542 BVT;PERSONAL CARE
6026190;;F;72;CHILENO;;Silencioso;RENCA                         ;METROPOLITANA;0;0;0;0;0;0;0;0;0;AFEITADORA SG-7210 NEGRO;PERSONAL CARE
8237329;;M;64;CHILENO;;Boomers;SAN FERNANDO                  ;L.G.B.OÂ´HIGGINS;0;0;0;0;0;0;0;0;0;AFEITADORA SG-7210 NEGRO;PERSONAL CARE
17850059;;F;31;CHILENO;;Millenial;RENCA                         ;METROPOLITANA;0;0;0;0;0;0;0;0;0;SECADOR DE PELO SG-3012C14 ROJO;PERSONAL CARE
14347615;;M;43;CHILENO;;X;ILLAPEL                       ;COQUIMBO;0;0;0;0;0;0;0;0;0;SECADOR DE PELO MISTRAL STD;PERSONAL CARE
10736922;Casado;M;48;CHILENO;PSICOLOGO;Silencioso;PROVIDENCIA                   ;METROPOLITANA;0;0;0;0;0;0;0;0;0;SECADOR PHILIPS BHC010;PERSONAL CARE
7417958;;M;62;CHILENO;;Boomers;EL BOSQUE                     ;METROPOLITANA;0;0;0;0;0;0;0;0;0;AFEITADORA SPORT;PERSONAL CARE
18842532;Soltero;F;27;CHILENO;;Millenial;PROVIDENCIA                   ;METROPOLITANA;0;0;0;0;0;0;0;0;0;ALISADORA SG-4653;PERSONAL CARE
13537155;Soltero;M;43;CHILENO;;X;RENCA                         ;METROPOLITANA;0;0;0;0;0;0;0;0;0;DEPILADORA CYBELE IPL GOLD 200 MIL PULSACIONES;PERSONAL CARE
25763289;;M;23;COLOMBIANO;;Extranjero;QUINTA NORMAL                 ;METROPOLITANA;0;0;0;0;0;0;0;0;0;AFEITADORA QP2521/50 ONE BLADE GRAFITO;PERSONAL CARE
6173055;;M;72;CHILENO;;Silencioso;RENCA                         ;METROPOLITANA;0;0;0;0;0;0;0;0;0;CORTEPELO GT420;PERSONAL CARE
16226773;;M;36;CHILENO;;Millenial;GENERAL LAGOS                 ;ARICA Y PARINACOTA;0;0;0;0;0;0;0;0;0;AFEITADORA SG-7210 NEGRO;PERSONAL CARE
13533916;;M;51;CHILENO;;X;PROVIDENCIA                   ;METROPOLITANA;0;0;0;0;0;0;0;0;0;ALISADOR DE PELO SG-4651 ROJO;PERSONAL CARE
18238638;;F;29;CHILENO;;Millenial;PUERTO MONTT                  ;LOS LAGOS;0;0;0;0;0;0;0;0;0;SECADOR DE PELO STD TITAN KERATIN PLATA;PERSONAL CARE
11172868;;F;55;CHILENO;;Boomers;PERALILLO                     ;L.G.B.OÂ´HIGGINS;0;0;0;0;0;0;0;0;0;KIT PG181;PERSONAL CARE
15338739;;M;39;CHILENO;;X;RENCA                         ;METROPOLITANA;0;0;0;0;0;0;0;0;0;CORTA PELO SG-8520;PERSONAL CARE
17866348;Soltero;F;30;CHILENO;TECNICO DE NIVEL SUPERIOR EN ENFERMERIA;Millenial;PROVIDENCIA                   ;METROPOLITANA;0;0;0;0;0;0;0;0;0;SECADOR PELO SG-3012C19;PERSONAL CARE
25553034;;F;34;BOLIVIANO;;Extranjero;CALAMA                        ;ANTOFAGASTA;0;0;0;0;0;0;0;0;0;TRICOMBO SECADOR+ALISADOR+ONDULAD;PERSONAL CARE
16117815;Casado;F;36;CHILENO;;Millenial;PROVIDENCIA                   ;METROPOLITANA;0;0;0;0;0;0;0;0;0;CORTA PELO HC3505;PERSONAL CARE
13621784;;M;42;CHILENO;;X;RANCAGUA                      ;L.G.B.OÂ´HIGGINS;0;0;0;0;0;0;0;0;0;ALISADOR DE PELO SG-4651 ROJO;PERSONAL CARE
16195025;;F;36;CHILENO;;Millenial;PROVIDENCIA                   ;METROPOLITANA;0;0;0;0;0;0;0;0;0;Secador Potenza Keration;PERSONAL CARE
20395935;;F;22;CHILENO;;Z;PROVIDENCIA                   ;METROPOLITANA;0;0;0;0;0;0;0;0;0;CORTA PELO SG-8200;PERSONAL CARE
13621844;;F;42;CHILENO;;X;CHILLAN                       ;BIO BIO;0;0;0;0;0;0;0;0;0;ALISADOR SIEGEN SG-4716;PERSONAL CARE
12319601;;F;49;CHILENO;;X;PROVIDENCIA                   ;METROPOLITANA;0;0;0;0;0;0;0;0;0;Secador Potenza Keration;PERSONAL CARE
13111885;Soltero;M;47;CHILENO;AUXILIAR PARAMEDICO DE ALIMENTACION;X;NUEVA IMPERIAL                ;ARAUCANIA;0;0;0;0;0;0;0;0;0;AFEITADORA SG-7210 NEGRO;PERSONAL CARE
12944401;;F;45;CHILENO;;X;RENCA                         ;METROPOLITANA;0;0;0;0;0;0;0;0;0;TRICOMBO SECADOR+ALISADOR+ONDULAD;PERSONAL CARE
10427762;;M;56;CHILENO;;Boomers;RENCA                         ;METROPOLITANA;0;0;0;0;0;0;0;0;0;DEPILADORA OASIS LOOK BVT;PERSONAL CARE
18346183;Soltero;F;28;CHILENO;;Millenial;PROVIDENCIA                   ;METROPOLITANA;0;0;0;0;0;0;0;0;0;CORTA PELO GM 562;PERSONAL CARE
3213007;;M;92;CHILENO;;Silencioso;RENCA                         ;METROPOLITANA;0;0;0;0;0;0;0;0;0;AFEITADORA SG-7250 NEGRO;PERSONAL CARE
7888637;;M;64;CHILENO;;Boomers;CAUQUENES                     ;MAULE;0;0;0;0;0;0;0;0;0;SECADOR PELO SG-3012C19;PERSONAL CARE
12794047;;F;46;CHILENO;;X;LINARES                       ;MAULE;0;0;0;0;0;0;0;0;0;ALISADOR DE PELO SG-3512D1 ROSA;PERSONAL CARE
13093178;;M;45;CHILENO;;X;PROVIDENCIA                   ;METROPOLITANA;0;0;0;0;0;0;0;0;0;SECADOR DE PELO MISTRAL STD;PERSONAL CARE
19703031;;F;25;CHILENO;;Z;PROVIDENCIA                   ;METROPOLITANA;0;0;0;0;0;0;0;0;0;AFEITADORA GAMA 900;PERSONAL CARE
17940192;;M;30;CHILENO;;Millenial;PROVIDENCIA                   ;METROPOLITANA;0;0;0;0;0;0;0;0;0;AFEITADORA S1323/41 ELECTRICA;PERSONAL CARE
8348632;;M;63;CHILENO;;Boomers;LA PINTANA                    ;METROPOLITANA;0;0;0;0;0;0;0;0;0;DEPILADORA GAMA ESSENCIAL;PERSONAL CARE
8729527;;F;64;CHILENO;;Boomers;ALTO HOSPICIO;TARAPACA;0;0;0;0;0;0;0;0;0;SECADOR DIAMOND STD;PERSONAL CARE
8022849;;M;62;CHILENO;;Boomers;RENCA                         ;METROPOLITANA;0;0;0;0;0;0;0;0;0;CORTA PELO SG-8520;PERSONAL CARE
12352989;Soltero;M;48;CHILENO;;X;RENCA                         ;METROPOLITANA;0;0;0;0;0;0;0;0;0;DEPILADORA OASIS SENSATION;PERSONAL CARE
17519720;;M;31;CHILENO;;Millenial;PROVIDENCIA                   ;METROPOLITANA;0;0;0;0;0;0;0;0;0;ALISADOR ATTIVA STD;PERSONAL CARE
15319753;;F;40;CHILENO;;X;PROVIDENCIA                   ;METROPOLITANA;0;0;0;0;0;0;0;0;0;DEPILADORA BRE225/00;PERSONAL CARE
25211575;;M;31;BOLIVIANO;;Extranjero;IQUIQUE                       ;TARAPACA;0;0;0;0;0;0;0;0;0;ALISADORA SG-4653;PERSONAL CARE
12197961;;M;50;CHILENO;;X;PROVIDENCIA                   ;METROPOLITANA;0;0;0;0;0;0;0;0;0;DEPILADORA SG-9004EX;PERSONAL CARE
10933116;;F;58;CHILENO;;Boomers;PROVIDENCIA                   ;METROPOLITANA;0;0;0;0;0;0;0;0;0;AFEITADORA S1121/41 ELECTRICA;PERSONAL CARE
21196756;;M;53;ARGENTINO;;Extranjero;VINA DEL MAR                  ;VALPARAISO;0;0;0;0;0;0;0;0;0;ALISADOR DE PELO SG-3540 MORADO MORADO;PERSONAL CARE
8915841;;M;59;CHILENO;;Boomers;MAULE                         ;MAULE;0;0;0;0;0;0;0;0;0;BHB862 + BHC010 + BHS376;PERSONAL CARE
19094267;Soltero;F;27;CHILENO;;Z;PROVIDENCIA                   ;METROPOLITANA;0;0;0;0;0;0;0;0;0;DEPILADORA GAMA ESSENCIAL;PERSONAL CARE
11946023;;M;50;CHILENO;;X;RENCA                         ;METROPOLITANA;0;0;0;0;0;0;0;0;0;AFEITADORA SPORT;PERSONAL CARE
6567743;;F;69;CHILENO;;Silencioso;RENCA                         ;METROPOLITANA;0;0;0;0;0;0;0;0;0;AFEITADORA PR1342 ROTATIVA RECARGABLE;PERSONAL CARE
15044817;Casado;M;38;CHILENO;;X;PROVIDENCIA                   ;METROPOLITANA;0;0;0;0;0;0;0;0;0;CORTA PELO MGK3220 BLACK BOX MN;PERSONAL CARE
5867107;;M;74;CHILENO;;Silencioso;PENCAHUE                      ;MAULE;0;0;0;0;0;0;0;0;0;CORTA PELO SG-8200;PERSONAL CARE
13540927;;F;42;CHILENO;;X;NOGALES                       ;VALPARAISO;0;0;0;0;0;0;0;0;0;AFEITADORA S1121/41 ELECTRICA;PERSONAL CARE
8240398;;F;61;CHILENO;;Boomers;TEMUCO                        ;ARAUCANIA;0;0;0;0;0;0;0;0;0;CORTAPELOS GM 596;PERSONAL CARE
15159364;Casado;F;39;CHILENO;;X;PROVIDENCIA                   ;METROPOLITANA;0;0;0;0;0;0;0;0;0;CORTAPELOS GM 596;PERSONAL CARE
9494003;Casado;F;59;CHILENO;;Boomers;PROVIDENCIA                   ;METROPOLITANA;0;0;0;0;0;0;0;0;0;SECADOR DE PELO SE-3049C01 FUCSIA;PERSONAL CARE
19371767;;F;25;CHILENO;;Z;LOS ANGELES                   ;BIO BIO;0;0;0;0;0;0;0;0;0;ALISADOR DE PELO SG-4651 ROJO;PERSONAL CARE
16970818;Casado;F;34;CHILENO;;Millenial;RENCA                         ;METROPOLITANA;0;0;0;0;0;0;0;0;0;CORTA PELO GM 562;PERSONAL CARE
19938310;;F;24;CHILENO;;Z;PROVIDENCIA                   ;METROPOLITANA;0;0;0;0;0;0;0;0;0;DEPILADORA SG-9004;PERSONAL CARE
24786125;;M;43;HAITIANO;;Extranjero;INDEPENDENCIA                 ;METROPOLITANA;0;0;0;0;0;0;0;0;0;CORTA PELO GM 562;PERSONAL CARE
12830242;;F;48;CHILENO;;X;PROVIDENCIA                   ;METROPOLITANA;0;0;0;0;0;0;0;0;0;SECADOR DE PELO SG-3035 NEGRO;PERSONAL CARE
17652614;;M;32;CHILENO;;Millenial;LONCOCHE                      ;ARAUCANIA;0;0;0;0;0;0;0;0;0;DEPILADORA HP-6543;PERSONAL CARE
16186540;;F;36;CHILENO;;Millenial;N/D;N/D;0;0;0;0;0;0;0;0;0;CORTA PELO MGK3220 BLACK BOX MN;PERSONAL CARE
18448883;Soltero;M;28;CHILENO;;Millenial;PROVIDENCIA                   ;METROPOLITANA;0;0;0;0;0;0;0;0;0;DEPILADORA OASIS SENSATION;PERSONAL CARE
19722702;;F;24;CHILENO;;Z;CASTRO                        ;LOS LAGOS;0;0;0;0;0;0;0;0;0;SECADOR DE PELO SG-3012 NEGRO;PERSONAL CARE
17362421;;M;32;CHILENO;;Millenial;PROVIDENCIA                   ;METROPOLITANA;0;0;0;0;0;0;0;0;0;Secador Potenza Keration;PERSONAL CARE
6248080;Soltero;F;74;CHILENO;;Silencioso;PROVIDENCIA                   ;METROPOLITANA;0;0;0;0;0;0;0;0;0;DEPILADORA OASIS SENSATION;PERSONAL CARE
26867714;Soltero;F;33;EXTRANJERO - NO INFORMA NACIONALIDAD;;Extranjero;PROVIDENCIA                   ;METROPOLITANA;0;0;0;0;0;0;0;0;0;ALISADOR ATTIVA STD;PERSONAL CARE
19018539;;F;27;CHILENO;;Z;PROVIDENCIA                   ;METROPOLITANA;0;0;0;0;0;0;0;0;0;ALISADOR CP3 DIGITAL TITANIUM;PERSONAL CARE
27129486;;F;45;PERUANO;;Extranjero;N/D;N/D;0;0;0;0;0;0;0;0;0;CEPILLO ALISADOR SIEGEN SG-4910;PERSONAL CARE
11183866;;F;55;CHILENO;;Boomers;CARTAGENA                     ;VALPARAISO;0;0;0;0;0;0;0;0;0;SECADOR DE PELO SG-3035 NEGRO;PERSONAL CARE
9023387;Casado;M;59;CHILENO;;Boomers;RENCA                         ;METROPOLITANA;0;0;0;0;0;0;0;0;0;AFEITADORA SG-7250 NEGRO;PERSONAL CARE
9423723;;M;55;CHILENO;;Boomers;LOS ANGELES                   ;BIO BIO;0;0;0;0;0;0;0;0;0;AFEITADORA SG-7250 NEGRO;PERSONAL CARE
6888938;Viudo;M;67;CHILENO;;Boomers;PROVIDENCIA                   ;METROPOLITANA;0;0;0;0;0;0;0;0;0;SECADOR DE PELO SG-3035 NEGRO;PERSONAL CARE
14356337;Soltero;F;43;CHILENO;;X;RENCA                         ;METROPOLITANA;0;0;0;0;0;0;0;0;0;ALISADOR DE PELO SG-3510 FUCSIA;PERSONAL CARE
9674909;;M;58;CHILENO;;Boomers;"";"";0;0;0;0;0;0;0;0;0;AFEITADORA ONE BLADE QP2521/10 + ESTUCHE;PERSONAL CARE
12473293;;M;48;CHILENO;;X;VILLARICA                     ;ARAUCANIA;0;0;0;0;0;0;0;0;0;SECADOR DE PELO TEMPO MORADO;PERSONAL CARE
18368233;;F;29;CHILENO;;Millenial;PROVIDENCIA                   ;METROPOLITANA;0;0;0;0;0;0;0;0;0;DEPILADORA HP-6543;PERSONAL CARE
17542388;Soltero;M;30;CHILENO;FONOAUDIOLOGO;Millenial;TOME                          ;BIO BIO;0;0;0;0;0;0;0;0;0;CORTA PELO GM 562;PERSONAL CARE
15552146;;F;37;CHILENO;;Millenial;VILLARICA                     ;ARAUCANIA;0;0;0;0;0;0;0;0;0;DEPILADORA HP-6543;PERSONAL CARE
11956164;;M;50;CHILENO;;X;RENCA                         ;METROPOLITANA;0;0;0;0;0;0;0;0;0;SECADOR DE PELO SG-3035 NEGRO;PERSONAL CARE
10727312;Divorciado;F;52;CHILENO;SECRETARIA;X;RENCA                         ;METROPOLITANA;0;0;0;0;0;0;0;0;0;DEPILADORA HP-6543;PERSONAL CARE
12639134;;F;49;CHILENO;;X;SAN MIGUEL                    ;METROPOLITANA;18980;2;2;2;2;18980;0;0;0;Hervidor Inox One Midea;ELECTRODOMESTICOS
12029414;;F;48;CHILENO;;X;NUEVA IMPERIAL                ;ARAUCANIA;378970;3;2;0;0;0;3;2;378970;Horno Electrico TH62I 60Lts;ELECTRODOMESTICOS
8360273;;M;53;CHILENO;;X;RENCA                         ;METROPOLITANA;67980;2;2;0;0;0;2;2;67980;Hervidor Electrico Tetera HA-4100 4Lts Iox;ELECTRODOMESTICOS
10369090;;M;56;CHILENO;;Boomers;PICHIDEGUA                    ;L.G.B.OÂ´HIGGINS;232020;6;3;0;0;0;6;3;232020;HORNO ELECTRICO DORTMUND 45 LITROS;ELECTRODOMESTICOS
16839366;;M;34;CHILENO;;Silencioso;PROVIDENCIA                   ;METROPOLITANA;479980;2;2;2;2;479980;0;0;0;Horno Microonda Columba 1700;ELECTRODOMESTICOS
11279543;;F;53;CHILENO;;X;SAN FERNANDO                  ;L.G.B.OÂ´HIGGINS;997920;11;6;0;0;0;11;6;997920;Horno Electrico TH-80i 80Lts;ELECTRODOMESTICOS
13778875;Soltero;F;42;CHILENO;;X;SAN VICENTE                   ;L.G.B.OÂ´HIGGINS;13990;1;1;0;0;0;1;1;13990;Plancha a Vapor 5001;ELECTRODOMESTICOS
12029352;;F;57;CHILENO;;Boomers;VICTORIA                      ;ARAUCANIA;1044370;9;9;0;0;0;9;9;1044370;Hervidor Electrico UT-DUNKEL17P 2Lts Negro;ELECTRODOMESTICOS
17568795;;F;31;CHILENO;;Millenial;QUILPUE                       ;VALPARAISO;22990;1;1;0;0;0;1;1;22990;Licuadora Berry Blender Roja 1400 Vaso Vidrio;ELECTRODOMESTICOS
9566317;Casado;F;61;CHILENO;;Boomers;RENCA                         ;METROPOLITANA;26990;1;1;0;0;0;1;1;26990;Hervidor Electrico UT-REIN17SS;ELECTRODOMESTICOS
7759780;Casado;F;71;CHILENO;;Silencioso;RENCA                         ;METROPOLITANA;66830;3;2;0;0;0;3;2;66830;Plancha UT-KERAMIKTOP 2200Watts Base Ceramica;ELECTRODOMESTICOS
6304991;;M;71;CHILENO;;Silencioso;HUALQUI                       ;BIO BIO;106060;2;1;0;0;0;2;1;106060;Olla Multiuso 6801 5,7Lts;ELECTRODOMESTICOS
15250135;;F;40;CHILENO;;X;COIHUECO                      ;BIO BIO;221980;3;2;0;0;0;3;2;221980;Licuadora TH-401V Roja 1,75Lts Vaso Vidrio;ELECTRODOMESTICOS
8433674;;F;63;CHILENO;;Boomers;RENCA                         ;METROPOLITANA;211860;3;1;0;0;0;3;1;211860;Maquina de coser Singer 024;ELECTRODOMESTICOS
12361369;;F;49;CHILENO;;X;QUILLON                       ;BIO BIO;319990;3;2;0;0;0;3;2;319990;Maquina de Coser ST-371HD Heavy Duty;ELECTRODOMESTICOS
19745945;;F;24;CHILENO;;Z;PROVIDENCIA                   ;METROPOLITANA;11990;1;1;0;0;0;1;1;11990;Hervidor Inox One Midea;ELECTRODOMESTICOS
5884307;;M;74;CHILENO;;Silencioso;COPIAPO                       ;ATACAMA;117130;3;2;0;0;0;3;2;117130;Horno Microondas Digital TH-20S01 20Lts;ELECTRODOMESTICOS
13571288;Casado;F;43;CHILENO;TECNICO DE NIVEL SUPERIOR EN PODOLOGIA;X;SANTA CRUZ                    ;L.G.B.OÂ´HIGGINS;54980;2;2;0;0;0;2;2;54980;Hervidor Electrico Tetera TH-6505RT 1,7Lts Rojo;ELECTRODOMESTICOS
10061920;;M;53;CHILENO;;X;TOCOPILLA                     ;ANTOFAGASTA;43990;1;1;0;0;0;1;1;43990;Aspiradora AP1700 Arrastre 1700Watts;ELECTRODOMESTICOS
9697785;;F;58;CHILENO;;Boomers;MELIPILLA                     ;METROPOLITANA;559142;10;8;0;0;0;10;8;559142;Horno Electrico TH62I 60Lts;ELECTRODOMESTICOS
10592380;;F;55;CHILENO;;Boomers;CONCEPCION                    ;BIO BIO;17980;2;1;2;1;17980;0;0;0;BATIDORA MANUAL 150W 5VEL. B-1500 BLANCA;ELECTRODOMESTICOS
13067783;;F;46;CHILENO;;X;RENCA                         ;METROPOLITANA;18990;1;2;0;0;0;1;2;18990;Hervidor Electrico TH-4515N 2Lts Negro;ELECTRODOMESTICOS
15222110;;M;39;CHILENO;;X;SAN PEDRO DE LA PAZ           ;BIO BIO;59990;1;3;1;1;34990;0;2;25000;Aspiradora TH1870 Arrastre 1800Watts Gris;ELECTRODOMESTICOS
8371147;;M;71;CHILENO;;Silencioso;IQUIQUE                       ;TARAPACA;744723;11;5;0;0;0;11;5;744723;Olla Arrocera OA-400NG 1,8Lts;ELECTRODOMESTICOS
7160637;;M;69;CHILENO;;Silencioso;PROVIDENCIA                   ;METROPOLITANA;24990;1;1;0;0;0;1;1;24990;Hervidor Electrico TH-5407i 2Lts;ELECTRODOMESTICOS
8591151;;M;64;CHILENO;;Boomers;NAVIDAD                       ;L.G.B.OÂ´HIGGINS;13993;1;1;0;0;0;1;1;13993;Plancha UT-KERAMIK1 2200Watts Base Ceramica;ELECTRODOMESTICOS
11877696;;F;50;CHILENO;;X;N/D;N/D;49990;2;1;0;0;0;2;1;49990;PICADORA 123 MULTIUSO P-123TVIN;ELECTRODOMESTICOS
6048818;;M;73;CHILENO;;Silencioso;NATALES                       ;MAGALLANES;752000;7;5;0;0;0;7;5;752000;Plancha Easy Steam (PV4500);ELECTRODOMESTICOS
13557213;Soltero;F;43;CHILENO;;X;PROVIDENCIA                   ;METROPOLITANA;20240;2;1;0;0;0;2;1;20240;Tostador de PanTH-120R 2 Rebanadas Rojo;ELECTRODOMESTICOS
26364509;;M;57;EXTRANJERO - NO INFORMA NACIONALIDAD;;Extranjero;"";"";69990;1;1;0;0;0;1;1;69990;Horno Microondas Mecanico M-2020NG 20Lts;ELECTRODOMESTICOS
13051099;;F;46;CHILENO;;X;"";"";285900;8;2;8;2;285900;0;0;0;PLANCHA A VAPOR 6953 BASE AEROCERAMICA AUTAPA.22;ELECTRODOMESTICOS
10827266;;F;57;CHILENO;;Millenial;"";"";22990;1;1;0;0;0;1;1;22990;Licuadora Berry Blender Roja 1400 Vaso Vidrio;ELECTRODOMESTICOS
9004555;;F;61;CHILENO;;Boomers;PROVIDENCIA                   ;METROPOLITANA;25491;1;1;0;0;0;1;1;25491;Batidora Vertical Minipimer UT-KLOT400P;ELECTRODOMESTICOS
16294731;;F;35;CHILENO;;Millenial;HUASCO                        ;ATACAMA;1090000;18;12;0;0;0;18;12;1090000;Hervidor Electrico TH-4515N 2Lts Negro;ELECTRODOMESTICOS
27118090;;M;38;CHILENO;;Extranjero;"";"";493950;5;3;2;1;289980;3;2;203970;Plancha a Vapor 5001;ELECTRODOMESTICOS
16362841;;F;36;CHILENO;;Millenial;PROVIDENCIA                   ;METROPOLITANA;111980;2;2;0;0;0;2;2;111980;Exprimidor Fauna 500 cc;ELECTRODOMESTICOS
11650976;Soltero;F;52;CHILENO;;X;VILLARRICA;ARAUCANIA;46970;4;2;3;1;31980;1;1;14990;Hervidor Electrico UT-MANLY17 1,7Lts Negro;ELECTRODOMESTICOS
17258304;;F;33;CHILENO;;Millenial;SAN ANTONIO                   ;VALPARAISO;33980;2;2;0;0;0;2;2;33980;Batidora Vertical Stick Mixer 2609;ELECTRODOMESTICOS
16531242;Soltero;F;35;CHILENO;;Millenial;RENCA                         ;METROPOLITANA;15990;1;1;0;0;0;1;1;15990;Hervidor Electrico TH-4212N 1,7Lts Negro;ELECTRODOMESTICOS
16214035;;M;36;CHILENO;;Millenial;"";"";189990;1;1;0;0;0;1;1;189990;Horno Electrico TH-100i 100Lts;ELECTRODOMESTICOS
11011014;;M;41;CHILENO;;X;CANETE                        ;BIO BIO;211870;13;14;0;0;0;13;14;211870;HERVIDOR TH-4340;ELECTRODOMESTICOS
7448108;;F;69;CHILENO;;Silencioso;CURICO                        ;MAULE;270555;4;3;0;0;0;4;3;270555;Hervidor Electrico Tetera UT-LECKER18R 1,8Lts;ELECTRODOMESTICOS
26645273;;M;25;EXTRANJERO - NO INFORMA NACIONALIDAD;;Extranjero;"";"";402810;5;3;0;0;0;5;3;402810;Licuadora Berry Blender Roja 1400 Vaso Vidrio;ELECTRODOMESTICOS
6271753;Casado;F;66;CHILENO;;Boomers;"";"";11990;1;1;0;0;0;1;1;11990;Hervidor Inox One Midea;ELECTRODOMESTICOS
8308567;Casado;F;61;CHILENO;PROFESOR;Boomers;PUENTE ALTO                   ;METROPOLITANA;19990;1;1;0;0;0;1;1;19990;Tostador de PanTH-120R 2 Rebanadas Rojo;ELECTRODOMESTICOS
24243629;;M;28;PERUANO;;Extranjero;"";"";605950;5;3;0;0;0;5;3;605950;Licuadora Osterizer 4112/72 1,25Lts Vaso Vidrio;ELECTRODOMESTICOS
12276956;;M;50;CHILENO;;X;PUENTE ALTO                   ;METROPOLITANA;1042780;11;3;0;0;0;11;3;1042780;Olla Multiuso 6801 5,7Lts;ELECTRODOMESTICOS
20018310;;F;22;CHILENO;;Z;VALDIVIA                      ;LOS LAGOS;1029878;14;8;0;0;0;14;8;1029878;Aspiradora TH1415 Arrastre 1500Watts;ELECTRODOMESTICOS
7857420;;M;66;CHILENO;;Boomers;RENCA                         ;METROPOLITANA;26980;2;1;0;0;0;2;1;26980;TOSTADOR OLDEMBURGO 2 REBANADAS;ELECTRODOMESTICOS
7716836;;M;67;CHILENO;;Boomers;RENCA                         ;METROPOLITANA;294462;4;4;0;0;0;4;4;294462;Hervidor Electrico HA-3300 2,5Lts Blanco;ELECTRODOMESTICOS
13113344;;M;47;CHILENO;;X;RENCA                         ;METROPOLITANA;292360;3;2;0;0;0;3;2;292360;Horno Microondas Digital TH-20S01 20Lts;ELECTRODOMESTICOS
10662809;;F;54;CHILENO;;Boomers;N/D;N/D;209800;7;5;0;0;0;7;5;209800;Licuadora Berry Blender Roja 1400 Vaso Vidrio;ELECTRODOMESTICOS
14312242;;F;46;CHILENO;;X;N/D;N/D;409960;4;3;1;1;24990;3;2;384970;Aspiradora UT-SILENT1603 Arrastre 1600Watts;ELECTRODOMESTICOS
13390464;;F;43;CHILENO;;X;LOS ALAMOS                    ;BIO BIO;679900;10;8;2;1;99980;8;7;579920;HORNO ELECTRICO BREMEN 23 LITROS;ELECTRODOMESTICOS
15064410;;M;39;CHILENO;;X;PROVIDENCIA                   ;METROPOLITANA;100980;2;2;0;0;0;2;2;100980;Horno Electrico TH-48N 48Lts;ELECTRODOMESTICOS
14141231;;M;40;CHILENO;;X;N/D;N/D;579940;6;5;0;0;0;6;5;579940;Parrilla Electrica TH-224;ELECTRODOMESTICOS
8990712;;M;60;CHILENO;;Boomers;PROVIDENCIA                   ;METROPOLITANA;17990;1;1;0;0;0;1;1;17990;Hervidor Family Kettle HE500;ELECTRODOMESTICOS
7702086;;F;65;CHILENO;;Boomers;NATALES                       ;MAGALLANES;175970;3;3;0;0;0;3;3;175970;Aspiradora VCC4190V3E/XZS Arrastre 2000Watts;ELECTRODOMESTICOS
7369331;;F;67;CHILENO;;Boomers;ARICA                         ;ARICA Y PARINACOTA;140672;5;4;0;0;0;5;4;140672;Hervidor Electrico Tetera UT-LECKER18R 1,8Lts;ELECTRODOMESTICOS
16899582;;M;34;CHILENO;;Millenial;N/D;N/D;494920;8;4;8;4;494920;0;0;0;ASPIRADORA SAMSUNG VC18M3110VB/ZS;ELECTRODOMESTICOS
12190858;;F;53;CHILENO;;X;TIRUA                         ;BIO BIO;742033;7;6;0;0;0;7;6;742033;Combo Licuadora + Batidora;ELECTRODOMESTICOS
12622927;;M;47;CHILENO;;X;N/D;N/D;34990;1;1;1;1;34990;0;0;0;HORNO ELECTRICO BREMEN 23 LITROS;ELECTRODOMESTICOS
6916208;;M;65;CHILENO;;Boomers;LEBU                          ;BIO BIO;21990;1;1;0;0;0;1;1;21990;Hervidor Electrico UT-DUNKEL17P 2Lts Negro;ELECTRODOMESTICOS
9055666;;M;61;CHILENO;;Boomers;PANGUIPULLI                   ;LOS RIOS;66060;2;1;0;0;0;2;1;66060;Horno Microondas Mecanico Easy Wave 20Lts;ELECTRODOMESTICOS
10417065;;M;53;CHILENO;;X;"";"";127970;3;2;0;0;0;3;2;127970;PROCESADOR THOMAS TH-9160;ELECTRODOMESTICOS
18505442;;F;29;CHILENO;;Millenial;"";"";16990;1;1;0;0;0;1;1;16990;HERVIDOR HAMBURGO 2,0 LITROS;ELECTRODOMESTICOS
26657432;Soltero;F;35;EXTRANJERO - NO INFORMA NACIONALIDAD;;Extranjero;ESTACION CENTRAL              ;METROPOLITANA;766370;8;7;2;1;209990;6;6;556380;FREIDORA DE AIRE THOMAS TH-AF60Mi;ELECTRODOMESTICOS
17813689;;M;35;CHILENO;;Millenial;N/D;N/D;208463;4;3;0;0;0;4;3;208463;Hervidor Electrico TH-4212N 1,7Lts Negro;ELECTRODOMESTICOS
13617013;;F;43;CHILENO;;X;SAN CARLOS                    ;BIO BIO;599960;4;4;0;0;0;4;4;599960;Horno Electrico TH62I 60Lts;ELECTRODOMESTICOS
13989258;;F;41;CHILENO;;X;LA LIGUA                      ;VALPARAISO;2481812;25;12;2;1;334980;23;11;2146832;Hervidor Electrico TH-4515N 2Lts Negro;ELECTRODOMESTICOS
12360751;;M;49;CHILENO;;X;SAN IGNACIO                   ;BIO BIO;494070;4;3;0;0;0;4;3;494070;Batidora Pedestal UT-KLEIN700;ELECTRODOMESTICOS
6100646;Casado;M;74;CHILENO;AGRONOMO;Silencioso;RENCA                         ;METROPOLITANA;38990;1;1;0;0;0;1;1;38990;Aspiradora TH1407 Arrastre 1400Watts;ELECTRODOMESTICOS
18176334;Soltero;F;29;CHILENO;;Millenial;RENCA                         ;METROPOLITANA;13990;1;1;0;0;0;1;1;13990;HERVIDOR TH-4340;ELECTRODOMESTICOS
14049182;;M;42;CHILENO;;X;SAN FERNANDO                  ;L.G.B.OÂ´HIGGINS;45980;2;2;0;0;0;2;2;45980;Hervidor Family Kettle HE500;ELECTRODOMESTICOS
26421905;;M;33;HAITIANO;;Extranjero;CHEPICA                       ;L.G.B.OÂ´HIGGINS;116923;5;2;0;0;0;5;2;116923;LICUADORA CROMADA CON TECLAS PLUS;ELECTRODOMESTICOS
6501649;;F;69;CHILENO;;Silencioso;RIO NEGRO                     ;LOS LAGOS;139980;2;3;0;0;0;2;3;139980;Horno Electrico TH62I 60Lts;ELECTRODOMESTICOS
6339407;Viudo;F;70;CHILENO;;Silencioso;RENCA                         ;METROPOLITANA;29990;1;1;0;0;0;1;1;29990;Licuadora L-5500IN 1,5Lts;ELECTRODOMESTICOS
12816790;;F;47;CHILENO;;X;LA LIGUA                      ;VALPARAISO;137980;2;2;0;0;0;2;2;137980;HORNO ELECTRICO MUNICH 60 LITROS;ELECTRODOMESTICOS
13393451;;F;44;CHILENO;;X;CANETE                        ;BIO BIO;28980;2;1;0;0;0;2;1;28980;Sandwichera TH-952 2 Panes Blanca;ELECTRODOMESTICOS
19399589;;F;26;CHILENO;;Z;CASTRO                        ;LOS LAGOS;47970;3;2;0;0;0;3;2;47970;Hervidor Electrico TH-4212N 1,7Lts Negro;ELECTRODOMESTICOS
17160393;;F;33;CHILENO;;Z;N/D;N/D;0;0;2;0;0;0;0;2;0;FREIDORA DE AIRE BAVIERA 3,8 LITROS;ELECTRODOMESTICOS
13835896;;M;42;CHILENO;;X;LA PINTANA                    ;METROPOLITANA;48950;6;2;6;2;48950;0;0;0;Batidora Vertical Minipimer UT-KLOT400P;ELECTRODOMESTICOS
14104527;;F;40;CHILENO;;X;HUARA                         ;TARAPACA;60830;3;2;0;0;0;3;2;60830;HORNO 10 LITROS OSTER ROJO;ELECTRODOMESTICOS
14345043;;F;45;CHILENO;;X;N/D;N/D;864920;9;5;0;0;0;9;5;864920;Horno Microondas Digital L UT-25KROMM 25Lts;ELECTRODOMESTICOS
14092928;;F;40;CHILENO;;X;"";"";70970;3;2;0;0;0;3;2;70970;Batidora Pedestal UT-KLEIN700;ELECTRODOMESTICOS
16509603;;M;35;CHILENO;;Millenial;SAN ANTONIO                   ;VALPARAISO;29990;1;1;1;1;29990;0;0;0;FREIDORA DE AIRE HESSIA 2,0 LITROS;ELECTRODOMESTICOS
14533149;;F;43;CHILENO;;X;PROVIDENCIA                   ;METROPOLITANA;697950;6;3;5;2;683960;1;1;13990;Plancha a Vapor 5001;ELECTRODOMESTICOS
5067592;;F;75;CHILENO;;Silencioso;ARICA                         ;ARICA Y PARINACOTA;583461;4;2;0;0;0;4;2;583461;PLANCHA A VAPOR GCSTCS401 SUELA CERAMICA 2200W;ELECTRODOMESTICOS
19859455;;F;24;CHILENO;;Z;N/D;N/D;427980;4;2;0;0;0;4;2;427980;ASPIRADORA THOMAS TH-1640;ELECTRODOMESTICOS
8729911;;F;56;CHILENO;;Boomers;COIHAIQUE                     ;AYSEN;19990;1;1;0;0;0;1;1;19990;PLANCHA A VAPOR 6003 BASE ANTIADHERENTE 1600W;ELECTRODOMESTICOS
18121856;;F;30;CHILENO;;Silencioso;PROVIDENCIA                   ;METROPOLITANA;14980;2;1;2;1;14980;0;0;0;HERVIDOR HA-2010 BL;ELECTRODOMESTICOS
9324125;Viudo;M;60;CHILENO;;Boomers;TALAGANTE                     ;METROPOLITANA;117970;3;2;0;0;0;3;2;117970;Batidora Pedestal UT-KLEIN700;ELECTRODOMESTICOS
18610571;;F;29;CHILENO;;Millenial;QUINTA NORMAL                 ;METROPOLITANA;21990;1;1;0;0;0;1;1;21990;Hervidor Electrico TH-4515N 2Lts Negro;ELECTRODOMESTICOS
7809329;;F;65;CHILENO;;Boomers;LONCOCHE                      ;ARAUCANIA;14990;1;1;0;0;0;1;1;14990;Batidora Manual 3532;ELECTRODOMESTICOS
12804058;;F;47;CHILENO;;X;VALLENAR;ATACAMA;272661;4;4;0;0;0;4;4;272661;Maquina de coser Singer 024;ELECTRODOMESTICOS
8247330;;F;63;CHILENO;;Boomers;PAPUDO                        ;VALPARAISO;315060;5;4;0;0;0;5;4;315060;Licuadora L1000 Inox 1,7LtsVaso Vidrio;ELECTRODOMESTICOS
13731118;;M;43;CHILENO;;X;N/D;N/D;553930;7;4;3;1;213970;4;3;339960;Horno Microonda Columba 1700;ELECTRODOMESTICOS
19306301;;F;25;CHILENO;;Z;TEMUCO;ARAUCANIA;39990;1;1;1;1;39990;0;0;0;Horno Electrico UT-BACKOFEN26 26Lts;ELECTRODOMESTICOS
14560403;;M;41;CHILENO;;X;CALAMA                        ;ANTOFAGASTA;45980;2;2;0;0;0;2;2;45980;HERVIDOR BERLIN 1,7 LITROS;ELECTRODOMESTICOS
12487282;;F;49;CHILENO;;X;PROVIDENCIA                   ;METROPOLITANA;822950;5;5;0;0;0;5;5;822950;Horno Microondas Digital L UT-25KROMM 25Lts;ELECTRODOMESTICOS
11520380;Casado;M;51;CHILENO;;X;RENCA                         ;METROPOLITANA;37990;2;1;0;0;0;2;1;37990;Licuadora L-1630V Negra 1,5Lts Vaso Vidrio;ELECTRODOMESTICOS
17065327;;F;33;CHILENO;;Millenial;PROVIDENCIA                   ;METROPOLITANA;79990;1;1;0;0;0;1;1;79990;Batidora Pedestal TH910PN 4,6Lts 1300Watts;ELECTRODOMESTICOS
15186261;;M;39;CHILENO;;X;"";"";136210;6;4;0;0;0;6;4;136210;Parrilla Electrica TH-180;ELECTRODOMESTICOS
8585508;;F;65;CHILENO;;Boomers;ANTOFAGASTA                   ;ANTOFAGASTA;236050;3;2;0;0;0;3;2;236050;Horno Microonda Columba 1700;ELECTRODOMESTICOS
6477348;;F;71;CHILENO;;Silencioso;LA CISTERNA                   ;METROPOLITANA;339660;5;4;0;0;0;5;4;339660;FREIDORA DE AIRE THOMAS TH-AF60Mi;ELECTRODOMESTICOS
11325074;;M;54;CHILENO;;X;N/D;N/D;394980;2;2;0;0;0;2;2;394980;Horno Electrico TH-80i 80Lts;ELECTRODOMESTICOS
6323707;;M;69;CHILENO;;Silencioso;N/D;N/D;513440;5;3;0;0;0;5;3;513440;Licuadora L1000 Inox 1,7LtsVaso Vidrio;ELECTRODOMESTICOS
15294733;;F;39;CHILENO;;X;COIHAIQUE                     ;AYSEN;268030;5;4;0;0;0;5;4;268030;Horno Electrico TH-48N 48Lts;ELECTRODOMESTICOS
15114392;;M;40;CHILENO;;X;PALMILLA                      ;L.G.B.OÂ´HIGGINS;538070;6;4;0;0;0;6;4;538070;Aspiradora TH1870 Arrastre 1800Watts Gris;ELECTRODOMESTICOS
9005527;;F;63;CHILENO;;Boomers;EL BOSQUE                     ;METROPOLITANA;414880;4;3;0;0;0;4;3;414880;HERVIDOR TH-4340;ELECTRODOMESTICOS
19450909;;F;41;CHILENO;;X;COPIAPO                       ;ATACAMA;29990;1;1;0;0;0;1;1;29990;Combo Licuadora + Batidora;ELECTRODOMESTICOS
10808784;;F;51;CHILENO;;Millenial;N/D;N/D;854589;8;5;0;0;0;8;5;854589;Horno Microondas Mecanico TH-18B05 18Lts;ELECTRODOMESTICOS
18334327;;M;29;CHILENO;;Millenial;SAN FERNANDO                  ;L.G.B.OÂ´HIGGINS;959172;12;6;3;1;335970;9;5;623202;HORNO ELECTRICO MUNICH 60 LITROS;ELECTRODOMESTICOS
7309263;;F;66;CHILENO;;Boomers;ARICA                         ;ARICA Y PARINACOTA;23980;2;1;0;0;0;2;1;23980;Plancha Easy Steam (PV4500);ELECTRODOMESTICOS
15119191;;F;39;CHILENO;;X;N/D;N/D;88950;5;6;1;1;12990;4;5;75960;Hervidor Electrico TH-4515N 2Lts Negro;ELECTRODOMESTICOS
18202799;;F;29;CHILENO;;Millenial;N/D;N/D;235030;6;4;0;0;0;6;4;235030;Horno Microondas Mecanico Easy Wave 20Lts;ELECTRODOMESTICOS
13865764;;F;41;CHILENO;;X;IQUIQUE                       ;TARAPACA;59990;1;1;0;0;0;1;1;59990;FREIDORA DE AIRE BAVIERA 3,8 LITROS;ELECTRODOMESTICOS
16131960;;M;36;CHILENO;;Millenial;SAN BERNARDO                  ;METROPOLITANA;327980;2;2;0;0;0;2;2;327980;Hervidor Family Kettle HE500;ELECTRODOMESTICOS
6434136;;M;72;CHILENO;;Silencioso;CHILLAN                       ;BIO BIO;74980;2;2;0;0;0;2;2;74980;Plancha TH-7052 2000Watts Base Inox;ELECTRODOMESTICOS
9436718;;F;58;CHILENO;;Boomers;SAN BERNARDO                  ;METROPOLITANA;559970;3;2;0;0;0;3;2;559970;Hervidor Electrico UT-DUNKEL17P 2Lts Negro;ELECTRODOMESTICOS
8063943;;M;63;CHILENO;;Boomers;TALAGANTE                     ;METROPOLITANA;219380;3;3;0;0;0;3;3;219380;Horno Microondas Digital L UT-25KROMM 25Lts;ELECTRODOMESTICOS
5588761;;M;71;CHILENO;;Silencioso;RENCA                         ;METROPOLITANA;24990;1;1;0;0;0;1;1;24990;Batidora Vertical Multimixer TH-8720;ELECTRODOMESTICOS
8635678;Casado;F;62;CHILENO;;Boomers;RENCA                         ;METROPOLITANA;119990;1;1;0;0;0;1;1;119990;Maquina de Coser JS-2135CL Calipso;ELECTRODOMESTICOS
19097954;;F;26;CHILENO;;Z;CAUQUENES                     ;MAULE;1840870;13;10;0;0;0;13;10;1840870;Licuadora L-1630V Negra 1,5Lts Vaso Vidrio;ELECTRODOMESTICOS
20315602;;M;23;CHILENO;;Z;N/D;N/D;14990;1;1;0;0;0;1;1;14990;HERVIDOR COLONIA 1,7 LITROS;ELECTRODOMESTICOS
9640289;;F;61;CHILENO;;Boomers;PROVIDENCIA                   ;METROPOLITANA;675942;11;6;0;0;0;11;6;675942;Licuadora Osterizer 4112/72 1,25Lts Vaso Vidrio;ELECTRODOMESTICOS
15019290;;F;40;CHILENO;;X;ANTOFAGASTA                   ;ANTOFAGASTA;48990;1;1;0;0;0;1;1;48990;Horno Microondas Mecanico Fancy 20Lts;ELECTRODOMESTICOS
7161274;;F;70;CHILENO;;Silencioso;SAN FELIPE                    ;VALPARAISO;116182;5;3;0;0;0;5;3;116182;Hervidor Family Kettle HE500;ELECTRODOMESTICOS
15811358;;F;38;CHILENO;;Millenial;PROVIDENCIA                   ;METROPOLITANA;149990;1;1;0;0;0;1;1;149990;Maquina de coser Singer 024;ELECTRODOMESTICOS
18227424;;F;29;CHILENO;;Millenial;PROVIDENCIA                   ;METROPOLITANA;27980;2;2;0;0;0;2;2;27980;Batidora Vertical Stick Mixer 2609;ELECTRODOMESTICOS
16124460;Soltero;M;37;CHILENO;INGENIERO EN TELECOMUNICACIONES;Millenial;RENCA                         ;METROPOLITANA;100960;4;2;4;2;100960;0;0;0;Olla Multiuso TH-40PC 0,5Lts;ELECTRODOMESTICOS
19325190;;F;25;CHILENO;;Millenial;N/D;N/D;36990;1;1;0;0;0;1;1;36990;Combo Hervidor + Tostador + Sandwichera;ELECTRODOMESTICOS
12544812;;F;47;CHILENO;;X;N/D;N/D;136950;5;4;0;0;0;5;4;136950;Aspiradora UT-SILENT1603 Arrastre 1600Watts;ELECTRODOMESTICOS
19212745;;F;26;CHILENO;;Z;ISLA DE MAIPO                 ;METROPOLITANA;807940;6;4;2;1;283980;4;3;523960;Horno Electrico TH62I 60Lts;ELECTRODOMESTICOS
15343764;Soltero;M;40;CHILENO;;X;RENCA                         ;METROPOLITANA;59990;1;1;0;0;0;1;1;59990;Aspiradora UT-SILENT1603 Arrastre 1600Watts;ELECTRODOMESTICOS
10675575;;F;54;CHILENO;;X;ARICA                         ;ARICA Y PARINACOTA;49840;2;1;0;0;0;2;1;49840;Plancha UT-SHANGRILA Inalambrica 2200Watss;ELECTRODOMESTICOS
16748390;;M;34;CHILENO;;Millenial;N/D;N/D;89980;2;1;0;0;0;2;1;89980;FREIDORA DE AIRE BAVIERA 3,8 LITROS;ELECTRODOMESTICOS
6649758;;F;71;CHILENO;;Silencioso;SAN FERNANDO                  ;L.G.B.OÂ´HIGGINS;136971;3;2;0;0;0;3;2;136971;FREIDORA DE AIRE THOMAS TH-AF60Mi;ELECTRODOMESTICOS
11817051;;F;50;CHILENO;;X;N/D;N/D;240970;3;2;0;0;0;3;2;240970;Horno Microondas Mecanico Easy Wave 20Lts;ELECTRODOMESTICOS
16873161;;M;34;CHILENO;;Millenial;"";"";79990;1;1;0;0;0;1;1;79990;Batidora Pedestal TH910PN 4,6Lts 1300Watts;ELECTRODOMESTICOS
8828837;;M;60;CHILENO;;Boomers;PROVIDENCIA                   ;METROPOLITANA;43980;2;1;2;1;43980;0;0;0;Horno Microondas Mecanico C1700N 17Lts Blanco;ELECTRODOMESTICOS
14562028;;M;42;CHILENO;;X;N/D;N/D;791940;6;4;0;0;0;6;4;791940;Horno Electrico TH-100i 100Lts;ELECTRODOMESTICOS
5260933;;M;77;CHILENO;;Silencioso;LA SERENA                     ;COQUIMBO;431970;3;2;0;0;0;3;2;431970;Plancha UT-KERAMIKTOP 2200Watts Base Ceramica;ELECTRODOMESTICOS
14043407;;F;43;CHILENO;;X;RIO IBANEZ                    ;AYSEN;62980;2;1;0;0;0;2;1;62980;PICADORA 123 SILHQUETTE;ELECTRODOMESTICOS
16179741;;M;36;CHILENO;;Millenial;"";"";44990;1;1;0;0;0;1;1;44990;Parrilla Electrica M18W;ELECTRODOMESTICOS
6496181;Soltero;M;72;CHILENO;;Silencioso;PROVIDENCIA                   ;METROPOLITANA;97970;3;4;0;0;0;3;4;97970;Hervidor Family Kettle HE500;ELECTRODOMESTICOS
8217051;Casado;F;61;CHILENO;INGENIERO INDUSTRIAL;Boomers;RENCA                         ;METROPOLITANA;402920;8;5;5;3;252950;3;2;149970;Horno Electrico TH-38N 38Lts;ELECTRODOMESTICOS
19977532;;M;23;CHILENO;;Z;ALTO HOSPICIO;TARAPACA;26979;2;1;0;0;0;2;1;26979;Combo Hervidor + Batidora;ELECTRODOMESTICOS
18902715;Soltero;F;27;CHILENO;;Millenial;"";"";27990;1;1;0;0;0;1;1;27990;Licuadora Berry Blender Roja 1400 Vaso Vidrio;ELECTRODOMESTICOS
13580671;;F;42;CHILENO;;X;CANETE                        ;BIO BIO;314970;4;4;0;0;0;4;4;314970;SUPER FREIDORA DE AIRE OV3;ELECTRODOMESTICOS
14298747;;M;47;CHILENO;;X;LOS ANGELES                   ;BIO BIO;74980;2;2;0;0;0;2;2;74980;Combo Licuadora + Batidora;ELECTRODOMESTICOS
17399317;Soltero;F;32;CHILENO;ENFERMERA;Silencioso;PROVIDENCIA                   ;METROPOLITANA;71970;3;2;2;1;41980;1;1;29990;Batidora Vertical Minipimer UT-KLOT400P;ELECTRODOMESTICOS
11699417;;F;51;CHILENO;;X;LOS ANGELES                   ;BIO BIO;12990;1;1;0;0;0;1;1;12990;Batidora Vertical Stick Mixer 2609;ELECTRODOMESTICOS
15701527;;M;38;CHILENO;;X;N/D;N/D;1038940;6;4;2;1;853980;4;3;184960;Hervidor Electrico 3101 1,7Lts Negro;ELECTRODOMESTICOS
8210443;Casado;F;67;CHILENO;;Boomers;PROVIDENCIA                   ;METROPOLITANA;19990;1;1;0;0;0;1;1;19990;Batidora Manual TH-8830;ELECTRODOMESTICOS
16195175;;F;36;CHILENO;;Millenial;MONTE PATRIA                  ;COQUIMBO;14990;1;1;0;0;0;1;1;14990;Plancha a Vapor 5001;ELECTRODOMESTICOS
17588570;;F;30;CHILENO;;Millenial;NATALES                       ;MAGALLANES;354940;6;2;0;0;0;6;2;354940;Aspiradora TH1407 Arrastre 1400Watts;ELECTRODOMESTICOS
20621681;;F;21;CHILENO;;Millenial;"";"";96810;3;1;0;0;0;3;1;96810;Horno Microondas Mecanico TH-18B05 18Lts;ELECTRODOMESTICOS
17774611;;F;30;CHILENO;;Millenial;COQUIMBO                      ;COQUIMBO;102980;2;1;0;0;0;2;1;102980;Batidora Pedestal UT-KLEIN700;ELECTRODOMESTICOS
20088053;;F;23;CHILENO;;Z;CURANILAHUE                   ;BIO BIO;101772;3;2;0;0;0;3;2;101772;Hervidor Electrico Tetera TH-6505RT 1,7Lts Rojo;ELECTRODOMESTICOS
6954685;;M;65;CHILENO;;Boomers;PROVIDENCIA                   ;METROPOLITANA;18240;2;1;0;0;0;2;1;18240;Hervidor Electrico UT-KLAR20PW 2Lts Blanco;ELECTRODOMESTICOS
15592897;;F;38;CHILENO;;Millenial;CONCEPCION;BIO-BIO;151820;4;4;4;4;151820;0;0;0;Licuadora Berry Blender Roja 1400 Vaso Vidrio;ELECTRODOMESTICOS
18651410;;F;30;CHILENO;;Millenial;PETORCA;VALPARAISO;253960;4;2;4;2;253960;0;0;0;HORNO ELECTRICO THOMAS TH-38i;ELECTRODOMESTICOS
15407805;;M;39;CHILENO;;X;PROVIDENCIA                   ;METROPOLITANA;61980;2;1;0;0;0;2;1;61980;Licuadora TH-501V 1,5Lts Vaso Vidrio;ELECTRODOMESTICOS
17631040;;M;31;CHILENO;;Millenial;COIHAIQUE                     ;AYSEN;62980;2;2;0;0;0;2;2;62980;Licuadora Personal TH-300PB;ELECTRODOMESTICOS
15599407;;F;38;CHILENO;;Millenial;"";"";1102930;7;4;5;2;612950;2;2;489980;RECTA BSQ MOD F2 - MOTOR DIRECTO;ELECTRODOMESTICOS
20020871;;F;23;CHILENO;;Z;PROVIDENCIA                   ;METROPOLITANA;55980;2;1;2;1;55980;0;0;0;Horno Microondas Mecanico Fancy 20Lts;ELECTRODOMESTICOS
9723979;;M;56;CHILENO;;Boomers;CURANILAHUE                   ;BIO BIO;31990;1;1;0;0;0;1;1;31990;Cafetera TH-138i;ELECTRODOMESTICOS
12967691;;F;46;CHILENO;;Extranjero;COIHUECO                      ;BIO BIO;59980;2;1;0;0;0;2;1;59980;Extractor de Jugo EX800 1,4Lts;ELECTRODOMESTICOS
7777710;;M;65;CHILENO;;Boomers;IQUIQUE                       ;TARAPACA;502420;7;5;0;0;0;7;5;502420;Licuadora Berry Blender Roja 1400 Vaso Vidrio;ELECTRODOMESTICOS
26453114;;M;30;CHILENO;;Extranjero;SAN PEDRO DE LA PAZ           ;BIO BIO;21980;2;2;0;0;0;2;2;21980;Batidora Vertical Stick Mixer 2609;ELECTRODOMESTICOS
12599394;;F;48;CHILENO;;X;PUTAENDO                      ;VALPARAISO;1106720;10;7;0;0;0;10;7;1106720;Horno Microondas Digital TH-20S01 20Lts;ELECTRODOMESTICOS
16388108;Casado;F;35;CHILENO;TECNICO DE NIVEL SUPERIOR EN ENFERMERIA Y TELEMEDICINA;Millenial;PROVIDENCIA                   ;METROPOLITANA;54990;1;1;0;0;0;1;1;54990;Horno Microondas Mecanico Fancy 20Lts;ELECTRODOMESTICOS
11075136;Casado;F;56;CHILENO;;Boomers;RENCA                         ;METROPOLITANA;17990;1;1;0;0;0;1;1;17990;Sandwichera TH-952 2 Panes Blanca;ELECTRODOMESTICOS
13894544;;M;42;CHILENO;;X;ANCUD                         ;LOS LAGOS;297950;6;3;0;0;0;6;3;297950;HERVIDOR BERLIN 1,7 LITROS;ELECTRODOMESTICOS
9436731;;M;57;CHILENO;;Boomers;CISNES                        ;AYSEN;432040;5;2;0;0;0;5;2;432040;Licuadora Oster Clasica Azul 4134 1,25 lt;ELECTRODOMESTICOS
17780323;;F;31;CHILENO;;Millenial;SAN BERNARDO                  ;METROPOLITANA;83970;3;2;2;1;48980;1;1;34990;Horno Microondas Mecanico Fancy 20Lts;ELECTRODOMESTICOS
8698531;;F;62;CHILENO;;Boomers;QUILPUE                       ;VALPARAISO;336940;6;4;0;0;0;6;4;336940;HERVIDOR TETERA RELOJ 900R 2,5L ROJO;ELECTRODOMESTICOS
19347159;;F;25;CHILENO;;Z;LINARES                       ;MAULE;918870;15;9;3;2;108970;12;7;809900;HORNO ELECTRICO MUNICH 60 LITROS;ELECTRODOMESTICOS
16873519;;F;34;CHILENO;;Millenial;N/D;N/D;187540;3;3;2;1;187540;1;2;0;Aspiradora VCC4190V3E/XZS Arrastre 2000Watts;ELECTRODOMESTICOS
18489272;;F;29;CHILENO;;Millenial;"";"";209960;4;2;1;1;19990;3;1;189970;Combo Hervidor + Batidora;ELECTRODOMESTICOS
9200854;;M;60;CHILENO;;Boomers;ARICA                         ;ARICA Y PARINACOTA;541940;6;3;0;0;0;6;3;541940;HERVIDOR TH-4340;ELECTRODOMESTICOS
6079572;;F;70;CHILENO;;Silencioso;PUCON                         ;ARAUCANIA;202970;3;2;0;0;0;3;2;202970;HORNO ELECTRICO 16N01 16LTS NEGRO;ELECTRODOMESTICOS
18213894;;F;29;CHILENO;;Millenial;LAS CABRAS                    ;L.G.B.OÂ´HIGGINS;139990;1;1;0;0;0;1;1;139990;CAFETERA PRIMA LATTE 6603 ROJA;ELECTRODOMESTICOS
19439505;;M;25;CHILENO;;Z;RECOLETA                      ;METROPOLITANA;69990;1;1;0;0;0;1;1;69990;Horno Microondas Digital UT-CLASSY720 20Lts;ELECTRODOMESTICOS
19166111;;F;26;CHILENO;;Z;"";"";17990;1;1;0;0;0;1;1;17990;Plancha Easy Steam (PV4500);ELECTRODOMESTICOS
17594042;;M;32;CHILENO;;Millenial;N/D;N/D;30793;1;1;0;0;0;1;1;30793;Plancha Paninis 2880;ELECTRODOMESTICOS
18904367;;F;27;CHILENO;;Millenial;PROVIDENCIA                   ;METROPOLITANA;58980;2;1;2;1;58980;0;0;0;HORNO ELECTRICO DORTMUND 45 LITROS;ELECTRODOMESTICOS
8088608;;F;66;CHILENO;;Boomers;LINARES                       ;MAULE;54990;1;1;0;0;0;1;1;54990;BATIDORA PEDESTAL RENANIA 5 LITROS;ELECTRODOMESTICOS
10491242;;F;59;CHILENO;;Boomers;MELIPILLA                     ;METROPOLITANA;19990;1;1;0;0;0;1;1;19990;Licuadora Berry Blender Roja 1400 Vaso Vidrio;ELECTRODOMESTICOS
13761697;;M;42;CHILENO;;X;N/D;N/D;32990;1;1;0;0;0;1;1;32990;Combo Juguera + Hervidor;ELECTRODOMESTICOS
6807790;;M;67;CHILENO;;Boomers;SAN CARLOS                    ;BIO BIO;639960;4;3;0;0;0;4;3;639960;FREIDORA DE AIRE THOMAS TH-AF60Mi;ELECTRODOMESTICOS
11913708;;F;50;CHILENO;;X;PEMUCO                        ;BIO BIO;177230;3;2;0;0;0;3;2;177230;Sandwichera TH-952 2 Panes Blanca;ELECTRODOMESTICOS
19511225;;F;25;CHILENO;;Z;CURANILAHUE                   ;BIO BIO;63830;3;1;0;0;0;3;1;63830;FREIDORA DE AIRE HESSIA 2,0 LITROS;ELECTRODOMESTICOS
18015812;;F;30;CHILENO;;Millenial;ANCUD                         ;LOS LAGOS;70970;3;3;0;0;0;3;3;70970;Hervidor Electrico TH-4515N 2Lts Negro;ELECTRODOMESTICOS
4141967;;M;25;CHILENO;;Z;RENCA                         ;METROPOLITANA;14990;1;1;0;0;0;1;1;14990;Hervidor Electrico TH-4212N 1,7Lts Negro;ELECTRODOMESTICOS
20405657;;M;21;CHILENO;;Millenial;TEMUCO;ARAUCANIA;12990;1;1;0;0;0;1;1;12990;HERVIDOR BERLIN 1,7 LITROS;ELECTRODOMESTICOS
17134328;Soltero;F;33;CHILENO;PROFESOR;Extranjero;PROVIDENCIA                   ;N/D;10990;1;1;1;1;10990;0;0;0;Hervidor Inox One Midea;ELECTRODOMESTICOS
17851011;;F;31;CHILENO;;Millenial;LA PINTANA;METROPOLITANA;159980;2;2;1;1;139990;1;1;19990;Hervidor Electrico TH-4515N 2Lts Negro;ELECTRODOMESTICOS
18780061;Soltero;M;28;CHILENO;PSICOLOGO;Millenial;PROVIDENCIA                   ;METROPOLITANA;53960;4;1;0;0;0;4;1;53960;HERVIDOR TH-4340;ELECTRODOMESTICOS
23236575;Soltero;F;38;PERUANO;;Extranjero;INDEPENDENCIA                 ;METROPOLITANA;515182;5;2;0;0;0;5;2;515182;Horno Microondas Mecanico UT-SYDNEY18 18Lts;ELECTRODOMESTICOS
11787727;;M;50;CHILENO;;X;CURICO                        ;MAULE;38980;2;1;0;0;0;2;1;38980;Hervidor Electrico TH-4515N 2Lts Negro;ELECTRODOMESTICOS
5653975;Soltero;F;75;CHILENO;;Z;SAN VICENTE                   ;L.G.B.OÂ´HIGGINS;1014470;8;4;0;0;0;8;4;1014470;Maquina de coser Singer 024;ELECTRODOMESTICOS
16205551;;F;36;CHILENO;;Millenial;PROVIDENCIA                   ;METROPOLITANA;12990;1;1;0;0;0;1;1;12990;Hervidor Electrico TH-4212N 1,7Lts Negro;ELECTRODOMESTICOS
10587470;;F;49;CHILENO;;X;LOS MUERMOS                   ;LOS LAGOS;313830;6;5;0;0;0;6;5;313830;Horno Electrico TH62I 60Lts;ELECTRODOMESTICOS
16311554;;F;36;CHILENO;;Millenial;N/D;N/D;49990;1;1;0;0;0;1;1;49990;FREIDORA DE AIRE BAVIERA 3,8 LITROS;ELECTRODOMESTICOS
17044404;;M;33;CHILENO;;Millenial;CORONEL                       ;BIO BIO;18990;1;1;0;0;0;1;1;18990;Hervidor Electrico UT-KLAR20PW 2Lts Blanco;ELECTRODOMESTICOS
12484069;;F;48;CHILENO;;X;PUENTE ALTO;METROPOLITANA;38980;2;1;2;1;38980;0;0;0;Hervidor Termo BA-6928 Inox 2,8Lts;ELECTRODOMESTICOS
9368684;;M;57;CHILENO;;Boomers;CANETE                        ;BIO BIO;21990;1;1;0;0;0;1;1;21990;Hervidor Electrico TH-4515N 2Lts Negro;ELECTRODOMESTICOS
17226098;;M;31;CHILENO;;Millenial;SAN NICOLAS;BIO-BIO;24990;1;1;0;0;0;1;1;24990;Hervidor Electrico TH-5407i 2Lts;ELECTRODOMESTICOS
15923787;;F;37;CHILENO;;Millenial;LA SERENA                     ;COQUIMBO;45970;3;1;0;0;0;3;1;45970;Hervidor Electrico TH-4515N 2Lts Negro;ELECTRODOMESTICOS
9446409;;M;58;CHILENO;;Boomers;PROVIDENCIA                   ;METROPOLITANA;12990;1;1;0;0;0;1;1;12990;Batidora Vertical Stick Mixer 2609;ELECTRODOMESTICOS
13331830;;F;44;CHILENO;;X;QUILLOTA                      ;VALPARAISO;532810;8;3;0;0;0;8;3;532810;Batidora Vertical Minipimer UT-KLOT400P;ELECTRODOMESTICOS
14366718;;F;46;CHILENO;;X;ARAUCO                        ;BIO BIO;21990;1;1;0;0;0;1;1;21990;Hervidor Electrico TH-4515N 2Lts Negro;ELECTRODOMESTICOS
15121298;;M;34;CHILENO;;Millenial;NANCAGUA                      ;L.G.B.OÂ´HIGGINS;42980;2;2;0;0;0;2;2;42980;Cafetera UT-KAFFEEKLASSIK;ELECTRODOMESTICOS
18016617;;M;30;CHILENO;;Millenial;ANCUD                         ;LOS LAGOS;40990;1;1;0;0;0;1;1;40990;Combo Hervidor + Tostador + Sandwichera;ELECTRODOMESTICOS
5955093;;F;74;CHILENO;;Silencioso;N/D;N/D;755410;6;3;0;0;0;6;3;755410;Horno Microondas Mecanico Easy Wave 20Lts;ELECTRODOMESTICOS
13865708;;M;41;CHILENO;;X;N/D;N/D;59990;1;1;0;0;0;1;1;59990;Aspiradora AP3400 Arrastre 2000Watts;ELECTRODOMESTICOS
15528391;;F;33;CHILENO;;Millenial;COLBUN                        ;MAULE;1522900;10;7;0;0;0;10;7;1522900;Combo Hervidor + Tostador + Sandwichera;ELECTRODOMESTICOS
13535557;;M;43;CHILENO;;X;N/D;N/D;1169900;10;8;4;2;382960;6;6;786940;Combo Hervidor + Tostador + Sandwichera;ELECTRODOMESTICOS
7228083;;F;72;CHILENO;;Silencioso;OSORNO                        ;LOS LAGOS;95970;3;3;0;0;0;3;3;95970;Combo Hervidor + Batidora;ELECTRODOMESTICOS
16389788;;M;36;CHILENO;;Millenial;PROVIDENCIA                   ;METROPOLITANA;53980;2;1;2;1;53980;0;0;0;Freidora electrica Ut-KeramikAir;ELECTRODOMESTICOS
18671500;Soltero;F;28;CHILENO;FONOAUDIOLOGA;Millenial;PROVIDENCIA                   ;METROPOLITANA;117980;2;1;2;1;117980;0;0;0;HORNO ELECTRICO HE-600IN INOX SINDELEN;ELECTRODOMESTICOS
6219178;;M;71;CHILENO;;Silencioso;RENAICO                       ;ARAUCANIA;36361;2;1;0;0;0;2;1;36361;LICUADORA HANOVER 1,5 LITROS;ELECTRODOMESTICOS
10051649;;F;49;CHILENO;;X;PROVIDENCIA                   ;METROPOLITANA;51970;3;1;3;1;51970;0;0;0;TERMOHERVIDOR BA-6928 AZUL 2,8LTS;ELECTRODOMESTICOS
17622602;Soltero;F;31;CHILENO;;Millenial;PROVIDENCIA                   ;METROPOLITANA;225980;2;1;2;1;225980;0;0;0;Maquina de Coser Computarizada 1030MX Janome;ELECTRODOMESTICOS
18988111;;F;27;CHILENO;;Z;SAN FERNANDO                  ;L.G.B.OÂ´HIGGINS;506570;6;3;3;1;239990;3;2;266580;Maquina de coser Singer 1605;ELECTRODOMESTICOS
9858288;;F;53;CHILENO;;X;N/D;N/D;21990;1;1;0;0;0;1;1;21990;HERVIDOR ELECTRICO UT-STARK18;ELECTRODOMESTICOS
6536706;;F;71;CHILENO;;Silencioso;VILLA ALEMANA                 ;VALPARAISO;52980;2;2;0;0;0;2;2;52980;Licuadora TH-501V 1,5Lts Vaso Vidrio;ELECTRODOMESTICOS
8299685;;M;63;CHILENO;;Boomers;TUCAPEL                       ;BIO BIO;254190;16;4;0;0;0;16;4;254190;HERVIDOR TETERA RELOJ 900R 2,5L ROJO;ELECTRODOMESTICOS
16076069;;F;36;CHILENO;;Millenial;N/D;N/D;77970;3;2;2;1;67980;1;1;9990;Extractor de Jugo TH-2660i 2Lts;ELECTRODOMESTICOS
10526788;;M;52;CHILENO;;X;RENCA                         ;METROPOLITANA;36990;1;1;0;0;0;1;1;36990;HORNO ELECTRICO 16N01 16LTS NEGRO;ELECTRODOMESTICOS
18142424;Soltero;M;30;CHILENO;;Millenial;CONCEPCION;BIO-BIO;20993;1;1;1;1;20993;0;0;0;FREIDORA DE AIRE HESSIA 2,0 LITROS;ELECTRODOMESTICOS
16771877;Soltero;M;34;CHILENO;PSICOLOGO;Millenial;PEUMO;O HIGGINS;100710;2;1;0;0;0;2;1;100710;Horno Microondas Digital MS23K3513AK/ZS 23Lts;ELECTRODOMESTICOS
7687200;;F;62;CHILENO;;Boomers;RENCA                         ;METROPOLITANA;49990;1;1;0;0;0;1;1;49990;PROCESADOR THOMAS TH-9160;ELECTRODOMESTICOS
6532612;;F;70;CHILENO;;Silencioso;TALCA                         ;MAULE;19990;1;1;0;0;0;1;1;19990;Hervidor Electrico TH-4515N 2Lts Negro;ELECTRODOMESTICOS
15878418;;F;37;CHILENO;;Millenial;HUALPEN;BIO BIO;57980;2;1;2;1;57980;0;0;0;Horno Microondas Digital TH-20S01 20Lts;ELECTRODOMESTICOS
14110977;;M;41;CHILENO;;X;RENCA                         ;METROPOLITANA;64960;4;1;0;0;0;4;1;64960;Hervidor Electrico TH-4515N 2Lts Negro;ELECTRODOMESTICOS
6785617;;M;66;CHILENO;;Boomers;RENCA                         ;METROPOLITANA;79990;1;1;0;0;0;1;1;79990;Horno Electrico TH-38N 38Lts;ELECTRODOMESTICOS
11401316;Soltero;F;53;CHILENO;TECNICO UNIVERSITARIO CONSTRUCDOR;X;ILLAPEL                       ;COQUIMBO;49950;5;2;0;0;0;5;2;49950;HERVIDOR BERLIN 1,7 LITROS;ELECTRODOMESTICOS
16326614;;M;35;CHILENO;;Millenial;TOCOPILLA                     ;ANTOFAGASTA;1300900;10;4;0;0;0;10;4;1300900;HORNO ELECTRICO BREMEN 23 LITROS;ELECTRODOMESTICOS
19867895;;F;24;CHILENO;;Z;CONCEPCION                    ;BIO BIO;74980;2;1;0;0;0;2;1;74980;Horno Microondas Mecanico Easy Wave 20Lts;ELECTRODOMESTICOS
7945161;;F;65;CHILENO;;Boomers;ANCUD                         ;LOS LAGOS;14990;1;1;0;0;0;1;1;14990;Hervidor Electrico TH-4212N 1,7Lts Negro;ELECTRODOMESTICOS
15032599;;M;39;CHILENO;;X;PROVIDENCIA                   ;METROPOLITANA;84980;2;2;0;0;0;2;2;84980;HORNO ELECTRICO BREMEN 23 LITROS;ELECTRODOMESTICOS
14382332;;F;42;CHILENO;;X;RENCA                         ;METROPOLITANA;28980;2;1;2;1;28980;0;0;0;HORNO 10 LITROS OSTER ROJO;ELECTRODOMESTICOS
12345882;;F;49;CHILENO;;X;CASTRO                        ;LOS LAGOS;153690;4;3;0;0;0;4;3;153690;Aspiradora AP3400 Arrastre 2000Watts;ELECTRODOMESTICOS
4864631;;F;80;CHILENO;;Silencioso;SAN FERNANDO                  ;L.G.B.OÂ´HIGGINS;51980;2;4;0;0;0;2;4;51980;Picadora 1-2-3 AD6011CL 750W;ELECTRODOMESTICOS
10874783;;F;53;CHILENO;;X;SAN ANTONIO                   ;VALPARAISO;12990;1;1;0;0;0;1;1;12990;Hervidor Electrico TH-4212N 1,7Lts Negro;ELECTRODOMESTICOS
11615602;Soltero;M;52;CHILENO;;X;ANTOFAGASTA;ANTOFAGASTA;366950;5;3;2;1;309980;3;2;56970;Hervidor Electrico HA-2650NG;ELECTRODOMESTICOS
10458586;;F;56;CHILENO;;Boomers;N/D;N/D;200940;6;3;4;2;169960;2;1;30980;Batidora Manual 3532;ELECTRODOMESTICOS
20350219;;F;22;CHILENO;;Z;TALCA                         ;MAULE;1289519;9;3;0;0;0;9;3;1289519;Horno Electrico TH-38N 38Lts;ELECTRODOMESTICOS
16537215;;M;35;CHILENO;;Millenial;LINARES                       ;MAULE;532960;4;3;0;0;0;4;3;532960;Licuadora TH-501V 1,5Lts Vaso Vidrio;ELECTRODOMESTICOS
10037713;;F;51;CHILENO;;X;PROVIDENCIA                   ;METROPOLITANA;14990;1;1;0;0;0;1;1;14990;HERVIDOR COLONIA 1,7 LITROS;ELECTRODOMESTICOS
27048159;;M;47;VENEZOLANO;;Extranjero;PROVIDENCIA                   ;METROPOLITANA;34990;1;1;1;1;34990;0;0;0;Batidora de Mano y Pedestal 3612;ELECTRODOMESTICOS
15938684;;F;38;CHILENO;;Millenial;N/D;N/D;257960;4;2;4;2;257960;0;0;0;Aspiradora Handy Clean Black 1400;ELECTRODOMESTICOS
8127200;;M;61;CHILENO;;Millenial;"";"";13240;2;1;0;0;0;2;1;13240;Exprimidor Fauna 500 cc;ELECTRODOMESTICOS
12714771;;M;47;CHILENO;;X;QUINCHAO                      ;LOS LAGOS;609670;6;3;0;0;0;6;3;609670;BATIDORA PEDESTAL RENANIA 5 LITROS;ELECTRODOMESTICOS
12184528;;M;50;CHILENO;;X;CONSTITUCION                  ;MAULE;629160;10;6;0;0;0;10;6;629160;Horno Microondas Mecanico UT-SYDNEY18 18Lts;ELECTRODOMESTICOS
15624012;;F;38;CHILENO;;Millenial;PROVIDENCIA                   ;METROPOLITANA;31980;2;2;0;0;0;2;2;31980;Hervidor Family Kettle HE500;ELECTRODOMESTICOS
17495001;;F;32;CHILENO;;Millenial;PROVIDENCIA                   ;METROPOLITANA;14990;1;1;0;0;0;1;1;14990;Cafetera TH-130;ELECTRODOMESTICOS
25301421;;M;28;PERUANO;;Extranjero;N/D;N/D;49990;1;1;0;0;0;1;1;49990;Licuadora Oster Clasica Cobre 4128 1,25 lt;ELECTRODOMESTICOS
15624933;;F;38;CHILENO;;X;GRANEROS                      ;L.G.B.OÂ´HIGGINS;284970;3;2;0;0;0;3;2;284970;Horno Electrico TH-25N01 25Lts;ELECTRODOMESTICOS
17306493;;M;32;CHILENO;;Millenial;QUINTA NORMAL;METROPOLITANA;23980;2;1;2;1;23980;0;0;0;HERVIDOR 889R 2,5L Rojo;ELECTRODOMESTICOS
13302333;;M;44;CHILENO;;X;"";"";451971;4;2;0;0;0;4;2;451971;Horno Electrico TH62I 60Lts;ELECTRODOMESTICOS
11294586;;F;53;CHILENO;;X;CORONEL                       ;BIO BIO;1164370;10;7;0;0;0;10;7;1164370;Hervidor Electrico Tetera HA-4100 4Lts Iox;ELECTRODOMESTICOS
18453626;Soltero;M;28;CHILENO;;Millenial;PROVIDENCIA                   ;METROPOLITANA;251520;4;2;4;2;251520;0;0;0;Aspiradora Mi Robot Vacuum-Mop Essential;ELECTRODOMESTICOS
14524298;;M;46;CHILENO;;X;PENCAHUE                      ;MAULE;59990;1;1;0;0;0;1;1;59990;Batidora Pedestal UT-KLEIN700;ELECTRODOMESTICOS
15544464;;M;38;CHILENO;;Millenial;N/D;N/D;181970;3;3;0;0;0;3;3;181970;Batidora de Mano y Pedestal 3612;ELECTRODOMESTICOS
18264850;;F;29;CHILENO;;Millenial;ALTO HOSPICIO;TARAPACA;61980;2;2;0;0;0;2;2;61980;Combo Hervidor + Batidora;ELECTRODOMESTICOS
10916650;;M;56;CHILENO;;Boomers;N/D;N/D;230950;5;3;0;0;0;5;3;230950;Batidora Pedestal UT-KLEIN700;ELECTRODOMESTICOS
17516601;Soltero;M;32;CHILENO;TECNICO DE NIVEL SUPERIOR EN ENFERMERIA;Millenial;PROVIDENCIA                   ;METROPOLITANA;26990;1;1;0;0;0;1;1;26990;HORNO 10 LITROS OSTER ROJO;ELECTRODOMESTICOS
10504454;;F;56;CHILENO;;Boomers;ISLA DE MAIPO                 ;METROPOLITANA;74980;2;2;0;0;0;2;2;74980;Licuadora TH-320 Roja/Negro 1,5 Lts Vaso Vidrio;ELECTRODOMESTICOS
11514664;;F;52;CHILENO;;X;SALAMANCA                     ;COQUIMBO;769940;6;3;6;3;769940;0;0;0;HORNO ELECTRICO MUNICH 60 LITROS;ELECTRODOMESTICOS
8588600;;F;62;CHILENO;;Boomers;RENCA                         ;METROPOLITANA;139990;1;1;0;0;0;1;1;139990;Horno Electrico TH-80i 80Lts;ELECTRODOMESTICOS
8162970;;F;62;CHILENO;;Boomers;PUNTA ARENAS                  ;MAGALLANES;109980;2;2;0;0;0;2;2;109980;Horno Electrico TH-25N01 25Lts;ELECTRODOMESTICOS
12552114;;F;47;CHILENO;;X;RANCAGUA                      ;L.G.B.OÂ´HIGGINS;381950;5;2;0;0;0;5;2;381950;Licuadora L-5500IN 1,5Lts;ELECTRODOMESTICOS
11562868;;M;52;CHILENO;;X;RENCA                         ;METROPOLITANA;25990;3;2;0;0;0;3;2;25990;Hervidor Electrico HA-3300 2,5Lts Blanco;ELECTRODOMESTICOS
13930259;;M;42;CHILENO;;Silencioso;PROVIDENCIA                   ;METROPOLITANA;12990;1;1;0;0;0;1;1;12990;HERVIDOR COLONIA 1,7 LITROS;ELECTRODOMESTICOS
18402635;Soltero;M;28;CHILENO;;Millenial;PROVIDENCIA                   ;METROPOLITANA;34990;1;1;1;1;34990;0;0;0;Aspiradora TH1407 Arrastre 1400Watts;ELECTRODOMESTICOS
15851781;;F;38;CHILENO;;Silencioso;PROVIDENCIA                   ;METROPOLITANA;58980;2;1;2;1;58980;0;0;0;ASPIRADORA VCC4580V3K/XZS SAMSUNG BLACK;ELECTRODOMESTICOS
8934286;Casado;M;54;CHILENO;;Boomers;PROVIDENCIA                   ;METROPOLITANA;59990;1;1;1;1;59990;0;0;0;HORNO ELECTRICO DORTMUND 45 LITROS;ELECTRODOMESTICOS
11962431;;F;50;CHILENO;;X;LOS ANGELES                   ;BIO BIO;14990;1;1;0;0;0;1;1;14990;Batidora Manual BA-5010 Inox;ELECTRODOMESTICOS
14419040;;F;41;CHILENO;;X;"";"";69990;3;3;0;0;0;3;3;69990;HERVIDOR BERLIN 1,7 LITROS;ELECTRODOMESTICOS
12638864;;F;48;CHILENO;;X;N/D;N/D;128960;4;2;0;0;0;4;2;128960;Hervidor Electrico UT-DUNKEL17P 2Lts Negro;ELECTRODOMESTICOS
16540314;;F;35;CHILENO;;Millenial;N/D;N/D;241960;4;2;2;1;96980;2;1;144980;Freidora de Aire Digital 40D;ELECTRODOMESTICOS
24072144;Casado;F;32;CHILENO;;Extranjero;TOCOPILLA                     ;ANTOFAGASTA;604960;4;4;0;0;0;4;4;604960;Horno Electrico TH-38N 38Lts;ELECTRODOMESTICOS
19548175;;F;25;CHILENO;;Z;COLINA                        ;METROPOLITANA;341540;5;3;0;0;0;5;3;341540;LICUADORA HANOVER 1,5 LITROS;ELECTRODOMESTICOS
16325351;;F;35;CHILENO;;Millenial;MONTE PATRIA                  ;COQUIMBO;85073;3;3;0;0;0;3;3;85073;Exprimidor de Jugo CJ-2000 1Lts;ELECTRODOMESTICOS
15467986;;F;40;CHILENO;;X;N/D;N/D;78970;3;1;3;1;78970;0;0;0;Freidora electrica Ut-KeramikAir;ELECTRODOMESTICOS
15197157;;M;40;CHILENO;;X;ARAUCO                        ;BIO BIO;16990;1;1;0;0;0;1;1;16990;Hervidor Electrico UT-MANLY17 1,7Lts Negro;ELECTRODOMESTICOS
9695447;Soltero;M;59;CHILENO;;Boomers;RENCA                         ;METROPOLITANA;12990;1;1;0;0;0;1;1;12990;HERVIDOR COLONIA 1,7 LITROS;ELECTRODOMESTICOS
7821590;;M;67;CHILENO;;Boomers;CABILDO                       ;VALPARAISO;19990;1;1;0;0;0;1;1;19990;Batidora Manual TH-8830;ELECTRODOMESTICOS
13843489;;F;42;CHILENO;;X;LOS ANGELES                   ;BIO BIO;79972;3;4;0;0;0;3;4;79972;Licuadora BL1500 Silver 1,75Lts Vaso Vidrio;ELECTRODOMESTICOS
11945710;;M;50;CHILENO;;X;RENCA                         ;METROPOLITANA;99990;1;1;1;1;99990;0;0;0;CAFETERA PRIMA LATTE 6603 ROJA;ELECTRODOMESTICOS
18448381;Soltero;F;28;CHILENO;INGENIERIA EN ADMINISTRACION DE EMPRESAS MENCION FINANZAS;Millenial;PROVIDENCIA                   ;METROPOLITANA;18240;2;1;0;0;0;2;1;18240;Batidora Manual 3532;ELECTRODOMESTICOS
9570915;Divorciado;F;58;CHILENO;AUXILIAR DE ENFERMERIA;Boomers;RENCA                         ;METROPOLITANA;39990;1;1;0;0;0;1;1;39990;Aspiradora AP1700 Arrastre 1700Watts;ELECTRODOMESTICOS
15895730;;F;37;CHILENO;;Millenial;OSORNO                        ;LOS LAGOS;70530;3;2;2;1;33540;1;1;36990;Combo Hervidor + Tostador + Sandwichera;ELECTRODOMESTICOS
14004301;;F;40;CHILENO;;X;SAN JOAQUIN                   ;METROPOLITANA;43980;2;1;2;1;43980;0;0;0;Hervidor Electrico UT-HOCH18R;ELECTRODOMESTICOS
19557564;;F;25;CHILENO;;Millenial;"";"";254970;3;3;0;0;0;3;3;254970;FREIDORA DE AIRE BAVIERA 3,8 LITROS;ELECTRODOMESTICOS
14569635;;F;44;CHILENO;;X;SAN PEDRO DE LA PAZ           ;BIO BIO;44990;1;1;0;0;0;1;1;44990;Horno Microondas Mecanico Fancy 20Lts;ELECTRODOMESTICOS
15527828;;F;35;CHILENO;;Millenial;CHIMBARONGO                   ;L.G.B.OÂ´HIGGINS;13000;2;1;0;0;0;2;1;13000;Hervidor Electrico TH-4212N 1,7Lts Negro;ELECTRODOMESTICOS
15871850;;F;38;CHILENO;;Millenial;SAN ANTONIO                   ;VALPARAISO;12990;1;4;0;0;0;1;4;12990;HERVIDOR COLONIA 1,7 LITROS;ELECTRODOMESTICOS
12346525;;F;48;CHILENO;;X;RENCA                         ;METROPOLITANA;15990;1;1;0;0;0;1;1;15990;Hervidor Inox One Midea;ELECTRODOMESTICOS
9184464;;F;60;CHILENO;;Boomers;SAN ANTONIO                   ;VALPARAISO;39980;2;2;0;0;0;2;2;39980;Licuadora Berry Blender Roja 1400 Vaso Vidrio;ELECTRODOMESTICOS
15094133;;M;39;CHILENO;;X;N/D;N/D;426970;3;2;2;1;361980;1;1;64990;Aspiradora UT-SILENT1804 Arrastre 1800Watts;ELECTRODOMESTICOS
14293651;;M;47;CHILENO;;X;"";"";252680;5;2;0;0;0;5;2;252680;Olla Multiuso 6801 5,7Lts;ELECTRODOMESTICOS
15657258;;F;38;CHILENO;;Millenial;TEMUCO                        ;ARAUCANIA;18990;1;1;0;0;0;1;1;18990;Set Hervidor Valory VK330 Blanco + Tostador de;ELECTRODOMESTICOS
12938425;;M;46;CHILENO;;X;LA SERENA                     ;COQUIMBO;222920;8;5;1;1;79990;7;4;142930;Plancha Paninis 2880;ELECTRODOMESTICOS
13689294;;F;42;CHILENO;;X;PUERTO MONTT                  ;LOS LAGOS;51980;2;1;0;0;0;2;1;51980;Licuadora BL1500 Silver 1,75Lts Vaso Vidrio;ELECTRODOMESTICOS
6087189;Casado;M;73;CHILENO;;Silencioso;SAN JAVIER                    ;MAULE;93980;2;2;0;0;0;2;2;93980;Horno Electrico TH-38N 38Lts;ELECTRODOMESTICOS
9160238;Soltero;F;61;CHILENO;;Boomers;RENCA                         ;METROPOLITANA;179980;4;2;0;0;0;4;2;179980;Horno Microondas Digital TH-25DM 25Lts;ELECTRODOMESTICOS
14571780;;M;45;CHILENO;;X;CANETE                        ;BIO BIO;229960;5;3;0;0;0;5;3;229960;HERVIDOR COLONIA 1,7 LITROS;ELECTRODOMESTICOS
4926854;;F;87;CHILENO;;Silencioso;CASABLANCA                    ;VALPARAISO;238860;7;2;0;0;0;7;2;238860;Batidora Pedestal UT-KLEIN700;ELECTRODOMESTICOS
19607723;;M;24;CHILENO;;Z;PUERTO MONTT                  ;LOS LAGOS;168980;2;2;2;2;168980;0;0;0;Combo Licuadora + Batidora;ELECTRODOMESTICOS
27091889;;F;30;COLOMBIANO;;Extranjero;PROVIDENCIA                   ;METROPOLITANA;38980;2;1;2;1;38980;0;0;0;Horno Electrico TH-25N01 25Lts;ELECTRODOMESTICOS
11798945;;M;50;CHILENO;;X;TIRUA                         ;BIO BIO;11193;1;1;0;0;0;1;1;11193;Hervidor Electrico TH-4212N 1,7Lts Negro;ELECTRODOMESTICOS
14301669;;M;46;CHILENO;;X;LOS ALAMOS                    ;BIO BIO;49990;1;1;0;0;0;1;1;49990;Horno Microondas Mecanico Easy Wave 20Lts;ELECTRODOMESTICOS
17622151;;F;32;CHILENO;;Millenial;COLINA                        ;METROPOLITANA;122940;6;3;3;1;88970;3;2;33970;Horno Microondas Mecanico Easy Wave 20Lts;ELECTRODOMESTICOS
8237330;;F;70;CHILENO;;Silencioso;NANCAGUA                      ;L.G.B.OÂ´HIGGINS;481940;6;5;0;0;0;6;5;481940;Hervidor Electrico 3101 1,7Lts Negro;ELECTRODOMESTICOS
7555966;Divorciado;M;65;CHILENO;;Boomers;PROVIDENCIA                   ;METROPOLITANA;54980;2;1;0;0;0;2;1;54980;Parrilla Electrica Chef Grill;ELECTRODOMESTICOS
10042786;;F;56;CHILENO;;Boomers;CARAHUE                       ;ARAUCANIA;499970;3;3;0;0;0;3;3;499970;Maquina de Coser ST-371HD Heavy Duty;ELECTRODOMESTICOS
11541082;;F;51;CHILENO;;X;VILLARICA                     ;ARAUCANIA;463960;4;2;0;0;0;4;2;463960;Licuadora TH-501V 1,5Lts Vaso Vidrio;ELECTRODOMESTICOS
17518995;;F;32;CHILENO;;Millenial;TALAGANTE                     ;METROPOLITANA;175960;4;3;0;0;0;4;3;175960;HERVIDOR COLONIA 1,7 LITROS;ELECTRODOMESTICOS
13384598;;M;44;CHILENO;;X;N/D;N/D;17990;1;1;0;0;0;1;1;17990;Hervidor Electrico UT-MANLY17 1,7Lts Negro;ELECTRODOMESTICOS
15061183;Soltero;M;39;CHILENO;CHEF;X;PROVIDENCIA                   ;METROPOLITANA;14990;1;1;0;0;0;1;1;14990;Hervidor Inox One Midea;ELECTRODOMESTICOS
7718471;;F;67;CHILENO;;Boomers;VINA DEL MAR                  ;VALPARAISO;69990;1;1;0;0;0;1;1;69990;Enceradora EA-5000;ELECTRODOMESTICOS
14016227;;F;41;CHILENO;;X;RENCA                         ;METROPOLITANA;19990;1;1;0;0;0;1;1;19990;Hervidor Electrico TH-4515N 2Lts Negro;ELECTRODOMESTICOS
11235225;Casado;F;53;CHILENO;;X;PROVIDENCIA                   ;METROPOLITANA;14990;1;1;0;0;0;1;1;14990;TOSTADOR OLDEMBURGO 2 REBANADAS;ELECTRODOMESTICOS
12438698;;M;49;CHILENO;;X;LO PRADO                      ;METROPOLITANA;89980;3;2;1;1;29990;2;1;59990;Licuadora Roja 550W 1,5Lts Vaso Vidrio;ELECTRODOMESTICOS
20145850;;F;23;CHILENO;;Z;N/D;N/D;216190;11;6;3;2;25470;8;4;190720;FREIDORA DE AIRE HESSIA 2,0 LITROS;ELECTRODOMESTICOS
12831129;;F;48;CHILENO;;X;HUASCO                        ;ATACAMA;36990;1;1;0;0;0;1;1;36990;Batidora Vertical Multimixer TH-8720;ELECTRODOMESTICOS
17563072;;M;32;CHILENO;;Millenial;LA CISTERNA                   ;METROPOLITANA;0;0;2;0;2;0;0;0;0;Aspiradora AP1700 Arrastre 1700Watts;ELECTRODOMESTICOS
15091360;;F;39;CHILENO;;X;SAN FELIPE                    ;VALPARAISO;207211;8;6;0;0;0;8;6;207211;PLANCHA VAPOR TH-7146;ELECTRODOMESTICOS
12778872;;M;47;CHILENO;;X;PROVIDENCIA                   ;METROPOLITANA;243510;5;3;5;3;243510;0;0;0;Apiradora Mi Robot Vacuum-Mop XIAOMI;ELECTRODOMESTICOS
7087205;;M;64;CHILENO;;Boomers;ARICA                         ;ARICA Y PARINACOTA;382621;3;2;0;0;0;3;2;382621;Licuadora L2000VNG 1,5Lts Vaso Vidrio;ELECTRODOMESTICOS
10051782;;F;60;CHILENO;;Boomers;CHIGUAYANTE                   ;BIO BIO;239980;2;2;0;0;0;2;2;239980;Batidora Pedestal TH910PN 4,6Lts 1300Watts;ELECTRODOMESTICOS
18988942;;F;27;CHILENO;;Z;SAN FERNANDO                  ;L.G.B.OÂ´HIGGINS;109990;1;1;1;1;109990;0;0;0;SUPER FREIDORA DE AIRE OV3;ELECTRODOMESTICOS
15814893;;F;37;CHILENO;;Millenial;CABILDO                       ;VALPARAISO;36990;1;1;0;0;0;1;1;36990;Combo Hervidor + Tostador + Sandwichera;ELECTRODOMESTICOS
5612892;;M;72;CHILENO;;Silencioso;TOCOPILLA                     ;ANTOFAGASTA;25980;2;2;0;0;0;2;2;25980;Hervidor Electrico 3101 1,7Lts Negro;ELECTRODOMESTICOS
15113629;;M;39;CHILENO;;X;RENCA                         ;METROPOLITANA;109990;1;1;1;1;109990;0;0;0;SUPER FREIDORA DE AIRE OV3;ELECTRODOMESTICOS
9388887;;F;42;CHILENO;;X;ROMERAL                       ;MAULE;59980;2;2;1;1;49990;1;1;9990;Aspiradora TH1407 Arrastre 1400Watts;ELECTRODOMESTICOS
14487383;;F;46;CHILENO;;X;CARTAGENA                     ;VALPARAISO;49990;1;1;0;0;0;1;1;49990;FREIDORA DE AIRE BAVIERA 3,8 LITROS;ELECTRODOMESTICOS
15663916;;M;38;CHILENO;;X;RENCA                         ;METROPOLITANA;113980;2;1;2;1;113980;0;0;0;SUPER FREIDORA DE AIRE OV3;ELECTRODOMESTICOS
22576044;;M;45;PERUANO;;Extranjero;PROVIDENCIA                   ;METROPOLITANA;189990;1;1;1;1;189990;0;0;0;Horno Electrico TH-100i 100Lts;ELECTRODOMESTICOS
10005549;;F;60;CHILENO;;Boomers;SANTA CRUZ                    ;L.G.B.OÂ´HIGGINS;194980;2;2;0;0;0;2;2;194980;Horno Electrico TH-80i 80Lts;ELECTRODOMESTICOS
9310099;;F;56;CHILENO;;Boomers;LOS VILOS                     ;COQUIMBO;34980;2;2;0;0;0;2;2;34980;HERVIDOR COLONIA 1,7 LITROS;ELECTRODOMESTICOS
18510356;Soltero;F;29;CHILENO;;Millenial;LA LIGUA                      ;VALPARAISO;59990;1;1;1;1;59990;0;0;0;Horno electrico Black Oven 42lts;ELECTRODOMESTICOS
18856731;;F;31;CHILENO;;Millenial;CHILLAN                       ;BIO BIO;107980;2;1;2;1;107980;0;0;0;CAFETERA PRIMA LATTE 6603 ROJA;ELECTRODOMESTICOS
20017798;;M;23;CHILENO;;Z;N/D;N/D;218640;3;1;0;0;0;3;1;218640;Maquina de Coser VX1445 con 14 puntadas;ELECTRODOMESTICOS
9798395;Soltero;F;58;CHILENO;TECNOLOGO MEDICO;Boomers;QUILLOTA                      ;VALPARAISO;176060;2;1;0;0;0;2;1;176060;Maquina de Coser 311;ELECTRODOMESTICOS
14099570;;M;40;CHILENO;;X;VALLENAR;ATACAMA;49990;1;1;0;0;0;1;1;49990;FREIDORA DE AIRE BAVIERA 3,8 LITROS;ELECTRODOMESTICOS
18327778;;F;30;CHILENO;;Millenial;PROVIDENCIA                   ;METROPOLITANA;197960;3;1;3;1;197960;0;0;0;CAFETERA PRIMA LATTE 6603 ROJA;ELECTRODOMESTICOS
10339425;;F;58;CHILENO;;Boomers;N/D;N/D;817800;6;4;2;1;205840;4;3;611960;LICUADORA CROMADA CON TECLAS PLUS;ELECTRODOMESTICOS
18510215;;F;29;CHILENO;;Millenial;CALERA                        ;VALPARAISO;79990;1;1;0;0;0;1;1;79990;Batidora Pedestal TH910PN 4,6Lts 1300Watts;ELECTRODOMESTICOS
15571649;;F;39;CHILENO;;X;OVALLE                        ;COQUIMBO;89990;1;3;0;0;0;1;3;89990;Horno Electrico TH62I 60Lts;ELECTRODOMESTICOS
19939022;;F;24;CHILENO;;Z;CHANCO                        ;MAULE;228970;3;2;3;2;228970;0;0;0;Horno Microondas Digital TH-20S01 20Lts;ELECTRODOMESTICOS
11603389;Divorciado;M;53;CHILENO;;X;PROVIDENCIA                   ;METROPOLITANA;35980;3;1;0;0;0;3;1;35980;Exprimidor de Jugo 407W 1Lts;ELECTRODOMESTICOS
10464723;;F;58;CHILENO;;Boomers;CURANILAHUE                   ;BIO BIO;15083;2;2;0;0;0;2;2;15083;HERVIDOR COLONIA 1,7 LITROS;ELECTRODOMESTICOS
10711689;Soltero;F;56;CHILENO;PROFESOR;Boomers;VILLA ALEGRE                  ;MAULE;133970;3;2;0;0;0;3;2;133970;Horno Electrico TH-38N 38Lts;ELECTRODOMESTICOS
18188683;;M;29;CHILENO;;Millenial;TALCA                         ;MAULE;202660;3;2;0;0;0;3;2;202660;CAFETERA PRIMA LATTE 6603 ROJA;ELECTRODOMESTICOS
18327366;;F;29;CHILENO;;Millenial;PROVIDENCIA                   ;METROPOLITANA;11990;1;1;0;0;0;1;1;11990;Plancha a Vapor 5001;ELECTRODOMESTICOS
9088262;Casado;F;60;CHILENO;;Boomers;RENCA                         ;METROPOLITANA;57980;2;1;0;0;0;2;1;57980;Procesador TH-9010 Multimixer 1,5Lts Vaso Vidrio;ELECTRODOMESTICOS
14153340;;F;40;CHILENO;;X;PROVIDENCIA                   ;METROPOLITANA;128970;3;1;3;1;128970;0;0;0;Tostador De Longhi Icona Vintage Azul CTOV2003.A;ELECTRODOMESTICOS
11309979;;F;54;CHILENO;;X;PROVIDENCIA                   ;METROPOLITANA;16990;1;1;0;0;0;1;1;16990;Batidora Manual TH-8830;ELECTRODOMESTICOS
5415800;;M;78;CHILENO;;Silencioso;RENCA                         ;METROPOLITANA;99980;2;2;0;0;0;2;2;99980;HORNO ELECTRICO DORTMUND 45 LITROS;ELECTRODOMESTICOS
16787977;;F;34;CHILENO;;Millenial;"";"";50480;2;1;0;0;0;2;1;50480;Horno Microondas Mecanico C1700N 17Lts Blanco;ELECTRODOMESTICOS
19559327;;M;25;CHILENO;;Z;N/D;N/D;109990;1;1;1;1;109990;0;0;0;Maquina de coser Singer 1605;ELECTRODOMESTICOS
13270744;;M;45;CHILENO;;X;CHONCHI;LOS LAGOS;18990;1;1;1;1;18990;0;0;0;Cafetera TH-130;ELECTRODOMESTICOS
5689412;Casado;M;74;CHILENO;;Silencioso;RENCA                         ;METROPOLITANA;69990;1;1;0;0;0;1;1;69990;Aspiradora UT-SILENT1804 Arrastre 1800Watts;ELECTRODOMESTICOS
18126081;;F;30;CHILENO;;Millenial;HUECHURABA                    ;METROPOLITANA;38980;2;2;2;2;38980;0;0;0;HORNO ELECTRICO BREMEN 23 LITROS;ELECTRODOMESTICOS
10746756;;F;55;CHILENO;;Boomers;SAN CLEMENTE                  ;MAULE;165540;8;5;0;0;0;8;5;165540;Horno Microondas Mecanico Fancy 20Lts;ELECTRODOMESTICOS
5956410;;M;74;CHILENO;;Silencioso;COPIAPO                       ;ATACAMA;56980;2;1;0;0;0;2;1;56980;Combo Licuadora + Batidora;ELECTRODOMESTICOS
8316355;Casado;M;64;CHILENO;;Boomers;RENCA                         ;METROPOLITANA;32990;1;1;0;0;0;1;1;32990;BATIDORA INMERSION S MIX 2616;ELECTRODOMESTICOS
4036786;;M;81;CHILENO;;Silencioso;SAN MIGUEL                    ;METROPOLITANA;334960;4;3;0;0;0;4;3;334960;Hervidor Electrico UT-MANLY17 1,7Lts Negro;ELECTRODOMESTICOS
12947719;;F;46;CHILENO;;X;LA LIGUA                      ;VALPARAISO;369940;6;4;0;0;0;6;4;369940;Plancha UT-DUNST 2200Watts Base Ceramica;ELECTRODOMESTICOS
18689573;;M;28;CHILENO;;Millenial;OVALLE;COQUIMBO;309980;2;2;2;2;309980;0;0;0;SUPER FREIDORA DE AIRE OV3;ELECTRODOMESTICOS
10681009;;F;51;CHILENO;;X;CHIMBARONGO                   ;L.G.B.OÂ´HIGGINS;65450;2;1;0;0;0;2;1;65450;Horno Electrico TH-25N01 25Lts;ELECTRODOMESTICOS
9880913;;F;66;CHILENO;;Boomers;CERRO NAVIA                   ;METROPOLITANA;26990;1;1;0;0;0;1;1;26990;Hervidor Electrico UT-REIN17SS;ELECTRODOMESTICOS
16428224;;M;35;CHILENO;;Millenial;COLINA                        ;METROPOLITANA;796630;8;5;0;0;0;8;5;796630;Exprimidor de Jugo CJ-2000 1Lts;ELECTRODOMESTICOS
16696513;;F;34;CHILENO;;Millenial;N/D;N/D;83980;2;1;2;1;83980;0;0;0;Horno Microondas Digital MS23K3513AK/ZS 23Lts;ELECTRODOMESTICOS
18932625;;M;27;CHILENO;;Millenial;"";"";26990;1;1;1;1;26990;0;0;0;Tostador de Pan TH-126 4 Rebanadas Negro;ELECTRODOMESTICOS
5584253;;F;73;CHILENO;;Silencioso;TEMUCO                        ;ARAUCANIA;223969;3;3;0;0;0;3;3;223969;Horno Electrico TH-25N01 25Lts;ELECTRODOMESTICOS
6796699;;F;67;CHILENO;;Boomers;PEUMO                         ;L.G.B.OÂ´HIGGINS;139980;2;2;0;0;0;2;2;139980;Horno Electrico TH-48N 48Lts;ELECTRODOMESTICOS
12942809;;M;46;CHILENO;;X;RENCA                         ;METROPOLITANA;60960;4;2;0;0;0;4;2;60960;HERVIDOR COLONIA 1,7 LITROS;ELECTRODOMESTICOS
25115135;;F;30;PERUANO;;Extranjero;SANTIAGO                      ;METROPOLITANA;99980;2;2;0;0;0;2;2;99980;Batidora Pedestal TH910PN 4,6Lts 1300Watts;ELECTRODOMESTICOS
7864577;;F;63;CHILENO;;Boomers;LOS ANDES                     ;VALPARAISO;27990;1;1;0;0;0;1;1;27990;Plancha THOMAS TH-7170 2200Watts Base Ceramica;ELECTRODOMESTICOS
10421417;;F;56;CHILENO;;Boomers;RENCA                         ;METROPOLITANA;16990;1;1;0;0;0;1;1;16990;Hervidor Electrico UT-MANLY17 1,7Lts Negro;ELECTRODOMESTICOS
26372648;;F;43;VENEZOLANO;;Extranjero;N/D;N/D;531540;8;4;5;2;150950;3;2;380590;Maquina de coser Singer 1605;ELECTRODOMESTICOS
20198159;;M;23;CHILENO;;Z;"";"";59990;1;1;0;0;0;1;1;59990;Aspiradora UT-SILENT1603 Arrastre 1600Watts;ELECTRODOMESTICOS
18671452;;F;28;CHILENO;;Millenial;CANETE                        ;BIO BIO;18990;1;1;0;0;0;1;1;18990;Batidora Manual TH-8830;ELECTRODOMESTICOS
15092001;;F;40;CHILENO;;X;RENCA                         ;METROPOLITANA;19990;1;1;0;0;0;1;1;19990;Combo Hervidor + Batidora;ELECTRODOMESTICOS
19723274;;F;24;CHILENO;;Z;PROVIDENCIA                   ;METROPOLITANA;281970;3;2;0;0;0;3;2;281970;Cafetera TH-138i;ELECTRODOMESTICOS
13124126;;F;45;CHILENO;;X;COIHAIQUE                     ;AYSEN;30290;2;1;0;0;0;2;1;30290;Tostador de Pan TH-116 2 Rebanadas Negro;ELECTRODOMESTICOS
6408356;;F;70;CHILENO;;Silencioso;LA PINTANA                    ;METROPOLITANA;13990;1;1;0;0;0;1;1;13990;Batidora Vertical Stick Mixer 2609;ELECTRODOMESTICOS
16667644;;M;34;CHILENO;;Millenial;"";"";21990;1;1;0;0;0;1;1;21990;Plancha TH-7052 2000Watts Base Inox;ELECTRODOMESTICOS
19382316;;F;26;CHILENO;;Z;SAN BERNARDO                  ;METROPOLITANA;74990;1;1;0;0;0;1;1;74990;Horno Electrico UT-LEIF36 36Lts;ELECTRODOMESTICOS
15876813;;F;37;CHILENO;;Millenial;RENCA                         ;METROPOLITANA;189990;1;1;0;0;0;1;1;189990;Horno Electrico TH-100i 100Lts;ELECTRODOMESTICOS
19807536;;F;24;CHILENO;;Z;TALCA                         ;MAULE;33980;2;4;0;0;0;2;4;33980;Batidora Vertical Stick Mixer 2609;ELECTRODOMESTICOS
10035505;;M;48;CHILENO;;X;LINARES                       ;MAULE;426950;5;4;0;0;0;5;4;426950;Licuadora Osterizer 4112/72 1,25Lts Vaso Vidrio;ELECTRODOMESTICOS
24998996;;M;38;PERUANO;;Extranjero;ESTACION CENTRAL              ;METROPOLITANA;688930;7;5;2;2;319980;5;3;368950;Freidora de Aire 18M Oster;ELECTRODOMESTICOS
4313677;;F;83;CHILENO;;Silencioso;LO ESPEJO                     ;METROPOLITANA;514450;11;4;0;0;0;11;4;514450;Freidora de Aire 18M Oster;ELECTRODOMESTICOS
15129215;;M;40;CHILENO;;X;CURICO;MAULE;44990;1;1;0;0;0;1;1;44990;HERVIDOR TETERA RELOJ 900R 2,5L ROJO;ELECTRODOMESTICOS
11732614;;M;50;CHILENO;;X;HIJUELAS                      ;VALPARAISO;1303660;27;9;0;0;0;27;9;1303660;Combo Hervidor + Batidora;ELECTRODOMESTICOS
13655763;;M;43;CHILENO;;X;LA FLORIDA                    ;METROPOLITANA;16990;1;1;0;0;0;1;1;16990;Hervidor Electrico HA-3300 2,5Lts Blanco;ELECTRODOMESTICOS
12816511;;M;47;CHILENO;;X;LA LIGUA                      ;VALPARAISO;56980;2;2;0;0;0;2;2;56980;Horno Electrico TH-25N01 25Lts;ELECTRODOMESTICOS
19874370;;F;24;CHILENO;;Z;N/D;N/D;293970;3;3;1;1;229990;2;2;63980;Hervidor Electrico 3101 1,7Lts Negro;ELECTRODOMESTICOS
7875639;;M;64;CHILENO;;Boomers;PENCO                         ;BIO BIO;113392;4;2;0;0;0;4;2;113392;HORNO ELECTRICO BREMEN 23 LITROS;ELECTRODOMESTICOS
10190869;Casado;M;58;CHILENO;;Boomers;MALLOA                        ;L.G.B.OÂ´HIGGINS;159980;2;3;0;0;0;2;3;159980;Aspiradora TH1870 Arrastre 1800Watts Gris;ELECTRODOMESTICOS
13768392;;F;42;CHILENO;;X;PROVIDENCIA                   ;METROPOLITANA;49990;1;1;1;1;49990;0;0;0;Horno Microondas Mecanico Easy Wave 20Lts;ELECTRODOMESTICOS
6635089;;M;66;CHILENO;;Boomers;RENCA                         ;METROPOLITANA;59990;1;1;0;0;0;1;1;59990;Horno Microondas Mecanico TH-18B05 18Lts;ELECTRODOMESTICOS
12102628;;F;54;CHILENO;;Boomers;PAPUDO                        ;VALPARAISO;18990;1;1;0;0;0;1;1;18990;Batidora Manual 3532;ELECTRODOMESTICOS
14520513;;F;41;CHILENO;;X;PROVIDENCIA                   ;METROPOLITANA;9990;1;1;0;0;0;1;1;9990;HERVIDOR COLONIA 1,7 LITROS;ELECTRODOMESTICOS
12950888;;F;46;CHILENO;;X;N/D;N/D;249970;3;3;0;0;0;3;3;249970;Hervidor Electrico Tetera TH-6505RT 1,7Lts Rojo;ELECTRODOMESTICOS
14297724;;F;46;CHILENO;;X;LEBU                          ;BIO BIO;150980;3;2;0;0;0;3;2;150980;Plancha UT-DUNST 2200Watts Base Ceramica;ELECTRODOMESTICOS
20018879;;F;24;CHILENO;;Z;N/D;N/D;33980;2;1;0;0;0;2;1;33980;Batidora Vertical Stick Mixer 2609;ELECTRODOMESTICOS
19194537;;F;25;CHILENO;;Z;MULCHEN;BIO-BIO;38980;2;1;2;1;38980;0;0;0;Horno Microondas Mecanico C1700N 17Lts Blanco;ELECTRODOMESTICOS
9796072;;M;59;CHILENO;;Boomers;LA SERENA                     ;COQUIMBO;19990;1;1;0;0;0;1;1;19990;Combo Hervidor + Batidora;ELECTRODOMESTICOS
12291109;Casado;M;50;CHILENO;;X;CODEGUA                       ;L.G.B.OÂ´HIGGINS;27290;2;1;0;0;0;2;1;27290;HERVIDOR BERLIN 1,7 LITROS;ELECTRODOMESTICOS
15085851;;F;40;CHILENO;;X;PALMILLA                      ;L.G.B.OÂ´HIGGINS;50970;3;3;0;0;0;3;3;50970;PLANCHA A VAPOR 4070 SUELA CERAMICA 2500W;ELECTRODOMESTICOS
17977274;;F;31;CHILENO;;Millenial;PROVIDENCIA                   ;METROPOLITANA;109990;1;1;1;1;109990;0;0;0;SUPER FREIDORA DE AIRE OV3;ELECTRODOMESTICOS
16944397;;M;31;CHILENO;;Millenial;N/D;N/D;129980;3;2;3;2;129980;0;0;0;Batidora Berry Mixer (KM3000) 1300 watts;ELECTRODOMESTICOS
14015501;Soltero;M;41;CHILENO;;X;RENCA                         ;METROPOLITANA;249970;3;2;0;0;0;3;2;249970;Batidora Pedestal TH910PN 4,6Lts 1300Watts;ELECTRODOMESTICOS
11397619;;F;53;CHILENO;;X;RANCAGUA                      ;L.G.B.OÂ´HIGGINS;29990;1;1;0;0;0;1;1;29990;HORNO ELECTRICO BREMEN 23 LITROS;ELECTRODOMESTICOS
16110823;;F;36;CHILENO;;Millenial;OVALLE                        ;COQUIMBO;12990;1;1;0;0;0;1;1;12990;HERVIDOR COLONIA 1,7 LITROS;ELECTRODOMESTICOS
18008418;;F;30;CHILENO;;Millenial;IQUIQUE                       ;TARAPACA;104970;3;2;3;2;104970;0;0;0;FREIDORA DE AIRE BAVIERA 3,8 LITROS;ELECTRODOMESTICOS
25622504;Soltero;F;32;VENEZOLANO;;Extranjero;PROVIDENCIA                   ;METROPOLITANA;113980;2;1;2;1;113980;0;0;0;SUPER FREIDORA DE AIRE OV3;ELECTRODOMESTICOS
15196149;;F;40;CHILENO;;X;ARAUCO                        ;BIO BIO;312950;5;4;0;0;0;5;4;312950;Hervidor Electrico TH-4515N 2Lts Negro;ELECTRODOMESTICOS
15699372;Casado;M;39;CHILENO;;X;SAN CARLOS                    ;BIO BIO;39990;1;1;0;0;0;1;1;39990;HORNO ELECTRICO BREMEN 23 LITROS;ELECTRODOMESTICOS
5142560;;F;78;CHILENO;;Silencioso;CHIMBARONGO                   ;L.G.B.OÂ´HIGGINS;115971;3;2;0;0;0;3;2;115971;HORNO ELECTRICO BREMEN 23 LITROS;ELECTRODOMESTICOS
18307103;;F;34;CHILENO;;Millenial;N/D;N/D;199980;2;4;1;1;89990;1;3;109990;Aspiradora Trapeadora Robot Ut-Excellenza (B);ELECTRODOMESTICOS
9548400;Casado;M;59;CHILENO;;Boomers;RENCA                         ;METROPOLITANA;84980;2;2;0;0;0;2;2;84980;Horno Electrico TH-25N01 25Lts;ELECTRODOMESTICOS
17108181;;F;33;CHILENO;;Millenial;RENGO                         ;L.G.B.OÂ´HIGGINS;118980;2;1;2;1;118980;0;0;0;SUPER FREIDORA DE AIRE OV3;ELECTRODOMESTICOS
6303805;;M;69;CHILENO;;Silencioso;CAUQUENES                     ;MAULE;13990;1;3;0;2;0;1;1;13990;HERVIDOR COLONIA 1,7 LITROS;ELECTRODOMESTICOS
19471515;;M;24;CHILENO;;Z;QUILPUE                       ;VALPARAISO;79980;4;1;0;0;0;4;1;79980;FREIDORA DE AIRE HESSIA 2,0 LITROS;ELECTRODOMESTICOS
8480534;Casado;F;65;CHILENO;;Boomers;RENCA                         ;METROPOLITANA;39990;1;1;0;0;0;1;1;39990;Licuadora TH-501V 1,5Lts Vaso Vidrio;ELECTRODOMESTICOS
13618949;;F;43;CHILENO;;X;RENCA                         ;METROPOLITANA;74990;1;1;0;0;0;1;1;74990;Horno Microondas Mecanico M-2020NG 20Lts;ELECTRODOMESTICOS
6969696;;F;68;CHILENO;;Silencioso;NUNOA                         ;METROPOLITANA;274960;4;3;1;1;89990;3;2;184970;Batidora Pedestal UT-KLEIN700;ELECTRODOMESTICOS
17498353;;F;32;CHILENO;;Millenial;VILLA ALEGRE                  ;MAULE;1221160;10;8;0;0;0;10;8;1221160;Aspiradora TH1415 Arrastre 1500Watts;ELECTRODOMESTICOS
16738769;;M;35;CHILENO;;Millenial;LA FLORIDA;METROPOLITANA;44990;1;1;0;0;0;1;1;44990;Horno Electrico TH-25N01 25Lts;ELECTRODOMESTICOS
15206589;;M;39;CHILENO;;X;N/D;N/D;357970;5;4;0;0;0;5;4;357970;Parrilla Electrica M18W;ELECTRODOMESTICOS
7923254;;F;66;CHILENO;;Boomers;QUILPUE                       ;VALPARAISO;63970;3;2;0;0;0;3;2;63970;Freidora de Aire 18M Oster;ELECTRODOMESTICOS
6526443;;M;70;CHILENO;;Silencioso;PROVIDENCIA                   ;METROPOLITANA;12990;1;1;0;0;0;1;1;12990;HERVIDOR COLONIA 1,7 LITROS;ELECTRODOMESTICOS
12411794;Casado;F;49;CHILENO;;X;PROVIDENCIA                   ;METROPOLITANA;129980;2;2;0;0;0;2;2;129980;Horno Electrico UT-BACKOFEN48 48Lts;ELECTRODOMESTICOS
17978933;;M;31;CHILENO;;Millenial;LA SERENA;COQUIMBO;59990;1;1;0;0;0;1;1;59990;Horno Microondas Mecanico TH-18B05 18Lts;ELECTRODOMESTICOS
13378956;;M;43;CHILENO;;X;RENCA                         ;METROPOLITANA;288820;4;3;2;1;175840;2;2;112980;Batidora Pedestal UT-KLEIN700;ELECTRODOMESTICOS
17946485;;F;52;CHILENO;;X;PUENTE ALTO                   ;METROPOLITANA;303980;2;1;0;0;0;2;1;303980;COMBO BSQ MAQUINAS 990 + 3250;ELECTRODOMESTICOS
16131392;;F;36;CHILENO;;Millenial;PROVIDENCIA                   ;METROPOLITANA;15990;1;1;0;0;0;1;1;15990;Hervidor Electrico UT-MANLY17 1,7Lts Negro;ELECTRODOMESTICOS
27374291;;F;43;ECUATORIANO;;Extranjero;N/D;N/D;40980;2;2;0;0;0;2;2;40980;HORNO ELECTRICO BREMEN 23 LITROS;ELECTRODOMESTICOS
12328089;;M;48;CHILENO;;X;LA FLORIDA                    ;METROPOLITANA;19990;1;1;0;0;0;1;1;19990;Hervidor Electrico TH-4515N 2Lts Negro;ELECTRODOMESTICOS
15395902;;M;40;CHILENO;;X;PUDAHUEL                      ;METROPOLITANA;38980;2;1;2;1;38980;0;0;0;Hervidor Termo BA-6928 Inox 2,8Lts;ELECTRODOMESTICOS
14377118;;F;45;CHILENO;;X;BUIN                          ;METROPOLITANA;818870;5;3;0;0;0;5;3;818870;FREIDORA DE AIRE HESSIA 2,0 LITROS;ELECTRODOMESTICOS
19778521;;F;24;CHILENO;;Z;PROVIDENCIA                   ;METROPOLITANA;59990;1;1;1;1;59990;0;0;0;Horno Microondas Digital TH-20S01 20Lts;ELECTRODOMESTICOS
7662080;;F;73;CHILENO;;Silencioso;TEMUCO                        ;ARAUCANIA;12990;1;1;0;0;0;1;1;12990;TOSTADOR OLDEMBURGO 2 REBANADAS;ELECTRODOMESTICOS
6453613;;F;74;CHILENO;;Silencioso;PROVIDENCIA                   ;METROPOLITANA;44990;1;1;0;0;0;1;1;44990;Horno Electrico TH-25N01 25Lts;ELECTRODOMESTICOS
12857582;;F;47;CHILENO;;X;RENCA                         ;METROPOLITANA;16990;1;1;0;0;0;1;1;16990;Hervidor Electrico HA-3300 2,5Lts Blanco;ELECTRODOMESTICOS
15401764;;F;40;CHILENO;;X;MELIPILLA                     ;METROPOLITANA;773490;7;4;0;0;0;7;4;773490;Hervidor Electrico UT-REIN17SS;ELECTRODOMESTICOS
5624113;;F;73;CHILENO;;Silencioso;LA HIGUERA                    ;COQUIMBO;74990;1;1;0;0;0;1;1;74990;Horno Microondas Mecanico M-2020NG 20Lts;ELECTRODOMESTICOS
15934199;;F;36;CHILENO;;Millenial;N/D;N/D;189460;4;2;2;1;135480;2;1;53980;Aspiradora TH1407 Arrastre 1400Watts;ELECTRODOMESTICOS
15457688;;F;39;CHILENO;;X;EL BOSQUE                     ;METROPOLITANA;104970;3;3;0;0;0;3;3;104970;Aspiradora TH1415 Arrastre 1500Watts;ELECTRODOMESTICOS
10015430;Casado;F;58;CHILENO;;Boomers;COLTAUCO                      ;L.G.B.OÂ´HIGGINS;29990;1;1;0;0;0;1;1;29990;PLANCHA A VAPOR 6953 BASE AEROCERAMICA AUTAPA.22;ELECTRODOMESTICOS
20372766;;F;22;CHILENO;;Z;PROVIDENCIA                   ;METROPOLITANA;92980;2;1;0;0;0;2;1;92980;Horno Electrico TH-48N 48Lts;ELECTRODOMESTICOS
10045221;;F;59;CHILENO;;Boomers;RENCA                         ;METROPOLITANA;109980;2;2;1;1;89990;1;1;19990;Exprimidor de Jugo TH-1215 1,5Lts;ELECTRODOMESTICOS
19720593;;F;24;CHILENO;;Z;PAINE                         ;METROPOLITANA;12990;1;1;0;0;0;1;1;12990;HERVIDOR COLONIA 1,7 LITROS;ELECTRODOMESTICOS
11063994;;F;55;CHILENO;;Boomers;VALDIVIA                      ;LOS LAGOS;16990;1;1;0;0;0;1;1;16990;Batidora Manual 3532;ELECTRODOMESTICOS
11416988;Casado;F;52;CHILENO;;X;RENCA                         ;METROPOLITANA;37980;2;1;0;0;0;2;1;37980;Hervidor Electrico TH-4515N 2Lts Negro;ELECTRODOMESTICOS
17276382;;M;32;CHILENO;;Millenial;RENCA                         ;METROPOLITANA;58980;2;2;0;0;0;2;2;58980;Licuadora Sport Blender BSE10;ELECTRODOMESTICOS
13516533;;M;44;CHILENO;;X;SAN BERNARDO                  ;METROPOLITANA;50230;3;1;0;0;0;3;1;50230;Licuadora L-5500IN 1,5Lts;ELECTRODOMESTICOS
17612777;;F;32;CHILENO;;Millenial;RANCAGUA                      ;L.G.B.OÂ´HIGGINS;90240;3;2;0;0;0;3;2;90240;Horno Microondas Mecanico UT-SYDNEY18 18Lts;ELECTRODOMESTICOS
9793710;;M;58;CHILENO;;Boomers;PUERTO MONTT                  ;LOS LAGOS;469520;7;5;0;0;0;7;5;469520;Batidora Pedestal Bowl 300 Inox;ELECTRODOMESTICOS
10483772;;M;52;CHILENO;;X;PETORCA                       ;VALPARAISO;31990;1;1;0;0;0;1;1;31990;Licuadora L-5500IN 1,5Lts;ELECTRODOMESTICOS
13438178;;F;44;CHILENO;;X;N/D;N/D;70960;3;1;3;1;70960;0;0;0;Horno Microondas Digital MMP-20GC3D 20Lts;ELECTRODOMESTICOS
17016494;;F;33;CHILENO;;Millenial;PROVIDENCIA                   ;METROPOLITANA;34190;2;1;0;0;0;2;1;34190;Licuadora Berry Blender Roja 1400 Vaso Vidrio;ELECTRODOMESTICOS
10164718;;F;58;CHILENO;;Boomers;N/D;N/D;121190;6;3;0;0;0;6;3;121190;Licuadora L1000 Inox 1,7LtsVaso Vidrio;ELECTRODOMESTICOS
17129124;;F;33;CHILENO;;Millenial;N/D;N/D;310980;2;2;1;1;299990;1;1;10990;Exprimidor de Jugo CJ-2000 1Lts;ELECTRODOMESTICOS
9374177;;F;59;CHILENO;;Boomers;RENCA                         ;METROPOLITANA;54990;1;1;0;0;0;1;1;54990;Aspiradora TH1415 Arrastre 1500Watts;ELECTRODOMESTICOS
16760222;;M;34;CHILENO;;Millenial;CANETE                        ;BIO BIO;110970;3;2;0;0;0;3;2;110970;Aspiradora VCC4190V3E/XZS Arrastre 2000Watts;ELECTRODOMESTICOS
7900256;;M;67;CHILENO;;Boomers;CHILLAN                       ;BIO BIO;84980;2;2;0;0;0;2;2;84980;Licuadora L2000VNG 1,5Lts Vaso Vidrio;ELECTRODOMESTICOS
10085669;;F;58;CHILENO;;Boomers;PANQUEHUE                     ;VALPARAISO;516440;5;2;0;0;0;5;2;516440;Licuadora Oster Clasica Azul 4134 1,25 lt;ELECTRODOMESTICOS
16982979;;F;33;CHILENO;;Millenial;PROVIDENCIA                   ;METROPOLITANA;133390;2;1;0;0;0;2;1;133390;Maquina de coser Singer 1605;ELECTRODOMESTICOS
23898642;;F;54;DOMINICANO;;Extranjero;SANTIAGO                      ;METROPOLITANA;304970;3;2;0;0;0;3;2;304970;LICUADORA CROMADA CON TECLAS PLUS;ELECTRODOMESTICOS
15260949;Soltero;F;39;CHILENO;;X;TEMUCO                        ;ARAUCANIA;44990;3;1;0;0;0;3;1;44990;Plancha THOMAS TH-7170 2200Watts Base Ceramica;ELECTRODOMESTICOS
9642971;;F;62;CHILENO;;Boomers;MELIPILLA                     ;METROPOLITANA;14990;1;1;0;0;0;1;1;14990;Hervidor Inox One Midea;ELECTRODOMESTICOS
25533872;;M;37;HAITIANO;;Extranjero;N/D;N/D;432050;9;5;0;0;0;9;5;432050;Licuadora TH-501V 1,5Lts Vaso Vidrio;ELECTRODOMESTICOS
19722886;;M;24;CHILENO;;Z;VILLARICA                     ;ARAUCANIA;27990;1;1;0;0;0;1;1;27990;Licuadora TH-320 Roja/Negro 1,5 Lts Vaso Vidrio;ELECTRODOMESTICOS
19289402;;M;26;CHILENO;;Z;"";"";12990;1;1;1;1;12990;0;0;0;PLANCHA A VAPOR 4070 SUELA CERAMICA 2500W;ELECTRODOMESTICOS
5526747;;F;74;CHILENO;;Silencioso;PUDAHUEL                      ;METROPOLITANA;69990;1;1;0;0;0;1;1;69990;Horno Electrico TH-48N 48Lts;ELECTRODOMESTICOS
20324093;;M;22;CHILENO;;Z;MULCHEN                       ;BIO BIO;133390;2;1;0;0;0;2;1;133390;Horno Microondas Digital L UT-25KROMM 25Lts;ELECTRODOMESTICOS
12787134;;F;47;CHILENO;;X;PROVIDENCIA                   ;METROPOLITANA;99990;1;1;0;0;0;1;1;99990;Horno Electrico TH62I 60Lts;ELECTRODOMESTICOS
10885997;;M;56;CHILENO;;Boomers;PUDAHUEL                      ;METROPOLITANA;29990;1;1;0;0;0;1;1;29990;Hervidor Electrico Tetera HA-4100 4Lts Iox;ELECTRODOMESTICOS
6384824;;F;69;CHILENO;;Silencioso;RENCA                         ;METROPOLITANA;79960;4;8;0;0;0;4;8;79960;Hervidor Electrico 3101 1,7Lts Negro;ELECTRODOMESTICOS
9678272;;F;59;CHILENO;;Boomers;COQUIMBO                      ;COQUIMBO;89980;2;1;0;0;0;2;1;89980;Enceradora EA-5000;ELECTRODOMESTICOS
15107017;Casado;F;39;CHILENO;;X;PROVIDENCIA                   ;METROPOLITANA;74990;1;1;0;0;0;1;1;74990;Aspiradora TH1870 Arrastre 1800Watts Gris;ELECTRODOMESTICOS
17291334;;M;33;CHILENO;;Millenial;PROVIDENCIA                   ;METROPOLITANA;39990;1;1;1;1;39990;0;0;0;Freidora de Aire 18M Oster;ELECTRODOMESTICOS
7785817;;M;59;CHILENO;;Boomers;MONTE PATRIA                  ;COQUIMBO;26000;2;1;0;0;0;2;1;26000;Plancha UT-KERAMIKTOP 2200Watts Base Ceramica;ELECTRODOMESTICOS
19211508;;F;26;CHILENO;;Millenial;N/D;N/D;466070;9;6;5;2;239950;4;4;226120;Batidora Pedestal TH910PN 4,6Lts 1300Watts;ELECTRODOMESTICOS
13145297;;M;44;CHILENO;;X;LOS ANGELES                   ;BIO BIO;81970;3;1;0;0;0;3;1;81970;Picadora TH-9020V Vaso Vidrio 2Lts;ELECTRODOMESTICOS
25204891;;M;27;COLOMBIANO;;Extranjero;MEJILLONES                    ;ANTOFAGASTA;12990;1;1;0;0;0;1;1;12990;HERVIDOR COLONIA 1,7 LITROS;ELECTRODOMESTICOS
5147163;;M;77;CHILENO;;Silencioso;ARICA                         ;ARICA Y PARINACOTA;18990;1;1;0;0;0;1;1;18990;Plancha UT-DUNST 2200Watts Base Ceramica;ELECTRODOMESTICOS
18538863;;F;29;CHILENO;;Millenial;N/D;N/D;84980;2;4;1;1;34990;1;3;49990;Aspiradora UT-SILENT1804 Arrastre 1800Watts;ELECTRODOMESTICOS
15525137;;F;39;CHILENO;;X;MAIPU                         ;METROPOLITANA;49990;1;3;0;0;0;1;3;49990;FREIDORA DE AIRE BAVIERA 3,8 LITROS;ELECTRODOMESTICOS
10565197;;F;51;CHILENO;;X;LA LIGUA                      ;VALPARAISO;89990;1;1;1;1;89990;0;0;0;Horno Electrico UT-BACKOFEN48 48Lts;ELECTRODOMESTICOS
16803685;;F;34;CHILENO;;Millenial;CORONEL                       ;BIO BIO;107220;3;2;0;0;0;3;2;107220;Batidora Vertical Minipimer UT-KLOT800SS;ELECTRODOMESTICOS
6390541;;M;69;CHILENO;;Silencioso;RENCA                         ;METROPOLITANA;36990;1;1;0;0;0;1;1;36990;HORNO ELECTRICO 16N01 16LTS NEGRO;ELECTRODOMESTICOS
12457853;;F;49;CHILENO;;X;ANGOL                         ;ARAUCANIA;32980;2;1;0;0;0;2;1;32980;Batidora Vertical Stick Mixer 2609;ELECTRODOMESTICOS
9863019;;F;58;CHILENO;;Boomers;PADRE LAS CASAS               ;ARAUCANIA;59990;1;1;1;1;59990;0;0;0;Aspiradora TH1870 Arrastre 1800Watts Gris;ELECTRODOMESTICOS
7986620;;M;63;CHILENO;;Boomers;RENCA                         ;METROPOLITANA;148970;3;3;0;0;0;3;3;148970;Horno Electrico UT-BACKOFEN48 48Lts;ELECTRODOMESTICOS
18818568;;F;28;CHILENO;;Millenial;PROVIDENCIA                   ;METROPOLITANA;29990;1;1;0;0;0;1;1;29990;Cafetera TH-138i;ELECTRODOMESTICOS
15732146;;F;37;CHILENO;;Millenial;N/D;N/D;56970;3;3;0;0;0;3;3;56970;FREIDORA DE AIRE HESSIA 2,0 LITROS;ELECTRODOMESTICOS
17794674;;M;31;CHILENO;;Millenial;TENO                          ;MAULE;49990;1;1;0;0;0;1;1;49990;Horno Electrico TH-25N01 25Lts;ELECTRODOMESTICOS
11399172;;F;53;CHILENO;;X;PICHIDEGUA                    ;L.G.B.OÂ´HIGGINS;284970;3;2;0;0;0;3;2;284970;FREIDORA DE AIRE THOMAS TH-AF60Mi;ELECTRODOMESTICOS
10224683;;M;57;CHILENO;;Boomers;ILLAPEL                       ;COQUIMBO;347980;2;2;0;0;0;2;2;347980;Sandwichera TH-952 2 Panes Blanca;ELECTRODOMESTICOS
10525087;;M;52;CHILENO;;X;PROVIDENCIA                   ;METROPOLITANA;143980;2;1;2;1;143980;0;0;0;SUPER FREIDORA DE AIRE OV3;ELECTRODOMESTICOS
18851713;;F;28;CHILENO;;Millenial;"";"";221970;4;3;0;0;0;4;3;221970;Hervidor Electrico TH-4515N 2Lts Negro;ELECTRODOMESTICOS
7258424;;F;67;CHILENO;;Boomers;CONCHALI                      ;METROPOLITANA;63980;2;1;2;1;63980;0;0;0;Freidora de Aire Healty Fryer 3.5L;ELECTRODOMESTICOS
15306944;;M;39;CHILENO;;X;N/D;N/D;126970;3;2;0;0;0;3;2;126970;FREIDORA DE AIRE THOMAS TH-AF60Mi;ELECTRODOMESTICOS
10787773;;F;52;CHILENO;;X;ARICA                         ;ARICA Y PARINACOTA;69990;1;1;1;1;69990;0;0;0;Enceradora EA-5000;ELECTRODOMESTICOS
16517609;;F;35;CHILENO;;Millenial;"";"";124960;4;2;4;2;124960;0;0;0;Tostador de Pan TP-1400 4 Rebanadas Inox;ELECTRODOMESTICOS
19559540;;F;25;CHILENO;;Z;N/D;N/D;194970;3;2;2;1;179980;1;1;14990;Batidora Vertical Stick Mixer 2609;ELECTRODOMESTICOS
25656676;;F;28;VENEZOLANO;;Extranjero;"";"";39990;1;1;0;0;0;1;1;39990;Licuadora Kaliman Negra con Teclas;ELECTRODOMESTICOS
10586482;Casado;F;55;CHILENO;;Boomers;MAIPU                         ;METROPOLITANA;24990;1;1;0;0;0;1;1;24990;LICUADORA HANOVER 1,5 LITROS;ELECTRODOMESTICOS
16732510;;F;35;CHILENO;;Millenial;ALTO DEL CARMEN               ;ATACAMA;59990;1;1;0;0;0;1;1;59990;Horno Electrico TH-38N 38Lts;ELECTRODOMESTICOS
11648885;;F;51;CHILENO;;X;RENCA                         ;METROPOLITANA;34990;1;1;0;0;0;1;1;34990;Licuadora clasica oster edicion 75 anos;ELECTRODOMESTICOS
10813206;Soltero;M;56;CHILENO;TECNICO;Boomers;PROVIDENCIA                   ;METROPOLITANA;49990;1;1;0;0;0;1;1;49990;FREIDORA DE AIRE BAVIERA 3,8 LITROS;ELECTRODOMESTICOS
16364339;;M;35;CHILENO;;Millenial;COIHAIQUE                     ;AYSEN;18990;1;1;0;0;0;1;1;18990;HERVIDOR TH-4340;ELECTRODOMESTICOS
13097342;;F;46;CHILENO;;X;N/D;N/D;10990;1;1;0;0;0;1;1;10990;Exprimidor de Jugo CJ-2000 1Lts;ELECTRODOMESTICOS
5791720;;M;71;CHILENO;;Silencioso;CURANILAHUE                   ;BIO BIO;54990;1;1;0;0;0;1;1;54990;Freidora de Aire 18M Oster;ELECTRODOMESTICOS
19578174;;M;25;CHILENO;;Z;N/D;N/D;59980;2;2;0;0;0;2;2;59980;HORNO ELECTRICO BREMEN 23 LITROS;ELECTRODOMESTICOS
8448083;;M;62;CHILENO;;Boomers;SAN CARLOS                    ;BIO BIO;589970;3;3;0;0;0;3;3;589970;FREIDORA DE AIRE THOMAS TH-AF60Mi;ELECTRODOMESTICOS
8022226;;F;69;CHILENO;;Silencioso;BUIN                          ;METROPOLITANA;29990;1;1;0;0;0;1;1;29990;PLANCHA VAPOR TH-7146;ELECTRODOMESTICOS
18291658;;F;29;CHILENO;;Millenial;SAN FERNANDO;O HIGGINS;158980;2;1;2;1;158980;0;0;0;CAFETERA PRIMA LATTE 6603 COTTON CANDY;ELECTRODOMESTICOS
13327365;;M;44;CHILENO;;X;"";"";302970;3;2;0;0;0;3;2;302970;Hervidor Electrico Tetera HA-4100 4Lts Iox;ELECTRODOMESTICOS
10540471;Casado;F;52;CHILENO;;X;RENCA                         ;METROPOLITANA;39990;1;1;0;0;0;1;1;39990;Freidora de Aire 18M Oster;ELECTRODOMESTICOS
21726169;;M;58;PERUANO;;Extranjero;SANTIAGO                      ;METROPOLITANA;65250;2;1;0;0;0;2;1;65250;Aspiradora Tambor APA1000 1000Watts;ELECTRODOMESTICOS
15225365;;F;43;CHILENO;;X;ANGOL                         ;ARAUCANIA;179980;2;2;0;0;0;2;2;179980;Horno Electrico TH-38N 38Lts;ELECTRODOMESTICOS
15323198;;F;43;CHILENO;;X;SAN FERNANDO                  ;L.G.B.OÂ´HIGGINS;15990;1;1;0;0;0;1;1;15990;Hervidor Electrico UT-MANLY17 1,7Lts Negro;ELECTRODOMESTICOS
14080121;;F;42;CHILENO;;X;PROVIDENCIA                   ;METROPOLITANA;411950;5;4;0;0;0;5;4;411950;Horno Electrico TH-25N01 25Lts;ELECTRODOMESTICOS
10912995;Casado;F;55;CHILENO;;Boomers;RENCA                         ;METROPOLITANA;115250;2;1;0;0;0;2;1;115250;Maquina de coser Singer 1605;ELECTRODOMESTICOS
11678812;Casado;M;52;CHILENO;TECNICO ELECTRONICO;X;RENCA                         ;METROPOLITANA;44990;1;1;0;0;0;1;1;44990;Aspiradora TH1407 Arrastre 1400Watts;ELECTRODOMESTICOS
17669830;;F;31;CHILENO;;Millenial;CAUQUENES                     ;MAULE;282700;6;4;0;0;0;6;4;282700;HORNO ELECTRICO THOMAS TH-38i;ELECTRODOMESTICOS
17157048;;M;33;CHILENO;;Millenial;PROVIDENCIA                   ;METROPOLITANA;44960;4;1;4;1;44960;0;0;0;PLANCHA A VAPOR 4070 SUELA CERAMICA 2500W;ELECTRODOMESTICOS
4202644;Casado;M;74;CHILENO;;Silencioso;PROVIDENCIA                   ;METROPOLITANA;13990;1;1;0;0;0;1;1;13990;Hervidor Electrico 3101 1,7Lts Negro;ELECTRODOMESTICOS
20570082;;F;22;CHILENO;;Z;CAUQUENES                     ;MAULE;327980;2;2;0;0;0;2;2;327980;HERVIDOR TH-4340;ELECTRODOMESTICOS
16699819;;M;34;CHILENO;;Millenial;LA FLORIDA                    ;METROPOLITANA;143980;2;1;2;1;143980;0;0;0;SUPER FREIDORA DE AIRE OV3;ELECTRODOMESTICOS
11413615;;M;53;CHILENO;;X;PUERTO MONTT                  ;LOS LAGOS;92870;2;2;0;0;0;2;2;92870;Horno Microondas Mecanico Fancy 20Lts;ELECTRODOMESTICOS
13040802;;F;45;CHILENO;;X;EL MONTE                      ;METROPOLITANA;93130;5;1;0;0;0;5;1;93130;Licuadora TH-401V Roja 1,75Lts Vaso Vidrio;ELECTRODOMESTICOS
8751728;;F;61;CHILENO;;Boomers;N/D;N/D;485960;4;3;0;0;0;4;3;485960;MAQUINA COSER 2250;ELECTRODOMESTICOS
5946652;;F;75;CHILENO;;Silencioso;TALCAHUANO                    ;BIO BIO;373790;8;4;2;1;75840;6;3;297950;Horno Microondas Digital TH-25DM 25Lts;ELECTRODOMESTICOS
17400650;;F;32;CHILENO;;Millenial;LOS ANGELES                   ;BIO BIO;645960;4;2;0;0;0;4;2;645960;Olla Multiuso 6801 5,7Lts;ELECTRODOMESTICOS
7664670;;M;61;CHILENO;;Boomers;LLAILLAY                      ;VALPARAISO;131970;3;2;0;0;0;3;2;131970;Exprimidor de Jugo 407W 1Lts;ELECTRODOMESTICOS
15510104;;M;39;CHILENO;;X;PROVIDENCIA                   ;METROPOLITANA;143980;2;1;2;1;143980;0;0;0;SUPER FREIDORA DE AIRE OV3;ELECTRODOMESTICOS
8576249;Divorciado;F;54;CHILENO;;Boomers;RENCA                         ;METROPOLITANA;14990;1;1;0;0;0;1;1;14990;Hervidor Electrico TH-4212N 1,7Lts Negro;ELECTRODOMESTICOS
7285225;;F;72;CHILENO;;Silencioso;VILLA ALEMANA                 ;VALPARAISO;168320;4;2;0;0;0;4;2;168320;Batidora Pedestal TH910PN 4,6Lts 1300Watts;ELECTRODOMESTICOS
5672369;;F;76;CHILENO;;Silencioso;RENCA                         ;METROPOLITANA;44990;1;1;0;0;0;1;1;44990;HERVIDOR TETERA RELOJ 900R 2,5L ROJO;ELECTRODOMESTICOS
10931608;;F;50;CHILENO;;X;VINA DEL MAR                  ;VALPARAISO;137960;4;3;3;2;115970;1;1;21990;Plancha TH-7052 2000Watts Base Inox;ELECTRODOMESTICOS
12141592;;F;55;CHILENO;;Boomers;N/D;N/D;545530;6;2;0;0;0;6;2;545530;Plancha a Vapor 5001;ELECTRODOMESTICOS
7493118;;M;67;CHILENO;;Boomers;N/D;N/D;205969;3;2;0;0;0;3;2;205969;HERVIDOR COLONIA 1,7 LITROS;ELECTRODOMESTICOS
15312541;;M;40;CHILENO;;Millenial;SAN ANTONIO                   ;VALPARAISO;25980;2;1;0;0;0;2;1;25980;PLANCHA A VAPOR 4070 SUELA CERAMICA 2500W;ELECTRODOMESTICOS
11926787;;F;50;CHILENO;;X;ANCUD                         ;LOS LAGOS;1010450;11;6;6;3;540500;5;3;469950;Horno Electrico TH-38N 38Lts;ELECTRODOMESTICOS
14328872;;M;44;CHILENO;;X;N/D;N/D;44990;1;1;0;0;0;1;1;44990;Horno Electrico TH-25N01 25Lts;ELECTRODOMESTICOS
26655130;;F;36;VENEZOLANO;;Extranjero;PUERTO MONTT                  ;LOS LAGOS;34982;2;3;0;0;0;2;3;34982;Combo Hervidor + Batidora;ELECTRODOMESTICOS
16691756;;M;35;CHILENO;;Millenial;PUENTE ALTO                   ;METROPOLITANA;1326600;9;5;0;0;0;9;5;1326600;Licuadora TH-320 Roja/Negro 1,5 Lts Vaso Vidrio;ELECTRODOMESTICOS
16697103;;M;34;CHILENO;;Millenial;VALPARAISO;VALPARAISO;661960;4;2;4;2;661960;0;0;0;H MICROONDA MMP-23GABV 23L;ELECTRODOMESTICOS
11952747;;F;49;CHILENO;;X;RENCA                         ;METROPOLITANA;16990;1;1;0;0;0;1;1;16990;Batidora Manual 3532;ELECTRODOMESTICOS
12803629;;M;47;CHILENO;;X;COPIAPO                       ;ATACAMA;59990;1;1;0;0;0;1;1;59990;PROCESADOR DE ALIMENTOS UT-PROCESSOR750;ELECTRODOMESTICOS
8940806;;M;59;CHILENO;;Boomers;N/D;N/D;74990;1;1;0;0;0;1;1;74990;Horno Microondas Digital TH-25DM 25Lts;ELECTRODOMESTICOS
5679088;;F;75;CHILENO;;Silencioso;QUILLOTA                      ;VALPARAISO;63980;2;1;0;0;0;2;1;63980;Horno Microondas Mecanico Easy Wave 20Lts;ELECTRODOMESTICOS
10081320;;F;59;CHILENO;;Boomers;MELIPILLA                     ;METROPOLITANA;14990;1;1;0;0;0;1;1;14990;Hervidor Electrico TH-4212N 1,7Lts Negro;ELECTRODOMESTICOS
9619556;;F;63;CHILENO;;Boomers;LO PRADO                      ;METROPOLITANA;67980;2;2;0;0;0;2;2;67980;Licuadora TH-501V 1,5Lts Vaso Vidrio;ELECTRODOMESTICOS
8159153;;M;64;CHILENO;;Boomers;CHIMBARONGO                   ;L.G.B.OÂ´HIGGINS;329970;3;2;0;0;0;3;2;329970;Hervidor Electrico UT-KLAR20PW 2Lts Blanco;ELECTRODOMESTICOS
7835056;;F;67;CHILENO;;Boomers;MELIPILLA                     ;METROPOLITANA;21990;1;1;0;0;0;1;1;21990;HERVIDOR ELECTRICO UT-STARK18;ELECTRODOMESTICOS
23547482;;F;54;PERUANO;;Extranjero;RECOLETA                      ;METROPOLITANA;49980;4;1;0;0;0;4;1;49980;Olla Arrocera OA-400NG 1,8Lts;ELECTRODOMESTICOS
19521455;;F;25;CHILENO;;Z;PROVIDENCIA                   ;METROPOLITANA;49990;1;1;0;0;0;1;1;49990;ASPIRADORA THOMAS TH-1640;ELECTRODOMESTICOS
24763646;Soltero;F;55;PERUANO;;Extranjero;PROVIDENCIA                   ;METROPOLITANA;12990;1;1;0;0;0;1;1;12990;PLANCHA A VAPOR 4070 SUELA CERAMICA 2500W;ELECTRODOMESTICOS
5508229;;F;71;CHILENO;;Silencioso;LOS ANGELES                   ;BIO BIO;29990;1;1;0;0;0;1;1;29990;Licuadora TH-320 Roja/Negro 1,5 Lts Vaso Vidrio;ELECTRODOMESTICOS
18135464;;F;30;CHILENO;;Millenial;LOTA                          ;BIO BIO;25980;2;1;0;0;0;2;1;25980;PLANCHA A VAPOR 4070 SUELA CERAMICA 2500W;ELECTRODOMESTICOS
8576423;;M;63;CHILENO;;Boomers;LA UNION                      ;LOS LAGOS;99990;1;1;0;0;0;1;1;99990;Horno Electrico TH62I 60Lts;ELECTRODOMESTICOS
18059104;;M;30;CHILENO;;Millenial;PAINE                         ;METROPOLITANA;105960;4;2;2;1;53980;2;1;51980;Olla a Presion Multiolla Daily Food 6L;ELECTRODOMESTICOS
12397551;;F;48;CHILENO;;X;CALAMA                        ;ANTOFAGASTA;149990;1;1;0;0;0;1;1;149990;Maquina de Coser 311;ELECTRODOMESTICOS
13734089;Casado;F;49;CHILENO;;X;PROVIDENCIA                   ;METROPOLITANA;49990;1;1;0;0;0;1;1;49990;Horno Electrico TH-25N01 25Lts;ELECTRODOMESTICOS
12530772;;F;48;CHILENO;;X;PROVIDENCIA                   ;METROPOLITANA;36990;1;1;0;0;0;1;1;36990;Plancha UT-SHANGRILA Inalambrica 2200Watss;ELECTRODOMESTICOS
5812642;;F;76;CHILENO;;Silencioso;RENCA                         ;METROPOLITANA;64990;1;1;0;0;0;1;1;64990;Batidora Pedestal TH910PN 4,6Lts 1300Watts;ELECTRODOMESTICOS
16214217;;F;36;CHILENO;;Millenial;N/D;N/D;272970;5;3;0;0;0;5;3;272970;Tostador de Pan TH-126 4 Rebanadas Negro;ELECTRODOMESTICOS
20336320;;F;22;CHILENO;;Z;PUDAHUEL;METROPOLITANA;153980;2;1;2;1;153980;0;0;0;CAFETERA PRIMA LATTE 6603 COTTON CANDY;ELECTRODOMESTICOS
13309335;;M;45;CHILENO;;X;PROVIDENCIA                   ;METROPOLITANA;16990;1;1;0;0;0;1;1;16990;Hervidor Family Kettle HE500;ELECTRODOMESTICOS
18599136;;F;28;CHILENO;;Millenial;MAIPU                         ;METROPOLITANA;15240;2;1;0;0;0;2;1;15240;Batidora Vertical Stick Mixer 2609;ELECTRODOMESTICOS
9740269;;F;60;CHILENO;;Boomers;PARRAL                        ;MAULE;474980;2;2;0;0;0;2;2;474980;Horno Electrico UT-BACKOFEN48 48Lts;ELECTRODOMESTICOS
17581443;;M;33;CHILENO;;Millenial;PROVIDENCIA                   ;METROPOLITANA;94990;1;1;0;0;0;1;1;94990;Horno Microondas Digital TH-25DM 25Lts;ELECTRODOMESTICOS
5881473;;F;75;CHILENO;;Silencioso;QUILPUE                       ;VALPARAISO;74980;2;2;0;0;0;2;2;74980;Horno Electrico TH-25N01 25Lts;ELECTRODOMESTICOS
5925155;;M;72;CHILENO;;Silencioso;CANETE                        ;BIO BIO;159990;1;1;0;0;0;1;1;159990;Horno Electrico TH-100i 100Lts;ELECTRODOMESTICOS
16661136;;F;34;CHILENO;;Millenial;LA REINA                      ;METROPOLITANA;312950;6;3;6;3;312950;0;0;0;MAQUINA COSER 2250;ELECTRODOMESTICOS
18518498;;F;28;CHILENO;;Millenial;N/D;N/D;27960;4;2;0;0;0;4;2;27960;PLANCHA A VAPOR 4070 SUELA CERAMICA 2500W;ELECTRODOMESTICOS
11299174;;F;54;CHILENO;;X;LA LIGUA                      ;VALPARAISO;29980;2;2;0;0;0;2;2;29980;PLANCHA A VAPOR 4070 SUELA CERAMICA 2500W;ELECTRODOMESTICOS
14485350;;F;46;CHILENO;;X;SAGRADA FAMILIA               ;MAULE;83940;6;3;0;0;0;6;3;83940;Licuadora UT-METALLEK505P 1,5Lts Vaso Vidrio;ELECTRODOMESTICOS
19583054;;F;25;CHILENO;;Z;SAN JAVIER                    ;MAULE;371963;6;3;0;0;0;6;3;371963;Horno Microondas Mecanico TH-18B05 18Lts;ELECTRODOMESTICOS
25576367;;F;33;VENEZOLANO;;Extranjero;ESTACION CENTRAL              ;METROPOLITANA;103980;2;1;2;1;103980;0;0;0;FREIDORA DE AIRE CKSTAF55 1700W;ELECTRODOMESTICOS
14010301;;M;40;CHILENO;;X;PROVIDENCIA                   ;METROPOLITANA;71970;3;2;2;1;58980;1;1;12990;Cafetera TH-130;ELECTRODOMESTICOS
14507986;Soltero;F;48;CHILENO;CONTADOR AUDITOR;X;RENCA                         ;METROPOLITANA;16990;1;1;0;0;0;1;1;16990;HERVIDOR BERLIN 1,7 LITROS;ELECTRODOMESTICOS
16419030;;M;36;CHILENO;;Millenial;PROVIDENCIA                   ;METROPOLITANA;18990;1;1;0;0;0;1;1;18990;Plancha UT-DUNST 2200Watts Base Ceramica;ELECTRODOMESTICOS
14074201;;F;40;CHILENO;;X;VICTORIA                      ;ARAUCANIA;250970;3;3;0;0;0;3;3;250970;Licuadora L2000VNG 1,5Lts Vaso Vidrio;ELECTRODOMESTICOS
10664983;;F;55;CHILENO;;Boomers;SAN CLEMENTE                  ;MAULE;175950;5;3;0;0;0;5;3;175950;Horno Electrico TH-38N 38Lts;ELECTRODOMESTICOS
10829363;;F;55;CHILENO;;Boomers;PROVIDENCIA                   ;METROPOLITANA;43990;1;1;0;0;0;1;1;43990;Freidora de Aire 18M Oster;ELECTRODOMESTICOS
14215653;;F;40;CHILENO;;X;LONQUIMAY;ARAUCANIA;34990;1;1;0;0;0;1;1;34990;Combo Hervidor + Tostador + Sandwichera;ELECTRODOMESTICOS
15310752;Soltero;M;39;CHILENO;;X;NATALES                       ;MAGALLANES;52980;2;2;0;0;0;2;2;52980;Aspiradora AP1700 Arrastre 1700Watts;ELECTRODOMESTICOS
17807167;;F;31;CHILENO;;Millenial;SAN ANTONIO                   ;VALPARAISO;813920;8;2;0;0;0;8;2;813920;Licuadora Berry Blender Roja 1400 Vaso Vidrio;ELECTRODOMESTICOS
15914212;;M;43;CHILENO;;X;LA LIGUA                      ;VALPARAISO;128970;4;2;0;0;0;4;2;128970;Aspiradora Handy Clean Black 1400;ELECTRODOMESTICOS
18712120;;M;27;CHILENO;;Millenial;RENGO;O HIGGINS;28990;1;1;0;0;0;1;1;28990;Hervidor Electrico Tetera UT-LECKER18R 1,8Lts;ELECTRODOMESTICOS
8193872;;F;65;CHILENO;;Boomers;PROVIDENCIA                   ;METROPOLITANA;119990;1;1;0;0;0;1;1;119990;Horno Electrico TH62I 60Lts;ELECTRODOMESTICOS
6840614;;F;72;CHILENO;;Silencioso;CHIMBARONGO                   ;L.G.B.OÂ´HIGGINS;19990;1;1;0;0;0;1;1;19990;Hervidor Electrico TH-4515N 2Lts Negro;ELECTRODOMESTICOS
12576376;;F;48;CHILENO;;X;FREIRINA                      ;ATACAMA;84972;3;4;0;0;0;3;4;84972;Exprimidor de Jugo 407W 1Lts;ELECTRODOMESTICOS
10136704;;M;57;CHILENO;;Boomers;COLINA                        ;METROPOLITANA;149960;4;3;0;0;0;4;3;149960;Aspiradora UT-SILENT1804 Arrastre 1800Watts;ELECTRODOMESTICOS
9510323;;F;58;CHILENO;;Boomers;ANGOL                         ;ARAUCANIA;77980;2;2;0;0;0;2;2;77980;Licuadora L-5500IN 1,5Lts;ELECTRODOMESTICOS
17550163;;F;30;CHILENO;;Silencioso;FUTRONO                       ;LOS RIOS;13990;1;1;0;0;0;1;1;13990;Hervidor Electrico 3101 1,7Lts Negro;ELECTRODOMESTICOS
7602271;;F;68;CHILENO;;Silencioso;VALDIVIA                      ;LOS RIOS;18990;1;1;0;0;0;1;1;18990;MULTIMIXER THOMAS TH- 8706;ELECTRODOMESTICOS
16806257;Soltero;F;34;CHILENO;;Millenial;PROVIDENCIA                   ;METROPOLITANA;169990;1;1;0;0;0;1;1;169990;Maquina de Coser 311;ELECTRODOMESTICOS
9478883;;M;59;CHILENO;;Boomers;LA CRUZ                       ;VALPARAISO;44990;1;1;0;0;0;1;1;44990;Horno Electrico UT-BACKOFEN26 26Lts;ELECTRODOMESTICOS
25913944;;M;26;BOLIVIANO;;Extranjero;N/D;N/D;93970;3;1;0;0;0;3;1;93970;Licuadora Kaliman Negra con Teclas;ELECTRODOMESTICOS
13702877;Casado;F;43;CHILENO;;X;RENCA                         ;METROPOLITANA;19990;1;1;0;0;0;1;1;19990;Hervidor Electrico UT-DUNKEL17P 2Lts Negro;ELECTRODOMESTICOS
14906807;Soltero;F;41;CHILENO;ASISTENTE SOCIAL;X;RENCA                         ;METROPOLITANA;546350;4;3;0;0;0;4;3;546350;Licuadora TH-501V 1,5Lts Vaso Vidrio;ELECTRODOMESTICOS
11110351;;F;55;CHILENO;;Boomers;N/D;N/D;13980;2;3;0;0;0;2;3;13980;Hervidor Electrico Tetera HA-4100 4Lts Iox;ELECTRODOMESTICOS
18945595;;F;28;CHILENO;;Millenial;HUECHURABA                    ;METROPOLITANA;43980;2;1;2;1;43980;0;0;0;ASPIRADORA ROBOT WIFI FIDDLER HOME BLANCA;ELECTRODOMESTICOS
7163482;;M;69;CHILENO;;Silencioso;N/D;N/D;311960;5;3;0;0;0;5;3;311960;Horno Electrico TH62I 60Lts;ELECTRODOMESTICOS
6075874;;M;82;CHILENO;;Silencioso;SAN JAVIER                    ;MAULE;62980;2;2;0;0;0;2;2;62980;Plancha a Vapor Oster 3803;ELECTRODOMESTICOS
7114698;;M;66;CHILENO;;Boomers;RENCA                         ;METROPOLITANA;39990;1;1;0;0;0;1;1;39990;Procesador TH-9010 Multimixer 1,5Lts Vaso Vidrio;ELECTRODOMESTICOS
16482106;;F;35;CHILENO;;Millenial;NACIMIENTO                    ;BIO BIO;22091;1;1;0;0;0;1;1;22091;Plancha UT-KERAMIKTOP 2200Watts Base Ceramica;ELECTRODOMESTICOS
14299699;;M;46;CHILENO;;X;COIHAIQUE                     ;AYSEN;139990;1;1;0;0;0;1;1;139990;CAFETERA PRIMA LATTE 6603 ROJA;ELECTRODOMESTICOS
8287456;;M;59;CHILENO;;Boomers;QUINTA DE TILCOCO             ;L.G.B.OÂ´HIGGINS;68170;2;1;0;0;0;2;1;68170;Aspiradora UT-SILENT1804 Arrastre 1800Watts;ELECTRODOMESTICOS
11441185;;F;52;CHILENO;;X;HUECHURABA                    ;METROPOLITANA;12990;1;1;0;0;0;1;1;12990;HERVIDOR COLONIA 1,7 LITROS;ELECTRODOMESTICOS
7324088;;F;71;CHILENO;;Silencioso;ISLA DE MAIPO                 ;METROPOLITANA;389960;4;3;0;0;0;4;3;389960;Licuadora UT-METALLEK505P 1,5Lts Vaso Vidrio;ELECTRODOMESTICOS
14338821;;M;45;CHILENO;;X;PROVIDENCIA                   ;METROPOLITANA;89990;1;1;0;0;0;1;1;89990;Olla Multiuso 6801 5,7Lts;ELECTRODOMESTICOS
12760162;;F;46;CHILENO;;X;DALCAHUE                      ;LOS LAGOS;432960;4;2;0;0;0;4;2;432960;MAQUINA COSER 2250;ELECTRODOMESTICOS
13716072;;F;42;CHILENO;;X;N/D;N/D;19990;1;1;0;0;0;1;1;19990;Hervidor Electrico TH-4515N 2Lts Negro;ELECTRODOMESTICOS
7145468;;F;63;CHILENO;;Silencioso;PROVIDENCIA                   ;METROPOLITANA;37560;3;2;0;0;0;3;2;37560;Batidora Vertical Stick Mixer 2609;ELECTRODOMESTICOS
8782817;Casado;F;63;CHILENO;;Boomers;RENCA                         ;METROPOLITANA;29990;1;1;0;0;0;1;1;29990;Picadora UT-PETRUS320 1Lts Vaso Vidrio;ELECTRODOMESTICOS
7534379;;M;65;CHILENO;;Boomers;CONCEPCION                    ;BIO BIO;35980;2;2;0;0;0;2;2;35980;Olla Arrocera OA-400NG 1,8Lts;ELECTRODOMESTICOS
4554373;;M;80;CHILENO;;Silencioso;RENCA                         ;METROPOLITANA;9990;1;1;0;0;0;1;1;9990;Plancha a Vapor Oster 3803;ELECTRODOMESTICOS
10455422;Casado;M;56;CHILENO;PROFESOR;Boomers;RENCA                         ;METROPOLITANA;26990;1;1;1;1;26990;0;0;0;Plancha THOMAS TH-7170 2200Watts Base Ceramica;ELECTRODOMESTICOS
16393774;;M;35;CHILENO;;Millenial;N/D;N/D;71980;2;1;2;1;71980;0;0;0;Licuadora Reversible Roja;ELECTRODOMESTICOS
12210048;;F;50;CHILENO;;X;ARICA                         ;ARICA Y PARINACOTA;29990;1;1;0;0;0;1;1;29990;Combo Licuadora + Batidora;ELECTRODOMESTICOS
13313093;;M;44;CHILENO;;X;PROVIDENCIA                   ;METROPOLITANA;23990;1;1;0;0;0;1;1;23990;Licuadora L-1630V Negra 1,5Lts Vaso Vidrio;ELECTRODOMESTICOS
5496911;;F;78;CHILENO;;Silencioso;RENCA                         ;METROPOLITANA;34990;1;1;0;0;0;1;1;34990;Licuadora TH-501V 1,5Lts Vaso Vidrio;ELECTRODOMESTICOS
12084365;;M;49;CHILENO;;X;LOS ANDES                     ;VALPARAISO;99990;1;1;0;0;0;1;1;99990;FREIDORA DE AIRE THOMAS TH-AF60Mi;ELECTRODOMESTICOS
15999961;;F;37;CHILENO;;Millenial;RENCA                         ;METROPOLITANA;16990;1;1;0;0;0;1;1;16990;Hervidor Electrico HA-3300 2,5Lts Blanco;ELECTRODOMESTICOS
10972660;;F;53;CHILENO;;X;COLINA                        ;METROPOLITANA;29990;1;1;0;0;0;1;1;29990;HORNO ELECTRICO 16N01 16LTS NEGRO;ELECTRODOMESTICOS
17080968;;M;32;CHILENO;;Millenial;N/D;N/D;179970;3;4;1;1;26990;2;3;152980;Combo Licuadora + Batidora;ELECTRODOMESTICOS
6606234;;F;70;CHILENO;;Silencioso;PROVIDENCIA                   ;METROPOLITANA;12990;1;1;0;0;0;1;1;12990;Hervidor Electrico HA-3300 2,5Lts Blanco;ELECTRODOMESTICOS
27162294;;M;30;EXTRANJERO - NO INFORMA NACIONALIDAD;;Extranjero;N/D;N/D;612730;6;3;0;0;0;6;3;612730;Plancha Paninis 2880;ELECTRODOMESTICOS
12234254;;M;50;CHILENO;;X;PROVIDENCIA                   ;METROPOLITANA;39990;1;1;0;0;0;1;1;39990;Licuadora TH-501V 1,5Lts Vaso Vidrio;ELECTRODOMESTICOS
16327111;;M;36;CHILENO;;Millenial;LO PRADO                      ;METROPOLITANA;27990;1;1;0;0;0;1;1;27990;Picadora UT-PETRUS320 1Lts Vaso Vidrio;ELECTRODOMESTICOS
19266276;Soltero;M;31;CHILENO;;Silencioso;PROVIDENCIA                   ;METROPOLITANA;64980;2;1;0;0;0;2;1;64980;Licuadora TH-401V Roja 1,75Lts Vaso Vidrio;ELECTRODOMESTICOS
16187520;;M;37;CHILENO;;Millenial;N/D;N/D;120960;4;5;0;0;0;4;5;120960;Horno Microondas Digital UT-CLASSY720 20Lts;ELECTRODOMESTICOS
10488430;;M;56;CHILENO;;Boomers;RENCA                         ;METROPOLITANA;20980;2;1;0;0;0;2;1;20980;Plancha a Vapor Oster 3803;ELECTRODOMESTICOS
18438655;;F;28;CHILENO;;Millenial;TEMUCO                        ;ARAUCANIA;49990;1;1;0;0;0;1;1;49990;Aspiradora Tambor APA1000 1000Watts;ELECTRODOMESTICOS
9234719;;F;59;CHILENO;;Boomers;PROVIDENCIA                   ;METROPOLITANA;69990;1;1;0;0;0;1;1;69990;Horno Microondas Mecanico TH-18B05 18Lts;ELECTRODOMESTICOS
26107102;Soltero;F;32;VENEZOLANO;;Extranjero;PROVIDENCIA                   ;METROPOLITANA;133980;2;1;2;1;133980;0;0;0;SUPER FREIDORA DE AIRE OV3;ELECTRODOMESTICOS
14499022;;F;40;CHILENO;;X;LINARES                       ;MAULE;79990;1;1;0;0;0;1;1;79990;Enceradora EA-5000;ELECTRODOMESTICOS
4802386;;F;81;CHILENO;;Silencioso;LA CRUZ                       ;VALPARAISO;34990;1;1;0;0;0;1;1;34990;Licuadora Roja 550W 1,5Lts Vaso Vidrio;ELECTRODOMESTICOS
16614972;;M;35;CHILENO;;Millenial;PROVIDENCIA                   ;METROPOLITANA;89980;2;1;0;0;0;2;1;89980;Aspiradora TH1415 Arrastre 1500Watts;ELECTRODOMESTICOS
12616584;;F;47;CHILENO;;X;RENCA                         ;METROPOLITANA;74990;1;1;0;0;0;1;1;74990;Aspiradora UT-MEINER1803 Arrastre 1800Watts;ELECTRODOMESTICOS
12353245;;M;50;CHILENO;;X;RENCA                         ;METROPOLITANA;149990;1;1;0;0;0;1;1;149990;Horno Electrico TH-80i 80Lts;ELECTRODOMESTICOS
17322850;;F;32;CHILENO;;Millenial;TOCOPILLA                     ;ANTOFAGASTA;54980;2;2;0;0;0;2;2;54980;Licuadora L2000VNG 1,5Lts Vaso Vidrio;ELECTRODOMESTICOS
13339918;;F;44;CHILENO;;X;MELIPILLA                     ;METROPOLITANA;234980;2;2;0;0;0;2;2;234980;HERVIDOR TH-4340;ELECTRODOMESTICOS
26159176;;F;41;VENEZOLANO;;Extranjero;CAUQUENES                     ;MAULE;20990;1;1;0;0;0;1;1;20990;Plancha TH-7052 2000Watts Base Inox;ELECTRODOMESTICOS
12927205;Soltero;F;51;CHILENO;;X;RENCA                         ;METROPOLITANA;169980;2;2;0;0;0;2;2;169980;Combo Hervidor + Batidora;ELECTRODOMESTICOS
13400867;;M;51;CHILENO;;X;BUIN                          ;METROPOLITANA;190940;8;4;0;0;0;8;4;190940;Hervidor Inox One Midea;ELECTRODOMESTICOS
10186809;;F;58;CHILENO;;Boomers;PUERTO MONTT                  ;LOS LAGOS;424970;3;3;0;0;0;3;3;424970;Licuadora TH-501V 1,5Lts Vaso Vidrio;ELECTRODOMESTICOS
12665040;Casado;F;48;CHILENO;;X;RENCA                         ;METROPOLITANA;132980;2;1;0;0;0;2;1;132980;Horno Microondas Digital L UT-25KROMM 25Lts;ELECTRODOMESTICOS
9629783;Soltero;M;58;CHILENO;AGROINDUSTRIA;Boomers;CAUQUENES                     ;MAULE;100000;2;1;0;0;0;2;1;100000;Horno Electrico UT-BACKOFEN60 60Lts;ELECTRODOMESTICOS
18427925;;M;30;CHILENO;;Millenial;COCHRANE                      ;AYSEN;54990;1;1;0;0;0;1;1;54990;Aspiradora UT-SILENT1603 Arrastre 1600Watts;ELECTRODOMESTICOS
5842257;;F;81;CHILENO;;Silencioso;MELIPILLA                     ;METROPOLITANA;98970;3;2;0;0;0;3;2;98970;ASPIRADORA THOMAS TH-1640;ELECTRODOMESTICOS
18624331;;F;28;CHILENO;;Millenial;EL MONTE                      ;METROPOLITANA;14990;1;1;0;0;0;1;1;14990;Batidora Manual 3532;ELECTRODOMESTICOS
9817836;Casado;F;57;CHILENO;;Boomers;RENCA                         ;METROPOLITANA;69990;1;1;0;0;0;1;1;69990;Aspiradora TH1870 Arrastre 1800Watts Gris;ELECTRODOMESTICOS
8091587;;F;62;CHILENO;;Boomers;ALTO DEL CARMEN               ;ATACAMA;279970;3;3;0;0;0;3;3;279970;Licuadora L-25000NG;ELECTRODOMESTICOS
7848231;;M;64;CHILENO;;Boomers;ARICA                         ;ARICA Y PARINACOTA;12990;1;1;0;0;0;1;1;12990;Hervidor Inox One Midea;ELECTRODOMESTICOS
8544861;;F;65;CHILENO;;Boomers;CHILLAN                       ;BIO BIO;34990;1;1;0;0;0;1;1;34990;Horno Electrico TH-25N01 25Lts;ELECTRODOMESTICOS
12718073;;M;47;CHILENO;;X;ILLAPEL                       ;COQUIMBO;16990;1;1;0;0;0;1;1;16990;MULTIMIXER THOMAS TH- 8706;ELECTRODOMESTICOS
16935320;;F;29;CHILENO;;Millenial;CONSTITUCION                  ;MAULE;19990;1;1;0;0;0;1;1;19990;Hervidor Electrico TH-4515N 2Lts Negro;ELECTRODOMESTICOS
18741018;;M;28;CHILENO;;Millenial;SANTIAGO;METROPOLITANA;12990;1;1;0;0;0;1;1;12990;HERVIDOR COLONIA 1,7 LITROS;ELECTRODOMESTICOS
6511342;;M;71;CHILENO;;Silencioso;PUCON                         ;ARAUCANIA;119980;2;2;2;2;119980;0;0;0;Horno Electrico TH-48N 48Lts;ELECTRODOMESTICOS
16298293;;F;36;CHILENO;;Millenial;SAN CLEMENTE                  ;MAULE;79990;1;1;0;0;0;1;1;79990;Horno Electrico UT-BACKOFEN48 48Lts;ELECTRODOMESTICOS
16698890;;M;34;CHILENO;;Millenial;PUENTE ALTO                   ;METROPOLITANA;34990;1;1;0;0;0;1;1;34990;Licuadora L1000 Inox 1,7LtsVaso Vidrio;ELECTRODOMESTICOS
18380287;;M;29;CHILENO;;Millenial;QUILPUE                       ;VALPARAISO;76970;3;2;2;1;75980;1;1;990;Olla Multiuso 6801 5,7Lts;ELECTRODOMESTICOS
11404033;;F;53;CHILENO;;X;PROVIDENCIA                   ;METROPOLITANA;16990;1;1;0;0;0;1;1;16990;Batidora Manual 3532;ELECTRODOMESTICOS
12779074;;M;47;CHILENO;;X;REQUINOA                      ;L.G.B.OÂ´HIGGINS;29990;1;1;0;0;0;1;1;29990;Plancha UT-PLATTEISEN 2000Watts Base Ceramica;ELECTRODOMESTICOS
11565457;;F;51;CHILENO;;X;LINARES                       ;MAULE;14990;1;1;0;0;0;1;1;14990;Batidora Manual 3532;ELECTRODOMESTICOS
6505400;;F;72;CHILENO;;Silencioso;CANETE                        ;BIO BIO;58970;3;4;0;0;0;3;4;58970;Licuadora TH-401V Roja 1,75Lts Vaso Vidrio;ELECTRODOMESTICOS
7605799;;F;70;CHILENO;;Silencioso;CAUQUENES                     ;MAULE;89980;2;1;0;0;0;2;1;89980;Enceradora EA-5000;ELECTRODOMESTICOS
10348000;;F;45;CHILENO;;X;NATALES                       ;MAGALLANES;20990;1;1;0;0;0;1;1;20990;Hervidor Electrico TH-4515N 2Lts Negro;ELECTRODOMESTICOS
17427760;Soltero;F;32;CHILENO;PROFESOR;Millenial;PROVIDENCIA                   ;METROPOLITANA;73980;2;1;2;1;73980;0;0;0;Olla Multiuso 6801 5,7Lts;ELECTRODOMESTICOS
11738963;;F;50;CHILENO;;X;COLINA                        ;METROPOLITANA;29980;2;1;0;0;0;2;1;29980;Plancha TH-7052 2000Watts Base Inox;ELECTRODOMESTICOS
16741021;;F;36;CHILENO;;Millenial;ANCUD                         ;LOS LAGOS;390060;6;4;5;3;377070;1;1;12990;HERVIDOR TH-4340;ELECTRODOMESTICOS
14139918;;M;41;CHILENO;;X;IQUIQUE                       ;TARAPACA;19990;1;1;0;0;0;1;1;19990;Plancha TH-7052 2000Watts Base Inox;ELECTRODOMESTICOS
20149909;Soltero;F;30;CHILENO;PROFESOR;Millenial;LOTA                          ;BIO BIO;64990;1;1;0;0;0;1;1;64990;Horno Microondas Mecanico Fancy 20Lts;ELECTRODOMESTICOS
6792169;;F;66;CHILENO;;Boomers;TALCAHUANO                    ;BIO BIO;26990;1;1;0;0;0;1;1;26990;Tostador de Pan TP-1400 4 Rebanadas Inox;ELECTRODOMESTICOS
19478153;;F;25;CHILENO;;Z;PROVIDENCIA                   ;METROPOLITANA;44990;1;1;0;0;0;1;1;44990;Aspiradora Handy Clean Black 1400;ELECTRODOMESTICOS
9408485;;F;60;CHILENO;;Boomers;PUENTE ALTO                   ;METROPOLITANA;16990;1;1;0;0;0;1;1;16990;HERVIDOR BERLIN 1,7 LITROS;ELECTRODOMESTICOS
26248743;;F;45;VENEZOLANO;;Extranjero;N/D;N/D;89980;2;2;0;0;0;2;2;89980;Horno Electrico UT-LEIF36 36Lts;ELECTRODOMESTICOS
16199264;;F;36;CHILENO;;Millenial;EL QUISCO                     ;VALPARAISO;94990;1;1;0;0;0;1;1;94990;FREIDORA DE AIRE THOMAS TH-AF60Mi;ELECTRODOMESTICOS
15970148;;F;37;CHILENO;;Millenial;RECOLETA;METROPOLITANA;29990;1;1;0;0;0;1;1;29990;PLANCHA VAPOR TH-7146;ELECTRODOMESTICOS
9255852;;F;57;CHILENO;;Boomers;CORONEL                       ;BIO BIO;344980;2;2;0;0;0;2;2;344980;Horno Microondas Mecanico Easy Wave 20Lts;ELECTRODOMESTICOS
10882122;;F;50;CHILENO;;X;MELIPILLA                     ;METROPOLITANA;34990;1;1;0;0;0;1;1;34990;Licuadora Kaliman Negra con Teclas;ELECTRODOMESTICOS
17688180;;M;32;CHILENO;;Millenial;N/D;N/D;362450;4;2;0;0;0;4;2;362450;Hervidor Inox One Midea;ELECTRODOMESTICOS
8266949;Casado;F;67;CHILENO;;Boomers;VICTORIA                      ;ARAUCANIA;50000;2;1;0;0;0;2;1;50000;Licuadora TH-501V 1,5Lts Vaso Vidrio;ELECTRODOMESTICOS
13491619;;M;52;CHILENO;;X;N/D;N/D;24990;1;1;0;0;0;1;1;24990;Hervidor Electrico TH-5407i 2Lts;ELECTRODOMESTICOS
18981181;;F;27;CHILENO;;Millenial;YERBAS BUENAS                 ;MAULE;34990;1;1;0;0;0;1;1;34990;Combo Juguera + Hervidor;ELECTRODOMESTICOS
26176580;;M;26;EXTRANJERO - NO INFORMA NACIONALIDAD;;Extranjero;ESTACION CENTRAL              ;METROPOLITANA;64980;2;1;0;0;0;2;1;64980;Horno Microondas Mecanico Easy Wave 20Lts;ELECTRODOMESTICOS
13212632;;M;45;CHILENO;;X;ARICA                         ;ARICA Y PARINACOTA;167970;3;3;0;0;0;3;3;167970;Licuadora TH-501V 1,5Lts Vaso Vidrio;ELECTRODOMESTICOS
6234184;Casado;M;72;CHILENO;;Silencioso;PUNTA ARENAS                  ;MAGALLANES;24990;1;1;0;0;0;1;1;24990;Licuadora L-1630V Negra 1,5Lts Vaso Vidrio;ELECTRODOMESTICOS
9831178;;F;55;CHILENO;;Boomers;SAN VICENTE                   ;L.G.B.OÂ´HIGGINS;79990;1;1;0;0;0;1;1;79990;Enceradora EA-5000;ELECTRODOMESTICOS
11073354;;F;56;CHILENO;;Silencioso;PROVIDENCIA                   ;METROPOLITANA;34990;1;1;0;0;0;1;1;34990;Hervidor Electrico Tetera TH-6505RT 1,7Lts Rojo;ELECTRODOMESTICOS
8302565;Casado;F;64;CHILENO;;Boomers;RENCA                         ;METROPOLITANA;43990;1;1;0;0;0;1;1;43990;Licuadora TH-401V Roja 1,75Lts Vaso Vidrio;ELECTRODOMESTICOS
9978855;;F;67;CHILENO;;Boomers;PROVIDENCIA                   ;METROPOLITANA;20990;1;1;0;0;0;1;1;20990;MULTIMIXER THOMAS TH- 8706;ELECTRODOMESTICOS
5596914;;M;74;CHILENO;;Silencioso;QUILPUE                       ;VALPARAISO;39990;1;1;0;0;0;1;1;39990;Aspiradora TH1415 Arrastre 1500Watts;ELECTRODOMESTICOS
14214289;Soltero;F;41;CHILENO;;X;RENGO                         ;L.G.B.OÂ´HIGGINS;11990;1;1;0;0;0;1;1;11990;Hervidor Electrico 3101 1,7Lts Negro;ELECTRODOMESTICOS
18754220;;M;27;CHILENO;;Z;TEMUCO                        ;ARAUCANIA;68970;3;2;0;0;0;3;2;68970;Hervidor Electrico UT-REIN17SS;ELECTRODOMESTICOS
18645266;;M;27;CHILENO;;Millenial;PROVIDENCIA                   ;METROPOLITANA;39980;2;3;1;1;34990;1;2;4990;MULTIMIXER THOMAS TH- 8706;ELECTRODOMESTICOS
13679420;;F;43;CHILENO;;X;PENAFLOR                      ;METROPOLITANA;1029930;7;5;4;2;599960;3;3;429970;PLANCHA A VAPOR 6953 BASE AEROCERAMICA AUTAPA.22;ELECTRODOMESTICOS
23617807;Soltero;F;57;PERUANO;;Extranjero;MAIPU                         ;METROPOLITANA;44980;2;2;0;0;0;2;2;44980;Picadora UT-PETRUS320 1Lts Vaso Vidrio;ELECTRODOMESTICOS
11571624;;F;52;CHILENO;;X;PENCO                         ;BIO BIO;24990;1;1;0;0;0;1;1;24990;Licuadora L2000VNG 1,5Lts Vaso Vidrio;ELECTRODOMESTICOS
9794856;;F;57;CHILENO;;Boomers;PROVIDENCIA                   ;METROPOLITANA;12990;1;1;1;1;12990;0;0;0;PLANCHA A VAPOR 4070 SUELA CERAMICA 2500W;ELECTRODOMESTICOS
17977330;;F;31;CHILENO;;Millenial;PROVIDENCIA                   ;METROPOLITANA;76980;2;1;2;1;76980;0;0;0;Olla Multiuso 6801 5,7Lts;ELECTRODOMESTICOS
10089640;;F;56;CHILENO;;Boomers;"";"";12990;1;1;0;0;0;1;1;12990;PLANCHA A VAPOR 4070 SUELA CERAMICA 2500W;ELECTRODOMESTICOS
16240341;Soltero;M;36;CHILENO;PROFESOR;Millenial;RENCA                         ;METROPOLITANA;68980;2;1;0;0;0;2;1;68980;Aspiradora Tambor APA1000 1000Watts;ELECTRODOMESTICOS
11872403;;F;51;CHILENO;;X;COLINA                        ;METROPOLITANA;12990;1;1;0;0;0;1;1;12990;Hervidor Inox One Midea;ELECTRODOMESTICOS
15201628;;F;40;CHILENO;;X;RENCA                         ;METROPOLITANA;19970;3;1;0;0;0;3;1;19970;Plancha a Vapor Oster 3803;ELECTRODOMESTICOS
8642741;;M;63;CHILENO;;Boomers;COLINA                        ;METROPOLITANA;39990;1;1;0;0;0;1;1;39990;Picadora TH-9020V Vaso Vidrio 2Lts;ELECTRODOMESTICOS
10523790;Casado;M;54;CHILENO;;X;PROVIDENCIA                   ;METROPOLITANA;19990;1;1;0;0;0;1;1;19990;Plancha TH-7052 2000Watts Base Inox;ELECTRODOMESTICOS
13583740;;F;43;CHILENO;;X;VILLARICA                     ;ARAUCANIA;65980;2;1;0;0;0;2;1;65980;Licuadora TH-320 Roja/Negro 1,5 Lts Vaso Vidrio;ELECTRODOMESTICOS
17095726;;F;33;CHILENO;;Millenial;PROVIDENCIA                   ;METROPOLITANA;24990;1;1;0;0;0;1;1;24990;PLANCHA VAPOR TH-7146;ELECTRODOMESTICOS
6418267;;F;68;CHILENO;;Silencioso;N/D;N/D;23990;1;1;0;0;0;1;1;23990;Plancha UT-KERAMIK1 2200Watts Base Ceramica;ELECTRODOMESTICOS
13773143;;M;41;CHILENO;;X;MELIPILLA                     ;METROPOLITANA;29990;1;1;0;0;0;1;1;29990;PLANCHA VAPOR TH-7146;ELECTRODOMESTICOS
17358498;;F;32;CHILENO;;Millenial;SAGRADA FAMILIA               ;MAULE;14990;1;1;0;0;0;1;1;14990;Exprimidor de Jugo CJ-2000 1Lts;ELECTRODOMESTICOS
14149243;;M;47;CHILENO;;X;N/D;N/D;291900;10;4;0;0;0;10;4;291900;Horno Microondas Mecanico Easy Wave 20Lts;ELECTRODOMESTICOS
12718614;;F;46;CHILENO;;X;N/D;N/D;16990;1;1;0;0;0;1;1;16990;Exprimidor de Jugo 407W 1Lts;ELECTRODOMESTICOS
13287578;;M;45;CHILENO;;X;ANCUD                         ;LOS LAGOS;53980;2;1;0;0;0;2;1;53980;Aspiradora TH1415 Arrastre 1500Watts;ELECTRODOMESTICOS
11746661;;M;51;CHILENO;;X;RENCA                         ;METROPOLITANA;29990;1;1;0;0;0;1;1;29990;Combo Juguera + Hervidor;ELECTRODOMESTICOS
17079067;;M;33;CHILENO;;Millenial;SAN ANTONIO                   ;VALPARAISO;22980;2;1;0;0;0;2;1;22980;Hervidor Inox One Midea;ELECTRODOMESTICOS
8768209;;F;62;CHILENO;;Boomers;MOSTAZAL                      ;L.G.B.OÂ´HIGGINS;34990;1;1;0;0;0;1;1;34990;Batidora Vertical Minipimer UT-KLOT400P;ELECTRODOMESTICOS
15068358;Soltero;M;40;CHILENO;TECNICO EN ADMINISTRACION DE EMPRESAS;X;RENCA                         ;METROPOLITANA;69990;1;1;0;0;0;1;1;69990;Aspiradora TH1870 Arrastre 1800Watts Gris;ELECTRODOMESTICOS
12592473;;M;51;CHILENO;;X;RENCA                         ;METROPOLITANA;31990;1;1;0;0;0;1;1;31990;Extractor de Jugo EX800 1,4Lts;ELECTRODOMESTICOS
10526718;;F;53;CHILENO;;X;RENCA                         ;METROPOLITANA;73470;5;2;0;0;0;5;2;73470;Plancha THOMAS TH-7170 2200Watts Base Ceramica;ELECTRODOMESTICOS
9667970;;F;59;CHILENO;;Boomers;VILLARICA                     ;ARAUCANIA;18990;1;1;0;0;0;1;1;18990;Batidora Manual TH-8830;ELECTRODOMESTICOS
24821450;;M;42;HAITIANO;;Extranjero;N/D;N/D;11990;1;1;0;0;0;1;1;11990;Hervidor Electrico 3101 1,7Lts Negro;ELECTRODOMESTICOS
16702072;;M;34;CHILENO;;Millenial;N/D;N/D;421960;4;3;0;0;0;4;3;421960;Hervidor Electrico 3101 1,7Lts Negro;ELECTRODOMESTICOS
7423400;Casado;F;66;CHILENO;PROFESOR;Boomers;SAN CARLOS                    ;BIO BIO;17980;2;1;0;0;0;2;1;17980;Plancha a Vapor Oster 3803;ELECTRODOMESTICOS
9690375;;F;62;CHILENO;;Boomers;SAN JAVIER                    ;MAULE;109790;6;3;0;0;0;6;3;109790;Horno Electrico TH-25N01 25Lts;ELECTRODOMESTICOS
9812500;;F;57;CHILENO;;Boomers;RENCA                         ;METROPOLITANA;57980;2;1;0;0;0;2;1;57980;Licuadora L2000VNG 1,5Lts Vaso Vidrio;ELECTRODOMESTICOS
15491279;;F;39;CHILENO;;X;SAN CARLOS                    ;BIO BIO;494950;5;3;0;0;0;5;3;494950;Horno Microondas Mecanico Easy Wave 20Lts;ELECTRODOMESTICOS
17336992;;M;32;CHILENO;;Millenial;N/D;N/D;21990;1;1;0;0;0;1;1;21990;Hervidor Electrico Tetera HA-4100 4Lts Iox;ELECTRODOMESTICOS
15357470;;M;39;CHILENO;;X;PROVIDENCIA                   ;METROPOLITANA;29990;1;1;1;1;29990;0;0;0;Licuadora Roja 550W 1,5Lts Vaso Vidrio;ELECTRODOMESTICOS
16421048;;F;35;CHILENO;;Millenial;MAIPU                         ;METROPOLITANA;80230;3;1;0;0;0;3;1;80230;Horno Microondas Mecanico M-2030 NG 20Lts;ELECTRODOMESTICOS
26484067;Soltero;F;36;EXTRANJERO - NO INFORMA NACIONALIDAD;;Extranjero;PROVIDENCIA                   ;METROPOLITANA;12990;1;1;1;1;12990;0;0;0;PLANCHA A VAPOR 4070 SUELA CERAMICA 2500W;ELECTRODOMESTICOS
8160698;Casado;M;65;CHILENO;;Boomers;RENCA                         ;METROPOLITANA;17990;1;1;0;0;0;1;1;17990;Hervidor Electrico UT-KLAR20PW 2Lts Blanco;ELECTRODOMESTICOS
19256873;;M;26;CHILENO;;Z;"";"";21990;1;1;0;0;0;1;1;21990;HERVIDOR ELECTRICO UT-STARK18;ELECTRODOMESTICOS
19527296;;F;24;CHILENO;;Z;N/D;N/D;208510;5;3;2;1;84540;3;2;123970;Aspiradora TH1870 Arrastre 1800Watts Gris;ELECTRODOMESTICOS
13356010;;M;44;CHILENO;;X;CHILLAN                       ;BIO BIO;113980;2;1;0;0;0;2;1;113980;Horno Electrico UT-BACKOFEN60 60Lts;ELECTRODOMESTICOS
19312019;Soltero;M;26;CHILENO;;Z;PROVIDENCIA                   ;METROPOLITANA;16980;2;1;2;1;16980;0;0;0;PLANCHA A VAPOR 4070 SUELA CERAMICA 2500W;ELECTRODOMESTICOS
22681246;Soltero;F;52;ESTADOUNIDENSE;;Extranjero;PROVIDENCIA                   ;METROPOLITANA;19990;1;1;0;0;0;1;1;19990;Hervidor Family Kettle HE500;ELECTRODOMESTICOS
9696579;Casado;F;57;CHILENO;;Boomers;RENCA                         ;METROPOLITANA;19990;1;1;0;0;0;1;1;19990;Set Hervidor Valory VK330 Blanco + Tostador de;ELECTRODOMESTICOS
20901960;Soltero;F;26;CHILENO;;Z;COIHAIQUE                     ;AYSEN;328980;2;2;0;0;0;2;2;328980;Exprimidor de Jugo 407W 1Lts;ELECTRODOMESTICOS
10637980;;F;56;CHILENO;;Boomers;NUEVA IMPERIAL                ;ARAUCANIA;32990;1;1;0;0;0;1;1;32990;Combo Licuadora + Batidora;ELECTRODOMESTICOS
11715677;;M;51;CHILENO;;X;HUALAIHUE                     ;LOS LAGOS;40980;2;2;0;0;0;2;2;40980;Licuadora Sport Blender BSE10;ELECTRODOMESTICOS
4665854;;M;78;CHILENO;;Silencioso;PROVIDENCIA                   ;METROPOLITANA;29990;1;1;0;0;0;1;1;29990;Combo Juguera + Hervidor;ELECTRODOMESTICOS
16997398;Soltero;F;33;CHILENO;PERIODISTA;Millenial;PROVIDENCIA                   ;METROPOLITANA;194980;2;4;0;2;0;2;2;194980;Cafetera P65 Silver;ELECTRODOMESTICOS
9884473;;M;57;CHILENO;;Boomers;N/D;N/D;11990;1;1;0;0;0;1;1;11990;Exprimidor de Jugo CJ-2000 1Lts;ELECTRODOMESTICOS
7562558;;F;67;CHILENO;;Boomers;LA LIGUA                      ;VALPARAISO;101980;2;1;0;0;0;2;1;101980;Horno Electrico TH-25N01 25Lts;ELECTRODOMESTICOS
16189690;;F;36;CHILENO;;Millenial;COINCO                        ;L.G.B.OÂ´HIGGINS;119980;2;1;0;0;0;2;1;119980;Horno Microondas Digital TH20DM 20Lts Espejado;ELECTRODOMESTICOS
14260916;;M;48;CHILENO;;X;PROVIDENCIA                   ;METROPOLITANA;27990;1;1;0;0;0;1;1;27990;Picadora UT-PETRUS320 1Lts Vaso Vidrio;ELECTRODOMESTICOS
5839085;Viudo;M;71;CHILENO;;Silencioso;RENCA                         ;METROPOLITANA;17990;1;1;0;0;0;1;1;17990;Hervidor Electrico UT-KLAR20PW 2Lts Blanco;ELECTRODOMESTICOS
8740874;;F;62;CHILENO;;Boomers;LOS ANGELES                   ;BIO BIO;134980;2;2;0;0;0;2;2;134980;Licuadora L1000 Inox 1,7LtsVaso Vidrio;ELECTRODOMESTICOS
19754128;;F;24;CHILENO;;Z;PROVIDENCIA                   ;METROPOLITANA;26990;1;1;0;0;0;1;1;26990;Licuadora L2000VNG 1,5Lts Vaso Vidrio;ELECTRODOMESTICOS
8674681;;M;62;CHILENO;;Boomers;RENCA                         ;METROPOLITANA;52980;2;1;0;0;0;2;1;52980;Plancha UT-SHANGRILA Inalambrica 2200Watss;ELECTRODOMESTICOS
16342312;;M;35;CHILENO;;Millenial;PROVIDENCIA                   ;METROPOLITANA;146970;3;1;0;0;0;3;1;146970;Horno Electrico UT-BACKOFEN38 38Lts;ELECTRODOMESTICOS
5291927;;F;76;CHILENO;;Silencioso;RENCA                         ;METROPOLITANA;14990;1;1;0;0;0;1;1;14990;Batidora Vertical Stick Mixer 2609;ELECTRODOMESTICOS
10194248;;F;57;CHILENO;;Boomers;SAN ANTONIO                   ;VALPARAISO;94980;2;1;0;0;0;2;1;94980;Aspiradora UT-SILENT1603 Arrastre 1600Watts;ELECTRODOMESTICOS
14212851;;F;41;CHILENO;;X;CORONEL                       ;BIO BIO;109970;3;1;0;0;0;3;1;109970;Batidora Vertical Minipimer UT-KLOT800SS;ELECTRODOMESTICOS
15227379;;F;40;CHILENO;;X;ANGOL                         ;ARAUCANIA;96980;2;2;0;0;0;2;2;96980;Horno electrico Black Oven 42lts;ELECTRODOMESTICOS
11940617;;F;49;CHILENO;;X;EL BOSQUE                     ;METROPOLITANA;59990;1;1;0;0;0;1;1;59990;Parrilla Electrica TH-224;ELECTRODOMESTICOS
25616547;Soltero;M;46;HAITIANO;;X;PAINE                         ;METROPOLITANA;83980;2;1;0;0;0;2;1;83980;Horno Microondas Mecanico M-2030 NG 20Lts;ELECTRODOMESTICOS
18562419;;M;28;CHILENO;;Millenial;PUTAENDO                      ;VALPARAISO;92980;2;2;0;0;0;2;2;92980;Aspiradora Tambor APA1000 1000Watts;ELECTRODOMESTICOS
7148734;;M;68;CHILENO;;Boomers;PROVIDENCIA                   ;METROPOLITANA;16990;1;1;0;0;0;1;1;16990;Plancha Easy Steam (PV4500);ELECTRODOMESTICOS
10158820;;F;58;CHILENO;;Boomers;CALBUCO                       ;LOS LAGOS;28240;2;1;0;0;0;2;1;28240;Plancha UT-PLATTEISEN 2000Watts Base Ceramica;ELECTRODOMESTICOS
25379177;;F;41;BOLIVIANO;;Extranjero;CALAMA                        ;ANTOFAGASTA;87980;2;5;0;0;0;2;5;87980;Licuadora TH-501V 1,5Lts Vaso Vidrio;ELECTRODOMESTICOS
9319243;Casado;F;59;CHILENO;;Boomers;RENCA                         ;METROPOLITANA;19990;1;1;0;0;0;1;1;19990;MULTIMIXER THOMAS TH- 8706;ELECTRODOMESTICOS
14324333;;F;45;CHILENO;;X;RENCA                         ;METROPOLITANA;23230;3;2;0;0;0;3;2;23230;Exprimidor de Jugo CJ-2000 1Lts;ELECTRODOMESTICOS
9248992;Casado;F;59;CHILENO;;Boomers;EL MONTE                      ;METROPOLITANA;19990;1;1;0;0;0;1;1;19990;Hervidor Electrico UT-DUNKEL17P 2Lts Negro;ELECTRODOMESTICOS
17356861;;M;32;CHILENO;;Millenial;PROVIDENCIA                   ;METROPOLITANA;149990;2;1;2;1;149990;0;0;0;Robot aspirador Roomba 614;ELECTRODOMESTICOS
20370270;;F;22;CHILENO;;Z;N/D;N/D;511990;13;5;4;2;155080;9;3;356910;Aspiradora TH1407 Arrastre 1400Watts;ELECTRODOMESTICOS
8972269;Casado;F;72;CHILENO;;Silencioso;RENCA                         ;METROPOLITANA;184980;2;1;0;0;0;2;1;184980;Horno Electrico TH62I 60Lts;ELECTRODOMESTICOS
13151496;;F;45;CHILENO;;X;ANGOL                         ;ARAUCANIA;24990;1;1;0;0;0;1;1;24990;Licuadora L-1630V Negra 1,5Lts Vaso Vidrio;ELECTRODOMESTICOS
22196646;;F;32;PERUANO;;Extranjero;RENCA;METROPOLITANA;49990;1;1;0;0;0;1;1;49990;Horno Microondas Mecanico Easy Wave 20Lts;ELECTRODOMESTICOS
10423536;;M;56;CHILENO;;Boomers;RENCA                         ;METROPOLITANA;29990;1;1;0;0;0;1;1;29990;Hervidor Electrico Tetera HA-4100 4Lts Iox;ELECTRODOMESTICOS
6333650;;M;71;CHILENO;;Silencioso;MELIPILLA                     ;METROPOLITANA;19990;1;1;0;0;0;1;1;19990;Combo Hervidor + Batidora;ELECTRODOMESTICOS
13277837;;F;45;CHILENO;;X;LA GRANJA                     ;METROPOLITANA;68980;2;1;0;0;0;2;1;68980;Horno Electrico UT-BACKOFEN26 26Lts;ELECTRODOMESTICOS
12721474;;M;47;CHILENO;;X;LA FLORIDA;METROPOLITANA;26990;1;1;0;0;0;1;1;26990;Tostador de Pan TP-1400 4 Rebanadas Inox;ELECTRODOMESTICOS
11173859;Casado;M;54;CHILENO;;Boomers;PROVIDENCIA                   ;METROPOLITANA;132980;2;1;0;0;0;2;1;132980;Horno Electrico TH62I 60Lts;ELECTRODOMESTICOS
9611237;;F;60;CHILENO;;Boomers;MOSTAZAL                      ;L.G.B.OÂ´HIGGINS;14990;1;1;0;0;0;1;1;14990;Hervidor Electrico HA-3300 2,5Lts Blanco;ELECTRODOMESTICOS
19255658;Soltero;F;25;CHILENO;FONOAUDIOLOGO;Z;PROVIDENCIA                   ;METROPOLITANA;265470;3;1;3;1;265470;0;0;0;CAFETERA PRIMA LATTE 6603 ROJA;ELECTRODOMESTICOS
18539271;;F;29;CHILENO;;Millenial;ANGOL                         ;ARAUCANIA;39990;1;1;1;1;39990;0;0;0;Aspiradora TH1407 Arrastre 1400Watts;ELECTRODOMESTICOS
17633094;Soltero;F;31;CHILENO;;Millenial;PROVIDENCIA                   ;METROPOLITANA;39980;2;2;0;0;0;2;2;39980;Set Hervidor Valory VK330 Blanco + Tostador de;ELECTRODOMESTICOS
4868989;;M;78;CHILENO;;Silencioso;RENCA                         ;METROPOLITANA;21990;1;1;0;0;0;1;1;21990;Plancha TH-7052 2000Watts Base Inox;ELECTRODOMESTICOS
19169190;;F;26;CHILENO;;Z;SAN CARLOS                    ;BIO BIO;69990;1;1;0;0;0;1;1;69990;Horno electrico Black Oven 42lts;ELECTRODOMESTICOS
25801618;;M;33;VENEZOLANO;;Extranjero;LOS ANDES                     ;VALPARAISO;71980;2;2;1;1;49990;1;1;21990;Plancha UT-KERAMIK1 2200Watts Base Ceramica;ELECTRODOMESTICOS
14022480;;F;40;CHILENO;;X;RENCA                         ;METROPOLITANA;139990;1;1;0;0;0;1;1;139990;Horno Electrico TH-80i 80Lts;ELECTRODOMESTICOS
8239122;Casado;F;61;CHILENO;;Boomers;PROVIDENCIA                   ;METROPOLITANA;39970;3;2;0;0;0;3;2;39970;Hervidor Electrico UT-MANLY17 1,7Lts Negro;ELECTRODOMESTICOS
9506133;;M;60;CHILENO;;Boomers;PELLUHUE                      ;MAULE;129980;2;1;0;0;0;2;1;129980;Horno Microondas Digital UT-CLASSY720 20Lts;ELECTRODOMESTICOS
19260790;;F;25;CHILENO;;Z;N/D;N/D;32980;2;1;2;1;32980;0;0;0;HORNO 10 LITROS OSTER ROJO;ELECTRODOMESTICOS
19809588;;M;24;CHILENO;;Silencioso;VILLARICA                     ;ARAUCANIA;101970;3;2;0;0;0;3;2;101970;Exprimidor de Jugo CJ-2000 1Lts;ELECTRODOMESTICOS
18846615;;F;28;CHILENO;;Millenial;"";"";36990;1;1;0;0;0;1;1;36990;Licuadora L1000 Inox 1,7LtsVaso Vidrio;ELECTRODOMESTICOS
12658542;;M;47;CHILENO;;Millenial;"";"";312530;3;1;3;1;312530;0;0;0;Mi Robot Vacuum-Mop P (White) - 26200;ELECTRODOMESTICOS
8282977;;F;60;CHILENO;;Boomers;ANGOL                         ;ARAUCANIA;24990;1;1;0;0;0;1;1;24990;Licuadora TH-320 Roja/Negro 1,5 Lts Vaso Vidrio;ELECTRODOMESTICOS
14435219;Casado;F;51;CHILENO;;X;RENCA                         ;METROPOLITANA;16990;1;1;0;0;0;1;1;16990;Plancha a vapor 6052 Oster;ELECTRODOMESTICOS
10742854;;F;56;CHILENO;;Boomers;VILLARICA                     ;ARAUCANIA;42980;2;1;0;0;0;2;1;42980;Hervidor Electrico TH-5407i 2Lts;ELECTRODOMESTICOS
11532329;;F;54;CHILENO;;X;PARRAL                        ;MAULE;20990;1;1;0;0;0;1;1;20990;MULTIMIXER THOMAS TH- 8706;ELECTRODOMESTICOS
26269819;;M;30;HAITIANO;;Extranjero;"";"";44990;1;1;0;0;0;1;1;44990;Licuadora TH-501V 1,5Lts Vaso Vidrio;ELECTRODOMESTICOS
15357887;;F;39;CHILENO;;X;PROVIDENCIA                   ;METROPOLITANA;24980;2;2;0;0;0;2;2;24980;Batidora Vertical Stick Mixer 2609;ELECTRODOMESTICOS
9701681;;F;61;CHILENO;;Boomers;SAN VICENTE                   ;L.G.B.OÂ´HIGGINS;680720;7;3;0;0;0;7;3;680720;Horno Microondas Mecanico Easy Wave 20Lts;ELECTRODOMESTICOS
15993573;;F;39;CHILENO;;X;PROVIDENCIA                   ;METROPOLITANA;12990;1;1;0;0;0;1;1;12990;Hervidor Electrico HA-2650NG;ELECTRODOMESTICOS
16322793;Soltero;F;36;CHILENO;ENFERMERA;Millenial;PROVIDENCIA                   ;METROPOLITANA;24990;1;1;0;0;0;1;1;24990;Licuadora TH-320 Roja/Negro 1,5 Lts Vaso Vidrio;ELECTRODOMESTICOS
11435118;Soltero;M;52;CHILENO;INGENIERO AGRICOLA;X;PROVIDENCIA                   ;METROPOLITANA;84970;3;3;0;0;0;3;3;84970;HORNO ELECTRICO 16N01 16LTS NEGRO;ELECTRODOMESTICOS
16524761;;F;34;CHILENO;;Millenial;"";"";34990;1;1;0;0;0;1;1;34990;Licuadora TH-401V Roja 1,75Lts Vaso Vidrio;ELECTRODOMESTICOS
15431813;;M;40;CHILENO;;X;"";"";114970;3;2;0;0;0;3;2;114970;FREIDORA DE AIRE THOMAS TH-AF60Mi;ELECTRODOMESTICOS
19147125;Soltero;F;27;CHILENO;;Z;ARICA                         ;ARICA Y PARINACOTA;49990;1;1;0;0;0;1;1;49990;PROCESADOR THOMAS TH-9160;ELECTRODOMESTICOS
8103661;;M;65;CHILENO;;Boomers;CANETE                        ;BIO BIO;204980;4;2;0;0;0;4;2;204980;Horno Microondas Mecanico TH-18B05 18Lts;ELECTRODOMESTICOS
12313115;;M;48;CHILENO;;X;PROVIDENCIA                   ;METROPOLITANA;14990;1;1;0;0;0;1;1;14990;Hervidor Electrico HA-3300 2,5Lts Blanco;ELECTRODOMESTICOS
12626953;;F;47;CHILENO;;X;RENCA                         ;METROPOLITANA;25980;2;1;2;1;25980;0;0;0;PLANCHA A VAPOR 4070 SUELA CERAMICA 2500W;ELECTRODOMESTICOS
18428424;Soltero;F;29;CHILENO;;Millenial;PROVIDENCIA                   ;METROPOLITANA;85230;3;1;0;0;0;3;1;85230;ASPIRADORA THOMAS TH-1640;ELECTRODOMESTICOS
5320990;;F;78;CHILENO;;Silencioso;RENCA                         ;METROPOLITANA;139990;1;1;0;0;0;1;1;139990;Horno Electrico TH-80i 80Lts;ELECTRODOMESTICOS
15512859;;F;38;CHILENO;;X;ANGOL                         ;ARAUCANIA;32980;2;2;0;0;0;2;2;32980;Batidora Manual 3532;ELECTRODOMESTICOS
18824313;Soltero;F;28;CHILENO;;Millenial;"";"";21990;1;1;0;0;0;1;1;21990;Licuadora TH-320 Roja/Negro 1,5 Lts Vaso Vidrio;ELECTRODOMESTICOS
15827231;;M;36;CHILENO;;Millenial;PROVIDENCIA                   ;METROPOLITANA;12990;1;1;0;0;0;1;1;12990;Hervidor Electrico HA-2650NG;ELECTRODOMESTICOS
8867423;Casado;M;60;CHILENO;MEDICO CIRUJANO;Boomers;RENCA                         ;METROPOLITANA;61970;3;1;3;1;61970;0;0;0;HORNO 10 LITROS OSTER ROJO;ELECTRODOMESTICOS
6133513;;F;80;CHILENO;;Silencioso;VICTORIA                      ;ARAUCANIA;69990;1;1;0;0;0;1;1;69990;PROCESADOR DE ALIMENTOS UT-PROCESSOR750;ELECTRODOMESTICOS
8907926;Casado;F;51;CHILENO;;X;RENCA                         ;METROPOLITANA;71980;2;2;0;0;0;2;2;71980;Horno Microondas Mecanico TH-18B05 18Lts;ELECTRODOMESTICOS
20343946;;F;27;CHILENO;;Extranjero;N/D;N/D;21990;1;1;1;1;21990;0;0;0;Batidora Manual BA-5010 Inox;ELECTRODOMESTICOS
17930498;;F;30;CHILENO;;Millenial;PROVIDENCIA                   ;METROPOLITANA;16990;1;1;0;0;0;1;1;16990;Tostador de Pan TH-116 2 Rebanadas Negro;ELECTRODOMESTICOS
17721040;;F;31;CHILENO;;Millenial;COQUIMBO                      ;COQUIMBO;54990;1;1;0;0;0;1;1;54990;Horno Microondas Mecanico TH-18B05 18Lts;ELECTRODOMESTICOS
9686897;;F;55;CHILENO;;Boomers;ARAUCO                        ;BIO BIO;26990;1;1;0;0;0;1;1;26990;Licuadora UT-METALLEK605P 1,55Lts;ELECTRODOMESTICOS
17750240;;F;32;CHILENO;;Extranjero;N/D;N/D;358860;9;2;0;0;0;9;2;358860;Horno Electrico TH-80i 80Lts;ELECTRODOMESTICOS
7267282;;M;64;CHILENO;;Boomers;ARICA                         ;TARAPACA;29990;1;1;0;0;0;1;1;29990;HORNO ELECTRICO 16N01 16LTS NEGRO;ELECTRODOMESTICOS
7030631;;F;72;CHILENO;;Silencioso;VILLARICA                     ;ARAUCANIA;254980;2;2;0;0;0;2;2;254980;Horno Electrico TH-100i 100Lts;ELECTRODOMESTICOS
13381345;;F;44;CHILENO;;X;CHILLAN VIEJO                 ;BIO BIO;34990;1;1;0;0;0;1;1;34990;Licuadora TH-401V Roja 1,75Lts Vaso Vidrio;ELECTRODOMESTICOS
17105861;;F;33;CHILENO;;Millenial;PENALOLEN                     ;METROPOLITANA;92970;3;1;0;0;0;3;1;92970;Horno Microondas Mecanico Easy Wave 20Lts;ELECTRODOMESTICOS
14316399;Soltero;F;45;CHILENO;;X;RENCA                         ;METROPOLITANA;29990;1;1;0;0;0;1;1;29990;Plancha UT-PLATTEISEN 2000Watts Base Ceramica;ELECTRODOMESTICOS
6088021;;F;72;CHILENO;;Silencioso;PAPUDO                        ;VALPARAISO;241970;3;2;0;0;0;3;2;241970;Licuadora Osterizer 4112/72 1,25Lts Vaso Vidrio;ELECTRODOMESTICOS
9941685;;M;59;CHILENO;;Boomers;RENCA                         ;METROPOLITANA;184980;2;1;0;0;0;2;1;184980;Maquina de Coser ME9100;ELECTRODOMESTICOS
15943472;;M;37;CHILENO;;Millenial;N/D;N/D;79990;1;1;0;0;0;1;1;79990;Aspiradora UT-MEINER1803 Arrastre 1800Watts;ELECTRODOMESTICOS
19411457;;F;26;CHILENO;;Z;MELIPILLA                     ;METROPOLITANA;324970;3;4;0;0;0;3;4;324970;Horno Electrico TH-38N 38Lts;ELECTRODOMESTICOS
7896824;;M;61;CHILENO;;Boomers;INDEPENDENCIA                 ;METROPOLITANA;27990;1;1;0;0;0;1;1;27990;Plancha UT-PLATTEISEN 2000Watts Base Ceramica;ELECTRODOMESTICOS
12275390;Casado;M;50;CHILENO;CONTADOR AUDITOR;X;RENCA                         ;METROPOLITANA;36990;1;1;1;1;36990;0;0;0;Aspiradora AP1700 Arrastre 1700Watts;ELECTRODOMESTICOS
9590562;;M;59;CHILENO;;Boomers;RENCA                         ;METROPOLITANA;74990;1;1;0;0;0;1;1;74990;Horno Electrico TH-48N 48Lts;ELECTRODOMESTICOS
18369268;;F;29;CHILENO;;Millenial;"";"";18990;1;1;0;0;0;1;1;18990;MULTIMIXER THOMAS TH- 8706;ELECTRODOMESTICOS
7776086;;M;64;CHILENO;;Boomers;PANGUIPULLI                   ;LOS RIOS;94990;1;1;0;0;0;1;1;94990;Batidora Pedestal TH910PN 4,6Lts 1300Watts;ELECTRODOMESTICOS
8706999;Casado;F;60;CHILENO;;Boomers;RENCA                         ;METROPOLITANA;34990;1;1;0;0;0;1;1;34990;Licuadora TH-501V 1,5Lts Vaso Vidrio;ELECTRODOMESTICOS
8830823;;F;63;CHILENO;;Boomers;QUILPUE                       ;VALPARAISO;155960;4;1;0;0;0;4;1;155960;Horno Electrico UT-BACKOFEN48 48Lts;ELECTRODOMESTICOS
5909427;;F;74;CHILENO;;Silencioso;TOCOPILLA                     ;ANTOFAGASTA;21990;1;1;0;0;0;1;1;21990;Licuadora Sport Blender BSE10;ELECTRODOMESTICOS
9568846;;F;60;CHILENO;;Boomers;PROVIDENCIA                   ;METROPOLITANA;44990;1;1;0;0;0;1;1;44990;PROCESADOR THOMAS TH-9160;ELECTRODOMESTICOS
12733403;;F;48;CHILENO;;X;VICTORIA                      ;ARAUCANIA;254960;4;3;0;0;0;4;3;254960;Batidora Pedestal Bowl 300 Inox;ELECTRODOMESTICOS
6774305;Divorciado;F;66;CHILENO;PROFESOR;Boomers;RENCA                         ;METROPOLITANA;-24990;-1;1;0;0;0;-1;1;-24990;Hervidor Electrico TH-5407i 2Lts;ELECTRODOMESTICOS
18184475;;M;30;CHILENO;;Millenial;LA FLORIDA                    ;METROPOLITANA;84980;2;2;0;0;0;2;2;84980;Freidora de Aire 18M Oster;ELECTRODOMESTICOS
14308842;;F;46;CHILENO;;X;CALAMA                        ;ANTOFAGASTA;156564;4;3;0;0;0;4;3;156564;Plancha UT-KERAMIKTOP 2200Watts Base Ceramica;ELECTRODOMESTICOS
11866571;;F;51;CHILENO;;X;N/D;N/D;20240;2;1;0;0;0;2;1;20240;Hervidor Electrico UT-DUNKEL17P 2Lts Negro;ELECTRODOMESTICOS
9432124;;F;60;CHILENO;;Boomers;CORONEL                       ;BIO BIO;47970;3;1;0;0;0;3;1;47970;Cafetera TH-130;ELECTRODOMESTICOS
19173099;;M;26;CHILENO;;Z;ERCILLA                       ;ARAUCANIA;63980;2;1;0;0;0;2;1;63980;Freidora de Aire 18M Oster;ELECTRODOMESTICOS
19392031;;M;25;CHILENO;;Z;PROVIDENCIA                   ;METROPOLITANA;29990;1;1;0;0;0;1;1;29990;Batidora Pedestal Bowl 300 Inox;ELECTRODOMESTICOS
11854627;;M;51;CHILENO;;X;PADRE LAS CASAS               ;ARAUCANIA;139990;1;1;0;0;0;1;1;139990;Horno Electrico TH-80i 80Lts;ELECTRODOMESTICOS
20376889;;F;21;CHILENO;;Millenial;TEMUCO                        ;ARAUCANIA;43980;2;1;0;0;0;2;1;43980;Licuadora TH-320 Roja/Negro 1,5 Lts Vaso Vidrio;ELECTRODOMESTICOS
10463250;;M;56;CHILENO;;Boomers;OVALLE                        ;COQUIMBO;19990;1;1;0;0;0;1;1;19990;Hervidor Electrico TH-5407i 2Lts;ELECTRODOMESTICOS
4771476;;F;76;CHILENO;;Silencioso;PROVIDENCIA                   ;METROPOLITANA;18990;1;1;0;0;0;1;1;18990;Tostador de PanTH-120R 2 Rebanadas Rojo;ELECTRODOMESTICOS
19255250;;F;26;CHILENO;;Z;"";"";179540;5;3;0;0;0;5;3;179540;Batidora Vertical Minipimer UT-KLOT400P;ELECTRODOMESTICOS
6570358;;F;72;CHILENO;;Silencioso;VILLARICA                     ;ARAUCANIA;16990;1;1;0;0;0;1;1;16990;HERVIDOR TH-4340;ELECTRODOMESTICOS
20010367;;F;23;CHILENO;;Z;PROVIDENCIA                   ;METROPOLITANA;129980;2;2;2;2;129980;0;0;0;Horno Electrico UT-BACKOFEN26 26Lts;ELECTRODOMESTICOS
12193999;;F;50;CHILENO;;X;RENCA                         ;METROPOLITANA;129990;1;1;0;0;0;1;1;129990;Maquina de Coser JS-2135CL Calipso;ELECTRODOMESTICOS
6149660;;F;69;CHILENO;;Silencioso;EL MONTE                      ;METROPOLITANA;49990;1;1;0;0;0;1;1;49990;Horno Microondas Mecanico TH-18B05 18Lts;ELECTRODOMESTICOS
10902087;;F;56;CHILENO;;Boomers;COIHAIQUE                     ;AYSEN;132980;2;2;0;0;0;2;2;132980;HORNO ELECTRICO 16N01 16LTS NEGRO;ELECTRODOMESTICOS
12947368;;F;46;CHILENO;;X;PETORCA                       ;VALPARAISO;149990;1;1;0;0;0;1;1;149990;Horno Electrico TH-80i 80Lts;ELECTRODOMESTICOS
7114612;;F;65;CHILENO;;Boomers;CALERA                        ;VALPARAISO;0;0;2;0;0;0;0;2;0;Horno Microondas Mecanico Fancy 20Lts;ELECTRODOMESTICOS
18968698;;F;27;CHILENO;;Z;COPIAPO                       ;ATACAMA;67970;3;2;0;0;0;3;2;67970;Combo Licuadora + Batidora;ELECTRODOMESTICOS
9060747;;M;62;CHILENO;;Boomers;RENGO                         ;L.G.B.OÂ´HIGGINS;149990;1;1;0;0;0;1;1;149990;Horno Electrico TH-100i 100Lts;ELECTRODOMESTICOS
13332143;;M;43;CHILENO;;X;RENCA                         ;METROPOLITANA;29990;1;1;0;0;0;1;1;29990;Batidora Pedestal B5300 Inox;ELECTRODOMESTICOS
14349888;;M;43;CHILENO;;X;PROVIDENCIA                   ;METROPOLITANA;43980;2;1;0;0;0;2;1;43980;Plancha Paninis 2880;ELECTRODOMESTICOS
4815984;;M;78;CHILENO;;Silencioso;ESTACION CENTRAL              ;METROPOLITANA;24990;1;1;0;0;0;1;1;24990;Licuadora TH-320 Roja/Negro 1,5 Lts Vaso Vidrio;ELECTRODOMESTICOS
17705101;;F;32;CHILENO;;Millenial;N/D;N/D;29990;1;1;0;0;0;1;1;29990;Combo Juguera + Hervidor;ELECTRODOMESTICOS
14469373;;F;50;CHILENO;;X;SAN BERNARDO                  ;METROPOLITANA;134970;3;1;0;0;0;3;1;134970;Horno Electrico UT-BACKOFEN38 38Lts;ELECTRODOMESTICOS
17138524;;F;32;CHILENO;;Millenial;SAN FERNANDO                  ;L.G.B.OÂ´HIGGINS;139990;1;1;0;0;0;1;1;139990;Horno Electrico TH-80i 80Lts;ELECTRODOMESTICOS
7539596;Casado;F;65;CHILENO;;Boomers;BUIN                          ;METROPOLITANA;19990;1;1;0;0;0;1;1;19990;Combo Hervidor + Batidora;ELECTRODOMESTICOS
16405393;;F;35;CHILENO;;Millenial;N/D;N/D;59990;1;1;0;0;0;1;1;59990;Aspiradora TH1870 Arrastre 1800Watts Gris;ELECTRODOMESTICOS
25420897;Soltero;F;41;BOLIVIANO;;Extranjero;CALAMA                        ;ANTOFAGASTA;133950;5;2;0;0;0;5;2;133950;Licuadora TH-401V Roja 1,75Lts Vaso Vidrio;ELECTRODOMESTICOS
8912773;Casado;F;59;CHILENO;;Boomers;GORBEA                        ;ARAUCANIA;36980;2;2;0;0;0;2;2;36980;Batidora Manual UT-TEKLA300;ELECTRODOMESTICOS
18421244;;M;28;CHILENO;;Millenial;NOGALES                       ;VALPARAISO;0;0;2;0;2;0;0;0;0;Hervidor Electrico Tetera TH-6505RT 1,7Lts Rojo;ELECTRODOMESTICOS
8917855;;M;65;CHILENO;;Boomers;ANGOL                         ;ARAUCANIA;118980;2;2;0;0;0;2;2;118980;Licuadora TH-401V Roja 1,75Lts Vaso Vidrio;ELECTRODOMESTICOS
11424528;;F;52;CHILENO;;X;RENCA                         ;METROPOLITANA;27990;1;1;0;0;0;1;1;27990;Hervidor Electrico Tetera TH-6505RT 1,7Lts Rojo;ELECTRODOMESTICOS
8810671;;M;62;CHILENO;;Boomers;QUILLOTA                      ;VALPARAISO;19990;1;1;0;0;0;1;1;19990;Hervidor Electrico UT-DUNKEL17P 2Lts Negro;ELECTRODOMESTICOS
5922066;;F;72;CHILENO;;Silencioso;CONSTITUCION                  ;MAULE;64990;1;1;0;0;0;1;1;64990;Horno Microondas Mecanico Easy Wave 20Lts;ELECTRODOMESTICOS
10371027;Divorciado;M;52;CHILENO;INGENIERO CIVIL ELECTRONICO;X;PROVIDENCIA                   ;METROPOLITANA;29990;1;1;0;0;0;1;1;29990;Licuadora Osterizer 4112/72 1,25Lts Vaso Vidrio;ELECTRODOMESTICOS
8030123;;F;64;CHILENO;;Boomers;CONCON                        ;VALPARAISO;18990;1;1;0;0;0;1;1;18990;Plancha UT-DUNST 2200Watts Base Ceramica;ELECTRODOMESTICOS
10798078;;M;53;CHILENO;;X;TOCOPILLA                     ;ANTOFAGASTA;59990;1;1;0;0;0;1;1;59990;Aspiradora TH1870 Arrastre 1800Watts Gris;ELECTRODOMESTICOS
8814824;;M;60;CHILENO;;Boomers;CHILLAN                       ;BIO BIO;49990;1;1;0;0;0;1;1;49990;Licuadora L-25000NG;ELECTRODOMESTICOS
13243372;;M;45;CHILENO;;X;LAMPA                         ;METROPOLITANA;24990;1;1;0;0;0;1;1;24990;Batidora Pedestal Bowl 300 Inox;ELECTRODOMESTICOS
8964151;;F;62;CHILENO;;Boomers;PAINE                         ;METROPOLITANA;54980;2;2;0;0;0;2;2;54980;Combo Licuadora + Batidora;ELECTRODOMESTICOS
15059333;;F;32;CHILENO;;Millenial;ZAPALLAR                      ;VALPARAISO;18990;1;1;0;0;0;1;1;18990;Hervidor Electrico TH-4515N 2Lts Negro;ELECTRODOMESTICOS
16702671;;F;34;CHILENO;;Millenial;PANQUEHUE                     ;VALPARAISO;19990;1;1;0;0;0;1;1;19990;Hervidor Electrico UT-DUNKEL17P 2Lts Negro;ELECTRODOMESTICOS
18065569;;M;30;CHILENO;;Millenial;PROVIDENCIA                   ;METROPOLITANA;219980;2;2;1;1;169990;1;1;49990;Licuadora L-25000NG;ELECTRODOMESTICOS
25348814;;M;54;COLOMBIANO;;Extranjero;MAIPU                         ;METROPOLITANA;102870;2;2;0;0;0;2;2;102870;Freidora de Aire 18M Oster;ELECTRODOMESTICOS
6998790;;M;66;CHILENO;;Boomers;BUIN                          ;METROPOLITANA;14990;1;1;0;0;0;1;1;14990;Hervidor Electrico UT-MANLY17 1,7Lts Negro;ELECTRODOMESTICOS
12398638;Soltero;F;48;CHILENO;PSICOLOGO;X;RENCA                         ;METROPOLITANA;33980;2;1;0;0;0;2;1;33980;Hervidor Electrico TH-4515N 2Lts Negro;ELECTRODOMESTICOS
12733880;;M;46;CHILENO;;X;MULCHEN                       ;BIO BIO;29990;1;1;0;0;0;1;1;29990;Set Hervidor Valory VK330 Blanco + Tostador de;ELECTRODOMESTICOS
10984872;;M;55;CHILENO;;Boomers;VALDIVIA                      ;LOS RIOS;26990;1;1;0;0;0;1;1;26990;Licuadora L2000VNG 1,5Lts Vaso Vidrio;ELECTRODOMESTICOS
17124728;;F;33;CHILENO;;Millenial;PROVIDENCIA                   ;METROPOLITANA;48540;2;1;2;1;48540;0;0;0;Aspiradora TH1407 Arrastre 1400Watts;ELECTRODOMESTICOS
16235523;;M;35;CHILENO;;Millenial;COLLIPULLI;ARAUCANIA;56980;2;1;2;1;56980;0;0;0;Batidora de Pedestal FDV Venus Grey;ELECTRODOMESTICOS
5731782;;F;76;CHILENO;;Silencioso;PROVIDENCIA                   ;METROPOLITANA;19990;1;1;0;0;0;1;1;19990;Tostador de PanTH-120R 2 Rebanadas Rojo;ELECTRODOMESTICOS
6033554;;M;68;CHILENO;;Silencioso;CURICO                        ;MAULE;82980;2;1;0;0;0;2;1;82980;Aspiradora UT-SILENT1804 Arrastre 1800Watts;ELECTRODOMESTICOS
6999901;;F;68;CHILENO;;Boomers;HUASCO                        ;ATACAMA;411970;3;2;0;0;0;3;2;411970;Horno Electrico TH-80i 80Lts;ELECTRODOMESTICOS
18699785;Soltero;F;26;CHILENO;;Z;PROVIDENCIA                   ;METROPOLITANA;19990;1;1;1;1;19990;0;0;0;Licuadora Sport Blender BSE10;ELECTRODOMESTICOS
5283618;;F;77;CHILENO;;Silencioso;RENCA                         ;METROPOLITANA;26990;1;1;0;0;0;1;1;26990;Licuadora Berry Blender Roja 1400 Vaso Vidrio;ELECTRODOMESTICOS
9477552;;F;60;CHILENO;;Boomers;EL BOSQUE                     ;METROPOLITANA;28980;2;2;0;0;0;2;2;28980;Batidora Manual UT-TEKLA300;ELECTRODOMESTICOS
12068822;Casado;F;56;CHILENO;;Boomers;PROVIDENCIA                   ;METROPOLITANA;127370;2;1;0;0;0;2;1;127370;Horno Electrico UT-BACKOFEN60 60Lts;ELECTRODOMESTICOS
8982312;;M;59;CHILENO;;Boomers;LA CRUZ                       ;VALPARAISO;16990;1;1;1;1;16990;0;0;0;Tostador de PanTH-120R 2 Rebanadas Rojo;ELECTRODOMESTICOS
18453287;;F;29;CHILENO;;Millenial;N/D;N/D;19990;1;1;0;0;0;1;1;19990;Plancha TH-7052 2000Watts Base Inox;ELECTRODOMESTICOS
25482787;;M;32;PERUANO;;Extranjero;N/D;N/D;103980;2;1;2;1;103980;0;0;0;SUPER FREIDORA DE AIRE OV3;ELECTRODOMESTICOS
19466713;Soltero;F;38;CHILENO;;X;PROVIDENCIA                   ;METROPOLITANA;49990;1;1;0;0;0;1;1;49990;Horno Microondas Mecanico Easy Wave 20Lts;ELECTRODOMESTICOS
16256155;Soltero;M;35;CHILENO;;Silencioso;PROVIDENCIA                   ;METROPOLITANA;63980;2;1;2;1;63980;0;0;0;ASPIRADORA VCC4580V3K/XZS SAMSUNG BLACK;ELECTRODOMESTICOS
18077877;;F;29;CHILENO;;Extranjero;LA FLORIDA                    ;METROPOLITANA;69990;1;1;0;0;0;1;1;69990;Enceradora EA-5000;ELECTRODOMESTICOS
19356642;;F;25;CHILENO;;Z;ARICA                         ;TARAPACA;14990;1;1;0;0;0;1;1;14990;Batidora Manual 3532;ELECTRODOMESTICOS
10996289;;M;53;CHILENO;;X;PROVIDENCIA                   ;METROPOLITANA;73980;2;1;2;1;73980;0;0;0;Horno Electrico TH-48N 48Lts;ELECTRODOMESTICOS
8149013;Casado;F;64;CHILENO;;Boomers;RENCA                         ;METROPOLITANA;54990;1;1;0;0;0;1;1;54990;Horno Microondas Mecanico C1700N 17Lts Blanco;ELECTRODOMESTICOS
11610175;Soltero;F;43;CHILENO;;X;PROVIDENCIA                   ;METROPOLITANA;15240;2;1;0;0;0;2;1;15240;Batidora Manual 3532;ELECTRODOMESTICOS
15968243;;M;38;CHILENO;;Millenial;OVALLE                        ;COQUIMBO;78983;2;2;0;0;0;2;2;78983;Horno Electrico UT-BACKOFEN38 38Lts;ELECTRODOMESTICOS
11116244;;F;56;CHILENO;;Boomers;N/D;N/D;141970;3;3;0;0;0;3;3;141970;Aspiradora TH1407 Arrastre 1400Watts;ELECTRODOMESTICOS
16194931;Soltero;F;35;CHILENO;;Millenial;PROVIDENCIA                   ;METROPOLITANA;72660;3;1;0;0;0;3;1;72660;Horno Electrico UT-BACKOFEN26 26Lts;ELECTRODOMESTICOS
11563730;;F;52;CHILENO;;X;TALCA                         ;MAULE;79990;1;1;0;0;0;1;1;79990;Batidora Pedestal TH910PN 4,6Lts 1300Watts;ELECTRODOMESTICOS
7731992;Casado;F;65;CHILENO;;Boomers;PROVIDENCIA                   ;METROPOLITANA;27980;2;2;0;0;0;2;2;27980;Batidora Vertical Stick Mixer 2609;ELECTRODOMESTICOS
8337267;;M;62;CHILENO;;Boomers;RENCA                         ;METROPOLITANA;49990;1;1;0;0;0;1;1;49990;Picadora TH-9020V Vaso Vidrio 2Lts;ELECTRODOMESTICOS
15161480;;F;39;CHILENO;;X;N/D;N/D;29990;1;1;0;0;0;1;1;29990;Licuadora TH-501V 1,5Lts Vaso Vidrio;ELECTRODOMESTICOS
10923959;;F;57;CHILENO;;Boomers;LA GRANJA                     ;METROPOLITANA;34990;1;1;0;0;0;1;1;34990;Aspiradora TH1407 Arrastre 1400Watts;ELECTRODOMESTICOS
16213255;;F;35;CHILENO;;Millenial;PROVIDENCIA                   ;METROPOLITANA;163980;2;1;2;1;163980;0;0;0;MICROONDAS 30L MG30T5018CK/ZS SAMSUNG;ELECTRODOMESTICOS
15146605;;M;39;CHILENO;;X;SAN CLEMENTE                  ;MAULE;34990;1;1;0;0;0;1;1;34990;Plancha Paninis 2880;ELECTRODOMESTICOS
4727534;;F;79;CHILENO;;Silencioso;SAN ANTONIO                   ;VALPARAISO;18240;2;1;0;0;0;2;1;18240;Hervidor Electrico UT-KLAR20PW 2Lts Blanco;ELECTRODOMESTICOS
15288294;;F;39;CHILENO;;X;CASTRO                        ;LOS LAGOS;29990;1;1;0;0;0;1;1;29990;Combo Hervidor + Tostador + Sandwichera;ELECTRODOMESTICOS
5013733;;F;76;CHILENO;;Silencioso;PROVIDENCIA                   ;METROPOLITANA;14990;1;1;0;0;0;1;1;14990;Hervidor Electrico HA-2650NG;ELECTRODOMESTICOS
12056728;;F;54;CHILENO;;X;YERBAS BUENAS                 ;MAULE;177370;2;1;0;0;0;2;1;177370;Horno Electrico TH-100i 100Lts;ELECTRODOMESTICOS
16492475;;F;35;CHILENO;;Millenial;RANCAGUA                      ;L.G.B.OÂ´HIGGINS;25990;1;1;0;0;0;1;1;25990;Combo Licuadora + Batidora;ELECTRODOMESTICOS
12668383;;F;48;CHILENO;;X;PROVIDENCIA                   ;METROPOLITANA;29990;1;1;0;0;0;1;1;29990;Licuadora Kaliman Negra con Teclas;ELECTRODOMESTICOS
14745377;;F;30;CHILENO;;Extranjero;SAN VICENTE                   ;L.G.B.OÂ´HIGGINS;149990;1;1;0;0;0;1;1;149990;Horno Electrico TH-100i 100Lts;ELECTRODOMESTICOS
13384268;;M;44;CHILENO;;X;"";"";158160;3;1;0;0;0;3;1;158160;Batidora Pedestal TH910PN 4,6Lts 1300Watts;ELECTRODOMESTICOS
13920152;;F;41;CHILENO;;X;RENCA                         ;METROPOLITANA;38980;2;1;2;1;38980;0;0;0;Aspiradora Polvo AP-700 GR;ELECTRODOMESTICOS
7691457;;F;65;CHILENO;;Boomers;RENCA                         ;METROPOLITANA;18990;1;1;0;0;0;1;1;18990;Batidora Manual TH-8830;ELECTRODOMESTICOS
13421800;;F;43;CHILENO;;X;N/D;N/D;129980;2;2;0;0;0;2;2;129980;ASPIRADORA ROBOT WIFI FIDDLER HOME BLANCA;ELECTRODOMESTICOS
18517941;;M;30;CHILENO;;Millenial;PANGUIPULLI                   ;LOS LAGOS;21990;2;3;0;0;0;2;3;21990;Batidora Manual 3532;ELECTRODOMESTICOS
7153350;;F;69;CHILENO;;Silencioso;PROVIDENCIA                   ;METROPOLITANA;24990;1;1;0;0;0;1;1;24990;Licuadora Roja 550W 1,5Lts Vaso Vidrio;ELECTRODOMESTICOS
17956457;Soltero;F;28;CHILENO;;Millenial;PROVIDENCIA                   ;METROPOLITANA;123980;2;1;2;1;123980;0;0;0;CAFETERA PRIMA LATTE 6603 NEGRA;ELECTRODOMESTICOS
16061771;;F;37;CHILENO;;Millenial;LOS ANGELES                   ;BIO BIO;61980;2;2;0;0;0;2;2;61980;Tostador de Pan TP-1400 4 Rebanadas Inox;ELECTRODOMESTICOS
15755592;;M;37;CHILENO;;Millenial;PROVIDENCIA                   ;METROPOLITANA;128540;2;1;2;1;128540;0;0;0;CAFETERA PRIMA LATTE 6603 ROJA;ELECTRODOMESTICOS
12912066;;F;47;CHILENO;;X;GRANEROS                      ;L.G.B.OÂ´HIGGINS;12990;1;1;0;0;0;1;1;12990;Hervidor Electrico TH-4212N 1,7Lts Negro;ELECTRODOMESTICOS
19757200;;M;25;CHILENO;;Z;PROVIDENCIA                   ;METROPOLITANA;34990;1;1;0;0;0;1;1;34990;Batidora Vertical Minipimer UT-KLOT400P;ELECTRODOMESTICOS
9433219;;F;59;CHILENO;;Boomers;ANGOL                         ;ARAUCANIA;59990;1;1;0;0;0;1;1;59990;Horno Microondas Mecanico TH-18B05 18Lts;ELECTRODOMESTICOS
17836565;Soltero;F;31;CHILENO;;Millenial;PROVIDENCIA                   ;METROPOLITANA;226440;4;1;0;0;0;4;1;226440;Horno Electrico TH62I 60Lts;ELECTRODOMESTICOS
11076153;;F;55;CHILENO;;Boomers;LOS ANGELES                   ;BIO BIO;144980;2;2;0;0;0;2;2;144980;Aspiradora UT-KRAFT(DIG) Arrastre 2200Watts;ELECTRODOMESTICOS
9042828;;F;58;CHILENO;;Boomers;OVALLE                        ;COQUIMBO;117370;2;1;0;0;0;2;1;117370;Horno Microondas Digital ME0113MB1/XZS 32Lts;ELECTRODOMESTICOS
18051399;Soltero;F;30;CHILENO;;Millenial;PROVIDENCIA                   ;METROPOLITANA;24990;1;1;0;0;0;1;1;24990;Licuadora L2000VNG 1,5Lts Vaso Vidrio;ELECTRODOMESTICOS
18637837;;F;29;CHILENO;;Millenial;NUNOA;METROPOLITANA;156980;2;2;2;2;156980;0;0;0;Aspiradora Trapeadora Robot Ut-Excellenza (B);ELECTRODOMESTICOS
12789830;;F;47;CHILENO;;X;COLBUN                        ;MAULE;54990;1;1;0;0;0;1;1;54990;Horno Electrico TH-48N 48Lts;ELECTRODOMESTICOS
6490288;;F;67;CHILENO;;Boomers;PROVIDENCIA                   ;METROPOLITANA;74990;1;1;0;0;0;1;1;74990;Horno Microondas Digital TH-20S01 20Lts;ELECTRODOMESTICOS
19726023;;F;24;CHILENO;;Z;PROVIDENCIA                   ;METROPOLITANA;169990;1;1;0;0;0;1;1;169990;Maquina de Coser 311;ELECTRODOMESTICOS
8936273;;F;60;CHILENO;;Boomers;PROVIDENCIA                   ;METROPOLITANA;63170;2;1;0;0;0;2;1;63170;Horno Microondas Mecanico Easy Wave 20Lts;ELECTRODOMESTICOS
6412918;Viudo;M;72;CHILENO;;Silencioso;ANTOFAGASTA                   ;ANTOFAGASTA;32990;1;1;0;0;0;1;1;32990;Hervidor Electrico Tetera HA-4100 4Lts Iox;ELECTRODOMESTICOS
16671201;;M;34;CHILENO;;Millenial;OSORNO                        ;LOS LAGOS;49990;1;1;0;0;0;1;1;49990;Aspiradora TH1415 Arrastre 1500Watts;ELECTRODOMESTICOS
6983658;Soltero;F;70;CHILENO;;Silencioso;PROVIDENCIA                   ;METROPOLITANA;78270;2;1;0;0;0;2;1;78270;Horno Microondas Mecanico UT-SYDNEY18 18Lts;ELECTRODOMESTICOS
15489678;;F;40;CHILENO;;X;RENCA                         ;METROPOLITANA;12990;1;1;0;0;0;1;1;12990;Hervidor Electrico 3101 1,7Lts Negro;ELECTRODOMESTICOS
7387086;;F;68;CHILENO;;Silencioso;CORONEL                       ;BIO BIO;74990;1;1;0;0;0;1;1;74990;Horno Microondas Digital ME0113MB1/XZS 32Lts;ELECTRODOMESTICOS
12714198;;F;47;CHILENO;;X;PUERTO MONTT                  ;LOS LAGOS;399980;2;2;0;0;0;2;2;399980;ASPIRADORA THOMAS TH-1640;ELECTRODOMESTICOS
10963328;;F;51;CHILENO;;X;ILLAPEL                       ;COQUIMBO;44670;2;3;0;0;0;2;3;44670;Hervidor Electrico Tetera HA-4100 4Lts Iox;ELECTRODOMESTICOS
10202862;;F;57;CHILENO;;Boomers;TEMUCO                        ;ARAUCANIA;127980;2;2;0;0;0;2;2;127980;Licuadora Personal TH-300PB;ELECTRODOMESTICOS
7760670;;F;66;CHILENO;;Boomers;RENCA                         ;METROPOLITANA;37670;2;1;0;0;0;2;1;37670;Licuadora L2000VNG 1,5Lts Vaso Vidrio;ELECTRODOMESTICOS
15671918;;F;38;CHILENO;;Millenial;PROVIDENCIA                   ;METROPOLITANA;16990;1;1;0;0;0;1;1;16990;MULTIMIXER THOMAS TH- 8706;ELECTRODOMESTICOS
10718367;;M;55;CHILENO;;Boomers;CONSTITUCION                  ;MAULE;59990;1;1;0;0;0;1;1;59990;Aspiradora TH1870 Arrastre 1800Watts Gris;ELECTRODOMESTICOS
8799179;;M;61;CHILENO;;Boomers;N/D;N/D;16990;1;1;0;0;0;1;1;16990;Hervidor Electrico HA-3300 2,5Lts Blanco;ELECTRODOMESTICOS
18451967;;F;32;CHILENO;;Millenial;CHILLAN                       ;BIO BIO;23990;1;1;0;0;0;1;1;23990;Olla Arrocera OA-400NG 1,8Lts;ELECTRODOMESTICOS
12326136;;F;49;CHILENO;;X;N/D;N/D;339980;2;2;0;0;0;2;2;339980;Horno Electrico TH-100i 100Lts;ELECTRODOMESTICOS
17711810;;F;31;CHILENO;;Millenial;PROVIDENCIA                   ;METROPOLITANA;22240;2;1;0;0;0;2;1;22240;Licuadora L-1630V Negra 1,5Lts Vaso Vidrio;ELECTRODOMESTICOS
26040307;;F;48;BOLIVIANO;;Extranjero;SANTIAGO                      ;METROPOLITANA;47670;2;1;0;0;0;2;1;47670;LICUADORA CROMADA CON TECLAS PLUS;ELECTRODOMESTICOS
12675312;;F;48;CHILENO;;X;N/D;N/D;24980;2;2;0;0;0;2;2;24980;Tostador de PanTH-120R 2 Rebanadas Rojo;ELECTRODOMESTICOS
7852250;;F;65;CHILENO;;Boomers;LLAILLAY                      ;VALPARAISO;441450;4;2;0;0;0;4;2;441450;Exprimidor de Jugo 407W 1Lts;ELECTRODOMESTICOS
17940130;;M;34;CHILENO;;Millenial;N/D;N/D;95340;4;1;0;0;0;4;1;95340;Cafetera UT-KAFFEEKLASSIK;ELECTRODOMESTICOS
7031441;;M;68;CHILENO;;Silencioso;PROVIDENCIA                   ;METROPOLITANA;69990;1;1;0;0;0;1;1;69990;Horno Microondas Digital MS23K3513AK/ZS 23Lts;ELECTRODOMESTICOS
9492055;;F;59;CHILENO;;Boomers;N/D;N/D;91980;2;1;0;0;0;2;1;91980;Horno Microondas Digital MS23K3513AK/ZS 23Lts;ELECTRODOMESTICOS
12328708;;F;49;CHILENO;;X;N/D;N/D;24990;1;1;0;0;0;1;1;24990;Plancha UT-KERAMIK1 2200Watts Base Ceramica;ELECTRODOMESTICOS
26744328;;F;37;EXTRANJERO - NO INFORMA NACIONALIDAD;;Extranjero;SAN MIGUEL;METROPOLITANA;53980;2;1;2;1;53980;0;0;0;ASPIRADORA POLVO Y AGUA APA-1150 IN;ELECTRODOMESTICOS
7393507;;M;68;CHILENO;;Silencioso;SAN FERNANDO                  ;L.G.B.OÂ´HIGGINS;39990;1;1;0;0;0;1;1;39990;Horno Electrico TH-25N01 25Lts;ELECTRODOMESTICOS
20899553;;M;38;CHILENO;;Millenial;PROVIDENCIA                   ;METROPOLITANA;59980;2;1;0;0;0;2;1;59980;Licuadora TH-501V 1,5Lts Vaso Vidrio;ELECTRODOMESTICOS
10591915;;F;56;CHILENO;;Boomers;YUMBEL                        ;BIO BIO;25990;1;1;0;0;0;1;1;25990;Combo Licuadora + Batidora;ELECTRODOMESTICOS
10776842;;F;56;CHILENO;;Boomers;PUENTE ALTO                   ;METROPOLITANA;149990;1;1;0;0;0;1;1;149990;Horno Electrico TH-80i 80Lts;ELECTRODOMESTICOS
5233878;;F;77;CHILENO;;Silencioso;RENCA                         ;METROPOLITANA;34990;1;1;0;0;0;1;1;34990;Licuadora TH-401V Roja 1,75Lts Vaso Vidrio;ELECTRODOMESTICOS
8313808;;F;63;CHILENO;;Boomers;N/D;N/D;499970;3;2;0;0;0;3;2;499970;Horno Electrico TH-38N 38Lts;ELECTRODOMESTICOS
7532314;;F;67;CHILENO;;Boomers;CERRILLOS                     ;METROPOLITANA;24990;1;1;0;0;0;1;1;24990;Combo Juguera + Hervidor;ELECTRODOMESTICOS
11515084;;M;52;CHILENO;;X;IQUIQUE                       ;TARAPACA;29990;1;1;0;0;0;1;1;29990;Licuadora Kaliman Negra con Teclas;ELECTRODOMESTICOS
19707827;;F;24;CHILENO;;Z;PAINE                         ;METROPOLITANA;31493;1;1;0;0;0;1;1;31493;Parrilla Electrica M18W;ELECTRODOMESTICOS
18757582;;F;28;CHILENO;;Millenial;LA SERENA                     ;COQUIMBO;89990;1;1;0;0;0;1;1;89990;Horno Electrico TH62I 60Lts;ELECTRODOMESTICOS
19271087;;F;25;CHILENO;;Z;N/D;N/D;59990;3;1;0;0;0;3;1;59990;Horno Electrico TH-25N01 25Lts;ELECTRODOMESTICOS
7883041;Casado;F;65;CHILENO;;Boomers;RENCA                         ;METROPOLITANA;34990;1;1;0;0;0;1;1;34990;Licuadora TH-401V Roja 1,75Lts Vaso Vidrio;ELECTRODOMESTICOS
11368082;;M;53;CHILENO;;X;RENCA                         ;METROPOLITANA;26990;1;1;0;0;0;1;1;26990;Hervidor Electrico UT-REIN17SS;ELECTRODOMESTICOS
9947626;Soltero;M;52;CHILENO;;X;RENCA                         ;METROPOLITANA;29990;1;1;0;0;0;1;1;29990;Hervidor Electrico Tetera HA-4100 4Lts Iox;ELECTRODOMESTICOS
20010574;;F;24;CHILENO;;Z;PROVIDENCIA                   ;METROPOLITANA;139980;2;1;0;0;0;2;1;139980;Batidora Pedestal TH910PN 4,6Lts 1300Watts;ELECTRODOMESTICOS
5805436;;F;76;CHILENO;;Silencioso;ANTOFAGASTA                   ;ANTOFAGASTA;59990;1;1;0;0;0;1;1;59990;Horno Electrico TH-38N 38Lts;ELECTRODOMESTICOS
26494810;;M;27;EXTRANJERO - NO INFORMA NACIONALIDAD;;Extranjero;VINA DEL MAR                  ;VALPARAISO;530860;11;3;11;3;530860;0;0;0;Batidora Pedestal FDV Atenea Roja;ELECTRODOMESTICOS
8893877;Casado;F;61;CHILENO;;Silencioso;PROVIDENCIA                   ;METROPOLITANA;69990;1;1;0;0;0;1;1;69990;Batidora Pedestal TH910PN 4,6Lts 1300Watts;ELECTRODOMESTICOS
13615698;;M;43;CHILENO;;X;PARRAL                        ;MAULE;9990;1;1;0;0;0;1;1;9990;Exprimidor de Jugo CJ-2000 1Lts;ELECTRODOMESTICOS
19588930;;F;25;CHILENO;;Z;PROVIDENCIA                   ;METROPOLITANA;84540;2;1;2;1;84540;0;0;0;FREIDORA DE AIRE THOMAS TH-AF60Mi;ELECTRODOMESTICOS
7375613;Casado;F;71;CHILENO;;Silencioso;RENCA                         ;METROPOLITANA;49670;2;1;0;0;0;2;1;49670;Aspiradora AP1700 Arrastre 1700Watts;ELECTRODOMESTICOS
10305117;;M;52;CHILENO;;X;PROVIDENCIA                   ;METROPOLITANA;49990;1;1;1;1;49990;0;0;0;Horno Microondas Digital TH-20S01 20Lts;ELECTRODOMESTICOS
11987178;;F;50;CHILENO;;X;ANGOL                         ;ARAUCANIA;49990;1;1;0;0;0;1;1;49990;Horno Electrico TH-25N01 25Lts;ELECTRODOMESTICOS
13390396;;M;43;CHILENO;;X;N/D;N/D;27990;1;1;0;0;0;1;1;27990;Combo Juguera + Hervidor;ELECTRODOMESTICOS
12196085;Casado;F;54;CHILENO;;Boomers;FREIRE                        ;ARAUCANIA;13980;2;1;0;0;0;2;1;13980;Plancha a Vapor Oster 3803;ELECTRODOMESTICOS
6640449;;M;69;CHILENO;;Silencioso;SAN ANTONIO                   ;VALPARAISO;29990;1;1;0;0;0;1;1;29990;Licuadora Personal TH-300PB;ELECTRODOMESTICOS
17201362;;M;32;CHILENO;;Millenial;ANTOFAGASTA                   ;ANTOFAGASTA;16990;1;1;1;1;16990;0;0;0;Plancha a vapor 6052 Oster;ELECTRODOMESTICOS
12179241;;M;49;CHILENO;;X;RENCA                         ;METROPOLITANA;54990;1;1;0;0;0;1;1;54990;Parrilla Electrica TH-224;ELECTRODOMESTICOS
7631379;;M;64;CHILENO;;Boomers;RENCA                         ;METROPOLITANA;89990;1;1;0;0;0;1;1;89990;Batidora Pedestal TH910PN 4,6Lts 1300Watts;ELECTRODOMESTICOS
13230986;;F;45;CHILENO;;X;RENCA                         ;METROPOLITANA;59980;2;2;2;2;59980;0;0;0;Horno Electrico TH-25N01 25Lts;ELECTRODOMESTICOS
18326439;Soltero;M;29;CHILENO;;Silencioso;PROVIDENCIA                   ;METROPOLITANA;68980;2;1;2;1;68980;0;0;0;Horno Microondas Digital MS23K3513AK/ZS 23Lts;ELECTRODOMESTICOS
6220306;;M;72;CHILENO;;Silencioso;PROVIDENCIA                   ;METROPOLITANA;19990;1;1;0;0;0;1;1;19990;Hervidor Electrico TH-4515N 2Lts Negro;ELECTRODOMESTICOS
14633122;;M;37;PERUANO;;Extranjero;QUILLOTA                      ;VALPARAISO;14990;1;1;1;1;14990;0;0;0;Exprimidor de Jugo 407W 1Lts;ELECTRODOMESTICOS
15082863;Soltero;F;39;CHILENO;TECNICO EN ALIMENTOS;X;RENCA                         ;METROPOLITANA;104980;2;1;2;1;104980;0;0;0;Aspiradora Trapeadora Robot Ut-Excellenza (B);ELECTRODOMESTICOS
14430525;;F;48;CHILENO;;X;NATALES                       ;MAGALLANES;68170;2;1;0;0;0;2;1;68170;Horno Microondas Digital TH-20S01 20Lts;ELECTRODOMESTICOS
6630505;Casado;M;71;CHILENO;;Silencioso;RENCA                         ;METROPOLITANA;39990;1;1;0;0;0;1;1;39990;Licuadora TH-501V 1,5Lts Vaso Vidrio;ELECTRODOMESTICOS
7885471;;M;63;CHILENO;;Boomers;CAUQUENES                     ;MAULE;83170;2;1;0;0;0;2;1;83170;Aspiradora TH1870 Arrastre 1800Watts Gris;ELECTRODOMESTICOS
16728254;;F;34;CHILENO;;Millenial;MELIPILLA                     ;METROPOLITANA;27990;1;1;0;0;0;1;1;27990;Picadora UT-PETRUS320 1Lts Vaso Vidrio;ELECTRODOMESTICOS
7263852;Casado;F;65;CHILENO;;Boomers;RENCA                         ;METROPOLITANA;14990;1;1;0;0;0;1;1;14990;Hervidor Family Kettle HE500;ELECTRODOMESTICOS
5756976;;M;69;CHILENO;;Silencioso;CABILDO                       ;VALPARAISO;19990;1;1;0;0;0;1;1;19990;Hervidor Electrico UT-DUNKEL17P 2Lts Negro;ELECTRODOMESTICOS
17447490;Soltero;F;32;CHILENO;PROFESOR;Millenial;PROVIDENCIA                   ;METROPOLITANA;16990;1;1;0;0;0;1;1;16990;Hervidor Electrico HA-3300 2,5Lts Blanco;ELECTRODOMESTICOS
6157834;;F;68;CHILENO;;Silencioso;PROVIDENCIA                   ;METROPOLITANA;137980;2;1;0;0;0;2;1;137980;Horno Electrico TH62I 60Lts;ELECTRODOMESTICOS
19060678;;F;27;CHILENO;;Millenial;"";"";39990;2;1;2;1;39990;0;0;0;Parrilla Electrica TH-224;ELECTRODOMESTICOS
15612813;;M;39;CHILENO;;X;PENCO                         ;BIO BIO;834820;4;2;4;2;834820;0;0;0;Horno Microondas Digital MS23K3513AK/ZS 23Lts;ELECTRODOMESTICOS
10741567;Casado;M;53;CHILENO;;X;RENCA                         ;METROPOLITANA;27990;1;1;0;0;0;1;1;27990;Hervidor Electrico Tetera TH-6505RT 1,7Lts Rojo;ELECTRODOMESTICOS
12213341;;F;49;CHILENO;;X;ARICA                         ;ARICA Y PARINACOTA;77970;3;1;0;0;0;3;1;77970;Horno Microondas Mecanico UT-SYDNEY18 18Lts;ELECTRODOMESTICOS
15868180;;F;37;CHILENO;;Millenial;PROVIDENCIA                   ;METROPOLITANA;85840;2;1;2;1;85840;0;0;0;Horno Microondas Digital Deli (2017 DM) 20Lts;ELECTRODOMESTICOS
13569869;;M;43;CHILENO;;X;SAN FERNANDO                  ;L.G.B.OÂ´HIGGINS;74540;2;1;2;1;74540;0;0;0;Cafetera Dolce Gusto Piccolo XS 0,8 Lts Negra;ELECTRODOMESTICOS
15542280;;M;38;CHILENO;;Millenial;N/D;N/D;44990;1;1;0;0;0;1;1;44990;Horno Electrico TH-25N01 25Lts;ELECTRODOMESTICOS
9026690;;M;62;CHILENO;;Boomers;RENCA                         ;METROPOLITANA;14990;1;1;0;0;0;1;1;14990;HERVIDOR TH-4340;ELECTRODOMESTICOS
14296381;;F;46;CHILENO;;X;LAS CABRAS                    ;L.G.B.OÂ´HIGGINS;102968;3;1;0;0;0;3;1;102968;Horno Microondas Digital TH-20S01 20Lts;ELECTRODOMESTICOS
16575711;;F;34;CHILENO;;Millenial;N/D;N/D;9990;1;1;0;0;0;1;1;9990;Plancha a Vapor Oster 3803;ELECTRODOMESTICOS
17601696;;F;31;CHILENO;;Millenial;PROVIDENCIA                   ;METROPOLITANA;50980;2;1;0;0;0;2;1;50980;Batidora Pedestal Bowl 300 Inox;ELECTRODOMESTICOS
10380707;;M;54;CHILENO;;X;RENCA                         ;METROPOLITANA;29990;1;1;0;0;0;1;1;29990;Licuadora L-5500IN 1,5Lts;ELECTRODOMESTICOS
20123619;;F;23;CHILENO;;Z;PROVIDENCIA                   ;METROPOLITANA;44990;1;1;1;1;44990;0;0;0;Horno Microondas Mecanico Easy Wave 20Lts;ELECTRODOMESTICOS
14306342;;F;47;CHILENO;;X;N/D;N/D;32992;1;2;0;0;0;1;2;32992;Hervidor Electrico Tetera HA-4100 4Lts Iox;ELECTRODOMESTICOS
10938329;;F;54;CHILENO;;X;PROVIDENCIA                   ;METROPOLITANA;39070;2;1;0;0;0;2;1;39070;Licuadora Kaliman Negra con Teclas;ELECTRODOMESTICOS
8107780;;F;63;CHILENO;;Boomers;LEBU                          ;BIO BIO;110970;3;1;0;0;0;3;1;110970;Horno Microondas Mecanico Fancy 20Lts;ELECTRODOMESTICOS
19263518;;F;26;CHILENO;;Z;N/D;N/D;204700;5;3;2;1;104540;3;2;100160;ASPIRADORA ROBOT WIFI FIDDLER HOME BLANCA;ELECTRODOMESTICOS
9280922;;M;59;CHILENO;;Boomers;PROVIDENCIA                   ;METROPOLITANA;24990;1;1;0;0;0;1;1;24990;Licuadora L2000VNG 1,5Lts Vaso Vidrio;ELECTRODOMESTICOS
9521826;Casado;F;61;CHILENO;;Boomers;RENCA                         ;METROPOLITANA;27990;1;1;0;0;0;1;1;27990;Plancha THOMAS TH-7170 2200Watts Base Ceramica;ELECTRODOMESTICOS
6369750;;M;69;CHILENO;;Silencioso;N/D;N/D;83980;2;1;2;1;83980;0;0;0;FREIDORA DE AIRE THOMAS TH-AF60Mi;ELECTRODOMESTICOS
10207178;;M;54;CHILENO;;Boomers;LA SERENA                     ;COQUIMBO;30970;3;2;0;0;0;3;2;30970;Batidora Vertical Minipimer UT-KLOT400P;ELECTRODOMESTICOS
17765715;;M;30;CHILENO;;Millenial;EL BOSQUE                     ;METROPOLITANA;109990;1;1;0;0;0;1;1;109990;Horno Electrico UT-BACKOFEN60 60Lts;ELECTRODOMESTICOS
11824611;;F;51;CHILENO;;X;QUILLOTA                      ;VALPARAISO;59990;2;1;0;0;0;2;1;59990;Horno Microondas Mecanico Easy Wave 20Lts;ELECTRODOMESTICOS
5351534;;F;75;CHILENO;;Silencioso;RENCA                         ;METROPOLITANA;44990;1;1;0;0;0;1;1;44990;Horno Electrico TH-25N01 25Lts;ELECTRODOMESTICOS
5999242;Casado;F;75;CHILENO;;Silencioso;RENCA                         ;METROPOLITANA;51980;2;1;0;0;0;2;1;51980;Licuadora TH-401V Roja 1,75Lts Vaso Vidrio;ELECTRODOMESTICOS
25658445;;M;30;VENEZOLANO;;Extranjero;SANTIAGO                      ;METROPOLITANA;35240;2;1;0;0;0;2;1;35240;Licuadora UT-METALLEK605P 1,55Lts;ELECTRODOMESTICOS
9708454;;F;59;CHILENO;;Boomers;LA PINTANA                    ;METROPOLITANA;486050;4;2;0;0;0;4;2;486050;Hervidor Electrico Tetera HA-4100 4Lts Iox;ELECTRODOMESTICOS
18198700;Soltero;F;29;CHILENO;;Millenial;PROVIDENCIA                   ;METROPOLITANA;19990;1;1;0;0;0;1;1;19990;Licuadora Berry Blender Roja 1400 Vaso Vidrio;ELECTRODOMESTICOS
7716908;;F;71;CHILENO;;Silencioso;SANTA MARIA                   ;VALPARAISO;16990;1;1;0;0;0;1;1;16990;Hervidor Electrico HA-3300 2,5Lts Blanco;ELECTRODOMESTICOS
25239789;;F;52;COLOMBIANO;;Extranjero;SANTIAGO                      ;METROPOLITANA;88170;2;1;0;0;0;2;1;88170;Olla Multiuso 6801 5,7Lts;ELECTRODOMESTICOS
17384632;;M;32;CHILENO;;Millenial;LA PINTANA;METROPOLITANA;53980;2;1;2;1;53980;0;0;0;Cafetera P65 Silver;ELECTRODOMESTICOS
18613025;;M;28;CHILENO;;Millenial;PROVIDENCIA                   ;METROPOLITANA;63980;2;1;2;1;63980;0;0;0;Horno Electrico TH-38N 38Lts;ELECTRODOMESTICOS
7717992;Casado;F;66;CHILENO;;Boomers;NANCAGUA                      ;L.G.B.OÂ´HIGGINS;49990;1;1;0;0;0;1;1;49990;ASPIRADORA THOMAS TH-1640;ELECTRODOMESTICOS
12674960;;F;49;CHILENO;;X;PROVIDENCIA                   ;METROPOLITANA;34990;1;1;1;1;34990;0;0;0;Combo Hervidor + Tostador + Sandwichera;ELECTRODOMESTICOS
7702692;;F;67;CHILENO;;Boomers;RENCA                         ;METROPOLITANA;39990;1;1;0;0;0;1;1;39990;Licuadora TH-501V 1,5Lts Vaso Vidrio;ELECTRODOMESTICOS
19017951;;M;27;CHILENO;;Z;PROVIDENCIA                   ;METROPOLITANA;64990;1;1;1;1;64990;0;0;0;Horno electrico Black Oven 42lts;ELECTRODOMESTICOS
15920146;;F;37;CHILENO;;Millenial;LINARES                       ;MAULE;86970;4;1;0;0;0;4;1;86970;Plancha UT-SHANGRILA Inalambrica 2200Watss;ELECTRODOMESTICOS
13937450;;F;42;CHILENO;;X;MAIPU                         ;METROPOLITANA;93980;2;1;2;1;93980;0;0;0;Horno Electrico TH-80i 80Lts;ELECTRODOMESTICOS
15878347;;M;37;CHILENO;;Millenial;PROVIDENCIA                   ;METROPOLITANA;14990;1;1;0;0;0;1;1;14990;Exprimidor de Jugo 407W 1Lts;ELECTRODOMESTICOS
9236149;;F;61;CHILENO;;Boomers;CHOLCHOL;ARAUCANIA;44980;2;1;0;0;0;2;1;44980;Licuadora TH-320 Roja/Negro 1,5 Lts Vaso Vidrio;ELECTRODOMESTICOS
16423804;;F;35;CHILENO;;Millenial;PROVIDENCIA                   ;METROPOLITANA;43980;2;1;2;1;43980;0;0;0;Horno Microonda Columba 1700;ELECTRODOMESTICOS
12122022;;F;40;CHILENO;;X;PROVIDENCIA                   ;METROPOLITANA;35840;2;1;2;1;35840;0;0;0;Aspiradora Polvo AP-700 GR;ELECTRODOMESTICOS
7561414;;F;67;CHILENO;;Boomers;BUIN                          ;METROPOLITANA;69990;1;1;0;0;0;1;1;69990;Horno Microondas Mecanico M-2030 NG 20Lts;ELECTRODOMESTICOS
13278851;;M;44;CHILENO;;X;MAIPU                         ;METROPOLITANA;11893;1;1;0;0;0;1;1;11893;Batidora Manual 3532;ELECTRODOMESTICOS
7130118;;M;70;CHILENO;;Silencioso;PROVIDENCIA                   ;METROPOLITANA;9990;1;1;0;0;0;1;1;9990;Plancha a Vapor Oster 3803;ELECTRODOMESTICOS
13728800;Casado;F;43;CHILENO;CONTADOR AUDITOR;X;CERRILLOS                     ;METROPOLITANA;69990;1;1;1;1;69990;0;0;0;Batidora Pedestal TH910PN 4,6Lts 1300Watts;ELECTRODOMESTICOS
9981330;Casado;F;56;CHILENO;;Boomers;RENCA                         ;METROPOLITANA;29990;1;1;0;0;0;1;1;29990;Batidora Vertical Minipimer UT-KLOT400P;ELECTRODOMESTICOS
8278016;;M;65;CHILENO;;Silencioso;OLIVAR                        ;L.G.B.OÂ´HIGGINS;99980;2;1;0;0;0;2;1;99980;Aspiradora TH1870 Arrastre 1800Watts Gris;ELECTRODOMESTICOS
20102772;;F;23;CHILENO;;Z;N/D;N/D;73170;2;1;0;0;0;2;1;73170;Horno Electrico TH-38N 38Lts;ELECTRODOMESTICOS
18315067;;F;30;CHILENO;;Millenial;PROVIDENCIA                   ;METROPOLITANA;109990;1;1;0;0;0;1;1;109990;Horno Microondas Digital L UT-25KROMM 25Lts;ELECTRODOMESTICOS
15947332;Soltero;F;38;CHILENO;;Millenial;PROVIDENCIA                   ;METROPOLITANA;34990;1;1;0;0;0;1;1;34990;Licuadora Osterizer 4112/72 1,25Lts Vaso Vidrio;ELECTRODOMESTICOS
13389069;;M;43;CHILENO;;X;CORONEL                       ;BIO BIO;79990;1;1;0;0;0;1;1;79990;Horno Electrico TH-48N 48Lts;ELECTRODOMESTICOS
6997963;;F;68;CHILENO;;Boomers;TEMUCO                        ;ARAUCANIA;43990;1;1;0;0;0;1;1;43990;LICUADORA CROMADA CON TECLAS PLUS;ELECTRODOMESTICOS
9399770;;M;59;CHILENO;;Boomers;RENGO                         ;L.G.B.OÂ´HIGGINS;59990;2;1;0;0;0;2;1;59990;Horno Microondas Mecanico Easy Wave 20Lts;ELECTRODOMESTICOS
17076756;;F;33;CHILENO;;Millenial;VICTORIA                      ;ARAUCANIA;319970;3;2;0;0;0;3;2;319970;Horno Electrico UT-BACKOFEN60 60Lts;ELECTRODOMESTICOS
16761403;;M;34;CHILENO;;Silencioso;PROVIDENCIA                   ;METROPOLITANA;74990;1;1;0;0;0;1;1;74990;Horno Microondas Digital TH-20S01 20Lts;ELECTRODOMESTICOS
13134185;;F;45;CHILENO;;X;N/D;N/D;29990;1;1;0;0;0;1;1;29990;Hervidor Electrico Tetera HA-4100 4Lts Iox;ELECTRODOMESTICOS
10491634;;F;57;CHILENO;;Boomers;PROVIDENCIA                   ;METROPOLITANA;28990;1;1;0;0;0;1;1;28990;Tostador de Pan TP-1400 4 Rebanadas Inox;ELECTRODOMESTICOS
15957309;;F;37;CHILENO;;Silencioso;PROVIDENCIA                   ;METROPOLITANA;492470;3;1;3;1;492470;0;0;0;ASPIRADORA IROBOT ROOMBA 960;ELECTRODOMESTICOS
17344823;;M;32;CHILENO;;Millenial;TALCAHUANO                    ;BIO BIO;24990;1;1;0;0;0;1;1;24990;Licuadora L2000VNG 1,5Lts Vaso Vidrio;ELECTRODOMESTICOS
4280576;;F;72;CHILENO;;Silencioso;TOME                          ;BIO BIO;132260;3;1;0;0;0;3;1;132260;Horno Electrico TH62I 60Lts;ELECTRODOMESTICOS
16859764;;F;34;CHILENO;;Millenial;PROVIDENCIA                   ;METROPOLITANA;44980;2;2;0;0;0;2;2;44980;Batidora Manual UT-TEKLA300;ELECTRODOMESTICOS
11168688;;F;54;CHILENO;;Boomers;N/D;N/D;13990;1;1;0;0;0;1;1;13990;Exprimidor de Jugo CJ-2000 1Lts;ELECTRODOMESTICOS
9519608;;F;59;CHILENO;;Boomers;CURARREHUE                    ;ARAUCANIA;209980;2;1;0;0;0;2;1;209980;Horno Electrico TH-100i 100Lts;ELECTRODOMESTICOS
14273474;;M;47;CHILENO;;X;TALCAHUANO                    ;BIO BIO;56980;2;1;0;0;0;2;1;56980;Hervidor Electrico Tetera TH-6505RT 1,7Lts Rojo;ELECTRODOMESTICOS
6726210;;F;70;CHILENO;;Silencioso;PROVIDENCIA                   ;METROPOLITANA;11990;1;1;0;0;0;1;1;11990;Exprimidor de Jugo CJ-2000 1Lts;ELECTRODOMESTICOS
16816509;;F;35;CHILENO;;Millenial;RENCA                         ;METROPOLITANA;14990;1;1;0;0;0;1;1;14990;Batidora Manual 3532;ELECTRODOMESTICOS
7616083;Casado;F;66;CHILENO;AUXILIAR DE ENFERMERIA;Boomers;RENCA                         ;METROPOLITANA;104990;1;1;0;0;0;1;1;104990;Horno Microondas Digital ME0113MB1/XZS 32Lts;ELECTRODOMESTICOS
14308258;;F;46;CHILENO;;X;PLACILLA                      ;L.G.B.OÂ´HIGGINS;67980;2;2;0;0;0;2;2;67980;Licuadora UT-METALLEK805R 1,75Lts Vaso Vidrio;ELECTRODOMESTICOS
11514924;;F;51;CHILENO;;X;PROVIDENCIA                   ;METROPOLITANA;224270;2;1;0;0;0;2;1;224270;Maquina de Coser BM-3850CL Lila;ELECTRODOMESTICOS
7660015;;F;72;CHILENO;;Silencioso;OVALLE                        ;COQUIMBO;84980;2;2;0;0;0;2;2;84980;Aspiradora UT-ZYKLON1402 Arrastre 1400Watts;ELECTRODOMESTICOS
18484385;;F;29;CHILENO;;Millenial;LA SERENA                     ;COQUIMBO;13990;1;1;0;0;0;1;1;13990;Batidora Vertical Stick Mixer 2609;ELECTRODOMESTICOS
16038023;;F;36;CHILENO;;Millenial;PROVIDENCIA                   ;METROPOLITANA;27990;1;1;0;0;0;1;1;27990;Tostador de Pan TH-126 4 Rebanadas Negro;ELECTRODOMESTICOS
19137389;;M;26;CHILENO;;Silencioso;PROVIDENCIA                   ;METROPOLITANA;96980;2;1;2;1;96980;0;0;0;Horno Microondas Digital MS28F303TAS/ZS 28Lts;ELECTRODOMESTICOS
15131597;;F;40;CHILENO;;X;PROVIDENCIA                   ;METROPOLITANA;169990;1;1;0;0;0;1;1;169990;Horno Electrico TH-100i 100Lts;ELECTRODOMESTICOS
10420611;;F;53;CHILENO;;X;QUELLON                       ;LOS LAGOS;41990;1;1;0;0;0;1;1;41990;Picadora TH-9020V Vaso Vidrio 2Lts;ELECTRODOMESTICOS
18964893;;F;27;CHILENO;;Millenial;CANETE                        ;BIO BIO;54990;1;1;0;0;0;1;1;54990;PROCESADOR THOMAS TH-9160;ELECTRODOMESTICOS
4887520;;F;78;CHILENO;;Silencioso;NOGALES                       ;VALPARAISO;24990;1;1;0;0;0;1;1;24990;Licuadora TH-320 Roja/Negro 1,5 Lts Vaso Vidrio;ELECTRODOMESTICOS
14727467;;F;53;PERUANO;;Extranjero;LA CISTERNA                   ;METROPOLITANA;13990;1;1;0;0;0;1;1;13990;Exprimidor de Jugo CJ-2000 1Lts;ELECTRODOMESTICOS
17968713;;M;31;CHILENO;;Millenial;N/D;N/D;41990;1;1;0;0;0;1;1;41990;HERVIDOR TETERA RELOJ 900R 2,5L ROJO;ELECTRODOMESTICOS
14547637;;F;58;CHILENO;;Boomers;TEMUCO                        ;ARAUCANIA;17990;1;1;0;0;0;1;1;17990;Hervidor Electrico TH-4515N 2Lts Negro;ELECTRODOMESTICOS
11320594;;M;53;CHILENO;;X;PROVIDENCIA                   ;METROPOLITANA;-109990;-1;1;-1;1;-109990;0;0;0;Horno Electrico UT-BACKOFEN60 60Lts;ELECTRODOMESTICOS
18474921;;M;29;CHILENO;;Millenial;PROVIDENCIA                   ;METROPOLITANA;24990;1;1;0;0;0;1;1;24990;Plancha UT-KERAMIK1 2200Watts Base Ceramica;ELECTRODOMESTICOS
11562981;;F;52;CHILENO;;X;SAN JAVIER                    ;MAULE;18990;1;1;0;0;0;1;1;18990;Hervidor Electrico TH-4515N 2Lts Negro;ELECTRODOMESTICOS
5719848;;F;72;CHILENO;;Silencioso;PENAFLOR                      ;METROPOLITANA;219439;4;1;0;0;0;4;1;219439;Horno Microondas Digital L UT-25KROMM 25Lts;ELECTRODOMESTICOS
18821282;;F;27;CHILENO;;Millenial;CORONEL                       ;BIO BIO;41990;1;1;0;0;0;1;1;41990;Picadora TH-9020V Vaso Vidrio 2Lts;ELECTRODOMESTICOS
6226075;;M;70;CHILENO;;Silencioso;PROVIDENCIA                   ;METROPOLITANA;25990;1;1;0;0;0;1;1;25990;Tostador de Pan TP-1400 4 Rebanadas Inox;ELECTRODOMESTICOS
18950977;;M;27;CHILENO;;Millenial;PROVIDENCIA                   ;METROPOLITANA;15990;1;1;0;0;0;1;1;15990;Tostador de Pan TH-116 2 Rebanadas Negro;ELECTRODOMESTICOS
20902870;;F;39;CHILENO;;X;ARICA                         ;ARICA Y PARINACOTA;89990;1;1;0;0;0;1;1;89990;Olla Multiuso 6801 5,7Lts;ELECTRODOMESTICOS
17831305;Soltero;F;31;CHILENO;PROFESOR;Millenial;PROVIDENCIA                   ;METROPOLITANA;32990;1;1;0;0;0;1;1;32990;Licuadora L1000 Inox 1,7LtsVaso Vidrio;ELECTRODOMESTICOS
19788757;;F;24;CHILENO;;Z;PROVIDENCIA                   ;METROPOLITANA;4000;0;2;0;0;0;0;2;4000;Licuadora TH-320 Roja/Negro 1,5 Lts Vaso Vidrio;ELECTRODOMESTICOS
19379576;;F;25;CHILENO;;Z;DONIHUE                       ;L.G.B.OÂ´HIGGINS;12990;1;1;0;0;0;1;1;12990;Sandwichera TH-952 2 Panes Blanca;ELECTRODOMESTICOS
15212864;;F;39;CHILENO;;Silencioso;PROVIDENCIA                   ;METROPOLITANA;24990;1;1;0;0;0;1;1;24990;Licuadora L2000VNG 1,5Lts Vaso Vidrio;ELECTRODOMESTICOS
9780371;;F;54;CHILENO;;Boomers;PROVIDENCIA                   ;METROPOLITANA;13990;1;1;0;0;0;1;1;13990;Exprimidor de Jugo CJ-2000 1Lts;ELECTRODOMESTICOS
16504597;;F;35;CHILENO;;Millenial;PUENTE ALTO                   ;METROPOLITANA;93980;2;1;2;1;93980;0;0;0;FREIDORA DE AIRE THOMAS TH-AF60Mi;ELECTRODOMESTICOS
9148571;;M;60;CHILENO;;Boomers;CALAMA                        ;ANTOFAGASTA;174980;2;2;0;0;0;2;2;174980;Horno Electrico TH-100i 100Lts;ELECTRODOMESTICOS
9733124;;F;57;CHILENO;;Boomers;PROVIDENCIA                   ;METROPOLITANA;29990;1;1;0;0;0;1;1;29990;Licuadora Kaliman Negra con Teclas;ELECTRODOMESTICOS
10011636;Casado;F;59;CHILENO;;Boomers;RENCA                         ;METROPOLITANA;9990;1;1;1;1;9990;0;0;0;Exprimidor Fauna 500 cc;ELECTRODOMESTICOS
10226708;;F;57;CHILENO;;Boomers;LA SERENA                     ;COQUIMBO;19990;1;1;0;0;0;1;1;19990;Batidora Manual UT-TEKLA300;ELECTRODOMESTICOS
8384367;;F;66;CHILENO;;Silencioso;PROVIDENCIA                   ;METROPOLITANA;79990;1;1;0;0;0;1;1;79990;Horno Electrico TH-38N 38Lts;ELECTRODOMESTICOS
8959090;;F;61;CHILENO;;Silencioso;PROVIDENCIA                   ;METROPOLITANA;31840;2;1;2;1;31840;0;0;0;Tostador de Pan TP-1400 4 Rebanadas Inox;ELECTRODOMESTICOS
16139299;Casado;F;36;CHILENO;;Millenial;RENCA                         ;METROPOLITANA;-26990;-1;1;-1;1;-26990;0;0;0;PICADORA 123 SILHQUETTE;ELECTRODOMESTICOS
9743130;;F;59;CHILENO;;Boomers;PROVIDENCIA                   ;METROPOLITANA;29990;1;1;0;0;0;1;1;29990;Hervidor Electrico Tetera HA-4100 4Lts Iox;ELECTRODOMESTICOS
10615845;;F;55;CHILENO;;Boomers;PROVIDENCIA                   ;METROPOLITANA;73170;2;1;0;0;0;2;1;73170;Horno Microondas Mecanico Fancy 20Lts;ELECTRODOMESTICOS
9246431;Casado;F;62;CHILENO;CONTADOR GENERAL;Boomers;RENCA                         ;METROPOLITANA;99990;1;1;0;0;0;1;1;99990;Batidora Pedestal TH910PN 4,6Lts 1300Watts;ELECTRODOMESTICOS
12323573;;F;49;CHILENO;;X;RENCA                         ;METROPOLITANA;49990;1;1;0;0;0;1;1;49990;Aspiradora UT-ZYKLON1402 Arrastre 1400Watts;ELECTRODOMESTICOS
14591973;;M;42;CHILENO;;X;N/D;N/D;72980;2;1;0;0;0;2;1;72980;Aspiradora TH1415 Arrastre 1500Watts;ELECTRODOMESTICOS
26482579;;F;28;EXTRANJERO - NO INFORMA NACIONALIDAD;;Extranjero;N/D;N/D;59990;1;1;0;0;0;1;1;59990;ASPIRADORA ROBOT WIFI FIDDLER HOME BLANCA;ELECTRODOMESTICOS
27042249;;F;25;CHILENO;;Extranjero;N/D;N/D;59990;1;1;0;0;0;1;1;59990;Freidora de Aire 18M Oster;ELECTRODOMESTICOS
9999735;;F;55;CHILENO;;Boomers;ARICA                         ;ARICA Y PARINACOTA;25990;1;1;0;0;0;1;1;25990;Combo Licuadora + Batidora;ELECTRODOMESTICOS
11675074;;M;52;CHILENO;;X;TALCA                         ;MAULE;161270;2;1;0;0;0;2;1;161270;Maquina de Coser Remington J011;ELECTRODOMESTICOS
12815868;;F;47;CHILENO;;X;SALAMANCA                     ;COQUIMBO;86980;2;1;0;0;0;2;1;86980;Aspiradora VCC4190V3E/XZS Arrastre 2000Watts;ELECTRODOMESTICOS
8212318;;F;65;CHILENO;;Boomers;RENCA                         ;METROPOLITANA;11990;1;1;0;0;0;1;1;11990;Exprimidor de Jugo CJ-2000 1Lts;ELECTRODOMESTICOS
17384692;;F;32;CHILENO;;Millenial;PROVIDENCIA                   ;METROPOLITANA;19990;1;1;0;0;0;1;1;19990;Hervidor Electrico UT-DUNKEL17P 2Lts Negro;ELECTRODOMESTICOS
14525382;;F;46;CHILENO;;X;RENCA                         ;METROPOLITANA;89990;1;1;0;0;0;1;1;89990;Batidora Pedestal UT-KLEIN700;ELECTRODOMESTICOS
12941409;Soltero;F;47;CHILENO;;X;LA SERENA                     ;COQUIMBO;29990;1;1;0;0;0;1;1;29990;Licuadora Personal TH-300PB;ELECTRODOMESTICOS
19692389;;F;24;CHILENO;;Z;PROVIDENCIA                   ;METROPOLITANA;69640;2;1;2;1;69640;0;0;0;Enceradora y Pulidora Inalambrica 360Â° B-fresh;ELECTRODOMESTICOS
9053263;;M;61;CHILENO;;Boomers;"";"";79990;1;1;0;0;0;1;1;79990;Batidora Pedestal UT-KLEIN700;ELECTRODOMESTICOS
6431434;Casado;F;74;CHILENO;;Silencioso;RENCA                         ;METROPOLITANA;217370;2;1;0;0;0;2;1;217370;Horno Electrico TH-100i 100Lts;ELECTRODOMESTICOS
6454367;;F;71;CHILENO;;Silencioso;PROVIDENCIA                   ;METROPOLITANA;0;0;0;0;0;0;0;0;0;Licuadora L-1630V Negra 1,5Lts Vaso Vidrio;ELECTRODOMESTICOS
14388116;;F;44;CHILENO;;X;PARRAL                        ;MAULE;0;0;0;0;0;0;0;0;0;Exprimidor Fauna 500 cc;ELECTRODOMESTICOS
8537894;;F;65;CHILENO;;Boomers;HUECHURABA                    ;METROPOLITANA;0;0;0;0;0;0;0;0;0;Batidora Pedestal UT-KLEIN700;ELECTRODOMESTICOS
4764991;;F;79;CHILENO;;Silencioso;RENCA                         ;METROPOLITANA;0;0;0;0;0;0;0;0;0;Hervidor Electrico HA-3300 2,5Lts Blanco;ELECTRODOMESTICOS
16901972;;M;34;CHILENO;;Silencioso;PROVIDENCIA                   ;METROPOLITANA;0;0;0;0;0;0;0;0;0;Exprimidor Fauna 500 cc;ELECTRODOMESTICOS
9249015;Soltero;M;61;CHILENO;AGRONOMO;Boomers;PROVIDENCIA                   ;METROPOLITANA;0;0;0;0;0;0;0;0;0;Licuadora TH-320 Roja/Negro 1,5 Lts Vaso Vidrio;ELECTRODOMESTICOS
15140112;Soltero;M;39;CHILENO;INGENIERO CIVIL EN OBRAS CIVILES;X;RENCA                         ;METROPOLITANA;0;0;0;0;0;0;0;0;0;CAFETERA PRIMA LATTE 6603 NEGRA;ELECTRODOMESTICOS
8103555;;M;65;CHILENO;;Boomers;SAN JAVIER                    ;MAULE;0;0;0;0;0;0;0;0;0;Aspiradora UT-KRAFT(DIG) Arrastre 2200Watts;ELECTRODOMESTICOS
8241344;;M;65;CHILENO;;Boomers;RENCA                         ;METROPOLITANA;0;0;0;0;0;0;0;0;0;Plancha Vertical TH-7300 1200Watts;ELECTRODOMESTICOS
14230142;;F;54;CHILENO;;X;LO PRADO                      ;METROPOLITANA;0;0;0;0;0;0;0;0;0;Aspiradora TH1407 Arrastre 1400Watts;ELECTRODOMESTICOS
16497147;;F;35;CHILENO;;Millenial;"";"";0;0;0;0;0;0;0;0;0;Hervidor Electrico 3101 1,7Lts Negro;ELECTRODOMESTICOS
7660016;;F;68;CHILENO;;Silencioso;EL BOSQUE                     ;METROPOLITANA;0;0;0;0;0;0;0;0;0;Aspiradora TH1407 Arrastre 1400Watts;ELECTRODOMESTICOS
7054428;;F;71;CHILENO;;Silencioso;MAIPU                         ;METROPOLITANA;0;0;0;0;0;0;0;0;0;ASPIRADORA THOMAS TH-1640;ELECTRODOMESTICOS
13375184;;F;46;CHILENO;;X;PARRAL                        ;MAULE;0;0;0;0;0;0;0;0;0;Horno Microondas Mecanico Easy Wave 20Lts;ELECTRODOMESTICOS
15359943;;M;38;CHILENO;;X;N/D;N/D;0;0;0;0;0;0;0;0;0;Horno Electrico HE-300NG 30Lts;ELECTRODOMESTICOS
16109898;;M;37;CHILENO;;Millenial;COMBARBALA                    ;COQUIMBO;0;0;0;0;0;0;0;0;0;Combo Juguera + Hervidor;ELECTRODOMESTICOS
19776198;;F;23;CHILENO;;Z;N/D;N/D;0;0;0;0;0;0;0;0;0;Batidora Pedestal B5300 Inox;ELECTRODOMESTICOS
11972005;;F;50;CHILENO;;X;COPIAPO                       ;ATACAMA;0;0;0;0;0;0;0;0;0;HERVIDOR ELECTRICO UT-STARK18;ELECTRODOMESTICOS
11962410;;F;50;CHILENO;;X;LOS ANGELES                   ;BIO BIO;0;0;0;0;0;0;0;0;0;Hervidor Electrico HA-3300 2,5Lts Blanco;ELECTRODOMESTICOS
10029073;;M;45;CHILENO;;Silencioso;PROVIDENCIA                   ;METROPOLITANA;0;0;0;0;0;0;0;0;0;Aspiradora AP1700 Arrastre 1700Watts;ELECTRODOMESTICOS
19988296;;F;23;CHILENO;;Z;PROVIDENCIA                   ;METROPOLITANA;0;0;0;0;0;0;0;0;0;Maquina de Coser 311;ELECTRODOMESTICOS
19777763;;M;24;CHILENO;;Z;PEDRO AGUIRRE CERDA           ;METROPOLITANA;0;0;0;0;0;0;0;0;0;Hervidor Electrico TH-4515N 2Lts Negro;ELECTRODOMESTICOS
13840024;;F;41;CHILENO;;X;LA CISTERNA                   ;METROPOLITANA;0;0;0;0;0;0;0;0;0;Plancha OSTER 4801T 1200Watts Base Ceramica;ELECTRODOMESTICOS
10256657;;F;55;CHILENO;;Boomers;PROVIDENCIA                   ;METROPOLITANA;0;0;0;0;0;0;0;0;0;BATIDORA MANUAL 260R;ELECTRODOMESTICOS
5902206;;F;75;CHILENO;;Silencioso;PUTAENDO                      ;VALPARAISO;0;0;0;0;0;0;0;0;0;Batidora Pedestal TH910PN 4,6Lts 1300Watts;ELECTRODOMESTICOS
7133784;;F;74;CHILENO;;Silencioso;QUILLOTA                      ;VALPARAISO;0;0;0;0;0;0;0;0;0;Exprimidor Fauna 500 cc;ELECTRODOMESTICOS
12422111;;M;49;CHILENO;;Silencioso;PROVIDENCIA                   ;METROPOLITANA;0;0;0;0;0;0;0;0;0;Licuadora L2000VNG 1,5Lts Vaso Vidrio;ELECTRODOMESTICOS
16981730;;M;34;CHILENO;;Millenial;LOS ANGELES                   ;BIO BIO;0;0;0;0;0;0;0;0;0;Horno Electrico TH-100i 100Lts;ELECTRODOMESTICOS
5724015;;F;74;CHILENO;;Silencioso;COIHAIQUE                     ;AYSEN;0;0;0;0;0;0;0;0;0;Horno Microondas Mecanico Easy Wave 20Lts;ELECTRODOMESTICOS
14000023;;F;41;CHILENO;;X;VALPARAISO                    ;VALPARAISO;0;0;0;0;0;0;0;0;0;Aspiradora Tambor APA1000 1000Watts;ELECTRODOMESTICOS
18213977;;M;29;CHILENO;;Millenial;MELIPILLA                     ;METROPOLITANA;0;0;0;0;0;0;0;0;0;Hervidor Electrico UT-MANLY17 1,7Lts Negro;ELECTRODOMESTICOS
6926356;;M;67;CHILENO;;Boomers;PROVIDENCIA                   ;METROPOLITANA;0;0;0;0;0;0;0;0;0;Hervidor Electrico HA-2650NG;ELECTRODOMESTICOS
18942505;;F;27;CHILENO;;Silencioso;PROVIDENCIA                   ;METROPOLITANA;0;0;0;0;0;0;0;0;0;Hervidor Electrico UT-MANLY17 1,7Lts Negro;ELECTRODOMESTICOS
6254567;;F;75;CHILENO;;Silencioso;VINA DEL MAR                  ;VALPARAISO;0;0;0;0;0;0;0;0;0;Aspiradora TH1407 Arrastre 1400Watts;ELECTRODOMESTICOS
20227545;;F;22;CHILENO;;Z;N/D;N/D;0;0;0;0;0;0;0;0;0;Licuadora TH-401V Roja 1,75Lts Vaso Vidrio;ELECTRODOMESTICOS
12010081;Casado;M;50;CHILENO;;X;PROVIDENCIA                   ;METROPOLITANA;0;0;0;0;0;0;0;0;0;Plancha a Vapor 8202 Verde;ELECTRODOMESTICOS
19873322;;F;24;CHILENO;;Z;DIEGO DE ALMAGRO;ATACAMA;0;0;0;0;0;0;0;0;0;BATIDORA INMERSION S MIX 2616;ELECTRODOMESTICOS
16621057;;F;35;CHILENO;;Millenial;SAN FERNANDO                  ;L.G.B.OÂ´HIGGINS;0;0;0;0;0;0;0;0;0;Horno Microondas Digital L UT-25KROMM 25Lts;ELECTRODOMESTICOS
17364408;;F;32;CHILENO;;Millenial;IQUIQUE                       ;TARAPACA;0;0;0;0;0;0;0;0;0;LICUADORA CROMADA CON TECLAS PLUS;ELECTRODOMESTICOS
13656137;;F;44;CHILENO;;X;LA PINTANA                    ;METROPOLITANA;0;0;0;0;0;0;0;0;0;Horno Microondas Digital TH-25DM 25Lts;ELECTRODOMESTICOS
11603830;;M;52;CHILENO;;Silencioso;PROVIDENCIA                   ;METROPOLITANA;0;0;0;0;0;0;0;0;0;Aspiradora TH1415 Arrastre 1500Watts;ELECTRODOMESTICOS
18952790;;M;26;CHILENO;;Silencioso;PROVIDENCIA                   ;METROPOLITANA;0;0;0;0;0;0;0;0;0;Plancha THOMAS TH-7170 2200Watts Base Ceramica;ELECTRODOMESTICOS
16144824;;F;37;CHILENO;;Millenial;RENCA                         ;METROPOLITANA;0;0;0;0;0;0;0;0;0;Aspiradora Tambor APA1000 1000Watts;ELECTRODOMESTICOS
13201181;;F;45;CHILENO;;Extranjero;CHIMBARONGO                   ;L.G.B.OÂ´HIGGINS;0;0;0;0;0;0;0;0;0;Combo Licuadora + Batidora;ELECTRODOMESTICOS
12053250;;M;54;CHILENO;;Boomers;RENCA                         ;METROPOLITANA;0;0;0;0;0;0;0;0;0;Aspiradora TH1870 Arrastre 1800Watts Gris;ELECTRODOMESTICOS
7965235;;M;65;CHILENO;;Boomers;PROVIDENCIA                   ;METROPOLITANA;0;0;0;0;0;0;0;0;0;Aspiradora TH1415 Arrastre 1500Watts;ELECTRODOMESTICOS
13063686;;F;50;CHILENO;;X;N/D;N/D;0;0;0;0;0;0;0;0;0;Horno Microondas Digital TH-25DM 25Lts;ELECTRODOMESTICOS
14201062;Soltero;F;41;CHILENO;;X;PROVIDENCIA                   ;METROPOLITANA;0;0;0;0;0;0;0;0;0;Hervidor Electrico HA-3300 2,5Lts Blanco;ELECTRODOMESTICOS
7582015;;F;66;CHILENO;;Boomers;MOLINA                        ;MAULE;0;0;0;0;0;0;0;0;0;Aspiradora UT-SILENT1804 Arrastre 1800Watts;ELECTRODOMESTICOS
19551509;;F;24;CHILENO;;Z;PROVIDENCIA                   ;METROPOLITANA;0;0;0;0;0;0;0;0;0;Horno Electrico TH-38N 38Lts;ELECTRODOMESTICOS
8549794;;M;62;CHILENO;;Boomers;PROVIDENCIA                   ;METROPOLITANA;0;0;0;0;0;0;0;0;0;PICADORA 123 SILHQUETTE;ELECTRODOMESTICOS
16006584;;M;37;CHILENO;;Millenial;QUILPUE                       ;VALPARAISO;0;0;0;0;0;0;0;0;0;Batidora Vertical Stick Mixer 2609;ELECTRODOMESTICOS
26566857;;M;30;VENEZOLANO;;Extranjero;N/D;N/D;0;0;0;0;0;0;0;0;0;LICUADORA CROMADA CON TECLAS PLUS;ELECTRODOMESTICOS
6522514;;F;70;CHILENO;;Silencioso;CURICO                        ;MAULE;0;0;0;0;0;0;0;0;0;Horno Electrico UT-LEIF36 36Lts;ELECTRODOMESTICOS
15041989;;F;39;CHILENO;;X;LA SERENA                     ;COQUIMBO;0;0;0;0;0;0;0;0;0;Exprimidor de Jugo 407W 1Lts;ELECTRODOMESTICOS
11760283;;M;50;CHILENO;;X;PICHILEMU                     ;L.G.B.OÂ´HIGGINS;0;0;0;0;0;0;0;0;0;Combo Juguera + Hervidor;ELECTRODOMESTICOS
18965719;;F;27;CHILENO;;Millenial;TALCA                         ;MAULE;0;0;0;0;0;0;0;0;0;Hervidor Electrico UT-MANLY17 1,7Lts Negro;ELECTRODOMESTICOS
11842170;;F;50;CHILENO;;X;PICHIDEGUA                    ;L.G.B.OÂ´HIGGINS;0;0;0;0;0;0;0;0;0;FREIDORA DE AIRE CKSTAF15B 1850W;ELECTRODOMESTICOS
18967203;;F;27;CHILENO;;Z;MOLINA                        ;MAULE;0;0;0;0;0;0;0;0;0;Hervidor Electrico UT-MANLY17 1,7Lts Negro;ELECTRODOMESTICOS
5671211;;F;74;CHILENO;;Silencioso;PROVIDENCIA                   ;METROPOLITANA;0;0;0;0;0;0;0;0;0;PICADORA 123 SILHQUETTE;ELECTRODOMESTICOS
11569457;;F;52;CHILENO;;X;PROVIDENCIA                   ;METROPOLITANA;0;0;0;0;0;0;0;0;0;Aspiradora AP1700 Arrastre 1700Watts;ELECTRODOMESTICOS
22599389;;F;53;PERUANO;;Extranjero;CALAMA                        ;ANTOFAGASTA;0;0;0;0;0;0;0;0;0;Licuadora TH-501V 1,5Lts Vaso Vidrio;ELECTRODOMESTICOS
15426931;;F;39;CHILENO;;X;MAIPU                         ;METROPOLITANA;0;0;0;0;0;0;0;0;0;Aspiradora AP1700 Arrastre 1700Watts;ELECTRODOMESTICOS
9244125;;F;58;CHILENO;;Boomers;PUERTO MONTT                  ;LOS LAGOS;0;0;0;0;0;0;0;0;0;Licuadora Personal TH-300PB;ELECTRODOMESTICOS
15131008;;F;39;CHILENO;;X;PROVIDENCIA                   ;METROPOLITANA;0;0;0;0;0;0;0;0;0;Horno Microondas Digital TH20DM 20Lts Espejado;ELECTRODOMESTICOS
13616615;;F;43;CHILENO;;X;PROVIDENCIA                   ;METROPOLITANA;0;0;0;0;0;0;0;0;0;ASPIRADORA THOMAS TH-2230;ELECTRODOMESTICOS
17283260;;F;32;CHILENO;;Millenial;PERALILLO                     ;L.G.B.OÂ´HIGGINS;0;0;0;0;0;0;0;0;0;Horno Microondas Digital TH-25DM 25Lts;ELECTRODOMESTICOS
13861293;;F;41;CHILENO;;X;ARAUCO                        ;BIO BIO;0;0;0;0;0;0;0;0;0;Batidora Manual TH-8830;ELECTRODOMESTICOS
26706740;;M;37;VENEZOLANO;;Extranjero;N/D;N/D;0;0;0;0;0;0;0;0;0;Maquina de Coser 311;ELECTRODOMESTICOS
12763501;;M;48;CHILENO;;X;HUALPEN;BIO-BIO;0;0;0;0;0;0;0;0;0;Hervidor Electrico Tetera HA-4100 4Lts Iox;ELECTRODOMESTICOS
19613063;;F;27;CHILENO;;Z;PROVIDENCIA                   ;METROPOLITANA;0;0;0;0;0;0;0;0;0;Horno Microondas Mecanico Fancy 20Lts;ELECTRODOMESTICOS
6589540;;M;70;CHILENO;;Silencioso;SAN ESTEBAN                   ;VALPARAISO;0;0;0;0;0;0;0;0;0;Horno Electrico TH-100i 100Lts;ELECTRODOMESTICOS
13184581;;F;45;CHILENO;;Silencioso;PROVIDENCIA                   ;METROPOLITANA;0;0;0;0;0;0;0;0;0;CAFETERA PRIMA LATTE 6603 NEGRA;ELECTRODOMESTICOS
9804541;;M;58;CHILENO;;Boomers;PROVIDENCIA                   ;METROPOLITANA;0;0;0;0;0;0;0;0;0;Horno Electrico TH-38N 38Lts;ELECTRODOMESTICOS
9717981;;M;48;CHILENO;;X;N/D;N/D;0;0;0;0;0;0;0;0;0;Licuadora L-1630V Negra 1,5Lts Vaso Vidrio;ELECTRODOMESTICOS
19268709;Soltero;F;25;CHILENO;;Silencioso;PROVIDENCIA                   ;METROPOLITANA;0;0;0;0;0;0;0;0;0;Parrilla Electrica TH-224;ELECTRODOMESTICOS
17854628;;M;30;CHILENO;;Millenial;PROVIDENCIA                   ;METROPOLITANA;0;0;0;0;0;0;0;0;0;Batidora Vertical Stick Mixer 2609;ELECTRODOMESTICOS
10172273;;M;57;CHILENO;;Boomers;N/D;N/D;0;0;0;0;0;0;0;0;0;Horno Electrico TH-100i 100Lts;ELECTRODOMESTICOS
19963643;;F;23;CHILENO;;Z;PUERTO MONTT                  ;LOS LAGOS;0;0;0;0;0;0;0;0;0;Licuadora TH-320 Roja/Negro 1,5 Lts Vaso Vidrio;ELECTRODOMESTICOS
21142613;;F;39;PERUANO;;Extranjero;PROVIDENCIA                   ;METROPOLITANA;0;0;0;0;0;0;0;0;0;Horno Microondas Digital TH20DM 20Lts Espejado;ELECTRODOMESTICOS
11858277;;F;51;CHILENO;;X;N/D;N/D;0;0;0;0;0;0;0;0;0;Aspiradora TH2206 Arrastre 1800Watts;ELECTRODOMESTICOS
12833025;;F;47;CHILENO;;X;ARICA                         ;ARICA Y PARINACOTA;0;0;0;0;0;0;0;0;0;Licuadora Kaliman Negra con Teclas;ELECTRODOMESTICOS
10813485;Soltero;F;56;CHILENO;;Boomers;RENCA                         ;METROPOLITANA;0;0;0;0;0;0;0;0;0;Horno Electrico TH-38N 38Lts;ELECTRODOMESTICOS
13870430;;M;42;CHILENO;;X;ANTOFAGASTA                   ;ANTOFAGASTA;0;0;0;0;0;0;0;0;0;Licuadora Kaliman Negra con Teclas;ELECTRODOMESTICOS
17208486;;M;33;CHILENO;;Millenial;HUALPEN;BIO BIO;0;0;0;0;0;0;0;0;0;Hervidor Electrico UT-DUNKEL17P 2Lts Negro;ELECTRODOMESTICOS
10673362;;M;43;CHILENO;;X;RENCA                         ;METROPOLITANA;0;0;0;0;0;0;0;0;0;HORNO ELECTRICO 16N01 16LTS NEGRO;ELECTRODOMESTICOS
8500110;;F;63;CHILENO;;Boomers;RENCA                         ;METROPOLITANA;0;0;0;0;0;0;0;0;0;Maquina de coser Singer 024;ELECTRODOMESTICOS
17653112;Soltero;F;31;CHILENO;;Millenial;PROVIDENCIA                   ;METROPOLITANA;0;0;0;0;0;0;0;0;0;Hervidor Electrico Tetera UT-LECKER18R 1,8Lts;ELECTRODOMESTICOS
8785276;Casado;M;62;CHILENO;;Boomers;RENCA                         ;METROPOLITANA;0;0;0;0;0;0;0;0;0;Aspiradora UT-KRAFT(DIG) Arrastre 2200Watts;ELECTRODOMESTICOS
16179623;Soltero;M;36;CHILENO;;Silencioso;PROVIDENCIA                   ;METROPOLITANA;0;0;0;0;0;0;0;0;0;Batidora Vertical Stick Mixer 2609;ELECTRODOMESTICOS
15251097;;M;39;CHILENO;;X;GORBEA                        ;ARAUCANIA;0;0;0;0;0;0;0;0;0;Horno Microondas Digital TH-20S01 20Lts;ELECTRODOMESTICOS
8178105;;F;62;CHILENO;;Silencioso;PROVIDENCIA                   ;METROPOLITANA;0;0;0;0;0;0;0;0;0;Hervidor Electrico HA-2650NG;ELECTRODOMESTICOS
8383711;;M;63;CHILENO;;Boomers;PROVIDENCIA                   ;METROPOLITANA;0;0;0;0;0;0;0;0;0;Horno Electrico UT-BACKOFEN26 26Lts;ELECTRODOMESTICOS
18886219;;F;28;CHILENO;;Millenial;N/D;N/D;0;0;0;0;0;0;0;0;0;Combo Juguera + Hervidor;ELECTRODOMESTICOS
18446543;;F;28;CHILENO;;Silencioso;PROVIDENCIA                   ;METROPOLITANA;0;0;0;0;0;0;0;0;0;Hervidor Electrico 3100 1,7Lts Negro;ELECTRODOMESTICOS
13328321;;M;44;CHILENO;;X;N/D;N/D;0;0;0;0;0;0;0;0;0;Batidora Vertical Minipimer UT-KLOT400P;ELECTRODOMESTICOS
19242457;;F;24;CHILENO;;Z;CHIMBARONGO;O HIGGINS;0;0;0;0;0;0;0;0;0;Tostador de Pan TH-116 2 Rebanadas Negro;ELECTRODOMESTICOS
16893998;;F;34;CHILENO;;Millenial;PUERTO MONTT                  ;LOS LAGOS;0;0;0;0;0;0;0;0;0;Aspiradora UT-MEINER1803 Arrastre 1800Watts;ELECTRODOMESTICOS
14173990;;F;41;CHILENO;;X;EL BOSQUE                     ;METROPOLITANA;0;0;0;0;0;0;0;0;0;Batidora Vertical Minipimer UT-KLOT400P;ELECTRODOMESTICOS
15199641;;M;39;CHILENO;;X;PROVIDENCIA                   ;METROPOLITANA;0;0;0;0;0;0;0;0;0;Licuadora TH-320 Roja/Negro 1,5 Lts Vaso Vidrio;ELECTRODOMESTICOS
6732039;;F;72;CHILENO;;Silencioso;PAINE                         ;METROPOLITANA;0;0;0;0;0;0;0;0;0;Aspiradora UT-KRAFT(DIG) Arrastre 2200Watts;ELECTRODOMESTICOS
24647719;Casado;F;37;CHILENO;;Extranjero;ARICA                         ;TARAPACA;0;0;0;0;0;0;0;0;0;Licuadora Kaliman Negra con Teclas;ELECTRODOMESTICOS
8388912;;F;62;CHILENO;;Silencioso;PROVIDENCIA                   ;METROPOLITANA;0;0;0;0;0;0;0;0;0;Batidora Manual 3532;ELECTRODOMESTICOS
12411887;;M;49;CHILENO;;X;N/D;N/D;0;0;0;0;0;0;0;0;0;Licuadora TH-320 Roja/Negro 1,5 Lts Vaso Vidrio;ELECTRODOMESTICOS
19390092;;F;25;CHILENO;;Z;TALCA                         ;MAULE;0;0;0;0;0;0;0;0;0;Hervidor Electrico TH-4212N 1,7Lts Negro;ELECTRODOMESTICOS
12835000;;F;47;CHILENO;;X;RENCA                         ;METROPOLITANA;0;0;0;0;0;0;0;0;0;FREIDORA DE AIRE THOMAS TH-AF60Mi;ELECTRODOMESTICOS
8430431;;M;48;CHILENO;;X;RENCA                         ;METROPOLITANA;0;0;0;0;0;0;0;0;0;Horno Electrico UT-LEIF36 36Lts;ELECTRODOMESTICOS
13341355;;F;44;CHILENO;;X;RENCA                         ;METROPOLITANA;0;0;0;0;0;0;0;0;0;Combo Licuadora + Batidora;ELECTRODOMESTICOS
18655703;;F;28;CHILENO;;Millenial;LINARES                       ;MAULE;0;0;0;0;0;0;0;0;0;Hervidor Electrico 3100 1,7Lts Negro;ELECTRODOMESTICOS
18679710;;M;28;CHILENO;;Millenial;LOS ANDES                     ;VALPARAISO;0;0;0;0;0;0;0;0;0;Batidora Pedestal B5300 Inox;ELECTRODOMESTICOS
18097926;;F;30;CHILENO;;Millenial;N/D;N/D;0;0;0;0;0;0;0;0;0;Horno Electrico UT-BACKOFEN26 26Lts;ELECTRODOMESTICOS
12058664;;F;53;CHILENO;;X;CONCHALI                      ;METROPOLITANA;0;0;0;0;0;0;0;0;0;Hervidor Electrico HA-3300 2,5Lts Blanco;ELECTRODOMESTICOS
15513166;Soltero;M;38;CHILENO;;Silencioso;PROVIDENCIA                   ;METROPOLITANA;0;0;0;0;0;0;0;0;0;Hervidor Electrico UT-MANLY17 1,7Lts Negro;ELECTRODOMESTICOS
5625322;;M;69;CHILENO;;Silencioso;PROVIDENCIA                   ;METROPOLITANA;0;0;0;0;0;0;0;0;0;Horno Electrico TH62I 60Lts;ELECTRODOMESTICOS
17061909;Soltero;M;33;CHILENO;;Silencioso;PINTO                         ;BIO BIO;0;0;0;0;0;0;0;0;0;Horno Microondas Mecanico UT-SYDNEY18 18Lts;ELECTRODOMESTICOS
9535271;;F;58;CHILENO;;Boomers;N/D;N/D;0;0;0;0;0;0;0;0;0;Horno Electrico TH-25N01 25Lts;ELECTRODOMESTICOS
8988237;;M;61;CHILENO;;Boomers;RENCA                         ;METROPOLITANA;0;0;0;0;0;0;0;0;0;Hervidor Electrico Tetera HA-4100 4Lts Iox;ELECTRODOMESTICOS
18729788;;F;28;CHILENO;;Millenial;N/D;N/D;0;0;0;0;0;0;0;0;0;Horno Microondas Digital TH-20S01 20Lts;ELECTRODOMESTICOS
9040216;Soltero;F;62;CHILENO;;Boomers;RENCA                         ;METROPOLITANA;0;0;0;0;0;0;0;0;0;Licuadora L-1630V Negra 1,5Lts Vaso Vidrio;ELECTRODOMESTICOS
19930922;;F;24;CHILENO;;Z;PROVIDENCIA                   ;METROPOLITANA;0;0;0;0;0;0;0;0;0;LICUADORA CROMADA CON TECLAS PLUS;ELECTRODOMESTICOS
13510538;;M;43;CHILENO;;X;PROVIDENCIA                   ;METROPOLITANA;0;0;0;0;0;0;0;0;0;Horno Microondas Digital TH-20S01 20Lts;ELECTRODOMESTICOS
5777433;;M;69;CHILENO;;Silencioso;VILLA ALEMANA                 ;VALPARAISO;0;0;0;0;0;0;0;0;0;Horno Electrico TH-80i 80Lts;ELECTRODOMESTICOS
6802376;Casado;F;66;CHILENO;PROFESOR;Boomers;PROVIDENCIA                   ;METROPOLITANA;0;0;0;0;0;0;0;0;0;Hervidor Electrico UT-KLAR20PW 2Lts Blanco;ELECTRODOMESTICOS
10683301;;M;54;CHILENO;;Boomers;RENCA                         ;METROPOLITANA;0;0;0;0;0;0;0;0;0;HERVIDOR TH-4340;ELECTRODOMESTICOS
11421233;;M;53;CHILENO;;X;PAREDONES                     ;L.G.B.OÂ´HIGGINS;0;0;0;0;0;0;0;0;0;Batidora Manual BA-5010 Inox;ELECTRODOMESTICOS
5575683;;F;76;CHILENO;;Silencioso;CARTAGENA                     ;VALPARAISO;0;0;0;0;0;0;0;0;0;Hervidor Electrico Tetera UT-LECKER18R 1,8Lts;ELECTRODOMESTICOS
18700873;;M;28;CHILENO;;Millenial;PEUMO                         ;L.G.B.OÂ´HIGGINS;0;0;0;0;0;0;0;0;0;Horno Electrico UT-BACKOFEN48 48Lts;ELECTRODOMESTICOS
15543552;;F;38;CHILENO;;Millenial;SAN BERNARDO                  ;METROPOLITANA;0;0;0;0;0;0;0;0;0;Horno Microondas Digital MS23K3513AK/ZS 23Lts;ELECTRODOMESTICOS
12367396;;M;49;CHILENO;;X;RENCA                         ;METROPOLITANA;0;0;0;0;0;0;0;0;0;Tostador de Pan TH-116 2 Rebanadas Negro;ELECTRODOMESTICOS
9885930;;M;56;CHILENO;;Boomers;CHIMBARONGO                   ;L.G.B.OÂ´HIGGINS;0;0;0;0;0;0;0;0;0;Horno Electrico TH62I 60Lts;ELECTRODOMESTICOS
7641471;Casado;F;62;CHILENO;;Boomers;PAINE                         ;METROPOLITANA;0;0;0;0;0;0;0;0;0;Licuadora TH-501V 1,5Lts Vaso Vidrio;ELECTRODOMESTICOS
6819485;;F;75;CHILENO;;Silencioso;PROVIDENCIA                   ;METROPOLITANA;0;0;0;0;0;0;0;0;0;Hervidor Electrico UT-MANLY17 1,7Lts Negro;ELECTRODOMESTICOS
8620894;;F;60;CHILENO;;Boomers;N/D;N/D;0;0;0;0;0;0;0;0;0;Hervidor Electrico TH-4515N 2Lts Negro;ELECTRODOMESTICOS
9863381;;F;59;CHILENO;;Boomers;TALCAHUANO                    ;BIO BIO;0;0;0;0;0;0;0;0;0;ASPIRADORA THOMAS TH-1640;ELECTRODOMESTICOS
20683549;;F;26;CHILENO;;Z;N/D;N/D;0;0;0;0;0;0;0;0;0;Horno Electrico TH-25N01 25Lts;ELECTRODOMESTICOS
16816276;;M;34;CHILENO;;Silencioso;PROVIDENCIA                   ;METROPOLITANA;0;0;0;0;0;0;0;0;0;Aspiradora Polvo AP-700 GR;ELECTRODOMESTICOS
17881190;;F;30;CHILENO;;Millenial;TEMUCO                        ;ARAUCANIA;0;0;0;0;0;0;0;0;0;HORNO ELECTRICO 16N01 16LTS NEGRO;ELECTRODOMESTICOS
8769170;;F;63;CHILENO;;Boomers;RENCA                         ;METROPOLITANA;0;0;0;0;0;0;0;0;0;MAQ. DE COSER REMINGTON STF21;ELECTRODOMESTICOS
17925722;;F;31;CHILENO;;Millenial;PUENTE ALTO                   ;METROPOLITANA;0;0;0;0;0;0;0;0;0;Horno Microondas Digital UT-CLASSY720 20Lts;ELECTRODOMESTICOS
11733566;;M;51;CHILENO;;X;PROVIDENCIA                   ;METROPOLITANA;0;0;0;0;0;0;0;0;0;Cafetera TH-138i;ELECTRODOMESTICOS
8979595;;M;62;CHILENO;;Boomers;MONTE PATRIA                  ;COQUIMBO;0;0;0;0;0;0;0;0;0;Hervidor Electrico Tetera HA-4100 4Lts Iox;ELECTRODOMESTICOS
10502658;;M;56;CHILENO;;Boomers;LLAILLAY                      ;VALPARAISO;0;0;0;0;0;0;0;0;0;Hervidor Electrico Tetera HA-4100 4Lts Iox;ELECTRODOMESTICOS
18166024;;F;30;CHILENO;;Millenial;NATALES;MAGALLANES;0;0;0;0;0;0;0;0;0;Hervidor Electrico TH-4800 2Lts Negro Azul;ELECTRODOMESTICOS
4594493;;M;82;CHILENO;;Silencioso;ARAUCO                        ;BIO BIO;0;0;0;0;0;0;0;0;0;Plancha UT-KERAMIKTOP 2200Watts Base Ceramica;ELECTRODOMESTICOS
10235252;;F;54;CHILENO;;Boomers;ROMERAL                       ;MAULE;0;0;0;0;0;0;0;0;0;Licuadora TH-401V Roja 1,75Lts Vaso Vidrio;ELECTRODOMESTICOS
6677068;;F;68;CHILENO;;Boomers;N/D;N/D;0;0;0;0;0;0;0;0;0;Hervidor Electrico UT-DUNKEL17P 2Lts Negro;ELECTRODOMESTICOS
10041957;Casado;M;56;CHILENO;;Boomers;RANCAGUA                      ;L.G.B.OÂ´HIGGINS;0;0;0;0;0;0;0;0;0;FREIDORA DE AIRE THOMAS TH-AF60Mi;ELECTRODOMESTICOS
17492264;;M;32;CHILENO;;Millenial;N/D;N/D;0;0;0;0;0;0;0;0;0;Aspiradora Tambor APA1000 1000Watts;ELECTRODOMESTICOS
6012725;;M;72;CHILENO;;Silencioso;RENCA                         ;METROPOLITANA;0;0;0;0;0;0;0;0;0;Hervidor Electrico UT-KLAR20PW 2Lts Blanco;ELECTRODOMESTICOS
15912008;;M;37;CHILENO;;Millenial;PROVIDENCIA                   ;METROPOLITANA;0;0;0;0;0;0;0;0;0;Horno Microondas Mecanico TH-18B05 18Lts;ELECTRODOMESTICOS
26889475;;M;34;EXTRANJERO - NO INFORMA NACIONALIDAD;;Extranjero;PENAFLOR;METROPOLITANA;0;0;0;0;0;0;0;0;0;Licuadora Oster Clasica Azul 4134 1,25 lt;ELECTRODOMESTICOS
19203388;;F;30;CHILENO;;Millenial;PROVIDENCIA                   ;METROPOLITANA;0;0;0;0;0;0;0;0;0;Aspiradora TH1870 Arrastre 1800Watts Gris;ELECTRODOMESTICOS
17531701;Casado;F;32;CHILENO;;Millenial;PROVIDENCIA                   ;METROPOLITANA;0;0;0;0;0;0;0;0;0;Aspiradora TH1415 Arrastre 1500Watts;ELECTRODOMESTICOS
5295748;;M;78;CHILENO;;Silencioso;PROVIDENCIA                   ;METROPOLITANA;0;0;0;0;0;0;0;0;0;Licuadora L-5500IN 1,5Lts;ELECTRODOMESTICOS
9983658;;F;55;CHILENO;;Boomers;MELIPILLA                     ;METROPOLITANA;0;0;0;0;0;0;0;0;0;ARROCERA ROJA 4723;ELECTRODOMESTICOS
10588659;;F;58;CHILENO;;Silencioso;PROVIDENCIA                   ;METROPOLITANA;0;0;0;0;0;0;0;0;0;Batidora Manual UT-TEKLA300;ELECTRODOMESTICOS
9015802;;F;61;CHILENO;;Boomers;RENCA                         ;METROPOLITANA;0;0;0;0;0;0;0;0;0;Hervidor Electrico HA-2650NG;ELECTRODOMESTICOS
12504791;;F;49;CHILENO;;X;RENCA                         ;METROPOLITANA;0;0;0;0;0;0;0;0;0;Horno Electrico TH-100i 100Lts;ELECTRODOMESTICOS
16637785;;F;35;CHILENO;;Millenial;N/D;N/D;0;0;0;0;0;0;0;0;0;Hervidor Electrico HA-3300 2,5Lts Blanco;ELECTRODOMESTICOS
13703933;;M;43;CHILENO;;X;IQUIQUE                       ;TARAPACA;0;0;0;0;0;0;0;0;0;Horno Microondas Digital L UT-25KROMM 25Lts;ELECTRODOMESTICOS
14343584;Divorciado;F;50;CHILENO;;X;RENCA                         ;METROPOLITANA;0;0;0;0;0;0;0;0;0;Licuadora Kaliman Negra con Teclas;ELECTRODOMESTICOS
10954536;;M;43;CHILENO;;X;PROVIDENCIA                   ;METROPOLITANA;0;0;0;0;0;0;0;0;0;Exprimidor de Jugo 407W 1Lts;ELECTRODOMESTICOS
16186470;Soltero;F;36;CHILENO;;Millenial;PROVIDENCIA                   ;METROPOLITANA;0;0;0;0;0;0;0;0;0;Tostador de Pan TH-126 4 Rebanadas Negro;ELECTRODOMESTICOS
18809828;Soltero;F;27;CHILENO;;Millenial;PROVIDENCIA                   ;METROPOLITANA;0;0;0;0;0;0;0;0;0;Tostador de Pan TP-1400 4 Rebanadas Inox;ELECTRODOMESTICOS
26732626;;M;37;VENEZOLANO;;Extranjero;PUERTO MONTT                  ;LOS LAGOS;0;0;0;0;0;0;0;0;0;Aspiradora UT-MEINER1803 Arrastre 1800Watts;ELECTRODOMESTICOS
6806918;;F;69;CHILENO;;Silencioso;RENCA                         ;METROPOLITANA;0;0;0;0;0;0;0;0;0;Licuadora L-1630V Negra 1,5Lts Vaso Vidrio;ELECTRODOMESTICOS
12020412;Casado;F;57;CHILENO;;Boomers;RENCA                         ;METROPOLITANA;0;0;0;0;0;0;0;0;0;Licuadora L2000VNG 1,5Lts Vaso Vidrio;ELECTRODOMESTICOS
15350628;;F;39;CHILENO;;Silencioso;PROVIDENCIA                   ;METROPOLITANA;0;0;0;0;0;0;0;0;0;Hervidor Oster 4410sg Silver Gold;ELECTRODOMESTICOS
14628078;;F;43;CHILENO;;X;PROVIDENCIA                   ;METROPOLITANA;0;0;0;0;0;0;0;0;0;Cafetera TH-138i;ELECTRODOMESTICOS
6309301;;M;69;CHILENO;;Silencioso;SAN JUAN DE LA COSTA          ;LOS LAGOS;0;0;0;0;0;0;0;0;0;Maquina de Coser BM-3850CL Lila;ELECTRODOMESTICOS
13576589;;F;43;CHILENO;;X;QUILICURA                     ;METROPOLITANA;0;0;0;0;0;0;0;0;0;Batidora Pedestal B5300 Inox;ELECTRODOMESTICOS
6320105;;M;73;CHILENO;;Silencioso;PROVIDENCIA                   ;METROPOLITANA;0;0;0;0;0;0;0;0;0;Horno Electrico UT-BACKOFEN48 48Lts;ELECTRODOMESTICOS
13795072;;F;41;CHILENO;;X;SANTIAGO                      ;METROPOLITANA;0;0;0;0;0;0;0;0;0;Horno Microondas Digital UT-CLASSY720 20Lts;ELECTRODOMESTICOS
16631421;;M;35;CHILENO;;Silencioso;PROVIDENCIA                   ;METROPOLITANA;0;0;0;0;0;0;0;0;0;Aspiradora UT-SILENT1804 Arrastre 1800Watts;ELECTRODOMESTICOS
13041082;;M;45;CHILENO;;Silencioso;PROVIDENCIA                   ;METROPOLITANA;0;0;0;0;0;0;0;0;0;Licuadora Berry Blender Roja 1400 Vaso Vidrio;ELECTRODOMESTICOS
9964226;;M;56;CHILENO;;Boomers;CASTRO                        ;LOS LAGOS;0;0;0;0;0;0;0;0;0;Horno Microondas Digital UT-CLASSY720 20Lts;ELECTRODOMESTICOS
9065588;;F;61;CHILENO;;Boomers;RENCA                         ;METROPOLITANA;0;0;0;0;0;0;0;0;0;LICUADORA CROMADA CON TECLAS PLUS;ELECTRODOMESTICOS
12148454;Casado;M;53;CHILENO;AGROINDUSTRIA;X;RENCA                         ;METROPOLITANA;0;0;0;0;0;0;0;0;0;Horno Electrico UT-BACKOFEN48 48Lts;ELECTRODOMESTICOS
7917609;;F;61;CHILENO;;Boomers;PUENTE ALTO                   ;METROPOLITANA;0;0;0;0;0;0;0;0;0;Horno Microondas Mecanico TH-18B05 18Lts;ELECTRODOMESTICOS
13585190;Casado;F;48;CHILENO;;X;RENCA                         ;METROPOLITANA;0;0;0;0;0;0;0;0;0;Hervidor Electrico UT-KLAR20PW 2Lts Blanco;ELECTRODOMESTICOS
12901457;;M;49;CHILENO;;X;PROVIDENCIA                   ;METROPOLITANA;0;0;0;0;0;0;0;0;0;Horno Electrico UT-BACKOFEN26 26Lts;ELECTRODOMESTICOS
15174660;;F;42;CHILENO;;X;RENCA                         ;METROPOLITANA;0;0;0;0;0;0;0;0;0;Hervidor Electrico 3100 1,7Lts Negro;ELECTRODOMESTICOS
13643751;;M;43;CHILENO;;X;ANTOFAGASTA                   ;ANTOFAGASTA;0;0;0;0;0;0;0;0;0;Licuadora UT-METALLEK505P 1,5Lts Vaso Vidrio;ELECTRODOMESTICOS
18098322;Soltero;F;30;CHILENO;;Millenial;PROVIDENCIA                   ;METROPOLITANA;0;0;0;0;0;0;0;0;0;Maquina de Coser Overlock MY8002D;ELECTRODOMESTICOS
12760264;;F;53;CHILENO;;X;RENCA                         ;METROPOLITANA;0;0;0;0;0;0;0;0;0;Plancha THOMAS TH-7170 2200Watts Base Ceramica;ELECTRODOMESTICOS
8373677;;F;62;CHILENO;;Boomers;PETORCA                       ;VALPARAISO;0;0;0;0;0;0;0;0;0;Maquina de coser Singer 024;ELECTRODOMESTICOS
8553106;Casado;F;65;CHILENO;;Boomers;PROVIDENCIA                   ;METROPOLITANA;0;0;0;0;0;0;0;0;0;Batidora Manual 2532;ELECTRODOMESTICOS
17154274;;M;33;CHILENO;;Millenial;LA SERENA                     ;COQUIMBO;0;0;0;0;0;0;0;0;0;Licuadora Kaliman Negra con Teclas;ELECTRODOMESTICOS
8076279;;F;69;CHILENO;;Silencioso;PELLUHUE                      ;MAULE;0;0;0;0;0;0;0;0;0;Horno Microondas Digital TH-25DM 25Lts;ELECTRODOMESTICOS
9548970;;F;62;CHILENO;;Boomers;RENCA                         ;METROPOLITANA;0;0;0;0;0;0;0;0;0;Plancha UT-DUNST 2200Watts Base Ceramica;ELECTRODOMESTICOS
12389580;;F;49;CHILENO;;X;PROVIDENCIA                   ;METROPOLITANA;0;0;0;0;0;0;0;0;0;Hervidor Electrico HA-3300 2,5Lts Blanco;ELECTRODOMESTICOS
5558924;Soltero;F;75;CHILENO;;Silencioso;RENCA                         ;METROPOLITANA;0;0;0;0;0;0;0;0;0;Horno Microondas Mecanico UT-SYDNEY18 18Lts;ELECTRODOMESTICOS
17620107;;F;32;CHILENO;;Millenial;SALAMANCA                     ;COQUIMBO;0;0;0;0;0;0;0;0;0;Horno Electrico TH-25N01 25Lts;ELECTRODOMESTICOS
18711904;;M;27;CHILENO;;Millenial;PROVIDENCIA                   ;METROPOLITANA;0;0;0;0;0;0;0;0;0;Tostador de Pan TP-1400 4 Rebanadas Inox;ELECTRODOMESTICOS
8769271;;F;64;CHILENO;;Boomers;TALAGANTE                     ;METROPOLITANA;0;0;0;0;0;0;0;0;0;Hervidor Electrico UT-DUNKEL17P 2Lts Negro;ELECTRODOMESTICOS
13577468;;F;43;CHILENO;;X;LINARES                       ;MAULE;0;0;0;0;0;0;0;0;0;Hervidor Electrico HE420 2lts Negro;ELECTRODOMESTICOS
10129720;;M;54;CHILENO;;Silencioso;PROVIDENCIA                   ;METROPOLITANA;0;0;0;0;0;0;0;0;0;Hervidor Electrico TH-4515N 2Lts Negro;ELECTRODOMESTICOS
6622911;;M;68;CHILENO;;Boomers;VALPARAISO                    ;VALPARAISO;0;0;0;0;0;0;0;0;0;Hervidor Electrico HA-3300 2,5Lts Blanco;ELECTRODOMESTICOS
18291953;Soltero;F;29;CHILENO;;Silencioso;PROVIDENCIA                   ;METROPOLITANA;0;0;0;0;0;0;0;0;0;Horno Electrico UT-LEIF36 36Lts;ELECTRODOMESTICOS
10595336;;F;53;CHILENO;;X;PROVIDENCIA                   ;METROPOLITANA;0;0;0;0;0;0;0;0;0;Aspiradora UT-SILENT1804 Arrastre 1800Watts;ELECTRODOMESTICOS
10108651;;F;56;CHILENO;;Boomers;CASTRO                        ;LOS LAGOS;0;0;0;0;0;0;0;0;0;Horno Electrico TH-38N 38Lts;ELECTRODOMESTICOS
12560106;;F;47;CHILENO;;X;RENCA                         ;METROPOLITANA;0;0;0;0;0;0;0;0;0;Batidora Pedestal B5300 Inox;ELECTRODOMESTICOS
19043698;;M;26;CHILENO;;Z;"";"";0;0;0;0;0;0;0;0;0;Cafetera P65 Silver;ELECTRODOMESTICOS
15779544;Soltero;F;37;CHILENO;;Millenial;PROVIDENCIA                   ;METROPOLITANA;0;0;0;0;0;0;0;0;0;Aspiradora TH1407 Arrastre 1400Watts;ELECTRODOMESTICOS
10325607;;F;57;CHILENO;;Boomers;RENCA                         ;METROPOLITANA;0;0;0;0;0;0;0;0;0;Aspiradora TH1870 Arrastre 1800Watts Gris;ELECTRODOMESTICOS
19783125;;F;25;CHILENO;;Z;SAN BERNARDO                  ;METROPOLITANA;0;0;0;0;0;0;0;0;0;Horno Electrico TH-25N01 25Lts;ELECTRODOMESTICOS
18900932;;M;27;CHILENO;;Z;LOS ANGELES;BIO-BIO;0;0;0;0;0;0;0;0;0;Aspiradora VCC4190V3E/XZS Arrastre 2000Watts;ELECTRODOMESTICOS
10753234;Divorciado;M;55;CHILENO;;Boomers;RENCA                         ;METROPOLITANA;0;0;0;0;0;0;0;0;0;BATIDORA PEDESTAL THOMAS TH-910PB;ELECTRODOMESTICOS
10604593;;F;58;CHILENO;;Boomers;COQUIMBO                      ;COQUIMBO;0;0;0;0;0;0;0;0;0;Batidora Manual 2532;ELECTRODOMESTICOS
17320391;Casado;M;33;CHILENO;;Millenial;PROVIDENCIA                   ;METROPOLITANA;0;0;0;0;0;0;0;0;0;Batidora Manual UT-TEKLA300;ELECTRODOMESTICOS
17765403;;F;30;CHILENO;;Millenial;ALHUE                         ;METROPOLITANA;0;0;0;0;0;0;0;0;0;Batidora Manual UT-TEKLA300;ELECTRODOMESTICOS
11525304;;M;51;CHILENO;;X;SAN BERNARDO                  ;METROPOLITANA;0;0;0;0;0;0;0;0;0;Plancha THOMAS TH-7170 2200Watts Base Ceramica;ELECTRODOMESTICOS
19233298;Soltero;F;26;CHILENO;;Silencioso;PROVIDENCIA                   ;METROPOLITANA;0;0;0;0;0;0;0;0;0;Batidora Vertical BM-450 Negra;ELECTRODOMESTICOS
11503874;;M;52;CHILENO;;Silencioso;PROVIDENCIA                   ;METROPOLITANA;0;0;0;0;0;0;0;0;0;LICUADORA CROMADA CON TECLAS PLUS;ELECTRODOMESTICOS
20125165;;F;23;CHILENO;;Z;PROVIDENCIA                   ;METROPOLITANA;0;0;0;0;0;0;0;0;0;Picadora UT-PETRUS320 1Lts Vaso Vidrio;ELECTRODOMESTICOS
20188515;;F;23;CHILENO;;Z;PROVIDENCIA                   ;METROPOLITANA;0;0;0;0;0;0;0;0;0;Horno Microondas Mecanico Easy Wave 20Lts;ELECTRODOMESTICOS
18691556;Soltero;F;27;CHILENO;NUTRICIONISTA;Silencioso;PROVIDENCIA                   ;METROPOLITANA;0;0;0;0;0;0;0;0;0;Plancha UT-DUNST 2200Watts Base Ceramica;ELECTRODOMESTICOS
17458408;Soltero;F;32;CHILENO;;Millenial;PROVIDENCIA                   ;METROPOLITANA;0;0;0;0;0;0;0;0;0;Horno Electrico TH-48N 48Lts;ELECTRODOMESTICOS
11878734;;F;52;CHILENO;;Silencioso;PROVIDENCIA                   ;METROPOLITANA;0;0;0;0;0;0;0;0;0;Extractor de Jugo EX800 1,4Lts;ELECTRODOMESTICOS
17765528;Soltero;F;30;CHILENO;ABOGADO;Millenial;PROVIDENCIA                   ;METROPOLITANA;0;0;0;0;0;0;0;0;0;Horno Microondas Digital UT-CLASSY720 20Lts;ELECTRODOMESTICOS
17543508;;F;35;CHILENO;;Millenial;PURRANQUE;LOS LAGOS;0;0;0;0;0;0;0;0;0;Hervidor Electrico Tetera UT-LECKER18R 1,8Lts;ELECTRODOMESTICOS
10234115;;F;54;CHILENO;;X;VALLENAR;ATACAMA;0;0;0;0;0;0;0;0;0;Plancha UT-SHANGRILA Inalambrica 2200Watss;ELECTRODOMESTICOS
9439310;;F;61;CHILENO;;Boomers;PROVIDENCIA                   ;METROPOLITANA;0;0;0;0;0;0;0;0;0;Horno Microondas Mecanico Easy Wave 20Lts;ELECTRODOMESTICOS
12929703;;F;47;CHILENO;;X;RENCA                         ;METROPOLITANA;0;0;0;0;0;0;0;0;0;Tostador de Pan TH-126 4 Rebanadas Negro;ELECTRODOMESTICOS
12475544;;M;48;CHILENO;;X;PROVIDENCIA                   ;METROPOLITANA;0;0;0;0;0;0;0;0;0;Horno Microondas Digital UT-CLASSY720 20Lts;ELECTRODOMESTICOS
11983234;;F;50;CHILENO;;X;CONSTITUCION                  ;MAULE;0;0;0;0;0;0;0;0;0;Exprimidor de Jugo CJ-2000 1Lts;ELECTRODOMESTICOS
10218189;;F;56;CHILENO;;Boomers;PROVIDENCIA                   ;METROPOLITANA;0;0;0;0;0;0;0;0;0;Batidora Pedestal UT-KLEIN700;ELECTRODOMESTICOS
18520057;Soltero;F;28;CHILENO;;Millenial;PROVIDENCIA                   ;METROPOLITANA;0;0;0;0;0;0;0;0;0;Aspiradora TH1870 Arrastre 1800Watts Gris;ELECTRODOMESTICOS
13011173;;F;48;CHILENO;;X;PUNITAQUI                     ;COQUIMBO;0;0;0;0;0;0;0;0;0;Horno Electrico UT-BACKOFEN26 26Lts;ELECTRODOMESTICOS
11367519;;F;53;CHILENO;;X;SAN FERNANDO                  ;L.G.B.OÂ´HIGGINS;0;0;0;0;0;0;0;0;0;MULTIMIXER THOMAS TH- 8706;ELECTRODOMESTICOS
10109967;;M;57;CHILENO;;Boomers;OVALLE                        ;COQUIMBO;0;0;0;0;0;0;0;0;0;Licuadora L2000VNG 1,5Lts Vaso Vidrio;ELECTRODOMESTICOS
12470637;;F;48;CHILENO;;X;SANTIAGO                      ;METROPOLITANA;0;0;0;0;0;0;0;0;0;Aspiradora VCC4190V3E/XZS Arrastre 2000Watts;ELECTRODOMESTICOS
11202683;;M;55;CHILENO;;Boomers;PROVIDENCIA                   ;METROPOLITANA;0;0;0;0;0;0;0;0;0;Licuadora TH-501V 1,5Lts Vaso Vidrio;ELECTRODOMESTICOS
17192495;;F;33;CHILENO;;Millenial;"";"";0;0;0;0;0;0;0;0;0;Horno Microondas Digital TH-25DM 25Lts;ELECTRODOMESTICOS
8265715;Casado;F;64;CHILENO;;Boomers;RENCA                         ;METROPOLITANA;0;0;0;0;0;0;0;0;0;LICUADORA CROMADA CON TECLAS PLUS;ELECTRODOMESTICOS
4717934;;M;81;CHILENO;;Silencioso;PROVIDENCIA                   ;METROPOLITANA;0;0;0;0;0;0;0;0;0;Hervidor Electrico UT-KLAR20PW 2Lts Blanco;ELECTRODOMESTICOS
16327636;;M;36;CHILENO;;Millenial;PROVIDENCIA                   ;METROPOLITANA;0;0;0;0;0;0;0;0;0;Horno Microondas Mecanico UT-SYDNEY18 18Lts;ELECTRODOMESTICOS
5734637;;M;74;CHILENO;;Silencioso;RENCA                         ;METROPOLITANA;0;0;0;0;0;0;0;0;0;Hervidor Electrico TH-5407i 2Lts;ELECTRODOMESTICOS
17416329;Casado;F;32;CHILENO;;Millenial;PROVIDENCIA                   ;METROPOLITANA;0;0;0;0;0;0;0;0;0;Horno Electrico UT-BACKOFEN26 26Lts;ELECTRODOMESTICOS
15425766;Soltero;F;39;CHILENO;;Silencioso;PROVIDENCIA                   ;METROPOLITANA;0;0;0;0;0;0;0;0;0;BATIDORA PEDESTAL THOMAS TH-910PB;ELECTRODOMESTICOS
16864169;;M;34;CHILENO;;Millenial;N/D;N/D;0;0;0;0;0;0;0;0;0;Licuadora TH-501V 1,5Lts Vaso Vidrio;ELECTRODOMESTICOS
16031318;Soltero;F;37;CHILENO;;Millenial;PROVIDENCIA                   ;METROPOLITANA;0;0;0;0;0;0;0;0;0;BATIDORA PEDESTAL THOMAS TH-910PB;ELECTRODOMESTICOS
9285897;;F;64;CHILENO;;Boomers;NANCAGUA                      ;L.G.B.OÂ´HIGGINS;0;0;0;0;0;0;0;0;0;Licuadora Osterizer 4112/72 1,25Lts Vaso Vidrio;ELECTRODOMESTICOS
14129074;;F;40;CHILENO;;X;LA FLORIDA;METROPOLITANA;0;0;0;0;0;0;0;0;0;BATIDORA VERTICAL MA-4100;ELECTRODOMESTICOS
16127445;Casado;M;38;CHILENO;TECNICO EN ADMINISTRACION DE EMPRESAS;X;PROVIDENCIA                   ;METROPOLITANA;0;0;0;0;0;0;0;0;0;MICROONDAS ME83X/XZS SAMSUNG MIRROR;ELECTRODOMESTICOS
14241158;;F;48;CHILENO;;X;RENCA                         ;METROPOLITANA;0;0;0;0;0;0;0;0;0;Cafetera UT-KAFFEEKLASSIK;ELECTRODOMESTICOS
20378539;;M;22;CHILENO;;Z;PROVIDENCIA                   ;METROPOLITANA;0;0;0;0;0;0;0;0;0;Horno Electrico UT-BACKOFEN48 48Lts;ELECTRODOMESTICOS
9987793;;F;57;CHILENO;;Boomers;ANCUD                         ;LOS LAGOS;0;0;0;0;0;0;0;0;0;Batidora Manual 2532;ELECTRODOMESTICOS
17696863;Casado;F;31;CHILENO;TECNICO DE NIVEL SUPERIOR EN ENFERMERIA;Millenial;RENCA                         ;METROPOLITANA;0;0;0;0;0;0;0;0;0;Horno Microondas Digital TH20DM 20Lts Espejado;ELECTRODOMESTICOS
16729227;;F;34;CHILENO;;Millenial;PROVIDENCIA                   ;METROPOLITANA;0;0;0;0;0;0;0;0;0;HERVIDOR TH-4340;ELECTRODOMESTICOS
18119508;Soltero;M;30;CHILENO;TECNICO DE NIVEL SUPERIOR EN IMAGENOLOGIA Y RADIOTERAPIA;Millenial;PROVIDENCIA                   ;METROPOLITANA;0;0;0;0;0;0;0;0;0;TOSTADOR ELECTRICO UT-ECKART2;ELECTRODOMESTICOS
19511208;;F;25;CHILENO;;Z;PROVIDENCIA                   ;METROPOLITANA;0;0;0;0;0;0;0;0;0;HERVIDOR TETERA RELOJ 900R 2,5L ROJO;ELECTRODOMESTICOS
15628627;Casado;M;38;CHILENO;TECNICO ELECTRICO;X;PROVIDENCIA                   ;METROPOLITANA;0;0;0;0;0;0;0;0;0;Aspiradora TH1870 Arrastre 1800Watts Gris;ELECTRODOMESTICOS
12841522;Soltero;M;47;CHILENO;PROFESOR;X;PROVIDENCIA                   ;METROPOLITANA;0;0;0;0;0;0;0;0;0;Horno Electrico UT-BACKOFEN48 48Lts;ELECTRODOMESTICOS
20902759;;F;28;CHILENO;;Millenial;PUENTE ALTO;METROPOLITANA;0;0;0;0;0;0;0;0;0;Licuadora 58159-CL 1,4Lts Vaso Tritan;ELECTRODOMESTICOS
15441091;;M;39;CHILENO;;Silencioso;PROVIDENCIA                   ;METROPOLITANA;0;0;0;0;0;0;0;0;0;Horno Microondas Mecanico Easy Wave 20Lts;ELECTRODOMESTICOS
8275058;;M;64;CHILENO;;Boomers;SANTA MARIA                   ;VALPARAISO;0;0;0;0;0;0;0;0;0;Hervidor Electrico TH-4212N 1,7Lts Negro;ELECTRODOMESTICOS
11232903;;F;54;CHILENO;;X;CURICO                        ;MAULE;0;0;0;0;0;0;0;0;0;Aspiradora Handy Clean Black 1400;ELECTRODOMESTICOS
10999258;;F;51;CHILENO;;X;RENCA                         ;METROPOLITANA;0;0;0;0;0;0;0;0;0;Aspiradora VCC4190V3E/XZS Arrastre 2000Watts;ELECTRODOMESTICOS
19295208;Soltero;F;25;CHILENO;TECNICO DE NIVEL MEDIO EN ALIMENTACION;Z;PROVIDENCIA                   ;METROPOLITANA;0;0;0;0;0;0;0;0;0;Licuadora TH-501V 1,5Lts Vaso Vidrio;ELECTRODOMESTICOS
6624611;;M;65;CHILENO;;Boomers;N/D;N/D;0;0;0;0;0;0;0;0;0;Hervidor Electrico UT-KLAR20PW 2Lts Blanco;ELECTRODOMESTICOS
8765668;;F;62;CHILENO;;Boomers;VALDIVIA                      ;LOS RIOS;0;0;0;0;0;0;0;0;0;LICUADORA CROMADA CON TECLAS PLUS;ELECTRODOMESTICOS
17375697;;F;32;CHILENO;;Millenial;PROVIDENCIA                   ;METROPOLITANA;0;0;0;0;0;0;0;0;0;LICUADORA MULTIFUNCION LCM-18000 GF;ELECTRODOMESTICOS
15276608;;F;37;CHILENO;;Millenial;"";"";0;0;0;0;0;0;0;0;0;Maquina de Coser Eco-17C;ELECTRODOMESTICOS
15671414;;F;39;CHILENO;;Silencioso;PROVIDENCIA                   ;METROPOLITANA;0;0;0;0;0;0;0;0;0;Horno Electrico UT-BACKOFEN60 60Lts;ELECTRODOMESTICOS
17763914;Soltero;M;31;CHILENO;;Silencioso;PROVIDENCIA                   ;METROPOLITANA;0;0;0;0;0;0;0;0;0;MICROONDAS MC32K7055CT/ZS SAMSUNG BLACK;ELECTRODOMESTICOS
8929169;;M;58;CHILENO;;Boomers;RANCAGUA                      ;L.G.B.OÂ´HIGGINS;0;0;0;0;0;0;0;0;0;Hervidor Electrico UT-DUNKEL17P 2Lts Negro;ELECTRODOMESTICOS
18981996;Soltero;F;27;CHILENO;KINESIOLOGO;Z;PROVIDENCIA                   ;METROPOLITANA;0;0;0;0;0;0;0;0;0;Horno Microondas Mecanico C1700N 17Lts Blanco;ELECTRODOMESTICOS
11414027;;M;53;CHILENO;;X;CASTRO                        ;LOS LAGOS;0;0;0;0;0;0;0;0;0;Batidora Manual UT-TEKLA300;ELECTRODOMESTICOS
17268382;;F;33;CHILENO;;Silencioso;N/D;N/D;0;0;0;0;0;0;0;0;0;Horno Electrico UT-BACKOFEN60 60Lts;ELECTRODOMESTICOS
8077788;;F;66;CHILENO;;Boomers;ANTOFAGASTA                   ;ANTOFAGASTA;0;0;0;0;0;0;0;0;0;Picadora TH-9020V Vaso Vidrio 2Lts;ELECTRODOMESTICOS
17299537;;M;32;CHILENO;;Silencioso;PROVIDENCIA                   ;METROPOLITANA;0;0;0;0;0;0;0;0;0;Horno Microondas Digital TH-25DM 25Lts;ELECTRODOMESTICOS
15783897;;M;38;CHILENO;;Millenial;MACUL                         ;METROPOLITANA;0;0;0;0;0;0;0;0;0;Batidora Pedestal TH910PN 4,6Lts 1300Watts;ELECTRODOMESTICOS
11978929;Soltero;F;50;CHILENO;;X;RENCA                         ;METROPOLITANA;0;0;0;0;0;0;0;0;0;Horno Microondas Mecanico UT-SYDNEY18 18Lts;ELECTRODOMESTICOS
19743199;;F;24;CHILENO;;Silencioso;PROVIDENCIA                   ;METROPOLITANA;0;0;0;0;0;0;0;0;0;BATIDORA INMERSION S MIX 2616;ELECTRODOMESTICOS
12930767;;F;47;CHILENO;;X;TEMUCO                        ;ARAUCANIA;0;0;0;0;0;0;0;0;0;FREIDORA DE AIRE CKSTAF15B 1850W;ELECTRODOMESTICOS
10801673;;M;46;CHILENO;;X;PROVIDENCIA                   ;METROPOLITANA;0;0;0;0;0;0;0;0;0;Horno Microondas Digital TH-25DM 25Lts;ELECTRODOMESTICOS
22821723;;F;41;NO INFORMA NACIONALIDAD;;Extranjero;IQUIQUE                       ;TARAPACA;0;0;0;0;0;0;0;0;0;Horno Microondas Digital TH-20S01 20Lts;ELECTRODOMESTICOS
17122573;Soltero;M;33;CHILENO;TECNICO EN PREVENCION DE RIESGOS;Millenial;PROVIDENCIA                   ;METROPOLITANA;0;0;0;0;0;0;0;0;0;Aspiradora AP1700 Arrastre 1700Watts;ELECTRODOMESTICOS
15101584;;F;39;CHILENO;;Millenial;"";"";0;0;0;0;0;0;0;0;0;Aspiradora AP1700 Arrastre 1700Watts;ELECTRODOMESTICOS
14174873;;F;41;CHILENO;;X;MAIPU                         ;METROPOLITANA;0;0;0;0;0;0;0;0;0;Batidora Pedestal TH910PN 4,6Lts 1300Watts;ELECTRODOMESTICOS
15440870;;F;39;CHILENO;;X;LA PINTANA                    ;METROPOLITANA;0;0;0;0;0;0;0;0;0;Horno Electrico TH-48N 48Lts;ELECTRODOMESTICOS
13929898;;F;42;CHILENO;;X;PROVIDENCIA                   ;METROPOLITANA;0;0;0;0;0;0;0;0;0;Parrilla Electrica TH-224;ELECTRODOMESTICOS
17336577;Soltero;F;33;CHILENO;;Millenial;PROVIDENCIA                   ;METROPOLITANA;0;0;0;0;0;0;0;0;0;Aspiradora AP1700 Arrastre 1700Watts;ELECTRODOMESTICOS
9601977;;F;60;CHILENO;;Boomers;LINARES                       ;MAULE;0;0;0;0;0;0;0;0;0;FREIDORA DE AIRE CKSTAF15B 1850W;ELECTRODOMESTICOS
18991658;;M;27;CHILENO;;Millenial;CERRO NAVIA                   ;METROPOLITANA;0;0;0;0;0;0;0;0;0;Batidora Pedestal Bowl 300 Inox;ELECTRODOMESTICOS
9370147;;F;61;CHILENO;;Boomers;PADRE HURTADO                 ;METROPOLITANA;0;0;0;0;0;0;0;0;0;Maquina de Coser ST-371HD Heavy Duty;ELECTRODOMESTICOS
18956985;Soltero;M;27;CHILENO;;Z;PROVIDENCIA                   ;METROPOLITANA;0;0;0;0;0;0;0;0;0;Horno Microondas Mecanico Fancy 20Lts;ELECTRODOMESTICOS
17906044;;M;31;CHILENO;;Millenial;PROVIDENCIA                   ;METROPOLITANA;0;0;0;0;0;0;0;0;0;Combo Licuadora + Batidora;ELECTRODOMESTICOS
10382413;;M;55;CHILENO;;Boomers;CERRO NAVIA                   ;METROPOLITANA;0;0;0;0;0;0;0;0;0;Horno Electrico UT-BACKOFEN60 60Lts;ELECTRODOMESTICOS
9177304;Soltero;M;61;CHILENO;;Boomers;PROVIDENCIA                   ;METROPOLITANA;0;0;0;0;0;0;0;0;0;Licuadora TH-320 Roja/Negro 1,5 Lts Vaso Vidrio;ELECTRODOMESTICOS
15569442;;M;39;CHILENO;;X;LINARES                       ;MAULE;0;0;0;0;0;0;0;0;0;Combo Juguera + Hervidor;ELECTRODOMESTICOS
25944175;;M;30;VENEZOLANO;;Extranjero;VINA DEL MAR                  ;VALPARAISO;0;0;0;0;0;0;0;0;0;Licuadora Osterizer 4112/72 1,25Lts Vaso Vidrio;ELECTRODOMESTICOS
14158447;;F;41;CHILENO;;X;PROVIDENCIA                   ;METROPOLITANA;0;0;0;0;0;0;0;0;0;Aspiradora AP1700 Arrastre 1700Watts;ELECTRODOMESTICOS
17163135;;F;32;CHILENO;;Silencioso;PROVIDENCIA                   ;METROPOLITANA;0;0;0;0;0;0;0;0;0;Horno Electrico UT-BACKOFEN48 48Lts;ELECTRODOMESTICOS
16975253;;F;34;CHILENO;;Millenial;COIHAIQUE                     ;AYSEN;0;0;0;0;0;0;0;0;0;Aspiradora TH1407 Arrastre 1400Watts;ELECTRODOMESTICOS
18944225;;F;27;CHILENO;;Z;PROVIDENCIA                   ;METROPOLITANA;0;0;0;0;0;0;0;0;0;HERVIDOR ELECTRICO UT-STARK18;ELECTRODOMESTICOS
15559000;Soltero;F;38;CHILENO;PROFESOR;X;PROVIDENCIA                   ;METROPOLITANA;0;0;0;0;0;0;0;0;0;Horno Electrico UT-BACKOFEN26 26Lts;ELECTRODOMESTICOS
8320659;;M;65;CHILENO;;Boomers;PROVIDENCIA                   ;METROPOLITANA;0;0;0;0;0;0;0;0;0;Picadora UT-PETRUS320 1Lts Vaso Vidrio;ELECTRODOMESTICOS
5597671;;M;76;CHILENO;;Silencioso;PROVIDENCIA                   ;METROPOLITANA;0;0;0;0;0;0;0;0;0;Horno Electrico HE-110 10Lts;ELECTRODOMESTICOS
17583306;;M;31;CHILENO;;Millenial;PADRE LAS CASAS               ;ARAUCANIA;0;0;0;0;0;0;0;0;0;Aspiradora TH1407 Arrastre 1400Watts;ELECTRODOMESTICOS
17336650;Soltero;F;32;CHILENO;TECNICO DE NIVEL SUPERIOR EN ENFERMERIA;Millenial;PROVIDENCIA                   ;METROPOLITANA;0;0;0;0;0;0;0;0;0;Aspiradora Trapeadora Robot Ut-Excellenza (B);ELECTRODOMESTICOS
20002177;;M;23;CHILENO;;Silencioso;PROVIDENCIA                   ;METROPOLITANA;0;0;0;0;0;0;0;0;0;Batidora Pedestal TH910PN 4,6Lts 1300Watts;ELECTRODOMESTICOS
15315850;;M;38;CHILENO;;X;PROVIDENCIA                   ;METROPOLITANA;0;0;0;0;0;0;0;0;0;Horno Electrico TH-48N 48Lts;ELECTRODOMESTICOS
19073422;;M;26;CHILENO;;Z;"";"";0;0;0;0;0;0;0;0;0;Hervidor Electrico UT-KLAR20PW 2Lts Blanco;ELECTRODOMESTICOS
12574340;;F;48;CHILENO;;X;RENCA                         ;METROPOLITANA;0;0;0;0;0;0;0;0;0;Horno Electrico TH-25N01 25Lts;ELECTRODOMESTICOS
20049820;;M;23;CHILENO;;Z;LOS SAUCES                    ;ARAUCANIA;0;0;0;0;0;0;0;0;0;Plancha TH-7052 2000Watts Base Inox;ELECTRODOMESTICOS
12676230;;F;48;CHILENO;;X;PROVIDENCIA                   ;METROPOLITANA;0;0;0;0;0;0;0;0;0;Aspiradora Polvo AP-700 GR;ELECTRODOMESTICOS
18348202;Casado;M;29;CHILENO;INGENIERO EN PREVENCION DE RIESGOS;Millenial;N/D;N/D;0;0;0;0;0;0;0;0;0;Hervidor Electrico TH-6200 R 1,7Lts Rojo;ELECTRODOMESTICOS
15937702;;F;37;CHILENO;;Millenial;SAN ANTONIO                   ;VALPARAISO;0;0;0;0;0;0;0;0;0;Licuadora L2000VNG 1,5Lts Vaso Vidrio;ELECTRODOMESTICOS
14288769;;F;48;CHILENO;;X;SAN BERNARDO                  ;METROPOLITANA;0;0;0;0;0;0;0;0;0;Hervidor Electrico HA-2650NG;ELECTRODOMESTICOS
5777361;;M;76;CHILENO;;Silencioso;RENCA                         ;METROPOLITANA;0;0;0;0;0;0;0;0;0;Hervidor Electrico UT-DUNKEL17P 2Lts Negro;ELECTRODOMESTICOS
5440170;Casado;M;73;CHILENO;;Silencioso;RENCA                         ;METROPOLITANA;0;0;0;0;0;0;0;0;0;Combo Licuadora + Batidora;ELECTRODOMESTICOS
15919007;;F;37;CHILENO;;Millenial;PROVIDENCIA                   ;METROPOLITANA;0;0;0;0;0;0;0;0;0;Extractor de Jugo TH-2540i;ELECTRODOMESTICOS
16331593;;F;35;CHILENO;;Millenial;PROVIDENCIA                   ;METROPOLITANA;0;0;0;0;0;0;0;0;0;LICUADORA 1000IN INOX SINDELEN;ELECTRODOMESTICOS
11903472;;F;51;CHILENO;;X;ARAUCO                        ;BIO BIO;0;0;0;0;0;0;0;0;0;Batidora Pedestal TH910PN 4,6Lts 1300Watts;ELECTRODOMESTICOS
13265439;;M;45;CHILENO;;Silencioso;PROVIDENCIA                   ;METROPOLITANA;0;0;0;0;0;0;0;0;0;Cafetera P65 Silver;ELECTRODOMESTICOS
12316643;;M;49;CHILENO;;X;CHANCO                        ;MAULE;0;0;0;0;0;0;0;0;0;Licuadora L-25000NG;ELECTRODOMESTICOS
13531267;;F;43;CHILENO;;X;OVALLE                        ;COQUIMBO;0;0;0;0;0;0;0;0;0;Parrilla Electrica TH-180;ELECTRODOMESTICOS
10852089;;M;53;CHILENO;;X;LA FLORIDA                    ;METROPOLITANA;0;0;0;0;0;0;0;0;0;Tostador de PanTH-120R 2 Rebanadas Rojo;ELECTRODOMESTICOS
16624435;;M;35;CHILENO;;Silencioso;"";"";0;0;0;0;0;0;0;0;0;Horno Microondas Digital TH-20S01 20Lts;ELECTRODOMESTICOS
18580435;;F;28;CHILENO;;Millenial;PROVIDENCIA                   ;METROPOLITANA;0;0;0;0;0;0;0;0;0;Parrilla Electrica TH-224;ELECTRODOMESTICOS
14190220;;F;42;CHILENO;;X;PROVIDENCIA                   ;METROPOLITANA;0;0;0;0;0;0;0;0;0;Horno Electrico TH-80i 80Lts;ELECTRODOMESTICOS
9650042;;F;59;CHILENO;;Boomers;LAS CABRAS                    ;L.G.B.OÂ´HIGGINS;0;0;0;0;0;0;0;0;0;Exprimidor de Jugo CJ-2000 1Lts;ELECTRODOMESTICOS
19538762;;F;25;CHILENO;;Z;PROVIDENCIA                   ;METROPOLITANA;0;0;0;0;0;0;0;0;0;Hervidor Electrico 3100 1,7Lts Negro;ELECTRODOMESTICOS
16050732;;F;37;CHILENO;;Millenial;PARRAL                        ;MAULE;0;0;0;0;0;0;0;0;0;Licuadora L2000VNG 1,5Lts Vaso Vidrio;ELECTRODOMESTICOS
11326046;;F;53;CHILENO;;X;RENCA                         ;METROPOLITANA;0;0;0;0;0;0;0;0;0;Plancha OSTER 4801T 1200Watts Base Ceramica;ELECTRODOMESTICOS
7833439;;F;66;CHILENO;;Boomers;PROVIDENCIA                   ;METROPOLITANA;0;0;0;0;0;0;0;0;0;Hervidor Electrico TH-5407i 2Lts;ELECTRODOMESTICOS
17034989;Soltero;F;33;CHILENO;KINESIOLOGA;Silencioso;PROVIDENCIA                   ;METROPOLITANA;0;0;0;0;0;0;0;0;0;Plancha Paninis 2880;ELECTRODOMESTICOS
11960682;;M;50;CHILENO;;X;PROVIDENCIA                   ;METROPOLITANA;0;0;0;0;0;0;0;0;0;Aspiradora TH1407 Arrastre 1400Watts;ELECTRODOMESTICOS
7773946;Soltero;F;62;CHILENO;MATRONA;Boomers;PROVIDENCIA                   ;METROPOLITANA;0;0;0;0;0;0;0;0;0;Licuadora Osterizer 4112/72 1,25Lts Vaso Vidrio;ELECTRODOMESTICOS
11778975;;F;51;CHILENO;;X;SAN BERNARDO                  ;METROPOLITANA;0;0;0;0;0;0;0;0;0;HERVIDOR ELECTRICO UT-STARK18;ELECTRODOMESTICOS
17036527;Soltero;F;33;CHILENO;;Millenial;RENCA                         ;METROPOLITANA;0;0;0;0;0;0;0;0;0;BATIDORA INMERSION S MIX 2616;ELECTRODOMESTICOS
14409666;;F;47;CHILENO;;X;PENALOLEN                     ;METROPOLITANA;0;0;0;0;0;0;0;0;0;Horno Electrico UT-LEIF36 36Lts;ELECTRODOMESTICOS
7277681;Divorciado;M;68;CHILENO;;Silencioso;PROVIDENCIA                   ;METROPOLITANA;0;0;0;0;0;0;0;0;0;Licuadora TH-320 Roja/Negro 1,5 Lts Vaso Vidrio;ELECTRODOMESTICOS
19014396;Soltero;M;26;CHILENO;;Silencioso;PROVIDENCIA                   ;METROPOLITANA;0;0;0;0;0;0;0;0;0;Parrilla Electrica TH-224;ELECTRODOMESTICOS
18833847;;F;27;CHILENO;;Millenial;RANCAGUA                      ;L.G.B.OÂ´HIGGINS;0;0;0;0;0;0;0;0;0;Aspiradora UT-MEINER1803 Arrastre 1800Watts;ELECTRODOMESTICOS
8178287;Divorciado;F;64;CHILENO;;Boomers;RENCA                         ;METROPOLITANA;0;0;0;0;0;0;0;0;0;Licuadora Roja 550W 1,5Lts Vaso Vidrio;ELECTRODOMESTICOS
11283668;;F;53;CHILENO;;X;RENCA                         ;METROPOLITANA;0;0;0;0;0;0;0;0;0;Cafetera TH-138i;ELECTRODOMESTICOS
12937760;;M;46;CHILENO;;X;ANTOFAGASTA                   ;ANTOFAGASTA;0;0;0;0;0;0;0;0;0;Aspiradora Trapeadora Robot Ut-Excellenza (B);ELECTRODOMESTICOS
8444323;;M;63;CHILENO;;Silencioso;N/D;N/D;0;0;0;0;0;0;0;0;0;Horno Electrico UT-BACKOFEN26 26Lts;ELECTRODOMESTICOS
15777238;;F;38;CHILENO;;Millenial;PROVIDENCIA                   ;METROPOLITANA;0;0;0;0;0;0;0;0;0;Horno Microondas Mecanico Easy Wave 20Lts;ELECTRODOMESTICOS
15990502;;M;39;CHILENO;;X;N/D;N/D;0;0;0;0;0;0;0;0;0;Licuadora L-5500IN 1,5Lts;ELECTRODOMESTICOS
7252819;;F;66;CHILENO;;Boomers;LA GRANJA                     ;METROPOLITANA;0;0;0;0;0;0;0;0;0;Horno Microondas Digital UT-CLASSY720 20Lts;ELECTRODOMESTICOS
6461017;Casado;M;67;CHILENO;;Boomers;RENCA                         ;METROPOLITANA;0;0;0;0;0;0;0;0;0;Horno Electrico TH-25N01 25Lts;ELECTRODOMESTICOS
18359533;;M;29;CHILENO;;Millenial;PROVIDENCIA                   ;METROPOLITANA;0;0;0;0;0;0;0;0;0;Sistema de nutricion Xpert Series 7001;ELECTRODOMESTICOS
14102840;;F;41;CHILENO;;X;N/D;N/D;0;0;0;0;0;0;0;0;0;Horno Electrico TH-25N01 25Lts;ELECTRODOMESTICOS
15810150;;M;38;CHILENO;;Millenial;LOS ANGELES                   ;BIO BIO;0;0;0;0;0;0;0;0;0;Plancha V-2300 1950Watts Base Inox;ELECTRODOMESTICOS
13003538;;M;46;CHILENO;;X;PLACILLA                      ;L.G.B.OÂ´HIGGINS;0;0;0;0;0;0;0;0;0;Licuadora UT-METALLEK605P 1,55Lts;ELECTRODOMESTICOS
15246541;;F;39;CHILENO;;Silencioso;VILCUN                        ;ARAUCANIA;0;0;0;0;0;0;0;0;0;Horno Electrico UT-BACKOFEN48 48Lts;ELECTRODOMESTICOS
25496159;;F;54;COLOMBIANO;;Extranjero;NUNOA                         ;METROPOLITANA;0;0;0;0;0;0;0;0;0;Aspiradora VCC4190V3E/XZS Arrastre 2000Watts;ELECTRODOMESTICOS
10925724;;F;47;CHILENO;;X;PROVIDENCIA                   ;METROPOLITANA;0;0;0;0;0;0;0;0;0;Batidora Pedestal UT-KLEIN700;ELECTRODOMESTICOS
25726851;;M;45;VENEZOLANO;;Extranjero;N/D;N/D;0;0;0;0;0;0;0;0;0;Hervidor Electrico UT-MANLY17 1,7Lts Negro;ELECTRODOMESTICOS
3175722;;M;89;CHILENO;;Silencioso;CURANILAHUE                   ;BIO BIO;0;0;0;0;0;0;0;0;0;Hervidor Electrico HA-3300 2,5Lts Blanco;ELECTRODOMESTICOS
19021774;;F;27;CHILENO;;Z;OVALLE                        ;COQUIMBO;0;0;0;0;0;0;0;0;0;Batidora Manual UT-TEKLA300;ELECTRODOMESTICOS
9401402;;F;61;CHILENO;;Silencioso;PROVIDENCIA                   ;METROPOLITANA;0;0;0;0;0;0;0;0;0;Licuadora L-5500IN 1,5Lts;ELECTRODOMESTICOS
12859966;;F;46;CHILENO;;X;COLINA                        ;METROPOLITANA;0;0;0;0;0;0;0;0;0;Licuadora L2000VNG 1,5Lts Vaso Vidrio;ELECTRODOMESTICOS
13233654;;F;45;CHILENO;;X;PROVIDENCIA                   ;METROPOLITANA;0;0;0;0;0;0;0;0;0;Horno Microondas Mecanico UT-SYDNEY18 18Lts;ELECTRODOMESTICOS
12168413;;M;47;CHILENO;;X;PROVIDENCIA                   ;METROPOLITANA;0;0;0;0;0;0;0;0;0;Horno Microondas Digital L UT-25KROMM 25Lts;ELECTRODOMESTICOS
16965956;;F;33;CHILENO;;Millenial;"";"";0;0;0;0;0;0;0;0;0;Aspiradora TH1870 Arrastre 1800Watts Gris;ELECTRODOMESTICOS
16977633;Soltero;F;33;CHILENO;INGENIERO COMERCIAL;Silencioso;PROVIDENCIA                   ;METROPOLITANA;0;0;0;0;0;0;0;0;0;Enceradora EA-5000;ELECTRODOMESTICOS
14009189;;M;41;CHILENO;;X;PROVIDENCIA                   ;METROPOLITANA;0;0;0;0;0;0;0;0;0;Maquina de coser computarizada SH7700;ELECTRODOMESTICOS
14686068;;F;24;CHILENO;;Z;PROVIDENCIA                   ;METROPOLITANA;0;0;0;0;0;0;0;0;0;MICROONDAS ME83X/XZS SAMSUNG MIRROR;ELECTRODOMESTICOS
19171432;Soltero;F;27;CHILENO;;Z;PROVIDENCIA                   ;METROPOLITANA;0;0;0;0;0;0;0;0;0;Batidora Manual BA-5010 Inox;ELECTRODOMESTICOS
17797851;;F;31;CHILENO;;Millenial;ALTO HOSPICIO;TARAPACA;0;0;0;0;0;0;0;0;0;Licuadora UT-METALLEK505P 1,5Lts Vaso Vidrio;ELECTRODOMESTICOS
15623953;Casado;F;38;CHILENO;;X;PROVIDENCIA                   ;METROPOLITANA;0;0;0;0;0;0;0;0;0;Horno Microondas Digital UT-CLASSY720 20Lts;ELECTRODOMESTICOS
10626446;;F;56;CHILENO;;Boomers;PARRAL                        ;MAULE;0;0;0;0;0;0;0;0;0;Hervidor Electrico HE420 2lts Negro;ELECTRODOMESTICOS
15292242;Casado;F;38;CHILENO;;X;RENCA                         ;METROPOLITANA;0;0;0;0;0;0;0;0;0;Licuadora L-1630V Negra 1,5Lts Vaso Vidrio;ELECTRODOMESTICOS
14484420;Casado;F;44;CHILENO;;Silencioso;PROVIDENCIA                   ;METROPOLITANA;0;0;0;0;0;0;0;0;0;Hervidor Electrico TH-5407i 2Lts;ELECTRODOMESTICOS
13467908;Casado;F;43;CHILENO;CONTADOR AUDITOR;X;PROVIDENCIA                   ;METROPOLITANA;0;0;0;0;0;0;0;0;0;Hervidor Termo BA-6928 Rojo 2,8Lts;ELECTRODOMESTICOS
19215132;Soltero;M;26;CHILENO;;Z;PROVIDENCIA                   ;METROPOLITANA;0;0;0;0;0;0;0;0;0;Plancha TH-7052 2000Watts Base Inox;ELECTRODOMESTICOS
13618672;;M;42;CHILENO;;X;RENCA                         ;METROPOLITANA;0;0;0;0;0;0;0;0;0;Batidora Manual TH-8830;ELECTRODOMESTICOS
10273089;;F;47;CHILENO;;X;PROVIDENCIA                   ;METROPOLITANA;0;0;0;0;0;0;0;0;0;Aspiradora VCC4190V3E/XZS Arrastre 2000Watts;ELECTRODOMESTICOS
8809459;;M;62;CHILENO;;Boomers;MAIPU                         ;METROPOLITANA;0;0;0;0;0;0;0;0;0;Hervidor Termo BA-6928 Rojo 2,8Lts;ELECTRODOMESTICOS
12414236;Soltero;M;48;CHILENO;;X;RENCA                         ;METROPOLITANA;0;0;0;0;0;0;0;0;0;Aspiradora UT-EXCELLENZA2000 0,5 litros 2600 MAH;ELECTRODOMESTICOS
11658465;;M;52;CHILENO;;X;RENCA                         ;METROPOLITANA;0;0;0;0;0;0;0;0;0;Aspiradora Cyclonic Adventage roja CA4000N;ELECTRODOMESTICOS
18930614;Soltero;F;27;CHILENO;ASISTENTE DE PARVULOS;Millenial;PROVIDENCIA                   ;METROPOLITANA;0;0;0;0;0;0;0;0;0;BATIDORA INMERSION S MIX 2616;ELECTRODOMESTICOS
17645226;Soltero;F;30;CHILENO;;Millenial;PROVIDENCIA                   ;METROPOLITANA;0;0;0;0;0;0;0;0;0;BATIDORA VERTICAL MA-4100;ELECTRODOMESTICOS
9402105;;F;59;CHILENO;;Boomers;PROVIDENCIA                   ;METROPOLITANA;0;0;0;0;0;0;0;0;0;Maquina para Hacer Pan MPP-600 BL;ELECTRODOMESTICOS
25707559;;F;39;VENEZOLANO;;Extranjero;N/D;N/D;0;0;0;0;0;0;0;0;0;Horno Electrico TH-16N 16Lts;ELECTRODOMESTICOS
25875299;;M;30;VENEZOLANO;;Extranjero;N/D;N/D;0;0;0;0;0;0;0;0;0;Aspiradora UT-MEINER1803 Arrastre 1800Watts;ELECTRODOMESTICOS
9806472;Soltero;M;58;CHILENO;CORREDOR DE PROPIEDADES;Boomers;PROVIDENCIA                   ;METROPOLITANA;0;0;0;0;0;0;0;0;0;Horno Electrico TH-16N 16Lts;ELECTRODOMESTICOS
7263873;;F;66;CHILENO;;Boomers;ARAUCO                        ;BIO BIO;0;0;0;0;0;0;0;0;0;Horno Electrico UT-BACKOFEN60 60Lts;ELECTRODOMESTICOS
16617260;;F;35;CHILENO;;Millenial;PUERTO MONTT                  ;LOS LAGOS;0;0;0;0;0;0;0;0;0;FREIDORA DE AIRE CKSTAF15B 1850W;ELECTRODOMESTICOS
17000350;;M;33;CHILENO;;Silencioso;PROVIDENCIA                   ;METROPOLITANA;0;0;0;0;0;0;0;0;0;Licuadora TH-320 Roja/Negro 1,5 Lts Vaso Vidrio;ELECTRODOMESTICOS
18298837;Soltero;M;29;CHILENO;;Silencioso;PROVIDENCIA                   ;METROPOLITANA;0;0;0;0;0;0;0;0;0;FREIDORA DE AIRE THOMAS TH-AF60Mi;ELECTRODOMESTICOS
10684847;;M;40;CHILENO;;X;RENCA                         ;METROPOLITANA;0;0;0;0;0;0;0;0;0;Hervidor 41020-CL 1,7Lts Inox;ELECTRODOMESTICOS
12081644;;M;50;CHILENO;;Silencioso;PROVIDENCIA                   ;METROPOLITANA;0;0;0;0;0;0;0;0;0;HERVIDOR ELECTRICO UT-STARK18;ELECTRODOMESTICOS
16765211;Soltero;F;34;CHILENO;;Millenial;PROVIDENCIA                   ;METROPOLITANA;0;0;0;0;0;0;0;0;0;Horno Microondas Digital UT-CLASSY720 20Lts;ELECTRODOMESTICOS
11388963;;F;53;CHILENO;;X;VILLA ALEMANA                 ;VALPARAISO;0;0;0;0;0;0;0;0;0;Hervidor Electrico HA-3300 2,5Lts Blanco;ELECTRODOMESTICOS
10615865;;F;56;CHILENO;;Boomers;N/D;N/D;0;0;0;0;0;0;0;0;0;Batidora Manual UT-TEKLA300;ELECTRODOMESTICOS
20310624;;F;22;CHILENO;;Z;PROVIDENCIA                   ;METROPOLITANA;0;0;0;0;0;0;0;0;0;Horno Electrico TH-38N 38Lts;ELECTRODOMESTICOS
19134129;Soltero;M;27;CHILENO;PSICOLOGO;Silencioso;PROVIDENCIA                   ;METROPOLITANA;0;0;0;0;0;0;0;0;0;Combo Hervidor + Tostador + Sandwichera;ELECTRODOMESTICOS
26292019;Soltero;F;41;EXTRANJERO - NO INFORMA NACIONALIDAD;;Extranjero;PROVIDENCIA                   ;METROPOLITANA;0;0;0;0;0;0;0;0;0;Aspiradora VCC4190V3E/XZS Arrastre 2000Watts;ELECTRODOMESTICOS
6739049;;F;71;CHILENO;;Silencioso;VALLENAR;ATACAMA;0;0;0;0;0;0;0;0;0;Licuadora L-25000NG;ELECTRODOMESTICOS
14100989;Casado;M;41;CHILENO;INGENIERO;X;PROVIDENCIA                   ;METROPOLITANA;0;0;0;0;0;0;0;0;0;Robot aspirador Roomba E5;ELECTRODOMESTICOS
12966034;;F;46;CHILENO;;X;PARRAL                        ;MAULE;0;0;0;0;0;0;0;0;0;Horno Electrico UT-BACKOFEN26 26Lts;ELECTRODOMESTICOS
7768392;;F;65;CHILENO;;Boomers;RENCA                         ;METROPOLITANA;0;0;0;0;0;0;0;0;0;HERVIDOR TH-4340;ELECTRODOMESTICOS
13674001;;M;43;CHILENO;;X;COPIAPO                       ;ATACAMA;0;0;0;0;0;0;0;0;0;Enceradora EA-5000;ELECTRODOMESTICOS
17447765;;F;32;CHILENO;;Silencioso;PROVIDENCIA                   ;METROPOLITANA;0;0;0;0;0;0;0;0;0;Hervidor 41020-CL 1,7Lts Inox;ELECTRODOMESTICOS
11499246;;M;53;CHILENO;;X;NUEVA IMPERIAL                ;ARAUCANIA;0;0;0;0;0;0;0;0;0;Aspiradora TH1870 Arrastre 1800Watts Gris;ELECTRODOMESTICOS
12594045;;F;48;CHILENO;;X;PROVIDENCIA                   ;METROPOLITANA;0;0;0;0;0;0;0;0;0;Horno Electrico TH-48N 48Lts;ELECTRODOMESTICOS
5645747;;M;75;CHILENO;;Silencioso;PROVIDENCIA                   ;METROPOLITANA;0;0;0;0;0;0;0;0;0;Horno Microondas Mecanico Easy Wave 20Lts;ELECTRODOMESTICOS
9060449;Casado;M;62;CHILENO;;Boomers;PROVIDENCIA                   ;METROPOLITANA;0;0;0;0;0;0;0;0;0;Batidora Vertical Multimixer TH-8720;ELECTRODOMESTICOS
14007314;Casado;F;41;CHILENO;;X;RENCA                         ;METROPOLITANA;0;0;0;0;0;0;0;0;0;Horno Microondas Mecanico C1700N 17Lts Blanco;ELECTRODOMESTICOS
15147256;Casado;F;37;CHILENO;TECNICO DE NIVEL SUPERIOR LABORATORISTA DENTAL;Millenial;PROVIDENCIA                   ;METROPOLITANA;0;0;0;0;0;0;0;0;0;FREIDORA DE AIRE CKSTAF18D 1000W;ELECTRODOMESTICOS
13104708;;M;45;CHILENO;;X;N/D;N/D;0;0;0;0;0;0;0;0;0;Hervidor Electrico UT-MANLY17 1,7Lts Negro;ELECTRODOMESTICOS
10840210;;F;51;CHILENO;;X;NUEVA IMPERIAL                ;ARAUCANIA;0;0;0;0;0;0;0;0;0;Hervidor Electrico UT-MANLY17 1,7Lts Negro;ELECTRODOMESTICOS
13536639;Casado;M;43;CHILENO;;X;PROVIDENCIA                   ;METROPOLITANA;0;0;0;0;0;0;0;0;0;Extractor de Jugo EX800 1,4Lts;ELECTRODOMESTICOS
11683387;;F;51;CHILENO;;X;PUDAHUEL                      ;METROPOLITANA;0;0;0;0;0;0;0;0;0;Batidora Vertical Multimixer TH-8720;ELECTRODOMESTICOS
10045633;;F;58;CHILENO;;Boomers;SAN BERNARDO                  ;METROPOLITANA;0;0;0;0;0;0;0;0;0;Hervidor Electrico UT-REIN17SS;ELECTRODOMESTICOS
9751182;;M;57;CHILENO;;Boomers;RENCA                         ;METROPOLITANA;0;0;0;0;0;0;0;0;0;Maquina de Coser XB-2500CL Rosado;ELECTRODOMESTICOS
8701413;;M;52;CHILENO;;X;PUNTA ARENAS                  ;MAGALLANES;0;0;0;0;0;0;0;0;0;Licuadora L2000VNG 1,5Lts Vaso Vidrio;ELECTRODOMESTICOS
6918913;;M;64;CHILENO;;Boomers;QUILPUE                       ;VALPARAISO;0;0;0;0;0;0;0;0;0;Horno Microondas Mecanico Easy Wave 20Lts;ELECTRODOMESTICOS
17330672;;F;32;CHILENO;;Millenial;PROVIDENCIA                   ;METROPOLITANA;0;0;0;0;0;0;0;0;0;Exprimidor de Jugo CJ-2000 1Lts;ELECTRODOMESTICOS
5353941;;M;76;CHILENO;;Silencioso;SAN ESTEBAN                   ;VALPARAISO;0;0;0;0;0;0;0;0;0;Horno Electrico TH-48N 48Lts;ELECTRODOMESTICOS
6458954;;F;72;CHILENO;;Silencioso;RENCA                         ;METROPOLITANA;0;0;0;0;0;0;0;0;0;Robot aspirador Roomba 675;ELECTRODOMESTICOS
17569223;;F;32;CHILENO;;Millenial;PROVIDENCIA                   ;METROPOLITANA;0;0;0;0;0;0;0;0;0;Exprimidor de Jugo 407W 1Lts;ELECTRODOMESTICOS
18088884;;F;30;CHILENO;;Silencioso;PROVIDENCIA                   ;METROPOLITANA;0;0;0;0;0;0;0;0;0;Horno Microondas Mecanico Easy Wave 20Lts;ELECTRODOMESTICOS
11333983;;F;54;CHILENO;;X;PENAFLOR                      ;METROPOLITANA;0;0;0;0;0;0;0;0;0;Licuadora UT-METALLEK705 1,75Lts Vaso Vidrio;ELECTRODOMESTICOS
12222459;;F;50;CHILENO;;X;RENCA                         ;METROPOLITANA;0;0;0;0;0;0;0;0;0;ASPIRADORA THOMAS TH-1640;ELECTRODOMESTICOS
18506662;;M;29;CHILENO;;Silencioso;PROVIDENCIA                   ;METROPOLITANA;0;0;0;0;0;0;0;0;0;Licuadora UT-METALLEK505P 1,5Lts Vaso Vidrio;ELECTRODOMESTICOS
8004026;;M;59;CHILENO;;Boomers;PROVIDENCIA                   ;METROPOLITANA;0;0;0;0;0;0;0;0;0;Hervidor Electrico UT-KLAR20PW 2Lts Blanco;ELECTRODOMESTICOS
10101394;;M;44;CHILENO;;X;COIHAIQUE                     ;AYSEN;0;0;0;0;0;0;0;0;0;Batidora Manual UT-TEKLA300;ELECTRODOMESTICOS
8884450;;F;59;CHILENO;;Boomers;RENCA                         ;METROPOLITANA;0;0;0;0;0;0;0;0;0;Aspiradora TH1870 Arrastre 1800Watts Gris;ELECTRODOMESTICOS
9270933;Soltero;M;60;CHILENO;;Boomers;PROVIDENCIA                   ;METROPOLITANA;0;0;0;0;0;0;0;0;0;PLANCHA A VAPOR 6003 BASE ANTIADHERENTE 1600W;ELECTRODOMESTICOS
10543140;;M;49;CHILENO;;Silencioso;PROVIDENCIA                   ;METROPOLITANA;0;0;0;0;0;0;0;0;0;Horno Microondas Mecanico Easy Wave 20Lts;ELECTRODOMESTICOS
7326981;;F;69;CHILENO;;Silencioso;PROVIDENCIA                   ;METROPOLITANA;0;0;0;0;0;0;0;0;0;Licuadora TH-501V 1,5Lts Vaso Vidrio;ELECTRODOMESTICOS
10647682;Casado;F;52;CHILENO;PROFESOR;X;RENCA                         ;METROPOLITANA;0;0;0;0;0;0;0;0;0;Horno Electrico TH-16N 16Lts;ELECTRODOMESTICOS
12788522;;F;47;CHILENO;;X;PROVIDENCIA                   ;METROPOLITANA;0;0;0;0;0;0;0;0;0;Cafetera TH-138i;ELECTRODOMESTICOS
6747104;;F;70;CHILENO;;Silencioso;PROVIDENCIA                   ;METROPOLITANA;0;0;0;0;0;0;0;0;0;Hervidor Electrico TH-5407i 2Lts;ELECTRODOMESTICOS
19339885;;F;25;CHILENO;;Z;PROVIDENCIA                   ;METROPOLITANA;0;0;0;0;0;0;0;0;0;Batidora Manual UT-TEKLA300;ELECTRODOMESTICOS
16350452;Soltero;F;36;CHILENO;ENFERMERA;Millenial;PROVIDENCIA                   ;METROPOLITANA;0;0;0;0;0;0;0;0;0;FREIDORA DE AIRE CKSTAF15B 1850W;ELECTRODOMESTICOS
6737844;;F;70;CHILENO;;Silencioso;SAN FELIPE                    ;VALPARAISO;0;0;0;0;0;0;0;0;0;Aspiradora UT-SILENT1804 Arrastre 1800Watts;ELECTRODOMESTICOS
5650548;;F;77;CHILENO;;Silencioso;PROVIDENCIA                   ;METROPOLITANA;0;0;0;0;0;0;0;0;0;Horno Electrico TH-25N01 25Lts;ELECTRODOMESTICOS
18538183;Soltero;M;29;CHILENO;;Silencioso;PROVIDENCIA                   ;METROPOLITANA;0;0;0;0;0;0;0;0;0;ASPIRADORA ROBOT VR05R5050WK/ZS;ELECTRODOMESTICOS
18442911;;F;29;CHILENO;;Millenial;"";"";0;0;0;0;0;0;0;0;0;Batidora Manual UT-TEKLA300;ELECTRODOMESTICOS
12961669;;M;45;CHILENO;;X;N/D;N/D;0;0;0;0;0;0;0;0;0;Licuadora UT-METALLEK605P 1,55Lts;ELECTRODOMESTICOS
12684170;;M;48;CHILENO;;Silencioso;PROVIDENCIA                   ;METROPOLITANA;0;0;0;0;0;0;0;0;0;Licuadora Roja 550W 1,5Lts Vaso Vidrio;ELECTRODOMESTICOS
16575294;;M;34;CHILENO;;Millenial;LA LIGUA                      ;VALPARAISO;0;0;0;0;0;0;0;0;0;Batidora Manual 2532;ELECTRODOMESTICOS
18854153;;F;27;CHILENO;;Silencioso;PROVIDENCIA                   ;METROPOLITANA;0;0;0;0;0;0;0;0;0;Hervidor Electrico UT-MANLY17 1,7Lts Negro;ELECTRODOMESTICOS
15786572;Soltero;M;38;CHILENO;INGENIERO COMERCIAL;Millenial;PROVIDENCIA                   ;METROPOLITANA;0;0;0;0;0;0;0;0;0;ASPIRADORA ROBOT VR05R5050WK/ZS;ELECTRODOMESTICOS
14012617;;M;41;CHILENO;;X;RENGO                         ;L.G.B.OÂ´HIGGINS;0;0;0;0;0;0;0;0;0;Maquina de Coser Overlock MY8002D;ELECTRODOMESTICOS
18231937;;F;30;CHILENO;;Millenial;PROVIDENCIA                   ;METROPOLITANA;0;0;0;0;0;0;0;0;0;Horno Electrico TH-25N01 25Lts;ELECTRODOMESTICOS
9889025;;F;56;CHILENO;;Boomers;PROVIDENCIA                   ;METROPOLITANA;0;0;0;0;0;0;0;0;0;Hervidor Electrico TH-6200 R 1,7Lts Rojo;ELECTRODOMESTICOS
20230061;;F;22;CHILENO;;Z;PROVIDENCIA                   ;METROPOLITANA;0;0;0;0;0;0;0;0;0;Licuadora L2000VNG 1,5Lts Vaso Vidrio;ELECTRODOMESTICOS
11260885;Soltero;F;55;CHILENO;;Boomers;PROVIDENCIA                   ;METROPOLITANA;0;0;0;0;0;0;0;0;0;Licuadora TH-320 Roja/Negro 1,5 Lts Vaso Vidrio;ELECTRODOMESTICOS
6591186;;F;68;CHILENO;;Boomers;CARTAGENA                     ;VALPARAISO;0;0;0;0;0;0;0;0;0;Tostador de PanTH-120R 2 Rebanadas Rojo;ELECTRODOMESTICOS
11522036;;F;52;CHILENO;;X;SAN ANTONIO                   ;VALPARAISO;0;0;0;0;0;0;0;0;0;Horno Microondas Mecanico C1700N 17Lts Blanco;ELECTRODOMESTICOS
9173762;Casado;M;56;CHILENO;;Boomers;PROVIDENCIA                   ;METROPOLITANA;0;0;0;0;0;0;0;0;0;Horno Microondas Digital TH-25DM 25Lts;ELECTRODOMESTICOS
17064307;;F;33;CHILENO;;Silencioso;PROVIDENCIA                   ;METROPOLITANA;0;0;0;0;0;0;0;0;0;Robot aspirador Roomba 675;ELECTRODOMESTICOS
13387509;;M;43;CHILENO;;Silencioso;PROVIDENCIA                   ;METROPOLITANA;0;0;0;0;0;0;0;0;0;Batidora Manual BA-5010 Inox;ELECTRODOMESTICOS
17071253;;M;33;CHILENO;;Millenial;PUENTE ALTO;METROPOLITANA;0;0;0;0;0;0;0;0;0;ASPIRADORA THOMAS TH-1640;ELECTRODOMESTICOS
8436314;;F;62;CHILENO;;Boomers;RENCA                         ;METROPOLITANA;0;0;0;0;0;0;0;0;0;ASPIRADORA THOMAS TH-1640;ELECTRODOMESTICOS
8340187;Soltero;F;66;CHILENO;;Boomers;PROVIDENCIA                   ;METROPOLITANA;0;0;0;0;0;0;0;0;0;Extractor de Jugo EX800 1,4Lts;ELECTRODOMESTICOS
6079772;;F;72;CHILENO;;Silencioso;PROVIDENCIA                   ;METROPOLITANA;0;0;0;0;0;0;0;0;0;Horno Electrico TH-100i 100Lts;ELECTRODOMESTICOS
24990328;;M;40;PERUANO;;Extranjero;"";"";0;0;0;0;0;0;0;0;0;Horno Microondas Digital TH-20S01 20Lts;ELECTRODOMESTICOS
9639589;;F;55;CHILENO;;Boomers;HIJUELAS                      ;VALPARAISO;0;0;0;0;0;0;0;0;0;Batidora Manual TH-8830;ELECTRODOMESTICOS
16907037;;M;34;CHILENO;;Millenial;N/D;N/D;0;0;0;0;0;0;0;0;0;Horno Electrico UT-BACKOFEN26 26Lts;ELECTRODOMESTICOS
13324841;;F;45;CHILENO;;X;"";"";0;0;0;0;0;0;0;0;0;Procesador TH-9010 Multimixer 1,5Lts Vaso Vidrio;ELECTRODOMESTICOS
7193399;;F;64;CHILENO;;Boomers;HUECHURABA                    ;METROPOLITANA;0;0;0;0;0;0;0;0;0;Hervidor Electrico 388R Rojo;ELECTRODOMESTICOS
9565538;Casado;F;61;CHILENO;;Millenial;PROVIDENCIA                   ;METROPOLITANA;0;0;0;0;0;0;0;0;0;Horno Electrico TH-100i 100Lts;ELECTRODOMESTICOS
13615493;;M;43;CHILENO;;X;RETIRO                        ;MAULE;0;0;0;0;0;0;0;0;0;Licuadora TH-320 Roja/Negro 1,5 Lts Vaso Vidrio;ELECTRODOMESTICOS
18806608;Soltero;M;27;CHILENO;;Z;PROVIDENCIA                   ;METROPOLITANA;0;0;0;0;0;0;0;0;0;Olla Arrocera TH38IF 1,8Lts;ELECTRODOMESTICOS
8479389;Casado;F;64;CHILENO;;Boomers;RENCA                         ;METROPOLITANA;0;0;0;0;0;0;0;0;0;Horno Electrico TH-25N01 25Lts;ELECTRODOMESTICOS
27099286;;M;23;NO INFORMA NACIONALIDAD;;Extranjero;PROVIDENCIA                   ;METROPOLITANA;0;0;0;0;0;0;0;0;0;Horno Microondas Mecanico Easy Wave 20Lts;ELECTRODOMESTICOS
16262176;;F;39;CHILENO;;Millenial;"";"";0;0;0;0;0;0;0;0;0;TERMOHERVIDOR ELECTRON 3,1 LTS BA-6932 RG;ELECTRODOMESTICOS
16841335;;F;33;CHILENO;;Millenial;RENCA                         ;METROPOLITANA;0;0;0;0;0;0;0;0;0;Licuadora Roja 550W 1,5Lts Vaso Vidrio;ELECTRODOMESTICOS
26177782;;M;36;HAITIANO;;Extranjero;N/D;N/D;0;0;0;0;0;0;0;0;0;Plancha TH-7052 2000Watts Base Inox;ELECTRODOMESTICOS
14462278;Casado;F;51;CHILENO;;X;PROVIDENCIA                   ;METROPOLITANA;0;0;0;0;0;0;0;0;0;Licuadora L-1630V Negra 1,5Lts Vaso Vidrio;ELECTRODOMESTICOS
16067065;Casado;F;37;CHILENO;;Millenial;PROVIDENCIA                   ;METROPOLITANA;0;0;0;0;0;0;0;0;0;Horno Electrico TH-48N 48Lts;ELECTRODOMESTICOS
10882685;;F;54;CHILENO;;Silencioso;PROVIDENCIA                   ;METROPOLITANA;0;0;0;0;0;0;0;0;0;Picadora TH-9020V Vaso Vidrio 2Lts;ELECTRODOMESTICOS
19305626;Soltero;F;26;CHILENO;;Z;PROVIDENCIA                   ;METROPOLITANA;0;0;0;0;0;0;0;0;0;Aspiradora Polvo AP-700 GR;ELECTRODOMESTICOS
15882649;;M;50;CHILENO;;X;SAN BERNARDO                  ;METROPOLITANA;0;0;0;0;0;0;0;0;0;Procesador TH-9010 Multimixer 1,5Lts Vaso Vidrio;ELECTRODOMESTICOS
9898440;;F;54;CHILENO;;Boomers;RENCA                         ;METROPOLITANA;0;0;0;0;0;0;0;0;0;Hervidor Electrico UT-KLAR20PW 2Lts Blanco;ELECTRODOMESTICOS
11369446;Soltero;M;52;CHILENO;;X;RENCA                         ;METROPOLITANA;0;0;0;0;0;0;0;0;0;HERVIDOR TH-4340;ELECTRODOMESTICOS
17843798;Soltero;F;31;CHILENO;;Millenial;PROVIDENCIA                   ;METROPOLITANA;0;0;0;0;0;0;0;0;0;Horno Microondas Digital TH-20S01 20Lts;ELECTRODOMESTICOS
9181986;;F;63;CHILENO;;Boomers;LA SERENA                     ;COQUIMBO;0;0;0;0;0;0;0;0;0;Horno Electrico UT-BACKOFEN26 26Lts;ELECTRODOMESTICOS
8704451;;F;57;CHILENO;;Boomers;TALCA                         ;MAULE;0;0;0;0;0;0;0;0;0;Licuadora TH-320 Roja/Negro 1,5 Lts Vaso Vidrio;ELECTRODOMESTICOS
15960209;;F;37;CHILENO;;Millenial;PROVIDENCIA                   ;METROPOLITANA;0;0;0;0;0;0;0;0;0;Batidora Vertical Multimixer TH-8720;ELECTRODOMESTICOS
19387451;;F;25;CHILENO;;Silencioso;PROVIDENCIA                   ;METROPOLITANA;0;0;0;0;0;0;0;0;0;Horno Electrico TH62I 60Lts;ELECTRODOMESTICOS
14342774;;F;45;CHILENO;;X;SAN BERNARDO                  ;METROPOLITANA;0;0;0;0;0;0;0;0;0;Horno Electrico TH-16N 16Lts;ELECTRODOMESTICOS
19747749;;M;24;CHILENO;;Z;SANTIAGO                      ;METROPOLITANA;0;0;0;0;0;0;0;0;0;Licuadora Personal TH-300PB;ELECTRODOMESTICOS
11862832;Divorciado;F;53;CHILENO;;Silencioso;PROVIDENCIA                   ;METROPOLITANA;0;0;0;0;0;0;0;0;0;Horno Electrico TH-16N 16Lts;ELECTRODOMESTICOS
9398666;;F;59;CHILENO;;Boomers;PAINE                         ;METROPOLITANA;0;0;0;0;0;0;0;0;0;Aspiradora TH1870 Arrastre 1800Watts Gris;ELECTRODOMESTICOS
10513028;;F;56;CHILENO;;Boomers;N/D;N/D;0;0;0;0;0;0;0;0;0;Horno Electrico TH-25N01 25Lts;ELECTRODOMESTICOS
18658636;;M;28;CHILENO;;Millenial;N/D;N/D;0;0;0;0;0;0;0;0;0;Hervidor Electrico TH-4800 2Lts Negro Azul;ELECTRODOMESTICOS
10738126;;F;55;CHILENO;;Boomers;PROVIDENCIA                   ;METROPOLITANA;0;0;0;0;0;0;0;0;0;ASPIRADORA THOMAS TH-1640;ELECTRODOMESTICOS
12691167;;F;48;CHILENO;;X;RENCA                         ;METROPOLITANA;0;0;0;0;0;0;0;0;0;Horno Electrico UT-LEIF36 36Lts;ELECTRODOMESTICOS
11359137;;F;53;CHILENO;;X;LOS VILOS                     ;COQUIMBO;0;0;0;0;0;0;0;0;0;Plancha TH-7052 2000Watts Base Inox;ELECTRODOMESTICOS
10444769;;F;57;CHILENO;;Boomers;PUENTE ALTO                   ;METROPOLITANA;0;0;0;0;0;0;0;0;0;Horno Electrico TH-16N 16Lts;ELECTRODOMESTICOS
5144417;;F;80;CHILENO;;Silencioso;RENCA                         ;METROPOLITANA;0;0;0;0;0;0;0;0;0;Batidora Manual TH-8830;ELECTRODOMESTICOS
10498360;Casado;F;57;CHILENO;;Boomers;RENCA                         ;METROPOLITANA;0;0;0;0;0;0;0;0;0;Batidora Manual BA-5010 Inox;ELECTRODOMESTICOS
14173060;;M;41;CHILENO;;X;LAS CABRAS                    ;L.G.B.OÂ´HIGGINS;0;0;0;0;0;0;0;0;0;Horno Microondas Digital L UT-25KROMM 25Lts;ELECTRODOMESTICOS
16571742;;F;34;CHILENO;;Millenial;SAN BERNARDO                  ;METROPOLITANA;0;0;0;0;0;0;0;0;0;Aspiradora TH1870 Arrastre 1800Watts Gris;ELECTRODOMESTICOS
4877411;;F;75;CHILENO;;Silencioso;LOS ANDES                     ;VALPARAISO;0;0;0;0;0;0;0;0;0;Hervidor Electrico Tetera TH-6505RT 1,7Lts Rojo;ELECTRODOMESTICOS
12983532;;F;47;CHILENO;;X;RENCA                         ;METROPOLITANA;0;0;0;0;0;0;0;0;0;Horno Electrico UT-BACKOFEN48 48Lts;ELECTRODOMESTICOS
14608486;;F;48;CHILENO;;X;N/D;N/D;0;0;0;0;0;0;0;0;0;Maquina para Hacer Pan MPP-600 BL;ELECTRODOMESTICOS
17736024;Soltero;M;31;CHILENO;INGENIERIA EN MAQUINARIA PESADA Y VEHICULOS AUTOMOTRICES;Millenial;PROVIDENCIA                   ;METROPOLITANA;0;0;0;0;0;0;0;0;0;Hervidor Electrico TH-4212N 1,7Lts Negro;ELECTRODOMESTICOS
6656324;Casado;M;65;CHILENO;;Silencioso;PROVIDENCIA                   ;METROPOLITANA;0;0;0;0;0;0;0;0;0;Licuadora TH-401V Roja 1,75Lts Vaso Vidrio;ELECTRODOMESTICOS
6261259;;F;71;CHILENO;;Silencioso;OSORNO                        ;LOS LAGOS;0;0;0;0;0;0;0;0;0;Plancha THOMAS TH-7170 2200Watts Base Ceramica;ELECTRODOMESTICOS
18648898;;M;27;CHILENO;;Millenial;REQUINOA                      ;L.G.B.OÂ´HIGGINS;0;0;0;0;0;0;0;0;0;Hervidor Electrico TH-4212N 1,7Lts Negro;ELECTRODOMESTICOS
7543380;Casado;M;66;CHILENO;INGENIERO;Silencioso;PROVIDENCIA                   ;METROPOLITANA;0;0;0;0;0;0;0;0;0;Hervidor Electrico UT-MANLY17 1,7Lts Negro;ELECTRODOMESTICOS
14527116;;F;45;CHILENO;;X;SAGRADA FAMILIA               ;MAULE;0;0;0;0;0;0;0;0;0;Horno Electrico UT-LEIF36 36Lts;ELECTRODOMESTICOS
8200212;Casado;F;61;CHILENO;;Boomers;PROVIDENCIA                   ;METROPOLITANA;0;0;0;0;0;0;0;0;0;Horno Electrico UT-BACKOFEN60 60Lts;ELECTRODOMESTICOS
13558098;Soltero;F;43;CHILENO;;X;RENCA                         ;METROPOLITANA;0;0;0;0;0;0;0;0;0;Plancha UT-KERAMIK1 2200Watts Base Ceramica;ELECTRODOMESTICOS
13237388;;F;45;CHILENO;;X;N/D;N/D;0;0;0;0;0;0;0;0;0;Horno Microondas Mecanico C1700N 17Lts Blanco;ELECTRODOMESTICOS
9434022;;F;57;CHILENO;;Boomers;PROVIDENCIA                   ;N/D;0;0;0;0;0;0;0;0;0;BATIDORA INMERSION S MIX 2616;ELECTRODOMESTICOS
9571866;;M;57;CHILENO;;Boomers;PROVIDENCIA                   ;METROPOLITANA;0;0;0;0;0;0;0;0;0;ASPIRADORA AP-3600 EGR;ELECTRODOMESTICOS
5801411;Casado;M;70;CHILENO;;Silencioso;RENCA                         ;METROPOLITANA;0;0;0;0;0;0;0;0;0;Batidora Vertical Multimixer TH-8720;ELECTRODOMESTICOS
26396288;;F;28;VENEZOLANO;;Extranjero;LA CRUZ                       ;VALPARAISO;0;0;0;0;0;0;0;0;0;Batidora Manual TH-8830;ELECTRODOMESTICOS
8914944;;F;64;CHILENO;;Boomers;PERALILLO                     ;L.G.B.OÂ´HIGGINS;0;0;0;0;0;0;0;0;0;Hervidor Electrico 3100 1,7Lts Negro;ELECTRODOMESTICOS
17706281;;F;31;CHILENO;;Millenial;PROVIDENCIA                   ;METROPOLITANA;0;0;0;0;0;0;0;0;0;Aspiradora Polvo AP-700 GR;ELECTRODOMESTICOS
11688529;;F;52;CHILENO;;X;RENCA                         ;METROPOLITANA;0;0;0;0;0;0;0;0;0;Batidora Vertical BM-450 Negra;ELECTRODOMESTICOS
14038975;;F;41;CHILENO;;X;PROVIDENCIA                   ;METROPOLITANA;0;0;0;0;0;0;0;0;0;Licuadora TH-501V 1,5Lts Vaso Vidrio;ELECTRODOMESTICOS
13665562;;M;43;CHILENO;;X;SAN BERNARDO                  ;METROPOLITANA;0;0;0;0;0;0;0;0;0;Maquina de Coser Remington J011;ELECTRODOMESTICOS
8219333;;F;61;CHILENO;;Boomers;PROVIDENCIA                   ;METROPOLITANA;0;0;0;0;0;0;0;0;0;Aspiradora Polvo AP-700 GR;ELECTRODOMESTICOS
18838399;;M;27;CHILENO;;Millenial;PROVIDENCIA                   ;METROPOLITANA;0;0;0;0;0;0;0;0;0;HERVIDOR ELECTRICO UT-STARK18;ELECTRODOMESTICOS
13262254;;F;45;CHILENO;;X;"";"";0;0;0;0;0;0;0;0;0;PLANCHA VERTICAL V-1600VBL;ELECTRODOMESTICOS
18266540;;F;29;CHILENO;;Millenial;RENCA                         ;METROPOLITANA;0;0;0;0;0;0;0;0;0;Aspiradora UT-SILENT1603 Arrastre 1600Watts;ELECTRODOMESTICOS
10858177;;F;53;CHILENO;;X;RENCA                         ;METROPOLITANA;0;0;0;0;0;0;0;0;0;Aspiradora AP3400 Arrastre 2000Watts;ELECTRODOMESTICOS
17657537;;M;31;CHILENO;;Millenial;PROVIDENCIA                   ;METROPOLITANA;0;0;0;0;0;0;0;0;0;Plancha UT-KERAMIK1 2200Watts Base Ceramica;ELECTRODOMESTICOS
13431600;;M;43;CHILENO;;X;"";"";0;0;0;0;0;0;0;0;0;Licuadora Osterizer 4112/72 1,25Lts Vaso Vidrio;ELECTRODOMESTICOS
19082337;;F;27;CHILENO;;Z;VILLA ALEMANA                 ;VALPARAISO;0;0;0;0;0;0;0;0;0;Horno Electrico TH-25N01 25Lts;ELECTRODOMESTICOS
19695966;;F;25;CHILENO;;Z;PROVIDENCIA                   ;METROPOLITANA;0;0;0;0;0;0;0;0;0;Batidora Manual BA-5010 Inox;ELECTRODOMESTICOS
10427230;;F;57;CHILENO;;Boomers;COLINA                        ;METROPOLITANA;0;0;0;0;0;0;0;0;0;Hervidor Electrico TH-6200 R 1,7Lts Rojo;ELECTRODOMESTICOS
7727880;;M;67;CHILENO;;Boomers;ARICA                         ;ARICA Y PARINACOTA;0;0;0;0;0;0;0;0;0;Licuadora UT-METALLEK805R 1,75Lts Vaso Vidrio;ELECTRODOMESTICOS
13599391;;M;43;CHILENO;;X;RENCA                         ;METROPOLITANA;0;0;0;0;0;0;0;0;0;Set Picador KP-123BL 1,2Lts;ELECTRODOMESTICOS
11694171;Casado;M;51;CHILENO;INGENIERO MECANICO;X;PROVIDENCIA                   ;METROPOLITANA;0;0;0;0;0;0;0;0;0;Aspiradora UT-SILENT1804 Arrastre 1800Watts;ELECTRODOMESTICOS
13985719;;F;41;CHILENO;;X;PROVIDENCIA                   ;METROPOLITANA;0;0;0;0;0;0;0;0;0;Picadora P-123TOPBL 1,5Lts;ELECTRODOMESTICOS
13920391;;M;41;CHILENO;;X;N/D;N/D;0;0;0;0;0;0;0;0;0;Aspiradora Handy Clean Black 1400;ELECTRODOMESTICOS
9586756;Casado;M;58;CHILENO;;Boomers;PROVIDENCIA                   ;METROPOLITANA;0;0;0;0;0;0;0;0;0;Horno Electrico TH-25N01 25Lts;ELECTRODOMESTICOS
16973109;;F;34;CHILENO;;Millenial;PROVIDENCIA                   ;METROPOLITANA;0;0;0;0;0;0;0;0;0;Cafetera TH-138i;ELECTRODOMESTICOS
10428269;;F;57;CHILENO;;Boomers;SAN PEDRO                     ;METROPOLITANA;0;0;0;0;0;0;0;0;0;Horno Electrico TH-25N01 25Lts;ELECTRODOMESTICOS
17604707;;F;32;CHILENO;;Millenial;FRUTILLAR                     ;LOS LAGOS;0;0;0;0;0;0;0;0;0;Batidora Vertical Minipimer UT-KLOT400P;ELECTRODOMESTICOS
10261906;;F;55;CHILENO;;Boomers;SAN FABIAN                    ;BIO BIO;0;0;0;0;0;0;0;0;0;Licuadora TH-501V 1,5Lts Vaso Vidrio;ELECTRODOMESTICOS
5524753;;F;71;CHILENO;;Silencioso;TALCA                         ;MAULE;0;0;0;0;0;0;0;0;0;Plancha OSTER 4801T 1200Watts Base Ceramica;ELECTRODOMESTICOS
16901681;;M;34;CHILENO;;Millenial;LA FLORIDA                    ;METROPOLITANA;0;0;0;0;0;0;0;0;0;Aspiradora Polvo AP-700 GR;ELECTRODOMESTICOS
8305169;;M;64;CHILENO;;Boomers;COIHAIQUE                     ;AYSEN;0;0;0;0;0;0;0;0;0;Exprimidor Fauna 500 cc;ELECTRODOMESTICOS
16826125;;F;33;CHILENO;;Millenial;LUMACO                        ;ARAUCANIA;0;0;0;0;0;0;0;0;0;Hervidor Electrico HE420 2lts Negro;ELECTRODOMESTICOS
9487584;Casado;F;57;CHILENO;;Boomers;PROVIDENCIA                   ;METROPOLITANA;0;0;0;0;0;0;0;0;0;Licuadora TH-501V 1,5Lts Vaso Vidrio;ELECTRODOMESTICOS
14479628;;F;49;CHILENO;;X;PROVIDENCIA                   ;METROPOLITANA;0;0;0;0;0;0;0;0;0;Tostador de Pan TH-126 4 Rebanadas Negro;ELECTRODOMESTICOS
7921031;;M;65;CHILENO;;Boomers;CABILDO                       ;VALPARAISO;0;0;0;0;0;0;0;0;0;Licuadora UT-METALLEK805R 1,75Lts Vaso Vidrio;ELECTRODOMESTICOS
9955636;;F;56;CHILENO;;Boomers;ARICA                         ;ARICA Y PARINACOTA;0;0;0;0;0;0;0;0;0;Licuadora TH-501V 1,5Lts Vaso Vidrio;ELECTRODOMESTICOS
10711528;;M;52;CHILENO;;X;RENCA                         ;METROPOLITANA;0;0;0;0;0;0;0;0;0;PROCESADOR THOMAS TH-9160;ELECTRODOMESTICOS
11411842;Casado;F;53;CHILENO;;X;PROVIDENCIA                   ;METROPOLITANA;0;0;0;0;0;0;0;0;0;Licuadora TH-501V 1,5Lts Vaso Vidrio;ELECTRODOMESTICOS
16725681;Soltero;M;35;CHILENO;;Millenial;RENCA                         ;METROPOLITANA;0;0;0;0;0;0;0;0;0;Set Picador KP-123BL 1,2Lts;ELECTRODOMESTICOS
17070065;;F;33;CHILENO;;Millenial;COLINA                        ;METROPOLITANA;0;0;0;0;0;0;0;0;0;FREIDORA DE AIRE CKSTAF15B 1850W;ELECTRODOMESTICOS
9555200;;F;60;CHILENO;;Boomers;PROVIDENCIA                   ;METROPOLITANA;0;0;0;0;0;0;0;0;0;Hervidor Electrico Tetera UT-LECKER18R 1,8Lts;ELECTRODOMESTICOS
6938474;;F;69;CHILENO;;Silencioso;QUINTA NORMAL                 ;METROPOLITANA;0;0;0;0;0;0;0;0;0;Enceradora EA-5000;ELECTRODOMESTICOS
3917143;;F;82;CHILENO;;Silencioso;VILLA ALEMANA                 ;VALPARAISO;0;0;0;0;0;0;0;0;0;Combo Hervidor + Batidora;ELECTRODOMESTICOS
18348244;;F;30;CHILENO;;Millenial;YUMBEL;BIO-BIO;0;0;0;0;0;0;0;0;0;Horno Electrico TH-38N 38Lts;ELECTRODOMESTICOS
11279617;;F;53;CHILENO;;Extranjero;N/D;N/D;0;0;0;0;0;0;0;0;0;Licuadora L2000VNG 1,5Lts Vaso Vidrio;ELECTRODOMESTICOS
11934519;Casado;M;51;CHILENO;;X;RENCA                         ;METROPOLITANA;0;0;0;0;0;0;0;0;0;Aspiradora UT-SILENT1804 Arrastre 1800Watts;ELECTRODOMESTICOS
13613137;;F;42;CHILENO;;X;PROVIDENCIA                   ;METROPOLITANA;0;0;0;0;0;0;0;0;0;Licuadora TH-501V 1,5Lts Vaso Vidrio;ELECTRODOMESTICOS
9578576;Casado;M;58;CHILENO;PROGRAMADOR DE APLICACIONES COMPUTACIONALES;Boomers;RENCA                         ;METROPOLITANA;0;0;0;0;0;0;0;0;0;Hervidor Electrico TH-4350 3Lts Blanco;ELECTRODOMESTICOS
10143419;;M;55;CHILENO;;Boomers;PROVIDENCIA                   ;METROPOLITANA;0;0;0;0;0;0;0;0;0;Aspiradora Handy Clean Black 1400;ELECTRODOMESTICOS
18366052;;M;30;CHILENO;;Millenial;N/D;N/D;0;0;0;0;0;0;0;0;0;Batidora Vertical Multimixer TH-8735I;ELECTRODOMESTICOS
10651265;Casado;F;55;CHILENO;;Boomers;SAN FERNANDO                  ;L.G.B.OÂ´HIGGINS;0;0;0;0;0;0;0;0;0;Maquina de Coser ME9100;ELECTRODOMESTICOS
17460366;Soltero;F;32;CHILENO;;Millenial;PROVIDENCIA                   ;METROPOLITANA;0;0;0;0;0;0;0;0;0;Horno Microondas Mecanico Easy Wave 20Lts;ELECTRODOMESTICOS
16051927;;M;37;CHILENO;;Millenial;PROVIDENCIA                   ;METROPOLITANA;0;0;0;0;0;0;0;0;0;Hervidor Electrico TH-5407i 2Lts;ELECTRODOMESTICOS
10492828;;F;56;CHILENO;;Boomers;PROVIDENCIA                   ;METROPOLITANA;0;0;0;0;0;0;0;0;0;Aspiradora Trapeadora Robot Ut-Excellenza (B);ELECTRODOMESTICOS
9435646;;F;59;CHILENO;;Boomers;ARICA                         ;ARICA Y PARINACOTA;0;0;0;0;0;0;0;0;0;Horno Electrico TH-100i 100Lts;ELECTRODOMESTICOS
6706308;;F;72;CHILENO;;Silencioso;PROVIDENCIA                   ;METROPOLITANA;0;0;0;0;0;0;0;0;0;HERVIDOR TH-4340;ELECTRODOMESTICOS
19124760;;F;26;CHILENO;;Z;PROVIDENCIA                   ;METROPOLITANA;0;0;0;0;0;0;0;0;0;FREIDORA DE AIRE CKSTAF15B 1850W;ELECTRODOMESTICOS
11673299;;M;52;CHILENO;;X;SAN VICENTE                   ;L.G.B.OÂ´HIGGINS;0;0;0;0;0;0;0;0;0;Horno Electrico TH-48N 48Lts;ELECTRODOMESTICOS
15632168;;M;38;CHILENO;;Millenial;PROVIDENCIA                   ;METROPOLITANA;0;0;0;0;0;0;0;0;0;Horno Microondas Digital MS28F303TAS/ZS 28Lts;ELECTRODOMESTICOS
7994729;;F;71;CHILENO;;Silencioso;LEBU                          ;BIO BIO;0;0;0;0;0;0;0;0;0;Maquina de Coser ME9100;ELECTRODOMESTICOS
17965008;Soltero;M;30;CHILENO;;Millenial;PROVIDENCIA                   ;METROPOLITANA;0;0;0;0;0;0;0;0;0;Enceradora EA-5000;ELECTRODOMESTICOS
25555642;;F;43;PERUANO;;Extranjero;INDEPENDENCIA                 ;METROPOLITANA;0;0;0;0;0;0;0;0;0;Hervidor Electrico UT-KLAR20PW 2Lts Blanco;ELECTRODOMESTICOS
12954670;;M;46;CHILENO;;X;N/D;N/D;0;0;0;0;0;0;0;0;0;Batidora Vertical Multimixer TH-8720;ELECTRODOMESTICOS
18133344;;F;30;CHILENO;;Millenial;VALDIVIA                      ;LOS RIOS;0;0;0;0;0;0;0;0;0;Hervidor Electrico 3100 1,7Lts Negro;ELECTRODOMESTICOS
16455917;;F;35;CHILENO;;Millenial;SAN JAVIER                    ;MAULE;0;0;0;0;0;0;0;0;0;Exprimidor de Jugo CJ-2000 1Lts;ELECTRODOMESTICOS
11152731;;F;55;CHILENO;;Boomers;CORONEL                       ;BIO BIO;0;0;0;0;0;0;0;0;0;Batidora Pedestal TH910PN 4,6Lts 1300Watts;ELECTRODOMESTICOS
18701076;Soltero;F;28;CHILENO;;Millenial;PROVIDENCIA                   ;METROPOLITANA;0;0;0;0;0;0;0;0;0;Cafetera TH-141Di;ELECTRODOMESTICOS
7526369;;M;63;CHILENO;;Boomers;IQUIQUE                       ;TARAPACA;0;0;0;0;0;0;0;0;0;Maquina de Coser XB-2500CL Rosado;ELECTRODOMESTICOS
6985087;;F;68;CHILENO;;Silencioso;VILLARICA                     ;ARAUCANIA;0;0;0;0;0;0;0;0;0;Hervidor Electrico UT-MANLY17 1,7Lts Negro;ELECTRODOMESTICOS
11496154;;M;53;CHILENO;;X;CHIGUAYANTE                   ;BIO BIO;0;0;0;0;0;0;0;0;0;Cafetera UT-KAFFEEKLASSIK;ELECTRODOMESTICOS
8446688;Casado;F;63;CHILENO;;Boomers;RENCA                         ;METROPOLITANA;0;0;0;0;0;0;0;0;0;Hervidor Electrico TH-4212N 1,7Lts Negro;ELECTRODOMESTICOS
16820840;;F;34;CHILENO;;Millenial;PROVIDENCIA                   ;METROPOLITANA;0;0;0;0;0;0;0;0;0;Licuadora Berry Blender Roja 1400 Vaso Vidrio;ELECTRODOMESTICOS
16329598;Soltero;M;35;CHILENO;;Millenial;PROVIDENCIA                   ;METROPOLITANA;0;0;0;0;0;0;0;0;0;Hervidor Electrico UT-MANLY17 1,7Lts Negro;ELECTRODOMESTICOS
6831292;Casado;F;72;CHILENO;;Silencioso;PROVIDENCIA                   ;METROPOLITANA;0;0;0;0;0;0;0;0;0;Batidora Vertical Stick Mixer 2609;ELECTRODOMESTICOS
19215580;;M;26;CHILENO;;Z;CUREPTO                       ;MAULE;0;0;0;0;0;0;0;0;0;Aspiradora TH1415 Arrastre 1500Watts;ELECTRODOMESTICOS
9238359;Soltero;F;62;CHILENO;;Boomers;RENCA                         ;METROPOLITANA;0;0;0;0;0;0;0;0;0;Horno Electrico UT-BACKOFEN60 60Lts;ELECTRODOMESTICOS
26255381;;F;38;VENEZOLANO;;Extranjero;CHILLAN                       ;BIO BIO;0;0;0;0;0;0;0;0;0;Extractor de Jugo EX800 1,4Lts;ELECTRODOMESTICOS
7898845;;M;62;CHILENO;;Boomers;PROVIDENCIA                   ;METROPOLITANA;0;0;0;0;0;0;0;0;0;Horno Microondas Digital ME0113MB1/XZS 32Lts;ELECTRODOMESTICOS
8764390;;M;60;CHILENO;;Boomers;PROVIDENCIA                   ;METROPOLITANA;0;0;0;0;0;0;0;0;0;Hervidor Electrico UT-DUNKEL17P 2Lts Negro;ELECTRODOMESTICOS
13439970;;M;44;CHILENO;;X;PROVIDENCIA                   ;METROPOLITANA;0;0;0;0;0;0;0;0;0;Licuadora UT-METALLEK605P 1,55Lts;ELECTRODOMESTICOS
11413469;;F;53;CHILENO;;X;PROVIDENCIA                   ;METROPOLITANA;0;0;0;0;0;0;0;0;0;Hervidor Electrico HA-3300 2,5Lts Blanco;ELECTRODOMESTICOS
8762884;Casado;F;64;CHILENO;;Boomers;RENCA                         ;METROPOLITANA;0;0;0;0;0;0;0;0;0;Plancha GSTBS 5854 1600Watts Base Ceramica;ELECTRODOMESTICOS
6270905;;M;72;CHILENO;;Silencioso;RENCA                         ;METROPOLITANA;0;0;0;0;0;0;0;0;0;Batidora Pedestal TH910PN 4,6Lts 1300Watts;ELECTRODOMESTICOS
12448646;;M;49;CHILENO;;X;PROVIDENCIA                   ;METROPOLITANA;0;0;0;0;0;0;0;0;0;Licuadora L1000 Inox 1,7LtsVaso Vidrio;ELECTRODOMESTICOS
10106332;Viudo;M;55;CHILENO;;Boomers;RENCA                         ;METROPOLITANA;0;0;0;0;0;0;0;0;0;Batidora Pedestal UT-KLEIN700;ELECTRODOMESTICOS
6714157;;F;70;CHILENO;;Silencioso;SAN BERNARDO                  ;METROPOLITANA;0;0;0;0;0;0;0;0;0;Horno Electrico UT-BACKOFEN26 26Lts;ELECTRODOMESTICOS
18711356;;M;28;CHILENO;;Millenial;TALAGANTE                     ;METROPOLITANA;0;0;0;0;0;0;0;0;0;Horno Microondas Digital L UT-25KROMM 25Lts;ELECTRODOMESTICOS
10869917;;M;53;CHILENO;;X;CALAMA                        ;ANTOFAGASTA;0;0;0;0;0;0;0;0;0;Aspiradora UT-SILENT1804 Arrastre 1800Watts;ELECTRODOMESTICOS
11601901;;F;52;CHILENO;;X;LEBU                          ;BIO BIO;0;0;0;0;0;0;0;0;0;Horno Microondas Digital TH-20S01 20Lts;ELECTRODOMESTICOS
27052786;;F;32;VENEZOLANO;;Extranjero;PROVIDENCIA                   ;METROPOLITANA;0;0;0;0;0;0;0;0;0;Batidora Vertical Stick Mixer 2609;ELECTRODOMESTICOS
15962813;Casado;M;37;CHILENO;;Millenial;PROVIDENCIA                   ;METROPOLITANA;0;0;0;0;0;0;0;0;0;Batidora Vertical Stick Mixer 2609;ELECTRODOMESTICOS
12111843;Casado;M;50;CHILENO;AGROINDUSTRIA;X;PROVIDENCIA                   ;METROPOLITANA;0;0;0;0;0;0;0;0;0;Licuadora Roja 550W 1,5Lts Vaso Vidrio;ELECTRODOMESTICOS
7705022;;F;66;CHILENO;;Boomers;PUENTE ALTO                   ;METROPOLITANA;0;0;0;0;0;0;0;0;0;Licuadora Osterizer 4112/72 1,25Lts Vaso Vidrio;ELECTRODOMESTICOS
14285246;;F;48;CHILENO;;X;CURICO                        ;MAULE;0;0;0;0;0;0;0;0;0;Hervidor Electrico HA-3300 2,5Lts Blanco;ELECTRODOMESTICOS
6015797;Viudo;F;70;CHILENO;;Silencioso;PROVIDENCIA                   ;METROPOLITANA;0;0;0;0;0;0;0;0;0;Batidora Manual 2532;ELECTRODOMESTICOS
12186254;;F;49;CHILENO;;X;PROVIDENCIA                   ;METROPOLITANA;0;0;0;0;0;0;0;0;0;Horno Microondas Digital TH-20S01 20Lts;ELECTRODOMESTICOS
8469006;;F;59;CHILENO;;Boomers;PAINE                         ;METROPOLITANA;0;0;0;0;0;0;0;0;0;Maquina de Coser ST-371HD Heavy Duty;ELECTRODOMESTICOS
9123099;;M;57;CHILENO;;Boomers;PEDRO AGUIRRE CERDA           ;METROPOLITANA;0;0;0;0;0;0;0;0;0;Aspiradora Trapeadora Robot Ut-Excellenza (B);ELECTRODOMESTICOS
11455212;Casado;M;53;CHILENO;;X;PROVIDENCIA                   ;METROPOLITANA;0;0;0;0;0;0;0;0;0;Plancha OSTER 4801T 1200Watts Base Ceramica;ELECTRODOMESTICOS
13138714;;F;45;CHILENO;;X;CHILLAN                       ;BIO BIO;0;0;0;0;0;0;0;0;0;Licuadora Roja 550W 1,5Lts Vaso Vidrio;ELECTRODOMESTICOS
17078518;;M;34;CHILENO;;Millenial;RENCA                         ;METROPOLITANA;0;0;0;0;0;0;0;0;0;Licuadora BL-2000 Negra1,5 Lts Vaso Vidrio;ELECTRODOMESTICOS
17569470;Soltero;F;32;CHILENO;;Millenial;RENCA                         ;METROPOLITANA;0;0;0;0;0;0;0;0;0;Parrilla Electrica PE2650;ELECTRODOMESTICOS
12395160;;M;49;CHILENO;;X;RENCA                         ;METROPOLITANA;0;0;0;0;0;0;0;0;0;Batidora Manual 2532;ELECTRODOMESTICOS
6168932;;F;77;CHILENO;;Silencioso;RENCA                         ;METROPOLITANA;0;0;0;0;0;0;0;0;0;Picadora UT-PETRUS320 1Lts Vaso Vidrio;ELECTRODOMESTICOS
15065935;;F;40;CHILENO;;X;PANQUEHUE                     ;VALPARAISO;0;0;0;0;0;0;0;0;0;Plancha UT-KERAMIK1 2200Watts Base Ceramica;ELECTRODOMESTICOS
7444023;;F;67;CHILENO;;Boomers;PROVIDENCIA                   ;METROPOLITANA;0;0;0;0;0;0;0;0;0;Enceradora EA-5000;ELECTRODOMESTICOS
11746109;;F;51;CHILENO;;X;LINARES                       ;MAULE;0;0;0;0;0;0;0;0;0;Hervidor Electrico HA-3300 2,5Lts Blanco;ELECTRODOMESTICOS
9166566;;F;60;CHILENO;;Boomers;PROVIDENCIA                   ;METROPOLITANA;0;0;0;0;0;0;0;0;0;Horno Electrico TH-25N01 25Lts;ELECTRODOMESTICOS
12628268;;F;48;CHILENO;;X;PROVIDENCIA                   ;METROPOLITANA;0;0;0;0;0;0;0;0;0;Licuadora UT-METALLEK605P 1,55Lts;ELECTRODOMESTICOS
7689017;;F;67;CHILENO;;Boomers;SALAMANCA                     ;COQUIMBO;0;0;0;0;0;0;0;0;0;Horno Microondas Mecanico UT-SYDNEY18 18Lts;ELECTRODOMESTICOS
12280370;Casado;F;49;CHILENO;;X;RENCA                         ;METROPOLITANA;0;0;0;0;0;0;0;0;0;Licuadora UT-METALLEK605P 1,55Lts;ELECTRODOMESTICOS
6339511;Casado;M;73;CHILENO;;Silencioso;RENCA                         ;METROPOLITANA;0;0;0;0;0;0;0;0;0;Horno Electrico TH-25N01 25Lts;ELECTRODOMESTICOS
5167571;;M;73;CHILENO;;Extranjero;LONGAVI                       ;MAULE;0;0;0;0;0;0;0;0;0;Batidora Manual 2532;ELECTRODOMESTICOS
14524261;;F;47;CHILENO;;X;PROVIDENCIA                   ;METROPOLITANA;0;0;0;0;0;0;0;0;0;Horno Electrico TH62I 60Lts;ELECTRODOMESTICOS
4944221;;M;79;CHILENO;;Silencioso;RENCA                         ;METROPOLITANA;0;0;0;0;0;0;0;0;0;Horno Microondas Digital L UT-25KROMM 25Lts;ELECTRODOMESTICOS
16350175;;M;36;CHILENO;;Millenial;PROVIDENCIA                   ;METROPOLITANA;0;0;0;0;0;0;0;0;0;Batidora Vertical BM-450 Negra;ELECTRODOMESTICOS
11220915;;F;53;CHILENO;;X;COQUIMBO                      ;COQUIMBO;0;0;0;0;0;0;0;0;0;Exprimidor de Jugo TH-1215 1,5Lts;ELECTRODOMESTICOS
12845488;;M;47;CHILENO;;X;VINA DEL MAR                  ;VALPARAISO;0;0;0;0;0;0;0;0;0;Horno Electrico TH-100i 100Lts;ELECTRODOMESTICOS
15125975;;M;39;CHILENO;;X;PROVIDENCIA                   ;METROPOLITANA;0;0;0;0;0;0;0;0;0;Horno Electrico UT-BACKOFEN26 26Lts;ELECTRODOMESTICOS
15806793;;F;37;CHILENO;;Millenial;PROVIDENCIA                   ;METROPOLITANA;0;0;0;0;0;0;0;0;0;Horno Microondas Mecanico C1700N 17Lts Blanco;ELECTRODOMESTICOS
14733156;Soltero;F;48;PERUANO;;Extranjero;PROVIDENCIA                   ;METROPOLITANA;0;0;0;0;0;0;0;0;0;Batidora Vertical Multimixer TH-8715I Roja;ELECTRODOMESTICOS
9277670;;F;63;CHILENO;;Boomers;RENCA                         ;METROPOLITANA;0;0;0;0;0;0;0;0;0;Horno Electrico TH-25N01 25Lts;ELECTRODOMESTICOS
10612851;;F;55;CHILENO;;Boomers;RENCA                         ;METROPOLITANA;0;0;0;0;0;0;0;0;0;Hervidor Electrico Tetera HA-4100 4Lts Iox;ELECTRODOMESTICOS
13572443;Casado;F;43;CHILENO;;X;RENCA                         ;METROPOLITANA;0;0;0;0;0;0;0;0;0;Hervidor Electrico TH-4515N 2Lts Negro;ELECTRODOMESTICOS
19169234;Soltero;F;26;CHILENO;TECNICO DE NIVEL MEDIO EN ALIMENTACION;Z;PROVIDENCIA                   ;METROPOLITANA;0;0;0;0;0;0;0;0;0;Licuadora TH-320 Roja/Negro 1,5 Lts Vaso Vidrio;ELECTRODOMESTICOS
8720506;;M;63;CHILENO;;Boomers;RENCA                         ;METROPOLITANA;0;0;0;0;0;0;0;0;0;Horno Microondas Mecanico UT-SYDNEY18 18Lts;ELECTRODOMESTICOS
9188825;;F;62;CHILENO;;Boomers;RENCA                         ;METROPOLITANA;0;0;0;0;0;0;0;0;0;Licuadora TH-501V 1,5Lts Vaso Vidrio;ELECTRODOMESTICOS
12025467;;F;57;CHILENO;;Boomers;SAN JOAQUIN                   ;METROPOLITANA;0;0;0;0;0;0;0;0;0;Hervidor Electrico UT-MANLY17 1,7Lts Negro;ELECTRODOMESTICOS
13503637;Soltero;F;43;CHILENO;INGENIERO INDUSTRIAL;X;PROVIDENCIA                   ;METROPOLITANA;0;0;0;0;0;0;0;0;0;Horno Electrico UT-BACKOFEN26 26Lts;ELECTRODOMESTICOS
3764377;;F;84;CHILENO;;Silencioso;RENCA                         ;METROPOLITANA;0;0;0;0;0;0;0;0;0;Licuadora Personal TH-300PB;ELECTRODOMESTICOS
5055200;;F;74;CHILENO;;Silencioso;RENCA                         ;METROPOLITANA;0;0;0;0;0;0;0;0;0;Cafetera TH-138i;ELECTRODOMESTICOS
18368697;;M;30;CHILENO;;Millenial;PROVIDENCIA                   ;METROPOLITANA;0;0;0;0;0;0;0;0;0;Aspiradora UT-ZYKLON1402 Arrastre 1400Watts;ELECTRODOMESTICOS
7844761;;F;64;CHILENO;;Boomers;RENCA                         ;METROPOLITANA;0;0;0;0;0;0;0;0;0;Enceradora EA-5000;ELECTRODOMESTICOS
26113399;;F;26;VENEZOLANO;;Extranjero;SANTIAGO                      ;METROPOLITANA;0;0;0;0;0;0;0;0;0;Picadora TH-9020V Vaso Vidrio 2Lts;ELECTRODOMESTICOS
13067700;;F;46;CHILENO;;X;N/D;N/D;0;0;0;0;0;0;0;0;0;Plancha UT-KERAMIKTOP 2200Watts Base Ceramica;ELECTRODOMESTICOS
11970619;Soltero;F;49;CHILENO;;X;RENCA                         ;METROPOLITANA;0;0;0;0;0;0;0;0;0;Horno Electrico TH-16N 16Lts;ELECTRODOMESTICOS
6742054;;F;68;CHILENO;;Silencioso;LO PRADO                      ;METROPOLITANA;0;0;0;0;0;0;0;0;0;Plancha GSTBS 5854 1600Watts Base Ceramica;ELECTRODOMESTICOS
20394944;;F;22;CHILENO;;Z;PROVIDENCIA                   ;METROPOLITANA;0;0;0;0;0;0;0;0;0;Horno Electrico UT-BACKOFEN48 48Lts;ELECTRODOMESTICOS
17634051;;F;32;CHILENO;;Millenial;PROVIDENCIA                   ;METROPOLITANA;0;0;0;0;0;0;0;0;0;Plancha OSTER 4801T 1200Watts Base Ceramica;ELECTRODOMESTICOS
17214788;Soltero;M;32;CHILENO;;Millenial;PROVIDENCIA                   ;METROPOLITANA;0;0;0;0;0;0;0;0;0;Plancha OSTER 4801T 1200Watts Base Ceramica;ELECTRODOMESTICOS
6615436;Soltero;M;66;CHILENO;;Boomers;RENCA                         ;METROPOLITANA;0;0;0;0;0;0;0;0;0;Licuadora 4128 Cromada Cobre 1,25Lts Vaso Vidrio;ELECTRODOMESTICOS
12424074;;F;49;CHILENO;;X;FREIRINA                      ;ATACAMA;0;0;0;0;0;0;0;0;0;Horno Electrico TH-38N 38Lts;ELECTRODOMESTICOS
10426720;;M;52;CHILENO;;X;RENCA                         ;METROPOLITANA;0;0;0;0;0;0;0;0;0;Hervidor Electrico 3100 1,7Lts Negro;ELECTRODOMESTICOS
10149323;;F;56;CHILENO;;Boomers;ARICA                         ;ARICA Y PARINACOTA;0;0;0;0;0;0;0;0;0;H. ELECTRICO TH-35N02 35LTS;ELECTRODOMESTICOS
18238112;Soltero;M;30;CHILENO;;Millenial;PROVIDENCIA                   ;METROPOLITANA;0;0;0;0;0;0;0;0;0;Horno Electrico UT-LEIF36 36Lts;ELECTRODOMESTICOS
6303083;;F;69;CHILENO;;Silencioso;VILLA ALEMANA                 ;VALPARAISO;0;0;0;0;0;0;0;0;0;Horno Electrico UT-BACKOFEN26 26Lts;ELECTRODOMESTICOS
13840729;;M;41;CHILENO;;X;PUENTE ALTO                   ;METROPOLITANA;0;0;0;0;0;0;0;0;0;Licuadora TH-501V 1,5Lts Vaso Vidrio;ELECTRODOMESTICOS
6825861;;F;70;CHILENO;;Silencioso;RENCA                         ;METROPOLITANA;0;0;0;0;0;0;0;0;0;Batidora Vertical BM-450 Negra;ELECTRODOMESTICOS
8192038;Casado;F;62;CHILENO;;Boomers;PROVIDENCIA                   ;METROPOLITANA;0;0;0;0;0;0;0;0;0;Plancha UT-PLATTEISEN 2000Watts Base Ceramica;ELECTRODOMESTICOS
17166360;;M;33;CHILENO;;Millenial;PROVIDENCIA                   ;METROPOLITANA;0;0;0;0;0;0;0;0;0;Aspiradora Trapeadora Robot Ut-Excellenza (B);ELECTRODOMESTICOS
8636575;Soltero;F;65;CHILENO;;Boomers;ANGOL                         ;ARAUCANIA;0;0;0;0;0;0;0;0;0;Procesador TH-9010 Multimixer 1,5Lts Vaso Vidrio;ELECTRODOMESTICOS
10806866;;F;48;CHILENO;;X;PROVIDENCIA                   ;METROPOLITANA;0;0;0;0;0;0;0;0;0;Batidora Vertical Minipimer UT-KLOT400P;ELECTRODOMESTICOS
9549112;;F;62;CHILENO;;Boomers;VALLENAR;ATACAMA;0;0;0;0;0;0;0;0;0;Licuadora UT-METALLEK805R 1,75Lts Vaso Vidrio;ELECTRODOMESTICOS
12090705;Soltero;F;60;CHILENO;;Boomers;ZAPALLAR                      ;VALPARAISO;0;0;0;0;0;0;0;0;0;Licuadora TH-501V 1,5Lts Vaso Vidrio;ELECTRODOMESTICOS
10485785;Casado;F;49;CHILENO;PROFESOR;X;PROVIDENCIA                   ;METROPOLITANA;0;0;0;0;0;0;0;0;0;Batidora Manual BA-5010 Inox;ELECTRODOMESTICOS
15058120;;F;37;CHILENO;;Millenial;PETORCA                       ;VALPARAISO;0;0;0;0;0;0;0;0;0;Hervidor Electrico TH-4515N 2Lts Negro;ELECTRODOMESTICOS
5674463;;M;76;CHILENO;;Silencioso;PROVIDENCIA                   ;METROPOLITANA;0;0;0;0;0;0;0;0;0;Aspiradora UT-SILENT1804 Arrastre 1800Watts;ELECTRODOMESTICOS
18256458;;M;29;CHILENO;;Millenial;PROVIDENCIA                   ;METROPOLITANA;0;0;0;0;0;0;0;0;0;MAQUINA DE COSER OVERLOCK 14SH754;ELECTRODOMESTICOS
15111041;;F;38;CHILENO;;X;SAN VICENTE                   ;L.G.B.OÂ´HIGGINS;0;0;0;0;0;0;0;0;0;Combo Plancha Batidora Secador de Pelo;ELECTRODOMESTICOS
17758436;;M;31;CHILENO;;Millenial;PROVIDENCIA                   ;METROPOLITANA;0;0;0;0;0;0;0;0;0;Horno Microondas Digital TH-20S01 20Lts;ELECTRODOMESTICOS
6643673;;F;67;CHILENO;;Boomers;SAN CARLOS                    ;BIO BIO;0;0;0;0;0;0;0;0;0;Combo Hervidor + Tostador;ELECTRODOMESTICOS
19579577;;F;24;CHILENO;;Z;PROVIDENCIA                   ;METROPOLITANA;0;0;0;0;0;0;0;0;0;Horno Microondas Mecanico UT-SYDNEY18 18Lts;ELECTRODOMESTICOS
13870741;;M;42;CHILENO;;X;RENCA                         ;METROPOLITANA;0;0;0;0;0;0;0;0;0;Batidora Vertical Multimixer TH-8720;ELECTRODOMESTICOS
14007159;Soltero;F;43;CHILENO;EDUCADOR DE PARVULOS;X;MELIPILLA                     ;METROPOLITANA;0;0;0;0;0;0;0;0;0;Horno Electrico UT-BACKOFEN26 26Lts;ELECTRODOMESTICOS
7930555;;M;66;CHILENO;;Boomers;PROVIDENCIA                   ;METROPOLITANA;0;0;0;0;0;0;0;0;0;Licuadora L-1630V Negra 1,5Lts Vaso Vidrio;ELECTRODOMESTICOS
14408559;;M;49;CHILENO;;X;PROVIDENCIA                   ;METROPOLITANA;0;0;0;0;0;0;0;0;0;Horno Electrico TH-48N 48Lts;ELECTRODOMESTICOS
17313324;;F;32;CHILENO;;Millenial;PROVIDENCIA                   ;METROPOLITANA;0;0;0;0;0;0;0;0;0;Hervidor Termo TH-5440TK 1,5Lts Inox;ELECTRODOMESTICOS
14260613;Casado;F;48;CHILENO;;X;PROVIDENCIA                   ;METROPOLITANA;0;0;0;0;0;0;0;0;0;Aspiradora UT-MEINER1803 Arrastre 1800Watts;ELECTRODOMESTICOS
13559362;Soltero;M;43;CHILENO;TECNICO EN COMERCIO INTERNACIONAL;X;RENCA                         ;METROPOLITANA;0;0;0;0;0;0;0;0;0;Hervidor Electrico UT-DUNKEL17P 2Lts Negro;ELECTRODOMESTICOS
5314678;Casado;M;71;CHILENO;;Silencioso;RENCA                         ;METROPOLITANA;0;0;0;0;0;0;0;0;0;Hervidor Electrico TH-5407i 2Lts;ELECTRODOMESTICOS
7313313;;F;70;CHILENO;;Silencioso;PENAFLOR                      ;METROPOLITANA;0;0;0;0;0;0;0;0;0;Aspiradora TH1415 Arrastre 1500Watts;ELECTRODOMESTICOS
7476190;Casado;M;65;CHILENO;;Boomers;RANCAGUA                      ;L.G.B.OÂ´HIGGINS;0;0;0;0;0;0;0;0;0;Hervidor Electrico Tetera 487 1,8Lts Crema;ELECTRODOMESTICOS
17114082;Soltero;M;33;CHILENO;;Millenial;PROVIDENCIA                   ;METROPOLITANA;0;0;0;0;0;0;0;0;0;Hervidor Electrico TH-4800 2Lts Negro Azul;ELECTRODOMESTICOS
6378299;;F;66;CHILENO;;Boomers;LA REINA                      ;METROPOLITANA;0;0;0;0;0;0;0;0;0;Aspiradora VCC4190V3E/XZS Arrastre 2000Watts;ELECTRODOMESTICOS
10309266;;M;56;CHILENO;;Boomers;PROVIDENCIA                   ;METROPOLITANA;0;0;0;0;0;0;0;0;0;Exprimidor de Jugo TH-1215 1,5Lts;ELECTRODOMESTICOS
12948724;;F;46;CHILENO;;X;SAN FELIPE                    ;VALPARAISO;0;0;0;0;0;0;0;0;0;Horno Microondas Digital TH-20S01 20Lts;ELECTRODOMESTICOS
11072019;;F;56;CHILENO;;Boomers;PROVIDENCIA                   ;METROPOLITANA;0;0;0;0;0;0;0;0;0;Licuadora TH-320 Roja/Negro 1,5 Lts Vaso Vidrio;ELECTRODOMESTICOS
15969557;;M;37;CHILENO;;Millenial;N/D;N/D;0;0;0;0;0;0;0;0;0;Aspiradora UT-SILENT1603 Arrastre 1600Watts;ELECTRODOMESTICOS
11518979;;F;52;CHILENO;;X;PROVIDENCIA                   ;METROPOLITANA;0;0;0;0;0;0;0;0;0;Licuadora TH-501V 1,5Lts Vaso Vidrio;ELECTRODOMESTICOS
15146262;;F;39;CHILENO;;X;CONSTITUCION                  ;MAULE;0;0;0;0;0;0;0;0;0;Aspiradora UT-SILENT1804 Arrastre 1800Watts;ELECTRODOMESTICOS
25769303;;M;30;VENEZOLANO;;Extranjero;N/D;N/D;0;0;0;0;0;0;0;0;0;Licuadora BL-2000 Negra1,5 Lts Vaso Vidrio;ELECTRODOMESTICOS
10892885;;M;55;CHILENO;;Boomers;QUILLOTA                      ;VALPARAISO;0;0;0;0;0;0;0;0;0;Hervidor Electrico HA-3300 2,5Lts Blanco;ELECTRODOMESTICOS
10891269;;F;57;CHILENO;;Boomers;CURICO                        ;MAULE;0;0;0;0;0;0;0;0;0;Hervidor Electrico TH-4212N 1,7Lts Negro;ELECTRODOMESTICOS
19894873;;F;25;CHILENO;;Z;ALHUE                         ;METROPOLITANA;0;0;0;0;0;0;0;0;0;Aspiradora TH1407 Arrastre 1400Watts;ELECTRODOMESTICOS
5155096;;F;78;CHILENO;;Silencioso;RENCA                         ;METROPOLITANA;0;0;0;0;0;0;0;0;0;Hervidor Electrico TH-4212N 1,7Lts Negro;ELECTRODOMESTICOS
7120345;;F;65;CHILENO;;Boomers;PROVIDENCIA                   ;METROPOLITANA;0;0;0;0;0;0;0;0;0;Exprimidor de Jugo CJ-2000 1Lts;ELECTRODOMESTICOS
4739891;;F;85;CHILENO;;Silencioso;OVALLE                        ;COQUIMBO;0;0;0;0;0;0;0;0;0;Hervidor Electrico UT-KLAR20PW 2Lts Blanco;ELECTRODOMESTICOS
16917511;;F;34;CHILENO;;Millenial;PANGUIPULLI                   ;LOS RIOS;0;0;0;0;0;0;0;0;0;Aspiradora TH1870 Arrastre 1800Watts Gris;ELECTRODOMESTICOS
7369655;Divorciado;M;63;CHILENO;;Boomers;LO ESPEJO                     ;METROPOLITANA;0;0;0;0;0;0;0;0;0;Hervidor Electrico UT-MANLY17 1,7Lts Negro;ELECTRODOMESTICOS
13499780;;F;43;CHILENO;;X;EL BOSQUE                     ;METROPOLITANA;0;0;0;0;0;0;0;0;0;Aspiradora Tambor APA1000 1000Watts;ELECTRODOMESTICOS
10267558;;M;55;CHILENO;;Boomers;PROVIDENCIA                   ;METROPOLITANA;0;0;0;0;0;0;0;0;0;Licuadora TH-401V Roja 1,75Lts Vaso Vidrio;ELECTRODOMESTICOS
15143245;Soltero;M;39;CHILENO;;X;RENCA                         ;METROPOLITANA;0;0;0;0;0;0;0;0;0;Batidora Vertical Multimixer TH-8720;ELECTRODOMESTICOS
18141147;;F;30;CHILENO;;Millenial;CALDERA                       ;ATACAMA;0;0;0;0;0;0;0;0;0;Horno Microondas Digital TH-25DM 25Lts;ELECTRODOMESTICOS
8291998;;F;60;CHILENO;;Boomers;PROVIDENCIA                   ;METROPOLITANA;0;0;0;0;0;0;0;0;0;Licuadora UT-METALLEK805R 1,75Lts Vaso Vidrio;ELECTRODOMESTICOS
16704912;;F;34;CHILENO;;Millenial;N/D;N/D;0;0;0;0;0;0;0;0;0;Horno Microondas Digital TH-20S01 20Lts;ELECTRODOMESTICOS
6950447;Casado;F;67;CHILENO;;Boomers;TALCAHUANO                    ;BIO BIO;0;0;0;0;0;0;0;0;0;Exprimidor de Jugo CJ-2000 1Lts;ELECTRODOMESTICOS
7671728;Viudo;F;61;CHILENO;;Boomers;TALCAHUANO                    ;BIO BIO;0;0;0;0;0;0;0;0;0;Tostador de Pan TH-116 2 Rebanadas Negro;ELECTRODOMESTICOS
4120405;;F;84;CHILENO;;Silencioso;TALAGANTE                     ;METROPOLITANA;0;0;0;0;0;0;0;0;0;Hervidor Electrico UT-KLAR20PW 2Lts Blanco;ELECTRODOMESTICOS
9614469;;F;60;CHILENO;;Boomers;RENCA                         ;METROPOLITANA;0;0;0;0;0;0;0;0;0;Plancha 6201 2200Watts Base Ceramica;ELECTRODOMESTICOS
18949806;;M;27;CHILENO;;Z;PROVIDENCIA                   ;METROPOLITANA;0;0;0;0;0;0;0;0;0;Batidora Vertical Minipimer UT-KLOT400P;ELECTRODOMESTICOS
8201741;;F;67;CHILENO;;Boomers;CURICO                        ;MAULE;0;0;0;0;0;0;0;0;0;Hervidor Electrico TH-4515N 2Lts Negro;ELECTRODOMESTICOS
7219993;;F;67;CHILENO;;Boomers;PERALILLO                     ;L.G.B.OÂ´HIGGINS;0;0;0;0;0;0;0;0;0;Horno Electrico TH-48N 48Lts;ELECTRODOMESTICOS
10493681;;F;58;CHILENO;;Boomers;CONSTITUCION                  ;MAULE;0;0;0;0;0;0;0;0;0;Batidora Vertical Multimixer TH-8720;ELECTRODOMESTICOS
9911319;Casado;F;59;CHILENO;;Boomers;PROVIDENCIA                   ;METROPOLITANA;0;0;0;0;0;0;0;0;0;Licuadora 4661B-052 Negra 1,5Lts Vaso Vidrio;ELECTRODOMESTICOS
11580831;;F;52;CHILENO;;X;PROVIDENCIA                   ;METROPOLITANA;0;0;0;0;0;0;0;0;0;Plancha THOMAS TH-7170 2200Watts Base Ceramica;ELECTRODOMESTICOS
26778070;;M;35;VENEZOLANO;;Extranjero;LOS ANGELES                   ;BIO BIO;0;0;0;0;0;0;0;0;0;Licuadora 4128 Cromada Cobre 1,25Lts Vaso Vidrio;ELECTRODOMESTICOS
9622432;;F;60;CHILENO;;Boomers;RENCA                         ;METROPOLITANA;0;0;0;0;0;0;0;0;0;Combo Hervidor + Batidora;ELECTRODOMESTICOS
13786137;;F;41;CHILENO;;X;CONSTITUCION                  ;MAULE;0;0;0;0;0;0;0;0;0;Horno Electrico TH-38N 38Lts;ELECTRODOMESTICOS
13912151;;F;42;CHILENO;;X;CERRILLOS                     ;METROPOLITANA;0;0;0;0;0;0;0;0;0;Licuadora 4661W-052 Blanca 1,5Lts Vaso Vidrio;ELECTRODOMESTICOS
14213727;;M;40;CHILENO;;X;PROVIDENCIA                   ;METROPOLITANA;0;0;0;0;0;0;0;0;0;Hervidor Electrico TH-4212N 1,7Lts Negro;ELECTRODOMESTICOS
20103218;;M;24;CHILENO;;Z;ARICA                         ;ARICA Y PARINACOTA;0;0;0;0;0;0;0;0;0;Horno Electrico TH-38N 38Lts;ELECTRODOMESTICOS
17438714;;M;33;CHILENO;;Millenial;ANTOFAGASTA                   ;ANTOFAGASTA;0;0;0;0;0;0;0;0;0;Horno Microondas Mecanico Easy Wave 20Lts;ELECTRODOMESTICOS
15938812;;F;38;CHILENO;;Millenial;RENCA                         ;METROPOLITANA;0;0;0;0;0;0;0;0;0;Horno Electrico TH-25N01 25Lts;ELECTRODOMESTICOS
9918128;;F;55;CHILENO;;Boomers;TENO                          ;MAULE;0;0;0;0;0;0;0;0;0;Plancha TH-7052 2000Watts Base Inox;ELECTRODOMESTICOS
9660501;;F;60;CHILENO;;Boomers;MAIPU                         ;METROPOLITANA;0;0;0;0;0;0;0;0;0;Combo Juguera + Hervidor;ELECTRODOMESTICOS
16304584;;M;36;CHILENO;;Millenial;ARAUCO                        ;BIO BIO;0;0;0;0;0;0;0;0;0;Combo Juguera + Hervidor;ELECTRODOMESTICOS
7849417;Soltero;M;63;CHILENO;;Boomers;PROVIDENCIA                   ;METROPOLITANA;0;0;0;0;0;0;0;0;0;Horno Microondas Digital UT-CLASSY720 20Lts;ELECTRODOMESTICOS
19766332;;M;23;CHILENO;;Z;PROVIDENCIA                   ;METROPOLITANA;0;0;0;0;0;0;0;0;0;Parrilla Electrica 3006;ELECTRODOMESTICOS
6765876;;M;67;CHILENO;;Boomers;N/D;N/D;0;0;0;0;0;0;0;0;0;Aspiradora UT-SILENT1804 Arrastre 1800Watts;ELECTRODOMESTICOS
14376200;;F;47;CHILENO;;X;N/D;N/D;0;0;0;0;0;0;0;0;0;Cafetera UT-KAFFEEKLASSIK;ELECTRODOMESTICOS
15620337;;M;38;CHILENO;;X;PROVIDENCIA                   ;METROPOLITANA;0;0;0;0;0;0;0;0;0;Hervidor Termo HA-3600 1,5Lts Inox;ELECTRODOMESTICOS
7242015;;F;68;CHILENO;;Boomers;RANCAGUA                      ;L.G.B.OÂ´HIGGINS;0;0;0;0;0;0;0;0;0;Horno Electrico TH-25N01 25Lts;ELECTRODOMESTICOS
19823273;;M;24;CHILENO;;X;SAN CARLOS                    ;BIO BIO;0;0;0;0;0;0;0;0;0;Aspiradora UT-SILENT1804 Arrastre 1800Watts;ELECTRODOMESTICOS
7133070;;F;65;CHILENO;;Boomers;RENCA                         ;METROPOLITANA;0;0;0;0;0;0;0;0;0;Aspiradora AP2700 Arrastre 1750Watts Gris;ELECTRODOMESTICOS
18029005;Soltero;F;29;CHILENO;;Millenial;CONSTITUCION                  ;MAULE;0;0;0;0;0;0;0;0;0;Aspiradora UT-SILENT1804 Arrastre 1800Watts;ELECTRODOMESTICOS
20017083;;F;23;CHILENO;;Millenial;"";"";0;0;0;0;0;0;0;0;0;Licuadora TH-320 Roja/Negro 1,5 Lts Vaso Vidrio;ELECTRODOMESTICOS
9705410;;M;52;CHILENO;;X;EL MONTE                      ;METROPOLITANA;0;0;0;0;0;0;0;0;0;Aspiradora TH1407 Arrastre 1400Watts;ELECTRODOMESTICOS
11623613;;F;56;CHILENO;;Boomers;VILLA ALEMANA                 ;VALPARAISO;0;0;0;0;0;0;0;0;0;Horno Microondas Digital TH-25DM 25Lts;ELECTRODOMESTICOS
12072713;Casado;F;48;CHILENO;;X;PROVIDENCIA                   ;METROPOLITANA;0;0;0;0;0;0;0;0;0;Horno Electrico UT-BACKOFEN60 60Lts;ELECTRODOMESTICOS
5740459;;F;72;CHILENO;;Silencioso;RENCA                         ;METROPOLITANA;0;0;0;0;0;0;0;0;0;Horno Microondas Digital UT-CLASSY720 20Lts;ELECTRODOMESTICOS
16037912;;F;37;CHILENO;;Millenial;SAN FERNANDO                  ;L.G.B.OÂ´HIGGINS;0;0;0;0;0;0;0;0;0;Aspiradora TH1870 Arrastre 1800Watts Gris;ELECTRODOMESTICOS
15504507;;F;39;CHILENO;;X;"";"";0;0;0;0;0;0;0;0;0;Aspiradora UT-MEINER1803 Arrastre 1800Watts;ELECTRODOMESTICOS
17028245;Soltero;M;33;CHILENO;INGENIERO;Millenial;PROVIDENCIA                   ;METROPOLITANA;0;0;0;0;0;0;0;0;0;TOSTADOR ELECTRICO UT-ECKART2;ELECTRODOMESTICOS
15517357;;F;39;CHILENO;;X;N/D;N/D;0;0;0;0;0;0;0;0;0;CORTA FIAMBRES TH-9200;ELECTRODOMESTICOS
9456407;;M;60;CHILENO;;Boomers;PROVIDENCIA                   ;METROPOLITANA;0;0;0;0;0;0;0;0;0;Plancha OSTER 4801T 1200Watts Base Ceramica;ELECTRODOMESTICOS
14264538;;M;50;CHILENO;;X;RENCA                         ;METROPOLITANA;0;0;0;0;0;0;0;0;0;Licuadora TH-320 Roja/Negro 1,5 Lts Vaso Vidrio;ELECTRODOMESTICOS
8642559;Soltero;F;61;CHILENO;;Boomers;RENCA                         ;METROPOLITANA;0;0;0;0;0;0;0;0;0;Horno Electrico TH-25N01 25Lts;ELECTRODOMESTICOS
4107877;;F;81;CHILENO;;Silencioso;MARIA PINTO                   ;METROPOLITANA;0;0;0;0;0;0;0;0;0;Hervidor Electrico TH-4800 2Lts Negro Azul;ELECTRODOMESTICOS
19271728;;F;26;CHILENO;;Z;PROVIDENCIA                   ;METROPOLITANA;0;0;0;0;0;0;0;0;0;Horno Electrico TH-25N01 25Lts;ELECTRODOMESTICOS
26312209;Soltero;M;38;HAITIANO;;Extranjero;MACUL                         ;METROPOLITANA;187500;2;1;0;0;0;2;1;187500;MINICOMPONENTE CJ45;ELECTRONICA MAYOR
26214731;;F;46;VENEZOLANO;;Extranjero;"";"";319980;2;2;0;0;0;2;2;319980;LED SAMSUNG 50 AU7090 CRYSTAL UHD 4K SMART TV 20;ELECTRONICA MAYOR
20929883;;M;20;CHILENO;;Z;LEBU                          ;BIO BIO;1688120;35;32;2;1;265840;33;31;1422280;LED 40 KEHD4020 SMART TV;ELECTRONICA MAYOR
18285924;;M;29;CHILENO;;Millenial;EL MONTE                      ;METROPOLITANA;679890;10;6;3;1;112960;7;5;566930;PARLANTE SENSEIGTH K3175;ELECTRONICA MAYOR
17211494;;M;33;CHILENO;;Millenial;CONSTITUCION                  ;MAULE;143396;4;2;0;0;0;4;2;143396;PARLANTE SCREAMER 5;ELECTRONICA MAYOR
17518623;;F;32;CHILENO;;Millenial;TALAGANTE                     ;METROPOLITANA;1186890;11;7;6;4;817940;5;3;368950;LED PHILIPS 43 43PUD7406 ANDROID TV UHD 4K;ELECTRONICA MAYOR
8686108;;F;60;CHILENO;;Boomers;VILLA ALEGRE                  ;MAULE;1042960;7;4;0;0;0;7;4;1042960;PARLANTE ULTRA BOOSTER Z2;ELECTRONICA MAYOR
15401804;Casado;F;40;CHILENO;;X;PROVIDENCIA                   ;METROPOLITANA;139990;1;1;0;0;0;1;1;139990;PARLANTE ULTRABUZZ;ELECTRONICA MAYOR
15384905;;M;39;CHILENO;;X;CATEMU                        ;VALPARAISO;3546899;104;64;0;0;0;104;64;3546899;POP CORN MAKER;ELECTRONICA MAYOR
16078406;;F;35;CHILENO;;Millenial;N/D;N/D;439970;3;5;1;1;219990;2;4;219980;LED 55 KEUH5521 SMART TV UHD;ELECTRONICA MAYOR
14054425;;F;41;CHILENO;;X;CONSTITUCION                  ;MAULE;532915;18;12;0;0;0;18;12;532915;PARLANTE ULTRABUZZ;ELECTRONICA MAYOR
15751934;;F;38;CHILENO;;Millenial;QUILPUE                       ;VALPARAISO;391880;6;3;0;0;0;6;3;391880;LED 55 KEUH5521 SMART TV UHD;ELECTRONICA MAYOR
11565140;;M;51;CHILENO;;X;LONGAVI                       ;MAULE;200222;2;1;0;0;0;2;1;200222;LED 50 KEUH50 SMART TV UHD;ELECTRONICA MAYOR
6784255;;F;79;CHILENO;;Silencioso;PUNTA ARENAS                  ;MAGALLANES;139990;1;1;0;0;0;1;1;139990;LED 32 32S5305 HD HDR10/HLG;ELECTRONICA MAYOR
17154490;Soltero;M;33;CHILENO;;Millenial;LAS CONDES                    ;METROPOLITANA;173980;2;1;2;1;173980;0;0;0;LED 40 KEHD4020 SMART TV;ELECTRONICA MAYOR
6214873;;M;73;CHILENO;;Silencioso;LLAILLAY                      ;VALPARAISO;355720;4;2;0;0;0;4;2;355720;LED 32 UN32T4300AGXZS HD SMART TV;ELECTRONICA MAYOR
10178192;;M;54;CHILENO;;Boomers;NATALES                       ;MAGALLANES;648490;6;8;0;0;0;6;8;648490;LED SAMSUNG 50 AU7090 CRYSTAL UHD 4K SMART TV 20;ELECTRONICA MAYOR
13127773;;M;45;CHILENO;;X;COIHUECO                      ;BIO BIO;1518130;25;15;0;0;0;25;15;1518130;LED 55 KEUH5521 SMART TV UHD;ELECTRONICA MAYOR
17033960;;M;33;CHILENO;;Millenial;PROVIDENCIA                   ;METROPOLITANA;120980;2;1;2;1;120980;0;0;0;LED 32 32PHD6825 HD SMART TV;ELECTRONICA MAYOR
6605596;;F;70;CHILENO;;Silencioso;ARAUCO                        ;BIO BIO;784380;13;8;0;0;0;13;8;784380;LED 40 KEHD4020 SMART TV;ELECTRONICA MAYOR
19807221;;M;24;CHILENO;;Z;TALCA                         ;MAULE;308982;2;1;0;0;0;2;1;308982;LED 55 KEUH5521 SMART TV UHD;ELECTRONICA MAYOR
12738619;;M;53;CHILENO;;X;TIRUA                         ;BIO BIO;295721;4;2;0;0;0;4;2;295721;LED KIOTO 32 MI3228 SMART TV;ELECTRONICA MAYOR
13854480;;M;42;CHILENO;;X;NATALES                       ;MAGALLANES;1037480;11;6;0;0;0;11;6;1037480;LED 32 32S60-32P ANDROID TV SMART LINE HD;ELECTRONICA MAYOR
19310500;Soltero;F;26;CHILENO;;Z;PROVIDENCIA                   ;METROPOLITANA;679970;3;2;2;1;279980;1;1;399990;LED SAMSUNG 50 AU7090 CRYSTAL UHD 4K SMART TV 20;ELECTRONICA MAYOR
14043373;;M;42;CHILENO;;X;COIHAIQUE                     ;AYSEN;308873;3;2;0;0;0;3;2;308873;LED SAMSUNG 43 UN43AU7090GXZS SMART TV UHD 4K;ELECTRONICA MAYOR
20497276;;F;21;CHILENO;;Z;PROVIDENCIA                   ;METROPOLITANA;118980;2;1;2;1;118980;0;0;0;LED 32 32PHD6825 HD SMART TV;ELECTRONICA MAYOR
18989154;Soltero;M;27;CHILENO;;Z;PROVIDENCIA                   ;METROPOLITANA;197500;2;1;0;0;0;2;1;197500;MINICOMPONENTE CJ45;ELECTRONICA MAYOR
13846694;;M;42;CHILENO;;X;PROVIDENCIA                   ;METROPOLITANA;347970;3;5;3;5;347970;0;0;0;LED SAMSUNG 50 AU7090 CRYSTAL UHD 4K SMART TV 20;ELECTRONICA MAYOR
16842202;;M;33;CHILENO;;Millenial;CHONCHI                       ;LOS LAGOS;582960;4;3;0;0;0;4;3;582960;LED 32 UN32T4300AGXZS HD SMART TV;ELECTRONICA MAYOR
11943524;;F;50;CHILENO;;X;CABILDO                       ;VALPARAISO;203730;4;2;0;0;0;4;2;203730;PARLANTE SCREAMER 4;ELECTRONICA MAYOR
9065019;;F;63;CHILENO;;Boomers;RANCAGUA                      ;L.G.B.OÂ´HIGGINS;1020446;8;5;0;0;0;8;5;1020446;LED 50 KEUH50 SMART TV UHD;ELECTRONICA MAYOR
6401720;;M;70;CHILENO;;Silencioso;VALPARAISO                    ;VALPARAISO;109990;1;1;0;0;0;1;1;109990;LED 32 32PHD6825 HD SMART TV;ELECTRONICA MAYOR
13108574;;F;46;CHILENO;;X;"";"";305950;5;5;1;1;189990;4;4;115960;LED 43 43S5195 ROKU TV FHD;ELECTRONICA MAYOR
16793331;Soltero;M;34;CHILENO;;Millenial;PROVIDENCIA                   ;METROPOLITANA;136980;2;1;0;0;0;2;1;136980;LED KIOTO 32 MI3228 SMART TV;ELECTRONICA MAYOR
10617040;Casado;M;52;CHILENO;TECNICO EN CONSTRUCCION;X;PROVIDENCIA                   ;METROPOLITANA;37970;3;1;3;1;37970;0;0;0;MAGIC REMOTE MR21G;ELECTRONICA MAYOR
11781430;Casado;M;50;CHILENO;TECNICO FORESTAL;X;TEMUCO                        ;ARAUCANIA;299990;1;1;0;0;0;1;1;299990;LED SAMSUNG 43 UN43AU7090GXZS SMART TV UHD 4K;ELECTRONICA MAYOR
11844941;;M;51;CHILENO;;X;MAIPU                         ;METROPOLITANA;433830;8;5;0;0;0;8;5;433830;PARLANTE SCREAMER 5;ELECTRONICA MAYOR
11962879;;F;49;CHILENO;;X;N/D;N/D;292970;3;2;2;1;237980;1;1;54990;PARLANTE SCREAMER 4;ELECTRONICA MAYOR
24577573;;F;61;PERUANO;;Extranjero;N/D;N/D;550360;11;4;0;0;0;11;4;550360;LED 43 43LM6370 SMART TV FHD;ELECTRONICA MAYOR
13728328;;M;42;CHILENO;;Z;CALAMA                        ;ANTOFAGASTA;189990;1;1;1;1;189990;0;0;0;LED 50 KEUH50 SMART TV UHD;ELECTRONICA MAYOR
10315756;;F;58;CHILENO;;Boomers;PROVIDENCIA                   ;METROPOLITANA;328430;3;1;0;0;0;3;1;328430;LED PHILIPS 43 43PUD7406 ANDROID TV UHD 4K;ELECTRONICA MAYOR
18284130;;M;29;CHILENO;;Millenial;N/D;N/D;264980;2;2;0;0;0;2;2;264980;PARLANTE MEGALUX K2777;ELECTRONICA MAYOR
26484743;;M;30;VENEZOLANO;;Extranjero;N/D;N/D;956302;7;4;0;0;0;7;4;956302;LED 55 55P615 UHD ANDROID TV 4K;ELECTRONICA MAYOR
10799772;;M;56;CHILENO;;Boomers;PROVIDENCIA                   ;METROPOLITANA;303980;3;1;3;1;303980;0;0;0;LED 40 KEHD4020 SMART TV;ELECTRONICA MAYOR
10263783;;M;49;CHILENO;;X;AISEN                         ;AYSEN;209990;1;1;0;0;0;1;1;209990;LED 40 KEHD4020 SMART TV;ELECTRONICA MAYOR
12038909;Soltero;M;55;CHILENO;;Boomers;RENCA                         ;METROPOLITANA;319990;1;1;0;0;0;1;1;319990;LED SAMSUNG 43 UN43AU7090GXZS SMART TV UHD 4K;ELECTRONICA MAYOR
11246607;;M;54;CHILENO;;X;PROVIDENCIA                   ;METROPOLITANA;379990;1;1;0;0;0;1;1;379990;LED SAMSUNG 55 4K UHD SMART TV UN55AU7090GXZS;ELECTRONICA MAYOR
10240222;;F;63;CHILENO;;Boomers;TIRUA                         ;BIO BIO;414890;2;1;0;0;0;2;1;414890;LED SAMSUNG 50 AU7090 CRYSTAL UHD 4K SMART TV 20;ELECTRONICA MAYOR
20211212;;M;23;CHILENO;;Z;CATEMU;VALPARAISO;228360;2;1;0;0;0;2;1;228360;LED 42 KHFH4221 SMART TV;ELECTRONICA MAYOR
8018205;Casado;M;62;CHILENO;;Boomers;RENCA                         ;METROPOLITANA;159990;1;1;1;1;159990;0;0;0;LED 42 42S6500 ANDROID TV FHD;ELECTRONICA MAYOR
9423873;;F;61;CHILENO;;Boomers;QUILLOTA                      ;VALPARAISO;983491;8;4;0;0;0;8;4;983491;LED SAMSUNG 50 AU7090 CRYSTAL UHD 4K SMART TV 20;ELECTRONICA MAYOR
17855526;;M;31;CHILENO;;Millenial;COIHAIQUE                     ;AYSEN;175970;3;3;0;0;0;3;3;175970;LED KIOTO 32 MI3228 SMART TV;ELECTRONICA MAYOR
12473192;;F;49;CHILENO;;X;SANTIAGO                      ;METROPOLITANA;103980;2;1;2;1;103980;0;0;0;LED 32 32PHD6825 HD SMART TV;ELECTRONICA MAYOR
10348520;;M;54;CHILENO;;X;NATALES                       ;MAGALLANES;2452640;17;15;0;0;0;17;15;2452640;LED 50 NanoCell 50NANO80 UHD SMART + MAGIC;ELECTRONICA MAYOR
20784990;;M;21;CHILENO;;Extranjero;PROVIDENCIA                   ;N/D;163980;2;1;2;1;163980;0;0;0;MINICOMPONENTE RN7;ELECTRONICA MAYOR
12759620;Casado;F;47;CHILENO;;X;PROVIDENCIA                   ;N/D;219990;1;1;0;0;0;1;1;219990;LED 43 43S5195 ROKU TV FHD;ELECTRONICA MAYOR
16043426;Casado;F;37;CHILENO;;Millenial;RENCA                         ;METROPOLITANA;103980;2;1;2;1;103980;0;0;0;LED 32 32PHD6825 HD SMART TV;ELECTRONICA MAYOR
10006389;;F;57;CHILENO;;Boomers;PETORCA                       ;VALPARAISO;375960;4;3;0;0;0;4;3;375960;LED 32 AOC ROKU TV HD 32S5195;ELECTRONICA MAYOR
19054395;Soltero;F;27;CHILENO;;Z;PROVIDENCIA                   ;METROPOLITANA;168980;2;1;2;1;168980;0;0;0;LED 32 32S60-32P ANDROID TV SMART LINE HD;ELECTRONICA MAYOR
9485337;;M;58;CHILENO;;Boomers;CAUQUENES                     ;MAULE;341690;5;2;0;0;0;5;2;341690;PARLANTE SCREAMER 3;ELECTRONICA MAYOR
16118166;;F;36;CHILENO;;Millenial;VILLARRICA;ARAUCANIA;85982;2;1;0;0;0;2;1;85982;KARAOKE 15 HEAVY BASS MIC INA CON ATRIL 8892;ELECTRONICA MAYOR
10917910;;F;57;CHILENO;;Boomers;PARRAL                        ;MAULE;186983;2;2;0;0;0;2;2;186983;PARLANTE SCREAMER 3;ELECTRONICA MAYOR
8744205;;M;63;CHILENO;;Boomers;CHILLAN                       ;BIO BIO;888440;6;2;0;0;0;6;2;888440;LED 40 KEHD4020 SMART TV;ELECTRONICA MAYOR
12667005;;F;48;CHILENO;;X;MAIPU                         ;METROPOLITANA;0;0;2;0;0;0;0;2;0;LED 50 50P615-50P ANDROID TV PASSION LINE UHD 4K;ELECTRONICA MAYOR
7739285;;M;73;CHILENO;;Silencioso;TOCOPILLA                     ;ANTOFAGASTA;249960;4;2;0;0;0;4;2;249960;LED 32 32PHD6825 HD SMART TV;ELECTRONICA MAYOR
11929202;Soltero;M;50;CHILENO;;X;RENCA                         ;METROPOLITANA;42720;2;1;0;0;0;2;1;42720;PARLANTE SCREAMER 3;ELECTRONICA MAYOR
10510505;;F;60;CHILENO;;Boomers;QUELLON                       ;LOS LAGOS;4873750;44;13;0;0;0;44;13;4873750;LED 42 42S6500 ANDROID TV FHD;ELECTRONICA MAYOR
20013727;;M;23;CHILENO;;Z;VILLA ALEMANA                 ;VALPARAISO;195880;8;4;5;2;96940;3;2;98940;PARLANTE SCREAMER 4;ELECTRONICA MAYOR
9936882;;M;57;CHILENO;;Boomers;SANTA CRUZ                    ;L.G.B.OÂ´HIGGINS;157980;3;2;0;0;0;3;2;157980;2a ELECTRONICA MAYOR;ELECTRONICA MAYOR
12135610;;F;57;CHILENO;;Boomers;"";"";237740;2;1;0;0;0;2;1;237740;LED 40 KEHD4020 SMART TV;ELECTRONICA MAYOR
19992059;;F;24;CHILENO;;Z;ANGOL                         ;ARAUCANIA;512265;24;16;1;1;159990;23;15;352275;PARLANTE ULTRAMEGA;ELECTRONICA MAYOR
13806831;;M;42;CHILENO;;X;PROVIDENCIA                   ;METROPOLITANA;388550;4;3;0;0;0;4;3;388550;PARLANTE SCREAMER 4;ELECTRONICA MAYOR
6275071;;M;70;CHILENO;;Silencioso;EL CARMEN                     ;BIO BIO;270730;3;3;0;0;0;3;3;270730;LED 42 42S6500 ANDROID TV FHD;ELECTRONICA MAYOR
6446031;;F;67;CHILENO;;Boomers;LAS CONDES                    ;METROPOLITANA;200970;3;3;0;0;0;3;3;200970;LED KIOTO 32 MI3228 SMART TV;ELECTRONICA MAYOR
8931173;;M;58;CHILENO;;Boomers;LOS VILOS                     ;COQUIMBO;359941;6;3;0;0;0;6;3;359941;LED 40 KEHD4020 SMART TV;ELECTRONICA MAYOR
8450763;;M;64;CHILENO;;Boomers;RENCA                         ;METROPOLITANA;189980;2;1;0;0;0;2;1;189980;LED 42 42S6500 ANDROID TV FHD;ELECTRONICA MAYOR
17720988;;M;27;CHILENO;;Millenial;N/D;N/D;709950;5;4;5;3;659950;0;1;50000;LED 32 32PHD6825 HD SMART TV;ELECTRONICA MAYOR
11197621;;F;55;CHILENO;;Boomers;PROVIDENCIA                   ;METROPOLITANA;149990;1;1;0;0;0;1;1;149990;PARLANTE ULTRABOOSTER 1;ELECTRONICA MAYOR
17131362;;F;33;CHILENO;;Millenial;MARCHIHUE                     ;L.G.B.OÂ´HIGGINS;118970;3;2;2;1;108980;1;1;9990;LED 32 32PHD6825 HD SMART TV;ELECTRONICA MAYOR
8110214;;F;62;CHILENO;;Boomers;MELIPILLA                     ;METROPOLITANA;206980;2;1;2;1;206980;0;0;0;LED 43 43S5195 ROKU TV FHD;ELECTRONICA MAYOR
13341549;;M;44;CHILENO;;X;N/D;N/D;647060;9;4;3;1;203970;6;3;443090;LED 32 32PHD6825 HD SMART TV;ELECTRONICA MAYOR
12946793;;F;46;CHILENO;;X;SALAMANCA                     ;COQUIMBO;415900;5;3;0;0;0;5;3;415900;LED 55 KEUH5521 SMART TV UHD;ELECTRONICA MAYOR
13624690;;F;42;CHILENO;;X;PENCO;BIO-BIO;187970;3;2;2;1;147980;1;1;39990;LED 32 32S60-32P ANDROID TV SMART LINE HD;ELECTRONICA MAYOR
6835380;;F;70;CHILENO;;Silencioso;LOS ANGELES                   ;BIO BIO;205620;2;1;0;0;0;2;1;205620;LED 42 42S6500 ANDROID TV FHD;ELECTRONICA MAYOR
11933877;;F;50;CHILENO;;X;TOCOPILLA                     ;ANTOFAGASTA;159990;1;1;0;0;0;1;1;159990;LED KIOTO 32 MI3228 SMART TV;ELECTRONICA MAYOR
9399410;;F;59;CHILENO;;Boomers;SANTO DOMINGO                 ;VALPARAISO;611420;7;3;0;0;0;7;3;611420;PARLANTE ULTRA BOOSTER Z2;ELECTRONICA MAYOR
26380843;Soltero;M;25;HAITIANO;;Extranjero;N/D;N/D;120000;2;1;0;0;0;2;1;120000;MINICOMPONENTE CJ45;ELECTRONICA MAYOR
9892131;;F;55;CHILENO;;Boomers;RECOLETA                      ;METROPOLITANA;186971;3;2;0;0;0;3;2;186971;LED KIOTO 32 MI3228 SMART TV;ELECTRONICA MAYOR
14540525;;F;48;CHILENO;;X;N/D;N/D;503810;5;3;5;3;503810;0;0;0;LED 58 KEUH5821 SMART TV UHD;ELECTRONICA MAYOR
10542903;;M;54;CHILENO;;Boomers;SAN FERNANDO                  ;L.G.B.OÂ´HIGGINS;164980;2;2;0;0;0;2;2;164980;LED KIOTO 32 MI3228 SMART TV;ELECTRONICA MAYOR
10974439;;M;48;CHILENO;;X;SANTIAGO;METROPOLITANA;199980;2;1;2;1;199980;0;0;0;LED 58 KEUH5821 SMART TV UHD;ELECTRONICA MAYOR
11337886;;F;53;CHILENO;;X;PROVIDENCIA                   ;METROPOLITANA;129990;1;1;0;0;0;1;1;129990;LED KIOTO 32 MI3228 SMART TV;ELECTRONICA MAYOR
11040204;;F;56;CHILENO;;Boomers;TEMUCO                        ;ARAUCANIA;266980;2;1;0;0;0;2;1;266980;LED 43 43UP7500 UHD SMART TV;ELECTRONICA MAYOR
11780302;;F;50;CHILENO;;X;ANGOL                         ;ARAUCANIA;789810;3;1;0;0;0;3;1;789810;LED 70 UN70AU7000GXZS UHD;ELECTRONICA MAYOR
7233347;;F;67;CHILENO;;Boomers;ALTO HOSPICIO;TARAPACA;440090;8;2;0;0;0;8;2;440090;LED 50 KEUH50 SMART TV UHD;ELECTRONICA MAYOR
14558264;;F;64;CHILENO;;Boomers;OSORNO                        ;LOS LAGOS;211980;2;2;0;0;0;2;2;211980;LED 43 43S5195 ROKU TV FHD;ELECTRONICA MAYOR
9047847;;M;59;CHILENO;;Boomers;PROVIDENCIA                   ;METROPOLITANA;188970;3;2;0;0;0;3;2;188970;SOUNDBAR BLIK SURREAL 2.0;ELECTRONICA MAYOR
6023911;;F;74;CHILENO;;Silencioso;PUENTE ALTO                   ;METROPOLITANA;152950;5;4;0;0;0;5;4;152950;SOUNDBAR BLIK SURREAL 2.0;ELECTRONICA MAYOR
11776076;;M;51;CHILENO;;X;CHIGUAYANTE                   ;BIO BIO;404970;3;2;0;0;0;3;2;404970;LED 32 UN32T4300AGXZS HD SMART TV;ELECTRONICA MAYOR
13278344;;M;45;CHILENO;;X;RENCA                         ;METROPOLITANA;309990;1;1;0;0;0;1;1;309990;LED SAMSUNG 50 AU7090 CRYSTAL UHD 4K SMART TV 20;ELECTRONICA MAYOR
16971932;;M;33;CHILENO;;Millenial;QUILPUE                       ;VALPARAISO;149990;1;1;0;0;0;1;1;149990;LED 32 AOC ROKU TV HD 32S5195;ELECTRONICA MAYOR
10040327;;M;58;CHILENO;;Boomers;PICHIDEGUA                    ;L.G.B.OÂ´HIGGINS;711780;9;6;0;0;0;9;6;711780;LED 42 KHFH4221 SMART TV;ELECTRONICA MAYOR
16650773;;M;34;CHILENO;;Millenial;PROVIDENCIA                   ;METROPOLITANA;573980;2;2;2;2;573980;0;0;0;LED SAMSUNG 50 AU7090 CRYSTAL UHD 4K SMART TV 20;ELECTRONICA MAYOR
7130977;;F;66;CHILENO;;Boomers;N/D;N/D;150870;2;1;0;0;0;2;1;150870;PARLANTE ULTRAMEGA;ELECTRONICA MAYOR
17924499;;F;31;CHILENO;;Millenial;"";"";143980;2;1;2;1;143980;0;0;0;LED 40 KEHD4020 SMART TV;ELECTRONICA MAYOR
7526969;Soltero;M;67;CHILENO;AGROINDUSTRIA;Boomers;PROVIDENCIA                   ;METROPOLITANA;150710;3;1;0;0;0;3;1;150710;LED KIOTO 32 MI3228 SMART TV;ELECTRONICA MAYOR
8134942;Viudo;F;62;CHILENO;PSICOPEDAGOGO;Boomers;PROVIDENCIA                   ;METROPOLITANA;164980;2;1;0;0;0;2;1;164980;LED KIOTO 32 MI3228 SMART TV;ELECTRONICA MAYOR
25607527;;M;35;HAITIANO;;Extranjero;CERRO NAVIA                   ;METROPOLITANA;224150;3;2;0;0;0;3;2;224150;LED 50 KEUH50 SMART TV UHD;ELECTRONICA MAYOR
10712967;;M;55;CHILENO;;Boomers;RANCAGUA                      ;L.G.B.OÂ´HIGGINS;299990;1;1;0;0;0;1;1;299990;LED 65 KEUH6521 SMART TV UHD;ELECTRONICA MAYOR
13950670;Soltero;F;41;CHILENO;;X;PROVIDENCIA                   ;METROPOLITANA;199990;1;1;0;0;0;1;1;199990;LED 55 KEUH5521 SMART TV UHD;ELECTRONICA MAYOR
17944067;;F;31;CHILENO;;Millenial;N/D;N/D;119980;2;2;0;0;0;2;2;119980;PARLANTE MEGALUX K2777;ELECTRONICA MAYOR
18257444;Soltero;F;29;CHILENO;;Silencioso;PROVIDENCIA                   ;METROPOLITANA;179990;1;1;1;1;179990;0;0;0;LED 50 KEUH50 SMART TV UHD;ELECTRONICA MAYOR
17236960;;M;47;CHILENO;;X;PROVIDENCIA                   ;METROPOLITANA;189990;1;1;0;0;0;1;1;189990;LED 43 Full HD Smart TV 43PFD6825;ELECTRONICA MAYOR
17289793;Soltero;M;29;CHILENO;TECNOLOGO MEDICO;Millenial;PROVIDENCIA                   ;METROPOLITANA;139990;1;1;1;1;139990;0;0;0;LED 40 KEHD4020 SMART TV;ELECTRONICA MAYOR
14235518;;M;51;CHILENO;;X;N/D;N/D;201970;3;2;1;1;179990;2;1;21980;LED 50 KEUH50 SMART TV UHD;ELECTRONICA MAYOR
14320878;;M;45;CHILENO;;X;SAN CARLOS                    ;BIO BIO;367970;4;2;0;0;0;4;2;367970;LED 65 KEUH6521 SMART TV UHD;ELECTRONICA MAYOR
7888067;;F;68;CHILENO;;Silencioso;SAN VICENTE                   ;L.G.B.OÂ´HIGGINS;233680;6;4;0;0;0;6;4;233680;LED KIOTO 32 MI3228 SMART TV;ELECTRONICA MAYOR
17640829;;M;32;CHILENO;;Millenial;LOTA                          ;BIO BIO;450620;2;1;0;0;0;2;1;450620;LED 58 58PUD7625 BORDES ULTRA DELGADOS 4K UHD;ELECTRONICA MAYOR
8249945;;M;66;CHILENO;;Boomers;ILLAPEL                       ;COQUIMBO;953740;5;4;0;0;0;5;4;953740;PARLANTE MGULTRAEXTREME;ELECTRONICA MAYOR
20573615;;F;21;CHILENO;;Z;PENALOLEN;METROPOLITANA;199990;1;1;0;0;0;1;1;199990;LED 40 40S65A-40P ANDROID TV SMART LINE FHD;ELECTRONICA MAYOR
11726419;;F;51;CHILENO;;X;ANDACOLLO                     ;COQUIMBO;353970;3;1;0;0;0;3;1;353970;LED 42 KHFH4221 SMART TV;ELECTRONICA MAYOR
11717474;;M;51;CHILENO;;X;DALCAHUE                      ;LOS LAGOS;169990;1;1;1;1;169990;0;0;0;LED 50 KEUH50 SMART TV UHD;ELECTRONICA MAYOR
19207703;;F;26;CHILENO;;Z;N/D;N/D;308530;3;2;3;2;308530;0;0;0;LED 50 KEUH50 SMART TV UHD;ELECTRONICA MAYOR
16128400;;M;36;CHILENO;;Silencioso;PROVIDENCIA                   ;METROPOLITANA;319970;3;2;3;2;319970;0;0;0;LED 50 50UP7500 UHD SMART TV;ELECTRONICA MAYOR
6916280;;F;70;CHILENO;;Silencioso;VALLENAR;ATACAMA;752630;6;4;0;0;0;6;4;752630;LED LG 32 SMART TV FHD 32LQ630BPSA.AWH;ELECTRONICA MAYOR
13170094;;F;44;CHILENO;;X;N/D;N/D;714920;8;5;0;0;0;8;5;714920;MINICOMPONENTE CJ45;ELECTRONICA MAYOR
13853890;;M;41;CHILENO;;X;LEBU                          ;BIO BIO;601141;7;3;0;0;0;7;3;601141;LED 40 KEHD4020 SMART TV;ELECTRONICA MAYOR
6227602;;M;68;CHILENO;;Boomers;CERRO NAVIA                   ;METROPOLITANA;323250;4;2;2;1;209980;2;1;113270;LED 55 KEUH5521 SMART TV UHD;ELECTRONICA MAYOR
26411978;;M;32;NO INFORMA NACIONALIDAD;;Extranjero;N/D;N/D;145350;6;2;2;1;123980;4;1;21370;SOUNDBAR HW-A450/ZS;ELECTRONICA MAYOR
17090015;Soltero;M;32;CHILENO;;Silencioso;PROVIDENCIA                   ;METROPOLITANA;213980;2;1;2;1;213980;0;0;0;LED 40 40S65A-40P ANDROID TV SMART LINE FHD;ELECTRONICA MAYOR
10092749;Casado;M;57;CHILENO;;Boomers;RENCA                         ;METROPOLITANA;0;0;2;0;2;0;0;0;0;LED 50 UN50TU7090GXZS UHD SMART TV;ELECTRONICA MAYOR
10087110;Viudo;M;71;CHILENO;INGENIERO AGRICOLA;Silencioso;PROVIDENCIA                   ;METROPOLITANA;180990;3;1;0;0;0;3;1;180990;LED 32 32S5305 HD HDR10/HLG;ELECTRONICA MAYOR
12354010;;M;49;CHILENO;;X;PROVIDENCIA                   ;METROPOLITANA;199990;1;1;1;1;199990;0;0;0;LED 55 KEUH5521 SMART TV UHD;ELECTRONICA MAYOR
20090161;;M;22;CHILENO;;Z;N/D;N/D;246980;4;2;0;0;0;4;2;246980;LED 42 KHFH4221 SMART TV;ELECTRONICA MAYOR
26302718;;M;49;VENEZOLANO;;Extranjero;"";"";104090;2;1;0;0;0;2;1;104090;SOUNDBAR HW-T400/ZS;ELECTRONICA MAYOR
17494093;;F;32;CHILENO;;Millenial;LINARES                       ;MAULE;536950;5;3;0;0;0;5;3;536950;LED 42 KHFH4221 SMART TV;ELECTRONICA MAYOR
14356130;Soltero;M;42;CHILENO;;X;RENCA                         ;METROPOLITANA;119980;2;3;3;2;169970;-1;1;-49990;MINICOMPONENTE CJ45;ELECTRONICA MAYOR
19450565;;F;25;CHILENO;;Z;PROVIDENCIA                   ;METROPOLITANA;229980;2;1;2;1;229980;0;0;0;LED 55 KEUH5521 SMART TV UHD;ELECTRONICA MAYOR
15204461;;M;40;CHILENO;;X;LOS ANGELES                   ;BIO BIO;457460;4;3;4;3;457460;0;0;0;LED 40 KEHD4020 SMART TV;ELECTRONICA MAYOR
13265694;;M;45;CHILENO;;X;N/D;N/D;190000;2;1;0;0;0;2;1;190000;LED 43 Full HD Smart TV 43PFD6825;ELECTRONICA MAYOR
15064067;;F;39;CHILENO;;X;LA CRUZ                       ;VALPARAISO;519380;7;2;0;0;0;7;2;519380;LED 55 KEUH5521 SMART TV UHD;ELECTRONICA MAYOR
13536269;;F;43;CHILENO;;X;N/D;N/D;144520;4;2;4;2;144520;0;0;0;PARLANTE ULTRAMEGA;ELECTRONICA MAYOR
10828242;;M;54;CHILENO;;Boomers;RENCA                         ;METROPOLITANA;199990;1;1;0;0;0;1;1;199990;LED 32 UN32T4300AGXZS HD SMART TV;ELECTRONICA MAYOR
13128363;;F;44;CHILENO;;X;"";"";169990;1;1;0;0;0;1;1;169990;LED 42 KHFH4221 SMART TV;ELECTRONICA MAYOR
6923585;;M;67;CHILENO;;Boomers;PUENTE ALTO                   ;METROPOLITANA;767580;7;3;0;0;0;7;3;767580;LED 58 UN58AU7000GXZS UHD 4K SMART TV;ELECTRONICA MAYOR
7711717;;M;59;CHILENO;;Boomers;N/D;N/D;89990;1;1;0;0;0;1;1;89990;LED KIOTO 32 MI3228 SMART TV;ELECTRONICA MAYOR
19339994;;M;25;CHILENO;;Z;LA LIGUA                      ;VALPARAISO;551190;5;2;0;0;0;5;2;551190;LED SAMSUNG 50 AU7090 CRYSTAL UHD 4K SMART TV 20;ELECTRONICA MAYOR
15799913;;F;38;CHILENO;;X;RENCA                         ;METROPOLITANA;129990;1;1;0;0;0;1;1;129990;LED KIOTO 32 MI3228 SMART TV;ELECTRONICA MAYOR
9873129;;M;58;CHILENO;;Boomers;CONSTITUCION                  ;MAULE;186110;2;1;0;0;0;2;1;186110;PARLANTE ULTRABOOSTER 1;ELECTRONICA MAYOR
12503751;;F;49;CHILENO;;X;SAN RAMON                     ;METROPOLITANA;90000;2;1;0;0;0;2;1;90000;LED KIOTO 32 MI3228 SMART TV;ELECTRONICA MAYOR
9824577;;M;57;CHILENO;;Boomers;N/D;N/D;176980;2;1;0;0;0;2;1;176980;LED 50 KEUH50 SMART TV UHD;ELECTRONICA MAYOR
12006443;;M;47;CHILENO;;X;NATALES                       ;MAGALLANES;460820;7;2;0;0;0;7;2;460820;PARLANTE SCREAMER 4;ELECTRONICA MAYOR
10591021;;F;56;CHILENO;;Boomers;ESTACION CENTRAL              ;METROPOLITANA;58550;3;1;0;0;0;3;1;58550;PARLANTE SCREAMER 3;ELECTRONICA MAYOR
9012029;;F;61;CHILENO;;Boomers;"";"";683960;6;3;2;1;359980;4;2;323980;LED 40 KEHD4020 SMART TV;ELECTRONICA MAYOR
7917032;Casado;M;64;CHILENO;;Boomers;PROVIDENCIA                   ;METROPOLITANA;169990;1;1;0;0;0;1;1;169990;LED 42 KHFH4221 SMART TV;ELECTRONICA MAYOR
16029500;;M;37;CHILENO;;Millenial;SAN RAMON;METROPOLITANA;179980;2;1;2;1;179980;0;0;0;LED 50 KEUH50 SMART TV UHD;ELECTRONICA MAYOR
6578069;;F;69;CHILENO;;Silencioso;CAUQUENES                     ;MAULE;623952;7;5;0;0;0;7;5;623952;LED 50 KEUH50 SMART TV UHD;ELECTRONICA MAYOR
7391059;;F;65;CHILENO;;Boomers;LEBU                          ;BIO BIO;299990;1;1;0;0;0;1;1;299990;LED 65 KEUH6521 SMART TV UHD;ELECTRONICA MAYOR
15423504;;F;39;CHILENO;;X;PENAFLOR                      ;METROPOLITANA;615780;3;2;0;0;0;3;2;615780;QLED 50 50C725 ANDROID TV 4K UHD;ELECTRONICA MAYOR
5734967;;M;77;CHILENO;;Silencioso;NIQUEN                        ;BIO BIO;65450;2;3;0;0;0;2;3;65450;PARLANTE COBRA;ELECTRONICA MAYOR
8525089;;F;65;CHILENO;;Boomers;TEMUCO                        ;ARAUCANIA;143960;3;1;3;1;143960;0;0;0;LED 40 KEHD4020 SMART TV;ELECTRONICA MAYOR
17199785;;F;32;CHILENO;;Millenial;TALCAHUANO                    ;BIO BIO;145980;2;1;0;0;0;2;1;145980;MLAB KARAOKE DISCO VIBRANIUM 9106;ELECTRONICA MAYOR
18533008;;F;28;CHILENO;;Millenial;N/D;N/D;189990;1;1;0;0;0;1;1;189990;LED 55 KEUH5521 SMART TV UHD;ELECTRONICA MAYOR
11490192;Casado;F;52;CHILENO;;X;"";"";802590;7;1;0;0;0;7;1;802590;LED 65 KEUH6521 SMART TV UHD;ELECTRONICA MAYOR
15267677;;F;40;CHILENO;;X;VILLARICA                     ;ARAUCANIA;446752;5;3;3;2;371970;2;1;74782;LED 55 55PUD6794 SMART TV UHD 4K;ELECTRONICA MAYOR
16234896;;M;41;CHILENO;;X;N/D;N/D;86980;2;2;0;0;0;2;2;86980;SOUNDBAR HW-T400/ZS;ELECTRONICA MAYOR
12098756;;F;53;CHILENO;;X;ARICA                         ;ARICA Y PARINACOTA;624980;2;2;0;0;0;2;2;624980;LED 43 43UP7500 UHD SMART TV;ELECTRONICA MAYOR
17444644;;F;32;CHILENO;;Millenial;CORONEL                       ;BIO BIO;419990;1;1;0;0;0;1;1;419990;LED 50 50NANO75 NanoCell UHD SMART + MAGIC;ELECTRONICA MAYOR
20434203;;F;22;CHILENO;;Z;RENCA;METROPOLITANA;319970;3;2;3;2;319970;0;0;0;LED 50 50P615-50P ANDROID TV PASSION LINE UHD 4K;ELECTRONICA MAYOR
8172634;;M;64;CHILENO;;Boomers;N/D;N/D;193980;2;1;2;1;193980;0;0;0;LED 32 UN32T4300AGXZS HD SMART TV;ELECTRONICA MAYOR
17973623;;F;30;CHILENO;;Millenial;FLORIDA                       ;BIO BIO;412980;2;1;0;0;0;2;1;412980;LED 50 50NANO75 NanoCell UHD SMART + MAGIC;ELECTRONICA MAYOR
11176346;;F;55;CHILENO;;Boomers;RETIRO                        ;MAULE;340940;6;3;0;0;0;6;3;340940;LED 50 KEUH50 SMART TV UHD;ELECTRONICA MAYOR
13546297;;F;42;CHILENO;;X;N/D;N/D;2030880;13;7;13;7;2030880;0;0;0;QLED 50 QN50Q60AAGXZS 4K UHD SMART TV;ELECTRONICA MAYOR
6918620;;M;69;CHILENO;;Silencioso;N/D;N/D;416090;10;7;0;0;0;10;7;416090;PARLANTE KARAOKE MGROCKET PLUS;ELECTRONICA MAYOR
19467394;Soltero;F;25;CHILENO;TECNICO DE NIVEL MEDIO EN ALIMENTACION;Z;PROVIDENCIA                   ;METROPOLITANA;324460;3;1;0;0;0;3;1;324460;LED 43 43UP7500 UHD SMART TV;ELECTRONICA MAYOR
12391868;;F;49;CHILENO;;X;LLAILLAY                      ;VALPARAISO;745710;8;3;3;1;285970;5;2;459740;LED 58 KEUH5821 SMART TV UHD;ELECTRONICA MAYOR
15195062;;M;38;CHILENO;;Millenial;CABRERO;BIO-BIO;648950;5;2;5;2;648950;0;0;0;LED 50 KEUH50 SMART TV UHD;ELECTRONICA MAYOR
6967143;;M;70;CHILENO;;Silencioso;COLLIPULLI                    ;ARAUCANIA;607200;9;6;0;0;0;9;6;607200;PARLANTE SPBYF7 PORTATIL;ELECTRONICA MAYOR
13717143;;M;42;CHILENO;;X;PROVIDENCIA                   ;METROPOLITANA;113980;2;1;2;1;113980;0;0;0;MINICOMPONENTE CJ45;ELECTRONICA MAYOR
6500424;;M;66;CHILENO;;Boomers;N/D;N/D;10000;0;2;0;0;0;0;2;10000;LED 43 Full HD Smart TV 43PFD6825;ELECTRONICA MAYOR
8765928;;M;63;CHILENO;;Boomers;PROVIDENCIA                   ;METROPOLITANA;189980;2;1;2;1;189980;0;0;0;LED 50 KEUH50 SMART TV UHD;ELECTRONICA MAYOR
27365835;;M;48;VENEZOLANO;;Extranjero;"";"";251950;5;3;0;0;0;5;3;251950;LED 55 KEUH5521 SMART TV UHD;ELECTRONICA MAYOR
5728216;;F;73;CHILENO;;Silencioso;N/D;N/D;236370;2;1;0;0;0;2;1;236370;LED 42 KHFH4221 SMART TV;ELECTRONICA MAYOR
15511935;;F;39;CHILENO;;X;PROVIDENCIA                   ;METROPOLITANA;189980;2;2;2;2;189980;0;0;0;LED 40 KEHD4020 SMART TV;ELECTRONICA MAYOR
17467694;;F;32;CHILENO;;Millenial;N/D;N/D;369980;2;2;1;1;199990;1;1;169990;LED 58 KEUH5821 SMART TV UHD;ELECTRONICA MAYOR
16089091;;F;36;CHILENO;;Millenial;NUEVA IMPERIAL                ;ARAUCANIA;137980;2;1;0;0;0;2;1;137980;LED KIOTO 32 MI3228 SMART TV;ELECTRONICA MAYOR
15151031;;M;39;CHILENO;;X;TALAGANTE;METROPOLITANA;319980;2;1;2;1;319980;0;0;0;LED 50 50UP7500 UHD SMART TV;ELECTRONICA MAYOR
12561881;Casado;M;48;CHILENO;;X;COLLIPULLI                    ;ARAUCANIA;199990;1;1;1;1;199990;0;0;0;LED 55 KEUH5521 SMART TV UHD;ELECTRONICA MAYOR
14910535;;F;44;CHILENO;;X;SALAMANCA                     ;COQUIMBO;586980;3;2;0;0;0;3;2;586980;LED 50 KEUH50 SMART TV UHD;ELECTRONICA MAYOR
15305494;;F;40;CHILENO;;X;COIHAIQUE                     ;AYSEN;356970;4;1;0;0;0;4;1;356970;LED 55 KEUH5521 SMART TV UHD;ELECTRONICA MAYOR
20342378;;M;32;CHILENO;;Millenial;PROVIDENCIA                   ;METROPOLITANA;209980;2;1;2;1;209980;0;0;0;LED 55 KEUH5521 SMART TV UHD;ELECTRONICA MAYOR
25786686;;M;32;HAITIANO;;Extranjero;N/D;N/D;692250;8;4;0;0;0;8;4;692250;LED KIOTO 32 MI3228 SMART TV;ELECTRONICA MAYOR
9386685;Casado;M;60;CHILENO;;Boomers;COLINA                        ;METROPOLITANA;29990;1;1;0;0;0;1;1;29990;PARLANTE SCREAMER 3;ELECTRONICA MAYOR
18100303;;F;30;CHILENO;;Millenial;N/D;N/D;176980;2;1;0;0;0;2;1;176980;LED 50 KEUH50 SMART TV UHD;ELECTRONICA MAYOR
15882643;;F;37;CHILENO;;Millenial;PROVIDENCIA                   ;METROPOLITANA;209980;2;2;2;2;209980;0;0;0;LED 40 KEHD4020 SMART TV;ELECTRONICA MAYOR
15290838;;M;38;CHILENO;;Millenial;N/D;N/D;511980;2;1;2;1;511980;0;0;0;LED 65 65PUD7625 4K UHD HDR;ELECTRONICA MAYOR
6473547;;F;67;CHILENO;;Boomers;LICANTEN                      ;MAULE;410790;7;2;0;0;0;7;2;410790;LED 43 UN43TU7090GXZS UHD SMART TV;ELECTRONICA MAYOR
27124265;;M;45;VENEZOLANO;;Extranjero;"";"";283914;2;1;0;0;0;2;1;283914;LED 58 KEUH5821 SMART TV UHD;ELECTRONICA MAYOR
10233685;;M;56;CHILENO;;Boomers;CORONEL                       ;BIO BIO;340000;2;1;0;0;0;2;1;340000;LED SAMSUNG 55 4K UHD SMART TV UN55AU7090GXZS;ELECTRONICA MAYOR
18710928;;F;28;CHILENO;;Millenial;N/D;N/D;119990;1;1;1;1;119990;0;0;0;LED 40 KEHD4020 SMART TV;ELECTRONICA MAYOR
7676426;;F;66;CHILENO;;Boomers;RENGO                         ;L.G.B.OÂ´HIGGINS;204310;2;1;0;0;0;2;1;204310;LED 40 KEHD4020 SMART TV;ELECTRONICA MAYOR
26695128;;M;41;VENEZOLANO;;Extranjero;"";"";369990;1;1;0;0;0;1;1;369990;LED SAMSUNG 55 4K UHD SMART TV UN55AU7090GXZS;ELECTRONICA MAYOR
24664027;;F;31;COLOMBIANO;;Extranjero;N/D;N/D;219970;3;2;2;1;191980;1;1;27990;LED 43 UN43T5202AGXZS FHD SMART TV;ELECTRONICA MAYOR
15576442;;M;38;CHILENO;;Silencioso;PROVIDENCIA                   ;METROPOLITANA;636950;5;3;2;1;421980;3;2;214970;LED 58 UN58AU7000GXZS UHD 4K SMART TV;ELECTRONICA MAYOR
17187653;;M;33;CHILENO;;Millenial;RENCA;METROPOLITANA;14990;1;1;0;0;0;1;1;14990;PARLANTE KARAOKE 8 MAXEIGHT;ELECTRONICA MAYOR
8274167;;F;65;CHILENO;;Boomers;CONCEPCION                    ;BIO BIO;610790;7;2;0;0;0;7;2;610790;LED 50 UN50TU7090GXZS UHD SMART TV;ELECTRONICA MAYOR
17000345;;F;33;CHILENO;;Millenial;ARAUCO                        ;BIO BIO;188980;2;1;2;1;188980;0;0;0;LED 40 KEHD4020 SMART TV;ELECTRONICA MAYOR
8158246;;F;69;CHILENO;;Silencioso;VILLARICA                     ;ARAUCANIA;189980;2;2;0;0;0;2;2;189980;MINICOMPONENTE OL45;ELECTRONICA MAYOR
17390967;;M;32;CHILENO;;Millenial;N/D;N/D;652960;4;2;0;0;0;4;2;652960;LED 43 UN43T5202AGXZS FHD SMART TV;ELECTRONICA MAYOR
8294726;;F;68;CHILENO;;Silencioso;CURICO                        ;MAULE;395980;4;1;0;0;0;4;1;395980;LED 58 KEUH5821 SMART TV UHD;ELECTRONICA MAYOR
7662973;Casado;M;66;CHILENO;;Boomers;RENCA                         ;METROPOLITANA;139990;1;1;0;0;0;1;1;139990;MINICOMPONENTE OL45;ELECTRONICA MAYOR
9707086;;F;58;CHILENO;;Boomers;COLINA                        ;METROPOLITANA;279990;1;1;0;0;0;1;1;279990;LED 50 50PUD7625 SMART TV ULTRA HD 4K;ELECTRONICA MAYOR
14146929;;M;46;CHILENO;;X;"";"";245160;4;2;0;0;0;4;2;245160;LED KIOTO 32 MI3228 SMART TV;ELECTRONICA MAYOR
10788197;;F;55;CHILENO;;Boomers;PUDAHUEL                      ;METROPOLITANA;412970;3;2;0;0;0;3;2;412970;LED 55 KEUH5521 SMART TV UHD;ELECTRONICA MAYOR
11374162;;F;53;CHILENO;;X;COLBUN                        ;MAULE;239980;3;3;0;0;0;3;3;239980;2a ELECTRONICA MAYOR;ELECTRONICA MAYOR
19446359;;F;25;CHILENO;;Z;TENO;MAULE;199990;1;1;0;0;0;1;1;199990;LED 42 KHFH4221 SMART TV;ELECTRONICA MAYOR
14024642;;M;43;CHILENO;;X;SAN CARLOS                    ;BIO BIO;43980;2;5;0;0;0;2;5;43980;LED 65 KEUH6521 SMART TV UHD;ELECTRONICA MAYOR
11373831;;M;53;CHILENO;;X;SAN JAVIER                    ;MAULE;316970;3;2;0;0;0;3;2;316970;LED 42 KHFH4221 SMART TV;ELECTRONICA MAYOR
5236050;;M;83;CHILENO;;Silencioso;ARICA                         ;ARICA Y PARINACOTA;199990;1;1;0;0;0;1;1;199990;MINICOMPONENTE RN7;ELECTRONICA MAYOR
5770711;;M;73;CHILENO;;Silencioso;LOS ANDES                     ;VALPARAISO;492180;4;4;0;0;0;4;4;492180;LED 65 KEUH6521 SMART TV UHD;ELECTRONICA MAYOR
7232601;;F;66;CHILENO;;Boomers;"";"";74980;2;1;0;0;0;2;1;74980;PARLANTE SPBYF7 PORTATIL;ELECTRONICA MAYOR
14278048;;F;49;CHILENO;;X;SAN CARLOS                    ;BIO BIO;999980;2;1;0;0;0;2;1;999980;LED NanoCell 55NANO80 UHD SMART + MAGIC;ELECTRONICA MAYOR
13160335;;M;44;CHILENO;;X;N/D;N/D;383940;6;2;0;0;0;6;2;383940;LED 32 32PHD6825 HD SMART TV;ELECTRONICA MAYOR
13802368;;F;41;CHILENO;;X;LOS ANGELES                   ;BIO BIO;190969;3;2;0;0;0;3;2;190969;LED 40 KEHD4020 SMART TV;ELECTRONICA MAYOR
12566870;;F;48;CHILENO;;X;TOCOPILLA;ANTOFAGASTA;488180;2;1;0;0;0;2;1;488180;LED 55 UN55TU7090GXZS SMART TV UHD;ELECTRONICA MAYOR
6827465;;M;68;CHILENO;;Boomers;RENCA                         ;METROPOLITANA;675590;4;2;0;0;0;4;2;675590;PARLANTE ULTRAFORCE-I;ELECTRONICA MAYOR
15976486;;F;35;CHILENO;;Millenial;PUNITAQUI                     ;COQUIMBO;857920;8;3;0;0;0;8;3;857920;LED 55 KEUH5521 SMART TV UHD;ELECTRONICA MAYOR
15020309;;F;39;CHILENO;;X;LA LIGUA                      ;VALPARAISO;396960;4;3;0;0;0;4;3;396960;LED 40 KEHD4020 SMART TV;ELECTRONICA MAYOR
13603432;;M;42;CHILENO;;X;N/D;N/D;30980;2;1;2;1;30980;0;0;0;MAGIC REMOTE MR21G;ELECTRONICA MAYOR
8095098;;F;67;CHILENO;;Boomers;CANETE                        ;BIO BIO;387970;3;2;0;0;0;3;2;387970;MINICOMPONENTE RN9;ELECTRONICA MAYOR
9464452;;F;59;CHILENO;;Boomers;NOGALES                       ;VALPARAISO;199990;1;3;0;0;0;1;3;199990;LED 40 UN40T5290AGXZS FHD SMART TV;ELECTRONICA MAYOR
8478711;;M;63;CHILENO;;Boomers;COQUIMBO                      ;COQUIMBO;200980;2;1;0;0;0;2;1;200980;LED 32 UN32T4300AGXZS HD SMART TV;ELECTRONICA MAYOR
19275853;;M;25;CHILENO;;Z;SANTA CRUZ                    ;L.G.B.OÂ´HIGGINS;1449058;11;13;2;4;499980;9;9;949078;LED 43 UN43T5202AGXZS FHD SMART TV;ELECTRONICA MAYOR
9782922;;F;59;CHILENO;;Boomers;VALDIVIA                      ;LOS LAGOS;260000;2;1;0;0;0;2;1;260000;LED 43 UN43TU7090GXZS UHD SMART TV;ELECTRONICA MAYOR
15140559;;F;38;CHILENO;;X;N/D;N/D;159990;1;1;0;0;0;1;1;159990;PARLANTE MGULTRAEXTREME;ELECTRONICA MAYOR
16090803;Soltero;M;36;CHILENO;PSICOLOGO;Millenial;PROVIDENCIA                   ;METROPOLITANA;249990;1;1;0;0;0;1;1;249990;LED 43 43LM6370 SMART TV FHD;ELECTRONICA MAYOR
19275080;Soltero;M;26;CHILENO;;Z;PROVIDENCIA                   ;METROPOLITANA;402970;3;1;0;0;0;3;1;402970;LED 55UP7500 UHD SMART;ELECTRONICA MAYOR
12749842;;M;46;CHILENO;;X;N/D;N/D;799960;4;2;0;0;0;4;2;799960;LED 40 40S65A-40P ANDROID TV SMART LINE FHD;ELECTRONICA MAYOR
5104603;;M;76;CHILENO;;Silencioso;RENCA                         ;METROPOLITANA;239990;1;1;0;0;0;1;1;239990;LED 43 UN43T5202AGXZS FHD SMART TV;ELECTRONICA MAYOR
10547717;;F;56;CHILENO;;Boomers;SAN CARLOS                    ;BIO BIO;484940;6;3;0;0;0;6;3;484940;LED 50 50PUD7625 SMART TV ULTRA HD 4K;ELECTRONICA MAYOR
17608641;;M;31;CHILENO;;Millenial;EL BOSQUE;METROPOLITANA;199990;1;1;0;0;0;1;1;199990;MINICOMPONENTE RN7;ELECTRONICA MAYOR
18218877;;M;29;CHILENO;;Millenial;VALLENAR;ATACAMA;1030880;12;7;2;1;311980;10;6;718900;LED 32 UN32T4300AGXZS HD SMART TV;ELECTRONICA MAYOR
7959984;Casado;M;65;CHILENO;AGROINDUSTRIA;Boomers;RENCA                         ;METROPOLITANA;225980;2;1;0;0;0;2;1;225980;LED 32 UN32T4300AGXZS HD SMART TV;ELECTRONICA MAYOR
14204006;;F;41;CHILENO;;Millenial;PUERTO VARAS                  ;LOS LAGOS;543970;3;1;0;0;0;3;1;543970;LED 60 UN60AU8000GXZS UHD SMART TV;ELECTRONICA MAYOR
25819067;;M;31;HAITIANO;;Extranjero;TALCA                         ;MAULE;264980;2;2;0;0;0;2;2;264980;LED 40 40S65A-40P ANDROID TV SMART LINE FHD;ELECTRONICA MAYOR
16025360;;F;36;CHILENO;;Millenial;ROMERAL                       ;MAULE;354950;5;3;0;0;0;5;3;354950;LED 42 KHFH4221 SMART TV;ELECTRONICA MAYOR
14397854;;M;44;CHILENO;;X;PENCAHUE                      ;MAULE;162980;2;1;0;0;0;2;1;162980;PARLANTE ULTRAMEGA;ELECTRONICA MAYOR
9623106;;F;62;CHILENO;;Boomers;MELIPILLA                     ;METROPOLITANA;431960;4;2;0;0;0;4;2;431960;PARLANTE ULTRAFORCE-I;ELECTRONICA MAYOR
27264983;;M;27;VENEZOLANO;;Extranjero;"";"";163980;2;1;2;1;163980;0;0;0;LED 32 32S5305 HD HDR10/HLG;ELECTRONICA MAYOR
16003509;;F;37;CHILENO;;Millenial;PROVIDENCIA                   ;METROPOLITANA;334940;6;3;0;0;0;6;3;334940;PARLANTE ULTRAFORCE-I;ELECTRONICA MAYOR
17909052;;M;31;CHILENO;;Millenial;"";"";14990;1;1;0;0;0;1;1;14990;PARLANTE KARAOKE 8 MAXEIGHT;ELECTRONICA MAYOR
9086914;;M;44;CHILENO;;X;COIHAIQUE                     ;AYSEN;259990;1;1;0;0;0;1;1;259990;MINICOMPONENTE RN9;ELECTRONICA MAYOR
17486926;;M;31;CHILENO;;Millenial;"";"";307970;3;3;3;3;307970;0;0;0;KARAOKE SP-101BT ALL IN ONE PORTATIL 60W;ELECTRONICA MAYOR
8380444;;M;65;CHILENO;;Boomers;RENCA                         ;METROPOLITANA;311970;3;1;0;0;0;3;1;311970;LED 43 UN43T5202AGXZS FHD SMART TV;ELECTRONICA MAYOR
20024591;;F;23;CHILENO;;Z;PROVIDENCIA                   ;METROPOLITANA;206980;2;1;2;1;206980;0;0;0;LED 43 Full HD Smart TV 43PFD6825;ELECTRONICA MAYOR
13157308;;F;50;CHILENO;;X;RENCA                         ;METROPOLITANA;174980;2;1;0;0;0;2;1;174980;PARLANTE ULTRABUZZ;ELECTRONICA MAYOR
8280709;;F;64;CHILENO;;Boomers;TALCAHUANO                    ;BIO BIO;356430;6;2;0;0;0;6;2;356430;LED 40 KEHD4020 SMART TV;ELECTRONICA MAYOR
18526308;;M;27;CHILENO;;Millenial;CHANCO                        ;MAULE;413960;4;2;0;0;0;4;2;413960;LED 50 KEUH50 SMART TV UHD;ELECTRONICA MAYOR
13277351;;M;45;CHILENO;;X;"";"";29990;1;1;0;0;0;1;1;29990;SOUNDBAR BLIK SURREAL 2.0;ELECTRONICA MAYOR
9864321;;F;61;CHILENO;;Boomers;N/D;N/D;446980;2;1;0;0;0;2;1;446980;LED 55UP7500 UHD SMART;ELECTRONICA MAYOR
12518794;;M;49;CHILENO;;X;SAN VICENTE                   ;L.G.B.OÂ´HIGGINS;208150;4;2;0;0;0;4;2;208150;MINICOMPONENTE CJ45;ELECTRONICA MAYOR
18892580;;M;27;CHILENO;;Millenial;SAN BERNARDO                  ;METROPOLITANA;543720;7;2;0;0;0;7;2;543720;LED 55 55P615 UHD ANDROID TV 4K;ELECTRONICA MAYOR
16541481;;F;34;CHILENO;;Millenial;PAILLACO                      ;LOS LAGOS;600350;5;2;0;0;0;5;2;600350;MINICOMPONENTE RN9;ELECTRONICA MAYOR
6966492;;F;70;CHILENO;;Silencioso;PROVIDENCIA                   ;METROPOLITANA;249990;1;1;0;0;0;1;1;249990;LED 50 50PUD6513/44 SMART TV UHD 4K;ELECTRONICA MAYOR
20085025;;M;30;CHILENO;;Millenial;N/D;N/D;464950;5;3;0;0;0;5;3;464950;MINICOMPONENTE MX-T40/ZS ALL IN ONE;ELECTRONICA MAYOR
22484667;;F;44;COLOMBIANO;;Extranjero;CALAMA;ANTOFAGASTA;79990;1;1;0;0;0;1;1;79990;KARAOKE SP-101BT ALL IN ONE PORTATIL 60W;ELECTRONICA MAYOR
19441005;;M;26;CHILENO;;Z;N/D;N/D;224980;3;1;0;0;0;3;1;224980;LED 40 KEHD4020 SMART TV;ELECTRONICA MAYOR
18012088;;M;30;CHILENO;;Millenial;N/D;N/D;139990;1;1;0;0;0;1;1;139990;LED KIOTO 32 MI3228 SMART TV;ELECTRONICA MAYOR
7748410;;F;66;CHILENO;;Boomers;VILLARICA                     ;ARAUCANIA;409990;3;2;0;0;0;3;2;409990;LED 49 49UN7100 UHD SMART TV;ELECTRONICA MAYOR
11475842;;F;52;CHILENO;;X;PUDAHUEL                      ;METROPOLITANA;139990;2;1;0;0;0;2;1;139990;LED KIOTO 32 MI3228 SMART TV;ELECTRONICA MAYOR
18058693;;F;30;CHILENO;;Millenial;LOS ALAMOS                    ;BIO BIO;1563870;13;4;4;2;517960;9;2;1045910;LED 55 UN55TU7090GXZS SMART TV UHD;ELECTRONICA MAYOR
19120332;;F;26;CHILENO;;Z;TIRUA                         ;BIO BIO;505830;3;2;2;1;315840;1;1;189990;LED 42 KHFH4221 SMART TV;ELECTRONICA MAYOR
24801140;;M;34;PERUANO;;Extranjero;N/D;N/D;239980;2;2;0;0;0;2;2;239980;PARLANTE MGULTRAEXTREME;ELECTRONICA MAYOR
13743132;;M;43;CHILENO;;X;COPIAPO                       ;ATACAMA;251970;3;1;0;0;0;3;1;251970;LED 40 UN40T5290AGXZS FHD SMART TV;ELECTRONICA MAYOR
24993930;;F;55;COLOMBIANO;;Extranjero;CASTRO                        ;LOS LAGOS;988950;5;3;0;0;0;5;3;988950;LED 70 UN70AU7000GXZS UHD;ELECTRONICA MAYOR
17853938;;F;30;CHILENO;;Millenial;PROVIDENCIA                   ;METROPOLITANA;206980;2;1;2;1;206980;0;0;0;LED 43 UN43T5202AGXZS FHD SMART TV;ELECTRONICA MAYOR
5543920;Casado;F;75;CHILENO;;Silencioso;RENCA                         ;METROPOLITANA;14990;1;3;0;0;0;1;3;14990;LED 50 UN50TU7090GXZS UHD SMART TV;ELECTRONICA MAYOR
5769029;;F;75;CHILENO;;Silencioso;SAN ANTONIO                   ;VALPARAISO;446970;3;1;0;0;0;3;1;446970;LED 40 UN40T5290AGXZS FHD SMART TV;ELECTRONICA MAYOR
16580088;;F;34;CHILENO;;Millenial;N/D;N/D;1055050;5;2;0;0;0;5;2;1055050;LED 55UP7500 UHD SMART;ELECTRONICA MAYOR
12039706;Soltero;F;58;CHILENO;;Boomers;RENCA                         ;METROPOLITANA;156980;2;2;0;0;0;2;2;156980;LED 32 32PHD6825 HD SMART TV;ELECTRONICA MAYOR
11529912;;F;51;CHILENO;;X;PUMANQUE                      ;L.G.B.OÂ´HIGGINS;209990;1;1;0;0;0;1;1;209990;LED 32LM637B HD SMART;ELECTRONICA MAYOR
18225586;;F;31;CHILENO;;Millenial;PROVIDENCIA                   ;METROPOLITANA;451980;2;1;2;1;451980;0;0;0;LED 60 UN60AU8000GXZS UHD SMART TV;ELECTRONICA MAYOR
18103919;;M;29;CHILENO;;Millenial;N/D;N/D;392960;4;3;0;0;0;4;3;392960;LED 50 KEUH50 SMART TV UHD;ELECTRONICA MAYOR
15253911;;F;40;CHILENO;;X;RENCA                         ;METROPOLITANA;189990;1;3;1;3;189990;0;0;0;LED 43 Full HD Smart TV 43PFD6825;ELECTRONICA MAYOR
17057348;;F;33;CHILENO;;Millenial;NUEVA IMPERIAL                ;ARAUCANIA;269990;1;1;1;1;269990;0;0;0;LED 50 UN50TU7090GXZS UHD SMART TV;ELECTRONICA MAYOR
15668509;;F;38;CHILENO;;Millenial;N/D;N/D;499980;2;1;0;0;0;2;1;499980;LED 55 UN55TU7090GXZS SMART TV UHD;ELECTRONICA MAYOR
15723579;;M;38;CHILENO;;X;PROVIDENCIA                   ;METROPOLITANA;179990;1;1;1;1;179990;0;0;0;LED 43 43S5305 SMART TV FULL HD;ELECTRONICA MAYOR
11231531;;F;53;CHILENO;;X;MELIPILLA                     ;METROPOLITANA;84980;2;2;0;0;0;2;2;84980;PARLANTE KARAOKE MGROCKET PLUS;ELECTRONICA MAYOR
14493054;;F;47;CHILENO;;X;PROVIDENCIA                   ;METROPOLITANA;204980;2;1;2;1;204980;0;0;0;LED 32LM637B HD SMART;ELECTRONICA MAYOR
8529387;;M;63;CHILENO;;Boomers;LEBU                          ;BIO BIO;416970;3;2;0;0;0;3;2;416970;LED 58 UN58AU7000GXZS UHD 4K SMART TV;ELECTRONICA MAYOR
17255549;;M;32;CHILENO;;Millenial;PUDAHUEL                      ;METROPOLITANA;99990;1;1;0;0;0;1;1;99990;PARLANTE ULTRAMAGIC;ELECTRONICA MAYOR
16856365;Casado;F;34;CHILENO;INGENIERO CIVIL;Millenial;MELIPILLA                     ;METROPOLITANA;101980;2;1;0;0;0;2;1;101980;PARLANTE BOLA DISCO CON MICROFONO INAL;ELECTRONICA MAYOR
22636054;;F;36;PERUANO;;Extranjero;TALCA                         ;MAULE;155230;3;3;0;0;0;3;3;155230;PARLANTE ULTRAMAGIC;ELECTRONICA MAYOR
16807569;;M;34;CHILENO;;Millenial;TOME                          ;BIO BIO;186980;2;1;0;0;0;2;1;186980;LED 42 KHFH4221 SMART TV;ELECTRONICA MAYOR
8074141;;M;61;CHILENO;;Boomers;N/D;N/D;332950;5;3;0;0;0;5;3;332950;MLAB KARAOKE 8 CITY SET MICROFONO INALAMBRICO AT;ELECTRONICA MAYOR
9181729;;F;56;CHILENO;;Boomers;PROVIDENCIA                   ;METROPOLITANA;169990;1;1;0;0;0;1;1;169990;LED 32 UN32T4300AGXZS HD SMART TV;ELECTRONICA MAYOR
19467533;;M;25;CHILENO;;Z;PROVIDENCIA                   ;METROPOLITANA;337980;2;1;0;0;0;2;1;337980;LED 55 KEUH5521 SMART TV UHD;ELECTRONICA MAYOR
16149877;;M;37;CHILENO;;Millenial;N/D;N/D;264540;2;1;2;1;264540;0;0;0;LED 43 43UP7500 UHD SMART TV;ELECTRONICA MAYOR
11926430;;F;51;CHILENO;;X;PUERTO MONTT                  ;LOS LAGOS;776330;6;3;0;0;0;6;3;776330;LED 42 KHFH4221 SMART TV;ELECTRONICA MAYOR
10144821;;M;57;CHILENO;;Boomers;LOS ALAMOS                    ;BIO BIO;309990;2;1;0;0;0;2;1;309990;LED 50 50PUD7625 SMART TV ULTRA HD 4K;ELECTRONICA MAYOR
8528256;Casado;M;55;CHILENO;TECNICO EN ANALISIS QUIMICO;Boomers;PROVIDENCIA                   ;METROPOLITANA;189990;1;1;1;1;189990;0;0;0;LED 32LM637B HD SMART;ELECTRONICA MAYOR
8815466;;M;63;CHILENO;;Boomers;ANGOL                         ;ARAUCANIA;576971;4;2;0;0;0;4;2;576971;LED 65 KEUH6521 SMART TV UHD;ELECTRONICA MAYOR
16986105;;F;34;CHILENO;;Extranjero;N/D;N/D;44990;1;1;0;0;0;1;1;44990;PARLANTE SPBYF7 PORTATIL;ELECTRONICA MAYOR
15172749;;F;41;CHILENO;;X;CALAMA                        ;ANTOFAGASTA;457950;5;2;0;0;0;5;2;457950;LED 40 UN40T5290AGXZS FHD SMART TV;ELECTRONICA MAYOR
18817272;;F;27;CHILENO;;Z;ARAUCO                        ;BIO BIO;880950;5;3;0;0;0;5;3;880950;LED 55 UN55TU7090GXZS SMART TV UHD;ELECTRONICA MAYOR
14214515;;M;41;CHILENO;;X;CORONEL                       ;BIO BIO;369990;1;1;0;0;0;1;1;369990;LED 55UP7500 UHD SMART;ELECTRONICA MAYOR
7232044;;F;65;CHILENO;;Boomers;TOCOPILLA                     ;ANTOFAGASTA;594350;4;2;0;0;0;4;2;594350;LED 50 50NANO75 NanoCell UHD SMART + MAGIC;ELECTRONICA MAYOR
9825227;Casado;M;54;CHILENO;;X;TALAGANTE                     ;METROPOLITANA;492980;2;1;0;0;0;2;1;492980;LED 58 UN58AU7000GXZS UHD 4K SMART TV;ELECTRONICA MAYOR
15042271;;F;40;CHILENO;;X;OVALLE                        ;COQUIMBO;369980;2;2;0;0;0;2;2;369980;PARLANTE ULTRASENSATION;ELECTRONICA MAYOR
15479902;Soltero;F;40;CHILENO;PROFESOR;X;PROVIDENCIA                   ;METROPOLITANA;170950;5;2;0;0;0;5;2;170950;LED 32 UN32T4300AGXZS HD SMART TV;ELECTRONICA MAYOR
20363096;;M;22;CHILENO;;Z;N/D;N/D;407950;5;3;0;0;0;5;3;407950;PARLANTE ULTRAFORCE-I;ELECTRONICA MAYOR
12855426;Casado;F;47;CHILENO;;X;RENCA                         ;METROPOLITANA;279980;2;1;0;0;0;2;1;279980;LED 43 UN43TU7090GXZS UHD SMART TV;ELECTRONICA MAYOR
10026326;Casado;M;54;CHILENO;INGENIERO DE EJECUCION EN GEOMENSURA;X;PROVIDENCIA                   ;METROPOLITANA;229990;1;1;1;1;229990;0;0;0;LED 40 UN40T5290AGXZS FHD SMART TV;ELECTRONICA MAYOR
14276105;;F;52;CHILENO;;X;EL BOSQUE                     ;METROPOLITANA;381950;5;2;0;0;0;5;2;381950;LED KIOTO 32 MI3228 SMART TV;ELECTRONICA MAYOR
5912619;Casado;M;74;CHILENO;;Silencioso;RENCA                         ;METROPOLITANA;299990;1;1;0;0;0;1;1;299990;LED 50 50UP7500 UHD SMART TV;ELECTRONICA MAYOR
26217543;;M;33;HAITIANO;;Extranjero;LA CISTERNA                   ;METROPOLITANA;242980;2;1;0;0;0;2;1;242980;PARLANTE ULTRASENSATION;ELECTRONICA MAYOR
4292859;;M;84;CHILENO;;Silencioso;N/D;N/D;481980;2;1;0;0;0;2;1;481980;LED 50 50UP7500 UHD SMART TV;ELECTRONICA MAYOR
15742142;;F;38;CHILENO;;X;PENAFLOR                      ;METROPOLITANA;284980;2;1;0;0;0;2;1;284980;LED 50 50PUD7625 SMART TV ULTRA HD 4K;ELECTRONICA MAYOR
18726468;;F;28;CHILENO;;Millenial;SAN BERNARDO                  ;METROPOLITANA;139990;1;1;0;0;0;1;1;139990;LED KIOTO 32 MI3228 SMART TV;ELECTRONICA MAYOR
5115470;;M;79;CHILENO;;Silencioso;PROVIDENCIA                   ;METROPOLITANA;273980;2;1;0;0;0;2;1;273980;LED 43 Full HD Smart TV 43PFD6825;ELECTRONICA MAYOR
9510214;;F;59;CHILENO;;Boomers;ANTOFAGASTA                   ;ANTOFAGASTA;662980;2;1;0;0;0;2;1;662980;LED NanoCell 65NANO75 UHD SMART + MAGIC;ELECTRONICA MAYOR
12031085;;F;53;CHILENO;;X;LOS ANGELES                   ;BIO BIO;253570;2;1;0;0;0;2;1;253570;LED 43 Full HD Smart TV 43PFD6825;ELECTRONICA MAYOR
10626068;;F;53;CHILENO;;X;RENCA                         ;METROPOLITANA;44990;1;1;0;0;0;1;1;44990;PARLANTE SPBYF7 PORTATIL;ELECTRONICA MAYOR
20070812;;F;23;CHILENO;;Silencioso;PROVIDENCIA                   ;METROPOLITANA;179990;1;1;1;1;179990;0;0;0;LED 32 32PHD6825 HD SMART TV;ELECTRONICA MAYOR
12529133;;M;49;CHILENO;;X;CAUQUENES                     ;MAULE;569750;4;4;0;0;0;4;4;569750;PARLANTE KARAOKE SPB8B;ELECTRONICA MAYOR
10985807;;F;52;CHILENO;;X;RENCA                         ;METROPOLITANA;139990;1;1;0;0;0;1;1;139990;MONITOR 24 24TL520S SMART TV HD;ELECTRONICA MAYOR
15662954;;F;38;CHILENO;;X;PROVIDENCIA                   ;METROPOLITANA;168970;3;1;0;0;0;3;1;168970;LED 32 KHHD3221 SMART TV;ELECTRONICA MAYOR
9532511;;F;61;CHILENO;;Boomers;RENCA                         ;METROPOLITANA;277970;3;1;0;0;0;3;1;277970;LED 42 KHFH4221 SMART TV;ELECTRONICA MAYOR
12115739;;F;41;CHILENO;;X;SAN CLEMENTE                  ;MAULE;44990;1;1;0;0;0;1;1;44990;PARLANTE SPBYF7 PORTATIL;ELECTRONICA MAYOR
17519478;;F;32;CHILENO;;Millenial;N/D;N/D;214980;2;2;0;0;0;2;2;214980;PARLANTE ULTRAFORCE-I;ELECTRONICA MAYOR
19929168;;F;24;CHILENO;;Z;COLINA                        ;METROPOLITANA;104980;2;2;0;0;0;2;2;104980;PARLANTE SENSEIGTH K3175;ELECTRONICA MAYOR
18527840;Soltero;F;29;CHILENO;;Millenial;PROVIDENCIA                   ;METROPOLITANA;176960;4;2;4;2;176960;0;0;0;PARLANTE ULTRAFUSION;ELECTRONICA MAYOR
15386049;;M;40;CHILENO;;X;PROVIDENCIA                   ;METROPOLITANA;289990;1;1;0;0;0;1;1;289990;LED 50 50P615-50P ANDROID TV PASSION LINE UHD 4K;ELECTRONICA MAYOR
9444706;;F;60;CHILENO;;Boomers;FREIRINA                      ;ATACAMA;219990;1;1;0;0;0;1;1;219990;LED 40 UN40T5290AGXZS FHD SMART TV;ELECTRONICA MAYOR
17393795;Casado;F;32;CHILENO;;Millenial;PROVIDENCIA                   ;METROPOLITANA;59990;1;1;0;0;0;1;1;59990;PARLANTE SENSEIGTH K3175;ELECTRONICA MAYOR
6825431;;M;68;CHILENO;;Boomers;PROVIDENCIA                   ;METROPOLITANA;146980;2;1;0;0;0;2;1;146980;LED KIOTO 32 MI3228 SMART TV;ELECTRONICA MAYOR
13520873;;M;44;CHILENO;;X;VALDIVIA                      ;LOS LAGOS;1730680;17;7;0;0;0;17;7;1730680;LED 58 UN58AU7000GXZS UHD 4K SMART TV;ELECTRONICA MAYOR
6902766;;F;70;CHILENO;;Silencioso;COQUIMBO                      ;COQUIMBO;355260;2;3;0;0;0;2;3;355260;PARLANTE KARAOKE MGROKR NEGRO;ELECTRONICA MAYOR
15231164;;F;39;CHILENO;;X;PROVIDENCIA                   ;METROPOLITANA;167980;2;2;0;0;0;2;2;167980;LED KIOTO 32 MI3228 SMART TV;ELECTRONICA MAYOR
9073260;;M;60;CHILENO;;Boomers;PETORCA                       ;VALPARAISO;179990;1;1;0;0;0;1;1;179990;LED 32LM637B HD SMART;ELECTRONICA MAYOR
11839871;;F;50;CHILENO;;X;PROVIDENCIA                   ;METROPOLITANA;143980;2;1;2;1;143980;0;0;0;MONITOR 24 24TL520S SMART TV HD;ELECTRONICA MAYOR
16242290;;M;35;CHILENO;;Silencioso;PROVIDENCIA                   ;METROPOLITANA;158980;2;1;2;1;158980;0;0;0;TOCADISCOS PS-LX310BT BT;ELECTRONICA MAYOR
15557910;;M;39;CHILENO;;X;VALPARAISO                    ;VALPARAISO;609550;4;2;0;0;0;4;2;609550;LED 43 Full HD Smart TV 43PFD6825;ELECTRONICA MAYOR
14094027;;F;43;CHILENO;;X;RENCA                         ;METROPOLITANA;359990;1;1;1;1;359990;0;0;0;LED 55 UN55TU7090GXZS SMART TV UHD;ELECTRONICA MAYOR
9393134;;M;60;CHILENO;;Boomers;PROVIDENCIA                   ;METROPOLITANA;60000;0;2;0;0;0;0;2;60000;LED 32 UN32T4300AGXZS HD SMART TV;ELECTRONICA MAYOR
18284399;;F;30;CHILENO;;Millenial;PUERTO MONTT;LOS LAGOS;129990;1;1;1;1;129990;0;0;0;LED 32 KHHD3221 SMART TV;ELECTRONICA MAYOR
5359255;;M;78;CHILENO;;Silencioso;RENCA                         ;METROPOLITANA;189990;1;1;0;0;0;1;1;189990;LED 40 KEHD4020 SMART TV;ELECTRONICA MAYOR
6970745;;M;56;CHILENO;;Millenial;"";"";247280;4;2;4;2;247280;0;0;0;KARAOKE PORTATIL TWO-EIGHT 8860;ELECTRONICA MAYOR
17195835;;F;33;CHILENO;;Millenial;PEUMO                         ;L.G.B.OÂ´HIGGINS;19990;1;1;0;0;0;1;1;19990;PARLANTE MG TWISTER;ELECTRONICA MAYOR
16639009;;F;35;CHILENO;;Millenial;N/D;N/D;603660;12;1;0;0;0;12;1;603660;LED 43 Full HD Smart TV 43PFD6825;ELECTRONICA MAYOR
11118541;;F;55;CHILENO;;Boomers;ANTOFAGASTA                   ;ANTOFAGASTA;134980;2;1;0;0;0;2;1;134980;MINICOMPONENTE OL45;ELECTRONICA MAYOR
13383863;;F;45;CHILENO;;X;N/D;N/D;299990;1;1;0;0;0;1;1;299990;LED 50 50PUD7625 SMART TV ULTRA HD 4K;ELECTRONICA MAYOR
12734841;;F;46;CHILENO;;X;CANETE                        ;BIO BIO;404980;2;2;0;0;0;2;2;404980;PARLANTE MEGALUX K2777;ELECTRONICA MAYOR
18016157;Soltero;M;30;CHILENO;;Millenial;PROVIDENCIA                   ;METROPOLITANA;39990;1;1;0;0;0;1;1;39990;SOUNDBAR XTS-801 Negro 40W;ELECTRONICA MAYOR
8058219;;F;65;CHILENO;;Boomers;SAN JAVIER                    ;MAULE;249990;1;1;0;0;0;1;1;249990;PARLANTE ULTRASENSATION;ELECTRONICA MAYOR
9950893;;F;59;CHILENO;;Boomers;RENCA                         ;METROPOLITANA;92980;2;1;0;0;0;2;1;92980;PARLANTE SENSEIGTH K3175;ELECTRONICA MAYOR
12058060;;F;57;CHILENO;;Boomers;CANETE                        ;BIO BIO;86980;2;1;0;0;0;2;1;86980;PARLANTE BOLA DISCO CON MICROFONO INAL;ELECTRONICA MAYOR
12298058;;F;50;CHILENO;;X;TALCA                         ;MAULE;99990;1;1;0;0;0;1;1;99990;PARLANTE MEGALUX K2777;ELECTRONICA MAYOR
12562280;;M;48;CHILENO;;X;MULCHEN                       ;BIO BIO;233470;2;1;0;0;0;2;1;233470;PARLANTE ULTRAFORCE-I;ELECTRONICA MAYOR
19231360;;F;27;CHILENO;;Millenial;PROVIDENCIA                   ;METROPOLITANA;349990;1;1;0;0;0;1;1;349990;LED 55 UN55TU7090GXZS SMART TV UHD;ELECTRONICA MAYOR
9023961;;M;61;CHILENO;;Boomers;CANETE                        ;BIO BIO;297970;3;1;0;0;0;3;1;297970;LED 42 KHFH4221 SMART TV;ELECTRONICA MAYOR
4659532;;M;81;CHILENO;;Silencioso;LEBU                          ;BIO BIO;134980;2;1;0;0;0;2;1;134980;PARLANTE ULTRAMAGIC;ELECTRONICA MAYOR
17247964;;F;32;CHILENO;;Millenial;RENCA                         ;METROPOLITANA;324990;1;1;0;0;0;1;1;324990;LED 50 UN50TU7090GXZS UHD SMART TV;ELECTRONICA MAYOR
8393191;;F;64;CHILENO;;Boomers;N/D;N/D;198980;2;1;0;0;0;2;1;198980;KARAOKE TRUE WIRELESS DUAL 10 PULGADAS LIGHT SHO;ELECTRONICA MAYOR
14077696;;F;42;CHILENO;;X;RENCA                         ;METROPOLITANA;61960;4;2;0;0;0;4;2;61960;KARAOKE STREET SONG 4 MICÂ CABLEÂ BLACK 8900;ELECTRONICA MAYOR
17629319;;F;32;CHILENO;;Millenial;"";"";34990;1;1;0;0;0;1;1;34990;KARAOKE FUNKY DISCO;ELECTRONICA MAYOR
19713115;;F;24;CHILENO;;Z;PROVIDENCIA                   ;METROPOLITANA;174980;2;1;0;0;0;2;1;174980;MINICOMPONENTE MX-T40/ZS ALL IN ONE;ELECTRONICA MAYOR
8757907;;F;65;CHILENO;;Boomers;TALCA                         ;MAULE;287960;4;1;0;0;0;4;1;287960;PARLANTE MEGALUX K2777;ELECTRONICA MAYOR
17166062;;M;33;CHILENO;;Millenial;MELIPILLA                     ;METROPOLITANA;34990;1;1;0;0;0;1;1;34990;MLAB KARAOKE 8 CITY SET MICROFONO INALAMBRICO AT;ELECTRONICA MAYOR
11285274;;M;54;CHILENO;;Boomers;SAN JAVIER                    ;MAULE;467960;5;3;0;0;0;5;3;467960;PARLANTE ULTRAFORCE-I;ELECTRONICA MAYOR
9603210;;M;59;CHILENO;;Boomers;LA FLORIDA                    ;METROPOLITANA;169990;1;1;0;0;0;1;1;169990;LED 32 UN32T4300AGXZS HD SMART TV;ELECTRONICA MAYOR
15467695;;M;40;CHILENO;;X;PROVIDENCIA                   ;METROPOLITANA;193980;2;1;2;1;193980;0;0;0;LED 40 40S65A-40P ANDROID TV SMART LINE FHD;ELECTRONICA MAYOR
11601908;;M;52;CHILENO;;X;LEBU                          ;BIO BIO;27990;1;1;0;0;0;1;1;27990;PARLANTE KARAOKE 8 MAXEIGHT;ELECTRONICA MAYOR
14408162;;F;51;CHILENO;;X;CERRO NAVIA                   ;METROPOLITANA;154990;1;1;0;0;0;1;1;154990;KARAOKE TRUE WIRELESS DUAL 10 PULGADAS LIGHT SHO;ELECTRONICA MAYOR
7283688;Viudo;M;69;CHILENO;;Silencioso;CALBUCO                       ;LOS LAGOS;209990;1;1;0;0;0;1;1;209990;LED 40 UN40T5290AGXZS FHD SMART TV;ELECTRONICA MAYOR
8697712;;M;63;CHILENO;;Boomers;PROVIDENCIA                   ;METROPOLITANA;144540;2;1;2;1;144540;0;0;0;LED 32 CS32S1 SMART TV HD NEGRO;ELECTRONICA MAYOR
14642549;;F;52;PERUANO;;X;TOCOPILLA                     ;ANTOFAGASTA;16990;1;1;0;0;0;1;1;16990;KARAOKE URBAN AZUL;ELECTRONICA MAYOR
14511323;;F;47;CHILENO;;X;"";"";284980;2;1;2;1;284980;0;0;0;LED 43 43UP7500 UHD SMART TV;ELECTRONICA MAYOR
16284431;;F;35;CHILENO;;Millenial;LEBU                          ;BIO BIO;219964;4;2;0;0;0;4;2;219964;PARLANTE KARAOKE MGLIGHTNING NEGRO;ELECTRONICA MAYOR
9514027;Soltero;M;59;CHILENO;;Boomers;OSORNO                        ;LOS LAGOS;139990;1;1;0;0;0;1;1;139990;LED 32 CS32S1 SMART TV HD NEGRO;ELECTRONICA MAYOR
12762494;;M;47;CHILENO;;X;CHILLAN VIEJO                 ;BIO BIO;139990;1;1;0;0;0;1;1;139990;LED KIOTO 32 MI3228 SMART TV;ELECTRONICA MAYOR
16292500;;F;36;CHILENO;;Millenial;MELIPILLA                     ;METROPOLITANA;359990;1;1;0;0;0;1;1;359990;LED 55UP7500 UHD SMART;ELECTRONICA MAYOR
8243806;;M;61;CHILENO;;Boomers;VINA DEL MAR                  ;VALPARAISO;27980;2;1;0;0;0;2;1;27980;PARLANTE MG TWISTER;ELECTRONICA MAYOR
26421229;;M;41;VENEZOLANO;;Extranjero;N/D;N/D;1281950;5;5;0;0;0;5;5;1281950;PARLANTE ULTRAMAGIC;ELECTRONICA MAYOR
16260010;;F;36;CHILENO;;Millenial;N/D;N/D;238099;4;2;0;0;0;4;2;238099;LED 32 KHHD3221 SMART TV;ELECTRONICA MAYOR
15706996;;F;38;CHILENO;;Millenial;LO PRADO                      ;METROPOLITANA;263980;2;1;2;1;263980;0;0;0;LED 43 43UP7500 UHD SMART TV;ELECTRONICA MAYOR
12544303;;F;48;CHILENO;;X;PROVIDENCIA                   ;METROPOLITANA;169990;1;1;0;0;0;1;1;169990;PARLANTE ULTRAFORCE-I;ELECTRONICA MAYOR
18758087;;F;28;CHILENO;;Millenial;N/D;N/D;1360394;9;4;0;0;0;9;4;1360394;PARLANTE ULTRASENSATION;ELECTRONICA MAYOR
11046660;;M;56;CHILENO;;Boomers;CERRILLOS;METROPOLITANA;99990;1;1;0;0;0;1;1;99990;PARLANTE ULTRAMAGIC;ELECTRONICA MAYOR
13304687;;M;45;CHILENO;;X;TALCA                         ;MAULE;209980;2;1;0;0;0;2;1;209980;SOUNDBAR SJ2;ELECTRONICA MAYOR
7351608;Soltero;M;73;CHILENO;INGENIERO AGRICOLA;Silencioso;PROVIDENCIA                   ;METROPOLITANA;192980;2;1;0;0;0;2;1;192980;LED KIOTO 32 MI3228 SMART TV;ELECTRONICA MAYOR
5504808;;F;78;CHILENO;;Silencioso;RENCA                         ;METROPOLITANA;139990;1;1;0;0;0;1;1;139990;LED KIOTO 32 MI3228 SMART TV;ELECTRONICA MAYOR
11757225;;M;51;CHILENO;;X;RENCA                         ;METROPOLITANA;109990;1;1;0;0;0;1;1;109990;PARLANTE MEGALUX K2777;ELECTRONICA MAYOR
7215383;;M;68;CHILENO;;Silencioso;CONSTITUCION                  ;MAULE;179990;1;1;0;0;0;1;1;179990;PARLANTE ULTRAFORCE-I;ELECTRONICA MAYOR
15634481;;M;38;CHILENO;;X;PAINE                         ;METROPOLITANA;232940;5;2;3;1;167960;2;1;64980;MINICOMPONENTE OL45;ELECTRONICA MAYOR
19115850;;F;27;CHILENO;;Z;"";"";369990;1;1;0;0;0;1;1;369990;LED 55UP7500 UHD SMART;ELECTRONICA MAYOR
15685917;;F;38;CHILENO;;Millenial;ALTO HOSPICIO;TARAPACA;399990;1;1;0;0;0;1;1;399990;LED 55UP7500 UHD SMART;ELECTRONICA MAYOR
9875420;;M;58;CHILENO;;Boomers;RENCA                         ;METROPOLITANA;289990;2;1;2;1;289990;0;0;0;LED 50 50UP7500 UHD SMART TV;ELECTRONICA MAYOR
11200620;;M;55;CHILENO;;Boomers;RETIRO                        ;MAULE;733950;5;2;2;1;311980;3;1;421970;LED 58 UN58AU7000GXZS UHD 4K SMART TV;ELECTRONICA MAYOR
24173253;;M;24;PERUANO;;Extranjero;N/D;N/D;299980;2;1;0;0;0;2;1;299980;LED 42 KHFH4221 SMART TV;ELECTRONICA MAYOR
8767361;;M;62;CHILENO;;Boomers;MOLINA                        ;MAULE;172980;2;1;0;0;0;2;1;172980;PARLANTE ULTRAFUSION;ELECTRONICA MAYOR
10387964;;F;40;CHILENO;;X;PROVIDENCIA                   ;METROPOLITANA;269990;1;1;1;1;269990;0;0;0;LED 43 UN43TU7090GXZS UHD SMART TV;ELECTRONICA MAYOR
17093523;;F;33;CHILENO;;Millenial;N/D;N/D;579970;3;2;2;1;399980;1;1;179990;LED 42 KHFH4221 SMART TV;ELECTRONICA MAYOR
7600788;;M;68;CHILENO;;Boomers;LANCO                         ;LOS RIOS;269990;1;1;0;0;0;1;1;269990;LED 50 CS50S1USM UHD SMART TV NEGRO;ELECTRONICA MAYOR
19415129;Soltero;M;25;CHILENO;;Z;PROVIDENCIA                   ;METROPOLITANA;375840;2;1;2;1;375840;0;0;0;LED 58 UN58AU7000GXZS UHD 4K SMART TV;ELECTRONICA MAYOR
7616837;;M;61;CHILENO;;Boomers;CONSTITUCION                  ;MAULE;379990;1;1;0;0;0;1;1;379990;LED 55 UN55TU7090GXZS SMART TV UHD;ELECTRONICA MAYOR
26647666;;M;34;VENEZOLANO;;Extranjero;N/D;N/D;154980;2;1;2;1;154980;0;0;0;LED 42 KHFH4221 SMART TV;ELECTRONICA MAYOR
26002950;;M;43;VENEZOLANO;;Extranjero;ARICA                         ;ARICA Y PARINACOTA;190770;2;1;0;0;0;2;1;190770;SOUNDBAR HW-A450/ZS;ELECTRONICA MAYOR
17945002;;M;30;CHILENO;;Millenial;QUILPUE                       ;VALPARAISO;155670;2;1;0;0;0;2;1;155670;PARLANTE ULTRAFUSION;ELECTRONICA MAYOR
13815938;;M;42;CHILENO;;X;RENCA                         ;METROPOLITANA;279990;1;1;1;1;279990;0;0;0;LED 50 50PUD7625 SMART TV ULTRA HD 4K;ELECTRONICA MAYOR
15434632;;M;39;CHILENO;;X;N/D;N/D;390970;4;2;4;2;390970;0;0;0;LED 58 UN58AU7000GXZS UHD 4K SMART TV;ELECTRONICA MAYOR
16540873;;M;35;CHILENO;;Millenial;TEMUCO                        ;ARAUCANIA;0;0;2;1;1;189990;-1;1;-189990;LED 42 KHFH4221 SMART TV;ELECTRONICA MAYOR
17714588;;M;31;CHILENO;;Millenial;N/D;N/D;424520;3;1;3;1;424520;0;0;0;LED 40 UN40T5290AGXZS FHD SMART TV;ELECTRONICA MAYOR
7047268;;F;63;CHILENO;;Boomers;PROVIDENCIA                   ;METROPOLITANA;542980;2;1;0;0;0;2;1;542980;LED 60 UN60AU8000GXZS UHD SMART TV;ELECTRONICA MAYOR
12368650;;F;48;CHILENO;;X;PAREDONES                     ;L.G.B.OÂ´HIGGINS;595260;3;2;0;0;0;3;2;595260;LED 60 UN60AU8000GXZS UHD SMART TV;ELECTRONICA MAYOR
13136564;;M;45;CHILENO;;X;PROVIDENCIA                   ;METROPOLITANA;129990;1;1;0;0;0;1;1;129990;PARLANTE ULTRAFUSION;ELECTRONICA MAYOR
8652138;;M;67;CHILENO;;Boomers;PUCON                         ;ARAUCANIA;492360;3;1;0;0;0;3;1;492360;LED 50 UN50TU7090GXZS UHD SMART TV;ELECTRONICA MAYOR
5723635;;M;74;CHILENO;;Silencioso;RENCA                         ;METROPOLITANA;49670;2;1;0;0;0;2;1;49670;KARAOKE FUNKY DISCO;ELECTRONICA MAYOR
10622183;;F;57;CHILENO;;Boomers;LAJA                          ;BIO BIO;129990;1;1;0;0;0;1;1;129990;PARLANTE ULTRAFUSION;ELECTRONICA MAYOR
17912682;;F;30;CHILENO;;Millenial;GRANEROS                      ;L.G.B.OÂ´HIGGINS;709810;5;3;4;2;419820;1;1;289990;LED 50 50PUD7625 SMART TV ULTRA HD 4K;ELECTRONICA MAYOR
18974014;;F;27;CHILENO;;Z;"";"";309990;1;3;0;0;0;1;3;309990;LED 49 49UN7100 UHD SMART TV;ELECTRONICA MAYOR
24042747;;F;45;PERUANO;;Extranjero;N/D;N/D;152470;2;1;0;0;0;2;1;152470;MINICOMPONENTE OL45;ELECTRONICA MAYOR
11990305;;F;50;CHILENO;;X;LLAILLAY                      ;VALPARAISO;261030;5;3;0;0;0;5;3;261030;LED 32 KHHD3221 SMART TV;ELECTRONICA MAYOR
15981161;;F;34;CHILENO;;Millenial;CURACAUTIN                    ;ARAUCANIA;721950;4;1;4;1;721950;0;0;0;LED 58 UN58AU7000GXZS UHD 4K SMART TV;ELECTRONICA MAYOR
13705797;;M;42;CHILENO;;X;CURANILAHUE                   ;BIO BIO;129990;1;1;1;1;129990;0;0;0;LED 32 KHHD3221 SMART TV;ELECTRONICA MAYOR
5652513;;M;76;CHILENO;;Silencioso;VALLENAR;ATACAMA;183560;3;1;0;0;0;3;1;183560;MINICOMPONENTE OL45;ELECTRONICA MAYOR
16519360;;M;35;CHILENO;;Millenial;CONSTITUCION                  ;MAULE;263640;5;3;0;0;0;5;3;263640;LED 43 CS43F2 SMART TV FHD NEGRO;ELECTRONICA MAYOR
9021685;;F;61;CHILENO;;Boomers;CABILDO                       ;VALPARAISO;169570;2;1;0;0;0;2;1;169570;LED 32 KHHD3221 SMART TV;ELECTRONICA MAYOR
7825556;;M;64;CHILENO;;Boomers;N/D;N/D;309990;1;1;0;0;0;1;1;309990;LED 50 50PUD7625 SMART TV ULTRA HD 4K;ELECTRONICA MAYOR
6560778;;F;71;CHILENO;;Silencioso;ALTO HOSPICIO;TARAPACA;354980;2;1;0;0;0;2;1;354980;LED 49 49UN7100 UHD SMART TV;ELECTRONICA MAYOR
9128508;;M;58;CHILENO;;Boomers;PROVIDENCIA                   ;METROPOLITANA;209990;2;1;2;1;209990;0;0;0;LED 43 43S5305 SMART TV FULL HD;ELECTRONICA MAYOR
16119358;;M;37;CHILENO;;Millenial;RETIRO                        ;MAULE;395480;2;1;2;1;395480;0;0;0;LED 50 50UP7750 FHD SMART TV + MAGIC;ELECTRONICA MAYOR
19477377;;F;25;CHILENO;;Z;PADRE LAS CASAS               ;ARAUCANIA;179990;1;1;0;0;0;1;1;179990;LED 42 KHFH4221 SMART TV;ELECTRONICA MAYOR
6711731;Casado;M;70;CHILENO;;Silencioso;ILLAPEL                       ;COQUIMBO;58670;2;1;0;0;0;2;1;58670;KARAOKE RHYTHM CHARGER 12 MIC CABLE 8890;ELECTRONICA MAYOR
9161860;Casado;M;60;CHILENO;;Boomers;RENCA                         ;METROPOLITANA;189990;1;1;1;1;189990;0;0;0;LED 42 KHFH4221 SMART TV;ELECTRONICA MAYOR
16497141;;M;35;CHILENO;;Millenial;PROVIDENCIA                   ;METROPOLITANA;219990;1;1;1;1;219990;0;0;0;LED 43 43S5305 SMART TV FULL HD;ELECTRONICA MAYOR
9595036;;F;63;CHILENO;;Boomers;SAN CARLOS                    ;BIO BIO;169990;1;1;0;0;0;1;1;169990;LED 42 KHFH4221 SMART TV;ELECTRONICA MAYOR
15915482;;F;37;CHILENO;;Millenial;SAN VICENTE                   ;L.G.B.OÂ´HIGGINS;379990;1;1;0;0;0;1;1;379990;LED 55 UN55TU7090GXZS SMART TV UHD;ELECTRONICA MAYOR
13354907;;M;43;CHILENO;;X;TALCA                         ;MAULE;59980;2;2;0;0;0;2;2;59980;KARAOKE 8 CITY SET MIC WIRELESS ATRIL SILVER;ELECTRONICA MAYOR
18648567;Soltero;F;27;CHILENO;;Silencioso;PROVIDENCIA                   ;METROPOLITANA;177980;2;1;0;0;0;2;1;177980;LED 32 KHHD3221 SMART TV;ELECTRONICA MAYOR
13277572;Soltero;F;45;CHILENO;;X;SANTIAGO                      ;METROPOLITANA;463980;2;1;2;1;463980;0;0;0;QLED 50 QN50Q60AAGXZS 4K UHD SMART TV;ELECTRONICA MAYOR
8732065;;F;60;CHILENO;;Boomers;VALLENAR;ATACAMA;169990;1;1;0;0;0;1;1;169990;LED 32 KHHD3221 SMART TV;ELECTRONICA MAYOR
11815132;;M;50;CHILENO;;X;ARICA                         ;TARAPACA;774979;2;1;0;0;0;2;1;774979;LED 58 UN58AU7000GXZS UHD 4K SMART TV;ELECTRONICA MAYOR
17524474;;M;30;CHILENO;;Silencioso;PROVIDENCIA                   ;METROPOLITANA;329980;2;1;2;1;329980;0;0;0;LED 50 50UP7500 UHD SMART TV;ELECTRONICA MAYOR
18987485;;F;26;CHILENO;;Z;PROVIDENCIA                   ;METROPOLITANA;185840;2;1;2;1;185840;0;0;0;LED 42 KHFH4221 SMART TV;ELECTRONICA MAYOR
11471476;;M;52;CHILENO;;X;LA SERENA                     ;COQUIMBO;504830;2;1;0;0;0;2;1;504830;LED 55 UN55TU7090GXZS SMART TV UHD;ELECTRONICA MAYOR
18810528;;F;27;CHILENO;;Millenial;N/D;N/D;200680;3;1;3;1;200680;0;0;0;LED 32 UN32T4300AGXZS HD SMART TV;ELECTRONICA MAYOR
10755315;;F;56;CHILENO;;Boomers;N/D;N/D;189990;1;1;0;0;0;1;1;189990;LED 32 UN32T4300AGXZS HD SMART TV;ELECTRONICA MAYOR
18484403;Soltero;F;29;CHILENO;TERAPEUTA OCUPACIONAL;Millenial;PROVIDENCIA                   ;METROPOLITANA;319990;1;1;1;1;319990;0;0;0;LED 50 50UP7500 UHD SMART TV;ELECTRONICA MAYOR
12328947;;F;49;CHILENO;;X;CURANILAHUE                   ;BIO BIO;463210;5;3;0;0;0;5;3;463210;LED 55UP7500 UHD SMART;ELECTRONICA MAYOR
17227730;;M;33;CHILENO;;Silencioso;PROVIDENCIA                   ;METROPOLITANA;184980;2;1;2;1;184980;0;0;0;LED 42 KHFH4221 SMART TV;ELECTRONICA MAYOR
12255209;;M;50;CHILENO;;X;RENCA                         ;METROPOLITANA;189990;1;1;0;0;0;1;1;189990;LED 32 UN32T4300AGXZS HD SMART TV;ELECTRONICA MAYOR
16416647;;M;35;CHILENO;;Millenial;PROVIDENCIA                   ;METROPOLITANA;143980;2;1;2;1;143980;0;0;0;MINICOMPONENTE CJ45;ELECTRONICA MAYOR
11608486;;M;52;CHILENO;;X;EL MONTE                      ;METROPOLITANA;289990;1;1;0;0;0;1;1;289990;LED 43 43UP7500 UHD SMART TV;ELECTRONICA MAYOR
14417746;;M;51;CHILENO;;X;N/D;N/D;206000;1;1;1;1;206000;0;0;0;LED 43 43S5305 SMART TV FULL HD;ELECTRONICA MAYOR
11940338;Soltero;F;50;CHILENO;PROFESOR;X;PROVIDENCIA                   ;METROPOLITANA;167540;2;1;2;1;167540;0;0;0;LED 32 KHHD3221 SMART TV;ELECTRONICA MAYOR
7338740;;F;70;CHILENO;;Silencioso;CAUQUENES                     ;MAULE;49990;1;1;0;0;0;1;1;49990;KARAOKE RHYTHM CHARGER 12 MIC CABLE 8890;ELECTRONICA MAYOR
16546467;;M;35;CHILENO;;Millenial;PROVIDENCIA                   ;METROPOLITANA;453980;2;1;2;1;453980;0;0;0;SOUNDBAR SP8A;ELECTRONICA MAYOR
17966331;;M;30;CHILENO;;Millenial;N/D;N/D;394210;4;2;0;0;0;4;2;394210;LED 42 KHFH4221 SMART TV;ELECTRONICA MAYOR
17423364;;M;31;CHILENO;;Millenial;PROVIDENCIA                   ;METROPOLITANA;319990;1;1;1;1;319990;0;0;0;LED 50 50UP7500 UHD SMART TV;ELECTRONICA MAYOR
17695468;Soltero;F;27;CHILENO;PROFESOR;Millenial;PROVIDENCIA                   ;METROPOLITANA;457080;4;2;4;2;457080;0;0;0;LED 40 UN40T5290AGXZS FHD SMART TV;ELECTRONICA MAYOR
14422139;;F;49;CHILENO;;X;RENCA                         ;METROPOLITANA;424980;2;1;2;1;424980;0;0;0;LED 58 UN58AU7000GXZS UHD 4K SMART TV;ELECTRONICA MAYOR
7635043;Casado;F;69;CHILENO;;Silencioso;CHEPICA                       ;L.G.B.OÂ´HIGGINS;864950;6;2;0;0;0;6;2;864950;LED 42 KHFH4221 SMART TV;ELECTRONICA MAYOR
23667030;;M;35;PERUANO;;Extranjero;SANTIAGO                      ;METROPOLITANA;369990;1;1;0;0;0;1;1;369990;LED 55 55P615 UHD ANDROID TV 4K;ELECTRONICA MAYOR
25589348;;M;30;HAITIANO;;Extranjero;INDEPENDENCIA                 ;METROPOLITANA;910850;4;1;0;0;0;4;1;910850;LED 65UP8050 UHD SMART + MAGIC;ELECTRONICA MAYOR
26172448;;M;40;VENEZOLANO;;Extranjero;CHIGUAYANTE                   ;BIO BIO;304990;1;1;0;0;0;1;1;304990;LED 50 UN50TU7090GXZS UHD SMART TV;ELECTRONICA MAYOR
15089530;Casado;F;39;CHILENO;PSICOLOGO;X;RENCA                         ;METROPOLITANA;293980;2;1;2;1;293980;0;0;0;LED 43 UN43TU7090GXZS UHD SMART TV;ELECTRONICA MAYOR
15119098;;F;39;CHILENO;;X;LA PINTANA                    ;METROPOLITANA;302860;3;2;0;0;0;3;2;302860;LED 43 43S5305 SMART TV FULL HD;ELECTRONICA MAYOR
16383296;;F;35;CHILENO;;Silencioso;PROVIDENCIA                   ;METROPOLITANA;71990;1;1;0;0;0;1;1;71990;PARLANTE KARAOKE RM1 8 PULGADAS;ELECTRONICA MAYOR
10526623;Casado;F;55;CHILENO;;Boomers;PROVIDENCIA                   ;METROPOLITANA;423980;2;1;2;1;423980;0;0;0;LED 58 UN58AU7000GXZS UHD 4K SMART TV;ELECTRONICA MAYOR
8231253;Casado;F;62;CHILENO;;Boomers;PROVIDENCIA                   ;METROPOLITANA;305480;2;1;2;1;305480;0;0;0;LED 43 43UP7500 UHD SMART TV;ELECTRONICA MAYOR
14437924;;F;51;CHILENO;;X;N/D;N/D;281940;4;1;4;1;281940;0;0;0;LED 32 KHHD3221 SMART TV;ELECTRONICA MAYOR
16118165;;M;36;CHILENO;;Millenial;PROVIDENCIA                   ;METROPOLITANA;243980;2;1;2;1;243980;0;0;0;LED 40 UN40T5290AGXZS FHD SMART TV;ELECTRONICA MAYOR
14387558;;F;44;CHILENO;;X;LIMACHE                       ;VALPARAISO;304980;2;1;2;1;304980;0;0;0;LED 50 50PUD7625 SMART TV ULTRA HD 4K;ELECTRONICA MAYOR
25444337;;M;56;HAITIANO;;Extranjero;CURICO                        ;MAULE;459650;4;2;0;0;0;4;2;459650;LED 32LM637B HD SMART;ELECTRONICA MAYOR
15466471;;F;40;CHILENO;;X;PROVIDENCIA                   ;METROPOLITANA;303980;2;1;2;1;303980;0;0;0;LED 50 50PUD7625 SMART TV ULTRA HD 4K;ELECTRONICA MAYOR
13526568;;M;44;CHILENO;;X;AISEN                         ;AYSEN;196980;2;1;2;1;196980;0;0;0;LED 42 KHFH4221 SMART TV;ELECTRONICA MAYOR
20464709;;F;22;CHILENO;;Z;PROVIDENCIA                   ;METROPOLITANA;23980;2;1;2;1;23980;0;0;0;KARAOKE EXTRA SAVAGE MICÂ CABLEÂ BLACK 8902;ELECTRONICA MAYOR
19442189;;F;25;CHILENO;;Z;LEBU                          ;BIO BIO;484960;4;2;0;0;0;4;2;484960;LED 32 KHHD3221 SMART TV;ELECTRONICA MAYOR
19400470;;M;23;CHILENO;;Z;COPIAPO;ATACAMA;188640;2;1;2;1;188640;0;0;0;LED 32 32S60-32P ANDROID TV SMART LINE HD;ELECTRONICA MAYOR
9369894;;F;61;CHILENO;;Boomers;N/D;N/D;224980;2;1;0;0;0;2;1;224980;LED 32 UN32T4300AGXZS HD SMART TV;ELECTRONICA MAYOR
16243063;;F;37;CHILENO;;Millenial;PEDRO AGUIRRE CERDA           ;METROPOLITANA;28980;2;1;2;1;28980;0;0;0;MAGIC REMOTE MR20GA;ELECTRONICA MAYOR
8837963;;M;63;CHILENO;;Boomers;CORONEL                       ;BIO BIO;824840;5;2;0;0;0;5;2;824840;LED NanoCell 55NANO80 UHD SMART + MAGIC;ELECTRONICA MAYOR
15478503;Casado;F;39;CHILENO;DISENADOR GRAFICO;X;PROVIDENCIA                   ;METROPOLITANA;717940;6;2;3;1;129970;3;1;587970;LED 50 50NANO75 NanoCell UHD SMART + MAGIC;ELECTRONICA MAYOR
7337911;Casado;M;66;CHILENO;;Boomers;COINCO                        ;L.G.B.OÂ´HIGGINS;0;0;2;0;0;0;0;2;0;LED 32 32PHD6825 HD SMART TV;ELECTRONICA MAYOR
20402536;;F;22;CHILENO;;Z;N/D;N/D;69990;1;1;0;0;0;1;1;69990;SOUNDBAR SK1;ELECTRONICA MAYOR
9292232;;M;60;CHILENO;;Boomers;VALDIVIA                      ;LOS LAGOS;87170;2;1;0;0;0;2;1;87170;PARLANTE MGVIPER;ELECTRONICA MAYOR
6677676;;M;65;CHILENO;;Silencioso;PROVIDENCIA                   ;METROPOLITANA;326980;2;2;0;0;0;2;2;326980;LED 49 49UN7100 UHD SMART TV;ELECTRONICA MAYOR
18781106;;F;27;CHILENO;;Millenial;TALCA                         ;MAULE;569990;1;1;0;0;0;1;1;569990;LED 65 UN65AU7000GXZS UHD 4K SMART TV;ELECTRONICA MAYOR
16732470;;F;35;CHILENO;;Millenial;N/D;N/D;40980;2;1;0;0;0;2;1;40980;KARAOKE STREET SONG 4 MICÂ CABLEÂ BLACK 8900;ELECTRONICA MAYOR
13835116;;F;42;CHILENO;;X;LA PINTANA                    ;METROPOLITANA;179990;1;1;0;0;0;1;1;179990;MINICOMPONENTE RN7;ELECTRONICA MAYOR
19753416;;F;24;CHILENO;;Silencioso;QUILICURA                     ;METROPOLITANA;182460;3;1;0;0;0;3;1;182460;MINICOMPONENTE CJ45;ELECTRONICA MAYOR
13112148;;F;45;CHILENO;;X;TEMUCO                        ;ARAUCANIA;497970;3;2;0;0;0;3;2;497970;LED 49 49UN7100 UHD SMART TV;ELECTRONICA MAYOR
17653091;;F;31;CHILENO;;Millenial;VILLARICA                     ;ARAUCANIA;469990;1;1;0;0;0;1;1;469990;LED 55 55UP7750 UHD SMART + MAGIC;ELECTRONICA MAYOR
17991241;;F;30;CHILENO;;Millenial;ERCILLA                       ;ARAUCANIA;708860;3;1;0;0;0;3;1;708860;LED 70 UN70AU7000GXZS UHD;ELECTRONICA MAYOR
6368747;;M;69;CHILENO;;Silencioso;N/D;N/D;149990;1;1;0;0;0;1;1;149990;LED 32 CS32S1 SMART TV HD NEGRO;ELECTRONICA MAYOR
4892375;;M;75;CHILENO;;Silencioso;RENCA                         ;METROPOLITANA;317870;2;1;0;0;0;2;1;317870;LED 40 UN40T5290AGXZS FHD SMART TV;ELECTRONICA MAYOR
15549906;;F;37;CHILENO;;Millenial;TEMUCO                        ;ARAUCANIA;429990;1;1;1;1;429990;0;0;0;LED 55 55UP7750 UHD SMART + MAGIC;ELECTRONICA MAYOR
8762038;;M;63;CHILENO;;Boomers;TALCA                         ;MAULE;523600;6;2;0;0;0;6;2;523600;MINICOMPONENTE MX-T40/ZS ALL IN ONE;ELECTRONICA MAYOR
6772275;;F;79;CHILENO;;Silencioso;TEMUCO                        ;ARAUCANIA;243570;2;1;0;0;0;2;1;243570;LED 32LM637B HD SMART;ELECTRONICA MAYOR
5146472;;F;82;CHILENO;;Silencioso;SAN BERNARDO                  ;METROPOLITANA;231570;2;1;0;0;0;2;1;231570;LED 32 UN32T4300AGXZS HD SMART TV;ELECTRONICA MAYOR
13370822;;M;54;CHILENO;;Silencioso;PROVIDENCIA                   ;METROPOLITANA;203470;2;1;0;0;0;2;1;203470;MINICOMPONENTE RN5;ELECTRONICA MAYOR
15869755;;M;37;CHILENO;;Millenial;N/D;N/D;95980;2;1;0;0;0;2;1;95980;PARLANTE ULTRAMEGA;ELECTRONICA MAYOR
20014226;;M;23;CHILENO;;Z;VINA DEL MAR                  ;VALPARAISO;96062;3;1;0;0;0;3;1;96062;PARLANTE KARAOKE MGROKR NEGRO;ELECTRONICA MAYOR
14160622;;M;41;CHILENO;;X;N/D;N/D;371760;3;2;0;0;0;3;2;371760;LED 50 50U6305 SMART TV ULTRA HD;ELECTRONICA MAYOR
19175684;;M;24;CHILENO;;Z;N/D;N/D;218070;2;1;0;0;0;2;1;218070;MINICOMPONENTE RN5;ELECTRONICA MAYOR
26393337;;M;40;VENEZOLANO;;Extranjero;CONCEPCION                    ;BIO BIO;213470;2;1;0;0;0;2;1;213470;MINICOMPONENTE RN7;ELECTRONICA MAYOR
7552963;;F;66;CHILENO;;Boomers;PROVIDENCIA                   ;METROPOLITANA;248870;2;1;0;0;0;2;1;248870;LED 32LM637B HD SMART;ELECTRONICA MAYOR
11858121;Casado;M;50;CHILENO;INGENIERIA CIVIL INFORMATICA;X;RENCA                         ;METROPOLITANA;154990;1;1;0;0;0;1;1;154990;MONITOR 24 24TL520S SMART TV HD;ELECTRONICA MAYOR
5137311;;F;78;CHILENO;;Silencioso;PROVIDENCIA                   ;METROPOLITANA;190660;3;1;0;0;0;3;1;190660;KARAOKE SP-101BT ALL IN ONE PORTATIL 60W;ELECTRONICA MAYOR
10981512;;M;49;CHILENO;;Silencioso;PROVIDENCIA                   ;METROPOLITANA;409990;1;1;0;0;0;1;1;409990;LED 55 UN55TU8300GXZS UHD SMART TV CURVO;ELECTRONICA MAYOR
15222918;Casado;F;39;CHILENO;ENFERMERA;X;CONCEPCION                    ;BIO BIO;699990;1;1;0;0;0;1;1;699990;LED NanoCell 65NANO75 UHD SMART + MAGIC;ELECTRONICA MAYOR
13348634;;M;44;CHILENO;;Silencioso;PROVIDENCIA                   ;METROPOLITANA;149990;1;1;0;0;0;1;1;149990;MONITOR 24 24TL520S SMART TV HD;ELECTRONICA MAYOR
8445195;;M;64;CHILENO;;Boomers;LOTA                          ;BIO BIO;0;0;0;0;0;0;0;0;0;LED 58 58F2 SMART TV UHD;ELECTRONICA MAYOR
11574061;;F;51;CHILENO;;X;HUALQUI                       ;BIO BIO;0;0;0;0;0;0;0;0;0;PARLANTE KARAOKE 12 FM/BT/USB;ELECTRONICA MAYOR
15516735;;F;38;CHILENO;;X;N/D;N/D;0;0;0;0;0;0;0;0;0;LED 40 UN40T5290AGXZS FHD SMART TV;ELECTRONICA MAYOR
8506112;;M;62;CHILENO;;Boomers;ANCUD                         ;LOS LAGOS;0;0;0;0;0;0;0;0;0;MINICOMPONENTE CJ45;ELECTRONICA MAYOR
16627836;;F;34;CHILENO;;Silencioso;N/D;N/D;0;0;0;0;0;0;0;0;0;MINICOMPONENTE RN9;ELECTRONICA MAYOR
7954753;;M;63;CHILENO;;Boomers;PROVIDENCIA                   ;METROPOLITANA;0;0;0;0;0;0;0;0;0;LED 50 UN50TU7090GXZS UHD SMART TV;ELECTRONICA MAYOR
6045026;Casado;M;68;CHILENO;;Silencioso;PROVIDENCIA                   ;METROPOLITANA;0;0;0;0;0;0;0;0;0;PARLANTE KARAOKE 12 FM/BT/USB;ELECTRONICA MAYOR
15668299;;M;38;CHILENO;;Millenial;N/D;N/D;0;0;0;0;0;0;0;0;0;LED 32LM637B HD SMART;ELECTRONICA MAYOR
8164682;Casado;F;61;CHILENO;;Boomers;LA PINTANA                    ;METROPOLITANA;0;0;0;0;0;0;0;0;0;SOUNDBAR TS6110;ELECTRONICA MAYOR
15949400;;F;37;CHILENO;;Millenial;VALPARAISO                    ;VALPARAISO;0;0;0;0;0;0;0;0;0;LED 32LM637B HD SMART;ELECTRONICA MAYOR
18047445;;F;30;CHILENO;;Millenial;PENALOLEN                     ;METROPOLITANA;0;0;0;0;0;0;0;0;0;LED 60 UN60AU8000GXZS UHD SMART TV;ELECTRONICA MAYOR
20317484;;F;23;CHILENO;;Z;COYHAIQUE;AYSEN;0;0;0;0;0;0;0;0;0;LED 32LM637B HD SMART;ELECTRONICA MAYOR
10664846;;M;53;CHILENO;;X;ARICA                         ;TARAPACA;0;0;0;0;0;0;0;0;0;LED 50 50U6305 SMART TV ULTRA HD;ELECTRONICA MAYOR
10861922;;F;57;CHILENO;;Boomers;PADRE HURTADO                 ;METROPOLITANA;0;0;0;0;0;0;0;0;0;LED 43 43UP7500 UHD SMART TV;ELECTRONICA MAYOR
17873751;;F;31;CHILENO;;Millenial;N/D;N/D;0;0;0;0;0;0;0;0;0;MINICOMPONENTE RN5;ELECTRONICA MAYOR
17649590;Soltero;M;30;CHILENO;;Millenial;PROVIDENCIA                   ;METROPOLITANA;0;0;0;0;0;0;0;0;0;PARLANTE BOLA DISCO CON MICROFONO INAL;ELECTRONICA MAYOR
15980546;Soltero;F;37;CHILENO;QUIMICO FARMACEUTICO;Millenial;N/D;N/D;0;0;0;0;0;0;0;0;0;LED 55UP7500 UHD SMART;ELECTRONICA MAYOR
9804123;;F;58;CHILENO;;Boomers;RENCA                         ;METROPOLITANA;0;0;0;0;0;0;0;0;0;MONITOR 24 24TL520S SMART TV HD;ELECTRONICA MAYOR
11096490;;F;55;CHILENO;;Boomers;RENCA                         ;METROPOLITANA;0;0;0;0;0;0;0;0;0;LED 43 UN43T5202AGXZS FHD SMART TV;ELECTRONICA MAYOR
11992862;;F;49;CHILENO;;X;MAIPU                         ;METROPOLITANA;0;0;0;0;0;0;0;0;0;LED 70 UN70AU7000GXZS UHD;ELECTRONICA MAYOR
16495218;;M;35;CHILENO;;Millenial;PROVIDENCIA                   ;METROPOLITANA;0;0;0;0;0;0;0;0;0;MINICOMPONENTE CJ45;ELECTRONICA MAYOR
12985063;;M;45;CHILENO;;X;N/D;N/D;0;0;0;0;0;0;0;0;0;LED 32 UN32T4300AGXZS HD SMART TV;ELECTRONICA MAYOR
10845310;;M;55;CHILENO;;Boomers;PROVIDENCIA                   ;METROPOLITANA;0;0;0;0;0;0;0;0;0;LED 43 43UP7500 UHD SMART TV;ELECTRONICA MAYOR
10136988;;F;59;CHILENO;;Boomers;MAIPU                         ;METROPOLITANA;0;0;0;0;0;0;0;0;0;LED KIOTO 32 MI3228 SMART TV;ELECTRONICA MAYOR
10888154;;F;42;CHILENO;;X;VINA DEL MAR                  ;VALPARAISO;0;0;0;0;0;0;0;0;0;LED 32 32PHD6825 HD SMART TV;ELECTRONICA MAYOR
10583387;;F;48;CHILENO;;X;PROVIDENCIA                   ;METROPOLITANA;0;0;0;0;0;0;0;0;0;QLED 55 QN55Q60AAGXZS 4K UHD SMART TV;ELECTRONICA MAYOR
12246675;;F;49;CHILENO;;X;MELIPILLA                     ;METROPOLITANA;0;0;0;0;0;0;0;0;0;MINICOMPONENTE RN9;ELECTRONICA MAYOR
11599010;Casado;M;52;CHILENO;;X;PROVIDENCIA                   ;METROPOLITANA;0;0;0;0;0;0;0;0;0;LED 40 UN40T5290AGXZS FHD SMART TV;ELECTRONICA MAYOR
9632773;;F;64;CHILENO;;Silencioso;PROVIDENCIA                   ;METROPOLITANA;0;0;0;0;0;0;0;0;0;LED 32 32PHD6825 HD SMART TV;ELECTRONICA MAYOR
17646745;Soltero;M;31;CHILENO;;Millenial;PROVIDENCIA                   ;METROPOLITANA;0;0;0;0;0;0;0;0;0;LED 60 UN60AU8000GXZS UHD SMART TV;ELECTRONICA MAYOR
12851064;;F;47;CHILENO;;X;IQUIQUE                       ;TARAPACA;0;0;0;0;0;0;0;0;0;LED 40 UN40T5290AGXZS FHD SMART TV;ELECTRONICA MAYOR
17520025;;F;31;CHILENO;;Millenial;PROVIDENCIA                   ;METROPOLITANA;0;0;0;0;0;0;0;0;0;LED 50 UN50TU7090GXZS UHD SMART TV;ELECTRONICA MAYOR
12103995;Casado;F;48;CHILENO;;X;N/D;N/D;0;0;0;0;0;0;0;0;0;MINICOMPONENTE OL45;ELECTRONICA MAYOR
13580576;;F;42;CHILENO;;X;LA PINTANA                    ;METROPOLITANA;0;0;0;0;0;0;0;0;0;LED 32 32S5295 SMART TV HD;ELECTRONICA MAYOR
20363560;;M;22;CHILENO;;Silencioso;PROVIDENCIA                   ;METROPOLITANA;0;0;0;0;0;0;0;0;0;LED 42 42S6500 ANDROID TV FHD;ELECTRONICA MAYOR
5277856;;F;76;CHILENO;;Silencioso;ERCILLA                       ;ARAUCANIA;0;0;0;0;0;0;0;0;0;MINICOMPONENTE MHC-V02 ALL IN ONE;ELECTRONICA MAYOR
9331306;;M;61;CHILENO;;Boomers;SAN CARLOS                    ;BIO BIO;0;0;0;0;0;0;0;0;0;LED 40 UN40T5290AGXZS FHD SMART TV;ELECTRONICA MAYOR
18217293;;M;30;CHILENO;;Millenial;COPIAPO                       ;ATACAMA;0;0;0;0;0;0;0;0;0;LED 60 UN60AU8000GXZS UHD SMART TV;ELECTRONICA MAYOR
15169998;;M;40;CHILENO;;X;PROVIDENCIA                   ;METROPOLITANA;0;0;0;0;0;0;0;0;0;LED 50 KHUH5021 SMART TV;ELECTRONICA MAYOR
18359745;;F;29;CHILENO;;Millenial;SAN JAVIER                    ;MAULE;0;0;0;0;0;0;0;0;0;LED 42 42S6500 ANDROID TV FHD;ELECTRONICA MAYOR
9025523;;M;60;CHILENO;;Boomers;RENCA                         ;METROPOLITANA;0;0;0;0;0;0;0;0;0;MINICOMPONENTE MHC-V02 ALL IN ONE;ELECTRONICA MAYOR
11688663;;F;52;CHILENO;;X;TEMUCO                        ;ARAUCANIA;0;0;0;0;0;0;0;0;0;PARLANTE ULTRAMEGA;ELECTRONICA MAYOR
14533833;;F;47;CHILENO;;X;COPIAPO                       ;ATACAMA;0;0;0;0;0;0;0;0;0;PARLANTE ULTRAFORCE-I;ELECTRONICA MAYOR
9055641;;M;61;CHILENO;;Boomers;NIQUEN                        ;BIO BIO;0;0;0;0;0;0;0;0;0;LED 55 55P615 UHD ANDROID TV 4K;ELECTRONICA MAYOR
20093300;;F;23;CHILENO;;Millenial;N/D;N/D;0;0;0;0;0;0;0;0;0;LED 32 32S5295 SMART TV HD;ELECTRONICA MAYOR
17769503;;F;31;CHILENO;;Millenial;RENCA                         ;METROPOLITANA;0;0;0;0;0;0;0;0;0;QLED 55 QN55Q70AAGXZS 4K UHD SMART TV;ELECTRONICA MAYOR
12327284;;M;49;CHILENO;;X;LOS ANGELES                   ;BIO BIO;0;0;0;0;0;0;0;0;0;PARLANTE ULTRAMEGA;ELECTRONICA MAYOR
18653026;;F;28;CHILENO;;Millenial;N/D;N/D;0;0;0;0;0;0;0;0;0;LED 43 UN43T5202AGXZS FHD SMART TV;ELECTRONICA MAYOR
17929855;;F;30;CHILENO;;Millenial;MAIPU                         ;METROPOLITANA;0;0;0;0;0;0;0;0;0;LED 40 KEHD4020 SMART TV;ELECTRONICA MAYOR
18259731;;M;29;CHILENO;;Millenial;SANTA MARIA                   ;VALPARAISO;0;0;0;0;0;0;0;0;0;MINICOMPONENTE MX-T50/ZS ALL IN ONE;ELECTRONICA MAYOR
6834188;Casado;M;71;CHILENO;TECNICO EN ADMINISTRACION DE EMPRESAS;Silencioso;LA SERENA                     ;COQUIMBO;0;0;0;0;0;0;0;0;0;LED 50 50PUD6513/44 SMART TV UHD 4K;ELECTRONICA MAYOR
5184250;;M;76;CHILENO;;Silencioso;CISNES                        ;AYSEN;0;0;0;0;0;0;0;0;0;LED 40 KEHD4020 SMART TV;ELECTRONICA MAYOR
12855995;;F;47;CHILENO;;X;PICHIDEGUA                    ;L.G.B.OÂ´HIGGINS;0;0;0;0;0;0;0;0;0;LED 55 55P615 UHD ANDROID TV 4K;ELECTRONICA MAYOR
26804603;;M;33;VENEZOLANO;;Extranjero;N/D;N/D;0;0;0;0;0;0;0;0;0;LED 55 UN55TU7090GXZS SMART TV UHD;ELECTRONICA MAYOR
10855899;;M;55;CHILENO;;Boomers;VICTORIA                      ;ARAUCANIA;0;0;0;0;0;0;0;0;0;LED 55 UN55TU7090GXZS SMART TV UHD;ELECTRONICA MAYOR
5401178;;M;77;CHILENO;;Silencioso;PROVIDENCIA                   ;METROPOLITANA;0;0;0;0;0;0;0;0;0;MONITOR 24 24TL520S SMART TV HD;ELECTRONICA MAYOR
12529495;;F;49;CHILENO;;X;SAN PEDRO DE LA PAZ;BIO-BIO;0;0;0;0;0;0;0;0;0;LED KIOTO 32 MI3228 SMART TV;ELECTRONICA MAYOR
19394030;;M;26;CHILENO;;Z;PROVIDENCIA                   ;METROPOLITANA;0;0;0;0;0;0;0;0;0;MINICOMPONENTE CJ45;ELECTRONICA MAYOR
19098012;;M;26;CHILENO;;Z;CAUQUENES                     ;MAULE;0;0;0;0;0;0;0;0;0;LED 70 UN70AU7000GXZS UHD;ELECTRONICA MAYOR
20178381;;F;23;CHILENO;;Z;PROVIDENCIA                   ;METROPOLITANA;0;0;0;0;0;0;0;0;0;KARAOKE EXTRA SAVAGE MICÂ CABLEÂ BLACK 8902;ELECTRONICA MAYOR
17540400;;F;32;CHILENO;;Millenial;RENCA                         ;METROPOLITANA;0;0;0;0;0;0;0;0;0;LED 50 50U6305 SMART TV ULTRA HD;ELECTRONICA MAYOR
16547006;;F;35;CHILENO;;Millenial;RANCAGUA                      ;L.G.B.OÂ´HIGGINS;0;0;0;0;0;0;0;0;0;LED 55 55P615 UHD ANDROID TV 4K;ELECTRONICA MAYOR
17583811;;F;31;CHILENO;;Millenial;N/D;N/D;0;0;0;0;0;0;0;0;0;PARLANTE ULTRAFORCE-I;ELECTRONICA MAYOR
17494523;;M;32;CHILENO;;Millenial;TALCA                         ;MAULE;0;0;0;0;0;0;0;0;0;LED 40 KEHD4020 SMART TV;ELECTRONICA MAYOR
17583460;;F;31;CHILENO;;Millenial;"";"";0;0;0;0;0;0;0;0;0;LED 50 UN50TU7090GXZS UHD SMART TV;ELECTRONICA MAYOR
15202943;;F;41;CHILENO;;X;TIRUA                         ;BIO BIO;0;0;0;0;0;0;0;0;0;LED 65UP7500 UHD SMART;ELECTRONICA MAYOR
12654366;;F;48;CHILENO;;X;PICHIDEGUA                    ;L.G.B.OÂ´HIGGINS;0;0;0;0;0;0;0;0;0;LED 32 32S60-32P ANDROID TV SMART LINE HD;ELECTRONICA MAYOR
18550553;;M;26;CHILENO;;Silencioso;PROVIDENCIA                   ;METROPOLITANA;0;0;0;0;0;0;0;0;0;LED NanoCell 65NANO75 UHD SMART + MAGIC;ELECTRONICA MAYOR
10363179;;M;51;CHILENO;;X;VINA DEL MAR                  ;VALPARAISO;0;0;0;0;0;0;0;0;0;LED KIOTO 32 MI3228 SMART TV;ELECTRONICA MAYOR
14660616;;M;52;ARGENTINO;;Extranjero;PUENTE ALTO                   ;METROPOLITANA;0;0;0;0;0;0;0;0;0;PARLANTE ULTRASENSATION;ELECTRONICA MAYOR
6712314;;F;68;CHILENO;;Silencioso;SAN VICENTE                   ;L.G.B.OÂ´HIGGINS;0;0;0;0;0;0;0;0;0;LED 50 50U6305 SMART TV ULTRA HD;ELECTRONICA MAYOR
10524507;;M;55;CHILENO;;Boomers;RENCA                         ;METROPOLITANA;0;0;0;0;0;0;0;0;0;MONITOR 24 24TL520S SMART TV HD;ELECTRONICA MAYOR
12475443;;M;48;CHILENO;;Silencioso;PROVIDENCIA                   ;METROPOLITANA;0;0;0;0;0;0;0;0;0;LED 32 32S5295 SMART TV HD;ELECTRONICA MAYOR
8264151;;M;63;CHILENO;;Boomers;QUILLOTA                      ;VALPARAISO;0;0;0;0;0;0;0;0;0;MINICOMPONENTE CM4360;ELECTRONICA MAYOR
9611733;;M;61;CHILENO;;Boomers;LA PINTANA                    ;METROPOLITANA;0;0;0;0;0;0;0;0;0;LED 42 42S6500 ANDROID TV FHD;ELECTRONICA MAYOR
19051893;;F;26;CHILENO;;Z;LOS ANGELES                   ;BIO BIO;0;0;0;0;0;0;0;0;0;LED 60 UN60AU8000GXZS UHD SMART TV;ELECTRONICA MAYOR
16027704;;F;36;CHILENO;;Millenial;CALLE LARGA                   ;VALPARAISO;0;0;0;0;0;0;0;0;0;KARAOKE STREET SONG 4 MICÂ CABLEÂ BLACK 8900;ELECTRONICA MAYOR
16762467;;F;33;CHILENO;;Millenial;N/D;N/D;0;0;0;0;0;0;0;0;0;PARLANTE ULTRAMEGA;ELECTRONICA MAYOR
6777598;;M;69;CHILENO;;Silencioso;SAN BERNARDO                  ;METROPOLITANA;0;0;0;0;0;0;0;0;0;LED 32 32PHD6825 HD SMART TV;ELECTRONICA MAYOR
17575815;;M;32;CHILENO;;Silencioso;PROVIDENCIA                   ;METROPOLITANA;0;0;0;0;0;0;0;0;0;LED 50 UN50TU7090GXZS UHD SMART TV;ELECTRONICA MAYOR
14193853;;F;45;CHILENO;;X;PENAFLOR                      ;METROPOLITANA;0;0;0;0;0;0;0;0;0;LED 55 55P615 UHD ANDROID TV 4K;ELECTRONICA MAYOR
12969913;;F;46;CHILENO;;X;CHILLAN VIEJO                 ;BIO BIO;0;0;0;0;0;0;0;0;0;LED 40 KEHD4020 SMART TV;ELECTRONICA MAYOR
15080719;;F;39;CHILENO;;X;SANTIAGO                      ;METROPOLITANA;0;0;0;0;0;0;0;0;0;LED 49 49UN7100 UHD SMART TV;ELECTRONICA MAYOR
19231130;;M;26;CHILENO;;Z;PROVIDENCIA                   ;METROPOLITANA;0;0;0;0;0;0;0;0;0;LED 40 KEHD4020 SMART TV;ELECTRONICA MAYOR
13750289;;M;52;CHILENO;;X;COPIAPO                       ;ATACAMA;0;0;0;0;0;0;0;0;0;LED 43 43LM6300PSB SMART TV HD;ELECTRONICA MAYOR
19218295;Soltero;M;27;CHILENO;;Z;NUEVA IMPERIAL                ;ARAUCANIA;0;0;0;0;0;0;0;0;0;LED KIOTO 32 MI3228 SMART TV;ELECTRONICA MAYOR
19569136;;F;24;CHILENO;;Z;LA LIGUA                      ;VALPARAISO;0;0;0;0;0;0;0;0;0;LED 40 KEHD4020 SMART TV;ELECTRONICA MAYOR
12425351;;F;49;CHILENO;;X;RENCA                         ;METROPOLITANA;0;0;0;0;0;0;0;0;0;LED 32 UN32T4300AGXZS HD SMART TV;ELECTRONICA MAYOR
10943777;;M;53;CHILENO;;X;N/D;N/D;0;0;0;0;0;0;0;0;0;LED KIOTO 32 MI3228 SMART TV;ELECTRONICA MAYOR
19072937;;F;27;CHILENO;;Z;CHILLAN;BIO-BIO;0;0;0;0;0;0;0;0;0;LED 49 49UN7100 UHD SMART TV;ELECTRONICA MAYOR
14256021;Casado;M;48;CHILENO;;X;RENCA                         ;METROPOLITANA;0;0;0;0;0;0;0;0;0;LED 50 UN50TU7090GXZS UHD SMART TV;ELECTRONICA MAYOR
7709640;;M;64;CHILENO;;Boomers;COIHAIQUE                     ;AYSEN;0;0;0;0;0;0;0;0;0;LED 43 43UN7300 UHD SMART TV 4K;ELECTRONICA MAYOR
12976148;;M;45;CHILENO;;Silencioso;PROVIDENCIA                   ;METROPOLITANA;0;0;0;0;0;0;0;0;0;LED 50 UN50TU7090GXZS UHD SMART TV;ELECTRONICA MAYOR
9036947;;M;61;CHILENO;;Boomers;RENCA                         ;METROPOLITANA;0;0;0;0;0;0;0;0;0;PARLANTE ULTRAMEGA;ELECTRONICA MAYOR
10655117;;M;55;CHILENO;;Boomers;CHILLAN VIEJO                 ;BIO BIO;0;0;0;0;0;0;0;0;0;LED 40 KEHD4020 SMART TV;ELECTRONICA MAYOR
20475254;;F;22;CHILENO;;Z;ILLAPEL                       ;COQUIMBO;0;0;0;0;0;0;0;0;0;LED 43 Full HD Smart TV 43PFD6825;ELECTRONICA MAYOR
9378682;;F;60;CHILENO;;Boomers;LA LIGUA                      ;VALPARAISO;0;0;0;0;0;0;0;0;0;SISTEMA DE SONIDO CM1560;ELECTRONICA MAYOR
7897954;Casado;M;64;CHILENO;CONTADOR GENERAL;Boomers;PROVIDENCIA                   ;METROPOLITANA;0;0;0;0;0;0;0;0;0;LED KIOTO 32 MI3228 SMART TV;ELECTRONICA MAYOR
14203143;;F;40;CHILENO;;X;PROVIDENCIA                   ;METROPOLITANA;0;0;0;0;0;0;0;0;0;LED 70 70UP7750 UHD SMART + MAGIC;ELECTRONICA MAYOR
18079031;;M;30;CHILENO;;Millenial;PROVIDENCIA                   ;METROPOLITANA;0;0;0;0;0;0;0;0;0;LED 40 KEHD4020 SMART TV;ELECTRONICA MAYOR
9352262;;F;56;CHILENO;;Boomers;RENCA                         ;METROPOLITANA;0;0;0;0;0;0;0;0;0;MONITOR 24 24TL520S SMART TV HD;ELECTRONICA MAYOR
9578956;Casado;F;57;CHILENO;;Silencioso;PROVIDENCIA                   ;METROPOLITANA;0;0;0;0;0;0;0;0;0;LED 50 UN50TU7090GXZS UHD SMART TV;ELECTRONICA MAYOR
18075311;;F;30;CHILENO;;Millenial;PROVIDENCIA                   ;METROPOLITANA;0;0;0;0;0;0;0;0;0;LED 43 UN43T5202AGXZS FHD SMART TV;ELECTRONICA MAYOR
16507228;Soltero;M;35;CHILENO;;Millenial;PROVIDENCIA                   ;METROPOLITANA;0;0;0;0;0;0;0;0;0;LED 40 KEHD4020 SMART TV;ELECTRONICA MAYOR
18717748;;M;28;CHILENO;;Millenial;PAINE                         ;METROPOLITANA;0;0;0;0;0;0;0;0;0;LED KIOTO 32 MI3228 SMART TV;ELECTRONICA MAYOR
10064986;;F;53;CHILENO;;X;LOTA                          ;BIO BIO;0;0;0;0;0;0;0;0;0;LED 40 KEHD4020 SMART TV;ELECTRONICA MAYOR
10554731;;F;56;CHILENO;;Boomers;PANGUIPULLI                   ;LOS RIOS;0;0;0;0;0;0;0;0;0;LED 43 43LM6370 SMART TV FHD;ELECTRONICA MAYOR
9114925;;M;59;CHILENO;;Boomers;N/D;N/D;0;0;0;0;0;0;0;0;0;LED 50 50U6295 SMART TV UHD;ELECTRONICA MAYOR
13107593;Casado;M;45;CHILENO;;X;RENCA                         ;METROPOLITANA;0;0;0;0;0;0;0;0;0;MONITOR 24 24TL520S SMART TV HD;ELECTRONICA MAYOR
4797695;;F;80;CHILENO;;Silencioso;RENCA                         ;METROPOLITANA;0;0;0;0;0;0;0;0;0;LED 50 UN50TU7090GXZS UHD SMART TV;ELECTRONICA MAYOR
9866452;;M;56;CHILENO;;Silencioso;PROVIDENCIA                   ;METROPOLITANA;0;0;0;0;0;0;0;0;0;LED 32 32LM630BPSB SMART TV;ELECTRONICA MAYOR
13181980;Casado;M;45;CHILENO;INGENIERO EN ADMINISTRACION DE EMPRESAS;Silencioso;PROVIDENCIA                   ;METROPOLITANA;0;0;0;0;0;0;0;0;0;LED 49 49UN7100 UHD SMART TV;ELECTRONICA MAYOR
13476714;Soltero;F;44;CHILENO;ADMINISTRADOR PUBLICO;X;RENCA                         ;METROPOLITANA;0;0;0;0;0;0;0;0;0;LED 32 32LM630BPSB SMART TV;ELECTRONICA MAYOR
5354584;;M;78;CHILENO;;Silencioso;PERALILLO                     ;L.G.B.OÂ´HIGGINS;0;0;0;0;0;0;0;0;0;LED 40 KEHD4020 SMART TV;ELECTRONICA MAYOR
16979520;;F;32;CHILENO;;Millenial;N/D;N/D;0;0;0;0;0;0;0;0;0;LED 50 UN50TU7090GXZS UHD SMART TV;ELECTRONICA MAYOR
17120045;Casado;M;33;CHILENO;PUBLICISTA;Silencioso;PROVIDENCIA                   ;METROPOLITANA;0;0;0;0;0;0;0;0;0;LED 32 32LM630BPSB SMART TV;ELECTRONICA MAYOR
6373323;Soltero;F;74;CHILENO;CONTADOR GENERAL;Silencioso;PROVIDENCIA                   ;METROPOLITANA;0;0;0;0;0;0;0;0;0;LED 40 KEHD4020 SMART TV;ELECTRONICA MAYOR
13161057;;F;44;CHILENO;;X;PROVIDENCIA                   ;METROPOLITANA;0;0;0;0;0;0;0;0;0;LED 40 KEHD4020 SMART TV;ELECTRONICA MAYOR
13779223;;M;44;CHILENO;;X;PROVIDENCIA                   ;METROPOLITANA;0;0;0;0;0;0;0;0;0;LED 43 43LM6300PSB SMART TV HD;ELECTRONICA MAYOR
15629464;;M;38;CHILENO;;X;PROVIDENCIA                   ;METROPOLITANA;0;0;0;0;0;0;0;0;0;MINICOMPONENTE MX-T70/ZS ALL IN ONE;ELECTRONICA MAYOR
12244685;Divorciado;F;50;CHILENO;;X;RENCA                         ;METROPOLITANA;0;0;0;0;0;0;0;0;0;LED 43 43S5295 SMART TV FHD;ELECTRONICA MAYOR
17651192;;F;31;CHILENO;;Millenial;PROVIDENCIA                   ;METROPOLITANA;0;0;0;0;0;0;0;0;0;LED 49 49UN7100 UHD SMART TV;ELECTRONICA MAYOR
17333917;Soltero;F;32;CHILENO;;Silencioso;PROVIDENCIA                   ;METROPOLITANA;0;0;0;0;0;0;0;0;0;LED 50 UN50TU7090GXZS UHD SMART TV;ELECTRONICA MAYOR
19386730;Soltero;M;26;CHILENO;;Z;PROVIDENCIA                   ;METROPOLITANA;0;0;0;0;0;0;0;0;0;LED 50 UN50TU7090GXZS UHD SMART TV;ELECTRONICA MAYOR
16648664;;M;34;CHILENO;;Millenial;SANTIAGO                      ;METROPOLITANA;0;0;0;0;0;0;0;0;0;LED 43 43UN7300 UHD SMART TV 4K;ELECTRONICA MAYOR
15585276;;M;39;CHILENO;;X;PROVIDENCIA                   ;METROPOLITANA;0;0;0;0;0;0;0;0;0;LED 65 KUHK6520 UHD SMART TV;ELECTRONICA MAYOR
6560769;;F;71;CHILENO;;Silencioso;RENCA                         ;METROPOLITANA;0;0;0;0;0;0;0;0;0;MINICOMPONENTE RN7;ELECTRONICA MAYOR
16027796;;M;36;CHILENO;;Millenial;LOS ANDES                     ;VALPARAISO;0;0;0;0;0;0;0;0;0;LED 40 KEHD4020 SMART TV;ELECTRONICA MAYOR
9407283;;M;58;CHILENO;;Boomers;RENCA                         ;METROPOLITANA;0;0;0;0;0;0;0;0;0;LED 55 UN55TU7090GXZS SMART TV UHD;ELECTRONICA MAYOR
13754462;;F;41;CHILENO;;X;N/D;N/D;0;0;0;0;0;0;0;0;0;LED 43 43S5295 SMART TV FHD;ELECTRONICA MAYOR
13593287;;M;43;CHILENO;;X;ANCUD                         ;LOS LAGOS;0;0;0;0;0;0;0;0;0;LED 43 43LM6300PSB SMART TV HD;ELECTRONICA MAYOR
12032643;;M;54;CHILENO;;Silencioso;PROVIDENCIA                   ;METROPOLITANA;0;0;0;0;0;0;0;0;0;LED 40 KEHD4020 SMART TV;ELECTRONICA MAYOR
13275098;;F;45;CHILENO;;X;MAULE                         ;MAULE;0;0;0;0;0;0;0;0;0;LED KIOTO 32 MI3228 SMART TV;ELECTRONICA MAYOR
20210801;;F;23;CHILENO;;Z;PROVIDENCIA                   ;METROPOLITANA;0;0;0;0;0;0;0;0;0;LED 43 UN43T5202AGXZS FHD SMART TV;ELECTRONICA MAYOR
18095642;;M;30;CHILENO;;Millenial;COIHAIQUE                     ;AYSEN;0;0;0;0;0;0;0;0;0;LED 32 32S5295 SMART TV HD;ELECTRONICA MAYOR
25331018;;M;45;COLOMBIANO;;Extranjero;N/D;N/D;0;0;0;0;0;0;0;0;0;LED 43 UN43T5202AGXZS FHD SMART TV;ELECTRONICA MAYOR
16706556;;M;34;CHILENO;;Millenial;N/D;N/D;0;0;0;0;0;0;0;0;0;LED 70 UN70TU6900GXZS UHD SMART TV;ELECTRONICA MAYOR
19032040;;M;27;CHILENO;;Z;N/D;N/D;0;0;0;0;0;0;0;0;0;LED 40 KEHD4020 SMART TV;ELECTRONICA MAYOR
18385856;;F;28;CHILENO;;Millenial;LOS ANDES                     ;VALPARAISO;0;0;0;0;0;0;0;0;0;MINICOMPONENTE CM4360;ELECTRONICA MAYOR
8736769;;F;62;CHILENO;;Boomers;ANGOL                         ;ARAUCANIA;0;0;0;0;0;0;0;0;0;LED KIOTO 32 MI3228 SMART TV;ELECTRONICA MAYOR
13519452;;M;44;CHILENO;;X;PROVIDENCIA                   ;METROPOLITANA;0;0;0;0;0;0;0;0;0;LED 40 KEHD4020 SMART TV;ELECTRONICA MAYOR
12874756;;F;47;CHILENO;;X;LAS CONDES                    ;METROPOLITANA;0;0;0;0;0;0;0;0;0;LED 43 UN43T5202AGXZS FHD SMART TV;ELECTRONICA MAYOR
12926357;;M;46;CHILENO;;X;PROVIDENCIA                   ;METROPOLITANA;0;0;0;0;0;0;0;0;0;LED 49 49UN7100 UHD SMART TV;ELECTRONICA MAYOR
19400506;;F;23;CHILENO;;Z;PROVIDENCIA                   ;METROPOLITANA;0;0;0;0;0;0;0;0;0;LED 55 UN55TU7090GXZS SMART TV UHD;ELECTRONICA MAYOR
14301043;Soltero;F;47;CHILENO;;X;MARCHIHUE                     ;L.G.B.OÂ´HIGGINS;0;0;0;0;0;0;0;0;0;PARLANTE MG TWISTER;ELECTRONICA MAYOR
23103351;;F;40;EXTRANJERO - NO INFORMA NACIONALIDAD;;Extranjero;"";"";0;0;0;0;0;0;0;0;0;LED KIOTO 32 MI3228 SMART TV;ELECTRONICA MAYOR
7499326;Casado;M;67;CHILENO;;Boomers;SALAMANCA                     ;COQUIMBO;0;0;0;0;0;0;0;0;0;LED 50 50PUD6513/44 SMART TV UHD 4K;ELECTRONICA MAYOR
6396162;;M;72;CHILENO;;Silencioso;OVALLE                        ;COQUIMBO;0;0;0;0;0;0;0;0;0;LED 32 UN32T4300AGXZS HD SMART TV;ELECTRONICA MAYOR
7252539;;M;65;CHILENO;;Boomers;N/D;N/D;0;0;0;0;0;0;0;0;0;LED 50 UN50TU7090GXZS UHD SMART TV;ELECTRONICA MAYOR
18740411;;F;28;CHILENO;;Millenial;PROVIDENCIA                   ;METROPOLITANA;0;0;0;0;0;0;0;0;0;MINICOMPONENTE CM4360;ELECTRONICA MAYOR
17667567;;M;31;CHILENO;;Millenial;LA CISTERNA                   ;METROPOLITANA;0;0;0;0;0;0;0;0;0;LED 50 50PUD6513/44 SMART TV UHD 4K;ELECTRONICA MAYOR
12401952;;F;48;CHILENO;;Silencioso;PROVIDENCIA                   ;METROPOLITANA;0;0;0;0;0;0;0;0;0;LED 43 43LM6300PSB SMART TV HD;ELECTRONICA MAYOR
12554162;;M;47;CHILENO;;Extranjero;"";"";0;0;0;0;0;0;0;0;0;LED 43 43S5295 SMART TV FHD;ELECTRONICA MAYOR
11400863;;F;53;CHILENO;;X;VALPARAISO                    ;VALPARAISO;0;0;0;0;0;0;0;0;0;LED 43 UN43T5202AGXZS FHD SMART TV;ELECTRONICA MAYOR
19014639;Soltero;M;26;CHILENO;;Silencioso;PROVIDENCIA                   ;METROPOLITANA;0;0;0;0;0;0;0;0;0;LED 32 32LM630BPSB SMART TV;ELECTRONICA MAYOR
19266838;;F;25;CHILENO;;Z;PROVIDENCIA                   ;METROPOLITANA;0;0;0;0;0;0;0;0;0;LED 40 40PFD6825 UHD Smart TV;ELECTRONICA MAYOR
18940036;Soltero;M;27;CHILENO;;Silencioso;PROVIDENCIA                   ;METROPOLITANA;0;0;0;0;0;0;0;0;0;LED 43 43LM6300PSB SMART TV HD;ELECTRONICA MAYOR
13533469;;M;42;CHILENO;;X;VICUNA                        ;COQUIMBO;0;0;0;0;0;0;0;0;0;MINICOMPONENTE CJ45;ELECTRONICA MAYOR
14454779;;M;46;CHILENO;;Silencioso;PROVIDENCIA                   ;METROPOLITANA;0;0;0;0;0;0;0;0;0;MINICOMPONENTE MHC-V02 ALL IN ONE;ELECTRONICA MAYOR
8936529;;F;59;CHILENO;;Boomers;LA SERENA                     ;COQUIMBO;0;0;0;0;0;0;0;0;0;LED 43 43LM6300PSB SMART TV HD;ELECTRONICA MAYOR
16409944;;F;36;CHILENO;;Millenial;LA GRANJA                     ;METROPOLITANA;0;0;0;0;0;0;0;0;0;LED 32 UN32T4300AGXZS HD SMART TV;ELECTRONICA MAYOR
18621835;Soltero;M;27;CHILENO;;Silencioso;N/D;N/D;0;0;0;0;0;0;0;0;0;LED 43 UN43TU7090GXZS UHD SMART TV;ELECTRONICA MAYOR
15148862;Casado;M;40;CHILENO;;X;PROVIDENCIA                   ;METROPOLITANA;0;0;0;0;0;0;0;0;0;LED 32 32PHD5813 SMART TV HD;ELECTRONICA MAYOR
5857817;;F;77;CHILENO;;Silencioso;ILLAPEL                       ;COQUIMBO;0;0;0;0;0;0;0;0;0;LED 40 KEHD4020 SMART TV;ELECTRONICA MAYOR
13206824;;M;45;CHILENO;;X;CAUQUENES                     ;MAULE;0;0;0;0;0;0;0;0;0;LED 49 49UN7100 UHD SMART TV;ELECTRONICA MAYOR
3741118;;F;86;CHILENO;;Silencioso;SAN ANTONIO                   ;VALPARAISO;0;0;0;0;0;0;0;0;0;LED 32 UN32T4300AGXZS HD SMART TV;ELECTRONICA MAYOR
17895007;;F;30;CHILENO;;Millenial;PROVIDENCIA                   ;METROPOLITANA;0;0;0;0;0;0;0;0;0;LED 40 40PFD6825 UHD Smart TV;ELECTRONICA MAYOR
5764172;;F;77;CHILENO;;Silencioso;PANGUIPULLI                   ;LOS LAGOS;0;0;0;0;0;0;0;0;0;LED KIOTO 32 MI3228 SMART TV;ELECTRONICA MAYOR
13518781;;M;44;CHILENO;;X;TEMUCO                        ;ARAUCANIA;0;0;0;0;0;0;0;0;0;LED KIOTO 32 MI3228 SMART TV;ELECTRONICA MAYOR
15918478;Soltero;M;37;CHILENO;TECNICO ELECTRICO;Silencioso;PROVIDENCIA                   ;METROPOLITANA;0;0;0;0;0;0;0;0;0;LED 70 UN70AU7000GXZS UHD;ELECTRONICA MAYOR
19633667;;F;25;CHILENO;;Z;PROVIDENCIA                   ;METROPOLITANA;0;0;0;0;0;0;0;0;0;LED 40 KEHD4020 SMART TV;ELECTRONICA MAYOR
25557385;;M;29;PERUANO;;Extranjero;SANTIAGO                      ;METROPOLITANA;0;0;0;0;0;0;0;0;0;LED KIOTO 32 MI3228 SMART TV;ELECTRONICA MAYOR
9790346;;M;59;CHILENO;;Boomers;PUERTO MONTT                  ;LOS LAGOS;0;0;0;0;0;0;0;0;0;LED KIOTO 32 MI3228 SMART TV;ELECTRONICA MAYOR
19865723;;F;24;CHILENO;;Z;PROVIDENCIA                   ;METROPOLITANA;0;0;0;0;0;0;0;0;0;PARLANTE MGVIPER;ELECTRONICA MAYOR
6272070;Casado;M;71;CHILENO;;Silencioso;PROVIDENCIA                   ;METROPOLITANA;0;0;0;0;0;0;0;0;0;LED 49 49UN7100 UHD SMART TV;ELECTRONICA MAYOR
17976979;;F;31;CHILENO;;Millenial;QUILLOTA                      ;VALPARAISO;0;0;0;0;0;0;0;0;0;LED 43 43S5295 SMART TV FHD;ELECTRONICA MAYOR
16939311;Soltero;F;33;CHILENO;ABOGADO;Silencioso;PROVIDENCIA                   ;METROPOLITANA;0;0;0;0;0;0;0;0;0;LED 32 32LM630BPSB SMART TV;ELECTRONICA MAYOR
8438535;;F;64;CHILENO;;Boomers;N/D;N/D;0;0;0;0;0;0;0;0;0;LED 65 UN65TU6900GXZS UHD SMART TV;ELECTRONICA MAYOR
6839927;;M;66;CHILENO;;Silencioso;PROVIDENCIA                   ;METROPOLITANA;0;0;0;0;0;0;0;0;0;OLED 55C1 UHD SMART + MAGIC;ELECTRONICA MAYOR
17012079;;F;33;CHILENO;;Millenial;ARICA                         ;TARAPACA;0;0;0;0;0;0;0;0;0;LED 43 43UN7300 UHD SMART TV 4K;ELECTRONICA MAYOR
10978211;;F;50;CHILENO;;X;N/D;N/D;0;0;0;0;0;0;0;0;0;MINICOMPONENTE CJ45;ELECTRONICA MAYOR
7204528;;F;59;CHILENO;;Boomers;NATALES                       ;MAGALLANES;0;0;0;0;0;0;0;0;0;LED 43 43LM6300PSB SMART TV HD;ELECTRONICA MAYOR
18647199;;F;28;CHILENO;;Millenial;N/D;N/D;0;0;0;0;0;0;0;0;0;LED KIOTO 32 MI3228 SMART TV;ELECTRONICA MAYOR
8740905;Soltero;F;63;CHILENO;;Boomers;RENCA                         ;METROPOLITANA;0;0;0;0;0;0;0;0;0;LED 49 49LJ5100 FHD;ELECTRONICA MAYOR
17200474;;F;33;CHILENO;;Millenial;PROVIDENCIA                   ;METROPOLITANA;0;0;0;0;0;0;0;0;0;LED 50 KEUH50 SMART TV UHD;ELECTRONICA MAYOR
13862803;;M;42;CHILENO;;X;ARICA                         ;ARICA Y PARINACOTA;0;0;0;0;0;0;0;0;0;LED 32 32LM630BPSB SMART TV;ELECTRONICA MAYOR
16250016;;F;36;CHILENO;;Millenial;COPIAPO                       ;ATACAMA;0;0;0;0;0;0;0;0;0;KARAOKE URBAN AZUL;ELECTRONICA MAYOR
4841621;;F;82;CHILENO;;Silencioso;PROVIDENCIA                   ;METROPOLITANA;0;0;0;0;0;0;0;0;0;SISTEMA DE SONIDO CM1560;ELECTRONICA MAYOR
15629863;;M;39;CHILENO;;X;PROVIDENCIA                   ;METROPOLITANA;0;0;0;0;0;0;0;0;0;LED 58 KUHK5820 UHD SMART TV;ELECTRONICA MAYOR
14333010;;F;45;CHILENO;;X;COIHAIQUE                     ;AYSEN;0;0;0;0;0;0;0;0;0;MINICOMPONENTE OL45;ELECTRONICA MAYOR
10283127;;M;56;CHILENO;;Boomers;PROVIDENCIA                   ;METROPOLITANA;0;0;0;0;0;0;0;0;0;LED KIOTO 32 MI3228 SMART TV;ELECTRONICA MAYOR
14108970;;F;41;CHILENO;;X;"";"";0;0;0;0;0;0;0;0;0;LED 75 UN75TU6900GXZS UHD SMART TV;ELECTRONICA MAYOR
16299245;Soltero;M;36;CHILENO;;Silencioso;PROVIDENCIA                   ;METROPOLITANA;0;0;0;0;0;0;0;0;0;LED 32 32S60-32P ANDROID TV SMART LINE HD;ELECTRONICA MAYOR
13206533;;M;45;CHILENO;;X;CAUQUENES                     ;MAULE;0;0;0;0;0;0;0;0;0;LED 58 58PUD6513/44 SMART TV UHD;ELECTRONICA MAYOR
10727305;Casado;M;44;CHILENO;;X;PROVIDENCIA                   ;METROPOLITANA;0;0;0;0;0;0;0;0;0;LED 50 50PUD6513/44 SMART TV UHD 4K;ELECTRONICA MAYOR
19526774;;F;25;CHILENO;;Z;SAN VICENTE                   ;L.G.B.OÂ´HIGGINS;0;0;0;0;0;0;0;0;0;LED KIOTO 32 MI3228 SMART TV;ELECTRONICA MAYOR
25842578;Soltero;F;41;EXTRANJERO - NO INFORMA NACIONALIDAD;;Extranjero;PROVIDENCIA                   ;METROPOLITANA;0;0;0;0;0;0;0;0;0;LED 32 UN32T4300AGXZS HD SMART TV;ELECTRONICA MAYOR
14023312;Soltero;M;41;CHILENO;;X;RENCA                         ;METROPOLITANA;0;0;0;0;0;0;0;0;0;LED 55 55UN7100 UHD SMART TV;ELECTRONICA MAYOR
17933170;Casado;M;31;CHILENO;;Millenial;RENCA                         ;METROPOLITANA;0;0;0;0;0;0;0;0;0;LED 50 KEUH50 SMART TV UHD;ELECTRONICA MAYOR
8276560;Casado;F;65;CHILENO;EDUCADOR DE PARVULO;Boomers;PROVIDENCIA                   ;METROPOLITANA;0;0;0;0;0;0;0;0;0;LED KIOTO 32 MI3228 SMART TV;ELECTRONICA MAYOR
17868637;Soltero;F;31;CHILENO;FONOAUDIOLOGO;Millenial;PROVIDENCIA                   ;METROPOLITANA;0;0;0;0;0;0;0;0;0;LED 32 32LK540 HD SMART;ELECTRONICA MAYOR
20843374;;M;34;CHILENO;;Millenial;VALPARAISO                    ;VALPARAISO;0;0;0;0;0;0;0;0;0;LED KIOTO 32 MI3228 SMART TV;ELECTRONICA MAYOR
18303037;;F;33;CHILENO;;Millenial;TOLTEN                        ;ARAUCANIA;0;0;0;0;0;0;0;0;0;LED 40 KEHD4020 SMART TV;ELECTRONICA MAYOR
8931093;;M;61;CHILENO;;Millenial;PUERTO MONTT                  ;LOS LAGOS;0;0;0;0;0;0;0;0;0;MINICOMPONENTE OL45;ELECTRONICA MAYOR
12973916;;M;46;CHILENO;;Millenial;PROVIDENCIA                   ;METROPOLITANA;0;0;0;0;0;0;0;0;0;LED 40 KEHD4020 SMART TV;ELECTRONICA MAYOR
12331164;;M;49;CHILENO;;X;CORONEL                       ;BIO BIO;0;0;0;0;0;0;0;0;0;LED 43 43PFD5813 SMART TV FULL HD;ELECTRONICA MAYOR
17403734;;F;32;CHILENO;;Millenial;PROVIDENCIA                   ;METROPOLITANA;0;0;0;0;0;0;0;0;0;LED 43 43UN7300 UHD SMART TV 4K;ELECTRONICA MAYOR
8382968;Casado;M;61;CHILENO;;Boomers;RENCA                         ;METROPOLITANA;0;0;0;0;0;0;0;0;0;LED 43 43UN7300 UHD SMART TV 4K;ELECTRONICA MAYOR
7945894;Divorciado;M;61;CHILENO;;Boomers;PROVIDENCIA                   ;METROPOLITANA;0;0;0;0;0;0;0;0;0;LED 65 UN65TU6900GXZS UHD SMART TV;ELECTRONICA MAYOR
15331663;;F;39;CHILENO;;Millenial;PROVIDENCIA                   ;METROPOLITANA;0;0;0;0;0;0;0;0;0;LED 50 KEUH50 SMART TV UHD;ELECTRONICA MAYOR
12893012;;M;46;CHILENO;;X;PENALOLEN                     ;METROPOLITANA;0;0;0;0;0;0;0;0;0;LED 49 49UN7100 UHD SMART TV;ELECTRONICA MAYOR
16839878;;F;34;CHILENO;;Millenial;PROVIDENCIA                   ;METROPOLITANA;0;0;0;0;0;0;0;0;0;LED 32 UN32T4300AGXZS HD SMART TV;ELECTRONICA MAYOR
16422258;Soltero;M;35;CHILENO;INGENIERO EN PREVENCION DE RIESGOS;Silencioso;PROVIDENCIA                   ;METROPOLITANA;0;0;0;0;0;0;0;0;0;LED KIOTO 32 MI3228 SMART TV;ELECTRONICA MAYOR
8013028;;M;61;CHILENO;;Boomers;COIHAIQUE                     ;AYSEN;0;0;0;0;0;0;0;0;0;LED 32 32PHD5813 SMART TV HD;ELECTRONICA MAYOR
15934611;Soltero;F;37;CHILENO;;Silencioso;PROVIDENCIA                   ;METROPOLITANA;0;0;0;0;0;0;0;0;0;LED 43 43S5295 SMART TV FHD;ELECTRONICA MAYOR
9202007;Casado;M;60;CHILENO;INGENIERO AGRICOLA;Boomers;PROVIDENCIA                   ;METROPOLITANA;0;0;0;0;0;0;0;0;0;LED KIOTO 32 MI3228 SMART TV;ELECTRONICA MAYOR
14665554;Casado;M;55;PERUANO;;Extranjero;RECOLETA                      ;METROPOLITANA;0;0;0;0;0;0;0;0;0;LED KIOTO 32 MI3228 SMART TV;ELECTRONICA MAYOR
18475625;;M;29;CHILENO;;Millenial;CONSTITUCION                  ;MAULE;0;0;0;0;0;0;0;0;0;LED 43 43LM6300PSB SMART TV HD;ELECTRONICA MAYOR
15445805;;F;39;CHILENO;;X;LAJA                          ;BIO BIO;0;0;0;0;0;0;0;0;0;LED KIOTO 32 MI3228 SMART TV;ELECTRONICA MAYOR
17926933;Soltero;M;30;CHILENO;DISENADOR MULTIMEDIA;Silencioso;PROVIDENCIA                   ;METROPOLITANA;0;0;0;0;0;0;0;0;0;LED 43 43UN7300 UHD SMART TV 4K;ELECTRONICA MAYOR
14333734;;M;44;CHILENO;;X;PALMILLA                      ;L.G.B.OÂ´HIGGINS;0;0;0;0;0;0;0;0;0;LED 65 UN65TU7100GXZS UHD 4K CRYSTAL;ELECTRONICA MAYOR
16427236;;M;36;CHILENO;;Silencioso;PROVIDENCIA                   ;METROPOLITANA;0;0;0;0;0;0;0;0;0;LED 32 32LM630BPSB SMART TV;ELECTRONICA MAYOR
7143280;;F;64;CHILENO;;Boomers;SAN FERNANDO                  ;L.G.B.OÂ´HIGGINS;0;0;0;0;0;0;0;0;0;LED 55 UN55TU7090GXZS SMART TV UHD;ELECTRONICA MAYOR
10275801;;M;55;CHILENO;;Boomers;PROVIDENCIA                   ;METROPOLITANA;0;0;0;0;0;0;0;0;0;LED KIOTO 32 MI3228 SMART TV;ELECTRONICA MAYOR
10892723;;F;55;CHILENO;;Boomers;N/D;N/D;0;0;0;0;0;0;0;0;0;KARAOKE RHYTHM CHARGER 12 MIC CABLE 8890;ELECTRONICA MAYOR
13291058;Soltero;M;46;CHILENO;PUBLICISTA;X;PROVIDENCIA                   ;METROPOLITANA;0;0;0;0;0;0;0;0;0;LED 43 43LM6300PSB SMART TV HD;ELECTRONICA MAYOR
16844048;;M;34;CHILENO;;Millenial;PROVIDENCIA                   ;METROPOLITANA;0;0;0;0;0;0;0;0;0;LED 40 KEHD4020 SMART TV;ELECTRONICA MAYOR
6673240;Casado;M;70;CHILENO;;Silencioso;PROVIDENCIA                   ;METROPOLITANA;0;0;0;0;0;0;0;0;0;LED 40 KEHD4020 SMART TV;ELECTRONICA MAYOR
10422695;;F;56;CHILENO;;Boomers;ALTO HOSPICIO;TARAPACA;0;0;0;0;0;0;0;0;0;LED 32 32LK540 HD SMART;ELECTRONICA MAYOR
19728965;;M;24;CHILENO;;Z;LA LIGUA                      ;VALPARAISO;0;0;0;0;0;0;0;0;0;LED 58 KUHK5820 UHD SMART TV;ELECTRONICA MAYOR
15279767;;M;39;CHILENO;;X;PROVIDENCIA                   ;METROPOLITANA;0;0;0;0;0;0;0;0;0;LED 32 32LM630BPSB SMART TV;ELECTRONICA MAYOR
8409232;Soltero;F;67;CHILENO;;Boomers;PROVIDENCIA                   ;METROPOLITANA;0;0;0;0;0;0;0;0;0;LED 32 32PHD5813 SMART TV HD;ELECTRONICA MAYOR
18825517;;F;28;CHILENO;;Millenial;LOS ANDES                     ;VALPARAISO;0;0;0;0;0;0;0;0;0;LED 50 50U6295 SMART TV UHD;ELECTRONICA MAYOR
16803343;;M;34;CHILENO;;Millenial;N/D;N/D;0;0;0;0;0;0;0;0;0;LED 49 49UN7100 UHD SMART TV;ELECTRONICA MAYOR
24035722;;F;35;DOMINICANO;;Extranjero;INDEPENDENCIA                 ;METROPOLITANA;0;0;0;0;0;0;0;0;0;LED 32 UN32T4300AGXZS HD SMART TV;ELECTRONICA MAYOR
10162106;Soltero;F;58;CHILENO;;Boomers;LAS CONDES                    ;METROPOLITANA;0;0;0;0;0;0;0;0;0;LED 49 49LJ5100 FHD;ELECTRONICA MAYOR
9910394;Casado;F;52;CHILENO;PSICOLOGO;Silencioso;PROVIDENCIA                   ;METROPOLITANA;0;0;0;0;0;0;0;0;0;LED 32 UN32T4300AGXZS HD SMART TV;ELECTRONICA MAYOR
8266465;;M;63;CHILENO;;Boomers;RANCAGUA                      ;L.G.B.OÂ´HIGGINS;0;0;0;0;0;0;0;0;0;LED 43 UN43T5202AGXZS FHD SMART TV;ELECTRONICA MAYOR
9973444;;F;54;CHILENO;;X;PROVIDENCIA                   ;METROPOLITANA;0;0;0;0;0;0;0;0;0;MONITOR 24 24TL520S SMART TV HD;ELECTRONICA MAYOR
13803073;;M;45;CHILENO;;X;RENCA                         ;METROPOLITANA;0;0;0;0;0;0;0;0;0;LED 40 KEHD4020 SMART TV;ELECTRONICA MAYOR
6266099;;M;74;CHILENO;;Silencioso;VINA DEL MAR                  ;VALPARAISO;0;0;0;0;0;0;0;0;0;LED KIOTO 32 MI3228 SMART TV;ELECTRONICA MAYOR
12643098;Casado;M;51;CHILENO;INGENIERO FORESTAL;X;RENCA                         ;METROPOLITANA;0;0;0;0;0;0;0;0;0;LED 43 UN43T5202AGXZS FHD SMART TV;ELECTRONICA MAYOR
17860976;;F;30;CHILENO;;Millenial;HUASCO                        ;ATACAMA;0;0;0;0;0;0;0;0;0;LED 40 KEHD4020 SMART TV;ELECTRONICA MAYOR
10600398;;F;52;CHILENO;;X;VILLA ALEMANA                 ;VALPARAISO;0;0;0;0;0;0;0;0;0;LED 32 32S5295 SMART TV HD;ELECTRONICA MAYOR
15027152;;M;38;CHILENO;;X;RENCA                         ;METROPOLITANA;0;0;0;0;0;0;0;0;0;LED 32 32LM630BPSB SMART TV;ELECTRONICA MAYOR
6607287;;M;70;CHILENO;;Silencioso;ARICA                         ;ARICA Y PARINACOTA;0;0;0;0;0;0;0;0;0;LED 55 UN55TU7090GXZS SMART TV UHD;ELECTRONICA MAYOR
12116062;;F;53;CHILENO;;X;N/D;N/D;0;0;0;0;0;0;0;0;0;LED 32 32PHD5813 SMART TV HD;ELECTRONICA MAYOR
16820758;;F;33;CHILENO;;Millenial;CALERA                        ;VALPARAISO;0;0;0;0;0;0;0;0;0;MINICOMPONENTE CM4360;ELECTRONICA MAYOR
17720501;;M;28;CHILENO;;Millenial;PROVIDENCIA                   ;METROPOLITANA;0;0;0;0;0;0;0;0;0;PARLANTE KARAOKE RM1 8 PULGADAS;ELECTRONICA MAYOR
12514370;;M;48;CHILENO;;Silencioso;PROVIDENCIA                   ;METROPOLITANA;0;0;0;0;0;0;0;0;0;MONITOR 24 24TL520S SMART TV HD;ELECTRONICA MAYOR
9543060;;F;59;CHILENO;;Boomers;PENAFLOR                      ;METROPOLITANA;0;0;0;0;0;0;0;0;0;LED 40 KEHD4020 SMART TV;ELECTRONICA MAYOR
19331182;;F;25;CHILENO;;Z;PROVIDENCIA                   ;METROPOLITANA;0;0;0;0;0;0;0;0;0;LED 40 KEHD4020 SMART TV;ELECTRONICA MAYOR
7835380;Casado;M;55;CHILENO;MEDICO CIRUJANO;Boomers;RENCA                         ;METROPOLITANA;0;0;0;0;0;0;0;0;0;LED 32 32PHD5813 SMART TV HD;ELECTRONICA MAYOR
14008133;;F;42;CHILENO;;X;PROVIDENCIA                   ;METROPOLITANA;0;0;0;0;0;0;0;0;0;MINICOMPONENTE CJ45;ELECTRONICA MAYOR
12987236;;F;48;CHILENO;;X;LONQUIMAY                     ;ARAUCANIA;0;0;0;0;0;0;0;0;0;KARAOKE 8 CITY SET MIC WIRELESS ATRIL SILVER;ELECTRONICA MAYOR
16423142;;F;35;CHILENO;;Millenial;PROVIDENCIA                   ;METROPOLITANA;0;0;0;0;0;0;0;0;0;LED 60 60UN7310 SMART TV UHD;ELECTRONICA MAYOR
15684304;;M;39;CHILENO;;X;RENCA                         ;METROPOLITANA;0;0;0;0;0;0;0;0;0;LED 70 UN70TU6900GXZS UHD SMART TV;ELECTRONICA MAYOR
19325087;Soltero;M;26;CHILENO;;Z;"";"";0;0;0;0;0;0;0;0;0;LED 40 KEHD4020 SMART TV;ELECTRONICA MAYOR
6698761;;M;68;CHILENO;;Boomers;LA UNION                      ;LOS RIOS;0;0;0;0;0;0;0;0;0;LED 43 43LM6300PSB SMART TV HD;ELECTRONICA MAYOR
15584322;;F;40;CHILENO;;X;PUENTE ALTO                   ;METROPOLITANA;0;0;0;0;0;0;0;0;0;LED 43 43LM6300PSB SMART TV HD;ELECTRONICA MAYOR
17132538;;F;33;CHILENO;;Millenial;PROVIDENCIA                   ;METROPOLITANA;0;0;0;0;0;0;0;0;0;LED 55 55NANO79 NanoCell UHD SMART TV;ELECTRONICA MAYOR
11952927;;F;49;CHILENO;;X;NANCAGUA                      ;L.G.B.OÂ´HIGGINS;0;0;0;0;0;0;0;0;0;LED 43 UN43TU7090GXZS UHD SMART TV;ELECTRONICA MAYOR
16987079;;F;33;CHILENO;;Millenial;PROVIDENCIA                   ;METROPOLITANA;0;0;0;0;0;0;0;0;0;LED 32 UN32T4300AGXZS HD SMART TV;ELECTRONICA MAYOR
15838079;;M;37;CHILENO;;Millenial;PROVIDENCIA                   ;METROPOLITANA;0;0;0;0;0;0;0;0;0;LED 32 UN32T4300AGXZS HD SMART TV;ELECTRONICA MAYOR
15796155;;M;37;CHILENO;;Millenial;PROVIDENCIA                   ;METROPOLITANA;0;0;0;0;0;0;0;0;0;LED 32 32S5295 SMART TV HD;ELECTRONICA MAYOR
22156514;;F;51;PERUANO;;Extranjero;QUINTA NORMAL                 ;METROPOLITANA;0;0;0;0;0;0;0;0;0;MINICOMPONENTE OL45;ELECTRONICA MAYOR
16658814;;M;35;CHILENO;;Silencioso;PROVIDENCIA                   ;METROPOLITANA;0;0;0;0;0;0;0;0;0;LED 32 32PHD5813 SMART TV HD;ELECTRONICA MAYOR
17196668;;F;32;CHILENO;;Millenial;SAN CARLOS                    ;NUBLE;0;0;0;0;0;0;0;0;0;LED 40 KEHD4020 SMART TV;ELECTRONICA MAYOR
17992012;;F;30;CHILENO;;Millenial;RENGO                         ;L.G.B.OÂ´HIGGINS;0;0;0;0;0;0;0;0;0;LED 32 UN32T4300AGXZS HD SMART TV;ELECTRONICA MAYOR
26180194;;M;27;HAITIANO;;Extranjero;MAIPU                         ;METROPOLITANA;0;0;0;0;0;0;0;0;0;LED 40 KEHD4020 SMART TV;ELECTRONICA MAYOR
18231019;;F;30;CHILENO;;Millenial;PROVIDENCIA                   ;METROPOLITANA;0;0;0;0;0;0;0;0;0;LED 32 UN32T4300AGXZS HD SMART TV;ELECTRONICA MAYOR
18702471;;F;28;CHILENO;;Millenial;PROVIDENCIA                   ;METROPOLITANA;0;0;0;0;0;0;0;0;0;LED 40 KEHD4020 SMART TV;ELECTRONICA MAYOR
6726687;;F;71;CHILENO;;Silencioso;LA FLORIDA                    ;METROPOLITANA;0;0;0;0;0;0;0;0;0;LED 65 65UN7100 UHD SMART TV;ELECTRONICA MAYOR
5042187;;F;78;CHILENO;;Silencioso;CONCEPCION                    ;BIO BIO;0;0;0;0;0;0;0;0;0;LED 32 UN32T4300AGXZS HD SMART TV;ELECTRONICA MAYOR
17504365;;M;32;CHILENO;;Millenial;PROVIDENCIA                   ;METROPOLITANA;0;0;0;0;0;0;0;0;0;KARAOKE 8 CITY SET MIC WIRELESS ATRIL SILVER;ELECTRONICA MAYOR
13546921;;M;43;CHILENO;;X;SAN ANTONIO                   ;VALPARAISO;0;0;0;0;0;0;0;0;0;LED 43 UN43T5202AGXZS FHD SMART TV;ELECTRONICA MAYOR
13711014;;F;43;CHILENO;;X;PROVIDENCIA                   ;METROPOLITANA;0;0;0;0;0;0;0;0;0;MONITOR 24 24TL520S SMART TV HD;ELECTRONICA MAYOR
16716659;;M;34;CHILENO;;Millenial;"";"";0;0;0;0;0;0;0;0;0;LED 43 UN43T5202AGXZS FHD SMART TV;ELECTRONICA MAYOR
9218546;;M;60;CHILENO;;Boomers;INDEPENDENCIA                 ;METROPOLITANA;0;0;0;0;0;0;0;0;0;LED 43 UN43T5202AGXZS FHD SMART TV;ELECTRONICA MAYOR
12678123;;M;47;CHILENO;;X;RANCAGUA                      ;L.G.B.OÂ´HIGGINS;0;0;0;0;0;0;0;0;0;LED 43 43LM6300PSB SMART TV HD;ELECTRONICA MAYOR
7712496;;F;67;CHILENO;;Boomers;PROVIDENCIA                   ;METROPOLITANA;0;0;0;0;0;0;0;0;0;LED 65 65UN7100 UHD SMART TV;ELECTRONICA MAYOR
10225245;;F;56;CHILENO;;Boomers;SAN BERNARDO                  ;METROPOLITANA;0;0;0;0;0;0;0;0;0;LED 55 UN55TU8300GXZS UHD SMART TV CURVO;ELECTRONICA MAYOR
12011644;;M;53;CHILENO;;X;PROVIDENCIA                   ;METROPOLITANA;0;0;0;0;0;0;0;0;0;LED 40 KEHD4020 SMART TV;ELECTRONICA MAYOR
11453072;;M;52;CHILENO;;X;TEODORO SCHMIDT               ;ARAUCANIA;0;0;0;0;0;0;0;0;0;LED 40 KEHD4020 SMART TV;ELECTRONICA MAYOR
26469753;;M;32;VENEZOLANO;;Extranjero;N/D;N/D;0;0;0;0;0;0;0;0;0;LED 50 UN50TU7090GXZS UHD SMART TV;ELECTRONICA MAYOR
17223183;;F;32;CHILENO;;Millenial;TALCAHUANO                    ;BIO BIO;0;0;0;0;0;0;0;0;0;LED 40 40S65A-40P ANDROID TV SMART LINE FHD;ELECTRONICA MAYOR
15429532;;F;40;CHILENO;;X;PROVIDENCIA                   ;METROPOLITANA;0;0;0;0;0;0;0;0;0;LED 49 49UN7100 UHD SMART TV;ELECTRONICA MAYOR
17945395;;M;30;CHILENO;;Millenial;QUILPUE                       ;VALPARAISO;0;0;0;0;0;0;0;0;0;KARAOKE RHYTHM CHARGER 12 MIC CABLE 8890;ELECTRONICA MAYOR
8948997;Casado;M;62;CHILENO;;Boomers;PROVIDENCIA                   ;METROPOLITANA;0;0;0;0;0;0;0;0;0;KARAOKE RHYTHM CHARGER 12 MIC CABLE 8890;ELECTRONICA MAYOR
8725625;;F;62;CHILENO;;Boomers;CONCEPCION                    ;BIO BIO;0;0;0;0;0;0;0;0;0;PARLANTE ULTRAFORCE-I;ELECTRONICA MAYOR
11110728;;F;55;CHILENO;;Boomers;RENCA                         ;METROPOLITANA;0;0;0;0;0;0;0;0;0;LED 49 49LJ5100 FHD;ELECTRONICA MAYOR
10736708;;M;52;CHILENO;;X;TALCAHUANO                    ;BIO BIO;0;0;0;0;0;0;0;0;0;PARLANTE ULTRAMEGA;ELECTRONICA MAYOR
11287946;;F;54;CHILENO;;X;IQUIQUE                       ;TARAPACA;0;0;0;0;0;0;0;0;0;LED 43 UN43T5202AGXZS FHD SMART TV;ELECTRONICA MAYOR
8410458;;M;62;CHILENO;;Boomers;PROVIDENCIA                   ;METROPOLITANA;0;0;0;0;0;0;0;0;0;LED 32 CS32S1 SMART TV HD NEGRO;ELECTRONICA MAYOR
8544647;;M;63;CHILENO;;Boomers;PUDAHUEL                      ;METROPOLITANA;0;0;0;0;0;0;0;0;0;LED 55 UN55TU8300GXZS UHD SMART TV CURVO;ELECTRONICA MAYOR
15747679;;M;38;CHILENO;;Millenial;N/D;N/D;0;0;0;0;0;0;0;0;0;LED 43 UN43J5202AGXZS SMART TV FHD;ELECTRONICA MAYOR
7323094;;F;69;CHILENO;;Silencioso;VALPARAISO                    ;VALPARAISO;0;0;0;0;0;0;0;0;0;LED 32 32S5295 SMART TV HD;ELECTRONICA MAYOR
13166496;;M;45;CHILENO;;X;RENCA                         ;METROPOLITANA;0;0;0;0;0;0;0;0;0;LED 58 58PUD6513/44 SMART TV UHD;ELECTRONICA MAYOR
17512660;;M;31;CHILENO;;Millenial;PROVIDENCIA                   ;METROPOLITANA;0;0;0;0;0;0;0;0;0;LED 50 UN50TU7090GXZS UHD SMART TV;ELECTRONICA MAYOR
16603922;;F;35;CHILENO;;Millenial;MAIPU                         ;METROPOLITANA;0;0;0;0;0;0;0;0;0;LED 43 UN43T5202AGXZS FHD SMART TV;ELECTRONICA MAYOR
12435318;;M;49;CHILENO;;X;ARICA                         ;ARICA Y PARINACOTA;0;0;0;0;0;0;0;0;0;MINICOMPONENTE RN7;ELECTRONICA MAYOR
13714362;;M;43;CHILENO;;X;PROVIDENCIA                   ;METROPOLITANA;0;0;0;0;0;0;0;0;0;PARLANTE KARAOKE RM1 8 PULGADAS;ELECTRONICA MAYOR
13037100;;F;46;CHILENO;;X;PROVIDENCIA                   ;METROPOLITANA;0;0;0;0;0;0;0;0;0;LED 49 49UN7100 UHD SMART TV;ELECTRONICA MAYOR
15371951;;M;40;CHILENO;;X;QUILPUE                       ;VALPARAISO;0;0;0;0;0;0;0;0;0;LED 32 32PHD5813 SMART TV HD;ELECTRONICA MAYOR
12799860;;M;46;CHILENO;;X;MELIPILLA                     ;METROPOLITANA;0;0;0;0;0;0;0;0;0;MINICOMPONENTE CJ45;ELECTRONICA MAYOR
7182947;Soltero;M;69;CHILENO;;Silencioso;PUERTO MONTT                  ;LOS LAGOS;0;0;0;0;0;0;0;0;0;MINICOMPONENTE MX-T50/ZS ALL IN ONE;ELECTRONICA MAYOR
18438880;;M;28;CHILENO;;Extranjero;TEMUCO                        ;ARAUCANIA;0;0;0;0;0;0;0;0;0;LED 50 UN50TU7090GXZS UHD SMART TV;ELECTRONICA MAYOR
11067580;;F;56;CHILENO;;Boomers;VINA DEL MAR                  ;VALPARAISO;0;0;0;0;0;0;0;0;0;LED 32 32PHD5813 SMART TV HD;ELECTRONICA MAYOR
19167508;;F;27;CHILENO;;Z;LA SERENA                     ;COQUIMBO;0;0;0;0;0;0;0;0;0;PARLANTE BOLA DISCO CON MICROFONO INAL;ELECTRONICA MAYOR
17526404;;M;30;CHILENO;;Millenial;RANCAGUA                      ;L.G.B.OÂ´HIGGINS;0;0;0;0;0;0;0;0;0;LED 70 UN70TU6900GXZS UHD SMART TV;ELECTRONICA MAYOR
9526931;;M;59;CHILENO;;Boomers;DALCAHUE                      ;LOS LAGOS;0;0;0;0;0;0;0;0;0;LED 32 CS32S1 SMART TV HD NEGRO;ELECTRONICA MAYOR
11694834;;M;51;CHILENO;;X;SAN BERNARDO                  ;METROPOLITANA;0;0;0;0;0;0;0;0;0;LED 58 58PUD6513/44 SMART TV UHD;ELECTRONICA MAYOR
13581998;;F;46;CHILENO;;X;CONCHALI                      ;METROPOLITANA;0;0;0;0;0;0;0;0;0;LED 50 UN50TU7090GXZS UHD SMART TV;ELECTRONICA MAYOR
9082268;;M;60;CHILENO;;Boomers;TALCAHUANO                    ;BIO BIO;0;0;0;0;0;0;0;0;0;PARLANTE ULTRAMAGIC;ELECTRONICA MAYOR
16230646;;M;37;CHILENO;;Millenial;PROVIDENCIA                   ;METROPOLITANA;0;0;0;0;0;0;0;0;0;LED 32 32LM630BPSB SMART TV;ELECTRONICA MAYOR
12596718;;F;48;CHILENO;;X;RENCA                         ;METROPOLITANA;0;0;0;0;0;0;0;0;0;KARAOKE RHYTHM CHARGER 12 MIC CABLE 8890;ELECTRONICA MAYOR
12384099;;M;48;CHILENO;;X;SAN BERNARDO                  ;METROPOLITANA;0;0;0;0;0;0;0;0;0;PARLANTE ULTRAMEGA;ELECTRONICA MAYOR
14043173;;M;40;CHILENO;;X;RENCA                         ;METROPOLITANA;0;0;0;0;0;0;0;0;0;KARAOKE BLACK PHANTER II;ELECTRONICA MAYOR
17222820;;F;32;CHILENO;;Millenial;PROVIDENCIA                   ;METROPOLITANA;0;0;0;0;0;0;0;0;0;LED 43 43LM6300PSB SMART TV HD;ELECTRONICA MAYOR
13539294;;F;43;CHILENO;;Millenial;"";"";0;0;0;0;0;0;0;0;0;LED 49 49UN7100 UHD SMART TV;ELECTRONICA MAYOR
20209723;;F;22;CHILENO;;Z;LUMACO                        ;ARAUCANIA;0;0;0;0;0;0;0;0;0;KARAOKE RHYTHM CHARGER 12 MIC CABLE 8890;ELECTRONICA MAYOR
17286766;;M;32;CHILENO;;Millenial;PROVIDENCIA                   ;METROPOLITANA;0;0;0;0;0;0;0;0;0;PARLANTE KARAOKE RM1 8 PULGADAS;ELECTRONICA MAYOR
18311175;Soltero;M;29;CHILENO;INGENIERO EN AUTOMATIZACION Y CONTROL INDUSTRIAL;Millenial;PROVIDENCIA                   ;METROPOLITANA;0;0;0;0;0;0;0;0;0;LED 58 58PUD6513/44 SMART TV UHD;ELECTRONICA MAYOR
10932974;Casado;F;53;CHILENO;AUXILIAR PARAMEDICO DE ENFERMERIA;X;PROVIDENCIA                   ;METROPOLITANA;0;0;0;0;0;0;0;0;0;LED 49 49UJ6300 UHD SMART;ELECTRONICA MAYOR
12533643;;F;48;CHILENO;;X;N/D;N/D;0;0;0;0;0;0;0;0;0;KARAOKE RHYTHM CHARGER 12 MIC CABLE 8890;ELECTRONICA MAYOR
10398264;;M;55;CHILENO;;Boomers;RENCA                         ;METROPOLITANA;0;0;0;0;0;0;0;0;0;PARLANTE ULTRAFORCE-I;ELECTRONICA MAYOR
11763743;;F;54;CHILENO;;X;CURICO                        ;MAULE;0;0;0;0;0;0;0;0;0;LED KIOTO 32 MI3228 SMART TV;ELECTRONICA MAYOR
16219259;Soltero;M;35;CHILENO;;Millenial;PROVIDENCIA                   ;METROPOLITANA;0;0;0;0;0;0;0;0;0;LED 32 32LM630BPSB SMART TV;ELECTRONICA MAYOR
17299442;;F;32;CHILENO;;Millenial;N/D;N/D;0;0;0;0;0;0;0;0;0;LED 50 50PUD6654 SMART TV UHD BL BT SILVER;ELECTRONICA MAYOR
18453297;;M;29;CHILENO;;Millenial;N/D;N/D;0;0;0;0;0;0;0;0;0;MNICOMPONENTE OM7560;ELECTRONICA MAYOR
12571420;;M;48;CHILENO;;X;OVALLE                        ;COQUIMBO;0;0;0;0;0;0;0;0;0;MINICOMPONENTE RN5;ELECTRONICA MAYOR
17297664;Soltero;M;33;CHILENO;MEDICO CIRUJANO;Millenial;TALCA                         ;MAULE;0;0;0;0;0;0;0;0;0;LED 32 32PHD5813 SMART TV HD;ELECTRONICA MAYOR
5850274;;M;72;CHILENO;;Silencioso;CORONEL                       ;BIO BIO;0;0;0;0;0;0;0;0;0;LED 43 UN43TU7090GXZS UHD SMART TV;ELECTRONICA MAYOR
11444067;;M;52;CHILENO;;X;QUILICURA                     ;METROPOLITANA;0;0;0;0;0;0;0;0;0;LED 55 UN55NU7095GXZS SMART TV TV 4K;ELECTRONICA MAYOR
15971397;;M;37;CHILENO;;Millenial;N/D;N/D;0;0;0;0;0;0;0;0;0;PARLANTE ULTRAFORCE-I;ELECTRONICA MAYOR
18329548;;M;29;CHILENO;;Millenial;MAIPU;METROPOLITANA;0;0;0;0;0;0;0;0;0;SOUNDBAR HW-T400/ZS;ELECTRONICA MAYOR
12704513;;F;47;CHILENO;;X;PROVIDENCIA                   ;METROPOLITANA;0;0;0;0;0;0;0;0;0;LED 43 MI4328 SMART TV;ELECTRONICA MAYOR
6741794;;F;69;CHILENO;;Silencioso;"";"";0;0;0;0;0;0;0;0;0;LED 50 UN50TU7090GXZS UHD SMART TV;ELECTRONICA MAYOR
12917186;;F;48;CHILENO;;X;TALCAHUANO                    ;BIO BIO;0;0;0;0;0;0;0;0;0;LED 43 43S5295 SMART TV FHD;ELECTRONICA MAYOR
16071236;;F;36;CHILENO;;Millenial;MAIPU                         ;METROPOLITANA;0;0;0;0;0;0;0;0;0;LED 43 43S5295 SMART TV FHD;ELECTRONICA MAYOR
13094914;;M;46;CHILENO;;X;N/D;N/D;0;0;0;0;0;0;0;0;0;PARLANTE ULTRAMAGIC;ELECTRONICA MAYOR
18819425;;M;27;CHILENO;;Z;PROVIDENCIA                   ;METROPOLITANA;0;0;0;0;0;0;0;0;0;LED 32 UN32T4300AGXZS HD SMART TV;ELECTRONICA MAYOR
9968047;;F;57;CHILENO;;Extranjero;PUENTE ALTO                   ;METROPOLITANA;0;0;0;0;0;0;0;0;0;LED 55 55UN7100 UHD SMART TV;ELECTRONICA MAYOR
9860725;;M;58;CHILENO;;Boomers;LLAILLAY                      ;VALPARAISO;0;0;0;0;0;0;0;0;0;LED 55 UN55TU8300GXZS UHD SMART TV CURVO;ELECTRONICA MAYOR
4526579;;M;75;CHILENO;;Silencioso;RENCA                         ;METROPOLITANA;0;0;0;0;0;0;0;0;0;LED 43 UN43J5202AGXZS SMART TV FHD;ELECTRONICA MAYOR
17537656;;F;32;CHILENO;;Millenial;TILTIL                        ;METROPOLITANA;0;0;0;0;0;0;0;0;0;PARLANTE ULTRAMAGIC;ELECTRONICA MAYOR
6261000;;F;73;CHILENO;;Silencioso;ARICA                         ;ARICA Y PARINACOTA;0;0;0;0;0;0;0;0;0;MINICOMPONENTE RN5;ELECTRONICA MAYOR
4941154;;M;76;CHILENO;;Silencioso;RENCA                         ;METROPOLITANA;0;0;0;0;0;0;0;0;0;PARLANTE ULTRAMEGA;ELECTRONICA MAYOR
12236704;;F;50;CHILENO;;X;QUILICURA                     ;METROPOLITANA;0;0;0;0;0;0;0;0;0;MINICOMPONENTE RN7;ELECTRONICA MAYOR
11658640;;M;52;CHILENO;;X;RENCA                         ;METROPOLITANA;0;0;0;0;0;0;0;0;0;LED 55 55UN7100 UHD SMART TV;ELECTRONICA MAYOR
16102422;;M;36;CHILENO;;Millenial;COIHAIQUE                     ;AYSEN;0;0;0;0;0;0;0;0;0;MONITOR 24 24TL520S SMART TV HD;ELECTRONICA MAYOR
7730538;;M;64;CHILENO;;Boomers;N/D;N/D;0;0;0;0;0;0;0;0;0;LED 43 43S5295 SMART TV FHD;ELECTRONICA MAYOR
13398577;;F;44;CHILENO;;X;PITRUFQUEN                    ;ARAUCANIA;0;0;0;0;0;0;0;0;0;LED 43 43LM6300PSB SMART TV HD;ELECTRONICA MAYOR
11906684;;F;51;CHILENO;;X;REQUINOA                      ;L.G.B.OÂ´HIGGINS;0;0;0;0;0;0;0;0;0;LED 50 UN50TU7090GXZS UHD SMART TV;ELECTRONICA MAYOR
18623834;;M;28;CHILENO;;Millenial;"";"";0;0;0;0;0;0;0;0;0;MINICOMPONENTE MX-T50/ZS ALL IN ONE;ELECTRONICA MAYOR
16137093;;F;37;CHILENO;;Millenial;PROVIDENCIA                   ;METROPOLITANA;0;0;0;0;0;0;0;0;0;LED 32 UN32T4300AGXZS HD SMART TV;ELECTRONICA MAYOR
26747023;;M;27;EXTRANJERO - NO INFORMA NACIONALIDAD;;Extranjero;TALCA                         ;MAULE;0;0;0;0;0;0;0;0;0;MINICOMPONENTE OL45;ELECTRONICA MAYOR
17839523;;F;30;CHILENO;;Millenial;"";"";0;0;0;0;0;0;0;0;0;LED 32 UN32T4300AGXZS HD SMART TV;ELECTRONICA MAYOR
17648281;Soltero;F;31;CHILENO;;Millenial;PROVIDENCIA                   ;METROPOLITANA;0;0;0;0;0;0;0;0;0;LED 55 UN55NU7095GXZS SMART TV TV 4K;ELECTRONICA MAYOR
7120782;;F;64;CHILENO;;Boomers;RANCAGUA                      ;L.G.B.OÂ´HIGGINS;0;0;0;0;0;0;0;0;0;LED 32 32LK540 HD SMART;ELECTRONICA MAYOR
13645451;;F;42;CHILENO;;X;ANTOFAGASTA                   ;ANTOFAGASTA;0;0;0;0;0;0;0;0;0;PARLANTE ULTRAFORCE-I;ELECTRONICA MAYOR
16810837;;M;34;CHILENO;;Millenial;LO PRADO                      ;METROPOLITANA;0;0;0;0;0;0;0;0;0;LED KIOTO 32 MI3228 SMART TV;ELECTRONICA MAYOR
19780926;;M;24;CHILENO;;Z;VALPARAISO                    ;VALPARAISO;0;0;0;0;0;0;0;0;0;LED 40 40S65A-40P ANDROID TV SMART LINE FHD;ELECTRONICA MAYOR
19805855;;M;24;CHILENO;;Z;TALCA                         ;MAULE;0;0;0;0;0;0;0;0;0;LED 43 UN43J5202AGXZS SMART TV FHD;ELECTRONICA MAYOR
12269090;;F;50;CHILENO;;X;N/D;N/D;0;0;0;0;0;0;0;0;0;LED 65 UN65TU6900GXZS UHD SMART TV;ELECTRONICA MAYOR
14412346;Casado;M;43;CHILENO;INGENIERO COMERCIAL;X;PROVIDENCIA                   ;METROPOLITANA;0;0;0;0;0;0;0;0;0;MONITOR 24 24TL520S SMART TV HD;ELECTRONICA MAYOR
5905134;;F;75;CHILENO;;Silencioso;VALPARAISO                    ;VALPARAISO;0;0;0;0;0;0;0;0;0;LED 43 UN43J5202AGXZS SMART TV FHD;ELECTRONICA MAYOR
12396596;;M;48;CHILENO;;X;ARICA                         ;ARICA Y PARINACOTA;0;0;0;0;0;0;0;0;0;LED 55 UN55NU7095GXZS SMART TV TV 4K;ELECTRONICA MAYOR
12082923;;F;57;CHILENO;;Boomers;NEGRETE                       ;BIO BIO;0;0;0;0;0;0;0;0;0;LED 49 49UN7100 UHD SMART TV;ELECTRONICA MAYOR
16753498;;M;34;CHILENO;;Millenial;N/D;N/D;0;0;0;0;0;0;0;0;0;LED KIOTO 32 MI3228 SMART TV;ELECTRONICA MAYOR
7630121;;F;64;CHILENO;;Millenial;N/D;N/D;0;0;0;0;0;0;0;0;0;LED KIOTO 32 MI3228 SMART TV;ELECTRONICA MAYOR
14008383;;M;40;CHILENO;;X;"";"";0;0;0;0;0;0;0;0;0;LED 32 UN32T4300AGXZS HD SMART TV;ELECTRONICA MAYOR
27064004;;F;43;VENEZOLANO;;Extranjero;CONCEPCION                    ;BIO BIO;0;0;0;0;0;0;0;0;0;LED 43 43S5295 SMART TV FHD;ELECTRONICA MAYOR
11239750;;F;53;CHILENO;;X;RENCA                         ;METROPOLITANA;0;0;0;0;0;0;0;0;0;LED 32 32S5295 SMART TV HD;ELECTRONICA MAYOR
7836917;;M;67;CHILENO;;Boomers;SAN CLEMENTE                  ;MAULE;0;0;0;0;0;0;0;0;0;MINICOMPONENTE OL45;ELECTRONICA MAYOR
14230419;Soltero;F;54;CHILENO;;X;RENCA                         ;METROPOLITANA;0;0;0;0;0;0;0;0;0;LED 55 UN55NU7095GXZS SMART TV TV 4K;ELECTRONICA MAYOR
17893282;Soltero;M;30;CHILENO;MEDICO CIRUJANO;Millenial;PROVIDENCIA                   ;METROPOLITANA;0;0;0;0;0;0;0;0;0;SOUNDBAR HW-Q70T/ZS;ELECTRONICA MAYOR
11493734;;F;53;CHILENO;;X;N/D;N/D;0;0;0;0;0;0;0;0;0;LED 43 UN43J5202AGXZS SMART TV FHD;ELECTRONICA MAYOR
16534838;;F;34;CHILENO;;Millenial;VILLARICA                     ;ARAUCANIA;0;0;0;0;0;0;0;0;0;LED 50 50PUD6513/44 SMART TV UHD 4K;ELECTRONICA MAYOR
8436805;;F;62;CHILENO;;Boomers;COLLIPULLI                    ;ARAUCANIA;0;0;0;0;0;0;0;0;0;KARAOKE SP-101BT ALL IN ONE PORTATIL 60W;ELECTRONICA MAYOR
9207958;;F;58;CHILENO;;Boomers;SANTIAGO                      ;METROPOLITANA;0;0;0;0;0;0;0;0;0;LED 65 65UN7300 UHD SMART TV;ELECTRONICA MAYOR
14629531;;M;50;CHILENO;;Extranjero;IQUIQUE                       ;TARAPACA;0;0;0;0;0;0;0;0;0;LED 55 55UM7100PSA SMART TV + MAGIC REMOTE UHD;ELECTRONICA MAYOR
12073577;;F;55;CHILENO;;Boomers;EL BOSQUE                     ;METROPOLITANA;0;0;0;0;0;0;0;0;0;LED 43 UN43J5202AGXZS SMART TV FHD;ELECTRONICA MAYOR
17734517;Soltero;F;31;CHILENO;;Millenial;PROVIDENCIA                   ;METROPOLITANA;0;0;0;0;0;0;0;0;0;LED 40 40S65A-40P ANDROID TV SMART LINE FHD;ELECTRONICA MAYOR
14083771;Casado;F;41;CHILENO;;X;PROVIDENCIA                   ;METROPOLITANA;0;0;0;0;0;0;0;0;0;KARAOKE RHYTHM CHARGER 12 MIC CABLE 8890;ELECTRONICA MAYOR
10016149;;M;56;CHILENO;;Boomers;ANTOFAGASTA                   ;ANTOFAGASTA;0;0;0;0;0;0;0;0;0;LED 32 32PHD5813 SMART TV HD;ELECTRONICA MAYOR
8623346;;M;62;CHILENO;;Boomers;GORBEA                        ;ARAUCANIA;0;0;0;0;0;0;0;0;0;LED 43 43PFD5813 SMART TV FULL HD;ELECTRONICA MAYOR
10226808;;F;56;CHILENO;;Boomers;RENCA                         ;METROPOLITANA;0;0;0;0;0;0;0;0;0;KARAOKE PORTATIL TWO-EIGHT 8860;ELECTRONICA MAYOR
10031274;;F;56;CHILENO;;Boomers;PROVIDENCIA                   ;METROPOLITANA;0;0;0;0;0;0;0;0;0;LED 43 43LM6300PSB SMART TV HD;ELECTRONICA MAYOR
17841684;Soltero;M;30;CHILENO;;Millenial;PROVIDENCIA                   ;METROPOLITANA;0;0;0;0;0;0;0;0;0;LED 32 32LM630BPSB SMART TV;ELECTRONICA MAYOR
9412678;;M;58;CHILENO;;Boomers;ANGOL                         ;ARAUCANIA;0;0;0;0;0;0;0;0;0;LED 50 MI50291 SMART TV 4K;ELECTRONICA MAYOR
15896379;;F;37;CHILENO;;Millenial;N/D;N/D;0;0;0;0;0;0;0;0;0;PARLANTE CITY MIC WIRELESS GREEN 8710;ELECTRONICA MAYOR
15118298;;M;39;CHILENO;;X;N/D;N/D;0;0;0;0;0;0;0;0;0;LED 43 MI4328 SMART TV;ELECTRONICA MAYOR
13145176;;F;45;CHILENO;;X;RENCA                         ;METROPOLITANA;0;0;0;0;0;0;0;0;0;LED 50 UN50TU7090GXZS UHD SMART TV;ELECTRONICA MAYOR
11435318;Casado;M;52;CHILENO;;X;RENCA                         ;METROPOLITANA;0;0;0;0;0;0;0;0;0;LED 32 UN32T4300AGXZS HD SMART TV;ELECTRONICA MAYOR
12280619;;M;49;CHILENO;;X;PROVIDENCIA                   ;METROPOLITANA;0;0;0;0;0;0;0;0;0;PARLANTE CITY MIC WIRELESS GREEN 8710;ELECTRONICA MAYOR
15678994;;F;38;CHILENO;;Millenial;PROVIDENCIA                   ;METROPOLITANA;0;0;0;0;0;0;0;0;0;LED 43 UN43J5202AGXZS SMART TV FHD;ELECTRONICA MAYOR
8074360;;F;66;CHILENO;;Boomers;MELIPILLA                     ;METROPOLITANA;0;0;0;0;0;0;0;0;0;LED KIOTO 32 MI3228 SMART TV;ELECTRONICA MAYOR
15329108;Casado;M;39;CHILENO;INGENIERO INFORMATICO;X;PROVIDENCIA                   ;METROPOLITANA;0;0;0;0;0;0;0;0;0;LED 49 49UN7100 UHD SMART TV;ELECTRONICA MAYOR
19062478;Soltero;F;27;CHILENO;;Z;PROVIDENCIA                   ;METROPOLITANA;0;0;0;0;0;0;0;0;0;LED 58 58PUD6513/44 SMART TV UHD;ELECTRONICA MAYOR
13306813;;M;45;CHILENO;;X;LOS ANGELES                   ;BIO BIO;0;0;0;0;0;0;0;0;0;LED 32 32PHD5813 SMART TV HD;ELECTRONICA MAYOR
11056003;;F;56;CHILENO;;Boomers;SAN BERNARDO                  ;METROPOLITANA;0;0;0;0;0;0;0;0;0;LED 50 50U6295 SMART TV UHD;ELECTRONICA MAYOR
26156021;;M;42;COLOMBIANO;;Extranjero;PROVIDENCIA                   ;METROPOLITANA;0;0;0;0;0;0;0;0;0;LED 43 UN43TU7090GXZS UHD SMART TV;ELECTRONICA MAYOR
19128769;;F;26;CHILENO;;Z;LA LIGUA                      ;VALPARAISO;0;0;0;0;0;0;0;0;0;LED 43 43PFD5813 SMART TV FULL HD;ELECTRONICA MAYOR
16059324;;M;36;CHILENO;;Millenial;HIJUELAS                      ;VALPARAISO;0;0;0;0;0;0;0;0;0;PARLANTE DJ VIBRANIUM;ELECTRONICA MAYOR
17184266;;F;33;CHILENO;;Millenial;SAN RAFAEL                    ;MAULE;0;0;0;0;0;0;0;0;0;LED 43 43NU7090 SMART TV 4K UHD;ELECTRONICA MAYOR
19388119;Soltero;F;26;CHILENO;MATRONA;Z;PROVIDENCIA                   ;METROPOLITANA;0;0;0;0;0;0;0;0;0;LED 50 50PUD6513/44 SMART TV UHD 4K;ELECTRONICA MAYOR
7761907;;F;65;CHILENO;;Boomers;RENCA                         ;METROPOLITANA;0;0;0;0;0;0;0;0;0;LED 43 UN43J5202AGXZS SMART TV FHD;ELECTRONICA MAYOR
16757618;;F;34;CHILENO;;Millenial;EL TABO                       ;VALPARAISO;0;0;0;0;0;0;0;0;0;KARAOKE KIOTO GA121;ELECTRONICA MAYOR
18759059;;F;27;CHILENO;;Millenial;VINA DEL MAR                  ;VALPARAISO;0;0;0;0;0;0;0;0;0;LED 50 50PUD6513/44 SMART TV UHD 4K;ELECTRONICA MAYOR
16524169;;F;35;CHILENO;;Millenial;COPIAPO                       ;ATACAMA;0;0;0;0;0;0;0;0;0;LED 32 CS32S1 SMART TV HD NEGRO;ELECTRONICA MAYOR
9338357;;F;58;CHILENO;;Boomers;MELIPILLA                     ;METROPOLITANA;0;0;0;0;0;0;0;0;0;LED 50 UN50TU7090GXZS UHD SMART TV;ELECTRONICA MAYOR
